,AÃ±o,Mes,Nacionalidad,Femenino,Masculino,Indefinido,Total,long,lat
907,2012,Enero,Venezuela,297,339,,636,-77.35600000000001,0.81488
908,2012,Enero,Venezuela,7,12,,19,-75.527794,10.406342
909,2012,Enero,Venezuela,76,133,,209,-75.516486,10.446304
910,2012,Enero,Venezuela,55,70,,125,-74.77647900000001,10.886686
911,2012,Enero,Venezuela,0,4,,4,-74.232675,11.117206
912,2012,Enero,Venezuela,1265,1721,,2986,-72.129595,11.360028999999999
913,2012,Enero,Venezuela,1,0,,1,-72.919186,11.52863
914,2012,Enero,Venezuela,13,13,,26,-81.70216500000001,12.5862
915,2012,Enero,Venezuela,53,58,,111,-76.532004,3.451668
916,2012,Enero,Venezuela,5306,6178,,11484,-74.140516,4.697157
917,2012,Enero,Venezuela,7,24,,31,-75.736374,4.815189
918,2012,Enero,Venezuela,362,421,,783,-75.42726,6.170465
919,2012,Enero,Venezuela,5,3,,8,-67.48402800000001,6.185536
920,2012,Enero,Venezuela,67,81,,148,-70.74025300000001,7.088728999999999
921,2012,Enero,Venezuela,3,1,,4,-73.181317,7.1280470000000005
922,2012,Enero,Venezuela,1767,1997,,3764,-72.453013,7.819
923,2012,Enero,Venezuela,431,487,,918,-72.508188,7.927233
924,2012,Enero,Venezuela,1,1,,2,-77.35002,8.63337
1883,2012,Febrero,Venezuela,0,3,,3,-69.941498,4.191162
1884,2012,Febrero,Venezuela,95,123,,218,-77.35600000000001,0.81488
1885,2012,Febrero,Venezuela,9,15,,24,-75.527794,10.406342
1886,2012,Febrero,Venezuela,81,113,,194,-75.516486,10.446304
1887,2012,Febrero,Venezuela,82,116,,198,-74.77647900000001,10.886686
1888,2012,Febrero,Venezuela,0,1,,1,-74.765343,10.970933
1889,2012,Febrero,Venezuela,0,4,,4,-74.232675,11.117206
1890,2012,Febrero,Venezuela,0,3,,3,-74.213989,11.247722999999999
1891,2012,Febrero,Venezuela,1852,2260,,4112,-72.129595,11.360028999999999
1892,2012,Febrero,Venezuela,3,2,,5,-72.919186,11.52863
1893,2012,Febrero,Venezuela,9,13,,22,-81.70216500000001,12.5862
1894,2012,Febrero,Venezuela,49,60,,109,-76.532004,3.451668
1895,2012,Febrero,Venezuela,0,2,,2,-75.76635300000001,4.45285
1896,2012,Febrero,Venezuela,4326,5705,,10031,-74.140516,4.697157
1897,2012,Febrero,Venezuela,2,15,,17,-75.736374,4.815189
1898,2012,Febrero,Venezuela,294,336,,630,-75.42726,6.170465
1899,2012,Febrero,Venezuela,4,6,,10,-67.48402800000001,6.185536
1900,2012,Febrero,Venezuela,27,45,,72,-70.74025300000001,7.088728999999999
1901,2012,Febrero,Venezuela,6,10,,16,-73.181317,7.1280470000000005
1902,2012,Febrero,Venezuela,1318,1520,,2838,-72.453013,7.819
1903,2012,Febrero,Venezuela,325,382,,707,-72.508188,7.927233
1904,2012,Febrero,Venezuela,7,4,,11,-77.35002,8.63337
2890,2012,Marzo,Venezuela,48,89,,137,-77.35600000000001,0.81488
2891,2012,Marzo,Venezuela,17,9,,26,-75.527794,10.406342
2892,2012,Marzo,Venezuela,64,123,,187,-75.516486,10.446304
2893,2012,Marzo,Venezuela,116,137,,253,-74.77647900000001,10.886686
2894,2012,Marzo,Venezuela,0,4,,4,-74.232675,11.117206
2895,2012,Marzo,Venezuela,1251,1720,,2971,-72.129595,11.360028999999999
2896,2012,Marzo,Venezuela,2,1,,3,-72.919186,11.52863
2897,2012,Marzo,Venezuela,0,1,,1,-81.703935,12.574411099999999
2898,2012,Marzo,Venezuela,8,7,,15,-81.70216500000001,12.5862
2899,2012,Marzo,Venezuela,35,51,,86,-76.532004,3.451668
2900,2012,Marzo,Venezuela,1,2,,3,-75.76635300000001,4.45285
2901,2012,Marzo,Venezuela,4184,5545,,9729,-74.140516,4.697157
2902,2012,Marzo,Venezuela,2,21,,23,-75.736374,4.815189
2903,2012,Marzo,Venezuela,321,396,,717,-75.42726,6.170465
2904,2012,Marzo,Venezuela,13,14,,27,-67.48402800000001,6.185536
2905,2012,Marzo,Venezuela,41,82,,123,-70.74025300000001,7.088728999999999
2906,2012,Marzo,Venezuela,8,17,,25,-73.181317,7.1280470000000005
2907,2012,Marzo,Venezuela,1299,1506,,2805,-72.453013,7.819
2908,2012,Marzo,Venezuela,256,300,,556,-72.508188,7.927233
2909,2012,Marzo,Venezuela,0,1,,1,-77.35002,8.63337
3859,2012,Abril,Venezuela,50,94,,144,-77.35600000000001,0.81488
3860,2012,Abril,Venezuela,0,1,,1,-78.802679,18.00143
3861,2012,Abril,Venezuela,7,20,,27,-75.527794,10.406342
3862,2012,Abril,Venezuela,0,14,,14,-73.247863,10.433608999999999
3863,2012,Abril,Venezuela,112,222,,334,-75.516486,10.446304
3864,2012,Abril,Venezuela,35,53,,88,-74.77647900000001,10.886686
3865,2012,Abril,Venezuela,1,2,,3,-74.232675,11.117206
3866,2012,Abril,Venezuela,0,3,,3,-74.213989,11.247722999999999
3867,2012,Abril,Venezuela,2051,2483,,4534,-72.129595,11.360028999999999
3868,2012,Abril,Venezuela,7,6,,13,-72.919186,11.52863
3869,2012,Abril,Venezuela,8,8,,16,-81.70216500000001,12.5862
3870,2012,Abril,Venezuela,51,58,,109,-76.532004,3.451668
3871,2012,Abril,Venezuela,1,1,,2,-75.76635300000001,4.45285
3872,2012,Abril,Venezuela,5067,5746,,10813,-74.140516,4.697157
3873,2012,Abril,Venezuela,1,17,,18,-75.736374,4.815189
3874,2012,Abril,Venezuela,243,312,,555,-75.42726,6.170465
3875,2012,Abril,Venezuela,28,45,,73,-67.48402800000001,6.185536
3876,2012,Abril,Venezuela,47,47,,94,-70.74025300000001,7.088728999999999
3877,2012,Abril,Venezuela,5,6,,11,-73.181317,7.1280470000000005
3878,2012,Abril,Venezuela,1276,1365,,2641,-72.453013,7.819
3879,2012,Abril,Venezuela,225,220,,445,-72.508188,7.927233
3880,2012,Abril,Venezuela,0,1,,1,-77.35002,8.63337
4813,2012,Mayo,Venezuela,0,2,,2,-69.941498,4.191162
4814,2012,Mayo,Venezuela,40,60,,100,-77.35600000000001,0.81488
4815,2012,Mayo,Venezuela,3,12,,15,-75.527794,10.406342
4816,2012,Mayo,Venezuela,88,130,,218,-75.516486,10.446304
4817,2012,Mayo,Venezuela,56,92,,148,-74.77647900000001,10.886686
4818,2012,Mayo,Venezuela,0,1,,1,-74.765343,10.970933
4819,2012,Mayo,Venezuela,0,2,,2,-74.213989,11.247722999999999
4820,2012,Mayo,Venezuela,1008,1448,,2456,-72.129595,11.360028999999999
4821,2012,Mayo,Venezuela,1,5,,6,-72.919186,11.52863
4822,2012,Mayo,Venezuela,11,9,,20,-81.70216500000001,12.5862
4823,2012,Mayo,Venezuela,52,78,,130,-76.532004,3.451668
4824,2012,Mayo,Venezuela,3812,5305,,9117,-74.140516,4.697157
4825,2012,Mayo,Venezuela,5,20,,25,-75.736374,4.815189
4826,2012,Mayo,Venezuela,320,415,,735,-75.42726,6.170465
4827,2012,Mayo,Venezuela,0,4,,4,-67.48402800000001,6.185536
4828,2012,Mayo,Venezuela,30,68,,98,-70.74025300000001,7.088728999999999
4829,2012,Mayo,Venezuela,13,20,,33,-73.181317,7.1280470000000005
4830,2012,Mayo,Venezuela,851,1016,,1867,-72.453013,7.819
4831,2012,Mayo,Venezuela,175,197,,372,-72.508188,7.927233
4832,2012,Mayo,Venezuela,0,1,,1,-77.35002,8.63337
5779,2012,Junio,Venezuela,32,69,,101,-77.35600000000001,0.81488
5780,2012,Junio,Venezuela,0,27,,27,-75.527794,10.406342
5781,2012,Junio,Venezuela,80,122,,202,-75.516486,10.446304
5782,2012,Junio,Venezuela,40,97,,137,-74.77647900000001,10.886686
5783,2012,Junio,Venezuela,0,2,,2,-74.213989,11.247722999999999
5784,2012,Junio,Venezuela,1048,1561,,2609,-72.129595,11.360028999999999
5785,2012,Junio,Venezuela,3,1,,4,-72.919186,11.52863
5786,2012,Junio,Venezuela,11,10,,21,-81.70216500000001,12.5862
5787,2012,Junio,Venezuela,39,50,,89,-76.532004,3.451668
5788,2012,Junio,Venezuela,3770,4979,,8749,-74.140516,4.697157
5789,2012,Junio,Venezuela,3,13,,16,-75.736374,4.815189
5790,2012,Junio,Venezuela,292,362,,654,-75.42726,6.170465
5791,2012,Junio,Venezuela,7,4,,11,-67.48402800000001,6.185536
5792,2012,Junio,Venezuela,59,110,,169,-70.74025300000001,7.088728999999999
5793,2012,Junio,Venezuela,7,10,,17,-73.181317,7.1280470000000005
5794,2012,Junio,Venezuela,1018,1303,,2321,-72.453013,7.819
5795,2012,Junio,Venezuela,186,236,,422,-72.508188,7.927233
6779,2012,Julio,Venezuela,1,1,,2,-76.876446,0.33002
6780,2012,Julio,Venezuela,47,75,,122,-77.35600000000001,0.81488
6781,2012,Julio,Venezuela,0,3,,3,-75.527794,10.406342
6782,2012,Julio,Venezuela,88,94,,182,-75.516486,10.446304
6783,2012,Julio,Venezuela,29,70,,99,-74.77647900000001,10.886686
6784,2012,Julio,Venezuela,0,5,,5,-74.232675,11.117206
6785,2012,Julio,Venezuela,1810,2333,,4143,-72.129595,11.360028999999999
6786,2012,Julio,Venezuela,1,2,,3,-72.919186,11.52863
6787,2012,Julio,Venezuela,22,24,,46,-81.70216500000001,12.5862
6788,2012,Julio,Venezuela,37,55,,92,-76.532004,3.451668
6789,2012,Julio,Venezuela,0,1,,1,-75.76635300000001,4.45285
6790,2012,Julio,Venezuela,4918,6202,,11120,-74.140516,4.697157
6791,2012,Julio,Venezuela,5,17,,22,-75.736374,4.815189
6792,2012,Julio,Venezuela,478,511,,989,-75.42726,6.170465
6793,2012,Julio,Venezuela,7,4,,11,-67.48402800000001,6.185536
6794,2012,Julio,Venezuela,30,40,,70,-70.74025300000001,7.088728999999999
6795,2012,Julio,Venezuela,5,4,,9,-73.181317,7.1280470000000005
6796,2012,Julio,Venezuela,1785,1888,,3673,-72.453013,7.819
6797,2012,Julio,Venezuela,282,263,,545,-72.508188,7.927233
7754,2012,Agosto,Venezuela,0,1,,1,-69.941498,4.191162
7755,2012,Agosto,Venezuela,5,1,,6,-76.876446,0.33002
7756,2012,Agosto,Venezuela,95,126,,221,-77.35600000000001,0.81488
7757,2012,Agosto,Venezuela,0,10,,10,-75.527794,10.406342
7758,2012,Agosto,Venezuela,462,289,,751,-75.516486,10.446304
7759,2012,Agosto,Venezuela,45,68,,113,-74.77647900000001,10.886686
7760,2012,Agosto,Venezuela,3578,3358,,6936,-72.129595,11.360028999999999
7761,2012,Agosto,Venezuela,2,0,,2,-72.919186,11.52863
7762,2012,Agosto,Venezuela,30,28,,58,-81.70216500000001,12.5862
7763,2012,Agosto,Venezuela,33,54,,87,-76.532004,3.451668
7764,2012,Agosto,Venezuela,1,1,,2,-75.76635300000001,4.45285
7765,2012,Agosto,Venezuela,6480,6578,,13058,-74.140516,4.697157
7766,2012,Agosto,Venezuela,1,9,,10,-75.736374,4.815189
7767,2012,Agosto,Venezuela,562,648,,1210,-75.42726,6.170465
7768,2012,Agosto,Venezuela,3,5,,8,-67.48402800000001,6.185536
7769,2012,Agosto,Venezuela,103,133,,236,-70.74025300000001,7.088728999999999
7770,2012,Agosto,Venezuela,3,8,,11,-73.181317,7.1280470000000005
7771,2012,Agosto,Venezuela,3295,3022,,6317,-72.453013,7.819
7772,2012,Agosto,Venezuela,502,484,,986,-72.508188,7.927233
7773,2012,Agosto,Venezuela,0,1,,1,-76.7333,8.06667
8690,2012,Septiembre,Venezuela,0,4,,4,-76.876446,0.33002
8691,2012,Septiembre,Venezuela,144,156,,300,-77.35600000000001,0.81488
8692,2012,Septiembre,Venezuela,347,311,,658,-75.516486,10.446304
8693,2012,Septiembre,Venezuela,34,81,,115,-74.77647900000001,10.886686
8694,2012,Septiembre,Venezuela,0,4,,4,-74.232675,11.117206
8695,2012,Septiembre,Venezuela,1360,1693,,3053,-72.129595,11.360028999999999
8696,2012,Septiembre,Venezuela,1,0,,1,-72.919186,11.52863
8697,2012,Septiembre,Venezuela,27,16,,43,-81.70216500000001,12.5862
8698,2012,Septiembre,Venezuela,112,104,,216,-76.532004,3.451668
8699,2012,Septiembre,Venezuela,5947,6938,,12885,-74.140516,4.697157
8700,2012,Septiembre,Venezuela,0,7,,7,-75.736374,4.815189
8701,2012,Septiembre,Venezuela,310,366,,676,-75.42726,6.170465
8702,2012,Septiembre,Venezuela,2,3,,5,-67.48402800000001,6.185536
8703,2012,Septiembre,Venezuela,2,0,,2,-77.401154,6.222551999999999
8704,2012,Septiembre,Venezuela,28,47,,75,-70.74025300000001,7.088728999999999
8705,2012,Septiembre,Venezuela,9,7,,16,-73.181317,7.1280470000000005
8706,2012,Septiembre,Venezuela,1801,1765,,3566,-72.453013,7.819
8707,2012,Septiembre,Venezuela,402,444,,846,-72.508188,7.927233
8708,2012,Septiembre,Venezuela,0,2,,2,-76.7333,8.06667
8709,2012,Septiembre,Venezuela,0,1,,1,-77.35002,8.63337
9666,2012,Octubre,Venezuela,0,2,,2,-69.941498,4.191162
9667,2012,Octubre,Venezuela,0,1,,1,-76.876446,0.33002
9668,2012,Octubre,Venezuela,69,83,,152,-77.35600000000001,0.81488
9669,2012,Octubre,Venezuela,0,20,,20,-77.290564,13.97318
9670,2012,Octubre,Venezuela,0,1,,1,-75.527794,10.406342
9671,2012,Octubre,Venezuela,131,153,,284,-75.516486,10.446304
9672,2012,Octubre,Venezuela,35,75,,110,-74.77647900000001,10.886686
9673,2012,Octubre,Venezuela,2,7,,9,-74.232675,11.117206
9674,2012,Octubre,Venezuela,776,1425,,2201,-72.129595,11.360028999999999
9675,2012,Octubre,Venezuela,20,12,,32,-81.70216500000001,12.5862
9676,2012,Octubre,Venezuela,55,81,,136,-76.532004,3.451668
9677,2012,Octubre,Venezuela,1,3,,4,-75.76635300000001,4.45285
9678,2012,Octubre,Venezuela,5287,6649,,11936,-74.140516,4.697157
9679,2012,Octubre,Venezuela,1,12,,13,-75.736374,4.815189
9680,2012,Octubre,Venezuela,313,393,,706,-75.42726,6.170465
9681,2012,Octubre,Venezuela,51,89,,140,-67.48402800000001,6.185536
9682,2012,Octubre,Venezuela,49,101,,150,-70.74025300000001,7.088728999999999
9683,2012,Octubre,Venezuela,2,2,,4,-73.181317,7.1280470000000005
9684,2012,Octubre,Venezuela,1046,1305,,2351,-72.453013,7.819
9685,2012,Octubre,Venezuela,214,302,,516,-72.508188,7.927233
9686,2012,Octubre,Venezuela,0,1,,1,-77.35002,8.63337
10684,2012,Noviembre,Venezuela,2,4,,6,-69.941498,4.191162
10685,2012,Noviembre,Venezuela,0,2,,2,-76.876446,0.33002
10686,2012,Noviembre,Venezuela,36,64,,100,-77.35600000000001,0.81488
10687,2012,Noviembre,Venezuela,3,5,,8,-75.527794,10.406342
10688,2012,Noviembre,Venezuela,72,90,,162,-75.516486,10.446304
10689,2012,Noviembre,Venezuela,27,63,,90,-74.77647900000001,10.886686
10690,2012,Noviembre,Venezuela,0,5,,5,-74.232675,11.117206
10691,2012,Noviembre,Venezuela,0,2,,2,-74.213989,11.247722999999999
10692,2012,Noviembre,Venezuela,749,1391,,2140,-72.129595,11.360028999999999
10693,2012,Noviembre,Venezuela,0,1,,1,-72.919186,11.52863
10694,2012,Noviembre,Venezuela,16,10,,26,-81.70216500000001,12.5862
10695,2012,Noviembre,Venezuela,62,89,,151,-76.532004,3.451668
10696,2012,Noviembre,Venezuela,2,3,,5,-75.76635300000001,4.45285
10697,2012,Noviembre,Venezuela,5158,6676,,11834,-74.140516,4.697157
10698,2012,Noviembre,Venezuela,7,14,,21,-75.736374,4.815189
10699,2012,Noviembre,Venezuela,372,561,,933,-75.42726,6.170465
10700,2012,Noviembre,Venezuela,197,243,,440,-67.48402800000001,6.185536
10701,2012,Noviembre,Venezuela,40,79,,119,-70.74025300000001,7.088728999999999
10702,2012,Noviembre,Venezuela,11,13,,24,-73.181317,7.1280470000000005
10703,2012,Noviembre,Venezuela,1063,1339,,2402,-72.453013,7.819
10704,2012,Noviembre,Venezuela,179,200,,379,-72.508188,7.927233
10705,2012,Noviembre,Venezuela,1,1,,2,-77.35002,8.63337
11709,2012,Diciembre,Venezuela,0,1,,1,-69.941498,4.191162
11710,2012,Diciembre,Venezuela,0,2,,2,-76.876446,0.33002
11711,2012,Diciembre,Venezuela,66,95,,161,-77.35600000000001,0.81488
11712,2012,Diciembre,Venezuela,8,31,,39,-75.527794,10.406342
11713,2012,Diciembre,Venezuela,138,155,,293,-75.516486,10.446304
11714,2012,Diciembre,Venezuela,74,106,,180,-74.77647900000001,10.886686
11715,2012,Diciembre,Venezuela,3349,4331,,7680,-72.129595,11.360028999999999
11716,2012,Diciembre,Venezuela,2,3,,5,-72.919186,11.52863
11717,2012,Diciembre,Venezuela,10,9,,19,-81.70216500000001,12.5862
11718,2012,Diciembre,Venezuela,91,104,,195,-76.532004,3.451668
11719,2012,Diciembre,Venezuela,3,3,,6,-75.76635300000001,4.45285
11720,2012,Diciembre,Venezuela,6518,6896,,13414,-74.140516,4.697157
11721,2012,Diciembre,Venezuela,6,18,,24,-75.736374,4.815189
11722,2012,Diciembre,Venezuela,630,616,,1246,-75.42726,6.170465
11723,2012,Diciembre,Venezuela,174,236,,410,-67.48402800000001,6.185536
11724,2012,Diciembre,Venezuela,115,174,,289,-70.74025300000001,7.088728999999999
11725,2012,Diciembre,Venezuela,11,12,,23,-73.181317,7.1280470000000005
11726,2012,Diciembre,Venezuela,2675,3224,,5899,-72.453013,7.819
11727,2012,Diciembre,Venezuela,648,666,,1314,-72.508188,7.927233
12724,2013,Enero,Venezuela,218,230,,448,-77.35600000000001,0.81488
12725,2013,Enero,Venezuela,6,6,,12,-75.527794,10.406342
12726,2013,Enero,Venezuela,110,161,,271,-75.516486,10.446304
12727,2013,Enero,Venezuela,59,90,,149,-74.77647900000001,10.886686
12728,2013,Enero,Venezuela,1209,1878,,3087,-72.129595,11.360028999999999
12729,2013,Enero,Venezuela,1,1,,2,-72.919186,11.52863
12730,2013,Enero,Venezuela,8,2,,10,-81.70216500000001,12.5862
12731,2013,Enero,Venezuela,86,111,,197,-76.532004,3.451668
12732,2013,Enero,Venezuela,1,1,,2,-75.76635300000001,4.45285
12733,2013,Enero,Venezuela,5877,6570,,12447,-74.140516,4.697157
12734,2013,Enero,Venezuela,3,19,,22,-75.736374,4.815189
12735,2013,Enero,Venezuela,358,415,,773,-75.42726,6.170465
12736,2013,Enero,Venezuela,134,204,,338,-67.48402800000001,6.185536
12737,2013,Enero,Venezuela,57,104,,161,-70.74025300000001,7.088728999999999
12738,2013,Enero,Venezuela,4,3,,7,-73.181317,7.1280470000000005
12739,2013,Enero,Venezuela,1408,1586,,2994,-72.453013,7.819
12740,2013,Enero,Venezuela,238,262,,500,-72.508188,7.927233
12741,2013,Enero,Venezuela,1,2,,3,-77.35002,8.63337
13675,2013,Febrero,Venezuela,86,94,,180,-77.35600000000001,0.81488
13676,2013,Febrero,Venezuela,6,5,,11,-75.527794,10.406342
13677,2013,Febrero,Venezuela,97,175,,272,-75.516486,10.446304
13678,2013,Febrero,Venezuela,128,148,,276,-74.77647900000001,10.886686
13679,2013,Febrero,Venezuela,1,0,,1,-74.213989,11.247722999999999
13680,2013,Febrero,Venezuela,1714,2157,,3871,-72.129595,11.360028999999999
13681,2013,Febrero,Venezuela,1,3,,4,-72.919186,11.52863
13682,2013,Febrero,Venezuela,18,10,,28,-81.70216500000001,12.5862
13683,2013,Febrero,Venezuela,58,74,,132,-76.532004,3.451668
13684,2013,Febrero,Venezuela,1,3,,4,-75.76635300000001,4.45285
13685,2013,Febrero,Venezuela,6493,7160,,13653,-74.140516,4.697157
13686,2013,Febrero,Venezuela,6,25,,31,-75.736374,4.815189
13687,2013,Febrero,Venezuela,417,477,,894,-75.42726,6.170465
13688,2013,Febrero,Venezuela,214,333,,547,-67.48402800000001,6.185536
13689,2013,Febrero,Venezuela,45,72,,117,-70.74025300000001,7.088728999999999
13690,2013,Febrero,Venezuela,15,10,,25,-73.181317,7.1280470000000005
13691,2013,Febrero,Venezuela,1629,1570,,3199,-72.453013,7.819
13692,2013,Febrero,Venezuela,353,330,,683,-72.508188,7.927233
14655,2013,Marzo,Venezuela,0,2,,2,-69.941498,4.191162
14656,2013,Marzo,Venezuela,68,95,,163,-77.35600000000001,0.81488
14657,2013,Marzo,Venezuela,4,10,,14,-75.527794,10.406342
14658,2013,Marzo,Venezuela,104,139,,243,-75.516486,10.446304
14659,2013,Marzo,Venezuela,39,63,,102,-74.77647900000001,10.886686
14660,2013,Marzo,Venezuela,1443,1824,,3267,-72.129595,11.360028999999999
14661,2013,Marzo,Venezuela,2,1,,3,-72.919186,11.52863
14662,2013,Marzo,Venezuela,2,2,,4,-81.70216500000001,12.5862
14663,2013,Marzo,Venezuela,44,74,,118,-76.532004,3.451668
14664,2013,Marzo,Venezuela,0,2,,2,-75.76635300000001,4.45285
14665,2013,Marzo,Venezuela,5349,6141,,11490,-74.140516,4.697157
14666,2013,Marzo,Venezuela,6,11,,17,-75.736374,4.815189
14667,2013,Marzo,Venezuela,348,378,,726,-75.42726,6.170465
14668,2013,Marzo,Venezuela,151,260,,411,-67.48402800000001,6.185536
14669,2013,Marzo,Venezuela,66,117,,183,-70.74025300000001,7.088728999999999
14670,2013,Marzo,Venezuela,3,4,,7,-73.181317,7.1280470000000005
14671,2013,Marzo,Venezuela,1257,1516,,2773,-72.453013,7.819
14672,2013,Marzo,Venezuela,195,208,,403,-72.508188,7.927233
15613,2013,Abril,Venezuela,1,3,,4,-76.876446,0.33002
15614,2013,Abril,Venezuela,41,71,,112,-77.35600000000001,0.81488
15615,2013,Abril,Venezuela,2,3,,5,-75.527794,10.406342
15616,2013,Abril,Venezuela,5,24,,29,-73.247863,10.433608999999999
15617,2013,Abril,Venezuela,84,112,,196,-75.516486,10.446304
15618,2013,Abril,Venezuela,33,57,,90,-74.77647900000001,10.886686
15619,2013,Abril,Venezuela,947,1321,,2268,-72.129595,11.360028999999999
15620,2013,Abril,Venezuela,2,2,,4,-72.919186,11.52863
15621,2013,Abril,Venezuela,8,7,,15,-81.70216500000001,12.5862
15622,2013,Abril,Venezuela,52,79,,131,-76.532004,3.451668
15623,2013,Abril,Venezuela,4657,6221,,10878,-74.140516,4.697157
15624,2013,Abril,Venezuela,3,19,,22,-75.736374,4.815189
15625,2013,Abril,Venezuela,237,342,,579,-75.42726,6.170465
15626,2013,Abril,Venezuela,120,225,,345,-67.48402800000001,6.185536
15627,2013,Abril,Venezuela,27,60,,87,-70.74025300000001,7.088728999999999
15628,2013,Abril,Venezuela,5,5,,10,-73.181317,7.1280470000000005
15629,2013,Abril,Venezuela,788,1014,,1802,-72.453013,7.819
15630,2013,Abril,Venezuela,119,132,,251,-72.508188,7.927233
15631,2013,Abril,Venezuela,0,1,,1,-77.35002,8.63337
16551,2013,Mayo,Venezuela,1,1,,2,-69.941498,4.191162
16552,2013,Mayo,Venezuela,0,1,,1,-76.876446,0.33002
16553,2013,Mayo,Venezuela,40,57,,97,-77.35600000000001,0.81488
16554,2013,Mayo,Venezuela,0,1,,1,-75.527794,10.406342
16555,2013,Mayo,Venezuela,117,178,,295,-75.516486,10.446304
16556,2013,Mayo,Venezuela,42,82,,124,-74.77647900000001,10.886686
16557,2013,Mayo,Venezuela,0,1,,1,-74.765343,10.970933
16558,2013,Mayo,Venezuela,0,1,,1,-74.213989,11.247722999999999
16559,2013,Mayo,Venezuela,909,1365,,2274,-72.129595,11.360028999999999
16560,2013,Mayo,Venezuela,1,1,,2,-72.919186,11.52863
16561,2013,Mayo,Venezuela,4,4,,8,-81.70216500000001,12.5862
16562,2013,Mayo,Venezuela,46,102,,148,-76.532004,3.451668
16563,2013,Mayo,Venezuela,1,0,,1,-75.76635300000001,4.45285
16564,2013,Mayo,Venezuela,4629,6187,,10816,-74.140516,4.697157
16565,2013,Mayo,Venezuela,2,11,,13,-75.736374,4.815189
16566,2013,Mayo,Venezuela,267,440,,707,-75.42726,6.170465
16567,2013,Mayo,Venezuela,78,176,,254,-67.48402800000001,6.185536
16568,2013,Mayo,Venezuela,52,67,,119,-70.74025300000001,7.088728999999999
16569,2013,Mayo,Venezuela,4,3,,7,-73.181317,7.1280470000000005
16570,2013,Mayo,Venezuela,905,1117,,2022,-72.453013,7.819
16571,2013,Mayo,Venezuela,100,151,,251,-72.508188,7.927233
17541,2013,Junio,Venezuela,0,2,,2,-69.941498,4.191162
17542,2013,Junio,Venezuela,0,1,,1,-76.876446,0.33002
17543,2013,Junio,Venezuela,44,57,,101,-77.35600000000001,0.81488
17544,2013,Junio,Venezuela,4,41,,45,-75.527794,10.406342
17545,2013,Junio,Venezuela,75,116,,191,-75.516486,10.446304
17546,2013,Junio,Venezuela,31,76,,107,-74.77647900000001,10.886686
17547,2013,Junio,Venezuela,0,1,,1,-74.213989,11.247722999999999
17548,2013,Junio,Venezuela,994,1553,,2547,-72.129595,11.360028999999999
17549,2013,Junio,Venezuela,0,1,,1,-72.919186,11.52863
17550,2013,Junio,Venezuela,7,7,,14,-81.70216500000001,12.5862
17551,2013,Junio,Venezuela,84,95,,179,-76.532004,3.451668
17552,2013,Junio,Venezuela,4884,6240,,11124,-74.140516,4.697157
17553,2013,Junio,Venezuela,1,7,,8,-75.736374,4.815189
17554,2013,Junio,Venezuela,332,457,,789,-75.42726,6.170465
17555,2013,Junio,Venezuela,132,198,,330,-67.48402800000001,6.185536
17556,2013,Junio,Venezuela,76,149,,225,-70.74025300000001,7.088728999999999
17557,2013,Junio,Venezuela,5,0,,5,-73.181317,7.1280470000000005
17558,2013,Junio,Venezuela,991,1247,,2238,-72.453013,7.819
17559,2013,Junio,Venezuela,116,131,,247,-72.508188,7.927233
18566,2013,Julio,Venezuela,0,1,,1,-76.876446,0.33002
18567,2013,Julio,Venezuela,69,115,,184,-77.35600000000001,0.81488
18568,2013,Julio,Venezuela,6,9,,15,-75.527794,10.406342
18569,2013,Julio,Venezuela,88,168,,256,-75.516486,10.446304
18570,2013,Julio,Venezuela,45,128,,173,-74.77647900000001,10.886686
18571,2013,Julio,Venezuela,0,2,,2,-74.213989,11.247722999999999
18572,2013,Julio,Venezuela,1367,1949,,3316,-72.129595,11.360028999999999
18573,2013,Julio,Venezuela,1,0,,1,-72.919186,11.52863
18574,2013,Julio,Venezuela,7,6,,13,-81.70216500000001,12.5862
18575,2013,Julio,Venezuela,88,177,,265,-76.532004,3.451668
18576,2013,Julio,Venezuela,5972,6774,,12746,-74.140516,4.697157
18577,2013,Julio,Venezuela,4,11,,15,-75.736374,4.815189
18578,2013,Julio,Venezuela,476,614,,1090,-75.42726,6.170465
18579,2013,Julio,Venezuela,151,259,,410,-67.48402800000001,6.185536
18580,2013,Julio,Venezuela,31,53,,84,-70.74025300000001,7.088728999999999
18581,2013,Julio,Venezuela,7,9,,16,-73.181317,7.1280470000000005
18582,2013,Julio,Venezuela,1625,1944,,3569,-72.453013,7.819
18583,2013,Julio,Venezuela,195,278,,473,-72.508188,7.927233
18584,2013,Julio,Venezuela,0,2,,2,-77.35002,8.63337
19550,2013,Agosto,Venezuela,0,1,,1,-69.941498,4.191162
19551,2013,Agosto,Venezuela,2,0,,2,-76.876446,0.33002
19552,2013,Agosto,Venezuela,44,77,,121,-77.35600000000001,0.81488
19553,2013,Agosto,Venezuela,21,30,,51,-75.527794,10.406342
19554,2013,Agosto,Venezuela,79,113,,192,-75.516486,10.446304
19555,2013,Agosto,Venezuela,38,109,,147,-74.77647900000001,10.886686
19556,2013,Agosto,Venezuela,2147,2313,,4460,-72.129595,11.360028999999999
19557,2013,Agosto,Venezuela,0,1,,1,-72.919186,11.52863
19558,2013,Agosto,Venezuela,6,5,,11,-81.70216500000001,12.5862
19559,2013,Agosto,Venezuela,71,100,,171,-76.532004,3.451668
19560,2013,Agosto,Venezuela,6306,6796,,13102,-74.140516,4.697157
19561,2013,Agosto,Venezuela,2,9,,11,-75.736374,4.815189
19562,2013,Agosto,Venezuela,481,589,,1070,-75.42726,6.170465
19563,2013,Agosto,Venezuela,23,49,,72,-67.48402800000001,6.185536
19564,2013,Agosto,Venezuela,122,164,,286,-70.74025300000001,7.088728999999999
19565,2013,Agosto,Venezuela,6,3,,9,-73.181317,7.1280470000000005
19566,2013,Agosto,Venezuela,1945,2330,,4275,-72.453013,7.819
19567,2013,Agosto,Venezuela,252,316,,568,-72.508188,7.927233
20522,2013,Septiembre,Venezuela,0,2,,2,-69.941498,4.191162
20523,2013,Septiembre,Venezuela,193,234,,427,-77.35600000000001,0.81488
20524,2013,Septiembre,Venezuela,6,9,,15,-75.527794,10.406342
20525,2013,Septiembre,Venezuela,81,140,,221,-75.516486,10.446304
20526,2013,Septiembre,Venezuela,32,100,,132,-74.77647900000001,10.886686
20527,2013,Septiembre,Venezuela,6,5,,11,-74.765343,10.970933
20528,2013,Septiembre,Venezuela,1130,1867,,2997,-72.129595,11.360028999999999
20529,2013,Septiembre,Venezuela,2,4,,6,-72.919186,11.52863
20530,2013,Septiembre,Venezuela,4,2,,6,-81.70216500000001,12.5862
20531,2013,Septiembre,Venezuela,47,70,,117,-76.532004,3.451668
20532,2013,Septiembre,Venezuela,0,2,,2,-75.76635300000001,4.45285
20533,2013,Septiembre,Venezuela,5626,6289,,11915,-74.140516,4.697157
20534,2013,Septiembre,Venezuela,3,15,,18,-75.736374,4.815189
20535,2013,Septiembre,Venezuela,347,463,,810,-75.42726,6.170465
20536,2013,Septiembre,Venezuela,10,49,,59,-67.48402800000001,6.185536
20537,2013,Septiembre,Venezuela,25,48,,73,-70.74025300000001,7.088728999999999
20538,2013,Septiembre,Venezuela,10,11,,21,-73.181317,7.1280470000000005
20539,2013,Septiembre,Venezuela,1235,1549,,2784,-72.453013,7.819
20540,2013,Septiembre,Venezuela,199,269,,468,-72.508188,7.927233
21517,2013,Octubre,Venezuela,0,2,,2,-69.941498,4.191162
21518,2013,Octubre,Venezuela,1,3,,4,-76.876446,0.33002
21519,2013,Octubre,Venezuela,214,252,,466,-77.35600000000001,0.81488
21520,2013,Octubre,Venezuela,7,26,,33,-75.527794,10.406342
21521,2013,Octubre,Venezuela,59,122,,181,-75.516486,10.446304
21522,2013,Octubre,Venezuela,33,86,,119,-74.77647900000001,10.886686
21523,2013,Octubre,Venezuela,0,1,,1,-74.765343,10.970933
21524,2013,Octubre,Venezuela,1208,1953,,3161,-72.129595,11.360028999999999
21525,2013,Octubre,Venezuela,0,2,,2,-72.919186,11.52863
21526,2013,Octubre,Venezuela,2,5,,7,-81.70216500000001,12.5862
21527,2013,Octubre,Venezuela,67,87,,154,-76.532004,3.451668
21528,2013,Octubre,Venezuela,0,1,,1,-75.76635300000001,4.45285
21529,2013,Octubre,Venezuela,5535,6683,,12218,-74.140516,4.697157
21530,2013,Octubre,Venezuela,1,10,,11,-75.736374,4.815189
21531,2013,Octubre,Venezuela,583,579,,1162,-75.42726,6.170465
21532,2013,Octubre,Venezuela,17,81,,98,-67.48402800000001,6.185536
21533,2013,Octubre,Venezuela,119,159,,278,-70.74025300000001,7.088728999999999
21534,2013,Octubre,Venezuela,2,7,,9,-73.181317,7.1280470000000005
21535,2013,Octubre,Venezuela,1749,2071,,3820,-72.453013,7.819
21536,2013,Octubre,Venezuela,248,326,,574,-72.508188,7.927233
22499,2013,Noviembre,Venezuela,2,0,,2,-69.941498,4.191162
22500,2013,Noviembre,Venezuela,172,241,,413,-77.35600000000001,0.81488
22501,2013,Noviembre,Venezuela,9,34,,43,-75.527794,10.406342
22502,2013,Noviembre,Venezuela,80,133,,213,-75.516486,10.446304
22503,2013,Noviembre,Venezuela,37,91,,128,-74.77647900000001,10.886686
22504,2013,Noviembre,Venezuela,0,1,,1,-74.765343,10.970933
22505,2013,Noviembre,Venezuela,1016,1966,,2982,-72.129595,11.360028999999999
22506,2013,Noviembre,Venezuela,2,3,,5,-72.919186,11.52863
22507,2013,Noviembre,Venezuela,0,1,,1,-81.703935,12.574411099999999
22508,2013,Noviembre,Venezuela,4,3,,7,-81.70216500000001,12.5862
22509,2013,Noviembre,Venezuela,77,133,,210,-76.532004,3.451668
22510,2013,Noviembre,Venezuela,0,1,,1,-75.76635300000001,4.45285
22511,2013,Noviembre,Venezuela,5512,6300,,11812,-74.140516,4.697157
22512,2013,Noviembre,Venezuela,2,10,,12,-75.736374,4.815189
22513,2013,Noviembre,Venezuela,795,783,,1578,-75.42726,6.170465
22514,2013,Noviembre,Venezuela,136,189,,325,-67.48402800000001,6.185536
22515,2013,Noviembre,Venezuela,69,132,,201,-70.74025300000001,7.088728999999999
22516,2013,Noviembre,Venezuela,2,10,,12,-73.181317,7.1280470000000005
22517,2013,Noviembre,Venezuela,1678,2290,,3968,-72.453013,7.819
22518,2013,Noviembre,Venezuela,388,536,,924,-72.508188,7.927233
22519,2013,Noviembre,Venezuela,0,1,,1,-77.35002,8.63337
23526,2013,Diciembre,Venezuela,0,1,,1,-76.876446,0.33002
23527,2013,Diciembre,Venezuela,149,218,,367,-77.35600000000001,0.81488
23528,2013,Diciembre,Venezuela,13,30,,43,-75.527794,10.406342
23529,2013,Diciembre,Venezuela,139,168,,307,-75.516486,10.446304
23530,2013,Diciembre,Venezuela,67,115,,182,-74.77647900000001,10.886686
23531,2013,Diciembre,Venezuela,2996,4237,,7233,-72.129595,11.360028999999999
23532,2013,Diciembre,Venezuela,7,6,,13,-72.919186,11.52863
23533,2013,Diciembre,Venezuela,4,4,,8,-81.70216500000001,12.5862
23534,2013,Diciembre,Venezuela,118,130,,248,-76.532004,3.451668
23535,2013,Diciembre,Venezuela,0,1,,1,-77.061029,3.8844260000000004
23536,2013,Diciembre,Venezuela,0,3,,3,-75.76635300000001,4.45285
23537,2013,Diciembre,Venezuela,6548,7145,,13693,-74.140516,4.697157
23538,2013,Diciembre,Venezuela,12,13,,25,-75.736374,4.815189
23539,2013,Diciembre,Venezuela,834,784,,1618,-75.42726,6.170465
23540,2013,Diciembre,Venezuela,48,105,,153,-67.48402800000001,6.185536
23541,2013,Diciembre,Venezuela,165,271,,436,-70.74025300000001,7.088728999999999
23542,2013,Diciembre,Venezuela,8,11,,19,-73.181317,7.1280470000000005
23543,2013,Diciembre,Venezuela,2803,3371,,6174,-72.453013,7.819
23544,2013,Diciembre,Venezuela,454,552,,1006,-72.508188,7.927233
23545,2013,Diciembre,Venezuela,0,1,,1,-77.35002,8.63337
24000,2014,Enero,Venezuela,2,11,,13,-75.527794,10.406342
24001,2014,Enero,Venezuela,22,48,,70,-75.516486,10.446304
24002,2014,Enero,Venezuela,29,67,,96,-74.77647900000001,10.886686
24003,2014,Enero,Venezuela,0,3,,3,-74.232675,11.117206
24004,2014,Enero,Venezuela,1689,2919,,4608,-72.129595,11.360028999999999
24005,2014,Enero,Venezuela,40,48,,88,-76.532004,3.451668
24006,2014,Enero,Venezuela,4501,5321,,9822,-74.140516,4.697157
24007,2014,Enero,Venezuela,3,18,,21,-75.736374,4.815189
24008,2014,Enero,Venezuela,365,440,,805,-75.42726,6.170465
24009,2014,Enero,Venezuela,45,75,,120,-67.48402800000001,6.185536
24010,2014,Enero,Venezuela,79,183,,262,-70.74025300000001,7.088728999999999
24011,2014,Enero,Venezuela,0,2,,2,-73.181317,7.1280470000000005
24012,2014,Enero,Venezuela,2849,3141,,5990,-72.453013,7.819
24013,2014,Enero,Venezuela,140,181,,321,-72.508188,7.927233
24452,2014,Febrero,Venezuela,0,19,,19,-75.527794,10.406342
24453,2014,Febrero,Venezuela,9,44,,53,-75.516486,10.446304
24454,2014,Febrero,Venezuela,44,76,,120,-74.77647900000001,10.886686
24455,2014,Febrero,Venezuela,1646,2334,,3980,-72.129595,11.360028999999999
24456,2014,Febrero,Venezuela,11,19,,30,-76.532004,3.451668
24457,2014,Febrero,Venezuela,3035,4130,,7165,-74.140516,4.697157
24458,2014,Febrero,Venezuela,3,3,,6,-75.736374,4.815189
24459,2014,Febrero,Venezuela,193,268,,461,-75.42726,6.170465
24460,2014,Febrero,Venezuela,43,90,,133,-67.48402800000001,6.185536
24461,2014,Febrero,Venezuela,55,84,,139,-70.74025300000001,7.088728999999999
24462,2014,Febrero,Venezuela,1,4,,5,-73.181317,7.1280470000000005
24463,2014,Febrero,Venezuela,1558,2162,,3720,-72.453013,7.819
24464,2014,Febrero,Venezuela,89,132,,221,-72.508188,7.927233
24884,2014,Marzo,Venezuela,0,2,,2,-75.527794,10.406342
24885,2014,Marzo,Venezuela,31,75,,106,-75.516486,10.446304
24886,2014,Marzo,Venezuela,22,61,,83,-74.77647900000001,10.886686
24887,2014,Marzo,Venezuela,0,1,,1,-74.213989,11.247722999999999
24888,2014,Marzo,Venezuela,1061,1865,,2926,-72.129595,11.360028999999999
24889,2014,Marzo,Venezuela,2,7,,9,-81.70216500000001,12.5862
24890,2014,Marzo,Venezuela,13,27,,40,-76.532004,3.451668
24891,2014,Marzo,Venezuela,2743,3709,,6452,-74.140516,4.697157
24892,2014,Marzo,Venezuela,4,3,,7,-75.736374,4.815189
24893,2014,Marzo,Venezuela,135,214,,349,-75.42726,6.170465
24894,2014,Marzo,Venezuela,69,135,,204,-67.48402800000001,6.185536
24895,2014,Marzo,Venezuela,85,164,,249,-70.74025300000001,7.088728999999999
24896,2014,Marzo,Venezuela,5,7,,12,-73.181317,7.1280470000000005
24897,2014,Marzo,Venezuela,1159,1827,,2986,-72.453013,7.819
24898,2014,Marzo,Venezuela,64,79,,143,-72.508188,7.927233
25367,2014,Abril,Venezuela,0,9,,9,-75.527794,10.406342
25368,2014,Abril,Venezuela,14,58,,72,-75.516486,10.446304
25369,2014,Abril,Venezuela,18,73,,91,-74.77647900000001,10.886686
25370,2014,Abril,Venezuela,0,2,,2,-74.765343,10.970933
25371,2014,Abril,Venezuela,0,2,,2,-74.213989,11.247722999999999
25372,2014,Abril,Venezuela,1885,2916,,4801,-72.129595,11.360028999999999
25373,2014,Abril,Venezuela,4,5,,9,-81.70216500000001,12.5862
25374,2014,Abril,Venezuela,9,18,,27,-76.532004,3.451668
25375,2014,Abril,Venezuela,3862,4057,,7919,-74.140516,4.697157
25376,2014,Abril,Venezuela,5,8,,13,-75.736374,4.815189
25377,2014,Abril,Venezuela,260,317,,577,-75.42726,6.170465
25378,2014,Abril,Venezuela,21,34,,55,-67.48402800000001,6.185536
25379,2014,Abril,Venezuela,65,124,,189,-70.74025300000001,7.088728999999999
25380,2014,Abril,Venezuela,4,13,,17,-73.181317,7.1280470000000005
25381,2014,Abril,Venezuela,1845,2486,,4331,-72.453013,7.819
25382,2014,Abril,Venezuela,119,134,,253,-72.508188,7.927233
25803,2014,Mayo,Venezuela,0,17,,17,-75.527794,10.406342
25804,2014,Mayo,Venezuela,4,6,,10,-73.247863,10.433608999999999
25805,2014,Mayo,Venezuela,11,32,,43,-75.516486,10.446304
25806,2014,Mayo,Venezuela,14,48,,62,-74.77647900000001,10.886686
25807,2014,Mayo,Venezuela,0,1,,1,-74.765343,10.970933
25808,2014,Mayo,Venezuela,0,1,,1,-74.213989,11.247722999999999
25809,2014,Mayo,Venezuela,1033,1669,,2702,-72.129595,11.360028999999999
25810,2014,Mayo,Venezuela,1,0,,1,-81.70216500000001,12.5862
25811,2014,Mayo,Venezuela,19,42,,61,-76.532004,3.451668
25812,2014,Mayo,Venezuela,3038,4216,,7254,-74.140516,4.697157
25813,2014,Mayo,Venezuela,4,10,,14,-75.736374,4.815189
25814,2014,Mayo,Venezuela,246,445,,691,-75.42726,6.170465
25815,2014,Mayo,Venezuela,15,29,,44,-67.48402800000001,6.185536
25816,2014,Mayo,Venezuela,27,35,,62,-70.74025300000001,7.088728999999999
25817,2014,Mayo,Venezuela,0,2,,2,-73.181317,7.1280470000000005
25818,2014,Mayo,Venezuela,1303,1879,,3182,-72.453013,7.819
25819,2014,Mayo,Venezuela,104,120,,224,-72.508188,7.927233
26247,2014,Junio,Venezuela,0,18,,18,-75.527794,10.406342
26248,2014,Junio,Venezuela,4,10,,14,-75.516486,10.446304
26249,2014,Junio,Venezuela,20,56,,76,-74.77647900000001,10.886686
26250,2014,Junio,Venezuela,0,2,,2,-74.765343,10.970933
26251,2014,Junio,Venezuela,1,2,,3,-74.232675,11.117206
26252,2014,Junio,Venezuela,1189,1867,,3056,-72.129595,11.360028999999999
26253,2014,Junio,Venezuela,9,18,,27,-76.532004,3.451668
26254,2014,Junio,Venezuela,4483,5441,,9924,-74.140516,4.697157
26255,2014,Junio,Venezuela,1,1,,2,-75.736374,4.815189
26256,2014,Junio,Venezuela,64,104,,168,-75.42726,6.170465
26257,2014,Junio,Venezuela,35,51,,86,-67.48402800000001,6.185536
26258,2014,Junio,Venezuela,82,169,,251,-70.74025300000001,7.088728999999999
26259,2014,Junio,Venezuela,4,12,,16,-73.181317,7.1280470000000005
26260,2014,Junio,Venezuela,1494,2076,,3570,-72.453013,7.819
26261,2014,Junio,Venezuela,156,172,,328,-72.508188,7.927233
26733,2014,Julio,Venezuela,0,44,,44,-75.527794,10.406342
26734,2014,Julio,Venezuela,23,105,,128,-75.516486,10.446304
26735,2014,Julio,Venezuela,15,50,,65,-74.77647900000001,10.886686
26736,2014,Julio,Venezuela,0,12,,12,-74.232675,11.117206
26737,2014,Julio,Venezuela,0,2,,2,-74.213989,11.247722999999999
26738,2014,Julio,Venezuela,1692,2297,,3989,-72.129595,11.360028999999999
26739,2014,Julio,Venezuela,3,22,,25,-76.532004,3.451668
26740,2014,Julio,Venezuela,4963,5311,,10274,-74.140516,4.697157
26741,2014,Julio,Venezuela,0,1,,1,-75.736374,4.815189
26742,2014,Julio,Venezuela,94,157,,251,-75.42726,6.170465
26743,2014,Julio,Venezuela,13,23,,36,-67.48402800000001,6.185536
26744,2014,Julio,Venezuela,55,88,,143,-70.74025300000001,7.088728999999999
26745,2014,Julio,Venezuela,2817,3509,,6326,-72.453013,7.819
26746,2014,Julio,Venezuela,274,278,,552,-72.508188,7.927233
27209,2014,Agosto,Venezuela,1,19,,20,-75.527794,10.406342
27210,2014,Agosto,Venezuela,18,83,,101,-75.516486,10.446304
27211,2014,Agosto,Venezuela,10,43,,53,-74.77647900000001,10.886686
27212,2014,Agosto,Venezuela,3,5,,8,-74.232675,11.117206
27213,2014,Agosto,Venezuela,2767,3257,,6024,-72.129595,11.360028999999999
27214,2014,Agosto,Venezuela,1,3,,4,-81.70216500000001,12.5862
27215,2014,Agosto,Venezuela,1,6,,7,-76.532004,3.451668
27216,2014,Agosto,Venezuela,4499,4398,,8897,-74.140516,4.697157
27217,2014,Agosto,Venezuela,2,2,,4,-75.736374,4.815189
27218,2014,Agosto,Venezuela,84,184,,268,-75.42726,6.170465
27219,2014,Agosto,Venezuela,32,207,,239,-67.48402800000001,6.185536
27220,2014,Agosto,Venezuela,177,289,,466,-70.74025300000001,7.088728999999999
27221,2014,Agosto,Venezuela,16,19,,35,-73.181317,7.1280470000000005
27222,2014,Agosto,Venezuela,4781,5584,,10365,-72.453013,7.819
27223,2014,Agosto,Venezuela,586,722,,1308,-72.508188,7.927233
27665,2014,Septiembre,Venezuela,0,3,,3,-75.527794,10.406342
27666,2014,Septiembre,Venezuela,9,42,,51,-75.516486,10.446304
27667,2014,Septiembre,Venezuela,5,73,,78,-74.77647900000001,10.886686
27668,2014,Septiembre,Venezuela,0,1,,1,-74.213989,11.247722999999999
27669,2014,Septiembre,Venezuela,1527,2192,,3719,-72.129595,11.360028999999999
27670,2014,Septiembre,Venezuela,2,3,,5,-81.70216500000001,12.5862
27671,2014,Septiembre,Venezuela,14,17,,31,-76.532004,3.451668
27672,2014,Septiembre,Venezuela,3421,3870,,7291,-74.140516,4.697157
27673,2014,Septiembre,Venezuela,1,1,,2,-75.736374,4.815189
27674,2014,Septiembre,Venezuela,29,75,,104,-75.42726,6.170465
27675,2014,Septiembre,Venezuela,22,40,,62,-67.48402800000001,6.185536
27676,2014,Septiembre,Venezuela,69,85,,154,-70.74025300000001,7.088728999999999
27677,2014,Septiembre,Venezuela,3,2,,5,-73.181317,7.1280470000000005
27678,2014,Septiembre,Venezuela,3120,4014,,7134,-72.453013,7.819
27679,2014,Septiembre,Venezuela,393,399,,792,-72.508188,7.927233
28147,2014,Octubre,Venezuela,0,11,,11,-75.527794,10.406342
28148,2014,Octubre,Venezuela,7,35,,42,-75.516486,10.446304
28149,2014,Octubre,Venezuela,19,74,,93,-74.77647900000001,10.886686
28150,2014,Octubre,Venezuela,0,3,,3,-74.765343,10.970933
28151,2014,Octubre,Venezuela,1236,2044,,3280,-72.129595,11.360028999999999
28152,2014,Octubre,Venezuela,18,38,,56,-76.532004,3.451668
28153,2014,Octubre,Venezuela,3765,4607,,8372,-74.140516,4.697157
28154,2014,Octubre,Venezuela,0,2,,2,-75.736374,4.815189
28155,2014,Octubre,Venezuela,68,92,,160,-75.42726,6.170465
28156,2014,Octubre,Venezuela,224,423,,647,-67.48402800000001,6.185536
28157,2014,Octubre,Venezuela,108,155,,263,-70.74025300000001,7.088728999999999
28158,2014,Octubre,Venezuela,0,3,,3,-73.181317,7.1280470000000005
28159,2014,Octubre,Venezuela,2798,3919,,6717,-72.453013,7.819
28160,2014,Octubre,Venezuela,282,386,,668,-72.508188,7.927233
28161,2014,Octubre,Venezuela,0,2,,2,-75.68164200000001,9.402597
28630,2014,Noviembre,Venezuela,0,12,,12,-75.527794,10.406342
28631,2014,Noviembre,Venezuela,19,78,,97,-75.516486,10.446304
28632,2014,Noviembre,Venezuela,10,55,,65,-74.77647900000001,10.886686
28633,2014,Noviembre,Venezuela,0,1,,1,-74.765343,10.970933
28634,2014,Noviembre,Venezuela,1185,1999,,3184,-72.129595,11.360028999999999
28635,2014,Noviembre,Venezuela,0,2,,2,-81.70216500000001,12.5862
28636,2014,Noviembre,Venezuela,12,33,,45,-76.532004,3.451668
28637,2014,Noviembre,Venezuela,3854,4413,,8267,-74.140516,4.697157
28638,2014,Noviembre,Venezuela,1,3,,4,-75.736374,4.815189
28639,2014,Noviembre,Venezuela,37,115,,152,-75.42726,6.170465
28640,2014,Noviembre,Venezuela,383,611,,994,-67.48402800000001,6.185536
28641,2014,Noviembre,Venezuela,83,143,,226,-70.74025300000001,7.088728999999999
28642,2014,Noviembre,Venezuela,2893,3899,,6792,-72.453013,7.819
28643,2014,Noviembre,Venezuela,241,327,,568,-72.508188,7.927233
29162,2014,Diciembre,Venezuela,8,22,,30,-75.516486,10.446304
29163,2014,Diciembre,Venezuela,15,56,,71,-74.77647900000001,10.886686
29164,2014,Diciembre,Venezuela,0,3,,3,-74.765343,10.970933
29165,2014,Diciembre,Venezuela,0,6,,6,-74.232675,11.117206
29166,2014,Diciembre,Venezuela,3505,4402,,7907,-72.129595,11.360028999999999
29167,2014,Diciembre,Venezuela,4,1,,5,-81.70216500000001,12.5862
29168,2014,Diciembre,Venezuela,10,16,,26,-76.532004,3.451668
29169,2014,Diciembre,Venezuela,7,7,,14,-67.927521,3.866713
29170,2014,Diciembre,Venezuela,4523,4553,,9076,-74.140516,4.697157
29171,2014,Diciembre,Venezuela,0,1,,1,-75.736374,4.815189
29172,2014,Diciembre,Venezuela,64,74,,138,-75.42726,6.170465
29173,2014,Diciembre,Venezuela,404,650,,1054,-67.48402800000001,6.185536
29174,2014,Diciembre,Venezuela,206,311,,517,-70.74025300000001,7.088728999999999
29175,2014,Diciembre,Venezuela,3,13,,16,-73.181317,7.1280470000000005
29176,2014,Diciembre,Venezuela,6268,7293,,13561,-72.453013,7.819
29177,2014,Diciembre,Venezuela,669,627,,1296,-72.508188,7.927233
29654,2015,Enero,Venezuela,0,19,,19,-75.527794,10.406342
29655,2015,Enero,Venezuela,5,19,,24,-75.516486,10.446304
29656,2015,Enero,Venezuela,9,45,,54,-74.77647900000001,10.886686
29657,2015,Enero,Venezuela,0,4,,4,-74.765343,10.970933
29658,2015,Enero,Venezuela,1843,2794,,4637,-72.129595,11.360028999999999
29659,2015,Enero,Venezuela,9,34,,43,-76.532004,3.451668
29660,2015,Enero,Venezuela,8,8,,16,-67.927521,3.866713
29661,2015,Enero,Venezuela,3405,3945,,7350,-74.140516,4.697157
29662,2015,Enero,Venezuela,8,4,,12,-75.736374,4.815189
29663,2015,Enero,Venezuela,45,87,,132,-75.42726,6.170465
29664,2015,Enero,Venezuela,384,571,,955,-67.48402800000001,6.185536
29665,2015,Enero,Venezuela,93,189,,282,-70.74025300000001,7.088728999999999
29666,2015,Enero,Venezuela,2,3,,5,-73.181317,7.1280470000000005
29667,2015,Enero,Venezuela,3709,4861,,8570,-72.453013,7.819
29668,2015,Enero,Venezuela,296,286,,582,-72.508188,7.927233
30114,2015,Febrero,Venezuela,0,22,,22,-75.527794,10.406342
30115,2015,Febrero,Venezuela,20,32,,52,-75.516486,10.446304
30116,2015,Febrero,Venezuela,13,71,,84,-74.77647900000001,10.886686
30117,2015,Febrero,Venezuela,0,4,,4,-74.765343,10.970933
30118,2015,Febrero,Venezuela,2256,3048,,5304,-72.129595,11.360028999999999
30119,2015,Febrero,Venezuela,9,22,,31,-76.532004,3.451668
30120,2015,Febrero,Venezuela,5,22,,27,-67.927521,3.866713
30121,2015,Febrero,Venezuela,2942,3699,,6641,-74.140516,4.697157
30122,2015,Febrero,Venezuela,0,1,,1,-75.736374,4.815189
30123,2015,Febrero,Venezuela,26,67,,93,-75.42726,6.170465
30124,2015,Febrero,Venezuela,305,511,,816,-67.48402800000001,6.185536
30125,2015,Febrero,Venezuela,70,118,,188,-70.74025300000001,7.088728999999999
30126,2015,Febrero,Venezuela,1,5,,6,-73.181317,7.1280470000000005
30127,2015,Febrero,Venezuela,2825,3574,,6399,-72.453013,7.819
30128,2015,Febrero,Venezuela,252,282,,534,-72.508188,7.927233
30589,2015,Marzo,Venezuela,1,28,,29,-75.527794,10.406342
30590,2015,Marzo,Venezuela,57,104,,161,-75.516486,10.446304
30591,2015,Marzo,Venezuela,7,68,,75,-74.77647900000001,10.886686
30592,2015,Marzo,Venezuela,0,7,,7,-74.765343,10.970933
30593,2015,Marzo,Venezuela,2142,2691,,4833,-72.129595,11.360028999999999
30594,2015,Marzo,Venezuela,7,14,,21,-76.532004,3.451668
30595,2015,Marzo,Venezuela,11,12,,23,-67.927521,3.866713
30596,2015,Marzo,Venezuela,0,1,,1,-77.061029,3.8844260000000004
30597,2015,Marzo,Venezuela,3645,4259,,7904,-74.140516,4.697157
30598,2015,Marzo,Venezuela,5,6,,11,-75.736374,4.815189
30599,2015,Marzo,Venezuela,31,83,,114,-75.42726,6.170465
30600,2015,Marzo,Venezuela,124,228,,352,-67.48402800000001,6.185536
30601,2015,Marzo,Venezuela,142,227,,369,-70.74025300000001,7.088728999999999
30602,2015,Marzo,Venezuela,4,7,,11,-73.181317,7.1280470000000005
30603,2015,Marzo,Venezuela,3270,4232,,7502,-72.453013,7.819
30604,2015,Marzo,Venezuela,265,326,,591,-72.508188,7.927233
31060,2015,Abril,Venezuela,0,9,,9,-75.527794,10.406342
31061,2015,Abril,Venezuela,4,13,,17,-73.247863,10.433608999999999
31062,2015,Abril,Venezuela,8,28,,36,-75.516486,10.446304
31063,2015,Abril,Venezuela,5,65,,70,-74.77647900000001,10.886686
31064,2015,Abril,Venezuela,0,5,,5,-74.213989,11.247722999999999
31065,2015,Abril,Venezuela,1775,2840,,4615,-72.129595,11.360028999999999
31066,2015,Abril,Venezuela,9,18,,27,-76.532004,3.451668
31067,2015,Abril,Venezuela,9,10,,19,-67.927521,3.866713
31068,2015,Abril,Venezuela,3686,4295,,7981,-74.140516,4.697157
31069,2015,Abril,Venezuela,0,1,,1,-75.736374,4.815189
31070,2015,Abril,Venezuela,52,100,,152,-75.42726,6.170465
31071,2015,Abril,Venezuela,149,264,,413,-67.48402800000001,6.185536
31072,2015,Abril,Venezuela,65,122,,187,-70.74025300000001,7.088728999999999
31073,2015,Abril,Venezuela,2,3,,5,-73.181317,7.1280470000000005
31074,2015,Abril,Venezuela,2712,3840,,6552,-72.453013,7.819
31075,2015,Abril,Venezuela,193,234,,427,-72.508188,7.927233
31530,2015,Mayo,Venezuela,0,12,,12,-75.527794,10.406342
31531,2015,Mayo,Venezuela,0,7,,7,-73.247863,10.433608999999999
31532,2015,Mayo,Venezuela,7,41,,48,-75.516486,10.446304
31533,2015,Mayo,Venezuela,19,79,,98,-74.77647900000001,10.886686
31534,2015,Mayo,Venezuela,0,1,,1,-74.765343,10.970933
31535,2015,Mayo,Venezuela,1770,2658,,4428,-72.129595,11.360028999999999
31536,2015,Mayo,Venezuela,28,58,,86,-76.532004,3.451668
31537,2015,Mayo,Venezuela,11,14,,25,-67.927521,3.866713
31538,2015,Mayo,Venezuela,3172,3929,,7101,-74.140516,4.697157
31539,2015,Mayo,Venezuela,0,4,,4,-75.736374,4.815189
31540,2015,Mayo,Venezuela,59,81,,140,-75.42726,6.170465
31541,2015,Mayo,Venezuela,199,462,,661,-67.48402800000001,6.185536
31542,2015,Mayo,Venezuela,53,106,,159,-70.74025300000001,7.088728999999999
31543,2015,Mayo,Venezuela,2,6,,8,-73.181317,7.1280470000000005
31544,2015,Mayo,Venezuela,3047,3986,,7033,-72.453013,7.819
31545,2015,Mayo,Venezuela,229,282,,511,-72.508188,7.927233
32042,2015,Junio,Venezuela,0,26,,26,-75.527794,10.406342
32043,2015,Junio,Venezuela,9,30,,39,-75.516486,10.446304
32044,2015,Junio,Venezuela,15,75,,90,-74.77647900000001,10.886686
32045,2015,Junio,Venezuela,0,1,,1,-74.765343,10.970933
32046,2015,Junio,Venezuela,0,4,,4,-74.232675,11.117206
32047,2015,Junio,Venezuela,0,1,,1,-74.213989,11.247722999999999
32048,2015,Junio,Venezuela,1820,2608,,4428,-72.129595,11.360028999999999
32049,2015,Junio,Venezuela,0,2,,2,-81.70216500000001,12.5862
32050,2015,Junio,Venezuela,14,29,,43,-76.532004,3.451668
32051,2015,Junio,Venezuela,13,9,,22,-67.927521,3.866713
32052,2015,Junio,Venezuela,3018,3716,,6734,-74.140516,4.697157
32053,2015,Junio,Venezuela,1,4,,5,-75.736374,4.815189
32054,2015,Junio,Venezuela,42,79,,121,-75.42726,6.170465
32055,2015,Junio,Venezuela,214,397,,611,-67.48402800000001,6.185536
32056,2015,Junio,Venezuela,130,200,,330,-70.74025300000001,7.088728999999999
32057,2015,Junio,Venezuela,1,2,,3,-73.181317,7.1280470000000005
32058,2015,Junio,Venezuela,3055,3996,,7051,-72.453013,7.819
32059,2015,Junio,Venezuela,201,217,,418,-72.508188,7.927233
32602,2015,Julio,Venezuela,0,7,,7,-75.527794,10.406342
32603,2015,Julio,Venezuela,431,374,,805,-75.516486,10.446304
32604,2015,Julio,Venezuela,22,95,,117,-74.77647900000001,10.886686
32605,2015,Julio,Venezuela,0,6,,6,-74.765343,10.970933
32606,2015,Julio,Venezuela,0,5,,5,-74.232675,11.117206
32607,2015,Julio,Venezuela,2696,3355,,6051,-72.129595,11.360028999999999
32608,2015,Julio,Venezuela,2,0,,2,-81.70216500000001,12.5862
32609,2015,Julio,Venezuela,14,20,,34,-76.532004,3.451668
32610,2015,Julio,Venezuela,37,65,,102,-67.927521,3.866713
32611,2015,Julio,Venezuela,3920,4566,,8486,-74.140516,4.697157
32612,2015,Julio,Venezuela,7,8,,15,-75.736374,4.815189
32613,2015,Julio,Venezuela,856,898,,1754,-75.42726,6.170465
32614,2015,Julio,Venezuela,389,646,,1035,-67.48402800000001,6.185536
32615,2015,Julio,Venezuela,70,115,,185,-70.74025300000001,7.088728999999999
32616,2015,Julio,Venezuela,1,1,,2,-73.181317,7.1280470000000005
32617,2015,Julio,Venezuela,4365,4980,,9345,-72.453013,7.819
32618,2015,Julio,Venezuela,342,315,,657,-72.508188,7.927233
33115,2015,Agosto,Venezuela,0,9,,9,-75.527794,10.406342
33116,2015,Agosto,Venezuela,521,433,,954,-75.516486,10.446304
33117,2015,Agosto,Venezuela,5,37,,42,-74.77647900000001,10.886686
33118,2015,Agosto,Venezuela,0,6,,6,-74.765343,10.970933
33119,2015,Agosto,Venezuela,4183,4807,,8990,-72.129595,11.360028999999999
33120,2015,Agosto,Venezuela,18,40,,58,-76.532004,3.451668
33121,2015,Agosto,Venezuela,52,78,,130,-67.927521,3.866713
33122,2015,Agosto,Venezuela,4536,4731,,9267,-74.140516,4.697157
33123,2015,Agosto,Venezuela,1,1,,2,-75.736374,4.815189
33124,2015,Agosto,Venezuela,2585,2404,,4989,-75.42726,6.170465
33125,2015,Agosto,Venezuela,359,641,,1000,-67.48402800000001,6.185536
33126,2015,Agosto,Venezuela,323,401,,724,-70.74025300000001,7.088728999999999
33127,2015,Agosto,Venezuela,12,10,,22,-73.181317,7.1280470000000005
33128,2015,Agosto,Venezuela,4242,4548,,8790,-72.453013,7.819
33129,2015,Agosto,Venezuela,368,327,,695,-72.508188,7.927233
33622,2015,Septiembre,Venezuela,0,9,,9,-75.527794,10.406342
33623,2015,Septiembre,Venezuela,436,397,,833,-75.516486,10.446304
33624,2015,Septiembre,Venezuela,15,53,,68,-74.77647900000001,10.886686
33625,2015,Septiembre,Venezuela,0,2,,2,-74.765343,10.970933
33626,2015,Septiembre,Venezuela,970,1250,,2220,-72.129595,11.360028999999999
33627,2015,Septiembre,Venezuela,1,0,,1,-81.70216500000001,12.5862
33628,2015,Septiembre,Venezuela,12,10,,22,-76.532004,3.451668
33629,2015,Septiembre,Venezuela,34,44,,78,-67.927521,3.866713
33630,2015,Septiembre,Venezuela,4122,4564,,8686,-74.140516,4.697157
33631,2015,Septiembre,Venezuela,0,2,,2,-75.736374,4.815189
33632,2015,Septiembre,Venezuela,2561,2271,,4832,-75.42726,6.170465
33633,2015,Septiembre,Venezuela,205,424,,629,-67.48402800000001,6.185536
33634,2015,Septiembre,Venezuela,191,278,,469,-70.74025300000001,7.088728999999999
33635,2015,Septiembre,Venezuela,3,2,,5,-73.181317,7.1280470000000005
33636,2015,Septiembre,Venezuela,1457,1804,,3261,-72.453013,7.819
33637,2015,Septiembre,Venezuela,61,89,,150,-72.508188,7.927233
34136,2015,Octubre,Venezuela,0,21,,21,-75.527794,10.406342
34137,2015,Octubre,Venezuela,443,376,,819,-75.516486,10.446304
34138,2015,Octubre,Venezuela,20,63,,83,-74.77647900000001,10.886686
34139,2015,Octubre,Venezuela,2,20,,22,-74.232675,11.117206
34140,2015,Octubre,Venezuela,206,288,,494,-72.129595,11.360028999999999
34141,2015,Octubre,Venezuela,18,33,,51,-76.532004,3.451668
34142,2015,Octubre,Venezuela,34,55,,89,-67.927521,3.866713
34143,2015,Octubre,Venezuela,4433,4837,,9270,-74.140516,4.697157
34144,2015,Octubre,Venezuela,0,2,,2,-75.736374,4.815189
34145,2015,Octubre,Venezuela,2400,2107,,4507,-75.42726,6.170465
34146,2015,Octubre,Venezuela,27,50,,77,-67.48402800000001,6.185536
34147,2015,Octubre,Venezuela,46,96,,142,-70.74025300000001,7.088728999999999
34148,2015,Octubre,Venezuela,6,10,,16,-73.181317,7.1280470000000005
34149,2015,Octubre,Venezuela,1793,2282,,4075,-72.453013,7.819
34150,2015,Octubre,Venezuela,78,95,,173,-72.508188,7.927233
34651,2015,Noviembre,Venezuela,0,22,,22,-75.527794,10.406342
34652,2015,Noviembre,Venezuela,545,431,,976,-75.516486,10.446304
34653,2015,Noviembre,Venezuela,14,45,,59,-74.77647900000001,10.886686
34654,2015,Noviembre,Venezuela,0,4,,4,-74.765343,10.970933
34655,2015,Noviembre,Venezuela,6,7,,13,-74.232675,11.117206
34656,2015,Noviembre,Venezuela,188,291,,479,-72.129595,11.360028999999999
34657,2015,Noviembre,Venezuela,2,0,,2,-81.70216500000001,12.5862
34658,2015,Noviembre,Venezuela,12,16,,28,-76.532004,3.451668
34659,2015,Noviembre,Venezuela,36,59,,95,-67.927521,3.866713
34660,2015,Noviembre,Venezuela,4208,4760,,8968,-74.140516,4.697157
34661,2015,Noviembre,Venezuela,4,4,,8,-75.736374,4.815189
34662,2015,Noviembre,Venezuela,1892,1810,,3702,-75.42726,6.170465
34663,2015,Noviembre,Venezuela,59,101,,160,-67.48402800000001,6.185536
34664,2015,Noviembre,Venezuela,40,63,,103,-70.74025300000001,7.088728999999999
34665,2015,Noviembre,Venezuela,7,6,,13,-73.181317,7.1280470000000005
34666,2015,Noviembre,Venezuela,2521,3080,,5601,-72.453013,7.819
34667,2015,Noviembre,Venezuela,115,132,,247,-72.508188,7.927233
35207,2015,Diciembre,Venezuela,0,20,,20,-75.527794,10.406342
35208,2015,Diciembre,Venezuela,529,406,,935,-75.516486,10.446304
35209,2015,Diciembre,Venezuela,27,48,,75,-74.77647900000001,10.886686
35210,2015,Diciembre,Venezuela,0,6,,6,-74.232675,11.117206
35211,2015,Diciembre,Venezuela,225,330,,555,-72.129595,11.360028999999999
35212,2015,Diciembre,Venezuela,3,5,,8,-81.70216500000001,12.5862
35213,2015,Diciembre,Venezuela,24,43,,67,-76.532004,3.451668
35214,2015,Diciembre,Venezuela,47,48,,95,-67.927521,3.866713
35215,2015,Diciembre,Venezuela,4543,4387,,8930,-74.140516,4.697157
35216,2015,Diciembre,Venezuela,1,4,,5,-75.736374,4.815189
35217,2015,Diciembre,Venezuela,1985,1641,,3626,-75.42726,6.170465
35218,2015,Diciembre,Venezuela,49,76,,125,-67.48402800000001,6.185536
35219,2015,Diciembre,Venezuela,61,145,,206,-70.74025300000001,7.088728999999999
35220,2015,Diciembre,Venezuela,20,18,,38,-73.181317,7.1280470000000005
35221,2015,Diciembre,Venezuela,3048,3439,,6487,-72.453013,7.819
35222,2015,Diciembre,Venezuela,178,221,,399,-72.508188,7.927233
35726,2016,Enero,Venezuela,0,42,,42,-75.527794,10.406342
35727,2016,Enero,Venezuela,61,88,,149,-75.516486,10.446304
35728,2016,Enero,Venezuela,14,47,,61,-74.77647900000001,10.886686
35729,2016,Enero,Venezuela,1,5,,6,-74.232675,11.117206
35730,2016,Enero,Venezuela,244,414,,658,-72.129595,11.360028999999999
35731,2016,Enero,Venezuela,1,2,,3,-81.70216500000001,12.5862
35732,2016,Enero,Venezuela,22,46,,68,-76.532004,3.451668
35733,2016,Enero,Venezuela,36,47,,83,-67.927521,3.866713
35734,2016,Enero,Venezuela,3445,3845,,7290,-74.140516,4.697157
35735,2016,Enero,Venezuela,5,9,,14,-75.736374,4.815189
35736,2016,Enero,Venezuela,719,716,,1435,-75.42726,6.170465
35737,2016,Enero,Venezuela,32,81,,113,-67.48402800000001,6.185536
35738,2016,Enero,Venezuela,43,80,,123,-70.74025300000001,7.088728999999999
35739,2016,Enero,Venezuela,12,15,,27,-73.181317,7.1280470000000005
35740,2016,Enero,Venezuela,2721,3401,,6122,-72.453013,7.819
35741,2016,Enero,Venezuela,159,225,,384,-72.508188,7.927233
36226,2016,Febrero,Venezuela,0,7,,7,-75.527794,10.406342
36227,2016,Febrero,Venezuela,4,17,,21,-75.516486,10.446304
36228,2016,Febrero,Venezuela,16,65,,81,-74.77647900000001,10.886686
36229,2016,Febrero,Venezuela,0,1,,1,-74.765343,10.970933
36230,2016,Febrero,Venezuela,3,4,,7,-74.213989,11.247722999999999
36231,2016,Febrero,Venezuela,279,456,,735,-72.129595,11.360028999999999
36232,2016,Febrero,Venezuela,1,3,,4,-81.70216500000001,12.5862
36233,2016,Febrero,Venezuela,14,28,,42,-76.532004,3.451668
36234,2016,Febrero,Venezuela,48,53,,101,-67.927521,3.866713
36235,2016,Febrero,Venezuela,2975,3669,,6644,-74.140516,4.697157
36236,2016,Febrero,Venezuela,0,1,,1,-75.736374,4.815189
36237,2016,Febrero,Venezuela,541,599,,1140,-75.42726,6.170465
36238,2016,Febrero,Venezuela,64,101,,165,-67.48402800000001,6.185536
36239,2016,Febrero,Venezuela,36,45,,81,-70.74025300000001,7.088728999999999
36240,2016,Febrero,Venezuela,1,1,,2,-73.181317,7.1280470000000005
36241,2016,Febrero,Venezuela,1865,2498,,4363,-72.453013,7.819
36242,2016,Febrero,Venezuela,148,187,,335,-72.508188,7.927233
36753,2016,Marzo,Venezuela,2,9,,11,-75.527794,10.406342
36754,2016,Marzo,Venezuela,3,6,,9,-75.516486,10.446304
36755,2016,Marzo,Venezuela,16,42,,58,-74.77647900000001,10.886686
36756,2016,Marzo,Venezuela,0,10,,10,-74.232675,11.117206
36757,2016,Marzo,Venezuela,424,602,,1026,-72.129595,11.360028999999999
36758,2016,Marzo,Venezuela,0,1,,1,-81.70216500000001,12.5862
36759,2016,Marzo,Venezuela,11,18,,29,-76.532004,3.451668
36760,2016,Marzo,Venezuela,53,72,,125,-67.927521,3.866713
36761,2016,Marzo,Venezuela,3610,4205,,7815,-74.140516,4.697157
36762,2016,Marzo,Venezuela,3,5,,8,-75.736374,4.815189
36763,2016,Marzo,Venezuela,831,812,,1643,-75.42726,6.170465
36764,2016,Marzo,Venezuela,81,134,,215,-67.48402800000001,6.185536
36765,2016,Marzo,Venezuela,63,93,,156,-70.74025300000001,7.088728999999999
36766,2016,Marzo,Venezuela,2,11,,13,-73.181317,7.1280470000000005
36767,2016,Marzo,Venezuela,1656,2095,,3751,-72.453013,7.819
36768,2016,Marzo,Venezuela,107,146,,253,-72.508188,7.927233
37253,2016,Abril,Venezuela,0,9,,9,-75.527794,10.406342
37254,2016,Abril,Venezuela,6,4,,10,-73.247863,10.433608999999999
37255,2016,Abril,Venezuela,3,21,,24,-75.516486,10.446304
37256,2016,Abril,Venezuela,11,61,,72,-74.77647900000001,10.886686
37257,2016,Abril,Venezuela,0,1,,1,-74.765343,10.970933
37258,2016,Abril,Venezuela,0,5,,5,-74.232675,11.117206
37259,2016,Abril,Venezuela,0,3,,3,-74.213989,11.247722999999999
37260,2016,Abril,Venezuela,402,643,,1045,-72.129595,11.360028999999999
37261,2016,Abril,Venezuela,1,4,,5,-81.70216500000001,12.5862
37262,2016,Abril,Venezuela,15,20,,35,-76.532004,3.451668
37263,2016,Abril,Venezuela,35,26,,61,-67.927521,3.866713
37264,2016,Abril,Venezuela,3024,3553,,6577,-74.140516,4.697157
37265,2016,Abril,Venezuela,2,5,,7,-75.736374,4.815189
37266,2016,Abril,Venezuela,507,586,,1093,-75.42726,6.170465
37267,2016,Abril,Venezuela,40,53,,93,-67.48402800000001,6.185536
37268,2016,Abril,Venezuela,51,47,,98,-70.74025300000001,7.088728999999999
37269,2016,Abril,Venezuela,3,3,,6,-73.181317,7.1280470000000005
37270,2016,Abril,Venezuela,1308,1935,,3243,-72.453013,7.819
37271,2016,Abril,Venezuela,90,126,,216,-72.508188,7.927233
37781,2016,Mayo,Venezuela,0,14,,14,-75.527794,10.406342
37782,2016,Mayo,Venezuela,1,3,,4,-75.516486,10.446304
37783,2016,Mayo,Venezuela,12,44,,56,-74.77647900000001,10.886686
37784,2016,Mayo,Venezuela,0,2,,2,-74.765343,10.970933
37785,2016,Mayo,Venezuela,1,10,,11,-74.232675,11.117206
37786,2016,Mayo,Venezuela,0,7,,7,-74.213989,11.247722999999999
37787,2016,Mayo,Venezuela,418,677,,1095,-72.129595,11.360028999999999
37788,2016,Mayo,Venezuela,1,1,,2,-81.70216500000001,12.5862
37789,2016,Mayo,Venezuela,8,22,,30,-76.532004,3.451668
37790,2016,Mayo,Venezuela,32,39,,71,-67.927521,3.866713
37791,2016,Mayo,Venezuela,3120,4011,,7131,-74.140516,4.697157
37792,2016,Mayo,Venezuela,0,6,,6,-75.736374,4.815189
37793,2016,Mayo,Venezuela,492,588,,1080,-75.42726,6.170465
37794,2016,Mayo,Venezuela,47,54,,101,-67.48402800000001,6.185536
37795,2016,Mayo,Venezuela,60,71,,131,-70.74025300000001,7.088728999999999
37796,2016,Mayo,Venezuela,3,2,,5,-73.181317,7.1280470000000005
37797,2016,Mayo,Venezuela,1513,2147,,3660,-72.453013,7.819
37798,2016,Mayo,Venezuela,136,172,,308,-72.508188,7.927233
38293,2016,Junio,Venezuela,0,27,,27,-75.527794,10.406342
38294,2016,Junio,Venezuela,9,22,,31,-75.516486,10.446304
38295,2016,Junio,Venezuela,32,40,,72,-74.77647900000001,10.886686
38296,2016,Junio,Venezuela,0,1,,1,-74.213989,11.247722999999999
38297,2016,Junio,Venezuela,670,942,,1612,-72.129595,11.360028999999999
38298,2016,Junio,Venezuela,4,4,,8,-81.70216500000001,12.5862
38299,2016,Junio,Venezuela,8,28,,36,-76.532004,3.451668
38300,2016,Junio,Venezuela,24,38,,62,-67.927521,3.866713
38301,2016,Junio,Venezuela,3351,4195,,7546,-74.140516,4.697157
38302,2016,Junio,Venezuela,1,4,,5,-75.736374,4.815189
38303,2016,Junio,Venezuela,659,733,,1392,-75.42726,6.170465
38304,2016,Junio,Venezuela,27,46,,73,-67.48402800000001,6.185536
38305,2016,Junio,Venezuela,78,84,,162,-70.74025300000001,7.088728999999999
38306,2016,Junio,Venezuela,2,4,,6,-73.181317,7.1280470000000005
38307,2016,Junio,Venezuela,1466,2036,,3502,-72.453013,7.819
38308,2016,Junio,Venezuela,161,165,,326,-72.508188,7.927233
38824,2016,Julio,Venezuela,0,1,,1,-75.527794,10.406342
38825,2016,Julio,Venezuela,29,40,,69,-75.516486,10.446304
38826,2016,Julio,Venezuela,18,51,,69,-74.77647900000001,10.886686
38827,2016,Julio,Venezuela,1,10,,11,-74.232675,11.117206
38828,2016,Julio,Venezuela,0,1,,1,-74.213989,11.247722999999999
38829,2016,Julio,Venezuela,2209,2843,,5052,-72.129595,11.360028999999999
38830,2016,Julio,Venezuela,2,4,,6,-81.70216500000001,12.5862
38831,2016,Julio,Venezuela,8,25,,33,-76.532004,3.451668
38832,2016,Julio,Venezuela,9,23,,32,-67.927521,3.866713
38833,2016,Julio,Venezuela,4487,4615,,9102,-74.140516,4.697157
38834,2016,Julio,Venezuela,1,3,,4,-75.736374,4.815189
38835,2016,Julio,Venezuela,963,959,,1922,-75.42726,6.170465
38836,2016,Julio,Venezuela,31,43,,74,-67.48402800000001,6.185536
38837,2016,Julio,Venezuela,44,45,,89,-70.74025300000001,7.088728999999999
38838,2016,Julio,Venezuela,5,3,,8,-73.181317,7.1280470000000005
38839,2016,Julio,Venezuela,2517,3113,,5630,-72.453013,7.819
38840,2016,Julio,Venezuela,263,288,,551,-72.508188,7.927233
38841,2016,Julio,Venezuela,18,22,,40,-72.409396,8.36068
39346,2016,Agosto,Venezuela,0,11,,11,-75.527794,10.406342
39347,2016,Agosto,Venezuela,5,6,,11,-75.516486,10.446304
39348,2016,Agosto,Venezuela,46,156,,202,-74.77647900000001,10.886686
39349,2016,Agosto,Venezuela,8298,8635,,16933,-72.129595,11.360028999999999
39350,2016,Agosto,Venezuela,0,1,,1,-81.70216500000001,12.5862
39351,2016,Agosto,Venezuela,27,23,,50,-76.532004,3.451668
39352,2016,Agosto,Venezuela,14,15,,29,-67.927521,3.866713
39353,2016,Agosto,Venezuela,4337,4693,,9030,-74.140516,4.697157
39354,2016,Agosto,Venezuela,6,11,,17,-75.736374,4.815189
39355,2016,Agosto,Venezuela,828,912,,1740,-75.42726,6.170465
39356,2016,Agosto,Venezuela,1342,1695,,3037,-67.48402800000001,6.185536
39357,2016,Agosto,Venezuela,5234,4834,,10068,-70.74025300000001,7.088728999999999
39358,2016,Agosto,Venezuela,10,8,,18,-73.181317,7.1280470000000005
39359,2016,Agosto,Venezuela,6171,7462,,13633,-72.453013,7.819
39360,2016,Agosto,Venezuela,0,2,,2,-72.508188,7.927233
39361,2016,Agosto,Venezuela,436,444,,880,-72.409396,8.36068
39842,2016,Septiembre,Venezuela,0,2,,2,-75.527794,10.406342
39843,2016,Septiembre,Venezuela,15,114,,129,-75.516486,10.446304
39844,2016,Septiembre,Venezuela,11,98,,109,-74.77647900000001,10.886686
39845,2016,Septiembre,Venezuela,0,1,,1,-74.232675,11.117206
39846,2016,Septiembre,Venezuela,0,1,,1,-74.213989,11.247722999999999
39847,2016,Septiembre,Venezuela,4588,5586,,10174,-72.129595,11.360028999999999
39848,2016,Septiembre,Venezuela,3,3,,6,-81.70216500000001,12.5862
39849,2016,Septiembre,Venezuela,9,31,,40,-76.532004,3.451668
39850,2016,Septiembre,Venezuela,23,21,,44,-67.927521,3.866713
39851,2016,Septiembre,Venezuela,3273,3718,,6991,-74.140516,4.697157
39852,2016,Septiembre,Venezuela,3,2,,5,-75.736374,4.815189
39853,2016,Septiembre,Venezuela,492,564,,1056,-75.42726,6.170465
39854,2016,Septiembre,Venezuela,1864,2356,,4220,-67.48402800000001,6.185536
39855,2016,Septiembre,Venezuela,5522,5453,,10975,-70.74025300000001,7.088728999999999
39856,2016,Septiembre,Venezuela,2,2,,4,-73.181317,7.1280470000000005
39857,2016,Septiembre,Venezuela,6120,8063,,14183,-72.453013,7.819
39858,2016,Septiembre,Venezuela,1,7,,8,-72.508188,7.927233
39859,2016,Septiembre,Venezuela,125,137,,262,-72.409396,8.36068
40362,2016,Octubre,Venezuela,0,5,,5,-75.527794,10.406342
40363,2016,Octubre,Venezuela,32,78,,110,-75.516486,10.446304
40364,2016,Octubre,Venezuela,19,59,,78,-74.77647900000001,10.886686
40365,2016,Octubre,Venezuela,0,7,,7,-74.765343,10.970933
40366,2016,Octubre,Venezuela,0,1,,1,-74.213989,11.247722999999999
40367,2016,Octubre,Venezuela,4332,5126,,9458,-72.129595,11.360028999999999
40368,2016,Octubre,Venezuela,0,2,,2,-81.70216500000001,12.5862
40369,2016,Octubre,Venezuela,14,32,,46,-76.532004,3.451668
40370,2016,Octubre,Venezuela,17,17,,34,-67.927521,3.866713
40371,2016,Octubre,Venezuela,0,1,,1,-77.061029,3.8844260000000004
40372,2016,Octubre,Venezuela,3437,3950,,7387,-74.140516,4.697157
40373,2016,Octubre,Venezuela,6,8,,14,-75.736374,4.815189
40374,2016,Octubre,Venezuela,577,621,,1198,-75.42726,6.170465
40375,2016,Octubre,Venezuela,1382,1840,,3222,-67.48402800000001,6.185536
40376,2016,Octubre,Venezuela,87,112,,199,-70.74025300000001,7.088728999999999
40377,2016,Octubre,Venezuela,2,1,,3,-73.181317,7.1280470000000005
40378,2016,Octubre,Venezuela,6722,8714,,15436,-72.453013,7.819
40379,2016,Octubre,Venezuela,67,84,,151,-72.409396,8.36068
40850,2016,Noviembre,Venezuela,0,4,,4,-75.527794,10.406342
40851,2016,Noviembre,Venezuela,7,17,,24,-75.516486,10.446304
40852,2016,Noviembre,Venezuela,31,65,,96,-74.77647900000001,10.886686
40853,2016,Noviembre,Venezuela,0,11,,11,-74.232675,11.117206
40854,2016,Noviembre,Venezuela,4334,5075,,9409,-72.129595,11.360028999999999
40855,2016,Noviembre,Venezuela,2,0,,2,-81.70216500000001,12.5862
40856,2016,Noviembre,Venezuela,9,54,,63,-76.532004,3.451668
40857,2016,Noviembre,Venezuela,44,36,,80,-67.927521,3.866713
40858,2016,Noviembre,Venezuela,3419,4073,,7492,-74.140516,4.697157
40859,2016,Noviembre,Venezuela,3,3,,6,-75.736374,4.815189
40860,2016,Noviembre,Venezuela,563,570,,1133,-75.42726,6.170465
40861,2016,Noviembre,Venezuela,785,1024,,1809,-67.48402800000001,6.185536
40862,2016,Noviembre,Venezuela,117,161,,278,-70.74025300000001,7.088728999999999
40863,2016,Noviembre,Venezuela,2,7,,9,-73.181317,7.1280470000000005
40864,2016,Noviembre,Venezuela,6800,8672,,15472,-72.453013,7.819
40865,2016,Noviembre,Venezuela,75,75,,150,-72.409396,8.36068
41363,2016,Diciembre,Venezuela,0,18,,18,-75.527794,10.406342
41364,2016,Diciembre,Venezuela,18,37,,55,-75.516486,10.446304
41365,2016,Diciembre,Venezuela,20,42,,62,-74.77647900000001,10.886686
41366,2016,Diciembre,Venezuela,0,1,,1,-74.765343,10.970933
41367,2016,Diciembre,Venezuela,1,4,,5,-74.232675,11.117206
41368,2016,Diciembre,Venezuela,3834,3982,,7816,-72.129595,11.360028999999999
41369,2016,Diciembre,Venezuela,9,9,,18,-81.70216500000001,12.5862
41370,2016,Diciembre,Venezuela,14,28,,42,-76.532004,3.451668
41371,2016,Diciembre,Venezuela,40,38,,78,-67.927521,3.866713
41372,2016,Diciembre,Venezuela,4172,4077,,8249,-74.140516,4.697157
41373,2016,Diciembre,Venezuela,4,7,,11,-75.736374,4.815189
41374,2016,Diciembre,Venezuela,705,703,,1408,-75.42726,6.170465
41375,2016,Diciembre,Venezuela,415,580,,995,-67.48402800000001,6.185536
41376,2016,Diciembre,Venezuela,118,165,,283,-70.74025300000001,7.088728999999999
41377,2016,Diciembre,Venezuela,5,9,,14,-73.181317,7.1280470000000005
41378,2016,Diciembre,Venezuela,8818,8976,,17794,-72.453013,7.819
41379,2016,Diciembre,Venezuela,1,1,,2,-72.508188,7.927233
41380,2016,Diciembre,Venezuela,155,163,,318,-72.409396,8.36068
41890,2017,Enero,Venezuela,16,31,,47,-75.516486,10.446304
41891,2017,Enero,Venezuela,19,74,,93,-74.77647900000001,10.886686
41892,2017,Enero,Venezuela,4116,5697,,9813,-72.129595,11.360028999999999
41893,2017,Enero,Venezuela,8,30,,38,-76.532004,3.451668
41894,2017,Enero,Venezuela,49,39,,88,-67.927521,3.866713
41895,2017,Enero,Venezuela,3162,3400,,6562,-74.140516,4.697157
41896,2017,Enero,Venezuela,3,8,,11,-75.736374,4.815189
41897,2017,Enero,Venezuela,418,515,,933,-75.42726,6.170465
41898,2017,Enero,Venezuela,403,553,,956,-67.48402800000001,6.185536
41899,2017,Enero,Venezuela,113,137,,250,-70.74025300000001,7.088728999999999
41900,2017,Enero,Venezuela,6,8,,14,-73.181317,7.1280470000000005
41901,2017,Enero,Venezuela,8660,12338,,20998,-72.453013,7.819
41902,2017,Enero,Venezuela,0,2,,2,-72.508188,7.927233
41903,2017,Enero,Venezuela,244,301,,545,-72.409396,8.36068
42385,2017,Febrero,Venezuela,0,4,,4,-75.527794,10.406342
42386,2017,Febrero,Venezuela,5,11,,16,-75.516486,10.446304
42387,2017,Febrero,Venezuela,24,73,,97,-74.77647900000001,10.886686
42388,2017,Febrero,Venezuela,0,1,,1,-74.765343,10.970933
42389,2017,Febrero,Venezuela,11,8,,19,-74.232675,11.117206
42390,2017,Febrero,Venezuela,4617,5720,,10337,-72.129595,11.360028999999999
42391,2017,Febrero,Venezuela,1,0,,1,-81.70216500000001,12.5862
42392,2017,Febrero,Venezuela,9,20,,29,-76.532004,3.451668
42393,2017,Febrero,Venezuela,53,46,,99,-67.927521,3.866713
42394,2017,Febrero,Venezuela,2710,3151,,5861,-74.140516,4.697157
42395,2017,Febrero,Venezuela,3,3,,6,-75.736374,4.815189
42396,2017,Febrero,Venezuela,400,458,,858,-75.42726,6.170465
42397,2017,Febrero,Venezuela,517,710,,1227,-67.48402800000001,6.185536
42398,2017,Febrero,Venezuela,77,82,,159,-70.74025300000001,7.088728999999999
42399,2017,Febrero,Venezuela,2,1,,3,-73.181317,7.1280470000000005
42400,2017,Febrero,Venezuela,7026,9695,,16721,-72.453013,7.819
42401,2017,Febrero,Venezuela,1,10,,11,-72.508188,7.927233
42402,2017,Febrero,Venezuela,159,217,,376,-72.409396,8.36068
42894,2017,Marzo,Venezuela,14,50,,64,-75.516486,10.446304
42895,2017,Marzo,Venezuela,19,82,,101,-74.77647900000001,10.886686
42896,2017,Marzo,Venezuela,0,1,,1,-74.765343,10.970933
42897,2017,Marzo,Venezuela,0,1,,1,-74.213989,11.247722999999999
42898,2017,Marzo,Venezuela,4080,5005,,9085,-72.129595,11.360028999999999
42899,2017,Marzo,Venezuela,0,1,,1,-81.70216500000001,12.5862
42900,2017,Marzo,Venezuela,23,24,,47,-76.532004,3.451668
42901,2017,Marzo,Venezuela,167,179,,346,-67.927521,3.866713
42902,2017,Marzo,Venezuela,2535,3221,,5756,-74.140516,4.697157
42903,2017,Marzo,Venezuela,1,2,,3,-75.736374,4.815189
42904,2017,Marzo,Venezuela,391,475,,866,-75.42726,6.170465
42905,2017,Marzo,Venezuela,323,484,,807,-67.48402800000001,6.185536
42906,2017,Marzo,Venezuela,89,130,,219,-70.74025300000001,7.088728999999999
42907,2017,Marzo,Venezuela,4,8,,12,-73.181317,7.1280470000000005
42908,2017,Marzo,Venezuela,7200,9792,,16992,-72.453013,7.819
42909,2017,Marzo,Venezuela,0,5,,5,-72.508188,7.927233
42910,2017,Marzo,Venezuela,240,349,,589,-72.409396,8.36068
43399,2017,Abril,Venezuela,0,4,,4,-75.527794,10.406342
43400,2017,Abril,Venezuela,6,16,,22,-73.247863,10.433608999999999
43401,2017,Abril,Venezuela,10,13,,23,-75.516486,10.446304
43402,2017,Abril,Venezuela,8,50,,58,-74.77647900000001,10.886686
43403,2017,Abril,Venezuela,0,6,,6,-74.765343,10.970933
43404,2017,Abril,Venezuela,5168,5629,,10797,-72.129595,11.360028999999999
43405,2017,Abril,Venezuela,1,1,,2,-81.70216500000001,12.5862
43406,2017,Abril,Venezuela,14,20,,34,-76.532004,3.451668
43407,2017,Abril,Venezuela,106,120,,226,-67.927521,3.866713
43408,2017,Abril,Venezuela,3498,3621,,7119,-74.140516,4.697157
43409,2017,Abril,Venezuela,1,3,,4,-75.736374,4.815189
43410,2017,Abril,Venezuela,548,561,,1109,-75.42726,6.170465
43411,2017,Abril,Venezuela,127,175,,302,-67.48402800000001,6.185536
43412,2017,Abril,Venezuela,113,119,,232,-70.74025300000001,7.088728999999999
43413,2017,Abril,Venezuela,11,11,,22,-73.181317,7.1280470000000005
43414,2017,Abril,Venezuela,7956,10225,,18181,-72.453013,7.819
43415,2017,Abril,Venezuela,3,7,,10,-72.508188,7.927233
43416,2017,Abril,Venezuela,255,269,,524,-72.409396,8.36068
43900,2017,Mayo,Venezuela,0,10,,10,-75.527794,10.406342
43901,2017,Mayo,Venezuela,0,3,,3,-73.247863,10.433608999999999
43902,2017,Mayo,Venezuela,7,43,,50,-75.516486,10.446304
43903,2017,Mayo,Venezuela,21,58,,79,-74.77647900000001,10.886686
43904,2017,Mayo,Venezuela,1,8,,9,-74.232675,11.117206
43905,2017,Mayo,Venezuela,5810,6768,,12578,-72.129595,11.360028999999999
43906,2017,Mayo,Venezuela,1,0,,1,-81.70216500000001,12.5862
43907,2017,Mayo,Venezuela,14,15,,29,-76.532004,3.451668
43908,2017,Mayo,Venezuela,11,17,,28,-67.927521,3.866713
43909,2017,Mayo,Venezuela,3145,3565,,6710,-74.140516,4.697157
43910,2017,Mayo,Venezuela,3,5,,8,-75.736374,4.815189
43911,2017,Mayo,Venezuela,375,481,,856,-75.42726,6.170465
43912,2017,Mayo,Venezuela,15,23,,38,-67.48402800000001,6.185536
43913,2017,Mayo,Venezuela,184,194,,378,-70.74025300000001,7.088728999999999
43914,2017,Mayo,Venezuela,2,1,,3,-73.181317,7.1280470000000005
43915,2017,Mayo,Venezuela,7773,10764,,18537,-72.453013,7.819
43916,2017,Mayo,Venezuela,1,2,,3,-72.508188,7.927233
43917,2017,Mayo,Venezuela,451,594,,1045,-72.409396,8.36068
44416,2017,Junio,Venezuela,0,10,,10,-75.527794,10.406342
44417,2017,Junio,Venezuela,7,25,,32,-75.516486,10.446304
44418,2017,Junio,Venezuela,6,46,,52,-74.77647900000001,10.886686
44419,2017,Junio,Venezuela,5009,5745,,10754,-72.129595,11.360028999999999
44420,2017,Junio,Venezuela,1,0,,1,-81.70216500000001,12.5862
44421,2017,Junio,Venezuela,8,15,,23,-76.532004,3.451668
44422,2017,Junio,Venezuela,2,12,,14,-67.927521,3.866713
44423,2017,Junio,Venezuela,3191,3644,,6835,-74.140516,4.697157
44424,2017,Junio,Venezuela,4,6,,10,-75.736374,4.815189
44425,2017,Junio,Venezuela,431,503,,934,-75.42726,6.170465
44426,2017,Junio,Venezuela,14,15,,29,-67.48402800000001,6.185536
44427,2017,Junio,Venezuela,143,181,,324,-70.74025300000001,7.088728999999999
44428,2017,Junio,Venezuela,4,6,,10,-73.181317,7.1280470000000005
44429,2017,Junio,Venezuela,9674,13026,,22700,-72.453013,7.819
44430,2017,Junio,Venezuela,245,316,,561,-72.409396,8.36068
44979,2017,Julio,Venezuela,0,5,,5,-75.527794,10.406342
44980,2017,Julio,Venezuela,3,19,,22,-75.516486,10.446304
44981,2017,Julio,Venezuela,17,47,,64,-74.77647900000001,10.886686
44982,2017,Julio,Venezuela,0,1,,1,-74.765343,10.970933
44983,2017,Julio,Venezuela,7076,7243,,14319,-72.129595,11.360028999999999
44984,2017,Julio,Venezuela,1,1,,2,-81.70216500000001,12.5862
44985,2017,Julio,Venezuela,25,34,,59,-76.532004,3.451668
44986,2017,Julio,Venezuela,12,18,,30,-67.927521,3.866713
44987,2017,Julio,Venezuela,4785,4542,,9327,-74.140516,4.697157
44988,2017,Julio,Venezuela,3,3,,6,-75.736374,4.815189
44989,2017,Julio,Venezuela,713,715,,1428,-75.42726,6.170465
44990,2017,Julio,Venezuela,17,16,,33,-67.48402800000001,6.185536
44991,2017,Julio,Venezuela,179,175,,354,-70.74025300000001,7.088728999999999
44992,2017,Julio,Venezuela,19406,22408,,41814,-72.453013,7.819
44993,2017,Julio,Venezuela,3,5,,8,-72.508188,7.927233
44994,2017,Julio,Venezuela,0,4,,4,-76.7333,8.06667
44995,2017,Julio,Venezuela,854,811,,1665,-72.409396,8.36068
45477,2017,Agosto,Venezuela,1,28,,29,-75.527794,10.406342
45478,2017,Agosto,Venezuela,10,29,,39,-75.516486,10.446304
45479,2017,Agosto,Venezuela,24,69,,93,-74.77647900000001,10.886686
45480,2017,Agosto,Venezuela,0,1,,1,-74.232675,11.117206
45481,2017,Agosto,Venezuela,1,3,,4,-74.213989,11.247722999999999
45482,2017,Agosto,Venezuela,9677,10072,,19749,-72.129595,11.360028999999999
45483,2017,Agosto,Venezuela,3,3,,6,-81.70216500000001,12.5862
45484,2017,Agosto,Venezuela,22,23,,45,-76.532004,3.451668
45485,2017,Agosto,Venezuela,15,19,,34,-67.927521,3.866713
45486,2017,Agosto,Venezuela,3015,2904,,5919,-74.140516,4.697157
45487,2017,Agosto,Venezuela,2,3,,5,-75.736374,4.815189
45488,2017,Agosto,Venezuela,573,678,,1251,-75.42726,6.170465
45489,2017,Agosto,Venezuela,26,29,,55,-67.48402800000001,6.185536
45490,2017,Agosto,Venezuela,299,318,,617,-70.74025300000001,7.088728999999999
45491,2017,Agosto,Venezuela,3,5,,8,-73.181317,7.1280470000000005
45492,2017,Agosto,Venezuela,23560,27330,,50890,-72.453013,7.819
45493,2017,Agosto,Venezuela,4,26,,30,-72.508188,7.927233
45494,2017,Agosto,Venezuela,850,868,,1718,-72.409396,8.36068
45927,2017,Septiembre,Venezuela,0,14,,14,-75.527794,10.406342
45928,2017,Septiembre,Venezuela,9,18,,27,-75.516486,10.446304
45929,2017,Septiembre,Venezuela,8,37,,45,-74.77647900000001,10.886686
45930,2017,Septiembre,Venezuela,0,1,,1,-74.765343,10.970933
45931,2017,Septiembre,Venezuela,6905,7574,,14479,-72.129595,11.360028999999999
45932,2017,Septiembre,Venezuela,17,22,,39,-76.532004,3.451668
45933,2017,Septiembre,Venezuela,13,12,,25,-67.927521,3.866713
45934,2017,Septiembre,Venezuela,1620,1720,,3340,-74.140516,4.697157
45935,2017,Septiembre,Venezuela,0,1,,1,-75.736374,4.815189
45936,2017,Septiembre,Venezuela,516,633,,1149,-75.42726,6.170465
45937,2017,Septiembre,Venezuela,30,25,,55,-67.48402800000001,6.185536
45938,2017,Septiembre,Venezuela,186,204,,390,-70.74025300000001,7.088728999999999
45939,2017,Septiembre,Venezuela,1,3,,4,-73.181317,7.1280470000000005
45940,2017,Septiembre,Venezuela,20416,24712,,45128,-72.453013,7.819
45941,2017,Septiembre,Venezuela,0,13,,13,-72.508188,7.927233
45942,2017,Septiembre,Venezuela,611,694,,1305,-72.409396,8.36068
46242,2017,Octubre,Venezuela,0,17,,17,-75.527794,10.406342
46243,2017,Octubre,Venezuela,3,18,,21,-75.516486,10.446304
46244,2017,Octubre,Venezuela,4,16,,20,-74.77647900000001,10.886686
46245,2017,Octubre,Venezuela,0,1,,1,-74.765343,10.970933
46246,2017,Octubre,Venezuela,0,5,,5,-74.232675,11.117206
46247,2017,Octubre,Venezuela,6655,7340,,13995,-72.129595,11.360028999999999
46248,2017,Octubre,Venezuela,12,50,,62,-76.532004,3.451668
46249,2017,Octubre,Venezuela,12,13,,25,-67.927521,3.866713
46250,2017,Octubre,Venezuela,173,354,,527,-74.140516,4.697157
46251,2017,Octubre,Venezuela,3,9,,12,-75.736374,4.815189
46252,2017,Octubre,Venezuela,526,646,,1172,-75.42726,6.170465
46253,2017,Octubre,Venezuela,15,24,,39,-67.48402800000001,6.185536
46254,2017,Octubre,Venezuela,202,283,,485,-70.74025300000001,7.088728999999999
46255,2017,Octubre,Venezuela,1,7,,8,-73.181317,7.1280470000000005
46256,2017,Octubre,Venezuela,22981,28522,,51503,-72.453013,7.819
46257,2017,Octubre,Venezuela,4,65,,69,-72.508188,7.927233
46258,2017,Octubre,Venezuela,665,747,,1412,-72.409396,8.36068
46259,2017,Octubre,Venezuela,0,7,,7,-75.68164200000001,9.402597
46783,2017,Noviembre,Venezuela,0,4,,4,-75.527794,10.406342
46784,2017,Noviembre,Venezuela,4,16,,20,-75.516486,10.446304
46785,2017,Noviembre,Venezuela,19,78,,97,-74.77647900000001,10.886686
46786,2017,Noviembre,Venezuela,0,1,,1,-74.765343,10.970933
46787,2017,Noviembre,Venezuela,0,6,,6,-74.232675,11.117206
46788,2017,Noviembre,Venezuela,6550,7478,,14028,-72.129595,11.360028999999999
46789,2017,Noviembre,Venezuela,4,14,,18,-72.919186,11.52863
46790,2017,Noviembre,Venezuela,2,0,,2,-81.70216500000001,12.5862
46791,2017,Noviembre,Venezuela,29,52,,81,-76.532004,3.451668
46792,2017,Noviembre,Venezuela,15,14,,29,-67.927521,3.866713
46793,2017,Noviembre,Venezuela,2667,2949,,5616,-74.140516,4.697157
46794,2017,Noviembre,Venezuela,3,6,,9,-75.736374,4.815189
46795,2017,Noviembre,Venezuela,575,612,,1187,-75.42726,6.170465
46796,2017,Noviembre,Venezuela,53,47,,100,-67.48402800000001,6.185536
46797,2017,Noviembre,Venezuela,1,7,,8,-75.586989,6.2188349999999994
46798,2017,Noviembre,Venezuela,262,298,,560,-70.74025300000001,7.088728999999999
46799,2017,Noviembre,Venezuela,3,4,,7,-73.181317,7.1280470000000005
46800,2017,Noviembre,Venezuela,27470,33868,,61338,-72.453013,7.819
46801,2017,Noviembre,Venezuela,3,19,,22,-72.508188,7.927233
46802,2017,Noviembre,Venezuela,846,905,,1751,-72.409396,8.36068
47360,2017,Diciembre,Venezuela,0,5,,5,-75.527794,10.406342
47361,2017,Diciembre,Venezuela,28,40,,68,-75.516486,10.446304
47362,2017,Diciembre,Venezuela,16,63,,79,-74.77647900000001,10.886686
47363,2017,Diciembre,Venezuela,0,4,,4,-74.765343,10.970933
47364,2017,Diciembre,Venezuela,2,2,,4,-74.232675,11.117206
47365,2017,Diciembre,Venezuela,7412,7323,,14735,-72.129595,11.360028999999999
47366,2017,Diciembre,Venezuela,9,10,,19,-72.919186,11.52863
47367,2017,Diciembre,Venezuela,32,46,,78,-76.532004,3.451668
47368,2017,Diciembre,Venezuela,12,9,,21,-67.927521,3.866713
47369,2017,Diciembre,Venezuela,3981,3648,,7629,-74.140516,4.697157
47370,2017,Diciembre,Venezuela,1,3,,4,-75.736374,4.815189
47371,2017,Diciembre,Venezuela,847,806,,1653,-75.42726,6.170465
47372,2017,Diciembre,Venezuela,26,30,,56,-67.48402800000001,6.185536
47373,2017,Diciembre,Venezuela,1,2,,3,-75.586989,6.2188349999999994
47374,2017,Diciembre,Venezuela,369,403,,772,-70.74025300000001,7.088728999999999
47375,2017,Diciembre,Venezuela,5,12,,17,-73.181317,7.1280470000000005
47376,2017,Diciembre,Venezuela,32717,35264,,67981,-72.453013,7.819
47377,2017,Diciembre,Venezuela,8,8,,16,-72.508188,7.927233
47378,2017,Diciembre,Venezuela,1452,1354,,2806,-72.409396,8.36068
48501,2018,Enero,Venezuela,5,3,,8,-69.941498,4.191162
48502,2018,Enero,Venezuela,0,1,,1,-69.94143100000001,4.214082
48503,2018,Enero,Venezuela,24,24,,48,-76.876446,0.33002
48504,2018,Enero,Venezuela,2200,2314,,4514,-77.35600000000001,0.81488
48505,2018,Enero,Venezuela,0,1,,1,-78.802679,18.00143
48506,2018,Enero,Venezuela,11,21,,32,-75.527794,10.406342
48507,2018,Enero,Venezuela,214,332,,546,-75.516486,10.446304
48508,2018,Enero,Venezuela,128,212,,340,-74.77647900000001,10.886686
48509,2018,Enero,Venezuela,0,2,,2,-74.765343,10.970933
48510,2018,Enero,Venezuela,6,32,,38,-74.232675,11.117206
48511,2018,Enero,Venezuela,7809,10209,,18018,-72.129595,11.360028999999999
48512,2018,Enero,Venezuela,7,2,,9,-72.919186,11.52863
48513,2018,Enero,Venezuela,0,3,,3,-71.983761,12.165168
48514,2018,Enero,Venezuela,2,1,,3,-81.70216500000001,12.5862
48515,2018,Enero,Venezuela,108,134,,242,-76.532004,3.451668
48516,2018,Enero,Venezuela,3,8,,11,-67.927521,3.866713
48517,2018,Enero,Venezuela,4,2,,6,-75.76635300000001,4.45285
48518,2018,Enero,Venezuela,7073,6646,,13719,-74.140516,4.697157
48519,2018,Enero,Venezuela,13,18,,31,-75.736374,4.815189
48520,2018,Enero,Venezuela,980,1123,,2103,-75.42726,6.170465
48521,2018,Enero,Venezuela,25,35,,60,-67.48402800000001,6.185536
48522,2018,Enero,Venezuela,405,571,,976,-70.74025300000001,7.088728999999999
48523,2018,Enero,Venezuela,13,16,,29,-73.181317,7.1280470000000005
48524,2018,Enero,Venezuela,33395,47879,,81274,-72.453013,7.819
48525,2018,Enero,Venezuela,5,15,,20,-72.508188,7.927233
48526,2018,Enero,Venezuela,2086,2853,,4939,-72.409396,8.36068
48527,2018,Enero,Venezuela,3,1,,4,-77.35002,8.63337
49625,2018,Febrero,Venezuela,2,15,,17,-69.941498,4.191162
49626,2018,Febrero,Venezuela,1,5,,6,-69.94143100000001,4.214082
49627,2018,Febrero,Venezuela,24,30,,54,-76.876446,0.33002
49628,2018,Febrero,Venezuela,0,1,,1,-77.84700600000001,0.8124359999999999
49629,2018,Febrero,Venezuela,1465,1736,,3201,-77.35600000000001,0.81488
49630,2018,Febrero,Venezuela,1,0,,1,-78.802679,18.00143
49631,2018,Febrero,Venezuela,9,8,,17,-75.527794,10.406342
49632,2018,Febrero,Venezuela,156,229,,385,-75.516486,10.446304
49633,2018,Febrero,Venezuela,117,188,,305,-74.77647900000001,10.886686
49634,2018,Febrero,Venezuela,28,62,,90,-74.232675,11.117206
49635,2018,Febrero,Venezuela,10064,12466,,22530,-72.129595,11.360028999999999
49636,2018,Febrero,Venezuela,0,3,,3,-72.919186,11.52863
49637,2018,Febrero,Venezuela,1,4,,5,-71.983761,12.165168
49638,2018,Febrero,Venezuela,84,138,,222,-76.532004,3.451668
49639,2018,Febrero,Venezuela,14,8,,22,-67.927521,3.866713
49640,2018,Febrero,Venezuela,2,2,,4,-75.76635300000001,4.45285
49641,2018,Febrero,Venezuela,5009,5257,,10266,-74.140516,4.697157
49642,2018,Febrero,Venezuela,6,5,,11,-75.736374,4.815189
49643,2018,Febrero,Venezuela,742,818,,1560,-75.42726,6.170465
49644,2018,Febrero,Venezuela,41,37,,78,-67.48402800000001,6.185536
49645,2018,Febrero,Venezuela,0,3,,3,-75.586989,6.2188349999999994
49646,2018,Febrero,Venezuela,756,1076,,1832,-70.74025300000001,7.088728999999999
49647,2018,Febrero,Venezuela,14,12,,26,-73.181317,7.1280470000000005
49648,2018,Febrero,Venezuela,34568,48041,,82609,-72.453013,7.819
49649,2018,Febrero,Venezuela,3,13,,16,-72.508188,7.927233
49650,2018,Febrero,Venezuela,2447,2963,,5410,-72.409396,8.36068
50798,2018,Marzo,Venezuela,3,3,,6,-69.941498,4.191162
50799,2018,Marzo,Venezuela,1,1,,2,-69.94143100000001,4.214082
50800,2018,Marzo,Venezuela,20,32,,52,-76.876446,0.33002
50801,2018,Marzo,Venezuela,2,1,,3,-77.84700600000001,0.8124359999999999
50802,2018,Marzo,Venezuela,1552,2092,,3644,-77.35600000000001,0.81488
50803,2018,Marzo,Venezuela,1,2,,3,-78.802679,18.00143
50804,2018,Marzo,Venezuela,17,14,,31,-75.527794,10.406342
50805,2018,Marzo,Venezuela,172,191,,363,-75.516486,10.446304
50806,2018,Marzo,Venezuela,116,191,,307,-74.77647900000001,10.886686
50807,2018,Marzo,Venezuela,0,5,,5,-74.765343,10.970933
50808,2018,Marzo,Venezuela,9,21,,30,-74.232675,11.117206
50809,2018,Marzo,Venezuela,8988,10090,,19078,-72.129595,11.360028999999999
50810,2018,Marzo,Venezuela,0,1,,1,-72.919186,11.52863
50811,2018,Marzo,Venezuela,0,8,,8,-71.983761,12.165168
50812,2018,Marzo,Venezuela,3,1,,4,-81.70216500000001,12.5862
50813,2018,Marzo,Venezuela,0,1,,1,-81.372937,13.338761300000002
50814,2018,Marzo,Venezuela,101,109,,210,-76.532004,3.451668
50815,2018,Marzo,Venezuela,10,15,,25,-67.927521,3.866713
50816,2018,Marzo,Venezuela,3,1,,4,-75.76635300000001,4.45285
50817,2018,Marzo,Venezuela,5215,5546,,10761,-74.140516,4.697157
50818,2018,Marzo,Venezuela,9,9,,18,-75.736374,4.815189
50819,2018,Marzo,Venezuela,883,896,,1779,-75.42726,6.170465
50820,2018,Marzo,Venezuela,53,64,,117,-67.48402800000001,6.185536
50821,2018,Marzo,Venezuela,892,1080,,1972,-70.74025300000001,7.088728999999999
50822,2018,Marzo,Venezuela,6,17,,23,-73.181317,7.1280470000000005
50823,2018,Marzo,Venezuela,32599,41798,,74397,-72.453013,7.819
50824,2018,Marzo,Venezuela,0,6,,6,-72.508188,7.927233
50825,2018,Marzo,Venezuela,2618,2992,,5610,-72.409396,8.36068
51904,2018,Abril,Venezuela,1,6,,7,-69.941498,4.191162
51905,2018,Abril,Venezuela,39,51,,90,-76.876446,0.33002
51906,2018,Abril,Venezuela,6,1,,7,-77.84700600000001,0.8124359999999999
51907,2018,Abril,Venezuela,1590,2241,,3831,-77.35600000000001,0.81488
51908,2018,Abril,Venezuela,1,3,,4,-78.802679,18.00143
51909,2018,Abril,Venezuela,7,36,,43,-75.527794,10.406342
51910,2018,Abril,Venezuela,15,35,,50,-73.247863,10.433608999999999
51911,2018,Abril,Venezuela,114,155,,269,-75.516486,10.446304
51912,2018,Abril,Venezuela,92,165,,257,-74.77647900000001,10.886686
51913,2018,Abril,Venezuela,8,19,,27,-74.232675,11.117206
51914,2018,Abril,Venezuela,8482,9745,,18227,-72.129595,11.360028999999999
51915,2018,Abril,Venezuela,6,6,,12,-72.919186,11.52863
51916,2018,Abril,Venezuela,4,1,,5,-81.70216500000001,12.5862
51917,2018,Abril,Venezuela,64,98,,162,-76.532004,3.451668
51918,2018,Abril,Venezuela,11,10,,21,-67.927521,3.866713
51919,2018,Abril,Venezuela,0,1,,1,-75.76635300000001,4.45285
51920,2018,Abril,Venezuela,5750,6043,,11793,-74.140516,4.697157
51921,2018,Abril,Venezuela,7,7,,14,-75.736374,4.815189
51922,2018,Abril,Venezuela,1446,1683,,3129,-75.42726,6.170465
51923,2018,Abril,Venezuela,73,48,,121,-67.48402800000001,6.185536
51924,2018,Abril,Venezuela,4,10,,14,-75.586989,6.2188349999999994
51925,2018,Abril,Venezuela,896,1176,,2072,-70.74025300000001,7.088728999999999
51926,2018,Abril,Venezuela,25,31,,56,-73.181317,7.1280470000000005
51927,2018,Abril,Venezuela,34810,42529,,77339,-72.453013,7.819
51928,2018,Abril,Venezuela,12,25,,37,-72.508188,7.927233
51929,2018,Abril,Venezuela,2660,2901,,5561,-72.409396,8.36068
53004,2018,Mayo,Venezuela,0,6,,6,-69.941498,4.191162
53005,2018,Mayo,Venezuela,2,3,,5,-69.94143100000001,4.214082
53006,2018,Mayo,Venezuela,54,51,,105,-76.876446,0.33002
53007,2018,Mayo,Venezuela,0,2,,2,-77.84700600000001,0.8124359999999999
53008,2018,Mayo,Venezuela,1759,2426,,4185,-77.35600000000001,0.81488
53009,2018,Mayo,Venezuela,3,0,,3,-78.802679,18.00143
53010,2018,Mayo,Venezuela,4,3,,7,-75.527794,10.406342
53011,2018,Mayo,Venezuela,150,196,,346,-75.516486,10.446304
53012,2018,Mayo,Venezuela,109,205,,314,-74.77647900000001,10.886686
53013,2018,Mayo,Venezuela,0,2,,2,-74.213989,11.247722999999999
53014,2018,Mayo,Venezuela,7143,8040,,15183,-72.129595,11.360028999999999
53015,2018,Mayo,Venezuela,6,5,,11,-72.919186,11.52863
53016,2018,Mayo,Venezuela,0,31,,31,-71.983761,12.165168
53017,2018,Mayo,Venezuela,8,3,,11,-81.70216500000001,12.5862
53018,2018,Mayo,Venezuela,72,107,,179,-76.532004,3.451668
53019,2018,Mayo,Venezuela,11,20,,31,-67.927521,3.866713
53020,2018,Mayo,Venezuela,6278,6305,,12583,-74.140516,4.697157
53021,2018,Mayo,Venezuela,8,24,,32,-75.736374,4.815189
53022,2018,Mayo,Venezuela,1195,1319,,2514,-75.42726,6.170465
53023,2018,Mayo,Venezuela,72,64,,136,-67.48402800000001,6.185536
53024,2018,Mayo,Venezuela,874,1013,,1887,-70.74025300000001,7.088728999999999
53025,2018,Mayo,Venezuela,23,16,,39,-73.181317,7.1280470000000005
53026,2018,Mayo,Venezuela,33579,37933,,71512,-72.453013,7.819
53027,2018,Mayo,Venezuela,4,7,,11,-72.508188,7.927233
53028,2018,Mayo,Venezuela,2583,2689,,5272,-72.409396,8.36068
54081,2018,Junio,Venezuela,3,6,,9,-69.941498,4.191162
54082,2018,Junio,Venezuela,2,6,,8,-69.94143100000001,4.214082
54083,2018,Junio,Venezuela,45,53,,98,-76.876446,0.33002
54084,2018,Junio,Venezuela,1,0,,1,-77.84700600000001,0.8124359999999999
54085,2018,Junio,Venezuela,1966,2434,,4400,-77.35600000000001,0.81488
54086,2018,Junio,Venezuela,2,3,,5,-78.802679,18.00143
54087,2018,Junio,Venezuela,11,61,,72,-75.527794,10.406342
54088,2018,Junio,Venezuela,168,275,,443,-75.516486,10.446304
54089,2018,Junio,Venezuela,98,183,,281,-74.77647900000001,10.886686
54090,2018,Junio,Venezuela,0,3,,3,-74.765343,10.970933
54091,2018,Junio,Venezuela,3,1,,4,-74.232675,11.117206
54092,2018,Junio,Venezuela,1,0,,1,-74.213989,11.247722999999999
54093,2018,Junio,Venezuela,6375,7289,,13664,-72.129595,11.360028999999999
54094,2018,Junio,Venezuela,1,2,,3,-71.983761,12.165168
54095,2018,Junio,Venezuela,0,1,,1,-81.703935,12.574411099999999
54096,2018,Junio,Venezuela,2,5,,7,-81.70216500000001,12.5862
54097,2018,Junio,Venezuela,90,123,,213,-76.532004,3.451668
54098,2018,Junio,Venezuela,7,19,,26,-67.927521,3.866713
54099,2018,Junio,Venezuela,5151,5393,,10544,-74.140516,4.697157
54100,2018,Junio,Venezuela,8,7,,15,-75.736374,4.815189
54101,2018,Junio,Venezuela,849,829,,1678,-75.42726,6.170465
54102,2018,Junio,Venezuela,54,60,,114,-67.48402800000001,6.185536
54103,2018,Junio,Venezuela,740,911,,1651,-70.74025300000001,7.088728999999999
54104,2018,Junio,Venezuela,14,17,,31,-73.181317,7.1280470000000005
54105,2018,Junio,Venezuela,26710,29983,,56693,-72.453013,7.819
54106,2018,Junio,Venezuela,4,14,,18,-72.508188,7.927233
54107,2018,Junio,Venezuela,2270,2189,,4459,-72.409396,8.36068
54108,2018,Junio,Venezuela,0,1,,1,-77.35002,8.63337
55238,2018,Julio,Venezuela,0,1,,1,-69.941498,4.191162
55239,2018,Julio,Venezuela,4,0,,4,-69.94143100000001,4.214082
55240,2018,Julio,Venezuela,0,1,,1,-74.78366,0.18595699999999998
55241,2018,Julio,Venezuela,64,65,,129,-76.876446,0.33002
55242,2018,Julio,Venezuela,2566,3150,,5716,-77.35600000000001,0.81488
55243,2018,Julio,Venezuela,3,5,,8,-78.802679,18.00143
55244,2018,Julio,Venezuela,13,13,,26,-75.527794,10.406342
55245,2018,Julio,Venezuela,276,361,,637,-75.516486,10.446304
55246,2018,Julio,Venezuela,306,586,,892,-74.77647900000001,10.886686
55247,2018,Julio,Venezuela,1,3,,4,-74.232675,11.117206
55248,2018,Julio,Venezuela,1,0,,1,-74.213989,11.247722999999999
55249,2018,Julio,Venezuela,8805,8320,,17125,-72.129595,11.360028999999999
55250,2018,Julio,Venezuela,0,15,,15,-71.983761,12.165168
55251,2018,Julio,Venezuela,10,5,,15,-81.70216500000001,12.5862
55252,2018,Julio,Venezuela,146,175,,321,-76.532004,3.451668
55253,2018,Julio,Venezuela,14,12,,26,-67.927521,3.866713
55254,2018,Julio,Venezuela,1,0,,1,-75.76635300000001,4.45285
55255,2018,Julio,Venezuela,5395,5389,,10784,-74.140516,4.697157
55256,2018,Julio,Venezuela,9,16,,25,-75.736374,4.815189
55257,2018,Julio,Venezuela,871,896,,1767,-75.42726,6.170465
55258,2018,Julio,Venezuela,44,31,,75,-67.48402800000001,6.185536
55259,2018,Julio,Venezuela,3,4,,7,-75.586989,6.2188349999999994
55260,2018,Julio,Venezuela,1139,1266,,2405,-70.74025300000001,7.088728999999999
55261,2018,Julio,Venezuela,12,7,,19,-73.181317,7.1280470000000005
55262,2018,Julio,Venezuela,36362,36633,,72995,-72.453013,7.819
55263,2018,Julio,Venezuela,1,3,,4,-72.508188,7.927233
55264,2018,Julio,Venezuela,3675,3143,,6818,-72.409396,8.36068
56360,2018,Agosto,Venezuela,1,0,,1,-74.140516,4.697157
56361,2018,Agosto,Venezuela,5,8,,13,-69.941498,4.191162
56362,2018,Agosto,Venezuela,0,1,,1,-69.94143100000001,4.214082
56363,2018,Agosto,Venezuela,128,154,,282,-76.876446,0.33002
56364,2018,Agosto,Venezuela,3,3,,6,-77.84700600000001,0.8124359999999999
56365,2018,Agosto,Venezuela,2513,3169,,5682,-77.35600000000001,0.81488
56366,2018,Agosto,Venezuela,5,1,,6,-78.802679,18.00143
56367,2018,Agosto,Venezuela,18,29,,47,-75.527794,10.406342
56368,2018,Agosto,Venezuela,206,227,,433,-75.516486,10.446304
56369,2018,Agosto,Venezuela,136,209,,345,-74.77647900000001,10.886686
56370,2018,Agosto,Venezuela,0,8,,8,-74.232675,11.117206
56371,2018,Agosto,Venezuela,0,1,,1,-74.213989,11.247722999999999
56372,2018,Agosto,Venezuela,10940,9426,,20366,-72.129595,11.360028999999999
56373,2018,Agosto,Venezuela,1,34,,35,-71.983761,12.165168
56374,2018,Agosto,Venezuela,6,4,,10,-81.70216500000001,12.5862
56375,2018,Agosto,Venezuela,111,145,,256,-76.532004,3.451668
56376,2018,Agosto,Venezuela,7,4,,11,-67.927521,3.866713
56377,2018,Agosto,Venezuela,1,5,,6,-75.76635300000001,4.45285
56378,2018,Agosto,Venezuela,6062,6254,,12316,-74.140516,4.697157
56379,2018,Agosto,Venezuela,16,18,,34,-75.736374,4.815189
56380,2018,Agosto,Venezuela,1017,973,,1990,-75.42726,6.170465
56381,2018,Agosto,Venezuela,34,33,,67,-67.48402800000001,6.185536
56382,2018,Agosto,Venezuela,1625,1634,,3259,-70.74025300000001,7.088728999999999
56383,2018,Agosto,Venezuela,9,5,,14,-73.181317,7.1280470000000005
56384,2018,Agosto,Venezuela,38931,35940,,74871,-72.453013,7.819
56385,2018,Agosto,Venezuela,5,8,,13,-72.508188,7.927233
56386,2018,Agosto,Venezuela,4649,3773,,8422,-72.409396,8.36068
57414,2018,Septiembre,Venezuela,1,2,,3,-69.941498,4.191162
57415,2018,Septiembre,Venezuela,2,3,,5,-69.94143100000001,4.214082
57416,2018,Septiembre,Venezuela,0,1,,1,-74.78366,0.18595699999999998
57417,2018,Septiembre,Venezuela,58,98,,156,-76.876446,0.33002
57418,2018,Septiembre,Venezuela,3492,4012,,7504,-77.35600000000001,0.81488
57419,2018,Septiembre,Venezuela,2,1,,3,-78.802679,18.00143
57420,2018,Septiembre,Venezuela,16,28,,44,-75.527794,10.406342
57421,2018,Septiembre,Venezuela,203,225,,428,-75.516486,10.446304
57422,2018,Septiembre,Venezuela,116,180,,296,-74.77647900000001,10.886686
57423,2018,Septiembre,Venezuela,0,2,,2,-74.232675,11.117206
57424,2018,Septiembre,Venezuela,7874,7088,,14962,-72.129595,11.360028999999999
57425,2018,Septiembre,Venezuela,0,11,,11,-71.983761,12.165168
57426,2018,Septiembre,Venezuela,3,5,,8,-81.70216500000001,12.5862
57427,2018,Septiembre,Venezuela,118,124,,242,-76.532004,3.451668
57428,2018,Septiembre,Venezuela,5,9,,14,-67.927521,3.866713
57429,2018,Septiembre,Venezuela,3,3,,6,-75.76635300000001,4.45285
57430,2018,Septiembre,Venezuela,6755,6815,,13570,-74.140516,4.697157
57431,2018,Septiembre,Venezuela,8,12,,20,-75.736374,4.815189
57432,2018,Septiembre,Venezuela,839,955,,1794,-75.42726,6.170465
57433,2018,Septiembre,Venezuela,59,41,,100,-67.48402800000001,6.185536
57434,2018,Septiembre,Venezuela,0,4,,4,-75.586989,6.2188349999999994
57435,2018,Septiembre,Venezuela,1063,1037,,2100,-70.74025300000001,7.088728999999999
57436,2018,Septiembre,Venezuela,11,16,,27,-73.181317,7.1280470000000005
57437,2018,Septiembre,Venezuela,27880,24472,,52352,-72.453013,7.819
57438,2018,Septiembre,Venezuela,2703,2291,,4994,-72.409396,8.36068
58463,2018,Octubre,Venezuela,4,10,,14,-69.941498,4.191162
58464,2018,Octubre,Venezuela,0,1,,1,-69.94143100000001,4.214082
58465,2018,Octubre,Venezuela,0,1,,1,-74.78366,0.18595699999999998
58466,2018,Octubre,Venezuela,92,94,,186,-76.876446,0.33002
58467,2018,Octubre,Venezuela,4276,4900,,9176,-77.35600000000001,0.81488
58468,2018,Octubre,Venezuela,5,2,,7,-78.802679,18.00143
58469,2018,Octubre,Venezuela,5,7,,12,-75.527794,10.406342
58470,2018,Octubre,Venezuela,173,175,,348,-75.516486,10.446304
58471,2018,Octubre,Venezuela,135,232,,367,-74.77647900000001,10.886686
58472,2018,Octubre,Venezuela,4,11,,15,-74.232675,11.117206
58473,2018,Octubre,Venezuela,0,5,,5,-74.213989,11.247722999999999
58474,2018,Octubre,Venezuela,7230,6377,,13607,-72.129595,11.360028999999999
58475,2018,Octubre,Venezuela,1,6,,7,-81.70216500000001,12.5862
58476,2018,Octubre,Venezuela,94,133,,227,-76.532004,3.451668
58477,2018,Octubre,Venezuela,17,22,,39,-67.927521,3.866713
58478,2018,Octubre,Venezuela,1,2,,3,-75.76635300000001,4.45285
58479,2018,Octubre,Venezuela,6722,6937,,13659,-74.140516,4.697157
58480,2018,Octubre,Venezuela,8,14,,22,-75.736374,4.815189
58481,2018,Octubre,Venezuela,740,823,,1563,-75.42726,6.170465
58482,2018,Octubre,Venezuela,55,48,,103,-67.48402800000001,6.185536
58483,2018,Octubre,Venezuela,1280,1311,,2591,-70.74025300000001,7.088728999999999
58484,2018,Octubre,Venezuela,16,13,,29,-73.181317,7.1280470000000005
58485,2018,Octubre,Venezuela,33390,28140,,61530,-72.453013,7.819
58486,2018,Octubre,Venezuela,4,11,,15,-72.508188,7.927233
58487,2018,Octubre,Venezuela,2794,2333,,5127,-72.409396,8.36068
59621,2018,Noviembre,Venezuela,4,6,,10,-69.941498,4.191162
59622,2018,Noviembre,Venezuela,1,1,,2,-69.94143100000001,4.214082
59623,2018,Noviembre,Venezuela,98,83,,181,-76.876446,0.33002
59624,2018,Noviembre,Venezuela,3,0,,3,-77.84700600000001,0.8124359999999999
59625,2018,Noviembre,Venezuela,4814,5704,,10518,-77.35600000000001,0.81488
59626,2018,Noviembre,Venezuela,5,2,,7,-78.802679,18.00143
59627,2018,Noviembre,Venezuela,19,37,,56,-75.527794,10.406342
59628,2018,Noviembre,Venezuela,231,249,,480,-75.516486,10.446304
59629,2018,Noviembre,Venezuela,104,171,,275,-74.77647900000001,10.886686
59630,2018,Noviembre,Venezuela,0,3,,3,-74.765343,10.970933
59631,2018,Noviembre,Venezuela,1,7,,8,-74.232675,11.117206
59632,2018,Noviembre,Venezuela,0,1,,1,-74.213989,11.247722999999999
59633,2018,Noviembre,Venezuela,6182,5413,,11595,-72.129595,11.360028999999999
59634,2018,Noviembre,Venezuela,0,1,,1,-72.919186,11.52863
59635,2018,Noviembre,Venezuela,0,1,,1,-81.703935,12.574411099999999
59636,2018,Noviembre,Venezuela,9,5,,14,-81.70216500000001,12.5862
59637,2018,Noviembre,Venezuela,100,130,,230,-76.532004,3.451668
59638,2018,Noviembre,Venezuela,31,16,,47,-67.927521,3.866713
59639,2018,Noviembre,Venezuela,1,0,,1,-75.76635300000001,4.45285
59640,2018,Noviembre,Venezuela,7314,7513,,14827,-74.140516,4.697157
59641,2018,Noviembre,Venezuela,8,14,,22,-75.736374,4.815189
59642,2018,Noviembre,Venezuela,911,927,,1838,-75.42726,6.170465
59643,2018,Noviembre,Venezuela,63,48,,111,-67.48402800000001,6.185536
59644,2018,Noviembre,Venezuela,1078,1011,,2089,-70.74025300000001,7.088728999999999
59645,2018,Noviembre,Venezuela,19,26,,45,-73.181317,7.1280470000000005
59646,2018,Noviembre,Venezuela,24218,19495,,43713,-72.453013,7.819
59647,2018,Noviembre,Venezuela,1,6,,7,-72.508188,7.927233
59648,2018,Noviembre,Venezuela,3083,2265,,5348,-72.409396,8.36068
60793,2018,Diciembre,Venezuela,7,8,,15,-69.941498,4.191162
60794,2018,Diciembre,Venezuela,6,5,,11,-69.94143100000001,4.214082
60795,2018,Diciembre,Venezuela,0,1,,1,-74.78366,0.18595699999999998
60796,2018,Diciembre,Venezuela,135,143,,278,-76.876446,0.33002
60797,2018,Diciembre,Venezuela,7788,9551,,17339,-77.35600000000001,0.81488
60798,2018,Diciembre,Venezuela,2,1,,3,-78.802679,18.00143
60799,2018,Diciembre,Venezuela,27,30,,57,-75.527794,10.406342
60800,2018,Diciembre,Venezuela,259,252,,511,-75.516486,10.446304
60801,2018,Diciembre,Venezuela,198,277,,475,-74.77647900000001,10.886686
60802,2018,Diciembre,Venezuela,1,1,,2,-74.765343,10.970933
60803,2018,Diciembre,Venezuela,4,14,,18,-74.232675,11.117206
60804,2018,Diciembre,Venezuela,1,0,,1,-74.213989,11.247722999999999
60805,2018,Diciembre,Venezuela,7020,5683,,12703,-72.129595,11.360028999999999
60806,2018,Diciembre,Venezuela,5,4,,9,-81.70216500000001,12.5862
60807,2018,Diciembre,Venezuela,338,336,,674,-76.532004,3.451668
60808,2018,Diciembre,Venezuela,23,13,,36,-67.927521,3.866713
60809,2018,Diciembre,Venezuela,4,2,,6,-75.76635300000001,4.45285
60810,2018,Diciembre,Venezuela,9164,9008,,18172,-74.140516,4.697157
60811,2018,Diciembre,Venezuela,9,24,,33,-75.736374,4.815189
60812,2018,Diciembre,Venezuela,1224,1157,,2381,-75.42726,6.170465
60813,2018,Diciembre,Venezuela,73,56,,129,-67.48402800000001,6.185536
60814,2018,Diciembre,Venezuela,1083,977,,2060,-70.74025300000001,7.088728999999999
60815,2018,Diciembre,Venezuela,17,39,,56,-73.181317,7.1280470000000005
60816,2018,Diciembre,Venezuela,26412,19223,,45635,-72.453013,7.819
60817,2018,Diciembre,Venezuela,2,19,,21,-72.508188,7.927233
60818,2018,Diciembre,Venezuela,3622,2408,,6030,-72.409396,8.36068
60819,2018,Diciembre,Venezuela,0,1,,1,-77.35002,8.63337
61998,2019,Enero,Venezuela,9,4,,13,-69.941498,4.191162
61999,2019,Enero,Venezuela,1,2,,3,-69.94143100000001,4.214082
62000,2019,Enero,Venezuela,103,83,,186,-76.876446,0.33002
62001,2019,Enero,Venezuela,3,4,,7,-77.84700600000001,0.8124359999999999
62002,2019,Enero,Venezuela,4952,4762,,9714,-77.35600000000001,0.81488
62003,2019,Enero,Venezuela,5,2,,7,-78.802679,18.00143
62004,2019,Enero,Venezuela,32,48,,80,-75.527794,10.406342
62005,2019,Enero,Venezuela,189,205,,394,-75.516486,10.446304
62006,2019,Enero,Venezuela,171,219,,390,-74.77647900000001,10.886686
62007,2019,Enero,Venezuela,0,1,,1,-74.765343,10.970933
62008,2019,Enero,Venezuela,9,7,,16,-74.232675,11.117206
62009,2019,Enero,Venezuela,5527,5326,,10853,-72.129595,11.360028999999999
62010,2019,Enero,Venezuela,0,2,,2,-71.983761,12.165168
62011,2019,Enero,Venezuela,7,2,,9,-81.70216500000001,12.5862
62012,2019,Enero,Venezuela,299,348,,647,-76.532004,3.451668
62013,2019,Enero,Venezuela,25,30,,55,-67.927521,3.866713
62014,2019,Enero,Venezuela,3,2,,5,-75.76635300000001,4.45285
62015,2019,Enero,Venezuela,8371,7406,,15777,-74.140516,4.697157
62016,2019,Enero,Venezuela,24,23,,47,-75.736374,4.815189
62017,2019,Enero,Venezuela,874,870,,1744,-75.42726,6.170465
62018,2019,Enero,Venezuela,49,31,,80,-67.48402800000001,6.185536
62019,2019,Enero,Venezuela,1,7,,8,-75.586989,6.2188349999999994
62020,2019,Enero,Venezuela,1159,1108,,2267,-70.74025300000001,7.088728999999999
62021,2019,Enero,Venezuela,18,21,,39,-73.181317,7.1280470000000005
62022,2019,Enero,Venezuela,23014,21954,,44968,-72.453013,7.819
62023,2019,Enero,Venezuela,2,9,,11,-72.508188,7.927233
62024,2019,Enero,Venezuela,2331,2061,,4392,-72.409396,8.36068
62025,2019,Enero,Venezuela,0,1,,1,-75.68164200000001,9.402597
63188,2019,Febrero,Venezuela,2,6,,8,-69.941498,4.191162
63189,2019,Febrero,Venezuela,2,1,,3,-69.94143100000001,4.214082
63190,2019,Febrero,Venezuela,0,1,,1,-74.78366,0.18595699999999998
63191,2019,Febrero,Venezuela,49,67,,116,-76.876446,0.33002
63192,2019,Febrero,Venezuela,3526,3604,,7130,-77.35600000000001,0.81488
63193,2019,Febrero,Venezuela,1,0,,1,-78.802679,18.00143
63194,2019,Febrero,Venezuela,22,19,,41,-75.527794,10.406342
63195,2019,Febrero,Venezuela,246,289,,535,-75.516486,10.446304
63196,2019,Febrero,Venezuela,119,158,,277,-74.77647900000001,10.886686
63197,2019,Febrero,Venezuela,0,1,,1,-74.765343,10.970933
63198,2019,Febrero,Venezuela,3,8,,11,-74.232675,11.117206
63199,2019,Febrero,Venezuela,4402,4160,,8562,-72.129595,11.360028999999999
63200,2019,Febrero,Venezuela,0,1,,1,-71.983761,12.165168
63201,2019,Febrero,Venezuela,5,2,,7,-81.70216500000001,12.5862
63202,2019,Febrero,Venezuela,238,275,,513,-76.532004,3.451668
63203,2019,Febrero,Venezuela,23,17,,40,-67.927521,3.866713
63204,2019,Febrero,Venezuela,6000,5983,,11983,-74.140516,4.697157
63205,2019,Febrero,Venezuela,19,15,,34,-75.736374,4.815189
63206,2019,Febrero,Venezuela,781,790,,1571,-75.42726,6.170465
63207,2019,Febrero,Venezuela,39,30,,69,-67.48402800000001,6.185536
63208,2019,Febrero,Venezuela,662,603,,1265,-70.74025300000001,7.088728999999999
63209,2019,Febrero,Venezuela,12,12,,24,-73.181317,7.1280470000000005
63210,2019,Febrero,Venezuela,20665,17554,,38219,-72.453013,7.819
63211,2019,Febrero,Venezuela,18,40,,58,-72.508188,7.927233
63212,2019,Febrero,Venezuela,1636,1283,,2919,-72.409396,8.36068
64331,2019,Marzo,Venezuela,2,2,,4,-69.941498,4.191162
64332,2019,Marzo,Venezuela,4,4,,8,-69.94143100000001,4.214082
64333,2019,Marzo,Venezuela,58,64,,122,-76.876446,0.33002
64334,2019,Marzo,Venezuela,1,1,,2,-77.84700600000001,0.8124359999999999
64335,2019,Marzo,Venezuela,3262,3451,,6713,-77.35600000000001,0.81488
64336,2019,Marzo,Venezuela,0,16,,16,-78.802679,18.00143
64337,2019,Marzo,Venezuela,19,35,,54,-75.527794,10.406342
64338,2019,Marzo,Venezuela,251,336,,587,-75.516486,10.446304
64339,2019,Marzo,Venezuela,250,388,,638,-74.77647900000001,10.886686
64340,2019,Marzo,Venezuela,0,7,,7,-74.765343,10.970933
64341,2019,Marzo,Venezuela,40,95,,135,-74.232675,11.117206
64342,2019,Marzo,Venezuela,0,6,,6,-74.213989,11.247722999999999
64343,2019,Marzo,Venezuela,6165,5155,,11320,-72.129595,11.360028999999999
64344,2019,Marzo,Venezuela,0,2,,2,-71.983761,12.165168
64345,2019,Marzo,Venezuela,5,7,,12,-81.70216500000001,12.5862
64346,2019,Marzo,Venezuela,217,250,,467,-76.532004,3.451668
64347,2019,Marzo,Venezuela,6,7,,13,-67.927521,3.866713
64348,2019,Marzo,Venezuela,1,2,,3,-75.76635300000001,4.45285
64349,2019,Marzo,Venezuela,7513,7329,,14842,-74.140516,4.697157
64350,2019,Marzo,Venezuela,6,17,,23,-75.736374,4.815189
64351,2019,Marzo,Venezuela,934,1173,,2107,-75.42726,6.170465
64352,2019,Marzo,Venezuela,27,31,,58,-67.48402800000001,6.185536
64353,2019,Marzo,Venezuela,2,1,,3,-75.586989,6.2188349999999994
64354,2019,Marzo,Venezuela,349,311,,660,-70.74025300000001,7.088728999999999
64355,2019,Marzo,Venezuela,13,15,,28,-73.181317,7.1280470000000005
64356,2019,Marzo,Venezuela,19031,16212,,35243,-72.453013,7.819
64357,2019,Marzo,Venezuela,12,42,,54,-72.508188,7.927233
64358,2019,Marzo,Venezuela,1152,955,,2107,-72.409396,8.36068
65471,2019,Abril,Venezuela,3,4,,7,-69.941498,4.191162
65472,2019,Abril,Venezuela,5,8,,13,-69.94143100000001,4.214082
65473,2019,Abril,Venezuela,0,2,,2,-74.78366,0.18595699999999998
65474,2019,Abril,Venezuela,131,118,,249,-76.876446,0.33002
65475,2019,Abril,Venezuela,3330,3554,,6884,-77.35600000000001,0.81488
65476,2019,Abril,Venezuela,4,9,,13,-78.802679,18.00143
65477,2019,Abril,Venezuela,22,17,,39,-75.527794,10.406342
65478,2019,Abril,Venezuela,10,36,,46,-73.247863,10.433608999999999
65479,2019,Abril,Venezuela,205,271,,476,-75.516486,10.446304
65480,2019,Abril,Venezuela,270,329,,599,-74.77647900000001,10.886686
65481,2019,Abril,Venezuela,0,5,,5,-74.765343,10.970933
65482,2019,Abril,Venezuela,23,63,,86,-74.232675,11.117206
65483,2019,Abril,Venezuela,9801,8584,,18385,-72.129595,11.360028999999999
65484,2019,Abril,Venezuela,0,1,,1,-71.983761,12.165168
65485,2019,Abril,Venezuela,0,1,,1,-81.703935,12.574411099999999
65486,2019,Abril,Venezuela,4,3,,7,-81.70216500000001,12.5862
65487,2019,Abril,Venezuela,243,225,,468,-76.532004,3.451668
65488,2019,Abril,Venezuela,21,10,,31,-67.927521,3.866713
65489,2019,Abril,Venezuela,1,0,,1,-75.76635300000001,4.45285
65490,2019,Abril,Venezuela,7563,7510,,15073,-74.140516,4.697157
65491,2019,Abril,Venezuela,7,14,,21,-75.736374,4.815189
65492,2019,Abril,Venezuela,1009,951,,1960,-75.42726,6.170465
65493,2019,Abril,Venezuela,43,37,,80,-67.48402800000001,6.185536
65494,2019,Abril,Venezuela,517,465,,982,-70.74025300000001,7.088728999999999
65495,2019,Abril,Venezuela,13,4,,17,-73.181317,7.1280470000000005
65496,2019,Abril,Venezuela,27906,24989,,52895,-72.453013,7.819
65497,2019,Abril,Venezuela,15,30,,45,-72.508188,7.927233
65498,2019,Abril,Venezuela,1239,1001,,2240,-72.409396,8.36068
66529,2019,Mayo,Venezuela,4,7,,11,-69.941498,4.191162
66530,2019,Mayo,Venezuela,5,4,,9,-69.94143100000001,4.214082
66531,2019,Mayo,Venezuela,66,78,,144,-76.876446,0.33002
66532,2019,Mayo,Venezuela,3618,3863,,7481,-77.35600000000001,0.81488
66533,2019,Mayo,Venezuela,3,18,,21,-78.802679,18.00143
66534,2019,Mayo,Venezuela,11,20,,31,-75.527794,10.406342
66535,2019,Mayo,Venezuela,229,222,,451,-75.516486,10.446304
66536,2019,Mayo,Venezuela,249,328,,577,-74.77647900000001,10.886686
66537,2019,Mayo,Venezuela,12,44,,56,-74.232675,11.117206
66538,2019,Mayo,Venezuela,0,2,,2,-74.213989,11.247722999999999
66539,2019,Mayo,Venezuela,8727,7879,,16606,-72.129595,11.360028999999999
66540,2019,Mayo,Venezuela,0,1,,1,-72.919186,11.52863
66541,2019,Mayo,Venezuela,2,3,,5,-81.70216500000001,12.5862
66542,2019,Mayo,Venezuela,0,1,,1,-81.372937,13.338761300000002
66543,2019,Mayo,Venezuela,213,234,,447,-76.532004,3.451668
66544,2019,Mayo,Venezuela,43,21,,64,-67.927521,3.866713
66545,2019,Mayo,Venezuela,3,1,,4,-75.76635300000001,4.45285
66546,2019,Mayo,Venezuela,8546,8266,,16812,-74.140516,4.697157
66547,2019,Mayo,Venezuela,9,20,,29,-75.736374,4.815189
66548,2019,Mayo,Venezuela,1529,1685,,3214,-75.42726,6.170465
66549,2019,Mayo,Venezuela,39,55,,94,-67.48402800000001,6.185536
66550,2019,Mayo,Venezuela,471,434,,905,-70.74025300000001,7.088728999999999
66551,2019,Mayo,Venezuela,9,7,,16,-73.181317,7.1280470000000005
66552,2019,Mayo,Venezuela,29767,28185,,57952,-72.453013,7.819
66553,2019,Mayo,Venezuela,8,18,,26,-72.508188,7.927233
66554,2019,Mayo,Venezuela,1251,1066,,2317,-72.409396,8.36068
67633,2019,Junio,Venezuela,4,3,,7,-69.941498,4.191162
67634,2019,Junio,Venezuela,6,3,,9,-69.94143100000001,4.214082
67635,2019,Junio,Venezuela,81,73,,154,-76.876446,0.33002
67636,2019,Junio,Venezuela,3555,3698,,7253,-77.35600000000001,0.81488
67637,2019,Junio,Venezuela,2,20,,22,-78.802679,18.00143
67638,2019,Junio,Venezuela,17,42,,59,-75.527794,10.406342
67639,2019,Junio,Venezuela,199,219,,418,-75.516486,10.446304
67640,2019,Junio,Venezuela,291,405,,696,-74.77647900000001,10.886686
67641,2019,Junio,Venezuela,16,27,,43,-74.232675,11.117206
67642,2019,Junio,Venezuela,7884,7359,,15243,-72.129595,11.360028999999999
67643,2019,Junio,Venezuela,0,2,,2,-72.919186,11.52863
67644,2019,Junio,Venezuela,3,2,,5,-81.70216500000001,12.5862
67645,2019,Junio,Venezuela,206,224,,430,-76.532004,3.451668
67646,2019,Junio,Venezuela,21,19,,40,-67.927521,3.866713
67647,2019,Junio,Venezuela,2,2,,4,-75.76635300000001,4.45285
67648,2019,Junio,Venezuela,7900,7827,,15727,-74.140516,4.697157
67649,2019,Junio,Venezuela,7,20,,27,-75.736374,4.815189
67650,2019,Junio,Venezuela,1515,1474,,2989,-75.42726,6.170465
67651,2019,Junio,Venezuela,38,28,,66,-67.48402800000001,6.185536
67652,2019,Junio,Venezuela,700,690,,1390,-70.74025300000001,7.088728999999999
67653,2019,Junio,Venezuela,9,13,,22,-73.181317,7.1280470000000005
67654,2019,Junio,Venezuela,29976,26826,,56802,-72.453013,7.819
67655,2019,Junio,Venezuela,12,28,,40,-72.508188,7.927233
67656,2019,Junio,Venezuela,1904,1597,,3501,-72.409396,8.36068
67657,2019,Junio,Venezuela,1,0,,1,-77.35002,8.63337
