,Año,Mes,Nacionalidad,Femenino,Masculino,Indefinido,Total,long,lat
0,2012,Enero,Islas Alboran y Perejil,1,0,,1,-74.140516,4.697157
1,2012,Enero,Albania,1,2,,3,-74.140516,4.697157
2,2012,Enero,Alemania,11,16,,27,-69.941498,4.191162
3,2012,Enero,Alemania,1,1,,2,-76.876446,0.33002
4,2012,Enero,Alemania,63,102,,165,-77.35600000000001,0.81488
5,2012,Enero,Alemania,22,23,,45,-75.527794,10.406342
6,2012,Enero,Alemania,27,48,,75,-75.516486,10.446304
7,2012,Enero,Alemania,7,4,,11,-74.77647900000001,10.886686
8,2012,Enero,Alemania,1,1,,2,-74.213989,11.247722999999999
9,2012,Enero,Alemania,8,21,,29,-72.129595,11.360028999999999
10,2012,Enero,Alemania,6,7,,13,-81.70216500000001,12.5862
11,2012,Enero,Alemania,1,1,,2,-81.372937,13.338761300000002
12,2012,Enero,Alemania,25,49,,74,-76.532004,3.451668
13,2012,Enero,Alemania,0,1,,1,-77.061029,3.8844260000000004
14,2012,Enero,Alemania,1182,2025,,3207,-74.140516,4.697157
15,2012,Enero,Alemania,30,97,,127,-75.42726,6.170465
16,2012,Enero,Alemania,1,0,,1,-67.48402800000001,6.185536
17,2012,Enero,Alemania,0,2,,2,-73.181317,7.1280470000000005
18,2012,Enero,Alemania,3,15,,18,-72.453013,7.819
19,2012,Enero,Alemania,0,1,,1,-72.508188,7.927233
20,2012,Enero,Alemania,8,25,,33,-77.35002,8.63337
21,2012,Enero,Andorra,6,11,,17,-74.140516,4.697157
22,2012,Enero,Angola,1,1,,2,-74.140516,4.697157
23,2012,Enero,Antigua y Barbuda,1,1,,2,-75.516486,10.446304
24,2012,Enero,Países Bajos,1,2,,3,-75.42726,6.170465
25,2012,Enero,Argelia,3,2,,5,-74.140516,4.697157
26,2012,Enero,Argelia,0,2,,2,-75.42726,6.170465
27,2012,Enero,Argentina,6,15,,21,-69.941498,4.191162
28,2012,Enero,Argentina,0,1,,1,-76.876446,0.33002
29,2012,Enero,Argentina,254,355,,609,-77.35600000000001,0.81488
30,2012,Enero,Argentina,1,0,,1,-78.802679,18.00143
31,2012,Enero,Argentina,93,68,,161,-75.527794,10.406342
32,2012,Enero,Argentina,568,412,,980,-75.516486,10.446304
33,2012,Enero,Argentina,23,35,,58,-74.77647900000001,10.886686
34,2012,Enero,Argentina,0,1,,1,-74.213989,11.247722999999999
35,2012,Enero,Argentina,65,70,,135,-72.129595,11.360028999999999
36,2012,Enero,Argentina,1,1,,2,-72.919186,11.52863
37,2012,Enero,Argentina,186,128,,314,-81.70216500000001,12.5862
38,2012,Enero,Argentina,48,61,,109,-76.532004,3.451668
39,2012,Enero,Argentina,4315,4691,,9006,-74.140516,4.697157
40,2012,Enero,Argentina,4,7,,11,-75.736374,4.815189
41,2012,Enero,Argentina,94,155,,249,-75.42726,6.170465
42,2012,Enero,Argentina,0,1,,1,-70.74025300000001,7.088728999999999
43,2012,Enero,Argentina,0,3,,3,-73.181317,7.1280470000000005
44,2012,Enero,Argentina,25,50,,75,-72.453013,7.819
45,2012,Enero,Argentina,1,1,,2,-72.508188,7.927233
46,2012,Enero,Argentina,12,27,,39,-77.35002,8.63337
47,2012,Enero,Aruba,0,1,,1,-76.532004,3.451668
48,2012,Enero,Aruba,0,1,,1,-74.140516,4.697157
49,2012,Enero,Australia,4,14,,18,-69.941498,4.191162
50,2012,Enero,Australia,29,58,,87,-77.35600000000001,0.81488
51,2012,Enero,Australia,14,30,,44,-75.527794,10.406342
52,2012,Enero,Australia,31,51,,82,-75.516486,10.446304
53,2012,Enero,Australia,3,7,,10,-74.77647900000001,10.886686
54,2012,Enero,Australia,1,2,,3,-74.213989,11.247722999999999
55,2012,Enero,Australia,4,6,,10,-72.129595,11.360028999999999
56,2012,Enero,Australia,0,1,,1,-81.70216500000001,12.5862
57,2012,Enero,Australia,3,1,,4,-81.372937,13.338761300000002
58,2012,Enero,Australia,11,21,,32,-76.532004,3.451668
59,2012,Enero,Australia,0,1,,1,-75.76635300000001,4.45285
60,2012,Enero,Australia,241,400,,641,-74.140516,4.697157
61,2012,Enero,Australia,1,1,,2,-75.736374,4.815189
62,2012,Enero,Australia,30,70,,100,-75.42726,6.170465
63,2012,Enero,Australia,0,1,,1,-67.48402800000001,6.185536
64,2012,Enero,Australia,1,4,,5,-72.453013,7.819
65,2012,Enero,Australia,1,1,,2,-72.508188,7.927233
66,2012,Enero,Australia,5,9,,14,-77.35002,8.63337
67,2012,Enero,Austria,4,6,,10,-69.941498,4.191162
68,2012,Enero,Austria,3,7,,10,-77.35600000000001,0.81488
69,2012,Enero,Austria,4,4,,8,-75.527794,10.406342
70,2012,Enero,Austria,6,4,,10,-75.516486,10.446304
71,2012,Enero,Austria,1,1,,2,-74.77647900000001,10.886686
72,2012,Enero,Austria,0,2,,2,-72.129595,11.360028999999999
73,2012,Enero,Austria,3,7,,10,-76.532004,3.451668
74,2012,Enero,Austria,124,284,,408,-74.140516,4.697157
75,2012,Enero,Austria,6,8,,14,-75.42726,6.170465
76,2012,Enero,Austria,0,1,,1,-77.401154,6.222551999999999
77,2012,Enero,Austria,0,1,,1,-72.453013,7.819
78,2012,Enero,Austria,0,3,,3,-77.35002,8.63337
79,2012,Enero,Azerbaiyán,0,1,,1,-77.35600000000001,0.81488
80,2012,Enero,Azerbaiyán,1,1,,2,-74.140516,4.697157
81,2012,Enero,Bahamas,2,3,,5,-74.140516,4.697157
82,2012,Enero,Bahamas,0,2,,2,-75.42726,6.170465
83,2012,Enero,Bahréin,0,1,,1,-74.140516,4.697157
84,2012,Enero,Bangladesh,0,1,,1,-74.140516,4.697157
85,2012,Enero,Barbados,1,0,,1,-75.516486,10.446304
86,2012,Enero,Barbados,2,3,,5,-74.140516,4.697157
87,2012,Enero,República de Belarús,0,1,,1,-75.516486,10.446304
88,2012,Enero,República de Belarús,1,1,,2,-74.140516,4.697157
89,2012,Enero,Bélgica,2,3,,5,-69.941498,4.191162
90,2012,Enero,Bélgica,1,1,,2,-76.876446,0.33002
91,2012,Enero,Bélgica,14,14,,28,-77.35600000000001,0.81488
92,2012,Enero,Bélgica,1,2,,3,-75.527794,10.406342
93,2012,Enero,Bélgica,2,8,,10,-75.516486,10.446304
94,2012,Enero,Bélgica,0,3,,3,-74.77647900000001,10.886686
95,2012,Enero,Bélgica,0,3,,3,-72.129595,11.360028999999999
96,2012,Enero,Bélgica,0,2,,2,-81.372937,13.338761300000002
97,2012,Enero,Bélgica,7,23,,30,-76.532004,3.451668
98,2012,Enero,Bélgica,137,304,,441,-74.140516,4.697157
99,2012,Enero,Bélgica,4,11,,15,-75.42726,6.170465
100,2012,Enero,Bélgica,0,1,,1,-67.48402800000001,6.185536
101,2012,Enero,Bélgica,4,3,,7,-72.453013,7.819
102,2012,Enero,Bélgica,0,2,,2,-77.35002,8.63337
103,2012,Enero,Belice,3,0,,3,-72.129595,11.360028999999999
104,2012,Enero,Belice,0,1,,1,-76.532004,3.451668
105,2012,Enero,Belice,5,7,,12,-74.140516,4.697157
106,2012,Enero,Belice,0,2,,2,-75.42726,6.170465
107,2012,Enero,Belice,1,1,,2,-73.181317,7.1280470000000005
108,2012,Enero,Bermudas/Territorio Británico de Ultramar,0,2,,2,-76.532004,3.451668
109,2012,Enero,Bolivia,19,25,,44,-77.35600000000001,0.81488
110,2012,Enero,Bolivia,4,3,,7,-75.527794,10.406342
111,2012,Enero,Bolivia,6,15,,21,-75.516486,10.446304
112,2012,Enero,Bolivia,0,1,,1,-74.77647900000001,10.886686
113,2012,Enero,Bolivia,8,10,,18,-81.70216500000001,12.5862
114,2012,Enero,Bolivia,20,18,,38,-76.532004,3.451668
115,2012,Enero,Bolivia,330,416,,746,-74.140516,4.697157
116,2012,Enero,Bolivia,0,2,,2,-75.736374,4.815189
117,2012,Enero,Bolivia,16,19,,35,-75.42726,6.170465
118,2012,Enero,Bolivia,1,3,,4,-72.453013,7.819
119,2012,Enero,Bosnia y Herzegovina,0,1,,1,-74.140516,4.697157
120,2012,Enero,Botsuana,0,1,,1,-74.140516,4.697157
121,2012,Enero,Brasil,94,111,,205,-69.941498,4.191162
122,2012,Enero,Brasil,0,1,,1,-76.876446,0.33002
123,2012,Enero,Brasil,17,35,,52,-77.35600000000001,0.81488
124,2012,Enero,Brasil,51,39,,90,-75.527794,10.406342
125,2012,Enero,Brasil,82,90,,172,-75.516486,10.446304
126,2012,Enero,Brasil,8,23,,31,-74.77647900000001,10.886686
127,2012,Enero,Brasil,21,27,,48,-72.129595,11.360028999999999
128,2012,Enero,Brasil,6,15,,21,-81.70216500000001,12.5862
129,2012,Enero,Brasil,26,50,,76,-76.532004,3.451668
130,2012,Enero,Brasil,0,1,,1,-75.76635300000001,4.45285
131,2012,Enero,Brasil,3820,4946,,8766,-74.140516,4.697157
132,2012,Enero,Brasil,22,114,,136,-75.736374,4.815189
133,2012,Enero,Brasil,60,93,,153,-75.42726,6.170465
134,2012,Enero,Brasil,1,1,,2,-67.48402800000001,6.185536
135,2012,Enero,Brasil,3,4,,7,-70.74025300000001,7.088728999999999
136,2012,Enero,Brasil,1,1,,2,-73.181317,7.1280470000000005
137,2012,Enero,Brasil,19,25,,44,-72.453013,7.819
138,2012,Enero,Brasil,0,2,,2,-72.508188,7.927233
139,2012,Enero,Brasil,0,1,,1,-77.35002,8.63337
140,2012,Enero,Bulgaria,1,3,,4,-75.516486,10.446304
141,2012,Enero,Bulgaria,0,1,,1,-74.213989,11.247722999999999
142,2012,Enero,Bulgaria,1,1,,2,-76.532004,3.451668
143,2012,Enero,Bulgaria,6,8,,14,-74.140516,4.697157
144,2012,Enero,Burkina Faso,1,0,,1,-74.140516,4.697157
145,2012,Enero,Islas Caimán/Territorio Británico de Ultramar,0,6,,6,-81.70216500000001,12.5862
146,2012,Enero,Islas Caimán/Territorio Británico de Ultramar,1,1,,2,-76.532004,3.451668
147,2012,Enero,Islas Caimán/Territorio Británico de Ultramar,1,1,,2,-74.140516,4.697157
148,2012,Enero,Camerún,1,2,,3,-74.140516,4.697157
149,2012,Enero,Canadá,7,14,,21,-69.941498,4.191162
150,2012,Enero,Canadá,23,41,,64,-77.35600000000001,0.81488
151,2012,Enero,Canadá,8,19,,27,-75.527794,10.406342
152,2012,Enero,Canadá,1237,1252,,2489,-75.516486,10.446304
153,2012,Enero,Canadá,5,16,,21,-74.77647900000001,10.886686
154,2012,Enero,Canadá,1,0,,1,-74.213989,11.247722999999999
155,2012,Enero,Canadá,6,7,,13,-72.129595,11.360028999999999
156,2012,Enero,Canadá,2,3,,5,-81.703935,12.574411099999999
157,2012,Enero,Canadá,600,568,,1168,-81.70216500000001,12.5862
158,2012,Enero,Canadá,0,1,,1,-81.372937,13.338761300000002
159,2012,Enero,Canadá,42,52,,94,-76.532004,3.451668
160,2012,Enero,Canadá,8,15,,23,-75.76635300000001,4.45285
161,2012,Enero,Canadá,730,1402,,2132,-74.140516,4.697157
162,2012,Enero,Canadá,4,6,,10,-75.736374,4.815189
163,2012,Enero,Canadá,102,215,,317,-75.42726,6.170465
164,2012,Enero,Canadá,1,4,,5,-73.181317,7.1280470000000005
165,2012,Enero,Canadá,5,9,,14,-72.453013,7.819
166,2012,Enero,Canadá,1,7,,8,-72.508188,7.927233
167,2012,Enero,Canadá,3,13,,16,-77.35002,8.63337
168,2012,Enero,Chad,0,2,,2,-74.140516,4.697157
169,2012,Enero,España,1,0,,1,-76.876446,0.33002
170,2012,Enero,España,14,27,,41,-77.35600000000001,0.81488
171,2012,Enero,España,10,14,,24,-75.516486,10.446304
172,2012,Enero,España,3,11,,14,-74.77647900000001,10.886686
173,2012,Enero,España,0,1,,1,-74.213989,11.247722999999999
174,2012,Enero,España,0,1,,1,-72.129595,11.360028999999999
175,2012,Enero,España,0,1,,1,-81.703935,12.574411099999999
176,2012,Enero,España,4,4,,8,-81.70216500000001,12.5862
177,2012,Enero,España,56,120,,176,-76.532004,3.451668
178,2012,Enero,España,1,0,,1,-75.76635300000001,4.45285
179,2012,Enero,España,192,397,,589,-74.140516,4.697157
180,2012,Enero,España,3,3,,6,-75.736374,4.815189
181,2012,Enero,España,32,65,,97,-75.42726,6.170465
182,2012,Enero,España,1,0,,1,-70.74025300000001,7.088728999999999
183,2012,Enero,España,3,1,,4,-72.453013,7.819
184,2012,Enero,España,1,3,,4,-72.508188,7.927233
185,2012,Enero,República Democrática del Congo,0,1,,1,-76.532004,3.451668
186,2012,Enero,República Democrática del Congo,0,2,,2,-74.140516,4.697157
187,2012,Enero,República de Corea,4,5,,9,-77.35600000000001,0.81488
188,2012,Enero,República de Corea,2,2,,4,-75.527794,10.406342
189,2012,Enero,República de Corea,4,19,,23,-75.516486,10.446304
190,2012,Enero,República de Corea,0,1,,1,-74.77647900000001,10.886686
191,2012,Enero,República de Corea,0,6,,6,-76.532004,3.451668
192,2012,Enero,República de Corea,126,290,,416,-74.140516,4.697157
193,2012,Enero,República de Corea,9,15,,24,-75.42726,6.170465
194,2012,Enero,República de Corea,0,1,,1,-72.453013,7.819
195,2012,Enero,República de Corea,0,1,,1,-72.508188,7.927233
196,2012,Enero,República de Corea,0,4,,4,-77.35002,8.63337
197,2012,Enero,Costa de Marfil,1,1,,2,-74.140516,4.697157
198,2012,Enero,Costa Rica,6,12,,18,-77.35600000000001,0.81488
199,2012,Enero,Costa Rica,0,1,,1,-75.527794,10.406342
200,2012,Enero,Costa Rica,48,48,,96,-75.516486,10.446304
201,2012,Enero,Costa Rica,20,21,,41,-74.77647900000001,10.886686
202,2012,Enero,Costa Rica,0,2,,2,-74.213989,11.247722999999999
203,2012,Enero,Costa Rica,0,2,,2,-72.129595,11.360028999999999
204,2012,Enero,Costa Rica,432,342,,774,-81.70216500000001,12.5862
205,2012,Enero,Costa Rica,26,46,,72,-76.532004,3.451668
206,2012,Enero,Costa Rica,307,480,,787,-74.140516,4.697157
207,2012,Enero,Costa Rica,1,6,,7,-75.736374,4.815189
208,2012,Enero,Costa Rica,115,132,,247,-75.42726,6.170465
209,2012,Enero,Costa Rica,3,4,,7,-73.181317,7.1280470000000005
210,2012,Enero,Costa Rica,1,7,,8,-72.453013,7.819
211,2012,Enero,Costa Rica,1,2,,3,-72.508188,7.927233
212,2012,Enero,Costa Rica,0,2,,2,-77.35002,8.63337
213,2012,Enero,Croacia,0,2,,2,-77.35600000000001,0.81488
214,2012,Enero,Croacia,0,1,,1,-75.527794,10.406342
215,2012,Enero,Croacia,2,0,,2,-75.516486,10.446304
216,2012,Enero,Croacia,1,0,,1,-76.532004,3.451668
217,2012,Enero,Croacia,7,14,,21,-74.140516,4.697157
218,2012,Enero,Croacia,1,0,,1,-75.42726,6.170465
219,2012,Enero,Croacia,0,1,,1,-72.508188,7.927233
220,2012,Enero,Cuba,1,2,,3,-77.35600000000001,0.81488
221,2012,Enero,Cuba,14,18,,32,-75.516486,10.446304
222,2012,Enero,Cuba,6,6,,12,-74.77647900000001,10.886686
223,2012,Enero,Cuba,1,3,,4,-72.129595,11.360028999999999
224,2012,Enero,Cuba,1,0,,1,-81.70216500000001,12.5862
225,2012,Enero,Cuba,30,37,,67,-76.532004,3.451668
226,2012,Enero,Cuba,0,1,,1,-75.76635300000001,4.45285
227,2012,Enero,Cuba,104,174,,278,-74.140516,4.697157
228,2012,Enero,Cuba,0,2,,2,-75.736374,4.815189
229,2012,Enero,Cuba,13,14,,27,-75.42726,6.170465
230,2012,Enero,Cuba,0,3,,3,-73.181317,7.1280470000000005
231,2012,Enero,Cuba,0,11,,11,-72.453013,7.819
232,2012,Enero,Cuba,2,11,,13,-72.508188,7.927233
233,2012,Enero,Curazao,0,1,,1,-74.140516,4.697157
234,2012,Enero,Curazao,1,0,,1,-75.42726,6.170465
235,2012,Enero,República Checa,0,2,,2,-69.941498,4.191162
236,2012,Enero,República Checa,1,4,,5,-77.35600000000001,0.81488
237,2012,Enero,República Checa,1,7,,8,-75.516486,10.446304
238,2012,Enero,República Checa,1,2,,3,-72.129595,11.360028999999999
239,2012,Enero,República Checa,1,0,,1,-76.532004,3.451668
240,2012,Enero,República Checa,40,50,,90,-74.140516,4.697157
241,2012,Enero,República Checa,2,3,,5,-75.42726,6.170465
242,2012,Enero,República Checa,1,4,,5,-72.453013,7.819
243,2012,Enero,República Checa,0,1,,1,-77.35002,8.63337
244,2012,Enero,Chile,2,3,,5,-69.941498,4.191162
245,2012,Enero,Chile,2,2,,4,-76.876446,0.33002
246,2012,Enero,Chile,69,97,,166,-77.35600000000001,0.81488
247,2012,Enero,Chile,59,36,,95,-75.527794,10.406342
248,2012,Enero,Chile,53,58,,111,-75.516486,10.446304
249,2012,Enero,Chile,2,19,,21,-74.77647900000001,10.886686
250,2012,Enero,Chile,9,9,,18,-72.129595,11.360028999999999
251,2012,Enero,Chile,3,2,,5,-81.703935,12.574411099999999
252,2012,Enero,Chile,38,28,,66,-81.70216500000001,12.5862
253,2012,Enero,Chile,33,53,,86,-76.532004,3.451668
254,2012,Enero,Chile,1889,2816,,4705,-74.140516,4.697157
255,2012,Enero,Chile,0,3,,3,-75.736374,4.815189
256,2012,Enero,Chile,71,122,,193,-75.42726,6.170465
257,2012,Enero,Chile,0,1,,1,-70.74025300000001,7.088728999999999
258,2012,Enero,Chile,0,2,,2,-73.181317,7.1280470000000005
259,2012,Enero,Chile,19,26,,45,-72.453013,7.819
260,2012,Enero,Chile,0,1,,1,-72.508188,7.927233
261,2012,Enero,Chile,2,0,,2,-77.35002,8.63337
262,2012,Enero,China,0,2,,2,-69.941498,4.191162
263,2012,Enero,China,3,2,,5,-77.35600000000001,0.81488
264,2012,Enero,China,0,1,,1,-75.527794,10.406342
265,2012,Enero,China,2,0,,2,-75.516486,10.446304
266,2012,Enero,China,1,0,,1,-74.77647900000001,10.886686
267,2012,Enero,China,1,1,,2,-81.70216500000001,12.5862
268,2012,Enero,China,1,9,,10,-76.532004,3.451668
269,2012,Enero,China,97,237,,334,-74.140516,4.697157
270,2012,Enero,China,7,10,,17,-75.42726,6.170465
271,2012,Enero,China,1,0,,1,-72.453013,7.819
272,2012,Enero,China,0,2,,2,-77.35002,8.63337
273,2012,Enero,Taiwán,1,1,,2,-77.35600000000001,0.81488
274,2012,Enero,Taiwán,2,3,,5,-75.516486,10.446304
275,2012,Enero,Taiwán,0,2,,2,-74.77647900000001,10.886686
276,2012,Enero,Taiwán,2,1,,3,-76.532004,3.451668
277,2012,Enero,Taiwán,29,28,,57,-74.140516,4.697157
278,2012,Enero,Taiwán,0,1,,1,-75.736374,4.815189
279,2012,Enero,Taiwán,5,3,,8,-75.42726,6.170465
280,2012,Enero,Taiwán,2,1,,3,-73.181317,7.1280470000000005
281,2012,Enero,Taiwán,1,0,,1,-72.453013,7.819
282,2012,Enero,Chipre,1,2,,3,-74.140516,4.697157
283,2012,Enero,Dinamarca,5,4,,9,-77.35600000000001,0.81488
284,2012,Enero,Dinamarca,3,4,,7,-75.527794,10.406342
285,2012,Enero,Dinamarca,3,5,,8,-75.516486,10.446304
286,2012,Enero,Dinamarca,0,2,,2,-74.77647900000001,10.886686
287,2012,Enero,Dinamarca,1,1,,2,-72.129595,11.360028999999999
288,2012,Enero,Dinamarca,1,14,,15,-76.532004,3.451668
289,2012,Enero,Dinamarca,56,133,,189,-74.140516,4.697157
290,2012,Enero,Dinamarca,0,1,,1,-75.736374,4.815189
291,2012,Enero,Dinamarca,3,5,,8,-75.42726,6.170465
292,2012,Enero,Dinamarca,0,2,,2,-72.453013,7.819
293,2012,Enero,Dominica,1,5,,6,-74.140516,4.697157
294,2012,Enero,Ecuador,0,1,,1,-69.941498,4.191162
295,2012,Enero,Ecuador,12,43,,55,-76.876446,0.33002
296,2012,Enero,Ecuador,796,1307,,2103,-77.35600000000001,0.81488
297,2012,Enero,Ecuador,3,3,,6,-78.802679,18.00143
298,2012,Enero,Ecuador,8,48,,56,-75.527794,10.406342
299,2012,Enero,Ecuador,7,14,,21,-75.516486,10.446304
300,2012,Enero,Ecuador,4,9,,13,-74.77647900000001,10.886686
301,2012,Enero,Ecuador,12,11,,23,-72.129595,11.360028999999999
302,2012,Enero,Ecuador,1,2,,3,-81.70216500000001,12.5862
303,2012,Enero,Ecuador,262,352,,614,-76.532004,3.451668
304,2012,Enero,Ecuador,1,1,,2,-75.76635300000001,4.45285
305,2012,Enero,Ecuador,1462,2292,,3754,-74.140516,4.697157
306,2012,Enero,Ecuador,1,5,,6,-75.736374,4.815189
307,2012,Enero,Ecuador,375,617,,992,-75.42726,6.170465
308,2012,Enero,Ecuador,0,1,,1,-70.74025300000001,7.088728999999999
309,2012,Enero,Ecuador,119,187,,306,-72.453013,7.819
310,2012,Enero,Ecuador,5,1,,6,-72.508188,7.927233
311,2012,Enero,Egipto,0,9,,9,-74.140516,4.697157
312,2012,Enero,El Salvador,0,1,,1,-77.35600000000001,0.81488
313,2012,Enero,El Salvador,1,0,,1,-75.527794,10.406342
314,2012,Enero,El Salvador,4,7,,11,-75.516486,10.446304
315,2012,Enero,El Salvador,1,4,,5,-74.77647900000001,10.886686
316,2012,Enero,El Salvador,1,0,,1,-72.129595,11.360028999999999
317,2012,Enero,El Salvador,1,2,,3,-81.70216500000001,12.5862
318,2012,Enero,El Salvador,9,13,,22,-76.532004,3.451668
319,2012,Enero,El Salvador,0,1,,1,-77.061029,3.8844260000000004
320,2012,Enero,El Salvador,342,474,,816,-74.140516,4.697157
321,2012,Enero,El Salvador,0,5,,5,-75.736374,4.815189
322,2012,Enero,El Salvador,12,35,,47,-75.42726,6.170465
323,2012,Enero,El Salvador,0,1,,1,-77.401154,6.222551999999999
324,2012,Enero,El Salvador,0,6,,6,-73.181317,7.1280470000000005
325,2012,Enero,El Salvador,2,5,,7,-72.453013,7.819
326,2012,Enero,España,1,3,,4,-69.941498,4.191162
327,2012,Enero,España,10,18,,28,-77.35600000000001,0.81488
328,2012,Enero,España,8,10,,18,-75.527794,10.406342
329,2012,Enero,España,21,50,,71,-75.516486,10.446304
330,2012,Enero,España,0,10,,10,-74.77647900000001,10.886686
331,2012,Enero,España,4,13,,17,-72.129595,11.360028999999999
332,2012,Enero,España,0,1,,1,-81.703935,12.574411099999999
333,2012,Enero,España,10,6,,16,-81.70216500000001,12.5862
334,2012,Enero,España,168,288,,456,-76.532004,3.451668
335,2012,Enero,España,2,2,,4,-75.76635300000001,4.45285
336,2012,Enero,España,1722,3810,,5532,-74.140516,4.697157
337,2012,Enero,España,0,2,,2,-75.736374,4.815189
338,2012,Enero,España,89,229,,318,-75.42726,6.170465
339,2012,Enero,España,0,5,,5,-70.74025300000001,7.088728999999999
340,2012,Enero,España,1,1,,2,-73.181317,7.1280470000000005
341,2012,Enero,España,19,65,,84,-72.453013,7.819
342,2012,Enero,España,2,1,,3,-72.508188,7.927233
343,2012,Enero,España,3,3,,6,-77.35002,8.63337
344,2012,Enero,Eslovaquia,0,4,,4,-77.35600000000001,0.81488
345,2012,Enero,Eslovaquia,12,24,,36,-74.140516,4.697157
346,2012,Enero,Eslovaquia,4,9,,13,-72.453013,7.819
347,2012,Enero,Eslovenia,3,3,,6,-77.35600000000001,0.81488
348,2012,Enero,Eslovenia,0,2,,2,-75.527794,10.406342
349,2012,Enero,Eslovenia,1,1,,2,-75.516486,10.446304
350,2012,Enero,Eslovenia,1,0,,1,-76.532004,3.451668
351,2012,Enero,Eslovenia,28,37,,65,-74.140516,4.697157
352,2012,Enero,Estados Unidos de América,6,18,,24,-69.941498,4.191162
353,2012,Enero,Estados Unidos de América,41,94,,135,-77.35600000000001,0.81488
354,2012,Enero,Estados Unidos de América,35,52,,87,-75.527794,10.406342
355,2012,Enero,Estados Unidos de América,710,1595,,2305,-75.516486,10.446304
356,2012,Enero,Estados Unidos de América,232,486,,718,-74.77647900000001,10.886686
357,2012,Enero,Estados Unidos de América,2,15,,17,-74.232675,11.117206
358,2012,Enero,Estados Unidos de América,9,13,,22,-74.213989,11.247722999999999
359,2012,Enero,Estados Unidos de América,13,19,,32,-72.129595,11.360028999999999
360,2012,Enero,Estados Unidos de América,1,9,,10,-81.703935,12.574411099999999
361,2012,Enero,Estados Unidos de América,8,27,,35,-81.70216500000001,12.5862
362,2012,Enero,Estados Unidos de América,4,6,,10,-81.372937,13.338761300000002
363,2012,Enero,Estados Unidos de América,504,931,,1435,-76.532004,3.451668
364,2012,Enero,Estados Unidos de América,49,101,,150,-75.76635300000001,4.45285
365,2012,Enero,Estados Unidos de América,4376,9251,,13627,-74.140516,4.697157
366,2012,Enero,Estados Unidos de América,61,96,,157,-75.736374,4.815189
367,2012,Enero,Estados Unidos de América,748,1921,,2669,-75.42726,6.170465
368,2012,Enero,Estados Unidos de América,0,1,,1,-77.401154,6.222551999999999
369,2012,Enero,Estados Unidos de América,1,0,,1,-70.74025300000001,7.088728999999999
370,2012,Enero,Estados Unidos de América,25,39,,64,-73.181317,7.1280470000000005
371,2012,Enero,Estados Unidos de América,38,73,,111,-72.453013,7.819
372,2012,Enero,Estados Unidos de América,17,30,,47,-72.508188,7.927233
373,2012,Enero,Estados Unidos de América,9,21,,30,-77.35002,8.63337
374,2012,Enero,Estonia,1,1,,2,-75.527794,10.406342
375,2012,Enero,Estonia,3,5,,8,-75.516486,10.446304
376,2012,Enero,Estonia,0,1,,1,-76.532004,3.451668
377,2012,Enero,Estonia,6,7,,13,-74.140516,4.697157
378,2012,Enero,Etiopia,0,2,,2,-74.140516,4.697157
379,2012,Enero,Filipinas,1,40,,41,-75.527794,10.406342
380,2012,Enero,Filipinas,2,6,,8,-75.516486,10.446304
381,2012,Enero,Filipinas,0,6,,6,-74.77647900000001,10.886686
382,2012,Enero,Filipinas,0,3,,3,-74.213989,11.247722999999999
383,2012,Enero,Filipinas,0,1,,1,-76.532004,3.451668
384,2012,Enero,Filipinas,0,17,,17,-77.061029,3.8844260000000004
385,2012,Enero,Filipinas,19,69,,88,-74.140516,4.697157
386,2012,Enero,Filipinas,5,3,,8,-75.42726,6.170465
387,2012,Enero,Filipinas,0,1,,1,-72.508188,7.927233
388,2012,Enero,Filipinas,1,0,,1,-77.35002,8.63337
389,2012,Enero,Finlandia,1,1,,2,-69.941498,4.191162
390,2012,Enero,Finlandia,5,8,,13,-77.35600000000001,0.81488
391,2012,Enero,Finlandia,1,1,,2,-75.527794,10.406342
392,2012,Enero,Finlandia,214,186,,400,-75.516486,10.446304
393,2012,Enero,Finlandia,0,4,,4,-72.129595,11.360028999999999
394,2012,Enero,Finlandia,0,1,,1,-76.532004,3.451668
395,2012,Enero,Finlandia,48,85,,133,-74.140516,4.697157
396,2012,Enero,Finlandia,0,1,,1,-75.42726,6.170465
397,2012,Enero,Finlandia,0,2,,2,-72.453013,7.819
398,2012,Enero,Finlandia,1,0,,1,-77.35002,8.63337
399,2012,Enero,Francia,4,11,,15,-69.941498,4.191162
400,2012,Enero,Francia,34,73,,107,-77.35600000000001,0.81488
401,2012,Enero,Francia,7,21,,28,-75.527794,10.406342
402,2012,Enero,Francia,22,41,,63,-75.516486,10.446304
403,2012,Enero,Francia,2,7,,9,-74.77647900000001,10.886686
404,2012,Enero,Francia,3,5,,8,-74.213989,11.247722999999999
405,2012,Enero,Francia,21,29,,50,-72.129595,11.360028999999999
406,2012,Enero,Francia,5,4,,9,-81.70216500000001,12.5862
407,2012,Enero,Francia,4,2,,6,-81.372937,13.338761300000002
408,2012,Enero,Francia,43,80,,123,-76.532004,3.451668
409,2012,Enero,Francia,0,1,,1,-75.76635300000001,4.45285
410,2012,Enero,Francia,1135,1758,,2893,-74.140516,4.697157
411,2012,Enero,Francia,3,3,,6,-75.736374,4.815189
412,2012,Enero,Francia,14,38,,52,-75.42726,6.170465
413,2012,Enero,Francia,0,1,,1,-70.74025300000001,7.088728999999999
414,2012,Enero,Francia,1,2,,3,-73.181317,7.1280470000000005
415,2012,Enero,Francia,14,28,,42,-72.453013,7.819
416,2012,Enero,Francia,1,1,,2,-72.508188,7.927233
417,2012,Enero,Francia,6,12,,18,-77.35002,8.63337
418,2012,Enero,Gabón,0,1,,1,-74.140516,4.697157
419,2012,Enero,Georgia,1,0,,1,-74.140516,4.697157
420,2012,Enero,Ghana,0,1,,1,-72.129595,11.360028999999999
421,2012,Enero,Ghana,0,2,,2,-74.140516,4.697157
422,2012,Enero,Ghana,0,2,,2,-72.508188,7.927233
423,2012,Enero,Granada,0,1,,1,-74.140516,4.697157
424,2012,Enero,Grecia,2,3,,5,-69.941498,4.191162
425,2012,Enero,Grecia,0,1,,1,-77.35600000000001,0.81488
426,2012,Enero,Grecia,0,1,,1,-75.527794,10.406342
427,2012,Enero,Grecia,0,2,,2,-75.516486,10.446304
428,2012,Enero,Grecia,0,1,,1,-74.77647900000001,10.886686
429,2012,Enero,Grecia,0,2,,2,-76.532004,3.451668
430,2012,Enero,Grecia,10,76,,86,-74.140516,4.697157
431,2012,Enero,Grecia,0,4,,4,-75.42726,6.170465
432,2012,Enero,Grecia,1,1,,2,-72.453013,7.819
433,2012,Enero,Grecia,0,1,,1,-72.508188,7.927233
434,2012,Enero,Grecia,0,5,,5,-75.68164200000001,9.402597
435,2012,Enero,Guatemala,0,1,,1,-77.35600000000001,0.81488
436,2012,Enero,Guatemala,8,15,,23,-75.516486,10.446304
437,2012,Enero,Guatemala,13,7,,20,-74.77647900000001,10.886686
438,2012,Enero,Guatemala,0,1,,1,-72.129595,11.360028999999999
439,2012,Enero,Guatemala,4,5,,9,-81.70216500000001,12.5862
440,2012,Enero,Guatemala,7,35,,42,-76.532004,3.451668
441,2012,Enero,Guatemala,142,261,,403,-74.140516,4.697157
442,2012,Enero,Guatemala,2,4,,6,-75.736374,4.815189
443,2012,Enero,Guatemala,27,62,,89,-75.42726,6.170465
444,2012,Enero,Guatemala,2,2,,4,-73.181317,7.1280470000000005
445,2012,Enero,Guatemala,2,7,,9,-72.453013,7.819
446,2012,Enero,Guatemala,1,5,,6,-72.508188,7.927233
447,2012,Enero,Guatemala,1,0,,1,-77.35002,8.63337
448,2012,Enero,Guyana,1,0,,1,-75.516486,10.446304
449,2012,Enero,Guyana,2,2,,4,-74.140516,4.697157
450,2012,Enero,Guinea,1,0,,1,-76.532004,3.451668
451,2012,Enero,Guinea Ecuatorial,0,1,,1,-74.140516,4.697157
452,2012,Enero,Guayana Francesa/Departamento de Ultramar Francés,0,1,,1,-74.140516,4.697157
453,2012,Enero,Haití,2,1,,3,-75.516486,10.446304
454,2012,Enero,Haití,5,16,,21,-74.140516,4.697157
455,2012,Enero,Haití,0,7,,7,-75.42726,6.170465
456,2012,Enero,Honduras,1,0,,1,-77.35600000000001,0.81488
457,2012,Enero,Honduras,0,1,,1,-75.527794,10.406342
458,2012,Enero,Honduras,1,14,,15,-75.516486,10.446304
459,2012,Enero,Honduras,4,8,,12,-74.77647900000001,10.886686
460,2012,Enero,Honduras,0,10,,10,-81.703935,12.574411099999999
461,2012,Enero,Honduras,9,11,,20,-76.532004,3.451668
462,2012,Enero,Honduras,1,0,,1,-75.76635300000001,4.45285
463,2012,Enero,Honduras,96,141,,237,-74.140516,4.697157
464,2012,Enero,Honduras,0,1,,1,-75.736374,4.815189
465,2012,Enero,Honduras,14,27,,41,-75.42726,6.170465
466,2012,Enero,Honduras,0,3,,3,-73.181317,7.1280470000000005
467,2012,Enero,Honduras,1,2,,3,-72.453013,7.819
468,2012,Enero,Honduras,0,1,,1,-72.508188,7.927233
469,2012,Enero,Hungría,0,2,,2,-77.35600000000001,0.81488
470,2012,Enero,Hungría,2,1,,3,-75.516486,10.446304
471,2012,Enero,Hungría,0,2,,2,-74.213989,11.247722999999999
472,2012,Enero,Hungría,0,1,,1,-81.70216500000001,12.5862
473,2012,Enero,Hungría,1,1,,2,-76.532004,3.451668
474,2012,Enero,Hungría,39,50,,89,-74.140516,4.697157
475,2012,Enero,Hungría,0,1,,1,-75.42726,6.170465
476,2012,Enero,Hungría,0,1,,1,-72.453013,7.819
477,2012,Enero,Hungría,1,0,,1,-77.35002,8.63337
478,2012,Enero,India,8,1,,9,-77.35600000000001,0.81488
479,2012,Enero,India,0,1,,1,-75.527794,10.406342
480,2012,Enero,India,2,3,,5,-75.516486,10.446304
481,2012,Enero,India,0,3,,3,-74.77647900000001,10.886686
482,2012,Enero,India,0,1,,1,-74.213989,11.247722999999999
483,2012,Enero,India,0,1,,1,-81.70216500000001,12.5862
484,2012,Enero,India,2,13,,15,-76.532004,3.451668
485,2012,Enero,India,0,5,,5,-77.061029,3.8844260000000004
486,2012,Enero,India,26,187,,213,-74.140516,4.697157
487,2012,Enero,India,0,1,,1,-75.736374,4.815189
488,2012,Enero,India,3,23,,26,-75.42726,6.170465
489,2012,Enero,Indonesia,0,2,,2,-75.527794,10.406342
490,2012,Enero,Indonesia,0,1,,1,-75.516486,10.446304
491,2012,Enero,Indonesia,17,13,,30,-74.140516,4.697157
492,2012,Enero,Irán,3,13,,16,-74.140516,4.697157
493,2012,Enero,Irán,0,1,,1,-72.453013,7.819
494,2012,Enero,República de Irlanda,2,4,,6,-69.941498,4.191162
495,2012,Enero,República de Irlanda,9,20,,29,-77.35600000000001,0.81488
496,2012,Enero,República de Irlanda,1,7,,8,-75.516486,10.446304
497,2012,Enero,República de Irlanda,0,3,,3,-72.129595,11.360028999999999
498,2012,Enero,República de Irlanda,0,3,,3,-76.532004,3.451668
499,2012,Enero,República de Irlanda,0,1,,1,-77.061029,3.8844260000000004
500,2012,Enero,República de Irlanda,44,100,,144,-74.140516,4.697157
501,2012,Enero,República de Irlanda,6,17,,23,-75.42726,6.170465
502,2012,Enero,República de Irlanda,0,2,,2,-72.453013,7.819
503,2012,Enero,República de Irlanda,1,5,,6,-77.35002,8.63337
504,2012,Enero,Islandia,0,1,,1,-77.35600000000001,0.81488
505,2012,Enero,Islandia,0,1,,1,-76.532004,3.451668
506,2012,Enero,Islandia,9,4,,13,-74.140516,4.697157
507,2012,Enero,Isla de Man,21,45,,66,-77.35600000000001,0.81488
508,2012,Enero,Isla de Man,1,6,,7,-75.516486,10.446304
509,2012,Enero,Isla de Man,6,11,,17,-74.77647900000001,10.886686
510,2012,Enero,Isla de Man,1,0,,1,-72.129595,11.360028999999999
511,2012,Enero,Isla de Man,12,13,,25,-76.532004,3.451668
512,2012,Enero,Isla de Man,40,111,,151,-74.140516,4.697157
513,2012,Enero,Isla de Man,6,15,,21,-75.42726,6.170465
514,2012,Enero,Isla de Man,0,2,,2,-72.453013,7.819
515,2012,Enero,Isla de Man,1,3,,4,-72.508188,7.927233
516,2012,Enero,Isla Johnston,0,1,,1,-74.77647900000001,10.886686
517,2012,Enero,Isla Johnston,0,1,,1,-74.140516,4.697157
518,2012,Enero,Israel,17,11,,28,-69.941498,4.191162
519,2012,Enero,Israel,6,11,,17,-77.35600000000001,0.81488
520,2012,Enero,Israel,1,21,,22,-75.516486,10.446304
521,2012,Enero,Israel,0,5,,5,-74.77647900000001,10.886686
522,2012,Enero,Israel,0,3,,3,-81.70216500000001,12.5862
523,2012,Enero,Israel,4,8,,12,-76.532004,3.451668
524,2012,Enero,Israel,69,371,,440,-74.140516,4.697157
525,2012,Enero,Israel,2,29,,31,-75.42726,6.170465
526,2012,Enero,Islas Aland/Provincia de Finlandia,1,0,,1,-74.140516,4.697157
527,2012,Enero,Isla Wake,0,1,,1,-76.532004,3.451668
528,2012,Enero,Italia,1,5,,6,-69.941498,4.191162
529,2012,Enero,Italia,1,1,,2,-76.876446,0.33002
530,2012,Enero,Italia,11,32,,43,-77.35600000000001,0.81488
531,2012,Enero,Italia,6,20,,26,-75.527794,10.406342
532,2012,Enero,Italia,27,96,,123,-75.516486,10.446304
533,2012,Enero,Italia,0,14,,14,-74.77647900000001,10.886686
534,2012,Enero,Italia,1,3,,4,-74.213989,11.247722999999999
535,2012,Enero,Italia,5,19,,24,-72.129595,11.360028999999999
536,2012,Enero,Italia,8,16,,24,-81.70216500000001,12.5862
537,2012,Enero,Italia,26,89,,115,-76.532004,3.451668
538,2012,Enero,Italia,598,1976,,2574,-74.140516,4.697157
539,2012,Enero,Italia,0,4,,4,-75.736374,4.815189
540,2012,Enero,Italia,32,102,,134,-75.42726,6.170465
541,2012,Enero,Italia,0,1,,1,-70.74025300000001,7.088728999999999
542,2012,Enero,Italia,1,3,,4,-73.181317,7.1280470000000005
543,2012,Enero,Italia,6,31,,37,-72.453013,7.819
544,2012,Enero,Italia,1,14,,15,-72.508188,7.927233
545,2012,Enero,Italia,2,5,,7,-77.35002,8.63337
546,2012,Enero,Islas del Canal,0,1,,1,-74.140516,4.697157
547,2012,Enero,Jamaica,3,1,,4,-75.516486,10.446304
548,2012,Enero,Jamaica,1,1,,2,-74.77647900000001,10.886686
549,2012,Enero,Jamaica,0,1,,1,-81.70216500000001,12.5862
550,2012,Enero,Jamaica,2,2,,4,-76.532004,3.451668
551,2012,Enero,Jamaica,15,16,,31,-74.140516,4.697157
552,2012,Enero,Jamaica,1,2,,3,-75.42726,6.170465
553,2012,Enero,Jamaica,0,1,,1,-72.453013,7.819
554,2012,Enero,Islas Marianas del Norte,0,1,,1,-74.140516,4.697157
555,2012,Enero,Japón,0,2,,2,-69.941498,4.191162
556,2012,Enero,Japón,3,7,,10,-77.35600000000001,0.81488
557,2012,Enero,Japón,1,2,,3,-75.527794,10.406342
558,2012,Enero,Japón,1,7,,8,-75.516486,10.446304
559,2012,Enero,Japón,6,10,,16,-76.532004,3.451668
560,2012,Enero,Japón,133,426,,559,-74.140516,4.697157
561,2012,Enero,Japón,3,26,,29,-75.42726,6.170465
562,2012,Enero,Japón,3,9,,12,-72.453013,7.819
563,2012,Enero,Japón,0,1,,1,-72.508188,7.927233
564,2012,Enero,Japón,0,3,,3,-77.35002,8.63337
565,2012,Enero,Jordania,0,1,,1,-77.35600000000001,0.81488
566,2012,Enero,Jordania,1,0,,1,-74.140516,4.697157
567,2012,Enero,Kazajistán,1,1,,2,-74.140516,4.697157
568,2012,Enero,Kenia,0,1,,1,-77.35600000000001,0.81488
569,2012,Enero,Kenia,7,13,,20,-74.140516,4.697157
570,2012,Enero,Kuwait,0,1,,1,-74.140516,4.697157
571,2012,Enero,Letonia,2,0,,2,-77.35600000000001,0.81488
572,2012,Enero,Letonia,10,8,,18,-74.140516,4.697157
573,2012,Enero,Lituania,1,0,,1,-75.516486,10.446304
574,2012,Enero,Lituania,1,0,,1,-72.129595,11.360028999999999
575,2012,Enero,Lituania,2,1,,3,-76.532004,3.451668
576,2012,Enero,Lituania,3,7,,10,-74.140516,4.697157
577,2012,Enero,Líbano,1,0,,1,-75.516486,10.446304
578,2012,Enero,Líbano,3,7,,10,-74.77647900000001,10.886686
579,2012,Enero,Líbano,1,5,,6,-72.129595,11.360028999999999
580,2012,Enero,Líbano,0,1,,1,-76.532004,3.451668
581,2012,Enero,Líbano,9,26,,35,-74.140516,4.697157
582,2012,Enero,Libia,0,1,,1,-75.42726,6.170465
583,2012,Enero,Liechtenstein,0,1,,1,-77.35600000000001,0.81488
584,2012,Enero,Liechtenstein,0,1,,1,-76.532004,3.451668
585,2012,Enero,Liechtenstein,1,2,,3,-74.140516,4.697157
586,2012,Enero,Luxemburgo,1,9,,10,-74.140516,4.697157
587,2012,Enero,Macedonia,0,1,,1,-74.140516,4.697157
588,2012,Enero,Malasia,3,2,,5,-75.516486,10.446304
589,2012,Enero,Malasia,0,1,,1,-76.532004,3.451668
590,2012,Enero,Malasia,9,13,,22,-74.140516,4.697157
591,2012,Enero,Malasia,1,1,,2,-75.42726,6.170465
592,2012,Enero,Malta,2,0,,2,-77.35600000000001,0.81488
593,2012,Enero,Malta,0,3,,3,-75.42726,6.170465
594,2012,Enero,Marruecos,2,6,,8,-74.140516,4.697157
595,2012,Enero,Mauricio,1,2,,3,-74.140516,4.697157
596,2012,Enero,México,0,1,,1,-69.941498,4.191162
597,2012,Enero,México,14,16,,30,-77.35600000000001,0.81488
598,2012,Enero,México,9,11,,20,-75.527794,10.406342
599,2012,Enero,México,55,95,,150,-75.516486,10.446304
600,2012,Enero,México,19,32,,51,-74.77647900000001,10.886686
601,2012,Enero,México,3,6,,9,-72.129595,11.360028999999999
602,2012,Enero,México,0,4,,4,-81.703935,12.574411099999999
603,2012,Enero,México,0,2,,2,-81.70216500000001,12.5862
604,2012,Enero,México,42,105,,147,-76.532004,3.451668
605,2012,Enero,México,1699,3555,,5254,-74.140516,4.697157
606,2012,Enero,México,2,17,,19,-75.736374,4.815189
607,2012,Enero,México,84,272,,356,-75.42726,6.170465
608,2012,Enero,México,0,1,,1,-67.48402800000001,6.185536
609,2012,Enero,México,2,2,,4,-73.181317,7.1280470000000005
610,2012,Enero,México,25,56,,81,-72.453013,7.819
611,2012,Enero,México,3,20,,23,-72.508188,7.927233
612,2012,Enero,México,2,2,,4,-77.35002,8.63337
613,2012,Enero,República de Moldavia,1,0,,1,-75.516486,10.446304
614,2012,Enero,República de Moldavia,2,0,,2,-74.140516,4.697157
615,2012,Enero,Mónaco,1,0,,1,-77.35600000000001,0.81488
616,2012,Enero,Mónaco,0,1,,1,-74.140516,4.697157
617,2012,Enero,Myanmar,1,0,,1,-74.140516,4.697157
618,2012,Enero,Namibia,0,1,,1,-74.140516,4.697157
619,2012,Enero,Nepal,0,1,,1,-75.516486,10.446304
620,2012,Enero,Nepal,0,3,,3,-74.140516,4.697157
621,2012,Enero,Nicaragua,2,2,,4,-75.516486,10.446304
622,2012,Enero,Nicaragua,0,2,,2,-74.77647900000001,10.886686
623,2012,Enero,Nicaragua,0,2,,2,-81.703935,12.574411099999999
624,2012,Enero,Nicaragua,1,1,,2,-81.70216500000001,12.5862
625,2012,Enero,Nicaragua,10,4,,14,-76.532004,3.451668
626,2012,Enero,Nicaragua,42,55,,97,-74.140516,4.697157
627,2012,Enero,Nicaragua,0,1,,1,-75.736374,4.815189
628,2012,Enero,Nicaragua,4,7,,11,-75.42726,6.170465
629,2012,Enero,Nicaragua,0,1,,1,-73.181317,7.1280470000000005
630,2012,Enero,Nigeria,0,1,,1,-75.516486,10.446304
631,2012,Enero,Nigeria,0,2,,2,-76.532004,3.451668
632,2012,Enero,Nigeria,2,10,,12,-74.140516,4.697157
633,2012,Enero,Nigeria,0,2,,2,-75.42726,6.170465
634,2012,Enero,Noruega,1,0,,1,-69.941498,4.191162
635,2012,Enero,Noruega,3,2,,5,-77.35600000000001,0.81488
636,2012,Enero,Noruega,1,2,,3,-75.527794,10.406342
637,2012,Enero,Noruega,4,11,,15,-75.516486,10.446304
638,2012,Enero,Noruega,0,4,,4,-74.77647900000001,10.886686
639,2012,Enero,Noruega,5,4,,9,-74.213989,11.247722999999999
640,2012,Enero,Noruega,1,2,,3,-72.129595,11.360028999999999
641,2012,Enero,Noruega,7,6,,13,-76.532004,3.451668
642,2012,Enero,Noruega,59,138,,197,-74.140516,4.697157
643,2012,Enero,Noruega,4,8,,12,-75.42726,6.170465
644,2012,Enero,Noruega,1,0,,1,-73.181317,7.1280470000000005
645,2012,Enero,Noruega,1,2,,3,-72.453013,7.819
646,2012,Enero,Noruega,2,3,,5,-77.35002,8.63337
647,2012,Enero,Nueva Zelanda,1,2,,3,-69.941498,4.191162
648,2012,Enero,Nueva Zelanda,4,6,,10,-77.35600000000001,0.81488
649,2012,Enero,Nueva Zelanda,4,9,,13,-75.516486,10.446304
650,2012,Enero,Nueva Zelanda,0,1,,1,-74.77647900000001,10.886686
651,2012,Enero,Nueva Zelanda,3,1,,4,-76.532004,3.451668
652,2012,Enero,Nueva Zelanda,24,40,,64,-74.140516,4.697157
653,2012,Enero,Nueva Zelanda,0,1,,1,-75.736374,4.815189
654,2012,Enero,Nueva Zelanda,4,9,,13,-75.42726,6.170465
655,2012,Enero,Nueva Zelanda,0,1,,1,-72.453013,7.819
656,2012,Enero,Nueva Zelanda,0,1,,1,-77.35002,8.63337
657,2012,Enero,Nueva Zelanda,4,8,,12,-75.527794,10.406342
658,2012,Enero,Nueva Zelanda,1,0,,1,-75.516486,10.446304
659,2012,Enero,Nueva Zelanda,0,4,,4,-74.140516,4.697157
660,2012,Enero,Nueva Zelanda,2,3,,5,-77.35002,8.63337
661,2012,Enero,Países Bajos,23,29,,52,-77.35600000000001,0.81488
662,2012,Enero,Países Bajos,2,14,,16,-75.516486,10.446304
663,2012,Enero,Países Bajos,1,7,,8,-74.77647900000001,10.886686
664,2012,Enero,Países Bajos,1,7,,8,-72.129595,11.360028999999999
665,2012,Enero,Países Bajos,14,28,,42,-72.919186,11.52863
666,2012,Enero,Países Bajos,7,14,,21,-76.532004,3.451668
667,2012,Enero,Países Bajos,122,198,,320,-74.140516,4.697157
668,2012,Enero,Países Bajos,150,173,,323,-75.42726,6.170465
669,2012,Enero,Países Bajos,0,1,,1,-72.508188,7.927233
670,2012,Enero,Pakistán,1,0,,1,-75.516486,10.446304
671,2012,Enero,Pakistán,0,1,,1,-76.532004,3.451668
672,2012,Enero,Pakistán,0,17,,17,-74.140516,4.697157
673,2012,Enero,Pakistán,0,1,,1,-75.42726,6.170465
674,2012,Enero,Panamá,0,2,,2,-77.35600000000001,0.81488
675,2012,Enero,Panamá,0,3,,3,-75.527794,10.406342
676,2012,Enero,Panamá,106,149,,255,-75.516486,10.446304
677,2012,Enero,Panamá,61,93,,154,-74.77647900000001,10.886686
678,2012,Enero,Panamá,0,1,,1,-74.765343,10.970933
679,2012,Enero,Panamá,1,3,,4,-72.129595,11.360028999999999
680,2012,Enero,Panamá,0,4,,4,-81.703935,12.574411099999999
681,2012,Enero,Panamá,43,37,,80,-81.70216500000001,12.5862
682,2012,Enero,Panamá,85,118,,203,-76.532004,3.451668
683,2012,Enero,Panamá,0,1,,1,-75.76635300000001,4.45285
684,2012,Enero,Panamá,469,681,,1150,-74.140516,4.697157
685,2012,Enero,Panamá,49,76,,125,-75.736374,4.815189
686,2012,Enero,Panamá,127,224,,351,-75.42726,6.170465
687,2012,Enero,Panamá,2,1,,3,-77.401154,6.222551999999999
688,2012,Enero,Panamá,10,5,,15,-73.181317,7.1280470000000005
689,2012,Enero,Panamá,5,15,,20,-72.453013,7.819
690,2012,Enero,Panamá,6,10,,16,-72.508188,7.927233
691,2012,Enero,Panamá,6,7,,13,-77.35002,8.63337
692,2012,Enero,Paraguay,2,2,,4,-77.35600000000001,0.81488
693,2012,Enero,Paraguay,4,9,,13,-75.516486,10.446304
694,2012,Enero,Paraguay,1,0,,1,-72.129595,11.360028999999999
695,2012,Enero,Paraguay,15,5,,20,-81.70216500000001,12.5862
696,2012,Enero,Paraguay,8,5,,13,-76.532004,3.451668
697,2012,Enero,Paraguay,81,100,,181,-74.140516,4.697157
698,2012,Enero,Paraguay,0,4,,4,-75.42726,6.170465
699,2012,Enero,Paraguay,0,2,,2,-72.453013,7.819
700,2012,Enero,Perú,28,21,,49,-69.941498,4.191162
701,2012,Enero,Perú,0,2,,2,-76.876446,0.33002
702,2012,Enero,Perú,288,499,,787,-77.35600000000001,0.81488
703,2012,Enero,Perú,0,2,,2,-78.802679,18.00143
704,2012,Enero,Perú,17,24,,41,-75.527794,10.406342
705,2012,Enero,Perú,120,108,,228,-75.516486,10.446304
706,2012,Enero,Perú,13,18,,31,-74.77647900000001,10.886686
707,2012,Enero,Perú,2,12,,14,-72.129595,11.360028999999999
708,2012,Enero,Perú,149,123,,272,-81.70216500000001,12.5862
709,2012,Enero,Perú,83,124,,207,-76.532004,3.451668
710,2012,Enero,Perú,1672,2545,,4217,-74.140516,4.697157
711,2012,Enero,Perú,4,4,,8,-75.736374,4.815189
712,2012,Enero,Perú,182,358,,540,-75.42726,6.170465
713,2012,Enero,Perú,0,1,,1,-70.74025300000001,7.088728999999999
714,2012,Enero,Perú,1,4,,5,-73.181317,7.1280470000000005
715,2012,Enero,Perú,66,108,,174,-72.453013,7.819
716,2012,Enero,Perú,2,1,,3,-72.508188,7.927233
717,2012,Enero,Palestina,1,0,,1,-77.35600000000001,0.81488
718,2012,Enero,Palestina,1,3,,4,-74.140516,4.697157
719,2012,Enero,Polonia,0,4,,4,-69.941498,4.191162
720,2012,Enero,Polonia,2,7,,9,-77.35600000000001,0.81488
721,2012,Enero,Polonia,2,7,,9,-75.527794,10.406342
722,2012,Enero,Polonia,8,12,,20,-75.516486,10.446304
723,2012,Enero,Polonia,1,2,,3,-74.77647900000001,10.886686
724,2012,Enero,Polonia,0,2,,2,-74.765343,10.970933
725,2012,Enero,Polonia,0,1,,1,-74.213989,11.247722999999999
726,2012,Enero,Polonia,0,2,,2,-72.129595,11.360028999999999
727,2012,Enero,Polonia,4,3,,7,-76.532004,3.451668
728,2012,Enero,Polonia,86,123,,209,-74.140516,4.697157
729,2012,Enero,Polonia,0,1,,1,-75.736374,4.815189
730,2012,Enero,Polonia,2,2,,4,-75.42726,6.170465
731,2012,Enero,Polonia,3,1,,4,-72.453013,7.819
732,2012,Enero,Polonia,2,0,,2,-77.35002,8.63337
733,2012,Enero,Portugal,1,3,,4,-77.35600000000001,0.81488
734,2012,Enero,Portugal,1,4,,5,-75.527794,10.406342
735,2012,Enero,Portugal,1,1,,2,-75.516486,10.446304
736,2012,Enero,Portugal,4,7,,11,-72.129595,11.360028999999999
737,2012,Enero,Portugal,0,1,,1,-81.70216500000001,12.5862
738,2012,Enero,Portugal,0,8,,8,-76.532004,3.451668
739,2012,Enero,Portugal,82,241,,323,-74.140516,4.697157
740,2012,Enero,Portugal,5,23,,28,-75.42726,6.170465
741,2012,Enero,Portugal,2,6,,8,-72.453013,7.819
742,2012,Enero,Portugal,0,1,,1,-77.35002,8.63337
743,2012,Enero,Puerto Rico/Territorio de Estados Unidos,0,1,,1,-75.516486,10.446304
744,2012,Enero,Reino Unido de Gran Bretaña e Irlanda del Norte,4,9,,13,-69.941498,4.191162
745,2012,Enero,Reino Unido de Gran Bretaña e Irlanda del Norte,1,19,,20,-77.35600000000001,0.81488
746,2012,Enero,Reino Unido de Gran Bretaña e Irlanda del Norte,25,35,,60,-75.516486,10.446304
747,2012,Enero,Reino Unido de Gran Bretaña e Irlanda del Norte,0,1,,1,-74.77647900000001,10.886686
748,2012,Enero,Reino Unido de Gran Bretaña e Irlanda del Norte,2,6,,8,-72.129595,11.360028999999999
749,2012,Enero,Reino Unido de Gran Bretaña e Irlanda del Norte,1,1,,2,-72.919186,11.52863
750,2012,Enero,Reino Unido de Gran Bretaña e Irlanda del Norte,6,20,,26,-76.532004,3.451668
751,2012,Enero,Reino Unido de Gran Bretaña e Irlanda del Norte,182,432,,614,-74.140516,4.697157
752,2012,Enero,Reino Unido de Gran Bretaña e Irlanda del Norte,9,20,,29,-75.42726,6.170465
753,2012,Enero,Reino Unido de Gran Bretaña e Irlanda del Norte,1,7,,8,-72.453013,7.819
754,2012,Enero,Reino Unido de Gran Bretaña e Irlanda del Norte,1,2,,3,-77.35002,8.63337
755,2012,Enero,República de Belarús,4,3,,7,-74.140516,4.697157
756,2012,Enero,República Dominicana,0,4,,4,-77.35600000000001,0.81488
757,2012,Enero,República Dominicana,0,7,,7,-75.527794,10.406342
758,2012,Enero,República Dominicana,13,45,,58,-75.516486,10.446304
759,2012,Enero,República Dominicana,5,39,,44,-74.77647900000001,10.886686
760,2012,Enero,República Dominicana,1,5,,6,-72.129595,11.360028999999999
761,2012,Enero,República Dominicana,23,17,,40,-76.532004,3.451668
762,2012,Enero,República Dominicana,0,1,,1,-75.76635300000001,4.45285
763,2012,Enero,República Dominicana,154,234,,388,-74.140516,4.697157
764,2012,Enero,República Dominicana,2,2,,4,-75.736374,4.815189
765,2012,Enero,República Dominicana,30,49,,79,-75.42726,6.170465
766,2012,Enero,República Dominicana,0,1,,1,-70.74025300000001,7.088728999999999
767,2012,Enero,República Dominicana,5,5,,10,-73.181317,7.1280470000000005
768,2012,Enero,República Dominicana,0,4,,4,-72.453013,7.819
769,2012,Enero,República Dominicana,4,17,,21,-72.508188,7.927233
770,2012,Enero,República Checa,0,1,,1,-75.527794,10.406342
771,2012,Enero,República Checa,6,7,,13,-74.140516,4.697157
772,2012,Enero,República Checa,0,1,,1,-77.401154,6.222551999999999
773,2012,Enero,República Checa,1,0,,1,-72.453013,7.819
774,2012,Enero,República Democrática Popular de Corea,1,1,,2,-74.140516,4.697157
775,2012,Enero,Rumania,0,2,,2,-77.35600000000001,0.81488
776,2012,Enero,Rumania,0,2,,2,-75.527794,10.406342
777,2012,Enero,Rumania,2,5,,7,-75.516486,10.446304
778,2012,Enero,Rumania,0,1,,1,-72.129595,11.360028999999999
779,2012,Enero,Rumania,4,1,,5,-76.532004,3.451668
780,2012,Enero,Rumania,25,49,,74,-74.140516,4.697157
781,2012,Enero,Rumania,0,1,,1,-75.736374,4.815189
782,2012,Enero,Rumania,0,2,,2,-75.42726,6.170465
783,2012,Enero,Rumania,0,2,,2,-77.35002,8.63337
784,2012,Enero,Federación de Rusia,2,11,,13,-77.35600000000001,0.81488
785,2012,Enero,Federación de Rusia,5,6,,11,-75.516486,10.446304
786,2012,Enero,Federación de Rusia,1,1,,2,-72.129595,11.360028999999999
787,2012,Enero,Federación de Rusia,5,6,,11,-76.532004,3.451668
788,2012,Enero,Federación de Rusia,0,2,,2,-77.061029,3.8844260000000004
789,2012,Enero,Federación de Rusia,112,135,,247,-74.140516,4.697157
790,2012,Enero,Federación de Rusia,1,0,,1,-75.736374,4.815189
791,2012,Enero,Federación de Rusia,2,4,,6,-75.42726,6.170465
792,2012,Enero,Federación de Rusia,1,0,,1,-73.181317,7.1280470000000005
793,2012,Enero,Rwanda,1,1,,2,-74.140516,4.697157
794,2012,Enero,San Marino,0,1,,1,-69.941498,4.191162
795,2012,Enero,San Marino,0,2,,2,-74.140516,4.697157
796,2012,Enero,San  Vicente y las Granadinas,0,1,,1,-75.516486,10.446304
797,2012,Enero,San  Vicente y las Granadinas,0,1,,1,-81.70216500000001,12.5862
798,2012,Enero,Santa Lucia,1,0,,1,-75.516486,10.446304
799,2012,Enero,Santa Lucia,0,2,,2,-74.140516,4.697157
800,2012,Enero,Santa Lucia,1,1,,2,-73.181317,7.1280470000000005
801,2012,Enero,Santa Sede/Ciudad del Vaticano,0,2,,2,-74.140516,4.697157
802,2012,Enero,Santo Tomé y Príncipe,0,1,,1,-69.941498,4.191162
803,2012,Enero,Senegal,1,0,,1,-74.140516,4.697157
804,2012,Enero,Serbia,0,1,,1,-77.35600000000001,0.81488
805,2012,Enero,Serbia,0,2,,2,-75.516486,10.446304
806,2012,Enero,Serbia,2,4,,6,-74.140516,4.697157
807,2012,Enero,Sierra Leona,0,1,,1,-74.140516,4.697157
808,2012,Enero,Singapur,0,1,,1,-77.35600000000001,0.81488
809,2012,Enero,Singapur,0,2,,2,-75.516486,10.446304
810,2012,Enero,Singapur,9,12,,21,-74.140516,4.697157
811,2012,Enero,Singapur,0,1,,1,-75.42726,6.170465
812,2012,Enero,República Árabe Siria,1,4,,5,-74.140516,4.697157
813,2012,Enero,República Árabe Siria,0,1,,1,-75.42726,6.170465
814,2012,Enero,Sri Lanka,0,2,,2,-74.140516,4.697157
815,2012,Enero,Sudáfrica,0,2,,2,-77.35600000000001,0.81488
816,2012,Enero,Sudáfrica,0,1,,1,-75.527794,10.406342
817,2012,Enero,Sudáfrica,0,3,,3,-74.77647900000001,10.886686
818,2012,Enero,Sudáfrica,0,1,,1,-76.532004,3.451668
819,2012,Enero,Sudáfrica,29,75,,104,-74.140516,4.697157
820,2012,Enero,Sudáfrica,1,1,,2,-75.42726,6.170465
821,2012,Enero,Sudáfrica,0,1,,1,-77.35002,8.63337
822,2012,Enero,Sudán,2,2,,4,-74.140516,4.697157
823,2012,Enero,Suecia,1,4,,5,-69.941498,4.191162
824,2012,Enero,Suecia,9,10,,19,-77.35600000000001,0.81488
825,2012,Enero,Suecia,4,10,,14,-75.527794,10.406342
826,2012,Enero,Suecia,12,22,,34,-75.516486,10.446304
827,2012,Enero,Suecia,0,1,,1,-74.77647900000001,10.886686
828,2012,Enero,Suecia,2,8,,10,-72.129595,11.360028999999999
829,2012,Enero,Suecia,12,13,,25,-76.532004,3.451668
830,2012,Enero,Suecia,191,298,,489,-74.140516,4.697157
831,2012,Enero,Suecia,7,14,,21,-75.42726,6.170465
832,2012,Enero,Suecia,4,3,,7,-72.453013,7.819
833,2012,Enero,Suecia,1,0,,1,-72.508188,7.927233
834,2012,Enero,Suecia,2,6,,8,-77.35002,8.63337
835,2012,Enero,Suiza,1,5,,6,-69.941498,4.191162
836,2012,Enero,Suiza,12,30,,42,-77.35600000000001,0.81488
837,2012,Enero,Suiza,11,16,,27,-75.527794,10.406342
838,2012,Enero,Suiza,14,18,,32,-75.516486,10.446304
839,2012,Enero,Suiza,2,7,,9,-74.77647900000001,10.886686
840,2012,Enero,Suiza,1,2,,3,-74.213989,11.247722999999999
841,2012,Enero,Suiza,5,9,,14,-72.129595,11.360028999999999
842,2012,Enero,Suiza,1,1,,2,-81.70216500000001,12.5862
843,2012,Enero,Suiza,18,30,,48,-76.532004,3.451668
844,2012,Enero,Suiza,317,483,,800,-74.140516,4.697157
845,2012,Enero,Suiza,20,54,,74,-75.42726,6.170465
846,2012,Enero,Suiza,1,8,,9,-72.453013,7.819
847,2012,Enero,Suiza,5,4,,9,-77.35002,8.63337
848,2012,Enero,Surinam,0,3,,3,-76.532004,3.451668
849,2012,Enero,Surinam,16,14,,30,-74.140516,4.697157
850,2012,Enero,Surinam,0,3,,3,-75.42726,6.170465
851,2012,Enero,Taiwán,5,6,,11,-74.140516,4.697157
852,2012,Enero,Tailandia,4,3,,7,-74.140516,4.697157
853,2012,Enero,Tailandia,1,0,,1,-75.42726,6.170465
854,2012,Enero,Territorio Antártico Británico/Territorio Británico de Ultramar,1,7,,8,-74.140516,4.697157
855,2012,Enero,Tanzania,1,2,,3,-74.140516,4.697157
856,2012,Enero,República Democrática de Timor Oriental,0,1,,1,-74.140516,4.697157
857,2012,Enero,Togo,0,1,,1,-74.140516,4.697157
858,2012,Enero,Trinidad y Tobago,0,7,,7,-75.516486,10.446304
859,2012,Enero,Trinidad y Tobago,0,3,,3,-74.77647900000001,10.886686
860,2012,Enero,Trinidad y Tobago,0,1,,1,-72.129595,11.360028999999999
861,2012,Enero,Trinidad y Tobago,2,4,,6,-76.532004,3.451668
862,2012,Enero,Trinidad y Tobago,21,37,,58,-74.140516,4.697157
863,2012,Enero,Trinidad y Tobago,0,1,,1,-75.736374,4.815189
864,2012,Enero,Trinidad y Tobago,0,3,,3,-75.42726,6.170465
865,2012,Enero,Trinidad y Tobago,0,3,,3,-73.181317,7.1280470000000005
866,2012,Enero,Trinidad y Tobago,0,1,,1,-72.453013,7.819
867,2012,Enero,Túnez,0,2,,2,-74.140516,4.697157
868,2012,Enero,Turquía,3,5,,8,-77.35600000000001,0.81488
869,2012,Enero,Turquía,0,2,,2,-75.527794,10.406342
870,2012,Enero,Turquía,1,7,,8,-75.516486,10.446304
871,2012,Enero,Turquía,1,1,,2,-76.532004,3.451668
872,2012,Enero,Turquía,16,90,,106,-74.140516,4.697157
873,2012,Enero,Turquía,5,8,,13,-75.42726,6.170465
874,2012,Enero,Turquía,0,2,,2,-72.453013,7.819
875,2012,Enero,Turkmenistán,1,0,,1,-74.140516,4.697157
876,2012,Enero,Ucrania,0,1,,1,-75.527794,10.406342
877,2012,Enero,Ucrania,0,1,,1,-76.532004,3.451668
878,2012,Enero,Ucrania,0,1,,1,-77.061029,3.8844260000000004
879,2012,Enero,Ucrania,30,25,,55,-74.140516,4.697157
880,2012,Enero,Ucrania,1,1,,2,-75.42726,6.170465
881,2012,Enero,Ucrania,0,1,,1,-77.35002,8.63337
882,2012,Enero,Uganda,2,7,,9,-74.140516,4.697157
883,2012,Enero,Federación de Rusia,1,3,,4,-69.941498,4.191162
884,2012,Enero,Federación de Rusia,1,0,,1,-75.527794,10.406342
885,2012,Enero,Federación de Rusia,3,1,,4,-75.516486,10.446304
886,2012,Enero,Federación de Rusia,1,1,,2,-72.129595,11.360028999999999
887,2012,Enero,Federación de Rusia,4,0,,4,-81.70216500000001,12.5862
888,2012,Enero,Federación de Rusia,0,1,,1,-76.532004,3.451668
889,2012,Enero,Federación de Rusia,148,223,,371,-74.140516,4.697157
890,2012,Enero,Federación de Rusia,1,2,,3,-75.42726,6.170465
891,2012,Enero,Federación de Rusia,8,8,,16,-72.453013,7.819
892,2012,Enero,Federación de Rusia,0,1,,1,-75.68164200000001,9.402597
893,2012,Enero,Uruguay,7,6,,13,-77.35600000000001,0.81488
894,2012,Enero,Uruguay,3,1,,4,-75.527794,10.406342
895,2012,Enero,Uruguay,92,58,,150,-75.516486,10.446304
896,2012,Enero,Uruguay,6,8,,14,-74.77647900000001,10.886686
897,2012,Enero,Uruguay,1,3,,4,-72.129595,11.360028999999999
898,2012,Enero,Uruguay,50,43,,93,-81.70216500000001,12.5862
899,2012,Enero,Uruguay,13,20,,33,-76.532004,3.451668
900,2012,Enero,Uruguay,116,220,,336,-74.140516,4.697157
901,2012,Enero,Uruguay,0,6,,6,-75.736374,4.815189
902,2012,Enero,Uruguay,11,28,,39,-75.42726,6.170465
903,2012,Enero,Uruguay,0,1,,1,-73.181317,7.1280470000000005
904,2012,Enero,Uruguay,1,8,,9,-72.453013,7.819
905,2012,Enero,Uruguay,1,1,,2,-77.35002,8.63337
906,2012,Enero,Uzbekistán,0,1,,1,-76.532004,3.451668
907,2012,Enero,Venezuela,297,339,,636,-77.35600000000001,0.81488
908,2012,Enero,Venezuela,7,12,,19,-75.527794,10.406342
909,2012,Enero,Venezuela,76,133,,209,-75.516486,10.446304
910,2012,Enero,Venezuela,55,70,,125,-74.77647900000001,10.886686
911,2012,Enero,Venezuela,0,4,,4,-74.232675,11.117206
912,2012,Enero,Venezuela,1265,1721,,2986,-72.129595,11.360028999999999
913,2012,Enero,Venezuela,1,0,,1,-72.919186,11.52863
914,2012,Enero,Venezuela,13,13,,26,-81.70216500000001,12.5862
915,2012,Enero,Venezuela,53,58,,111,-76.532004,3.451668
916,2012,Enero,Venezuela,5306,6178,,11484,-74.140516,4.697157
917,2012,Enero,Venezuela,7,24,,31,-75.736374,4.815189
918,2012,Enero,Venezuela,362,421,,783,-75.42726,6.170465
919,2012,Enero,Venezuela,5,3,,8,-67.48402800000001,6.185536
920,2012,Enero,Venezuela,67,81,,148,-70.74025300000001,7.088728999999999
921,2012,Enero,Venezuela,3,1,,4,-73.181317,7.1280470000000005
922,2012,Enero,Venezuela,1767,1997,,3764,-72.453013,7.819
923,2012,Enero,Venezuela,431,487,,918,-72.508188,7.927233
924,2012,Enero,Venezuela,1,1,,2,-77.35002,8.63337
925,2012,Enero,Vietnam,1,1,,2,-74.140516,4.697157
926,2012,Enero,Yugoslavia,1,3,,4,-74.140516,4.697157
927,2012,Enero,Zimbabue,0,1,,1,-76.532004,3.451668
928,2012,Enero,Zimbabue,0,1,,1,-74.140516,4.697157
929,2012,Enero,Reino Unido de Gran Bretaña e Irlanda del Norte,4,12,,16,-77.35600000000001,0.81488
930,2012,Enero,Reino Unido de Gran Bretaña e Irlanda del Norte,14,29,,43,-75.527794,10.406342
931,2012,Enero,Reino Unido de Gran Bretaña e Irlanda del Norte,19,34,,53,-75.516486,10.446304
932,2012,Enero,Reino Unido de Gran Bretaña e Irlanda del Norte,1,2,,3,-74.77647900000001,10.886686
933,2012,Enero,Reino Unido de Gran Bretaña e Irlanda del Norte,2,3,,5,-74.213989,11.247722999999999
934,2012,Enero,Reino Unido de Gran Bretaña e Irlanda del Norte,1,4,,5,-72.129595,11.360028999999999
935,2012,Enero,Reino Unido de Gran Bretaña e Irlanda del Norte,0,1,,1,-81.372937,13.338761300000002
936,2012,Enero,Reino Unido de Gran Bretaña e Irlanda del Norte,5,24,,29,-76.532004,3.451668
937,2012,Enero,Reino Unido de Gran Bretaña e Irlanda del Norte,302,742,,1044,-74.140516,4.697157
938,2012,Enero,Reino Unido de Gran Bretaña e Irlanda del Norte,9,47,,56,-75.42726,6.170465
939,2012,Enero,Reino Unido de Gran Bretaña e Irlanda del Norte,4,11,,15,-72.453013,7.819
940,2012,Enero,Reino Unido de Gran Bretaña e Irlanda del Norte,3,4,,7,-77.35002,8.63337
941,2012,Enero,Reino Unido de Gran Bretaña e Irlanda del Norte,0,1,,1,-75.68164200000001,9.402597
942,2012,Enero,Países Bajos,6,10,,16,-69.941498,4.191162
943,2012,Enero,Países Bajos,0,1,,1,-76.876446,0.33002
944,2012,Enero,Países Bajos,49,113,,162,-77.35600000000001,0.81488
945,2012,Enero,Países Bajos,7,11,,18,-75.527794,10.406342
946,2012,Enero,Países Bajos,10,32,,42,-75.516486,10.446304
947,2012,Enero,Países Bajos,1,0,,1,-74.77647900000001,10.886686
948,2012,Enero,Países Bajos,1,1,,2,-74.213989,11.247722999999999
949,2012,Enero,Países Bajos,2,5,,7,-72.129595,11.360028999999999
950,2012,Enero,Países Bajos,1,0,,1,-81.70216500000001,12.5862
951,2012,Enero,Países Bajos,8,22,,30,-76.532004,3.451668
952,2012,Enero,Países Bajos,365,698,,1063,-74.140516,4.697157
953,2012,Enero,Países Bajos,19,36,,55,-75.42726,6.170465
954,2012,Enero,Países Bajos,0,2,,2,-73.181317,7.1280470000000005
955,2012,Enero,Países Bajos,3,12,,15,-72.453013,7.819
956,2012,Enero,Países Bajos,5,2,,7,-77.35002,8.63337
957,2012,Enero,Desconocido,0,1,,1,-74.140516,4.697157
958,2012,Enero,Eslovenia,2,0,,2,-74.140516,4.697157
959,2012,Enero,Lituania,0,1,,1,-76.532004,3.451668
960,2012,Enero,Lituania,0,3,,3,-74.140516,4.697157
961,2012,Enero,Reino Unido de Gran Bretaña e Irlanda del Norte,2,0,,2,-74.213989,11.247722999999999
962,2012,Enero,Reino Unido de Gran Bretaña e Irlanda del Norte,0,1,,1,-76.532004,3.451668
963,2012,Enero,Reino Unido de Gran Bretaña e Irlanda del Norte,0,1,,1,-76.532004,3.451668
964,2012,Enero,Reino Unido de Gran Bretaña e Irlanda del Norte,2,7,,9,-74.140516,4.697157
965,2012,Enero,Reino Unido de Gran Bretaña e Irlanda del Norte,3,7,,10,-75.527794,10.406342
966,2012,Enero,Reino Unido de Gran Bretaña e Irlanda del Norte,0,2,,2,-75.516486,10.446304
967,2012,Enero,Reino Unido de Gran Bretaña e Irlanda del Norte,0,1,,1,-76.532004,3.451668
968,2012,Enero,Reino Unido de Gran Bretaña e Irlanda del Norte,0,17,,17,-74.140516,4.697157
969,2012,Enero,Letonia,1,0,,1,-75.516486,10.446304
970,2012,Enero,Letonia,0,1,,1,-74.140516,4.697157
971,2012,Enero,Letonia,0,1,,1,-75.68164200000001,9.402597
972,2012,Enero,República CentroÁfricana,0,1,,1,-74.140516,4.697157
973,2012,Febrero,Albania,0,1,,1,-74.140516,4.697157
974,2012,Febrero,Alemania,10,13,,23,-69.941498,4.191162
975,2012,Febrero,Alemania,1,0,,1,-76.876446,0.33002
976,2012,Febrero,Alemania,54,80,,134,-77.35600000000001,0.81488
977,2012,Febrero,Alemania,20,36,,56,-75.527794,10.406342
978,2012,Febrero,Alemania,26,52,,78,-75.516486,10.446304
979,2012,Febrero,Alemania,6,15,,21,-74.77647900000001,10.886686
980,2012,Febrero,Alemania,0,1,,1,-74.765343,10.970933
981,2012,Febrero,Alemania,1,3,,4,-74.213989,11.247722999999999
982,2012,Febrero,Alemania,11,18,,29,-72.129595,11.360028999999999
983,2012,Febrero,Alemania,1,1,,2,-81.703935,12.574411099999999
984,2012,Febrero,Alemania,4,7,,11,-81.70216500000001,12.5862
985,2012,Febrero,Alemania,2,5,,7,-81.372937,13.338761300000002
986,2012,Febrero,Alemania,31,60,,91,-76.532004,3.451668
987,2012,Febrero,Alemania,0,2,,2,-75.76635300000001,4.45285
988,2012,Febrero,Alemania,1259,2083,,3342,-74.140516,4.697157
989,2012,Febrero,Alemania,38,67,,105,-75.42726,6.170465
990,2012,Febrero,Alemania,0,1,,1,-73.181317,7.1280470000000005
991,2012,Febrero,Alemania,13,10,,23,-72.453013,7.819
992,2012,Febrero,Alemania,6,19,,25,-77.35002,8.63337
993,2012,Febrero,Andorra,1,4,,5,-74.140516,4.697157
994,2012,Febrero,Angola,1,0,,1,-76.532004,3.451668
995,2012,Febrero,Angola,3,0,,3,-74.140516,4.697157
996,2012,Febrero,Antigua y Barbuda,0,1,,1,-75.516486,10.446304
997,2012,Febrero,Antigua y Barbuda,1,1,,2,-74.140516,4.697157
998,2012,Febrero,Arabia Saudita,0,1,,1,-74.140516,4.697157
999,2012,Febrero,Arabia Saudita,0,1,,1,-74.140516,4.697157
1000,2012,Febrero,Arabia Saudita,0,1,,1,-75.42726,6.170465
1001,2012,Febrero,Argelia,0,2,,2,-74.140516,4.697157
1002,2012,Febrero,Argentina,8,12,,20,-69.941498,4.191162
1003,2012,Febrero,Argentina,1,0,,1,-76.876446,0.33002
1004,2012,Febrero,Argentina,101,156,,257,-77.35600000000001,0.81488
1005,2012,Febrero,Argentina,1,3,,4,-78.802679,18.00143
1006,2012,Febrero,Argentina,130,99,,229,-75.527794,10.406342
1007,2012,Febrero,Argentina,475,353,,828,-75.516486,10.446304
1008,2012,Febrero,Argentina,11,30,,41,-74.77647900000001,10.886686
1009,2012,Febrero,Argentina,26,34,,60,-72.129595,11.360028999999999
1010,2012,Febrero,Argentina,207,150,,357,-81.70216500000001,12.5862
1011,2012,Febrero,Argentina,27,69,,96,-76.532004,3.451668
1012,2012,Febrero,Argentina,3266,4563,,7829,-74.140516,4.697157
1013,2012,Febrero,Argentina,1,3,,4,-75.736374,4.815189
1014,2012,Febrero,Argentina,72,171,,243,-75.42726,6.170465
1015,2012,Febrero,Argentina,0,1,,1,-67.48402800000001,6.185536
1016,2012,Febrero,Argentina,0,1,,1,-73.181317,7.1280470000000005
1017,2012,Febrero,Argentina,33,65,,98,-72.453013,7.819
1018,2012,Febrero,Argentina,0,3,,3,-72.508188,7.927233
1019,2012,Febrero,Argentina,5,15,,20,-77.35002,8.63337
1020,2012,Febrero,República de Armenia,0,5,,5,-74.140516,4.697157
1021,2012,Febrero,Aruba,0,1,,1,-74.140516,4.697157
1022,2012,Febrero,Aruba,0,1,,1,-75.42726,6.170465
1023,2012,Febrero,Australia,3,4,,7,-69.941498,4.191162
1024,2012,Febrero,Australia,14,33,,47,-77.35600000000001,0.81488
1025,2012,Febrero,Australia,17,22,,39,-75.527794,10.406342
1026,2012,Febrero,Australia,23,33,,56,-75.516486,10.446304
1027,2012,Febrero,Australia,7,19,,26,-74.77647900000001,10.886686
1028,2012,Febrero,Australia,1,6,,7,-72.129595,11.360028999999999
1029,2012,Febrero,Australia,4,18,,22,-76.532004,3.451668
1030,2012,Febrero,Australia,0,1,,1,-75.76635300000001,4.45285
1031,2012,Febrero,Australia,188,360,,548,-74.140516,4.697157
1032,2012,Febrero,Australia,1,1,,2,-75.736374,4.815189
1033,2012,Febrero,Australia,22,46,,68,-75.42726,6.170465
1034,2012,Febrero,Australia,3,1,,4,-72.453013,7.819
1035,2012,Febrero,Australia,8,9,,17,-77.35002,8.63337
1036,2012,Febrero,Australia,3,4,,7,-69.941498,4.191162
1037,2012,Febrero,Australia,12,11,,23,-77.35600000000001,0.81488
1038,2012,Febrero,Australia,2,2,,4,-75.527794,10.406342
1039,2012,Febrero,Australia,2,5,,7,-75.516486,10.446304
1040,2012,Febrero,Australia,0,2,,2,-74.77647900000001,10.886686
1041,2012,Febrero,Australia,3,0,,3,-72.129595,11.360028999999999
1042,2012,Febrero,Australia,2,2,,4,-81.70216500000001,12.5862
1043,2012,Febrero,Australia,3,4,,7,-76.532004,3.451668
1044,2012,Febrero,Australia,123,235,,358,-74.140516,4.697157
1045,2012,Febrero,Australia,5,11,,16,-75.42726,6.170465
1046,2012,Febrero,Australia,2,4,,6,-72.453013,7.819
1047,2012,Febrero,Australia,0,1,,1,-72.508188,7.927233
1048,2012,Febrero,Australia,3,5,,8,-77.35002,8.63337
1049,2012,Febrero,Azerbaiyán,1,0,,1,-76.532004,3.451668
1050,2012,Febrero,Azerbaiyán,1,0,,1,-74.140516,4.697157
1051,2012,Febrero,Bahamas,1,4,,5,-75.516486,10.446304
1052,2012,Febrero,Bahamas,0,1,,1,-74.77647900000001,10.886686
1053,2012,Febrero,Bahamas,5,12,,17,-74.140516,4.697157
1054,2012,Febrero,Bahréin,1,0,,1,-74.140516,4.697157
1055,2012,Febrero,Bangladesh,0,3,,3,-74.140516,4.697157
1056,2012,Febrero,Barbados,1,1,,2,-75.516486,10.446304
1057,2012,Febrero,Barbados,4,2,,6,-74.140516,4.697157
1058,2012,Febrero,Barbados,0,1,,1,-75.42726,6.170465
1059,2012,Febrero,República de Belarús,1,0,,1,-75.527794,10.406342
1060,2012,Febrero,República de Belarús,1,1,,2,-74.140516,4.697157
1061,2012,Febrero,Bélgica,0,1,,1,-76.876446,0.33002
1062,2012,Febrero,Bélgica,4,5,,9,-77.35600000000001,0.81488
1063,2012,Febrero,Bélgica,3,3,,6,-75.527794,10.406342
1064,2012,Febrero,Bélgica,16,21,,37,-75.516486,10.446304
1065,2012,Febrero,Bélgica,1,2,,3,-74.77647900000001,10.886686
1066,2012,Febrero,Bélgica,2,3,,5,-74.213989,11.247722999999999
1067,2012,Febrero,Bélgica,1,2,,3,-72.129595,11.360028999999999
1068,2012,Febrero,Bélgica,0,2,,2,-81.70216500000001,12.5862
1069,2012,Febrero,Bélgica,2,13,,15,-76.532004,3.451668
1070,2012,Febrero,Bélgica,0,13,,13,-77.061029,3.8844260000000004
1071,2012,Febrero,Bélgica,102,290,,392,-74.140516,4.697157
1072,2012,Febrero,Bélgica,7,14,,21,-75.42726,6.170465
1073,2012,Febrero,Bélgica,0,1,,1,-73.181317,7.1280470000000005
1074,2012,Febrero,Bélgica,3,1,,4,-72.453013,7.819
1075,2012,Febrero,Bélgica,2,0,,2,-77.35002,8.63337
1076,2012,Febrero,Belice,0,1,,1,-75.516486,10.446304
1077,2012,Febrero,Belice,1,1,,2,-74.77647900000001,10.886686
1078,2012,Febrero,Belice,1,4,,5,-74.140516,4.697157
1079,2012,Febrero,Belice,0,1,,1,-75.736374,4.815189
1080,2012,Febrero,Benín,2,2,,4,-74.140516,4.697157
1081,2012,Febrero,Bolivia,0,1,,1,-69.941498,4.191162
1082,2012,Febrero,Bolivia,13,16,,29,-77.35600000000001,0.81488
1083,2012,Febrero,Bolivia,1,0,,1,-75.527794,10.406342
1084,2012,Febrero,Bolivia,10,13,,23,-75.516486,10.446304
1085,2012,Febrero,Bolivia,2,5,,7,-74.77647900000001,10.886686
1086,2012,Febrero,Bolivia,0,1,,1,-72.129595,11.360028999999999
1087,2012,Febrero,Bolivia,10,8,,18,-81.70216500000001,12.5862
1088,2012,Febrero,Bolivia,13,5,,18,-76.532004,3.451668
1089,2012,Febrero,Bolivia,217,371,,588,-74.140516,4.697157
1090,2012,Febrero,Bolivia,0,3,,3,-75.736374,4.815189
1091,2012,Febrero,Bolivia,36,47,,83,-75.42726,6.170465
1092,2012,Febrero,Bolivia,1,3,,4,-72.453013,7.819
1093,2012,Febrero,Bosnia y Herzegovina,0,2,,2,-74.140516,4.697157
1094,2012,Febrero,Bosnia y Herzegovina,0,1,,1,-72.508188,7.927233
1095,2012,Febrero,Brasil,84,97,,181,-69.941498,4.191162
1096,2012,Febrero,Brasil,11,31,,42,-77.35600000000001,0.81488
1097,2012,Febrero,Brasil,0,1,,1,-78.802679,18.00143
1098,2012,Febrero,Brasil,83,67,,150,-75.527794,10.406342
1099,2012,Febrero,Brasil,110,101,,211,-75.516486,10.446304
1100,2012,Febrero,Brasil,8,22,,30,-74.77647900000001,10.886686
1101,2012,Febrero,Brasil,8,8,,16,-72.129595,11.360028999999999
1102,2012,Febrero,Brasil,60,42,,102,-81.70216500000001,12.5862
1103,2012,Febrero,Brasil,19,44,,63,-76.532004,3.451668
1104,2012,Febrero,Brasil,2919,3973,,6892,-74.140516,4.697157
1105,2012,Febrero,Brasil,4,4,,8,-75.736374,4.815189
1106,2012,Febrero,Brasil,18,72,,90,-75.42726,6.170465
1107,2012,Febrero,Brasil,0,3,,3,-67.48402800000001,6.185536
1108,2012,Febrero,Brasil,1,20,,21,-72.453013,7.819
1109,2012,Febrero,Brasil,0,16,,16,-72.508188,7.927233
1110,2012,Febrero,Brasil,1,1,,2,-77.35002,8.63337
1111,2012,Febrero,Bulgaria,1,0,,1,-76.532004,3.451668
1112,2012,Febrero,Bulgaria,4,7,,11,-74.140516,4.697157
1113,2012,Febrero,Bulgaria,2,1,,3,-75.42726,6.170465
1114,2012,Febrero,Burundi,0,1,,1,-75.42726,6.170465
1115,2012,Febrero,Islas Caimán/Territorio Británico de Ultramar,1,0,,1,-74.140516,4.697157
1116,2012,Febrero,Camboya,0,2,,2,-74.140516,4.697157
1117,2012,Febrero,Camerún,1,2,,3,-74.140516,4.697157
1118,2012,Febrero,Canadá,3,7,,10,-69.941498,4.191162
1119,2012,Febrero,Canadá,21,30,,51,-77.35600000000001,0.81488
1120,2012,Febrero,Canadá,21,31,,52,-75.527794,10.406342
1121,2012,Febrero,Canadá,1170,1142,,2312,-75.516486,10.446304
1122,2012,Febrero,Canadá,12,26,,38,-74.77647900000001,10.886686
1123,2012,Febrero,Canadá,2,8,,10,-72.129595,11.360028999999999
1124,2012,Febrero,Canadá,446,456,,902,-81.70216500000001,12.5862
1125,2012,Febrero,Canadá,2,3,,5,-81.372937,13.338761300000002
1126,2012,Febrero,Canadá,20,42,,62,-76.532004,3.451668
1127,2012,Febrero,Canadá,5,8,,13,-75.76635300000001,4.45285
1128,2012,Febrero,Canadá,725,1389,,2114,-74.140516,4.697157
1129,2012,Febrero,Canadá,2,4,,6,-75.736374,4.815189
1130,2012,Febrero,Canadá,54,143,,197,-75.42726,6.170465
1131,2012,Febrero,Canadá,1,1,,2,-73.181317,7.1280470000000005
1132,2012,Febrero,Canadá,1,9,,10,-72.453013,7.819
1133,2012,Febrero,Canadá,1,1,,2,-72.508188,7.927233
1134,2012,Febrero,Canadá,3,7,,10,-77.35002,8.63337
1135,2012,Febrero,España,9,27,,36,-77.35600000000001,0.81488
1136,2012,Febrero,España,2,6,,8,-75.527794,10.406342
1137,2012,Febrero,España,10,18,,28,-75.516486,10.446304
1138,2012,Febrero,España,6,19,,25,-74.77647900000001,10.886686
1139,2012,Febrero,España,0,1,,1,-72.129595,11.360028999999999
1140,2012,Febrero,España,8,4,,12,-81.70216500000001,12.5862
1141,2012,Febrero,España,61,141,,202,-76.532004,3.451668
1142,2012,Febrero,España,0,1,,1,-75.76635300000001,4.45285
1143,2012,Febrero,España,147,421,,568,-74.140516,4.697157
1144,2012,Febrero,España,26,91,,117,-75.42726,6.170465
1145,2012,Febrero,España,1,1,,2,-72.508188,7.927233
1146,2012,Febrero,República Democrática del Congo,3,1,,4,-74.140516,4.697157
1147,2012,Febrero,República de Corea,2,0,,2,-69.941498,4.191162
1148,2012,Febrero,República de Corea,8,5,,13,-77.35600000000001,0.81488
1149,2012,Febrero,República de Corea,2,3,,5,-75.516486,10.446304
1150,2012,Febrero,República de Corea,2,3,,5,-74.77647900000001,10.886686
1151,2012,Febrero,República de Corea,0,1,,1,-74.765343,10.970933
1152,2012,Febrero,República de Corea,0,1,,1,-81.70216500000001,12.5862
1153,2012,Febrero,República de Corea,1,2,,3,-76.532004,3.451668
1154,2012,Febrero,República de Corea,100,417,,517,-74.140516,4.697157
1155,2012,Febrero,República de Corea,0,11,,11,-75.42726,6.170465
1156,2012,Febrero,República de Corea,0,2,,2,-72.453013,7.819
1157,2012,Febrero,República de Corea,0,2,,2,-77.35002,8.63337
1158,2012,Febrero,Costa de Marfil,1,0,,1,-74.140516,4.697157
1159,2012,Febrero,Costa Rica,3,1,,4,-77.35600000000001,0.81488
1160,2012,Febrero,Costa Rica,26,31,,57,-75.516486,10.446304
1161,2012,Febrero,Costa Rica,16,26,,42,-74.77647900000001,10.886686
1162,2012,Febrero,Costa Rica,0,1,,1,-72.129595,11.360028999999999
1163,2012,Febrero,Costa Rica,0,1,,1,-81.703935,12.574411099999999
1164,2012,Febrero,Costa Rica,290,248,,538,-81.70216500000001,12.5862
1165,2012,Febrero,Costa Rica,18,39,,57,-76.532004,3.451668
1166,2012,Febrero,Costa Rica,271,530,,801,-74.140516,4.697157
1167,2012,Febrero,Costa Rica,2,3,,5,-75.736374,4.815189
1168,2012,Febrero,Costa Rica,72,99,,171,-75.42726,6.170465
1169,2012,Febrero,Costa Rica,1,0,,1,-73.181317,7.1280470000000005
1170,2012,Febrero,Costa Rica,3,2,,5,-72.453013,7.819
1171,2012,Febrero,Costa Rica,1,0,,1,-77.35002,8.63337
1172,2012,Febrero,Croacia,1,3,,4,-75.527794,10.406342
1173,2012,Febrero,Croacia,0,4,,4,-75.516486,10.446304
1174,2012,Febrero,Croacia,0,1,,1,-74.765343,10.970933
1175,2012,Febrero,Croacia,0,3,,3,-77.061029,3.8844260000000004
1176,2012,Febrero,Croacia,4,26,,30,-74.140516,4.697157
1177,2012,Febrero,Croacia,0,1,,1,-75.42726,6.170465
1178,2012,Febrero,Croacia,0,1,,1,-72.453013,7.819
1179,2012,Febrero,Cuba,0,1,,1,-69.941498,4.191162
1180,2012,Febrero,Cuba,0,6,,6,-77.35600000000001,0.81488
1181,2012,Febrero,Cuba,1,1,,2,-75.527794,10.406342
1182,2012,Febrero,Cuba,10,14,,24,-75.516486,10.446304
1183,2012,Febrero,Cuba,3,16,,19,-74.77647900000001,10.886686
1184,2012,Febrero,Cuba,0,1,,1,-72.129595,11.360028999999999
1185,2012,Febrero,Cuba,1,0,,1,-81.70216500000001,12.5862
1186,2012,Febrero,Cuba,10,22,,32,-76.532004,3.451668
1187,2012,Febrero,Cuba,0,4,,4,-75.76635300000001,4.45285
1188,2012,Febrero,Cuba,65,156,,221,-74.140516,4.697157
1189,2012,Febrero,Cuba,0,1,,1,-75.736374,4.815189
1190,2012,Febrero,Cuba,7,16,,23,-75.42726,6.170465
1191,2012,Febrero,Cuba,1,0,,1,-73.181317,7.1280470000000005
1192,2012,Febrero,Cuba,1,1,,2,-72.453013,7.819
1193,2012,Febrero,Curazao,0,2,,2,-74.140516,4.697157
1194,2012,Febrero,Curazao,1,1,,2,-75.42726,6.170465
1195,2012,Febrero,República Checa,4,9,,13,-77.35600000000001,0.81488
1196,2012,Febrero,República Checa,0,2,,2,-75.516486,10.446304
1197,2012,Febrero,República Checa,3,0,,3,-72.129595,11.360028999999999
1198,2012,Febrero,República Checa,0,1,,1,-76.532004,3.451668
1199,2012,Febrero,República Checa,26,48,,74,-74.140516,4.697157
1200,2012,Febrero,República Checa,0,1,,1,-75.42726,6.170465
1201,2012,Febrero,Chile,8,3,,11,-69.941498,4.191162
1202,2012,Febrero,Chile,1,2,,3,-76.876446,0.33002
1203,2012,Febrero,Chile,71,106,,177,-77.35600000000001,0.81488
1204,2012,Febrero,Chile,114,103,,217,-75.527794,10.406342
1205,2012,Febrero,Chile,136,97,,233,-75.516486,10.446304
1206,2012,Febrero,Chile,5,15,,20,-74.77647900000001,10.886686
1207,2012,Febrero,Chile,1,1,,2,-74.213989,11.247722999999999
1208,2012,Febrero,Chile,8,10,,18,-72.129595,11.360028999999999
1209,2012,Febrero,Chile,37,32,,69,-81.70216500000001,12.5862
1210,2012,Febrero,Chile,24,37,,61,-76.532004,3.451668
1211,2012,Febrero,Chile,3105,3731,,6836,-74.140516,4.697157
1212,2012,Febrero,Chile,107,123,,230,-75.42726,6.170465
1213,2012,Febrero,Chile,0,2,,2,-73.181317,7.1280470000000005
1214,2012,Febrero,Chile,7,15,,22,-72.453013,7.819
1215,2012,Febrero,Chile,0,2,,2,-72.508188,7.927233
1216,2012,Febrero,Chile,1,2,,3,-77.35002,8.63337
1217,2012,Febrero,China,2,4,,6,-77.35600000000001,0.81488
1218,2012,Febrero,China,2,9,,11,-75.516486,10.446304
1219,2012,Febrero,China,0,1,,1,-74.77647900000001,10.886686
1220,2012,Febrero,China,2,1,,3,-72.129595,11.360028999999999
1221,2012,Febrero,China,2,6,,8,-76.532004,3.451668
1222,2012,Febrero,China,140,443,,583,-74.140516,4.697157
1223,2012,Febrero,China,0,2,,2,-75.736374,4.815189
1224,2012,Febrero,China,1,4,,5,-75.42726,6.170465
1225,2012,Febrero,China,1,0,,1,-72.453013,7.819
1226,2012,Febrero,China,1,0,,1,-72.508188,7.927233
1227,2012,Febrero,Taiwán,0,1,,1,-77.35600000000001,0.81488
1228,2012,Febrero,Taiwán,4,2,,6,-75.516486,10.446304
1229,2012,Febrero,Taiwán,0,2,,2,-74.77647900000001,10.886686
1230,2012,Febrero,Taiwán,1,0,,1,-72.129595,11.360028999999999
1231,2012,Febrero,Taiwán,0,3,,3,-76.532004,3.451668
1232,2012,Febrero,Taiwán,24,50,,74,-74.140516,4.697157
1233,2012,Febrero,Taiwán,3,11,,14,-75.42726,6.170465
1234,2012,Febrero,Taiwán,1,0,,1,-72.508188,7.927233
1235,2012,Febrero,Chipre,0,1,,1,-74.140516,4.697157
1236,2012,Febrero,Dinamarca,1,1,,2,-69.941498,4.191162
1237,2012,Febrero,Dinamarca,6,3,,9,-77.35600000000001,0.81488
1238,2012,Febrero,Dinamarca,0,6,,6,-75.527794,10.406342
1239,2012,Febrero,Dinamarca,2,5,,7,-75.516486,10.446304
1240,2012,Febrero,Dinamarca,0,2,,2,-74.77647900000001,10.886686
1241,2012,Febrero,Dinamarca,1,1,,2,-72.129595,11.360028999999999
1242,2012,Febrero,Dinamarca,1,0,,1,-76.532004,3.451668
1243,2012,Febrero,Dinamarca,44,131,,175,-74.140516,4.697157
1244,2012,Febrero,Dinamarca,2,4,,6,-75.42726,6.170465
1245,2012,Febrero,Dinamarca,1,3,,4,-72.453013,7.819
1246,2012,Febrero,República de Yibuti,0,1,,1,-74.140516,4.697157
1247,2012,Febrero,Dominica,0,1,,1,-77.35600000000001,0.81488
1248,2012,Febrero,Dominica,1,0,,1,-74.77647900000001,10.886686
1249,2012,Febrero,Dominica,4,4,,8,-74.140516,4.697157
1250,2012,Febrero,Ecuador,0,3,,3,-69.941498,4.191162
1251,2012,Febrero,Ecuador,8,37,,45,-76.876446,0.33002
1252,2012,Febrero,Ecuador,1228,1269,,2497,-77.35600000000001,0.81488
1253,2012,Febrero,Ecuador,2,2,,4,-78.802679,18.00143
1254,2012,Febrero,Ecuador,9,13,,22,-75.527794,10.406342
1255,2012,Febrero,Ecuador,12,15,,27,-75.516486,10.446304
1256,2012,Febrero,Ecuador,8,24,,32,-74.77647900000001,10.886686
1257,2012,Febrero,Ecuador,0,9,,9,-72.129595,11.360028999999999
1258,2012,Febrero,Ecuador,19,12,,31,-81.70216500000001,12.5862
1259,2012,Febrero,Ecuador,354,419,,773,-76.532004,3.451668
1260,2012,Febrero,Ecuador,0,2,,2,-75.76635300000001,4.45285
1261,2012,Febrero,Ecuador,1853,2907,,4760,-74.140516,4.697157
1262,2012,Febrero,Ecuador,0,3,,3,-75.736374,4.815189
1263,2012,Febrero,Ecuador,413,498,,911,-75.42726,6.170465
1264,2012,Febrero,Ecuador,0,1,,1,-77.401154,6.222551999999999
1265,2012,Febrero,Ecuador,0,1,,1,-70.74025300000001,7.088728999999999
1266,2012,Febrero,Ecuador,129,161,,290,-72.453013,7.819
1267,2012,Febrero,Ecuador,1,3,,4,-72.508188,7.927233
1268,2012,Febrero,Egipto,5,19,,24,-74.140516,4.697157
1269,2012,Febrero,El Salvador,1,1,,2,-77.35600000000001,0.81488
1270,2012,Febrero,El Salvador,5,8,,13,-75.516486,10.446304
1271,2012,Febrero,El Salvador,7,8,,15,-74.77647900000001,10.886686
1272,2012,Febrero,El Salvador,3,16,,19,-76.532004,3.451668
1273,2012,Febrero,El Salvador,408,586,,994,-74.140516,4.697157
1274,2012,Febrero,El Salvador,12,27,,39,-75.42726,6.170465
1275,2012,Febrero,El Salvador,1,1,,2,-72.453013,7.819
1276,2012,Febrero,Emiratos Árabes,1,3,,4,-74.140516,4.697157
1277,2012,Febrero,España,6,1,,7,-69.941498,4.191162
1278,2012,Febrero,España,13,23,,36,-77.35600000000001,0.81488
1279,2012,Febrero,España,15,25,,40,-75.527794,10.406342
1280,2012,Febrero,España,35,52,,87,-75.516486,10.446304
1281,2012,Febrero,España,0,5,,5,-74.77647900000001,10.886686
1282,2012,Febrero,España,1,1,,2,-74.765343,10.970933
1283,2012,Febrero,España,3,11,,14,-72.129595,11.360028999999999
1284,2012,Febrero,España,3,4,,7,-81.70216500000001,12.5862
1285,2012,Febrero,España,137,296,,433,-76.532004,3.451668
1286,2012,Febrero,España,0,1,,1,-75.76635300000001,4.45285
1287,2012,Febrero,España,1520,3829,,5349,-74.140516,4.697157
1288,2012,Febrero,España,1,5,,6,-75.736374,4.815189
1289,2012,Febrero,España,66,197,,263,-75.42726,6.170465
1290,2012,Febrero,España,0,1,,1,-67.48402800000001,6.185536
1291,2012,Febrero,España,1,0,,1,-70.74025300000001,7.088728999999999
1292,2012,Febrero,España,0,1,,1,-73.181317,7.1280470000000005
1293,2012,Febrero,España,14,51,,65,-72.453013,7.819
1294,2012,Febrero,España,2,2,,4,-72.508188,7.927233
1295,2012,Febrero,España,1,2,,3,-77.35002,8.63337
1296,2012,Febrero,Eslovaquia,0,1,,1,-77.35600000000001,0.81488
1297,2012,Febrero,Eslovaquia,0,1,,1,-75.516486,10.446304
1298,2012,Febrero,Eslovaquia,3,0,,3,-74.77647900000001,10.886686
1299,2012,Febrero,Eslovaquia,1,0,,1,-74.213989,11.247722999999999
1300,2012,Febrero,Eslovaquia,0,3,,3,-72.129595,11.360028999999999
1301,2012,Febrero,Eslovaquia,12,11,,23,-74.140516,4.697157
1302,2012,Febrero,Eslovaquia,3,1,,4,-75.42726,6.170465
1303,2012,Febrero,Eslovaquia,1,1,,2,-72.453013,7.819
1304,2012,Febrero,Eslovenia,2,1,,3,-77.35600000000001,0.81488
1305,2012,Febrero,Eslovenia,1,0,,1,-74.77647900000001,10.886686
1306,2012,Febrero,Eslovenia,2,0,,2,-72.129595,11.360028999999999
1307,2012,Febrero,Eslovenia,1,1,,2,-76.532004,3.451668
1308,2012,Febrero,Eslovenia,13,24,,37,-74.140516,4.697157
1309,2012,Febrero,Eslovenia,0,1,,1,-75.42726,6.170465
1310,2012,Febrero,Estados Unidos de América,12,14,,26,-69.941498,4.191162
1311,2012,Febrero,Estados Unidos de América,30,79,,109,-77.35600000000001,0.81488
1312,2012,Febrero,Estados Unidos de América,42,62,,104,-75.527794,10.406342
1313,2012,Febrero,Estados Unidos de América,947,1711,,2658,-75.516486,10.446304
1314,2012,Febrero,Estados Unidos de América,489,815,,1304,-74.77647900000001,10.886686
1315,2012,Febrero,Estados Unidos de América,2,12,,14,-74.213989,11.247722999999999
1316,2012,Febrero,Estados Unidos de América,5,8,,13,-72.129595,11.360028999999999
1317,2012,Febrero,Estados Unidos de América,0,1,,1,-72.919186,11.52863
1318,2012,Febrero,Estados Unidos de América,6,24,,30,-81.703935,12.574411099999999
1319,2012,Febrero,Estados Unidos de América,23,27,,50,-81.70216500000001,12.5862
1320,2012,Febrero,Estados Unidos de América,2,6,,8,-81.372937,13.338761300000002
1321,2012,Febrero,Estados Unidos de América,565,922,,1487,-76.532004,3.451668
1322,2012,Febrero,Estados Unidos de América,73,111,,184,-75.76635300000001,4.45285
1323,2012,Febrero,Estados Unidos de América,5161,10995,,16156,-74.140516,4.697157
1324,2012,Febrero,Estados Unidos de América,47,76,,123,-75.736374,4.815189
1325,2012,Febrero,Estados Unidos de América,791,2192,,2983,-75.42726,6.170465
1326,2012,Febrero,Estados Unidos de América,1,1,,2,-67.48402800000001,6.185536
1327,2012,Febrero,Estados Unidos de América,10,15,,25,-73.181317,7.1280470000000005
1328,2012,Febrero,Estados Unidos de América,18,41,,59,-72.453013,7.819
1329,2012,Febrero,Estados Unidos de América,7,12,,19,-72.508188,7.927233
1330,2012,Febrero,Estados Unidos de América,9,9,,18,-77.35002,8.63337
1331,2012,Febrero,Estonia,2,0,,2,-77.35600000000001,0.81488
1332,2012,Febrero,Estonia,5,3,,8,-75.516486,10.446304
1333,2012,Febrero,Estonia,3,1,,4,-74.77647900000001,10.886686
1334,2012,Febrero,Estonia,0,1,,1,-72.129595,11.360028999999999
1335,2012,Febrero,Estonia,1,3,,4,-76.532004,3.451668
1336,2012,Febrero,Estonia,11,11,,22,-74.140516,4.697157
1337,2012,Febrero,Estonia,2,1,,3,-72.453013,7.819
1338,2012,Febrero,Etiopia,0,3,,3,-74.140516,4.697157
1339,2012,Febrero,Filipinas,1,46,,47,-75.527794,10.406342
1340,2012,Febrero,Filipinas,1,5,,6,-75.516486,10.446304
1341,2012,Febrero,Filipinas,0,3,,3,-74.77647900000001,10.886686
1342,2012,Febrero,Filipinas,0,7,,7,-74.765343,10.970933
1343,2012,Febrero,Filipinas,0,12,,12,-74.213989,11.247722999999999
1344,2012,Febrero,Filipinas,1,0,,1,-81.70216500000001,12.5862
1345,2012,Febrero,Filipinas,0,25,,25,-76.532004,3.451668
1346,2012,Febrero,Filipinas,0,37,,37,-77.061029,3.8844260000000004
1347,2012,Febrero,Filipinas,16,70,,86,-74.140516,4.697157
1348,2012,Febrero,Filipinas,2,2,,4,-75.42726,6.170465
1349,2012,Febrero,Filipinas,0,1,,1,-72.508188,7.927233
1350,2012,Febrero,Filipinas,0,8,,8,-75.68164200000001,9.402597
1351,2012,Febrero,Finlandia,1,1,,2,-69.941498,4.191162
1352,2012,Febrero,Finlandia,4,4,,8,-77.35600000000001,0.81488
1353,2012,Febrero,Finlandia,3,0,,3,-75.527794,10.406342
1354,2012,Febrero,Finlandia,157,146,,303,-75.516486,10.446304
1355,2012,Febrero,Finlandia,0,1,,1,-72.129595,11.360028999999999
1356,2012,Febrero,Finlandia,2,3,,5,-76.532004,3.451668
1357,2012,Febrero,Finlandia,61,92,,153,-74.140516,4.697157
1358,2012,Febrero,Finlandia,1,4,,5,-75.42726,6.170465
1359,2012,Febrero,Finlandia,0,1,,1,-72.453013,7.819
1360,2012,Febrero,Francia,7,9,,16,-69.941498,4.191162
1361,2012,Febrero,Francia,1,3,,4,-76.876446,0.33002
1362,2012,Febrero,Francia,38,79,,117,-77.35600000000001,0.81488
1363,2012,Febrero,Francia,16,13,,29,-75.527794,10.406342
1364,2012,Febrero,Francia,18,43,,61,-75.516486,10.446304
1365,2012,Febrero,Francia,6,10,,16,-74.77647900000001,10.886686
1366,2012,Febrero,Francia,1,1,,2,-74.213989,11.247722999999999
1367,2012,Febrero,Francia,9,9,,18,-72.129595,11.360028999999999
1368,2012,Febrero,Francia,3,3,,6,-81.703935,12.574411099999999
1369,2012,Febrero,Francia,1,3,,4,-81.70216500000001,12.5862
1370,2012,Febrero,Francia,1,2,,3,-81.372937,13.338761300000002
1371,2012,Febrero,Francia,25,60,,85,-76.532004,3.451668
1372,2012,Febrero,Francia,0,1,,1,-77.061029,3.8844260000000004
1373,2012,Febrero,Francia,1094,1768,,2862,-74.140516,4.697157
1374,2012,Febrero,Francia,0,1,,1,-75.736374,4.815189
1375,2012,Febrero,Francia,24,67,,91,-75.42726,6.170465
1376,2012,Febrero,Francia,0,3,,3,-70.74025300000001,7.088728999999999
1377,2012,Febrero,Francia,6,22,,28,-72.453013,7.819
1378,2012,Febrero,Francia,2,4,,6,-72.508188,7.927233
1379,2012,Febrero,Francia,4,7,,11,-77.35002,8.63337
1380,2012,Febrero,Gabón,0,1,,1,-74.140516,4.697157
1381,2012,Febrero,Gambia,0,1,,1,-72.453013,7.819
1382,2012,Febrero,Ghana,0,2,,2,-75.516486,10.446304
1383,2012,Febrero,Ghana,0,1,,1,-74.77647900000001,10.886686
1384,2012,Febrero,Ghana,2,1,,3,-74.140516,4.697157
1385,2012,Febrero,Ghana,0,2,,2,-72.453013,7.819
1386,2012,Febrero,Granada,1,0,,1,-75.516486,10.446304
1387,2012,Febrero,Granada,0,2,,2,-74.140516,4.697157
1388,2012,Febrero,Grecia,0,4,,4,-75.527794,10.406342
1389,2012,Febrero,Grecia,1,2,,3,-75.516486,10.446304
1390,2012,Febrero,Grecia,2,3,,5,-74.77647900000001,10.886686
1391,2012,Febrero,Grecia,1,2,,3,-74.213989,11.247722999999999
1392,2012,Febrero,Grecia,2,1,,3,-76.532004,3.451668
1393,2012,Febrero,Grecia,0,1,,1,-77.061029,3.8844260000000004
1394,2012,Febrero,Grecia,26,63,,89,-74.140516,4.697157
1395,2012,Febrero,Grecia,0,4,,4,-75.42726,6.170465
1396,2012,Febrero,Grecia,1,0,,1,-72.453013,7.819
1397,2012,Febrero,Guatemala,1,0,,1,-76.876446,0.33002
1398,2012,Febrero,Guatemala,2,3,,5,-77.35600000000001,0.81488
1399,2012,Febrero,Guatemala,1,5,,6,-75.527794,10.406342
1400,2012,Febrero,Guatemala,25,54,,79,-75.516486,10.446304
1401,2012,Febrero,Guatemala,3,18,,21,-74.77647900000001,10.886686
1402,2012,Febrero,Guatemala,0,1,,1,-81.70216500000001,12.5862
1403,2012,Febrero,Guatemala,0,1,,1,-81.372937,13.338761300000002
1404,2012,Febrero,Guatemala,6,31,,37,-76.532004,3.451668
1405,2012,Febrero,Guatemala,111,354,,465,-74.140516,4.697157
1406,2012,Febrero,Guatemala,0,4,,4,-75.736374,4.815189
1407,2012,Febrero,Guatemala,22,44,,66,-75.42726,6.170465
1408,2012,Febrero,Guatemala,0,1,,1,-73.181317,7.1280470000000005
1409,2012,Febrero,Guatemala,4,5,,9,-72.453013,7.819
1410,2012,Febrero,Guatemala,2,2,,4,-72.508188,7.927233
1411,2012,Febrero,Guyana,0,2,,2,-77.35600000000001,0.81488
1412,2012,Febrero,Guyana,0,1,,1,-75.527794,10.406342
1413,2012,Febrero,Guyana,0,1,,1,-75.516486,10.446304
1414,2012,Febrero,Guyana,2,7,,9,-74.140516,4.697157
1415,2012,Febrero,Guyana,0,1,,1,-75.42726,6.170465
1416,2012,Febrero,Haití,0,1,,1,-69.941498,4.191162
1417,2012,Febrero,Haití,0,1,,1,-75.527794,10.406342
1418,2012,Febrero,Haití,0,1,,1,-75.516486,10.446304
1419,2012,Febrero,Haití,1,1,,2,-76.532004,3.451668
1420,2012,Febrero,Haití,0,11,,11,-74.140516,4.697157
1421,2012,Febrero,Haití,0,1,,1,-75.42726,6.170465
1422,2012,Febrero,Honduras,2,3,,5,-77.35600000000001,0.81488
1423,2012,Febrero,Honduras,0,3,,3,-75.527794,10.406342
1424,2012,Febrero,Honduras,7,12,,19,-75.516486,10.446304
1425,2012,Febrero,Honduras,2,9,,11,-74.77647900000001,10.886686
1426,2012,Febrero,Honduras,0,1,,1,-81.70216500000001,12.5862
1427,2012,Febrero,Honduras,5,13,,18,-76.532004,3.451668
1428,2012,Febrero,Honduras,0,1,,1,-77.061029,3.8844260000000004
1429,2012,Febrero,Honduras,1,0,,1,-75.76635300000001,4.45285
1430,2012,Febrero,Honduras,115,171,,286,-74.140516,4.697157
1431,2012,Febrero,Honduras,1,1,,2,-75.736374,4.815189
1432,2012,Febrero,Honduras,14,23,,37,-75.42726,6.170465
1433,2012,Febrero,Honduras,0,1,,1,-77.35002,8.63337
1434,2012,Febrero,Hungría,5,8,,13,-77.35600000000001,0.81488
1435,2012,Febrero,Hungría,1,1,,2,-75.516486,10.446304
1436,2012,Febrero,Hungría,0,1,,1,-72.129595,11.360028999999999
1437,2012,Febrero,Hungría,1,1,,2,-76.532004,3.451668
1438,2012,Febrero,Hungría,33,31,,64,-74.140516,4.697157
1439,2012,Febrero,Hungría,1,2,,3,-75.42726,6.170465
1440,2012,Febrero,Hungría,1,1,,2,-72.453013,7.819
1441,2012,Febrero,India,0,2,,2,-77.35600000000001,0.81488
1442,2012,Febrero,India,2,4,,6,-75.516486,10.446304
1443,2012,Febrero,India,1,2,,3,-74.77647900000001,10.886686
1444,2012,Febrero,India,0,1,,1,-72.919186,11.52863
1445,2012,Febrero,India,0,1,,1,-81.70216500000001,12.5862
1446,2012,Febrero,India,0,15,,15,-76.532004,3.451668
1447,2012,Febrero,India,0,4,,4,-77.061029,3.8844260000000004
1448,2012,Febrero,India,23,284,,307,-74.140516,4.697157
1449,2012,Febrero,India,0,3,,3,-75.736374,4.815189
1450,2012,Febrero,India,0,26,,26,-75.42726,6.170465
1451,2012,Febrero,Indonesia,0,1,,1,-75.527794,10.406342
1452,2012,Febrero,Indonesia,0,3,,3,-74.213989,11.247722999999999
1453,2012,Febrero,Indonesia,1,1,,2,-76.532004,3.451668
1454,2012,Febrero,Indonesia,0,1,,1,-77.061029,3.8844260000000004
1455,2012,Febrero,Indonesia,7,15,,22,-74.140516,4.697157
1456,2012,Febrero,Indonesia,1,1,,2,-75.42726,6.170465
1457,2012,Febrero,Irán,4,15,,19,-74.140516,4.697157
1458,2012,Febrero,Irán,0,1,,1,-75.42726,6.170465
1459,2012,Febrero,República de Irlanda,1,1,,2,-69.941498,4.191162
1460,2012,Febrero,República de Irlanda,15,16,,31,-77.35600000000001,0.81488
1461,2012,Febrero,República de Irlanda,3,7,,10,-75.516486,10.446304
1462,2012,Febrero,República de Irlanda,1,0,,1,-72.129595,11.360028999999999
1463,2012,Febrero,República de Irlanda,0,2,,2,-76.532004,3.451668
1464,2012,Febrero,República de Irlanda,33,80,,113,-74.140516,4.697157
1465,2012,Febrero,República de Irlanda,2,5,,7,-75.42726,6.170465
1466,2012,Febrero,República de Irlanda,1,1,,2,-77.35002,8.63337
1467,2012,Febrero,Islandia,2,3,,5,-77.35600000000001,0.81488
1468,2012,Febrero,Islandia,0,1,,1,-74.77647900000001,10.886686
1469,2012,Febrero,Islandia,0,1,,1,-76.532004,3.451668
1470,2012,Febrero,Islandia,6,8,,14,-74.140516,4.697157
1471,2012,Febrero,Islandia,1,0,,1,-75.42726,6.170465
1472,2012,Febrero,Isla de Man,13,34,,47,-77.35600000000001,0.81488
1473,2012,Febrero,Isla de Man,6,14,,20,-75.516486,10.446304
1474,2012,Febrero,Isla de Man,5,8,,13,-74.77647900000001,10.886686
1475,2012,Febrero,Isla de Man,6,20,,26,-76.532004,3.451668
1476,2012,Febrero,Isla de Man,0,1,,1,-77.061029,3.8844260000000004
1477,2012,Febrero,Isla de Man,28,117,,145,-74.140516,4.697157
1478,2012,Febrero,Isla de Man,6,23,,29,-75.42726,6.170465
1479,2012,Febrero,Isla de Man,1,1,,2,-73.181317,7.1280470000000005
1480,2012,Febrero,Isla Johnston,1,0,,1,-75.516486,10.446304
1481,2012,Febrero,Isla Johnston,1,1,,2,-74.140516,4.697157
1482,2012,Febrero,Israel,32,28,,60,-69.941498,4.191162
1483,2012,Febrero,Israel,2,3,,5,-77.35600000000001,0.81488
1484,2012,Febrero,Israel,1,6,,7,-75.527794,10.406342
1485,2012,Febrero,Israel,5,23,,28,-75.516486,10.446304
1486,2012,Febrero,Israel,0,2,,2,-74.77647900000001,10.886686
1487,2012,Febrero,Israel,0,1,,1,-81.70216500000001,12.5862
1488,2012,Febrero,Israel,3,13,,16,-76.532004,3.451668
1489,2012,Febrero,Israel,76,452,,528,-74.140516,4.697157
1490,2012,Febrero,Israel,7,43,,50,-75.42726,6.170465
1491,2012,Febrero,Israel,0,1,,1,-73.181317,7.1280470000000005
1492,2012,Febrero,Israel,1,0,,1,-72.453013,7.819
1493,2012,Febrero,Israel,0,1,,1,-72.508188,7.927233
1494,2012,Febrero,Israel,1,0,,1,-77.35002,8.63337
1495,2012,Febrero,Islas Aland/Provincia de Finlandia,0,1,,1,-75.516486,10.446304
1496,2012,Febrero,Isla Wake,1,0,,1,-74.140516,4.697157
1497,2012,Febrero,Italia,2,7,,9,-69.941498,4.191162
1498,2012,Febrero,Italia,0,1,,1,-76.876446,0.33002
1499,2012,Febrero,Italia,7,23,,30,-77.35600000000001,0.81488
1500,2012,Febrero,Italia,21,22,,43,-75.527794,10.406342
1501,2012,Febrero,Italia,50,63,,113,-75.516486,10.446304
1502,2012,Febrero,Italia,4,12,,16,-74.77647900000001,10.886686
1503,2012,Febrero,Italia,3,18,,21,-72.129595,11.360028999999999
1504,2012,Febrero,Italia,9,14,,23,-81.70216500000001,12.5862
1505,2012,Febrero,Italia,18,67,,85,-76.532004,3.451668
1506,2012,Febrero,Italia,1,0,,1,-75.76635300000001,4.45285
1507,2012,Febrero,Italia,476,1660,,2136,-74.140516,4.697157
1508,2012,Febrero,Italia,0,1,,1,-75.736374,4.815189
1509,2012,Febrero,Italia,25,80,,105,-75.42726,6.170465
1510,2012,Febrero,Italia,0,3,,3,-73.181317,7.1280470000000005
1511,2012,Febrero,Italia,4,49,,53,-72.453013,7.819
1512,2012,Febrero,Italia,1,5,,6,-72.508188,7.927233
1513,2012,Febrero,Italia,0,4,,4,-77.35002,8.63337
1514,2012,Febrero,Jamaica,3,6,,9,-75.516486,10.446304
1515,2012,Febrero,Jamaica,0,1,,1,-74.77647900000001,10.886686
1516,2012,Febrero,Jamaica,0,1,,1,-81.70216500000001,12.5862
1517,2012,Febrero,Jamaica,1,3,,4,-76.532004,3.451668
1518,2012,Febrero,Jamaica,8,11,,19,-74.140516,4.697157
1519,2012,Febrero,Jamaica,1,4,,5,-75.42726,6.170465
1520,2012,Febrero,Jamaica,1,0,,1,-72.453013,7.819
1521,2012,Febrero,Islas Salomón,1,0,,1,-74.140516,4.697157
1522,2012,Febrero,Papúa Occidental,1,0,,1,-74.140516,4.697157
1523,2012,Febrero,Japón,6,5,,11,-69.941498,4.191162
1524,2012,Febrero,Japón,7,10,,17,-77.35600000000001,0.81488
1525,2012,Febrero,Japón,24,11,,35,-75.527794,10.406342
1526,2012,Febrero,Japón,13,12,,25,-75.516486,10.446304
1527,2012,Febrero,Japón,3,3,,6,-74.77647900000001,10.886686
1528,2012,Febrero,Japón,0,1,,1,-72.129595,11.360028999999999
1529,2012,Febrero,Japón,0,12,,12,-76.532004,3.451668
1530,2012,Febrero,Japón,1,0,,1,-75.76635300000001,4.45285
1531,2012,Febrero,Japón,122,417,,539,-74.140516,4.697157
1532,2012,Febrero,Japón,0,1,,1,-75.736374,4.815189
1533,2012,Febrero,Japón,8,25,,33,-75.42726,6.170465
1534,2012,Febrero,Japón,0,1,,1,-72.453013,7.819
1535,2012,Febrero,Japón,0,1,,1,-72.508188,7.927233
1536,2012,Febrero,Japón,2,1,,3,-77.35002,8.63337
1537,2012,Febrero,Jordania,1,0,,1,-76.532004,3.451668
1538,2012,Febrero,Jordania,1,4,,5,-74.140516,4.697157
1539,2012,Febrero,Kazajistán,1,0,,1,-76.532004,3.451668
1540,2012,Febrero,Kazajistán,3,1,,4,-74.140516,4.697157
1541,2012,Febrero,Kenia,0,1,,1,-77.35600000000001,0.81488
1542,2012,Febrero,Kenia,0,1,,1,-72.129595,11.360028999999999
1543,2012,Febrero,Kenia,0,12,,12,-74.140516,4.697157
1544,2012,Febrero,Kenia,0,2,,2,-72.453013,7.819
1545,2012,Febrero,Kirguistán,0,1,,1,-74.140516,4.697157
1546,2012,Febrero,Kuwait,1,0,,1,-74.140516,4.697157
1547,2012,Febrero,República de Kosovo,1,0,,1,-74.140516,4.697157
1548,2012,Febrero,Lesoto,0,1,,1,-74.140516,4.697157
1549,2012,Febrero,Letonia,0,1,,1,-77.061029,3.8844260000000004
1550,2012,Febrero,Letonia,6,2,,8,-74.140516,4.697157
1551,2012,Febrero,Lituania,0,1,,1,-77.35600000000001,0.81488
1552,2012,Febrero,Lituania,0,1,,1,-75.527794,10.406342
1553,2012,Febrero,Lituania,0,1,,1,-75.516486,10.446304
1554,2012,Febrero,Lituania,0,1,,1,-72.129595,11.360028999999999
1555,2012,Febrero,Lituania,0,1,,1,-76.532004,3.451668
1556,2012,Febrero,Lituania,9,7,,16,-74.140516,4.697157
1557,2012,Febrero,Lituania,1,1,,2,-75.42726,6.170465
1558,2012,Febrero,Lituania,0,1,,1,-72.453013,7.819
1559,2012,Febrero,Líbano,1,1,,2,-74.77647900000001,10.886686
1560,2012,Febrero,Líbano,5,4,,9,-72.129595,11.360028999999999
1561,2012,Febrero,Líbano,0,1,,1,-76.532004,3.451668
1562,2012,Febrero,Líbano,14,30,,44,-74.140516,4.697157
1563,2012,Febrero,Líbano,0,1,,1,-73.181317,7.1280470000000005
1564,2012,Febrero,Líbano,0,1,,1,-72.508188,7.927233
1565,2012,Febrero,Liechtenstein,0,2,,2,-77.35600000000001,0.81488
1566,2012,Febrero,Liechtenstein,1,2,,3,-74.140516,4.697157
1567,2012,Febrero,Luxemburgo,4,12,,16,-74.140516,4.697157
1568,2012,Febrero,Luxemburgo,0,1,,1,-77.35002,8.63337
1569,2012,Febrero,Macedonia,1,0,,1,-74.140516,4.697157
1570,2012,Febrero,Madagascar,1,0,,1,-74.140516,4.697157
1571,2012,Febrero,Malasia,9,26,,35,-74.140516,4.697157
1572,2012,Febrero,Malta,1,2,,3,-74.140516,4.697157
1573,2012,Febrero,Marruecos,1,7,,8,-74.140516,4.697157
1574,2012,Febrero,Mauricio,1,0,,1,-74.140516,4.697157
1575,2012,Febrero,México,0,1,,1,-69.941498,4.191162
1576,2012,Febrero,México,1,0,,1,-76.876446,0.33002
1577,2012,Febrero,México,6,12,,18,-77.35600000000001,0.81488
1578,2012,Febrero,México,10,9,,19,-75.527794,10.406342
1579,2012,Febrero,México,66,108,,174,-75.516486,10.446304
1580,2012,Febrero,México,10,36,,46,-74.77647900000001,10.886686
1581,2012,Febrero,México,1,2,,3,-72.129595,11.360028999999999
1582,2012,Febrero,México,0,2,,2,-81.703935,12.574411099999999
1583,2012,Febrero,México,6,6,,12,-81.70216500000001,12.5862
1584,2012,Febrero,México,26,103,,129,-76.532004,3.451668
1585,2012,Febrero,México,0,1,,1,-75.76635300000001,4.45285
1586,2012,Febrero,México,1468,3844,,5312,-74.140516,4.697157
1587,2012,Febrero,México,3,16,,19,-75.736374,4.815189
1588,2012,Febrero,México,81,209,,290,-75.42726,6.170465
1589,2012,Febrero,México,4,2,,6,-73.181317,7.1280470000000005
1590,2012,Febrero,México,9,31,,40,-72.453013,7.819
1591,2012,Febrero,México,1,5,,6,-72.508188,7.927233
1592,2012,Febrero,México,0,1,,1,-77.35002,8.63337
1593,2012,Febrero,República de Moldavia,2,0,,2,-74.140516,4.697157
1594,2012,Febrero,Mongolia,1,0,,1,-74.140516,4.697157
1595,2012,Febrero,Mozambique,0,1,,1,-74.140516,4.697157
1596,2012,Febrero,Myanmar,0,1,,1,-77.061029,3.8844260000000004
1597,2012,Febrero,Myanmar,1,0,,1,-74.140516,4.697157
1598,2012,Febrero,Nicaragua,9,8,,17,-75.516486,10.446304
1599,2012,Febrero,Nicaragua,1,3,,4,-74.77647900000001,10.886686
1600,2012,Febrero,Nicaragua,1,4,,5,-76.532004,3.451668
1601,2012,Febrero,Nicaragua,1,0,,1,-75.76635300000001,4.45285
1602,2012,Febrero,Nicaragua,52,47,,99,-74.140516,4.697157
1603,2012,Febrero,Nicaragua,8,6,,14,-75.42726,6.170465
1604,2012,Febrero,Nicaragua,0,1,,1,-72.508188,7.927233
1605,2012,Febrero,Nigeria,1,1,,2,-75.516486,10.446304
1606,2012,Febrero,Nigeria,2,5,,7,-74.140516,4.697157
1607,2012,Febrero,Noruega,6,8,,14,-77.35600000000001,0.81488
1608,2012,Febrero,Noruega,4,5,,9,-75.527794,10.406342
1609,2012,Febrero,Noruega,7,10,,17,-75.516486,10.446304
1610,2012,Febrero,Noruega,0,2,,2,-74.77647900000001,10.886686
1611,2012,Febrero,Noruega,1,0,,1,-72.129595,11.360028999999999
1612,2012,Febrero,Noruega,2,6,,8,-76.532004,3.451668
1613,2012,Febrero,Noruega,91,150,,241,-74.140516,4.697157
1614,2012,Febrero,Noruega,8,18,,26,-75.42726,6.170465
1615,2012,Febrero,Noruega,0,1,,1,-72.453013,7.819
1616,2012,Febrero,Noruega,1,1,,2,-72.508188,7.927233
1617,2012,Febrero,Nueva Zelanda,5,4,,9,-77.35600000000001,0.81488
1618,2012,Febrero,Nueva Zelanda,2,4,,6,-75.516486,10.446304
1619,2012,Febrero,Nueva Zelanda,0,2,,2,-74.77647900000001,10.886686
1620,2012,Febrero,Nueva Zelanda,1,0,,1,-72.129595,11.360028999999999
1621,2012,Febrero,Nueva Zelanda,1,0,,1,-76.532004,3.451668
1622,2012,Febrero,Nueva Zelanda,20,68,,88,-74.140516,4.697157
1623,2012,Febrero,Nueva Zelanda,0,1,,1,-75.736374,4.815189
1624,2012,Febrero,Nueva Zelanda,0,6,,6,-75.42726,6.170465
1625,2012,Febrero,Nueva Zelanda,0,1,,1,-72.453013,7.819
1626,2012,Febrero,Nueva Zelanda,0,1,,1,-77.35002,8.63337
1627,2012,Febrero,Papúa Nueva Guinea,0,1,,1,-74.140516,4.697157
1628,2012,Febrero,Nueva Zelanda,4,8,,12,-75.527794,10.406342
1629,2012,Febrero,Nueva Zelanda,0,1,,1,-81.703935,12.574411099999999
1630,2012,Febrero,Nueva Zelanda,2,5,,7,-74.140516,4.697157
1631,2012,Febrero,Nueva Zelanda,1,0,,1,-77.35002,8.63337
1632,2012,Febrero,Países Bajos,21,18,,39,-77.35600000000001,0.81488
1633,2012,Febrero,Países Bajos,1,15,,16,-75.516486,10.446304
1634,2012,Febrero,Países Bajos,5,16,,21,-74.77647900000001,10.886686
1635,2012,Febrero,Países Bajos,0,6,,6,-72.129595,11.360028999999999
1636,2012,Febrero,Países Bajos,16,31,,47,-72.919186,11.52863
1637,2012,Febrero,Países Bajos,11,22,,33,-76.532004,3.451668
1638,2012,Febrero,Países Bajos,0,2,,2,-77.061029,3.8844260000000004
1639,2012,Febrero,Países Bajos,143,227,,370,-74.140516,4.697157
1640,2012,Febrero,Países Bajos,1,2,,3,-75.736374,4.815189
1641,2012,Febrero,Países Bajos,113,163,,276,-75.42726,6.170465
1642,2012,Febrero,Países Bajos,1,0,,1,-72.453013,7.819
1643,2012,Febrero,Países Bajos,1,0,,1,-72.508188,7.927233
1644,2012,Febrero,Pakistán,0,1,,1,-77.35600000000001,0.81488
1645,2012,Febrero,Pakistán,0,1,,1,-75.516486,10.446304
1646,2012,Febrero,Pakistán,0,6,,6,-74.140516,4.697157
1647,2012,Febrero,Pakistán,0,1,,1,-75.42726,6.170465
1648,2012,Febrero,Panamá,0,5,,5,-75.527794,10.406342
1649,2012,Febrero,Panamá,120,167,,287,-75.516486,10.446304
1650,2012,Febrero,Panamá,73,118,,191,-74.77647900000001,10.886686
1651,2012,Febrero,Panamá,0,3,,3,-81.703935,12.574411099999999
1652,2012,Febrero,Panamá,60,55,,115,-81.70216500000001,12.5862
1653,2012,Febrero,Panamá,73,94,,167,-76.532004,3.451668
1654,2012,Febrero,Panamá,0,2,,2,-77.061029,3.8844260000000004
1655,2012,Febrero,Panamá,512,722,,1234,-74.140516,4.697157
1656,2012,Febrero,Panamá,56,82,,138,-75.736374,4.815189
1657,2012,Febrero,Panamá,132,258,,390,-75.42726,6.170465
1658,2012,Febrero,Panamá,1,2,,3,-77.401154,6.222551999999999
1659,2012,Febrero,Panamá,11,6,,17,-73.181317,7.1280470000000005
1660,2012,Febrero,Panamá,1,2,,3,-72.453013,7.819
1661,2012,Febrero,Panamá,4,7,,11,-72.508188,7.927233
1662,2012,Febrero,Panamá,2,10,,12,-77.35002,8.63337
1663,2012,Febrero,Paraguay,2,0,,2,-77.35600000000001,0.81488
1664,2012,Febrero,Paraguay,2,2,,4,-75.527794,10.406342
1665,2012,Febrero,Paraguay,3,0,,3,-75.516486,10.446304
1666,2012,Febrero,Paraguay,0,1,,1,-74.77647900000001,10.886686
1667,2012,Febrero,Paraguay,18,13,,31,-81.70216500000001,12.5862
1668,2012,Febrero,Paraguay,2,8,,10,-76.532004,3.451668
1669,2012,Febrero,Paraguay,66,96,,162,-74.140516,4.697157
1670,2012,Febrero,Paraguay,7,6,,13,-75.42726,6.170465
1671,2012,Febrero,Paraguay,1,2,,3,-72.453013,7.819
1672,2012,Febrero,Perú,30,23,,53,-69.941498,4.191162
1673,2012,Febrero,Perú,3,2,,5,-76.876446,0.33002
1674,2012,Febrero,Perú,218,382,,600,-77.35600000000001,0.81488
1675,2012,Febrero,Perú,161,93,,254,-75.527794,10.406342
1676,2012,Febrero,Perú,226,185,,411,-75.516486,10.446304
1677,2012,Febrero,Perú,8,22,,30,-74.77647900000001,10.886686
1678,2012,Febrero,Perú,0,1,,1,-74.213989,11.247722999999999
1679,2012,Febrero,Perú,5,7,,12,-72.129595,11.360028999999999
1680,2012,Febrero,Perú,0,1,,1,-72.919186,11.52863
1681,2012,Febrero,Perú,287,207,,494,-81.70216500000001,12.5862
1682,2012,Febrero,Perú,62,88,,150,-76.532004,3.451668
1683,2012,Febrero,Perú,0,1,,1,-77.061029,3.8844260000000004
1684,2012,Febrero,Perú,2539,3289,,5828,-74.140516,4.697157
1685,2012,Febrero,Perú,0,3,,3,-75.736374,4.815189
1686,2012,Febrero,Perú,136,257,,393,-75.42726,6.170465
1687,2012,Febrero,Perú,39,75,,114,-72.453013,7.819
1688,2012,Febrero,Perú,1,1,,2,-72.508188,7.927233
1689,2012,Febrero,Perú,0,1,,1,-77.35002,8.63337
1690,2012,Febrero,Palestina,0,1,,1,-75.516486,10.446304
1691,2012,Febrero,Palestina,0,2,,2,-74.140516,4.697157
1692,2012,Febrero,Polonia,1,1,,2,-69.941498,4.191162
1693,2012,Febrero,Polonia,12,21,,33,-77.35600000000001,0.81488
1694,2012,Febrero,Polonia,1,0,,1,-78.802679,18.00143
1695,2012,Febrero,Polonia,5,18,,23,-75.527794,10.406342
1696,2012,Febrero,Polonia,2,8,,10,-75.516486,10.446304
1697,2012,Febrero,Polonia,0,2,,2,-74.77647900000001,10.886686
1698,2012,Febrero,Polonia,1,13,,14,-74.765343,10.970933
1699,2012,Febrero,Polonia,1,6,,7,-74.213989,11.247722999999999
1700,2012,Febrero,Polonia,2,4,,6,-72.129595,11.360028999999999
1701,2012,Febrero,Polonia,1,1,,2,-76.532004,3.451668
1702,2012,Febrero,Polonia,0,1,,1,-77.061029,3.8844260000000004
1703,2012,Febrero,Polonia,82,154,,236,-74.140516,4.697157
1704,2012,Febrero,Polonia,0,3,,3,-75.42726,6.170465
1705,2012,Febrero,Polonia,1,0,,1,-73.181317,7.1280470000000005
1706,2012,Febrero,Polonia,1,2,,3,-72.453013,7.819
1707,2012,Febrero,Polonia,1,1,,2,-77.35002,8.63337
1708,2012,Febrero,Portugal,0,4,,4,-69.941498,4.191162
1709,2012,Febrero,Portugal,2,5,,7,-77.35600000000001,0.81488
1710,2012,Febrero,Portugal,1,1,,2,-75.527794,10.406342
1711,2012,Febrero,Portugal,1,6,,7,-75.516486,10.446304
1712,2012,Febrero,Portugal,3,1,,4,-74.77647900000001,10.886686
1713,2012,Febrero,Portugal,2,3,,5,-72.129595,11.360028999999999
1714,2012,Febrero,Portugal,1,12,,13,-76.532004,3.451668
1715,2012,Febrero,Portugal,74,222,,296,-74.140516,4.697157
1716,2012,Febrero,Portugal,1,10,,11,-75.42726,6.170465
1717,2012,Febrero,Portugal,1,7,,8,-72.453013,7.819
1718,2012,Febrero,Puerto Rico/Territorio de Estados Unidos,0,1,,1,-75.516486,10.446304
1719,2012,Febrero,Puerto Rico/Territorio de Estados Unidos,0,2,,2,-76.532004,3.451668
1720,2012,Febrero,Reino Unido de Gran Bretaña e Irlanda del Norte,2,5,,7,-69.941498,4.191162
1721,2012,Febrero,Reino Unido de Gran Bretaña e Irlanda del Norte,3,6,,9,-77.35600000000001,0.81488
1722,2012,Febrero,Reino Unido de Gran Bretaña e Irlanda del Norte,15,24,,39,-75.516486,10.446304
1723,2012,Febrero,Reino Unido de Gran Bretaña e Irlanda del Norte,2,5,,7,-72.129595,11.360028999999999
1724,2012,Febrero,Reino Unido de Gran Bretaña e Irlanda del Norte,4,15,,19,-76.532004,3.451668
1725,2012,Febrero,Reino Unido de Gran Bretaña e Irlanda del Norte,163,438,,601,-74.140516,4.697157
1726,2012,Febrero,Reino Unido de Gran Bretaña e Irlanda del Norte,5,20,,25,-75.42726,6.170465
1727,2012,Febrero,Reino Unido de Gran Bretaña e Irlanda del Norte,0,2,,2,-73.181317,7.1280470000000005
1728,2012,Febrero,Reino Unido de Gran Bretaña e Irlanda del Norte,1,1,,2,-72.453013,7.819
1729,2012,Febrero,Reino Unido de Gran Bretaña e Irlanda del Norte,0,1,,1,-72.508188,7.927233
1730,2012,Febrero,Reino Unido de Gran Bretaña e Irlanda del Norte,4,2,,6,-77.35002,8.63337
1731,2012,Febrero,República de Belarús,3,0,,3,-74.140516,4.697157
1732,2012,Febrero,República Dominicana,0,2,,2,-69.941498,4.191162
1733,2012,Febrero,República Dominicana,0,4,,4,-77.35600000000001,0.81488
1734,2012,Febrero,República Dominicana,1,4,,5,-75.527794,10.406342
1735,2012,Febrero,República Dominicana,21,34,,55,-75.516486,10.446304
1736,2012,Febrero,República Dominicana,11,42,,53,-74.77647900000001,10.886686
1737,2012,Febrero,República Dominicana,0,6,,6,-72.129595,11.360028999999999
1738,2012,Febrero,República Dominicana,6,22,,28,-76.532004,3.451668
1739,2012,Febrero,República Dominicana,198,333,,531,-74.140516,4.697157
1740,2012,Febrero,República Dominicana,1,5,,6,-75.736374,4.815189
1741,2012,Febrero,República Dominicana,23,40,,63,-75.42726,6.170465
1742,2012,Febrero,República Dominicana,1,0,,1,-73.181317,7.1280470000000005
1743,2012,Febrero,República Dominicana,2,3,,5,-72.453013,7.819
1744,2012,Febrero,República Dominicana,4,4,,8,-72.508188,7.927233
1745,2012,Febrero,República Checa,0,1,,1,-78.802679,18.00143
1746,2012,Febrero,República Checa,2,3,,5,-74.140516,4.697157
1747,2012,Febrero,República Checa,0,1,,1,-72.453013,7.819
1748,2012,Febrero,Rumania,0,1,,1,-78.802679,18.00143
1749,2012,Febrero,Rumania,0,4,,4,-75.527794,10.406342
1750,2012,Febrero,Rumania,0,1,,1,-75.516486,10.446304
1751,2012,Febrero,Rumania,1,1,,2,-74.77647900000001,10.886686
1752,2012,Febrero,Rumania,0,1,,1,-81.70216500000001,12.5862
1753,2012,Febrero,Rumania,1,1,,2,-76.532004,3.451668
1754,2012,Febrero,Rumania,37,50,,87,-74.140516,4.697157
1755,2012,Febrero,Rumania,1,0,,1,-75.42726,6.170465
1756,2012,Febrero,Federación de Rusia,0,1,,1,-69.941498,4.191162
1757,2012,Febrero,Federación de Rusia,17,14,,31,-77.35600000000001,0.81488
1758,2012,Febrero,Federación de Rusia,3,1,,4,-75.527794,10.406342
1759,2012,Febrero,Federación de Rusia,5,2,,7,-75.516486,10.446304
1760,2012,Febrero,Federación de Rusia,1,0,,1,-74.77647900000001,10.886686
1761,2012,Febrero,Federación de Rusia,0,1,,1,-72.129595,11.360028999999999
1762,2012,Febrero,Federación de Rusia,1,1,,2,-76.532004,3.451668
1763,2012,Febrero,Federación de Rusia,53,76,,129,-74.140516,4.697157
1764,2012,Febrero,Federación de Rusia,1,0,,1,-75.42726,6.170465
1765,2012,Febrero,Federación de Rusia,0,2,,2,-77.35002,8.63337
1766,2012,Febrero,Rwanda,0,1,,1,-74.140516,4.697157
1767,2012,Febrero,San Cristóbal y Nevis,1,1,,2,-74.140516,4.697157
1768,2012,Febrero,San Cristóbal y Nevis,0,1,,1,-75.42726,6.170465
1769,2012,Febrero,Samoa Occidental,1,0,,1,-74.140516,4.697157
1770,2012,Febrero,San Marino,0,1,,1,-69.941498,4.191162
1771,2012,Febrero,San Marino,0,1,,1,-75.736374,4.815189
1772,2012,Febrero,San  Vicente y las Granadinas,2,1,,3,-74.140516,4.697157
1773,2012,Febrero,Santa Lucia,0,1,,1,-74.77647900000001,10.886686
1774,2012,Febrero,Santa Lucia,2,2,,4,-74.140516,4.697157
1775,2012,Febrero,Senegal,1,0,,1,-74.140516,4.697157
1776,2012,Febrero,Serbia,1,1,,2,-75.527794,10.406342
1777,2012,Febrero,Serbia,7,7,,14,-74.140516,4.697157
1778,2012,Febrero,Serbia,0,1,,1,-75.42726,6.170465
1779,2012,Febrero,Singapur,1,14,,15,-74.140516,4.697157
1780,2012,Febrero,Singapur,0,1,,1,-75.42726,6.170465
1781,2012,Febrero,República Árabe Siria,0,1,,1,-72.129595,11.360028999999999
1782,2012,Febrero,Sri Lanka,0,3,,3,-74.140516,4.697157
1783,2012,Febrero,Sudáfrica,1,2,,3,-69.941498,4.191162
1784,2012,Febrero,Sudáfrica,0,4,,4,-77.35600000000001,0.81488
1785,2012,Febrero,Sudáfrica,0,3,,3,-75.527794,10.406342
1786,2012,Febrero,Sudáfrica,0,4,,4,-75.516486,10.446304
1787,2012,Febrero,Sudáfrica,0,1,,1,-74.77647900000001,10.886686
1788,2012,Febrero,Sudáfrica,1,0,,1,-72.129595,11.360028999999999
1789,2012,Febrero,Sudáfrica,0,1,,1,-81.703935,12.574411099999999
1790,2012,Febrero,Sudáfrica,12,65,,77,-74.140516,4.697157
1791,2012,Febrero,Sudáfrica,1,0,,1,-75.42726,6.170465
1792,2012,Febrero,Sudáfrica,0,1,,1,-72.453013,7.819
1793,2012,Febrero,Sudáfrica,1,1,,2,-77.35002,8.63337
1794,2012,Febrero,Sudán,0,2,,2,-74.140516,4.697157
1795,2012,Febrero,Suecia,13,16,,29,-69.941498,4.191162
1796,2012,Febrero,Suecia,17,10,,27,-77.35600000000001,0.81488
1797,2012,Febrero,Suecia,4,3,,7,-75.527794,10.406342
1798,2012,Febrero,Suecia,6,11,,17,-75.516486,10.446304
1799,2012,Febrero,Suecia,0,2,,2,-74.77647900000001,10.886686
1800,2012,Febrero,Suecia,0,1,,1,-74.213989,11.247722999999999
1801,2012,Febrero,Suecia,2,4,,6,-72.129595,11.360028999999999
1802,2012,Febrero,Suecia,1,1,,2,-81.703935,12.574411099999999
1803,2012,Febrero,Suecia,1,0,,1,-81.372937,13.338761300000002
1804,2012,Febrero,Suecia,3,5,,8,-76.532004,3.451668
1805,2012,Febrero,Suecia,180,244,,424,-74.140516,4.697157
1806,2012,Febrero,Suecia,7,8,,15,-75.42726,6.170465
1807,2012,Febrero,Suecia,3,2,,5,-72.453013,7.819
1808,2012,Febrero,Suecia,1,1,,2,-77.35002,8.63337
1809,2012,Febrero,Suiza,3,2,,5,-69.941498,4.191162
1810,2012,Febrero,Suiza,0,1,,1,-76.876446,0.33002
1811,2012,Febrero,Suiza,40,41,,81,-77.35600000000001,0.81488
1812,2012,Febrero,Suiza,2,8,,10,-75.527794,10.406342
1813,2012,Febrero,Suiza,23,13,,36,-75.516486,10.446304
1814,2012,Febrero,Suiza,2,4,,6,-74.77647900000001,10.886686
1815,2012,Febrero,Suiza,2,3,,5,-72.129595,11.360028999999999
1816,2012,Febrero,Suiza,0,2,,2,-81.703935,12.574411099999999
1817,2012,Febrero,Suiza,1,1,,2,-81.70216500000001,12.5862
1818,2012,Febrero,Suiza,21,27,,48,-76.532004,3.451668
1819,2012,Febrero,Suiza,275,508,,783,-74.140516,4.697157
1820,2012,Febrero,Suiza,20,41,,61,-75.42726,6.170465
1821,2012,Febrero,Suiza,1,4,,5,-72.453013,7.819
1822,2012,Febrero,Suiza,2,8,,10,-77.35002,8.63337
1823,2012,Febrero,Surinam,4,1,,5,-75.516486,10.446304
1824,2012,Febrero,Surinam,7,11,,18,-74.140516,4.697157
1825,2012,Febrero,Surinam,2,2,,4,-75.42726,6.170465
1826,2012,Febrero,Taiwán,10,1,,11,-75.527794,10.406342
1827,2012,Febrero,Taiwán,1,4,,5,-74.140516,4.697157
1828,2012,Febrero,Taiwán,2,2,,4,-72.453013,7.819
1829,2012,Febrero,Tailandia,4,1,,5,-74.140516,4.697157
1830,2012,Febrero,Tailandia,0,1,,1,-75.42726,6.170465
1831,2012,Febrero,Tíbet/Región Autónoma de China,0,1,,1,-74.140516,4.697157
1832,2012,Febrero,Territorio Antártico Británico/Territorio Británico de Ultramar,0,1,,1,-77.35600000000001,0.81488
1833,2012,Febrero,Territorio Antártico Británico/Territorio Británico de Ultramar,1,4,,5,-74.140516,4.697157
1834,2012,Febrero,Territorio Antártico Británico/Territorio Británico de Ultramar,0,1,,1,-75.42726,6.170465
1835,2012,Febrero,Tanzania,2,5,,7,-74.140516,4.697157
1836,2012,Febrero,Trinidad y Tobago,0,1,,1,-75.527794,10.406342
1837,2012,Febrero,Trinidad y Tobago,1,8,,9,-75.516486,10.446304
1838,2012,Febrero,Trinidad y Tobago,0,2,,2,-74.77647900000001,10.886686
1839,2012,Febrero,Trinidad y Tobago,0,1,,1,-81.70216500000001,12.5862
1840,2012,Febrero,Trinidad y Tobago,1,3,,4,-76.532004,3.451668
1841,2012,Febrero,Trinidad y Tobago,13,27,,40,-74.140516,4.697157
1842,2012,Febrero,Trinidad y Tobago,0,2,,2,-75.736374,4.815189
1843,2012,Febrero,Trinidad y Tobago,4,3,,7,-75.42726,6.170465
1844,2012,Febrero,Trinidad y Tobago,1,2,,3,-73.181317,7.1280470000000005
1845,2012,Febrero,Trinidad y Tobago,0,2,,2,-72.453013,7.819
1846,2012,Febrero,Túnez,0,1,,1,-75.527794,10.406342
1847,2012,Febrero,Turquía,0,5,,5,-77.35600000000001,0.81488
1848,2012,Febrero,Turquía,2,4,,6,-75.516486,10.446304
1849,2012,Febrero,Turquía,0,5,,5,-76.532004,3.451668
1850,2012,Febrero,Turquía,23,63,,86,-74.140516,4.697157
1851,2012,Febrero,Turquía,0,3,,3,-75.42726,6.170465
1852,2012,Febrero,Turquía,0,4,,4,-72.453013,7.819
1853,2012,Febrero,Ucrania,6,10,,16,-77.35600000000001,0.81488
1854,2012,Febrero,Ucrania,1,0,,1,-76.532004,3.451668
1855,2012,Febrero,Ucrania,0,3,,3,-77.061029,3.8844260000000004
1856,2012,Febrero,Ucrania,10,12,,22,-74.140516,4.697157
1857,2012,Febrero,Ucrania,1,1,,2,-75.42726,6.170465
1858,2012,Febrero,Ucrania,3,4,,7,-72.453013,7.819
1859,2012,Febrero,Uganda,0,1,,1,-76.532004,3.451668
1860,2012,Febrero,Uganda,0,3,,3,-74.140516,4.697157
1861,2012,Febrero,Federación de Rusia,4,4,,8,-75.527794,10.406342
1862,2012,Febrero,Federación de Rusia,1,1,,2,-75.516486,10.446304
1863,2012,Febrero,Federación de Rusia,0,1,,1,-74.213989,11.247722999999999
1864,2012,Febrero,Federación de Rusia,2,3,,5,-72.129595,11.360028999999999
1865,2012,Febrero,Federación de Rusia,99,131,,230,-74.140516,4.697157
1866,2012,Febrero,Federación de Rusia,1,3,,4,-75.42726,6.170465
1867,2012,Febrero,Federación de Rusia,12,8,,20,-72.453013,7.819
1868,2012,Febrero,Uruguay,0,1,,1,-76.876446,0.33002
1869,2012,Febrero,Uruguay,3,8,,11,-77.35600000000001,0.81488
1870,2012,Febrero,Uruguay,12,11,,23,-75.527794,10.406342
1871,2012,Febrero,Uruguay,115,75,,190,-75.516486,10.446304
1872,2012,Febrero,Uruguay,4,8,,12,-74.77647900000001,10.886686
1873,2012,Febrero,Uruguay,0,1,,1,-72.129595,11.360028999999999
1874,2012,Febrero,Uruguay,94,73,,167,-81.70216500000001,12.5862
1875,2012,Febrero,Uruguay,7,15,,22,-76.532004,3.451668
1876,2012,Febrero,Uruguay,113,249,,362,-74.140516,4.697157
1877,2012,Febrero,Uruguay,1,2,,3,-75.736374,4.815189
1878,2012,Febrero,Uruguay,5,33,,38,-75.42726,6.170465
1879,2012,Febrero,Uruguay,1,1,,2,-73.181317,7.1280470000000005
1880,2012,Febrero,Uruguay,3,6,,9,-72.453013,7.819
1881,2012,Febrero,Uruguay,0,1,,1,-72.508188,7.927233
1882,2012,Febrero,Uruguay,0,1,,1,-77.35002,8.63337
1883,2012,Febrero,Venezuela,0,3,,3,-69.941498,4.191162
1884,2012,Febrero,Venezuela,95,123,,218,-77.35600000000001,0.81488
1885,2012,Febrero,Venezuela,9,15,,24,-75.527794,10.406342
1886,2012,Febrero,Venezuela,81,113,,194,-75.516486,10.446304
1887,2012,Febrero,Venezuela,82,116,,198,-74.77647900000001,10.886686
1888,2012,Febrero,Venezuela,0,1,,1,-74.765343,10.970933
1889,2012,Febrero,Venezuela,0,4,,4,-74.232675,11.117206
1890,2012,Febrero,Venezuela,0,3,,3,-74.213989,11.247722999999999
1891,2012,Febrero,Venezuela,1852,2260,,4112,-72.129595,11.360028999999999
1892,2012,Febrero,Venezuela,3,2,,5,-72.919186,11.52863
1893,2012,Febrero,Venezuela,9,13,,22,-81.70216500000001,12.5862
1894,2012,Febrero,Venezuela,49,60,,109,-76.532004,3.451668
1895,2012,Febrero,Venezuela,0,2,,2,-75.76635300000001,4.45285
1896,2012,Febrero,Venezuela,4326,5705,,10031,-74.140516,4.697157
1897,2012,Febrero,Venezuela,2,15,,17,-75.736374,4.815189
1898,2012,Febrero,Venezuela,294,336,,630,-75.42726,6.170465
1899,2012,Febrero,Venezuela,4,6,,10,-67.48402800000001,6.185536
1900,2012,Febrero,Venezuela,27,45,,72,-70.74025300000001,7.088728999999999
1901,2012,Febrero,Venezuela,6,10,,16,-73.181317,7.1280470000000005
1902,2012,Febrero,Venezuela,1318,1520,,2838,-72.453013,7.819
1903,2012,Febrero,Venezuela,325,382,,707,-72.508188,7.927233
1904,2012,Febrero,Venezuela,7,4,,11,-77.35002,8.63337
1905,2012,Febrero,Vietnam,1,0,,1,-75.516486,10.446304
1906,2012,Febrero,Vietnam,2,1,,3,-74.140516,4.697157
1907,2012,Febrero,Vietnam,1,0,,1,-75.42726,6.170465
1908,2012,Febrero,Yugoslavia,0,1,,1,-75.42726,6.170465
1909,2012,Febrero,Zambia,1,3,,4,-74.140516,4.697157
1910,2012,Febrero,Zimbabue,1,1,,2,-74.140516,4.697157
1911,2012,Febrero,Reino Unido de Gran Bretaña e Irlanda del Norte,4,6,,10,-69.941498,4.191162
1912,2012,Febrero,Reino Unido de Gran Bretaña e Irlanda del Norte,1,11,,12,-77.35600000000001,0.81488
1913,2012,Febrero,Reino Unido de Gran Bretaña e Irlanda del Norte,15,15,,30,-75.527794,10.406342
1914,2012,Febrero,Reino Unido de Gran Bretaña e Irlanda del Norte,14,26,,40,-75.516486,10.446304
1915,2012,Febrero,Reino Unido de Gran Bretaña e Irlanda del Norte,2,1,,3,-74.77647900000001,10.886686
1916,2012,Febrero,Reino Unido de Gran Bretaña e Irlanda del Norte,0,2,,2,-74.213989,11.247722999999999
1917,2012,Febrero,Reino Unido de Gran Bretaña e Irlanda del Norte,1,6,,7,-72.129595,11.360028999999999
1918,2012,Febrero,Reino Unido de Gran Bretaña e Irlanda del Norte,1,0,,1,-81.703935,12.574411099999999
1919,2012,Febrero,Reino Unido de Gran Bretaña e Irlanda del Norte,1,3,,4,-81.70216500000001,12.5862
1920,2012,Febrero,Reino Unido de Gran Bretaña e Irlanda del Norte,6,18,,24,-76.532004,3.451668
1921,2012,Febrero,Reino Unido de Gran Bretaña e Irlanda del Norte,257,612,,869,-74.140516,4.697157
1922,2012,Febrero,Reino Unido de Gran Bretaña e Irlanda del Norte,13,29,,42,-75.42726,6.170465
1923,2012,Febrero,Reino Unido de Gran Bretaña e Irlanda del Norte,3,8,,11,-72.453013,7.819
1924,2012,Febrero,Reino Unido de Gran Bretaña e Irlanda del Norte,1,6,,7,-77.35002,8.63337
1925,2012,Febrero,Países Bajos,3,4,,7,-69.941498,4.191162
1926,2012,Febrero,Países Bajos,4,7,,11,-77.35600000000001,0.81488
1927,2012,Febrero,Países Bajos,8,13,,21,-75.527794,10.406342
1928,2012,Febrero,Países Bajos,9,28,,37,-75.516486,10.446304
1929,2012,Febrero,Países Bajos,1,2,,3,-74.77647900000001,10.886686
1930,2012,Febrero,Países Bajos,1,4,,5,-72.129595,11.360028999999999
1931,2012,Febrero,Países Bajos,1,0,,1,-72.919186,11.52863
1932,2012,Febrero,Países Bajos,1,1,,2,-81.70216500000001,12.5862
1933,2012,Febrero,Países Bajos,19,35,,54,-76.532004,3.451668
1934,2012,Febrero,Países Bajos,0,2,,2,-77.061029,3.8844260000000004
1935,2012,Febrero,Países Bajos,407,720,,1127,-74.140516,4.697157
1936,2012,Febrero,Países Bajos,47,61,,108,-75.42726,6.170465
1937,2012,Febrero,Países Bajos,0,1,,1,-67.48402800000001,6.185536
1938,2012,Febrero,Países Bajos,2,10,,12,-72.453013,7.819
1939,2012,Febrero,Países Bajos,2,2,,4,-72.508188,7.927233
1940,2012,Febrero,Países Bajos,0,5,,5,-77.35002,8.63337
1941,2012,Febrero,Eslovenia,0,2,,2,-74.140516,4.697157
1942,2012,Febrero,Lituania,6,1,,7,-74.140516,4.697157
1943,2012,Febrero,Reino Unido de Gran Bretaña e Irlanda del Norte,0,1,,1,-74.213989,11.247722999999999
1944,2012,Febrero,Reino Unido de Gran Bretaña e Irlanda del Norte,0,1,,1,-77.35600000000001,0.81488
1945,2012,Febrero,Reino Unido de Gran Bretaña e Irlanda del Norte,3,8,,11,-74.140516,4.697157
1946,2012,Febrero,Reino Unido de Gran Bretaña e Irlanda del Norte,1,0,,1,-77.35600000000001,0.81488
1947,2012,Febrero,Reino Unido de Gran Bretaña e Irlanda del Norte,3,3,,6,-75.527794,10.406342
1948,2012,Febrero,Reino Unido de Gran Bretaña e Irlanda del Norte,1,2,,3,-75.516486,10.446304
1949,2012,Febrero,Reino Unido de Gran Bretaña e Irlanda del Norte,4,8,,12,-74.140516,4.697157
1950,2012,Febrero,Reino Unido de Gran Bretaña e Irlanda del Norte,0,1,,1,-75.42726,6.170465
1951,2012,Febrero,Reino Unido de Gran Bretaña e Irlanda del Norte,1,0,,1,-77.35002,8.63337
1952,2012,Febrero,Letonia,0,1,,1,-75.42726,6.170465
1953,2012,Febrero,Marruecos,0,2,,2,-74.140516,4.697157
1954,2012,Febrero,República CentroÁfricana,1,1,,2,-74.140516,4.697157
1955,2012,Febrero,Desconocido,0,1,,1,-74.140516,4.697157
1956,2012,Marzo,Albania,1,0,,1,-74.140516,4.697157
1957,2012,Marzo,Alemania,11,19,,30,-69.941498,4.191162
1958,2012,Marzo,Alemania,1,0,,1,-76.876446,0.33002
1959,2012,Marzo,Alemania,62,69,,131,-77.35600000000001,0.81488
1960,2012,Marzo,Alemania,0,1,,1,-78.802679,18.00143
1961,2012,Marzo,Alemania,22,21,,43,-75.527794,10.406342
1962,2012,Marzo,Alemania,20,41,,61,-75.516486,10.446304
1963,2012,Marzo,Alemania,5,17,,22,-74.77647900000001,10.886686
1964,2012,Marzo,Alemania,0,1,,1,-74.765343,10.970933
1965,2012,Marzo,Alemania,5,7,,12,-72.129595,11.360028999999999
1966,2012,Marzo,Alemania,5,3,,8,-81.70216500000001,12.5862
1967,2012,Marzo,Alemania,1,1,,2,-81.372937,13.338761300000002
1968,2012,Marzo,Alemania,25,46,,71,-76.532004,3.451668
1969,2012,Marzo,Alemania,0,1,,1,-75.76635300000001,4.45285
1970,2012,Marzo,Alemania,1411,2262,,3673,-74.140516,4.697157
1971,2012,Marzo,Alemania,1,3,,4,-75.736374,4.815189
1972,2012,Marzo,Alemania,24,62,,86,-75.42726,6.170465
1973,2012,Marzo,Alemania,1,0,,1,-67.48402800000001,6.185536
1974,2012,Marzo,Alemania,5,20,,25,-72.453013,7.819
1975,2012,Marzo,Alemania,5,12,,17,-77.35002,8.63337
1976,2012,Marzo,Andorra,0,1,,1,-76.532004,3.451668
1977,2012,Marzo,Andorra,1,8,,9,-74.140516,4.697157
1978,2012,Marzo,Andorra,0,1,,1,-75.42726,6.170465
1979,2012,Marzo,Angola,0,2,,2,-74.77647900000001,10.886686
1980,2012,Marzo,Angola,1,0,,1,-74.140516,4.697157
1981,2012,Marzo,Antigua y Barbuda,2,1,,3,-74.140516,4.697157
1982,2012,Marzo,Países Bajos,4,2,,6,-74.140516,4.697157
1983,2012,Marzo,Países Bajos,2,8,,10,-75.42726,6.170465
1984,2012,Marzo,Arabia Saudita,0,2,,2,-74.140516,4.697157
1985,2012,Marzo,Arabia Saudita,1,1,,2,-74.140516,4.697157
1986,2012,Marzo,Argelia,0,1,,1,-74.140516,4.697157
1987,2012,Marzo,Argentina,1,4,,5,-69.941498,4.191162
1988,2012,Marzo,Argentina,2,1,,3,-76.876446,0.33002
1989,2012,Marzo,Argentina,73,134,,207,-77.35600000000001,0.81488
1990,2012,Marzo,Argentina,0,1,,1,-78.802679,18.00143
1991,2012,Marzo,Argentina,32,31,,63,-75.527794,10.406342
1992,2012,Marzo,Argentina,656,482,,1138,-75.516486,10.446304
1993,2012,Marzo,Argentina,17,43,,60,-74.77647900000001,10.886686
1994,2012,Marzo,Argentina,19,35,,54,-72.129595,11.360028999999999
1995,2012,Marzo,Argentina,391,273,,664,-81.70216500000001,12.5862
1996,2012,Marzo,Argentina,44,72,,116,-76.532004,3.451668
1997,2012,Marzo,Argentina,0,1,,1,-77.061029,3.8844260000000004
1998,2012,Marzo,Argentina,1,0,,1,-75.76635300000001,4.45285
1999,2012,Marzo,Argentina,3155,4509,,7664,-74.140516,4.697157
2000,2012,Marzo,Argentina,0,4,,4,-75.736374,4.815189
2001,2012,Marzo,Argentina,64,214,,278,-75.42726,6.170465
2002,2012,Marzo,Argentina,0,1,,1,-73.181317,7.1280470000000005
2003,2012,Marzo,Argentina,14,49,,63,-72.453013,7.819
2004,2012,Marzo,Argentina,1,0,,1,-72.508188,7.927233
2005,2012,Marzo,Argentina,2,9,,11,-77.35002,8.63337
2006,2012,Marzo,República de Armenia,0,2,,2,-74.140516,4.697157
2007,2012,Marzo,Aruba,4,3,,7,-74.140516,4.697157
2008,2012,Marzo,Aruba,0,1,,1,-75.42726,6.170465
2009,2012,Marzo,Australia,9,16,,25,-69.941498,4.191162
2010,2012,Marzo,Australia,14,18,,32,-77.35600000000001,0.81488
2011,2012,Marzo,Australia,1,0,,1,-78.802679,18.00143
2012,2012,Marzo,Australia,18,21,,39,-75.527794,10.406342
2013,2012,Marzo,Australia,29,48,,77,-75.516486,10.446304
2014,2012,Marzo,Australia,5,14,,19,-74.77647900000001,10.886686
2015,2012,Marzo,Australia,5,7,,12,-72.129595,11.360028999999999
2016,2012,Marzo,Australia,11,22,,33,-76.532004,3.451668
2017,2012,Marzo,Australia,1,0,,1,-75.76635300000001,4.45285
2018,2012,Marzo,Australia,179,341,,520,-74.140516,4.697157
2019,2012,Marzo,Australia,0,1,,1,-75.736374,4.815189
2020,2012,Marzo,Australia,10,42,,52,-75.42726,6.170465
2021,2012,Marzo,Australia,0,2,,2,-72.453013,7.819
2022,2012,Marzo,Australia,4,6,,10,-77.35002,8.63337
2023,2012,Marzo,Austria,0,1,,1,-69.941498,4.191162
2024,2012,Marzo,Austria,5,9,,14,-77.35600000000001,0.81488
2025,2012,Marzo,Austria,4,3,,7,-75.527794,10.406342
2026,2012,Marzo,Austria,2,1,,3,-75.516486,10.446304
2027,2012,Marzo,Austria,2,5,,7,-74.77647900000001,10.886686
2028,2012,Marzo,Austria,2,3,,5,-72.129595,11.360028999999999
2029,2012,Marzo,Austria,2,3,,5,-76.532004,3.451668
2030,2012,Marzo,Austria,98,182,,280,-74.140516,4.697157
2031,2012,Marzo,Austria,2,16,,18,-75.42726,6.170465
2032,2012,Marzo,Austria,0,1,,1,-72.453013,7.819
2033,2012,Marzo,Austria,0,2,,2,-77.35002,8.63337
2034,2012,Marzo,Azerbaiyán,1,2,,3,-74.140516,4.697157
2035,2012,Marzo,Bahamas,0,4,,4,-75.516486,10.446304
2036,2012,Marzo,Bahamas,0,3,,3,-74.77647900000001,10.886686
2037,2012,Marzo,Bahamas,0,1,,1,-76.532004,3.451668
2038,2012,Marzo,Bahamas,2,4,,6,-74.140516,4.697157
2039,2012,Marzo,Bahamas,0,4,,4,-75.42726,6.170465
2040,2012,Marzo,Bahréin,0,1,,1,-74.140516,4.697157
2041,2012,Marzo,Bangladesh,2,0,,2,-75.516486,10.446304
2042,2012,Marzo,Bangladesh,0,1,,1,-74.140516,4.697157
2043,2012,Marzo,Barbados,1,1,,2,-74.77647900000001,10.886686
2044,2012,Marzo,Barbados,3,5,,8,-74.140516,4.697157
2045,2012,Marzo,Barbados,0,1,,1,-75.42726,6.170465
2046,2012,Marzo,República de Belarús,2,0,,2,-74.140516,4.697157
2047,2012,Marzo,Bélgica,0,2,,2,-69.941498,4.191162
2048,2012,Marzo,Bélgica,12,19,,31,-77.35600000000001,0.81488
2049,2012,Marzo,Bélgica,1,1,,2,-75.527794,10.406342
2050,2012,Marzo,Bélgica,4,9,,13,-75.516486,10.446304
2051,2012,Marzo,Bélgica,0,3,,3,-74.77647900000001,10.886686
2052,2012,Marzo,Bélgica,1,1,,2,-72.129595,11.360028999999999
2053,2012,Marzo,Bélgica,2,10,,12,-76.532004,3.451668
2054,2012,Marzo,Bélgica,112,299,,411,-74.140516,4.697157
2055,2012,Marzo,Bélgica,5,5,,10,-75.42726,6.170465
2056,2012,Marzo,Bélgica,0,3,,3,-72.453013,7.819
2057,2012,Marzo,Bélgica,0,1,,1,-72.508188,7.927233
2058,2012,Marzo,Bélgica,1,1,,2,-77.35002,8.63337
2059,2012,Marzo,Belice,0,1,,1,-72.129595,11.360028999999999
2060,2012,Marzo,Belice,3,5,,8,-74.140516,4.697157
2061,2012,Marzo,Belice,0,3,,3,-75.42726,6.170465
2062,2012,Marzo,Benín,0,1,,1,-74.140516,4.697157
2063,2012,Marzo,Bermudas/Territorio Británico de Ultramar,0,2,,2,-75.516486,10.446304
2064,2012,Marzo,Bermudas/Territorio Británico de Ultramar,0,4,,4,-74.140516,4.697157
2065,2012,Marzo,Bolivia,0,1,,1,-69.941498,4.191162
2066,2012,Marzo,Bolivia,1,0,,1,-76.876446,0.33002
2067,2012,Marzo,Bolivia,17,14,,31,-77.35600000000001,0.81488
2068,2012,Marzo,Bolivia,8,1,,9,-75.527794,10.406342
2069,2012,Marzo,Bolivia,54,11,,65,-75.516486,10.446304
2070,2012,Marzo,Bolivia,23,14,,37,-74.77647900000001,10.886686
2071,2012,Marzo,Bolivia,10,12,,22,-76.532004,3.451668
2072,2012,Marzo,Bolivia,259,411,,670,-74.140516,4.697157
2073,2012,Marzo,Bolivia,0,1,,1,-75.736374,4.815189
2074,2012,Marzo,Bolivia,10,19,,29,-75.42726,6.170465
2075,2012,Marzo,Bolivia,0,4,,4,-72.453013,7.819
2076,2012,Marzo,Bosnia y Herzegovina,0,2,,2,-74.140516,4.697157
2077,2012,Marzo,Brasil,37,50,,87,-69.941498,4.191162
2078,2012,Marzo,Brasil,1,0,,1,-76.876446,0.33002
2079,2012,Marzo,Brasil,8,17,,25,-77.35600000000001,0.81488
2080,2012,Marzo,Brasil,33,31,,64,-75.527794,10.406342
2081,2012,Marzo,Brasil,68,65,,133,-75.516486,10.446304
2082,2012,Marzo,Brasil,9,15,,24,-74.77647900000001,10.886686
2083,2012,Marzo,Brasil,11,13,,24,-72.129595,11.360028999999999
2084,2012,Marzo,Brasil,39,28,,67,-81.70216500000001,12.5862
2085,2012,Marzo,Brasil,18,54,,72,-76.532004,3.451668
2086,2012,Marzo,Brasil,1960,3649,,5609,-74.140516,4.697157
2087,2012,Marzo,Brasil,3,3,,6,-75.736374,4.815189
2088,2012,Marzo,Brasil,34,106,,140,-75.42726,6.170465
2089,2012,Marzo,Brasil,0,1,,1,-67.48402800000001,6.185536
2090,2012,Marzo,Brasil,0,1,,1,-73.181317,7.1280470000000005
2091,2012,Marzo,Brasil,8,21,,29,-72.453013,7.819
2092,2012,Marzo,Brasil,0,3,,3,-72.508188,7.927233
2093,2012,Marzo,Brasil,0,1,,1,-77.35002,8.63337
2094,2012,Marzo,Bulgaria,1,2,,3,-75.516486,10.446304
2095,2012,Marzo,Bulgaria,0,1,,1,-77.061029,3.8844260000000004
2096,2012,Marzo,Bulgaria,1,8,,9,-74.140516,4.697157
2097,2012,Marzo,Islas Caimán/Territorio Británico de Ultramar,0,1,,1,-75.516486,10.446304
2098,2012,Marzo,Islas Caimán/Territorio Británico de Ultramar,0,1,,1,-76.532004,3.451668
2099,2012,Marzo,Islas Caimán/Territorio Británico de Ultramar,1,0,,1,-75.42726,6.170465
2100,2012,Marzo,Camboya,1,2,,3,-74.140516,4.697157
2101,2012,Marzo,Camerún,0,3,,3,-74.140516,4.697157
2102,2012,Marzo,Camerún,0,1,,1,-75.42726,6.170465
2103,2012,Marzo,Canadá,4,9,,13,-69.941498,4.191162
2104,2012,Marzo,Canadá,28,25,,53,-77.35600000000001,0.81488
2105,2012,Marzo,Canadá,17,23,,40,-75.527794,10.406342
2106,2012,Marzo,Canadá,1270,1179,,2449,-75.516486,10.446304
2107,2012,Marzo,Canadá,14,18,,32,-74.77647900000001,10.886686
2108,2012,Marzo,Canadá,2,7,,9,-72.129595,11.360028999999999
2109,2012,Marzo,Canadá,1,1,,2,-72.919186,11.52863
2110,2012,Marzo,Canadá,1,1,,2,-81.703935,12.574411099999999
2111,2012,Marzo,Canadá,524,440,,964,-81.70216500000001,12.5862
2112,2012,Marzo,Canadá,2,2,,4,-81.372937,13.338761300000002
2113,2012,Marzo,Canadá,30,50,,80,-76.532004,3.451668
2114,2012,Marzo,Canadá,3,4,,7,-75.76635300000001,4.45285
2115,2012,Marzo,Canadá,622,1320,,1942,-74.140516,4.697157
2116,2012,Marzo,Canadá,2,1,,3,-75.736374,4.815189
2117,2012,Marzo,Canadá,72,167,,239,-75.42726,6.170465
2118,2012,Marzo,Canadá,0,1,,1,-67.48402800000001,6.185536
2119,2012,Marzo,Canadá,0,3,,3,-73.181317,7.1280470000000005
2120,2012,Marzo,Canadá,4,16,,20,-72.453013,7.819
2121,2012,Marzo,Canadá,1,0,,1,-72.508188,7.927233
2122,2012,Marzo,Canadá,0,7,,7,-77.35002,8.63337
2123,2012,Marzo,España,11,38,,49,-77.35600000000001,0.81488
2124,2012,Marzo,España,1,2,,3,-75.527794,10.406342
2125,2012,Marzo,España,8,18,,26,-75.516486,10.446304
2126,2012,Marzo,España,5,15,,20,-74.77647900000001,10.886686
2127,2012,Marzo,España,0,1,,1,-74.213989,11.247722999999999
2128,2012,Marzo,España,0,2,,2,-72.129595,11.360028999999999
2129,2012,Marzo,España,3,10,,13,-81.70216500000001,12.5862
2130,2012,Marzo,España,42,65,,107,-76.532004,3.451668
2131,2012,Marzo,España,0,2,,2,-75.76635300000001,4.45285
2132,2012,Marzo,España,131,390,,521,-74.140516,4.697157
2133,2012,Marzo,España,1,5,,6,-75.736374,4.815189
2134,2012,Marzo,España,35,85,,120,-75.42726,6.170465
2135,2012,Marzo,España,1,0,,1,-73.181317,7.1280470000000005
2136,2012,Marzo,España,1,0,,1,-72.453013,7.819
2137,2012,Marzo,España,0,1,,1,-72.508188,7.927233
2138,2012,Marzo,República Democrática del Congo,1,6,,7,-74.140516,4.697157
2139,2012,Marzo,República Democrática del Congo,2,0,,2,-75.42726,6.170465
2140,2012,Marzo,República de Corea,0,3,,3,-69.941498,4.191162
2141,2012,Marzo,República de Corea,6,11,,17,-77.35600000000001,0.81488
2142,2012,Marzo,República de Corea,1,12,,13,-75.516486,10.446304
2143,2012,Marzo,República de Corea,2,4,,6,-74.77647900000001,10.886686
2144,2012,Marzo,República de Corea,1,8,,9,-76.532004,3.451668
2145,2012,Marzo,República de Corea,0,2,,2,-77.061029,3.8844260000000004
2146,2012,Marzo,República de Corea,104,443,,547,-74.140516,4.697157
2147,2012,Marzo,República de Corea,1,14,,15,-75.42726,6.170465
2148,2012,Marzo,República de Corea,2,0,,2,-72.453013,7.819
2149,2012,Marzo,Costa de Marfil,0,2,,2,-74.140516,4.697157
2150,2012,Marzo,Costa Rica,0,4,,4,-77.35600000000001,0.81488
2151,2012,Marzo,Costa Rica,0,1,,1,-75.527794,10.406342
2152,2012,Marzo,Costa Rica,34,27,,61,-75.516486,10.446304
2153,2012,Marzo,Costa Rica,8,24,,32,-74.77647900000001,10.886686
2154,2012,Marzo,Costa Rica,1,0,,1,-81.703935,12.574411099999999
2155,2012,Marzo,Costa Rica,269,203,,472,-81.70216500000001,12.5862
2156,2012,Marzo,Costa Rica,16,45,,61,-76.532004,3.451668
2157,2012,Marzo,Costa Rica,1,0,,1,-75.76635300000001,4.45285
2158,2012,Marzo,Costa Rica,399,658,,1057,-74.140516,4.697157
2159,2012,Marzo,Costa Rica,2,4,,6,-75.736374,4.815189
2160,2012,Marzo,Costa Rica,75,120,,195,-75.42726,6.170465
2161,2012,Marzo,Costa Rica,5,0,,5,-73.181317,7.1280470000000005
2162,2012,Marzo,Costa Rica,0,1,,1,-72.453013,7.819
2163,2012,Marzo,Costa Rica,2,0,,2,-72.508188,7.927233
2164,2012,Marzo,Costa Rica,0,2,,2,-77.35002,8.63337
2165,2012,Marzo,Croacia,1,0,,1,-77.35600000000001,0.81488
2166,2012,Marzo,Croacia,0,11,,11,-75.527794,10.406342
2167,2012,Marzo,Croacia,0,4,,4,-75.516486,10.446304
2168,2012,Marzo,Croacia,0,1,,1,-74.77647900000001,10.886686
2169,2012,Marzo,Croacia,0,5,,5,-74.765343,10.970933
2170,2012,Marzo,Croacia,2,3,,5,-72.129595,11.360028999999999
2171,2012,Marzo,Croacia,0,1,,1,-76.532004,3.451668
2172,2012,Marzo,Croacia,5,35,,40,-74.140516,4.697157
2173,2012,Marzo,Croacia,0,2,,2,-75.42726,6.170465
2174,2012,Marzo,Cuba,1,0,,1,-69.941498,4.191162
2175,2012,Marzo,Cuba,0,4,,4,-77.35600000000001,0.81488
2176,2012,Marzo,Cuba,12,19,,31,-75.516486,10.446304
2177,2012,Marzo,Cuba,3,9,,12,-74.77647900000001,10.886686
2178,2012,Marzo,Cuba,8,20,,28,-76.532004,3.451668
2179,2012,Marzo,Cuba,1,2,,3,-75.76635300000001,4.45285
2180,2012,Marzo,Cuba,69,133,,202,-74.140516,4.697157
2181,2012,Marzo,Cuba,9,25,,34,-75.42726,6.170465
2182,2012,Marzo,Cuba,0,4,,4,-73.181317,7.1280470000000005
2183,2012,Marzo,Cuba,0,2,,2,-72.453013,7.819
2184,2012,Marzo,Curazao,1,1,,2,-74.140516,4.697157
2185,2012,Marzo,Curazao,4,3,,7,-75.42726,6.170465
2186,2012,Marzo,República Checa,3,1,,4,-77.35600000000001,0.81488
2187,2012,Marzo,República Checa,1,2,,3,-75.516486,10.446304
2188,2012,Marzo,República Checa,39,65,,104,-74.140516,4.697157
2189,2012,Marzo,Chile,4,2,,6,-69.941498,4.191162
2190,2012,Marzo,Chile,21,55,,76,-77.35600000000001,0.81488
2191,2012,Marzo,Chile,1,2,,3,-78.802679,18.00143
2192,2012,Marzo,Chile,30,35,,65,-75.527794,10.406342
2193,2012,Marzo,Chile,171,133,,304,-75.516486,10.446304
2194,2012,Marzo,Chile,8,28,,36,-74.77647900000001,10.886686
2195,2012,Marzo,Chile,4,6,,10,-72.129595,11.360028999999999
2196,2012,Marzo,Chile,78,55,,133,-81.70216500000001,12.5862
2197,2012,Marzo,Chile,34,48,,82,-76.532004,3.451668
2198,2012,Marzo,Chile,0,1,,1,-77.061029,3.8844260000000004
2199,2012,Marzo,Chile,2047,3189,,5236,-74.140516,4.697157
2200,2012,Marzo,Chile,0,1,,1,-75.736374,4.815189
2201,2012,Marzo,Chile,48,114,,162,-75.42726,6.170465
2202,2012,Marzo,Chile,11,16,,27,-72.453013,7.819
2203,2012,Marzo,Chile,2,2,,4,-77.35002,8.63337
2204,2012,Marzo,China,1,1,,2,-77.35600000000001,0.81488
2205,2012,Marzo,China,0,1,,1,-75.527794,10.406342
2206,2012,Marzo,China,10,4,,14,-75.516486,10.446304
2207,2012,Marzo,China,0,1,,1,-74.77647900000001,10.886686
2208,2012,Marzo,China,0,1,,1,-74.765343,10.970933
2209,2012,Marzo,China,0,2,,2,-72.129595,11.360028999999999
2210,2012,Marzo,China,1,7,,8,-76.532004,3.451668
2211,2012,Marzo,China,149,449,,598,-74.140516,4.697157
2212,2012,Marzo,China,0,2,,2,-75.736374,4.815189
2213,2012,Marzo,China,6,13,,19,-75.42726,6.170465
2214,2012,Marzo,China,0,1,,1,-73.181317,7.1280470000000005
2215,2012,Marzo,China,0,2,,2,-72.453013,7.819
2216,2012,Marzo,China,1,0,,1,-77.35002,8.63337
2217,2012,Marzo,Taiwán,1,8,,9,-75.516486,10.446304
2218,2012,Marzo,Taiwán,0,2,,2,-74.77647900000001,10.886686
2219,2012,Marzo,Taiwán,2,3,,5,-76.532004,3.451668
2220,2012,Marzo,Taiwán,13,34,,47,-74.140516,4.697157
2221,2012,Marzo,Taiwán,0,1,,1,-75.736374,4.815189
2222,2012,Marzo,Taiwán,4,9,,13,-75.42726,6.170465
2223,2012,Marzo,Taiwán,2,1,,3,-72.453013,7.819
2224,2012,Marzo,Chipre,0,1,,1,-69.941498,4.191162
2225,2012,Marzo,Chipre,0,4,,4,-74.140516,4.697157
2226,2012,Marzo,Dinamarca,3,3,,6,-77.35600000000001,0.81488
2227,2012,Marzo,Dinamarca,5,2,,7,-75.527794,10.406342
2228,2012,Marzo,Dinamarca,2,8,,10,-75.516486,10.446304
2229,2012,Marzo,Dinamarca,0,5,,5,-74.77647900000001,10.886686
2230,2012,Marzo,Dinamarca,0,1,,1,-72.129595,11.360028999999999
2231,2012,Marzo,Dinamarca,0,2,,2,-81.372937,13.338761300000002
2232,2012,Marzo,Dinamarca,1,4,,5,-76.532004,3.451668
2233,2012,Marzo,Dinamarca,62,151,,213,-74.140516,4.697157
2234,2012,Marzo,Dinamarca,2,10,,12,-75.42726,6.170465
2235,2012,Marzo,Dinamarca,0,1,,1,-72.453013,7.819
2236,2012,Marzo,Dinamarca,1,1,,2,-77.35002,8.63337
2237,2012,Marzo,Dominica,0,2,,2,-75.527794,10.406342
2238,2012,Marzo,Dominica,0,1,,1,-76.532004,3.451668
2239,2012,Marzo,Dominica,1,6,,7,-74.140516,4.697157
2240,2012,Marzo,Dominica,0,1,,1,-75.736374,4.815189
2241,2012,Marzo,Ecuador,0,2,,2,-69.941498,4.191162
2242,2012,Marzo,Ecuador,13,49,,62,-76.876446,0.33002
2243,2012,Marzo,Ecuador,1048,1554,,2602,-77.35600000000001,0.81488
2244,2012,Marzo,Ecuador,0,1,,1,-78.802679,18.00143
2245,2012,Marzo,Ecuador,6,14,,20,-75.527794,10.406342
2246,2012,Marzo,Ecuador,10,11,,21,-75.516486,10.446304
2247,2012,Marzo,Ecuador,8,8,,16,-74.77647900000001,10.886686
2248,2012,Marzo,Ecuador,3,6,,9,-72.129595,11.360028999999999
2249,2012,Marzo,Ecuador,43,28,,71,-81.70216500000001,12.5862
2250,2012,Marzo,Ecuador,311,379,,690,-76.532004,3.451668
2251,2012,Marzo,Ecuador,1775,2908,,4683,-74.140516,4.697157
2252,2012,Marzo,Ecuador,1,2,,3,-75.736374,4.815189
2253,2012,Marzo,Ecuador,300,469,,769,-75.42726,6.170465
2254,2012,Marzo,Ecuador,0,1,,1,-70.74025300000001,7.088728999999999
2255,2012,Marzo,Ecuador,107,124,,231,-72.453013,7.819
2256,2012,Marzo,Ecuador,0,2,,2,-72.508188,7.927233
2257,2012,Marzo,Egipto,0,1,,1,-76.532004,3.451668
2258,2012,Marzo,Egipto,4,12,,16,-74.140516,4.697157
2259,2012,Marzo,El Salvador,2,0,,2,-77.35600000000001,0.81488
2260,2012,Marzo,El Salvador,7,6,,13,-75.516486,10.446304
2261,2012,Marzo,El Salvador,4,2,,6,-74.77647900000001,10.886686
2262,2012,Marzo,El Salvador,2,1,,3,-81.70216500000001,12.5862
2263,2012,Marzo,El Salvador,14,19,,33,-76.532004,3.451668
2264,2012,Marzo,El Salvador,373,518,,891,-74.140516,4.697157
2265,2012,Marzo,El Salvador,22,32,,54,-75.42726,6.170465
2266,2012,Marzo,Emiratos Árabes,1,24,,25,-74.140516,4.697157
2267,2012,Marzo,España,3,4,,7,-69.941498,4.191162
2268,2012,Marzo,España,1,0,,1,-76.876446,0.33002
2269,2012,Marzo,España,8,22,,30,-77.35600000000001,0.81488
2270,2012,Marzo,España,10,8,,18,-75.527794,10.406342
2271,2012,Marzo,España,17,50,,67,-75.516486,10.446304
2272,2012,Marzo,España,5,11,,16,-74.77647900000001,10.886686
2273,2012,Marzo,España,3,8,,11,-72.129595,11.360028999999999
2274,2012,Marzo,España,1,1,,2,-81.703935,12.574411099999999
2275,2012,Marzo,España,6,5,,11,-81.70216500000001,12.5862
2276,2012,Marzo,España,0,3,,3,-81.372937,13.338761300000002
2277,2012,Marzo,España,107,220,,327,-76.532004,3.451668
2278,2012,Marzo,España,1780,4207,,5987,-74.140516,4.697157
2279,2012,Marzo,España,0,3,,3,-75.736374,4.815189
2280,2012,Marzo,España,68,166,,234,-75.42726,6.170465
2281,2012,Marzo,España,1,0,,1,-67.48402800000001,6.185536
2282,2012,Marzo,España,1,0,,1,-70.74025300000001,7.088728999999999
2283,2012,Marzo,España,14,36,,50,-72.453013,7.819
2284,2012,Marzo,España,3,0,,3,-72.508188,7.927233
2285,2012,Marzo,España,1,6,,7,-77.35002,8.63337
2286,2012,Marzo,Eslovaquia,1,0,,1,-77.35600000000001,0.81488
2287,2012,Marzo,Eslovaquia,0,1,,1,-78.802679,18.00143
2288,2012,Marzo,Eslovaquia,1,0,,1,-75.516486,10.446304
2289,2012,Marzo,Eslovaquia,3,0,,3,-81.372937,13.338761300000002
2290,2012,Marzo,Eslovaquia,2,1,,3,-76.532004,3.451668
2291,2012,Marzo,Eslovaquia,17,10,,27,-74.140516,4.697157
2292,2012,Marzo,Eslovaquia,0,1,,1,-75.42726,6.170465
2293,2012,Marzo,Eslovaquia,1,3,,4,-72.453013,7.819
2294,2012,Marzo,Eslovenia,1,0,,1,-69.941498,4.191162
2295,2012,Marzo,Eslovenia,0,2,,2,-77.35600000000001,0.81488
2296,2012,Marzo,Eslovenia,0,1,,1,-75.527794,10.406342
2297,2012,Marzo,Eslovenia,1,0,,1,-72.129595,11.360028999999999
2298,2012,Marzo,Eslovenia,0,3,,3,-76.532004,3.451668
2299,2012,Marzo,Eslovenia,15,30,,45,-74.140516,4.697157
2300,2012,Marzo,Estados Unidos de América,10,27,,37,-69.941498,4.191162
2301,2012,Marzo,Estados Unidos de América,38,85,,123,-77.35600000000001,0.81488
2302,2012,Marzo,Estados Unidos de América,1,0,,1,-78.802679,18.00143
2303,2012,Marzo,Estados Unidos de América,26,76,,102,-75.527794,10.406342
2304,2012,Marzo,Estados Unidos de América,977,1912,,2889,-75.516486,10.446304
2305,2012,Marzo,Estados Unidos de América,438,593,,1031,-74.77647900000001,10.886686
2306,2012,Marzo,Estados Unidos de América,0,3,,3,-74.765343,10.970933
2307,2012,Marzo,Estados Unidos de América,2,7,,9,-74.213989,11.247722999999999
2308,2012,Marzo,Estados Unidos de América,12,19,,31,-72.129595,11.360028999999999
2309,2012,Marzo,Estados Unidos de América,0,1,,1,-72.919186,11.52863
2310,2012,Marzo,Estados Unidos de América,14,20,,34,-81.703935,12.574411099999999
2311,2012,Marzo,Estados Unidos de América,16,40,,56,-81.70216500000001,12.5862
2312,2012,Marzo,Estados Unidos de América,6,17,,23,-81.372937,13.338761300000002
2313,2012,Marzo,Estados Unidos de América,813,1194,,2007,-76.532004,3.451668
2314,2012,Marzo,Estados Unidos de América,109,150,,259,-75.76635300000001,4.45285
2315,2012,Marzo,Estados Unidos de América,5878,11611,,17489,-74.140516,4.697157
2316,2012,Marzo,Estados Unidos de América,46,67,,113,-75.736374,4.815189
2317,2012,Marzo,Estados Unidos de América,889,2311,,3200,-75.42726,6.170465
2318,2012,Marzo,Estados Unidos de América,0,1,,1,-67.48402800000001,6.185536
2319,2012,Marzo,Estados Unidos de América,15,32,,47,-73.181317,7.1280470000000005
2320,2012,Marzo,Estados Unidos de América,25,39,,64,-72.453013,7.819
2321,2012,Marzo,Estados Unidos de América,10,21,,31,-72.508188,7.927233
2322,2012,Marzo,Estados Unidos de América,6,17,,23,-77.35002,8.63337
2323,2012,Marzo,Estonia,1,0,,1,-75.527794,10.406342
2324,2012,Marzo,Estonia,4,2,,6,-75.516486,10.446304
2325,2012,Marzo,Estonia,1,1,,2,-72.129595,11.360028999999999
2326,2012,Marzo,Estonia,18,18,,36,-74.140516,4.697157
2327,2012,Marzo,Etiopia,2,7,,9,-74.140516,4.697157
2328,2012,Marzo,Filipinas,1,19,,20,-75.527794,10.406342
2329,2012,Marzo,Filipinas,0,7,,7,-75.516486,10.446304
2330,2012,Marzo,Filipinas,0,7,,7,-74.77647900000001,10.886686
2331,2012,Marzo,Filipinas,0,22,,22,-74.765343,10.970933
2332,2012,Marzo,Filipinas,0,21,,21,-74.213989,11.247722999999999
2333,2012,Marzo,Filipinas,3,1,,4,-76.532004,3.451668
2334,2012,Marzo,Filipinas,0,14,,14,-77.061029,3.8844260000000004
2335,2012,Marzo,Filipinas,12,86,,98,-74.140516,4.697157
2336,2012,Marzo,Filipinas,5,1,,6,-75.42726,6.170465
2337,2012,Marzo,Filipinas,0,6,,6,-75.68164200000001,9.402597
2338,2012,Marzo,Finlandia,0,1,,1,-69.941498,4.191162
2339,2012,Marzo,Finlandia,3,2,,5,-77.35600000000001,0.81488
2340,2012,Marzo,Finlandia,93,83,,176,-75.516486,10.446304
2341,2012,Marzo,Finlandia,0,1,,1,-72.129595,11.360028999999999
2342,2012,Marzo,Finlandia,1,1,,2,-76.532004,3.451668
2343,2012,Marzo,Finlandia,1,0,,1,-75.76635300000001,4.45285
2344,2012,Marzo,Finlandia,45,65,,110,-74.140516,4.697157
2345,2012,Marzo,Finlandia,5,6,,11,-75.42726,6.170465
2346,2012,Marzo,Finlandia,1,2,,3,-72.453013,7.819
2347,2012,Marzo,Francia,4,6,,10,-69.941498,4.191162
2348,2012,Marzo,Francia,1,1,,2,-76.876446,0.33002
2349,2012,Marzo,Francia,37,66,,103,-77.35600000000001,0.81488
2350,2012,Marzo,Francia,9,29,,38,-75.527794,10.406342
2351,2012,Marzo,Francia,28,40,,68,-75.516486,10.446304
2352,2012,Marzo,Francia,4,16,,20,-74.77647900000001,10.886686
2353,2012,Marzo,Francia,0,1,,1,-74.765343,10.970933
2354,2012,Marzo,Francia,1,2,,3,-74.213989,11.247722999999999
2355,2012,Marzo,Francia,7,14,,21,-72.129595,11.360028999999999
2356,2012,Marzo,Francia,2,7,,9,-81.70216500000001,12.5862
2357,2012,Marzo,Francia,6,7,,13,-81.372937,13.338761300000002
2358,2012,Marzo,Francia,12,58,,70,-76.532004,3.451668
2359,2012,Marzo,Francia,0,1,,1,-77.061029,3.8844260000000004
2360,2012,Marzo,Francia,825,1680,,2505,-74.140516,4.697157
2361,2012,Marzo,Francia,1,5,,6,-75.736374,4.815189
2362,2012,Marzo,Francia,22,46,,68,-75.42726,6.170465
2363,2012,Marzo,Francia,0,1,,1,-70.74025300000001,7.088728999999999
2364,2012,Marzo,Francia,5,11,,16,-72.453013,7.819
2365,2012,Marzo,Francia,1,3,,4,-72.508188,7.927233
2366,2012,Marzo,Francia,7,22,,29,-77.35002,8.63337
2367,2012,Marzo,Georgia,9,16,,25,-74.140516,4.697157
2368,2012,Marzo,Ghana,2,3,,5,-74.140516,4.697157
2369,2012,Marzo,Grecia,0,1,,1,-77.35600000000001,0.81488
2370,2012,Marzo,Grecia,0,4,,4,-75.527794,10.406342
2371,2012,Marzo,Grecia,0,1,,1,-74.213989,11.247722999999999
2372,2012,Marzo,Grecia,1,1,,2,-76.532004,3.451668
2373,2012,Marzo,Grecia,0,1,,1,-77.061029,3.8844260000000004
2374,2012,Marzo,Grecia,20,51,,71,-74.140516,4.697157
2375,2012,Marzo,Grecia,2,8,,10,-75.42726,6.170465
2376,2012,Marzo,Grecia,0,2,,2,-72.453013,7.819
2377,2012,Marzo,Grecia,0,1,,1,-72.508188,7.927233
2378,2012,Marzo,Grecia,0,1,,1,-75.68164200000001,9.402597
2379,2012,Marzo,Guatemala,1,2,,3,-77.35600000000001,0.81488
2380,2012,Marzo,Guatemala,0,3,,3,-75.527794,10.406342
2381,2012,Marzo,Guatemala,31,33,,64,-75.516486,10.446304
2382,2012,Marzo,Guatemala,13,21,,34,-74.77647900000001,10.886686
2383,2012,Marzo,Guatemala,0,1,,1,-72.129595,11.360028999999999
2384,2012,Marzo,Guatemala,0,1,,1,-81.703935,12.574411099999999
2385,2012,Marzo,Guatemala,13,32,,45,-81.70216500000001,12.5862
2386,2012,Marzo,Guatemala,14,44,,58,-76.532004,3.451668
2387,2012,Marzo,Guatemala,152,353,,505,-74.140516,4.697157
2388,2012,Marzo,Guatemala,4,6,,10,-75.736374,4.815189
2389,2012,Marzo,Guatemala,36,86,,122,-75.42726,6.170465
2390,2012,Marzo,Guatemala,1,0,,1,-70.74025300000001,7.088728999999999
2391,2012,Marzo,Guatemala,1,1,,2,-73.181317,7.1280470000000005
2392,2012,Marzo,Guatemala,2,5,,7,-72.453013,7.819
2393,2012,Marzo,Guatemala,1,0,,1,-72.508188,7.927233
2394,2012,Marzo,Guatemala,1,3,,4,-77.35002,8.63337
2395,2012,Marzo,Guyana,0,1,,1,-77.35600000000001,0.81488
2396,2012,Marzo,Guyana,0,1,,1,-75.527794,10.406342
2397,2012,Marzo,Guyana,0,9,,9,-74.77647900000001,10.886686
2398,2012,Marzo,Guyana,0,7,,7,-74.765343,10.970933
2399,2012,Marzo,Guyana,0,1,,1,-76.532004,3.451668
2400,2012,Marzo,Guyana,3,6,,9,-74.140516,4.697157
2401,2012,Marzo,Guyana,0,2,,2,-75.42726,6.170465
2402,2012,Marzo,Guinea Ecuatorial,1,0,,1,-74.140516,4.697157
2403,2012,Marzo,Guinea Bissau,0,1,,1,-74.140516,4.697157
2404,2012,Marzo,Haití,1,1,,2,-75.516486,10.446304
2405,2012,Marzo,Haití,1,2,,3,-74.77647900000001,10.886686
2406,2012,Marzo,Haití,0,1,,1,-76.532004,3.451668
2407,2012,Marzo,Haití,5,24,,29,-74.140516,4.697157
2408,2012,Marzo,Haití,1,3,,4,-75.42726,6.170465
2409,2012,Marzo,Honduras,2,0,,2,-77.35600000000001,0.81488
2410,2012,Marzo,Honduras,1,16,,17,-75.527794,10.406342
2411,2012,Marzo,Honduras,9,12,,21,-75.516486,10.446304
2412,2012,Marzo,Honduras,11,15,,26,-74.77647900000001,10.886686
2413,2012,Marzo,Honduras,0,5,,5,-81.703935,12.574411099999999
2414,2012,Marzo,Honduras,1,1,,2,-81.70216500000001,12.5862
2415,2012,Marzo,Honduras,13,12,,25,-76.532004,3.451668
2416,2012,Marzo,Honduras,0,1,,1,-75.76635300000001,4.45285
2417,2012,Marzo,Honduras,134,181,,315,-74.140516,4.697157
2418,2012,Marzo,Honduras,1,1,,2,-75.736374,4.815189
2419,2012,Marzo,Honduras,17,21,,38,-75.42726,6.170465
2420,2012,Marzo,Honduras,1,0,,1,-72.453013,7.819
2421,2012,Marzo,Honduras,0,1,,1,-77.35002,8.63337
2422,2012,Marzo,Hungría,2,0,,2,-69.941498,4.191162
2423,2012,Marzo,Hungría,0,2,,2,-77.35600000000001,0.81488
2424,2012,Marzo,Hungría,0,2,,2,-75.527794,10.406342
2425,2012,Marzo,Hungría,3,1,,4,-75.516486,10.446304
2426,2012,Marzo,Hungría,0,2,,2,-72.129595,11.360028999999999
2427,2012,Marzo,Hungría,1,2,,3,-76.532004,3.451668
2428,2012,Marzo,Hungría,21,28,,49,-74.140516,4.697157
2429,2012,Marzo,Hungría,1,0,,1,-75.42726,6.170465
2430,2012,Marzo,Hungría,0,2,,2,-72.453013,7.819
2431,2012,Marzo,India,2,4,,6,-77.35600000000001,0.81488
2432,2012,Marzo,India,1,3,,4,-75.516486,10.446304
2433,2012,Marzo,India,2,4,,6,-74.77647900000001,10.886686
2434,2012,Marzo,India,0,1,,1,-81.70216500000001,12.5862
2435,2012,Marzo,India,2,2,,4,-76.532004,3.451668
2436,2012,Marzo,India,43,230,,273,-74.140516,4.697157
2437,2012,Marzo,India,5,30,,35,-75.42726,6.170465
2438,2012,Marzo,India,0,1,,1,-73.181317,7.1280470000000005
2439,2012,Marzo,Indonesia,1,20,,21,-75.527794,10.406342
2440,2012,Marzo,Indonesia,1,0,,1,-75.516486,10.446304
2441,2012,Marzo,Indonesia,0,1,,1,-74.765343,10.970933
2442,2012,Marzo,Indonesia,1,0,,1,-76.532004,3.451668
2443,2012,Marzo,Indonesia,5,22,,27,-74.140516,4.697157
2444,2012,Marzo,Indonesia,1,1,,2,-75.42726,6.170465
2445,2012,Marzo,Iraq,0,2,,2,-74.140516,4.697157
2446,2012,Marzo,Irán,6,16,,22,-74.140516,4.697157
2447,2012,Marzo,República de Irlanda,0,1,,1,-69.941498,4.191162
2448,2012,Marzo,República de Irlanda,9,11,,20,-77.35600000000001,0.81488
2449,2012,Marzo,República de Irlanda,1,4,,5,-75.516486,10.446304
2450,2012,Marzo,República de Irlanda,1,1,,2,-72.129595,11.360028999999999
2451,2012,Marzo,República de Irlanda,0,3,,3,-76.532004,3.451668
2452,2012,Marzo,República de Irlanda,44,111,,155,-74.140516,4.697157
2453,2012,Marzo,República de Irlanda,0,2,,2,-75.736374,4.815189
2454,2012,Marzo,República de Irlanda,2,4,,6,-75.42726,6.170465
2455,2012,Marzo,República de Irlanda,0,4,,4,-72.453013,7.819
2456,2012,Marzo,República de Irlanda,0,3,,3,-77.35002,8.63337
2457,2012,Marzo,Islandia,2,0,,2,-77.35600000000001,0.81488
2458,2012,Marzo,Islandia,1,0,,1,-81.372937,13.338761300000002
2459,2012,Marzo,Islandia,3,3,,6,-74.140516,4.697157
2460,2012,Marzo,Islandia,1,1,,2,-75.42726,6.170465
2461,2012,Marzo,Isla de Man,28,45,,73,-77.35600000000001,0.81488
2462,2012,Marzo,Isla de Man,11,22,,33,-75.516486,10.446304
2463,2012,Marzo,Isla de Man,1,38,,39,-74.77647900000001,10.886686
2464,2012,Marzo,Isla de Man,0,1,,1,-72.129595,11.360028999999999
2465,2012,Marzo,Isla de Man,7,20,,27,-76.532004,3.451668
2466,2012,Marzo,Isla de Man,0,2,,2,-75.76635300000001,4.45285
2467,2012,Marzo,Isla de Man,55,124,,179,-74.140516,4.697157
2468,2012,Marzo,Isla de Man,0,1,,1,-75.736374,4.815189
2469,2012,Marzo,Isla de Man,8,31,,39,-75.42726,6.170465
2470,2012,Marzo,Isla Johnston,0,1,,1,-76.532004,3.451668
2471,2012,Marzo,Israel,1,0,,1,-69.941498,4.191162
2472,2012,Marzo,Israel,3,9,,12,-77.35600000000001,0.81488
2473,2012,Marzo,Israel,3,29,,32,-75.516486,10.446304
2474,2012,Marzo,Israel,0,4,,4,-74.77647900000001,10.886686
2475,2012,Marzo,Israel,2,0,,2,-81.70216500000001,12.5862
2476,2012,Marzo,Israel,1,5,,6,-76.532004,3.451668
2477,2012,Marzo,Israel,89,445,,534,-74.140516,4.697157
2478,2012,Marzo,Israel,1,53,,54,-75.42726,6.170465
2479,2012,Marzo,Israel,0,2,,2,-72.508188,7.927233
2480,2012,Marzo,Israel,1,1,,2,-77.35002,8.63337
2481,2012,Marzo,Islas Aland/Provincia de Finlandia,0,1,,1,-74.140516,4.697157
2482,2012,Marzo,Italia,0,4,,4,-69.941498,4.191162
2483,2012,Marzo,Italia,9,18,,27,-77.35600000000001,0.81488
2484,2012,Marzo,Italia,3,4,,7,-75.527794,10.406342
2485,2012,Marzo,Italia,104,194,,298,-75.516486,10.446304
2486,2012,Marzo,Italia,3,20,,23,-74.77647900000001,10.886686
2487,2012,Marzo,Italia,3,16,,19,-72.129595,11.360028999999999
2488,2012,Marzo,Italia,10,20,,30,-81.70216500000001,12.5862
2489,2012,Marzo,Italia,1,2,,3,-81.372937,13.338761300000002
2490,2012,Marzo,Italia,14,68,,82,-76.532004,3.451668
2491,2012,Marzo,Italia,360,1654,,2014,-74.140516,4.697157
2492,2012,Marzo,Italia,0,3,,3,-75.736374,4.815189
2493,2012,Marzo,Italia,18,82,,100,-75.42726,6.170465
2494,2012,Marzo,Italia,0,1,,1,-67.48402800000001,6.185536
2495,2012,Marzo,Italia,4,25,,29,-72.453013,7.819
2496,2012,Marzo,Italia,1,4,,5,-72.508188,7.927233
2497,2012,Marzo,Italia,0,1,,1,-77.35002,8.63337
2498,2012,Marzo,Islas del Canal,1,1,,2,-74.140516,4.697157
2499,2012,Marzo,Jamaica,0,1,,1,-75.527794,10.406342
2500,2012,Marzo,Jamaica,2,4,,6,-75.516486,10.446304
2501,2012,Marzo,Jamaica,1,0,,1,-81.70216500000001,12.5862
2502,2012,Marzo,Jamaica,1,2,,3,-76.532004,3.451668
2503,2012,Marzo,Jamaica,4,18,,22,-74.140516,4.697157
2504,2012,Marzo,Jamaica,2,4,,6,-75.42726,6.170465
2505,2012,Marzo,Japón,8,24,,32,-77.35600000000001,0.81488
2506,2012,Marzo,Japón,0,9,,9,-75.527794,10.406342
2507,2012,Marzo,Japón,1,7,,8,-75.516486,10.446304
2508,2012,Marzo,Japón,1,2,,3,-74.77647900000001,10.886686
2509,2012,Marzo,Japón,1,1,,2,-72.129595,11.360028999999999
2510,2012,Marzo,Japón,3,25,,28,-76.532004,3.451668
2511,2012,Marzo,Japón,235,479,,714,-74.140516,4.697157
2512,2012,Marzo,Japón,1,0,,1,-75.736374,4.815189
2513,2012,Marzo,Japón,4,16,,20,-75.42726,6.170465
2514,2012,Marzo,Japón,0,1,,1,-67.48402800000001,6.185536
2515,2012,Marzo,Japón,1,3,,4,-72.453013,7.819
2516,2012,Marzo,Japón,0,3,,3,-72.508188,7.927233
2517,2012,Marzo,Japón,0,1,,1,-77.35002,8.63337
2518,2012,Marzo,Jordania,3,7,,10,-74.140516,4.697157
2519,2012,Marzo,Jordania,0,2,,2,-75.42726,6.170465
2520,2012,Marzo,Kazajistán,1,0,,1,-77.35600000000001,0.81488
2521,2012,Marzo,Kazajistán,1,3,,4,-74.140516,4.697157
2522,2012,Marzo,Kenia,1,0,,1,-77.35600000000001,0.81488
2523,2012,Marzo,Kenia,3,8,,11,-74.140516,4.697157
2524,2012,Marzo,Kenia,0,1,,1,-72.453013,7.819
2525,2012,Marzo,Kirguistán,0,1,,1,-74.140516,4.697157
2526,2012,Marzo,Kuwait,0,3,,3,-74.77647900000001,10.886686
2527,2012,Marzo,República de Kosovo,6,14,,20,-74.140516,4.697157
2528,2012,Marzo,Letonia,1,0,,1,-77.35600000000001,0.81488
2529,2012,Marzo,Letonia,0,3,,3,-75.527794,10.406342
2530,2012,Marzo,Letonia,0,1,,1,-75.516486,10.446304
2531,2012,Marzo,Letonia,5,9,,14,-74.140516,4.697157
2532,2012,Marzo,Letonia,1,0,,1,-75.42726,6.170465
2533,2012,Marzo,Lituania,1,0,,1,-77.35600000000001,0.81488
2534,2012,Marzo,Lituania,1,0,,1,-75.516486,10.446304
2535,2012,Marzo,Lituania,4,12,,16,-74.140516,4.697157
2536,2012,Marzo,Lituania,1,0,,1,-75.42726,6.170465
2537,2012,Marzo,Líbano,1,8,,9,-74.77647900000001,10.886686
2538,2012,Marzo,Líbano,5,5,,10,-72.129595,11.360028999999999
2539,2012,Marzo,Líbano,0,1,,1,-76.532004,3.451668
2540,2012,Marzo,Líbano,10,31,,41,-74.140516,4.697157
2541,2012,Marzo,Liberia,0,1,,1,-74.140516,4.697157
2542,2012,Marzo,Liechtenstein,1,0,,1,-72.129595,11.360028999999999
2543,2012,Marzo,Liechtenstein,2,3,,5,-74.140516,4.697157
2544,2012,Marzo,Liechtenstein,1,0,,1,-75.42726,6.170465
2545,2012,Marzo,Luxemburgo,0,2,,2,-77.35600000000001,0.81488
2546,2012,Marzo,Luxemburgo,0,1,,1,-75.527794,10.406342
2547,2012,Marzo,Luxemburgo,8,17,,25,-74.140516,4.697157
2548,2012,Marzo,Macedonia,1,4,,5,-74.140516,4.697157
2549,2012,Marzo,Madagascar,0,2,,2,-74.140516,4.697157
2550,2012,Marzo,Malasia,1,0,,1,-69.941498,4.191162
2551,2012,Marzo,Malasia,1,0,,1,-77.35600000000001,0.81488
2552,2012,Marzo,Malasia,0,1,,1,-75.516486,10.446304
2553,2012,Marzo,Malasia,1,1,,2,-76.532004,3.451668
2554,2012,Marzo,Malasia,4,20,,24,-74.140516,4.697157
2555,2012,Marzo,Malawi,2,0,,2,-74.140516,4.697157
2556,2012,Marzo,Malta,0,1,,1,-69.941498,4.191162
2557,2012,Marzo,Malta,1,0,,1,-75.516486,10.446304
2558,2012,Marzo,Malta,0,1,,1,-76.532004,3.451668
2559,2012,Marzo,Malta,0,4,,4,-74.140516,4.697157
2560,2012,Marzo,Marruecos,1,0,,1,-76.532004,3.451668
2561,2012,Marzo,Marruecos,5,9,,14,-74.140516,4.697157
2562,2012,Marzo,Marruecos,0,1,,1,-75.42726,6.170465
2563,2012,Marzo,Mauricio,0,1,,1,-74.140516,4.697157
2564,2012,Marzo,México,0,1,,1,-69.941498,4.191162
2565,2012,Marzo,México,1,0,,1,-76.876446,0.33002
2566,2012,Marzo,México,8,9,,17,-77.35600000000001,0.81488
2567,2012,Marzo,México,11,19,,30,-75.527794,10.406342
2568,2012,Marzo,México,69,103,,172,-75.516486,10.446304
2569,2012,Marzo,México,18,49,,67,-74.77647900000001,10.886686
2570,2012,Marzo,México,3,8,,11,-72.129595,11.360028999999999
2571,2012,Marzo,México,0,2,,2,-81.703935,12.574411099999999
2572,2012,Marzo,México,2,3,,5,-81.70216500000001,12.5862
2573,2012,Marzo,México,44,91,,135,-76.532004,3.451668
2574,2012,Marzo,México,0,1,,1,-77.061029,3.8844260000000004
2575,2012,Marzo,México,1,2,,3,-75.76635300000001,4.45285
2576,2012,Marzo,México,1685,4074,,5759,-74.140516,4.697157
2577,2012,Marzo,México,3,9,,12,-75.736374,4.815189
2578,2012,Marzo,México,86,281,,367,-75.42726,6.170465
2579,2012,Marzo,México,1,2,,3,-73.181317,7.1280470000000005
2580,2012,Marzo,México,6,27,,33,-72.453013,7.819
2581,2012,Marzo,México,3,3,,6,-72.508188,7.927233
2582,2012,Marzo,México,1,6,,7,-77.35002,8.63337
2583,2012,Marzo,República de Moldavia,2,0,,2,-74.140516,4.697157
2584,2012,Marzo,Mónaco,0,1,,1,-74.77647900000001,10.886686
2585,2012,Marzo,Mozambique,1,1,,2,-74.140516,4.697157
2586,2012,Marzo,Myanmar,1,0,,1,-74.140516,4.697157
2587,2012,Marzo,Namibia,0,1,,1,-74.140516,4.697157
2588,2012,Marzo,Nepal,0,2,,2,-77.35600000000001,0.81488
2589,2012,Marzo,Nepal,0,1,,1,-74.140516,4.697157
2590,2012,Marzo,Nepal,0,1,,1,-75.42726,6.170465
2591,2012,Marzo,Nicaragua,8,8,,16,-75.516486,10.446304
2592,2012,Marzo,Nicaragua,2,2,,4,-74.77647900000001,10.886686
2593,2012,Marzo,Nicaragua,1,2,,3,-81.70216500000001,12.5862
2594,2012,Marzo,Nicaragua,2,9,,11,-76.532004,3.451668
2595,2012,Marzo,Nicaragua,38,64,,102,-74.140516,4.697157
2596,2012,Marzo,Nicaragua,0,1,,1,-75.736374,4.815189
2597,2012,Marzo,Nicaragua,9,10,,19,-75.42726,6.170465
2598,2012,Marzo,Nicaragua,1,0,,1,-73.181317,7.1280470000000005
2599,2012,Marzo,Nigeria,2,5,,7,-74.140516,4.697157
2600,2012,Marzo,Noruega,7,2,,9,-77.35600000000001,0.81488
2601,2012,Marzo,Noruega,1,9,,10,-75.527794,10.406342
2602,2012,Marzo,Noruega,2,7,,9,-75.516486,10.446304
2603,2012,Marzo,Noruega,0,1,,1,-74.77647900000001,10.886686
2604,2012,Marzo,Noruega,0,2,,2,-74.765343,10.970933
2605,2012,Marzo,Noruega,3,3,,6,-74.213989,11.247722999999999
2606,2012,Marzo,Noruega,0,2,,2,-72.129595,11.360028999999999
2607,2012,Marzo,Noruega,3,8,,11,-76.532004,3.451668
2608,2012,Marzo,Noruega,72,126,,198,-74.140516,4.697157
2609,2012,Marzo,Noruega,5,8,,13,-75.42726,6.170465
2610,2012,Marzo,Noruega,1,3,,4,-73.181317,7.1280470000000005
2611,2012,Marzo,Noruega,0,1,,1,-72.453013,7.819
2612,2012,Marzo,Noruega,0,1,,1,-72.508188,7.927233
2613,2012,Marzo,Noruega,0,3,,3,-77.35002,8.63337
2614,2012,Marzo,Nueva Caledonia/Territorio francés,0,1,,1,-75.527794,10.406342
2615,2012,Marzo,Nueva Zelanda,4,7,,11,-77.35600000000001,0.81488
2616,2012,Marzo,Nueva Zelanda,3,7,,10,-75.516486,10.446304
2617,2012,Marzo,Nueva Zelanda,0,1,,1,-74.77647900000001,10.886686
2618,2012,Marzo,Nueva Zelanda,0,4,,4,-76.532004,3.451668
2619,2012,Marzo,Nueva Zelanda,33,51,,84,-74.140516,4.697157
2620,2012,Marzo,Nueva Zelanda,0,1,,1,-75.736374,4.815189
2621,2012,Marzo,Nueva Zelanda,1,6,,7,-75.42726,6.170465
2622,2012,Marzo,Nueva Zelanda,1,1,,2,-72.453013,7.819
2623,2012,Marzo,Omán,0,1,,1,-74.140516,4.697157
2624,2012,Marzo,Nueva Zelanda,1,4,,5,-69.941498,4.191162
2625,2012,Marzo,Nueva Zelanda,1,1,,2,-77.35600000000001,0.81488
2626,2012,Marzo,Nueva Zelanda,2,5,,7,-75.527794,10.406342
2627,2012,Marzo,Nueva Zelanda,1,0,,1,-74.213989,11.247722999999999
2628,2012,Marzo,Nueva Zelanda,2,5,,7,-74.140516,4.697157
2629,2012,Marzo,Nueva Zelanda,0,1,,1,-75.42726,6.170465
2630,2012,Marzo,Nueva Zelanda,0,1,,1,-72.453013,7.819
2631,2012,Marzo,Nueva Zelanda,0,2,,2,-77.35002,8.63337
2632,2012,Marzo,Omán,0,1,,1,-74.140516,4.697157
2633,2012,Marzo,Países Bajos,23,20,,43,-77.35600000000001,0.81488
2634,2012,Marzo,Países Bajos,0,1,,1,-75.527794,10.406342
2635,2012,Marzo,Países Bajos,4,16,,20,-75.516486,10.446304
2636,2012,Marzo,Países Bajos,7,8,,15,-74.77647900000001,10.886686
2637,2012,Marzo,Países Bajos,1,3,,4,-72.129595,11.360028999999999
2638,2012,Marzo,Países Bajos,23,23,,46,-72.919186,11.52863
2639,2012,Marzo,Países Bajos,0,1,,1,-81.70216500000001,12.5862
2640,2012,Marzo,Países Bajos,7,15,,22,-76.532004,3.451668
2641,2012,Marzo,Países Bajos,158,262,,420,-74.140516,4.697157
2642,2012,Marzo,Países Bajos,0,1,,1,-75.736374,4.815189
2643,2012,Marzo,Países Bajos,129,159,,288,-75.42726,6.170465
2644,2012,Marzo,Países Bajos,1,2,,3,-73.181317,7.1280470000000005
2645,2012,Marzo,Pakistán,0,1,,1,-75.516486,10.446304
2646,2012,Marzo,Pakistán,1,25,,26,-74.140516,4.697157
2647,2012,Marzo,Pakistán,1,0,,1,-75.42726,6.170465
2648,2012,Marzo,Panamá,0,1,,1,-77.35600000000001,0.81488
2649,2012,Marzo,Panamá,3,42,,45,-75.527794,10.406342
2650,2012,Marzo,Panamá,59,114,,173,-75.516486,10.446304
2651,2012,Marzo,Panamá,54,93,,147,-74.77647900000001,10.886686
2652,2012,Marzo,Panamá,0,5,,5,-81.703935,12.574411099999999
2653,2012,Marzo,Panamá,23,32,,55,-81.70216500000001,12.5862
2654,2012,Marzo,Panamá,57,109,,166,-76.532004,3.451668
2655,2012,Marzo,Panamá,467,851,,1318,-74.140516,4.697157
2656,2012,Marzo,Panamá,31,52,,83,-75.736374,4.815189
2657,2012,Marzo,Panamá,110,222,,332,-75.42726,6.170465
2658,2012,Marzo,Panamá,1,1,,2,-77.401154,6.222551999999999
2659,2012,Marzo,Panamá,8,12,,20,-73.181317,7.1280470000000005
2660,2012,Marzo,Panamá,0,4,,4,-72.453013,7.819
2661,2012,Marzo,Panamá,7,19,,26,-72.508188,7.927233
2662,2012,Marzo,Panamá,1,7,,8,-77.35002,8.63337
2663,2012,Marzo,Paraguay,4,6,,10,-75.516486,10.446304
2664,2012,Marzo,Paraguay,0,4,,4,-74.77647900000001,10.886686
2665,2012,Marzo,Paraguay,1,1,,2,-81.70216500000001,12.5862
2666,2012,Marzo,Paraguay,4,6,,10,-76.532004,3.451668
2667,2012,Marzo,Paraguay,45,59,,104,-74.140516,4.697157
2668,2012,Marzo,Paraguay,5,6,,11,-75.42726,6.170465
2669,2012,Marzo,Paraguay,0,22,,22,-72.453013,7.819
2670,2012,Marzo,Perú,19,31,,50,-69.941498,4.191162
2671,2012,Marzo,Perú,2,3,,5,-76.876446,0.33002
2672,2012,Marzo,Perú,157,382,,539,-77.35600000000001,0.81488
2673,2012,Marzo,Perú,20,14,,34,-75.527794,10.406342
2674,2012,Marzo,Perú,127,89,,216,-75.516486,10.446304
2675,2012,Marzo,Perú,16,25,,41,-74.77647900000001,10.886686
2676,2012,Marzo,Perú,0,1,,1,-74.765343,10.970933
2677,2012,Marzo,Perú,2,6,,8,-72.129595,11.360028999999999
2678,2012,Marzo,Perú,212,163,,375,-81.70216500000001,12.5862
2679,2012,Marzo,Perú,94,153,,247,-76.532004,3.451668
2680,2012,Marzo,Perú,0,1,,1,-75.76635300000001,4.45285
2681,2012,Marzo,Perú,2407,3451,,5858,-74.140516,4.697157
2682,2012,Marzo,Perú,0,8,,8,-75.736374,4.815189
2683,2012,Marzo,Perú,120,343,,463,-75.42726,6.170465
2684,2012,Marzo,Perú,1,0,,1,-67.48402800000001,6.185536
2685,2012,Marzo,Perú,0,1,,1,-70.74025300000001,7.088728999999999
2686,2012,Marzo,Perú,4,8,,12,-73.181317,7.1280470000000005
2687,2012,Marzo,Perú,43,65,,108,-72.453013,7.819
2688,2012,Marzo,Perú,3,2,,5,-72.508188,7.927233
2689,2012,Marzo,Perú,1,0,,1,-77.35002,8.63337
2690,2012,Marzo,Perú,0,1,,1,-75.68164200000001,9.402597
2691,2012,Marzo,Palestina,0,2,,2,-74.140516,4.697157
2692,2012,Marzo,Palestina,0,1,,1,-75.42726,6.170465
2693,2012,Marzo,Polonia,0,3,,3,-69.941498,4.191162
2694,2012,Marzo,Polonia,6,6,,12,-77.35600000000001,0.81488
2695,2012,Marzo,Polonia,5,14,,19,-75.527794,10.406342
2696,2012,Marzo,Polonia,4,1,,5,-75.516486,10.446304
2697,2012,Marzo,Polonia,1,1,,2,-74.77647900000001,10.886686
2698,2012,Marzo,Polonia,0,6,,6,-74.765343,10.970933
2699,2012,Marzo,Polonia,0,9,,9,-74.213989,11.247722999999999
2700,2012,Marzo,Polonia,3,1,,4,-72.129595,11.360028999999999
2701,2012,Marzo,Polonia,1,2,,3,-76.532004,3.451668
2702,2012,Marzo,Polonia,0,1,,1,-77.061029,3.8844260000000004
2703,2012,Marzo,Polonia,79,142,,221,-74.140516,4.697157
2704,2012,Marzo,Polonia,1,2,,3,-75.42726,6.170465
2705,2012,Marzo,Polonia,0,1,,1,-77.35002,8.63337
2706,2012,Marzo,Portugal,0,1,,1,-69.941498,4.191162
2707,2012,Marzo,Portugal,1,1,,2,-76.876446,0.33002
2708,2012,Marzo,Portugal,2,3,,5,-77.35600000000001,0.81488
2709,2012,Marzo,Portugal,0,2,,2,-75.527794,10.406342
2710,2012,Marzo,Portugal,4,7,,11,-75.516486,10.446304
2711,2012,Marzo,Portugal,0,2,,2,-74.77647900000001,10.886686
2712,2012,Marzo,Portugal,1,3,,4,-72.129595,11.360028999999999
2713,2012,Marzo,Portugal,0,5,,5,-76.532004,3.451668
2714,2012,Marzo,Portugal,77,245,,322,-74.140516,4.697157
2715,2012,Marzo,Portugal,4,5,,9,-75.42726,6.170465
2716,2012,Marzo,Portugal,2,3,,5,-72.453013,7.819
2717,2012,Marzo,Portugal,1,1,,2,-72.508188,7.927233
2718,2012,Marzo,Puerto Rico/Territorio de Estados Unidos,2,2,,4,-75.516486,10.446304
2719,2012,Marzo,Puerto Rico/Territorio de Estados Unidos,0,2,,2,-75.42726,6.170465
2720,2012,Marzo,Reino Unido de Gran Bretaña e Irlanda del Norte,12,15,,27,-69.941498,4.191162
2721,2012,Marzo,Reino Unido de Gran Bretaña e Irlanda del Norte,0,5,,5,-77.35600000000001,0.81488
2722,2012,Marzo,Reino Unido de Gran Bretaña e Irlanda del Norte,24,32,,56,-75.516486,10.446304
2723,2012,Marzo,Reino Unido de Gran Bretaña e Irlanda del Norte,0,1,,1,-74.77647900000001,10.886686
2724,2012,Marzo,Reino Unido de Gran Bretaña e Irlanda del Norte,5,5,,10,-72.129595,11.360028999999999
2725,2012,Marzo,Reino Unido de Gran Bretaña e Irlanda del Norte,4,16,,20,-76.532004,3.451668
2726,2012,Marzo,Reino Unido de Gran Bretaña e Irlanda del Norte,225,482,,707,-74.140516,4.697157
2727,2012,Marzo,Reino Unido de Gran Bretaña e Irlanda del Norte,8,29,,37,-75.42726,6.170465
2728,2012,Marzo,Reino Unido de Gran Bretaña e Irlanda del Norte,1,1,,2,-73.181317,7.1280470000000005
2729,2012,Marzo,Reino Unido de Gran Bretaña e Irlanda del Norte,1,1,,2,-72.453013,7.819
2730,2012,Marzo,Reino Unido de Gran Bretaña e Irlanda del Norte,0,2,,2,-72.508188,7.927233
2731,2012,Marzo,Reino Unido de Gran Bretaña e Irlanda del Norte,0,4,,4,-77.35002,8.63337
2732,2012,Marzo,Reino Unido de Gran Bretaña e Irlanda del Norte,0,1,,1,-75.68164200000001,9.402597
2733,2012,Marzo,República de Belarús,2,0,,2,-74.140516,4.697157
2734,2012,Marzo,República Dominicana,2,2,,4,-77.35600000000001,0.81488
2735,2012,Marzo,República Dominicana,0,2,,2,-75.527794,10.406342
2736,2012,Marzo,República Dominicana,9,18,,27,-75.516486,10.446304
2737,2012,Marzo,República Dominicana,32,19,,51,-74.77647900000001,10.886686
2738,2012,Marzo,República Dominicana,0,1,,1,-72.129595,11.360028999999999
2739,2012,Marzo,República Dominicana,21,39,,60,-76.532004,3.451668
2740,2012,Marzo,República Dominicana,207,325,,532,-74.140516,4.697157
2741,2012,Marzo,República Dominicana,2,2,,4,-75.736374,4.815189
2742,2012,Marzo,República Dominicana,44,48,,92,-75.42726,6.170465
2743,2012,Marzo,República Dominicana,1,2,,3,-73.181317,7.1280470000000005
2744,2012,Marzo,República Dominicana,1,4,,5,-72.453013,7.819
2745,2012,Marzo,República Dominicana,1,0,,1,-72.508188,7.927233
2746,2012,Marzo,República Checa,0,1,,1,-77.35600000000001,0.81488
2747,2012,Marzo,República Checa,4,4,,8,-74.140516,4.697157
2748,2012,Marzo,Rumania,1,4,,5,-75.527794,10.406342
2749,2012,Marzo,Rumania,2,7,,9,-75.516486,10.446304
2750,2012,Marzo,Rumania,0,1,,1,-76.532004,3.451668
2751,2012,Marzo,Rumania,41,79,,120,-74.140516,4.697157
2752,2012,Marzo,Rumania,2,2,,4,-75.42726,6.170465
2753,2012,Marzo,Rumania,0,1,,1,-72.453013,7.819
2754,2012,Marzo,Rumania,0,1,,1,-72.508188,7.927233
2755,2012,Marzo,Federación de Rusia,9,10,,19,-77.35600000000001,0.81488
2756,2012,Marzo,Federación de Rusia,2,2,,4,-75.516486,10.446304
2757,2012,Marzo,Federación de Rusia,0,2,,2,-74.765343,10.970933
2758,2012,Marzo,Federación de Rusia,0,1,,1,-72.129595,11.360028999999999
2759,2012,Marzo,Federación de Rusia,3,1,,4,-76.532004,3.451668
2760,2012,Marzo,Federación de Rusia,0,2,,2,-77.061029,3.8844260000000004
2761,2012,Marzo,Federación de Rusia,49,56,,105,-74.140516,4.697157
2762,2012,Marzo,Federación de Rusia,1,0,,1,-75.736374,4.815189
2763,2012,Marzo,Federación de Rusia,2,5,,7,-75.42726,6.170465
2764,2012,Marzo,Federación de Rusia,3,1,,4,-72.453013,7.819
2765,2012,Marzo,San Cristóbal y Nevis,0,1,,1,-75.516486,10.446304
2766,2012,Marzo,San Cristóbal y Nevis,0,1,,1,-74.140516,4.697157
2767,2012,Marzo,San Marino,0,1,,1,-72.129595,11.360028999999999
2768,2012,Marzo,San  Vicente y las Granadinas,0,1,,1,-75.516486,10.446304
2769,2012,Marzo,San  Vicente y las Granadinas,1,1,,2,-75.42726,6.170465
2770,2012,Marzo,Santa Lucia,0,2,,2,-75.527794,10.406342
2771,2012,Marzo,Santa Lucia,1,2,,3,-75.516486,10.446304
2772,2012,Marzo,Santa Lucia,0,1,,1,-74.77647900000001,10.886686
2773,2012,Marzo,Santa Lucia,2,2,,4,-74.140516,4.697157
2774,2012,Marzo,Santa Lucia,2,4,,6,-73.181317,7.1280470000000005
2775,2012,Marzo,Santa Sede/Ciudad del Vaticano,0,1,,1,-74.140516,4.697157
2776,2012,Marzo,Senegal,1,2,,3,-74.140516,4.697157
2777,2012,Marzo,Serbia,1,0,,1,-77.35600000000001,0.81488
2778,2012,Marzo,Serbia,0,1,,1,-75.516486,10.446304
2779,2012,Marzo,Serbia,0,1,,1,-72.129595,11.360028999999999
2780,2012,Marzo,Serbia,1,1,,2,-76.532004,3.451668
2781,2012,Marzo,Serbia,14,17,,31,-74.140516,4.697157
2782,2012,Marzo,Sierra Leona,0,1,,1,-74.140516,4.697157
2783,2012,Marzo,Singapur,2,0,,2,-75.516486,10.446304
2784,2012,Marzo,Singapur,10,17,,27,-74.140516,4.697157
2785,2012,Marzo,Singapur,1,0,,1,-75.42726,6.170465
2786,2012,Marzo,República Árabe Siria,0,1,,1,-76.532004,3.451668
2787,2012,Marzo,República Árabe Siria,1,2,,3,-74.140516,4.697157
2788,2012,Marzo,República Árabe Siria,0,1,,1,-75.42726,6.170465
2789,2012,Marzo,Sri Lanka,0,1,,1,-74.140516,4.697157
2790,2012,Marzo,Sudáfrica,3,2,,5,-77.35600000000001,0.81488
2791,2012,Marzo,Sudáfrica,1,2,,3,-78.802679,18.00143
2792,2012,Marzo,Sudáfrica,1,0,,1,-75.527794,10.406342
2793,2012,Marzo,Sudáfrica,0,3,,3,-75.516486,10.446304
2794,2012,Marzo,Sudáfrica,0,3,,3,-74.77647900000001,10.886686
2795,2012,Marzo,Sudáfrica,1,3,,4,-72.129595,11.360028999999999
2796,2012,Marzo,Sudáfrica,0,2,,2,-76.532004,3.451668
2797,2012,Marzo,Sudáfrica,33,76,,109,-74.140516,4.697157
2798,2012,Marzo,Sudán,0,1,,1,-74.140516,4.697157
2799,2012,Marzo,Suecia,0,5,,5,-69.941498,4.191162
2800,2012,Marzo,Suecia,11,17,,28,-77.35600000000001,0.81488
2801,2012,Marzo,Suecia,5,13,,18,-75.527794,10.406342
2802,2012,Marzo,Suecia,6,8,,14,-75.516486,10.446304
2803,2012,Marzo,Suecia,2,8,,10,-74.77647900000001,10.886686
2804,2012,Marzo,Suecia,0,2,,2,-74.213989,11.247722999999999
2805,2012,Marzo,Suecia,1,4,,5,-72.129595,11.360028999999999
2806,2012,Marzo,Suecia,0,1,,1,-81.703935,12.574411099999999
2807,2012,Marzo,Suecia,1,0,,1,-81.70216500000001,12.5862
2808,2012,Marzo,Suecia,8,10,,18,-76.532004,3.451668
2809,2012,Marzo,Suecia,136,234,,370,-74.140516,4.697157
2810,2012,Marzo,Suecia,5,15,,20,-75.42726,6.170465
2811,2012,Marzo,Suecia,0,3,,3,-77.401154,6.222551999999999
2812,2012,Marzo,Suecia,2,5,,7,-72.453013,7.819
2813,2012,Marzo,Suecia,0,2,,2,-77.35002,8.63337
2814,2012,Marzo,Suiza,3,7,,10,-69.941498,4.191162
2815,2012,Marzo,Suiza,0,1,,1,-76.876446,0.33002
2816,2012,Marzo,Suiza,21,29,,50,-77.35600000000001,0.81488
2817,2012,Marzo,Suiza,11,12,,23,-75.527794,10.406342
2818,2012,Marzo,Suiza,18,17,,35,-75.516486,10.446304
2819,2012,Marzo,Suiza,2,4,,6,-74.77647900000001,10.886686
2820,2012,Marzo,Suiza,0,5,,5,-72.129595,11.360028999999999
2821,2012,Marzo,Suiza,1,1,,2,-81.70216500000001,12.5862
2822,2012,Marzo,Suiza,10,29,,39,-76.532004,3.451668
2823,2012,Marzo,Suiza,244,499,,743,-74.140516,4.697157
2824,2012,Marzo,Suiza,14,33,,47,-75.42726,6.170465
2825,2012,Marzo,Suiza,0,1,,1,-73.181317,7.1280470000000005
2826,2012,Marzo,Suiza,3,6,,9,-72.453013,7.819
2827,2012,Marzo,Suiza,2,2,,4,-77.35002,8.63337
2828,2012,Marzo,Surinam,6,17,,23,-74.140516,4.697157
2829,2012,Marzo,Surinam,0,2,,2,-75.42726,6.170465
2830,2012,Marzo,Suazilandia,1,0,,1,-74.140516,4.697157
2831,2012,Marzo,Taiwán,1,0,,1,-74.140516,4.697157
2832,2012,Marzo,Taiwán,0,3,,3,-72.453013,7.819
2833,2012,Marzo,Tailandia,1,1,,2,-74.77647900000001,10.886686
2834,2012,Marzo,Tailandia,4,1,,5,-74.140516,4.697157
2835,2012,Marzo,Territorio Antártico Británico/Territorio Británico de Ultramar,1,4,,5,-74.140516,4.697157
2836,2012,Marzo,Tanzania,2,1,,3,-74.140516,4.697157
2837,2012,Marzo,República de Tayikistán,1,0,,1,-74.140516,4.697157
2838,2012,Marzo,Togo,0,1,,1,-74.140516,4.697157
2839,2012,Marzo,Trinidad y Tobago,1,0,,1,-75.527794,10.406342
2840,2012,Marzo,Trinidad y Tobago,5,44,,49,-75.516486,10.446304
2841,2012,Marzo,Trinidad y Tobago,0,2,,2,-74.77647900000001,10.886686
2842,2012,Marzo,Trinidad y Tobago,1,2,,3,-72.129595,11.360028999999999
2843,2012,Marzo,Trinidad y Tobago,1,2,,3,-81.70216500000001,12.5862
2844,2012,Marzo,Trinidad y Tobago,3,4,,7,-76.532004,3.451668
2845,2012,Marzo,Trinidad y Tobago,16,45,,61,-74.140516,4.697157
2846,2012,Marzo,Trinidad y Tobago,0,2,,2,-75.736374,4.815189
2847,2012,Marzo,Trinidad y Tobago,0,4,,4,-75.42726,6.170465
2848,2012,Marzo,Trinidad y Tobago,0,1,,1,-73.181317,7.1280470000000005
2849,2012,Marzo,Túnez,0,1,,1,-76.532004,3.451668
2850,2012,Marzo,Túnez,1,5,,6,-74.140516,4.697157
2851,2012,Marzo,Turquía,1,1,,2,-77.35600000000001,0.81488
2852,2012,Marzo,Turquía,2,4,,6,-75.527794,10.406342
2853,2012,Marzo,Turquía,3,13,,16,-75.516486,10.446304
2854,2012,Marzo,Turquía,0,1,,1,-76.532004,3.451668
2855,2012,Marzo,Turquía,15,71,,86,-74.140516,4.697157
2856,2012,Marzo,Turquía,1,3,,4,-75.42726,6.170465
2857,2012,Marzo,Turquía,0,1,,1,-73.181317,7.1280470000000005
2858,2012,Marzo,Turquía,0,1,,1,-72.508188,7.927233
2859,2012,Marzo,Ucrania,0,1,,1,-75.527794,10.406342
2860,2012,Marzo,Ucrania,2,0,,2,-75.516486,10.446304
2861,2012,Marzo,Ucrania,1,11,,12,-74.765343,10.970933
2862,2012,Marzo,Ucrania,1,0,,1,-72.129595,11.360028999999999
2863,2012,Marzo,Ucrania,23,14,,37,-74.140516,4.697157
2864,2012,Marzo,Ucrania,2,4,,6,-72.453013,7.819
2865,2012,Marzo,Uganda,1,4,,5,-74.140516,4.697157
2866,2012,Marzo,Federación de Rusia,2,4,,6,-69.941498,4.191162
2867,2012,Marzo,Federación de Rusia,0,3,,3,-75.527794,10.406342
2868,2012,Marzo,Federación de Rusia,1,1,,2,-75.516486,10.446304
2869,2012,Marzo,Federación de Rusia,0,9,,9,-74.765343,10.970933
2870,2012,Marzo,Federación de Rusia,0,1,,1,-74.213989,11.247722999999999
2871,2012,Marzo,Federación de Rusia,0,2,,2,-72.129595,11.360028999999999
2872,2012,Marzo,Federación de Rusia,2,0,,2,-76.532004,3.451668
2873,2012,Marzo,Federación de Rusia,88,133,,221,-74.140516,4.697157
2874,2012,Marzo,Federación de Rusia,4,3,,7,-75.42726,6.170465
2875,2012,Marzo,Federación de Rusia,10,13,,23,-72.453013,7.819
2876,2012,Marzo,Uruguay,0,6,,6,-77.35600000000001,0.81488
2877,2012,Marzo,Uruguay,0,1,,1,-75.527794,10.406342
2878,2012,Marzo,Uruguay,124,83,,207,-75.516486,10.446304
2879,2012,Marzo,Uruguay,0,5,,5,-74.77647900000001,10.886686
2880,2012,Marzo,Uruguay,1,0,,1,-72.129595,11.360028999999999
2881,2012,Marzo,Uruguay,84,84,,168,-81.70216500000001,12.5862
2882,2012,Marzo,Uruguay,5,14,,19,-76.532004,3.451668
2883,2012,Marzo,Uruguay,115,260,,375,-74.140516,4.697157
2884,2012,Marzo,Uruguay,0,2,,2,-75.736374,4.815189
2885,2012,Marzo,Uruguay,6,33,,39,-75.42726,6.170465
2886,2012,Marzo,Uruguay,0,3,,3,-72.453013,7.819
2887,2012,Marzo,Uruguay,0,1,,1,-72.508188,7.927233
2888,2012,Marzo,Uzbekistán,1,0,,1,-74.77647900000001,10.886686
2889,2012,Marzo,Uzbekistán,1,0,,1,-74.140516,4.697157
2890,2012,Marzo,Venezuela,48,89,,137,-77.35600000000001,0.81488
2891,2012,Marzo,Venezuela,17,9,,26,-75.527794,10.406342
2892,2012,Marzo,Venezuela,64,123,,187,-75.516486,10.446304
2893,2012,Marzo,Venezuela,116,137,,253,-74.77647900000001,10.886686
2894,2012,Marzo,Venezuela,0,4,,4,-74.232675,11.117206
2895,2012,Marzo,Venezuela,1251,1720,,2971,-72.129595,11.360028999999999
2896,2012,Marzo,Venezuela,2,1,,3,-72.919186,11.52863
2897,2012,Marzo,Venezuela,0,1,,1,-81.703935,12.574411099999999
2898,2012,Marzo,Venezuela,8,7,,15,-81.70216500000001,12.5862
2899,2012,Marzo,Venezuela,35,51,,86,-76.532004,3.451668
2900,2012,Marzo,Venezuela,1,2,,3,-75.76635300000001,4.45285
2901,2012,Marzo,Venezuela,4184,5545,,9729,-74.140516,4.697157
2902,2012,Marzo,Venezuela,2,21,,23,-75.736374,4.815189
2903,2012,Marzo,Venezuela,321,396,,717,-75.42726,6.170465
2904,2012,Marzo,Venezuela,13,14,,27,-67.48402800000001,6.185536
2905,2012,Marzo,Venezuela,41,82,,123,-70.74025300000001,7.088728999999999
2906,2012,Marzo,Venezuela,8,17,,25,-73.181317,7.1280470000000005
2907,2012,Marzo,Venezuela,1299,1506,,2805,-72.453013,7.819
2908,2012,Marzo,Venezuela,256,300,,556,-72.508188,7.927233
2909,2012,Marzo,Venezuela,0,1,,1,-77.35002,8.63337
2910,2012,Marzo,Vietnam,2,2,,4,-74.140516,4.697157
2911,2012,Marzo,Yugoslavia,1,0,,1,-74.140516,4.697157
2912,2012,Marzo,Zambia,0,1,,1,-74.140516,4.697157
2913,2012,Marzo,Zimbabue,1,0,,1,-76.532004,3.451668
2914,2012,Marzo,Zimbabue,0,3,,3,-74.140516,4.697157
2915,2012,Marzo,Reino Unido de Gran Bretaña e Irlanda del Norte,3,2,,5,-69.941498,4.191162
2916,2012,Marzo,Reino Unido de Gran Bretaña e Irlanda del Norte,9,16,,25,-77.35600000000001,0.81488
2917,2012,Marzo,Reino Unido de Gran Bretaña e Irlanda del Norte,14,35,,49,-75.527794,10.406342
2918,2012,Marzo,Reino Unido de Gran Bretaña e Irlanda del Norte,15,21,,36,-75.516486,10.446304
2919,2012,Marzo,Reino Unido de Gran Bretaña e Irlanda del Norte,1,7,,8,-74.77647900000001,10.886686
2920,2012,Marzo,Reino Unido de Gran Bretaña e Irlanda del Norte,0,7,,7,-74.765343,10.970933
2921,2012,Marzo,Reino Unido de Gran Bretaña e Irlanda del Norte,4,7,,11,-74.213989,11.247722999999999
2922,2012,Marzo,Reino Unido de Gran Bretaña e Irlanda del Norte,1,2,,3,-72.129595,11.360028999999999
2923,2012,Marzo,Reino Unido de Gran Bretaña e Irlanda del Norte,0,1,,1,-81.70216500000001,12.5862
2924,2012,Marzo,Reino Unido de Gran Bretaña e Irlanda del Norte,0,1,,1,-81.372937,13.338761300000002
2925,2012,Marzo,Reino Unido de Gran Bretaña e Irlanda del Norte,5,17,,22,-76.532004,3.451668
2926,2012,Marzo,Reino Unido de Gran Bretaña e Irlanda del Norte,272,707,,979,-74.140516,4.697157
2927,2012,Marzo,Reino Unido de Gran Bretaña e Irlanda del Norte,1,2,,3,-75.736374,4.815189
2928,2012,Marzo,Reino Unido de Gran Bretaña e Irlanda del Norte,8,19,,27,-75.42726,6.170465
2929,2012,Marzo,Reino Unido de Gran Bretaña e Irlanda del Norte,0,1,,1,-67.48402800000001,6.185536
2930,2012,Marzo,Reino Unido de Gran Bretaña e Irlanda del Norte,2,7,,9,-72.453013,7.819
2931,2012,Marzo,Reino Unido de Gran Bretaña e Irlanda del Norte,1,1,,2,-72.508188,7.927233
2932,2012,Marzo,Reino Unido de Gran Bretaña e Irlanda del Norte,1,1,,2,-77.35002,8.63337
2933,2012,Marzo,Países Bajos,2,5,,7,-69.941498,4.191162
2934,2012,Marzo,Países Bajos,0,1,,1,-76.876446,0.33002
2935,2012,Marzo,Países Bajos,2,4,,6,-77.35600000000001,0.81488
2936,2012,Marzo,Países Bajos,0,2,,2,-78.802679,18.00143
2937,2012,Marzo,Países Bajos,5,13,,18,-75.527794,10.406342
2938,2012,Marzo,Países Bajos,7,35,,42,-75.516486,10.446304
2939,2012,Marzo,Países Bajos,1,6,,7,-74.77647900000001,10.886686
2940,2012,Marzo,Países Bajos,1,2,,3,-74.213989,11.247722999999999
2941,2012,Marzo,Países Bajos,1,3,,4,-72.129595,11.360028999999999
2942,2012,Marzo,Países Bajos,1,1,,2,-81.703935,12.574411099999999
2943,2012,Marzo,Países Bajos,1,2,,3,-81.372937,13.338761300000002
2944,2012,Marzo,Países Bajos,7,46,,53,-76.532004,3.451668
2945,2012,Marzo,Países Bajos,383,739,,1122,-74.140516,4.697157
2946,2012,Marzo,Países Bajos,0,1,,1,-75.736374,4.815189
2947,2012,Marzo,Países Bajos,35,43,,78,-75.42726,6.170465
2948,2012,Marzo,Países Bajos,5,3,,8,-73.181317,7.1280470000000005
2949,2012,Marzo,Países Bajos,5,8,,13,-72.453013,7.819
2950,2012,Marzo,Países Bajos,1,3,,4,-77.35002,8.63337
2951,2012,Marzo,Lituania,0,2,,2,-75.527794,10.406342
2952,2012,Marzo,Lituania,1,0,,1,-76.532004,3.451668
2953,2012,Marzo,Lituania,1,0,,1,-74.140516,4.697157
2954,2012,Marzo,Lituania,1,0,,1,-77.35002,8.63337
2955,2012,Marzo,Reino Unido de Gran Bretaña e Irlanda del Norte,0,1,,1,-74.213989,11.247722999999999
2956,2012,Marzo,Reino Unido de Gran Bretaña e Irlanda del Norte,0,4,,4,-74.140516,4.697157
2957,2012,Marzo,Reino Unido de Gran Bretaña e Irlanda del Norte,1,0,,1,-69.941498,4.191162
2958,2012,Marzo,Reino Unido de Gran Bretaña e Irlanda del Norte,5,7,,12,-75.527794,10.406342
2959,2012,Marzo,Reino Unido de Gran Bretaña e Irlanda del Norte,5,6,,11,-74.140516,4.697157
2960,2012,Marzo,Reino Unido de Gran Bretaña e Irlanda del Norte,0,1,,1,-75.42726,6.170465
2961,2012,Marzo,Letonia,1,0,,1,-75.516486,10.446304
2962,2012,Marzo,Letonia,0,1,,1,-74.765343,10.970933
2963,2012,Marzo,Letonia,0,3,,3,-74.140516,4.697157
2964,2012,Marzo,República CentroÁfricana,0,4,,4,-74.140516,4.697157
2965,2012,Abril,Albania,3,4,,7,-74.140516,4.697157
2966,2012,Abril,Alemania,9,17,,26,-69.941498,4.191162
2967,2012,Abril,Alemania,1,2,,3,-76.876446,0.33002
2968,2012,Abril,Alemania,50,47,,97,-77.35600000000001,0.81488
2969,2012,Abril,Alemania,19,32,,51,-75.527794,10.406342
2970,2012,Abril,Alemania,17,32,,49,-75.516486,10.446304
2971,2012,Abril,Alemania,2,11,,13,-74.77647900000001,10.886686
2972,2012,Abril,Alemania,2,4,,6,-74.213989,11.247722999999999
2973,2012,Abril,Alemania,1,11,,12,-72.129595,11.360028999999999
2974,2012,Abril,Alemania,2,2,,4,-81.70216500000001,12.5862
2975,2012,Abril,Alemania,1,1,,2,-81.372937,13.338761300000002
2976,2012,Abril,Alemania,33,49,,82,-76.532004,3.451668
2977,2012,Abril,Alemania,0,1,,1,-75.76635300000001,4.45285
2978,2012,Abril,Alemania,761,1443,,2204,-74.140516,4.697157
2979,2012,Abril,Alemania,1,0,,1,-75.736374,4.815189
2980,2012,Abril,Alemania,27,75,,102,-75.42726,6.170465
2981,2012,Abril,Alemania,8,14,,22,-72.453013,7.819
2982,2012,Abril,Alemania,0,1,,1,-72.508188,7.927233
2983,2012,Abril,Alemania,9,6,,15,-77.35002,8.63337
2984,2012,Abril,Andorra,0,1,,1,-76.532004,3.451668
2985,2012,Abril,Andorra,1,6,,7,-74.140516,4.697157
2986,2012,Abril,Angola,0,1,,1,-75.516486,10.446304
2987,2012,Abril,Angola,0,1,,1,-74.140516,4.697157
2988,2012,Abril,Antigua y Barbuda,2,1,,3,-75.516486,10.446304
2989,2012,Abril,Antigua y Barbuda,0,1,,1,-76.532004,3.451668
2990,2012,Abril,Países Bajos,0,1,,1,-74.140516,4.697157
2991,2012,Abril,Países Bajos,1,1,,2,-75.42726,6.170465
2992,2012,Abril,Arabia Saudita,0,3,,3,-74.140516,4.697157
2993,2012,Abril,Arabia Saudita,0,2,,2,-75.42726,6.170465
2994,2012,Abril,Argelia,1,3,,4,-74.140516,4.697157
2995,2012,Abril,Argentina,2,3,,5,-69.941498,4.191162
2996,2012,Abril,Argentina,1,2,,3,-76.876446,0.33002
2997,2012,Abril,Argentina,69,101,,170,-77.35600000000001,0.81488
2998,2012,Abril,Argentina,10,9,,19,-75.527794,10.406342
2999,2012,Abril,Argentina,608,408,,1016,-75.516486,10.446304
3000,2012,Abril,Argentina,16,20,,36,-74.77647900000001,10.886686
3001,2012,Abril,Argentina,7,26,,33,-72.129595,11.360028999999999
3002,2012,Abril,Argentina,1,1,,2,-72.919186,11.52863
3003,2012,Abril,Argentina,222,172,,394,-81.70216500000001,12.5862
3004,2012,Abril,Argentina,30,65,,95,-76.532004,3.451668
3005,2012,Abril,Argentina,3056,4330,,7386,-74.140516,4.697157
3006,2012,Abril,Argentina,0,4,,4,-75.736374,4.815189
3007,2012,Abril,Argentina,53,185,,238,-75.42726,6.170465
3008,2012,Abril,Argentina,0,2,,2,-70.74025300000001,7.088728999999999
3009,2012,Abril,Argentina,2,0,,2,-73.181317,7.1280470000000005
3010,2012,Abril,Argentina,15,39,,54,-72.453013,7.819
3011,2012,Abril,Argentina,2,6,,8,-72.508188,7.927233
3012,2012,Abril,Argentina,1,7,,8,-77.35002,8.63337
3013,2012,Abril,República de Armenia,1,1,,2,-74.140516,4.697157
3014,2012,Abril,Aruba,0,2,,2,-72.919186,11.52863
3015,2012,Abril,Aruba,1,0,,1,-75.42726,6.170465
3016,2012,Abril,Australia,12,7,,19,-69.941498,4.191162
3017,2012,Abril,Australia,31,54,,85,-77.35600000000001,0.81488
3018,2012,Abril,Australia,19,30,,49,-75.527794,10.406342
3019,2012,Abril,Australia,21,19,,40,-75.516486,10.446304
3020,2012,Abril,Australia,4,5,,9,-74.77647900000001,10.886686
3021,2012,Abril,Australia,6,6,,12,-72.129595,11.360028999999999
3022,2012,Abril,Australia,0,1,,1,-81.703935,12.574411099999999
3023,2012,Abril,Australia,2,15,,17,-76.532004,3.451668
3024,2012,Abril,Australia,150,320,,470,-74.140516,4.697157
3025,2012,Abril,Australia,28,39,,67,-75.42726,6.170465
3026,2012,Abril,Australia,2,1,,3,-73.181317,7.1280470000000005
3027,2012,Abril,Australia,5,2,,7,-72.453013,7.819
3028,2012,Abril,Australia,0,2,,2,-77.35002,8.63337
3029,2012,Abril,Austria,4,12,,16,-77.35600000000001,0.81488
3030,2012,Abril,Austria,1,6,,7,-75.527794,10.406342
3031,2012,Abril,Austria,4,3,,7,-75.516486,10.446304
3032,2012,Abril,Austria,1,0,,1,-74.77647900000001,10.886686
3033,2012,Abril,Austria,0,1,,1,-74.213989,11.247722999999999
3034,2012,Abril,Austria,1,1,,2,-72.129595,11.360028999999999
3035,2012,Abril,Austria,1,1,,2,-81.703935,12.574411099999999
3036,2012,Abril,Austria,6,6,,12,-76.532004,3.451668
3037,2012,Abril,Austria,70,153,,223,-74.140516,4.697157
3038,2012,Abril,Austria,1,10,,11,-75.42726,6.170465
3039,2012,Abril,Austria,0,1,,1,-77.35002,8.63337
3040,2012,Abril,Azerbaiyán,1,0,,1,-77.35600000000001,0.81488
3041,2012,Abril,Azerbaiyán,0,2,,2,-74.140516,4.697157
3042,2012,Abril,Bahamas,1,4,,5,-75.516486,10.446304
3043,2012,Abril,Bahamas,0,1,,1,-74.77647900000001,10.886686
3044,2012,Abril,Bahamas,0,2,,2,-76.532004,3.451668
3045,2012,Abril,Bahamas,2,8,,10,-74.140516,4.697157
3046,2012,Abril,Bangladesh,0,3,,3,-74.140516,4.697157
3047,2012,Abril,Barbados,3,2,,5,-75.516486,10.446304
3048,2012,Abril,Barbados,1,1,,2,-76.532004,3.451668
3049,2012,Abril,Barbados,2,5,,7,-74.140516,4.697157
3050,2012,Abril,Barbados,5,3,,8,-75.42726,6.170465
3051,2012,Abril,Barbados,1,1,,2,-73.181317,7.1280470000000005
3052,2012,Abril,República de Belarús,0,2,,2,-74.140516,4.697157
3053,2012,Abril,Bélgica,1,3,,4,-69.941498,4.191162
3054,2012,Abril,Bélgica,3,5,,8,-77.35600000000001,0.81488
3055,2012,Abril,Bélgica,5,2,,7,-75.527794,10.406342
3056,2012,Abril,Bélgica,3,4,,7,-75.516486,10.446304
3057,2012,Abril,Bélgica,3,5,,8,-74.77647900000001,10.886686
3058,2012,Abril,Bélgica,0,8,,8,-74.213989,11.247722999999999
3059,2012,Abril,Bélgica,0,1,,1,-72.129595,11.360028999999999
3060,2012,Abril,Bélgica,3,10,,13,-76.532004,3.451668
3061,2012,Abril,Bélgica,78,241,,319,-74.140516,4.697157
3062,2012,Abril,Bélgica,4,11,,15,-75.42726,6.170465
3063,2012,Abril,Bélgica,1,2,,3,-72.453013,7.819
3064,2012,Abril,Belice,0,1,,1,-75.527794,10.406342
3065,2012,Abril,Belice,1,1,,2,-75.516486,10.446304
3066,2012,Abril,Belice,0,1,,1,-74.77647900000001,10.886686
3067,2012,Abril,Belice,0,1,,1,-81.372937,13.338761300000002
3068,2012,Abril,Belice,4,8,,12,-74.140516,4.697157
3069,2012,Abril,Belice,0,1,,1,-75.42726,6.170465
3070,2012,Abril,Bolivia,0,1,,1,-76.876446,0.33002
3071,2012,Abril,Bolivia,6,7,,13,-77.35600000000001,0.81488
3072,2012,Abril,Bolivia,32,74,,106,-75.516486,10.446304
3073,2012,Abril,Bolivia,2,1,,3,-74.77647900000001,10.886686
3074,2012,Abril,Bolivia,1,1,,2,-81.70216500000001,12.5862
3075,2012,Abril,Bolivia,5,4,,9,-76.532004,3.451668
3076,2012,Abril,Bolivia,269,351,,620,-74.140516,4.697157
3077,2012,Abril,Bolivia,0,3,,3,-75.736374,4.815189
3078,2012,Abril,Bolivia,10,24,,34,-75.42726,6.170465
3079,2012,Abril,Bolivia,0,3,,3,-72.453013,7.819
3080,2012,Abril,Bosnia y Herzegovina,0,1,,1,-75.516486,10.446304
3081,2012,Abril,Bosnia y Herzegovina,0,1,,1,-76.532004,3.451668
3082,2012,Abril,Brasil,42,64,,106,-69.941498,4.191162
3083,2012,Abril,Brasil,0,1,,1,-76.876446,0.33002
3084,2012,Abril,Brasil,9,16,,25,-77.35600000000001,0.81488
3085,2012,Abril,Brasil,10,16,,26,-75.527794,10.406342
3086,2012,Abril,Brasil,84,128,,212,-75.516486,10.446304
3087,2012,Abril,Brasil,10,20,,30,-74.77647900000001,10.886686
3088,2012,Abril,Brasil,1,0,,1,-74.765343,10.970933
3089,2012,Abril,Brasil,3,10,,13,-72.129595,11.360028999999999
3090,2012,Abril,Brasil,24,13,,37,-81.70216500000001,12.5862
3091,2012,Abril,Brasil,1,0,,1,-81.372937,13.338761300000002
3092,2012,Abril,Brasil,7,33,,40,-76.532004,3.451668
3093,2012,Abril,Brasil,2604,3919,,6523,-74.140516,4.697157
3094,2012,Abril,Brasil,3,5,,8,-75.736374,4.815189
3095,2012,Abril,Brasil,26,64,,90,-75.42726,6.170465
3096,2012,Abril,Brasil,5,2,,7,-70.74025300000001,7.088728999999999
3097,2012,Abril,Brasil,7,21,,28,-72.453013,7.819
3098,2012,Abril,Brasil,1,3,,4,-72.508188,7.927233
3099,2012,Abril,Bulgaria,0,1,,1,-75.516486,10.446304
3100,2012,Abril,Bulgaria,1,0,,1,-74.77647900000001,10.886686
3101,2012,Abril,Bulgaria,2,0,,2,-76.532004,3.451668
3102,2012,Abril,Bulgaria,3,6,,9,-74.140516,4.697157
3103,2012,Abril,Bulgaria,1,2,,3,-75.42726,6.170465
3104,2012,Abril,Bulgaria,1,0,,1,-72.508188,7.927233
3105,2012,Abril,Burkina Faso,0,1,,1,-74.140516,4.697157
3106,2012,Abril,Islas Caimán/Territorio Británico de Ultramar,0,1,,1,-75.516486,10.446304
3107,2012,Abril,Islas Caimán/Territorio Británico de Ultramar,0,1,,1,-81.70216500000001,12.5862
3108,2012,Abril,Camerún,0,2,,2,-74.140516,4.697157
3109,2012,Abril,Canadá,6,9,,15,-69.941498,4.191162
3110,2012,Abril,Canadá,29,19,,48,-77.35600000000001,0.81488
3111,2012,Abril,Canadá,5,19,,24,-75.527794,10.406342
3112,2012,Abril,Canadá,198,276,,474,-75.516486,10.446304
3113,2012,Abril,Canadá,8,30,,38,-74.77647900000001,10.886686
3114,2012,Abril,Canadá,1,1,,2,-74.765343,10.970933
3115,2012,Abril,Canadá,5,2,,7,-74.213989,11.247722999999999
3116,2012,Abril,Canadá,3,10,,13,-72.129595,11.360028999999999
3117,2012,Abril,Canadá,0,1,,1,-81.703935,12.574411099999999
3118,2012,Abril,Canadá,156,134,,290,-81.70216500000001,12.5862
3119,2012,Abril,Canadá,4,1,,5,-81.372937,13.338761300000002
3120,2012,Abril,Canadá,25,43,,68,-76.532004,3.451668
3121,2012,Abril,Canadá,0,2,,2,-75.76635300000001,4.45285
3122,2012,Abril,Canadá,528,1181,,1709,-74.140516,4.697157
3123,2012,Abril,Canadá,2,9,,11,-75.736374,4.815189
3124,2012,Abril,Canadá,58,127,,185,-75.42726,6.170465
3125,2012,Abril,Canadá,3,9,,12,-72.453013,7.819
3126,2012,Abril,Canadá,0,2,,2,-72.508188,7.927233
3127,2012,Abril,Canadá,1,3,,4,-77.35002,8.63337
3128,2012,Abril,España,10,19,,29,-77.35600000000001,0.81488
3129,2012,Abril,España,4,11,,15,-75.516486,10.446304
3130,2012,Abril,España,7,18,,25,-74.77647900000001,10.886686
3131,2012,Abril,España,0,1,,1,-74.213989,11.247722999999999
3132,2012,Abril,España,3,1,,4,-72.129595,11.360028999999999
3133,2012,Abril,España,1,3,,4,-81.703935,12.574411099999999
3134,2012,Abril,España,1,4,,5,-81.70216500000001,12.5862
3135,2012,Abril,España,48,67,,115,-76.532004,3.451668
3136,2012,Abril,España,0,1,,1,-75.76635300000001,4.45285
3137,2012,Abril,España,170,408,,578,-74.140516,4.697157
3138,2012,Abril,España,1,3,,4,-75.736374,4.815189
3139,2012,Abril,España,30,98,,128,-75.42726,6.170465
3140,2012,Abril,España,1,0,,1,-77.401154,6.222551999999999
3141,2012,Abril,España,1,2,,3,-70.74025300000001,7.088728999999999
3142,2012,Abril,España,0,2,,2,-72.508188,7.927233
3143,2012,Abril,República Democrática del Congo,1,1,,2,-74.140516,4.697157
3144,2012,Abril,República de Corea,7,7,,14,-77.35600000000001,0.81488
3145,2012,Abril,República de Corea,9,13,,22,-75.516486,10.446304
3146,2012,Abril,República de Corea,1,6,,7,-74.77647900000001,10.886686
3147,2012,Abril,República de Corea,0,3,,3,-81.70216500000001,12.5862
3148,2012,Abril,República de Corea,0,1,,1,-76.532004,3.451668
3149,2012,Abril,República de Corea,160,387,,547,-74.140516,4.697157
3150,2012,Abril,República de Corea,0,4,,4,-75.736374,4.815189
3151,2012,Abril,República de Corea,7,20,,27,-75.42726,6.170465
3152,2012,Abril,República de Corea,1,1,,2,-72.453013,7.819
3153,2012,Abril,República de Corea,1,2,,3,-77.35002,8.63337
3154,2012,Abril,Costa de Marfil,0,1,,1,-76.532004,3.451668
3155,2012,Abril,Costa de Marfil,0,1,,1,-74.140516,4.697157
3156,2012,Abril,Costa Rica,2,4,,6,-77.35600000000001,0.81488
3157,2012,Abril,Costa Rica,60,44,,104,-75.516486,10.446304
3158,2012,Abril,Costa Rica,18,23,,41,-74.77647900000001,10.886686
3159,2012,Abril,Costa Rica,0,1,,1,-72.129595,11.360028999999999
3160,2012,Abril,Costa Rica,1,4,,5,-81.703935,12.574411099999999
3161,2012,Abril,Costa Rica,301,213,,514,-81.70216500000001,12.5862
3162,2012,Abril,Costa Rica,17,32,,49,-76.532004,3.451668
3163,2012,Abril,Costa Rica,382,673,,1055,-74.140516,4.697157
3164,2012,Abril,Costa Rica,4,5,,9,-75.736374,4.815189
3165,2012,Abril,Costa Rica,68,100,,168,-75.42726,6.170465
3166,2012,Abril,Costa Rica,0,3,,3,-73.181317,7.1280470000000005
3167,2012,Abril,Costa Rica,5,4,,9,-72.453013,7.819
3168,2012,Abril,Croacia,0,2,,2,-75.516486,10.446304
3169,2012,Abril,Croacia,0,15,,15,-74.213989,11.247722999999999
3170,2012,Abril,Croacia,0,1,,1,-77.061029,3.8844260000000004
3171,2012,Abril,Croacia,6,24,,30,-74.140516,4.697157
3172,2012,Abril,Croacia,0,3,,3,-75.42726,6.170465
3173,2012,Abril,Cuba,0,1,,1,-69.941498,4.191162
3174,2012,Abril,Cuba,2,6,,8,-77.35600000000001,0.81488
3175,2012,Abril,Cuba,1,1,,2,-75.527794,10.406342
3176,2012,Abril,Cuba,6,17,,23,-75.516486,10.446304
3177,2012,Abril,Cuba,1,3,,4,-74.77647900000001,10.886686
3178,2012,Abril,Cuba,10,41,,51,-76.532004,3.451668
3179,2012,Abril,Cuba,87,157,,244,-74.140516,4.697157
3180,2012,Abril,Cuba,13,31,,44,-75.42726,6.170465
3181,2012,Abril,Cuba,2,1,,3,-73.181317,7.1280470000000005
3182,2012,Abril,Cuba,0,1,,1,-72.508188,7.927233
3183,2012,Abril,Curazao,0,1,,1,-72.129595,11.360028999999999
3184,2012,Abril,Curazao,0,1,,1,-76.532004,3.451668
3185,2012,Abril,Curazao,1,4,,5,-74.140516,4.697157
3186,2012,Abril,República Checa,5,4,,9,-77.35600000000001,0.81488
3187,2012,Abril,República Checa,3,0,,3,-72.129595,11.360028999999999
3188,2012,Abril,República Checa,1,0,,1,-76.532004,3.451668
3189,2012,Abril,República Checa,15,20,,35,-74.140516,4.697157
3190,2012,Abril,República Checa,0,1,,1,-70.74025300000001,7.088728999999999
3191,2012,Abril,República Checa,1,2,,3,-72.453013,7.819
3192,2012,Abril,Chile,0,4,,4,-69.941498,4.191162
3193,2012,Abril,Chile,13,37,,50,-77.35600000000001,0.81488
3194,2012,Abril,Chile,7,8,,15,-75.527794,10.406342
3195,2012,Abril,Chile,83,106,,189,-75.516486,10.446304
3196,2012,Abril,Chile,3,37,,40,-74.77647900000001,10.886686
3197,2012,Abril,Chile,2,2,,4,-72.129595,11.360028999999999
3198,2012,Abril,Chile,52,33,,85,-81.70216500000001,12.5862
3199,2012,Abril,Chile,19,34,,53,-76.532004,3.451668
3200,2012,Abril,Chile,2029,3115,,5144,-74.140516,4.697157
3201,2012,Abril,Chile,3,1,,4,-75.736374,4.815189
3202,2012,Abril,Chile,38,89,,127,-75.42726,6.170465
3203,2012,Abril,Chile,0,1,,1,-73.181317,7.1280470000000005
3204,2012,Abril,Chile,5,16,,21,-72.453013,7.819
3205,2012,Abril,Chile,0,1,,1,-77.35002,8.63337
3206,2012,Abril,China,6,5,,11,-77.35600000000001,0.81488
3207,2012,Abril,China,0,3,,3,-75.527794,10.406342
3208,2012,Abril,China,5,9,,14,-75.516486,10.446304
3209,2012,Abril,China,0,2,,2,-74.77647900000001,10.886686
3210,2012,Abril,China,0,3,,3,-72.129595,11.360028999999999
3211,2012,Abril,China,1,1,,2,-81.70216500000001,12.5862
3212,2012,Abril,China,1,4,,5,-76.532004,3.451668
3213,2012,Abril,China,147,509,,656,-74.140516,4.697157
3214,2012,Abril,China,1,0,,1,-75.736374,4.815189
3215,2012,Abril,China,7,12,,19,-75.42726,6.170465
3216,2012,Abril,China,1,2,,3,-72.453013,7.819
3217,2012,Abril,Taiwán,2,1,,3,-77.35600000000001,0.81488
3218,2012,Abril,Taiwán,1,2,,3,-75.516486,10.446304
3219,2012,Abril,Taiwán,1,2,,3,-74.77647900000001,10.886686
3220,2012,Abril,Taiwán,1,2,,3,-76.532004,3.451668
3221,2012,Abril,Taiwán,41,73,,114,-74.140516,4.697157
3222,2012,Abril,Taiwán,1,11,,12,-75.42726,6.170465
3223,2012,Abril,Taiwán,3,2,,5,-72.453013,7.819
3224,2012,Abril,Chipre,0,1,,1,-75.527794,10.406342
3225,2012,Abril,Chipre,3,2,,5,-74.140516,4.697157
3226,2012,Abril,Dinamarca,0,2,,2,-69.941498,4.191162
3227,2012,Abril,Dinamarca,0,12,,12,-77.35600000000001,0.81488
3228,2012,Abril,Dinamarca,0,2,,2,-75.527794,10.406342
3229,2012,Abril,Dinamarca,1,4,,5,-75.516486,10.446304
3230,2012,Abril,Dinamarca,1,0,,1,-74.77647900000001,10.886686
3231,2012,Abril,Dinamarca,0,1,,1,-74.213989,11.247722999999999
3232,2012,Abril,Dinamarca,0,3,,3,-72.129595,11.360028999999999
3233,2012,Abril,Dinamarca,1,8,,9,-76.532004,3.451668
3234,2012,Abril,Dinamarca,53,108,,161,-74.140516,4.697157
3235,2012,Abril,Dinamarca,5,11,,16,-75.42726,6.170465
3236,2012,Abril,Dominica,3,4,,7,-75.516486,10.446304
3237,2012,Abril,Dominica,0,1,,1,-81.703935,12.574411099999999
3238,2012,Abril,Dominica,1,5,,6,-74.140516,4.697157
3239,2012,Abril,Dominica,0,1,,1,-75.42726,6.170465
3240,2012,Abril,Dominica,0,1,,1,-72.453013,7.819
3241,2012,Abril,Ecuador,0,1,,1,-69.941498,4.191162
3242,2012,Abril,Ecuador,15,36,,51,-76.876446,0.33002
3243,2012,Abril,Ecuador,851,1289,,2140,-77.35600000000001,0.81488
3244,2012,Abril,Ecuador,0,43,,43,-78.802679,18.00143
3245,2012,Abril,Ecuador,2,11,,13,-75.527794,10.406342
3246,2012,Abril,Ecuador,6,13,,19,-75.516486,10.446304
3247,2012,Abril,Ecuador,1,11,,12,-74.77647900000001,10.886686
3248,2012,Abril,Ecuador,8,11,,19,-72.129595,11.360028999999999
3249,2012,Abril,Ecuador,7,8,,15,-81.70216500000001,12.5862
3250,2012,Abril,Ecuador,263,306,,569,-76.532004,3.451668
3251,2012,Abril,Ecuador,1617,2386,,4003,-74.140516,4.697157
3252,2012,Abril,Ecuador,2,1,,3,-75.736374,4.815189
3253,2012,Abril,Ecuador,435,553,,988,-75.42726,6.170465
3254,2012,Abril,Ecuador,117,132,,249,-72.453013,7.819
3255,2012,Abril,Ecuador,0,2,,2,-72.508188,7.927233
3256,2012,Abril,Ecuador,0,1,,1,-77.35002,8.63337
3257,2012,Abril,Egipto,0,1,,1,-74.77647900000001,10.886686
3258,2012,Abril,Egipto,4,16,,20,-74.140516,4.697157
3259,2012,Abril,El Salvador,0,1,,1,-77.35600000000001,0.81488
3260,2012,Abril,El Salvador,12,31,,43,-75.516486,10.446304
3261,2012,Abril,El Salvador,3,1,,4,-74.77647900000001,10.886686
3262,2012,Abril,El Salvador,1,7,,8,-76.532004,3.451668
3263,2012,Abril,El Salvador,374,563,,937,-74.140516,4.697157
3264,2012,Abril,El Salvador,12,23,,35,-75.42726,6.170465
3265,2012,Abril,El Salvador,1,1,,2,-72.453013,7.819
3266,2012,Abril,El Salvador,1,0,,1,-72.508188,7.927233
3267,2012,Abril,Emiratos Árabes,0,7,,7,-74.140516,4.697157
3268,2012,Abril,España,1,5,,6,-69.941498,4.191162
3269,2012,Abril,España,9,18,,27,-77.35600000000001,0.81488
3270,2012,Abril,España,0,1,,1,-78.802679,18.00143
3271,2012,Abril,España,4,7,,11,-75.527794,10.406342
3272,2012,Abril,España,44,49,,93,-75.516486,10.446304
3273,2012,Abril,España,7,10,,17,-74.77647900000001,10.886686
3274,2012,Abril,España,8,12,,20,-72.129595,11.360028999999999
3275,2012,Abril,España,4,6,,10,-81.70216500000001,12.5862
3276,2012,Abril,España,1,0,,1,-81.372937,13.338761300000002
3277,2012,Abril,España,120,254,,374,-76.532004,3.451668
3278,2012,Abril,España,1507,3596,,5103,-74.140516,4.697157
3279,2012,Abril,España,1,9,,10,-75.736374,4.815189
3280,2012,Abril,España,51,160,,211,-75.42726,6.170465
3281,2012,Abril,España,1,1,,2,-70.74025300000001,7.088728999999999
3282,2012,Abril,España,0,1,,1,-73.181317,7.1280470000000005
3283,2012,Abril,España,16,24,,40,-72.453013,7.819
3284,2012,Abril,España,4,6,,10,-72.508188,7.927233
3285,2012,Abril,España,0,6,,6,-77.35002,8.63337
3286,2012,Abril,Eslovaquia,1,1,,2,-69.941498,4.191162
3287,2012,Abril,Eslovaquia,0,2,,2,-77.35600000000001,0.81488
3288,2012,Abril,Eslovaquia,1,1,,2,-75.516486,10.446304
3289,2012,Abril,Eslovaquia,1,1,,2,-72.129595,11.360028999999999
3290,2012,Abril,Eslovaquia,16,27,,43,-74.140516,4.697157
3291,2012,Abril,Eslovenia,0,3,,3,-75.527794,10.406342
3292,2012,Abril,Eslovenia,0,1,,1,-74.77647900000001,10.886686
3293,2012,Abril,Eslovenia,1,0,,1,-76.532004,3.451668
3294,2012,Abril,Eslovenia,7,33,,40,-74.140516,4.697157
3295,2012,Abril,Eslovenia,0,1,,1,-75.42726,6.170465
3296,2012,Abril,Eslovenia,1,1,,2,-72.453013,7.819
3297,2012,Abril,Estados Unidos de América,14,16,,30,-69.941498,4.191162
3298,2012,Abril,Estados Unidos de América,0,1,,1,-76.876446,0.33002
3299,2012,Abril,Estados Unidos de América,49,94,,143,-77.35600000000001,0.81488
3300,2012,Abril,Estados Unidos de América,20,55,,75,-75.527794,10.406342
3301,2012,Abril,Estados Unidos de América,1,6,,7,-73.247863,10.433608999999999
3302,2012,Abril,Estados Unidos de América,753,1903,,2656,-75.516486,10.446304
3303,2012,Abril,Estados Unidos de América,286,615,,901,-74.77647900000001,10.886686
3304,2012,Abril,Estados Unidos de América,0,17,,17,-74.765343,10.970933
3305,2012,Abril,Estados Unidos de América,0,3,,3,-74.232675,11.117206
3306,2012,Abril,Estados Unidos de América,3,4,,7,-74.213989,11.247722999999999
3307,2012,Abril,Estados Unidos de América,12,11,,23,-72.129595,11.360028999999999
3308,2012,Abril,Estados Unidos de América,0,1,,1,-72.919186,11.52863
3309,2012,Abril,Estados Unidos de América,3,18,,21,-81.703935,12.574411099999999
3310,2012,Abril,Estados Unidos de América,20,21,,41,-81.70216500000001,12.5862
3311,2012,Abril,Estados Unidos de América,10,15,,25,-81.372937,13.338761300000002
3312,2012,Abril,Estados Unidos de América,551,1010,,1561,-76.532004,3.451668
3313,2012,Abril,Estados Unidos de América,65,123,,188,-75.76635300000001,4.45285
3314,2012,Abril,Estados Unidos de América,4657,9816,,14473,-74.140516,4.697157
3315,2012,Abril,Estados Unidos de América,38,68,,106,-75.736374,4.815189
3316,2012,Abril,Estados Unidos de América,721,1994,,2715,-75.42726,6.170465
3317,2012,Abril,Estados Unidos de América,0,1,,1,-67.48402800000001,6.185536
3318,2012,Abril,Estados Unidos de América,1,0,,1,-77.401154,6.222551999999999
3319,2012,Abril,Estados Unidos de América,9,22,,31,-73.181317,7.1280470000000005
3320,2012,Abril,Estados Unidos de América,19,41,,60,-72.453013,7.819
3321,2012,Abril,Estados Unidos de América,7,14,,21,-72.508188,7.927233
3322,2012,Abril,Estados Unidos de América,6,10,,16,-77.35002,8.63337
3323,2012,Abril,Estonia,0,1,,1,-77.35600000000001,0.81488
3324,2012,Abril,Estonia,1,0,,1,-76.532004,3.451668
3325,2012,Abril,Estonia,4,4,,8,-74.140516,4.697157
3326,2012,Abril,Etiopia,0,3,,3,-74.140516,4.697157
3327,2012,Abril,Filipinas,0,1,,1,-77.35600000000001,0.81488
3328,2012,Abril,Filipinas,0,26,,26,-75.527794,10.406342
3329,2012,Abril,Filipinas,3,7,,10,-75.516486,10.446304
3330,2012,Abril,Filipinas,0,6,,6,-74.77647900000001,10.886686
3331,2012,Abril,Filipinas,0,9,,9,-74.765343,10.970933
3332,2012,Abril,Filipinas,0,15,,15,-74.213989,11.247722999999999
3333,2012,Abril,Filipinas,1,9,,10,-76.532004,3.451668
3334,2012,Abril,Filipinas,0,6,,6,-77.061029,3.8844260000000004
3335,2012,Abril,Filipinas,12,44,,56,-74.140516,4.697157
3336,2012,Abril,Filipinas,0,2,,2,-75.42726,6.170465
3337,2012,Abril,Filipinas,0,2,,2,-75.68164200000001,9.402597
3338,2012,Abril,Finlandia,4,0,,4,-69.941498,4.191162
3339,2012,Abril,Finlandia,2,5,,7,-77.35600000000001,0.81488
3340,2012,Abril,Finlandia,1,1,,2,-75.527794,10.406342
3341,2012,Abril,Finlandia,1,2,,3,-75.516486,10.446304
3342,2012,Abril,Finlandia,1,2,,3,-72.129595,11.360028999999999
3343,2012,Abril,Finlandia,1,6,,7,-76.532004,3.451668
3344,2012,Abril,Finlandia,27,56,,83,-74.140516,4.697157
3345,2012,Abril,Finlandia,4,6,,10,-75.42726,6.170465
3346,2012,Abril,Francia,9,8,,17,-69.941498,4.191162
3347,2012,Abril,Francia,1,1,,2,-76.876446,0.33002
3348,2012,Abril,Francia,54,73,,127,-77.35600000000001,0.81488
3349,2012,Abril,Francia,12,34,,46,-75.527794,10.406342
3350,2012,Abril,Francia,32,38,,70,-75.516486,10.446304
3351,2012,Abril,Francia,1,13,,14,-74.77647900000001,10.886686
3352,2012,Abril,Francia,4,12,,16,-74.213989,11.247722999999999
3353,2012,Abril,Francia,5,12,,17,-72.129595,11.360028999999999
3354,2012,Abril,Francia,1,2,,3,-81.70216500000001,12.5862
3355,2012,Abril,Francia,3,5,,8,-81.372937,13.338761300000002
3356,2012,Abril,Francia,16,42,,58,-76.532004,3.451668
3357,2012,Abril,Francia,849,1582,,2431,-74.140516,4.697157
3358,2012,Abril,Francia,0,4,,4,-75.736374,4.815189
3359,2012,Abril,Francia,19,66,,85,-75.42726,6.170465
3360,2012,Abril,Francia,3,3,,6,-73.181317,7.1280470000000005
3361,2012,Abril,Francia,9,13,,22,-72.453013,7.819
3362,2012,Abril,Francia,2,3,,5,-72.508188,7.927233
3363,2012,Abril,Francia,7,6,,13,-77.35002,8.63337
3364,2012,Abril,Georgia,0,1,,1,-74.140516,4.697157
3365,2012,Abril,Granada,1,5,,6,-75.516486,10.446304
3366,2012,Abril,Granada,1,0,,1,-81.703935,12.574411099999999
3367,2012,Abril,Granada,1,2,,3,-74.140516,4.697157
3368,2012,Abril,Granada,0,1,,1,-75.42726,6.170465
3369,2012,Abril,Grecia,0,2,,2,-75.527794,10.406342
3370,2012,Abril,Grecia,2,2,,4,-75.516486,10.446304
3371,2012,Abril,Grecia,0,1,,1,-72.129595,11.360028999999999
3372,2012,Abril,Grecia,0,3,,3,-76.532004,3.451668
3373,2012,Abril,Grecia,6,34,,40,-74.140516,4.697157
3374,2012,Abril,Grecia,0,4,,4,-75.42726,6.170465
3375,2012,Abril,Grecia,0,1,,1,-72.453013,7.819
3376,2012,Abril,Grecia,0,4,,4,-75.68164200000001,9.402597
3377,2012,Abril,Guatemala,2,3,,5,-77.35600000000001,0.81488
3378,2012,Abril,Guatemala,33,94,,127,-75.516486,10.446304
3379,2012,Abril,Guatemala,2,12,,14,-74.77647900000001,10.886686
3380,2012,Abril,Guatemala,0,1,,1,-72.129595,11.360028999999999
3381,2012,Abril,Guatemala,11,11,,22,-81.70216500000001,12.5862
3382,2012,Abril,Guatemala,4,35,,39,-76.532004,3.451668
3383,2012,Abril,Guatemala,154,292,,446,-74.140516,4.697157
3384,2012,Abril,Guatemala,2,2,,4,-75.736374,4.815189
3385,2012,Abril,Guatemala,19,62,,81,-75.42726,6.170465
3386,2012,Abril,Guatemala,5,7,,12,-72.453013,7.819
3387,2012,Abril,Guatemala,0,1,,1,-77.35002,8.63337
3388,2012,Abril,Guyana,1,3,,4,-75.516486,10.446304
3389,2012,Abril,Guyana,1,0,,1,-74.77647900000001,10.886686
3390,2012,Abril,Guyana,3,10,,13,-74.140516,4.697157
3391,2012,Abril,Guyana,0,1,,1,-75.736374,4.815189
3392,2012,Abril,Guyana,1,1,,2,-75.42726,6.170465
3393,2012,Abril,Guinea,1,1,,2,-74.140516,4.697157
3394,2012,Abril,Guayana Francesa/Departamento de Ultramar Francés,0,1,,1,-74.77647900000001,10.886686
3395,2012,Abril,Haití,0,1,,1,-69.941498,4.191162
3396,2012,Abril,Haití,3,7,,10,-75.516486,10.446304
3397,2012,Abril,Haití,1,1,,2,-76.532004,3.451668
3398,2012,Abril,Haití,4,17,,21,-74.140516,4.697157
3399,2012,Abril,Haití,0,1,,1,-75.42726,6.170465
3400,2012,Abril,Honduras,0,1,,1,-69.941498,4.191162
3401,2012,Abril,Honduras,4,4,,8,-77.35600000000001,0.81488
3402,2012,Abril,Honduras,12,33,,45,-75.516486,10.446304
3403,2012,Abril,Honduras,0,5,,5,-74.77647900000001,10.886686
3404,2012,Abril,Honduras,0,2,,2,-74.765343,10.970933
3405,2012,Abril,Honduras,0,7,,7,-81.703935,12.574411099999999
3406,2012,Abril,Honduras,0,1,,1,-81.70216500000001,12.5862
3407,2012,Abril,Honduras,8,11,,19,-76.532004,3.451668
3408,2012,Abril,Honduras,117,180,,297,-74.140516,4.697157
3409,2012,Abril,Honduras,0,1,,1,-75.736374,4.815189
3410,2012,Abril,Honduras,20,17,,37,-75.42726,6.170465
3411,2012,Abril,Honduras,2,0,,2,-72.453013,7.819
3412,2012,Abril,Hungría,0,1,,1,-69.941498,4.191162
3413,2012,Abril,Hungría,1,2,,3,-77.35600000000001,0.81488
3414,2012,Abril,Hungría,2,1,,3,-75.516486,10.446304
3415,2012,Abril,Hungría,0,2,,2,-76.532004,3.451668
3416,2012,Abril,Hungría,7,19,,26,-74.140516,4.697157
3417,2012,Abril,Hungría,1,1,,2,-75.42726,6.170465
3418,2012,Abril,India,0,1,,1,-77.35600000000001,0.81488
3419,2012,Abril,India,0,1,,1,-75.527794,10.406342
3420,2012,Abril,India,1,2,,3,-75.516486,10.446304
3421,2012,Abril,India,0,1,,1,-74.77647900000001,10.886686
3422,2012,Abril,India,1,10,,11,-76.532004,3.451668
3423,2012,Abril,India,34,207,,241,-74.140516,4.697157
3424,2012,Abril,India,1,19,,20,-75.42726,6.170465
3425,2012,Abril,Indonesia,0,41,,41,-75.527794,10.406342
3426,2012,Abril,Indonesia,0,18,,18,-74.213989,11.247722999999999
3427,2012,Abril,Indonesia,1,2,,3,-76.532004,3.451668
3428,2012,Abril,Indonesia,4,25,,29,-74.140516,4.697157
3429,2012,Abril,Indonesia,2,1,,3,-75.42726,6.170465
3430,2012,Abril,Irán,0,1,,1,-77.35600000000001,0.81488
3431,2012,Abril,Irán,2,13,,15,-74.140516,4.697157
3432,2012,Abril,República de Irlanda,1,1,,2,-69.941498,4.191162
3433,2012,Abril,República de Irlanda,14,16,,30,-77.35600000000001,0.81488
3434,2012,Abril,República de Irlanda,7,7,,14,-75.516486,10.446304
3435,2012,Abril,República de Irlanda,1,0,,1,-74.77647900000001,10.886686
3436,2012,Abril,República de Irlanda,1,1,,2,-81.372937,13.338761300000002
3437,2012,Abril,República de Irlanda,0,4,,4,-76.532004,3.451668
3438,2012,Abril,República de Irlanda,24,77,,101,-74.140516,4.697157
3439,2012,Abril,República de Irlanda,2,11,,13,-75.42726,6.170465
3440,2012,Abril,República de Irlanda,1,1,,2,-72.453013,7.819
3441,2012,Abril,Islandia,0,1,,1,-77.35600000000001,0.81488
3442,2012,Abril,Islandia,4,2,,6,-74.140516,4.697157
3443,2012,Abril,Isla de Man,23,40,,63,-77.35600000000001,0.81488
3444,2012,Abril,Isla de Man,7,13,,20,-75.516486,10.446304
3445,2012,Abril,Isla de Man,0,11,,11,-74.77647900000001,10.886686
3446,2012,Abril,Isla de Man,3,0,,3,-72.129595,11.360028999999999
3447,2012,Abril,Isla de Man,8,20,,28,-76.532004,3.451668
3448,2012,Abril,Isla de Man,0,1,,1,-75.76635300000001,4.45285
3449,2012,Abril,Isla de Man,44,120,,164,-74.140516,4.697157
3450,2012,Abril,Isla de Man,6,34,,40,-75.42726,6.170465
3451,2012,Abril,Isla de Man,0,1,,1,-72.453013,7.819
3452,2012,Abril,Isla Johnston,0,2,,2,-74.140516,4.697157
3453,2012,Abril,Israel,3,8,,11,-69.941498,4.191162
3454,2012,Abril,Israel,8,15,,23,-77.35600000000001,0.81488
3455,2012,Abril,Israel,1,0,,1,-75.527794,10.406342
3456,2012,Abril,Israel,0,12,,12,-75.516486,10.446304
3457,2012,Abril,Israel,0,1,,1,-74.77647900000001,10.886686
3458,2012,Abril,Israel,0,1,,1,-81.70216500000001,12.5862
3459,2012,Abril,Israel,3,9,,12,-76.532004,3.451668
3460,2012,Abril,Israel,106,512,,618,-74.140516,4.697157
3461,2012,Abril,Israel,2,85,,87,-75.42726,6.170465
3462,2012,Abril,Israel,0,1,,1,-77.35002,8.63337
3463,2012,Abril,Islas Aland/Provincia de Finlandia,0,1,,1,-74.140516,4.697157
3464,2012,Abril,Italia,5,4,,9,-69.941498,4.191162
3465,2012,Abril,Italia,8,21,,29,-77.35600000000001,0.81488
3466,2012,Abril,Italia,1,1,,2,-78.802679,18.00143
3467,2012,Abril,Italia,5,7,,12,-75.527794,10.406342
3468,2012,Abril,Italia,21,67,,88,-75.516486,10.446304
3469,2012,Abril,Italia,2,12,,14,-74.77647900000001,10.886686
3470,2012,Abril,Italia,0,5,,5,-74.213989,11.247722999999999
3471,2012,Abril,Italia,1,8,,9,-72.129595,11.360028999999999
3472,2012,Abril,Italia,4,8,,12,-81.70216500000001,12.5862
3473,2012,Abril,Italia,8,61,,69,-76.532004,3.451668
3474,2012,Abril,Italia,345,1294,,1639,-74.140516,4.697157
3475,2012,Abril,Italia,0,1,,1,-75.736374,4.815189
3476,2012,Abril,Italia,8,69,,77,-75.42726,6.170465
3477,2012,Abril,Italia,0,3,,3,-70.74025300000001,7.088728999999999
3478,2012,Abril,Italia,2,2,,4,-73.181317,7.1280470000000005
3479,2012,Abril,Italia,4,27,,31,-72.453013,7.819
3480,2012,Abril,Italia,1,2,,3,-72.508188,7.927233
3481,2012,Abril,Italia,0,3,,3,-77.35002,8.63337
3482,2012,Abril,Jamaica,1,1,,2,-77.35600000000001,0.81488
3483,2012,Abril,Jamaica,7,7,,14,-75.516486,10.446304
3484,2012,Abril,Jamaica,0,3,,3,-74.77647900000001,10.886686
3485,2012,Abril,Jamaica,0,1,,1,-81.70216500000001,12.5862
3486,2012,Abril,Jamaica,0,2,,2,-76.532004,3.451668
3487,2012,Abril,Jamaica,10,16,,26,-74.140516,4.697157
3488,2012,Abril,Jamaica,2,6,,8,-75.42726,6.170465
3489,2012,Abril,Jamaica,0,1,,1,-72.453013,7.819
3490,2012,Abril,Jamaica,1,0,,1,-72.508188,7.927233
3491,2012,Abril,Japón,0,2,,2,-69.941498,4.191162
3492,2012,Abril,Japón,11,20,,31,-77.35600000000001,0.81488
3493,2012,Abril,Japón,2,4,,6,-75.527794,10.406342
3494,2012,Abril,Japón,11,16,,27,-75.516486,10.446304
3495,2012,Abril,Japón,0,2,,2,-74.77647900000001,10.886686
3496,2012,Abril,Japón,0,1,,1,-72.129595,11.360028999999999
3497,2012,Abril,Japón,1,1,,2,-81.70216500000001,12.5862
3498,2012,Abril,Japón,4,15,,19,-76.532004,3.451668
3499,2012,Abril,Japón,106,360,,466,-74.140516,4.697157
3500,2012,Abril,Japón,1,0,,1,-75.736374,4.815189
3501,2012,Abril,Japón,3,20,,23,-75.42726,6.170465
3502,2012,Abril,Japón,2,6,,8,-72.453013,7.819
3503,2012,Abril,Japón,1,0,,1,-72.508188,7.927233
3504,2012,Abril,Japón,0,2,,2,-77.35002,8.63337
3505,2012,Abril,Jordania,1,1,,2,-75.516486,10.446304
3506,2012,Abril,Jordania,1,0,,1,-74.140516,4.697157
3507,2012,Abril,Kazajistán,2,3,,5,-74.140516,4.697157
3508,2012,Abril,Kenia,0,8,,8,-74.140516,4.697157
3509,2012,Abril,Kirguistán,0,1,,1,-74.140516,4.697157
3510,2012,Abril,Kuwait,0,1,,1,-74.140516,4.697157
3511,2012,Abril,República de Kosovo,1,0,,1,-74.140516,4.697157
3512,2012,Abril,Letonia,1,0,,1,-77.35600000000001,0.81488
3513,2012,Abril,Letonia,1,1,,2,-75.516486,10.446304
3514,2012,Abril,Letonia,1,5,,6,-74.140516,4.697157
3515,2012,Abril,Lituania,1,4,,5,-77.35600000000001,0.81488
3516,2012,Abril,Lituania,4,9,,13,-74.140516,4.697157
3517,2012,Abril,Líbano,0,1,,1,-75.516486,10.446304
3518,2012,Abril,Líbano,2,1,,3,-74.77647900000001,10.886686
3519,2012,Abril,Líbano,7,5,,12,-72.129595,11.360028999999999
3520,2012,Abril,Líbano,0,1,,1,-76.532004,3.451668
3521,2012,Abril,Líbano,9,26,,35,-74.140516,4.697157
3522,2012,Abril,Líbano,1,0,,1,-75.42726,6.170465
3523,2012,Abril,Liechtenstein,2,3,,5,-74.140516,4.697157
3524,2012,Abril,Luxemburgo,4,9,,13,-74.140516,4.697157
3525,2012,Abril,Macedonia,1,1,,2,-74.140516,4.697157
3526,2012,Abril,Madagascar,1,0,,1,-75.516486,10.446304
3527,2012,Abril,Malasia,3,1,,4,-77.35600000000001,0.81488
3528,2012,Abril,Malasia,4,21,,25,-74.140516,4.697157
3529,2012,Abril,Malawi,0,1,,1,-74.140516,4.697157
3530,2012,Abril,Malta,0,5,,5,-74.140516,4.697157
3531,2012,Abril,Marruecos,3,6,,9,-74.140516,4.697157
3532,2012,Abril,Marruecos,1,0,,1,-75.42726,6.170465
3533,2012,Abril,Mauricio,0,1,,1,-74.140516,4.697157
3534,2012,Abril,México,1,2,,3,-69.941498,4.191162
3535,2012,Abril,México,2,0,,2,-76.876446,0.33002
3536,2012,Abril,México,9,12,,21,-77.35600000000001,0.81488
3537,2012,Abril,México,4,14,,18,-75.527794,10.406342
3538,2012,Abril,México,172,283,,455,-75.516486,10.446304
3539,2012,Abril,México,13,50,,63,-74.77647900000001,10.886686
3540,2012,Abril,México,4,2,,6,-72.129595,11.360028999999999
3541,2012,Abril,México,0,5,,5,-81.703935,12.574411099999999
3542,2012,Abril,México,1,4,,5,-81.70216500000001,12.5862
3543,2012,Abril,México,27,86,,113,-76.532004,3.451668
3544,2012,Abril,México,1,1,,2,-75.76635300000001,4.45285
3545,2012,Abril,México,1726,3970,,5696,-74.140516,4.697157
3546,2012,Abril,México,4,7,,11,-75.736374,4.815189
3547,2012,Abril,México,75,205,,280,-75.42726,6.170465
3548,2012,Abril,México,0,2,,2,-70.74025300000001,7.088728999999999
3549,2012,Abril,México,3,8,,11,-73.181317,7.1280470000000005
3550,2012,Abril,México,14,30,,44,-72.453013,7.819
3551,2012,Abril,México,5,15,,20,-72.508188,7.927233
3552,2012,Abril,México,0,2,,2,-77.35002,8.63337
3553,2012,Abril,Mónaco,1,1,,2,-74.140516,4.697157
3554,2012,Abril,Montenegro,0,1,,1,-74.140516,4.697157
3555,2012,Abril,Mozambique,1,1,,2,-74.140516,4.697157
3556,2012,Abril,Namibia,1,1,,2,-74.140516,4.697157
3557,2012,Abril,Nepal,0,2,,2,-77.35600000000001,0.81488
3558,2012,Abril,Nepal,1,1,,2,-74.140516,4.697157
3559,2012,Abril,Nicaragua,0,3,,3,-75.527794,10.406342
3560,2012,Abril,Nicaragua,7,15,,22,-75.516486,10.446304
3561,2012,Abril,Nicaragua,1,2,,3,-74.77647900000001,10.886686
3562,2012,Abril,Nicaragua,0,1,,1,-81.70216500000001,12.5862
3563,2012,Abril,Nicaragua,4,3,,7,-76.532004,3.451668
3564,2012,Abril,Nicaragua,39,64,,103,-74.140516,4.697157
3565,2012,Abril,Nicaragua,1,0,,1,-75.736374,4.815189
3566,2012,Abril,Nicaragua,3,8,,11,-75.42726,6.170465
3567,2012,Abril,Nicaragua,1,0,,1,-72.453013,7.819
3568,2012,Abril,Nigeria,0,1,,1,-75.516486,10.446304
3569,2012,Abril,Nigeria,0,6,,6,-74.140516,4.697157
3570,2012,Abril,Níger,0,1,,1,-75.527794,10.406342
3571,2012,Abril,Noruega,1,3,,4,-69.941498,4.191162
3572,2012,Abril,Noruega,1,8,,9,-77.35600000000001,0.81488
3573,2012,Abril,Noruega,1,6,,7,-75.527794,10.406342
3574,2012,Abril,Noruega,3,9,,12,-75.516486,10.446304
3575,2012,Abril,Noruega,0,1,,1,-74.77647900000001,10.886686
3576,2012,Abril,Noruega,1,1,,2,-72.129595,11.360028999999999
3577,2012,Abril,Noruega,6,6,,12,-81.70216500000001,12.5862
3578,2012,Abril,Noruega,1,1,,2,-81.372937,13.338761300000002
3579,2012,Abril,Noruega,2,3,,5,-76.532004,3.451668
3580,2012,Abril,Noruega,41,80,,121,-74.140516,4.697157
3581,2012,Abril,Noruega,4,8,,12,-75.42726,6.170465
3582,2012,Abril,Noruega,0,1,,1,-73.181317,7.1280470000000005
3583,2012,Abril,Noruega,0,1,,1,-72.508188,7.927233
3584,2012,Abril,Nueva Zelanda,1,0,,1,-69.941498,4.191162
3585,2012,Abril,Nueva Zelanda,13,8,,21,-77.35600000000001,0.81488
3586,2012,Abril,Nueva Zelanda,4,4,,8,-75.516486,10.446304
3587,2012,Abril,Nueva Zelanda,0,2,,2,-74.77647900000001,10.886686
3588,2012,Abril,Nueva Zelanda,1,1,,2,-72.129595,11.360028999999999
3589,2012,Abril,Nueva Zelanda,0,2,,2,-76.532004,3.451668
3590,2012,Abril,Nueva Zelanda,22,47,,69,-74.140516,4.697157
3591,2012,Abril,Nueva Zelanda,3,7,,10,-75.42726,6.170465
3592,2012,Abril,Nueva Zelanda,2,1,,3,-72.453013,7.819
3593,2012,Abril,Nueva Zelanda,0,1,,1,-69.941498,4.191162
3594,2012,Abril,Nueva Zelanda,3,2,,5,-75.527794,10.406342
3595,2012,Abril,Nueva Zelanda,1,4,,5,-74.213989,11.247722999999999
3596,2012,Abril,Nueva Zelanda,0,1,,1,-76.532004,3.451668
3597,2012,Abril,Nueva Zelanda,2,7,,9,-74.140516,4.697157
3598,2012,Abril,Nueva Zelanda,1,0,,1,-72.453013,7.819
3599,2012,Abril,Nueva Zelanda,0,1,,1,-77.35002,8.63337
3600,2012,Abril,Países Bajos,14,6,,20,-77.35600000000001,0.81488
3601,2012,Abril,Países Bajos,2,16,,18,-75.516486,10.446304
3602,2012,Abril,Países Bajos,0,6,,6,-74.77647900000001,10.886686
3603,2012,Abril,Países Bajos,21,37,,58,-72.919186,11.52863
3604,2012,Abril,Países Bajos,1,0,,1,-81.70216500000001,12.5862
3605,2012,Abril,Países Bajos,8,15,,23,-76.532004,3.451668
3606,2012,Abril,Países Bajos,144,246,,390,-74.140516,4.697157
3607,2012,Abril,Países Bajos,1,0,,1,-75.736374,4.815189
3608,2012,Abril,Países Bajos,197,230,,427,-75.42726,6.170465
3609,2012,Abril,Países Bajos,6,4,,10,-73.181317,7.1280470000000005
3610,2012,Abril,Pakistán,6,17,,23,-74.140516,4.697157
3611,2012,Abril,Panamá,0,1,,1,-77.35600000000001,0.81488
3612,2012,Abril,Panamá,0,10,,10,-75.527794,10.406342
3613,2012,Abril,Panamá,64,159,,223,-75.516486,10.446304
3614,2012,Abril,Panamá,37,97,,134,-74.77647900000001,10.886686
3615,2012,Abril,Panamá,2,3,,5,-72.129595,11.360028999999999
3616,2012,Abril,Panamá,1,7,,8,-81.703935,12.574411099999999
3617,2012,Abril,Panamá,34,43,,77,-81.70216500000001,12.5862
3618,2012,Abril,Panamá,72,106,,178,-76.532004,3.451668
3619,2012,Abril,Panamá,459,685,,1144,-74.140516,4.697157
3620,2012,Abril,Panamá,46,72,,118,-75.736374,4.815189
3621,2012,Abril,Panamá,75,237,,312,-75.42726,6.170465
3622,2012,Abril,Panamá,2,1,,3,-77.401154,6.222551999999999
3623,2012,Abril,Panamá,3,5,,8,-73.181317,7.1280470000000005
3624,2012,Abril,Panamá,4,4,,8,-72.453013,7.819
3625,2012,Abril,Panamá,7,11,,18,-72.508188,7.927233
3626,2012,Abril,Panamá,1,3,,4,-77.35002,8.63337
3627,2012,Abril,Paraguay,1,3,,4,-69.941498,4.191162
3628,2012,Abril,Paraguay,0,1,,1,-77.35600000000001,0.81488
3629,2012,Abril,Paraguay,9,12,,21,-75.516486,10.446304
3630,2012,Abril,Paraguay,0,1,,1,-74.77647900000001,10.886686
3631,2012,Abril,Paraguay,1,2,,3,-72.129595,11.360028999999999
3632,2012,Abril,Paraguay,1,0,,1,-81.70216500000001,12.5862
3633,2012,Abril,Paraguay,8,0,,8,-76.532004,3.451668
3634,2012,Abril,Paraguay,65,69,,134,-74.140516,4.697157
3635,2012,Abril,Paraguay,0,1,,1,-75.736374,4.815189
3636,2012,Abril,Paraguay,12,8,,20,-75.42726,6.170465
3637,2012,Abril,Paraguay,1,0,,1,-70.74025300000001,7.088728999999999
3638,2012,Abril,Paraguay,0,1,,1,-72.453013,7.819
3639,2012,Abril,Paraguay,0,2,,2,-72.508188,7.927233
3640,2012,Abril,Perú,23,23,,46,-69.941498,4.191162
3641,2012,Abril,Perú,0,1,,1,-76.876446,0.33002
3642,2012,Abril,Perú,95,277,,372,-77.35600000000001,0.81488
3643,2012,Abril,Perú,1,1,,2,-78.802679,18.00143
3644,2012,Abril,Perú,1,4,,5,-75.527794,10.406342
3645,2012,Abril,Perú,165,150,,315,-75.516486,10.446304
3646,2012,Abril,Perú,10,9,,19,-74.77647900000001,10.886686
3647,2012,Abril,Perú,0,2,,2,-74.765343,10.970933
3648,2012,Abril,Perú,2,9,,11,-72.129595,11.360028999999999
3649,2012,Abril,Perú,247,177,,424,-81.70216500000001,12.5862
3650,2012,Abril,Perú,67,105,,172,-76.532004,3.451668
3651,2012,Abril,Perú,2084,2868,,4952,-74.140516,4.697157
3652,2012,Abril,Perú,2,2,,4,-75.736374,4.815189
3653,2012,Abril,Perú,148,261,,409,-75.42726,6.170465
3654,2012,Abril,Perú,1,2,,3,-77.401154,6.222551999999999
3655,2012,Abril,Perú,0,5,,5,-73.181317,7.1280470000000005
3656,2012,Abril,Perú,26,55,,81,-72.453013,7.819
3657,2012,Abril,Perú,0,3,,3,-72.508188,7.927233
3658,2012,Abril,Perú,1,2,,3,-77.35002,8.63337
3659,2012,Abril,Palestina,1,0,,1,-77.35600000000001,0.81488
3660,2012,Abril,Palestina,0,2,,2,-74.140516,4.697157
3661,2012,Abril,Polonia,3,0,,3,-69.941498,4.191162
3662,2012,Abril,Polonia,1,10,,11,-77.35600000000001,0.81488
3663,2012,Abril,Polonia,4,5,,9,-78.802679,18.00143
3664,2012,Abril,Polonia,3,14,,17,-75.527794,10.406342
3665,2012,Abril,Polonia,0,3,,3,-75.516486,10.446304
3666,2012,Abril,Polonia,0,1,,1,-74.77647900000001,10.886686
3667,2012,Abril,Polonia,0,2,,2,-74.765343,10.970933
3668,2012,Abril,Polonia,0,4,,4,-74.213989,11.247722999999999
3669,2012,Abril,Polonia,5,0,,5,-72.129595,11.360028999999999
3670,2012,Abril,Polonia,1,2,,3,-76.532004,3.451668
3671,2012,Abril,Polonia,53,108,,161,-74.140516,4.697157
3672,2012,Abril,Polonia,1,10,,11,-75.42726,6.170465
3673,2012,Abril,Polonia,1,2,,3,-72.453013,7.819
3674,2012,Abril,Polonia,2,0,,2,-77.35002,8.63337
3675,2012,Abril,Portugal,0,3,,3,-77.35600000000001,0.81488
3676,2012,Abril,Portugal,0,3,,3,-75.527794,10.406342
3677,2012,Abril,Portugal,13,11,,24,-75.516486,10.446304
3678,2012,Abril,Portugal,0,2,,2,-74.77647900000001,10.886686
3679,2012,Abril,Portugal,2,3,,5,-72.129595,11.360028999999999
3680,2012,Abril,Portugal,1,6,,7,-76.532004,3.451668
3681,2012,Abril,Portugal,63,235,,298,-74.140516,4.697157
3682,2012,Abril,Portugal,2,7,,9,-75.42726,6.170465
3683,2012,Abril,Portugal,0,1,,1,-72.453013,7.819
3684,2012,Abril,Portugal,0,1,,1,-77.35002,8.63337
3685,2012,Abril,Puerto Rico/Territorio de Estados Unidos,0,1,,1,-75.516486,10.446304
3686,2012,Abril,Puerto Rico/Territorio de Estados Unidos,0,2,,2,-76.532004,3.451668
3687,2012,Abril,Puerto Rico/Territorio de Estados Unidos,0,1,,1,-74.140516,4.697157
3688,2012,Abril,Puerto Rico/Territorio de Estados Unidos,0,1,,1,-75.42726,6.170465
3689,2012,Abril,Reino Unido de Gran Bretaña e Irlanda del Norte,8,13,,21,-69.941498,4.191162
3690,2012,Abril,Reino Unido de Gran Bretaña e Irlanda del Norte,15,20,,35,-77.35600000000001,0.81488
3691,2012,Abril,Reino Unido de Gran Bretaña e Irlanda del Norte,1,14,,15,-75.516486,10.446304
3692,2012,Abril,Reino Unido de Gran Bretaña e Irlanda del Norte,1,3,,4,-74.77647900000001,10.886686
3693,2012,Abril,Reino Unido de Gran Bretaña e Irlanda del Norte,3,8,,11,-72.129595,11.360028999999999
3694,2012,Abril,Reino Unido de Gran Bretaña e Irlanda del Norte,0,1,,1,-81.70216500000001,12.5862
3695,2012,Abril,Reino Unido de Gran Bretaña e Irlanda del Norte,1,2,,3,-81.372937,13.338761300000002
3696,2012,Abril,Reino Unido de Gran Bretaña e Irlanda del Norte,2,13,,15,-76.532004,3.451668
3697,2012,Abril,Reino Unido de Gran Bretaña e Irlanda del Norte,141,397,,538,-74.140516,4.697157
3698,2012,Abril,Reino Unido de Gran Bretaña e Irlanda del Norte,7,24,,31,-75.42726,6.170465
3699,2012,Abril,Reino Unido de Gran Bretaña e Irlanda del Norte,3,6,,9,-72.453013,7.819
3700,2012,Abril,Reino Unido de Gran Bretaña e Irlanda del Norte,0,1,,1,-72.508188,7.927233
3701,2012,Abril,Reino Unido de Gran Bretaña e Irlanda del Norte,2,7,,9,-77.35002,8.63337
3702,2012,Abril,República de Belarús,0,1,,1,-76.532004,3.451668
3703,2012,Abril,República de Belarús,1,0,,1,-74.140516,4.697157
3704,2012,Abril,República Dominicana,3,5,,8,-77.35600000000001,0.81488
3705,2012,Abril,República Dominicana,28,54,,82,-75.516486,10.446304
3706,2012,Abril,República Dominicana,13,32,,45,-74.77647900000001,10.886686
3707,2012,Abril,República Dominicana,3,4,,7,-72.129595,11.360028999999999
3708,2012,Abril,República Dominicana,1,4,,5,-72.919186,11.52863
3709,2012,Abril,República Dominicana,0,3,,3,-81.70216500000001,12.5862
3710,2012,Abril,República Dominicana,17,25,,42,-76.532004,3.451668
3711,2012,Abril,República Dominicana,2,0,,2,-75.76635300000001,4.45285
3712,2012,Abril,República Dominicana,215,270,,485,-74.140516,4.697157
3713,2012,Abril,República Dominicana,0,3,,3,-75.736374,4.815189
3714,2012,Abril,República Dominicana,17,31,,48,-75.42726,6.170465
3715,2012,Abril,República Dominicana,1,2,,3,-73.181317,7.1280470000000005
3716,2012,Abril,República Dominicana,0,1,,1,-72.453013,7.819
3717,2012,Abril,República Dominicana,1,1,,2,-72.508188,7.927233
3718,2012,Abril,República Checa,1,0,,1,-69.941498,4.191162
3719,2012,Abril,República Checa,2,0,,2,-75.527794,10.406342
3720,2012,Abril,República Checa,1,0,,1,-75.516486,10.446304
3721,2012,Abril,República Checa,2,4,,6,-74.140516,4.697157
3722,2012,Abril,Rumania,1,2,,3,-69.941498,4.191162
3723,2012,Abril,Rumania,2,0,,2,-77.35600000000001,0.81488
3724,2012,Abril,Rumania,1,7,,8,-75.527794,10.406342
3725,2012,Abril,Rumania,1,0,,1,-75.516486,10.446304
3726,2012,Abril,Rumania,0,1,,1,-72.129595,11.360028999999999
3727,2012,Abril,Rumania,1,0,,1,-76.532004,3.451668
3728,2012,Abril,Rumania,38,68,,106,-74.140516,4.697157
3729,2012,Abril,Rumania,2,1,,3,-75.42726,6.170465
3730,2012,Abril,Federación de Rusia,9,11,,20,-77.35600000000001,0.81488
3731,2012,Abril,Federación de Rusia,0,1,,1,-75.527794,10.406342
3732,2012,Abril,Federación de Rusia,2,0,,2,-75.516486,10.446304
3733,2012,Abril,Federación de Rusia,1,1,,2,-74.77647900000001,10.886686
3734,2012,Abril,Federación de Rusia,0,1,,1,-72.129595,11.360028999999999
3735,2012,Abril,Federación de Rusia,4,3,,7,-76.532004,3.451668
3736,2012,Abril,Federación de Rusia,33,70,,103,-74.140516,4.697157
3737,2012,Abril,Federación de Rusia,2,2,,4,-75.42726,6.170465
3738,2012,Abril,Federación de Rusia,0,1,,1,-73.181317,7.1280470000000005
3739,2012,Abril,Federación de Rusia,1,0,,1,-72.453013,7.819
3740,2012,Abril,San Cristóbal y Nevis,2,2,,4,-75.516486,10.446304
3741,2012,Abril,San Cristóbal y Nevis,0,1,,1,-75.42726,6.170465
3742,2012,Abril,San Marino,0,1,,1,-69.941498,4.191162
3743,2012,Abril,San Marino,1,1,,2,-74.140516,4.697157
3744,2012,Abril,San Marino,0,1,,1,-75.42726,6.170465
3745,2012,Abril,San  Vicente y las Granadinas,1,3,,4,-75.516486,10.446304
3746,2012,Abril,San  Vicente y las Granadinas,0,1,,1,-76.532004,3.451668
3747,2012,Abril,San  Vicente y las Granadinas,1,0,,1,-74.140516,4.697157
3748,2012,Abril,Santa Lucia,1,2,,3,-75.516486,10.446304
3749,2012,Abril,Santa Lucia,2,3,,5,-74.140516,4.697157
3750,2012,Abril,Santa Lucia,1,2,,3,-73.181317,7.1280470000000005
3751,2012,Abril,Santa Sede/Ciudad del Vaticano,1,0,,1,-74.140516,4.697157
3752,2012,Abril,Senegal,0,1,,1,-74.140516,4.697157
3753,2012,Abril,Serbia,1,4,,5,-74.140516,4.697157
3754,2012,Abril,Serbia,0,1,,1,-75.42726,6.170465
3755,2012,Abril,Singapur,0,1,,1,-69.941498,4.191162
3756,2012,Abril,Singapur,0,1,,1,-77.35600000000001,0.81488
3757,2012,Abril,Singapur,7,13,,20,-74.140516,4.697157
3758,2012,Abril,Singapur,0,2,,2,-75.42726,6.170465
3759,2012,Abril,República Árabe Siria,0,1,,1,-72.129595,11.360028999999999
3760,2012,Abril,República Árabe Siria,0,2,,2,-74.140516,4.697157
3761,2012,Abril,Sri Lanka,0,2,,2,-74.140516,4.697157
3762,2012,Abril,Sudáfrica,1,0,,1,-77.35600000000001,0.81488
3763,2012,Abril,Sudáfrica,2,2,,4,-75.527794,10.406342
3764,2012,Abril,Sudáfrica,0,2,,2,-75.516486,10.446304
3765,2012,Abril,Sudáfrica,0,3,,3,-74.765343,10.970933
3766,2012,Abril,Sudáfrica,0,1,,1,-74.213989,11.247722999999999
3767,2012,Abril,Sudáfrica,0,1,,1,-72.129595,11.360028999999999
3768,2012,Abril,Sudáfrica,15,64,,79,-74.140516,4.697157
3769,2012,Abril,Sudáfrica,2,1,,3,-75.42726,6.170465
3770,2012,Abril,Sudán,2,6,,8,-74.140516,4.697157
3771,2012,Abril,Suecia,1,0,,1,-69.941498,4.191162
3772,2012,Abril,Suecia,25,20,,45,-77.35600000000001,0.81488
3773,2012,Abril,Suecia,5,11,,16,-75.527794,10.406342
3774,2012,Abril,Suecia,7,14,,21,-75.516486,10.446304
3775,2012,Abril,Suecia,0,2,,2,-74.77647900000001,10.886686
3776,2012,Abril,Suecia,1,0,,1,-81.372937,13.338761300000002
3777,2012,Abril,Suecia,9,11,,20,-76.532004,3.451668
3778,2012,Abril,Suecia,114,187,,301,-74.140516,4.697157
3779,2012,Abril,Suecia,5,7,,12,-75.42726,6.170465
3780,2012,Abril,Suecia,2,4,,6,-72.453013,7.819
3781,2012,Abril,Suecia,0,1,,1,-72.508188,7.927233
3782,2012,Abril,Suecia,3,0,,3,-77.35002,8.63337
3783,2012,Abril,Suiza,8,9,,17,-69.941498,4.191162
3784,2012,Abril,Suiza,15,33,,48,-77.35600000000001,0.81488
3785,2012,Abril,Suiza,4,9,,13,-75.527794,10.406342
3786,2012,Abril,Suiza,8,15,,23,-75.516486,10.446304
3787,2012,Abril,Suiza,3,3,,6,-74.77647900000001,10.886686
3788,2012,Abril,Suiza,3,5,,8,-72.129595,11.360028999999999
3789,2012,Abril,Suiza,1,1,,2,-81.70216500000001,12.5862
3790,2012,Abril,Suiza,2,2,,4,-81.372937,13.338761300000002
3791,2012,Abril,Suiza,9,22,,31,-76.532004,3.451668
3792,2012,Abril,Suiza,234,432,,666,-74.140516,4.697157
3793,2012,Abril,Suiza,15,35,,50,-75.42726,6.170465
3794,2012,Abril,Suiza,1,1,,2,-73.181317,7.1280470000000005
3795,2012,Abril,Suiza,2,1,,3,-72.453013,7.819
3796,2012,Abril,Suiza,0,1,,1,-77.35002,8.63337
3797,2012,Abril,Surinam,1,0,,1,-75.527794,10.406342
3798,2012,Abril,Surinam,5,13,,18,-75.516486,10.446304
3799,2012,Abril,Surinam,28,23,,51,-74.140516,4.697157
3800,2012,Abril,Surinam,0,3,,3,-75.42726,6.170465
3801,2012,Abril,Taiwán,0,1,,1,-75.527794,10.406342
3802,2012,Abril,Taiwán,0,1,,1,-75.516486,10.446304
3803,2012,Abril,Taiwán,2,2,,4,-74.140516,4.697157
3804,2012,Abril,Taiwán,0,1,,1,-75.736374,4.815189
3805,2012,Abril,Tailandia,1,0,,1,-76.532004,3.451668
3806,2012,Abril,Tailandia,2,5,,7,-74.140516,4.697157
3807,2012,Abril,Tailandia,0,1,,1,-75.42726,6.170465
3808,2012,Abril,Territorio Antártico Británico/Territorio Británico de Ultramar,0,4,,4,-74.140516,4.697157
3809,2012,Abril,Tanzania,0,1,,1,-74.140516,4.697157
3810,2012,Abril,Trinidad y Tobago,5,37,,42,-75.516486,10.446304
3811,2012,Abril,Trinidad y Tobago,0,7,,7,-74.77647900000001,10.886686
3812,2012,Abril,Trinidad y Tobago,0,1,,1,-81.70216500000001,12.5862
3813,2012,Abril,Trinidad y Tobago,0,2,,2,-76.532004,3.451668
3814,2012,Abril,Trinidad y Tobago,15,53,,68,-74.140516,4.697157
3815,2012,Abril,Trinidad y Tobago,6,3,,9,-75.736374,4.815189
3816,2012,Abril,Trinidad y Tobago,0,18,,18,-75.42726,6.170465
3817,2012,Abril,Trinidad y Tobago,0,1,,1,-73.181317,7.1280470000000005
3818,2012,Abril,Túnez,0,1,,1,-76.532004,3.451668
3819,2012,Abril,Túnez,0,4,,4,-74.140516,4.697157
3820,2012,Abril,Turquía,0,2,,2,-77.35600000000001,0.81488
3821,2012,Abril,Turquía,3,3,,6,-75.516486,10.446304
3822,2012,Abril,Turquía,0,1,,1,-74.765343,10.970933
3823,2012,Abril,Turquía,1,1,,2,-76.532004,3.451668
3824,2012,Abril,Turquía,9,32,,41,-74.140516,4.697157
3825,2012,Abril,Turquía,0,3,,3,-75.42726,6.170465
3826,2012,Abril,Turquía,0,3,,3,-72.453013,7.819
3827,2012,Abril,Turquía,0,1,,1,-77.35002,8.63337
3828,2012,Abril,Ucrania,0,1,,1,-77.35600000000001,0.81488
3829,2012,Abril,Ucrania,1,0,,1,-76.532004,3.451668
3830,2012,Abril,Ucrania,13,8,,21,-74.140516,4.697157
3831,2012,Abril,Ucrania,0,2,,2,-75.42726,6.170465
3832,2012,Abril,Ucrania,11,15,,26,-72.453013,7.819
3833,2012,Abril,Uganda,1,1,,2,-74.140516,4.697157
3834,2012,Abril,Uganda,0,1,,1,-75.42726,6.170465
3835,2012,Abril,Federación de Rusia,1,1,,2,-69.941498,4.191162
3836,2012,Abril,Federación de Rusia,1,2,,3,-77.35600000000001,0.81488
3837,2012,Abril,Federación de Rusia,0,2,,2,-75.527794,10.406342
3838,2012,Abril,Federación de Rusia,4,2,,6,-75.516486,10.446304
3839,2012,Abril,Federación de Rusia,0,1,,1,-74.765343,10.970933
3840,2012,Abril,Federación de Rusia,0,9,,9,-74.213989,11.247722999999999
3841,2012,Abril,Federación de Rusia,1,1,,2,-81.70216500000001,12.5862
3842,2012,Abril,Federación de Rusia,1,0,,1,-76.532004,3.451668
3843,2012,Abril,Federación de Rusia,94,142,,236,-74.140516,4.697157
3844,2012,Abril,Federación de Rusia,2,1,,3,-75.42726,6.170465
3845,2012,Abril,Federación de Rusia,6,3,,9,-72.453013,7.819
3846,2012,Abril,Federación de Rusia,0,1,,1,-75.68164200000001,9.402597
3847,2012,Abril,Uruguay,1,8,,9,-77.35600000000001,0.81488
3848,2012,Abril,Uruguay,1,1,,2,-75.527794,10.406342
3849,2012,Abril,Uruguay,132,106,,238,-75.516486,10.446304
3850,2012,Abril,Uruguay,2,11,,13,-74.77647900000001,10.886686
3851,2012,Abril,Uruguay,0,1,,1,-72.919186,11.52863
3852,2012,Abril,Uruguay,65,55,,120,-81.70216500000001,12.5862
3853,2012,Abril,Uruguay,6,17,,23,-76.532004,3.451668
3854,2012,Abril,Uruguay,117,258,,375,-74.140516,4.697157
3855,2012,Abril,Uruguay,0,1,,1,-75.736374,4.815189
3856,2012,Abril,Uruguay,12,71,,83,-75.42726,6.170465
3857,2012,Abril,Uruguay,1,5,,6,-72.453013,7.819
3858,2012,Abril,Uruguay,0,2,,2,-72.508188,7.927233
3859,2012,Abril,Venezuela,50,94,,144,-77.35600000000001,0.81488
3860,2012,Abril,Venezuela,0,1,,1,-78.802679,18.00143
3861,2012,Abril,Venezuela,7,20,,27,-75.527794,10.406342
3862,2012,Abril,Venezuela,0,14,,14,-73.247863,10.433608999999999
3863,2012,Abril,Venezuela,112,222,,334,-75.516486,10.446304
3864,2012,Abril,Venezuela,35,53,,88,-74.77647900000001,10.886686
3865,2012,Abril,Venezuela,1,2,,3,-74.232675,11.117206
3866,2012,Abril,Venezuela,0,3,,3,-74.213989,11.247722999999999
3867,2012,Abril,Venezuela,2051,2483,,4534,-72.129595,11.360028999999999
3868,2012,Abril,Venezuela,7,6,,13,-72.919186,11.52863
3869,2012,Abril,Venezuela,8,8,,16,-81.70216500000001,12.5862
3870,2012,Abril,Venezuela,51,58,,109,-76.532004,3.451668
3871,2012,Abril,Venezuela,1,1,,2,-75.76635300000001,4.45285
3872,2012,Abril,Venezuela,5067,5746,,10813,-74.140516,4.697157
3873,2012,Abril,Venezuela,1,17,,18,-75.736374,4.815189
3874,2012,Abril,Venezuela,243,312,,555,-75.42726,6.170465
3875,2012,Abril,Venezuela,28,45,,73,-67.48402800000001,6.185536
3876,2012,Abril,Venezuela,47,47,,94,-70.74025300000001,7.088728999999999
3877,2012,Abril,Venezuela,5,6,,11,-73.181317,7.1280470000000005
3878,2012,Abril,Venezuela,1276,1365,,2641,-72.453013,7.819
3879,2012,Abril,Venezuela,225,220,,445,-72.508188,7.927233
3880,2012,Abril,Venezuela,0,1,,1,-77.35002,8.63337
3881,2012,Abril,Vietnam,0,17,,17,-75.527794,10.406342
3882,2012,Abril,República Árabe de Yemen,0,1,,1,-74.140516,4.697157
3883,2012,Abril,Yugoslavia,1,0,,1,-74.140516,4.697157
3884,2012,Abril,Reino Unido de Gran Bretaña e Irlanda del Norte,1,2,,3,-69.941498,4.191162
3885,2012,Abril,Reino Unido de Gran Bretaña e Irlanda del Norte,14,24,,38,-77.35600000000001,0.81488
3886,2012,Abril,Reino Unido de Gran Bretaña e Irlanda del Norte,19,27,,46,-75.527794,10.406342
3887,2012,Abril,Reino Unido de Gran Bretaña e Irlanda del Norte,3,15,,18,-75.516486,10.446304
3888,2012,Abril,Reino Unido de Gran Bretaña e Irlanda del Norte,1,1,,2,-74.77647900000001,10.886686
3889,2012,Abril,Reino Unido de Gran Bretaña e Irlanda del Norte,2,1,,3,-74.213989,11.247722999999999
3890,2012,Abril,Reino Unido de Gran Bretaña e Irlanda del Norte,4,6,,10,-72.129595,11.360028999999999
3891,2012,Abril,Reino Unido de Gran Bretaña e Irlanda del Norte,0,1,,1,-81.70216500000001,12.5862
3892,2012,Abril,Reino Unido de Gran Bretaña e Irlanda del Norte,10,17,,27,-76.532004,3.451668
3893,2012,Abril,Reino Unido de Gran Bretaña e Irlanda del Norte,222,644,,866,-74.140516,4.697157
3894,2012,Abril,Reino Unido de Gran Bretaña e Irlanda del Norte,8,25,,33,-75.42726,6.170465
3895,2012,Abril,Reino Unido de Gran Bretaña e Irlanda del Norte,3,6,,9,-72.453013,7.819
3896,2012,Abril,Reino Unido de Gran Bretaña e Irlanda del Norte,0,3,,3,-77.35002,8.63337
3897,2012,Abril,Países Bajos,0,1,,1,-76.876446,0.33002
3898,2012,Abril,Países Bajos,10,16,,26,-77.35600000000001,0.81488
3899,2012,Abril,Países Bajos,2,4,,6,-75.527794,10.406342
3900,2012,Abril,Países Bajos,4,20,,24,-75.516486,10.446304
3901,2012,Abril,Países Bajos,3,3,,6,-74.77647900000001,10.886686
3902,2012,Abril,Países Bajos,1,11,,12,-74.213989,11.247722999999999
3903,2012,Abril,Países Bajos,4,7,,11,-72.129595,11.360028999999999
3904,2012,Abril,Países Bajos,2,1,,3,-72.919186,11.52863
3905,2012,Abril,Países Bajos,1,1,,2,-81.70216500000001,12.5862
3906,2012,Abril,Países Bajos,0,2,,2,-81.372937,13.338761300000002
3907,2012,Abril,Países Bajos,11,29,,40,-76.532004,3.451668
3908,2012,Abril,Países Bajos,1,0,,1,-75.76635300000001,4.45285
3909,2012,Abril,Países Bajos,381,708,,1089,-74.140516,4.697157
3910,2012,Abril,Países Bajos,1,0,,1,-75.736374,4.815189
3911,2012,Abril,Países Bajos,31,60,,91,-75.42726,6.170465
3912,2012,Abril,Países Bajos,4,5,,9,-73.181317,7.1280470000000005
3913,2012,Abril,Países Bajos,3,4,,7,-72.453013,7.819
3914,2012,Abril,Países Bajos,1,1,,2,-72.508188,7.927233
3915,2012,Abril,Países Bajos,0,1,,1,-77.35002,8.63337
3916,2012,Abril,Lituania,1,0,,1,-75.527794,10.406342
3917,2012,Abril,Lituania,5,3,,8,-74.140516,4.697157
3918,2012,Abril,Reino Unido de Gran Bretaña e Irlanda del Norte,0,1,,1,-77.35600000000001,0.81488
3919,2012,Abril,Reino Unido de Gran Bretaña e Irlanda del Norte,0,4,,4,-74.213989,11.247722999999999
3920,2012,Abril,Reino Unido de Gran Bretaña e Irlanda del Norte,1,0,,1,-77.35600000000001,0.81488
3921,2012,Abril,Reino Unido de Gran Bretaña e Irlanda del Norte,1,1,,2,-74.140516,4.697157
3922,2012,Abril,Reino Unido de Gran Bretaña e Irlanda del Norte,0,1,,1,-69.941498,4.191162
3923,2012,Abril,Reino Unido de Gran Bretaña e Irlanda del Norte,4,3,,7,-75.527794,10.406342
3924,2012,Abril,Reino Unido de Gran Bretaña e Irlanda del Norte,1,0,,1,-74.213989,11.247722999999999
3925,2012,Abril,Reino Unido de Gran Bretaña e Irlanda del Norte,3,10,,13,-74.140516,4.697157
3926,2012,Abril,Reino Unido de Gran Bretaña e Irlanda del Norte,0,1,,1,-75.42726,6.170465
3927,2012,Abril,Reino Unido de Gran Bretaña e Irlanda del Norte,1,0,,1,-77.35002,8.63337
3928,2012,Abril,Letonia,1,0,,1,-74.140516,4.697157
3929,2012,Mayo,Afganistán,0,1,,1,-74.140516,4.697157
3930,2012,Mayo,Albania,1,1,,2,-74.140516,4.697157
3931,2012,Mayo,Alemania,11,10,,21,-69.941498,4.191162
3932,2012,Mayo,Alemania,45,63,,108,-77.35600000000001,0.81488
3933,2012,Mayo,Alemania,20,28,,48,-75.527794,10.406342
3934,2012,Mayo,Alemania,13,24,,37,-75.516486,10.446304
3935,2012,Mayo,Alemania,1,7,,8,-74.77647900000001,10.886686
3936,2012,Mayo,Alemania,7,9,,16,-72.129595,11.360028999999999
3937,2012,Mayo,Alemania,0,1,,1,-81.703935,12.574411099999999
3938,2012,Mayo,Alemania,5,4,,9,-81.70216500000001,12.5862
3939,2012,Mayo,Alemania,4,3,,7,-81.372937,13.338761300000002
3940,2012,Mayo,Alemania,22,35,,57,-76.532004,3.451668
3941,2012,Mayo,Alemania,790,1488,,2278,-74.140516,4.697157
3942,2012,Mayo,Alemania,23,55,,78,-75.42726,6.170465
3943,2012,Mayo,Alemania,1,0,,1,-73.181317,7.1280470000000005
3944,2012,Mayo,Alemania,8,12,,20,-72.453013,7.819
3945,2012,Mayo,Alemania,4,5,,9,-77.35002,8.63337
3946,2012,Mayo,Andorra,1,9,,10,-74.140516,4.697157
3947,2012,Mayo,Angola,0,1,,1,-75.516486,10.446304
3948,2012,Mayo,Angola,0,2,,2,-74.140516,4.697157
3949,2012,Mayo,Países Bajos,2,2,,4,-75.42726,6.170465
3950,2012,Mayo,Arabia Saudita,0,3,,3,-74.140516,4.697157
3951,2012,Mayo,Argelia,1,4,,5,-74.140516,4.697157
3952,2012,Mayo,Argentina,4,5,,9,-69.941498,4.191162
3953,2012,Mayo,Argentina,4,3,,7,-76.876446,0.33002
3954,2012,Mayo,Argentina,52,110,,162,-77.35600000000001,0.81488
3955,2012,Mayo,Argentina,3,8,,11,-75.527794,10.406342
3956,2012,Mayo,Argentina,664,451,,1115,-75.516486,10.446304
3957,2012,Mayo,Argentina,5,22,,27,-74.77647900000001,10.886686
3958,2012,Mayo,Argentina,19,33,,52,-72.129595,11.360028999999999
3959,2012,Mayo,Argentina,215,167,,382,-81.70216500000001,12.5862
3960,2012,Mayo,Argentina,24,60,,84,-76.532004,3.451668
3961,2012,Mayo,Argentina,0,1,,1,-75.76635300000001,4.45285
3962,2012,Mayo,Argentina,2443,3857,,6300,-74.140516,4.697157
3963,2012,Mayo,Argentina,4,8,,12,-75.736374,4.815189
3964,2012,Mayo,Argentina,45,185,,230,-75.42726,6.170465
3965,2012,Mayo,Argentina,0,2,,2,-77.401154,6.222551999999999
3966,2012,Mayo,Argentina,2,2,,4,-73.181317,7.1280470000000005
3967,2012,Mayo,Argentina,19,19,,38,-72.453013,7.819
3968,2012,Mayo,Argentina,2,1,,3,-72.508188,7.927233
3969,2012,Mayo,Argentina,2,8,,10,-77.35002,8.63337
3970,2012,Mayo,Aruba,1,3,,4,-74.140516,4.697157
3971,2012,Mayo,Aruba,0,1,,1,-75.42726,6.170465
3972,2012,Mayo,Australia,7,8,,15,-69.941498,4.191162
3973,2012,Mayo,Australia,36,67,,103,-77.35600000000001,0.81488
3974,2012,Mayo,Australia,14,26,,40,-75.527794,10.406342
3975,2012,Mayo,Australia,11,19,,30,-75.516486,10.446304
3976,2012,Mayo,Australia,4,13,,17,-74.77647900000001,10.886686
3977,2012,Mayo,Australia,0,1,,1,-72.129595,11.360028999999999
3978,2012,Mayo,Australia,3,12,,15,-76.532004,3.451668
3979,2012,Mayo,Australia,1,1,,2,-75.76635300000001,4.45285
3980,2012,Mayo,Australia,192,346,,538,-74.140516,4.697157
3981,2012,Mayo,Australia,5,46,,51,-75.42726,6.170465
3982,2012,Mayo,Australia,1,4,,5,-72.453013,7.819
3983,2012,Mayo,Australia,0,2,,2,-72.508188,7.927233
3984,2012,Mayo,Australia,1,2,,3,-77.35002,8.63337
3985,2012,Mayo,Austria,2,5,,7,-69.941498,4.191162
3986,2012,Mayo,Austria,9,8,,17,-77.35600000000001,0.81488
3987,2012,Mayo,Austria,1,0,,1,-75.527794,10.406342
3988,2012,Mayo,Austria,0,1,,1,-75.516486,10.446304
3989,2012,Mayo,Austria,0,2,,2,-74.77647900000001,10.886686
3990,2012,Mayo,Austria,4,4,,8,-72.129595,11.360028999999999
3991,2012,Mayo,Austria,0,1,,1,-81.703935,12.574411099999999
3992,2012,Mayo,Austria,0,3,,3,-76.532004,3.451668
3993,2012,Mayo,Austria,57,147,,204,-74.140516,4.697157
3994,2012,Mayo,Austria,5,7,,12,-75.42726,6.170465
3995,2012,Mayo,Austria,0,1,,1,-70.74025300000001,7.088728999999999
3996,2012,Mayo,Austria,1,1,,2,-72.453013,7.819
3997,2012,Mayo,Austria,1,1,,2,-77.35002,8.63337
3998,2012,Mayo,Bahamas,0,1,,1,-75.516486,10.446304
3999,2012,Mayo,Bahamas,0,4,,4,-76.532004,3.451668
4000,2012,Mayo,Bahamas,3,8,,11,-74.140516,4.697157
4001,2012,Mayo,Bahamas,0,3,,3,-75.42726,6.170465
4002,2012,Mayo,Bangladesh,1,0,,1,-77.35600000000001,0.81488
4003,2012,Mayo,Barbados,0,1,,1,-76.532004,3.451668
4004,2012,Mayo,Barbados,2,3,,5,-74.140516,4.697157
4005,2012,Mayo,Barbados,0,2,,2,-73.181317,7.1280470000000005
4006,2012,Mayo,República de Belarús,0,3,,3,-74.140516,4.697157
4007,2012,Mayo,Bélgica,10,9,,19,-77.35600000000001,0.81488
4008,2012,Mayo,Bélgica,0,1,,1,-78.802679,18.00143
4009,2012,Mayo,Bélgica,1,2,,3,-75.527794,10.406342
4010,2012,Mayo,Bélgica,0,9,,9,-75.516486,10.446304
4011,2012,Mayo,Bélgica,0,2,,2,-74.77647900000001,10.886686
4012,2012,Mayo,Bélgica,1,0,,1,-81.372937,13.338761300000002
4013,2012,Mayo,Bélgica,2,6,,8,-76.532004,3.451668
4014,2012,Mayo,Bélgica,61,220,,281,-74.140516,4.697157
4015,2012,Mayo,Bélgica,3,15,,18,-75.42726,6.170465
4016,2012,Mayo,Bélgica,1,0,,1,-72.453013,7.819
4017,2012,Mayo,Belice,0,1,,1,-72.129595,11.360028999999999
4018,2012,Mayo,Belice,1,0,,1,-76.532004,3.451668
4019,2012,Mayo,Belice,1,3,,4,-74.140516,4.697157
4020,2012,Mayo,Belice,0,1,,1,-75.42726,6.170465
4021,2012,Mayo,Benín,2,0,,2,-74.140516,4.697157
4022,2012,Mayo,Bermudas/Territorio Británico de Ultramar,0,1,,1,-74.140516,4.697157
4023,2012,Mayo,Bolivia,1,0,,1,-76.876446,0.33002
4024,2012,Mayo,Bolivia,10,10,,20,-77.35600000000001,0.81488
4025,2012,Mayo,Bolivia,11,15,,26,-75.516486,10.446304
4026,2012,Mayo,Bolivia,7,2,,9,-74.77647900000001,10.886686
4027,2012,Mayo,Bolivia,2,3,,5,-81.70216500000001,12.5862
4028,2012,Mayo,Bolivia,5,6,,11,-76.532004,3.451668
4029,2012,Mayo,Bolivia,259,377,,636,-74.140516,4.697157
4030,2012,Mayo,Bolivia,0,1,,1,-75.736374,4.815189
4031,2012,Mayo,Bolivia,12,35,,47,-75.42726,6.170465
4032,2012,Mayo,Bolivia,0,1,,1,-73.181317,7.1280470000000005
4033,2012,Mayo,Bosnia y Herzegovina,1,1,,2,-74.140516,4.697157
4034,2012,Mayo,Botsuana,0,1,,1,-74.140516,4.697157
4035,2012,Mayo,Brasil,50,36,,86,-69.941498,4.191162
4036,2012,Mayo,Brasil,0,1,,1,-76.876446,0.33002
4037,2012,Mayo,Brasil,10,19,,29,-77.35600000000001,0.81488
4038,2012,Mayo,Brasil,145,122,,267,-75.516486,10.446304
4039,2012,Mayo,Brasil,7,23,,30,-74.77647900000001,10.886686
4040,2012,Mayo,Brasil,0,1,,1,-74.213989,11.247722999999999
4041,2012,Mayo,Brasil,1,13,,14,-72.129595,11.360028999999999
4042,2012,Mayo,Brasil,2,1,,3,-72.919186,11.52863
4043,2012,Mayo,Brasil,17,15,,32,-81.70216500000001,12.5862
4044,2012,Mayo,Brasil,16,40,,56,-76.532004,3.451668
4045,2012,Mayo,Brasil,2286,3934,,6220,-74.140516,4.697157
4046,2012,Mayo,Brasil,1,1,,2,-75.736374,4.815189
4047,2012,Mayo,Brasil,62,101,,163,-75.42726,6.170465
4048,2012,Mayo,Brasil,1,1,,2,-67.48402800000001,6.185536
4049,2012,Mayo,Brasil,0,1,,1,-70.74025300000001,7.088728999999999
4050,2012,Mayo,Brasil,0,1,,1,-73.181317,7.1280470000000005
4051,2012,Mayo,Brasil,2,12,,14,-72.453013,7.819
4052,2012,Mayo,Brasil,0,2,,2,-72.508188,7.927233
4053,2012,Mayo,Brasil,1,1,,2,-77.35002,8.63337
4054,2012,Mayo,Bulgaria,2,0,,2,-76.532004,3.451668
4055,2012,Mayo,Bulgaria,4,8,,12,-74.140516,4.697157
4056,2012,Mayo,Bulgaria,0,2,,2,-75.42726,6.170465
4057,2012,Mayo,Bulgaria,2,0,,2,-72.453013,7.819
4058,2012,Mayo,Burkina Faso,0,1,,1,-74.140516,4.697157
4059,2012,Mayo,Cabo Verde,0,1,,1,-74.140516,4.697157
4060,2012,Mayo,Islas Caimán/Territorio Británico de Ultramar,0,1,,1,-75.516486,10.446304
4061,2012,Mayo,Islas Caimán/Territorio Británico de Ultramar,2,0,,2,-74.77647900000001,10.886686
4062,2012,Mayo,Islas Caimán/Territorio Británico de Ultramar,1,0,,1,-81.70216500000001,12.5862
4063,2012,Mayo,Camboya,0,1,,1,-74.140516,4.697157
4064,2012,Mayo,Camerún,0,2,,2,-74.140516,4.697157
4065,2012,Mayo,Canadá,2,5,,7,-69.941498,4.191162
4066,2012,Mayo,Canadá,23,28,,51,-77.35600000000001,0.81488
4067,2012,Mayo,Canadá,7,16,,23,-75.527794,10.406342
4068,2012,Mayo,Canadá,30,65,,95,-75.516486,10.446304
4069,2012,Mayo,Canadá,8,25,,33,-74.77647900000001,10.886686
4070,2012,Mayo,Canadá,2,3,,5,-74.213989,11.247722999999999
4071,2012,Mayo,Canadá,0,4,,4,-72.129595,11.360028999999999
4072,2012,Mayo,Canadá,0,1,,1,-72.919186,11.52863
4073,2012,Mayo,Canadá,2,5,,7,-81.70216500000001,12.5862
4074,2012,Mayo,Canadá,5,3,,8,-81.372937,13.338761300000002
4075,2012,Mayo,Canadá,28,43,,71,-76.532004,3.451668
4076,2012,Mayo,Canadá,525,1211,,1736,-74.140516,4.697157
4077,2012,Mayo,Canadá,0,2,,2,-75.736374,4.815189
4078,2012,Mayo,Canadá,59,157,,216,-75.42726,6.170465
4079,2012,Mayo,Canadá,0,4,,4,-73.181317,7.1280470000000005
4080,2012,Mayo,Canadá,2,5,,7,-72.453013,7.819
4081,2012,Mayo,Canadá,0,1,,1,-72.508188,7.927233
4082,2012,Mayo,Canadá,0,3,,3,-77.35002,8.63337
4083,2012,Mayo,España,0,5,,5,-76.876446,0.33002
4084,2012,Mayo,España,7,11,,18,-77.35600000000001,0.81488
4085,2012,Mayo,España,5,9,,14,-75.516486,10.446304
4086,2012,Mayo,España,4,17,,21,-74.77647900000001,10.886686
4087,2012,Mayo,España,0,1,,1,-74.213989,11.247722999999999
4088,2012,Mayo,España,0,2,,2,-81.70216500000001,12.5862
4089,2012,Mayo,España,29,64,,93,-76.532004,3.451668
4090,2012,Mayo,España,0,1,,1,-75.76635300000001,4.45285
4091,2012,Mayo,España,123,380,,503,-74.140516,4.697157
4092,2012,Mayo,España,2,6,,8,-75.736374,4.815189
4093,2012,Mayo,España,35,87,,122,-75.42726,6.170465
4094,2012,Mayo,España,1,1,,2,-73.181317,7.1280470000000005
4095,2012,Mayo,España,1,5,,6,-72.508188,7.927233
4096,2012,Mayo,República Democrática del Congo,1,1,,2,-74.140516,4.697157
4097,2012,Mayo,República de Corea,0,1,,1,-69.941498,4.191162
4098,2012,Mayo,República de Corea,7,8,,15,-77.35600000000001,0.81488
4099,2012,Mayo,República de Corea,1,1,,2,-75.516486,10.446304
4100,2012,Mayo,República de Corea,0,2,,2,-72.129595,11.360028999999999
4101,2012,Mayo,República de Corea,1,7,,8,-76.532004,3.451668
4102,2012,Mayo,República de Corea,142,372,,514,-74.140516,4.697157
4103,2012,Mayo,República de Corea,0,1,,1,-75.736374,4.815189
4104,2012,Mayo,República de Corea,6,18,,24,-75.42726,6.170465
4105,2012,Mayo,República de Corea,2,2,,4,-67.48402800000001,6.185536
4106,2012,Mayo,República de Corea,1,2,,3,-72.453013,7.819
4107,2012,Mayo,República de Corea,0,1,,1,-77.35002,8.63337
4108,2012,Mayo,Costa de Marfil,0,2,,2,-74.140516,4.697157
4109,2012,Mayo,Costa de Marfil,0,1,,1,-72.453013,7.819
4110,2012,Mayo,Costa Rica,1,2,,3,-77.35600000000001,0.81488
4111,2012,Mayo,Costa Rica,0,1,,1,-75.527794,10.406342
4112,2012,Mayo,Costa Rica,43,42,,85,-75.516486,10.446304
4113,2012,Mayo,Costa Rica,7,22,,29,-74.77647900000001,10.886686
4114,2012,Mayo,Costa Rica,0,1,,1,-81.703935,12.574411099999999
4115,2012,Mayo,Costa Rica,212,152,,364,-81.70216500000001,12.5862
4116,2012,Mayo,Costa Rica,12,32,,44,-76.532004,3.451668
4117,2012,Mayo,Costa Rica,315,549,,864,-74.140516,4.697157
4118,2012,Mayo,Costa Rica,3,4,,7,-75.736374,4.815189
4119,2012,Mayo,Costa Rica,46,111,,157,-75.42726,6.170465
4120,2012,Mayo,Costa Rica,0,1,,1,-77.401154,6.222551999999999
4121,2012,Mayo,Costa Rica,1,2,,3,-73.181317,7.1280470000000005
4122,2012,Mayo,Costa Rica,1,4,,5,-72.453013,7.819
4123,2012,Mayo,Costa Rica,0,1,,1,-77.35002,8.63337
4124,2012,Mayo,Croacia,0,1,,1,-77.35600000000001,0.81488
4125,2012,Mayo,Croacia,0,1,,1,-75.527794,10.406342
4126,2012,Mayo,Croacia,1,4,,5,-75.516486,10.446304
4127,2012,Mayo,Croacia,0,1,,1,-72.129595,11.360028999999999
4128,2012,Mayo,Croacia,4,27,,31,-74.140516,4.697157
4129,2012,Mayo,Croacia,0,1,,1,-72.453013,7.819
4130,2012,Mayo,Cuba,0,4,,4,-77.35600000000001,0.81488
4131,2012,Mayo,Cuba,6,8,,14,-75.516486,10.446304
4132,2012,Mayo,Cuba,1,10,,11,-74.77647900000001,10.886686
4133,2012,Mayo,Cuba,1,1,,2,-72.129595,11.360028999999999
4134,2012,Mayo,Cuba,0,1,,1,-81.70216500000001,12.5862
4135,2012,Mayo,Cuba,15,55,,70,-76.532004,3.451668
4136,2012,Mayo,Cuba,0,1,,1,-75.76635300000001,4.45285
4137,2012,Mayo,Cuba,60,132,,192,-74.140516,4.697157
4138,2012,Mayo,Cuba,1,2,,3,-75.736374,4.815189
4139,2012,Mayo,Cuba,7,25,,32,-75.42726,6.170465
4140,2012,Mayo,Cuba,0,1,,1,-72.453013,7.819
4141,2012,Mayo,Curazao,1,0,,1,-74.140516,4.697157
4142,2012,Mayo,Curazao,2,4,,6,-75.42726,6.170465
4143,2012,Mayo,República Checa,2,2,,4,-69.941498,4.191162
4144,2012,Mayo,República Checa,3,7,,10,-77.35600000000001,0.81488
4145,2012,Mayo,República Checa,2,2,,4,-75.516486,10.446304
4146,2012,Mayo,República Checa,17,31,,48,-74.140516,4.697157
4147,2012,Mayo,República Checa,1,2,,3,-75.42726,6.170465
4148,2012,Mayo,República Checa,0,1,,1,-72.453013,7.819
4149,2012,Mayo,Chile,1,1,,2,-69.941498,4.191162
4150,2012,Mayo,Chile,1,0,,1,-76.876446,0.33002
4151,2012,Mayo,Chile,20,38,,58,-77.35600000000001,0.81488
4152,2012,Mayo,Chile,0,1,,1,-78.802679,18.00143
4153,2012,Mayo,Chile,84,71,,155,-75.516486,10.446304
4154,2012,Mayo,Chile,4,9,,13,-74.77647900000001,10.886686
4155,2012,Mayo,Chile,7,11,,18,-72.129595,11.360028999999999
4156,2012,Mayo,Chile,52,34,,86,-81.70216500000001,12.5862
4157,2012,Mayo,Chile,18,38,,56,-76.532004,3.451668
4158,2012,Mayo,Chile,0,1,,1,-75.76635300000001,4.45285
4159,2012,Mayo,Chile,2270,3367,,5637,-74.140516,4.697157
4160,2012,Mayo,Chile,0,1,,1,-75.736374,4.815189
4161,2012,Mayo,Chile,44,128,,172,-75.42726,6.170465
4162,2012,Mayo,Chile,1,0,,1,-73.181317,7.1280470000000005
4163,2012,Mayo,Chile,7,15,,22,-72.453013,7.819
4164,2012,Mayo,Chile,0,2,,2,-72.508188,7.927233
4165,2012,Mayo,Chile,0,1,,1,-77.35002,8.63337
4166,2012,Mayo,China,0,5,,5,-77.35600000000001,0.81488
4167,2012,Mayo,China,2,2,,4,-75.516486,10.446304
4168,2012,Mayo,China,1,2,,3,-74.77647900000001,10.886686
4169,2012,Mayo,China,2,0,,2,-72.129595,11.360028999999999
4170,2012,Mayo,China,3,6,,9,-76.532004,3.451668
4171,2012,Mayo,China,0,2,,2,-77.061029,3.8844260000000004
4172,2012,Mayo,China,166,560,,726,-74.140516,4.697157
4173,2012,Mayo,China,8,11,,19,-75.42726,6.170465
4174,2012,Mayo,China,0,1,,1,-72.453013,7.819
4175,2012,Mayo,China,0,1,,1,-72.508188,7.927233
4176,2012,Mayo,Taiwán,1,0,,1,-69.941498,4.191162
4177,2012,Mayo,Taiwán,2,1,,3,-77.35600000000001,0.81488
4178,2012,Mayo,Taiwán,2,1,,3,-75.516486,10.446304
4179,2012,Mayo,Taiwán,1,3,,4,-74.77647900000001,10.886686
4180,2012,Mayo,Taiwán,1,1,,2,-72.129595,11.360028999999999
4181,2012,Mayo,Taiwán,2,4,,6,-76.532004,3.451668
4182,2012,Mayo,Taiwán,0,1,,1,-77.061029,3.8844260000000004
4183,2012,Mayo,Taiwán,41,59,,100,-74.140516,4.697157
4184,2012,Mayo,Taiwán,1,0,,1,-75.736374,4.815189
4185,2012,Mayo,Taiwán,4,6,,10,-75.42726,6.170465
4186,2012,Mayo,Taiwán,1,1,,2,-72.453013,7.819
4187,2012,Mayo,Chipre,1,0,,1,-77.35600000000001,0.81488
4188,2012,Mayo,Chipre,2,3,,5,-74.140516,4.697157
4189,2012,Mayo,Dinamarca,1,0,,1,-69.941498,4.191162
4190,2012,Mayo,Dinamarca,5,6,,11,-77.35600000000001,0.81488
4191,2012,Mayo,Dinamarca,1,6,,7,-75.527794,10.406342
4192,2012,Mayo,Dinamarca,0,2,,2,-75.516486,10.446304
4193,2012,Mayo,Dinamarca,0,1,,1,-74.213989,11.247722999999999
4194,2012,Mayo,Dinamarca,1,3,,4,-76.532004,3.451668
4195,2012,Mayo,Dinamarca,48,79,,127,-74.140516,4.697157
4196,2012,Mayo,Dinamarca,2,5,,7,-75.42726,6.170465
4197,2012,Mayo,Dinamarca,0,1,,1,-77.35002,8.63337
4198,2012,Mayo,Dominica,0,1,,1,-74.213989,11.247722999999999
4199,2012,Mayo,Dominica,3,2,,5,-74.140516,4.697157
4200,2012,Mayo,Dominica,0,1,,1,-75.42726,6.170465
4201,2012,Mayo,Dominica,0,1,,1,-72.453013,7.819
4202,2012,Mayo,Ecuador,0,1,,1,-69.941498,4.191162
4203,2012,Mayo,Ecuador,9,54,,63,-76.876446,0.33002
4204,2012,Mayo,Ecuador,623,1165,,1788,-77.35600000000001,0.81488
4205,2012,Mayo,Ecuador,1,8,,9,-77.290564,13.97318
4206,2012,Mayo,Ecuador,1,56,,57,-78.802679,18.00143
4207,2012,Mayo,Ecuador,0,4,,4,-75.527794,10.406342
4208,2012,Mayo,Ecuador,14,30,,44,-75.516486,10.446304
4209,2012,Mayo,Ecuador,4,10,,14,-74.77647900000001,10.886686
4210,2012,Mayo,Ecuador,2,8,,10,-72.129595,11.360028999999999
4211,2012,Mayo,Ecuador,42,36,,78,-81.70216500000001,12.5862
4212,2012,Mayo,Ecuador,240,312,,552,-76.532004,3.451668
4213,2012,Mayo,Ecuador,1595,2738,,4333,-74.140516,4.697157
4214,2012,Mayo,Ecuador,1,1,,2,-75.736374,4.815189
4215,2012,Mayo,Ecuador,407,535,,942,-75.42726,6.170465
4216,2012,Mayo,Ecuador,0,1,,1,-67.48402800000001,6.185536
4217,2012,Mayo,Ecuador,2,2,,4,-73.181317,7.1280470000000005
4218,2012,Mayo,Ecuador,88,135,,223,-72.453013,7.819
4219,2012,Mayo,Ecuador,1,3,,4,-72.508188,7.927233
4220,2012,Mayo,Egipto,0,1,,1,-75.516486,10.446304
4221,2012,Mayo,Egipto,6,17,,23,-74.140516,4.697157
4222,2012,Mayo,Egipto,0,1,,1,-75.42726,6.170465
4223,2012,Mayo,El Salvador,3,11,,14,-75.516486,10.446304
4224,2012,Mayo,El Salvador,1,2,,3,-74.77647900000001,10.886686
4225,2012,Mayo,El Salvador,2,2,,4,-81.70216500000001,12.5862
4226,2012,Mayo,El Salvador,2,11,,13,-76.532004,3.451668
4227,2012,Mayo,El Salvador,319,538,,857,-74.140516,4.697157
4228,2012,Mayo,El Salvador,19,42,,61,-75.42726,6.170465
4229,2012,Mayo,El Salvador,0,1,,1,-77.35002,8.63337
4230,2012,Mayo,Emiratos Árabes,2,9,,11,-74.140516,4.697157
4231,2012,Mayo,España,0,6,,6,-69.941498,4.191162
4232,2012,Mayo,España,16,36,,52,-77.35600000000001,0.81488
4233,2012,Mayo,España,6,7,,13,-75.527794,10.406342
4234,2012,Mayo,España,33,70,,103,-75.516486,10.446304
4235,2012,Mayo,España,5,7,,12,-74.77647900000001,10.886686
4236,2012,Mayo,España,1,4,,5,-72.129595,11.360028999999999
4237,2012,Mayo,España,7,6,,13,-81.70216500000001,12.5862
4238,2012,Mayo,España,1,2,,3,-81.372937,13.338761300000002
4239,2012,Mayo,España,97,224,,321,-76.532004,3.451668
4240,2012,Mayo,España,2,0,,2,-75.76635300000001,4.45285
4241,2012,Mayo,España,1397,3852,,5249,-74.140516,4.697157
4242,2012,Mayo,España,0,4,,4,-75.736374,4.815189
4243,2012,Mayo,España,70,182,,252,-75.42726,6.170465
4244,2012,Mayo,España,1,0,,1,-77.401154,6.222551999999999
4245,2012,Mayo,España,1,0,,1,-70.74025300000001,7.088728999999999
4246,2012,Mayo,España,11,35,,46,-72.453013,7.819
4247,2012,Mayo,España,1,6,,7,-72.508188,7.927233
4248,2012,Mayo,España,3,4,,7,-77.35002,8.63337
4249,2012,Mayo,Eslovaquia,1,0,,1,-69.941498,4.191162
4250,2012,Mayo,Eslovaquia,1,0,,1,-77.35600000000001,0.81488
4251,2012,Mayo,Eslovaquia,1,1,,2,-75.527794,10.406342
4252,2012,Mayo,Eslovaquia,0,1,,1,-75.516486,10.446304
4253,2012,Mayo,Eslovaquia,11,6,,17,-74.140516,4.697157
4254,2012,Mayo,Eslovaquia,0,1,,1,-75.736374,4.815189
4255,2012,Mayo,Eslovaquia,0,1,,1,-75.42726,6.170465
4256,2012,Mayo,Eslovaquia,1,1,,2,-72.453013,7.819
4257,2012,Mayo,Eslovenia,0,1,,1,-77.35600000000001,0.81488
4258,2012,Mayo,Eslovenia,0,2,,2,-75.527794,10.406342
4259,2012,Mayo,Eslovenia,1,1,,2,-75.516486,10.446304
4260,2012,Mayo,Eslovenia,0,1,,1,-72.129595,11.360028999999999
4261,2012,Mayo,Eslovenia,3,17,,20,-74.140516,4.697157
4262,2012,Mayo,Eslovenia,0,2,,2,-75.42726,6.170465
4263,2012,Mayo,Estados Unidos de América,10,13,,23,-69.941498,4.191162
4264,2012,Mayo,Estados Unidos de América,56,78,,134,-77.35600000000001,0.81488
4265,2012,Mayo,Estados Unidos de América,1,0,,1,-78.802679,18.00143
4266,2012,Mayo,Estados Unidos de América,21,46,,67,-75.527794,10.406342
4267,2012,Mayo,Estados Unidos de América,663,1399,,2062,-75.516486,10.446304
4268,2012,Mayo,Estados Unidos de América,339,523,,862,-74.77647900000001,10.886686
4269,2012,Mayo,Estados Unidos de América,1,7,,8,-74.232675,11.117206
4270,2012,Mayo,Estados Unidos de América,4,6,,10,-74.213989,11.247722999999999
4271,2012,Mayo,Estados Unidos de América,6,11,,17,-72.129595,11.360028999999999
4272,2012,Mayo,Estados Unidos de América,3,17,,20,-81.703935,12.574411099999999
4273,2012,Mayo,Estados Unidos de América,9,12,,21,-81.70216500000001,12.5862
4274,2012,Mayo,Estados Unidos de América,13,14,,27,-81.372937,13.338761300000002
4275,2012,Mayo,Estados Unidos de América,756,1236,,1992,-76.532004,3.451668
4276,2012,Mayo,Estados Unidos de América,94,143,,237,-75.76635300000001,4.45285
4277,2012,Mayo,Estados Unidos de América,5784,11385,,17169,-74.140516,4.697157
4278,2012,Mayo,Estados Unidos de América,43,70,,113,-75.736374,4.815189
4279,2012,Mayo,Estados Unidos de América,909,2338,,3247,-75.42726,6.170465
4280,2012,Mayo,Estados Unidos de América,1,1,,2,-70.74025300000001,7.088728999999999
4281,2012,Mayo,Estados Unidos de América,20,27,,47,-73.181317,7.1280470000000005
4282,2012,Mayo,Estados Unidos de América,20,23,,43,-72.453013,7.819
4283,2012,Mayo,Estados Unidos de América,13,20,,33,-72.508188,7.927233
4284,2012,Mayo,Estados Unidos de América,2,3,,5,-77.35002,8.63337
4285,2012,Mayo,Estonia,0,2,,2,-75.527794,10.406342
4286,2012,Mayo,Estonia,0,1,,1,-75.516486,10.446304
4287,2012,Mayo,Estonia,0,1,,1,-77.061029,3.8844260000000004
4288,2012,Mayo,Estonia,3,4,,7,-74.140516,4.697157
4289,2012,Mayo,Estonia,1,0,,1,-75.42726,6.170465
4290,2012,Mayo,Etiopia,1,0,,1,-76.532004,3.451668
4291,2012,Mayo,Etiopia,1,0,,1,-74.140516,4.697157
4292,2012,Mayo,Islas Fiji,1,0,,1,-74.140516,4.697157
4293,2012,Mayo,Filipinas,1,1,,2,-77.35600000000001,0.81488
4294,2012,Mayo,Filipinas,2,23,,25,-75.527794,10.406342
4295,2012,Mayo,Filipinas,3,6,,9,-75.516486,10.446304
4296,2012,Mayo,Filipinas,0,3,,3,-74.77647900000001,10.886686
4297,2012,Mayo,Filipinas,0,13,,13,-74.765343,10.970933
4298,2012,Mayo,Filipinas,0,13,,13,-74.213989,11.247722999999999
4299,2012,Mayo,Filipinas,0,3,,3,-76.532004,3.451668
4300,2012,Mayo,Filipinas,0,2,,2,-77.061029,3.8844260000000004
4301,2012,Mayo,Filipinas,15,76,,91,-74.140516,4.697157
4302,2012,Mayo,Filipinas,0,1,,1,-75.42726,6.170465
4303,2012,Mayo,Filipinas,1,0,,1,-72.508188,7.927233
4304,2012,Mayo,Finlandia,0,1,,1,-69.941498,4.191162
4305,2012,Mayo,Finlandia,2,4,,6,-77.35600000000001,0.81488
4306,2012,Mayo,Finlandia,1,1,,2,-75.527794,10.406342
4307,2012,Mayo,Finlandia,2,0,,2,-75.516486,10.446304
4308,2012,Mayo,Finlandia,2,1,,3,-76.532004,3.451668
4309,2012,Mayo,Finlandia,37,60,,97,-74.140516,4.697157
4310,2012,Mayo,Finlandia,4,3,,7,-75.42726,6.170465
4311,2012,Mayo,Finlandia,2,0,,2,-77.35002,8.63337
4312,2012,Mayo,Francia,3,9,,12,-69.941498,4.191162
4313,2012,Mayo,Francia,51,63,,114,-77.35600000000001,0.81488
4314,2012,Mayo,Francia,6,22,,28,-75.527794,10.406342
4315,2012,Mayo,Francia,17,52,,69,-75.516486,10.446304
4316,2012,Mayo,Francia,3,3,,6,-74.77647900000001,10.886686
4317,2012,Mayo,Francia,4,1,,5,-74.213989,11.247722999999999
4318,2012,Mayo,Francia,4,13,,17,-72.129595,11.360028999999999
4319,2012,Mayo,Francia,0,2,,2,-81.703935,12.574411099999999
4320,2012,Mayo,Francia,1,3,,4,-81.70216500000001,12.5862
4321,2012,Mayo,Francia,3,2,,5,-81.372937,13.338761300000002
4322,2012,Mayo,Francia,23,46,,69,-76.532004,3.451668
4323,2012,Mayo,Francia,0,1,,1,-75.76635300000001,4.45285
4324,2012,Mayo,Francia,648,1377,,2025,-74.140516,4.697157
4325,2012,Mayo,Francia,4,2,,6,-75.736374,4.815189
4326,2012,Mayo,Francia,22,69,,91,-75.42726,6.170465
4327,2012,Mayo,Francia,0,1,,1,-70.74025300000001,7.088728999999999
4328,2012,Mayo,Francia,0,1,,1,-73.181317,7.1280470000000005
4329,2012,Mayo,Francia,2,13,,15,-72.453013,7.819
4330,2012,Mayo,Francia,1,6,,7,-77.35002,8.63337
4331,2012,Mayo,Gabón,0,1,,1,-74.140516,4.697157
4332,2012,Mayo,Georgia,1,0,,1,-76.532004,3.451668
4333,2012,Mayo,Georgia,1,2,,3,-74.140516,4.697157
4334,2012,Mayo,Ghana,0,1,,1,-76.532004,3.451668
4335,2012,Mayo,Ghana,2,6,,8,-74.140516,4.697157
4336,2012,Mayo,Ghana,0,4,,4,-72.453013,7.819
4337,2012,Mayo,Granada,1,0,,1,-74.140516,4.697157
4338,2012,Mayo,Grecia,1,1,,2,-77.35600000000001,0.81488
4339,2012,Mayo,Grecia,1,2,,3,-75.527794,10.406342
4340,2012,Mayo,Grecia,0,2,,2,-75.516486,10.446304
4341,2012,Mayo,Grecia,0,1,,1,-72.129595,11.360028999999999
4342,2012,Mayo,Grecia,2,2,,4,-76.532004,3.451668
4343,2012,Mayo,Grecia,9,35,,44,-74.140516,4.697157
4344,2012,Mayo,Grecia,0,4,,4,-75.42726,6.170465
4345,2012,Mayo,Grecia,0,1,,1,-72.453013,7.819
4346,2012,Mayo,Grecia,0,1,,1,-75.68164200000001,9.402597
4347,2012,Mayo,Guatemala,1,2,,3,-77.35600000000001,0.81488
4348,2012,Mayo,Guatemala,1,6,,7,-75.527794,10.406342
4349,2012,Mayo,Guatemala,29,59,,88,-75.516486,10.446304
4350,2012,Mayo,Guatemala,3,9,,12,-74.77647900000001,10.886686
4351,2012,Mayo,Guatemala,0,1,,1,-72.129595,11.360028999999999
4352,2012,Mayo,Guatemala,2,0,,2,-81.70216500000001,12.5862
4353,2012,Mayo,Guatemala,5,34,,39,-76.532004,3.451668
4354,2012,Mayo,Guatemala,0,1,,1,-75.76635300000001,4.45285
4355,2012,Mayo,Guatemala,167,331,,498,-74.140516,4.697157
4356,2012,Mayo,Guatemala,1,8,,9,-75.736374,4.815189
4357,2012,Mayo,Guatemala,22,67,,89,-75.42726,6.170465
4358,2012,Mayo,Guatemala,0,2,,2,-67.48402800000001,6.185536
4359,2012,Mayo,Guatemala,2,3,,5,-72.453013,7.819
4360,2012,Mayo,Guatemala,0,1,,1,-72.508188,7.927233
4361,2012,Mayo,Guyana,0,1,,1,-77.35600000000001,0.81488
4362,2012,Mayo,Guyana,1,2,,3,-75.516486,10.446304
4363,2012,Mayo,Guyana,0,1,,1,-74.77647900000001,10.886686
4364,2012,Mayo,Guyana,0,1,,1,-76.532004,3.451668
4365,2012,Mayo,Guyana,5,28,,33,-74.140516,4.697157
4366,2012,Mayo,Guyana,0,1,,1,-75.42726,6.170465
4367,2012,Mayo,Guinea,0,1,,1,-75.42726,6.170465
4368,2012,Mayo,Guinea Ecuatorial,1,0,,1,-74.140516,4.697157
4369,2012,Mayo,Guayana Francesa/Departamento de Ultramar Francés,0,1,,1,-75.527794,10.406342
4370,2012,Mayo,Guayana Francesa/Departamento de Ultramar Francés,0,2,,2,-74.140516,4.697157
4371,2012,Mayo,Haití,0,6,,6,-75.516486,10.446304
4372,2012,Mayo,Haití,1,0,,1,-74.77647900000001,10.886686
4373,2012,Mayo,Haití,0,7,,7,-74.140516,4.697157
4374,2012,Mayo,Haití,0,2,,2,-75.42726,6.170465
4375,2012,Mayo,Honduras,0,1,,1,-77.35600000000001,0.81488
4376,2012,Mayo,Honduras,0,3,,3,-75.527794,10.406342
4377,2012,Mayo,Honduras,10,19,,29,-75.516486,10.446304
4378,2012,Mayo,Honduras,4,10,,14,-74.77647900000001,10.886686
4379,2012,Mayo,Honduras,0,7,,7,-81.372937,13.338761300000002
4380,2012,Mayo,Honduras,7,9,,16,-76.532004,3.451668
4381,2012,Mayo,Honduras,109,160,,269,-74.140516,4.697157
4382,2012,Mayo,Honduras,1,0,,1,-75.736374,4.815189
4383,2012,Mayo,Honduras,10,33,,43,-75.42726,6.170465
4384,2012,Mayo,Honduras,0,1,,1,-73.181317,7.1280470000000005
4385,2012,Mayo,Honduras,1,0,,1,-72.453013,7.819
4386,2012,Mayo,Honduras,1,0,,1,-72.508188,7.927233
4387,2012,Mayo,Hong Kong,0,1,,1,-74.140516,4.697157
4388,2012,Mayo,Hungría,1,2,,3,-77.35600000000001,0.81488
4389,2012,Mayo,Hungría,1,1,,2,-75.527794,10.406342
4390,2012,Mayo,Hungría,1,0,,1,-75.516486,10.446304
4391,2012,Mayo,Hungría,13,24,,37,-74.140516,4.697157
4392,2012,Mayo,Hungría,2,0,,2,-75.42726,6.170465
4393,2012,Mayo,Hungría,1,0,,1,-72.453013,7.819
4394,2012,Mayo,India,4,0,,4,-77.35600000000001,0.81488
4395,2012,Mayo,India,0,1,,1,-75.527794,10.406342
4396,2012,Mayo,India,1,4,,5,-75.516486,10.446304
4397,2012,Mayo,India,0,1,,1,-74.77647900000001,10.886686
4398,2012,Mayo,India,0,3,,3,-81.70216500000001,12.5862
4399,2012,Mayo,India,0,9,,9,-76.532004,3.451668
4400,2012,Mayo,India,47,256,,303,-74.140516,4.697157
4401,2012,Mayo,India,0,1,,1,-75.736374,4.815189
4402,2012,Mayo,India,5,24,,29,-75.42726,6.170465
4403,2012,Mayo,India,0,2,,2,-72.508188,7.927233
4404,2012,Mayo,Indonesia,1,1,,2,-76.532004,3.451668
4405,2012,Mayo,Indonesia,8,15,,23,-74.140516,4.697157
4406,2012,Mayo,Indonesia,1,0,,1,-75.42726,6.170465
4407,2012,Mayo,Iraq,0,1,,1,-74.140516,4.697157
4408,2012,Mayo,Irán,2,21,,23,-74.140516,4.697157
4409,2012,Mayo,Irán,1,0,,1,-72.508188,7.927233
4410,2012,Mayo,República de Irlanda,1,1,,2,-69.941498,4.191162
4411,2012,Mayo,República de Irlanda,13,9,,22,-77.35600000000001,0.81488
4412,2012,Mayo,República de Irlanda,2,8,,10,-75.516486,10.446304
4413,2012,Mayo,República de Irlanda,0,1,,1,-72.129595,11.360028999999999
4414,2012,Mayo,República de Irlanda,1,6,,7,-76.532004,3.451668
4415,2012,Mayo,República de Irlanda,39,89,,128,-74.140516,4.697157
4416,2012,Mayo,República de Irlanda,2,11,,13,-75.42726,6.170465
4417,2012,Mayo,República de Irlanda,1,1,,2,-72.453013,7.819
4418,2012,Mayo,Islandia,3,0,,3,-77.35600000000001,0.81488
4419,2012,Mayo,Islandia,5,5,,10,-74.140516,4.697157
4420,2012,Mayo,Islandia,0,1,,1,-75.42726,6.170465
4421,2012,Mayo,Isla de Man,22,32,,54,-77.35600000000001,0.81488
4422,2012,Mayo,Isla de Man,0,1,,1,-75.527794,10.406342
4423,2012,Mayo,Isla de Man,3,6,,9,-75.516486,10.446304
4424,2012,Mayo,Isla de Man,2,2,,4,-74.77647900000001,10.886686
4425,2012,Mayo,Isla de Man,0,3,,3,-72.129595,11.360028999999999
4426,2012,Mayo,Isla de Man,5,13,,18,-76.532004,3.451668
4427,2012,Mayo,Isla de Man,1,1,,2,-75.76635300000001,4.45285
4428,2012,Mayo,Isla de Man,48,107,,155,-74.140516,4.697157
4429,2012,Mayo,Isla de Man,12,23,,35,-75.42726,6.170465
4430,2012,Mayo,Isla de Man,0,1,,1,-72.508188,7.927233
4431,2012,Mayo,Isla Johnston,0,2,,2,-74.140516,4.697157
4432,2012,Mayo,Israel,1,3,,4,-69.941498,4.191162
4433,2012,Mayo,Israel,18,60,,78,-77.35600000000001,0.81488
4434,2012,Mayo,Israel,0,1,,1,-75.527794,10.406342
4435,2012,Mayo,Israel,1,19,,20,-75.516486,10.446304
4436,2012,Mayo,Israel,0,3,,3,-74.77647900000001,10.886686
4437,2012,Mayo,Israel,10,17,,27,-76.532004,3.451668
4438,2012,Mayo,Israel,124,594,,718,-74.140516,4.697157
4439,2012,Mayo,Israel,5,48,,53,-75.42726,6.170465
4440,2012,Mayo,Israel,0,4,,4,-72.508188,7.927233
4441,2012,Mayo,Israel,1,1,,2,-77.35002,8.63337
4442,2012,Mayo,Italia,1,4,,5,-69.941498,4.191162
4443,2012,Mayo,Italia,13,13,,26,-77.35600000000001,0.81488
4444,2012,Mayo,Italia,0,1,,1,-78.802679,18.00143
4445,2012,Mayo,Italia,0,4,,4,-75.527794,10.406342
4446,2012,Mayo,Italia,29,30,,59,-75.516486,10.446304
4447,2012,Mayo,Italia,1,10,,11,-74.77647900000001,10.886686
4448,2012,Mayo,Italia,1,4,,5,-72.129595,11.360028999999999
4449,2012,Mayo,Italia,0,2,,2,-81.703935,12.574411099999999
4450,2012,Mayo,Italia,5,5,,10,-81.70216500000001,12.5862
4451,2012,Mayo,Italia,19,49,,68,-76.532004,3.451668
4452,2012,Mayo,Italia,333,1305,,1638,-74.140516,4.697157
4453,2012,Mayo,Italia,25,60,,85,-75.42726,6.170465
4454,2012,Mayo,Italia,0,1,,1,-73.181317,7.1280470000000005
4455,2012,Mayo,Italia,6,24,,30,-72.453013,7.819
4456,2012,Mayo,Italia,1,2,,3,-72.508188,7.927233
4457,2012,Mayo,Italia,1,5,,6,-77.35002,8.63337
4458,2012,Mayo,Jamaica,2,1,,3,-75.516486,10.446304
4459,2012,Mayo,Jamaica,0,1,,1,-74.77647900000001,10.886686
4460,2012,Mayo,Jamaica,1,2,,3,-76.532004,3.451668
4461,2012,Mayo,Jamaica,8,20,,28,-74.140516,4.697157
4462,2012,Mayo,Jamaica,0,9,,9,-75.42726,6.170465
4463,2012,Mayo,Japón,1,0,,1,-69.941498,4.191162
4464,2012,Mayo,Japón,12,21,,33,-77.35600000000001,0.81488
4465,2012,Mayo,Japón,1,2,,3,-75.527794,10.406342
4466,2012,Mayo,Japón,7,17,,24,-75.516486,10.446304
4467,2012,Mayo,Japón,1,3,,4,-74.77647900000001,10.886686
4468,2012,Mayo,Japón,1,1,,2,-72.129595,11.360028999999999
4469,2012,Mayo,Japón,6,23,,29,-76.532004,3.451668
4470,2012,Mayo,Japón,128,404,,532,-74.140516,4.697157
4471,2012,Mayo,Japón,3,24,,27,-75.42726,6.170465
4472,2012,Mayo,Japón,4,3,,7,-72.453013,7.819
4473,2012,Mayo,Jordania,2,0,,2,-75.516486,10.446304
4474,2012,Mayo,Jordania,1,6,,7,-74.140516,4.697157
4475,2012,Mayo,Jordania,0,1,,1,-75.42726,6.170465
4476,2012,Mayo,Kazajistán,1,1,,2,-75.516486,10.446304
4477,2012,Mayo,Kazajistán,4,2,,6,-74.140516,4.697157
4478,2012,Mayo,Kenia,1,0,,1,-74.77647900000001,10.886686
4479,2012,Mayo,Kenia,1,2,,3,-76.532004,3.451668
4480,2012,Mayo,Kenia,2,6,,8,-74.140516,4.697157
4481,2012,Mayo,Kirguistán,1,0,,1,-74.140516,4.697157
4482,2012,Mayo,Kuwait,0,4,,4,-74.140516,4.697157
4483,2012,Mayo,Lesoto,1,0,,1,-74.140516,4.697157
4484,2012,Mayo,Letonia,0,1,,1,-76.532004,3.451668
4485,2012,Mayo,Letonia,0,1,,1,-77.061029,3.8844260000000004
4486,2012,Mayo,Letonia,3,5,,8,-74.140516,4.697157
4487,2012,Mayo,Letonia,1,0,,1,-77.35002,8.63337
4488,2012,Mayo,Lituania,0,1,,1,-75.527794,10.406342
4489,2012,Mayo,Lituania,0,1,,1,-76.532004,3.451668
4490,2012,Mayo,Lituania,5,5,,10,-74.140516,4.697157
4491,2012,Mayo,Líbano,0,1,,1,-77.35600000000001,0.81488
4492,2012,Mayo,Líbano,1,4,,5,-75.516486,10.446304
4493,2012,Mayo,Líbano,1,2,,3,-74.77647900000001,10.886686
4494,2012,Mayo,Líbano,4,4,,8,-72.129595,11.360028999999999
4495,2012,Mayo,Líbano,0,1,,1,-76.532004,3.451668
4496,2012,Mayo,Líbano,7,20,,27,-74.140516,4.697157
4497,2012,Mayo,Líbano,0,1,,1,-73.181317,7.1280470000000005
4498,2012,Mayo,Líbano,0,1,,1,-72.508188,7.927233
4499,2012,Mayo,Liechtenstein,0,2,,2,-74.140516,4.697157
4500,2012,Mayo,Luxemburgo,4,4,,8,-74.140516,4.697157
4501,2012,Mayo,Macedonia,1,1,,2,-74.140516,4.697157
4502,2012,Mayo,Malasia,0,1,,1,-77.35600000000001,0.81488
4503,2012,Mayo,Malasia,1,3,,4,-75.516486,10.446304
4504,2012,Mayo,Malasia,0,1,,1,-74.77647900000001,10.886686
4505,2012,Mayo,Malasia,1,1,,2,-72.129595,11.360028999999999
4506,2012,Mayo,Malasia,8,20,,28,-74.140516,4.697157
4507,2012,Mayo,Malasia,2,2,,4,-75.42726,6.170465
4508,2012,Mayo,Malawi,1,0,,1,-74.140516,4.697157
4509,2012,Mayo,Malta,0,1,,1,-77.35600000000001,0.81488
4510,2012,Mayo,Malta,1,1,,2,-75.516486,10.446304
4511,2012,Mayo,Malta,1,3,,4,-74.140516,4.697157
4512,2012,Mayo,Marruecos,2,5,,7,-74.140516,4.697157
4513,2012,Mayo,Mauricio,1,0,,1,-74.140516,4.697157
4514,2012,Mayo,Mauritania,0,1,,1,-74.140516,4.697157
4515,2012,Mayo,México,0,2,,2,-69.941498,4.191162
4516,2012,Mayo,México,2,6,,8,-77.35600000000001,0.81488
4517,2012,Mayo,México,1,8,,9,-75.527794,10.406342
4518,2012,Mayo,México,93,171,,264,-75.516486,10.446304
4519,2012,Mayo,México,13,22,,35,-74.77647900000001,10.886686
4520,2012,Mayo,México,2,3,,5,-72.129595,11.360028999999999
4521,2012,Mayo,México,0,2,,2,-81.703935,12.574411099999999
4522,2012,Mayo,México,3,3,,6,-81.70216500000001,12.5862
4523,2012,Mayo,México,32,108,,140,-76.532004,3.451668
4524,2012,Mayo,México,1740,3919,,5659,-74.140516,4.697157
4525,2012,Mayo,México,3,10,,13,-75.736374,4.815189
4526,2012,Mayo,México,87,299,,386,-75.42726,6.170465
4527,2012,Mayo,México,3,3,,6,-73.181317,7.1280470000000005
4528,2012,Mayo,México,12,35,,47,-72.453013,7.819
4529,2012,Mayo,México,2,5,,7,-72.508188,7.927233
4530,2012,Mayo,México,0,3,,3,-77.35002,8.63337
4531,2012,Mayo,República de Moldavia,0,1,,1,-77.35600000000001,0.81488
4532,2012,Mayo,República de Moldavia,2,0,,2,-74.140516,4.697157
4533,2012,Mayo,Mónaco,0,1,,1,-74.140516,4.697157
4534,2012,Mayo,Mongolia,1,1,,2,-74.140516,4.697157
4535,2012,Mayo,Mozambique,0,3,,3,-74.140516,4.697157
4536,2012,Mayo,Myanmar,0,1,,1,-74.765343,10.970933
4537,2012,Mayo,Nepal,0,7,,7,-74.140516,4.697157
4538,2012,Mayo,Nepal,0,1,,1,-75.42726,6.170465
4539,2012,Mayo,Nicaragua,7,4,,11,-75.516486,10.446304
4540,2012,Mayo,Nicaragua,1,1,,2,-74.77647900000001,10.886686
4541,2012,Mayo,Nicaragua,0,1,,1,-81.70216500000001,12.5862
4542,2012,Mayo,Nicaragua,3,6,,9,-76.532004,3.451668
4543,2012,Mayo,Nicaragua,56,43,,99,-74.140516,4.697157
4544,2012,Mayo,Nicaragua,8,15,,23,-75.42726,6.170465
4545,2012,Mayo,Nicaragua,1,0,,1,-73.181317,7.1280470000000005
4546,2012,Mayo,Nigeria,0,1,,1,-77.35600000000001,0.81488
4547,2012,Mayo,Nigeria,1,3,,4,-74.140516,4.697157
4548,2012,Mayo,Níger,1,1,,2,-74.140516,4.697157
4549,2012,Mayo,Noruega,1,1,,2,-69.941498,4.191162
4550,2012,Mayo,Noruega,9,5,,14,-77.35600000000001,0.81488
4551,2012,Mayo,Noruega,7,3,,10,-75.527794,10.406342
4552,2012,Mayo,Noruega,0,1,,1,-75.516486,10.446304
4553,2012,Mayo,Noruega,0,1,,1,-74.77647900000001,10.886686
4554,2012,Mayo,Noruega,0,1,,1,-72.129595,11.360028999999999
4555,2012,Mayo,Noruega,1,3,,4,-76.532004,3.451668
4556,2012,Mayo,Noruega,34,67,,101,-74.140516,4.697157
4557,2012,Mayo,Noruega,2,3,,5,-75.42726,6.170465
4558,2012,Mayo,Noruega,0,1,,1,-73.181317,7.1280470000000005
4559,2012,Mayo,Noruega,1,0,,1,-77.35002,8.63337
4560,2012,Mayo,Nueva Zelanda,4,2,,6,-69.941498,4.191162
4561,2012,Mayo,Nueva Zelanda,9,20,,29,-77.35600000000001,0.81488
4562,2012,Mayo,Nueva Zelanda,0,1,,1,-75.527794,10.406342
4563,2012,Mayo,Nueva Zelanda,1,5,,6,-75.516486,10.446304
4564,2012,Mayo,Nueva Zelanda,1,0,,1,-74.77647900000001,10.886686
4565,2012,Mayo,Nueva Zelanda,2,1,,3,-72.129595,11.360028999999999
4566,2012,Mayo,Nueva Zelanda,2,0,,2,-76.532004,3.451668
4567,2012,Mayo,Nueva Zelanda,32,61,,93,-74.140516,4.697157
4568,2012,Mayo,Nueva Zelanda,3,11,,14,-75.42726,6.170465
4569,2012,Mayo,Omán,1,1,,2,-74.140516,4.697157
4570,2012,Mayo,Nueva Zelanda,0,1,,1,-77.35600000000001,0.81488
4571,2012,Mayo,Nueva Zelanda,1,1,,2,-75.527794,10.406342
4572,2012,Mayo,Nueva Zelanda,0,1,,1,-74.77647900000001,10.886686
4573,2012,Mayo,Nueva Zelanda,3,6,,9,-74.140516,4.697157
4574,2012,Mayo,Países Bajos,1,0,,1,-69.941498,4.191162
4575,2012,Mayo,Países Bajos,7,18,,25,-77.35600000000001,0.81488
4576,2012,Mayo,Países Bajos,2,10,,12,-75.516486,10.446304
4577,2012,Mayo,Países Bajos,4,6,,10,-74.77647900000001,10.886686
4578,2012,Mayo,Países Bajos,1,5,,6,-72.129595,11.360028999999999
4579,2012,Mayo,Países Bajos,25,31,,56,-72.919186,11.52863
4580,2012,Mayo,Países Bajos,38,20,,58,-76.532004,3.451668
4581,2012,Mayo,Países Bajos,120,208,,328,-74.140516,4.697157
4582,2012,Mayo,Países Bajos,116,169,,285,-75.42726,6.170465
4583,2012,Mayo,Países Bajos,1,2,,3,-73.181317,7.1280470000000005
4584,2012,Mayo,Pakistán,0,5,,5,-76.532004,3.451668
4585,2012,Mayo,Pakistán,1,10,,11,-74.140516,4.697157
4586,2012,Mayo,Pakistán,0,2,,2,-75.42726,6.170465
4587,2012,Mayo,Panamá,1,0,,1,-77.35600000000001,0.81488
4588,2012,Mayo,Panamá,1,19,,20,-75.527794,10.406342
4589,2012,Mayo,Panamá,84,144,,228,-75.516486,10.446304
4590,2012,Mayo,Panamá,37,87,,124,-74.77647900000001,10.886686
4591,2012,Mayo,Panamá,0,4,,4,-72.129595,11.360028999999999
4592,2012,Mayo,Panamá,1,1,,2,-81.703935,12.574411099999999
4593,2012,Mayo,Panamá,22,25,,47,-81.70216500000001,12.5862
4594,2012,Mayo,Panamá,52,110,,162,-76.532004,3.451668
4595,2012,Mayo,Panamá,0,1,,1,-75.76635300000001,4.45285
4596,2012,Mayo,Panamá,389,719,,1108,-74.140516,4.697157
4597,2012,Mayo,Panamá,49,63,,112,-75.736374,4.815189
4598,2012,Mayo,Panamá,80,202,,282,-75.42726,6.170465
4599,2012,Mayo,Panamá,3,0,,3,-77.401154,6.222551999999999
4600,2012,Mayo,Panamá,2,11,,13,-73.181317,7.1280470000000005
4601,2012,Mayo,Panamá,4,3,,7,-72.453013,7.819
4602,2012,Mayo,Panamá,3,13,,16,-72.508188,7.927233
4603,2012,Mayo,Panamá,7,4,,11,-77.35002,8.63337
4604,2012,Mayo,Paraguay,0,1,,1,-77.35600000000001,0.81488
4605,2012,Mayo,Paraguay,5,7,,12,-75.516486,10.446304
4606,2012,Mayo,Paraguay,1,1,,2,-81.70216500000001,12.5862
4607,2012,Mayo,Paraguay,0,5,,5,-76.532004,3.451668
4608,2012,Mayo,Paraguay,61,65,,126,-74.140516,4.697157
4609,2012,Mayo,Paraguay,5,11,,16,-75.42726,6.170465
4610,2012,Mayo,Paraguay,0,1,,1,-72.453013,7.819
4611,2012,Mayo,Paraguay,0,2,,2,-72.508188,7.927233
4612,2012,Mayo,Perú,23,21,,44,-69.941498,4.191162
4613,2012,Mayo,Perú,0,5,,5,-76.876446,0.33002
4614,2012,Mayo,Perú,129,285,,414,-77.35600000000001,0.81488
4615,2012,Mayo,Perú,0,3,,3,-75.527794,10.406342
4616,2012,Mayo,Perú,79,75,,154,-75.516486,10.446304
4617,2012,Mayo,Perú,5,15,,20,-74.77647900000001,10.886686
4618,2012,Mayo,Perú,0,1,,1,-74.765343,10.970933
4619,2012,Mayo,Perú,0,3,,3,-72.129595,11.360028999999999
4620,2012,Mayo,Perú,177,121,,298,-81.70216500000001,12.5862
4621,2012,Mayo,Perú,45,114,,159,-76.532004,3.451668
4622,2012,Mayo,Perú,0,1,,1,-75.76635300000001,4.45285
4623,2012,Mayo,Perú,2532,3191,,5723,-74.140516,4.697157
4624,2012,Mayo,Perú,1,1,,2,-75.736374,4.815189
4625,2012,Mayo,Perú,119,251,,370,-75.42726,6.170465
4626,2012,Mayo,Perú,2,2,,4,-73.181317,7.1280470000000005
4627,2012,Mayo,Perú,26,59,,85,-72.453013,7.819
4628,2012,Mayo,Perú,0,3,,3,-72.508188,7.927233
4629,2012,Mayo,Perú,1,2,,3,-77.35002,8.63337
4630,2012,Mayo,Polonia,1,0,,1,-69.941498,4.191162
4631,2012,Mayo,Polonia,4,3,,7,-77.35600000000001,0.81488
4632,2012,Mayo,Polonia,3,8,,11,-75.527794,10.406342
4633,2012,Mayo,Polonia,0,4,,4,-75.516486,10.446304
4634,2012,Mayo,Polonia,3,1,,4,-74.77647900000001,10.886686
4635,2012,Mayo,Polonia,0,1,,1,-74.213989,11.247722999999999
4636,2012,Mayo,Polonia,0,2,,2,-72.129595,11.360028999999999
4637,2012,Mayo,Polonia,3,0,,3,-76.532004,3.451668
4638,2012,Mayo,Polonia,38,54,,92,-74.140516,4.697157
4639,2012,Mayo,Polonia,0,1,,1,-75.42726,6.170465
4640,2012,Mayo,Polonia,0,5,,5,-72.453013,7.819
4641,2012,Mayo,Polonia,0,1,,1,-75.68164200000001,9.402597
4642,2012,Mayo,Portugal,0,3,,3,-76.876446,0.33002
4643,2012,Mayo,Portugal,3,3,,6,-77.35600000000001,0.81488
4644,2012,Mayo,Portugal,2,3,,5,-75.516486,10.446304
4645,2012,Mayo,Portugal,0,1,,1,-74.77647900000001,10.886686
4646,2012,Mayo,Portugal,1,0,,1,-81.70216500000001,12.5862
4647,2012,Mayo,Portugal,1,6,,7,-76.532004,3.451668
4648,2012,Mayo,Portugal,63,303,,366,-74.140516,4.697157
4649,2012,Mayo,Portugal,4,15,,19,-75.42726,6.170465
4650,2012,Mayo,Portugal,0,1,,1,-72.453013,7.819
4651,2012,Mayo,Portugal,0,1,,1,-77.35002,8.63337
4652,2012,Mayo,Puerto Rico/Territorio de Estados Unidos,1,0,,1,-75.516486,10.446304
4653,2012,Mayo,Puerto Rico/Territorio de Estados Unidos,0,1,,1,-74.140516,4.697157
4654,2012,Mayo,Puerto Rico/Territorio de Estados Unidos,1,0,,1,-75.42726,6.170465
4655,2012,Mayo,Qatar,1,1,,2,-75.42726,6.170465
4656,2012,Mayo,Reino Unido de Gran Bretaña e Irlanda del Norte,5,6,,11,-69.941498,4.191162
4657,2012,Mayo,Reino Unido de Gran Bretaña e Irlanda del Norte,14,15,,29,-77.35600000000001,0.81488
4658,2012,Mayo,Reino Unido de Gran Bretaña e Irlanda del Norte,3,19,,22,-75.516486,10.446304
4659,2012,Mayo,Reino Unido de Gran Bretaña e Irlanda del Norte,1,6,,7,-72.129595,11.360028999999999
4660,2012,Mayo,Reino Unido de Gran Bretaña e Irlanda del Norte,5,12,,17,-76.532004,3.451668
4661,2012,Mayo,Reino Unido de Gran Bretaña e Irlanda del Norte,159,476,,635,-74.140516,4.697157
4662,2012,Mayo,Reino Unido de Gran Bretaña e Irlanda del Norte,6,31,,37,-75.42726,6.170465
4663,2012,Mayo,Reino Unido de Gran Bretaña e Irlanda del Norte,2,2,,4,-72.453013,7.819
4664,2012,Mayo,Reino Unido de Gran Bretaña e Irlanda del Norte,0,1,,1,-72.508188,7.927233
4665,2012,Mayo,Reino Unido de Gran Bretaña e Irlanda del Norte,0,1,,1,-77.35002,8.63337
4666,2012,Mayo,República Dominicana,2,6,,8,-77.35600000000001,0.81488
4667,2012,Mayo,República Dominicana,27,34,,61,-75.516486,10.446304
4668,2012,Mayo,República Dominicana,9,29,,38,-74.77647900000001,10.886686
4669,2012,Mayo,República Dominicana,0,1,,1,-72.129595,11.360028999999999
4670,2012,Mayo,República Dominicana,17,22,,39,-76.532004,3.451668
4671,2012,Mayo,República Dominicana,202,283,,485,-74.140516,4.697157
4672,2012,Mayo,República Dominicana,0,4,,4,-75.736374,4.815189
4673,2012,Mayo,República Dominicana,29,72,,101,-75.42726,6.170465
4674,2012,Mayo,República Dominicana,3,2,,5,-73.181317,7.1280470000000005
4675,2012,Mayo,República Dominicana,4,0,,4,-72.453013,7.819
4676,2012,Mayo,República Dominicana,4,6,,10,-72.508188,7.927233
4677,2012,Mayo,República Checa,1,7,,8,-74.140516,4.697157
4678,2012,Mayo,Rumania,1,3,,4,-77.35600000000001,0.81488
4679,2012,Mayo,Rumania,1,2,,3,-75.527794,10.406342
4680,2012,Mayo,Rumania,2,2,,4,-75.516486,10.446304
4681,2012,Mayo,Rumania,0,1,,1,-74.77647900000001,10.886686
4682,2012,Mayo,Rumania,1,1,,2,-72.129595,11.360028999999999
4683,2012,Mayo,Rumania,6,1,,7,-76.532004,3.451668
4684,2012,Mayo,Rumania,43,58,,101,-74.140516,4.697157
4685,2012,Mayo,Rumania,2,3,,5,-75.42726,6.170465
4686,2012,Mayo,Rumania,0,1,,1,-72.453013,7.819
4687,2012,Mayo,Rumania,0,1,,1,-77.35002,8.63337
4688,2012,Mayo,Federación de Rusia,7,4,,11,-77.35600000000001,0.81488
4689,2012,Mayo,Federación de Rusia,0,1,,1,-75.527794,10.406342
4690,2012,Mayo,Federación de Rusia,2,2,,4,-75.516486,10.446304
4691,2012,Mayo,Federación de Rusia,2,5,,7,-72.129595,11.360028999999999
4692,2012,Mayo,Federación de Rusia,0,1,,1,-76.532004,3.451668
4693,2012,Mayo,Federación de Rusia,25,50,,75,-74.140516,4.697157
4694,2012,Mayo,Federación de Rusia,2,0,,2,-75.42726,6.170465
4695,2012,Mayo,Federación de Rusia,1,0,,1,-73.181317,7.1280470000000005
4696,2012,Mayo,San Cristóbal y Nevis,0,3,,3,-74.140516,4.697157
4697,2012,Mayo,San  Vicente y las Granadinas,0,1,,1,-75.516486,10.446304
4698,2012,Mayo,San  Vicente y las Granadinas,0,1,,1,-81.703935,12.574411099999999
4699,2012,Mayo,San  Vicente y las Granadinas,1,0,,1,-75.42726,6.170465
4700,2012,Mayo,Santa Lucia,3,0,,3,-75.516486,10.446304
4701,2012,Mayo,Santa Lucia,0,2,,2,-74.140516,4.697157
4702,2012,Mayo,Santa Lucia,2,0,,2,-73.181317,7.1280470000000005
4703,2012,Mayo,Santa Sede/Ciudad del Vaticano,0,1,,1,-74.140516,4.697157
4704,2012,Mayo,Senegal,1,2,,3,-74.140516,4.697157
4705,2012,Mayo,Serbia,1,2,,3,-74.140516,4.697157
4706,2012,Mayo,Sierra Leona,0,1,,1,-75.42726,6.170465
4707,2012,Mayo,Singapur,1,1,,2,-77.35600000000001,0.81488
4708,2012,Mayo,Singapur,1,1,,2,-75.516486,10.446304
4709,2012,Mayo,Singapur,9,15,,24,-74.140516,4.697157
4710,2012,Mayo,Singapur,1,0,,1,-77.35002,8.63337
4711,2012,Mayo,República Árabe Siria,1,0,,1,-72.129595,11.360028999999999
4712,2012,Mayo,República Árabe Siria,3,0,,3,-74.140516,4.697157
4713,2012,Mayo,Sri Lanka,0,3,,3,-74.140516,4.697157
4714,2012,Mayo,Sudáfrica,7,5,,12,-69.941498,4.191162
4715,2012,Mayo,Sudáfrica,3,3,,6,-77.35600000000001,0.81488
4716,2012,Mayo,Sudáfrica,1,2,,3,-75.527794,10.406342
4717,2012,Mayo,Sudáfrica,3,2,,5,-75.516486,10.446304
4718,2012,Mayo,Sudáfrica,1,3,,4,-74.77647900000001,10.886686
4719,2012,Mayo,Sudáfrica,0,2,,2,-74.765343,10.970933
4720,2012,Mayo,Sudáfrica,0,1,,1,-81.703935,12.574411099999999
4721,2012,Mayo,Sudáfrica,0,1,,1,-76.532004,3.451668
4722,2012,Mayo,Sudáfrica,31,78,,109,-74.140516,4.697157
4723,2012,Mayo,Sudáfrica,0,1,,1,-75.42726,6.170465
4724,2012,Mayo,Sudáfrica,0,1,,1,-72.453013,7.819
4725,2012,Mayo,Sudáfrica,0,1,,1,-72.508188,7.927233
4726,2012,Mayo,Sudán,1,2,,3,-74.140516,4.697157
4727,2012,Mayo,Suecia,0,2,,2,-69.941498,4.191162
4728,2012,Mayo,Suecia,23,23,,46,-77.35600000000001,0.81488
4729,2012,Mayo,Suecia,4,8,,12,-75.527794,10.406342
4730,2012,Mayo,Suecia,1,1,,2,-75.516486,10.446304
4731,2012,Mayo,Suecia,2,3,,5,-74.77647900000001,10.886686
4732,2012,Mayo,Suecia,2,0,,2,-72.129595,11.360028999999999
4733,2012,Mayo,Suecia,4,5,,9,-76.532004,3.451668
4734,2012,Mayo,Suecia,102,162,,264,-74.140516,4.697157
4735,2012,Mayo,Suecia,8,22,,30,-75.42726,6.170465
4736,2012,Mayo,Suecia,1,3,,4,-72.453013,7.819
4737,2012,Mayo,Suiza,6,5,,11,-69.941498,4.191162
4738,2012,Mayo,Suiza,33,29,,62,-77.35600000000001,0.81488
4739,2012,Mayo,Suiza,6,11,,17,-75.527794,10.406342
4740,2012,Mayo,Suiza,5,18,,23,-75.516486,10.446304
4741,2012,Mayo,Suiza,2,4,,6,-74.77647900000001,10.886686
4742,2012,Mayo,Suiza,3,2,,5,-72.129595,11.360028999999999
4743,2012,Mayo,Suiza,1,1,,2,-81.703935,12.574411099999999
4744,2012,Mayo,Suiza,1,0,,1,-81.70216500000001,12.5862
4745,2012,Mayo,Suiza,7,27,,34,-76.532004,3.451668
4746,2012,Mayo,Suiza,173,368,,541,-74.140516,4.697157
4747,2012,Mayo,Suiza,12,23,,35,-75.42726,6.170465
4748,2012,Mayo,Suiza,2,6,,8,-72.453013,7.819
4749,2012,Mayo,Suiza,0,2,,2,-77.35002,8.63337
4750,2012,Mayo,Surinam,7,21,,28,-74.140516,4.697157
4751,2012,Mayo,Surinam,0,6,,6,-75.42726,6.170465
4752,2012,Mayo,Taiwán,1,0,,1,-75.516486,10.446304
4753,2012,Mayo,Taiwán,1,0,,1,-76.532004,3.451668
4754,2012,Mayo,Taiwán,1,4,,5,-74.140516,4.697157
4755,2012,Mayo,Taiwán,1,0,,1,-75.736374,4.815189
4756,2012,Mayo,Tailandia,1,0,,1,-76.532004,3.451668
4757,2012,Mayo,Tailandia,7,18,,25,-74.140516,4.697157
4758,2012,Mayo,Tailandia,0,2,,2,-72.508188,7.927233
4759,2012,Mayo,Tíbet/Región Autónoma de China,0,1,,1,-74.140516,4.697157
4760,2012,Mayo,Territorio Antártico Británico/Territorio Británico de Ultramar,0,1,,1,-77.35600000000001,0.81488
4761,2012,Mayo,Territorio Antártico Británico/Territorio Británico de Ultramar,1,4,,5,-74.140516,4.697157
4762,2012,Mayo,Territorio Antártico Británico/Territorio Británico de Ultramar,0,1,,1,-72.453013,7.819
4763,2012,Mayo,Tanzania,1,1,,2,-74.140516,4.697157
4764,2012,Mayo,Togo,0,1,,1,-75.516486,10.446304
4765,2012,Mayo,Trinidad y Tobago,0,8,,8,-75.527794,10.406342
4766,2012,Mayo,Trinidad y Tobago,3,31,,34,-75.516486,10.446304
4767,2012,Mayo,Trinidad y Tobago,0,9,,9,-74.77647900000001,10.886686
4768,2012,Mayo,Trinidad y Tobago,2,4,,6,-76.532004,3.451668
4769,2012,Mayo,Trinidad y Tobago,19,66,,85,-74.140516,4.697157
4770,2012,Mayo,Trinidad y Tobago,0,2,,2,-75.42726,6.170465
4771,2012,Mayo,Trinidad y Tobago,1,3,,4,-73.181317,7.1280470000000005
4772,2012,Mayo,Trinidad y Tobago,0,2,,2,-72.453013,7.819
4773,2012,Mayo,Túnez,0,1,,1,-76.532004,3.451668
4774,2012,Mayo,Túnez,3,3,,6,-74.140516,4.697157
4775,2012,Mayo,Turquía,1,4,,5,-77.35600000000001,0.81488
4776,2012,Mayo,Turquía,2,1,,3,-75.516486,10.446304
4777,2012,Mayo,Turquía,1,5,,6,-74.77647900000001,10.886686
4778,2012,Mayo,Turquía,19,68,,87,-74.140516,4.697157
4779,2012,Mayo,Turquía,0,4,,4,-75.42726,6.170465
4780,2012,Mayo,Turquía,0,1,,1,-72.453013,7.819
4781,2012,Mayo,Turkmenistán,1,0,,1,-74.140516,4.697157
4782,2012,Mayo,Ucrania,0,1,,1,-75.516486,10.446304
4783,2012,Mayo,Ucrania,0,1,,1,-74.213989,11.247722999999999
4784,2012,Mayo,Ucrania,0,1,,1,-77.061029,3.8844260000000004
4785,2012,Mayo,Ucrania,11,17,,28,-74.140516,4.697157
4786,2012,Mayo,Ucrania,1,0,,1,-75.42726,6.170465
4787,2012,Mayo,Uganda,3,1,,4,-74.140516,4.697157
4788,2012,Mayo,Federación de Rusia,0,3,,3,-69.941498,4.191162
4789,2012,Mayo,Federación de Rusia,1,4,,5,-77.35600000000001,0.81488
4790,2012,Mayo,Federación de Rusia,0,4,,4,-75.527794,10.406342
4791,2012,Mayo,Federación de Rusia,1,2,,3,-75.516486,10.446304
4792,2012,Mayo,Federación de Rusia,0,2,,2,-74.765343,10.970933
4793,2012,Mayo,Federación de Rusia,1,2,,3,-74.213989,11.247722999999999
4794,2012,Mayo,Federación de Rusia,2,3,,5,-72.129595,11.360028999999999
4795,2012,Mayo,Federación de Rusia,1,0,,1,-76.532004,3.451668
4796,2012,Mayo,Federación de Rusia,0,1,,1,-77.061029,3.8844260000000004
4797,2012,Mayo,Federación de Rusia,65,92,,157,-74.140516,4.697157
4798,2012,Mayo,Federación de Rusia,1,1,,2,-75.42726,6.170465
4799,2012,Mayo,Federación de Rusia,4,1,,5,-72.453013,7.819
4800,2012,Mayo,Federación de Rusia,0,5,,5,-75.68164200000001,9.402597
4801,2012,Mayo,Uruguay,1,0,,1,-69.941498,4.191162
4802,2012,Mayo,Uruguay,2,8,,10,-77.35600000000001,0.81488
4803,2012,Mayo,Uruguay,0,1,,1,-75.527794,10.406342
4804,2012,Mayo,Uruguay,112,66,,178,-75.516486,10.446304
4805,2012,Mayo,Uruguay,3,8,,11,-74.77647900000001,10.886686
4806,2012,Mayo,Uruguay,71,40,,111,-81.70216500000001,12.5862
4807,2012,Mayo,Uruguay,3,7,,10,-76.532004,3.451668
4808,2012,Mayo,Uruguay,102,241,,343,-74.140516,4.697157
4809,2012,Mayo,Uruguay,0,3,,3,-75.736374,4.815189
4810,2012,Mayo,Uruguay,12,24,,36,-75.42726,6.170465
4811,2012,Mayo,Uruguay,0,1,,1,-73.181317,7.1280470000000005
4812,2012,Mayo,Uruguay,3,3,,6,-72.453013,7.819
4813,2012,Mayo,Venezuela,0,2,,2,-69.941498,4.191162
4814,2012,Mayo,Venezuela,40,60,,100,-77.35600000000001,0.81488
4815,2012,Mayo,Venezuela,3,12,,15,-75.527794,10.406342
4816,2012,Mayo,Venezuela,88,130,,218,-75.516486,10.446304
4817,2012,Mayo,Venezuela,56,92,,148,-74.77647900000001,10.886686
4818,2012,Mayo,Venezuela,0,1,,1,-74.765343,10.970933
4819,2012,Mayo,Venezuela,0,2,,2,-74.213989,11.247722999999999
4820,2012,Mayo,Venezuela,1008,1448,,2456,-72.129595,11.360028999999999
4821,2012,Mayo,Venezuela,1,5,,6,-72.919186,11.52863
4822,2012,Mayo,Venezuela,11,9,,20,-81.70216500000001,12.5862
4823,2012,Mayo,Venezuela,52,78,,130,-76.532004,3.451668
4824,2012,Mayo,Venezuela,3812,5305,,9117,-74.140516,4.697157
4825,2012,Mayo,Venezuela,5,20,,25,-75.736374,4.815189
4826,2012,Mayo,Venezuela,320,415,,735,-75.42726,6.170465
4827,2012,Mayo,Venezuela,0,4,,4,-67.48402800000001,6.185536
4828,2012,Mayo,Venezuela,30,68,,98,-70.74025300000001,7.088728999999999
4829,2012,Mayo,Venezuela,13,20,,33,-73.181317,7.1280470000000005
4830,2012,Mayo,Venezuela,851,1016,,1867,-72.453013,7.819
4831,2012,Mayo,Venezuela,175,197,,372,-72.508188,7.927233
4832,2012,Mayo,Venezuela,0,1,,1,-77.35002,8.63337
4833,2012,Mayo,Vietnam,1,0,,1,-74.77647900000001,10.886686
4834,2012,Mayo,Vietnam,2,9,,11,-74.140516,4.697157
4835,2012,Mayo,Vietnam,0,2,,2,-72.508188,7.927233
4836,2012,Mayo,Islas Vírgenes Británicas/Territorio Británico de Ultramar,0,1,,1,-74.140516,4.697157
4837,2012,Mayo,República Árabe de Yemen,0,1,,1,-74.140516,4.697157
4838,2012,Mayo,Yugoslavia,1,1,,2,-74.140516,4.697157
4839,2012,Mayo,Zambia,2,1,,3,-74.140516,4.697157
4840,2012,Mayo,Zimbabue,0,2,,2,-74.140516,4.697157
4841,2012,Mayo,Reino Unido de Gran Bretaña e Irlanda del Norte,2,3,,5,-69.941498,4.191162
4842,2012,Mayo,Reino Unido de Gran Bretaña e Irlanda del Norte,60,65,,125,-77.35600000000001,0.81488
4843,2012,Mayo,Reino Unido de Gran Bretaña e Irlanda del Norte,14,32,,46,-75.527794,10.406342
4844,2012,Mayo,Reino Unido de Gran Bretaña e Irlanda del Norte,9,27,,36,-75.516486,10.446304
4845,2012,Mayo,Reino Unido de Gran Bretaña e Irlanda del Norte,1,6,,7,-74.77647900000001,10.886686
4846,2012,Mayo,Reino Unido de Gran Bretaña e Irlanda del Norte,4,6,,10,-72.129595,11.360028999999999
4847,2012,Mayo,Reino Unido de Gran Bretaña e Irlanda del Norte,0,1,,1,-81.70216500000001,12.5862
4848,2012,Mayo,Reino Unido de Gran Bretaña e Irlanda del Norte,0,3,,3,-81.372937,13.338761300000002
4849,2012,Mayo,Reino Unido de Gran Bretaña e Irlanda del Norte,8,9,,17,-76.532004,3.451668
4850,2012,Mayo,Reino Unido de Gran Bretaña e Irlanda del Norte,187,514,,701,-74.140516,4.697157
4851,2012,Mayo,Reino Unido de Gran Bretaña e Irlanda del Norte,10,19,,29,-75.42726,6.170465
4852,2012,Mayo,Reino Unido de Gran Bretaña e Irlanda del Norte,2,5,,7,-72.453013,7.819
4853,2012,Mayo,Reino Unido de Gran Bretaña e Irlanda del Norte,0,1,,1,-72.508188,7.927233
4854,2012,Mayo,Reino Unido de Gran Bretaña e Irlanda del Norte,3,2,,5,-77.35002,8.63337
4855,2012,Mayo,Países Bajos,3,3,,6,-69.941498,4.191162
4856,2012,Mayo,Países Bajos,15,15,,30,-77.35600000000001,0.81488
4857,2012,Mayo,Países Bajos,10,10,,20,-75.527794,10.406342
4858,2012,Mayo,Países Bajos,5,31,,36,-75.516486,10.446304
4859,2012,Mayo,Países Bajos,1,4,,5,-74.77647900000001,10.886686
4860,2012,Mayo,Países Bajos,2,0,,2,-74.213989,11.247722999999999
4861,2012,Mayo,Países Bajos,1,1,,2,-72.129595,11.360028999999999
4862,2012,Mayo,Países Bajos,0,3,,3,-81.70216500000001,12.5862
4863,2012,Mayo,Países Bajos,0,1,,1,-81.372937,13.338761300000002
4864,2012,Mayo,Países Bajos,10,33,,43,-76.532004,3.451668
4865,2012,Mayo,Países Bajos,316,616,,932,-74.140516,4.697157
4866,2012,Mayo,Países Bajos,1,1,,2,-75.736374,4.815189
4867,2012,Mayo,Países Bajos,32,52,,84,-75.42726,6.170465
4868,2012,Mayo,Países Bajos,0,1,,1,-67.48402800000001,6.185536
4869,2012,Mayo,Países Bajos,0,1,,1,-77.401154,6.222551999999999
4870,2012,Mayo,Países Bajos,0,5,,5,-73.181317,7.1280470000000005
4871,2012,Mayo,Países Bajos,5,10,,15,-72.453013,7.819
4872,2012,Mayo,Países Bajos,1,1,,2,-72.508188,7.927233
4873,2012,Mayo,Países Bajos,5,2,,7,-77.35002,8.63337
4874,2012,Mayo,Desconocido,0,1,,1,-75.516486,10.446304
4875,2012,Mayo,Eslovenia,1,1,,2,-75.516486,10.446304
4876,2012,Mayo,Eslovenia,1,0,,1,-74.140516,4.697157
4877,2012,Mayo,Lituania,0,1,,1,-74.765343,10.970933
4878,2012,Mayo,Lituania,1,1,,2,-76.532004,3.451668
4879,2012,Mayo,Lituania,3,1,,4,-74.140516,4.697157
4880,2012,Mayo,Reino Unido de Gran Bretaña e Irlanda del Norte,0,2,,2,-74.213989,11.247722999999999
4881,2012,Mayo,Reino Unido de Gran Bretaña e Irlanda del Norte,1,0,,1,-76.532004,3.451668
4882,2012,Mayo,Reino Unido de Gran Bretaña e Irlanda del Norte,1,0,,1,-76.532004,3.451668
4883,2012,Mayo,Reino Unido de Gran Bretaña e Irlanda del Norte,3,2,,5,-74.140516,4.697157
4884,2012,Mayo,Reino Unido de Gran Bretaña e Irlanda del Norte,1,0,,1,-76.876446,0.33002
4885,2012,Mayo,Reino Unido de Gran Bretaña e Irlanda del Norte,1,0,,1,-77.35600000000001,0.81488
4886,2012,Mayo,Reino Unido de Gran Bretaña e Irlanda del Norte,2,8,,10,-75.527794,10.406342
4887,2012,Mayo,Reino Unido de Gran Bretaña e Irlanda del Norte,0,2,,2,-75.516486,10.446304
4888,2012,Mayo,Reino Unido de Gran Bretaña e Irlanda del Norte,1,1,,2,-72.129595,11.360028999999999
4889,2012,Mayo,Reino Unido de Gran Bretaña e Irlanda del Norte,0,1,,1,-76.532004,3.451668
4890,2012,Mayo,Reino Unido de Gran Bretaña e Irlanda del Norte,2,16,,18,-74.140516,4.697157
4891,2012,Mayo,Reino Unido de Gran Bretaña e Irlanda del Norte,0,2,,2,-75.42726,6.170465
4892,2012,Mayo,Reino Unido de Gran Bretaña e Irlanda del Norte,0,1,,1,-72.453013,7.819
4893,2012,Mayo,Letonia,0,1,,1,-77.061029,3.8844260000000004
4894,2012,Junio,Albania,2,1,,3,-74.140516,4.697157
4895,2012,Junio,Alemania,7,7,,14,-69.941498,4.191162
4896,2012,Junio,Alemania,2,0,,2,-76.876446,0.33002
4897,2012,Junio,Alemania,55,54,,109,-77.35600000000001,0.81488
4898,2012,Junio,Alemania,23,39,,62,-75.527794,10.406342
4899,2012,Junio,Alemania,20,32,,52,-75.516486,10.446304
4900,2012,Junio,Alemania,2,10,,12,-74.77647900000001,10.886686
4901,2012,Junio,Alemania,0,1,,1,-74.765343,10.970933
4902,2012,Junio,Alemania,0,1,,1,-74.213989,11.247722999999999
4903,2012,Junio,Alemania,3,13,,16,-72.129595,11.360028999999999
4904,2012,Junio,Alemania,1,1,,2,-81.70216500000001,12.5862
4905,2012,Junio,Alemania,22,45,,67,-76.532004,3.451668
4906,2012,Junio,Alemania,2,6,,8,-77.061029,3.8844260000000004
4907,2012,Junio,Alemania,919,1411,,2330,-74.140516,4.697157
4908,2012,Junio,Alemania,5,2,,7,-75.736374,4.815189
4909,2012,Junio,Alemania,25,69,,94,-75.42726,6.170465
4910,2012,Junio,Alemania,1,0,,1,-67.48402800000001,6.185536
4911,2012,Junio,Alemania,1,2,,3,-73.181317,7.1280470000000005
4912,2012,Junio,Alemania,1,15,,16,-72.453013,7.819
4913,2012,Junio,Alemania,0,1,,1,-72.508188,7.927233
4914,2012,Junio,Alemania,0,1,,1,-77.35002,8.63337
4915,2012,Junio,Andorra,0,11,,11,-74.140516,4.697157
4916,2012,Junio,Andorra,0,1,,1,-75.42726,6.170465
4917,2012,Junio,Angola,1,3,,4,-74.140516,4.697157
4918,2012,Junio,Antigua y Barbuda,0,3,,3,-74.140516,4.697157
4919,2012,Junio,Países Bajos,1,0,,1,-74.140516,4.697157
4920,2012,Junio,Países Bajos,0,1,,1,-75.42726,6.170465
4921,2012,Junio,Arabia Saudita,0,3,,3,-74.140516,4.697157
4922,2012,Junio,Arabia Saudita,0,1,,1,-75.516486,10.446304
4923,2012,Junio,Arabia Saudita,0,10,,10,-74.140516,4.697157
4924,2012,Junio,Arabia Saudita,0,1,,1,-75.42726,6.170465
4925,2012,Junio,Argelia,1,6,,7,-74.140516,4.697157
4926,2012,Junio,Argentina,2,7,,9,-69.941498,4.191162
4927,2012,Junio,Argentina,48,113,,161,-77.35600000000001,0.81488
4928,2012,Junio,Argentina,1,5,,6,-75.527794,10.406342
4929,2012,Junio,Argentina,551,390,,941,-75.516486,10.446304
4930,2012,Junio,Argentina,12,25,,37,-74.77647900000001,10.886686
4931,2012,Junio,Argentina,13,22,,35,-72.129595,11.360028999999999
4932,2012,Junio,Argentina,211,166,,377,-81.70216500000001,12.5862
4933,2012,Junio,Argentina,33,68,,101,-76.532004,3.451668
4934,2012,Junio,Argentina,2091,3495,,5586,-74.140516,4.697157
4935,2012,Junio,Argentina,1,5,,6,-75.736374,4.815189
4936,2012,Junio,Argentina,87,157,,244,-75.42726,6.170465
4937,2012,Junio,Argentina,3,3,,6,-73.181317,7.1280470000000005
4938,2012,Junio,Argentina,12,32,,44,-72.453013,7.819
4939,2012,Junio,Argentina,0,7,,7,-72.508188,7.927233
4940,2012,Junio,Argentina,0,1,,1,-77.35002,8.63337
4941,2012,Junio,República de Armenia,0,1,,1,-74.140516,4.697157
4942,2012,Junio,Aruba,0,1,,1,-72.129595,11.360028999999999
4943,2012,Junio,Aruba,0,1,,1,-76.532004,3.451668
4944,2012,Junio,Aruba,4,1,,5,-74.140516,4.697157
4945,2012,Junio,Australia,9,6,,15,-69.941498,4.191162
4946,2012,Junio,Australia,1,0,,1,-76.876446,0.33002
4947,2012,Junio,Australia,42,48,,90,-77.35600000000001,0.81488
4948,2012,Junio,Australia,19,30,,49,-75.527794,10.406342
4949,2012,Junio,Australia,12,20,,32,-75.516486,10.446304
4950,2012,Junio,Australia,3,8,,11,-74.77647900000001,10.886686
4951,2012,Junio,Australia,2,2,,4,-74.213989,11.247722999999999
4952,2012,Junio,Australia,4,3,,7,-72.129595,11.360028999999999
4953,2012,Junio,Australia,3,10,,13,-76.532004,3.451668
4954,2012,Junio,Australia,0,1,,1,-75.76635300000001,4.45285
4955,2012,Junio,Australia,207,353,,560,-74.140516,4.697157
4956,2012,Junio,Australia,0,1,,1,-75.736374,4.815189
4957,2012,Junio,Australia,16,46,,62,-75.42726,6.170465
4958,2012,Junio,Australia,0,1,,1,-73.181317,7.1280470000000005
4959,2012,Junio,Australia,1,5,,6,-72.453013,7.819
4960,2012,Junio,Australia,1,1,,2,-77.35002,8.63337
4961,2012,Junio,Austria,0,1,,1,-69.941498,4.191162
4962,2012,Junio,Austria,13,10,,23,-77.35600000000001,0.81488
4963,2012,Junio,Austria,4,3,,7,-75.527794,10.406342
4964,2012,Junio,Austria,4,3,,7,-75.516486,10.446304
4965,2012,Junio,Austria,0,3,,3,-74.77647900000001,10.886686
4966,2012,Junio,Austria,1,0,,1,-72.129595,11.360028999999999
4967,2012,Junio,Austria,1,1,,2,-81.70216500000001,12.5862
4968,2012,Junio,Austria,7,8,,15,-76.532004,3.451668
4969,2012,Junio,Austria,76,138,,214,-74.140516,4.697157
4970,2012,Junio,Austria,2,6,,8,-75.42726,6.170465
4971,2012,Junio,Austria,1,0,,1,-72.453013,7.819
4972,2012,Junio,Azerbaiyán,0,1,,1,-75.516486,10.446304
4973,2012,Junio,Azerbaiyán,0,2,,2,-74.140516,4.697157
4974,2012,Junio,Bahamas,1,1,,2,-75.516486,10.446304
4975,2012,Junio,Bahamas,0,1,,1,-76.532004,3.451668
4976,2012,Junio,Bahamas,5,11,,16,-74.140516,4.697157
4977,2012,Junio,Bahamas,0,1,,1,-75.736374,4.815189
4978,2012,Junio,Bahamas,0,2,,2,-75.42726,6.170465
4979,2012,Junio,Bangladesh,0,2,,2,-74.140516,4.697157
4980,2012,Junio,Bangladesh,0,1,,1,-75.42726,6.170465
4981,2012,Junio,Barbados,1,0,,1,-75.516486,10.446304
4982,2012,Junio,Barbados,1,6,,7,-74.140516,4.697157
4983,2012,Junio,República de Belarús,2,1,,3,-74.140516,4.697157
4984,2012,Junio,Bélgica,0,5,,5,-69.941498,4.191162
4985,2012,Junio,Bélgica,7,15,,22,-77.35600000000001,0.81488
4986,2012,Junio,Bélgica,1,4,,5,-75.527794,10.406342
4987,2012,Junio,Bélgica,3,5,,8,-75.516486,10.446304
4988,2012,Junio,Bélgica,1,2,,3,-74.77647900000001,10.886686
4989,2012,Junio,Bélgica,0,26,,26,-74.213989,11.247722999999999
4990,2012,Junio,Bélgica,0,2,,2,-72.129595,11.360028999999999
4991,2012,Junio,Bélgica,7,15,,22,-76.532004,3.451668
4992,2012,Junio,Bélgica,159,293,,452,-74.140516,4.697157
4993,2012,Junio,Bélgica,0,1,,1,-75.736374,4.815189
4994,2012,Junio,Bélgica,10,27,,37,-75.42726,6.170465
4995,2012,Junio,Belice,0,1,,1,-75.516486,10.446304
4996,2012,Junio,Belice,0,1,,1,-74.77647900000001,10.886686
4997,2012,Junio,Belice,1,0,,1,-72.129595,11.360028999999999
4998,2012,Junio,Belice,3,21,,24,-74.140516,4.697157
4999,2012,Junio,Benín,1,0,,1,-74.140516,4.697157
5000,2012,Junio,Bermudas/Territorio Británico de Ultramar,0,1,,1,-76.532004,3.451668
5001,2012,Junio,Bermudas/Territorio Británico de Ultramar,1,0,,1,-74.140516,4.697157
5002,2012,Junio,Bolivia,1,0,,1,-69.941498,4.191162
5003,2012,Junio,Bolivia,0,1,,1,-76.876446,0.33002
5004,2012,Junio,Bolivia,7,11,,18,-77.35600000000001,0.81488
5005,2012,Junio,Bolivia,5,6,,11,-75.516486,10.446304
5006,2012,Junio,Bolivia,3,1,,4,-74.77647900000001,10.886686
5007,2012,Junio,Bolivia,0,1,,1,-81.70216500000001,12.5862
5008,2012,Junio,Bolivia,5,5,,10,-76.532004,3.451668
5009,2012,Junio,Bolivia,281,396,,677,-74.140516,4.697157
5010,2012,Junio,Bolivia,3,4,,7,-75.736374,4.815189
5011,2012,Junio,Bolivia,5,17,,22,-75.42726,6.170465
5012,2012,Junio,Bolivia,1,0,,1,-73.181317,7.1280470000000005
5013,2012,Junio,Bolivia,0,4,,4,-72.453013,7.819
5014,2012,Junio,Bosnia y Herzegovina,1,2,,3,-74.140516,4.697157
5015,2012,Junio,Botsuana,0,1,,1,-74.140516,4.697157
5016,2012,Junio,Brasil,55,63,,118,-69.941498,4.191162
5017,2012,Junio,Brasil,0,1,,1,-76.876446,0.33002
5018,2012,Junio,Brasil,8,21,,29,-77.35600000000001,0.81488
5019,2012,Junio,Brasil,2,4,,6,-75.527794,10.406342
5020,2012,Junio,Brasil,91,95,,186,-75.516486,10.446304
5021,2012,Junio,Brasil,6,29,,35,-74.77647900000001,10.886686
5022,2012,Junio,Brasil,5,9,,14,-72.129595,11.360028999999999
5023,2012,Junio,Brasil,11,11,,22,-81.70216500000001,12.5862
5024,2012,Junio,Brasil,0,1,,1,-81.372937,13.338761300000002
5025,2012,Junio,Brasil,13,46,,59,-76.532004,3.451668
5026,2012,Junio,Brasil,1,0,,1,-75.76635300000001,4.45285
5027,2012,Junio,Brasil,2035,3489,,5524,-74.140516,4.697157
5028,2012,Junio,Brasil,2,3,,5,-75.736374,4.815189
5029,2012,Junio,Brasil,23,62,,85,-75.42726,6.170465
5030,2012,Junio,Brasil,1,3,,4,-67.48402800000001,6.185536
5031,2012,Junio,Brasil,0,1,,1,-73.181317,7.1280470000000005
5032,2012,Junio,Brasil,6,10,,16,-72.453013,7.819
5033,2012,Junio,Brasil,0,1,,1,-72.508188,7.927233
5034,2012,Junio,Brasil,0,1,,1,-77.35002,8.63337
5035,2012,Junio,Brunei Darussalam,1,0,,1,-74.140516,4.697157
5036,2012,Junio,Bulgaria,1,0,,1,-76.532004,3.451668
5037,2012,Junio,Bulgaria,6,8,,14,-74.140516,4.697157
5038,2012,Junio,Bulgaria,1,0,,1,-75.42726,6.170465
5039,2012,Junio,Burkina Faso,1,0,,1,-76.532004,3.451668
5040,2012,Junio,Burkina Faso,0,2,,2,-74.140516,4.697157
5041,2012,Junio,Burundi,0,1,,1,-74.140516,4.697157
5042,2012,Junio,Bután,0,3,,3,-74.140516,4.697157
5043,2012,Junio,Islas Caimán/Territorio Británico de Ultramar,2,2,,4,-81.703935,12.574411099999999
5044,2012,Junio,Islas Caimán/Territorio Británico de Ultramar,4,7,,11,-81.70216500000001,12.5862
5045,2012,Junio,Islas Caimán/Territorio Británico de Ultramar,3,0,,3,-76.532004,3.451668
5046,2012,Junio,Islas Caimán/Territorio Británico de Ultramar,0,1,,1,-74.140516,4.697157
5047,2012,Junio,Camboya,0,2,,2,-74.140516,4.697157
5048,2012,Junio,Camerún,1,0,,1,-75.516486,10.446304
5049,2012,Junio,Camerún,1,4,,5,-74.140516,4.697157
5050,2012,Junio,Camerún,0,1,,1,-75.42726,6.170465
5051,2012,Junio,Canadá,17,15,,32,-77.35600000000001,0.81488
5052,2012,Junio,Canadá,14,10,,24,-75.527794,10.406342
5053,2012,Junio,Canadá,20,68,,88,-75.516486,10.446304
5054,2012,Junio,Canadá,8,25,,33,-74.77647900000001,10.886686
5055,2012,Junio,Canadá,0,1,,1,-74.213989,11.247722999999999
5056,2012,Junio,Canadá,2,2,,4,-72.129595,11.360028999999999
5057,2012,Junio,Canadá,1,2,,3,-81.70216500000001,12.5862
5058,2012,Junio,Canadá,1,0,,1,-81.372937,13.338761300000002
5059,2012,Junio,Canadá,32,53,,85,-76.532004,3.451668
5060,2012,Junio,Canadá,3,1,,4,-75.76635300000001,4.45285
5061,2012,Junio,Canadá,589,1240,,1829,-74.140516,4.697157
5062,2012,Junio,Canadá,3,1,,4,-75.736374,4.815189
5063,2012,Junio,Canadá,74,136,,210,-75.42726,6.170465
5064,2012,Junio,Canadá,3,10,,13,-73.181317,7.1280470000000005
5065,2012,Junio,Canadá,2,5,,7,-72.453013,7.819
5066,2012,Junio,Canadá,2,6,,8,-72.508188,7.927233
5067,2012,Junio,Canadá,0,1,,1,-77.35002,8.63337
5068,2012,Junio,Chad,0,1,,1,-74.140516,4.697157
5069,2012,Junio,España,4,5,,9,-77.35600000000001,0.81488
5070,2012,Junio,España,3,16,,19,-75.516486,10.446304
5071,2012,Junio,España,7,13,,20,-74.77647900000001,10.886686
5072,2012,Junio,España,2,0,,2,-72.129595,11.360028999999999
5073,2012,Junio,España,1,0,,1,-81.70216500000001,12.5862
5074,2012,Junio,España,111,154,,265,-76.532004,3.451668
5075,2012,Junio,España,142,352,,494,-74.140516,4.697157
5076,2012,Junio,España,1,13,,14,-75.736374,4.815189
5077,2012,Junio,España,25,92,,117,-75.42726,6.170465
5078,2012,Junio,España,1,1,,2,-72.453013,7.819
5079,2012,Junio,España,1,2,,3,-72.508188,7.927233
5080,2012,Junio,República Democrática del Congo,2,5,,7,-74.140516,4.697157
5081,2012,Junio,República de Corea,9,11,,20,-77.35600000000001,0.81488
5082,2012,Junio,República de Corea,3,10,,13,-75.516486,10.446304
5083,2012,Junio,República de Corea,1,2,,3,-74.77647900000001,10.886686
5084,2012,Junio,República de Corea,0,1,,1,-72.129595,11.360028999999999
5085,2012,Junio,República de Corea,9,22,,31,-76.532004,3.451668
5086,2012,Junio,República de Corea,0,2,,2,-77.061029,3.8844260000000004
5087,2012,Junio,República de Corea,169,698,,867,-74.140516,4.697157
5088,2012,Junio,República de Corea,0,3,,3,-75.736374,4.815189
5089,2012,Junio,República de Corea,2,9,,11,-75.42726,6.170465
5090,2012,Junio,República de Corea,0,1,,1,-72.453013,7.819
5091,2012,Junio,República de Corea,0,7,,7,-75.68164200000001,9.402597
5092,2012,Junio,Costa de Marfil,0,2,,2,-74.140516,4.697157
5093,2012,Junio,Costa Rica,2,3,,5,-77.35600000000001,0.81488
5094,2012,Junio,Costa Rica,50,68,,118,-75.516486,10.446304
5095,2012,Junio,Costa Rica,11,13,,24,-74.77647900000001,10.886686
5096,2012,Junio,Costa Rica,1,0,,1,-72.129595,11.360028999999999
5097,2012,Junio,Costa Rica,60,39,,99,-81.70216500000001,12.5862
5098,2012,Junio,Costa Rica,12,44,,56,-76.532004,3.451668
5099,2012,Junio,Costa Rica,390,674,,1064,-74.140516,4.697157
5100,2012,Junio,Costa Rica,3,8,,11,-75.736374,4.815189
5101,2012,Junio,Costa Rica,90,127,,217,-75.42726,6.170465
5102,2012,Junio,Costa Rica,1,4,,5,-73.181317,7.1280470000000005
5103,2012,Junio,Costa Rica,3,2,,5,-72.453013,7.819
5104,2012,Junio,Croacia,1,2,,3,-75.527794,10.406342
5105,2012,Junio,Croacia,0,1,,1,-75.516486,10.446304
5106,2012,Junio,Croacia,0,1,,1,-74.77647900000001,10.886686
5107,2012,Junio,Croacia,0,12,,12,-74.213989,11.247722999999999
5108,2012,Junio,Croacia,5,37,,42,-74.140516,4.697157
5109,2012,Junio,Cuba,0,1,,1,-69.941498,4.191162
5110,2012,Junio,Cuba,1,2,,3,-77.35600000000001,0.81488
5111,2012,Junio,Cuba,1,1,,2,-75.527794,10.406342
5112,2012,Junio,Cuba,5,9,,14,-75.516486,10.446304
5113,2012,Junio,Cuba,4,12,,16,-74.77647900000001,10.886686
5114,2012,Junio,Cuba,1,0,,1,-72.129595,11.360028999999999
5115,2012,Junio,Cuba,12,18,,30,-76.532004,3.451668
5116,2012,Junio,Cuba,66,133,,199,-74.140516,4.697157
5117,2012,Junio,Cuba,0,1,,1,-75.736374,4.815189
5118,2012,Junio,Cuba,12,15,,27,-75.42726,6.170465
5119,2012,Junio,Cuba,2,1,,3,-73.181317,7.1280470000000005
5120,2012,Junio,Cuba,0,2,,2,-72.453013,7.819
5121,2012,Junio,Cuba,0,2,,2,-72.508188,7.927233
5122,2012,Junio,Curazao,4,0,,4,-74.140516,4.697157
5123,2012,Junio,Curazao,2,1,,3,-75.42726,6.170465
5124,2012,Junio,República Checa,3,3,,6,-77.35600000000001,0.81488
5125,2012,Junio,República Checa,1,1,,2,-75.516486,10.446304
5126,2012,Junio,República Checa,0,2,,2,-81.70216500000001,12.5862
5127,2012,Junio,República Checa,1,3,,4,-76.532004,3.451668
5128,2012,Junio,República Checa,37,75,,112,-74.140516,4.697157
5129,2012,Junio,República Checa,0,2,,2,-75.42726,6.170465
5130,2012,Junio,República Checa,0,1,,1,-72.453013,7.819
5131,2012,Junio,Chile,2,1,,3,-69.941498,4.191162
5132,2012,Junio,Chile,28,36,,64,-77.35600000000001,0.81488
5133,2012,Junio,Chile,0,1,,1,-75.527794,10.406342
5134,2012,Junio,Chile,111,104,,215,-75.516486,10.446304
5135,2012,Junio,Chile,7,10,,17,-74.77647900000001,10.886686
5136,2012,Junio,Chile,2,5,,7,-72.129595,11.360028999999999
5137,2012,Junio,Chile,1,2,,3,-81.703935,12.574411099999999
5138,2012,Junio,Chile,103,66,,169,-81.70216500000001,12.5862
5139,2012,Junio,Chile,21,53,,74,-76.532004,3.451668
5140,2012,Junio,Chile,1954,3084,,5038,-74.140516,4.697157
5141,2012,Junio,Chile,0,1,,1,-75.736374,4.815189
5142,2012,Junio,Chile,37,68,,105,-75.42726,6.170465
5143,2012,Junio,Chile,0,1,,1,-67.48402800000001,6.185536
5144,2012,Junio,Chile,0,3,,3,-73.181317,7.1280470000000005
5145,2012,Junio,Chile,4,8,,12,-72.453013,7.819
5146,2012,Junio,Chile,0,2,,2,-72.508188,7.927233
5147,2012,Junio,China,1,1,,2,-77.35600000000001,0.81488
5148,2012,Junio,China,0,1,,1,-75.527794,10.406342
5149,2012,Junio,China,3,13,,16,-75.516486,10.446304
5150,2012,Junio,China,1,0,,1,-74.77647900000001,10.886686
5151,2012,Junio,China,4,0,,4,-72.129595,11.360028999999999
5152,2012,Junio,China,0,1,,1,-81.70216500000001,12.5862
5153,2012,Junio,China,1,5,,6,-76.532004,3.451668
5154,2012,Junio,China,121,424,,545,-74.140516,4.697157
5155,2012,Junio,China,4,6,,10,-75.42726,6.170465
5156,2012,Junio,China,3,3,,6,-72.453013,7.819
5157,2012,Junio,Taiwán,1,2,,3,-77.35600000000001,0.81488
5158,2012,Junio,Taiwán,1,2,,3,-75.516486,10.446304
5159,2012,Junio,Taiwán,0,1,,1,-74.77647900000001,10.886686
5160,2012,Junio,Taiwán,0,1,,1,-76.532004,3.451668
5161,2012,Junio,Taiwán,27,48,,75,-74.140516,4.697157
5162,2012,Junio,Taiwán,0,1,,1,-75.736374,4.815189
5163,2012,Junio,Taiwán,4,9,,13,-75.42726,6.170465
5164,2012,Junio,Taiwán,0,3,,3,-72.453013,7.819
5165,2012,Junio,Chipre,1,0,,1,-76.532004,3.451668
5166,2012,Junio,Chipre,1,5,,6,-74.140516,4.697157
5167,2012,Junio,Dinamarca,3,0,,3,-69.941498,4.191162
5168,2012,Junio,Dinamarca,3,0,,3,-77.35600000000001,0.81488
5169,2012,Junio,Dinamarca,1,3,,4,-75.527794,10.406342
5170,2012,Junio,Dinamarca,2,1,,3,-75.516486,10.446304
5171,2012,Junio,Dinamarca,0,1,,1,-74.213989,11.247722999999999
5172,2012,Junio,Dinamarca,1,1,,2,-76.532004,3.451668
5173,2012,Junio,Dinamarca,0,3,,3,-77.061029,3.8844260000000004
5174,2012,Junio,Dinamarca,64,129,,193,-74.140516,4.697157
5175,2012,Junio,Dinamarca,8,11,,19,-75.42726,6.170465
5176,2012,Junio,Dinamarca,1,0,,1,-72.453013,7.819
5177,2012,Junio,Dominica,1,3,,4,-74.140516,4.697157
5178,2012,Junio,Ecuador,1,3,,4,-69.941498,4.191162
5179,2012,Junio,Ecuador,13,41,,54,-76.876446,0.33002
5180,2012,Junio,Ecuador,687,1185,,1872,-77.35600000000001,0.81488
5181,2012,Junio,Ecuador,0,145,,145,-78.802679,18.00143
5182,2012,Junio,Ecuador,1,9,,10,-75.527794,10.406342
5183,2012,Junio,Ecuador,72,74,,146,-75.516486,10.446304
5184,2012,Junio,Ecuador,1,11,,12,-74.77647900000001,10.886686
5185,2012,Junio,Ecuador,7,8,,15,-72.129595,11.360028999999999
5186,2012,Junio,Ecuador,5,5,,10,-81.70216500000001,12.5862
5187,2012,Junio,Ecuador,222,256,,478,-76.532004,3.451668
5188,2012,Junio,Ecuador,1375,2503,,3878,-74.140516,4.697157
5189,2012,Junio,Ecuador,1,1,,2,-75.736374,4.815189
5190,2012,Junio,Ecuador,308,434,,742,-75.42726,6.170465
5191,2012,Junio,Ecuador,2,3,,5,-73.181317,7.1280470000000005
5192,2012,Junio,Ecuador,97,162,,259,-72.453013,7.819
5193,2012,Junio,Ecuador,2,2,,4,-72.508188,7.927233
5194,2012,Junio,Ecuador,0,2,,2,-77.35002,8.63337
5195,2012,Junio,Egipto,0,1,,1,-75.516486,10.446304
5196,2012,Junio,Egipto,2,11,,13,-74.140516,4.697157
5197,2012,Junio,El Salvador,0,1,,1,-77.35600000000001,0.81488
5198,2012,Junio,El Salvador,7,11,,18,-75.516486,10.446304
5199,2012,Junio,El Salvador,1,3,,4,-74.77647900000001,10.886686
5200,2012,Junio,El Salvador,0,1,,1,-72.129595,11.360028999999999
5201,2012,Junio,El Salvador,2,1,,3,-81.70216500000001,12.5862
5202,2012,Junio,El Salvador,6,10,,16,-76.532004,3.451668
5203,2012,Junio,El Salvador,311,586,,897,-74.140516,4.697157
5204,2012,Junio,El Salvador,1,0,,1,-75.736374,4.815189
5205,2012,Junio,El Salvador,17,24,,41,-75.42726,6.170465
5206,2012,Junio,El Salvador,0,1,,1,-73.181317,7.1280470000000005
5207,2012,Junio,El Salvador,0,1,,1,-72.453013,7.819
5208,2012,Junio,Emiratos Árabes,0,1,,1,-75.516486,10.446304
5209,2012,Junio,Emiratos Árabes,2,6,,8,-74.140516,4.697157
5210,2012,Junio,España,4,8,,12,-69.941498,4.191162
5211,2012,Junio,España,0,1,,1,-76.876446,0.33002
5212,2012,Junio,España,16,54,,70,-77.35600000000001,0.81488
5213,2012,Junio,España,4,14,,18,-75.527794,10.406342
5214,2012,Junio,España,33,94,,127,-75.516486,10.446304
5215,2012,Junio,España,3,7,,10,-74.77647900000001,10.886686
5216,2012,Junio,España,5,9,,14,-72.129595,11.360028999999999
5217,2012,Junio,España,5,2,,7,-81.70216500000001,12.5862
5218,2012,Junio,España,278,398,,676,-76.532004,3.451668
5219,2012,Junio,España,1,0,,1,-77.061029,3.8844260000000004
5220,2012,Junio,España,1763,4189,,5952,-74.140516,4.697157
5221,2012,Junio,España,3,12,,15,-75.736374,4.815189
5222,2012,Junio,España,115,213,,328,-75.42726,6.170465
5223,2012,Junio,España,1,1,,2,-67.48402800000001,6.185536
5224,2012,Junio,España,0,1,,1,-70.74025300000001,7.088728999999999
5225,2012,Junio,España,7,39,,46,-72.453013,7.819
5226,2012,Junio,España,1,5,,6,-72.508188,7.927233
5227,2012,Junio,España,1,1,,2,-77.35002,8.63337
5228,2012,Junio,Eritrea,0,1,,1,-74.140516,4.697157
5229,2012,Junio,Eslovaquia,0,1,,1,-77.35600000000001,0.81488
5230,2012,Junio,Eslovaquia,1,1,,2,-76.532004,3.451668
5231,2012,Junio,Eslovaquia,9,19,,28,-74.140516,4.697157
5232,2012,Junio,Eslovenia,0,1,,1,-75.527794,10.406342
5233,2012,Junio,Eslovenia,1,2,,3,-76.532004,3.451668
5234,2012,Junio,Eslovenia,3,12,,15,-74.140516,4.697157
5235,2012,Junio,Eslovenia,3,2,,5,-75.42726,6.170465
5236,2012,Junio,Estados Unidos de América,26,41,,67,-69.941498,4.191162
5237,2012,Junio,Estados Unidos de América,0,2,,2,-76.876446,0.33002
5238,2012,Junio,Estados Unidos de América,39,68,,107,-77.35600000000001,0.81488
5239,2012,Junio,Estados Unidos de América,0,2,,2,-78.802679,18.00143
5240,2012,Junio,Estados Unidos de América,15,47,,62,-75.527794,10.406342
5241,2012,Junio,Estados Unidos de América,1054,1812,,2866,-75.516486,10.446304
5242,2012,Junio,Estados Unidos de América,705,860,,1565,-74.77647900000001,10.886686
5243,2012,Junio,Estados Unidos de América,3,18,,21,-74.213989,11.247722999999999
5244,2012,Junio,Estados Unidos de América,9,16,,25,-72.129595,11.360028999999999
5245,2012,Junio,Estados Unidos de América,0,1,,1,-72.919186,11.52863
5246,2012,Junio,Estados Unidos de América,1,9,,10,-81.703935,12.574411099999999
5247,2012,Junio,Estados Unidos de América,35,49,,84,-81.70216500000001,12.5862
5248,2012,Junio,Estados Unidos de América,4,8,,12,-81.372937,13.338761300000002
5249,2012,Junio,Estados Unidos de América,1586,1908,,3494,-76.532004,3.451668
5250,2012,Junio,Estados Unidos de América,116,150,,266,-75.76635300000001,4.45285
5251,2012,Junio,Estados Unidos de América,8744,14303,,23047,-74.140516,4.697157
5252,2012,Junio,Estados Unidos de América,121,144,,265,-75.736374,4.815189
5253,2012,Junio,Estados Unidos de América,1810,2943,,4753,-75.42726,6.170465
5254,2012,Junio,Estados Unidos de América,1,2,,3,-67.48402800000001,6.185536
5255,2012,Junio,Estados Unidos de América,41,43,,84,-73.181317,7.1280470000000005
5256,2012,Junio,Estados Unidos de América,19,35,,54,-72.453013,7.819
5257,2012,Junio,Estados Unidos de América,17,29,,46,-72.508188,7.927233
5258,2012,Junio,Estados Unidos de América,2,0,,2,-77.35002,8.63337
5259,2012,Junio,Estonia,1,0,,1,-76.532004,3.451668
5260,2012,Junio,Estonia,3,4,,7,-74.140516,4.697157
5261,2012,Junio,Estonia,0,2,,2,-72.453013,7.819
5262,2012,Junio,Etiopia,0,5,,5,-74.140516,4.697157
5263,2012,Junio,Filipinas,1,0,,1,-77.35600000000001,0.81488
5264,2012,Junio,Filipinas,0,33,,33,-75.527794,10.406342
5265,2012,Junio,Filipinas,2,15,,17,-75.516486,10.446304
5266,2012,Junio,Filipinas,0,1,,1,-74.77647900000001,10.886686
5267,2012,Junio,Filipinas,0,15,,15,-74.765343,10.970933
5268,2012,Junio,Filipinas,0,30,,30,-74.213989,11.247722999999999
5269,2012,Junio,Filipinas,1,0,,1,-81.70216500000001,12.5862
5270,2012,Junio,Filipinas,1,1,,2,-76.532004,3.451668
5271,2012,Junio,Filipinas,0,1,,1,-77.061029,3.8844260000000004
5272,2012,Junio,Filipinas,16,53,,69,-74.140516,4.697157
5273,2012,Junio,Filipinas,2,2,,4,-75.42726,6.170465
5274,2012,Junio,Filipinas,0,1,,1,-77.35002,8.63337
5275,2012,Junio,Finlandia,7,4,,11,-69.941498,4.191162
5276,2012,Junio,Finlandia,1,0,,1,-77.35600000000001,0.81488
5277,2012,Junio,Finlandia,2,3,,5,-75.516486,10.446304
5278,2012,Junio,Finlandia,0,1,,1,-74.77647900000001,10.886686
5279,2012,Junio,Finlandia,0,2,,2,-76.532004,3.451668
5280,2012,Junio,Finlandia,36,58,,94,-74.140516,4.697157
5281,2012,Junio,Finlandia,1,1,,2,-75.42726,6.170465
5282,2012,Junio,Francia,10,15,,25,-69.941498,4.191162
5283,2012,Junio,Francia,1,1,,2,-76.876446,0.33002
5284,2012,Junio,Francia,52,72,,124,-77.35600000000001,0.81488
5285,2012,Junio,Francia,0,1,,1,-78.802679,18.00143
5286,2012,Junio,Francia,12,13,,25,-75.527794,10.406342
5287,2012,Junio,Francia,18,41,,59,-75.516486,10.446304
5288,2012,Junio,Francia,0,6,,6,-74.77647900000001,10.886686
5289,2012,Junio,Francia,2,3,,5,-74.213989,11.247722999999999
5290,2012,Junio,Francia,7,12,,19,-72.129595,11.360028999999999
5291,2012,Junio,Francia,33,56,,89,-76.532004,3.451668
5292,2012,Junio,Francia,901,1606,,2507,-74.140516,4.697157
5293,2012,Junio,Francia,0,4,,4,-75.736374,4.815189
5294,2012,Junio,Francia,24,41,,65,-75.42726,6.170465
5295,2012,Junio,Francia,0,2,,2,-67.48402800000001,6.185536
5296,2012,Junio,Francia,0,1,,1,-73.181317,7.1280470000000005
5297,2012,Junio,Francia,3,10,,13,-72.453013,7.819
5298,2012,Junio,Francia,0,2,,2,-72.508188,7.927233
5299,2012,Junio,Francia,0,2,,2,-77.35002,8.63337
5300,2012,Junio,Gabón,1,2,,3,-74.140516,4.697157
5301,2012,Junio,Georgia,0,2,,2,-77.061029,3.8844260000000004
5302,2012,Junio,Georgia,1,0,,1,-74.140516,4.697157
5303,2012,Junio,Ghana,0,1,,1,-75.516486,10.446304
5304,2012,Junio,Ghana,1,3,,4,-74.140516,4.697157
5305,2012,Junio,Granada,0,3,,3,-74.140516,4.697157
5306,2012,Junio,Grecia,0,3,,3,-75.527794,10.406342
5307,2012,Junio,Grecia,1,2,,3,-75.516486,10.446304
5308,2012,Junio,Grecia,0,1,,1,-74.765343,10.970933
5309,2012,Junio,Grecia,0,4,,4,-76.532004,3.451668
5310,2012,Junio,Grecia,16,40,,56,-74.140516,4.697157
5311,2012,Junio,Grecia,1,3,,4,-75.42726,6.170465
5312,2012,Junio,Grecia,0,1,,1,-75.68164200000001,9.402597
5313,2012,Junio,Guatemala,1,5,,6,-77.35600000000001,0.81488
5314,2012,Junio,Guatemala,0,2,,2,-75.527794,10.406342
5315,2012,Junio,Guatemala,40,50,,90,-75.516486,10.446304
5316,2012,Junio,Guatemala,4,10,,14,-74.77647900000001,10.886686
5317,2012,Junio,Guatemala,0,1,,1,-72.129595,11.360028999999999
5318,2012,Junio,Guatemala,10,9,,19,-81.70216500000001,12.5862
5319,2012,Junio,Guatemala,12,30,,42,-76.532004,3.451668
5320,2012,Junio,Guatemala,0,1,,1,-75.76635300000001,4.45285
5321,2012,Junio,Guatemala,217,498,,715,-74.140516,4.697157
5322,2012,Junio,Guatemala,4,6,,10,-75.736374,4.815189
5323,2012,Junio,Guatemala,42,62,,104,-75.42726,6.170465
5324,2012,Junio,Guatemala,4,4,,8,-73.181317,7.1280470000000005
5325,2012,Junio,Guatemala,3,7,,10,-72.453013,7.819
5326,2012,Junio,Guatemala,0,1,,1,-77.35002,8.63337
5327,2012,Junio,Guyana,0,1,,1,-75.516486,10.446304
5328,2012,Junio,Guyana,1,0,,1,-74.77647900000001,10.886686
5329,2012,Junio,Guyana,1,0,,1,-81.70216500000001,12.5862
5330,2012,Junio,Guyana,5,16,,21,-74.140516,4.697157
5331,2012,Junio,Guinea,0,1,,1,-74.140516,4.697157
5332,2012,Junio,Guinea Ecuatorial,1,0,,1,-77.35600000000001,0.81488
5333,2012,Junio,Haití,0,2,,2,-75.516486,10.446304
5334,2012,Junio,Haití,1,0,,1,-76.532004,3.451668
5335,2012,Junio,Haití,3,15,,18,-74.140516,4.697157
5336,2012,Junio,Haití,0,4,,4,-75.42726,6.170465
5337,2012,Junio,Honduras,1,2,,3,-77.35600000000001,0.81488
5338,2012,Junio,Honduras,1,4,,5,-75.527794,10.406342
5339,2012,Junio,Honduras,2,14,,16,-75.516486,10.446304
5340,2012,Junio,Honduras,10,14,,24,-74.77647900000001,10.886686
5341,2012,Junio,Honduras,0,1,,1,-72.129595,11.360028999999999
5342,2012,Junio,Honduras,0,37,,37,-81.703935,12.574411099999999
5343,2012,Junio,Honduras,0,4,,4,-81.70216500000001,12.5862
5344,2012,Junio,Honduras,10,16,,26,-76.532004,3.451668
5345,2012,Junio,Honduras,104,211,,315,-74.140516,4.697157
5346,2012,Junio,Honduras,1,1,,2,-75.736374,4.815189
5347,2012,Junio,Honduras,10,21,,31,-75.42726,6.170465
5348,2012,Junio,Honduras,0,1,,1,-72.508188,7.927233
5349,2012,Junio,Hungría,2,0,,2,-77.35600000000001,0.81488
5350,2012,Junio,Hungría,0,1,,1,-75.527794,10.406342
5351,2012,Junio,Hungría,1,0,,1,-75.516486,10.446304
5352,2012,Junio,Hungría,0,1,,1,-76.532004,3.451668
5353,2012,Junio,Hungría,15,22,,37,-74.140516,4.697157
5354,2012,Junio,Hungría,0,2,,2,-75.42726,6.170465
5355,2012,Junio,India,1,12,,13,-75.516486,10.446304
5356,2012,Junio,India,1,10,,11,-76.532004,3.451668
5357,2012,Junio,India,40,217,,257,-74.140516,4.697157
5358,2012,Junio,India,0,3,,3,-75.736374,4.815189
5359,2012,Junio,India,3,7,,10,-75.42726,6.170465
5360,2012,Junio,Indonesia,1,0,,1,-77.35600000000001,0.81488
5361,2012,Junio,Indonesia,0,10,,10,-75.527794,10.406342
5362,2012,Junio,Indonesia,2,1,,3,-75.516486,10.446304
5363,2012,Junio,Indonesia,0,4,,4,-74.213989,11.247722999999999
5364,2012,Junio,Indonesia,11,20,,31,-74.140516,4.697157
5365,2012,Junio,Irán,7,18,,25,-74.140516,4.697157
5366,2012,Junio,República de Irlanda,4,3,,7,-69.941498,4.191162
5367,2012,Junio,República de Irlanda,2,0,,2,-76.876446,0.33002
5368,2012,Junio,República de Irlanda,13,13,,26,-77.35600000000001,0.81488
5369,2012,Junio,República de Irlanda,2,1,,3,-75.527794,10.406342
5370,2012,Junio,República de Irlanda,3,6,,9,-75.516486,10.446304
5371,2012,Junio,República de Irlanda,0,1,,1,-74.77647900000001,10.886686
5372,2012,Junio,República de Irlanda,1,1,,2,-72.129595,11.360028999999999
5373,2012,Junio,República de Irlanda,0,1,,1,-81.70216500000001,12.5862
5374,2012,Junio,República de Irlanda,4,2,,6,-76.532004,3.451668
5375,2012,Junio,República de Irlanda,47,90,,137,-74.140516,4.697157
5376,2012,Junio,República de Irlanda,0,4,,4,-75.42726,6.170465
5377,2012,Junio,República de Irlanda,0,1,,1,-73.181317,7.1280470000000005
5378,2012,Junio,República de Irlanda,0,1,,1,-77.35002,8.63337
5379,2012,Junio,Islandia,5,0,,5,-77.35600000000001,0.81488
5380,2012,Junio,Islandia,5,3,,8,-74.140516,4.697157
5381,2012,Junio,Isla de Man,22,26,,48,-77.35600000000001,0.81488
5382,2012,Junio,Isla de Man,5,15,,20,-75.516486,10.446304
5383,2012,Junio,Isla de Man,2,8,,10,-74.77647900000001,10.886686
5384,2012,Junio,Isla de Man,0,1,,1,-81.70216500000001,12.5862
5385,2012,Junio,Isla de Man,6,11,,17,-76.532004,3.451668
5386,2012,Junio,Isla de Man,44,107,,151,-74.140516,4.697157
5387,2012,Junio,Isla de Man,0,1,,1,-75.736374,4.815189
5388,2012,Junio,Isla de Man,8,27,,35,-75.42726,6.170465
5389,2012,Junio,Isla de Man,1,1,,2,-72.508188,7.927233
5390,2012,Junio,Israel,0,9,,9,-69.941498,4.191162
5391,2012,Junio,Israel,27,97,,124,-77.35600000000001,0.81488
5392,2012,Junio,Israel,0,1,,1,-75.527794,10.406342
5393,2012,Junio,Israel,2,17,,19,-75.516486,10.446304
5394,2012,Junio,Israel,0,4,,4,-74.77647900000001,10.886686
5395,2012,Junio,Israel,0,1,,1,-72.129595,11.360028999999999
5396,2012,Junio,Israel,1,1,,2,-81.70216500000001,12.5862
5397,2012,Junio,Israel,6,12,,18,-76.532004,3.451668
5398,2012,Junio,Israel,106,492,,598,-74.140516,4.697157
5399,2012,Junio,Israel,7,44,,51,-75.42726,6.170465
5400,2012,Junio,Israel,0,1,,1,-77.35002,8.63337
5401,2012,Junio,Islas Aland/Provincia de Finlandia,0,1,,1,-74.140516,4.697157
5402,2012,Junio,Italia,1,9,,10,-69.941498,4.191162
5403,2012,Junio,Italia,6,20,,26,-77.35600000000001,0.81488
5404,2012,Junio,Italia,0,4,,4,-75.527794,10.406342
5405,2012,Junio,Italia,17,66,,83,-75.516486,10.446304
5406,2012,Junio,Italia,1,13,,14,-74.77647900000001,10.886686
5407,2012,Junio,Italia,1,4,,5,-72.129595,11.360028999999999
5408,2012,Junio,Italia,12,10,,22,-81.70216500000001,12.5862
5409,2012,Junio,Italia,27,74,,101,-76.532004,3.451668
5410,2012,Junio,Italia,0,1,,1,-77.061029,3.8844260000000004
5411,2012,Junio,Italia,450,1402,,1852,-74.140516,4.697157
5412,2012,Junio,Italia,1,0,,1,-75.736374,4.815189
5413,2012,Junio,Italia,19,73,,92,-75.42726,6.170465
5414,2012,Junio,Italia,0,13,,13,-72.453013,7.819
5415,2012,Junio,Italia,2,3,,5,-72.508188,7.927233
5416,2012,Junio,Italia,0,1,,1,-77.35002,8.63337
5417,2012,Junio,Islas del Canal,0,1,,1,-74.140516,4.697157
5418,2012,Junio,Jamaica,3,8,,11,-75.516486,10.446304
5419,2012,Junio,Jamaica,0,1,,1,-74.77647900000001,10.886686
5420,2012,Junio,Jamaica,0,1,,1,-72.129595,11.360028999999999
5421,2012,Junio,Jamaica,2,7,,9,-81.70216500000001,12.5862
5422,2012,Junio,Jamaica,0,2,,2,-76.532004,3.451668
5423,2012,Junio,Jamaica,0,1,,1,-75.76635300000001,4.45285
5424,2012,Junio,Jamaica,9,28,,37,-74.140516,4.697157
5425,2012,Junio,Jamaica,0,3,,3,-75.42726,6.170465
5426,2012,Junio,Jamaica,0,1,,1,-72.453013,7.819
5427,2012,Junio,Jamaica,1,0,,1,-72.508188,7.927233
5428,2012,Junio,Islas Salomón,0,1,,1,-72.453013,7.819
5429,2012,Junio,Japón,0,2,,2,-69.941498,4.191162
5430,2012,Junio,Japón,11,8,,19,-77.35600000000001,0.81488
5431,2012,Junio,Japón,26,21,,47,-75.527794,10.406342
5432,2012,Junio,Japón,5,9,,14,-75.516486,10.446304
5433,2012,Junio,Japón,0,7,,7,-74.77647900000001,10.886686
5434,2012,Junio,Japón,0,1,,1,-72.129595,11.360028999999999
5435,2012,Junio,Japón,1,0,,1,-81.70216500000001,12.5862
5436,2012,Junio,Japón,4,19,,23,-76.532004,3.451668
5437,2012,Junio,Japón,111,401,,512,-74.140516,4.697157
5438,2012,Junio,Japón,1,0,,1,-75.736374,4.815189
5439,2012,Junio,Japón,5,19,,24,-75.42726,6.170465
5440,2012,Junio,Japón,3,4,,7,-72.453013,7.819
5441,2012,Junio,Jordania,0,5,,5,-74.140516,4.697157
5442,2012,Junio,Kazajistán,3,0,,3,-74.140516,4.697157
5443,2012,Junio,Kazajistán,1,1,,2,-75.42726,6.170465
5444,2012,Junio,Kenia,5,20,,25,-74.140516,4.697157
5445,2012,Junio,Kenia,1,2,,3,-72.453013,7.819
5446,2012,Junio,Kuwait,0,7,,7,-74.140516,4.697157
5447,2012,Junio,República de Kosovo,1,0,,1,-74.140516,4.697157
5448,2012,Junio,República Democrática Popular  Lao,0,2,,2,-74.140516,4.697157
5449,2012,Junio,Letonia,0,2,,2,-77.35600000000001,0.81488
5450,2012,Junio,Letonia,3,6,,9,-74.140516,4.697157
5451,2012,Junio,Letonia,2,0,,2,-75.42726,6.170465
5452,2012,Junio,Lituania,0,1,,1,-77.35600000000001,0.81488
5453,2012,Junio,Lituania,3,1,,4,-76.532004,3.451668
5454,2012,Junio,Lituania,3,3,,6,-74.140516,4.697157
5455,2012,Junio,Líbano,0,3,,3,-74.77647900000001,10.886686
5456,2012,Junio,Líbano,1,4,,5,-72.129595,11.360028999999999
5457,2012,Junio,Líbano,0,1,,1,-81.70216500000001,12.5862
5458,2012,Junio,Líbano,0,1,,1,-76.532004,3.451668
5459,2012,Junio,Líbano,10,27,,37,-74.140516,4.697157
5460,2012,Junio,Líbano,0,1,,1,-72.453013,7.819
5461,2012,Junio,Liberia,0,2,,2,-74.140516,4.697157
5462,2012,Junio,Libia,0,1,,1,-77.35600000000001,0.81488
5463,2012,Junio,Libia,0,2,,2,-74.140516,4.697157
5464,2012,Junio,Luxemburgo,0,2,,2,-75.516486,10.446304
5465,2012,Junio,Luxemburgo,1,0,,1,-76.532004,3.451668
5466,2012,Junio,Luxemburgo,2,9,,11,-74.140516,4.697157
5467,2012,Junio,Luxemburgo,0,1,,1,-75.42726,6.170465
5468,2012,Junio,Macedonia,0,1,,1,-77.35600000000001,0.81488
5469,2012,Junio,Macedonia,1,0,,1,-74.77647900000001,10.886686
5470,2012,Junio,Macedonia,2,1,,3,-74.140516,4.697157
5471,2012,Junio,Madagascar,1,1,,2,-74.140516,4.697157
5472,2012,Junio,Malasia,0,3,,3,-75.516486,10.446304
5473,2012,Junio,Malasia,10,24,,34,-74.140516,4.697157
5474,2012,Junio,Malasia,1,0,,1,-75.42726,6.170465
5475,2012,Junio,Malta,1,0,,1,-76.532004,3.451668
5476,2012,Junio,Malta,1,1,,2,-74.140516,4.697157
5477,2012,Junio,Marruecos,0,1,,1,-75.516486,10.446304
5478,2012,Junio,Marruecos,1,0,,1,-76.532004,3.451668
5479,2012,Junio,Marruecos,2,5,,7,-74.140516,4.697157
5480,2012,Junio,Mauricio,0,1,,1,-74.140516,4.697157
5481,2012,Junio,Mauritania,0,1,,1,-74.77647900000001,10.886686
5482,2012,Junio,Mauritania,0,1,,1,-74.140516,4.697157
5483,2012,Junio,México,0,1,,1,-69.941498,4.191162
5484,2012,Junio,México,2,9,,11,-77.35600000000001,0.81488
5485,2012,Junio,México,0,3,,3,-78.802679,18.00143
5486,2012,Junio,México,1,6,,7,-75.527794,10.406342
5487,2012,Junio,México,77,118,,195,-75.516486,10.446304
5488,2012,Junio,México,13,34,,47,-74.77647900000001,10.886686
5489,2012,Junio,México,0,11,,11,-72.129595,11.360028999999999
5490,2012,Junio,México,0,2,,2,-81.703935,12.574411099999999
5491,2012,Junio,México,5,4,,9,-81.70216500000001,12.5862
5492,2012,Junio,México,21,70,,91,-76.532004,3.451668
5493,2012,Junio,México,0,1,,1,-77.061029,3.8844260000000004
5494,2012,Junio,México,0,1,,1,-75.76635300000001,4.45285
5495,2012,Junio,México,1680,3875,,5555,-74.140516,4.697157
5496,2012,Junio,México,1,15,,16,-75.736374,4.815189
5497,2012,Junio,México,109,278,,387,-75.42726,6.170465
5498,2012,Junio,México,1,2,,3,-67.48402800000001,6.185536
5499,2012,Junio,México,0,1,,1,-70.74025300000001,7.088728999999999
5500,2012,Junio,México,2,6,,8,-73.181317,7.1280470000000005
5501,2012,Junio,México,10,26,,36,-72.453013,7.819
5502,2012,Junio,México,2,8,,10,-72.508188,7.927233
5503,2012,Junio,República de Moldavia,1,0,,1,-75.42726,6.170465
5504,2012,Junio,Mónaco,0,1,,1,-74.140516,4.697157
5505,2012,Junio,Mongolia,1,0,,1,-75.76635300000001,4.45285
5506,2012,Junio,Mozambique,0,2,,2,-74.140516,4.697157
5507,2012,Junio,Namibia,0,1,,1,-74.140516,4.697157
5508,2012,Junio,Nepal,0,3,,3,-74.140516,4.697157
5509,2012,Junio,Nicaragua,0,1,,1,-75.527794,10.406342
5510,2012,Junio,Nicaragua,2,4,,6,-75.516486,10.446304
5511,2012,Junio,Nicaragua,0,5,,5,-74.77647900000001,10.886686
5512,2012,Junio,Nicaragua,2,2,,4,-81.703935,12.574411099999999
5513,2012,Junio,Nicaragua,2,5,,7,-76.532004,3.451668
5514,2012,Junio,Nicaragua,47,68,,115,-74.140516,4.697157
5515,2012,Junio,Nicaragua,2,0,,2,-75.736374,4.815189
5516,2012,Junio,Nicaragua,13,13,,26,-75.42726,6.170465
5517,2012,Junio,Nigeria,0,2,,2,-75.516486,10.446304
5518,2012,Junio,Nigeria,4,10,,14,-74.140516,4.697157
5519,2012,Junio,Nigeria,0,1,,1,-72.453013,7.819
5520,2012,Junio,Noruega,0,2,,2,-69.941498,4.191162
5521,2012,Junio,Noruega,4,5,,9,-77.35600000000001,0.81488
5522,2012,Junio,Noruega,1,1,,2,-75.527794,10.406342
5523,2012,Junio,Noruega,6,7,,13,-75.516486,10.446304
5524,2012,Junio,Noruega,2,0,,2,-74.77647900000001,10.886686
5525,2012,Junio,Noruega,0,3,,3,-72.129595,11.360028999999999
5526,2012,Junio,Noruega,9,15,,24,-76.532004,3.451668
5527,2012,Junio,Noruega,105,172,,277,-74.140516,4.697157
5528,2012,Junio,Noruega,2,0,,2,-75.736374,4.815189
5529,2012,Junio,Noruega,14,15,,29,-75.42726,6.170465
5530,2012,Junio,Noruega,0,1,,1,-73.181317,7.1280470000000005
5531,2012,Junio,Nueva Zelanda,1,1,,2,-69.941498,4.191162
5532,2012,Junio,Nueva Zelanda,7,10,,17,-77.35600000000001,0.81488
5533,2012,Junio,Nueva Zelanda,2,3,,5,-75.516486,10.446304
5534,2012,Junio,Nueva Zelanda,0,1,,1,-74.77647900000001,10.886686
5535,2012,Junio,Nueva Zelanda,0,1,,1,-72.129595,11.360028999999999
5536,2012,Junio,Nueva Zelanda,1,1,,2,-76.532004,3.451668
5537,2012,Junio,Nueva Zelanda,37,61,,98,-74.140516,4.697157
5538,2012,Junio,Nueva Zelanda,0,1,,1,-75.736374,4.815189
5539,2012,Junio,Nueva Zelanda,5,7,,12,-75.42726,6.170465
5540,2012,Junio,Nueva Zelanda,1,0,,1,-72.453013,7.819
5541,2012,Junio,Omán,0,1,,1,-75.516486,10.446304
5542,2012,Junio,Nueva Zelanda,4,4,,8,-75.527794,10.406342
5543,2012,Junio,Nueva Zelanda,4,7,,11,-74.140516,4.697157
5544,2012,Junio,Países Bajos,0,1,,1,-69.941498,4.191162
5545,2012,Junio,Países Bajos,5,11,,16,-77.35600000000001,0.81488
5546,2012,Junio,Países Bajos,2,6,,8,-75.516486,10.446304
5547,2012,Junio,Países Bajos,10,6,,16,-74.77647900000001,10.886686
5548,2012,Junio,Países Bajos,5,1,,6,-72.129595,11.360028999999999
5549,2012,Junio,Países Bajos,17,18,,35,-72.919186,11.52863
5550,2012,Junio,Países Bajos,5,13,,18,-76.532004,3.451668
5551,2012,Junio,Países Bajos,0,1,,1,-77.061029,3.8844260000000004
5552,2012,Junio,Países Bajos,202,284,,486,-74.140516,4.697157
5553,2012,Junio,Países Bajos,2,0,,2,-75.736374,4.815189
5554,2012,Junio,Países Bajos,166,182,,348,-75.42726,6.170465
5555,2012,Junio,Países Bajos,5,3,,8,-73.181317,7.1280470000000005
5556,2012,Junio,Pakistán,0,13,,13,-74.140516,4.697157
5557,2012,Junio,Pakistán,0,1,,1,-72.453013,7.819
5558,2012,Junio,Panamá,2,1,,3,-77.35600000000001,0.81488
5559,2012,Junio,Panamá,0,3,,3,-75.527794,10.406342
5560,2012,Junio,Panamá,79,147,,226,-75.516486,10.446304
5561,2012,Junio,Panamá,39,79,,118,-74.77647900000001,10.886686
5562,2012,Junio,Panamá,0,4,,4,-72.129595,11.360028999999999
5563,2012,Junio,Panamá,0,4,,4,-81.703935,12.574411099999999
5564,2012,Junio,Panamá,49,59,,108,-81.70216500000001,12.5862
5565,2012,Junio,Panamá,69,108,,177,-76.532004,3.451668
5566,2012,Junio,Panamá,443,735,,1178,-74.140516,4.697157
5567,2012,Junio,Panamá,49,68,,117,-75.736374,4.815189
5568,2012,Junio,Panamá,65,186,,251,-75.42726,6.170465
5569,2012,Junio,Panamá,3,1,,4,-77.401154,6.222551999999999
5570,2012,Junio,Panamá,0,1,,1,-70.74025300000001,7.088728999999999
5571,2012,Junio,Panamá,2,9,,11,-73.181317,7.1280470000000005
5572,2012,Junio,Panamá,0,1,,1,-72.453013,7.819
5573,2012,Junio,Panamá,5,7,,12,-72.508188,7.927233
5574,2012,Junio,Panamá,1,1,,2,-77.35002,8.63337
5575,2012,Junio,Papúa Nueva Guinea,1,2,,3,-74.140516,4.697157
5576,2012,Junio,Paraguay,1,5,,6,-77.35600000000001,0.81488
5577,2012,Junio,Paraguay,9,9,,18,-75.516486,10.446304
5578,2012,Junio,Paraguay,2,0,,2,-74.77647900000001,10.886686
5579,2012,Junio,Paraguay,1,1,,2,-72.129595,11.360028999999999
5580,2012,Junio,Paraguay,4,2,,6,-76.532004,3.451668
5581,2012,Junio,Paraguay,144,269,,413,-74.140516,4.697157
5582,2012,Junio,Paraguay,5,9,,14,-75.42726,6.170465
5583,2012,Junio,Paraguay,1,0,,1,-70.74025300000001,7.088728999999999
5584,2012,Junio,Paraguay,1,1,,2,-72.453013,7.819
5585,2012,Junio,Perú,15,22,,37,-69.941498,4.191162
5586,2012,Junio,Perú,3,1,,4,-76.876446,0.33002
5587,2012,Junio,Perú,133,288,,421,-77.35600000000001,0.81488
5588,2012,Junio,Perú,0,4,,4,-75.527794,10.406342
5589,2012,Junio,Perú,166,136,,302,-75.516486,10.446304
5590,2012,Junio,Perú,6,12,,18,-74.77647900000001,10.886686
5591,2012,Junio,Perú,5,7,,12,-72.129595,11.360028999999999
5592,2012,Junio,Perú,319,209,,528,-81.70216500000001,12.5862
5593,2012,Junio,Perú,46,97,,143,-76.532004,3.451668
5594,2012,Junio,Perú,0,1,,1,-77.061029,3.8844260000000004
5595,2012,Junio,Perú,1,0,,1,-75.76635300000001,4.45285
5596,2012,Junio,Perú,1850,2853,,4703,-74.140516,4.697157
5597,2012,Junio,Perú,0,3,,3,-75.736374,4.815189
5598,2012,Junio,Perú,86,198,,284,-75.42726,6.170465
5599,2012,Junio,Perú,0,1,,1,-67.48402800000001,6.185536
5600,2012,Junio,Perú,2,2,,4,-73.181317,7.1280470000000005
5601,2012,Junio,Perú,22,55,,77,-72.453013,7.819
5602,2012,Junio,Perú,0,1,,1,-72.508188,7.927233
5603,2012,Junio,Perú,0,1,,1,-75.68164200000001,9.402597
5604,2012,Junio,Palestina,1,1,,2,-74.140516,4.697157
5605,2012,Junio,Polonia,1,1,,2,-69.941498,4.191162
5606,2012,Junio,Polonia,5,5,,10,-77.35600000000001,0.81488
5607,2012,Junio,Polonia,2,8,,10,-75.527794,10.406342
5608,2012,Junio,Polonia,2,2,,4,-75.516486,10.446304
5609,2012,Junio,Polonia,0,3,,3,-74.765343,10.970933
5610,2012,Junio,Polonia,2,2,,4,-74.213989,11.247722999999999
5611,2012,Junio,Polonia,4,3,,7,-72.129595,11.360028999999999
5612,2012,Junio,Polonia,2,1,,3,-76.532004,3.451668
5613,2012,Junio,Polonia,54,76,,130,-74.140516,4.697157
5614,2012,Junio,Polonia,6,6,,12,-72.453013,7.819
5615,2012,Junio,Portugal,0,1,,1,-69.941498,4.191162
5616,2012,Junio,Portugal,1,0,,1,-77.35600000000001,0.81488
5617,2012,Junio,Portugal,2,4,,6,-75.527794,10.406342
5618,2012,Junio,Portugal,3,5,,8,-75.516486,10.446304
5619,2012,Junio,Portugal,1,1,,2,-74.77647900000001,10.886686
5620,2012,Junio,Portugal,1,3,,4,-72.129595,11.360028999999999
5621,2012,Junio,Portugal,3,9,,12,-76.532004,3.451668
5622,2012,Junio,Portugal,69,319,,388,-74.140516,4.697157
5623,2012,Junio,Portugal,3,15,,18,-75.42726,6.170465
5624,2012,Junio,Portugal,1,2,,3,-72.453013,7.819
5625,2012,Junio,Portugal,1,2,,3,-72.508188,7.927233
5626,2012,Junio,Puerto Rico/Territorio de Estados Unidos,3,6,,9,-75.516486,10.446304
5627,2012,Junio,Puerto Rico/Territorio de Estados Unidos,0,2,,2,-74.77647900000001,10.886686
5628,2012,Junio,Puerto Rico/Territorio de Estados Unidos,1,3,,4,-76.532004,3.451668
5629,2012,Junio,Puerto Rico/Territorio de Estados Unidos,0,1,,1,-75.42726,6.170465
5630,2012,Junio,Reino Unido de Gran Bretaña e Irlanda del Norte,6,14,,20,-69.941498,4.191162
5631,2012,Junio,Reino Unido de Gran Bretaña e Irlanda del Norte,10,21,,31,-77.35600000000001,0.81488
5632,2012,Junio,Reino Unido de Gran Bretaña e Irlanda del Norte,10,25,,35,-75.516486,10.446304
5633,2012,Junio,Reino Unido de Gran Bretaña e Irlanda del Norte,3,9,,12,-72.129595,11.360028999999999
5634,2012,Junio,Reino Unido de Gran Bretaña e Irlanda del Norte,0,1,,1,-81.70216500000001,12.5862
5635,2012,Junio,Reino Unido de Gran Bretaña e Irlanda del Norte,4,15,,19,-76.532004,3.451668
5636,2012,Junio,Reino Unido de Gran Bretaña e Irlanda del Norte,188,440,,628,-74.140516,4.697157
5637,2012,Junio,Reino Unido de Gran Bretaña e Irlanda del Norte,0,1,,1,-75.736374,4.815189
5638,2012,Junio,Reino Unido de Gran Bretaña e Irlanda del Norte,10,25,,35,-75.42726,6.170465
5639,2012,Junio,Reino Unido de Gran Bretaña e Irlanda del Norte,0,1,,1,-72.453013,7.819
5640,2012,Junio,República de Belarús,0,2,,2,-74.140516,4.697157
5641,2012,Junio,República de Belarús,0,2,,2,-75.42726,6.170465
5642,2012,Junio,República Dominicana,2,6,,8,-77.35600000000001,0.81488
5643,2012,Junio,República Dominicana,24,40,,64,-75.516486,10.446304
5644,2012,Junio,República Dominicana,6,9,,15,-74.77647900000001,10.886686
5645,2012,Junio,República Dominicana,0,1,,1,-72.129595,11.360028999999999
5646,2012,Junio,República Dominicana,21,34,,55,-76.532004,3.451668
5647,2012,Junio,República Dominicana,203,318,,521,-74.140516,4.697157
5648,2012,Junio,República Dominicana,1,0,,1,-75.736374,4.815189
5649,2012,Junio,República Dominicana,23,56,,79,-75.42726,6.170465
5650,2012,Junio,República Dominicana,3,0,,3,-73.181317,7.1280470000000005
5651,2012,Junio,República Dominicana,1,2,,3,-72.453013,7.819
5652,2012,Junio,República Dominicana,7,8,,15,-72.508188,7.927233
5653,2012,Junio,República Checa,0,2,,2,-75.527794,10.406342
5654,2012,Junio,República Checa,0,1,,1,-74.213989,11.247722999999999
5655,2012,Junio,República Checa,4,2,,6,-74.140516,4.697157
5656,2012,Junio,Rumania,0,2,,2,-77.35600000000001,0.81488
5657,2012,Junio,Rumania,0,4,,4,-75.527794,10.406342
5658,2012,Junio,Rumania,1,1,,2,-75.516486,10.446304
5659,2012,Junio,Rumania,3,4,,7,-76.532004,3.451668
5660,2012,Junio,Rumania,11,38,,49,-74.140516,4.697157
5661,2012,Junio,Rumania,1,4,,5,-75.42726,6.170465
5662,2012,Junio,Rumania,1,0,,1,-72.453013,7.819
5663,2012,Junio,Federación de Rusia,0,1,,1,-69.941498,4.191162
5664,2012,Junio,Federación de Rusia,6,6,,12,-77.35600000000001,0.81488
5665,2012,Junio,Federación de Rusia,0,2,,2,-75.527794,10.406342
5666,2012,Junio,Federación de Rusia,0,1,,1,-75.516486,10.446304
5667,2012,Junio,Federación de Rusia,1,3,,4,-72.129595,11.360028999999999
5668,2012,Junio,Federación de Rusia,0,1,,1,-76.532004,3.451668
5669,2012,Junio,Federación de Rusia,0,1,,1,-77.061029,3.8844260000000004
5670,2012,Junio,Federación de Rusia,32,48,,80,-74.140516,4.697157
5671,2012,Junio,Federación de Rusia,3,0,,3,-75.42726,6.170465
5672,2012,Junio,Rwanda,1,0,,1,-74.140516,4.697157
5673,2012,Junio,San Cristóbal y Nevis,0,6,,6,-74.140516,4.697157
5674,2012,Junio,Santa Lucia,0,1,,1,-74.77647900000001,10.886686
5675,2012,Junio,Santa Lucia,1,2,,3,-74.140516,4.697157
5676,2012,Junio,Santa Lucia,0,1,,1,-75.42726,6.170465
5677,2012,Junio,Santa Lucia,1,1,,2,-73.181317,7.1280470000000005
5678,2012,Junio,Santa Sede/Ciudad del Vaticano,0,1,,1,-74.140516,4.697157
5679,2012,Junio,Senegal,0,2,,2,-74.140516,4.697157
5680,2012,Junio,Serbia,2,1,,3,-77.35600000000001,0.81488
5681,2012,Junio,Serbia,0,4,,4,-74.140516,4.697157
5682,2012,Junio,Sierra Leona,2,0,,2,-74.140516,4.697157
5683,2012,Junio,Singapur,0,1,,1,-74.77647900000001,10.886686
5684,2012,Junio,Singapur,0,1,,1,-76.532004,3.451668
5685,2012,Junio,Singapur,6,10,,16,-74.140516,4.697157
5686,2012,Junio,Singapur,1,0,,1,-75.42726,6.170465
5687,2012,Junio,República Árabe Siria,0,1,,1,-72.129595,11.360028999999999
5688,2012,Junio,República Árabe Siria,0,1,,1,-74.140516,4.697157
5689,2012,Junio,República Árabe Siria,0,1,,1,-72.453013,7.819
5690,2012,Junio,Somalia,0,1,,1,-74.140516,4.697157
5691,2012,Junio,Sri Lanka,1,0,,1,-75.516486,10.446304
5692,2012,Junio,Sri Lanka,1,0,,1,-74.140516,4.697157
5693,2012,Junio,Sudáfrica,3,3,,6,-75.527794,10.406342
5694,2012,Junio,Sudáfrica,3,3,,6,-75.516486,10.446304
5695,2012,Junio,Sudáfrica,0,6,,6,-74.77647900000001,10.886686
5696,2012,Junio,Sudáfrica,0,5,,5,-74.765343,10.970933
5697,2012,Junio,Sudáfrica,0,2,,2,-72.129595,11.360028999999999
5698,2012,Junio,Sudáfrica,16,75,,91,-74.140516,4.697157
5699,2012,Junio,Sudáfrica,0,1,,1,-75.42726,6.170465
5700,2012,Junio,Sudáfrica,0,1,,1,-73.181317,7.1280470000000005
5701,2012,Junio,Sudán,0,2,,2,-74.140516,4.697157
5702,2012,Junio,Suecia,0,3,,3,-69.941498,4.191162
5703,2012,Junio,Suecia,3,3,,6,-77.35600000000001,0.81488
5704,2012,Junio,Suecia,4,6,,10,-75.527794,10.406342
5705,2012,Junio,Suecia,3,6,,9,-75.516486,10.446304
5706,2012,Junio,Suecia,1,2,,3,-74.77647900000001,10.886686
5707,2012,Junio,Suecia,0,1,,1,-74.213989,11.247722999999999
5708,2012,Junio,Suecia,0,2,,2,-72.129595,11.360028999999999
5709,2012,Junio,Suecia,12,18,,30,-76.532004,3.451668
5710,2012,Junio,Suecia,189,216,,405,-74.140516,4.697157
5711,2012,Junio,Suecia,12,19,,31,-75.42726,6.170465
5712,2012,Junio,Suecia,0,7,,7,-72.453013,7.819
5713,2012,Junio,Suiza,2,7,,9,-69.941498,4.191162
5714,2012,Junio,Suiza,23,23,,46,-77.35600000000001,0.81488
5715,2012,Junio,Suiza,12,9,,21,-75.527794,10.406342
5716,2012,Junio,Suiza,8,10,,18,-75.516486,10.446304
5717,2012,Junio,Suiza,5,6,,11,-74.77647900000001,10.886686
5718,2012,Junio,Suiza,1,2,,3,-72.129595,11.360028999999999
5719,2012,Junio,Suiza,13,14,,27,-76.532004,3.451668
5720,2012,Junio,Suiza,279,461,,740,-74.140516,4.697157
5721,2012,Junio,Suiza,0,1,,1,-75.736374,4.815189
5722,2012,Junio,Suiza,6,35,,41,-75.42726,6.170465
5723,2012,Junio,Suiza,0,2,,2,-73.181317,7.1280470000000005
5724,2012,Junio,Suiza,2,2,,4,-72.453013,7.819
5725,2012,Junio,Suiza,1,1,,2,-72.508188,7.927233
5726,2012,Junio,Surinam,5,16,,21,-74.140516,4.697157
5727,2012,Junio,Surinam,0,5,,5,-75.42726,6.170465
5728,2012,Junio,Taiwán,0,2,,2,-75.527794,10.406342
5729,2012,Junio,Taiwán,0,1,,1,-75.516486,10.446304
5730,2012,Junio,Taiwán,1,4,,5,-74.140516,4.697157
5731,2012,Junio,Taiwán,0,1,,1,-75.42726,6.170465
5732,2012,Junio,Tailandia,1,0,,1,-75.516486,10.446304
5733,2012,Junio,Tailandia,3,5,,8,-74.140516,4.697157
5734,2012,Junio,Tíbet/Región Autónoma de China,0,2,,2,-74.140516,4.697157
5735,2012,Junio,Territorio Antártico Británico/Territorio Británico de Ultramar,2,4,,6,-74.140516,4.697157
5736,2012,Junio,Tanzania,1,5,,6,-74.140516,4.697157
5737,2012,Junio,Trinidad y Tobago,2,36,,38,-75.516486,10.446304
5738,2012,Junio,Trinidad y Tobago,0,2,,2,-74.77647900000001,10.886686
5739,2012,Junio,Trinidad y Tobago,0,1,,1,-81.70216500000001,12.5862
5740,2012,Junio,Trinidad y Tobago,0,1,,1,-76.532004,3.451668
5741,2012,Junio,Trinidad y Tobago,12,61,,73,-74.140516,4.697157
5742,2012,Junio,Trinidad y Tobago,0,1,,1,-75.736374,4.815189
5743,2012,Junio,Trinidad y Tobago,4,11,,15,-75.42726,6.170465
5744,2012,Junio,Túnez,2,0,,2,-76.532004,3.451668
5745,2012,Junio,Túnez,0,4,,4,-74.140516,4.697157
5746,2012,Junio,Turquía,0,2,,2,-77.35600000000001,0.81488
5747,2012,Junio,Turquía,0,1,,1,-75.527794,10.406342
5748,2012,Junio,Turquía,0,1,,1,-75.516486,10.446304
5749,2012,Junio,Turquía,0,3,,3,-74.77647900000001,10.886686
5750,2012,Junio,Turquía,0,3,,3,-74.765343,10.970933
5751,2012,Junio,Turquía,0,3,,3,-72.129595,11.360028999999999
5752,2012,Junio,Turquía,0,1,,1,-76.532004,3.451668
5753,2012,Junio,Turquía,16,71,,87,-74.140516,4.697157
5754,2012,Junio,Turquía,1,2,,3,-75.42726,6.170465
5755,2012,Junio,Ucrania,1,0,,1,-76.532004,3.451668
5756,2012,Junio,Ucrania,16,11,,27,-74.140516,4.697157
5757,2012,Junio,Uganda,1,3,,4,-74.140516,4.697157
5758,2012,Junio,Federación de Rusia,0,1,,1,-77.35600000000001,0.81488
5759,2012,Junio,Federación de Rusia,1,1,,2,-75.516486,10.446304
5760,2012,Junio,Federación de Rusia,0,2,,2,-74.765343,10.970933
5761,2012,Junio,Federación de Rusia,0,3,,3,-74.213989,11.247722999999999
5762,2012,Junio,Federación de Rusia,2,2,,4,-72.129595,11.360028999999999
5763,2012,Junio,Federación de Rusia,78,97,,175,-74.140516,4.697157
5764,2012,Junio,Federación de Rusia,1,0,,1,-75.42726,6.170465
5765,2012,Junio,Federación de Rusia,3,3,,6,-72.453013,7.819
5766,2012,Junio,Federación de Rusia,1,0,,1,-72.508188,7.927233
5767,2012,Junio,Uruguay,3,8,,11,-77.35600000000001,0.81488
5768,2012,Junio,Uruguay,84,71,,155,-75.516486,10.446304
5769,2012,Junio,Uruguay,0,5,,5,-74.77647900000001,10.886686
5770,2012,Junio,Uruguay,1,0,,1,-72.129595,11.360028999999999
5771,2012,Junio,Uruguay,69,47,,116,-81.70216500000001,12.5862
5772,2012,Junio,Uruguay,4,13,,17,-76.532004,3.451668
5773,2012,Junio,Uruguay,0,2,,2,-75.76635300000001,4.45285
5774,2012,Junio,Uruguay,144,303,,447,-74.140516,4.697157
5775,2012,Junio,Uruguay,0,10,,10,-75.736374,4.815189
5776,2012,Junio,Uruguay,14,45,,59,-75.42726,6.170465
5777,2012,Junio,Uruguay,5,6,,11,-72.453013,7.819
5778,2012,Junio,Vanuatu,0,1,,1,-74.140516,4.697157
5779,2012,Junio,Venezuela,32,69,,101,-77.35600000000001,0.81488
5780,2012,Junio,Venezuela,0,27,,27,-75.527794,10.406342
5781,2012,Junio,Venezuela,80,122,,202,-75.516486,10.446304
5782,2012,Junio,Venezuela,40,97,,137,-74.77647900000001,10.886686
5783,2012,Junio,Venezuela,0,2,,2,-74.213989,11.247722999999999
5784,2012,Junio,Venezuela,1048,1561,,2609,-72.129595,11.360028999999999
5785,2012,Junio,Venezuela,3,1,,4,-72.919186,11.52863
5786,2012,Junio,Venezuela,11,10,,21,-81.70216500000001,12.5862
5787,2012,Junio,Venezuela,39,50,,89,-76.532004,3.451668
5788,2012,Junio,Venezuela,3770,4979,,8749,-74.140516,4.697157
5789,2012,Junio,Venezuela,3,13,,16,-75.736374,4.815189
5790,2012,Junio,Venezuela,292,362,,654,-75.42726,6.170465
5791,2012,Junio,Venezuela,7,4,,11,-67.48402800000001,6.185536
5792,2012,Junio,Venezuela,59,110,,169,-70.74025300000001,7.088728999999999
5793,2012,Junio,Venezuela,7,10,,17,-73.181317,7.1280470000000005
5794,2012,Junio,Venezuela,1018,1303,,2321,-72.453013,7.819
5795,2012,Junio,Venezuela,186,236,,422,-72.508188,7.927233
5796,2012,Junio,Vietnam,0,5,,5,-75.527794,10.406342
5797,2012,Junio,Vietnam,1,4,,5,-74.140516,4.697157
5798,2012,Junio,Islas Vírgenes Británicas/Territorio Británico de Ultramar,0,1,,1,-74.140516,4.697157
5799,2012,Junio,Zambia,0,6,,6,-74.140516,4.697157
5800,2012,Junio,Zimbabue,2,7,,9,-74.140516,4.697157
5801,2012,Junio,Reino Unido de Gran Bretaña e Irlanda del Norte,1,4,,5,-69.941498,4.191162
5802,2012,Junio,Reino Unido de Gran Bretaña e Irlanda del Norte,50,44,,94,-77.35600000000001,0.81488
5803,2012,Junio,Reino Unido de Gran Bretaña e Irlanda del Norte,11,17,,28,-75.527794,10.406342
5804,2012,Junio,Reino Unido de Gran Bretaña e Irlanda del Norte,7,24,,31,-75.516486,10.446304
5805,2012,Junio,Reino Unido de Gran Bretaña e Irlanda del Norte,2,3,,5,-72.129595,11.360028999999999
5806,2012,Junio,Reino Unido de Gran Bretaña e Irlanda del Norte,0,1,,1,-81.70216500000001,12.5862
5807,2012,Junio,Reino Unido de Gran Bretaña e Irlanda del Norte,1,1,,2,-81.372937,13.338761300000002
5808,2012,Junio,Reino Unido de Gran Bretaña e Irlanda del Norte,8,18,,26,-76.532004,3.451668
5809,2012,Junio,Reino Unido de Gran Bretaña e Irlanda del Norte,252,542,,794,-74.140516,4.697157
5810,2012,Junio,Reino Unido de Gran Bretaña e Irlanda del Norte,1,0,,1,-75.736374,4.815189
5811,2012,Junio,Reino Unido de Gran Bretaña e Irlanda del Norte,9,27,,36,-75.42726,6.170465
5812,2012,Junio,Reino Unido de Gran Bretaña e Irlanda del Norte,2,4,,6,-72.453013,7.819
5813,2012,Junio,Reino Unido de Gran Bretaña e Irlanda del Norte,0,1,,1,-77.35002,8.63337
5814,2012,Junio,Países Bajos,0,3,,3,-69.941498,4.191162
5815,2012,Junio,Países Bajos,15,22,,37,-77.35600000000001,0.81488
5816,2012,Junio,Países Bajos,6,8,,14,-75.527794,10.406342
5817,2012,Junio,Países Bajos,4,24,,28,-75.516486,10.446304
5818,2012,Junio,Países Bajos,7,1,,8,-74.77647900000001,10.886686
5819,2012,Junio,Países Bajos,0,14,,14,-74.213989,11.247722999999999
5820,2012,Junio,Países Bajos,3,2,,5,-72.129595,11.360028999999999
5821,2012,Junio,Países Bajos,18,45,,63,-76.532004,3.451668
5822,2012,Junio,Países Bajos,338,671,,1009,-74.140516,4.697157
5823,2012,Junio,Países Bajos,0,3,,3,-75.736374,4.815189
5824,2012,Junio,Países Bajos,64,85,,149,-75.42726,6.170465
5825,2012,Junio,Países Bajos,4,0,,4,-73.181317,7.1280470000000005
5826,2012,Junio,Países Bajos,4,5,,9,-72.453013,7.819
5827,2012,Junio,Países Bajos,1,0,,1,-77.35002,8.63337
5828,2012,Junio,Eslovenia,1,0,,1,-75.516486,10.446304
5829,2012,Junio,Eslovenia,0,1,,1,-74.140516,4.697157
5830,2012,Junio,Lituania,0,1,,1,-76.532004,3.451668
5831,2012,Junio,Lituania,0,1,,1,-74.140516,4.697157
5832,2012,Junio,Lituania,0,1,,1,-75.42726,6.170465
5833,2012,Junio,Reino Unido de Gran Bretaña e Irlanda del Norte,1,1,,2,-74.213989,11.247722999999999
5834,2012,Junio,Reino Unido de Gran Bretaña e Irlanda del Norte,0,1,,1,-77.35600000000001,0.81488
5835,2012,Junio,Reino Unido de Gran Bretaña e Irlanda del Norte,1,0,,1,-75.516486,10.446304
5836,2012,Junio,Reino Unido de Gran Bretaña e Irlanda del Norte,7,7,,14,-74.140516,4.697157
5837,2012,Junio,Reino Unido de Gran Bretaña e Irlanda del Norte,1,0,,1,-77.35600000000001,0.81488
5838,2012,Junio,Reino Unido de Gran Bretaña e Irlanda del Norte,2,1,,3,-75.527794,10.406342
5839,2012,Junio,Reino Unido de Gran Bretaña e Irlanda del Norte,0,1,,1,-75.516486,10.446304
5840,2012,Junio,Reino Unido de Gran Bretaña e Irlanda del Norte,4,3,,7,-74.140516,4.697157
5841,2012,Junio,República CentroÁfricana,0,1,,1,-74.140516,4.697157
5842,2012,Junio,República CentroÁfricana,0,1,,1,-72.453013,7.819
5843,2012,Julio,Albania,0,4,,4,-74.140516,4.697157
5844,2012,Julio,Alemania,12,14,,26,-69.941498,4.191162
5845,2012,Julio,Alemania,78,97,,175,-77.35600000000001,0.81488
5846,2012,Julio,Alemania,16,15,,31,-75.527794,10.406342
5847,2012,Julio,Alemania,22,48,,70,-75.516486,10.446304
5848,2012,Julio,Alemania,7,10,,17,-74.77647900000001,10.886686
5849,2012,Julio,Alemania,5,12,,17,-72.129595,11.360028999999999
5850,2012,Julio,Alemania,5,5,,10,-81.70216500000001,12.5862
5851,2012,Julio,Alemania,60,73,,133,-76.532004,3.451668
5852,2012,Julio,Alemania,1425,1967,,3392,-74.140516,4.697157
5853,2012,Julio,Alemania,0,3,,3,-75.736374,4.815189
5854,2012,Julio,Alemania,59,110,,169,-75.42726,6.170465
5855,2012,Julio,Alemania,1,0,,1,-77.401154,6.222551999999999
5856,2012,Julio,Alemania,2,0,,2,-73.181317,7.1280470000000005
5857,2012,Julio,Alemania,10,16,,26,-72.453013,7.819
5858,2012,Julio,Alemania,1,1,,2,-72.508188,7.927233
5859,2012,Julio,Alemania,10,15,,25,-77.35002,8.63337
5860,2012,Julio,Andorra,0,2,,2,-76.532004,3.451668
5861,2012,Julio,Andorra,0,8,,8,-74.140516,4.697157
5862,2012,Julio,Angola,0,1,,1,-74.140516,4.697157
5863,2012,Julio,Antigua y Barbuda,0,1,,1,-74.213989,11.247722999999999
5864,2012,Julio,Antigua y Barbuda,0,1,,1,-74.140516,4.697157
5865,2012,Julio,Antigua y Barbuda,2,0,,2,-75.42726,6.170465
5866,2012,Julio,Países Bajos,14,9,,23,-75.42726,6.170465
5867,2012,Julio,Arabia Saudita,0,1,,1,-75.516486,10.446304
5868,2012,Julio,Arabia Saudita,2,1,,3,-74.140516,4.697157
5869,2012,Julio,Arabia Saudita,0,1,,1,-74.140516,4.697157
5870,2012,Julio,Argelia,0,1,,1,-76.532004,3.451668
5871,2012,Julio,Argelia,1,2,,3,-74.140516,4.697157
5872,2012,Julio,Argentina,1,12,,13,-69.941498,4.191162
5873,2012,Julio,Argentina,2,3,,5,-76.876446,0.33002
5874,2012,Julio,Argentina,61,121,,182,-77.35600000000001,0.81488
5875,2012,Julio,Argentina,1,7,,8,-75.527794,10.406342
5876,2012,Julio,Argentina,411,362,,773,-75.516486,10.446304
5877,2012,Julio,Argentina,4,18,,22,-74.77647900000001,10.886686
5878,2012,Julio,Argentina,1,1,,2,-74.213989,11.247722999999999
5879,2012,Julio,Argentina,17,16,,33,-72.129595,11.360028999999999
5880,2012,Julio,Argentina,180,135,,315,-81.70216500000001,12.5862
5881,2012,Julio,Argentina,46,76,,122,-76.532004,3.451668
5882,2012,Julio,Argentina,0,3,,3,-75.76635300000001,4.45285
5883,2012,Julio,Argentina,2875,4287,,7162,-74.140516,4.697157
5884,2012,Julio,Argentina,0,1,,1,-75.736374,4.815189
5885,2012,Julio,Argentina,112,163,,275,-75.42726,6.170465
5886,2012,Julio,Argentina,0,2,,2,-67.48402800000001,6.185536
5887,2012,Julio,Argentina,3,17,,20,-73.181317,7.1280470000000005
5888,2012,Julio,Argentina,21,53,,74,-72.453013,7.819
5889,2012,Julio,Argentina,1,8,,9,-72.508188,7.927233
5890,2012,Julio,Argentina,5,10,,15,-77.35002,8.63337
5891,2012,Julio,Aruba,1,0,,1,-74.77647900000001,10.886686
5892,2012,Julio,Aruba,0,1,,1,-76.532004,3.451668
5893,2012,Julio,Aruba,1,4,,5,-74.140516,4.697157
5894,2012,Julio,Aruba,4,3,,7,-75.42726,6.170465
5895,2012,Julio,Australia,3,6,,9,-69.941498,4.191162
5896,2012,Julio,Australia,44,57,,101,-77.35600000000001,0.81488
5897,2012,Julio,Australia,17,18,,35,-75.527794,10.406342
5898,2012,Julio,Australia,24,38,,62,-75.516486,10.446304
5899,2012,Julio,Australia,3,9,,12,-74.77647900000001,10.886686
5900,2012,Julio,Australia,0,1,,1,-74.213989,11.247722999999999
5901,2012,Julio,Australia,1,3,,4,-72.129595,11.360028999999999
5902,2012,Julio,Australia,0,1,,1,-81.372937,13.338761300000002
5903,2012,Julio,Australia,9,18,,27,-76.532004,3.451668
5904,2012,Julio,Australia,216,355,,571,-74.140516,4.697157
5905,2012,Julio,Australia,0,1,,1,-75.736374,4.815189
5906,2012,Julio,Australia,26,32,,58,-75.42726,6.170465
5907,2012,Julio,Australia,0,1,,1,-73.181317,7.1280470000000005
5908,2012,Julio,Australia,2,3,,5,-72.453013,7.819
5909,2012,Julio,Australia,0,1,,1,-72.508188,7.927233
5910,2012,Julio,Australia,4,4,,8,-77.35002,8.63337
5911,2012,Julio,Austria,1,2,,3,-69.941498,4.191162
5912,2012,Julio,Austria,7,14,,21,-77.35600000000001,0.81488
5913,2012,Julio,Austria,4,5,,9,-75.527794,10.406342
5914,2012,Julio,Austria,8,10,,18,-75.516486,10.446304
5915,2012,Julio,Austria,3,7,,10,-72.129595,11.360028999999999
5916,2012,Julio,Austria,2,16,,18,-76.532004,3.451668
5917,2012,Julio,Austria,169,269,,438,-74.140516,4.697157
5918,2012,Julio,Austria,3,6,,9,-75.42726,6.170465
5919,2012,Julio,Austria,0,3,,3,-72.453013,7.819
5920,2012,Julio,Austria,0,3,,3,-77.35002,8.63337
5921,2012,Julio,Azerbaiyán,7,20,,27,-74.140516,4.697157
5922,2012,Julio,Bahamas,0,1,,1,-74.77647900000001,10.886686
5923,2012,Julio,Bahamas,1,1,,2,-76.532004,3.451668
5924,2012,Julio,Bahamas,4,6,,10,-74.140516,4.697157
5925,2012,Julio,Bahamas,2,1,,3,-75.42726,6.170465
5926,2012,Julio,Bahamas,0,1,,1,-72.508188,7.927233
5927,2012,Julio,Bangladesh,0,1,,1,-72.129595,11.360028999999999
5928,2012,Julio,Barbados,0,1,,1,-76.532004,3.451668
5929,2012,Julio,Barbados,5,1,,6,-74.140516,4.697157
5930,2012,Julio,Barbados,1,1,,2,-75.42726,6.170465
5931,2012,Julio,Barbados,1,2,,3,-72.453013,7.819
5932,2012,Julio,República de Belarús,0,1,,1,-74.140516,4.697157
5933,2012,Julio,República de Belarús,0,1,,1,-75.42726,6.170465
5934,2012,Julio,Bélgica,2,3,,5,-69.941498,4.191162
5935,2012,Julio,Bélgica,1,0,,1,-76.876446,0.33002
5936,2012,Julio,Bélgica,7,16,,23,-77.35600000000001,0.81488
5937,2012,Julio,Bélgica,1,2,,3,-75.527794,10.406342
5938,2012,Julio,Bélgica,8,8,,16,-75.516486,10.446304
5939,2012,Julio,Bélgica,2,3,,5,-74.77647900000001,10.886686
5940,2012,Julio,Bélgica,1,2,,3,-72.129595,11.360028999999999
5941,2012,Julio,Bélgica,1,1,,2,-81.70216500000001,12.5862
5942,2012,Julio,Bélgica,12,24,,36,-76.532004,3.451668
5943,2012,Julio,Bélgica,225,390,,615,-74.140516,4.697157
5944,2012,Julio,Bélgica,7,18,,25,-75.42726,6.170465
5945,2012,Julio,Bélgica,3,2,,5,-72.453013,7.819
5946,2012,Julio,Bélgica,0,2,,2,-77.35002,8.63337
5947,2012,Julio,Belice,0,1,,1,-69.941498,4.191162
5948,2012,Julio,Belice,1,0,,1,-77.35600000000001,0.81488
5949,2012,Julio,Belice,1,1,,2,-75.516486,10.446304
5950,2012,Julio,Belice,1,1,,2,-76.532004,3.451668
5951,2012,Julio,Belice,2,13,,15,-74.140516,4.697157
5952,2012,Julio,Belice,1,1,,2,-75.42726,6.170465
5953,2012,Julio,Bermudas/Territorio Británico de Ultramar,0,1,,1,-76.532004,3.451668
5954,2012,Julio,Bermudas/Territorio Británico de Ultramar,0,1,,1,-74.140516,4.697157
5955,2012,Julio,Bermudas/Territorio Británico de Ultramar,0,1,,1,-75.42726,6.170465
5956,2012,Julio,Bolivia,1,1,,2,-69.941498,4.191162
5957,2012,Julio,Bolivia,13,22,,35,-77.35600000000001,0.81488
5958,2012,Julio,Bolivia,6,4,,10,-75.516486,10.446304
5959,2012,Julio,Bolivia,3,1,,4,-74.77647900000001,10.886686
5960,2012,Julio,Bolivia,1,8,,9,-72.129595,11.360028999999999
5961,2012,Julio,Bolivia,4,5,,9,-81.70216500000001,12.5862
5962,2012,Julio,Bolivia,16,17,,33,-76.532004,3.451668
5963,2012,Julio,Bolivia,1,0,,1,-75.76635300000001,4.45285
5964,2012,Julio,Bolivia,307,409,,716,-74.140516,4.697157
5965,2012,Julio,Bolivia,10,20,,30,-75.42726,6.170465
5966,2012,Julio,Bolivia,8,14,,22,-72.453013,7.819
5967,2012,Julio,Bolivia,1,0,,1,-77.35002,8.63337
5968,2012,Julio,Bosnia y Herzegovina,1,0,,1,-72.129595,11.360028999999999
5969,2012,Julio,Bosnia y Herzegovina,0,2,,2,-74.140516,4.697157
5970,2012,Julio,Brasil,76,74,,150,-69.941498,4.191162
5971,2012,Julio,Brasil,19,31,,50,-77.35600000000001,0.81488
5972,2012,Julio,Brasil,124,130,,254,-75.516486,10.446304
5973,2012,Julio,Brasil,17,19,,36,-74.77647900000001,10.886686
5974,2012,Julio,Brasil,12,16,,28,-72.129595,11.360028999999999
5975,2012,Julio,Brasil,25,12,,37,-81.70216500000001,12.5862
5976,2012,Julio,Brasil,40,78,,118,-76.532004,3.451668
5977,2012,Julio,Brasil,3215,4416,,7631,-74.140516,4.697157
5978,2012,Julio,Brasil,3,4,,7,-75.736374,4.815189
5979,2012,Julio,Brasil,42,83,,125,-75.42726,6.170465
5980,2012,Julio,Brasil,0,5,,5,-67.48402800000001,6.185536
5981,2012,Julio,Brasil,1,1,,2,-73.181317,7.1280470000000005
5982,2012,Julio,Brasil,14,22,,36,-72.453013,7.819
5983,2012,Julio,Brasil,1,2,,3,-72.508188,7.927233
5984,2012,Julio,Bulgaria,0,1,,1,-75.527794,10.406342
5985,2012,Julio,Bulgaria,0,1,,1,-76.532004,3.451668
5986,2012,Julio,Bulgaria,7,3,,10,-74.140516,4.697157
5987,2012,Julio,Bulgaria,1,1,,2,-75.42726,6.170465
5988,2012,Julio,Bulgaria,1,0,,1,-72.453013,7.819
5989,2012,Julio,Bulgaria,0,1,,1,-77.35002,8.63337
5990,2012,Julio,Burkina Faso,1,0,,1,-77.35600000000001,0.81488
5991,2012,Julio,Islas Caimán/Territorio Británico de Ultramar,4,10,,14,-81.70216500000001,12.5862
5992,2012,Julio,Camerún,0,1,,1,-74.140516,4.697157
5993,2012,Julio,Canadá,5,7,,12,-69.941498,4.191162
5994,2012,Julio,Canadá,33,27,,60,-77.35600000000001,0.81488
5995,2012,Julio,Canadá,7,9,,16,-75.527794,10.406342
5996,2012,Julio,Canadá,52,81,,133,-75.516486,10.446304
5997,2012,Julio,Canadá,12,21,,33,-74.77647900000001,10.886686
5998,2012,Julio,Canadá,0,1,,1,-74.213989,11.247722999999999
5999,2012,Julio,Canadá,6,7,,13,-72.129595,11.360028999999999
6000,2012,Julio,Canadá,7,4,,11,-81.70216500000001,12.5862
6001,2012,Julio,Canadá,1,4,,5,-81.372937,13.338761300000002
6002,2012,Julio,Canadá,48,43,,91,-76.532004,3.451668
6003,2012,Julio,Canadá,4,7,,11,-75.76635300000001,4.45285
6004,2012,Julio,Canadá,1052,1700,,2752,-74.140516,4.697157
6005,2012,Julio,Canadá,1,4,,5,-75.736374,4.815189
6006,2012,Julio,Canadá,108,158,,266,-75.42726,6.170465
6007,2012,Julio,Canadá,1,4,,5,-73.181317,7.1280470000000005
6008,2012,Julio,Canadá,6,10,,16,-72.453013,7.819
6009,2012,Julio,Canadá,1,3,,4,-72.508188,7.927233
6010,2012,Julio,Canadá,10,3,,13,-77.35002,8.63337
6011,2012,Julio,España,8,16,,24,-77.35600000000001,0.81488
6012,2012,Julio,España,0,1,,1,-75.527794,10.406342
6013,2012,Julio,España,3,14,,17,-75.516486,10.446304
6014,2012,Julio,España,4,10,,14,-74.77647900000001,10.886686
6015,2012,Julio,España,0,1,,1,-81.372937,13.338761300000002
6016,2012,Julio,España,96,145,,241,-76.532004,3.451668
6017,2012,Julio,España,186,390,,576,-74.140516,4.697157
6018,2012,Julio,España,1,9,,10,-75.736374,4.815189
6019,2012,Julio,España,56,98,,154,-75.42726,6.170465
6020,2012,Julio,España,0,1,,1,-73.181317,7.1280470000000005
6021,2012,Julio,España,1,0,,1,-72.453013,7.819
6022,2012,Julio,España,4,0,,4,-72.508188,7.927233
6023,2012,Julio,República Democrática del Congo,1,0,,1,-77.35600000000001,0.81488
6024,2012,Julio,República Democrática del Congo,1,1,,2,-74.140516,4.697157
6025,2012,Julio,República de Corea,2,2,,4,-69.941498,4.191162
6026,2012,Julio,República de Corea,6,4,,10,-77.35600000000001,0.81488
6027,2012,Julio,República de Corea,3,5,,8,-75.516486,10.446304
6028,2012,Julio,República de Corea,3,5,,8,-74.77647900000001,10.886686
6029,2012,Julio,República de Corea,1,3,,4,-76.532004,3.451668
6030,2012,Julio,República de Corea,114,354,,468,-74.140516,4.697157
6031,2012,Julio,República de Corea,0,2,,2,-75.736374,4.815189
6032,2012,Julio,República de Corea,2,14,,16,-75.42726,6.170465
6033,2012,Julio,República de Corea,1,2,,3,-72.453013,7.819
6034,2012,Julio,República de Corea,0,1,,1,-77.35002,8.63337
6035,2012,Julio,Costa Rica,0,1,,1,-77.35600000000001,0.81488
6036,2012,Julio,Costa Rica,0,1,,1,-75.527794,10.406342
6037,2012,Julio,Costa Rica,52,53,,105,-75.516486,10.446304
6038,2012,Julio,Costa Rica,7,18,,25,-74.77647900000001,10.886686
6039,2012,Julio,Costa Rica,314,221,,535,-81.70216500000001,12.5862
6040,2012,Julio,Costa Rica,34,55,,89,-76.532004,3.451668
6041,2012,Julio,Costa Rica,434,701,,1135,-74.140516,4.697157
6042,2012,Julio,Costa Rica,0,2,,2,-75.736374,4.815189
6043,2012,Julio,Costa Rica,117,164,,281,-75.42726,6.170465
6044,2012,Julio,Costa Rica,0,1,,1,-73.181317,7.1280470000000005
6045,2012,Julio,Costa Rica,1,2,,3,-72.453013,7.819
6046,2012,Julio,Costa Rica,2,0,,2,-72.508188,7.927233
6047,2012,Julio,Costa Rica,0,1,,1,-77.35002,8.63337
6048,2012,Julio,Croacia,3,1,,4,-75.516486,10.446304
6049,2012,Julio,Croacia,0,1,,1,-74.77647900000001,10.886686
6050,2012,Julio,Croacia,4,28,,32,-74.140516,4.697157
6051,2012,Julio,Croacia,1,0,,1,-72.453013,7.819
6052,2012,Julio,Cuba,1,0,,1,-77.35600000000001,0.81488
6053,2012,Julio,Cuba,1,1,,2,-75.527794,10.406342
6054,2012,Julio,Cuba,11,18,,29,-75.516486,10.446304
6055,2012,Julio,Cuba,4,20,,24,-74.77647900000001,10.886686
6056,2012,Julio,Cuba,0,1,,1,-72.129595,11.360028999999999
6057,2012,Julio,Cuba,16,37,,53,-76.532004,3.451668
6058,2012,Julio,Cuba,88,158,,246,-74.140516,4.697157
6059,2012,Julio,Cuba,0,3,,3,-75.736374,4.815189
6060,2012,Julio,Cuba,16,34,,50,-75.42726,6.170465
6061,2012,Julio,Cuba,3,3,,6,-73.181317,7.1280470000000005
6062,2012,Julio,Cuba,1,5,,6,-72.453013,7.819
6063,2012,Julio,Cuba,1,2,,3,-72.508188,7.927233
6064,2012,Julio,Curazao,2,6,,8,-74.140516,4.697157
6065,2012,Julio,Curazao,5,6,,11,-75.42726,6.170465
6066,2012,Julio,República Checa,3,2,,5,-77.35600000000001,0.81488
6067,2012,Julio,República Checa,1,1,,2,-75.516486,10.446304
6068,2012,Julio,República Checa,2,0,,2,-76.532004,3.451668
6069,2012,Julio,República Checa,17,41,,58,-74.140516,4.697157
6070,2012,Julio,República Checa,0,2,,2,-75.42726,6.170465
6071,2012,Julio,República Checa,3,0,,3,-72.453013,7.819
6072,2012,Julio,República Checa,0,1,,1,-77.35002,8.63337
6073,2012,Julio,Chile,1,3,,4,-69.941498,4.191162
6074,2012,Julio,Chile,0,3,,3,-76.876446,0.33002
6075,2012,Julio,Chile,27,62,,89,-77.35600000000001,0.81488
6076,2012,Julio,Chile,0,1,,1,-75.527794,10.406342
6077,2012,Julio,Chile,159,137,,296,-75.516486,10.446304
6078,2012,Julio,Chile,18,20,,38,-74.77647900000001,10.886686
6079,2012,Julio,Chile,4,8,,12,-72.129595,11.360028999999999
6080,2012,Julio,Chile,0,1,,1,-72.919186,11.52863
6081,2012,Julio,Chile,92,60,,152,-81.70216500000001,12.5862
6082,2012,Julio,Chile,51,73,,124,-76.532004,3.451668
6083,2012,Julio,Chile,0,1,,1,-75.76635300000001,4.45285
6084,2012,Julio,Chile,2328,3166,,5494,-74.140516,4.697157
6085,2012,Julio,Chile,1,1,,2,-75.736374,4.815189
6086,2012,Julio,Chile,56,117,,173,-75.42726,6.170465
6087,2012,Julio,Chile,11,13,,24,-72.453013,7.819
6088,2012,Julio,Chile,0,3,,3,-77.35002,8.63337
6089,2012,Julio,China,1,3,,4,-77.35600000000001,0.81488
6090,2012,Julio,China,2,0,,2,-75.516486,10.446304
6091,2012,Julio,China,0,2,,2,-74.77647900000001,10.886686
6092,2012,Julio,China,0,2,,2,-72.129595,11.360028999999999
6093,2012,Julio,China,6,10,,16,-76.532004,3.451668
6094,2012,Julio,China,146,367,,513,-74.140516,4.697157
6095,2012,Julio,China,0,2,,2,-75.736374,4.815189
6096,2012,Julio,China,4,10,,14,-75.42726,6.170465
6097,2012,Julio,China,0,2,,2,-72.453013,7.819
6098,2012,Julio,Taiwán,0,1,,1,-69.941498,4.191162
6099,2012,Julio,Taiwán,1,1,,2,-77.35600000000001,0.81488
6100,2012,Julio,Taiwán,3,4,,7,-75.516486,10.446304
6101,2012,Julio,Taiwán,1,1,,2,-74.77647900000001,10.886686
6102,2012,Julio,Taiwán,2,1,,3,-76.532004,3.451668
6103,2012,Julio,Taiwán,21,39,,60,-74.140516,4.697157
6104,2012,Julio,Taiwán,1,2,,3,-75.736374,4.815189
6105,2012,Julio,Taiwán,3,8,,11,-75.42726,6.170465
6106,2012,Julio,Taiwán,2,1,,3,-72.453013,7.819
6107,2012,Julio,Chipre,0,1,,1,-75.527794,10.406342
6108,2012,Julio,Chipre,2,0,,2,-76.532004,3.451668
6109,2012,Julio,Chipre,3,0,,3,-74.140516,4.697157
6110,2012,Julio,Dinamarca,2,0,,2,-69.941498,4.191162
6111,2012,Julio,Dinamarca,0,2,,2,-76.876446,0.33002
6112,2012,Julio,Dinamarca,7,5,,12,-77.35600000000001,0.81488
6113,2012,Julio,Dinamarca,4,8,,12,-75.527794,10.406342
6114,2012,Julio,Dinamarca,2,9,,11,-75.516486,10.446304
6115,2012,Julio,Dinamarca,1,0,,1,-74.77647900000001,10.886686
6116,2012,Julio,Dinamarca,0,4,,4,-74.213989,11.247722999999999
6117,2012,Julio,Dinamarca,0,1,,1,-72.129595,11.360028999999999
6118,2012,Julio,Dinamarca,0,2,,2,-81.70216500000001,12.5862
6119,2012,Julio,Dinamarca,2,8,,10,-76.532004,3.451668
6120,2012,Julio,Dinamarca,107,146,,253,-74.140516,4.697157
6121,2012,Julio,Dinamarca,0,1,,1,-75.736374,4.815189
6122,2012,Julio,Dinamarca,5,10,,15,-75.42726,6.170465
6123,2012,Julio,Dinamarca,2,0,,2,-73.181317,7.1280470000000005
6124,2012,Julio,Dinamarca,2,1,,3,-72.453013,7.819
6125,2012,Julio,Dinamarca,0,1,,1,-77.35002,8.63337
6126,2012,Julio,Dominica,0,1,,1,-72.129595,11.360028999999999
6127,2012,Julio,Dominica,2,2,,4,-74.140516,4.697157
6128,2012,Julio,Dominica,1,0,,1,-75.42726,6.170465
6129,2012,Julio,Dominica,1,0,,1,-72.453013,7.819
6130,2012,Julio,Ecuador,0,2,,2,-69.941498,4.191162
6131,2012,Julio,Ecuador,32,47,,79,-76.876446,0.33002
6132,2012,Julio,Ecuador,1792,2083,,3875,-77.35600000000001,0.81488
6133,2012,Julio,Ecuador,1,105,,106,-78.802679,18.00143
6134,2012,Julio,Ecuador,0,44,,44,-75.527794,10.406342
6135,2012,Julio,Ecuador,266,273,,539,-75.516486,10.446304
6136,2012,Julio,Ecuador,4,7,,11,-74.77647900000001,10.886686
6137,2012,Julio,Ecuador,21,32,,53,-72.129595,11.360028999999999
6138,2012,Julio,Ecuador,253,200,,453,-81.70216500000001,12.5862
6139,2012,Julio,Ecuador,330,392,,722,-76.532004,3.451668
6140,2012,Julio,Ecuador,0,4,,4,-77.061029,3.8844260000000004
6141,2012,Julio,Ecuador,0,2,,2,-75.76635300000001,4.45285
6142,2012,Julio,Ecuador,1883,2982,,4865,-74.140516,4.697157
6143,2012,Julio,Ecuador,0,8,,8,-75.736374,4.815189
6144,2012,Julio,Ecuador,462,557,,1019,-75.42726,6.170465
6145,2012,Julio,Ecuador,2,11,,13,-73.181317,7.1280470000000005
6146,2012,Julio,Ecuador,125,249,,374,-72.453013,7.819
6147,2012,Julio,Ecuador,3,53,,56,-72.508188,7.927233
6148,2012,Julio,Ecuador,1,1,,2,-77.35002,8.63337
6149,2012,Julio,Egipto,0,1,,1,-75.516486,10.446304
6150,2012,Julio,Egipto,5,23,,28,-74.140516,4.697157
6151,2012,Julio,Egipto,1,0,,1,-75.42726,6.170465
6152,2012,Julio,El Salvador,1,1,,2,-77.35600000000001,0.81488
6153,2012,Julio,El Salvador,8,19,,27,-75.516486,10.446304
6154,2012,Julio,El Salvador,3,3,,6,-74.77647900000001,10.886686
6155,2012,Julio,El Salvador,0,1,,1,-81.70216500000001,12.5862
6156,2012,Julio,El Salvador,44,60,,104,-76.532004,3.451668
6157,2012,Julio,El Salvador,350,524,,874,-74.140516,4.697157
6158,2012,Julio,El Salvador,0,1,,1,-75.736374,4.815189
6159,2012,Julio,El Salvador,29,31,,60,-75.42726,6.170465
6160,2012,Julio,El Salvador,0,3,,3,-73.181317,7.1280470000000005
6161,2012,Julio,El Salvador,0,1,,1,-72.453013,7.819
6162,2012,Julio,Emiratos Árabes,6,8,,14,-74.140516,4.697157
6163,2012,Julio,España,13,10,,23,-69.941498,4.191162
6164,2012,Julio,España,1,2,,3,-76.876446,0.33002
6165,2012,Julio,España,22,35,,57,-77.35600000000001,0.81488
6166,2012,Julio,España,0,10,,10,-75.527794,10.406342
6167,2012,Julio,España,30,68,,98,-75.516486,10.446304
6168,2012,Julio,España,2,8,,10,-74.77647900000001,10.886686
6169,2012,Julio,España,3,12,,15,-72.129595,11.360028999999999
6170,2012,Julio,España,11,4,,15,-81.70216500000001,12.5862
6171,2012,Julio,España,216,386,,602,-76.532004,3.451668
6172,2012,Julio,España,0,1,,1,-75.76635300000001,4.45285
6173,2012,Julio,España,1805,3758,,5563,-74.140516,4.697157
6174,2012,Julio,España,0,5,,5,-75.736374,4.815189
6175,2012,Julio,España,115,222,,337,-75.42726,6.170465
6176,2012,Julio,España,1,4,,5,-73.181317,7.1280470000000005
6177,2012,Julio,España,29,39,,68,-72.453013,7.819
6178,2012,Julio,España,0,1,,1,-72.508188,7.927233
6179,2012,Julio,España,1,10,,11,-77.35002,8.63337
6180,2012,Julio,Eslovaquia,0,1,,1,-69.941498,4.191162
6181,2012,Julio,Eslovaquia,2,1,,3,-77.35600000000001,0.81488
6182,2012,Julio,Eslovaquia,1,1,,2,-76.532004,3.451668
6183,2012,Julio,Eslovaquia,16,5,,21,-74.140516,4.697157
6184,2012,Julio,Eslovenia,2,0,,2,-77.35600000000001,0.81488
6185,2012,Julio,Eslovenia,0,2,,2,-75.527794,10.406342
6186,2012,Julio,Eslovenia,0,2,,2,-75.516486,10.446304
6187,2012,Julio,Eslovenia,4,0,,4,-72.129595,11.360028999999999
6188,2012,Julio,Eslovenia,1,0,,1,-81.70216500000001,12.5862
6189,2012,Julio,Eslovenia,1,1,,2,-81.372937,13.338761300000002
6190,2012,Julio,Eslovenia,0,3,,3,-76.532004,3.451668
6191,2012,Julio,Eslovenia,22,17,,39,-74.140516,4.697157
6192,2012,Julio,Eslovenia,1,0,,1,-75.42726,6.170465
6193,2012,Julio,Eslovenia,1,1,,2,-72.453013,7.819
6194,2012,Julio,Estados Unidos de América,15,27,,42,-69.941498,4.191162
6195,2012,Julio,Estados Unidos de América,0,4,,4,-76.876446,0.33002
6196,2012,Julio,Estados Unidos de América,83,124,,207,-77.35600000000001,0.81488
6197,2012,Julio,Estados Unidos de América,0,1,,1,-78.802679,18.00143
6198,2012,Julio,Estados Unidos de América,17,32,,49,-75.527794,10.406342
6199,2012,Julio,Estados Unidos de América,1175,1881,,3056,-75.516486,10.446304
6200,2012,Julio,Estados Unidos de América,428,552,,980,-74.77647900000001,10.886686
6201,2012,Julio,Estados Unidos de América,0,1,,1,-74.765343,10.970933
6202,2012,Julio,Estados Unidos de América,0,1,,1,-74.232675,11.117206
6203,2012,Julio,Estados Unidos de América,1,3,,4,-74.213989,11.247722999999999
6204,2012,Julio,Estados Unidos de América,11,19,,30,-72.129595,11.360028999999999
6205,2012,Julio,Estados Unidos de América,0,1,,1,-81.703935,12.574411099999999
6206,2012,Julio,Estados Unidos de América,33,62,,95,-81.70216500000001,12.5862
6207,2012,Julio,Estados Unidos de América,4,3,,7,-81.372937,13.338761300000002
6208,2012,Julio,Estados Unidos de América,1350,1680,,3030,-76.532004,3.451668
6209,2012,Julio,Estados Unidos de América,0,1,,1,-77.061029,3.8844260000000004
6210,2012,Julio,Estados Unidos de América,141,151,,292,-75.76635300000001,4.45285
6211,2012,Julio,Estados Unidos de América,7668,12523,,20191,-74.140516,4.697157
6212,2012,Julio,Estados Unidos de América,125,143,,268,-75.736374,4.815189
6213,2012,Julio,Estados Unidos de América,1796,2985,,4781,-75.42726,6.170465
6214,2012,Julio,Estados Unidos de América,1,0,,1,-67.48402800000001,6.185536
6215,2012,Julio,Estados Unidos de América,1,4,,5,-70.74025300000001,7.088728999999999
6216,2012,Julio,Estados Unidos de América,34,58,,92,-73.181317,7.1280470000000005
6217,2012,Julio,Estados Unidos de América,23,70,,93,-72.453013,7.819
6218,2012,Julio,Estados Unidos de América,27,29,,56,-72.508188,7.927233
6219,2012,Julio,Estados Unidos de América,4,6,,10,-77.35002,8.63337
6220,2012,Julio,Estados Unidos de América,0,1,,1,-75.68164200000001,9.402597
6221,2012,Julio,Estonia,1,0,,1,-77.35600000000001,0.81488
6222,2012,Julio,Estonia,2,0,,2,-74.140516,4.697157
6223,2012,Julio,Estonia,1,1,,2,-75.42726,6.170465
6224,2012,Julio,Estonia,1,0,,1,-72.453013,7.819
6225,2012,Julio,Etiopia,3,3,,6,-74.140516,4.697157
6226,2012,Julio,Filipinas,0,36,,36,-75.527794,10.406342
6227,2012,Julio,Filipinas,1,13,,14,-75.516486,10.446304
6228,2012,Julio,Filipinas,0,8,,8,-74.77647900000001,10.886686
6229,2012,Julio,Filipinas,0,10,,10,-74.765343,10.970933
6230,2012,Julio,Filipinas,0,3,,3,-74.213989,11.247722999999999
6231,2012,Julio,Filipinas,3,4,,7,-76.532004,3.451668
6232,2012,Julio,Filipinas,0,17,,17,-77.061029,3.8844260000000004
6233,2012,Julio,Filipinas,19,30,,49,-74.140516,4.697157
6234,2012,Julio,Filipinas,1,4,,5,-75.42726,6.170465
6235,2012,Julio,Filipinas,0,4,,4,-75.68164200000001,9.402597
6236,2012,Julio,Finlandia,0,2,,2,-69.941498,4.191162
6237,2012,Julio,Finlandia,2,2,,4,-77.35600000000001,0.81488
6238,2012,Julio,Finlandia,1,2,,3,-75.516486,10.446304
6239,2012,Julio,Finlandia,1,1,,2,-76.532004,3.451668
6240,2012,Julio,Finlandia,33,52,,85,-74.140516,4.697157
6241,2012,Julio,Finlandia,1,1,,2,-75.42726,6.170465
6242,2012,Julio,Finlandia,1,1,,2,-72.453013,7.819
6243,2012,Julio,Finlandia,1,1,,2,-77.35002,8.63337
6244,2012,Julio,Francia,12,12,,24,-69.941498,4.191162
6245,2012,Julio,Francia,2,1,,3,-76.876446,0.33002
6246,2012,Julio,Francia,61,73,,134,-77.35600000000001,0.81488
6247,2012,Julio,Francia,4,18,,22,-75.527794,10.406342
6248,2012,Julio,Francia,31,47,,78,-75.516486,10.446304
6249,2012,Julio,Francia,3,13,,16,-74.77647900000001,10.886686
6250,2012,Julio,Francia,5,4,,9,-74.213989,11.247722999999999
6251,2012,Julio,Francia,17,25,,42,-72.129595,11.360028999999999
6252,2012,Julio,Francia,50,104,,154,-76.532004,3.451668
6253,2012,Julio,Francia,0,1,,1,-75.76635300000001,4.45285
6254,2012,Julio,Francia,1483,2272,,3755,-74.140516,4.697157
6255,2012,Julio,Francia,0,1,,1,-75.736374,4.815189
6256,2012,Julio,Francia,50,85,,135,-75.42726,6.170465
6257,2012,Julio,Francia,0,1,,1,-70.74025300000001,7.088728999999999
6258,2012,Julio,Francia,0,1,,1,-73.181317,7.1280470000000005
6259,2012,Julio,Francia,10,28,,38,-72.453013,7.819
6260,2012,Julio,Francia,1,3,,4,-72.508188,7.927233
6261,2012,Julio,Francia,4,10,,14,-77.35002,8.63337
6262,2012,Julio,Gabón,1,0,,1,-74.140516,4.697157
6263,2012,Julio,Georgia,0,1,,1,-75.516486,10.446304
6264,2012,Julio,Georgia,3,5,,8,-74.140516,4.697157
6265,2012,Julio,Ghana,0,1,,1,-72.129595,11.360028999999999
6266,2012,Julio,Ghana,1,2,,3,-74.140516,4.697157
6267,2012,Julio,Ghana,0,1,,1,-72.453013,7.819
6268,2012,Julio,Granada,0,1,,1,-72.129595,11.360028999999999
6269,2012,Julio,Granada,1,0,,1,-75.42726,6.170465
6270,2012,Julio,Grecia,2,1,,3,-77.35600000000001,0.81488
6271,2012,Julio,Grecia,0,1,,1,-75.527794,10.406342
6272,2012,Julio,Grecia,1,6,,7,-75.516486,10.446304
6273,2012,Julio,Grecia,0,1,,1,-74.77647900000001,10.886686
6274,2012,Julio,Grecia,0,1,,1,-74.765343,10.970933
6275,2012,Julio,Grecia,1,0,,1,-72.129595,11.360028999999999
6276,2012,Julio,Grecia,0,5,,5,-76.532004,3.451668
6277,2012,Julio,Grecia,21,34,,55,-74.140516,4.697157
6278,2012,Julio,Grecia,2,4,,6,-75.42726,6.170465
6279,2012,Julio,Grecia,0,1,,1,-72.453013,7.819
6280,2012,Julio,Grecia,0,1,,1,-75.68164200000001,9.402597
6281,2012,Julio,Guatemala,0,1,,1,-69.941498,4.191162
6282,2012,Julio,Guatemala,0,4,,4,-77.35600000000001,0.81488
6283,2012,Julio,Guatemala,0,3,,3,-75.527794,10.406342
6284,2012,Julio,Guatemala,14,24,,38,-75.516486,10.446304
6285,2012,Julio,Guatemala,3,11,,14,-74.77647900000001,10.886686
6286,2012,Julio,Guatemala,0,1,,1,-74.232675,11.117206
6287,2012,Julio,Guatemala,1,2,,3,-72.129595,11.360028999999999
6288,2012,Julio,Guatemala,3,3,,6,-81.70216500000001,12.5862
6289,2012,Julio,Guatemala,10,70,,80,-76.532004,3.451668
6290,2012,Julio,Guatemala,148,329,,477,-74.140516,4.697157
6291,2012,Julio,Guatemala,0,8,,8,-75.736374,4.815189
6292,2012,Julio,Guatemala,45,78,,123,-75.42726,6.170465
6293,2012,Julio,Guatemala,1,0,,1,-77.401154,6.222551999999999
6294,2012,Julio,Guatemala,2,2,,4,-73.181317,7.1280470000000005
6295,2012,Julio,Guatemala,18,15,,33,-72.453013,7.819
6296,2012,Julio,Guatemala,1,0,,1,-77.35002,8.63337
6297,2012,Julio,Guyana,0,1,,1,-77.35600000000001,0.81488
6298,2012,Julio,Guyana,0,1,,1,-75.516486,10.446304
6299,2012,Julio,Guyana,0,1,,1,-76.532004,3.451668
6300,2012,Julio,Guyana,2,4,,6,-74.140516,4.697157
6301,2012,Julio,Guyana,0,1,,1,-75.42726,6.170465
6302,2012,Julio,Guyana,0,1,,1,-72.453013,7.819
6303,2012,Julio,Guinea Ecuatorial,1,0,,1,-74.140516,4.697157
6304,2012,Julio,Guayana Francesa/Departamento de Ultramar Francés,0,1,,1,-74.140516,4.697157
6305,2012,Julio,Haití,1,1,,2,-77.35600000000001,0.81488
6306,2012,Julio,Haití,1,0,,1,-74.77647900000001,10.886686
6307,2012,Julio,Haití,0,3,,3,-76.532004,3.451668
6308,2012,Julio,Haití,1,11,,12,-74.140516,4.697157
6309,2012,Julio,Honduras,0,5,,5,-77.35600000000001,0.81488
6310,2012,Julio,Honduras,0,9,,9,-75.527794,10.406342
6311,2012,Julio,Honduras,7,13,,20,-75.516486,10.446304
6312,2012,Julio,Honduras,12,14,,26,-74.77647900000001,10.886686
6313,2012,Julio,Honduras,3,131,,134,-81.703935,12.574411099999999
6314,2012,Julio,Honduras,1,1,,2,-81.372937,13.338761300000002
6315,2012,Julio,Honduras,18,17,,35,-76.532004,3.451668
6316,2012,Julio,Honduras,118,185,,303,-74.140516,4.697157
6317,2012,Julio,Honduras,15,5,,20,-75.736374,4.815189
6318,2012,Julio,Honduras,30,30,,60,-75.42726,6.170465
6319,2012,Julio,Honduras,0,1,,1,-77.401154,6.222551999999999
6320,2012,Julio,Honduras,1,0,,1,-77.35002,8.63337
6321,2012,Julio,Hungría,0,2,,2,-77.35600000000001,0.81488
6322,2012,Julio,Hungría,0,3,,3,-75.516486,10.446304
6323,2012,Julio,Hungría,1,2,,3,-72.129595,11.360028999999999
6324,2012,Julio,Hungría,0,2,,2,-76.532004,3.451668
6325,2012,Julio,Hungría,24,29,,53,-74.140516,4.697157
6326,2012,Julio,Hungría,0,3,,3,-75.42726,6.170465
6327,2012,Julio,India,0,3,,3,-75.516486,10.446304
6328,2012,Julio,India,0,4,,4,-74.77647900000001,10.886686
6329,2012,Julio,India,0,1,,1,-74.213989,11.247722999999999
6330,2012,Julio,India,1,0,,1,-72.919186,11.52863
6331,2012,Julio,India,4,11,,15,-76.532004,3.451668
6332,2012,Julio,India,24,244,,268,-74.140516,4.697157
6333,2012,Julio,India,1,16,,17,-75.42726,6.170465
6334,2012,Julio,India,0,2,,2,-73.181317,7.1280470000000005
6335,2012,Julio,Indonesia,1,3,,4,-77.35600000000001,0.81488
6336,2012,Julio,Indonesia,4,29,,33,-74.140516,4.697157
6337,2012,Julio,Indonesia,0,4,,4,-72.453013,7.819
6338,2012,Julio,Irán,0,1,,1,-76.532004,3.451668
6339,2012,Julio,Irán,7,18,,25,-74.140516,4.697157
6340,2012,Julio,Irán,0,1,,1,-75.42726,6.170465
6341,2012,Julio,República de Irlanda,5,3,,8,-69.941498,4.191162
6342,2012,Julio,República de Irlanda,13,19,,32,-77.35600000000001,0.81488
6343,2012,Julio,República de Irlanda,2,4,,6,-75.527794,10.406342
6344,2012,Julio,República de Irlanda,5,11,,16,-75.516486,10.446304
6345,2012,Julio,República de Irlanda,1,2,,3,-74.77647900000001,10.886686
6346,2012,Julio,República de Irlanda,5,5,,10,-76.532004,3.451668
6347,2012,Julio,República de Irlanda,73,100,,173,-74.140516,4.697157
6348,2012,Julio,República de Irlanda,11,10,,21,-75.42726,6.170465
6349,2012,Julio,República de Irlanda,1,3,,4,-72.453013,7.819
6350,2012,Julio,Islandia,0,1,,1,-75.516486,10.446304
6351,2012,Julio,Islandia,1,0,,1,-76.532004,3.451668
6352,2012,Julio,Islandia,5,8,,13,-74.140516,4.697157
6353,2012,Julio,Islandia,0,1,,1,-75.42726,6.170465
6354,2012,Julio,Isla de Man,21,31,,52,-77.35600000000001,0.81488
6355,2012,Julio,Isla de Man,1,14,,15,-75.516486,10.446304
6356,2012,Julio,Isla de Man,1,8,,9,-74.77647900000001,10.886686
6357,2012,Julio,Isla de Man,2,2,,4,-72.129595,11.360028999999999
6358,2012,Julio,Isla de Man,1,0,,1,-81.70216500000001,12.5862
6359,2012,Julio,Isla de Man,12,25,,37,-76.532004,3.451668
6360,2012,Julio,Isla de Man,35,113,,148,-74.140516,4.697157
6361,2012,Julio,Isla de Man,2,2,,4,-75.736374,4.815189
6362,2012,Julio,Isla de Man,13,25,,38,-75.42726,6.170465
6363,2012,Julio,Isla de Man,0,1,,1,-73.181317,7.1280470000000005
6364,2012,Julio,Isla Johnston,5,0,,5,-74.140516,4.697157
6365,2012,Julio,Israel,2,6,,8,-69.941498,4.191162
6366,2012,Julio,Israel,36,83,,119,-77.35600000000001,0.81488
6367,2012,Julio,Israel,0,3,,3,-75.527794,10.406342
6368,2012,Julio,Israel,2,18,,20,-75.516486,10.446304
6369,2012,Julio,Israel,0,2,,2,-74.77647900000001,10.886686
6370,2012,Julio,Israel,6,9,,15,-76.532004,3.451668
6371,2012,Julio,Israel,93,413,,506,-74.140516,4.697157
6372,2012,Julio,Israel,4,54,,58,-75.42726,6.170465
6373,2012,Julio,Israel,0,2,,2,-72.508188,7.927233
6374,2012,Julio,Israel,1,2,,3,-77.35002,8.63337
6375,2012,Julio,Islas Aland/Provincia de Finlandia,1,1,,2,-74.140516,4.697157
6376,2012,Julio,Italia,3,2,,5,-69.941498,4.191162
6377,2012,Julio,Italia,9,10,,19,-77.35600000000001,0.81488
6378,2012,Julio,Italia,2,1,,3,-75.527794,10.406342
6379,2012,Julio,Italia,29,61,,90,-75.516486,10.446304
6380,2012,Julio,Italia,1,6,,7,-74.77647900000001,10.886686
6381,2012,Julio,Italia,1,1,,2,-74.213989,11.247722999999999
6382,2012,Julio,Italia,9,13,,22,-72.129595,11.360028999999999
6383,2012,Julio,Italia,1,6,,7,-81.70216500000001,12.5862
6384,2012,Julio,Italia,32,84,,116,-76.532004,3.451668
6385,2012,Julio,Italia,505,1441,,1946,-74.140516,4.697157
6386,2012,Julio,Italia,36,88,,124,-75.42726,6.170465
6387,2012,Julio,Italia,0,1,,1,-67.48402800000001,6.185536
6388,2012,Julio,Italia,6,22,,28,-72.453013,7.819
6389,2012,Julio,Italia,0,1,,1,-72.508188,7.927233
6390,2012,Julio,Italia,0,2,,2,-77.35002,8.63337
6391,2012,Julio,Italia,0,1,,1,-75.68164200000001,9.402597
6392,2012,Julio,Jamaica,2,3,,5,-75.516486,10.446304
6393,2012,Julio,Jamaica,1,1,,2,-72.919186,11.52863
6394,2012,Julio,Jamaica,2,3,,5,-81.70216500000001,12.5862
6395,2012,Julio,Jamaica,3,0,,3,-76.532004,3.451668
6396,2012,Julio,Jamaica,24,21,,45,-74.140516,4.697157
6397,2012,Julio,Jamaica,0,4,,4,-75.42726,6.170465
6398,2012,Julio,Jamaica,1,0,,1,-73.181317,7.1280470000000005
6399,2012,Julio,Jamaica,0,1,,1,-72.453013,7.819
6400,2012,Julio,Islas Marianas del Norte,0,1,,1,-75.42726,6.170465
6401,2012,Julio,Japón,0,2,,2,-69.941498,4.191162
6402,2012,Julio,Japón,6,15,,21,-77.35600000000001,0.81488
6403,2012,Julio,Japón,6,10,,16,-75.516486,10.446304
6404,2012,Julio,Japón,2,7,,9,-74.77647900000001,10.886686
6405,2012,Julio,Japón,1,4,,5,-72.129595,11.360028999999999
6406,2012,Julio,Japón,1,0,,1,-81.70216500000001,12.5862
6407,2012,Julio,Japón,6,18,,24,-76.532004,3.451668
6408,2012,Julio,Japón,144,412,,556,-74.140516,4.697157
6409,2012,Julio,Japón,6,31,,37,-75.42726,6.170465
6410,2012,Julio,Japón,3,4,,7,-72.453013,7.819
6411,2012,Julio,Japón,0,1,,1,-72.508188,7.927233
6412,2012,Julio,Japón,0,1,,1,-77.35002,8.63337
6413,2012,Julio,Jordania,0,4,,4,-74.140516,4.697157
6414,2012,Julio,Kazajistán,1,0,,1,-74.140516,4.697157
6415,2012,Julio,Kenia,0,2,,2,-77.35600000000001,0.81488
6416,2012,Julio,Kenia,1,0,,1,-75.516486,10.446304
6417,2012,Julio,Kenia,1,1,,2,-76.532004,3.451668
6418,2012,Julio,Kenia,6,10,,16,-74.140516,4.697157
6419,2012,Julio,Kenia,0,1,,1,-75.42726,6.170465
6420,2012,Julio,Kirguistán,1,1,,2,-74.140516,4.697157
6421,2012,Julio,Kuwait,1,0,,1,-74.140516,4.697157
6422,2012,Julio,Letonia,0,1,,1,-75.516486,10.446304
6423,2012,Julio,Letonia,1,1,,2,-72.919186,11.52863
6424,2012,Julio,Letonia,3,17,,20,-74.140516,4.697157
6425,2012,Julio,Letonia,1,1,,2,-75.42726,6.170465
6426,2012,Julio,Letonia,0,1,,1,-75.68164200000001,9.402597
6427,2012,Julio,Lituania,1,1,,2,-72.129595,11.360028999999999
6428,2012,Julio,Lituania,5,4,,9,-74.140516,4.697157
6429,2012,Julio,Líbano,0,3,,3,-77.35600000000001,0.81488
6430,2012,Julio,Líbano,0,5,,5,-74.77647900000001,10.886686
6431,2012,Julio,Líbano,5,5,,10,-72.129595,11.360028999999999
6432,2012,Julio,Líbano,1,1,,2,-76.532004,3.451668
6433,2012,Julio,Líbano,21,23,,44,-74.140516,4.697157
6434,2012,Julio,Liechtenstein,4,5,,9,-74.140516,4.697157
6435,2012,Julio,Luxemburgo,0,1,,1,-75.516486,10.446304
6436,2012,Julio,Luxemburgo,10,8,,18,-74.140516,4.697157
6437,2012,Julio,Macedonia,2,2,,4,-74.140516,4.697157
6438,2012,Julio,Madagascar,1,0,,1,-75.42726,6.170465
6439,2012,Julio,Malasia,6,18,,24,-74.140516,4.697157
6440,2012,Julio,Malasia,0,1,,1,-75.736374,4.815189
6441,2012,Julio,Malasia,1,0,,1,-75.42726,6.170465
6442,2012,Julio,Malta,1,2,,3,-74.140516,4.697157
6443,2012,Julio,Marruecos,0,1,,1,-75.516486,10.446304
6444,2012,Julio,Marruecos,5,12,,17,-74.140516,4.697157
6445,2012,Julio,Mauricio,0,1,,1,-74.140516,4.697157
6446,2012,Julio,Mauritania,0,1,,1,-74.140516,4.697157
6447,2012,Julio,México,2,2,,4,-69.941498,4.191162
6448,2012,Julio,México,0,1,,1,-76.876446,0.33002
6449,2012,Julio,México,22,23,,45,-77.35600000000001,0.81488
6450,2012,Julio,México,0,2,,2,-75.527794,10.406342
6451,2012,Julio,México,156,166,,322,-75.516486,10.446304
6452,2012,Julio,México,19,46,,65,-74.77647900000001,10.886686
6453,2012,Julio,México,5,4,,9,-72.129595,11.360028999999999
6454,2012,Julio,México,0,3,,3,-81.703935,12.574411099999999
6455,2012,Julio,México,7,4,,11,-81.70216500000001,12.5862
6456,2012,Julio,México,68,157,,225,-76.532004,3.451668
6457,2012,Julio,México,0,2,,2,-75.76635300000001,4.45285
6458,2012,Julio,México,2390,4704,,7094,-74.140516,4.697157
6459,2012,Julio,México,8,21,,29,-75.736374,4.815189
6460,2012,Julio,México,193,387,,580,-75.42726,6.170465
6461,2012,Julio,México,4,12,,16,-73.181317,7.1280470000000005
6462,2012,Julio,México,12,26,,38,-72.453013,7.819
6463,2012,Julio,México,3,9,,12,-72.508188,7.927233
6464,2012,Julio,México,3,1,,4,-77.35002,8.63337
6465,2012,Julio,República de Moldavia,2,0,,2,-74.140516,4.697157
6466,2012,Julio,Montenegro,0,1,,1,-77.061029,3.8844260000000004
6467,2012,Julio,Montenegro,1,1,,2,-74.140516,4.697157
6468,2012,Julio,Mozambique,1,0,,1,-74.140516,4.697157
6469,2012,Julio,Myanmar,0,1,,1,-75.527794,10.406342
6470,2012,Julio,Namibia,0,2,,2,-74.140516,4.697157
6471,2012,Julio,Nepal,0,1,,1,-77.35600000000001,0.81488
6472,2012,Julio,Nepal,0,1,,1,-74.140516,4.697157
6473,2012,Julio,Nicaragua,0,1,,1,-75.527794,10.406342
6474,2012,Julio,Nicaragua,5,7,,12,-75.516486,10.446304
6475,2012,Julio,Nicaragua,2,1,,3,-74.77647900000001,10.886686
6476,2012,Julio,Nicaragua,0,1,,1,-81.703935,12.574411099999999
6477,2012,Julio,Nicaragua,3,2,,5,-81.70216500000001,12.5862
6478,2012,Julio,Nicaragua,5,4,,9,-76.532004,3.451668
6479,2012,Julio,Nicaragua,39,55,,94,-74.140516,4.697157
6480,2012,Julio,Nicaragua,0,2,,2,-75.736374,4.815189
6481,2012,Julio,Nicaragua,12,14,,26,-75.42726,6.170465
6482,2012,Julio,Nigeria,1,0,,1,-75.516486,10.446304
6483,2012,Julio,Nigeria,0,3,,3,-74.140516,4.697157
6484,2012,Julio,Nigeria,0,1,,1,-72.453013,7.819
6485,2012,Julio,Noruega,1,0,,1,-69.941498,4.191162
6486,2012,Julio,Noruega,4,3,,7,-77.35600000000001,0.81488
6487,2012,Julio,Noruega,3,4,,7,-75.527794,10.406342
6488,2012,Julio,Noruega,6,13,,19,-75.516486,10.446304
6489,2012,Julio,Noruega,2,2,,4,-74.77647900000001,10.886686
6490,2012,Julio,Noruega,2,1,,3,-72.129595,11.360028999999999
6491,2012,Julio,Noruega,6,11,,17,-76.532004,3.451668
6492,2012,Julio,Noruega,1,0,,1,-75.76635300000001,4.45285
6493,2012,Julio,Noruega,93,127,,220,-74.140516,4.697157
6494,2012,Julio,Noruega,10,15,,25,-75.42726,6.170465
6495,2012,Julio,Noruega,0,2,,2,-72.453013,7.819
6496,2012,Julio,Nueva Zelanda,4,4,,8,-69.941498,4.191162
6497,2012,Julio,Nueva Zelanda,9,10,,19,-77.35600000000001,0.81488
6498,2012,Julio,Nueva Zelanda,5,6,,11,-75.516486,10.446304
6499,2012,Julio,Nueva Zelanda,1,0,,1,-81.70216500000001,12.5862
6500,2012,Julio,Nueva Zelanda,1,3,,4,-76.532004,3.451668
6501,2012,Julio,Nueva Zelanda,40,73,,113,-74.140516,4.697157
6502,2012,Julio,Nueva Zelanda,4,8,,12,-75.42726,6.170465
6503,2012,Julio,Nueva Zelanda,0,1,,1,-72.453013,7.819
6504,2012,Julio,Nueva Zelanda,1,2,,3,-77.35002,8.63337
6505,2012,Julio,Nueva Zelanda,1,6,,7,-75.527794,10.406342
6506,2012,Julio,Nueva Zelanda,0,1,,1,-75.516486,10.446304
6507,2012,Julio,Nueva Zelanda,0,1,,1,-74.213989,11.247722999999999
6508,2012,Julio,Nueva Zelanda,7,5,,12,-74.140516,4.697157
6509,2012,Julio,Nueva Zelanda,2,5,,7,-75.42726,6.170465
6510,2012,Julio,Nueva Zelanda,2,2,,4,-72.453013,7.819
6511,2012,Julio,Nueva Zelanda,0,1,,1,-77.35002,8.63337
6512,2012,Julio,Países Bajos,8,12,,20,-77.35600000000001,0.81488
6513,2012,Julio,Países Bajos,3,8,,11,-75.516486,10.446304
6514,2012,Julio,Países Bajos,4,7,,11,-74.77647900000001,10.886686
6515,2012,Julio,Países Bajos,9,20,,29,-72.129595,11.360028999999999
6516,2012,Julio,Países Bajos,89,76,,165,-72.919186,11.52863
6517,2012,Julio,Países Bajos,9,37,,46,-76.532004,3.451668
6518,2012,Julio,Países Bajos,0,3,,3,-77.061029,3.8844260000000004
6519,2012,Julio,Países Bajos,337,390,,727,-74.140516,4.697157
6520,2012,Julio,Países Bajos,2,3,,5,-75.736374,4.815189
6521,2012,Julio,Países Bajos,284,302,,586,-75.42726,6.170465
6522,2012,Julio,Países Bajos,4,7,,11,-73.181317,7.1280470000000005
6523,2012,Julio,Países Bajos,0,1,,1,-72.453013,7.819
6524,2012,Julio,Pakistán,0,1,,1,-77.35600000000001,0.81488
6525,2012,Julio,Pakistán,0,1,,1,-75.516486,10.446304
6526,2012,Julio,Pakistán,1,14,,15,-74.140516,4.697157
6527,2012,Julio,Pakistán,0,1,,1,-75.42726,6.170465
6528,2012,Julio,Palau,0,1,,1,-74.140516,4.697157
6529,2012,Julio,Panamá,0,1,,1,-69.941498,4.191162
6530,2012,Julio,Panamá,1,1,,2,-77.35600000000001,0.81488
6531,2012,Julio,Panamá,0,9,,9,-75.527794,10.406342
6532,2012,Julio,Panamá,87,137,,224,-75.516486,10.446304
6533,2012,Julio,Panamá,47,74,,121,-74.77647900000001,10.886686
6534,2012,Julio,Panamá,1,3,,4,-72.129595,11.360028999999999
6535,2012,Julio,Panamá,0,2,,2,-81.703935,12.574411099999999
6536,2012,Julio,Panamá,30,48,,78,-81.70216500000001,12.5862
6537,2012,Julio,Panamá,60,119,,179,-76.532004,3.451668
6538,2012,Julio,Panamá,0,1,,1,-75.76635300000001,4.45285
6539,2012,Julio,Panamá,476,848,,1324,-74.140516,4.697157
6540,2012,Julio,Panamá,112,90,,202,-75.736374,4.815189
6541,2012,Julio,Panamá,156,272,,428,-75.42726,6.170465
6542,2012,Julio,Panamá,3,2,,5,-77.401154,6.222551999999999
6543,2012,Julio,Panamá,3,6,,9,-73.181317,7.1280470000000005
6544,2012,Julio,Panamá,3,6,,9,-72.453013,7.819
6545,2012,Julio,Panamá,7,10,,17,-72.508188,7.927233
6546,2012,Julio,Panamá,1,7,,8,-77.35002,8.63337
6547,2012,Julio,Paraguay,2,2,,4,-77.35600000000001,0.81488
6548,2012,Julio,Paraguay,6,6,,12,-75.516486,10.446304
6549,2012,Julio,Paraguay,2,2,,4,-74.77647900000001,10.886686
6550,2012,Julio,Paraguay,3,4,,7,-81.70216500000001,12.5862
6551,2012,Julio,Paraguay,0,5,,5,-76.532004,3.451668
6552,2012,Julio,Paraguay,51,72,,123,-74.140516,4.697157
6553,2012,Julio,Paraguay,1,0,,1,-75.736374,4.815189
6554,2012,Julio,Paraguay,7,3,,10,-75.42726,6.170465
6555,2012,Julio,Paraguay,0,1,,1,-72.453013,7.819
6556,2012,Julio,Paraguay,0,2,,2,-72.508188,7.927233
6557,2012,Julio,Perú,24,67,,91,-69.941498,4.191162
6558,2012,Julio,Perú,2,2,,4,-76.876446,0.33002
6559,2012,Julio,Perú,174,318,,492,-77.35600000000001,0.81488
6560,2012,Julio,Perú,139,156,,295,-75.516486,10.446304
6561,2012,Julio,Perú,10,11,,21,-74.77647900000001,10.886686
6562,2012,Julio,Perú,7,22,,29,-72.129595,11.360028999999999
6563,2012,Julio,Perú,257,189,,446,-81.70216500000001,12.5862
6564,2012,Julio,Perú,141,86,,227,-76.532004,3.451668
6565,2012,Julio,Perú,0,1,,1,-77.061029,3.8844260000000004
6566,2012,Julio,Perú,2015,2969,,4984,-74.140516,4.697157
6567,2012,Julio,Perú,0,3,,3,-75.736374,4.815189
6568,2012,Julio,Perú,218,265,,483,-75.42726,6.170465
6569,2012,Julio,Perú,1,0,,1,-67.48402800000001,6.185536
6570,2012,Julio,Perú,0,1,,1,-70.74025300000001,7.088728999999999
6571,2012,Julio,Perú,3,6,,9,-73.181317,7.1280470000000005
6572,2012,Julio,Perú,27,53,,80,-72.453013,7.819
6573,2012,Julio,Perú,0,1,,1,-72.508188,7.927233
6574,2012,Julio,Perú,0,1,,1,-77.35002,8.63337
6575,2012,Julio,Palestina,2,3,,5,-74.140516,4.697157
6576,2012,Julio,Polonia,1,0,,1,-69.941498,4.191162
6577,2012,Julio,Polonia,1,0,,1,-76.876446,0.33002
6578,2012,Julio,Polonia,3,2,,5,-77.35600000000001,0.81488
6579,2012,Julio,Polonia,3,8,,11,-75.527794,10.406342
6580,2012,Julio,Polonia,5,3,,8,-75.516486,10.446304
6581,2012,Julio,Polonia,1,0,,1,-74.213989,11.247722999999999
6582,2012,Julio,Polonia,0,2,,2,-72.129595,11.360028999999999
6583,2012,Julio,Polonia,1,1,,2,-76.532004,3.451668
6584,2012,Julio,Polonia,53,63,,116,-74.140516,4.697157
6585,2012,Julio,Polonia,5,2,,7,-75.42726,6.170465
6586,2012,Julio,Polonia,1,1,,2,-72.453013,7.819
6587,2012,Julio,Polonia,0,1,,1,-75.68164200000001,9.402597
6588,2012,Julio,Portugal,0,2,,2,-69.941498,4.191162
6589,2012,Julio,Portugal,2,3,,5,-77.35600000000001,0.81488
6590,2012,Julio,Portugal,0,2,,2,-75.527794,10.406342
6591,2012,Julio,Portugal,2,4,,6,-75.516486,10.446304
6592,2012,Julio,Portugal,0,1,,1,-74.77647900000001,10.886686
6593,2012,Julio,Portugal,1,4,,5,-72.129595,11.360028999999999
6594,2012,Julio,Portugal,0,1,,1,-81.70216500000001,12.5862
6595,2012,Julio,Portugal,1,19,,20,-76.532004,3.451668
6596,2012,Julio,Portugal,80,235,,315,-74.140516,4.697157
6597,2012,Julio,Portugal,5,19,,24,-75.42726,6.170465
6598,2012,Julio,Portugal,1,2,,3,-72.453013,7.819
6599,2012,Julio,Portugal,1,5,,6,-72.508188,7.927233
6600,2012,Julio,Portugal,2,2,,4,-77.35002,8.63337
6601,2012,Julio,Puerto Rico/Territorio de Estados Unidos,2,4,,6,-75.516486,10.446304
6602,2012,Julio,Puerto Rico/Territorio de Estados Unidos,1,0,,1,-74.77647900000001,10.886686
6603,2012,Julio,Puerto Rico/Territorio de Estados Unidos,1,0,,1,-76.532004,3.451668
6604,2012,Julio,Puerto Rico/Territorio de Estados Unidos,0,2,,2,-75.42726,6.170465
6605,2012,Julio,Qatar,0,1,,1,-74.140516,4.697157
6606,2012,Julio,Qatar,0,1,,1,-75.42726,6.170465
6607,2012,Julio,Reino Unido de Gran Bretaña e Irlanda del Norte,5,16,,21,-69.941498,4.191162
6608,2012,Julio,Reino Unido de Gran Bretaña e Irlanda del Norte,10,10,,20,-77.35600000000001,0.81488
6609,2012,Julio,Reino Unido de Gran Bretaña e Irlanda del Norte,1,0,,1,-75.527794,10.406342
6610,2012,Julio,Reino Unido de Gran Bretaña e Irlanda del Norte,12,31,,43,-75.516486,10.446304
6611,2012,Julio,Reino Unido de Gran Bretaña e Irlanda del Norte,1,4,,5,-74.77647900000001,10.886686
6612,2012,Julio,Reino Unido de Gran Bretaña e Irlanda del Norte,6,3,,9,-72.129595,11.360028999999999
6613,2012,Julio,Reino Unido de Gran Bretaña e Irlanda del Norte,1,0,,1,-81.70216500000001,12.5862
6614,2012,Julio,Reino Unido de Gran Bretaña e Irlanda del Norte,11,18,,29,-76.532004,3.451668
6615,2012,Julio,Reino Unido de Gran Bretaña e Irlanda del Norte,1,0,,1,-75.76635300000001,4.45285
6616,2012,Julio,Reino Unido de Gran Bretaña e Irlanda del Norte,269,508,,777,-74.140516,4.697157
6617,2012,Julio,Reino Unido de Gran Bretaña e Irlanda del Norte,7,24,,31,-75.42726,6.170465
6618,2012,Julio,Reino Unido de Gran Bretaña e Irlanda del Norte,1,2,,3,-72.453013,7.819
6619,2012,Julio,Reino Unido de Gran Bretaña e Irlanda del Norte,0,1,,1,-77.35002,8.63337
6620,2012,Julio,República de Belarús,0,1,,1,-74.140516,4.697157
6621,2012,Julio,República Dominicana,3,5,,8,-77.35600000000001,0.81488
6622,2012,Julio,República Dominicana,0,2,,2,-75.527794,10.406342
6623,2012,Julio,República Dominicana,24,14,,38,-75.516486,10.446304
6624,2012,Julio,República Dominicana,8,34,,42,-74.77647900000001,10.886686
6625,2012,Julio,República Dominicana,1,3,,4,-72.129595,11.360028999999999
6626,2012,Julio,República Dominicana,26,22,,48,-76.532004,3.451668
6627,2012,Julio,República Dominicana,1,0,,1,-75.76635300000001,4.45285
6628,2012,Julio,República Dominicana,208,354,,562,-74.140516,4.697157
6629,2012,Julio,República Dominicana,5,4,,9,-75.736374,4.815189
6630,2012,Julio,República Dominicana,35,54,,89,-75.42726,6.170465
6631,2012,Julio,República Dominicana,6,0,,6,-73.181317,7.1280470000000005
6632,2012,Julio,República Dominicana,0,1,,1,-72.453013,7.819
6633,2012,Julio,República Dominicana,7,12,,19,-72.508188,7.927233
6634,2012,Julio,República Checa,0,2,,2,-81.70216500000001,12.5862
6635,2012,Julio,República Checa,0,3,,3,-74.140516,4.697157
6636,2012,Julio,República Checa,0,1,,1,-72.453013,7.819
6637,2012,Julio,Rumania,0,1,,1,-69.941498,4.191162
6638,2012,Julio,Rumania,1,0,,1,-77.35600000000001,0.81488
6639,2012,Julio,Rumania,0,1,,1,-75.527794,10.406342
6640,2012,Julio,Rumania,0,1,,1,-75.516486,10.446304
6641,2012,Julio,Rumania,0,1,,1,-74.765343,10.970933
6642,2012,Julio,Rumania,1,4,,5,-76.532004,3.451668
6643,2012,Julio,Rumania,0,1,,1,-77.061029,3.8844260000000004
6644,2012,Julio,Rumania,26,40,,66,-74.140516,4.697157
6645,2012,Julio,Rumania,0,2,,2,-75.68164200000001,9.402597
6646,2012,Julio,Federación de Rusia,0,2,,2,-77.35600000000001,0.81488
6647,2012,Julio,Federación de Rusia,1,6,,7,-75.527794,10.406342
6648,2012,Julio,Federación de Rusia,3,1,,4,-75.516486,10.446304
6649,2012,Julio,Federación de Rusia,0,1,,1,-74.77647900000001,10.886686
6650,2012,Julio,Federación de Rusia,1,1,,2,-72.129595,11.360028999999999
6651,2012,Julio,Federación de Rusia,3,3,,6,-76.532004,3.451668
6652,2012,Julio,Federación de Rusia,31,39,,70,-74.140516,4.697157
6653,2012,Julio,Federación de Rusia,1,0,,1,-75.736374,4.815189
6654,2012,Julio,Federación de Rusia,3,1,,4,-75.42726,6.170465
6655,2012,Julio,Federación de Rusia,0,1,,1,-75.68164200000001,9.402597
6656,2012,Julio,Rwanda,1,0,,1,-74.140516,4.697157
6657,2012,Julio,San Cristóbal y Nevis,0,1,,1,-72.129595,11.360028999999999
6658,2012,Julio,San Marino,0,1,,1,-72.129595,11.360028999999999
6659,2012,Julio,San  Vicente y las Granadinas,0,1,,1,-75.516486,10.446304
6660,2012,Julio,San  Vicente y las Granadinas,0,1,,1,-74.140516,4.697157
6661,2012,Julio,Santa Lucia,2,3,,5,-75.516486,10.446304
6662,2012,Julio,Santa Lucia,1,0,,1,-74.140516,4.697157
6663,2012,Julio,Santa Lucia,1,0,,1,-75.42726,6.170465
6664,2012,Julio,Santa Lucia,2,0,,2,-73.181317,7.1280470000000005
6665,2012,Julio,Santa Sede/Ciudad del Vaticano,0,3,,3,-74.140516,4.697157
6666,2012,Julio,Santa Sede/Ciudad del Vaticano,0,1,,1,-75.42726,6.170465
6667,2012,Julio,Senegal,0,1,,1,-74.140516,4.697157
6668,2012,Julio,Serbia,0,1,,1,-77.35600000000001,0.81488
6669,2012,Julio,Serbia,3,5,,8,-74.140516,4.697157
6670,2012,Julio,Sierra Leona,0,1,,1,-74.140516,4.697157
6671,2012,Julio,Singapur,1,0,,1,-77.35600000000001,0.81488
6672,2012,Julio,Singapur,1,0,,1,-75.527794,10.406342
6673,2012,Julio,Singapur,5,15,,20,-74.140516,4.697157
6674,2012,Julio,Singapur,0,1,,1,-75.42726,6.170465
6675,2012,Julio,República Árabe Siria,0,1,,1,-75.527794,10.406342
6676,2012,Julio,República Árabe Siria,0,1,,1,-72.129595,11.360028999999999
6677,2012,Julio,República Árabe Siria,0,1,,1,-74.140516,4.697157
6678,2012,Julio,Sri Lanka,0,1,,1,-76.532004,3.451668
6679,2012,Julio,Sri Lanka,0,2,,2,-74.140516,4.697157
6680,2012,Julio,Sudáfrica,3,2,,5,-77.35600000000001,0.81488
6681,2012,Julio,Sudáfrica,0,2,,2,-75.516486,10.446304
6682,2012,Julio,Sudáfrica,0,2,,2,-76.532004,3.451668
6683,2012,Julio,Sudáfrica,11,59,,70,-74.140516,4.697157
6684,2012,Julio,Sudáfrica,1,4,,5,-75.42726,6.170465
6685,2012,Julio,Sudáfrica,0,2,,2,-72.508188,7.927233
6686,2012,Julio,Sudán,0,1,,1,-74.140516,4.697157
6687,2012,Julio,Suecia,0,5,,5,-69.941498,4.191162
6688,2012,Julio,Suecia,8,2,,10,-77.35600000000001,0.81488
6689,2012,Julio,Suecia,1,3,,4,-75.527794,10.406342
6690,2012,Julio,Suecia,6,7,,13,-75.516486,10.446304
6691,2012,Julio,Suecia,2,3,,5,-74.77647900000001,10.886686
6692,2012,Julio,Suecia,0,4,,4,-72.129595,11.360028999999999
6693,2012,Julio,Suecia,1,8,,9,-76.532004,3.451668
6694,2012,Julio,Suecia,112,164,,276,-74.140516,4.697157
6695,2012,Julio,Suecia,0,1,,1,-75.736374,4.815189
6696,2012,Julio,Suecia,16,14,,30,-75.42726,6.170465
6697,2012,Julio,Suecia,0,2,,2,-72.453013,7.819
6698,2012,Julio,Suecia,0,1,,1,-77.35002,8.63337
6699,2012,Julio,Suiza,7,7,,14,-69.941498,4.191162
6700,2012,Julio,Suiza,25,36,,61,-77.35600000000001,0.81488
6701,2012,Julio,Suiza,14,14,,28,-75.527794,10.406342
6702,2012,Julio,Suiza,25,24,,49,-75.516486,10.446304
6703,2012,Julio,Suiza,5,6,,11,-74.77647900000001,10.886686
6704,2012,Julio,Suiza,0,1,,1,-74.213989,11.247722999999999
6705,2012,Julio,Suiza,3,10,,13,-72.129595,11.360028999999999
6706,2012,Julio,Suiza,1,0,,1,-81.70216500000001,12.5862
6707,2012,Julio,Suiza,53,62,,115,-76.532004,3.451668
6708,2012,Julio,Suiza,589,734,,1323,-74.140516,4.697157
6709,2012,Julio,Suiza,3,3,,6,-75.736374,4.815189
6710,2012,Julio,Suiza,28,48,,76,-75.42726,6.170465
6711,2012,Julio,Suiza,0,1,,1,-77.401154,6.222551999999999
6712,2012,Julio,Suiza,1,9,,10,-72.453013,7.819
6713,2012,Julio,Suiza,3,6,,9,-77.35002,8.63337
6714,2012,Julio,Surinam,3,2,,5,-75.516486,10.446304
6715,2012,Julio,Surinam,0,1,,1,-74.77647900000001,10.886686
6716,2012,Julio,Surinam,15,7,,22,-74.140516,4.697157
6717,2012,Julio,Surinam,0,1,,1,-77.35002,8.63337
6718,2012,Julio,Taiwán,0,1,,1,-76.532004,3.451668
6719,2012,Julio,Taiwán,1,6,,7,-74.140516,4.697157
6720,2012,Julio,Tailandia,1,0,,1,-77.35600000000001,0.81488
6721,2012,Julio,Tailandia,1,0,,1,-75.516486,10.446304
6722,2012,Julio,Tailandia,1,0,,1,-76.532004,3.451668
6723,2012,Julio,Tailandia,5,2,,7,-74.140516,4.697157
6724,2012,Julio,Tailandia,1,1,,2,-75.42726,6.170465
6725,2012,Julio,Tíbet/Región Autónoma de China,1,1,,2,-74.140516,4.697157
6726,2012,Julio,Territorio Antártico Británico/Territorio Británico de Ultramar,0,1,,1,-69.941498,4.191162
6727,2012,Julio,Territorio Antártico Británico/Territorio Británico de Ultramar,0,3,,3,-77.35600000000001,0.81488
6728,2012,Julio,Territorio Antártico Británico/Territorio Británico de Ultramar,0,1,,1,-72.129595,11.360028999999999
6729,2012,Julio,Territorio Antártico Británico/Territorio Británico de Ultramar,2,1,,3,-74.140516,4.697157
6730,2012,Julio,Territorio Antártico Británico/Territorio Británico de Ultramar,0,1,,1,-75.42726,6.170465
6731,2012,Julio,Tanzania,0,2,,2,-74.140516,4.697157
6732,2012,Julio,Trinidad y Tobago,6,24,,30,-75.516486,10.446304
6733,2012,Julio,Trinidad y Tobago,0,2,,2,-74.77647900000001,10.886686
6734,2012,Julio,Trinidad y Tobago,7,7,,14,-72.129595,11.360028999999999
6735,2012,Julio,Trinidad y Tobago,5,10,,15,-76.532004,3.451668
6736,2012,Julio,Trinidad y Tobago,18,73,,91,-74.140516,4.697157
6737,2012,Julio,Trinidad y Tobago,17,25,,42,-75.42726,6.170465
6738,2012,Julio,Trinidad y Tobago,1,4,,5,-73.181317,7.1280470000000005
6739,2012,Julio,Trinidad y Tobago,1,0,,1,-72.453013,7.819
6740,2012,Julio,Trinidad y Tobago,0,2,,2,-72.508188,7.927233
6741,2012,Julio,Túnez,1,2,,3,-74.140516,4.697157
6742,2012,Julio,Turkmenistán,0,1,,1,-75.736374,4.815189
6743,2012,Julio,Turquía,0,1,,1,-77.35600000000001,0.81488
6744,2012,Julio,Turquía,0,2,,2,-75.527794,10.406342
6745,2012,Julio,Turquía,0,26,,26,-75.516486,10.446304
6746,2012,Julio,Turquía,0,1,,1,-74.77647900000001,10.886686
6747,2012,Julio,Turquía,0,3,,3,-76.532004,3.451668
6748,2012,Julio,Turquía,28,66,,94,-74.140516,4.697157
6749,2012,Julio,Turquía,1,10,,11,-75.42726,6.170465
6750,2012,Julio,Turquía,0,5,,5,-72.453013,7.819
6751,2012,Julio,Turquía,0,1,,1,-72.508188,7.927233
6752,2012,Julio,Ucrania,1,0,,1,-75.516486,10.446304
6753,2012,Julio,Ucrania,1,1,,2,-76.532004,3.451668
6754,2012,Julio,Ucrania,0,5,,5,-77.061029,3.8844260000000004
6755,2012,Julio,Ucrania,17,19,,36,-74.140516,4.697157
6756,2012,Julio,Ucrania,1,0,,1,-75.42726,6.170465
6757,2012,Julio,Uganda,0,1,,1,-75.516486,10.446304
6758,2012,Julio,Uganda,0,2,,2,-74.140516,4.697157
6759,2012,Julio,Federación de Rusia,1,3,,4,-77.35600000000001,0.81488
6760,2012,Julio,Federación de Rusia,4,4,,8,-75.516486,10.446304
6761,2012,Julio,Federación de Rusia,0,1,,1,-74.765343,10.970933
6762,2012,Julio,Federación de Rusia,0,1,,1,-72.129595,11.360028999999999
6763,2012,Julio,Federación de Rusia,1,2,,3,-76.532004,3.451668
6764,2012,Julio,Federación de Rusia,70,83,,153,-74.140516,4.697157
6765,2012,Julio,Federación de Rusia,0,3,,3,-72.453013,7.819
6766,2012,Julio,Uruguay,1,0,,1,-76.876446,0.33002
6767,2012,Julio,Uruguay,1,7,,8,-77.35600000000001,0.81488
6768,2012,Julio,Uruguay,0,1,,1,-75.527794,10.406342
6769,2012,Julio,Uruguay,136,99,,235,-75.516486,10.446304
6770,2012,Julio,Uruguay,2,8,,10,-74.77647900000001,10.886686
6771,2012,Julio,Uruguay,52,37,,89,-81.70216500000001,12.5862
6772,2012,Julio,Uruguay,7,19,,26,-76.532004,3.451668
6773,2012,Julio,Uruguay,130,277,,407,-74.140516,4.697157
6774,2012,Julio,Uruguay,0,3,,3,-75.736374,4.815189
6775,2012,Julio,Uruguay,17,30,,47,-75.42726,6.170465
6776,2012,Julio,Uruguay,0,9,,9,-72.453013,7.819
6777,2012,Julio,Uruguay,0,1,,1,-72.508188,7.927233
6778,2012,Julio,Uzbekistán,2,0,,2,-74.140516,4.697157
6779,2012,Julio,Venezuela,1,1,,2,-76.876446,0.33002
6780,2012,Julio,Venezuela,47,75,,122,-77.35600000000001,0.81488
6781,2012,Julio,Venezuela,0,3,,3,-75.527794,10.406342
6782,2012,Julio,Venezuela,88,94,,182,-75.516486,10.446304
6783,2012,Julio,Venezuela,29,70,,99,-74.77647900000001,10.886686
6784,2012,Julio,Venezuela,0,5,,5,-74.232675,11.117206
6785,2012,Julio,Venezuela,1810,2333,,4143,-72.129595,11.360028999999999
6786,2012,Julio,Venezuela,1,2,,3,-72.919186,11.52863
6787,2012,Julio,Venezuela,22,24,,46,-81.70216500000001,12.5862
6788,2012,Julio,Venezuela,37,55,,92,-76.532004,3.451668
6789,2012,Julio,Venezuela,0,1,,1,-75.76635300000001,4.45285
6790,2012,Julio,Venezuela,4918,6202,,11120,-74.140516,4.697157
6791,2012,Julio,Venezuela,5,17,,22,-75.736374,4.815189
6792,2012,Julio,Venezuela,478,511,,989,-75.42726,6.170465
6793,2012,Julio,Venezuela,7,4,,11,-67.48402800000001,6.185536
6794,2012,Julio,Venezuela,30,40,,70,-70.74025300000001,7.088728999999999
6795,2012,Julio,Venezuela,5,4,,9,-73.181317,7.1280470000000005
6796,2012,Julio,Venezuela,1785,1888,,3673,-72.453013,7.819
6797,2012,Julio,Venezuela,282,263,,545,-72.508188,7.927233
6798,2012,Julio,Vietnam,1,1,,2,-74.140516,4.697157
6799,2012,Julio,Yugoslavia,1,0,,1,-74.140516,4.697157
6800,2012,Julio,Zimbabue,0,4,,4,-74.140516,4.697157
6801,2012,Julio,Anguila/Territorio Británico de Ultramar,0,3,,3,-74.140516,4.697157
6802,2012,Julio,Reino Unido de Gran Bretaña e Irlanda del Norte,5,14,,19,-69.941498,4.191162
6803,2012,Julio,Reino Unido de Gran Bretaña e Irlanda del Norte,39,58,,97,-77.35600000000001,0.81488
6804,2012,Julio,Reino Unido de Gran Bretaña e Irlanda del Norte,12,19,,31,-75.527794,10.406342
6805,2012,Julio,Reino Unido de Gran Bretaña e Irlanda del Norte,12,22,,34,-75.516486,10.446304
6806,2012,Julio,Reino Unido de Gran Bretaña e Irlanda del Norte,0,4,,4,-74.77647900000001,10.886686
6807,2012,Julio,Reino Unido de Gran Bretaña e Irlanda del Norte,1,1,,2,-74.213989,11.247722999999999
6808,2012,Julio,Reino Unido de Gran Bretaña e Irlanda del Norte,2,7,,9,-72.129595,11.360028999999999
6809,2012,Julio,Reino Unido de Gran Bretaña e Irlanda del Norte,0,1,,1,-81.70216500000001,12.5862
6810,2012,Julio,Reino Unido de Gran Bretaña e Irlanda del Norte,0,2,,2,-81.372937,13.338761300000002
6811,2012,Julio,Reino Unido de Gran Bretaña e Irlanda del Norte,9,22,,31,-76.532004,3.451668
6812,2012,Julio,Reino Unido de Gran Bretaña e Irlanda del Norte,301,622,,923,-74.140516,4.697157
6813,2012,Julio,Reino Unido de Gran Bretaña e Irlanda del Norte,0,4,,4,-75.736374,4.815189
6814,2012,Julio,Reino Unido de Gran Bretaña e Irlanda del Norte,6,22,,28,-75.42726,6.170465
6815,2012,Julio,Reino Unido de Gran Bretaña e Irlanda del Norte,5,17,,22,-72.453013,7.819
6816,2012,Julio,Reino Unido de Gran Bretaña e Irlanda del Norte,0,1,,1,-72.508188,7.927233
6817,2012,Julio,Reino Unido de Gran Bretaña e Irlanda del Norte,5,12,,17,-77.35002,8.63337
6818,2012,Julio,Reino Unido de Gran Bretaña e Irlanda del Norte,0,1,,1,-75.68164200000001,9.402597
6819,2012,Julio,Países Bajos,2,4,,6,-69.941498,4.191162
6820,2012,Julio,Países Bajos,15,24,,39,-77.35600000000001,0.81488
6821,2012,Julio,Países Bajos,9,13,,22,-75.527794,10.406342
6822,2012,Julio,Países Bajos,17,34,,51,-75.516486,10.446304
6823,2012,Julio,Países Bajos,8,11,,19,-74.77647900000001,10.886686
6824,2012,Julio,Países Bajos,0,1,,1,-74.213989,11.247722999999999
6825,2012,Julio,Países Bajos,1,8,,9,-72.129595,11.360028999999999
6826,2012,Julio,Países Bajos,2,4,,6,-81.70216500000001,12.5862
6827,2012,Julio,Países Bajos,27,62,,89,-76.532004,3.451668
6828,2012,Julio,Países Bajos,0,9,,9,-77.061029,3.8844260000000004
6829,2012,Julio,Países Bajos,693,946,,1639,-74.140516,4.697157
6830,2012,Julio,Países Bajos,3,3,,6,-75.736374,4.815189
6831,2012,Julio,Países Bajos,69,85,,154,-75.42726,6.170465
6832,2012,Julio,Países Bajos,7,10,,17,-73.181317,7.1280470000000005
6833,2012,Julio,Países Bajos,6,14,,20,-72.453013,7.819
6834,2012,Julio,Países Bajos,2,0,,2,-72.508188,7.927233
6835,2012,Julio,Países Bajos,2,2,,4,-77.35002,8.63337
6836,2012,Julio,Eslovenia,0,1,,1,-75.516486,10.446304
6837,2012,Julio,Lituania,0,1,,1,-75.527794,10.406342
6838,2012,Julio,Lituania,1,5,,6,-74.140516,4.697157
6839,2012,Julio,Lituania,0,1,,1,-75.42726,6.170465
6840,2012,Julio,Reino Unido de Gran Bretaña e Irlanda del Norte,0,2,,2,-74.213989,11.247722999999999
6841,2012,Julio,Reino Unido de Gran Bretaña e Irlanda del Norte,1,0,,1,-77.35600000000001,0.81488
6842,2012,Julio,Reino Unido de Gran Bretaña e Irlanda del Norte,0,1,,1,-74.213989,11.247722999999999
6843,2012,Julio,Reino Unido de Gran Bretaña e Irlanda del Norte,2,4,,6,-74.140516,4.697157
6844,2012,Julio,Reino Unido de Gran Bretaña e Irlanda del Norte,1,0,,1,-69.941498,4.191162
6845,2012,Julio,Reino Unido de Gran Bretaña e Irlanda del Norte,2,1,,3,-77.35600000000001,0.81488
6846,2012,Julio,Reino Unido de Gran Bretaña e Irlanda del Norte,0,1,,1,-75.516486,10.446304
6847,2012,Julio,Reino Unido de Gran Bretaña e Irlanda del Norte,0,1,,1,-72.129595,11.360028999999999
6848,2012,Julio,Reino Unido de Gran Bretaña e Irlanda del Norte,0,1,,1,-76.532004,3.451668
6849,2012,Julio,Reino Unido de Gran Bretaña e Irlanda del Norte,14,15,,29,-74.140516,4.697157
6850,2012,Julio,Reino Unido de Gran Bretaña e Irlanda del Norte,0,2,,2,-75.42726,6.170465
6851,2012,Julio,Reino Unido de Gran Bretaña e Irlanda del Norte,8,0,,8,-77.35002,8.63337
6852,2012,Julio,Letonia,0,1,,1,-74.140516,4.697157
6853,2012,Agosto,Albania,1,0,,1,-74.140516,4.697157
6854,2012,Agosto,Alemania,13,13,,26,-69.941498,4.191162
6855,2012,Agosto,Alemania,67,81,,148,-77.35600000000001,0.81488
6856,2012,Agosto,Alemania,0,1,,1,-78.802679,18.00143
6857,2012,Agosto,Alemania,18,23,,41,-75.527794,10.406342
6858,2012,Agosto,Alemania,30,45,,75,-75.516486,10.446304
6859,2012,Agosto,Alemania,1,7,,8,-74.77647900000001,10.886686
6860,2012,Agosto,Alemania,2,2,,4,-74.213989,11.247722999999999
6861,2012,Agosto,Alemania,18,18,,36,-72.129595,11.360028999999999
6862,2012,Agosto,Alemania,2,1,,3,-72.919186,11.52863
6863,2012,Agosto,Alemania,1,3,,4,-81.703935,12.574411099999999
6864,2012,Agosto,Alemania,0,2,,2,-81.70216500000001,12.5862
6865,2012,Agosto,Alemania,41,59,,100,-76.532004,3.451668
6866,2012,Agosto,Alemania,0,1,,1,-77.061029,3.8844260000000004
6867,2012,Agosto,Alemania,2,1,,3,-75.76635300000001,4.45285
6868,2012,Agosto,Alemania,1439,1954,,3393,-74.140516,4.697157
6869,2012,Agosto,Alemania,1,0,,1,-75.736374,4.815189
6870,2012,Agosto,Alemania,55,93,,148,-75.42726,6.170465
6871,2012,Agosto,Alemania,1,2,,3,-73.181317,7.1280470000000005
6872,2012,Agosto,Alemania,5,15,,20,-72.453013,7.819
6873,2012,Agosto,Alemania,1,1,,2,-72.508188,7.927233
6874,2012,Agosto,Alemania,3,9,,12,-77.35002,8.63337
6875,2012,Agosto,Andorra,1,11,,12,-74.140516,4.697157
6876,2012,Agosto,Angola,0,2,,2,-74.140516,4.697157
6877,2012,Agosto,Antigua y Barbuda,1,5,,6,-74.140516,4.697157
6878,2012,Agosto,Países Bajos,0,3,,3,-75.42726,6.170465
6879,2012,Agosto,Arabia Saudita,1,2,,3,-74.140516,4.697157
6880,2012,Agosto,Arabia Saudita,0,1,,1,-74.140516,4.697157
6881,2012,Agosto,Argelia,3,4,,7,-74.140516,4.697157
6882,2012,Agosto,Argentina,3,3,,6,-69.941498,4.191162
6883,2012,Agosto,Argentina,2,1,,3,-76.876446,0.33002
6884,2012,Agosto,Argentina,72,108,,180,-77.35600000000001,0.81488
6885,2012,Agosto,Argentina,0,1,,1,-78.802679,18.00143
6886,2012,Agosto,Argentina,0,5,,5,-75.527794,10.406342
6887,2012,Agosto,Argentina,652,577,,1229,-75.516486,10.446304
6888,2012,Agosto,Argentina,13,26,,39,-74.77647900000001,10.886686
6889,2012,Agosto,Argentina,20,41,,61,-72.129595,11.360028999999999
6890,2012,Agosto,Argentina,271,218,,489,-81.70216500000001,12.5862
6891,2012,Agosto,Argentina,47,111,,158,-76.532004,3.451668
6892,2012,Agosto,Argentina,0,1,,1,-75.76635300000001,4.45285
6893,2012,Agosto,Argentina,2311,3747,,6058,-74.140516,4.697157
6894,2012,Agosto,Argentina,1,5,,6,-75.736374,4.815189
6895,2012,Agosto,Argentina,91,213,,304,-75.42726,6.170465
6896,2012,Agosto,Argentina,1,0,,1,-70.74025300000001,7.088728999999999
6897,2012,Agosto,Argentina,1,0,,1,-73.181317,7.1280470000000005
6898,2012,Agosto,Argentina,42,49,,91,-72.453013,7.819
6899,2012,Agosto,Argentina,1,0,,1,-72.508188,7.927233
6900,2012,Agosto,Argentina,7,10,,17,-77.35002,8.63337
6901,2012,Agosto,República de Armenia,0,1,,1,-77.35600000000001,0.81488
6902,2012,Agosto,República de Armenia,0,1,,1,-74.140516,4.697157
6903,2012,Agosto,Aruba,0,2,,2,-74.77647900000001,10.886686
6904,2012,Agosto,Aruba,2,3,,5,-74.140516,4.697157
6905,2012,Agosto,Aruba,1,0,,1,-75.42726,6.170465
6906,2012,Agosto,Australia,6,6,,12,-69.941498,4.191162
6907,2012,Agosto,Australia,37,39,,76,-77.35600000000001,0.81488
6908,2012,Agosto,Australia,22,30,,52,-75.527794,10.406342
6909,2012,Agosto,Australia,20,17,,37,-75.516486,10.446304
6910,2012,Agosto,Australia,4,9,,13,-74.77647900000001,10.886686
6911,2012,Agosto,Australia,4,5,,9,-72.129595,11.360028999999999
6912,2012,Agosto,Australia,0,1,,1,-81.703935,12.574411099999999
6913,2012,Agosto,Australia,0,3,,3,-81.70216500000001,12.5862
6914,2012,Agosto,Australia,6,18,,24,-76.532004,3.451668
6915,2012,Agosto,Australia,198,363,,561,-74.140516,4.697157
6916,2012,Agosto,Australia,35,57,,92,-75.42726,6.170465
6917,2012,Agosto,Australia,1,4,,5,-72.453013,7.819
6918,2012,Agosto,Australia,2,3,,5,-77.35002,8.63337
6919,2012,Agosto,Austria,5,7,,12,-69.941498,4.191162
6920,2012,Agosto,Austria,15,12,,27,-77.35600000000001,0.81488
6921,2012,Agosto,Austria,1,4,,5,-75.527794,10.406342
6922,2012,Agosto,Austria,4,10,,14,-75.516486,10.446304
6923,2012,Agosto,Austria,0,3,,3,-74.77647900000001,10.886686
6924,2012,Agosto,Austria,0,1,,1,-74.213989,11.247722999999999
6925,2012,Agosto,Austria,2,1,,3,-72.129595,11.360028999999999
6926,2012,Agosto,Austria,1,1,,2,-72.919186,11.52863
6927,2012,Agosto,Austria,1,0,,1,-81.70216500000001,12.5862
6928,2012,Agosto,Austria,4,3,,7,-76.532004,3.451668
6929,2012,Agosto,Austria,123,218,,341,-74.140516,4.697157
6930,2012,Agosto,Austria,2,12,,14,-75.42726,6.170465
6931,2012,Agosto,Austria,1,0,,1,-72.453013,7.819
6932,2012,Agosto,Azerbaiyán,2,4,,6,-74.140516,4.697157
6933,2012,Agosto,Bahamas,0,4,,4,-75.516486,10.446304
6934,2012,Agosto,Bahamas,1,0,,1,-74.77647900000001,10.886686
6935,2012,Agosto,Bahamas,0,1,,1,-76.532004,3.451668
6936,2012,Agosto,Bahamas,4,3,,7,-74.140516,4.697157
6937,2012,Agosto,Bahamas,0,1,,1,-75.42726,6.170465
6938,2012,Agosto,Bangladesh,0,2,,2,-74.140516,4.697157
6939,2012,Agosto,Barbados,1,0,,1,-75.516486,10.446304
6940,2012,Agosto,Barbados,4,2,,6,-74.140516,4.697157
6941,2012,Agosto,Barbados,0,3,,3,-75.42726,6.170465
6942,2012,Agosto,Barbados,0,1,,1,-72.508188,7.927233
6943,2012,Agosto,República de Belarús,1,2,,3,-74.140516,4.697157
6944,2012,Agosto,Bélgica,1,2,,3,-69.941498,4.191162
6945,2012,Agosto,Bélgica,9,11,,20,-77.35600000000001,0.81488
6946,2012,Agosto,Bélgica,4,11,,15,-75.516486,10.446304
6947,2012,Agosto,Bélgica,1,1,,2,-74.77647900000001,10.886686
6948,2012,Agosto,Bélgica,0,1,,1,-74.213989,11.247722999999999
6949,2012,Agosto,Bélgica,2,3,,5,-72.129595,11.360028999999999
6950,2012,Agosto,Bélgica,7,12,,19,-76.532004,3.451668
6951,2012,Agosto,Bélgica,93,248,,341,-74.140516,4.697157
6952,2012,Agosto,Bélgica,7,18,,25,-75.42726,6.170465
6953,2012,Agosto,Bélgica,0,2,,2,-72.453013,7.819
6954,2012,Agosto,Bélgica,0,2,,2,-77.35002,8.63337
6955,2012,Agosto,Belice,4,9,,13,-74.140516,4.697157
6956,2012,Agosto,Belice,0,1,,1,-75.42726,6.170465
6957,2012,Agosto,Benín,1,2,,3,-74.140516,4.697157
6958,2012,Agosto,Bermudas/Territorio Británico de Ultramar,0,1,,1,-74.140516,4.697157
6959,2012,Agosto,Bolivia,0,1,,1,-76.876446,0.33002
6960,2012,Agosto,Bolivia,18,39,,57,-77.35600000000001,0.81488
6961,2012,Agosto,Bolivia,11,19,,30,-75.516486,10.446304
6962,2012,Agosto,Bolivia,3,0,,3,-74.77647900000001,10.886686
6963,2012,Agosto,Bolivia,1,3,,4,-72.129595,11.360028999999999
6964,2012,Agosto,Bolivia,10,9,,19,-81.70216500000001,12.5862
6965,2012,Agosto,Bolivia,17,15,,32,-76.532004,3.451668
6966,2012,Agosto,Bolivia,246,355,,601,-74.140516,4.697157
6967,2012,Agosto,Bolivia,29,34,,63,-75.42726,6.170465
6968,2012,Agosto,Bolivia,2,7,,9,-72.453013,7.819
6969,2012,Agosto,Bosnia y Herzegovina,1,0,,1,-75.42726,6.170465
6970,2012,Agosto,Brasil,69,74,,143,-69.941498,4.191162
6971,2012,Agosto,Brasil,13,38,,51,-77.35600000000001,0.81488
6972,2012,Agosto,Brasil,2,0,,2,-78.802679,18.00143
6973,2012,Agosto,Brasil,1,0,,1,-75.527794,10.406342
6974,2012,Agosto,Brasil,87,91,,178,-75.516486,10.446304
6975,2012,Agosto,Brasil,6,14,,20,-74.77647900000001,10.886686
6976,2012,Agosto,Brasil,0,2,,2,-74.213989,11.247722999999999
6977,2012,Agosto,Brasil,4,19,,23,-72.129595,11.360028999999999
6978,2012,Agosto,Brasil,25,26,,51,-81.70216500000001,12.5862
6979,2012,Agosto,Brasil,32,59,,91,-76.532004,3.451668
6980,2012,Agosto,Brasil,2122,3685,,5807,-74.140516,4.697157
6981,2012,Agosto,Brasil,0,1,,1,-75.736374,4.815189
6982,2012,Agosto,Brasil,41,80,,121,-75.42726,6.170465
6983,2012,Agosto,Brasil,0,2,,2,-67.48402800000001,6.185536
6984,2012,Agosto,Brasil,5,28,,33,-72.453013,7.819
6985,2012,Agosto,Brasil,1,4,,5,-72.508188,7.927233
6986,2012,Agosto,Brasil,1,1,,2,-77.35002,8.63337
6987,2012,Agosto,Bulgaria,1,0,,1,-77.35600000000001,0.81488
6988,2012,Agosto,Bulgaria,0,1,,1,-74.77647900000001,10.886686
6989,2012,Agosto,Bulgaria,14,23,,37,-74.140516,4.697157
6990,2012,Agosto,Bulgaria,2,2,,4,-75.42726,6.170465
6991,2012,Agosto,Islas Caimán/Territorio Británico de Ultramar,1,0,,1,-76.532004,3.451668
6992,2012,Agosto,Camerún,0,1,,1,-76.532004,3.451668
6993,2012,Agosto,Camerún,0,3,,3,-74.140516,4.697157
6994,2012,Agosto,Canadá,6,5,,11,-69.941498,4.191162
6995,2012,Agosto,Canadá,12,13,,25,-77.35600000000001,0.81488
6996,2012,Agosto,Canadá,7,9,,16,-75.527794,10.406342
6997,2012,Agosto,Canadá,32,52,,84,-75.516486,10.446304
6998,2012,Agosto,Canadá,6,23,,29,-74.77647900000001,10.886686
6999,2012,Agosto,Canadá,0,1,,1,-74.765343,10.970933
7000,2012,Agosto,Canadá,0,4,,4,-72.129595,11.360028999999999
7001,2012,Agosto,Canadá,4,11,,15,-81.70216500000001,12.5862
7002,2012,Agosto,Canadá,0,1,,1,-81.372937,13.338761300000002
7003,2012,Agosto,Canadá,33,35,,68,-76.532004,3.451668
7004,2012,Agosto,Canadá,2,5,,7,-75.76635300000001,4.45285
7005,2012,Agosto,Canadá,878,1497,,2375,-74.140516,4.697157
7006,2012,Agosto,Canadá,1,2,,3,-75.736374,4.815189
7007,2012,Agosto,Canadá,41,141,,182,-75.42726,6.170465
7008,2012,Agosto,Canadá,0,1,,1,-73.181317,7.1280470000000005
7009,2012,Agosto,Canadá,3,9,,12,-72.453013,7.819
7010,2012,Agosto,Canadá,3,3,,6,-77.35002,8.63337
7011,2012,Agosto,España,14,10,,24,-77.35600000000001,0.81488
7012,2012,Agosto,España,1,2,,3,-75.527794,10.406342
7013,2012,Agosto,España,8,20,,28,-75.516486,10.446304
7014,2012,Agosto,España,4,7,,11,-74.77647900000001,10.886686
7015,2012,Agosto,España,0,1,,1,-72.129595,11.360028999999999
7016,2012,Agosto,España,0,1,,1,-72.919186,11.52863
7017,2012,Agosto,España,3,1,,4,-81.70216500000001,12.5862
7018,2012,Agosto,España,83,159,,242,-76.532004,3.451668
7019,2012,Agosto,España,199,357,,556,-74.140516,4.697157
7020,2012,Agosto,España,2,7,,9,-75.736374,4.815189
7021,2012,Agosto,España,78,176,,254,-75.42726,6.170465
7022,2012,Agosto,España,0,1,,1,-73.181317,7.1280470000000005
7023,2012,Agosto,España,2,3,,5,-72.453013,7.819
7024,2012,Agosto,España,0,3,,3,-72.508188,7.927233
7025,2012,Agosto,República Democrática del Congo,2,2,,4,-74.140516,4.697157
7026,2012,Agosto,República de Corea,0,1,,1,-69.941498,4.191162
7027,2012,Agosto,República de Corea,8,5,,13,-77.35600000000001,0.81488
7028,2012,Agosto,República de Corea,3,2,,5,-75.516486,10.446304
7029,2012,Agosto,República de Corea,0,2,,2,-74.77647900000001,10.886686
7030,2012,Agosto,República de Corea,0,1,,1,-72.129595,11.360028999999999
7031,2012,Agosto,República de Corea,1,1,,2,-81.70216500000001,12.5862
7032,2012,Agosto,República de Corea,0,1,,1,-76.532004,3.451668
7033,2012,Agosto,República de Corea,140,302,,442,-74.140516,4.697157
7034,2012,Agosto,República de Corea,7,7,,14,-75.42726,6.170465
7035,2012,Agosto,República de Corea,0,3,,3,-72.453013,7.819
7036,2012,Agosto,Costa de Marfil,0,1,,1,-76.532004,3.451668
7037,2012,Agosto,Costa Rica,0,2,,2,-77.35600000000001,0.81488
7038,2012,Agosto,Costa Rica,1,1,,2,-75.527794,10.406342
7039,2012,Agosto,Costa Rica,47,45,,92,-75.516486,10.446304
7040,2012,Agosto,Costa Rica,3,21,,24,-74.77647900000001,10.886686
7041,2012,Agosto,Costa Rica,0,1,,1,-72.129595,11.360028999999999
7042,2012,Agosto,Costa Rica,236,238,,474,-81.70216500000001,12.5862
7043,2012,Agosto,Costa Rica,32,57,,89,-76.532004,3.451668
7044,2012,Agosto,Costa Rica,368,625,,993,-74.140516,4.697157
7045,2012,Agosto,Costa Rica,1,7,,8,-75.736374,4.815189
7046,2012,Agosto,Costa Rica,89,219,,308,-75.42726,6.170465
7047,2012,Agosto,Costa Rica,1,0,,1,-67.48402800000001,6.185536
7048,2012,Agosto,Costa Rica,1,1,,2,-73.181317,7.1280470000000005
7049,2012,Agosto,Costa Rica,5,5,,10,-72.453013,7.819
7050,2012,Agosto,Costa Rica,0,2,,2,-72.508188,7.927233
7051,2012,Agosto,Costa Rica,1,0,,1,-77.35002,8.63337
7052,2012,Agosto,Croacia,0,1,,1,-75.527794,10.406342
7053,2012,Agosto,Croacia,1,1,,2,-75.516486,10.446304
7054,2012,Agosto,Croacia,0,4,,4,-74.765343,10.970933
7055,2012,Agosto,Croacia,0,1,,1,-74.213989,11.247722999999999
7056,2012,Agosto,Croacia,0,1,,1,-76.532004,3.451668
7057,2012,Agosto,Croacia,0,1,,1,-77.061029,3.8844260000000004
7058,2012,Agosto,Croacia,6,27,,33,-74.140516,4.697157
7059,2012,Agosto,Croacia,1,0,,1,-75.42726,6.170465
7060,2012,Agosto,Croacia,0,1,,1,-72.453013,7.819
7061,2012,Agosto,Cuba,0,1,,1,-76.876446,0.33002
7062,2012,Agosto,Cuba,2,2,,4,-77.35600000000001,0.81488
7063,2012,Agosto,Cuba,1,1,,2,-75.527794,10.406342
7064,2012,Agosto,Cuba,11,24,,35,-75.516486,10.446304
7065,2012,Agosto,Cuba,3,10,,13,-74.77647900000001,10.886686
7066,2012,Agosto,Cuba,0,3,,3,-72.129595,11.360028999999999
7067,2012,Agosto,Cuba,0,1,,1,-81.70216500000001,12.5862
7068,2012,Agosto,Cuba,14,27,,41,-76.532004,3.451668
7069,2012,Agosto,Cuba,67,172,,239,-74.140516,4.697157
7070,2012,Agosto,Cuba,3,3,,6,-75.736374,4.815189
7071,2012,Agosto,Cuba,10,24,,34,-75.42726,6.170465
7072,2012,Agosto,Cuba,4,1,,5,-73.181317,7.1280470000000005
7073,2012,Agosto,Cuba,0,3,,3,-72.453013,7.819
7074,2012,Agosto,Cuba,1,2,,3,-72.508188,7.927233
7075,2012,Agosto,Curazao,1,0,,1,-74.140516,4.697157
7076,2012,Agosto,Curazao,3,7,,10,-75.42726,6.170465
7077,2012,Agosto,República Checa,8,5,,13,-77.35600000000001,0.81488
7078,2012,Agosto,República Checa,0,2,,2,-72.129595,11.360028999999999
7079,2012,Agosto,República Checa,1,2,,3,-76.532004,3.451668
7080,2012,Agosto,República Checa,19,27,,46,-74.140516,4.697157
7081,2012,Agosto,República Checa,1,0,,1,-73.181317,7.1280470000000005
7082,2012,Agosto,República Checa,1,1,,2,-72.453013,7.819
7083,2012,Agosto,Chile,1,2,,3,-69.941498,4.191162
7084,2012,Agosto,Chile,0,2,,2,-76.876446,0.33002
7085,2012,Agosto,Chile,38,57,,95,-77.35600000000001,0.81488
7086,2012,Agosto,Chile,1,0,,1,-78.802679,18.00143
7087,2012,Agosto,Chile,2,0,,2,-75.527794,10.406342
7088,2012,Agosto,Chile,197,172,,369,-75.516486,10.446304
7089,2012,Agosto,Chile,5,27,,32,-74.77647900000001,10.886686
7090,2012,Agosto,Chile,1,6,,7,-72.129595,11.360028999999999
7091,2012,Agosto,Chile,132,63,,195,-81.70216500000001,12.5862
7092,2012,Agosto,Chile,26,75,,101,-76.532004,3.451668
7093,2012,Agosto,Chile,2064,3231,,5295,-74.140516,4.697157
7094,2012,Agosto,Chile,56,160,,216,-75.42726,6.170465
7095,2012,Agosto,Chile,1,2,,3,-73.181317,7.1280470000000005
7096,2012,Agosto,Chile,13,21,,34,-72.453013,7.819
7097,2012,Agosto,Chile,0,1,,1,-72.508188,7.927233
7098,2012,Agosto,China,0,1,,1,-76.876446,0.33002
7099,2012,Agosto,China,0,2,,2,-77.35600000000001,0.81488
7100,2012,Agosto,China,5,3,,8,-75.516486,10.446304
7101,2012,Agosto,China,1,0,,1,-74.77647900000001,10.886686
7102,2012,Agosto,China,1,1,,2,-72.129595,11.360028999999999
7103,2012,Agosto,China,1,0,,1,-81.70216500000001,12.5862
7104,2012,Agosto,China,2,2,,4,-76.532004,3.451668
7105,2012,Agosto,China,149,464,,613,-74.140516,4.697157
7106,2012,Agosto,China,5,11,,16,-75.42726,6.170465
7107,2012,Agosto,China,2,6,,8,-72.453013,7.819
7108,2012,Agosto,Taiwán,1,1,,2,-77.35600000000001,0.81488
7109,2012,Agosto,Taiwán,1,4,,5,-75.516486,10.446304
7110,2012,Agosto,Taiwán,3,4,,7,-81.70216500000001,12.5862
7111,2012,Agosto,Taiwán,1,3,,4,-76.532004,3.451668
7112,2012,Agosto,Taiwán,28,53,,81,-74.140516,4.697157
7113,2012,Agosto,Taiwán,3,10,,13,-75.42726,6.170465
7114,2012,Agosto,Taiwán,1,1,,2,-73.181317,7.1280470000000005
7115,2012,Agosto,Taiwán,0,2,,2,-72.453013,7.819
7116,2012,Agosto,Chipre,1,9,,10,-74.140516,4.697157
7117,2012,Agosto,Dinamarca,1,6,,7,-77.35600000000001,0.81488
7118,2012,Agosto,Dinamarca,0,1,,1,-75.527794,10.406342
7119,2012,Agosto,Dinamarca,2,9,,11,-75.516486,10.446304
7120,2012,Agosto,Dinamarca,0,2,,2,-74.77647900000001,10.886686
7121,2012,Agosto,Dinamarca,0,2,,2,-74.765343,10.970933
7122,2012,Agosto,Dinamarca,0,3,,3,-72.129595,11.360028999999999
7123,2012,Agosto,Dinamarca,3,5,,8,-76.532004,3.451668
7124,2012,Agosto,Dinamarca,42,97,,139,-74.140516,4.697157
7125,2012,Agosto,Dinamarca,1,5,,6,-75.42726,6.170465
7126,2012,Agosto,Dominica,0,1,,1,-75.527794,10.406342
7127,2012,Agosto,Dominica,0,1,,1,-72.129595,11.360028999999999
7128,2012,Agosto,Dominica,5,3,,8,-74.140516,4.697157
7129,2012,Agosto,Ecuador,0,1,,1,-69.941498,4.191162
7130,2012,Agosto,Ecuador,37,52,,89,-76.876446,0.33002
7131,2012,Agosto,Ecuador,1527,2087,,3614,-77.35600000000001,0.81488
7132,2012,Agosto,Ecuador,0,173,,173,-78.802679,18.00143
7133,2012,Agosto,Ecuador,1,29,,30,-75.527794,10.406342
7134,2012,Agosto,Ecuador,155,139,,294,-75.516486,10.446304
7135,2012,Agosto,Ecuador,1,3,,4,-74.77647900000001,10.886686
7136,2012,Agosto,Ecuador,8,11,,19,-72.129595,11.360028999999999
7137,2012,Agosto,Ecuador,0,1,,1,-72.919186,11.52863
7138,2012,Agosto,Ecuador,0,2,,2,-81.703935,12.574411099999999
7139,2012,Agosto,Ecuador,154,109,,263,-81.70216500000001,12.5862
7140,2012,Agosto,Ecuador,572,640,,1212,-76.532004,3.451668
7141,2012,Agosto,Ecuador,1,2,,3,-75.76635300000001,4.45285
7142,2012,Agosto,Ecuador,2372,3256,,5628,-74.140516,4.697157
7143,2012,Agosto,Ecuador,0,1,,1,-75.736374,4.815189
7144,2012,Agosto,Ecuador,694,807,,1501,-75.42726,6.170465
7145,2012,Agosto,Ecuador,1,2,,3,-73.181317,7.1280470000000005
7146,2012,Agosto,Ecuador,196,217,,413,-72.453013,7.819
7147,2012,Agosto,Ecuador,5,7,,12,-72.508188,7.927233
7148,2012,Agosto,Egipto,3,16,,19,-74.140516,4.697157
7149,2012,Agosto,El Salvador,0,1,,1,-77.35600000000001,0.81488
7150,2012,Agosto,El Salvador,9,8,,17,-75.516486,10.446304
7151,2012,Agosto,El Salvador,1,1,,2,-74.77647900000001,10.886686
7152,2012,Agosto,El Salvador,1,0,,1,-72.129595,11.360028999999999
7153,2012,Agosto,El Salvador,35,14,,49,-81.70216500000001,12.5862
7154,2012,Agosto,El Salvador,53,64,,117,-76.532004,3.451668
7155,2012,Agosto,El Salvador,365,562,,927,-74.140516,4.697157
7156,2012,Agosto,El Salvador,26,49,,75,-75.42726,6.170465
7157,2012,Agosto,El Salvador,2,2,,4,-72.453013,7.819
7158,2012,Agosto,Emiratos Árabes,0,1,,1,-74.140516,4.697157
7159,2012,Agosto,España,10,10,,20,-69.941498,4.191162
7160,2012,Agosto,España,25,43,,68,-77.35600000000001,0.81488
7161,2012,Agosto,España,1,0,,1,-78.802679,18.00143
7162,2012,Agosto,España,2,5,,7,-75.527794,10.406342
7163,2012,Agosto,España,51,99,,150,-75.516486,10.446304
7164,2012,Agosto,España,5,10,,15,-74.77647900000001,10.886686
7165,2012,Agosto,España,9,18,,27,-72.129595,11.360028999999999
7166,2012,Agosto,España,5,2,,7,-81.70216500000001,12.5862
7167,2012,Agosto,España,234,458,,692,-76.532004,3.451668
7168,2012,Agosto,España,2,1,,3,-75.76635300000001,4.45285
7169,2012,Agosto,España,2147,4050,,6197,-74.140516,4.697157
7170,2012,Agosto,España,2,5,,7,-75.736374,4.815189
7171,2012,Agosto,España,125,255,,380,-75.42726,6.170465
7172,2012,Agosto,España,0,4,,4,-70.74025300000001,7.088728999999999
7173,2012,Agosto,España,1,4,,5,-73.181317,7.1280470000000005
7174,2012,Agosto,España,14,28,,42,-72.453013,7.819
7175,2012,Agosto,España,0,6,,6,-72.508188,7.927233
7176,2012,Agosto,España,3,0,,3,-77.35002,8.63337
7177,2012,Agosto,Eritrea,0,2,,2,-74.140516,4.697157
7178,2012,Agosto,Eslovaquia,1,0,,1,-75.516486,10.446304
7179,2012,Agosto,Eslovaquia,0,2,,2,-74.77647900000001,10.886686
7180,2012,Agosto,Eslovaquia,1,1,,2,-76.532004,3.451668
7181,2012,Agosto,Eslovaquia,29,12,,41,-74.140516,4.697157
7182,2012,Agosto,Eslovenia,1,1,,2,-77.35600000000001,0.81488
7183,2012,Agosto,Eslovenia,0,2,,2,-75.527794,10.406342
7184,2012,Agosto,Eslovenia,2,0,,2,-72.129595,11.360028999999999
7185,2012,Agosto,Eslovenia,0,1,,1,-76.532004,3.451668
7186,2012,Agosto,Eslovenia,5,15,,20,-74.140516,4.697157
7187,2012,Agosto,Estados Unidos de América,17,11,,28,-69.941498,4.191162
7188,2012,Agosto,Estados Unidos de América,0,2,,2,-76.876446,0.33002
7189,2012,Agosto,Estados Unidos de América,62,83,,145,-77.35600000000001,0.81488
7190,2012,Agosto,Estados Unidos de América,38,65,,103,-75.527794,10.406342
7191,2012,Agosto,Estados Unidos de América,889,1713,,2602,-75.516486,10.446304
7192,2012,Agosto,Estados Unidos de América,361,555,,916,-74.77647900000001,10.886686
7193,2012,Agosto,Estados Unidos de América,0,1,,1,-74.232675,11.117206
7194,2012,Agosto,Estados Unidos de América,3,7,,10,-74.213989,11.247722999999999
7195,2012,Agosto,Estados Unidos de América,12,23,,35,-72.129595,11.360028999999999
7196,2012,Agosto,Estados Unidos de América,2,0,,2,-72.919186,11.52863
7197,2012,Agosto,Estados Unidos de América,42,38,,80,-81.70216500000001,12.5862
7198,2012,Agosto,Estados Unidos de América,5,4,,9,-81.372937,13.338761300000002
7199,2012,Agosto,Estados Unidos de América,876,1294,,2170,-76.532004,3.451668
7200,2012,Agosto,Estados Unidos de América,100,137,,237,-75.76635300000001,4.45285
7201,2012,Agosto,Estados Unidos de América,6568,12252,,18820,-74.140516,4.697157
7202,2012,Agosto,Estados Unidos de América,87,113,,200,-75.736374,4.815189
7203,2012,Agosto,Estados Unidos de América,1342,3083,,4425,-75.42726,6.170465
7204,2012,Agosto,Estados Unidos de América,1,1,,2,-70.74025300000001,7.088728999999999
7205,2012,Agosto,Estados Unidos de América,13,43,,56,-73.181317,7.1280470000000005
7206,2012,Agosto,Estados Unidos de América,53,70,,123,-72.453013,7.819
7207,2012,Agosto,Estados Unidos de América,16,13,,29,-72.508188,7.927233
7208,2012,Agosto,Estados Unidos de América,7,14,,21,-77.35002,8.63337
7209,2012,Agosto,Estonia,1,0,,1,-69.941498,4.191162
7210,2012,Agosto,Estonia,5,7,,12,-74.140516,4.697157
7211,2012,Agosto,Etiopia,0,4,,4,-74.140516,4.697157
7212,2012,Agosto,Islas Fiji,1,0,,1,-74.140516,4.697157
7213,2012,Agosto,Filipinas,1,1,,2,-77.35600000000001,0.81488
7214,2012,Agosto,Filipinas,0,19,,19,-75.527794,10.406342
7215,2012,Agosto,Filipinas,1,6,,7,-75.516486,10.446304
7216,2012,Agosto,Filipinas,0,26,,26,-74.765343,10.970933
7217,2012,Agosto,Filipinas,1,1,,2,-74.213989,11.247722999999999
7218,2012,Agosto,Filipinas,1,0,,1,-81.70216500000001,12.5862
7219,2012,Agosto,Filipinas,0,15,,15,-76.532004,3.451668
7220,2012,Agosto,Filipinas,0,27,,27,-77.061029,3.8844260000000004
7221,2012,Agosto,Filipinas,18,63,,81,-74.140516,4.697157
7222,2012,Agosto,Filipinas,0,1,,1,-75.42726,6.170465
7223,2012,Agosto,Filipinas,1,1,,2,-72.453013,7.819
7224,2012,Agosto,Filipinas,0,5,,5,-75.68164200000001,9.402597
7225,2012,Agosto,Finlandia,4,2,,6,-77.35600000000001,0.81488
7226,2012,Agosto,Finlandia,1,0,,1,-75.527794,10.406342
7227,2012,Agosto,Finlandia,0,2,,2,-75.516486,10.446304
7228,2012,Agosto,Finlandia,0,2,,2,-74.77647900000001,10.886686
7229,2012,Agosto,Finlandia,2,1,,3,-72.129595,11.360028999999999
7230,2012,Agosto,Finlandia,1,1,,2,-76.532004,3.451668
7231,2012,Agosto,Finlandia,30,45,,75,-74.140516,4.697157
7232,2012,Agosto,Finlandia,1,4,,5,-75.42726,6.170465
7233,2012,Agosto,Finlandia,0,2,,2,-73.181317,7.1280470000000005
7234,2012,Agosto,Finlandia,0,1,,1,-72.453013,7.819
7235,2012,Agosto,Francia,12,17,,29,-69.941498,4.191162
7236,2012,Agosto,Francia,43,63,,106,-77.35600000000001,0.81488
7237,2012,Agosto,Francia,1,0,,1,-78.802679,18.00143
7238,2012,Agosto,Francia,9,14,,23,-75.527794,10.406342
7239,2012,Agosto,Francia,30,37,,67,-75.516486,10.446304
7240,2012,Agosto,Francia,0,11,,11,-74.77647900000001,10.886686
7241,2012,Agosto,Francia,3,2,,5,-74.213989,11.247722999999999
7242,2012,Agosto,Francia,10,22,,32,-72.129595,11.360028999999999
7243,2012,Agosto,Francia,0,1,,1,-72.919186,11.52863
7244,2012,Agosto,Francia,0,1,,1,-81.70216500000001,12.5862
7245,2012,Agosto,Francia,33,68,,101,-76.532004,3.451668
7246,2012,Agosto,Francia,1345,2089,,3434,-74.140516,4.697157
7247,2012,Agosto,Francia,3,4,,7,-75.736374,4.815189
7248,2012,Agosto,Francia,35,66,,101,-75.42726,6.170465
7249,2012,Agosto,Francia,0,2,,2,-73.181317,7.1280470000000005
7250,2012,Agosto,Francia,13,20,,33,-72.453013,7.819
7251,2012,Agosto,Francia,2,2,,4,-72.508188,7.927233
7252,2012,Agosto,Francia,2,6,,8,-77.35002,8.63337
7253,2012,Agosto,Gambia,0,1,,1,-74.77647900000001,10.886686
7254,2012,Agosto,Georgia,0,1,,1,-74.140516,4.697157
7255,2012,Agosto,Ghana,0,2,,2,-74.140516,4.697157
7256,2012,Agosto,Granada,1,0,,1,-74.140516,4.697157
7257,2012,Agosto,Granada,2,1,,3,-75.42726,6.170465
7258,2012,Agosto,Grecia,0,2,,2,-75.527794,10.406342
7259,2012,Agosto,Grecia,0,2,,2,-75.516486,10.446304
7260,2012,Agosto,Grecia,2,0,,2,-74.77647900000001,10.886686
7261,2012,Agosto,Grecia,17,41,,58,-74.140516,4.697157
7262,2012,Agosto,Grecia,1,3,,4,-75.42726,6.170465
7263,2012,Agosto,Grecia,1,0,,1,-72.453013,7.819
7264,2012,Agosto,Grecia,0,2,,2,-75.68164200000001,9.402597
7265,2012,Agosto,Guatemala,0,1,,1,-77.35600000000001,0.81488
7266,2012,Agosto,Guatemala,19,33,,52,-75.516486,10.446304
7267,2012,Agosto,Guatemala,6,11,,17,-74.77647900000001,10.886686
7268,2012,Agosto,Guatemala,0,1,,1,-74.232675,11.117206
7269,2012,Agosto,Guatemala,1,3,,4,-72.129595,11.360028999999999
7270,2012,Agosto,Guatemala,32,78,,110,-76.532004,3.451668
7271,2012,Agosto,Guatemala,1,1,,2,-75.76635300000001,4.45285
7272,2012,Agosto,Guatemala,176,329,,505,-74.140516,4.697157
7273,2012,Agosto,Guatemala,2,10,,12,-75.736374,4.815189
7274,2012,Agosto,Guatemala,41,128,,169,-75.42726,6.170465
7275,2012,Agosto,Guatemala,0,2,,2,-73.181317,7.1280470000000005
7276,2012,Agosto,Guatemala,3,12,,15,-72.453013,7.819
7277,2012,Agosto,Guatemala,0,4,,4,-72.508188,7.927233
7278,2012,Agosto,Guyana,1,2,,3,-75.516486,10.446304
7279,2012,Agosto,Guyana,0,1,,1,-72.129595,11.360028999999999
7280,2012,Agosto,Guyana,1,5,,6,-76.532004,3.451668
7281,2012,Agosto,Guyana,0,5,,5,-74.140516,4.697157
7282,2012,Agosto,Guyana,1,4,,5,-75.42726,6.170465
7283,2012,Agosto,Guinea Ecuatorial,1,0,,1,-74.140516,4.697157
7284,2012,Agosto,Guayana Francesa/Departamento de Ultramar Francés,0,1,,1,-72.919186,11.52863
7285,2012,Agosto,Haití,0,2,,2,-75.516486,10.446304
7286,2012,Agosto,Haití,1,1,,2,-74.77647900000001,10.886686
7287,2012,Agosto,Haití,6,12,,18,-74.140516,4.697157
7288,2012,Agosto,Haití,2,4,,6,-75.42726,6.170465
7289,2012,Agosto,Honduras,0,7,,7,-75.527794,10.406342
7290,2012,Agosto,Honduras,10,23,,33,-75.516486,10.446304
7291,2012,Agosto,Honduras,2,4,,6,-74.77647900000001,10.886686
7292,2012,Agosto,Honduras,0,2,,2,-74.765343,10.970933
7293,2012,Agosto,Honduras,0,39,,39,-81.703935,12.574411099999999
7294,2012,Agosto,Honduras,1,2,,3,-81.70216500000001,12.5862
7295,2012,Agosto,Honduras,11,18,,29,-76.532004,3.451668
7296,2012,Agosto,Honduras,136,148,,284,-74.140516,4.697157
7297,2012,Agosto,Honduras,1,0,,1,-75.736374,4.815189
7298,2012,Agosto,Honduras,27,36,,63,-75.42726,6.170465
7299,2012,Agosto,Honduras,0,1,,1,-72.453013,7.819
7300,2012,Agosto,Honduras,1,0,,1,-77.35002,8.63337
7301,2012,Agosto,Hungría,1,1,,2,-77.35600000000001,0.81488
7302,2012,Agosto,Hungría,0,1,,1,-75.527794,10.406342
7303,2012,Agosto,Hungría,0,2,,2,-76.532004,3.451668
7304,2012,Agosto,Hungría,15,27,,42,-74.140516,4.697157
7305,2012,Agosto,Hungría,1,2,,3,-75.42726,6.170465
7306,2012,Agosto,Hungría,2,4,,6,-72.453013,7.819
7307,2012,Agosto,India,0,1,,1,-69.941498,4.191162
7308,2012,Agosto,India,0,7,,7,-77.35600000000001,0.81488
7309,2012,Agosto,India,0,1,,1,-75.527794,10.406342
7310,2012,Agosto,India,3,6,,9,-75.516486,10.446304
7311,2012,Agosto,India,0,4,,4,-74.77647900000001,10.886686
7312,2012,Agosto,India,0,5,,5,-76.532004,3.451668
7313,2012,Agosto,India,0,1,,1,-77.061029,3.8844260000000004
7314,2012,Agosto,India,32,258,,290,-74.140516,4.697157
7315,2012,Agosto,India,5,22,,27,-75.42726,6.170465
7316,2012,Agosto,Indonesia,1,1,,2,-75.516486,10.446304
7317,2012,Agosto,Indonesia,0,1,,1,-74.765343,10.970933
7318,2012,Agosto,Indonesia,0,1,,1,-76.532004,3.451668
7319,2012,Agosto,Indonesia,6,5,,11,-74.140516,4.697157
7320,2012,Agosto,Iraq,2,0,,2,-74.140516,4.697157
7321,2012,Agosto,Irán,5,19,,24,-74.140516,4.697157
7322,2012,Agosto,Irán,0,1,,1,-72.453013,7.819
7323,2012,Agosto,República de Irlanda,1,5,,6,-69.941498,4.191162
7324,2012,Agosto,República de Irlanda,11,17,,28,-77.35600000000001,0.81488
7325,2012,Agosto,República de Irlanda,3,2,,5,-75.527794,10.406342
7326,2012,Agosto,República de Irlanda,5,9,,14,-75.516486,10.446304
7327,2012,Agosto,República de Irlanda,0,1,,1,-72.129595,11.360028999999999
7328,2012,Agosto,República de Irlanda,0,6,,6,-76.532004,3.451668
7329,2012,Agosto,República de Irlanda,63,103,,166,-74.140516,4.697157
7330,2012,Agosto,República de Irlanda,5,7,,12,-75.42726,6.170465
7331,2012,Agosto,República de Irlanda,1,3,,4,-77.35002,8.63337
7332,2012,Agosto,Islandia,1,0,,1,-69.941498,4.191162
7333,2012,Agosto,Islandia,0,1,,1,-77.35600000000001,0.81488
7334,2012,Agosto,Islandia,0,1,,1,-75.527794,10.406342
7335,2012,Agosto,Islandia,2,2,,4,-75.516486,10.446304
7336,2012,Agosto,Islandia,0,1,,1,-74.765343,10.970933
7337,2012,Agosto,Islandia,0,1,,1,-76.532004,3.451668
7338,2012,Agosto,Islandia,5,6,,11,-74.140516,4.697157
7339,2012,Agosto,Islandia,0,1,,1,-75.42726,6.170465
7340,2012,Agosto,Isla de Man,0,1,,1,-69.941498,4.191162
7341,2012,Agosto,Isla de Man,8,21,,29,-77.35600000000001,0.81488
7342,2012,Agosto,Isla de Man,0,7,,7,-75.516486,10.446304
7343,2012,Agosto,Isla de Man,1,5,,6,-74.77647900000001,10.886686
7344,2012,Agosto,Isla de Man,10,18,,28,-76.532004,3.451668
7345,2012,Agosto,Isla de Man,41,69,,110,-74.140516,4.697157
7346,2012,Agosto,Isla de Man,8,43,,51,-75.42726,6.170465
7347,2012,Agosto,Isla de Man,1,2,,3,-72.453013,7.819
7348,2012,Agosto,Isla Johnston,0,1,,1,-75.42726,6.170465
7349,2012,Agosto,Israel,2,1,,3,-69.941498,4.191162
7350,2012,Agosto,Israel,23,53,,76,-77.35600000000001,0.81488
7351,2012,Agosto,Israel,0,1,,1,-75.527794,10.406342
7352,2012,Agosto,Israel,4,29,,33,-75.516486,10.446304
7353,2012,Agosto,Israel,3,8,,11,-74.77647900000001,10.886686
7354,2012,Agosto,Israel,2,3,,5,-81.70216500000001,12.5862
7355,2012,Agosto,Israel,3,18,,21,-76.532004,3.451668
7356,2012,Agosto,Israel,83,339,,422,-74.140516,4.697157
7357,2012,Agosto,Israel,15,73,,88,-75.42726,6.170465
7358,2012,Agosto,Israel,0,1,,1,-73.181317,7.1280470000000005
7359,2012,Agosto,Israel,0,1,,1,-72.453013,7.819
7360,2012,Agosto,Israel,3,4,,7,-77.35002,8.63337
7361,2012,Agosto,Islas Aland/Provincia de Finlandia,0,2,,2,-74.140516,4.697157
7362,2012,Agosto,Italia,7,12,,19,-69.941498,4.191162
7363,2012,Agosto,Italia,13,24,,37,-77.35600000000001,0.81488
7364,2012,Agosto,Italia,6,10,,16,-75.527794,10.406342
7365,2012,Agosto,Italia,49,156,,205,-75.516486,10.446304
7366,2012,Agosto,Italia,4,13,,17,-74.77647900000001,10.886686
7367,2012,Agosto,Italia,11,19,,30,-72.129595,11.360028999999999
7368,2012,Agosto,Italia,10,12,,22,-81.70216500000001,12.5862
7369,2012,Agosto,Italia,29,91,,120,-76.532004,3.451668
7370,2012,Agosto,Italia,649,1739,,2388,-74.140516,4.697157
7371,2012,Agosto,Italia,2,1,,3,-75.736374,4.815189
7372,2012,Agosto,Italia,50,117,,167,-75.42726,6.170465
7373,2012,Agosto,Italia,0,3,,3,-73.181317,7.1280470000000005
7374,2012,Agosto,Italia,7,27,,34,-72.453013,7.819
7375,2012,Agosto,Italia,1,5,,6,-72.508188,7.927233
7376,2012,Agosto,Italia,0,3,,3,-77.35002,8.63337
7377,2012,Agosto,Jamaica,2,0,,2,-75.516486,10.446304
7378,2012,Agosto,Jamaica,0,2,,2,-74.77647900000001,10.886686
7379,2012,Agosto,Jamaica,3,3,,6,-76.532004,3.451668
7380,2012,Agosto,Jamaica,11,15,,26,-74.140516,4.697157
7381,2012,Agosto,Jamaica,2,9,,11,-75.42726,6.170465
7382,2012,Agosto,Jamaica,0,1,,1,-72.453013,7.819
7383,2012,Agosto,Japón,0,1,,1,-69.941498,4.191162
7384,2012,Agosto,Japón,7,18,,25,-77.35600000000001,0.81488
7385,2012,Agosto,Japón,4,0,,4,-75.527794,10.406342
7386,2012,Agosto,Japón,1,17,,18,-75.516486,10.446304
7387,2012,Agosto,Japón,0,3,,3,-74.77647900000001,10.886686
7388,2012,Agosto,Japón,0,1,,1,-72.129595,11.360028999999999
7389,2012,Agosto,Japón,0,1,,1,-81.70216500000001,12.5862
7390,2012,Agosto,Japón,9,11,,20,-76.532004,3.451668
7391,2012,Agosto,Japón,176,451,,627,-74.140516,4.697157
7392,2012,Agosto,Japón,3,30,,33,-75.42726,6.170465
7393,2012,Agosto,Japón,4,3,,7,-72.453013,7.819
7394,2012,Agosto,Jordania,1,2,,3,-74.140516,4.697157
7395,2012,Agosto,Jordania,0,1,,1,-75.42726,6.170465
7396,2012,Agosto,Kazajistán,0,1,,1,-75.527794,10.406342
7397,2012,Agosto,Kenia,6,5,,11,-76.532004,3.451668
7398,2012,Agosto,Kenia,1,6,,7,-74.140516,4.697157
7399,2012,Agosto,Kenia,0,1,,1,-75.42726,6.170465
7400,2012,Agosto,Kuwait,0,3,,3,-74.140516,4.697157
7401,2012,Agosto,Letonia,0,2,,2,-75.516486,10.446304
7402,2012,Agosto,Letonia,1,0,,1,-74.77647900000001,10.886686
7403,2012,Agosto,Letonia,6,7,,13,-74.140516,4.697157
7404,2012,Agosto,Lituania,2,0,,2,-77.35600000000001,0.81488
7405,2012,Agosto,Lituania,2,1,,3,-75.516486,10.446304
7406,2012,Agosto,Lituania,0,1,,1,-76.532004,3.451668
7407,2012,Agosto,Lituania,5,7,,12,-74.140516,4.697157
7408,2012,Agosto,Lituania,0,2,,2,-75.42726,6.170465
7409,2012,Agosto,Líbano,0,1,,1,-74.77647900000001,10.886686
7410,2012,Agosto,Líbano,7,5,,12,-72.129595,11.360028999999999
7411,2012,Agosto,Líbano,1,2,,3,-76.532004,3.451668
7412,2012,Agosto,Líbano,22,39,,61,-74.140516,4.697157
7413,2012,Agosto,Líbano,0,1,,1,-75.42726,6.170465
7414,2012,Agosto,Líbano,0,1,,1,-73.181317,7.1280470000000005
7415,2012,Agosto,Liechtenstein,2,2,,4,-74.140516,4.697157
7416,2012,Agosto,Liechtenstein,0,1,,1,-75.42726,6.170465
7417,2012,Agosto,Luxemburgo,4,2,,6,-69.941498,4.191162
7418,2012,Agosto,Luxemburgo,0,1,,1,-72.129595,11.360028999999999
7419,2012,Agosto,Luxemburgo,9,20,,29,-74.140516,4.697157
7420,2012,Agosto,Luxemburgo,0,1,,1,-75.42726,6.170465
7421,2012,Agosto,Madagascar,0,2,,2,-74.140516,4.697157
7422,2012,Agosto,Malasia,0,2,,2,-75.516486,10.446304
7423,2012,Agosto,Malasia,10,19,,29,-74.140516,4.697157
7424,2012,Agosto,Malasia,0,2,,2,-75.42726,6.170465
7425,2012,Agosto,Malasia,0,1,,1,-72.453013,7.819
7426,2012,Agosto,Malawi,0,1,,1,-76.532004,3.451668
7427,2012,Agosto,Malta,0,1,,1,-75.516486,10.446304
7428,2012,Agosto,Malta,2,1,,3,-74.140516,4.697157
7429,2012,Agosto,Marruecos,0,2,,2,-74.77647900000001,10.886686
7430,2012,Agosto,Marruecos,4,8,,12,-74.140516,4.697157
7431,2012,Agosto,Marruecos,0,1,,1,-72.453013,7.819
7432,2012,Agosto,Mauricio,1,0,,1,-75.516486,10.446304
7433,2012,Agosto,México,0,1,,1,-69.941498,4.191162
7434,2012,Agosto,México,4,0,,4,-76.876446,0.33002
7435,2012,Agosto,México,15,25,,40,-77.35600000000001,0.81488
7436,2012,Agosto,México,0,2,,2,-78.802679,18.00143
7437,2012,Agosto,México,2,9,,11,-75.527794,10.406342
7438,2012,Agosto,México,82,153,,235,-75.516486,10.446304
7439,2012,Agosto,México,15,37,,52,-74.77647900000001,10.886686
7440,2012,Agosto,México,5,6,,11,-72.129595,11.360028999999999
7441,2012,Agosto,México,0,1,,1,-72.919186,11.52863
7442,2012,Agosto,México,0,2,,2,-81.703935,12.574411099999999
7443,2012,Agosto,México,2,11,,13,-81.70216500000001,12.5862
7444,2012,Agosto,México,65,160,,225,-76.532004,3.451668
7445,2012,Agosto,México,2015,4485,,6500,-74.140516,4.697157
7446,2012,Agosto,México,6,7,,13,-75.736374,4.815189
7447,2012,Agosto,México,128,401,,529,-75.42726,6.170465
7448,2012,Agosto,México,0,6,,6,-73.181317,7.1280470000000005
7449,2012,Agosto,México,14,32,,46,-72.453013,7.819
7450,2012,Agosto,México,2,4,,6,-72.508188,7.927233
7451,2012,Agosto,México,1,2,,3,-77.35002,8.63337
7452,2012,Agosto,República de Moldavia,2,0,,2,-74.140516,4.697157
7453,2012,Agosto,República de Moldavia,1,0,,1,-75.42726,6.170465
7454,2012,Agosto,Mónaco,0,1,,1,-75.516486,10.446304
7455,2012,Agosto,Mongolia,0,1,,1,-75.42726,6.170465
7456,2012,Agosto,Mozambique,0,1,,1,-76.876446,0.33002
7457,2012,Agosto,Mozambique,1,6,,7,-74.140516,4.697157
7458,2012,Agosto,Nepal,0,2,,2,-74.140516,4.697157
7459,2012,Agosto,Nicaragua,0,1,,1,-75.527794,10.406342
7460,2012,Agosto,Nicaragua,6,7,,13,-75.516486,10.446304
7461,2012,Agosto,Nicaragua,2,1,,3,-74.77647900000001,10.886686
7462,2012,Agosto,Nicaragua,3,1,,4,-81.70216500000001,12.5862
7463,2012,Agosto,Nicaragua,8,3,,11,-76.532004,3.451668
7464,2012,Agosto,Nicaragua,49,26,,75,-74.140516,4.697157
7465,2012,Agosto,Nicaragua,6,9,,15,-75.42726,6.170465
7466,2012,Agosto,Nicaragua,0,1,,1,-77.35002,8.63337
7467,2012,Agosto,Nigeria,1,3,,4,-74.140516,4.697157
7468,2012,Agosto,Noruega,2,1,,3,-77.35600000000001,0.81488
7469,2012,Agosto,Noruega,0,1,,1,-75.527794,10.406342
7470,2012,Agosto,Noruega,1,6,,7,-75.516486,10.446304
7471,2012,Agosto,Noruega,0,2,,2,-74.77647900000001,10.886686
7472,2012,Agosto,Noruega,1,5,,6,-74.765343,10.970933
7473,2012,Agosto,Noruega,0,1,,1,-72.129595,11.360028999999999
7474,2012,Agosto,Noruega,4,8,,12,-76.532004,3.451668
7475,2012,Agosto,Noruega,43,81,,124,-74.140516,4.697157
7476,2012,Agosto,Noruega,1,14,,15,-75.42726,6.170465
7477,2012,Agosto,Noruega,2,3,,5,-73.181317,7.1280470000000005
7478,2012,Agosto,Noruega,2,4,,6,-72.453013,7.819
7479,2012,Agosto,Nueva Zelanda,1,0,,1,-69.941498,4.191162
7480,2012,Agosto,Nueva Zelanda,7,9,,16,-77.35600000000001,0.81488
7481,2012,Agosto,Nueva Zelanda,3,8,,11,-75.516486,10.446304
7482,2012,Agosto,Nueva Zelanda,0,2,,2,-74.77647900000001,10.886686
7483,2012,Agosto,Nueva Zelanda,2,2,,4,-72.129595,11.360028999999999
7484,2012,Agosto,Nueva Zelanda,0,2,,2,-76.532004,3.451668
7485,2012,Agosto,Nueva Zelanda,32,60,,92,-74.140516,4.697157
7486,2012,Agosto,Nueva Zelanda,0,1,,1,-75.736374,4.815189
7487,2012,Agosto,Nueva Zelanda,4,5,,9,-75.42726,6.170465
7488,2012,Agosto,Nueva Zelanda,4,3,,7,-77.35002,8.63337
7489,2012,Agosto,Omán,1,0,,1,-74.140516,4.697157
7490,2012,Agosto,Nueva Zelanda,4,6,,10,-75.527794,10.406342
7491,2012,Agosto,Nueva Zelanda,1,0,,1,-75.516486,10.446304
7492,2012,Agosto,Nueva Zelanda,0,4,,4,-74.140516,4.697157
7493,2012,Agosto,Países Bajos,2,16,,18,-77.35600000000001,0.81488
7494,2012,Agosto,Países Bajos,3,7,,10,-75.516486,10.446304
7495,2012,Agosto,Países Bajos,3,6,,9,-74.77647900000001,10.886686
7496,2012,Agosto,Países Bajos,5,8,,13,-72.129595,11.360028999999999
7497,2012,Agosto,Países Bajos,30,30,,60,-72.919186,11.52863
7498,2012,Agosto,Países Bajos,10,28,,38,-76.532004,3.451668
7499,2012,Agosto,Países Bajos,0,2,,2,-77.061029,3.8844260000000004
7500,2012,Agosto,Países Bajos,145,282,,427,-74.140516,4.697157
7501,2012,Agosto,Países Bajos,0,2,,2,-75.736374,4.815189
7502,2012,Agosto,Países Bajos,115,191,,306,-75.42726,6.170465
7503,2012,Agosto,Países Bajos,6,8,,14,-73.181317,7.1280470000000005
7504,2012,Agosto,Países Bajos,1,0,,1,-72.453013,7.819
7505,2012,Agosto,Países Bajos,0,1,,1,-72.508188,7.927233
7506,2012,Agosto,Pakistán,0,1,,1,-77.35600000000001,0.81488
7507,2012,Agosto,Pakistán,0,1,,1,-72.129595,11.360028999999999
7508,2012,Agosto,Pakistán,4,12,,16,-74.140516,4.697157
7509,2012,Agosto,Pakistán,0,1,,1,-72.453013,7.819
7510,2012,Agosto,Panamá,0,2,,2,-77.35600000000001,0.81488
7511,2012,Agosto,Panamá,1,54,,55,-75.527794,10.406342
7512,2012,Agosto,Panamá,132,186,,318,-75.516486,10.446304
7513,2012,Agosto,Panamá,74,107,,181,-74.77647900000001,10.886686
7514,2012,Agosto,Panamá,0,1,,1,-74.765343,10.970933
7515,2012,Agosto,Panamá,1,2,,3,-72.129595,11.360028999999999
7516,2012,Agosto,Panamá,27,26,,53,-81.70216500000001,12.5862
7517,2012,Agosto,Panamá,104,172,,276,-76.532004,3.451668
7518,2012,Agosto,Panamá,479,766,,1245,-74.140516,4.697157
7519,2012,Agosto,Panamá,49,75,,124,-75.736374,4.815189
7520,2012,Agosto,Panamá,151,308,,459,-75.42726,6.170465
7521,2012,Agosto,Panamá,4,4,,8,-77.401154,6.222551999999999
7522,2012,Agosto,Panamá,11,9,,20,-73.181317,7.1280470000000005
7523,2012,Agosto,Panamá,1,3,,4,-72.453013,7.819
7524,2012,Agosto,Panamá,1,5,,6,-72.508188,7.927233
7525,2012,Agosto,Panamá,2,0,,2,-76.7333,8.06667
7526,2012,Agosto,Panamá,1,1,,2,-77.35002,8.63337
7527,2012,Agosto,Papúa Nueva Guinea,0,1,,1,-74.140516,4.697157
7528,2012,Agosto,Paraguay,2,0,,2,-77.35600000000001,0.81488
7529,2012,Agosto,Paraguay,32,13,,45,-75.516486,10.446304
7530,2012,Agosto,Paraguay,0,1,,1,-74.77647900000001,10.886686
7531,2012,Agosto,Paraguay,4,1,,5,-81.70216500000001,12.5862
7532,2012,Agosto,Paraguay,3,1,,4,-76.532004,3.451668
7533,2012,Agosto,Paraguay,65,77,,142,-74.140516,4.697157
7534,2012,Agosto,Paraguay,3,7,,10,-75.42726,6.170465
7535,2012,Agosto,Paraguay,1,1,,2,-72.453013,7.819
7536,2012,Agosto,Perú,24,33,,57,-69.941498,4.191162
7537,2012,Agosto,Perú,0,3,,3,-76.876446,0.33002
7538,2012,Agosto,Perú,153,357,,510,-77.35600000000001,0.81488
7539,2012,Agosto,Perú,1,4,,5,-75.527794,10.406342
7540,2012,Agosto,Perú,155,163,,318,-75.516486,10.446304
7541,2012,Agosto,Perú,6,23,,29,-74.77647900000001,10.886686
7542,2012,Agosto,Perú,0,2,,2,-74.765343,10.970933
7543,2012,Agosto,Perú,6,21,,27,-72.129595,11.360028999999999
7544,2012,Agosto,Perú,318,250,,568,-81.70216500000001,12.5862
7545,2012,Agosto,Perú,88,101,,189,-76.532004,3.451668
7546,2012,Agosto,Perú,0,1,,1,-77.061029,3.8844260000000004
7547,2012,Agosto,Perú,2511,3245,,5756,-74.140516,4.697157
7548,2012,Agosto,Perú,0,2,,2,-75.736374,4.815189
7549,2012,Agosto,Perú,160,315,,475,-75.42726,6.170465
7550,2012,Agosto,Perú,3,3,,6,-73.181317,7.1280470000000005
7551,2012,Agosto,Perú,32,65,,97,-72.453013,7.819
7552,2012,Agosto,Perú,0,1,,1,-72.508188,7.927233
7553,2012,Agosto,Perú,1,1,,2,-77.35002,8.63337
7554,2012,Agosto,Perú,0,2,,2,-75.68164200000001,9.402597
7555,2012,Agosto,Palestina,1,4,,5,-74.140516,4.697157
7556,2012,Agosto,Polonia,3,1,,4,-69.941498,4.191162
7557,2012,Agosto,Polonia,6,9,,15,-77.35600000000001,0.81488
7558,2012,Agosto,Polonia,1,4,,5,-75.527794,10.406342
7559,2012,Agosto,Polonia,1,2,,3,-75.516486,10.446304
7560,2012,Agosto,Polonia,3,1,,4,-72.129595,11.360028999999999
7561,2012,Agosto,Polonia,0,2,,2,-76.532004,3.451668
7562,2012,Agosto,Polonia,76,102,,178,-74.140516,4.697157
7563,2012,Agosto,Polonia,7,5,,12,-75.42726,6.170465
7564,2012,Agosto,Polonia,1,7,,8,-72.453013,7.819
7565,2012,Agosto,Polonia,0,1,,1,-77.35002,8.63337
7566,2012,Agosto,Portugal,1,3,,4,-77.35600000000001,0.81488
7567,2012,Agosto,Portugal,0,1,,1,-75.527794,10.406342
7568,2012,Agosto,Portugal,1,4,,5,-75.516486,10.446304
7569,2012,Agosto,Portugal,2,0,,2,-74.77647900000001,10.886686
7570,2012,Agosto,Portugal,1,1,,2,-72.129595,11.360028999999999
7571,2012,Agosto,Portugal,4,7,,11,-76.532004,3.451668
7572,2012,Agosto,Portugal,74,274,,348,-74.140516,4.697157
7573,2012,Agosto,Portugal,9,17,,26,-75.42726,6.170465
7574,2012,Agosto,Portugal,3,3,,6,-72.453013,7.819
7575,2012,Agosto,Puerto Rico/Territorio de Estados Unidos,0,3,,3,-75.516486,10.446304
7576,2012,Agosto,Puerto Rico/Territorio de Estados Unidos,0,1,,1,-74.140516,4.697157
7577,2012,Agosto,Puerto Rico/Territorio de Estados Unidos,1,1,,2,-75.42726,6.170465
7578,2012,Agosto,Qatar,3,0,,3,-74.140516,4.697157
7579,2012,Agosto,Qatar,0,1,,1,-75.42726,6.170465
7580,2012,Agosto,Reino Unido de Gran Bretaña e Irlanda del Norte,8,4,,12,-69.941498,4.191162
7581,2012,Agosto,Reino Unido de Gran Bretaña e Irlanda del Norte,7,8,,15,-77.35600000000001,0.81488
7582,2012,Agosto,Reino Unido de Gran Bretaña e Irlanda del Norte,17,27,,44,-75.516486,10.446304
7583,2012,Agosto,Reino Unido de Gran Bretaña e Irlanda del Norte,1,2,,3,-74.77647900000001,10.886686
7584,2012,Agosto,Reino Unido de Gran Bretaña e Irlanda del Norte,2,7,,9,-74.765343,10.970933
7585,2012,Agosto,Reino Unido de Gran Bretaña e Irlanda del Norte,4,6,,10,-72.129595,11.360028999999999
7586,2012,Agosto,Reino Unido de Gran Bretaña e Irlanda del Norte,0,1,,1,-81.70216500000001,12.5862
7587,2012,Agosto,Reino Unido de Gran Bretaña e Irlanda del Norte,12,15,,27,-76.532004,3.451668
7588,2012,Agosto,Reino Unido de Gran Bretaña e Irlanda del Norte,244,525,,769,-74.140516,4.697157
7589,2012,Agosto,Reino Unido de Gran Bretaña e Irlanda del Norte,16,26,,42,-75.42726,6.170465
7590,2012,Agosto,Reino Unido de Gran Bretaña e Irlanda del Norte,0,2,,2,-72.453013,7.819
7591,2012,Agosto,República de Belarús,0,1,,1,-74.140516,4.697157
7592,2012,Agosto,República Dominicana,5,10,,15,-77.35600000000001,0.81488
7593,2012,Agosto,República Dominicana,0,2,,2,-75.527794,10.406342
7594,2012,Agosto,República Dominicana,18,42,,60,-75.516486,10.446304
7595,2012,Agosto,República Dominicana,18,28,,46,-74.77647900000001,10.886686
7596,2012,Agosto,República Dominicana,0,1,,1,-74.213989,11.247722999999999
7597,2012,Agosto,República Dominicana,0,1,,1,-72.919186,11.52863
7598,2012,Agosto,República Dominicana,0,1,,1,-81.70216500000001,12.5862
7599,2012,Agosto,República Dominicana,18,22,,40,-76.532004,3.451668
7600,2012,Agosto,República Dominicana,226,268,,494,-74.140516,4.697157
7601,2012,Agosto,República Dominicana,1,1,,2,-75.736374,4.815189
7602,2012,Agosto,República Dominicana,30,97,,127,-75.42726,6.170465
7603,2012,Agosto,República Dominicana,2,4,,6,-73.181317,7.1280470000000005
7604,2012,Agosto,República Dominicana,7,7,,14,-72.453013,7.819
7605,2012,Agosto,República Dominicana,7,3,,10,-72.508188,7.927233
7606,2012,Agosto,República Dominicana,0,1,,1,-77.35002,8.63337
7607,2012,Agosto,República Checa,3,3,,6,-74.140516,4.697157
7608,2012,Agosto,República Checa,0,2,,2,-72.453013,7.819
7609,2012,Agosto,Rumania,0,1,,1,-77.35600000000001,0.81488
7610,2012,Agosto,Rumania,0,3,,3,-75.527794,10.406342
7611,2012,Agosto,Rumania,0,1,,1,-74.765343,10.970933
7612,2012,Agosto,Rumania,0,1,,1,-74.213989,11.247722999999999
7613,2012,Agosto,Rumania,0,1,,1,-72.129595,11.360028999999999
7614,2012,Agosto,Rumania,2,3,,5,-76.532004,3.451668
7615,2012,Agosto,Rumania,26,36,,62,-74.140516,4.697157
7616,2012,Agosto,Rumania,0,2,,2,-75.42726,6.170465
7617,2012,Agosto,Rumania,0,1,,1,-72.453013,7.819
7618,2012,Agosto,Federación de Rusia,0,4,,4,-77.35600000000001,0.81488
7619,2012,Agosto,Federación de Rusia,0,1,,1,-75.527794,10.406342
7620,2012,Agosto,Federación de Rusia,3,4,,7,-75.516486,10.446304
7621,2012,Agosto,Federación de Rusia,2,1,,3,-72.129595,11.360028999999999
7622,2012,Agosto,Federación de Rusia,4,2,,6,-76.532004,3.451668
7623,2012,Agosto,Federación de Rusia,40,40,,80,-74.140516,4.697157
7624,2012,Agosto,Federación de Rusia,1,0,,1,-75.736374,4.815189
7625,2012,Agosto,Federación de Rusia,0,1,,1,-75.42726,6.170465
7626,2012,Agosto,Rwanda,0,1,,1,-76.532004,3.451668
7627,2012,Agosto,San Cristóbal y Nevis,0,1,,1,-72.129595,11.360028999999999
7628,2012,Agosto,San Cristóbal y Nevis,0,2,,2,-74.140516,4.697157
7629,2012,Agosto,San Cristóbal y Nevis,1,1,,2,-75.42726,6.170465
7630,2012,Agosto,San  Vicente y las Granadinas,0,2,,2,-74.140516,4.697157
7631,2012,Agosto,San  Vicente y las Granadinas,0,2,,2,-75.42726,6.170465
7632,2012,Agosto,Santa Lucia,1,0,,1,-75.516486,10.446304
7633,2012,Agosto,Santa Lucia,3,0,,3,-74.140516,4.697157
7634,2012,Agosto,Santa Lucia,3,2,,5,-75.42726,6.170465
7635,2012,Agosto,Santa Lucia,1,1,,2,-73.181317,7.1280470000000005
7636,2012,Agosto,Serbia,0,1,,1,-77.35600000000001,0.81488
7637,2012,Agosto,Serbia,1,0,,1,-75.516486,10.446304
7638,2012,Agosto,Serbia,2,2,,4,-74.140516,4.697157
7639,2012,Agosto,Sierra Leona,0,1,,1,-74.140516,4.697157
7640,2012,Agosto,Singapur,1,0,,1,-77.35600000000001,0.81488
7641,2012,Agosto,Singapur,0,1,,1,-75.516486,10.446304
7642,2012,Agosto,Singapur,15,19,,34,-74.140516,4.697157
7643,2012,Agosto,Singapur,0,2,,2,-75.42726,6.170465
7644,2012,Agosto,República Árabe Siria,1,1,,2,-74.77647900000001,10.886686
7645,2012,Agosto,República Árabe Siria,0,1,,1,-72.129595,11.360028999999999
7646,2012,Agosto,Sri Lanka,1,3,,4,-74.140516,4.697157
7647,2012,Agosto,Sudáfrica,0,1,,1,-69.941498,4.191162
7648,2012,Agosto,Sudáfrica,1,3,,4,-77.35600000000001,0.81488
7649,2012,Agosto,Sudáfrica,2,4,,6,-75.516486,10.446304
7650,2012,Agosto,Sudáfrica,0,4,,4,-74.77647900000001,10.886686
7651,2012,Agosto,Sudáfrica,0,1,,1,-74.765343,10.970933
7652,2012,Agosto,Sudáfrica,1,1,,2,-72.129595,11.360028999999999
7653,2012,Agosto,Sudáfrica,0,3,,3,-76.532004,3.451668
7654,2012,Agosto,Sudáfrica,29,89,,118,-74.140516,4.697157
7655,2012,Agosto,Sudáfrica,2,2,,4,-75.42726,6.170465
7656,2012,Agosto,Sudáfrica,1,0,,1,-72.508188,7.927233
7657,2012,Agosto,Sudáfrica,0,5,,5,-77.35002,8.63337
7658,2012,Agosto,Sudán,1,0,,1,-75.516486,10.446304
7659,2012,Agosto,Sudán,1,0,,1,-74.140516,4.697157
7660,2012,Agosto,Suecia,1,0,,1,-69.941498,4.191162
7661,2012,Agosto,Suecia,1,4,,5,-77.35600000000001,0.81488
7662,2012,Agosto,Suecia,1,0,,1,-75.527794,10.406342
7663,2012,Agosto,Suecia,4,9,,13,-75.516486,10.446304
7664,2012,Agosto,Suecia,0,1,,1,-74.213989,11.247722999999999
7665,2012,Agosto,Suecia,1,1,,2,-72.129595,11.360028999999999
7666,2012,Agosto,Suecia,0,1,,1,-81.372937,13.338761300000002
7667,2012,Agosto,Suecia,3,7,,10,-76.532004,3.451668
7668,2012,Agosto,Suecia,80,159,,239,-74.140516,4.697157
7669,2012,Agosto,Suecia,0,1,,1,-75.736374,4.815189
7670,2012,Agosto,Suecia,4,16,,20,-75.42726,6.170465
7671,2012,Agosto,Suecia,0,2,,2,-73.181317,7.1280470000000005
7672,2012,Agosto,Suecia,0,2,,2,-72.453013,7.819
7673,2012,Agosto,Suecia,2,0,,2,-72.508188,7.927233
7674,2012,Agosto,Suiza,2,8,,10,-69.941498,4.191162
7675,2012,Agosto,Suiza,16,29,,45,-77.35600000000001,0.81488
7676,2012,Agosto,Suiza,10,9,,19,-75.527794,10.406342
7677,2012,Agosto,Suiza,13,16,,29,-75.516486,10.446304
7678,2012,Agosto,Suiza,1,1,,2,-74.77647900000001,10.886686
7679,2012,Agosto,Suiza,1,1,,2,-74.213989,11.247722999999999
7680,2012,Agosto,Suiza,3,0,,3,-72.129595,11.360028999999999
7681,2012,Agosto,Suiza,11,26,,37,-76.532004,3.451668
7682,2012,Agosto,Suiza,238,422,,660,-74.140516,4.697157
7683,2012,Agosto,Suiza,1,1,,2,-75.736374,4.815189
7684,2012,Agosto,Suiza,13,36,,49,-75.42726,6.170465
7685,2012,Agosto,Suiza,0,6,,6,-72.453013,7.819
7686,2012,Agosto,Suiza,0,1,,1,-72.508188,7.927233
7687,2012,Agosto,Suiza,3,0,,3,-77.35002,8.63337
7688,2012,Agosto,Surinam,4,8,,12,-74.140516,4.697157
7689,2012,Agosto,Surinam,3,4,,7,-75.42726,6.170465
7690,2012,Agosto,Taiwán,2,0,,2,-75.527794,10.406342
7691,2012,Agosto,Taiwán,1,0,,1,-76.532004,3.451668
7692,2012,Agosto,Taiwán,0,4,,4,-74.140516,4.697157
7693,2012,Agosto,Tailandia,1,0,,1,-74.77647900000001,10.886686
7694,2012,Agosto,Tailandia,0,1,,1,-72.129595,11.360028999999999
7695,2012,Agosto,Tailandia,7,8,,15,-74.140516,4.697157
7696,2012,Agosto,Tailandia,1,1,,2,-75.42726,6.170465
7697,2012,Agosto,Territorio Antártico Británico/Territorio Británico de Ultramar,0,2,,2,-77.35600000000001,0.81488
7698,2012,Agosto,Territorio Antártico Británico/Territorio Británico de Ultramar,0,1,,1,-72.129595,11.360028999999999
7699,2012,Agosto,Territorio Antártico Británico/Territorio Británico de Ultramar,0,4,,4,-74.140516,4.697157
7700,2012,Agosto,Territorio Antártico Británico/Territorio Británico de Ultramar,0,1,,1,-72.453013,7.819
7701,2012,Agosto,Tanzania,0,1,,1,-76.532004,3.451668
7702,2012,Agosto,Togo,0,1,,1,-75.516486,10.446304
7703,2012,Agosto,Togo,0,1,,1,-74.140516,4.697157
7704,2012,Agosto,Trinidad y Tobago,0,3,,3,-75.527794,10.406342
7705,2012,Agosto,Trinidad y Tobago,6,15,,21,-75.516486,10.446304
7706,2012,Agosto,Trinidad y Tobago,0,4,,4,-74.77647900000001,10.886686
7707,2012,Agosto,Trinidad y Tobago,1,2,,3,-72.129595,11.360028999999999
7708,2012,Agosto,Trinidad y Tobago,0,1,,1,-81.70216500000001,12.5862
7709,2012,Agosto,Trinidad y Tobago,0,1,,1,-76.532004,3.451668
7710,2012,Agosto,Trinidad y Tobago,21,65,,86,-74.140516,4.697157
7711,2012,Agosto,Trinidad y Tobago,66,52,,118,-75.42726,6.170465
7712,2012,Agosto,Trinidad y Tobago,3,1,,4,-73.181317,7.1280470000000005
7713,2012,Agosto,Túnez,2,6,,8,-74.140516,4.697157
7714,2012,Agosto,Turquía,2,1,,3,-69.941498,4.191162
7715,2012,Agosto,Turquía,0,1,,1,-77.35600000000001,0.81488
7716,2012,Agosto,Turquía,1,1,,2,-75.516486,10.446304
7717,2012,Agosto,Turquía,1,1,,2,-72.129595,11.360028999999999
7718,2012,Agosto,Turquía,0,2,,2,-76.532004,3.451668
7719,2012,Agosto,Turquía,42,58,,100,-74.140516,4.697157
7720,2012,Agosto,Turquía,1,6,,7,-75.42726,6.170465
7721,2012,Agosto,Turquía,0,2,,2,-72.453013,7.819
7722,2012,Agosto,Turkmenistán,1,0,,1,-74.140516,4.697157
7723,2012,Agosto,Ucrania,1,0,,1,-75.527794,10.406342
7724,2012,Agosto,Ucrania,0,1,,1,-74.765343,10.970933
7725,2012,Agosto,Ucrania,1,9,,10,-76.532004,3.451668
7726,2012,Agosto,Ucrania,13,10,,23,-74.140516,4.697157
7727,2012,Agosto,Ucrania,4,1,,5,-75.42726,6.170465
7728,2012,Agosto,Uganda,2,0,,2,-76.532004,3.451668
7729,2012,Agosto,Uganda,3,1,,4,-74.140516,4.697157
7730,2012,Agosto,Federación de Rusia,1,2,,3,-77.35600000000001,0.81488
7731,2012,Agosto,Federación de Rusia,4,4,,8,-75.516486,10.446304
7732,2012,Agosto,Federación de Rusia,0,3,,3,-74.765343,10.970933
7733,2012,Agosto,Federación de Rusia,0,2,,2,-74.213989,11.247722999999999
7734,2012,Agosto,Federación de Rusia,0,1,,1,-72.129595,11.360028999999999
7735,2012,Agosto,Federación de Rusia,2,0,,2,-76.532004,3.451668
7736,2012,Agosto,Federación de Rusia,0,1,,1,-77.061029,3.8844260000000004
7737,2012,Agosto,Federación de Rusia,96,135,,231,-74.140516,4.697157
7738,2012,Agosto,Federación de Rusia,9,1,,10,-75.42726,6.170465
7739,2012,Agosto,Federación de Rusia,1,0,,1,-72.453013,7.819
7740,2012,Agosto,Federación de Rusia,0,7,,7,-75.68164200000001,9.402597
7741,2012,Agosto,Uruguay,0,1,,1,-69.941498,4.191162
7742,2012,Agosto,Uruguay,4,8,,12,-77.35600000000001,0.81488
7743,2012,Agosto,Uruguay,1,0,,1,-75.527794,10.406342
7744,2012,Agosto,Uruguay,138,107,,245,-75.516486,10.446304
7745,2012,Agosto,Uruguay,2,9,,11,-74.77647900000001,10.886686
7746,2012,Agosto,Uruguay,2,3,,5,-72.129595,11.360028999999999
7747,2012,Agosto,Uruguay,58,55,,113,-81.70216500000001,12.5862
7748,2012,Agosto,Uruguay,9,28,,37,-76.532004,3.451668
7749,2012,Agosto,Uruguay,131,308,,439,-74.140516,4.697157
7750,2012,Agosto,Uruguay,1,0,,1,-75.736374,4.815189
7751,2012,Agosto,Uruguay,16,71,,87,-75.42726,6.170465
7752,2012,Agosto,Uruguay,1,0,,1,-73.181317,7.1280470000000005
7753,2012,Agosto,Uruguay,4,5,,9,-72.453013,7.819
7754,2012,Agosto,Venezuela,0,1,,1,-69.941498,4.191162
7755,2012,Agosto,Venezuela,5,1,,6,-76.876446,0.33002
7756,2012,Agosto,Venezuela,95,126,,221,-77.35600000000001,0.81488
7757,2012,Agosto,Venezuela,0,10,,10,-75.527794,10.406342
7758,2012,Agosto,Venezuela,462,289,,751,-75.516486,10.446304
7759,2012,Agosto,Venezuela,45,68,,113,-74.77647900000001,10.886686
7760,2012,Agosto,Venezuela,3578,3358,,6936,-72.129595,11.360028999999999
7761,2012,Agosto,Venezuela,2,0,,2,-72.919186,11.52863
7762,2012,Agosto,Venezuela,30,28,,58,-81.70216500000001,12.5862
7763,2012,Agosto,Venezuela,33,54,,87,-76.532004,3.451668
7764,2012,Agosto,Venezuela,1,1,,2,-75.76635300000001,4.45285
7765,2012,Agosto,Venezuela,6480,6578,,13058,-74.140516,4.697157
7766,2012,Agosto,Venezuela,1,9,,10,-75.736374,4.815189
7767,2012,Agosto,Venezuela,562,648,,1210,-75.42726,6.170465
7768,2012,Agosto,Venezuela,3,5,,8,-67.48402800000001,6.185536
7769,2012,Agosto,Venezuela,103,133,,236,-70.74025300000001,7.088728999999999
7770,2012,Agosto,Venezuela,3,8,,11,-73.181317,7.1280470000000005
7771,2012,Agosto,Venezuela,3295,3022,,6317,-72.453013,7.819
7772,2012,Agosto,Venezuela,502,484,,986,-72.508188,7.927233
7773,2012,Agosto,Venezuela,0,1,,1,-76.7333,8.06667
7774,2012,Agosto,Vietnam,3,3,,6,-74.140516,4.697157
7775,2012,Agosto,Yugoslavia,1,0,,1,-76.532004,3.451668
7776,2012,Agosto,Zambia,1,0,,1,-76.532004,3.451668
7777,2012,Agosto,Zimbabue,3,3,,6,-74.140516,4.697157
7778,2012,Agosto,Zimbabue,1,0,,1,-75.42726,6.170465
7779,2012,Agosto,Reino Unido de Gran Bretaña e Irlanda del Norte,8,10,,18,-69.941498,4.191162
7780,2012,Agosto,Reino Unido de Gran Bretaña e Irlanda del Norte,29,39,,68,-77.35600000000001,0.81488
7781,2012,Agosto,Reino Unido de Gran Bretaña e Irlanda del Norte,13,24,,37,-75.527794,10.406342
7782,2012,Agosto,Reino Unido de Gran Bretaña e Irlanda del Norte,19,31,,50,-75.516486,10.446304
7783,2012,Agosto,Reino Unido de Gran Bretaña e Irlanda del Norte,1,3,,4,-74.77647900000001,10.886686
7784,2012,Agosto,Reino Unido de Gran Bretaña e Irlanda del Norte,0,1,,1,-74.765343,10.970933
7785,2012,Agosto,Reino Unido de Gran Bretaña e Irlanda del Norte,4,11,,15,-72.129595,11.360028999999999
7786,2012,Agosto,Reino Unido de Gran Bretaña e Irlanda del Norte,1,3,,4,-81.70216500000001,12.5862
7787,2012,Agosto,Reino Unido de Gran Bretaña e Irlanda del Norte,13,13,,26,-76.532004,3.451668
7788,2012,Agosto,Reino Unido de Gran Bretaña e Irlanda del Norte,254,565,,819,-74.140516,4.697157
7789,2012,Agosto,Reino Unido de Gran Bretaña e Irlanda del Norte,0,1,,1,-75.736374,4.815189
7790,2012,Agosto,Reino Unido de Gran Bretaña e Irlanda del Norte,4,10,,14,-75.42726,6.170465
7791,2012,Agosto,Reino Unido de Gran Bretaña e Irlanda del Norte,5,8,,13,-72.453013,7.819
7792,2012,Agosto,Reino Unido de Gran Bretaña e Irlanda del Norte,0,2,,2,-72.508188,7.927233
7793,2012,Agosto,Reino Unido de Gran Bretaña e Irlanda del Norte,3,3,,6,-77.35002,8.63337
7794,2012,Agosto,Países Bajos,5,9,,14,-69.941498,4.191162
7795,2012,Agosto,Países Bajos,14,11,,25,-77.35600000000001,0.81488
7796,2012,Agosto,Países Bajos,0,2,,2,-78.802679,18.00143
7797,2012,Agosto,Países Bajos,6,13,,19,-75.527794,10.406342
7798,2012,Agosto,Países Bajos,7,21,,28,-75.516486,10.446304
7799,2012,Agosto,Países Bajos,0,9,,9,-74.77647900000001,10.886686
7800,2012,Agosto,Países Bajos,0,1,,1,-74.765343,10.970933
7801,2012,Agosto,Países Bajos,0,3,,3,-74.213989,11.247722999999999
7802,2012,Agosto,Países Bajos,0,1,,1,-72.129595,11.360028999999999
7803,2012,Agosto,Países Bajos,1,0,,1,-81.70216500000001,12.5862
7804,2012,Agosto,Países Bajos,7,56,,63,-76.532004,3.451668
7805,2012,Agosto,Países Bajos,0,11,,11,-77.061029,3.8844260000000004
7806,2012,Agosto,Países Bajos,0,1,,1,-75.76635300000001,4.45285
7807,2012,Agosto,Países Bajos,333,612,,945,-74.140516,4.697157
7808,2012,Agosto,Países Bajos,2,7,,9,-75.736374,4.815189
7809,2012,Agosto,Países Bajos,53,71,,124,-75.42726,6.170465
7810,2012,Agosto,Países Bajos,2,1,,3,-73.181317,7.1280470000000005
7811,2012,Agosto,Países Bajos,1,9,,10,-72.453013,7.819
7812,2012,Agosto,Países Bajos,1,0,,1,-72.508188,7.927233
7813,2012,Agosto,Países Bajos,1,1,,2,-77.35002,8.63337
7814,2012,Agosto,Desconocido,0,1,,1,-74.140516,4.697157
7815,2012,Agosto,Lituania,2,2,,4,-74.140516,4.697157
7816,2012,Agosto,Lituania,1,0,,1,-77.401154,6.222551999999999
7817,2012,Agosto,Reino Unido de Gran Bretaña e Irlanda del Norte,0,1,,1,-75.527794,10.406342
7818,2012,Agosto,Reino Unido de Gran Bretaña e Irlanda del Norte,1,0,,1,-77.35600000000001,0.81488
7819,2012,Agosto,Reino Unido de Gran Bretaña e Irlanda del Norte,5,8,,13,-74.140516,4.697157
7820,2012,Agosto,Reino Unido de Gran Bretaña e Irlanda del Norte,1,3,,4,-75.42726,6.170465
7821,2012,Agosto,Reino Unido de Gran Bretaña e Irlanda del Norte,0,1,,1,-77.35600000000001,0.81488
7822,2012,Agosto,Reino Unido de Gran Bretaña e Irlanda del Norte,0,4,,4,-75.527794,10.406342
7823,2012,Agosto,Reino Unido de Gran Bretaña e Irlanda del Norte,0,1,,1,-75.516486,10.446304
7824,2012,Agosto,Reino Unido de Gran Bretaña e Irlanda del Norte,5,9,,14,-74.140516,4.697157
7825,2012,Agosto,Reino Unido de Gran Bretaña e Irlanda del Norte,0,1,,1,-75.42726,6.170465
7826,2012,Agosto,Letonia,1,0,,1,-75.516486,10.446304
7827,2012,Agosto,República CentroÁfricana,0,1,,1,-74.140516,4.697157
7828,2012,Septiembre,Afganistán,0,1,,1,-77.35600000000001,0.81488
7829,2012,Septiembre,Albania,0,1,,1,-76.532004,3.451668
7830,2012,Septiembre,Albania,2,3,,5,-74.140516,4.697157
7831,2012,Septiembre,Alemania,9,25,,34,-69.941498,4.191162
7832,2012,Septiembre,Alemania,56,53,,109,-77.35600000000001,0.81488
7833,2012,Septiembre,Alemania,12,21,,33,-75.527794,10.406342
7834,2012,Septiembre,Alemania,39,45,,84,-75.516486,10.446304
7835,2012,Septiembre,Alemania,7,13,,20,-74.77647900000001,10.886686
7836,2012,Septiembre,Alemania,2,5,,7,-72.129595,11.360028999999999
7837,2012,Septiembre,Alemania,0,1,,1,-72.919186,11.52863
7838,2012,Septiembre,Alemania,3,2,,5,-81.70216500000001,12.5862
7839,2012,Septiembre,Alemania,22,40,,62,-76.532004,3.451668
7840,2012,Septiembre,Alemania,0,2,,2,-75.76635300000001,4.45285
7841,2012,Septiembre,Alemania,920,1590,,2510,-74.140516,4.697157
7842,2012,Septiembre,Alemania,0,1,,1,-75.736374,4.815189
7843,2012,Septiembre,Alemania,26,77,,103,-75.42726,6.170465
7844,2012,Septiembre,Alemania,1,0,,1,-70.74025300000001,7.088728999999999
7845,2012,Septiembre,Alemania,1,0,,1,-73.181317,7.1280470000000005
7846,2012,Septiembre,Alemania,8,5,,13,-72.453013,7.819
7847,2012,Septiembre,Alemania,2,1,,3,-72.508188,7.927233
7848,2012,Septiembre,Alemania,12,11,,23,-77.35002,8.63337
7849,2012,Septiembre,Andorra,2,5,,7,-74.140516,4.697157
7850,2012,Septiembre,Angola,0,1,,1,-74.77647900000001,10.886686
7851,2012,Septiembre,Angola,1,0,,1,-76.532004,3.451668
7852,2012,Septiembre,Angola,0,1,,1,-74.140516,4.697157
7853,2012,Septiembre,Antigua y Barbuda,0,1,,1,-75.516486,10.446304
7854,2012,Septiembre,Antigua y Barbuda,0,1,,1,-74.140516,4.697157
7855,2012,Septiembre,Países Bajos,0,2,,2,-75.42726,6.170465
7856,2012,Septiembre,Arabia Saudita,0,2,,2,-74.140516,4.697157
7857,2012,Septiembre,Argelia,4,9,,13,-74.140516,4.697157
7858,2012,Septiembre,Argentina,1,9,,10,-69.941498,4.191162
7859,2012,Septiembre,Argentina,1,0,,1,-76.876446,0.33002
7860,2012,Septiembre,Argentina,59,104,,163,-77.35600000000001,0.81488
7861,2012,Septiembre,Argentina,1,3,,4,-75.527794,10.406342
7862,2012,Septiembre,Argentina,714,628,,1342,-75.516486,10.446304
7863,2012,Septiembre,Argentina,6,24,,30,-74.77647900000001,10.886686
7864,2012,Septiembre,Argentina,0,1,,1,-74.213989,11.247722999999999
7865,2012,Septiembre,Argentina,13,15,,28,-72.129595,11.360028999999999
7866,2012,Septiembre,Argentina,291,200,,491,-81.70216500000001,12.5862
7867,2012,Septiembre,Argentina,66,99,,165,-76.532004,3.451668
7868,2012,Septiembre,Argentina,1,1,,2,-75.76635300000001,4.45285
7869,2012,Septiembre,Argentina,2610,4048,,6658,-74.140516,4.697157
7870,2012,Septiembre,Argentina,1,2,,3,-75.736374,4.815189
7871,2012,Septiembre,Argentina,83,204,,287,-75.42726,6.170465
7872,2012,Septiembre,Argentina,0,1,,1,-67.48402800000001,6.185536
7873,2012,Septiembre,Argentina,0,1,,1,-70.74025300000001,7.088728999999999
7874,2012,Septiembre,Argentina,2,4,,6,-73.181317,7.1280470000000005
7875,2012,Septiembre,Argentina,27,45,,72,-72.453013,7.819
7876,2012,Septiembre,Argentina,3,2,,5,-72.508188,7.927233
7877,2012,Septiembre,Argentina,9,14,,23,-77.35002,8.63337
7878,2012,Septiembre,República de Armenia,1,0,,1,-76.532004,3.451668
7879,2012,Septiembre,República de Armenia,1,2,,3,-74.140516,4.697157
7880,2012,Septiembre,Aruba,1,0,,1,-74.77647900000001,10.886686
7881,2012,Septiembre,Aruba,3,2,,5,-75.42726,6.170465
7882,2012,Septiembre,Australia,3,5,,8,-69.941498,4.191162
7883,2012,Septiembre,Australia,20,30,,50,-77.35600000000001,0.81488
7884,2012,Septiembre,Australia,24,26,,50,-75.527794,10.406342
7885,2012,Septiembre,Australia,17,25,,42,-75.516486,10.446304
7886,2012,Septiembre,Australia,3,18,,21,-74.77647900000001,10.886686
7887,2012,Septiembre,Australia,0,1,,1,-74.213989,11.247722999999999
7888,2012,Septiembre,Australia,0,2,,2,-72.129595,11.360028999999999
7889,2012,Septiembre,Australia,5,16,,21,-76.532004,3.451668
7890,2012,Septiembre,Australia,0,1,,1,-75.76635300000001,4.45285
7891,2012,Septiembre,Australia,192,356,,548,-74.140516,4.697157
7892,2012,Septiembre,Australia,18,43,,61,-75.42726,6.170465
7893,2012,Septiembre,Australia,0,1,,1,-72.453013,7.819
7894,2012,Septiembre,Australia,1,2,,3,-77.35002,8.63337
7895,2012,Septiembre,Austria,0,1,,1,-69.941498,4.191162
7896,2012,Septiembre,Austria,10,18,,28,-77.35600000000001,0.81488
7897,2012,Septiembre,Austria,2,2,,4,-75.527794,10.406342
7898,2012,Septiembre,Austria,4,7,,11,-75.516486,10.446304
7899,2012,Septiembre,Austria,0,2,,2,-74.77647900000001,10.886686
7900,2012,Septiembre,Austria,2,6,,8,-76.532004,3.451668
7901,2012,Septiembre,Austria,54,189,,243,-74.140516,4.697157
7902,2012,Septiembre,Austria,0,1,,1,-75.736374,4.815189
7903,2012,Septiembre,Austria,2,10,,12,-75.42726,6.170465
7904,2012,Septiembre,Austria,1,0,,1,-72.453013,7.819
7905,2012,Septiembre,Austria,0,1,,1,-72.508188,7.927233
7906,2012,Septiembre,Azerbaiyán,1,1,,2,-75.516486,10.446304
7907,2012,Septiembre,Azerbaiyán,0,1,,1,-74.140516,4.697157
7908,2012,Septiembre,Bahamas,0,1,,1,-75.516486,10.446304
7909,2012,Septiembre,Bahamas,0,3,,3,-74.77647900000001,10.886686
7910,2012,Septiembre,Bahamas,0,2,,2,-76.532004,3.451668
7911,2012,Septiembre,Bahamas,0,3,,3,-74.140516,4.697157
7912,2012,Septiembre,Bahamas,0,27,,27,-75.42726,6.170465
7913,2012,Septiembre,Bangladesh,0,3,,3,-74.140516,4.697157
7914,2012,Septiembre,Bangladesh,0,1,,1,-75.42726,6.170465
7915,2012,Septiembre,Barbados,0,3,,3,-74.77647900000001,10.886686
7916,2012,Septiembre,Barbados,0,3,,3,-76.532004,3.451668
7917,2012,Septiembre,Barbados,1,3,,4,-74.140516,4.697157
7918,2012,Septiembre,Barbados,0,1,,1,-75.42726,6.170465
7919,2012,Septiembre,República de Belarús,2,0,,2,-74.140516,4.697157
7920,2012,Septiembre,Bélgica,4,5,,9,-77.35600000000001,0.81488
7921,2012,Septiembre,Bélgica,5,6,,11,-75.516486,10.446304
7922,2012,Septiembre,Bélgica,0,1,,1,-74.77647900000001,10.886686
7923,2012,Septiembre,Bélgica,0,1,,1,-72.129595,11.360028999999999
7924,2012,Septiembre,Bélgica,4,11,,15,-76.532004,3.451668
7925,2012,Septiembre,Bélgica,103,224,,327,-74.140516,4.697157
7926,2012,Septiembre,Bélgica,9,14,,23,-75.42726,6.170465
7927,2012,Septiembre,Bélgica,0,1,,1,-72.453013,7.819
7928,2012,Septiembre,Belice,3,0,,3,-75.516486,10.446304
7929,2012,Septiembre,Belice,0,2,,2,-74.77647900000001,10.886686
7930,2012,Septiembre,Belice,0,1,,1,-72.129595,11.360028999999999
7931,2012,Septiembre,Belice,0,1,,1,-76.532004,3.451668
7932,2012,Septiembre,Belice,3,8,,11,-74.140516,4.697157
7933,2012,Septiembre,Belice,0,1,,1,-75.42726,6.170465
7934,2012,Septiembre,Benín,0,4,,4,-74.140516,4.697157
7935,2012,Septiembre,Bermudas/Territorio Británico de Ultramar,1,3,,4,-74.140516,4.697157
7936,2012,Septiembre,Bolivia,1,0,,1,-69.941498,4.191162
7937,2012,Septiembre,Bolivia,20,24,,44,-77.35600000000001,0.81488
7938,2012,Septiembre,Bolivia,0,1,,1,-75.527794,10.406342
7939,2012,Septiembre,Bolivia,16,32,,48,-75.516486,10.446304
7940,2012,Septiembre,Bolivia,4,3,,7,-74.77647900000001,10.886686
7941,2012,Septiembre,Bolivia,0,3,,3,-72.129595,11.360028999999999
7942,2012,Septiembre,Bolivia,2,2,,4,-81.70216500000001,12.5862
7943,2012,Septiembre,Bolivia,32,21,,53,-76.532004,3.451668
7944,2012,Septiembre,Bolivia,314,418,,732,-74.140516,4.697157
7945,2012,Septiembre,Bolivia,16,49,,65,-75.42726,6.170465
7946,2012,Septiembre,Bolivia,3,0,,3,-72.453013,7.819
7947,2012,Septiembre,Bolivia,2,0,,2,-72.508188,7.927233
7948,2012,Septiembre,Bolivia,1,1,,2,-77.35002,8.63337
7949,2012,Septiembre,Bosnia y Herzegovina,0,1,,1,-74.140516,4.697157
7950,2012,Septiembre,Brasil,117,119,,236,-69.941498,4.191162
7951,2012,Septiembre,Brasil,6,16,,22,-77.35600000000001,0.81488
7952,2012,Septiembre,Brasil,140,144,,284,-75.516486,10.446304
7953,2012,Septiembre,Brasil,5,11,,16,-74.77647900000001,10.886686
7954,2012,Septiembre,Brasil,0,1,,1,-74.213989,11.247722999999999
7955,2012,Septiembre,Brasil,5,3,,8,-72.129595,11.360028999999999
7956,2012,Septiembre,Brasil,19,15,,34,-81.70216500000001,12.5862
7957,2012,Septiembre,Brasil,39,79,,118,-76.532004,3.451668
7958,2012,Septiembre,Brasil,2409,3943,,6352,-74.140516,4.697157
7959,2012,Septiembre,Brasil,0,1,,1,-75.736374,4.815189
7960,2012,Septiembre,Brasil,52,117,,169,-75.42726,6.170465
7961,2012,Septiembre,Brasil,0,1,,1,-67.48402800000001,6.185536
7962,2012,Septiembre,Brasil,0,1,,1,-70.74025300000001,7.088728999999999
7963,2012,Septiembre,Brasil,9,19,,28,-72.453013,7.819
7964,2012,Septiembre,Brasil,1,2,,3,-72.508188,7.927233
7965,2012,Septiembre,Brasil,0,2,,2,-77.35002,8.63337
7966,2012,Septiembre,Bulgaria,0,10,,10,-75.516486,10.446304
7967,2012,Septiembre,Bulgaria,4,13,,17,-74.140516,4.697157
7968,2012,Septiembre,Bulgaria,3,1,,4,-75.42726,6.170465
7969,2012,Septiembre,Burundi,0,1,,1,-74.140516,4.697157
7970,2012,Septiembre,Cabo Verde,0,1,,1,-76.532004,3.451668
7971,2012,Septiembre,Cabo Verde,0,1,,1,-74.140516,4.697157
7972,2012,Septiembre,Cabo Verde,0,1,,1,-75.42726,6.170465
7973,2012,Septiembre,Islas Caimán/Territorio Británico de Ultramar,1,2,,3,-75.516486,10.446304
7974,2012,Septiembre,Camerún,1,0,,1,-77.35600000000001,0.81488
7975,2012,Septiembre,Camerún,1,3,,4,-74.140516,4.697157
7976,2012,Septiembre,Canadá,3,8,,11,-69.941498,4.191162
7977,2012,Septiembre,Canadá,10,4,,14,-77.35600000000001,0.81488
7978,2012,Septiembre,Canadá,3,14,,17,-75.527794,10.406342
7979,2012,Septiembre,Canadá,31,73,,104,-75.516486,10.446304
7980,2012,Septiembre,Canadá,11,32,,43,-74.77647900000001,10.886686
7981,2012,Septiembre,Canadá,0,4,,4,-74.232675,11.117206
7982,2012,Septiembre,Canadá,1,0,,1,-74.213989,11.247722999999999
7983,2012,Septiembre,Canadá,0,2,,2,-72.129595,11.360028999999999
7984,2012,Septiembre,Canadá,1,0,,1,-81.70216500000001,12.5862
7985,2012,Septiembre,Canadá,31,49,,80,-76.532004,3.451668
7986,2012,Septiembre,Canadá,1,3,,4,-75.76635300000001,4.45285
7987,2012,Septiembre,Canadá,494,1225,,1719,-74.140516,4.697157
7988,2012,Septiembre,Canadá,3,6,,9,-75.736374,4.815189
7989,2012,Septiembre,Canadá,46,138,,184,-75.42726,6.170465
7990,2012,Septiembre,Canadá,0,1,,1,-70.74025300000001,7.088728999999999
7991,2012,Septiembre,Canadá,0,1,,1,-73.181317,7.1280470000000005
7992,2012,Septiembre,Canadá,0,4,,4,-72.453013,7.819
7993,2012,Septiembre,Canadá,1,2,,3,-72.508188,7.927233
7994,2012,Septiembre,Canadá,7,3,,10,-77.35002,8.63337
7995,2012,Septiembre,España,0,1,,1,-76.876446,0.33002
7996,2012,Septiembre,España,5,8,,13,-77.35600000000001,0.81488
7997,2012,Septiembre,España,0,2,,2,-75.527794,10.406342
7998,2012,Septiembre,España,2,7,,9,-75.516486,10.446304
7999,2012,Septiembre,España,3,10,,13,-74.77647900000001,10.886686
8000,2012,Septiembre,España,0,1,,1,-81.70216500000001,12.5862
8001,2012,Septiembre,España,63,112,,175,-76.532004,3.451668
8002,2012,Septiembre,España,159,417,,576,-74.140516,4.697157
8003,2012,Septiembre,España,1,2,,3,-75.736374,4.815189
8004,2012,Septiembre,España,38,98,,136,-75.42726,6.170465
8005,2012,Septiembre,España,1,9,,10,-72.453013,7.819
8006,2012,Septiembre,España,1,0,,1,-72.508188,7.927233
8007,2012,Septiembre,República de Corea,2,2,,4,-77.35600000000001,0.81488
8008,2012,Septiembre,República de Corea,1,4,,5,-75.516486,10.446304
8009,2012,Septiembre,República de Corea,0,2,,2,-74.77647900000001,10.886686
8010,2012,Septiembre,República de Corea,1,0,,1,-72.129595,11.360028999999999
8011,2012,Septiembre,República de Corea,0,1,,1,-76.532004,3.451668
8012,2012,Septiembre,República de Corea,94,385,,479,-74.140516,4.697157
8013,2012,Septiembre,República de Corea,2,16,,18,-75.42726,6.170465
8014,2012,Septiembre,República de Corea,3,2,,5,-72.453013,7.819
8015,2012,Septiembre,República de Corea,1,0,,1,-77.35002,8.63337
8016,2012,Septiembre,Costa de Marfil,0,2,,2,-76.532004,3.451668
8017,2012,Septiembre,Costa Rica,1,2,,3,-77.35600000000001,0.81488
8018,2012,Septiembre,Costa Rica,48,69,,117,-75.516486,10.446304
8019,2012,Septiembre,Costa Rica,8,24,,32,-74.77647900000001,10.886686
8020,2012,Septiembre,Costa Rica,237,164,,401,-81.70216500000001,12.5862
8021,2012,Septiembre,Costa Rica,25,93,,118,-76.532004,3.451668
8022,2012,Septiembre,Costa Rica,411,684,,1095,-74.140516,4.697157
8023,2012,Septiembre,Costa Rica,3,2,,5,-75.736374,4.815189
8024,2012,Septiembre,Costa Rica,110,151,,261,-75.42726,6.170465
8025,2012,Septiembre,Costa Rica,0,2,,2,-73.181317,7.1280470000000005
8026,2012,Septiembre,Costa Rica,2,2,,4,-72.453013,7.819
8027,2012,Septiembre,Costa Rica,2,2,,4,-72.508188,7.927233
8028,2012,Septiembre,Costa Rica,0,1,,1,-77.35002,8.63337
8029,2012,Septiembre,Croacia,0,3,,3,-75.527794,10.406342
8030,2012,Septiembre,Croacia,0,1,,1,-74.765343,10.970933
8031,2012,Septiembre,Croacia,6,24,,30,-74.140516,4.697157
8032,2012,Septiembre,Croacia,0,1,,1,-75.42726,6.170465
8033,2012,Septiembre,Cuba,0,1,,1,-69.941498,4.191162
8034,2012,Septiembre,Cuba,1,3,,4,-77.35600000000001,0.81488
8035,2012,Septiembre,Cuba,1,1,,2,-75.527794,10.406342
8036,2012,Septiembre,Cuba,12,11,,23,-75.516486,10.446304
8037,2012,Septiembre,Cuba,4,15,,19,-74.77647900000001,10.886686
8038,2012,Septiembre,Cuba,10,30,,40,-76.532004,3.451668
8039,2012,Septiembre,Cuba,0,1,,1,-75.76635300000001,4.45285
8040,2012,Septiembre,Cuba,73,169,,242,-74.140516,4.697157
8041,2012,Septiembre,Cuba,10,28,,38,-75.42726,6.170465
8042,2012,Septiembre,Cuba,1,1,,2,-73.181317,7.1280470000000005
8043,2012,Septiembre,Cuba,0,3,,3,-72.453013,7.819
8044,2012,Septiembre,Cuba,1,0,,1,-72.508188,7.927233
8045,2012,Septiembre,Curazao,0,1,,1,-74.77647900000001,10.886686
8046,2012,Septiembre,Curazao,1,2,,3,-74.140516,4.697157
8047,2012,Septiembre,Curazao,6,9,,15,-75.42726,6.170465
8048,2012,Septiembre,República Checa,0,1,,1,-69.941498,4.191162
8049,2012,Septiembre,República Checa,3,10,,13,-77.35600000000001,0.81488
8050,2012,Septiembre,República Checa,1,2,,3,-75.516486,10.446304
8051,2012,Septiembre,República Checa,0,2,,2,-72.129595,11.360028999999999
8052,2012,Septiembre,República Checa,0,2,,2,-76.532004,3.451668
8053,2012,Septiembre,República Checa,22,32,,54,-74.140516,4.697157
8054,2012,Septiembre,República Checa,0,6,,6,-75.42726,6.170465
8055,2012,Septiembre,Chile,1,1,,2,-69.941498,4.191162
8056,2012,Septiembre,Chile,30,39,,69,-77.35600000000001,0.81488
8057,2012,Septiembre,Chile,0,1,,1,-75.527794,10.406342
8058,2012,Septiembre,Chile,112,119,,231,-75.516486,10.446304
8059,2012,Septiembre,Chile,9,27,,36,-74.77647900000001,10.886686
8060,2012,Septiembre,Chile,4,8,,12,-72.129595,11.360028999999999
8061,2012,Septiembre,Chile,140,99,,239,-81.70216500000001,12.5862
8062,2012,Septiembre,Chile,49,76,,125,-76.532004,3.451668
8063,2012,Septiembre,Chile,2750,3758,,6508,-74.140516,4.697157
8064,2012,Septiembre,Chile,1,2,,3,-75.736374,4.815189
8065,2012,Septiembre,Chile,41,132,,173,-75.42726,6.170465
8066,2012,Septiembre,Chile,0,1,,1,-67.48402800000001,6.185536
8067,2012,Septiembre,Chile,0,2,,2,-73.181317,7.1280470000000005
8068,2012,Septiembre,Chile,11,14,,25,-72.453013,7.819
8069,2012,Septiembre,Chile,1,2,,3,-72.508188,7.927233
8070,2012,Septiembre,Chile,1,2,,3,-77.35002,8.63337
8071,2012,Septiembre,China,0,2,,2,-77.35600000000001,0.81488
8072,2012,Septiembre,China,2,2,,4,-75.516486,10.446304
8073,2012,Septiembre,China,2,1,,3,-74.77647900000001,10.886686
8074,2012,Septiembre,China,1,7,,8,-76.532004,3.451668
8075,2012,Septiembre,China,172,458,,630,-74.140516,4.697157
8076,2012,Septiembre,China,6,12,,18,-75.42726,6.170465
8077,2012,Septiembre,China,2,4,,6,-72.453013,7.819
8078,2012,Septiembre,China,2,0,,2,-77.35002,8.63337
8079,2012,Septiembre,Taiwán,0,1,,1,-69.941498,4.191162
8080,2012,Septiembre,Taiwán,5,1,,6,-77.35600000000001,0.81488
8081,2012,Septiembre,Taiwán,3,2,,5,-75.516486,10.446304
8082,2012,Septiembre,Taiwán,0,2,,2,-74.77647900000001,10.886686
8083,2012,Septiembre,Taiwán,1,1,,2,-72.129595,11.360028999999999
8084,2012,Septiembre,Taiwán,0,2,,2,-76.532004,3.451668
8085,2012,Septiembre,Taiwán,53,91,,144,-74.140516,4.697157
8086,2012,Septiembre,Taiwán,1,4,,5,-75.736374,4.815189
8087,2012,Septiembre,Taiwán,3,5,,8,-75.42726,6.170465
8088,2012,Septiembre,Taiwán,2,0,,2,-72.453013,7.819
8089,2012,Septiembre,Chipre,4,2,,6,-74.140516,4.697157
8090,2012,Septiembre,Dinamarca,1,1,,2,-69.941498,4.191162
8091,2012,Septiembre,Dinamarca,3,1,,4,-77.35600000000001,0.81488
8092,2012,Septiembre,Dinamarca,0,1,,1,-75.527794,10.406342
8093,2012,Septiembre,Dinamarca,1,6,,7,-75.516486,10.446304
8094,2012,Septiembre,Dinamarca,0,1,,1,-74.77647900000001,10.886686
8095,2012,Septiembre,Dinamarca,2,3,,5,-76.532004,3.451668
8096,2012,Septiembre,Dinamarca,38,112,,150,-74.140516,4.697157
8097,2012,Septiembre,Dinamarca,6,8,,14,-75.42726,6.170465
8098,2012,Septiembre,Dinamarca,0,2,,2,-72.453013,7.819
8099,2012,Septiembre,Dominica,0,1,,1,-77.35600000000001,0.81488
8100,2012,Septiembre,Dominica,4,7,,11,-74.140516,4.697157
8101,2012,Septiembre,Dominica,0,1,,1,-75.42726,6.170465
8102,2012,Septiembre,Ecuador,0,1,,1,-69.941498,4.191162
8103,2012,Septiembre,Ecuador,10,25,,35,-76.876446,0.33002
8104,2012,Septiembre,Ecuador,802,1276,,2078,-77.35600000000001,0.81488
8105,2012,Septiembre,Ecuador,0,109,,109,-78.802679,18.00143
8106,2012,Septiembre,Ecuador,2,25,,27,-75.527794,10.406342
8107,2012,Septiembre,Ecuador,18,32,,50,-75.516486,10.446304
8108,2012,Septiembre,Ecuador,1,7,,8,-74.77647900000001,10.886686
8109,2012,Septiembre,Ecuador,6,21,,27,-72.129595,11.360028999999999
8110,2012,Septiembre,Ecuador,17,8,,25,-81.70216500000001,12.5862
8111,2012,Septiembre,Ecuador,338,359,,697,-76.532004,3.451668
8112,2012,Septiembre,Ecuador,0,3,,3,-77.061029,3.8844260000000004
8113,2012,Septiembre,Ecuador,0,2,,2,-75.76635300000001,4.45285
8114,2012,Septiembre,Ecuador,1766,3007,,4773,-74.140516,4.697157
8115,2012,Septiembre,Ecuador,2,1,,3,-75.736374,4.815189
8116,2012,Septiembre,Ecuador,455,571,,1026,-75.42726,6.170465
8117,2012,Septiembre,Ecuador,1,0,,1,-67.48402800000001,6.185536
8118,2012,Septiembre,Ecuador,5,3,,8,-73.181317,7.1280470000000005
8119,2012,Septiembre,Ecuador,127,173,,300,-72.453013,7.819
8120,2012,Septiembre,Ecuador,2,3,,5,-72.508188,7.927233
8121,2012,Septiembre,Egipto,1,10,,11,-74.140516,4.697157
8122,2012,Septiembre,El Salvador,0,2,,2,-77.35600000000001,0.81488
8123,2012,Septiembre,El Salvador,22,19,,41,-75.516486,10.446304
8124,2012,Septiembre,El Salvador,1,5,,6,-74.77647900000001,10.886686
8125,2012,Septiembre,El Salvador,0,1,,1,-72.129595,11.360028999999999
8126,2012,Septiembre,El Salvador,1,1,,2,-81.70216500000001,12.5862
8127,2012,Septiembre,El Salvador,42,95,,137,-76.532004,3.451668
8128,2012,Septiembre,El Salvador,342,663,,1005,-74.140516,4.697157
8129,2012,Septiembre,El Salvador,0,1,,1,-75.736374,4.815189
8130,2012,Septiembre,El Salvador,33,46,,79,-75.42726,6.170465
8131,2012,Septiembre,El Salvador,1,1,,2,-72.453013,7.819
8132,2012,Septiembre,El Salvador,0,1,,1,-72.508188,7.927233
8133,2012,Septiembre,El Salvador,0,1,,1,-77.35002,8.63337
8134,2012,Septiembre,Emiratos Árabes,1,13,,14,-74.140516,4.697157
8135,2012,Septiembre,España,3,6,,9,-69.941498,4.191162
8136,2012,Septiembre,España,20,32,,52,-77.35600000000001,0.81488
8137,2012,Septiembre,España,2,9,,11,-75.527794,10.406342
8138,2012,Septiembre,España,27,64,,91,-75.516486,10.446304
8139,2012,Septiembre,España,2,12,,14,-74.77647900000001,10.886686
8140,2012,Septiembre,España,7,5,,12,-72.129595,11.360028999999999
8141,2012,Septiembre,España,0,1,,1,-81.703935,12.574411099999999
8142,2012,Septiembre,España,3,8,,11,-81.70216500000001,12.5862
8143,2012,Septiembre,España,146,310,,456,-76.532004,3.451668
8144,2012,Septiembre,España,0,3,,3,-75.76635300000001,4.45285
8145,2012,Septiembre,España,1716,4364,,6080,-74.140516,4.697157
8146,2012,Septiembre,España,2,7,,9,-75.736374,4.815189
8147,2012,Septiembre,España,84,201,,285,-75.42726,6.170465
8148,2012,Septiembre,España,1,3,,4,-73.181317,7.1280470000000005
8149,2012,Septiembre,España,9,30,,39,-72.453013,7.819
8150,2012,Septiembre,España,0,8,,8,-72.508188,7.927233
8151,2012,Septiembre,España,3,5,,8,-77.35002,8.63337
8152,2012,Septiembre,Eslovaquia,3,3,,6,-75.516486,10.446304
8153,2012,Septiembre,Eslovaquia,0,1,,1,-76.532004,3.451668
8154,2012,Septiembre,Eslovaquia,9,12,,21,-74.140516,4.697157
8155,2012,Septiembre,Eslovaquia,1,0,,1,-75.42726,6.170465
8156,2012,Septiembre,Eslovaquia,3,3,,6,-72.453013,7.819
8157,2012,Septiembre,Eslovenia,0,1,,1,-75.527794,10.406342
8158,2012,Septiembre,Eslovenia,1,1,,2,-76.532004,3.451668
8159,2012,Septiembre,Eslovenia,7,19,,26,-74.140516,4.697157
8160,2012,Septiembre,Estados Unidos de América,8,18,,26,-69.941498,4.191162
8161,2012,Septiembre,Estados Unidos de América,31,58,,89,-77.35600000000001,0.81488
8162,2012,Septiembre,Estados Unidos de América,20,24,,44,-75.527794,10.406342
8163,2012,Septiembre,Estados Unidos de América,724,1524,,2248,-75.516486,10.446304
8164,2012,Septiembre,Estados Unidos de América,217,458,,675,-74.77647900000001,10.886686
8165,2012,Septiembre,Estados Unidos de América,0,3,,3,-74.232675,11.117206
8166,2012,Septiembre,Estados Unidos de América,4,9,,13,-74.213989,11.247722999999999
8167,2012,Septiembre,Estados Unidos de América,4,6,,10,-72.129595,11.360028999999999
8168,2012,Septiembre,Estados Unidos de América,0,3,,3,-72.919186,11.52863
8169,2012,Septiembre,Estados Unidos de América,0,2,,2,-81.703935,12.574411099999999
8170,2012,Septiembre,Estados Unidos de América,16,11,,27,-81.70216500000001,12.5862
8171,2012,Septiembre,Estados Unidos de América,0,2,,2,-81.372937,13.338761300000002
8172,2012,Septiembre,Estados Unidos de América,482,938,,1420,-76.532004,3.451668
8173,2012,Septiembre,Estados Unidos de América,68,115,,183,-75.76635300000001,4.45285
8174,2012,Septiembre,Estados Unidos de América,4141,9719,,13860,-74.140516,4.697157
8175,2012,Septiembre,Estados Unidos de América,43,45,,88,-75.736374,4.815189
8176,2012,Septiembre,Estados Unidos de América,697,2191,,2888,-75.42726,6.170465
8177,2012,Septiembre,Estados Unidos de América,9,21,,30,-73.181317,7.1280470000000005
8178,2012,Septiembre,Estados Unidos de América,19,33,,52,-72.453013,7.819
8179,2012,Septiembre,Estados Unidos de América,9,16,,25,-72.508188,7.927233
8180,2012,Septiembre,Estados Unidos de América,6,6,,12,-77.35002,8.63337
8181,2012,Septiembre,Estonia,0,1,,1,-77.35600000000001,0.81488
8182,2012,Septiembre,Estonia,0,1,,1,-75.527794,10.406342
8183,2012,Septiembre,Estonia,1,5,,6,-74.140516,4.697157
8184,2012,Septiembre,Etiopia,3,4,,7,-74.140516,4.697157
8185,2012,Septiembre,Filipinas,0,58,,58,-75.527794,10.406342
8186,2012,Septiembre,Filipinas,3,22,,25,-75.516486,10.446304
8187,2012,Septiembre,Filipinas,0,8,,8,-74.77647900000001,10.886686
8188,2012,Septiembre,Filipinas,0,16,,16,-74.765343,10.970933
8189,2012,Septiembre,Filipinas,0,11,,11,-74.213989,11.247722999999999
8190,2012,Septiembre,Filipinas,2,11,,13,-76.532004,3.451668
8191,2012,Septiembre,Filipinas,0,9,,9,-77.061029,3.8844260000000004
8192,2012,Septiembre,Filipinas,14,79,,93,-74.140516,4.697157
8193,2012,Septiembre,Filipinas,4,2,,6,-75.42726,6.170465
8194,2012,Septiembre,Filipinas,0,3,,3,-75.68164200000001,9.402597
8195,2012,Septiembre,Finlandia,1,0,,1,-69.941498,4.191162
8196,2012,Septiembre,Finlandia,3,0,,3,-77.35600000000001,0.81488
8197,2012,Septiembre,Finlandia,0,1,,1,-78.802679,18.00143
8198,2012,Septiembre,Finlandia,1,4,,5,-75.516486,10.446304
8199,2012,Septiembre,Finlandia,0,1,,1,-81.70216500000001,12.5862
8200,2012,Septiembre,Finlandia,0,2,,2,-76.532004,3.451668
8201,2012,Septiembre,Finlandia,27,60,,87,-74.140516,4.697157
8202,2012,Septiembre,Finlandia,0,2,,2,-75.42726,6.170465
8203,2012,Septiembre,Francia,5,4,,9,-69.941498,4.191162
8204,2012,Septiembre,Francia,0,1,,1,-76.876446,0.33002
8205,2012,Septiembre,Francia,27,43,,70,-77.35600000000001,0.81488
8206,2012,Septiembre,Francia,5,8,,13,-75.527794,10.406342
8207,2012,Septiembre,Francia,10,50,,60,-75.516486,10.446304
8208,2012,Septiembre,Francia,6,17,,23,-74.77647900000001,10.886686
8209,2012,Septiembre,Francia,5,5,,10,-74.213989,11.247722999999999
8210,2012,Septiembre,Francia,6,7,,13,-72.129595,11.360028999999999
8211,2012,Septiembre,Francia,26,58,,84,-76.532004,3.451668
8212,2012,Septiembre,Francia,664,1466,,2130,-74.140516,4.697157
8213,2012,Septiembre,Francia,0,4,,4,-75.736374,4.815189
8214,2012,Septiembre,Francia,22,58,,80,-75.42726,6.170465
8215,2012,Septiembre,Francia,0,1,,1,-73.181317,7.1280470000000005
8216,2012,Septiembre,Francia,1,11,,12,-72.453013,7.819
8217,2012,Septiembre,Francia,2,7,,9,-77.35002,8.63337
8218,2012,Septiembre,Georgia,1,0,,1,-74.77647900000001,10.886686
8219,2012,Septiembre,Georgia,3,0,,3,-74.140516,4.697157
8220,2012,Septiembre,Ghana,0,2,,2,-74.140516,4.697157
8221,2012,Septiembre,Ghana,0,1,,1,-72.453013,7.819
8222,2012,Septiembre,Granada,0,1,,1,-74.77647900000001,10.886686
8223,2012,Septiembre,Granada,0,2,,2,-74.140516,4.697157
8224,2012,Septiembre,Grecia,2,0,,2,-77.35600000000001,0.81488
8225,2012,Septiembre,Grecia,0,7,,7,-75.527794,10.406342
8226,2012,Septiembre,Grecia,0,2,,2,-75.516486,10.446304
8227,2012,Septiembre,Grecia,0,3,,3,-74.213989,11.247722999999999
8228,2012,Septiembre,Grecia,1,4,,5,-76.532004,3.451668
8229,2012,Septiembre,Grecia,12,34,,46,-74.140516,4.697157
8230,2012,Septiembre,Grecia,0,2,,2,-75.42726,6.170465
8231,2012,Septiembre,Grecia,0,2,,2,-72.453013,7.819
8232,2012,Septiembre,Grecia,0,1,,1,-76.7333,8.06667
8233,2012,Septiembre,Guatemala,3,4,,7,-69.941498,4.191162
8234,2012,Septiembre,Guatemala,2,5,,7,-77.35600000000001,0.81488
8235,2012,Septiembre,Guatemala,0,1,,1,-75.527794,10.406342
8236,2012,Septiembre,Guatemala,22,63,,85,-75.516486,10.446304
8237,2012,Septiembre,Guatemala,6,20,,26,-74.77647900000001,10.886686
8238,2012,Septiembre,Guatemala,0,1,,1,-74.232675,11.117206
8239,2012,Septiembre,Guatemala,0,2,,2,-72.129595,11.360028999999999
8240,2012,Septiembre,Guatemala,3,3,,6,-81.70216500000001,12.5862
8241,2012,Septiembre,Guatemala,24,147,,171,-76.532004,3.451668
8242,2012,Septiembre,Guatemala,176,492,,668,-74.140516,4.697157
8243,2012,Septiembre,Guatemala,0,2,,2,-75.736374,4.815189
8244,2012,Septiembre,Guatemala,39,111,,150,-75.42726,6.170465
8245,2012,Septiembre,Guatemala,0,1,,1,-73.181317,7.1280470000000005
8246,2012,Septiembre,Guatemala,34,22,,56,-72.453013,7.819
8247,2012,Septiembre,Guatemala,29,16,,45,-72.508188,7.927233
8248,2012,Septiembre,Guatemala,0,3,,3,-77.35002,8.63337
8249,2012,Septiembre,Guyana,0,4,,4,-74.77647900000001,10.886686
8250,2012,Septiembre,Guyana,0,4,,4,-76.532004,3.451668
8251,2012,Septiembre,Guyana,1,7,,8,-74.140516,4.697157
8252,2012,Septiembre,Guyana,0,1,,1,-75.736374,4.815189
8253,2012,Septiembre,Guyana,1,2,,3,-75.42726,6.170465
8254,2012,Septiembre,Haití,1,1,,2,-77.35600000000001,0.81488
8255,2012,Septiembre,Haití,1,1,,2,-75.516486,10.446304
8256,2012,Septiembre,Haití,1,1,,2,-74.77647900000001,10.886686
8257,2012,Septiembre,Haití,7,14,,21,-74.140516,4.697157
8258,2012,Septiembre,Haití,0,1,,1,-75.42726,6.170465
8259,2012,Septiembre,Honduras,1,1,,2,-75.527794,10.406342
8260,2012,Septiembre,Honduras,21,49,,70,-75.516486,10.446304
8261,2012,Septiembre,Honduras,6,7,,13,-74.77647900000001,10.886686
8262,2012,Septiembre,Honduras,2,10,,12,-81.703935,12.574411099999999
8263,2012,Septiembre,Honduras,0,1,,1,-81.70216500000001,12.5862
8264,2012,Septiembre,Honduras,13,32,,45,-76.532004,3.451668
8265,2012,Septiembre,Honduras,108,161,,269,-74.140516,4.697157
8266,2012,Septiembre,Honduras,25,44,,69,-75.42726,6.170465
8267,2012,Septiembre,Honduras,0,1,,1,-76.7333,8.06667
8268,2012,Septiembre,Honduras,0,1,,1,-77.35002,8.63337
8269,2012,Septiembre,Hungría,0,1,,1,-69.941498,4.191162
8270,2012,Septiembre,Hungría,1,2,,3,-75.516486,10.446304
8271,2012,Septiembre,Hungría,0,1,,1,-74.77647900000001,10.886686
8272,2012,Septiembre,Hungría,3,0,,3,-76.532004,3.451668
8273,2012,Septiembre,Hungría,20,42,,62,-74.140516,4.697157
8274,2012,Septiembre,Hungría,0,1,,1,-72.508188,7.927233
8275,2012,Septiembre,India,0,1,,1,-69.941498,4.191162
8276,2012,Septiembre,India,0,2,,2,-77.35600000000001,0.81488
8277,2012,Septiembre,India,2,5,,7,-75.516486,10.446304
8278,2012,Septiembre,India,0,2,,2,-74.77647900000001,10.886686
8279,2012,Septiembre,India,3,12,,15,-76.532004,3.451668
8280,2012,Septiembre,India,23,262,,285,-74.140516,4.697157
8281,2012,Septiembre,India,3,27,,30,-75.42726,6.170465
8282,2012,Septiembre,India,0,1,,1,-73.181317,7.1280470000000005
8283,2012,Septiembre,Indonesia,0,1,,1,-69.941498,4.191162
8284,2012,Septiembre,Indonesia,1,12,,13,-75.527794,10.406342
8285,2012,Septiembre,Indonesia,0,1,,1,-76.532004,3.451668
8286,2012,Septiembre,Indonesia,4,46,,50,-74.140516,4.697157
8287,2012,Septiembre,Indonesia,2,0,,2,-75.42726,6.170465
8288,2012,Septiembre,Irán,0,1,,1,-74.77647900000001,10.886686
8289,2012,Septiembre,Irán,3,12,,15,-74.140516,4.697157
8290,2012,Septiembre,Irán,0,1,,1,-75.42726,6.170465
8291,2012,Septiembre,República de Irlanda,12,6,,18,-77.35600000000001,0.81488
8292,2012,Septiembre,República de Irlanda,1,3,,4,-75.527794,10.406342
8293,2012,Septiembre,República de Irlanda,7,7,,14,-75.516486,10.446304
8294,2012,Septiembre,República de Irlanda,1,5,,6,-74.77647900000001,10.886686
8295,2012,Septiembre,República de Irlanda,1,8,,9,-76.532004,3.451668
8296,2012,Septiembre,República de Irlanda,52,89,,141,-74.140516,4.697157
8297,2012,Septiembre,República de Irlanda,2,8,,10,-75.42726,6.170465
8298,2012,Septiembre,República de Irlanda,2,0,,2,-72.453013,7.819
8299,2012,Septiembre,República de Irlanda,0,1,,1,-77.35002,8.63337
8300,2012,Septiembre,Islandia,0,2,,2,-77.35600000000001,0.81488
8301,2012,Septiembre,Islandia,1,1,,2,-75.516486,10.446304
8302,2012,Septiembre,Islandia,2,5,,7,-74.140516,4.697157
8303,2012,Septiembre,Islandia,0,2,,2,-75.42726,6.170465
8304,2012,Septiembre,Islandia,1,2,,3,-72.453013,7.819
8305,2012,Septiembre,Islandia,1,1,,2,-77.35002,8.63337
8306,2012,Septiembre,Isla de Man,3,6,,9,-77.35600000000001,0.81488
8307,2012,Septiembre,Isla de Man,5,7,,12,-75.516486,10.446304
8308,2012,Septiembre,Isla de Man,0,4,,4,-74.77647900000001,10.886686
8309,2012,Septiembre,Isla de Man,4,21,,25,-76.532004,3.451668
8310,2012,Septiembre,Isla de Man,27,81,,108,-74.140516,4.697157
8311,2012,Septiembre,Isla de Man,9,41,,50,-75.42726,6.170465
8312,2012,Septiembre,Isla de Man,1,3,,4,-72.453013,7.819
8313,2012,Septiembre,Israel,1,2,,3,-69.941498,4.191162
8314,2012,Septiembre,Israel,8,24,,32,-77.35600000000001,0.81488
8315,2012,Septiembre,Israel,1,1,,2,-75.527794,10.406342
8316,2012,Septiembre,Israel,3,15,,18,-75.516486,10.446304
8317,2012,Septiembre,Israel,0,3,,3,-74.77647900000001,10.886686
8318,2012,Septiembre,Israel,0,1,,1,-74.213989,11.247722999999999
8319,2012,Septiembre,Israel,1,3,,4,-81.70216500000001,12.5862
8320,2012,Septiembre,Israel,5,7,,12,-76.532004,3.451668
8321,2012,Septiembre,Israel,100,393,,493,-74.140516,4.697157
8322,2012,Septiembre,Israel,7,34,,41,-75.42726,6.170465
8323,2012,Septiembre,Israel,0,1,,1,-77.35002,8.63337
8324,2012,Septiembre,Islas Aland/Provincia de Finlandia,0,1,,1,-74.140516,4.697157
8325,2012,Septiembre,Italia,1,0,,1,-69.941498,4.191162
8326,2012,Septiembre,Italia,0,1,,1,-76.876446,0.33002
8327,2012,Septiembre,Italia,9,11,,20,-77.35600000000001,0.81488
8328,2012,Septiembre,Italia,1,4,,5,-75.527794,10.406342
8329,2012,Septiembre,Italia,26,68,,94,-75.516486,10.446304
8330,2012,Septiembre,Italia,6,13,,19,-74.77647900000001,10.886686
8331,2012,Septiembre,Italia,2,1,,3,-74.213989,11.247722999999999
8332,2012,Septiembre,Italia,2,3,,5,-72.129595,11.360028999999999
8333,2012,Septiembre,Italia,4,5,,9,-81.70216500000001,12.5862
8334,2012,Septiembre,Italia,17,69,,86,-76.532004,3.451668
8335,2012,Septiembre,Italia,337,1366,,1703,-74.140516,4.697157
8336,2012,Septiembre,Italia,0,3,,3,-75.736374,4.815189
8337,2012,Septiembre,Italia,19,81,,100,-75.42726,6.170465
8338,2012,Septiembre,Italia,0,1,,1,-70.74025300000001,7.088728999999999
8339,2012,Septiembre,Italia,5,16,,21,-72.453013,7.819
8340,2012,Septiembre,Italia,1,2,,3,-72.508188,7.927233
8341,2012,Septiembre,Italia,0,4,,4,-77.35002,8.63337
8342,2012,Septiembre,Islas del Canal,1,1,,2,-74.140516,4.697157
8343,2012,Septiembre,Jamaica,3,1,,4,-75.516486,10.446304
8344,2012,Septiembre,Jamaica,0,1,,1,-74.77647900000001,10.886686
8345,2012,Septiembre,Jamaica,2,2,,4,-76.532004,3.451668
8346,2012,Septiembre,Jamaica,5,5,,10,-74.140516,4.697157
8347,2012,Septiembre,Jamaica,2,2,,4,-75.42726,6.170465
8348,2012,Septiembre,Japón,0,4,,4,-69.941498,4.191162
8349,2012,Septiembre,Japón,4,6,,10,-77.35600000000001,0.81488
8350,2012,Septiembre,Japón,1,5,,6,-75.527794,10.406342
8351,2012,Septiembre,Japón,4,8,,12,-75.516486,10.446304
8352,2012,Septiembre,Japón,0,5,,5,-74.77647900000001,10.886686
8353,2012,Septiembre,Japón,1,2,,3,-72.129595,11.360028999999999
8354,2012,Septiembre,Japón,1,1,,2,-81.70216500000001,12.5862
8355,2012,Septiembre,Japón,8,13,,21,-76.532004,3.451668
8356,2012,Septiembre,Japón,0,1,,1,-75.76635300000001,4.45285
8357,2012,Septiembre,Japón,140,419,,559,-74.140516,4.697157
8358,2012,Septiembre,Japón,0,2,,2,-75.736374,4.815189
8359,2012,Septiembre,Japón,3,27,,30,-75.42726,6.170465
8360,2012,Septiembre,Japón,0,1,,1,-77.401154,6.222551999999999
8361,2012,Septiembre,Japón,2,4,,6,-72.453013,7.819
8362,2012,Septiembre,Jordania,5,6,,11,-74.140516,4.697157
8363,2012,Septiembre,Kazajistán,2,3,,5,-74.140516,4.697157
8364,2012,Septiembre,Kazajistán,2,0,,2,-75.42726,6.170465
8365,2012,Septiembre,Kenia,5,15,,20,-74.140516,4.697157
8366,2012,Septiembre,Kenia,0,1,,1,-75.42726,6.170465
8367,2012,Septiembre,Kuwait,0,1,,1,-75.42726,6.170465
8368,2012,Septiembre,Letonia,0,2,,2,-77.35600000000001,0.81488
8369,2012,Septiembre,Letonia,1,1,,2,-75.516486,10.446304
8370,2012,Septiembre,Letonia,1,0,,1,-74.77647900000001,10.886686
8371,2012,Septiembre,Letonia,1,10,,11,-74.765343,10.970933
8372,2012,Septiembre,Letonia,1,8,,9,-74.140516,4.697157
8373,2012,Septiembre,Letonia,0,1,,1,-75.42726,6.170465
8374,2012,Septiembre,Lituania,0,1,,1,-77.35600000000001,0.81488
8375,2012,Septiembre,Lituania,1,0,,1,-75.516486,10.446304
8376,2012,Septiembre,Lituania,0,1,,1,-76.532004,3.451668
8377,2012,Septiembre,Lituania,1,10,,11,-74.140516,4.697157
8378,2012,Septiembre,Lituania,0,1,,1,-75.42726,6.170465
8379,2012,Septiembre,Líbano,0,2,,2,-77.35600000000001,0.81488
8380,2012,Septiembre,Líbano,0,1,,1,-75.516486,10.446304
8381,2012,Septiembre,Líbano,0,3,,3,-74.77647900000001,10.886686
8382,2012,Septiembre,Líbano,9,1,,10,-72.129595,11.360028999999999
8383,2012,Septiembre,Líbano,0,2,,2,-81.70216500000001,12.5862
8384,2012,Septiembre,Líbano,0,3,,3,-76.532004,3.451668
8385,2012,Septiembre,Líbano,22,36,,58,-74.140516,4.697157
8386,2012,Septiembre,Líbano,0,1,,1,-73.181317,7.1280470000000005
8387,2012,Septiembre,Líbano,1,0,,1,-72.453013,7.819
8388,2012,Septiembre,Libia,0,2,,2,-74.140516,4.697157
8389,2012,Septiembre,Liechtenstein,0,1,,1,-75.516486,10.446304
8390,2012,Septiembre,Liechtenstein,0,2,,2,-74.140516,4.697157
8391,2012,Septiembre,Luxemburgo,0,2,,2,-77.35600000000001,0.81488
8392,2012,Septiembre,Luxemburgo,3,6,,9,-74.140516,4.697157
8393,2012,Septiembre,Macedonia,0,1,,1,-74.140516,4.697157
8394,2012,Septiembre,Madagascar,1,0,,1,-74.140516,4.697157
8395,2012,Septiembre,Malasia,1,4,,5,-75.516486,10.446304
8396,2012,Septiembre,Malasia,25,66,,91,-74.140516,4.697157
8397,2012,Septiembre,Malasia,0,1,,1,-75.42726,6.170465
8398,2012,Septiembre,Malta,0,1,,1,-74.140516,4.697157
8399,2012,Septiembre,Malta,0,1,,1,-75.42726,6.170465
8400,2012,Septiembre,Marruecos,10,7,,17,-74.140516,4.697157
8401,2012,Septiembre,Mauricio,0,1,,1,-74.140516,4.697157
8402,2012,Septiembre,Mauritania,3,1,,4,-74.140516,4.697157
8403,2012,Septiembre,México,2,1,,3,-69.941498,4.191162
8404,2012,Septiembre,México,6,14,,20,-77.35600000000001,0.81488
8405,2012,Septiembre,México,0,2,,2,-75.527794,10.406342
8406,2012,Septiembre,México,108,159,,267,-75.516486,10.446304
8407,2012,Septiembre,México,19,57,,76,-74.77647900000001,10.886686
8408,2012,Septiembre,México,5,5,,10,-72.129595,11.360028999999999
8409,2012,Septiembre,México,0,4,,4,-81.703935,12.574411099999999
8410,2012,Septiembre,México,9,1,,10,-81.70216500000001,12.5862
8411,2012,Septiembre,México,47,196,,243,-76.532004,3.451668
8412,2012,Septiembre,México,0,1,,1,-75.76635300000001,4.45285
8413,2012,Septiembre,México,1813,4769,,6582,-74.140516,4.697157
8414,2012,Septiembre,México,0,13,,13,-75.736374,4.815189
8415,2012,Septiembre,México,128,387,,515,-75.42726,6.170465
8416,2012,Septiembre,México,0,1,,1,-70.74025300000001,7.088728999999999
8417,2012,Septiembre,México,1,17,,18,-73.181317,7.1280470000000005
8418,2012,Septiembre,México,26,25,,51,-72.453013,7.819
8419,2012,Septiembre,México,1,5,,6,-72.508188,7.927233
8420,2012,Septiembre,México,1,2,,3,-77.35002,8.63337
8421,2012,Septiembre,República de Moldavia,1,0,,1,-74.140516,4.697157
8422,2012,Septiembre,República de Moldavia,1,0,,1,-75.42726,6.170465
8423,2012,Septiembre,Mongolia,1,0,,1,-74.140516,4.697157
8424,2012,Septiembre,Mozambique,0,2,,2,-74.140516,4.697157
8425,2012,Septiembre,Namibia,1,0,,1,-74.140516,4.697157
8426,2012,Septiembre,Nepal,0,1,,1,-74.140516,4.697157
8427,2012,Septiembre,Nicaragua,13,18,,31,-75.516486,10.446304
8428,2012,Septiembre,Nicaragua,2,3,,5,-74.77647900000001,10.886686
8429,2012,Septiembre,Nicaragua,1,4,,5,-81.70216500000001,12.5862
8430,2012,Septiembre,Nicaragua,7,34,,41,-76.532004,3.451668
8431,2012,Septiembre,Nicaragua,53,82,,135,-74.140516,4.697157
8432,2012,Septiembre,Nicaragua,4,7,,11,-75.42726,6.170465
8433,2012,Septiembre,Nigeria,1,0,,1,-75.516486,10.446304
8434,2012,Septiembre,Nigeria,0,9,,9,-74.140516,4.697157
8435,2012,Septiembre,Nigeria,1,1,,2,-75.42726,6.170465
8436,2012,Septiembre,Noruega,0,1,,1,-77.35600000000001,0.81488
8437,2012,Septiembre,Noruega,1,3,,4,-75.527794,10.406342
8438,2012,Septiembre,Noruega,1,10,,11,-75.516486,10.446304
8439,2012,Septiembre,Noruega,0,2,,2,-74.77647900000001,10.886686
8440,2012,Septiembre,Noruega,1,0,,1,-72.129595,11.360028999999999
8441,2012,Septiembre,Noruega,3,8,,11,-76.532004,3.451668
8442,2012,Septiembre,Noruega,1,0,,1,-75.76635300000001,4.45285
8443,2012,Septiembre,Noruega,37,83,,120,-74.140516,4.697157
8444,2012,Septiembre,Noruega,1,15,,16,-75.42726,6.170465
8445,2012,Septiembre,Nueva Caledonia/Territorio francés,0,1,,1,-75.527794,10.406342
8446,2012,Septiembre,Nueva Zelanda,0,1,,1,-69.941498,4.191162
8447,2012,Septiembre,Nueva Zelanda,9,9,,18,-77.35600000000001,0.81488
8448,2012,Septiembre,Nueva Zelanda,1,4,,5,-75.516486,10.446304
8449,2012,Septiembre,Nueva Zelanda,0,1,,1,-74.77647900000001,10.886686
8450,2012,Septiembre,Nueva Zelanda,2,5,,7,-76.532004,3.451668
8451,2012,Septiembre,Nueva Zelanda,39,57,,96,-74.140516,4.697157
8452,2012,Septiembre,Nueva Zelanda,0,1,,1,-75.736374,4.815189
8453,2012,Septiembre,Nueva Zelanda,2,8,,10,-75.42726,6.170465
8454,2012,Septiembre,Nueva Zelanda,0,1,,1,-77.35002,8.63337
8455,2012,Septiembre,Nueva Zelanda,0,1,,1,-77.35600000000001,0.81488
8456,2012,Septiembre,Nueva Zelanda,4,7,,11,-75.527794,10.406342
8457,2012,Septiembre,Nueva Zelanda,3,5,,8,-74.140516,4.697157
8458,2012,Septiembre,Nueva Zelanda,0,1,,1,-75.42726,6.170465
8459,2012,Septiembre,Países Bajos,1,3,,4,-77.35600000000001,0.81488
8460,2012,Septiembre,Países Bajos,0,5,,5,-75.516486,10.446304
8461,2012,Septiembre,Países Bajos,2,4,,6,-74.77647900000001,10.886686
8462,2012,Septiembre,Países Bajos,1,1,,2,-72.129595,11.360028999999999
8463,2012,Septiembre,Países Bajos,17,21,,38,-72.919186,11.52863
8464,2012,Septiembre,Países Bajos,11,21,,32,-76.532004,3.451668
8465,2012,Septiembre,Países Bajos,170,281,,451,-74.140516,4.697157
8466,2012,Septiembre,Países Bajos,1,0,,1,-75.736374,4.815189
8467,2012,Septiembre,Países Bajos,111,173,,284,-75.42726,6.170465
8468,2012,Septiembre,Países Bajos,5,6,,11,-73.181317,7.1280470000000005
8469,2012,Septiembre,Países Bajos,1,1,,2,-72.453013,7.819
8470,2012,Septiembre,Países Bajos,1,0,,1,-72.508188,7.927233
8471,2012,Septiembre,Pakistán,0,1,,1,-72.129595,11.360028999999999
8472,2012,Septiembre,Pakistán,0,2,,2,-76.532004,3.451668
8473,2012,Septiembre,Pakistán,2,6,,8,-74.140516,4.697157
8474,2012,Septiembre,Panamá,0,15,,15,-75.527794,10.406342
8475,2012,Septiembre,Panamá,153,234,,387,-75.516486,10.446304
8476,2012,Septiembre,Panamá,58,103,,161,-74.77647900000001,10.886686
8477,2012,Septiembre,Panamá,1,2,,3,-72.129595,11.360028999999999
8478,2012,Septiembre,Panamá,0,1,,1,-81.703935,12.574411099999999
8479,2012,Septiembre,Panamá,79,66,,145,-81.70216500000001,12.5862
8480,2012,Septiembre,Panamá,133,160,,293,-76.532004,3.451668
8481,2012,Septiembre,Panamá,413,653,,1066,-74.140516,4.697157
8482,2012,Septiembre,Panamá,48,47,,95,-75.736374,4.815189
8483,2012,Septiembre,Panamá,181,303,,484,-75.42726,6.170465
8484,2012,Septiembre,Panamá,1,1,,2,-77.401154,6.222551999999999
8485,2012,Septiembre,Panamá,0,1,,1,-70.74025300000001,7.088728999999999
8486,2012,Septiembre,Panamá,3,4,,7,-73.181317,7.1280470000000005
8487,2012,Septiembre,Panamá,2,4,,6,-72.453013,7.819
8488,2012,Septiembre,Panamá,5,14,,19,-72.508188,7.927233
8489,2012,Septiembre,Panamá,3,8,,11,-77.35002,8.63337
8490,2012,Septiembre,Paraguay,1,2,,3,-77.35600000000001,0.81488
8491,2012,Septiembre,Paraguay,23,22,,45,-75.516486,10.446304
8492,2012,Septiembre,Paraguay,7,10,,17,-74.77647900000001,10.886686
8493,2012,Septiembre,Paraguay,10,40,,50,-76.532004,3.451668
8494,2012,Septiembre,Paraguay,70,100,,170,-74.140516,4.697157
8495,2012,Septiembre,Paraguay,10,13,,23,-75.42726,6.170465
8496,2012,Septiembre,Paraguay,1,0,,1,-70.74025300000001,7.088728999999999
8497,2012,Septiembre,Paraguay,3,1,,4,-72.453013,7.819
8498,2012,Septiembre,Paraguay,0,1,,1,-72.508188,7.927233
8499,2012,Septiembre,Perú,18,28,,46,-69.941498,4.191162
8500,2012,Septiembre,Perú,2,3,,5,-76.876446,0.33002
8501,2012,Septiembre,Perú,128,305,,433,-77.35600000000001,0.81488
8502,2012,Septiembre,Perú,0,1,,1,-75.527794,10.406342
8503,2012,Septiembre,Perú,140,124,,264,-75.516486,10.446304
8504,2012,Septiembre,Perú,5,9,,14,-74.77647900000001,10.886686
8505,2012,Septiembre,Perú,0,1,,1,-74.213989,11.247722999999999
8506,2012,Septiembre,Perú,8,18,,26,-72.129595,11.360028999999999
8507,2012,Septiembre,Perú,163,114,,277,-81.70216500000001,12.5862
8508,2012,Septiembre,Perú,126,166,,292,-76.532004,3.451668
8509,2012,Septiembre,Perú,1,2,,3,-75.76635300000001,4.45285
8510,2012,Septiembre,Perú,2244,3415,,5659,-74.140516,4.697157
8511,2012,Septiembre,Perú,0,2,,2,-75.736374,4.815189
8512,2012,Septiembre,Perú,196,376,,572,-75.42726,6.170465
8513,2012,Septiembre,Perú,2,3,,5,-67.48402800000001,6.185536
8514,2012,Septiembre,Perú,0,2,,2,-73.181317,7.1280470000000005
8515,2012,Septiembre,Perú,29,33,,62,-72.453013,7.819
8516,2012,Septiembre,Perú,2,1,,3,-72.508188,7.927233
8517,2012,Septiembre,Perú,0,2,,2,-77.35002,8.63337
8518,2012,Septiembre,Palestina,2,1,,3,-74.140516,4.697157
8519,2012,Septiembre,Polonia,0,1,,1,-69.941498,4.191162
8520,2012,Septiembre,Polonia,5,8,,13,-77.35600000000001,0.81488
8521,2012,Septiembre,Polonia,1,9,,10,-75.527794,10.406342
8522,2012,Septiembre,Polonia,1,2,,3,-75.516486,10.446304
8523,2012,Septiembre,Polonia,3,2,,5,-72.129595,11.360028999999999
8524,2012,Septiembre,Polonia,0,1,,1,-76.532004,3.451668
8525,2012,Septiembre,Polonia,49,98,,147,-74.140516,4.697157
8526,2012,Septiembre,Polonia,3,3,,6,-75.42726,6.170465
8527,2012,Septiembre,Polonia,1,1,,2,-77.35002,8.63337
8528,2012,Septiembre,Portugal,1,0,,1,-69.941498,4.191162
8529,2012,Septiembre,Portugal,3,3,,6,-77.35600000000001,0.81488
8530,2012,Septiembre,Portugal,1,2,,3,-75.527794,10.406342
8531,2012,Septiembre,Portugal,8,31,,39,-75.516486,10.446304
8532,2012,Septiembre,Portugal,2,0,,2,-74.77647900000001,10.886686
8533,2012,Septiembre,Portugal,0,1,,1,-72.129595,11.360028999999999
8534,2012,Septiembre,Portugal,1,21,,22,-76.532004,3.451668
8535,2012,Septiembre,Portugal,83,303,,386,-74.140516,4.697157
8536,2012,Septiembre,Portugal,6,16,,22,-75.42726,6.170465
8537,2012,Septiembre,Portugal,1,6,,7,-72.453013,7.819
8538,2012,Septiembre,Portugal,0,1,,1,-72.508188,7.927233
8539,2012,Septiembre,Portugal,0,2,,2,-77.35002,8.63337
8540,2012,Septiembre,Puerto Rico/Territorio de Estados Unidos,0,4,,4,-75.42726,6.170465
8541,2012,Septiembre,Qatar,0,1,,1,-75.42726,6.170465
8542,2012,Septiembre,Reino Unido de Gran Bretaña e Irlanda del Norte,1,2,,3,-69.941498,4.191162
8543,2012,Septiembre,Reino Unido de Gran Bretaña e Irlanda del Norte,2,3,,5,-77.35600000000001,0.81488
8544,2012,Septiembre,Reino Unido de Gran Bretaña e Irlanda del Norte,0,1,,1,-75.527794,10.406342
8545,2012,Septiembre,Reino Unido de Gran Bretaña e Irlanda del Norte,10,18,,28,-75.516486,10.446304
8546,2012,Septiembre,Reino Unido de Gran Bretaña e Irlanda del Norte,1,4,,5,-74.213989,11.247722999999999
8547,2012,Septiembre,Reino Unido de Gran Bretaña e Irlanda del Norte,5,16,,21,-76.532004,3.451668
8548,2012,Septiembre,Reino Unido de Gran Bretaña e Irlanda del Norte,196,509,,705,-74.140516,4.697157
8549,2012,Septiembre,Reino Unido de Gran Bretaña e Irlanda del Norte,0,1,,1,-75.736374,4.815189
8550,2012,Septiembre,Reino Unido de Gran Bretaña e Irlanda del Norte,11,33,,44,-75.42726,6.170465
8551,2012,Septiembre,Reino Unido de Gran Bretaña e Irlanda del Norte,3,1,,4,-72.453013,7.819
8552,2012,Septiembre,República Dominicana,2,8,,10,-77.35600000000001,0.81488
8553,2012,Septiembre,República Dominicana,37,68,,105,-75.516486,10.446304
8554,2012,Septiembre,República Dominicana,13,33,,46,-74.77647900000001,10.886686
8555,2012,Septiembre,República Dominicana,1,0,,1,-72.129595,11.360028999999999
8556,2012,Septiembre,República Dominicana,0,1,,1,-81.70216500000001,12.5862
8557,2012,Septiembre,República Dominicana,32,62,,94,-76.532004,3.451668
8558,2012,Septiembre,República Dominicana,200,398,,598,-74.140516,4.697157
8559,2012,Septiembre,República Dominicana,1,5,,6,-75.736374,4.815189
8560,2012,Septiembre,República Dominicana,24,76,,100,-75.42726,6.170465
8561,2012,Septiembre,República Dominicana,0,2,,2,-73.181317,7.1280470000000005
8562,2012,Septiembre,República Dominicana,2,0,,2,-72.453013,7.819
8563,2012,Septiembre,República Dominicana,12,16,,28,-72.508188,7.927233
8564,2012,Septiembre,República Checa,0,1,,1,-76.532004,3.451668
8565,2012,Septiembre,República Checa,1,3,,4,-74.140516,4.697157
8566,2012,Septiembre,República Checa,1,2,,3,-72.453013,7.819
8567,2012,Septiembre,Rumania,0,3,,3,-75.527794,10.406342
8568,2012,Septiembre,Rumania,0,1,,1,-74.765343,10.970933
8569,2012,Septiembre,Rumania,2,5,,7,-76.532004,3.451668
8570,2012,Septiembre,Rumania,34,58,,92,-74.140516,4.697157
8571,2012,Septiembre,Rumania,1,4,,5,-75.42726,6.170465
8572,2012,Septiembre,Federación de Rusia,4,4,,8,-77.35600000000001,0.81488
8573,2012,Septiembre,Federación de Rusia,0,1,,1,-75.527794,10.406342
8574,2012,Septiembre,Federación de Rusia,1,1,,2,-75.516486,10.446304
8575,2012,Septiembre,Federación de Rusia,1,2,,3,-76.532004,3.451668
8576,2012,Septiembre,Federación de Rusia,0,1,,1,-77.061029,3.8844260000000004
8577,2012,Septiembre,Federación de Rusia,32,34,,66,-74.140516,4.697157
8578,2012,Septiembre,Federación de Rusia,1,1,,2,-72.453013,7.819
8579,2012,Septiembre,Federación de Rusia,1,0,,1,-77.35002,8.63337
8580,2012,Septiembre,San Cristóbal y Nevis,0,1,,1,-74.77647900000001,10.886686
8581,2012,Septiembre,San Cristóbal y Nevis,0,2,,2,-72.129595,11.360028999999999
8582,2012,Septiembre,San Cristóbal y Nevis,0,1,,1,-72.919186,11.52863
8583,2012,Septiembre,San Cristóbal y Nevis,0,1,,1,-75.42726,6.170465
8584,2012,Septiembre,Santa Lucia,1,0,,1,-75.516486,10.446304
8585,2012,Septiembre,Santa Lucia,0,1,,1,-74.77647900000001,10.886686
8586,2012,Septiembre,Santa Lucia,2,2,,4,-74.140516,4.697157
8587,2012,Septiembre,Santa Lucia,0,1,,1,-73.181317,7.1280470000000005
8588,2012,Septiembre,Senegal,1,2,,3,-74.140516,4.697157
8589,2012,Septiembre,Serbia,1,1,,2,-75.516486,10.446304
8590,2012,Septiembre,Serbia,1,5,,6,-74.140516,4.697157
8591,2012,Septiembre,Sierra Leona,0,1,,1,-74.140516,4.697157
8592,2012,Septiembre,Singapur,1,0,,1,-75.516486,10.446304
8593,2012,Septiembre,Singapur,3,3,,6,-76.532004,3.451668
8594,2012,Septiembre,Singapur,11,20,,31,-74.140516,4.697157
8595,2012,Septiembre,Singapur,2,0,,2,-75.42726,6.170465
8596,2012,Septiembre,República Árabe Siria,2,2,,4,-74.140516,4.697157
8597,2012,Septiembre,Sri Lanka,1,1,,2,-74.140516,4.697157
8598,2012,Septiembre,Sudáfrica,1,0,,1,-69.941498,4.191162
8599,2012,Septiembre,Sudáfrica,1,0,,1,-75.527794,10.406342
8600,2012,Septiembre,Sudáfrica,0,3,,3,-75.516486,10.446304
8601,2012,Septiembre,Sudáfrica,0,5,,5,-74.77647900000001,10.886686
8602,2012,Septiembre,Sudáfrica,0,2,,2,-76.532004,3.451668
8603,2012,Septiembre,Sudáfrica,23,54,,77,-74.140516,4.697157
8604,2012,Septiembre,Sudáfrica,1,7,,8,-75.42726,6.170465
8605,2012,Septiembre,Suecia,2,9,,11,-77.35600000000001,0.81488
8606,2012,Septiembre,Suecia,1,2,,3,-75.527794,10.406342
8607,2012,Septiembre,Suecia,2,9,,11,-75.516486,10.446304
8608,2012,Septiembre,Suecia,0,1,,1,-74.77647900000001,10.886686
8609,2012,Septiembre,Suecia,1,1,,2,-72.129595,11.360028999999999
8610,2012,Septiembre,Suecia,2,3,,5,-76.532004,3.451668
8611,2012,Septiembre,Suecia,100,173,,273,-74.140516,4.697157
8612,2012,Septiembre,Suecia,2,0,,2,-75.736374,4.815189
8613,2012,Septiembre,Suecia,5,13,,18,-75.42726,6.170465
8614,2012,Septiembre,Suecia,0,2,,2,-72.453013,7.819
8615,2012,Septiembre,Suecia,1,0,,1,-77.35002,8.63337
8616,2012,Septiembre,Suiza,4,5,,9,-69.941498,4.191162
8617,2012,Septiembre,Suiza,9,16,,25,-77.35600000000001,0.81488
8618,2012,Septiembre,Suiza,1,1,,2,-75.527794,10.406342
8619,2012,Septiembre,Suiza,14,20,,34,-75.516486,10.446304
8620,2012,Septiembre,Suiza,1,3,,4,-74.77647900000001,10.886686
8621,2012,Septiembre,Suiza,0,2,,2,-74.213989,11.247722999999999
8622,2012,Septiembre,Suiza,1,3,,4,-72.129595,11.360028999999999
8623,2012,Septiembre,Suiza,8,24,,32,-76.532004,3.451668
8624,2012,Septiembre,Suiza,1,0,,1,-75.76635300000001,4.45285
8625,2012,Septiembre,Suiza,175,414,,589,-74.140516,4.697157
8626,2012,Septiembre,Suiza,5,32,,37,-75.42726,6.170465
8627,2012,Septiembre,Suiza,3,8,,11,-72.453013,7.819
8628,2012,Septiembre,Suiza,1,2,,3,-77.35002,8.63337
8629,2012,Septiembre,Surinam,1,0,,1,-75.516486,10.446304
8630,2012,Septiembre,Surinam,0,1,,1,-76.532004,3.451668
8631,2012,Septiembre,Surinam,13,15,,28,-74.140516,4.697157
8632,2012,Septiembre,Surinam,2,1,,3,-75.42726,6.170465
8633,2012,Septiembre,Taiwán,3,5,,8,-74.140516,4.697157
8634,2012,Septiembre,Tailandia,7,9,,16,-74.140516,4.697157
8635,2012,Septiembre,Tailandia,1,0,,1,-75.42726,6.170465
8636,2012,Septiembre,Territorio Antártico Británico/Territorio Británico de Ultramar,1,7,,8,-74.140516,4.697157
8637,2012,Septiembre,Territorio Antártico Británico/Territorio Británico de Ultramar,0,1,,1,-75.42726,6.170465
8638,2012,Septiembre,Tanzania,0,1,,1,-74.140516,4.697157
8639,2012,Septiembre,Tanzania,0,1,,1,-75.42726,6.170465
8640,2012,Septiembre,Trinidad y Tobago,77,55,,132,-75.516486,10.446304
8641,2012,Septiembre,Trinidad y Tobago,2,3,,5,-74.77647900000001,10.886686
8642,2012,Septiembre,Trinidad y Tobago,1,0,,1,-72.129595,11.360028999999999
8643,2012,Septiembre,Trinidad y Tobago,1,17,,18,-76.532004,3.451668
8644,2012,Septiembre,Trinidad y Tobago,15,47,,62,-74.140516,4.697157
8645,2012,Septiembre,Trinidad y Tobago,0,3,,3,-75.736374,4.815189
8646,2012,Septiembre,Trinidad y Tobago,0,13,,13,-75.42726,6.170465
8647,2012,Septiembre,Trinidad y Tobago,2,1,,3,-73.181317,7.1280470000000005
8648,2012,Septiembre,Trinidad y Tobago,0,3,,3,-72.453013,7.819
8649,2012,Septiembre,Túnez,0,1,,1,-74.140516,4.697157
8650,2012,Septiembre,Túnez,0,1,,1,-75.42726,6.170465
8651,2012,Septiembre,Turquía,0,2,,2,-77.35600000000001,0.81488
8652,2012,Septiembre,Turquía,0,2,,2,-75.527794,10.406342
8653,2012,Septiembre,Turquía,2,1,,3,-75.516486,10.446304
8654,2012,Septiembre,Turquía,0,1,,1,-74.77647900000001,10.886686
8655,2012,Septiembre,Turquía,0,1,,1,-72.129595,11.360028999999999
8656,2012,Septiembre,Turquía,1,4,,5,-76.532004,3.451668
8657,2012,Septiembre,Turquía,10,67,,77,-74.140516,4.697157
8658,2012,Septiembre,Turquía,0,2,,2,-75.42726,6.170465
8659,2012,Septiembre,Turquía,0,1,,1,-77.35002,8.63337
8660,2012,Septiembre,Turkmenistán,1,0,,1,-74.140516,4.697157
8661,2012,Septiembre,Ucrania,1,1,,2,-75.516486,10.446304
8662,2012,Septiembre,Ucrania,0,3,,3,-76.532004,3.451668
8663,2012,Septiembre,Ucrania,16,12,,28,-74.140516,4.697157
8664,2012,Septiembre,Uganda,0,3,,3,-74.140516,4.697157
8665,2012,Septiembre,Federación de Rusia,0,1,,1,-69.941498,4.191162
8666,2012,Septiembre,Federación de Rusia,2,0,,2,-77.35600000000001,0.81488
8667,2012,Septiembre,Federación de Rusia,0,1,,1,-75.527794,10.406342
8668,2012,Septiembre,Federación de Rusia,1,0,,1,-75.516486,10.446304
8669,2012,Septiembre,Federación de Rusia,0,1,,1,-74.765343,10.970933
8670,2012,Septiembre,Federación de Rusia,0,1,,1,-72.129595,11.360028999999999
8671,2012,Septiembre,Federación de Rusia,1,1,,2,-76.532004,3.451668
8672,2012,Septiembre,Federación de Rusia,98,132,,230,-74.140516,4.697157
8673,2012,Septiembre,Federación de Rusia,3,1,,4,-75.42726,6.170465
8674,2012,Septiembre,Federación de Rusia,0,1,,1,-75.68164200000001,9.402597
8675,2012,Septiembre,Uruguay,4,12,,16,-77.35600000000001,0.81488
8676,2012,Septiembre,Uruguay,1,0,,1,-75.527794,10.406342
8677,2012,Septiembre,Uruguay,74,69,,143,-75.516486,10.446304
8678,2012,Septiembre,Uruguay,8,109,,117,-74.77647900000001,10.886686
8679,2012,Septiembre,Uruguay,0,2,,2,-72.129595,11.360028999999999
8680,2012,Septiembre,Uruguay,46,44,,90,-81.70216500000001,12.5862
8681,2012,Septiembre,Uruguay,12,33,,45,-76.532004,3.451668
8682,2012,Septiembre,Uruguay,1,0,,1,-75.76635300000001,4.45285
8683,2012,Septiembre,Uruguay,131,370,,501,-74.140516,4.697157
8684,2012,Septiembre,Uruguay,0,1,,1,-75.736374,4.815189
8685,2012,Septiembre,Uruguay,37,44,,81,-75.42726,6.170465
8686,2012,Septiembre,Uruguay,0,1,,1,-70.74025300000001,7.088728999999999
8687,2012,Septiembre,Uruguay,0,1,,1,-73.181317,7.1280470000000005
8688,2012,Septiembre,Uruguay,5,11,,16,-72.453013,7.819
8689,2012,Septiembre,Uzbekistán,0,1,,1,-74.140516,4.697157
8690,2012,Septiembre,Venezuela,0,4,,4,-76.876446,0.33002
8691,2012,Septiembre,Venezuela,144,156,,300,-77.35600000000001,0.81488
8692,2012,Septiembre,Venezuela,347,311,,658,-75.516486,10.446304
8693,2012,Septiembre,Venezuela,34,81,,115,-74.77647900000001,10.886686
8694,2012,Septiembre,Venezuela,0,4,,4,-74.232675,11.117206
8695,2012,Septiembre,Venezuela,1360,1693,,3053,-72.129595,11.360028999999999
8696,2012,Septiembre,Venezuela,1,0,,1,-72.919186,11.52863
8697,2012,Septiembre,Venezuela,27,16,,43,-81.70216500000001,12.5862
8698,2012,Septiembre,Venezuela,112,104,,216,-76.532004,3.451668
8699,2012,Septiembre,Venezuela,5947,6938,,12885,-74.140516,4.697157
8700,2012,Septiembre,Venezuela,0,7,,7,-75.736374,4.815189
8701,2012,Septiembre,Venezuela,310,366,,676,-75.42726,6.170465
8702,2012,Septiembre,Venezuela,2,3,,5,-67.48402800000001,6.185536
8703,2012,Septiembre,Venezuela,2,0,,2,-77.401154,6.222551999999999
8704,2012,Septiembre,Venezuela,28,47,,75,-70.74025300000001,7.088728999999999
8705,2012,Septiembre,Venezuela,9,7,,16,-73.181317,7.1280470000000005
8706,2012,Septiembre,Venezuela,1801,1765,,3566,-72.453013,7.819
8707,2012,Septiembre,Venezuela,402,444,,846,-72.508188,7.927233
8708,2012,Septiembre,Venezuela,0,2,,2,-76.7333,8.06667
8709,2012,Septiembre,Venezuela,0,1,,1,-77.35002,8.63337
8710,2012,Septiembre,Zimbabue,0,1,,1,-74.140516,4.697157
8711,2012,Septiembre,Reino Unido de Gran Bretaña e Irlanda del Norte,1,8,,9,-69.941498,4.191162
8712,2012,Septiembre,Reino Unido de Gran Bretaña e Irlanda del Norte,23,42,,65,-77.35600000000001,0.81488
8713,2012,Septiembre,Reino Unido de Gran Bretaña e Irlanda del Norte,12,13,,25,-75.527794,10.406342
8714,2012,Septiembre,Reino Unido de Gran Bretaña e Irlanda del Norte,18,40,,58,-75.516486,10.446304
8715,2012,Septiembre,Reino Unido de Gran Bretaña e Irlanda del Norte,2,6,,8,-74.77647900000001,10.886686
8716,2012,Septiembre,Reino Unido de Gran Bretaña e Irlanda del Norte,0,1,,1,-74.213989,11.247722999999999
8717,2012,Septiembre,Reino Unido de Gran Bretaña e Irlanda del Norte,1,4,,5,-72.129595,11.360028999999999
8718,2012,Septiembre,Reino Unido de Gran Bretaña e Irlanda del Norte,0,1,,1,-81.70216500000001,12.5862
8719,2012,Septiembre,Reino Unido de Gran Bretaña e Irlanda del Norte,15,32,,47,-76.532004,3.451668
8720,2012,Septiembre,Reino Unido de Gran Bretaña e Irlanda del Norte,189,489,,678,-74.140516,4.697157
8721,2012,Septiembre,Reino Unido de Gran Bretaña e Irlanda del Norte,1,0,,1,-75.736374,4.815189
8722,2012,Septiembre,Reino Unido de Gran Bretaña e Irlanda del Norte,7,15,,22,-75.42726,6.170465
8723,2012,Septiembre,Reino Unido de Gran Bretaña e Irlanda del Norte,0,9,,9,-72.453013,7.819
8724,2012,Septiembre,Reino Unido de Gran Bretaña e Irlanda del Norte,0,1,,1,-72.508188,7.927233
8725,2012,Septiembre,Reino Unido de Gran Bretaña e Irlanda del Norte,1,6,,7,-77.35002,8.63337
8726,2012,Septiembre,Países Bajos,0,4,,4,-69.941498,4.191162
8727,2012,Septiembre,Países Bajos,8,9,,17,-77.35600000000001,0.81488
8728,2012,Septiembre,Países Bajos,5,17,,22,-75.527794,10.406342
8729,2012,Septiembre,Países Bajos,14,37,,51,-75.516486,10.446304
8730,2012,Septiembre,Países Bajos,1,12,,13,-74.77647900000001,10.886686
8731,2012,Septiembre,Países Bajos,3,4,,7,-74.213989,11.247722999999999
8732,2012,Septiembre,Países Bajos,1,3,,4,-72.129595,11.360028999999999
8733,2012,Septiembre,Países Bajos,0,1,,1,-81.70216500000001,12.5862
8734,2012,Septiembre,Países Bajos,14,49,,63,-76.532004,3.451668
8735,2012,Septiembre,Países Bajos,343,611,,954,-74.140516,4.697157
8736,2012,Septiembre,Países Bajos,0,2,,2,-75.736374,4.815189
8737,2012,Septiembre,Países Bajos,73,110,,183,-75.42726,6.170465
8738,2012,Septiembre,Países Bajos,3,3,,6,-73.181317,7.1280470000000005
8739,2012,Septiembre,Países Bajos,2,2,,4,-72.453013,7.819
8740,2012,Septiembre,Países Bajos,1,4,,5,-72.508188,7.927233
8741,2012,Septiembre,Eslovenia,0,2,,2,-74.140516,4.697157
8742,2012,Septiembre,Lituania,0,1,,1,-74.765343,10.970933
8743,2012,Septiembre,Lituania,0,1,,1,-76.532004,3.451668
8744,2012,Septiembre,Lituania,1,3,,4,-74.140516,4.697157
8745,2012,Septiembre,Reino Unido de Gran Bretaña e Irlanda del Norte,1,5,,6,-74.140516,4.697157
8746,2012,Septiembre,Reino Unido de Gran Bretaña e Irlanda del Norte,0,1,,1,-75.42726,6.170465
8747,2012,Septiembre,Reino Unido de Gran Bretaña e Irlanda del Norte,4,7,,11,-75.527794,10.406342
8748,2012,Septiembre,Reino Unido de Gran Bretaña e Irlanda del Norte,1,0,,1,-75.516486,10.446304
8749,2012,Septiembre,Reino Unido de Gran Bretaña e Irlanda del Norte,0,3,,3,-74.213989,11.247722999999999
8750,2012,Septiembre,Reino Unido de Gran Bretaña e Irlanda del Norte,0,1,,1,-72.129595,11.360028999999999
8751,2012,Septiembre,Reino Unido de Gran Bretaña e Irlanda del Norte,9,7,,16,-74.140516,4.697157
8752,2012,Septiembre,Letonia,0,4,,4,-74.140516,4.697157
8753,2012,Septiembre,Marruecos,1,0,,1,-74.140516,4.697157
8754,2012,Septiembre,República CentroÁfricana,1,2,,3,-74.140516,4.697157
8755,2012,Octubre,Desconocido,1,0,,1,-74.140516,4.697157
8756,2012,Octubre,Albania,0,3,,3,-77.35600000000001,0.81488
8757,2012,Octubre,Albania,1,3,,4,-74.140516,4.697157
8758,2012,Octubre,Alemania,3,2,,5,-69.941498,4.191162
8759,2012,Octubre,Alemania,0,1,,1,-76.876446,0.33002
8760,2012,Octubre,Alemania,28,38,,66,-77.35600000000001,0.81488
8761,2012,Octubre,Alemania,1,0,,1,-78.802679,18.00143
8762,2012,Octubre,Alemania,13,21,,34,-75.527794,10.406342
8763,2012,Octubre,Alemania,11,30,,41,-75.516486,10.446304
8764,2012,Octubre,Alemania,9,9,,18,-74.77647900000001,10.886686
8765,2012,Octubre,Alemania,5,6,,11,-72.129595,11.360028999999999
8766,2012,Octubre,Alemania,0,2,,2,-72.919186,11.52863
8767,2012,Octubre,Alemania,1,5,,6,-81.70216500000001,12.5862
8768,2012,Octubre,Alemania,30,64,,94,-76.532004,3.451668
8769,2012,Octubre,Alemania,0,1,,1,-77.061029,3.8844260000000004
8770,2012,Octubre,Alemania,1,1,,2,-75.76635300000001,4.45285
8771,2012,Octubre,Alemania,940,1749,,2689,-74.140516,4.697157
8772,2012,Octubre,Alemania,0,2,,2,-75.736374,4.815189
8773,2012,Octubre,Alemania,29,95,,124,-75.42726,6.170465
8774,2012,Octubre,Alemania,0,2,,2,-70.74025300000001,7.088728999999999
8775,2012,Octubre,Alemania,10,7,,17,-72.453013,7.819
8776,2012,Octubre,Alemania,0,2,,2,-72.508188,7.927233
8777,2012,Octubre,Alemania,4,7,,11,-77.35002,8.63337
8778,2012,Octubre,Andorra,1,1,,2,-76.532004,3.451668
8779,2012,Octubre,Andorra,2,7,,9,-74.140516,4.697157
8780,2012,Octubre,Angola,0,1,,1,-75.516486,10.446304
8781,2012,Octubre,Angola,1,1,,2,-74.140516,4.697157
8782,2012,Octubre,Antigua y Barbuda,2,1,,3,-76.532004,3.451668
8783,2012,Octubre,Antigua y Barbuda,1,1,,2,-74.140516,4.697157
8784,2012,Octubre,Antigua y Barbuda,1,0,,1,-75.42726,6.170465
8785,2012,Octubre,Países Bajos,1,0,,1,-74.140516,4.697157
8786,2012,Octubre,Países Bajos,0,1,,1,-75.42726,6.170465
8787,2012,Octubre,Arabia Saudita,0,1,,1,-74.140516,4.697157
8788,2012,Octubre,Arabia Saudita,0,6,,6,-74.140516,4.697157
8789,2012,Octubre,Arabia Saudita,0,1,,1,-75.42726,6.170465
8790,2012,Octubre,Argelia,1,2,,3,-74.140516,4.697157
8791,2012,Octubre,Argentina,1,5,,6,-69.941498,4.191162
8792,2012,Octubre,Argentina,4,3,,7,-76.876446,0.33002
8793,2012,Octubre,Argentina,43,68,,111,-77.35600000000001,0.81488
8794,2012,Octubre,Argentina,0,1,,1,-78.802679,18.00143
8795,2012,Octubre,Argentina,2,4,,6,-75.527794,10.406342
8796,2012,Octubre,Argentina,825,624,,1449,-75.516486,10.446304
8797,2012,Octubre,Argentina,10,30,,40,-74.77647900000001,10.886686
8798,2012,Octubre,Argentina,9,17,,26,-72.129595,11.360028999999999
8799,2012,Octubre,Argentina,0,1,,1,-81.703935,12.574411099999999
8800,2012,Octubre,Argentina,240,199,,439,-81.70216500000001,12.5862
8801,2012,Octubre,Argentina,35,68,,103,-76.532004,3.451668
8802,2012,Octubre,Argentina,2509,4122,,6631,-74.140516,4.697157
8803,2012,Octubre,Argentina,3,1,,4,-75.736374,4.815189
8804,2012,Octubre,Argentina,100,236,,336,-75.42726,6.170465
8805,2012,Octubre,Argentina,0,1,,1,-67.48402800000001,6.185536
8806,2012,Octubre,Argentina,20,40,,60,-72.453013,7.819
8807,2012,Octubre,Argentina,0,1,,1,-72.508188,7.927233
8808,2012,Octubre,Argentina,6,7,,13,-77.35002,8.63337
8809,2012,Octubre,República de Armenia,0,2,,2,-74.140516,4.697157
8810,2012,Octubre,Aruba,1,0,,1,-76.532004,3.451668
8811,2012,Octubre,Aruba,1,3,,4,-74.140516,4.697157
8812,2012,Octubre,Australia,3,5,,8,-69.941498,4.191162
8813,2012,Octubre,Australia,22,41,,63,-77.35600000000001,0.81488
8814,2012,Octubre,Australia,27,38,,65,-75.527794,10.406342
8815,2012,Octubre,Australia,14,22,,36,-75.516486,10.446304
8816,2012,Octubre,Australia,1,11,,12,-74.77647900000001,10.886686
8817,2012,Octubre,Australia,3,3,,6,-74.213989,11.247722999999999
8818,2012,Octubre,Australia,3,4,,7,-72.129595,11.360028999999999
8819,2012,Octubre,Australia,14,21,,35,-76.532004,3.451668
8820,2012,Octubre,Australia,1,0,,1,-75.76635300000001,4.45285
8821,2012,Octubre,Australia,198,358,,556,-74.140516,4.697157
8822,2012,Octubre,Australia,0,1,,1,-75.736374,4.815189
8823,2012,Octubre,Australia,17,58,,75,-75.42726,6.170465
8824,2012,Octubre,Australia,1,6,,7,-72.453013,7.819
8825,2012,Octubre,Australia,1,2,,3,-77.35002,8.63337
8826,2012,Octubre,Austria,0,2,,2,-69.941498,4.191162
8827,2012,Octubre,Austria,4,1,,5,-77.35600000000001,0.81488
8828,2012,Octubre,Austria,3,4,,7,-75.527794,10.406342
8829,2012,Octubre,Austria,3,5,,8,-75.516486,10.446304
8830,2012,Octubre,Austria,1,3,,4,-74.77647900000001,10.886686
8831,2012,Octubre,Austria,0,1,,1,-72.129595,11.360028999999999
8832,2012,Octubre,Austria,3,5,,8,-76.532004,3.451668
8833,2012,Octubre,Austria,80,178,,258,-74.140516,4.697157
8834,2012,Octubre,Austria,8,12,,20,-75.42726,6.170465
8835,2012,Octubre,Austria,0,1,,1,-72.453013,7.819
8836,2012,Octubre,Azerbaiyán,2,1,,3,-74.140516,4.697157
8837,2012,Octubre,Bahamas,1,0,,1,-81.70216500000001,12.5862
8838,2012,Octubre,Bahamas,1,1,,2,-76.532004,3.451668
8839,2012,Octubre,Bahamas,3,1,,4,-74.140516,4.697157
8840,2012,Octubre,Bangladesh,0,1,,1,-77.35600000000001,0.81488
8841,2012,Octubre,Bangladesh,0,1,,1,-75.516486,10.446304
8842,2012,Octubre,Bangladesh,1,3,,4,-74.140516,4.697157
8843,2012,Octubre,Barbados,0,1,,1,-74.77647900000001,10.886686
8844,2012,Octubre,Barbados,1,2,,3,-76.532004,3.451668
8845,2012,Octubre,Barbados,1,1,,2,-74.140516,4.697157
8846,2012,Octubre,Barbados,0,1,,1,-75.42726,6.170465
8847,2012,Octubre,República de Belarús,5,6,,11,-74.140516,4.697157
8848,2012,Octubre,Bélgica,1,2,,3,-69.941498,4.191162
8849,2012,Octubre,Bélgica,1,6,,7,-77.35600000000001,0.81488
8850,2012,Octubre,Bélgica,1,8,,9,-75.527794,10.406342
8851,2012,Octubre,Bélgica,4,5,,9,-75.516486,10.446304
8852,2012,Octubre,Bélgica,1,3,,4,-74.77647900000001,10.886686
8853,2012,Octubre,Bélgica,0,13,,13,-74.765343,10.970933
8854,2012,Octubre,Bélgica,0,1,,1,-72.129595,11.360028999999999
8855,2012,Octubre,Bélgica,6,26,,32,-76.532004,3.451668
8856,2012,Octubre,Bélgica,80,281,,361,-74.140516,4.697157
8857,2012,Octubre,Bélgica,8,8,,16,-75.42726,6.170465
8858,2012,Octubre,Bélgica,0,2,,2,-77.35002,8.63337
8859,2012,Octubre,Belice,4,15,,19,-74.140516,4.697157
8860,2012,Octubre,Belice,1,3,,4,-75.42726,6.170465
8861,2012,Octubre,Benín,1,0,,1,-74.140516,4.697157
8862,2012,Octubre,Bermudas/Territorio Británico de Ultramar,0,1,,1,-74.140516,4.697157
8863,2012,Octubre,Bolivia,1,0,,1,-69.941498,4.191162
8864,2012,Octubre,Bolivia,10,14,,24,-77.35600000000001,0.81488
8865,2012,Octubre,Bolivia,5,5,,10,-75.516486,10.446304
8866,2012,Octubre,Bolivia,1,3,,4,-74.77647900000001,10.886686
8867,2012,Octubre,Bolivia,0,3,,3,-72.129595,11.360028999999999
8868,2012,Octubre,Bolivia,8,5,,13,-81.70216500000001,12.5862
8869,2012,Octubre,Bolivia,14,19,,33,-76.532004,3.451668
8870,2012,Octubre,Bolivia,284,465,,749,-74.140516,4.697157
8871,2012,Octubre,Bolivia,0,2,,2,-75.736374,4.815189
8872,2012,Octubre,Bolivia,17,26,,43,-75.42726,6.170465
8873,2012,Octubre,Bolivia,0,4,,4,-72.453013,7.819
8874,2012,Octubre,Bolivia,1,0,,1,-77.35002,8.63337
8875,2012,Octubre,Bosnia y Herzegovina,1,1,,2,-74.140516,4.697157
8876,2012,Octubre,Brasil,67,67,,134,-69.941498,4.191162
8877,2012,Octubre,Brasil,6,20,,26,-77.35600000000001,0.81488
8878,2012,Octubre,Brasil,1,5,,6,-75.527794,10.406342
8879,2012,Octubre,Brasil,190,228,,418,-75.516486,10.446304
8880,2012,Octubre,Brasil,11,52,,63,-74.77647900000001,10.886686
8881,2012,Octubre,Brasil,6,11,,17,-72.129595,11.360028999999999
8882,2012,Octubre,Brasil,15,17,,32,-81.70216500000001,12.5862
8883,2012,Octubre,Brasil,27,63,,90,-76.532004,3.451668
8884,2012,Octubre,Brasil,2198,3858,,6056,-74.140516,4.697157
8885,2012,Octubre,Brasil,1,3,,4,-75.736374,4.815189
8886,2012,Octubre,Brasil,55,114,,169,-75.42726,6.170465
8887,2012,Octubre,Brasil,0,2,,2,-67.48402800000001,6.185536
8888,2012,Octubre,Brasil,1,1,,2,-73.181317,7.1280470000000005
8889,2012,Octubre,Brasil,9,14,,23,-72.453013,7.819
8890,2012,Octubre,Brasil,0,3,,3,-72.508188,7.927233
8891,2012,Octubre,Brunei Darussalam,1,0,,1,-77.35600000000001,0.81488
8892,2012,Octubre,Brunei Darussalam,3,2,,5,-74.140516,4.697157
8893,2012,Octubre,Bulgaria,1,0,,1,-77.35600000000001,0.81488
8894,2012,Octubre,Bulgaria,0,1,,1,-76.532004,3.451668
8895,2012,Octubre,Bulgaria,6,9,,15,-74.140516,4.697157
8896,2012,Octubre,Bulgaria,0,2,,2,-75.42726,6.170465
8897,2012,Octubre,Cabo Verde,1,0,,1,-75.516486,10.446304
8898,2012,Octubre,Camboya,2,2,,4,-74.140516,4.697157
8899,2012,Octubre,Camerún,0,25,,25,-74.140516,4.697157
8900,2012,Octubre,Canadá,2,2,,4,-69.941498,4.191162
8901,2012,Octubre,Canadá,12,9,,21,-77.35600000000001,0.81488
8902,2012,Octubre,Canadá,9,16,,25,-75.527794,10.406342
8903,2012,Octubre,Canadá,25,92,,117,-75.516486,10.446304
8904,2012,Octubre,Canadá,8,16,,24,-74.77647900000001,10.886686
8905,2012,Octubre,Canadá,2,2,,4,-72.129595,11.360028999999999
8906,2012,Octubre,Canadá,0,1,,1,-72.919186,11.52863
8907,2012,Octubre,Canadá,2,2,,4,-81.70216500000001,12.5862
8908,2012,Octubre,Canadá,17,33,,50,-76.532004,3.451668
8909,2012,Octubre,Canadá,1,1,,2,-75.76635300000001,4.45285
8910,2012,Octubre,Canadá,570,1341,,1911,-74.140516,4.697157
8911,2012,Octubre,Canadá,1,0,,1,-75.736374,4.815189
8912,2012,Octubre,Canadá,43,159,,202,-75.42726,6.170465
8913,2012,Octubre,Canadá,0,1,,1,-77.401154,6.222551999999999
8914,2012,Octubre,Canadá,1,1,,2,-70.74025300000001,7.088728999999999
8915,2012,Octubre,Canadá,0,4,,4,-73.181317,7.1280470000000005
8916,2012,Octubre,Canadá,1,3,,4,-72.453013,7.819
8917,2012,Octubre,Canadá,0,1,,1,-72.508188,7.927233
8918,2012,Octubre,Canadá,0,5,,5,-77.35002,8.63337
8919,2012,Octubre,España,7,6,,13,-77.35600000000001,0.81488
8920,2012,Octubre,España,0,1,,1,-78.802679,18.00143
8921,2012,Octubre,España,11,13,,24,-75.516486,10.446304
8922,2012,Octubre,España,1,8,,9,-74.77647900000001,10.886686
8923,2012,Octubre,España,61,124,,185,-76.532004,3.451668
8924,2012,Octubre,España,1,0,,1,-77.061029,3.8844260000000004
8925,2012,Octubre,España,170,488,,658,-74.140516,4.697157
8926,2012,Octubre,España,0,3,,3,-75.736374,4.815189
8927,2012,Octubre,España,39,122,,161,-75.42726,6.170465
8928,2012,Octubre,España,1,7,,8,-72.453013,7.819
8929,2012,Octubre,España,1,0,,1,-72.508188,7.927233
8930,2012,Octubre,España,0,1,,1,-77.35002,8.63337
8931,2012,Octubre,República Democrática del Congo,4,2,,6,-74.140516,4.697157
8932,2012,Octubre,República de Corea,0,1,,1,-69.941498,4.191162
8933,2012,Octubre,República de Corea,2,3,,5,-77.35600000000001,0.81488
8934,2012,Octubre,República de Corea,0,1,,1,-75.527794,10.406342
8935,2012,Octubre,República de Corea,2,4,,6,-75.516486,10.446304
8936,2012,Octubre,República de Corea,0,2,,2,-74.77647900000001,10.886686
8937,2012,Octubre,República de Corea,0,6,,6,-76.532004,3.451668
8938,2012,Octubre,República de Corea,105,410,,515,-74.140516,4.697157
8939,2012,Octubre,República de Corea,3,17,,20,-75.42726,6.170465
8940,2012,Octubre,República de Corea,1,2,,3,-72.453013,7.819
8941,2012,Octubre,Costa de Marfil,2,3,,5,-76.532004,3.451668
8942,2012,Octubre,Costa de Marfil,1,1,,2,-74.140516,4.697157
8943,2012,Octubre,Costa de Marfil,0,1,,1,-75.42726,6.170465
8944,2012,Octubre,Costa Rica,1,1,,2,-77.35600000000001,0.81488
8945,2012,Octubre,Costa Rica,37,44,,81,-75.516486,10.446304
8946,2012,Octubre,Costa Rica,7,14,,21,-74.77647900000001,10.886686
8947,2012,Octubre,Costa Rica,0,3,,3,-72.129595,11.360028999999999
8948,2012,Octubre,Costa Rica,239,208,,447,-81.70216500000001,12.5862
8949,2012,Octubre,Costa Rica,28,98,,126,-76.532004,3.451668
8950,2012,Octubre,Costa Rica,400,686,,1086,-74.140516,4.697157
8951,2012,Octubre,Costa Rica,3,7,,10,-75.736374,4.815189
8952,2012,Octubre,Costa Rica,93,161,,254,-75.42726,6.170465
8953,2012,Octubre,Costa Rica,3,0,,3,-73.181317,7.1280470000000005
8954,2012,Octubre,Costa Rica,2,1,,3,-72.453013,7.819
8955,2012,Octubre,Costa Rica,0,1,,1,-72.508188,7.927233
8956,2012,Octubre,Costa Rica,1,3,,4,-77.35002,8.63337
8957,2012,Octubre,Croacia,0,1,,1,-77.35600000000001,0.81488
8958,2012,Octubre,Croacia,0,4,,4,-75.527794,10.406342
8959,2012,Octubre,Croacia,0,3,,3,-74.765343,10.970933
8960,2012,Octubre,Croacia,0,1,,1,-72.129595,11.360028999999999
8961,2012,Octubre,Croacia,8,25,,33,-74.140516,4.697157
8962,2012,Octubre,Croacia,0,1,,1,-72.453013,7.819
8963,2012,Octubre,Cuba,0,3,,3,-77.35600000000001,0.81488
8964,2012,Octubre,Cuba,1,1,,2,-75.527794,10.406342
8965,2012,Octubre,Cuba,11,19,,30,-75.516486,10.446304
8966,2012,Octubre,Cuba,3,8,,11,-74.77647900000001,10.886686
8967,2012,Octubre,Cuba,0,1,,1,-72.129595,11.360028999999999
8968,2012,Octubre,Cuba,26,24,,50,-76.532004,3.451668
8969,2012,Octubre,Cuba,0,3,,3,-75.76635300000001,4.45285
8970,2012,Octubre,Cuba,98,175,,273,-74.140516,4.697157
8971,2012,Octubre,Cuba,4,3,,7,-75.736374,4.815189
8972,2012,Octubre,Cuba,18,15,,33,-75.42726,6.170465
8973,2012,Octubre,Cuba,0,2,,2,-73.181317,7.1280470000000005
8974,2012,Octubre,Cuba,0,2,,2,-72.453013,7.819
8975,2012,Octubre,Cuba,0,2,,2,-72.508188,7.927233
8976,2012,Octubre,Curazao,0,2,,2,-74.140516,4.697157
8977,2012,Octubre,Curazao,3,0,,3,-75.42726,6.170465
8978,2012,Octubre,República Checa,0,3,,3,-77.35600000000001,0.81488
8979,2012,Octubre,República Checa,6,0,,6,-75.516486,10.446304
8980,2012,Octubre,República Checa,1,4,,5,-76.532004,3.451668
8981,2012,Octubre,República Checa,13,40,,53,-74.140516,4.697157
8982,2012,Octubre,República Checa,1,4,,5,-75.42726,6.170465
8983,2012,Octubre,Chile,0,3,,3,-69.941498,4.191162
8984,2012,Octubre,Chile,0,1,,1,-76.876446,0.33002
8985,2012,Octubre,Chile,19,38,,57,-77.35600000000001,0.81488
8986,2012,Octubre,Chile,126,119,,245,-75.516486,10.446304
8987,2012,Octubre,Chile,4,12,,16,-74.77647900000001,10.886686
8988,2012,Octubre,Chile,4,12,,16,-72.129595,11.360028999999999
8989,2012,Octubre,Chile,123,70,,193,-81.70216500000001,12.5862
8990,2012,Octubre,Chile,23,58,,81,-76.532004,3.451668
8991,2012,Octubre,Chile,0,1,,1,-77.061029,3.8844260000000004
8992,2012,Octubre,Chile,2459,3741,,6200,-74.140516,4.697157
8993,2012,Octubre,Chile,2,2,,4,-75.736374,4.815189
8994,2012,Octubre,Chile,51,138,,189,-75.42726,6.170465
8995,2012,Octubre,Chile,7,12,,19,-72.453013,7.819
8996,2012,Octubre,Chile,1,0,,1,-72.508188,7.927233
8997,2012,Octubre,Chile,0,1,,1,-77.35002,8.63337
8998,2012,Octubre,China,3,3,,6,-77.35600000000001,0.81488
8999,2012,Octubre,China,0,3,,3,-75.527794,10.406342
9000,2012,Octubre,China,1,2,,3,-75.516486,10.446304
9001,2012,Octubre,China,4,6,,10,-74.77647900000001,10.886686
9002,2012,Octubre,China,2,2,,4,-72.129595,11.360028999999999
9003,2012,Octubre,China,3,6,,9,-76.532004,3.451668
9004,2012,Octubre,China,195,565,,760,-74.140516,4.697157
9005,2012,Octubre,China,6,10,,16,-75.42726,6.170465
9006,2012,Octubre,China,1,7,,8,-72.453013,7.819
9007,2012,Octubre,Taiwán,0,2,,2,-77.35600000000001,0.81488
9008,2012,Octubre,Taiwán,0,1,,1,-74.77647900000001,10.886686
9009,2012,Octubre,Taiwán,0,1,,1,-74.765343,10.970933
9010,2012,Octubre,Taiwán,1,0,,1,-81.70216500000001,12.5862
9011,2012,Octubre,Taiwán,1,2,,3,-76.532004,3.451668
9012,2012,Octubre,Taiwán,27,48,,75,-74.140516,4.697157
9013,2012,Octubre,Taiwán,5,13,,18,-75.42726,6.170465
9014,2012,Octubre,Taiwán,0,2,,2,-72.453013,7.819
9015,2012,Octubre,Chipre,2,2,,4,-74.140516,4.697157
9016,2012,Octubre,Chipre,0,2,,2,-75.42726,6.170465
9017,2012,Octubre,Dinamarca,2,5,,7,-77.35600000000001,0.81488
9018,2012,Octubre,Dinamarca,1,1,,2,-75.527794,10.406342
9019,2012,Octubre,Dinamarca,2,3,,5,-75.516486,10.446304
9020,2012,Octubre,Dinamarca,0,1,,1,-72.129595,11.360028999999999
9021,2012,Octubre,Dinamarca,0,6,,6,-81.703935,12.574411099999999
9022,2012,Octubre,Dinamarca,0,7,,7,-76.532004,3.451668
9023,2012,Octubre,Dinamarca,58,105,,163,-74.140516,4.697157
9024,2012,Octubre,Dinamarca,5,11,,16,-75.42726,6.170465
9025,2012,Octubre,Dominica,1,0,,1,-76.532004,3.451668
9026,2012,Octubre,Dominica,1,3,,4,-74.140516,4.697157
9027,2012,Octubre,Ecuador,0,7,,7,-69.941498,4.191162
9028,2012,Octubre,Ecuador,9,34,,43,-76.876446,0.33002
9029,2012,Octubre,Ecuador,859,1397,,2256,-77.35600000000001,0.81488
9030,2012,Octubre,Ecuador,5,164,,169,-78.802679,18.00143
9031,2012,Octubre,Ecuador,0,40,,40,-75.527794,10.406342
9032,2012,Octubre,Ecuador,21,43,,64,-75.516486,10.446304
9033,2012,Octubre,Ecuador,3,5,,8,-74.77647900000001,10.886686
9034,2012,Octubre,Ecuador,6,18,,24,-72.129595,11.360028999999999
9035,2012,Octubre,Ecuador,5,9,,14,-81.70216500000001,12.5862
9036,2012,Octubre,Ecuador,359,368,,727,-76.532004,3.451668
9037,2012,Octubre,Ecuador,1,0,,1,-75.76635300000001,4.45285
9038,2012,Octubre,Ecuador,1944,3353,,5297,-74.140516,4.697157
9039,2012,Octubre,Ecuador,2,4,,6,-75.736374,4.815189
9040,2012,Octubre,Ecuador,388,536,,924,-75.42726,6.170465
9041,2012,Octubre,Ecuador,0,1,,1,-70.74025300000001,7.088728999999999
9042,2012,Octubre,Ecuador,0,1,,1,-73.181317,7.1280470000000005
9043,2012,Octubre,Ecuador,79,126,,205,-72.453013,7.819
9044,2012,Octubre,Ecuador,1,2,,3,-72.508188,7.927233
9045,2012,Octubre,Egipto,1,0,,1,-77.35600000000001,0.81488
9046,2012,Octubre,Egipto,0,1,,1,-75.516486,10.446304
9047,2012,Octubre,Egipto,1,1,,2,-76.532004,3.451668
9048,2012,Octubre,Egipto,4,13,,17,-74.140516,4.697157
9049,2012,Octubre,El Salvador,1,2,,3,-77.35600000000001,0.81488
9050,2012,Octubre,El Salvador,13,18,,31,-75.516486,10.446304
9051,2012,Octubre,El Salvador,0,2,,2,-74.77647900000001,10.886686
9052,2012,Octubre,El Salvador,0,6,,6,-81.703935,12.574411099999999
9053,2012,Octubre,El Salvador,5,5,,10,-81.70216500000001,12.5862
9054,2012,Octubre,El Salvador,43,56,,99,-76.532004,3.451668
9055,2012,Octubre,El Salvador,396,645,,1041,-74.140516,4.697157
9056,2012,Octubre,El Salvador,0,1,,1,-75.736374,4.815189
9057,2012,Octubre,El Salvador,29,49,,78,-75.42726,6.170465
9058,2012,Octubre,Emiratos Árabes,0,1,,1,-74.140516,4.697157
9059,2012,Octubre,España,7,9,,16,-69.941498,4.191162
9060,2012,Octubre,España,2,3,,5,-76.876446,0.33002
9061,2012,Octubre,España,6,23,,29,-77.35600000000001,0.81488
9062,2012,Octubre,España,2,7,,9,-75.527794,10.406342
9063,2012,Octubre,España,43,91,,134,-75.516486,10.446304
9064,2012,Octubre,España,1,14,,15,-74.77647900000001,10.886686
9065,2012,Octubre,España,6,8,,14,-72.129595,11.360028999999999
9066,2012,Octubre,España,0,1,,1,-81.703935,12.574411099999999
9067,2012,Octubre,España,7,5,,12,-81.70216500000001,12.5862
9068,2012,Octubre,España,131,291,,422,-76.532004,3.451668
9069,2012,Octubre,España,1,2,,3,-75.76635300000001,4.45285
9070,2012,Octubre,España,1792,4612,,6404,-74.140516,4.697157
9071,2012,Octubre,España,0,8,,8,-75.736374,4.815189
9072,2012,Octubre,España,79,222,,301,-75.42726,6.170465
9073,2012,Octubre,España,0,3,,3,-67.48402800000001,6.185536
9074,2012,Octubre,España,1,1,,2,-70.74025300000001,7.088728999999999
9075,2012,Octubre,España,9,23,,32,-72.453013,7.819
9076,2012,Octubre,España,4,5,,9,-72.508188,7.927233
9077,2012,Octubre,España,4,2,,6,-77.35002,8.63337
9078,2012,Octubre,Eritrea,0,1,,1,-74.140516,4.697157
9079,2012,Octubre,Eslovaquia,0,1,,1,-77.35600000000001,0.81488
9080,2012,Octubre,Eslovaquia,0,1,,1,-72.129595,11.360028999999999
9081,2012,Octubre,Eslovaquia,1,1,,2,-76.532004,3.451668
9082,2012,Octubre,Eslovaquia,7,7,,14,-74.140516,4.697157
9083,2012,Octubre,Eslovaquia,2,0,,2,-75.42726,6.170465
9084,2012,Octubre,Eslovenia,1,0,,1,-77.35600000000001,0.81488
9085,2012,Octubre,Eslovenia,0,2,,2,-75.527794,10.406342
9086,2012,Octubre,Eslovenia,1,0,,1,-75.516486,10.446304
9087,2012,Octubre,Eslovenia,7,1,,8,-72.129595,11.360028999999999
9088,2012,Octubre,Eslovenia,6,17,,23,-74.140516,4.697157
9089,2012,Octubre,Eslovenia,1,1,,2,-75.42726,6.170465
9090,2012,Octubre,Eslovenia,0,1,,1,-77.35002,8.63337
9091,2012,Octubre,Estados Unidos de América,11,15,,26,-69.941498,4.191162
9092,2012,Octubre,Estados Unidos de América,37,54,,91,-77.35600000000001,0.81488
9093,2012,Octubre,Estados Unidos de América,1,0,,1,-78.802679,18.00143
9094,2012,Octubre,Estados Unidos de América,20,34,,54,-75.527794,10.406342
9095,2012,Octubre,Estados Unidos de América,637,1508,,2145,-75.516486,10.446304
9096,2012,Octubre,Estados Unidos de América,237,421,,658,-74.77647900000001,10.886686
9097,2012,Octubre,Estados Unidos de América,0,4,,4,-74.232675,11.117206
9098,2012,Octubre,Estados Unidos de América,3,6,,9,-74.213989,11.247722999999999
9099,2012,Octubre,Estados Unidos de América,7,15,,22,-72.129595,11.360028999999999
9100,2012,Octubre,Estados Unidos de América,0,1,,1,-72.919186,11.52863
9101,2012,Octubre,Estados Unidos de América,1,4,,5,-81.703935,12.574411099999999
9102,2012,Octubre,Estados Unidos de América,3,10,,13,-81.70216500000001,12.5862
9103,2012,Octubre,Estados Unidos de América,7,6,,13,-81.372937,13.338761300000002
9104,2012,Octubre,Estados Unidos de América,445,906,,1351,-76.532004,3.451668
9105,2012,Octubre,Estados Unidos de América,71,130,,201,-75.76635300000001,4.45285
9106,2012,Octubre,Estados Unidos de América,4338,10140,,14478,-74.140516,4.697157
9107,2012,Octubre,Estados Unidos de América,31,42,,73,-75.736374,4.815189
9108,2012,Octubre,Estados Unidos de América,661,2029,,2690,-75.42726,6.170465
9109,2012,Octubre,Estados Unidos de América,0,1,,1,-67.48402800000001,6.185536
9110,2012,Octubre,Estados Unidos de América,1,4,,5,-70.74025300000001,7.088728999999999
9111,2012,Octubre,Estados Unidos de América,6,21,,27,-73.181317,7.1280470000000005
9112,2012,Octubre,Estados Unidos de América,14,38,,52,-72.453013,7.819
9113,2012,Octubre,Estados Unidos de América,3,8,,11,-72.508188,7.927233
9114,2012,Octubre,Estados Unidos de América,3,13,,16,-77.35002,8.63337
9115,2012,Octubre,Estonia,7,9,,16,-74.140516,4.697157
9116,2012,Octubre,Estonia,1,3,,4,-75.42726,6.170465
9117,2012,Octubre,Estonia,0,1,,1,-76.7333,8.06667
9118,2012,Octubre,Estonia,0,1,,1,-77.35002,8.63337
9119,2012,Octubre,Etiopia,0,1,,1,-75.516486,10.446304
9120,2012,Octubre,Etiopia,1,0,,1,-74.77647900000001,10.886686
9121,2012,Octubre,Etiopia,1,0,,1,-81.70216500000001,12.5862
9122,2012,Octubre,Etiopia,1,1,,2,-74.140516,4.697157
9123,2012,Octubre,Filipinas,2,0,,2,-77.35600000000001,0.81488
9124,2012,Octubre,Filipinas,0,1,,1,-78.802679,18.00143
9125,2012,Octubre,Filipinas,0,38,,38,-75.527794,10.406342
9126,2012,Octubre,Filipinas,0,24,,24,-75.516486,10.446304
9127,2012,Octubre,Filipinas,0,26,,26,-74.765343,10.970933
9128,2012,Octubre,Filipinas,0,6,,6,-74.213989,11.247722999999999
9129,2012,Octubre,Filipinas,0,12,,12,-76.532004,3.451668
9130,2012,Octubre,Filipinas,0,6,,6,-77.061029,3.8844260000000004
9131,2012,Octubre,Filipinas,15,71,,86,-74.140516,4.697157
9132,2012,Octubre,Filipinas,5,3,,8,-75.42726,6.170465
9133,2012,Octubre,Filipinas,1,0,,1,-72.453013,7.819
9134,2012,Octubre,Filipinas,0,2,,2,-72.508188,7.927233
9135,2012,Octubre,Filipinas,0,3,,3,-76.7333,8.06667
9136,2012,Octubre,Filipinas,0,1,,1,-75.68164200000001,9.402597
9137,2012,Octubre,Finlandia,1,1,,2,-77.35600000000001,0.81488
9138,2012,Octubre,Finlandia,1,2,,3,-75.516486,10.446304
9139,2012,Octubre,Finlandia,47,87,,134,-74.140516,4.697157
9140,2012,Octubre,Finlandia,2,5,,7,-75.42726,6.170465
9141,2012,Octubre,Finlandia,0,1,,1,-72.453013,7.819
9142,2012,Octubre,Finlandia,0,1,,1,-72.508188,7.927233
9143,2012,Octubre,Francia,4,3,,7,-69.941498,4.191162
9144,2012,Octubre,Francia,1,0,,1,-76.876446,0.33002
9145,2012,Octubre,Francia,43,50,,93,-77.35600000000001,0.81488
9146,2012,Octubre,Francia,0,1,,1,-78.802679,18.00143
9147,2012,Octubre,Francia,4,17,,21,-75.527794,10.406342
9148,2012,Octubre,Francia,11,38,,49,-75.516486,10.446304
9149,2012,Octubre,Francia,3,8,,11,-74.77647900000001,10.886686
9150,2012,Octubre,Francia,1,1,,2,-74.213989,11.247722999999999
9151,2012,Octubre,Francia,4,7,,11,-72.129595,11.360028999999999
9152,2012,Octubre,Francia,1,2,,3,-81.70216500000001,12.5862
9153,2012,Octubre,Francia,2,3,,5,-81.372937,13.338761300000002
9154,2012,Octubre,Francia,19,48,,67,-76.532004,3.451668
9155,2012,Octubre,Francia,898,1745,,2643,-74.140516,4.697157
9156,2012,Octubre,Francia,2,4,,6,-75.736374,4.815189
9157,2012,Octubre,Francia,40,80,,120,-75.42726,6.170465
9158,2012,Octubre,Francia,0,4,,4,-67.48402800000001,6.185536
9159,2012,Octubre,Francia,8,15,,23,-72.453013,7.819
9160,2012,Octubre,Francia,3,7,,10,-77.35002,8.63337
9161,2012,Octubre,Gabón,1,0,,1,-76.532004,3.451668
9162,2012,Octubre,Gabón,0,2,,2,-74.140516,4.697157
9163,2012,Octubre,Georgia,1,0,,1,-74.140516,4.697157
9164,2012,Octubre,Ghana,1,3,,4,-74.140516,4.697157
9165,2012,Octubre,Granada,0,1,,1,-75.42726,6.170465
9166,2012,Octubre,Grecia,1,5,,6,-75.527794,10.406342
9167,2012,Octubre,Grecia,2,2,,4,-75.516486,10.446304
9168,2012,Octubre,Grecia,0,1,,1,-74.765343,10.970933
9169,2012,Octubre,Grecia,0,2,,2,-72.129595,11.360028999999999
9170,2012,Octubre,Grecia,0,2,,2,-76.532004,3.451668
9171,2012,Octubre,Grecia,11,50,,61,-74.140516,4.697157
9172,2012,Octubre,Grecia,0,2,,2,-75.42726,6.170465
9173,2012,Octubre,Grecia,0,1,,1,-72.453013,7.819
9174,2012,Octubre,Grecia,0,1,,1,-72.508188,7.927233
9175,2012,Octubre,Grecia,0,2,,2,-76.7333,8.06667
9176,2012,Octubre,Grecia,0,1,,1,-77.35002,8.63337
9177,2012,Octubre,Guatemala,5,5,,10,-69.941498,4.191162
9178,2012,Octubre,Guatemala,0,3,,3,-75.527794,10.406342
9179,2012,Octubre,Guatemala,41,62,,103,-75.516486,10.446304
9180,2012,Octubre,Guatemala,2,6,,8,-74.77647900000001,10.886686
9181,2012,Octubre,Guatemala,0,1,,1,-72.129595,11.360028999999999
9182,2012,Octubre,Guatemala,4,3,,7,-81.70216500000001,12.5862
9183,2012,Octubre,Guatemala,22,48,,70,-76.532004,3.451668
9184,2012,Octubre,Guatemala,168,412,,580,-74.140516,4.697157
9185,2012,Octubre,Guatemala,4,2,,6,-75.736374,4.815189
9186,2012,Octubre,Guatemala,53,73,,126,-75.42726,6.170465
9187,2012,Octubre,Guatemala,8,12,,20,-72.453013,7.819
9188,2012,Octubre,Guatemala,2,1,,3,-72.508188,7.927233
9189,2012,Octubre,Guatemala,0,2,,2,-77.35002,8.63337
9190,2012,Octubre,Guyana,0,3,,3,-74.77647900000001,10.886686
9191,2012,Octubre,Guyana,0,1,,1,-76.532004,3.451668
9192,2012,Octubre,Guyana,4,7,,11,-74.140516,4.697157
9193,2012,Octubre,Guyana,2,3,,5,-75.42726,6.170465
9194,2012,Octubre,Guayana Francesa/Departamento de Ultramar Francés,0,1,,1,-74.77647900000001,10.886686
9195,2012,Octubre,Haití,2,1,,3,-75.516486,10.446304
9196,2012,Octubre,Haití,0,1,,1,-74.77647900000001,10.886686
9197,2012,Octubre,Haití,0,4,,4,-76.532004,3.451668
9198,2012,Octubre,Haití,4,68,,72,-74.140516,4.697157
9199,2012,Octubre,Haití,0,2,,2,-75.42726,6.170465
9200,2012,Octubre,Honduras,1,2,,3,-77.35600000000001,0.81488
9201,2012,Octubre,Honduras,7,15,,22,-75.516486,10.446304
9202,2012,Octubre,Honduras,4,3,,7,-74.77647900000001,10.886686
9203,2012,Octubre,Honduras,1,22,,23,-81.703935,12.574411099999999
9204,2012,Octubre,Honduras,5,7,,12,-81.70216500000001,12.5862
9205,2012,Octubre,Honduras,12,21,,33,-76.532004,3.451668
9206,2012,Octubre,Honduras,117,206,,323,-74.140516,4.697157
9207,2012,Octubre,Honduras,1,2,,3,-75.736374,4.815189
9208,2012,Octubre,Honduras,26,38,,64,-75.42726,6.170465
9209,2012,Octubre,Honduras,0,2,,2,-73.181317,7.1280470000000005
9210,2012,Octubre,Honduras,0,1,,1,-72.508188,7.927233
9211,2012,Octubre,Honduras,0,1,,1,-76.7333,8.06667
9212,2012,Octubre,Hong Kong,0,1,,1,-74.140516,4.697157
9213,2012,Octubre,Hungría,0,2,,2,-75.516486,10.446304
9214,2012,Octubre,Hungría,1,1,,2,-76.532004,3.451668
9215,2012,Octubre,Hungría,11,22,,33,-74.140516,4.697157
9216,2012,Octubre,Hungría,0,1,,1,-75.42726,6.170465
9217,2012,Octubre,Hungría,1,1,,2,-72.453013,7.819
9218,2012,Octubre,India,0,2,,2,-75.527794,10.406342
9219,2012,Octubre,India,3,8,,11,-75.516486,10.446304
9220,2012,Octubre,India,0,1,,1,-74.77647900000001,10.886686
9221,2012,Octubre,India,1,11,,12,-76.532004,3.451668
9222,2012,Octubre,India,29,242,,271,-74.140516,4.697157
9223,2012,Octubre,India,4,25,,29,-75.42726,6.170465
9224,2012,Octubre,Indonesia,1,1,,2,-77.35600000000001,0.81488
9225,2012,Octubre,Indonesia,0,1,,1,-75.527794,10.406342
9226,2012,Octubre,Indonesia,7,25,,32,-74.140516,4.697157
9227,2012,Octubre,Indonesia,1,0,,1,-75.42726,6.170465
9228,2012,Octubre,Iraq,7,5,,12,-74.140516,4.697157
9229,2012,Octubre,Irán,0,2,,2,-75.516486,10.446304
9230,2012,Octubre,Irán,6,12,,18,-74.140516,4.697157
9231,2012,Octubre,República de Irlanda,10,9,,19,-77.35600000000001,0.81488
9232,2012,Octubre,República de Irlanda,1,6,,7,-75.527794,10.406342
9233,2012,Octubre,República de Irlanda,2,10,,12,-75.516486,10.446304
9234,2012,Octubre,República de Irlanda,0,1,,1,-74.77647900000001,10.886686
9235,2012,Octubre,República de Irlanda,0,6,,6,-72.129595,11.360028999999999
9236,2012,Octubre,República de Irlanda,0,2,,2,-76.532004,3.451668
9237,2012,Octubre,República de Irlanda,42,97,,139,-74.140516,4.697157
9238,2012,Octubre,República de Irlanda,3,8,,11,-75.42726,6.170465
9239,2012,Octubre,República de Irlanda,1,0,,1,-77.35002,8.63337
9240,2012,Octubre,Islandia,0,4,,4,-69.941498,4.191162
9241,2012,Octubre,Islandia,0,1,,1,-75.516486,10.446304
9242,2012,Octubre,Islandia,0,1,,1,-76.532004,3.451668
9243,2012,Octubre,Islandia,6,9,,15,-74.140516,4.697157
9244,2012,Octubre,Isla de Man,9,13,,22,-77.35600000000001,0.81488
9245,2012,Octubre,Isla de Man,3,14,,17,-75.516486,10.446304
9246,2012,Octubre,Isla de Man,2,4,,6,-74.77647900000001,10.886686
9247,2012,Octubre,Isla de Man,5,14,,19,-76.532004,3.451668
9248,2012,Octubre,Isla de Man,35,95,,130,-74.140516,4.697157
9249,2012,Octubre,Isla de Man,0,1,,1,-75.736374,4.815189
9250,2012,Octubre,Isla de Man,14,34,,48,-75.42726,6.170465
9251,2012,Octubre,Isla de Man,0,1,,1,-72.453013,7.819
9252,2012,Octubre,Isla de Man,0,1,,1,-77.35002,8.63337
9253,2012,Octubre,Isla Johnston,0,2,,2,-74.140516,4.697157
9254,2012,Octubre,Israel,1,3,,4,-69.941498,4.191162
9255,2012,Octubre,Israel,5,11,,16,-77.35600000000001,0.81488
9256,2012,Octubre,Israel,1,3,,4,-75.527794,10.406342
9257,2012,Octubre,Israel,4,21,,25,-75.516486,10.446304
9258,2012,Octubre,Israel,0,3,,3,-74.77647900000001,10.886686
9259,2012,Octubre,Israel,4,18,,22,-76.532004,3.451668
9260,2012,Octubre,Israel,1,0,,1,-75.76635300000001,4.45285
9261,2012,Octubre,Israel,75,417,,492,-74.140516,4.697157
9262,2012,Octubre,Israel,7,40,,47,-75.42726,6.170465
9263,2012,Octubre,Israel,0,1,,1,-72.453013,7.819
9264,2012,Octubre,Israel,0,1,,1,-72.508188,7.927233
9265,2012,Octubre,Israel,2,6,,8,-77.35002,8.63337
9266,2012,Octubre,Islas Aland/Provincia de Finlandia,0,2,,2,-74.140516,4.697157
9267,2012,Octubre,Italia,0,1,,1,-69.941498,4.191162
9268,2012,Octubre,Italia,3,18,,21,-77.35600000000001,0.81488
9269,2012,Octubre,Italia,2,9,,11,-75.527794,10.406342
9270,2012,Octubre,Italia,31,64,,95,-75.516486,10.446304
9271,2012,Octubre,Italia,1,13,,14,-74.77647900000001,10.886686
9272,2012,Octubre,Italia,0,2,,2,-74.765343,10.970933
9273,2012,Octubre,Italia,0,1,,1,-74.213989,11.247722999999999
9274,2012,Octubre,Italia,1,7,,8,-72.129595,11.360028999999999
9275,2012,Octubre,Italia,7,8,,15,-81.70216500000001,12.5862
9276,2012,Octubre,Italia,21,84,,105,-76.532004,3.451668
9277,2012,Octubre,Italia,402,1513,,1915,-74.140516,4.697157
9278,2012,Octubre,Italia,0,2,,2,-75.736374,4.815189
9279,2012,Octubre,Italia,13,96,,109,-75.42726,6.170465
9280,2012,Octubre,Italia,0,3,,3,-67.48402800000001,6.185536
9281,2012,Octubre,Italia,0,3,,3,-73.181317,7.1280470000000005
9282,2012,Octubre,Italia,3,18,,21,-72.453013,7.819
9283,2012,Octubre,Italia,0,4,,4,-72.508188,7.927233
9284,2012,Octubre,Italia,0,5,,5,-77.35002,8.63337
9285,2012,Octubre,Islas del Canal,0,1,,1,-74.140516,4.697157
9286,2012,Octubre,Jamaica,2,6,,8,-75.516486,10.446304
9287,2012,Octubre,Jamaica,0,3,,3,-74.77647900000001,10.886686
9288,2012,Octubre,Jamaica,0,1,,1,-72.129595,11.360028999999999
9289,2012,Octubre,Jamaica,1,4,,5,-81.70216500000001,12.5862
9290,2012,Octubre,Jamaica,1,3,,4,-76.532004,3.451668
9291,2012,Octubre,Jamaica,10,19,,29,-74.140516,4.697157
9292,2012,Octubre,Jamaica,3,1,,4,-75.42726,6.170465
9293,2012,Octubre,Jamaica,1,0,,1,-73.181317,7.1280470000000005
9294,2012,Octubre,Jamaica,0,2,,2,-72.453013,7.819
9295,2012,Octubre,Japón,0,2,,2,-69.941498,4.191162
9296,2012,Octubre,Japón,2,9,,11,-77.35600000000001,0.81488
9297,2012,Octubre,Japón,4,4,,8,-75.527794,10.406342
9298,2012,Octubre,Japón,2,12,,14,-75.516486,10.446304
9299,2012,Octubre,Japón,1,10,,11,-74.77647900000001,10.886686
9300,2012,Octubre,Japón,0,1,,1,-81.70216500000001,12.5862
9301,2012,Octubre,Japón,9,33,,42,-76.532004,3.451668
9302,2012,Octubre,Japón,77,429,,506,-74.140516,4.697157
9303,2012,Octubre,Japón,3,22,,25,-75.42726,6.170465
9304,2012,Octubre,Japón,3,5,,8,-72.453013,7.819
9305,2012,Octubre,Japón,0,1,,1,-72.508188,7.927233
9306,2012,Octubre,Jordania,0,1,,1,-76.532004,3.451668
9307,2012,Octubre,Jordania,1,5,,6,-74.140516,4.697157
9308,2012,Octubre,Jordania,0,1,,1,-72.453013,7.819
9309,2012,Octubre,Kazajistán,0,6,,6,-76.532004,3.451668
9310,2012,Octubre,Kenia,0,1,,1,-75.516486,10.446304
9311,2012,Octubre,Kenia,4,17,,21,-74.140516,4.697157
9312,2012,Octubre,Kenia,1,0,,1,-75.42726,6.170465
9313,2012,Octubre,Kirguistán,1,1,,2,-74.140516,4.697157
9314,2012,Octubre,Letonia,0,2,,2,-75.527794,10.406342
9315,2012,Octubre,Letonia,0,1,,1,-74.765343,10.970933
9316,2012,Octubre,Letonia,2,6,,8,-74.140516,4.697157
9317,2012,Octubre,Letonia,0,3,,3,-75.42726,6.170465
9318,2012,Octubre,Lituania,1,0,,1,-77.35600000000001,0.81488
9319,2012,Octubre,Lituania,0,2,,2,-75.527794,10.406342
9320,2012,Octubre,Lituania,1,0,,1,-76.532004,3.451668
9321,2012,Octubre,Lituania,8,13,,21,-74.140516,4.697157
9322,2012,Octubre,Lituania,1,0,,1,-75.42726,6.170465
9323,2012,Octubre,Líbano,0,3,,3,-77.35600000000001,0.81488
9324,2012,Octubre,Líbano,1,0,,1,-75.516486,10.446304
9325,2012,Octubre,Líbano,1,6,,7,-74.77647900000001,10.886686
9326,2012,Octubre,Líbano,1,8,,9,-72.129595,11.360028999999999
9327,2012,Octubre,Líbano,0,2,,2,-76.532004,3.451668
9328,2012,Octubre,Líbano,18,25,,43,-74.140516,4.697157
9329,2012,Octubre,Libia,0,1,,1,-74.140516,4.697157
9330,2012,Octubre,Liechtenstein,0,1,,1,-74.140516,4.697157
9331,2012,Octubre,Liechtenstein,0,1,,1,-75.42726,6.170465
9332,2012,Octubre,Luxemburgo,2,13,,15,-74.140516,4.697157
9333,2012,Octubre,Luxemburgo,1,0,,1,-75.42726,6.170465
9334,2012,Octubre,Macedonia,0,1,,1,-74.140516,4.697157
9335,2012,Octubre,Madagascar,1,2,,3,-74.140516,4.697157
9336,2012,Octubre,Malasia,1,3,,4,-75.516486,10.446304
9337,2012,Octubre,Malasia,1,2,,3,-76.532004,3.451668
9338,2012,Octubre,Malasia,10,15,,25,-74.140516,4.697157
9339,2012,Octubre,Malasia,3,0,,3,-75.42726,6.170465
9340,2012,Octubre,Malawi,0,1,,1,-74.140516,4.697157
9341,2012,Octubre,Malí,0,1,,1,-74.140516,4.697157
9342,2012,Octubre,Malta,1,0,,1,-74.140516,4.697157
9343,2012,Octubre,Malta,1,0,,1,-72.453013,7.819
9344,2012,Octubre,Marruecos,3,7,,10,-74.140516,4.697157
9345,2012,Octubre,Mauricio,1,0,,1,-77.35600000000001,0.81488
9346,2012,Octubre,Mauricio,0,1,,1,-74.140516,4.697157
9347,2012,Octubre,México,0,1,,1,-76.876446,0.33002
9348,2012,Octubre,México,10,21,,31,-77.35600000000001,0.81488
9349,2012,Octubre,México,2,4,,6,-75.527794,10.406342
9350,2012,Octubre,México,142,250,,392,-75.516486,10.446304
9351,2012,Octubre,México,18,59,,77,-74.77647900000001,10.886686
9352,2012,Octubre,México,1,2,,3,-72.129595,11.360028999999999
9353,2012,Octubre,México,4,2,,6,-81.70216500000001,12.5862
9354,2012,Octubre,México,63,172,,235,-76.532004,3.451668
9355,2012,Octubre,México,1980,4630,,6610,-74.140516,4.697157
9356,2012,Octubre,México,4,17,,21,-75.736374,4.815189
9357,2012,Octubre,México,126,343,,469,-75.42726,6.170465
9358,2012,Octubre,México,1,1,,2,-67.48402800000001,6.185536
9359,2012,Octubre,México,3,8,,11,-73.181317,7.1280470000000005
9360,2012,Octubre,México,6,22,,28,-72.453013,7.819
9361,2012,Octubre,México,2,4,,6,-72.508188,7.927233
9362,2012,Octubre,México,2,4,,6,-77.35002,8.63337
9363,2012,Octubre,República de Moldavia,3,1,,4,-74.140516,4.697157
9364,2012,Octubre,Mongolia,0,1,,1,-76.532004,3.451668
9365,2012,Octubre,Mongolia,1,0,,1,-74.140516,4.697157
9366,2012,Octubre,Mongolia,1,0,,1,-75.42726,6.170465
9367,2012,Octubre,Myanmar,0,1,,1,-74.140516,4.697157
9368,2012,Octubre,Namibia,1,4,,5,-74.140516,4.697157
9369,2012,Octubre,Nepal,1,1,,2,-74.140516,4.697157
9370,2012,Octubre,Nicaragua,1,0,,1,-77.35600000000001,0.81488
9371,2012,Octubre,Nicaragua,13,5,,18,-75.516486,10.446304
9372,2012,Octubre,Nicaragua,0,2,,2,-74.77647900000001,10.886686
9373,2012,Octubre,Nicaragua,7,3,,10,-81.70216500000001,12.5862
9374,2012,Octubre,Nicaragua,7,18,,25,-76.532004,3.451668
9375,2012,Octubre,Nicaragua,0,1,,1,-75.76635300000001,4.45285
9376,2012,Octubre,Nicaragua,68,78,,146,-74.140516,4.697157
9377,2012,Octubre,Nicaragua,0,2,,2,-75.736374,4.815189
9378,2012,Octubre,Nicaragua,10,15,,25,-75.42726,6.170465
9379,2012,Octubre,Nicaragua,0,1,,1,-73.181317,7.1280470000000005
9380,2012,Octubre,Nigeria,1,1,,2,-75.516486,10.446304
9381,2012,Octubre,Nigeria,0,1,,1,-76.532004,3.451668
9382,2012,Octubre,Nigeria,2,6,,8,-74.140516,4.697157
9383,2012,Octubre,Noruega,2,3,,5,-77.35600000000001,0.81488
9384,2012,Octubre,Noruega,0,4,,4,-75.527794,10.406342
9385,2012,Octubre,Noruega,0,5,,5,-75.516486,10.446304
9386,2012,Octubre,Noruega,0,3,,3,-74.77647900000001,10.886686
9387,2012,Octubre,Noruega,2,5,,7,-76.532004,3.451668
9388,2012,Octubre,Noruega,50,103,,153,-74.140516,4.697157
9389,2012,Octubre,Noruega,1,9,,10,-75.42726,6.170465
9390,2012,Octubre,Noruega,0,2,,2,-73.181317,7.1280470000000005
9391,2012,Octubre,Nueva Zelanda,1,3,,4,-69.941498,4.191162
9392,2012,Octubre,Nueva Zelanda,6,16,,22,-77.35600000000001,0.81488
9393,2012,Octubre,Nueva Zelanda,4,4,,8,-75.516486,10.446304
9394,2012,Octubre,Nueva Zelanda,0,2,,2,-74.77647900000001,10.886686
9395,2012,Octubre,Nueva Zelanda,2,3,,5,-76.532004,3.451668
9396,2012,Octubre,Nueva Zelanda,39,61,,100,-74.140516,4.697157
9397,2012,Octubre,Nueva Zelanda,0,1,,1,-75.736374,4.815189
9398,2012,Octubre,Nueva Zelanda,9,10,,19,-75.42726,6.170465
9399,2012,Octubre,Nueva Zelanda,0,1,,1,-72.453013,7.819
9400,2012,Octubre,Nueva Zelanda,0,1,,1,-69.941498,4.191162
9401,2012,Octubre,Nueva Zelanda,1,0,,1,-77.35600000000001,0.81488
9402,2012,Octubre,Nueva Zelanda,2,3,,5,-75.527794,10.406342
9403,2012,Octubre,Nueva Zelanda,0,2,,2,-75.516486,10.446304
9404,2012,Octubre,Nueva Zelanda,2,2,,4,-74.140516,4.697157
9405,2012,Octubre,Nueva Zelanda,1,1,,2,-75.42726,6.170465
9406,2012,Octubre,Países Bajos,1,2,,3,-77.35600000000001,0.81488
9407,2012,Octubre,Países Bajos,6,4,,10,-75.516486,10.446304
9408,2012,Octubre,Países Bajos,4,7,,11,-74.77647900000001,10.886686
9409,2012,Octubre,Países Bajos,20,26,,46,-72.919186,11.52863
9410,2012,Octubre,Países Bajos,5,25,,30,-76.532004,3.451668
9411,2012,Octubre,Países Bajos,4,12,,16,-75.76635300000001,4.45285
9412,2012,Octubre,Países Bajos,132,251,,383,-74.140516,4.697157
9413,2012,Octubre,Países Bajos,1,2,,3,-75.736374,4.815189
9414,2012,Octubre,Países Bajos,188,194,,382,-75.42726,6.170465
9415,2012,Octubre,Países Bajos,9,6,,15,-73.181317,7.1280470000000005
9416,2012,Octubre,Pakistán,0,1,,1,-77.35600000000001,0.81488
9417,2012,Octubre,Pakistán,0,1,,1,-75.516486,10.446304
9418,2012,Octubre,Pakistán,1,10,,11,-74.140516,4.697157
9419,2012,Octubre,Pakistán,0,1,,1,-72.453013,7.819
9420,2012,Octubre,Panamá,2,0,,2,-77.35600000000001,0.81488
9421,2012,Octubre,Panamá,0,9,,9,-75.527794,10.406342
9422,2012,Octubre,Panamá,126,173,,299,-75.516486,10.446304
9423,2012,Octubre,Panamá,40,98,,138,-74.77647900000001,10.886686
9424,2012,Octubre,Panamá,0,1,,1,-72.129595,11.360028999999999
9425,2012,Octubre,Panamá,23,24,,47,-81.70216500000001,12.5862
9426,2012,Octubre,Panamá,93,136,,229,-76.532004,3.451668
9427,2012,Octubre,Panamá,0,2,,2,-77.061029,3.8844260000000004
9428,2012,Octubre,Panamá,432,748,,1180,-74.140516,4.697157
9429,2012,Octubre,Panamá,46,81,,127,-75.736374,4.815189
9430,2012,Octubre,Panamá,179,313,,492,-75.42726,6.170465
9431,2012,Octubre,Panamá,2,2,,4,-77.401154,6.222551999999999
9432,2012,Octubre,Panamá,0,1,,1,-70.74025300000001,7.088728999999999
9433,2012,Octubre,Panamá,6,5,,11,-73.181317,7.1280470000000005
9434,2012,Octubre,Panamá,1,10,,11,-72.453013,7.819
9435,2012,Octubre,Panamá,5,6,,11,-72.508188,7.927233
9436,2012,Octubre,Panamá,2,5,,7,-77.35002,8.63337
9437,2012,Octubre,Paraguay,0,1,,1,-76.876446,0.33002
9438,2012,Octubre,Paraguay,2,3,,5,-77.35600000000001,0.81488
9439,2012,Octubre,Paraguay,73,83,,156,-75.516486,10.446304
9440,2012,Octubre,Paraguay,20,105,,125,-74.77647900000001,10.886686
9441,2012,Octubre,Paraguay,1,1,,2,-72.129595,11.360028999999999
9442,2012,Octubre,Paraguay,1,0,,1,-81.70216500000001,12.5862
9443,2012,Octubre,Paraguay,14,9,,23,-76.532004,3.451668
9444,2012,Octubre,Paraguay,89,119,,208,-74.140516,4.697157
9445,2012,Octubre,Paraguay,0,1,,1,-75.736374,4.815189
9446,2012,Octubre,Paraguay,24,24,,48,-75.42726,6.170465
9447,2012,Octubre,Paraguay,3,3,,6,-73.181317,7.1280470000000005
9448,2012,Octubre,Paraguay,1,2,,3,-72.453013,7.819
9449,2012,Octubre,Perú,30,43,,73,-69.941498,4.191162
9450,2012,Octubre,Perú,1,2,,3,-76.876446,0.33002
9451,2012,Octubre,Perú,93,281,,374,-77.35600000000001,0.81488
9452,2012,Octubre,Perú,1,0,,1,-78.802679,18.00143
9453,2012,Octubre,Perú,0,1,,1,-75.527794,10.406342
9454,2012,Octubre,Perú,165,167,,332,-75.516486,10.446304
9455,2012,Octubre,Perú,26,41,,67,-74.77647900000001,10.886686
9456,2012,Octubre,Perú,6,18,,24,-72.129595,11.360028999999999
9457,2012,Octubre,Perú,255,145,,400,-81.70216500000001,12.5862
9458,2012,Octubre,Perú,147,203,,350,-76.532004,3.451668
9459,2012,Octubre,Perú,2,0,,2,-75.76635300000001,4.45285
9460,2012,Octubre,Perú,2412,3414,,5826,-74.140516,4.697157
9461,2012,Octubre,Perú,1,1,,2,-75.736374,4.815189
9462,2012,Octubre,Perú,157,372,,529,-75.42726,6.170465
9463,2012,Octubre,Perú,1,0,,1,-67.48402800000001,6.185536
9464,2012,Octubre,Perú,1,2,,3,-73.181317,7.1280470000000005
9465,2012,Octubre,Perú,18,42,,60,-72.453013,7.819
9466,2012,Octubre,Perú,0,2,,2,-72.508188,7.927233
9467,2012,Octubre,Perú,0,1,,1,-77.35002,8.63337
9468,2012,Octubre,Palestina,2,4,,6,-74.140516,4.697157
9469,2012,Octubre,Polonia,14,11,,25,-77.35600000000001,0.81488
9470,2012,Octubre,Polonia,0,10,,10,-75.527794,10.406342
9471,2012,Octubre,Polonia,2,1,,3,-75.516486,10.446304
9472,2012,Octubre,Polonia,1,1,,2,-74.77647900000001,10.886686
9473,2012,Octubre,Polonia,0,1,,1,-74.765343,10.970933
9474,2012,Octubre,Polonia,0,1,,1,-74.213989,11.247722999999999
9475,2012,Octubre,Polonia,2,2,,4,-72.129595,11.360028999999999
9476,2012,Octubre,Polonia,4,1,,5,-76.532004,3.451668
9477,2012,Octubre,Polonia,58,93,,151,-74.140516,4.697157
9478,2012,Octubre,Polonia,2,16,,18,-75.42726,6.170465
9479,2012,Octubre,Polonia,1,1,,2,-77.35002,8.63337
9480,2012,Octubre,Polonia,0,1,,1,-75.68164200000001,9.402597
9481,2012,Octubre,Portugal,0,1,,1,-69.941498,4.191162
9482,2012,Octubre,Portugal,1,2,,3,-77.35600000000001,0.81488
9483,2012,Octubre,Portugal,0,2,,2,-75.527794,10.406342
9484,2012,Octubre,Portugal,3,7,,10,-75.516486,10.446304
9485,2012,Octubre,Portugal,1,1,,2,-74.77647900000001,10.886686
9486,2012,Octubre,Portugal,0,4,,4,-72.129595,11.360028999999999
9487,2012,Octubre,Portugal,4,18,,22,-76.532004,3.451668
9488,2012,Octubre,Portugal,0,1,,1,-75.76635300000001,4.45285
9489,2012,Octubre,Portugal,96,297,,393,-74.140516,4.697157
9490,2012,Octubre,Portugal,7,25,,32,-75.42726,6.170465
9491,2012,Octubre,Portugal,3,3,,6,-72.453013,7.819
9492,2012,Octubre,Portugal,1,1,,2,-72.508188,7.927233
9493,2012,Octubre,Puerto Rico/Territorio de Estados Unidos,0,4,,4,-75.516486,10.446304
9494,2012,Octubre,Puerto Rico/Territorio de Estados Unidos,0,1,,1,-74.140516,4.697157
9495,2012,Octubre,Puerto Rico/Territorio de Estados Unidos,1,0,,1,-75.42726,6.170465
9496,2012,Octubre,Reino Unido de Gran Bretaña e Irlanda del Norte,0,2,,2,-69.941498,4.191162
9497,2012,Octubre,Reino Unido de Gran Bretaña e Irlanda del Norte,0,7,,7,-77.35600000000001,0.81488
9498,2012,Octubre,Reino Unido de Gran Bretaña e Irlanda del Norte,0,1,,1,-75.527794,10.406342
9499,2012,Octubre,Reino Unido de Gran Bretaña e Irlanda del Norte,21,33,,54,-75.516486,10.446304
9500,2012,Octubre,Reino Unido de Gran Bretaña e Irlanda del Norte,1,1,,2,-74.77647900000001,10.886686
9501,2012,Octubre,Reino Unido de Gran Bretaña e Irlanda del Norte,2,2,,4,-72.129595,11.360028999999999
9502,2012,Octubre,Reino Unido de Gran Bretaña e Irlanda del Norte,0,1,,1,-81.70216500000001,12.5862
9503,2012,Octubre,Reino Unido de Gran Bretaña e Irlanda del Norte,6,16,,22,-76.532004,3.451668
9504,2012,Octubre,Reino Unido de Gran Bretaña e Irlanda del Norte,0,1,,1,-75.76635300000001,4.45285
9505,2012,Octubre,Reino Unido de Gran Bretaña e Irlanda del Norte,196,581,,777,-74.140516,4.697157
9506,2012,Octubre,Reino Unido de Gran Bretaña e Irlanda del Norte,12,30,,42,-75.42726,6.170465
9507,2012,Octubre,Reino Unido de Gran Bretaña e Irlanda del Norte,0,3,,3,-72.453013,7.819
9508,2012,Octubre,República de Belarús,4,7,,11,-74.140516,4.697157
9509,2012,Octubre,República Dominicana,2,6,,8,-77.35600000000001,0.81488
9510,2012,Octubre,República Dominicana,26,41,,67,-75.516486,10.446304
9511,2012,Octubre,República Dominicana,11,22,,33,-74.77647900000001,10.886686
9512,2012,Octubre,República Dominicana,3,3,,6,-72.129595,11.360028999999999
9513,2012,Octubre,República Dominicana,0,1,,1,-81.70216500000001,12.5862
9514,2012,Octubre,República Dominicana,31,37,,68,-76.532004,3.451668
9515,2012,Octubre,República Dominicana,0,1,,1,-75.76635300000001,4.45285
9516,2012,Octubre,República Dominicana,211,312,,523,-74.140516,4.697157
9517,2012,Octubre,República Dominicana,3,0,,3,-75.736374,4.815189
9518,2012,Octubre,República Dominicana,32,55,,87,-75.42726,6.170465
9519,2012,Octubre,República Dominicana,2,4,,6,-73.181317,7.1280470000000005
9520,2012,Octubre,República Dominicana,1,2,,3,-72.453013,7.819
9521,2012,Octubre,República Dominicana,13,26,,39,-72.508188,7.927233
9522,2012,Octubre,República Checa,2,1,,3,-77.35600000000001,0.81488
9523,2012,Octubre,República Checa,0,1,,1,-75.516486,10.446304
9524,2012,Octubre,República Checa,0,1,,1,-74.140516,4.697157
9525,2012,Octubre,Rumania,0,2,,2,-75.527794,10.406342
9526,2012,Octubre,Rumania,4,2,,6,-75.516486,10.446304
9527,2012,Octubre,Rumania,0,2,,2,-74.213989,11.247722999999999
9528,2012,Octubre,Rumania,3,3,,6,-76.532004,3.451668
9529,2012,Octubre,Rumania,32,51,,83,-74.140516,4.697157
9530,2012,Octubre,Rumania,0,6,,6,-75.42726,6.170465
9531,2012,Octubre,Rumania,0,1,,1,-72.453013,7.819
9532,2012,Octubre,Federación de Rusia,2,5,,7,-77.35600000000001,0.81488
9533,2012,Octubre,Federación de Rusia,2,20,,22,-75.527794,10.406342
9534,2012,Octubre,Federación de Rusia,3,18,,21,-75.516486,10.446304
9535,2012,Octubre,Federación de Rusia,2,1,,3,-76.532004,3.451668
9536,2012,Octubre,Federación de Rusia,42,63,,105,-74.140516,4.697157
9537,2012,Octubre,Federación de Rusia,1,0,,1,-75.736374,4.815189
9538,2012,Octubre,Federación de Rusia,1,1,,2,-75.42726,6.170465
9539,2012,Octubre,Federación de Rusia,1,0,,1,-73.181317,7.1280470000000005
9540,2012,Octubre,Rwanda,0,2,,2,-74.140516,4.697157
9541,2012,Octubre,Rwanda,0,1,,1,-75.42726,6.170465
9542,2012,Octubre,San Cristóbal y Nevis,0,1,,1,-74.140516,4.697157
9543,2012,Octubre,Samoa Estadounidense/Territorio no incorporado de Estados Unidos,0,1,,1,-75.42726,6.170465
9544,2012,Octubre,San  Vicente y las Granadinas,1,0,,1,-77.35600000000001,0.81488
9545,2012,Octubre,San  Vicente y las Granadinas,0,2,,2,-76.532004,3.451668
9546,2012,Octubre,San  Vicente y las Granadinas,1,1,,2,-74.140516,4.697157
9547,2012,Octubre,Santa Lucia,1,0,,1,-75.516486,10.446304
9548,2012,Octubre,Santa Lucia,2,2,,4,-76.532004,3.451668
9549,2012,Octubre,Santa Lucia,2,3,,5,-74.140516,4.697157
9550,2012,Octubre,Santa Lucia,1,0,,1,-75.42726,6.170465
9551,2012,Octubre,Santa Lucia,6,1,,7,-73.181317,7.1280470000000005
9552,2012,Octubre,Santa Sede/Ciudad del Vaticano,0,1,,1,-74.140516,4.697157
9553,2012,Octubre,Senegal,0,1,,1,-75.516486,10.446304
9554,2012,Octubre,Senegal,1,0,,1,-76.532004,3.451668
9555,2012,Octubre,Senegal,3,3,,6,-74.140516,4.697157
9556,2012,Octubre,Serbia,3,6,,9,-74.140516,4.697157
9557,2012,Octubre,Serbia,0,1,,1,-75.42726,6.170465
9558,2012,Octubre,Singapur,1,0,,1,-77.35600000000001,0.81488
9559,2012,Octubre,Singapur,3,0,,3,-75.516486,10.446304
9560,2012,Octubre,Singapur,5,12,,17,-74.140516,4.697157
9561,2012,Octubre,Singapur,0,1,,1,-75.736374,4.815189
9562,2012,Octubre,Singapur,0,1,,1,-75.42726,6.170465
9563,2012,Octubre,Singapur,0,1,,1,-72.453013,7.819
9564,2012,Octubre,República Árabe Siria,0,1,,1,-72.129595,11.360028999999999
9565,2012,Octubre,República Árabe Siria,0,4,,4,-74.140516,4.697157
9566,2012,Octubre,Sri Lanka,0,1,,1,-75.527794,10.406342
9567,2012,Octubre,Sri Lanka,0,3,,3,-74.140516,4.697157
9568,2012,Octubre,Sudáfrica,0,2,,2,-77.35600000000001,0.81488
9569,2012,Octubre,Sudáfrica,3,1,,4,-75.527794,10.406342
9570,2012,Octubre,Sudáfrica,1,2,,3,-75.516486,10.446304
9571,2012,Octubre,Sudáfrica,1,3,,4,-74.77647900000001,10.886686
9572,2012,Octubre,Sudáfrica,0,2,,2,-74.765343,10.970933
9573,2012,Octubre,Sudáfrica,1,1,,2,-76.532004,3.451668
9574,2012,Octubre,Sudáfrica,20,75,,95,-74.140516,4.697157
9575,2012,Octubre,Sudáfrica,2,8,,10,-75.42726,6.170465
9576,2012,Octubre,Sudáfrica,1,0,,1,-72.508188,7.927233
9577,2012,Octubre,Sudán,0,1,,1,-74.140516,4.697157
9578,2012,Octubre,Suecia,4,4,,8,-77.35600000000001,0.81488
9579,2012,Octubre,Suecia,1,0,,1,-75.527794,10.406342
9580,2012,Octubre,Suecia,5,12,,17,-75.516486,10.446304
9581,2012,Octubre,Suecia,1,0,,1,-74.77647900000001,10.886686
9582,2012,Octubre,Suecia,1,4,,5,-74.213989,11.247722999999999
9583,2012,Octubre,Suecia,1,3,,4,-72.129595,11.360028999999999
9584,2012,Octubre,Suecia,1,6,,7,-76.532004,3.451668
9585,2012,Octubre,Suecia,0,1,,1,-75.76635300000001,4.45285
9586,2012,Octubre,Suecia,115,229,,344,-74.140516,4.697157
9587,2012,Octubre,Suecia,7,20,,27,-75.42726,6.170465
9588,2012,Octubre,Suecia,1,1,,2,-73.181317,7.1280470000000005
9589,2012,Octubre,Suecia,3,4,,7,-72.453013,7.819
9590,2012,Octubre,Suecia,0,2,,2,-77.35002,8.63337
9591,2012,Octubre,Suiza,1,1,,2,-69.941498,4.191162
9592,2012,Octubre,Suiza,15,16,,31,-77.35600000000001,0.81488
9593,2012,Octubre,Suiza,8,15,,23,-75.527794,10.406342
9594,2012,Octubre,Suiza,7,11,,18,-75.516486,10.446304
9595,2012,Octubre,Suiza,0,7,,7,-74.77647900000001,10.886686
9596,2012,Octubre,Suiza,1,1,,2,-72.129595,11.360028999999999
9597,2012,Octubre,Suiza,1,1,,2,-72.919186,11.52863
9598,2012,Octubre,Suiza,1,4,,5,-81.70216500000001,12.5862
9599,2012,Octubre,Suiza,15,43,,58,-76.532004,3.451668
9600,2012,Octubre,Suiza,216,494,,710,-74.140516,4.697157
9601,2012,Octubre,Suiza,0,1,,1,-75.736374,4.815189
9602,2012,Octubre,Suiza,11,41,,52,-75.42726,6.170465
9603,2012,Octubre,Suiza,0,1,,1,-72.453013,7.819
9604,2012,Octubre,Suiza,2,0,,2,-77.35002,8.63337
9605,2012,Octubre,Surinam,0,5,,5,-75.516486,10.446304
9606,2012,Octubre,Surinam,1,1,,2,-76.532004,3.451668
9607,2012,Octubre,Surinam,12,15,,27,-74.140516,4.697157
9608,2012,Octubre,Surinam,2,3,,5,-75.42726,6.170465
9609,2012,Octubre,Taiwán,0,1,,1,-75.516486,10.446304
9610,2012,Octubre,Taiwán,0,1,,1,-81.70216500000001,12.5862
9611,2012,Octubre,Taiwán,1,1,,2,-76.532004,3.451668
9612,2012,Octubre,Taiwán,0,4,,4,-74.140516,4.697157
9613,2012,Octubre,Taiwán,1,0,,1,-75.42726,6.170465
9614,2012,Octubre,Tailandia,1,0,,1,-75.516486,10.446304
9615,2012,Octubre,Tailandia,1,2,,3,-76.532004,3.451668
9616,2012,Octubre,Tailandia,3,6,,9,-74.140516,4.697157
9617,2012,Octubre,Tailandia,1,0,,1,-75.42726,6.170465
9618,2012,Octubre,Territorio Antártico Británico/Territorio Británico de Ultramar,0,1,,1,-74.140516,4.697157
9619,2012,Octubre,Tanzania,0,3,,3,-75.42726,6.170465
9620,2012,Octubre,Togo,0,2,,2,-74.140516,4.697157
9621,2012,Octubre,Trinidad y Tobago,0,1,,1,-75.527794,10.406342
9622,2012,Octubre,Trinidad y Tobago,1,9,,10,-75.516486,10.446304
9623,2012,Octubre,Trinidad y Tobago,0,2,,2,-74.77647900000001,10.886686
9624,2012,Octubre,Trinidad y Tobago,0,1,,1,-72.129595,11.360028999999999
9625,2012,Octubre,Trinidad y Tobago,7,6,,13,-76.532004,3.451668
9626,2012,Octubre,Trinidad y Tobago,10,84,,94,-74.140516,4.697157
9627,2012,Octubre,Trinidad y Tobago,0,17,,17,-75.42726,6.170465
9628,2012,Octubre,Trinidad y Tobago,0,1,,1,-73.181317,7.1280470000000005
9629,2012,Octubre,Trinidad y Tobago,0,1,,1,-72.508188,7.927233
9630,2012,Octubre,Túnez,1,1,,2,-74.140516,4.697157
9631,2012,Octubre,Turquía,0,2,,2,-77.35600000000001,0.81488
9632,2012,Octubre,Turquía,0,1,,1,-78.802679,18.00143
9633,2012,Octubre,Turquía,0,2,,2,-75.527794,10.406342
9634,2012,Octubre,Turquía,0,2,,2,-75.516486,10.446304
9635,2012,Octubre,Turquía,0,1,,1,-72.129595,11.360028999999999
9636,2012,Octubre,Turquía,0,1,,1,-76.532004,3.451668
9637,2012,Octubre,Turquía,48,79,,127,-74.140516,4.697157
9638,2012,Octubre,Turquía,0,5,,5,-75.42726,6.170465
9639,2012,Octubre,Turquía,0,1,,1,-72.453013,7.819
9640,2012,Octubre,Ucrania,0,2,,2,-76.532004,3.451668
9641,2012,Octubre,Ucrania,0,2,,2,-77.061029,3.8844260000000004
9642,2012,Octubre,Ucrania,23,28,,51,-74.140516,4.697157
9643,2012,Octubre,Ucrania,1,0,,1,-75.42726,6.170465
9644,2012,Octubre,Uganda,0,1,,1,-76.876446,0.33002
9645,2012,Octubre,Uganda,2,0,,2,-74.140516,4.697157
9646,2012,Octubre,Federación de Rusia,1,3,,4,-69.941498,4.191162
9647,2012,Octubre,Federación de Rusia,0,1,,1,-77.35600000000001,0.81488
9648,2012,Octubre,Federación de Rusia,0,2,,2,-75.527794,10.406342
9649,2012,Octubre,Federación de Rusia,3,0,,3,-75.516486,10.446304
9650,2012,Octubre,Federación de Rusia,0,1,,1,-74.765343,10.970933
9651,2012,Octubre,Federación de Rusia,2,3,,5,-76.532004,3.451668
9652,2012,Octubre,Federación de Rusia,88,168,,256,-74.140516,4.697157
9653,2012,Octubre,Federación de Rusia,2,1,,3,-75.42726,6.170465
9654,2012,Octubre,Federación de Rusia,2,1,,3,-72.453013,7.819
9655,2012,Octubre,Uruguay,2,9,,11,-77.35600000000001,0.81488
9656,2012,Octubre,Uruguay,0,1,,1,-75.527794,10.406342
9657,2012,Octubre,Uruguay,80,74,,154,-75.516486,10.446304
9658,2012,Octubre,Uruguay,0,4,,4,-74.77647900000001,10.886686
9659,2012,Octubre,Uruguay,0,5,,5,-72.129595,11.360028999999999
9660,2012,Octubre,Uruguay,39,31,,70,-81.70216500000001,12.5862
9661,2012,Octubre,Uruguay,12,23,,35,-76.532004,3.451668
9662,2012,Octubre,Uruguay,116,290,,406,-74.140516,4.697157
9663,2012,Octubre,Uruguay,0,2,,2,-75.736374,4.815189
9664,2012,Octubre,Uruguay,25,47,,72,-75.42726,6.170465
9665,2012,Octubre,Uruguay,2,3,,5,-72.453013,7.819
9666,2012,Octubre,Venezuela,0,2,,2,-69.941498,4.191162
9667,2012,Octubre,Venezuela,0,1,,1,-76.876446,0.33002
9668,2012,Octubre,Venezuela,69,83,,152,-77.35600000000001,0.81488
9669,2012,Octubre,Venezuela,0,20,,20,-77.290564,13.97318
9670,2012,Octubre,Venezuela,0,1,,1,-75.527794,10.406342
9671,2012,Octubre,Venezuela,131,153,,284,-75.516486,10.446304
9672,2012,Octubre,Venezuela,35,75,,110,-74.77647900000001,10.886686
9673,2012,Octubre,Venezuela,2,7,,9,-74.232675,11.117206
9674,2012,Octubre,Venezuela,776,1425,,2201,-72.129595,11.360028999999999
9675,2012,Octubre,Venezuela,20,12,,32,-81.70216500000001,12.5862
9676,2012,Octubre,Venezuela,55,81,,136,-76.532004,3.451668
9677,2012,Octubre,Venezuela,1,3,,4,-75.76635300000001,4.45285
9678,2012,Octubre,Venezuela,5287,6649,,11936,-74.140516,4.697157
9679,2012,Octubre,Venezuela,1,12,,13,-75.736374,4.815189
9680,2012,Octubre,Venezuela,313,393,,706,-75.42726,6.170465
9681,2012,Octubre,Venezuela,51,89,,140,-67.48402800000001,6.185536
9682,2012,Octubre,Venezuela,49,101,,150,-70.74025300000001,7.088728999999999
9683,2012,Octubre,Venezuela,2,2,,4,-73.181317,7.1280470000000005
9684,2012,Octubre,Venezuela,1046,1305,,2351,-72.453013,7.819
9685,2012,Octubre,Venezuela,214,302,,516,-72.508188,7.927233
9686,2012,Octubre,Venezuela,0,1,,1,-77.35002,8.63337
9687,2012,Octubre,Vietnam,0,2,,2,-75.527794,10.406342
9688,2012,Octubre,Vietnam,2,4,,6,-74.140516,4.697157
9689,2012,Octubre,República Árabe de Yemen,0,1,,1,-74.140516,4.697157
9690,2012,Octubre,Yugoslavia,1,0,,1,-75.516486,10.446304
9691,2012,Octubre,Zambia,0,1,,1,-74.140516,4.697157
9692,2012,Octubre,Zimbabue,1,0,,1,-74.140516,4.697157
9693,2012,Octubre,Reino Unido de Gran Bretaña e Irlanda del Norte,8,3,,11,-69.941498,4.191162
9694,2012,Octubre,Reino Unido de Gran Bretaña e Irlanda del Norte,20,33,,53,-77.35600000000001,0.81488
9695,2012,Octubre,Reino Unido de Gran Bretaña e Irlanda del Norte,24,33,,57,-75.527794,10.406342
9696,2012,Octubre,Reino Unido de Gran Bretaña e Irlanda del Norte,11,29,,40,-75.516486,10.446304
9697,2012,Octubre,Reino Unido de Gran Bretaña e Irlanda del Norte,0,2,,2,-74.77647900000001,10.886686
9698,2012,Octubre,Reino Unido de Gran Bretaña e Irlanda del Norte,3,8,,11,-72.129595,11.360028999999999
9699,2012,Octubre,Reino Unido de Gran Bretaña e Irlanda del Norte,1,1,,2,-81.70216500000001,12.5862
9700,2012,Octubre,Reino Unido de Gran Bretaña e Irlanda del Norte,6,26,,32,-76.532004,3.451668
9701,2012,Octubre,Reino Unido de Gran Bretaña e Irlanda del Norte,1,0,,1,-75.76635300000001,4.45285
9702,2012,Octubre,Reino Unido de Gran Bretaña e Irlanda del Norte,185,589,,774,-74.140516,4.697157
9703,2012,Octubre,Reino Unido de Gran Bretaña e Irlanda del Norte,8,28,,36,-75.42726,6.170465
9704,2012,Octubre,Reino Unido de Gran Bretaña e Irlanda del Norte,0,6,,6,-72.453013,7.819
9705,2012,Octubre,Reino Unido de Gran Bretaña e Irlanda del Norte,4,0,,4,-77.35002,8.63337
9706,2012,Octubre,Países Bajos,3,3,,6,-69.941498,4.191162
9707,2012,Octubre,Países Bajos,7,10,,17,-77.35600000000001,0.81488
9708,2012,Octubre,Países Bajos,5,11,,16,-75.527794,10.406342
9709,2012,Octubre,Países Bajos,9,29,,38,-75.516486,10.446304
9710,2012,Octubre,Países Bajos,5,4,,9,-74.77647900000001,10.886686
9711,2012,Octubre,Países Bajos,0,4,,4,-74.765343,10.970933
9712,2012,Octubre,Países Bajos,1,1,,2,-74.213989,11.247722999999999
9713,2012,Octubre,Países Bajos,1,4,,5,-72.129595,11.360028999999999
9714,2012,Octubre,Países Bajos,0,1,,1,-81.703935,12.574411099999999
9715,2012,Octubre,Países Bajos,10,54,,64,-76.532004,3.451668
9716,2012,Octubre,Países Bajos,13,17,,30,-75.76635300000001,4.45285
9717,2012,Octubre,Países Bajos,382,695,,1077,-74.140516,4.697157
9718,2012,Octubre,Países Bajos,92,120,,212,-75.42726,6.170465
9719,2012,Octubre,Países Bajos,3,3,,6,-73.181317,7.1280470000000005
9720,2012,Octubre,Países Bajos,1,3,,4,-72.453013,7.819
9721,2012,Octubre,Países Bajos,0,3,,3,-76.7333,8.06667
9722,2012,Octubre,Países Bajos,0,1,,1,-77.35002,8.63337
9723,2012,Octubre,Eslovenia,1,0,,1,-74.140516,4.697157
9724,2012,Octubre,Lituania,2,0,,2,-74.140516,4.697157
9725,2012,Octubre,Reino Unido de Gran Bretaña e Irlanda del Norte,4,7,,11,-74.140516,4.697157
9726,2012,Octubre,Reino Unido de Gran Bretaña e Irlanda del Norte,0,1,,1,-75.42726,6.170465
9727,2012,Octubre,Reino Unido de Gran Bretaña e Irlanda del Norte,0,1,,1,-77.35600000000001,0.81488
9728,2012,Octubre,Reino Unido de Gran Bretaña e Irlanda del Norte,0,2,,2,-75.516486,10.446304
9729,2012,Octubre,Reino Unido de Gran Bretaña e Irlanda del Norte,4,5,,9,-74.140516,4.697157
9730,2012,Octubre,República CentroÁfricana,0,2,,2,-74.140516,4.697157
9731,2012,Noviembre,Desconocido,1,3,,4,-74.140516,4.697157
9732,2012,Noviembre,Afganistán,0,2,,2,-74.140516,4.697157
9733,2012,Noviembre,Albania,0,1,,1,-76.532004,3.451668
9734,2012,Noviembre,Albania,1,1,,2,-74.140516,4.697157
9735,2012,Noviembre,Alemania,9,18,,27,-69.941498,4.191162
9736,2012,Noviembre,Alemania,37,36,,73,-77.35600000000001,0.81488
9737,2012,Noviembre,Alemania,0,1,,1,-78.802679,18.00143
9738,2012,Noviembre,Alemania,25,34,,59,-75.527794,10.406342
9739,2012,Noviembre,Alemania,29,73,,102,-75.516486,10.446304
9740,2012,Noviembre,Alemania,7,11,,18,-74.77647900000001,10.886686
9741,2012,Noviembre,Alemania,2,1,,3,-74.213989,11.247722999999999
9742,2012,Noviembre,Alemania,6,9,,15,-72.129595,11.360028999999999
9743,2012,Noviembre,Alemania,1,2,,3,-81.70216500000001,12.5862
9744,2012,Noviembre,Alemania,1,0,,1,-81.372937,13.338761300000002
9745,2012,Noviembre,Alemania,29,63,,92,-76.532004,3.451668
9746,2012,Noviembre,Alemania,1199,2033,,3232,-74.140516,4.697157
9747,2012,Noviembre,Alemania,1,2,,3,-75.736374,4.815189
9748,2012,Noviembre,Alemania,26,88,,114,-75.42726,6.170465
9749,2012,Noviembre,Alemania,1,1,,2,-73.181317,7.1280470000000005
9750,2012,Noviembre,Alemania,5,14,,19,-72.453013,7.819
9751,2012,Noviembre,Alemania,0,4,,4,-72.508188,7.927233
9752,2012,Noviembre,Alemania,4,8,,12,-77.35002,8.63337
9753,2012,Noviembre,Andorra,0,10,,10,-74.140516,4.697157
9754,2012,Noviembre,Andorra,0,1,,1,-75.736374,4.815189
9755,2012,Noviembre,Andorra,0,1,,1,-75.42726,6.170465
9756,2012,Noviembre,Angola,1,0,,1,-74.140516,4.697157
9757,2012,Noviembre,Antigua y Barbuda,0,1,,1,-75.527794,10.406342
9758,2012,Noviembre,Antigua y Barbuda,0,1,,1,-74.77647900000001,10.886686
9759,2012,Noviembre,Antigua y Barbuda,0,2,,2,-74.140516,4.697157
9760,2012,Noviembre,Países Bajos,0,1,,1,-75.42726,6.170465
9761,2012,Noviembre,Países Bajos,1,1,,2,-73.181317,7.1280470000000005
9762,2012,Noviembre,Arabia Saudita,1,0,,1,-74.140516,4.697157
9763,2012,Noviembre,Arabia Saudita,0,1,,1,-75.516486,10.446304
9764,2012,Noviembre,Arabia Saudita,0,2,,2,-74.140516,4.697157
9765,2012,Noviembre,Argelia,0,3,,3,-74.140516,4.697157
9766,2012,Noviembre,Argentina,3,3,,6,-69.941498,4.191162
9767,2012,Noviembre,Argentina,1,1,,2,-76.876446,0.33002
9768,2012,Noviembre,Argentina,43,81,,124,-77.35600000000001,0.81488
9769,2012,Noviembre,Argentina,1,0,,1,-78.802679,18.00143
9770,2012,Noviembre,Argentina,1,5,,6,-75.527794,10.406342
9771,2012,Noviembre,Argentina,813,515,,1328,-75.516486,10.446304
9772,2012,Noviembre,Argentina,4,18,,22,-74.77647900000001,10.886686
9773,2012,Noviembre,Argentina,5,15,,20,-72.129595,11.360028999999999
9774,2012,Noviembre,Argentina,0,6,,6,-81.703935,12.574411099999999
9775,2012,Noviembre,Argentina,268,190,,458,-81.70216500000001,12.5862
9776,2012,Noviembre,Argentina,40,116,,156,-76.532004,3.451668
9777,2012,Noviembre,Argentina,0,1,,1,-75.76635300000001,4.45285
9778,2012,Noviembre,Argentina,2538,3910,,6448,-74.140516,4.697157
9779,2012,Noviembre,Argentina,0,6,,6,-75.736374,4.815189
9780,2012,Noviembre,Argentina,102,243,,345,-75.42726,6.170465
9781,2012,Noviembre,Argentina,0,1,,1,-67.48402800000001,6.185536
9782,2012,Noviembre,Argentina,2,2,,4,-73.181317,7.1280470000000005
9783,2012,Noviembre,Argentina,21,37,,58,-72.453013,7.819
9784,2012,Noviembre,Argentina,0,2,,2,-72.508188,7.927233
9785,2012,Noviembre,Argentina,7,6,,13,-77.35002,8.63337
9786,2012,Noviembre,República de Armenia,1,0,,1,-75.527794,10.406342
9787,2012,Noviembre,República de Armenia,1,1,,2,-74.140516,4.697157
9788,2012,Noviembre,Aruba,1,1,,2,-75.76635300000001,4.45285
9789,2012,Noviembre,Aruba,3,1,,4,-74.140516,4.697157
9790,2012,Noviembre,Aruba,2,2,,4,-75.42726,6.170465
9791,2012,Noviembre,Australia,6,10,,16,-69.941498,4.191162
9792,2012,Noviembre,Australia,21,37,,58,-77.35600000000001,0.81488
9793,2012,Noviembre,Australia,15,37,,52,-75.527794,10.406342
9794,2012,Noviembre,Australia,24,35,,59,-75.516486,10.446304
9795,2012,Noviembre,Australia,3,4,,7,-74.77647900000001,10.886686
9796,2012,Noviembre,Australia,1,2,,3,-74.213989,11.247722999999999
9797,2012,Noviembre,Australia,1,2,,3,-72.129595,11.360028999999999
9798,2012,Noviembre,Australia,0,3,,3,-81.703935,12.574411099999999
9799,2012,Noviembre,Australia,2,1,,3,-81.372937,13.338761300000002
9800,2012,Noviembre,Australia,10,25,,35,-76.532004,3.451668
9801,2012,Noviembre,Australia,258,438,,696,-74.140516,4.697157
9802,2012,Noviembre,Australia,0,1,,1,-75.736374,4.815189
9803,2012,Noviembre,Australia,33,60,,93,-75.42726,6.170465
9804,2012,Noviembre,Australia,0,1,,1,-73.181317,7.1280470000000005
9805,2012,Noviembre,Australia,0,1,,1,-72.453013,7.819
9806,2012,Noviembre,Australia,3,8,,11,-77.35002,8.63337
9807,2012,Noviembre,Austria,2,2,,4,-77.35600000000001,0.81488
9808,2012,Noviembre,Austria,5,8,,13,-75.527794,10.406342
9809,2012,Noviembre,Austria,11,8,,19,-75.516486,10.446304
9810,2012,Noviembre,Austria,0,1,,1,-74.77647900000001,10.886686
9811,2012,Noviembre,Austria,0,1,,1,-74.213989,11.247722999999999
9812,2012,Noviembre,Austria,0,5,,5,-72.129595,11.360028999999999
9813,2012,Noviembre,Austria,3,12,,15,-76.532004,3.451668
9814,2012,Noviembre,Austria,102,236,,338,-74.140516,4.697157
9815,2012,Noviembre,Austria,5,6,,11,-75.42726,6.170465
9816,2012,Noviembre,Austria,3,0,,3,-77.401154,6.222551999999999
9817,2012,Noviembre,Austria,1,0,,1,-72.453013,7.819
9818,2012,Noviembre,Austria,0,1,,1,-77.35002,8.63337
9819,2012,Noviembre,Azerbaiyán,0,1,,1,-74.140516,4.697157
9820,2012,Noviembre,Bahamas,1,0,,1,-74.77647900000001,10.886686
9821,2012,Noviembre,Bahamas,5,11,,16,-74.140516,4.697157
9822,2012,Noviembre,Bahamas,0,3,,3,-75.42726,6.170465
9823,2012,Noviembre,Bangladesh,1,1,,2,-74.140516,4.697157
9824,2012,Noviembre,Barbados,0,1,,1,-74.77647900000001,10.886686
9825,2012,Noviembre,Barbados,3,5,,8,-74.140516,4.697157
9826,2012,Noviembre,Barbados,1,1,,2,-75.736374,4.815189
9827,2012,Noviembre,Barbados,0,1,,1,-75.42726,6.170465
9828,2012,Noviembre,Barbados,0,1,,1,-73.181317,7.1280470000000005
9829,2012,Noviembre,República de Belarús,3,1,,4,-74.140516,4.697157
9830,2012,Noviembre,Bélgica,1,0,,1,-69.941498,4.191162
9831,2012,Noviembre,Bélgica,7,11,,18,-77.35600000000001,0.81488
9832,2012,Noviembre,Bélgica,2,1,,3,-75.527794,10.406342
9833,2012,Noviembre,Bélgica,3,7,,10,-75.516486,10.446304
9834,2012,Noviembre,Bélgica,1,0,,1,-74.77647900000001,10.886686
9835,2012,Noviembre,Bélgica,2,6,,8,-74.213989,11.247722999999999
9836,2012,Noviembre,Bélgica,6,14,,20,-76.532004,3.451668
9837,2012,Noviembre,Bélgica,105,280,,385,-74.140516,4.697157
9838,2012,Noviembre,Bélgica,0,1,,1,-75.736374,4.815189
9839,2012,Noviembre,Bélgica,6,14,,20,-75.42726,6.170465
9840,2012,Noviembre,Bélgica,0,1,,1,-72.453013,7.819
9841,2012,Noviembre,Bélgica,1,1,,2,-77.35002,8.63337
9842,2012,Noviembre,Belice,1,0,,1,-75.516486,10.446304
9843,2012,Noviembre,Belice,0,1,,1,-81.70216500000001,12.5862
9844,2012,Noviembre,Belice,1,5,,6,-74.140516,4.697157
9845,2012,Noviembre,Belice,0,2,,2,-75.42726,6.170465
9846,2012,Noviembre,Benín,1,0,,1,-75.42726,6.170465
9847,2012,Noviembre,Bermudas/Territorio Británico de Ultramar,1,0,,1,-72.129595,11.360028999999999
9848,2012,Noviembre,Bermudas/Territorio Británico de Ultramar,0,1,,1,-74.140516,4.697157
9849,2012,Noviembre,Bermudas/Territorio Británico de Ultramar,0,1,,1,-75.736374,4.815189
9850,2012,Noviembre,Bolivia,0,1,,1,-69.941498,4.191162
9851,2012,Noviembre,Bolivia,0,1,,1,-76.876446,0.33002
9852,2012,Noviembre,Bolivia,5,11,,16,-77.35600000000001,0.81488
9853,2012,Noviembre,Bolivia,6,11,,17,-75.516486,10.446304
9854,2012,Noviembre,Bolivia,7,3,,10,-74.77647900000001,10.886686
9855,2012,Noviembre,Bolivia,0,4,,4,-72.129595,11.360028999999999
9856,2012,Noviembre,Bolivia,3,2,,5,-81.70216500000001,12.5862
9857,2012,Noviembre,Bolivia,12,16,,28,-76.532004,3.451668
9858,2012,Noviembre,Bolivia,377,553,,930,-74.140516,4.697157
9859,2012,Noviembre,Bolivia,0,2,,2,-75.736374,4.815189
9860,2012,Noviembre,Bolivia,13,33,,46,-75.42726,6.170465
9861,2012,Noviembre,Bolivia,1,0,,1,-73.181317,7.1280470000000005
9862,2012,Noviembre,Bolivia,1,2,,3,-72.453013,7.819
9863,2012,Noviembre,Bosnia y Herzegovina,0,1,,1,-77.35600000000001,0.81488
9864,2012,Noviembre,Bosnia y Herzegovina,0,1,,1,-74.140516,4.697157
9865,2012,Noviembre,Botsuana,2,0,,2,-74.140516,4.697157
9866,2012,Noviembre,Brasil,101,144,,245,-69.941498,4.191162
9867,2012,Noviembre,Brasil,5,15,,20,-77.35600000000001,0.81488
9868,2012,Noviembre,Brasil,1,10,,11,-75.527794,10.406342
9869,2012,Noviembre,Brasil,126,124,,250,-75.516486,10.446304
9870,2012,Noviembre,Brasil,8,12,,20,-74.77647900000001,10.886686
9871,2012,Noviembre,Brasil,6,9,,15,-72.129595,11.360028999999999
9872,2012,Noviembre,Brasil,1,1,,2,-72.919186,11.52863
9873,2012,Noviembre,Brasil,18,19,,37,-81.70216500000001,12.5862
9874,2012,Noviembre,Brasil,15,58,,73,-76.532004,3.451668
9875,2012,Noviembre,Brasil,2035,3449,,5484,-74.140516,4.697157
9876,2012,Noviembre,Brasil,2,31,,33,-75.736374,4.815189
9877,2012,Noviembre,Brasil,58,122,,180,-75.42726,6.170465
9878,2012,Noviembre,Brasil,0,1,,1,-67.48402800000001,6.185536
9879,2012,Noviembre,Brasil,0,1,,1,-73.181317,7.1280470000000005
9880,2012,Noviembre,Brasil,6,21,,27,-72.453013,7.819
9881,2012,Noviembre,Brasil,1,2,,3,-72.508188,7.927233
9882,2012,Noviembre,Brasil,1,1,,2,-77.35002,8.63337
9883,2012,Noviembre,Bulgaria,7,14,,21,-74.140516,4.697157
9884,2012,Noviembre,Bulgaria,0,2,,2,-75.42726,6.170465
9885,2012,Noviembre,Burundi,0,2,,2,-74.140516,4.697157
9886,2012,Noviembre,Islas Caimán/Territorio Británico de Ultramar,1,1,,2,-81.70216500000001,12.5862
9887,2012,Noviembre,Camboya,1,3,,4,-74.140516,4.697157
9888,2012,Noviembre,Camerún,0,1,,1,-76.532004,3.451668
9889,2012,Noviembre,Camerún,0,3,,3,-74.140516,4.697157
9890,2012,Noviembre,Camerún,0,1,,1,-75.736374,4.815189
9891,2012,Noviembre,Camerún,1,0,,1,-75.42726,6.170465
9892,2012,Noviembre,Canadá,0,5,,5,-69.941498,4.191162
9893,2012,Noviembre,Canadá,15,22,,37,-77.35600000000001,0.81488
9894,2012,Noviembre,Canadá,9,18,,27,-75.527794,10.406342
9895,2012,Noviembre,Canadá,189,225,,414,-75.516486,10.446304
9896,2012,Noviembre,Canadá,15,25,,40,-74.77647900000001,10.886686
9897,2012,Noviembre,Canadá,1,2,,3,-74.213989,11.247722999999999
9898,2012,Noviembre,Canadá,0,5,,5,-72.129595,11.360028999999999
9899,2012,Noviembre,Canadá,1,3,,4,-81.703935,12.574411099999999
9900,2012,Noviembre,Canadá,6,6,,12,-81.70216500000001,12.5862
9901,2012,Noviembre,Canadá,2,2,,4,-81.372937,13.338761300000002
9902,2012,Noviembre,Canadá,38,57,,95,-76.532004,3.451668
9903,2012,Noviembre,Canadá,5,9,,14,-75.76635300000001,4.45285
9904,2012,Noviembre,Canadá,663,1461,,2124,-74.140516,4.697157
9905,2012,Noviembre,Canadá,4,5,,9,-75.736374,4.815189
9906,2012,Noviembre,Canadá,76,192,,268,-75.42726,6.170465
9907,2012,Noviembre,Canadá,0,5,,5,-73.181317,7.1280470000000005
9908,2012,Noviembre,Canadá,2,2,,4,-72.453013,7.819
9909,2012,Noviembre,Canadá,0,2,,2,-72.508188,7.927233
9910,2012,Noviembre,Canadá,2,2,,4,-77.35002,8.63337
9911,2012,Noviembre,España,0,1,,1,-76.876446,0.33002
9912,2012,Noviembre,España,6,11,,17,-77.35600000000001,0.81488
9913,2012,Noviembre,España,1,1,,2,-78.802679,18.00143
9914,2012,Noviembre,España,5,12,,17,-75.516486,10.446304
9915,2012,Noviembre,España,3,8,,11,-74.77647900000001,10.886686
9916,2012,Noviembre,España,1,0,,1,-74.213989,11.247722999999999
9917,2012,Noviembre,España,70,148,,218,-76.532004,3.451668
9918,2012,Noviembre,España,0,2,,2,-75.76635300000001,4.45285
9919,2012,Noviembre,España,196,631,,827,-74.140516,4.697157
9920,2012,Noviembre,España,0,8,,8,-75.736374,4.815189
9921,2012,Noviembre,España,43,116,,159,-75.42726,6.170465
9922,2012,Noviembre,España,2,1,,3,-73.181317,7.1280470000000005
9923,2012,Noviembre,España,1,4,,5,-72.453013,7.819
9924,2012,Noviembre,España,1,0,,1,-72.508188,7.927233
9925,2012,Noviembre,República Democrática del Congo,6,1,,7,-74.140516,4.697157
9926,2012,Noviembre,República de Corea,1,2,,3,-69.941498,4.191162
9927,2012,Noviembre,República de Corea,2,3,,5,-77.35600000000001,0.81488
9928,2012,Noviembre,República de Corea,1,1,,2,-75.527794,10.406342
9929,2012,Noviembre,República de Corea,1,0,,1,-72.129595,11.360028999999999
9930,2012,Noviembre,República de Corea,1,13,,14,-76.532004,3.451668
9931,2012,Noviembre,República de Corea,1,0,,1,-75.76635300000001,4.45285
9932,2012,Noviembre,República de Corea,144,522,,666,-74.140516,4.697157
9933,2012,Noviembre,República de Corea,7,16,,23,-75.42726,6.170465
9934,2012,Noviembre,República de Corea,2,4,,6,-72.453013,7.819
9935,2012,Noviembre,República de Corea,1,1,,2,-77.35002,8.63337
9936,2012,Noviembre,Costa de Marfil,1,1,,2,-74.140516,4.697157
9937,2012,Noviembre,Costa Rica,1,0,,1,-69.941498,4.191162
9938,2012,Noviembre,Costa Rica,3,1,,4,-77.35600000000001,0.81488
9939,2012,Noviembre,Costa Rica,1,13,,14,-75.527794,10.406342
9940,2012,Noviembre,Costa Rica,42,42,,84,-75.516486,10.446304
9941,2012,Noviembre,Costa Rica,7,23,,30,-74.77647900000001,10.886686
9942,2012,Noviembre,Costa Rica,1,0,,1,-72.129595,11.360028999999999
9943,2012,Noviembre,Costa Rica,296,201,,497,-81.70216500000001,12.5862
9944,2012,Noviembre,Costa Rica,26,56,,82,-76.532004,3.451668
9945,2012,Noviembre,Costa Rica,400,702,,1102,-74.140516,4.697157
9946,2012,Noviembre,Costa Rica,1,8,,9,-75.736374,4.815189
9947,2012,Noviembre,Costa Rica,68,141,,209,-75.42726,6.170465
9948,2012,Noviembre,Costa Rica,1,0,,1,-67.48402800000001,6.185536
9949,2012,Noviembre,Costa Rica,0,1,,1,-72.453013,7.819
9950,2012,Noviembre,Costa Rica,1,1,,2,-72.508188,7.927233
9951,2012,Noviembre,Croacia,0,1,,1,-77.35600000000001,0.81488
9952,2012,Noviembre,Croacia,0,2,,2,-75.527794,10.406342
9953,2012,Noviembre,Croacia,0,5,,5,-75.516486,10.446304
9954,2012,Noviembre,Croacia,0,1,,1,-74.765343,10.970933
9955,2012,Noviembre,Croacia,0,1,,1,-76.532004,3.451668
9956,2012,Noviembre,Croacia,0,2,,2,-77.061029,3.8844260000000004
9957,2012,Noviembre,Croacia,2,23,,25,-74.140516,4.697157
9958,2012,Noviembre,Cuba,0,3,,3,-77.35600000000001,0.81488
9959,2012,Noviembre,Cuba,0,1,,1,-75.527794,10.406342
9960,2012,Noviembre,Cuba,8,7,,15,-75.516486,10.446304
9961,2012,Noviembre,Cuba,2,6,,8,-74.77647900000001,10.886686
9962,2012,Noviembre,Cuba,0,2,,2,-72.129595,11.360028999999999
9963,2012,Noviembre,Cuba,4,3,,7,-81.70216500000001,12.5862
9964,2012,Noviembre,Cuba,9,23,,32,-76.532004,3.451668
9965,2012,Noviembre,Cuba,89,135,,224,-74.140516,4.697157
9966,2012,Noviembre,Cuba,0,1,,1,-75.736374,4.815189
9967,2012,Noviembre,Cuba,12,20,,32,-75.42726,6.170465
9968,2012,Noviembre,Cuba,0,1,,1,-70.74025300000001,7.088728999999999
9969,2012,Noviembre,Cuba,1,4,,5,-73.181317,7.1280470000000005
9970,2012,Noviembre,Cuba,1,1,,2,-72.508188,7.927233
9971,2012,Noviembre,Curazao,0,1,,1,-76.532004,3.451668
9972,2012,Noviembre,Curazao,1,1,,2,-74.140516,4.697157
9973,2012,Noviembre,Curazao,12,9,,21,-75.42726,6.170465
9974,2012,Noviembre,República Checa,2,1,,3,-77.35600000000001,0.81488
9975,2012,Noviembre,República Checa,0,1,,1,-72.129595,11.360028999999999
9976,2012,Noviembre,República Checa,1,1,,2,-76.532004,3.451668
9977,2012,Noviembre,República Checa,24,30,,54,-74.140516,4.697157
9978,2012,Noviembre,República Checa,0,1,,1,-75.42726,6.170465
9979,2012,Noviembre,República Checa,2,2,,4,-77.35002,8.63337
9980,2012,Noviembre,Chile,0,2,,2,-69.941498,4.191162
9981,2012,Noviembre,Chile,0,1,,1,-76.876446,0.33002
9982,2012,Noviembre,Chile,31,46,,77,-77.35600000000001,0.81488
9983,2012,Noviembre,Chile,0,4,,4,-75.527794,10.406342
9984,2012,Noviembre,Chile,95,84,,179,-75.516486,10.446304
9985,2012,Noviembre,Chile,4,10,,14,-74.77647900000001,10.886686
9986,2012,Noviembre,Chile,1,4,,5,-72.129595,11.360028999999999
9987,2012,Noviembre,Chile,71,29,,100,-81.70216500000001,12.5862
9988,2012,Noviembre,Chile,1,0,,1,-81.372937,13.338761300000002
9989,2012,Noviembre,Chile,20,61,,81,-76.532004,3.451668
9990,2012,Noviembre,Chile,2043,3240,,5283,-74.140516,4.697157
9991,2012,Noviembre,Chile,4,2,,6,-75.736374,4.815189
9992,2012,Noviembre,Chile,56,114,,170,-75.42726,6.170465
9993,2012,Noviembre,Chile,0,2,,2,-70.74025300000001,7.088728999999999
9994,2012,Noviembre,Chile,1,1,,2,-73.181317,7.1280470000000005
9995,2012,Noviembre,Chile,10,16,,26,-72.453013,7.819
9996,2012,Noviembre,Chile,3,3,,6,-77.35002,8.63337
9997,2012,Noviembre,China,1,2,,3,-77.35600000000001,0.81488
9998,2012,Noviembre,China,0,1,,1,-75.527794,10.406342
9999,2012,Noviembre,China,1,6,,7,-75.516486,10.446304
10000,2012,Noviembre,China,0,2,,2,-74.77647900000001,10.886686
10001,2012,Noviembre,China,2,0,,2,-72.129595,11.360028999999999
10002,2012,Noviembre,China,3,8,,11,-76.532004,3.451668
10003,2012,Noviembre,China,0,3,,3,-77.061029,3.8844260000000004
10004,2012,Noviembre,China,169,526,,695,-74.140516,4.697157
10005,2012,Noviembre,China,0,1,,1,-75.736374,4.815189
10006,2012,Noviembre,China,5,17,,22,-75.42726,6.170465
10007,2012,Noviembre,China,1,0,,1,-73.181317,7.1280470000000005
10008,2012,Noviembre,Taiwán,1,1,,2,-77.35600000000001,0.81488
10009,2012,Noviembre,Taiwán,1,5,,6,-75.516486,10.446304
10010,2012,Noviembre,Taiwán,1,3,,4,-74.77647900000001,10.886686
10011,2012,Noviembre,Taiwán,0,4,,4,-76.532004,3.451668
10012,2012,Noviembre,Taiwán,1,0,,1,-75.76635300000001,4.45285
10013,2012,Noviembre,Taiwán,26,47,,73,-74.140516,4.697157
10014,2012,Noviembre,Taiwán,0,1,,1,-75.736374,4.815189
10015,2012,Noviembre,Taiwán,4,11,,15,-75.42726,6.170465
10016,2012,Noviembre,Chipre,0,2,,2,-74.140516,4.697157
10017,2012,Noviembre,Chipre,0,1,,1,-75.42726,6.170465
10018,2012,Noviembre,Dinamarca,1,1,,2,-69.941498,4.191162
10019,2012,Noviembre,Dinamarca,5,3,,8,-77.35600000000001,0.81488
10020,2012,Noviembre,Dinamarca,2,3,,5,-75.527794,10.406342
10021,2012,Noviembre,Dinamarca,6,9,,15,-75.516486,10.446304
10022,2012,Noviembre,Dinamarca,0,1,,1,-74.77647900000001,10.886686
10023,2012,Noviembre,Dinamarca,0,2,,2,-72.129595,11.360028999999999
10024,2012,Noviembre,Dinamarca,2,6,,8,-76.532004,3.451668
10025,2012,Noviembre,Dinamarca,70,116,,186,-74.140516,4.697157
10026,2012,Noviembre,Dinamarca,7,14,,21,-75.42726,6.170465
10027,2012,Noviembre,Dinamarca,1,1,,2,-77.35002,8.63337
10028,2012,Noviembre,Dominica,0,1,,1,-72.129595,11.360028999999999
10029,2012,Noviembre,Dominica,3,4,,7,-74.140516,4.697157
10030,2012,Noviembre,Dominica,0,1,,1,-75.42726,6.170465
10031,2012,Noviembre,Ecuador,0,2,,2,-69.941498,4.191162
10032,2012,Noviembre,Ecuador,10,65,,75,-76.876446,0.33002
10033,2012,Noviembre,Ecuador,1068,1508,,2576,-77.35600000000001,0.81488
10034,2012,Noviembre,Ecuador,1,139,,140,-78.802679,18.00143
10035,2012,Noviembre,Ecuador,0,9,,9,-75.527794,10.406342
10036,2012,Noviembre,Ecuador,15,27,,42,-75.516486,10.446304
10037,2012,Noviembre,Ecuador,4,6,,10,-74.77647900000001,10.886686
10038,2012,Noviembre,Ecuador,13,20,,33,-72.129595,11.360028999999999
10039,2012,Noviembre,Ecuador,0,2,,2,-81.703935,12.574411099999999
10040,2012,Noviembre,Ecuador,3,2,,5,-81.70216500000001,12.5862
10041,2012,Noviembre,Ecuador,282,343,,625,-76.532004,3.451668
10042,2012,Noviembre,Ecuador,0,2,,2,-77.061029,3.8844260000000004
10043,2012,Noviembre,Ecuador,0,2,,2,-75.76635300000001,4.45285
10044,2012,Noviembre,Ecuador,1935,2863,,4798,-74.140516,4.697157
10045,2012,Noviembre,Ecuador,1,3,,4,-75.736374,4.815189
10046,2012,Noviembre,Ecuador,519,550,,1069,-75.42726,6.170465
10047,2012,Noviembre,Ecuador,1,0,,1,-67.48402800000001,6.185536
10048,2012,Noviembre,Ecuador,4,1,,5,-73.181317,7.1280470000000005
10049,2012,Noviembre,Ecuador,94,135,,229,-72.453013,7.819
10050,2012,Noviembre,Ecuador,0,1,,1,-72.508188,7.927233
10051,2012,Noviembre,Egipto,2,11,,13,-74.140516,4.697157
10052,2012,Noviembre,Egipto,0,2,,2,-75.42726,6.170465
10053,2012,Noviembre,El Salvador,2,0,,2,-77.35600000000001,0.81488
10054,2012,Noviembre,El Salvador,10,17,,27,-75.516486,10.446304
10055,2012,Noviembre,El Salvador,0,1,,1,-72.129595,11.360028999999999
10056,2012,Noviembre,El Salvador,21,6,,27,-81.70216500000001,12.5862
10057,2012,Noviembre,El Salvador,37,66,,103,-76.532004,3.451668
10058,2012,Noviembre,El Salvador,427,676,,1103,-74.140516,4.697157
10059,2012,Noviembre,El Salvador,1,3,,4,-75.736374,4.815189
10060,2012,Noviembre,El Salvador,12,40,,52,-75.42726,6.170465
10061,2012,Noviembre,El Salvador,0,1,,1,-72.453013,7.819
10062,2012,Noviembre,Emiratos Árabes,0,1,,1,-76.532004,3.451668
10063,2012,Noviembre,Emiratos Árabes,1,2,,3,-74.140516,4.697157
10064,2012,Noviembre,España,3,9,,12,-69.941498,4.191162
10065,2012,Noviembre,España,0,3,,3,-76.876446,0.33002
10066,2012,Noviembre,España,23,30,,53,-77.35600000000001,0.81488
10067,2012,Noviembre,España,2,7,,9,-75.527794,10.406342
10068,2012,Noviembre,España,44,118,,162,-75.516486,10.446304
10069,2012,Noviembre,España,3,10,,13,-74.77647900000001,10.886686
10070,2012,Noviembre,España,8,11,,19,-72.129595,11.360028999999999
10071,2012,Noviembre,España,3,8,,11,-81.70216500000001,12.5862
10072,2012,Noviembre,España,190,300,,490,-76.532004,3.451668
10073,2012,Noviembre,España,1684,4793,,6477,-74.140516,4.697157
10074,2012,Noviembre,España,1,15,,16,-75.736374,4.815189
10075,2012,Noviembre,España,70,234,,304,-75.42726,6.170465
10076,2012,Noviembre,España,20,50,,70,-72.453013,7.819
10077,2012,Noviembre,España,2,10,,12,-72.508188,7.927233
10078,2012,Noviembre,España,2,11,,13,-77.35002,8.63337
10079,2012,Noviembre,Eslovaquia,1,0,,1,-69.941498,4.191162
10080,2012,Noviembre,Eslovaquia,0,1,,1,-75.527794,10.406342
10081,2012,Noviembre,Eslovaquia,0,1,,1,-75.516486,10.446304
10082,2012,Noviembre,Eslovaquia,1,0,,1,-74.77647900000001,10.886686
10083,2012,Noviembre,Eslovaquia,0,2,,2,-76.532004,3.451668
10084,2012,Noviembre,Eslovaquia,16,15,,31,-74.140516,4.697157
10085,2012,Noviembre,Eslovaquia,2,1,,3,-75.42726,6.170465
10086,2012,Noviembre,Eslovaquia,1,0,,1,-77.35002,8.63337
10087,2012,Noviembre,Eslovenia,1,2,,3,-77.35600000000001,0.81488
10088,2012,Noviembre,Eslovenia,0,2,,2,-75.527794,10.406342
10089,2012,Noviembre,Eslovenia,2,1,,3,-75.516486,10.446304
10090,2012,Noviembre,Eslovenia,14,26,,40,-74.140516,4.697157
10091,2012,Noviembre,Eslovenia,1,1,,2,-75.42726,6.170465
10092,2012,Noviembre,Eslovenia,0,1,,1,-72.453013,7.819
10093,2012,Noviembre,Estados Unidos de América,9,12,,21,-69.941498,4.191162
10094,2012,Noviembre,Estados Unidos de América,23,65,,88,-77.35600000000001,0.81488
10095,2012,Noviembre,Estados Unidos de América,1,0,,1,-78.802679,18.00143
10096,2012,Noviembre,Estados Unidos de América,44,75,,119,-75.527794,10.406342
10097,2012,Noviembre,Estados Unidos de América,992,1846,,2838,-75.516486,10.446304
10098,2012,Noviembre,Estados Unidos de América,244,404,,648,-74.77647900000001,10.886686
10099,2012,Noviembre,Estados Unidos de América,0,3,,3,-74.232675,11.117206
10100,2012,Noviembre,Estados Unidos de América,8,14,,22,-74.213989,11.247722999999999
10101,2012,Noviembre,Estados Unidos de América,3,11,,14,-72.129595,11.360028999999999
10102,2012,Noviembre,Estados Unidos de América,0,1,,1,-72.919186,11.52863
10103,2012,Noviembre,Estados Unidos de América,2,13,,15,-81.703935,12.574411099999999
10104,2012,Noviembre,Estados Unidos de América,10,19,,29,-81.70216500000001,12.5862
10105,2012,Noviembre,Estados Unidos de América,6,12,,18,-81.372937,13.338761300000002
10106,2012,Noviembre,Estados Unidos de América,579,1048,,1627,-76.532004,3.451668
10107,2012,Noviembre,Estados Unidos de América,81,139,,220,-75.76635300000001,4.45285
10108,2012,Noviembre,Estados Unidos de América,4803,10722,,15525,-74.140516,4.697157
10109,2012,Noviembre,Estados Unidos de América,45,76,,121,-75.736374,4.815189
10110,2012,Noviembre,Estados Unidos de América,923,2378,,3301,-75.42726,6.170465
10111,2012,Noviembre,Estados Unidos de América,10,27,,37,-73.181317,7.1280470000000005
10112,2012,Noviembre,Estados Unidos de América,15,36,,51,-72.453013,7.819
10113,2012,Noviembre,Estados Unidos de América,12,7,,19,-72.508188,7.927233
10114,2012,Noviembre,Estados Unidos de América,8,15,,23,-77.35002,8.63337
10115,2012,Noviembre,Estonia,0,2,,2,-77.35600000000001,0.81488
10116,2012,Noviembre,Estonia,0,1,,1,-76.532004,3.451668
10117,2012,Noviembre,Estonia,1,1,,2,-75.76635300000001,4.45285
10118,2012,Noviembre,Estonia,3,11,,14,-74.140516,4.697157
10119,2012,Noviembre,Estonia,1,2,,3,-75.42726,6.170465
10120,2012,Noviembre,Etiopia,2,3,,5,-74.140516,4.697157
10121,2012,Noviembre,Islas Fiji,0,1,,1,-74.140516,4.697157
10122,2012,Noviembre,Filipinas,0,30,,30,-75.527794,10.406342
10123,2012,Noviembre,Filipinas,3,6,,9,-75.516486,10.446304
10124,2012,Noviembre,Filipinas,0,6,,6,-74.77647900000001,10.886686
10125,2012,Noviembre,Filipinas,0,25,,25,-74.765343,10.970933
10126,2012,Noviembre,Filipinas,0,4,,4,-74.213989,11.247722999999999
10127,2012,Noviembre,Filipinas,0,10,,10,-76.532004,3.451668
10128,2012,Noviembre,Filipinas,0,9,,9,-77.061029,3.8844260000000004
10129,2012,Noviembre,Filipinas,12,80,,92,-74.140516,4.697157
10130,2012,Noviembre,Filipinas,1,3,,4,-75.42726,6.170465
10131,2012,Noviembre,Filipinas,0,3,,3,-75.68164200000001,9.402597
10132,2012,Noviembre,Finlandia,2,2,,4,-69.941498,4.191162
10133,2012,Noviembre,Finlandia,4,0,,4,-77.35600000000001,0.81488
10134,2012,Noviembre,Finlandia,2,2,,4,-75.527794,10.406342
10135,2012,Noviembre,Finlandia,1,3,,4,-75.516486,10.446304
10136,2012,Noviembre,Finlandia,0,2,,2,-74.77647900000001,10.886686
10137,2012,Noviembre,Finlandia,2,0,,2,-81.70216500000001,12.5862
10138,2012,Noviembre,Finlandia,0,5,,5,-76.532004,3.451668
10139,2012,Noviembre,Finlandia,25,73,,98,-74.140516,4.697157
10140,2012,Noviembre,Finlandia,1,5,,6,-75.42726,6.170465
10141,2012,Noviembre,Francia,1,4,,5,-69.941498,4.191162
10142,2012,Noviembre,Francia,0,1,,1,-76.876446,0.33002
10143,2012,Noviembre,Francia,19,35,,54,-77.35600000000001,0.81488
10144,2012,Noviembre,Francia,18,26,,44,-75.527794,10.406342
10145,2012,Noviembre,Francia,21,74,,95,-75.516486,10.446304
10146,2012,Noviembre,Francia,2,5,,7,-74.77647900000001,10.886686
10147,2012,Noviembre,Francia,9,9,,18,-74.213989,11.247722999999999
10148,2012,Noviembre,Francia,10,15,,25,-72.129595,11.360028999999999
10149,2012,Noviembre,Francia,1,0,,1,-81.70216500000001,12.5862
10150,2012,Noviembre,Francia,28,48,,76,-76.532004,3.451668
10151,2012,Noviembre,Francia,894,1770,,2664,-74.140516,4.697157
10152,2012,Noviembre,Francia,0,4,,4,-75.736374,4.815189
10153,2012,Noviembre,Francia,28,89,,117,-75.42726,6.170465
10154,2012,Noviembre,Francia,0,2,,2,-70.74025300000001,7.088728999999999
10155,2012,Noviembre,Francia,6,20,,26,-72.453013,7.819
10156,2012,Noviembre,Francia,0,1,,1,-72.508188,7.927233
10157,2012,Noviembre,Francia,6,9,,15,-77.35002,8.63337
10158,2012,Noviembre,Gabón,0,2,,2,-74.140516,4.697157
10159,2012,Noviembre,Georgia,0,3,,3,-74.140516,4.697157
10160,2012,Noviembre,Georgia,2,2,,4,-75.42726,6.170465
10161,2012,Noviembre,Ghana,0,1,,1,-77.35600000000001,0.81488
10162,2012,Noviembre,Ghana,0,1,,1,-74.213989,11.247722999999999
10163,2012,Noviembre,Ghana,0,6,,6,-74.140516,4.697157
10164,2012,Noviembre,Ghana,0,2,,2,-75.42726,6.170465
10165,2012,Noviembre,Ghana,0,1,,1,-72.453013,7.819
10166,2012,Noviembre,Granada,1,0,,1,-75.516486,10.446304
10167,2012,Noviembre,Granada,0,2,,2,-74.77647900000001,10.886686
10168,2012,Noviembre,Granada,0,1,,1,-74.140516,4.697157
10169,2012,Noviembre,Grecia,2,2,,4,-77.35600000000001,0.81488
10170,2012,Noviembre,Grecia,0,6,,6,-75.527794,10.406342
10171,2012,Noviembre,Grecia,1,7,,8,-75.516486,10.446304
10172,2012,Noviembre,Grecia,0,1,,1,-74.77647900000001,10.886686
10173,2012,Noviembre,Grecia,0,1,,1,-74.213989,11.247722999999999
10174,2012,Noviembre,Grecia,0,3,,3,-76.532004,3.451668
10175,2012,Noviembre,Grecia,28,52,,80,-74.140516,4.697157
10176,2012,Noviembre,Grecia,0,3,,3,-75.42726,6.170465
10177,2012,Noviembre,Grecia,0,1,,1,-72.453013,7.819
10178,2012,Noviembre,Grecia,0,2,,2,-76.7333,8.06667
10179,2012,Noviembre,Guatemala,2,3,,5,-77.35600000000001,0.81488
10180,2012,Noviembre,Guatemala,0,2,,2,-75.527794,10.406342
10181,2012,Noviembre,Guatemala,42,66,,108,-75.516486,10.446304
10182,2012,Noviembre,Guatemala,2,17,,19,-74.77647900000001,10.886686
10183,2012,Noviembre,Guatemala,0,2,,2,-72.129595,11.360028999999999
10184,2012,Noviembre,Guatemala,9,5,,14,-81.70216500000001,12.5862
10185,2012,Noviembre,Guatemala,15,51,,66,-76.532004,3.451668
10186,2012,Noviembre,Guatemala,183,435,,618,-74.140516,4.697157
10187,2012,Noviembre,Guatemala,0,18,,18,-75.736374,4.815189
10188,2012,Noviembre,Guatemala,47,94,,141,-75.42726,6.170465
10189,2012,Noviembre,Guatemala,0,1,,1,-77.401154,6.222551999999999
10190,2012,Noviembre,Guatemala,3,1,,4,-73.181317,7.1280470000000005
10191,2012,Noviembre,Guatemala,24,25,,49,-72.453013,7.819
10192,2012,Noviembre,Guatemala,2,0,,2,-72.508188,7.927233
10193,2012,Noviembre,Guyana,1,0,,1,-77.35600000000001,0.81488
10194,2012,Noviembre,Guyana,0,1,,1,-75.527794,10.406342
10195,2012,Noviembre,Guyana,1,0,,1,-75.516486,10.446304
10196,2012,Noviembre,Guyana,0,6,,6,-74.213989,11.247722999999999
10197,2012,Noviembre,Guyana,2,9,,11,-74.140516,4.697157
10198,2012,Noviembre,Guyana,0,1,,1,-75.42726,6.170465
10199,2012,Noviembre,Guinea Ecuatorial,0,1,,1,-74.140516,4.697157
10200,2012,Noviembre,Guayana Francesa/Departamento de Ultramar Francés,0,1,,1,-74.140516,4.697157
10201,2012,Noviembre,Haití,1,3,,4,-75.516486,10.446304
10202,2012,Noviembre,Haití,0,6,,6,-74.77647900000001,10.886686
10203,2012,Noviembre,Haití,1,0,,1,-76.532004,3.451668
10204,2012,Noviembre,Haití,9,13,,22,-74.140516,4.697157
10205,2012,Noviembre,Haití,2,8,,10,-73.181317,7.1280470000000005
10206,2012,Noviembre,Haití,0,1,,1,-72.453013,7.819
10207,2012,Noviembre,Honduras,1,3,,4,-75.527794,10.406342
10208,2012,Noviembre,Honduras,23,19,,42,-75.516486,10.446304
10209,2012,Noviembre,Honduras,6,11,,17,-74.77647900000001,10.886686
10210,2012,Noviembre,Honduras,0,4,,4,-74.765343,10.970933
10211,2012,Noviembre,Honduras,0,1,,1,-81.70216500000001,12.5862
10212,2012,Noviembre,Honduras,11,20,,31,-76.532004,3.451668
10213,2012,Noviembre,Honduras,0,1,,1,-75.76635300000001,4.45285
10214,2012,Noviembre,Honduras,135,164,,299,-74.140516,4.697157
10215,2012,Noviembre,Honduras,0,7,,7,-75.736374,4.815189
10216,2012,Noviembre,Honduras,26,45,,71,-75.42726,6.170465
10217,2012,Noviembre,Honduras,2,1,,3,-72.453013,7.819
10218,2012,Noviembre,Honduras,0,2,,2,-76.7333,8.06667
10219,2012,Noviembre,Hungría,1,1,,2,-75.527794,10.406342
10220,2012,Noviembre,Hungría,1,0,,1,-75.516486,10.446304
10221,2012,Noviembre,Hungría,0,1,,1,-81.70216500000001,12.5862
10222,2012,Noviembre,Hungría,0,1,,1,-76.532004,3.451668
10223,2012,Noviembre,Hungría,18,24,,42,-74.140516,4.697157
10224,2012,Noviembre,Hungría,0,5,,5,-75.42726,6.170465
10225,2012,Noviembre,India,0,1,,1,-75.527794,10.406342
10226,2012,Noviembre,India,1,3,,4,-75.516486,10.446304
10227,2012,Noviembre,India,0,2,,2,-74.77647900000001,10.886686
10228,2012,Noviembre,India,2,10,,12,-76.532004,3.451668
10229,2012,Noviembre,India,0,1,,1,-77.061029,3.8844260000000004
10230,2012,Noviembre,India,28,243,,271,-74.140516,4.697157
10231,2012,Noviembre,India,3,24,,27,-75.42726,6.170465
10232,2012,Noviembre,Indonesia,0,18,,18,-75.527794,10.406342
10233,2012,Noviembre,Indonesia,0,17,,17,-75.516486,10.446304
10234,2012,Noviembre,Indonesia,4,32,,36,-74.140516,4.697157
10235,2012,Noviembre,Indonesia,0,3,,3,-75.42726,6.170465
10236,2012,Noviembre,Iraq,0,1,,1,-74.140516,4.697157
10237,2012,Noviembre,Irán,6,7,,13,-74.140516,4.697157
10238,2012,Noviembre,República de Irlanda,1,1,,2,-69.941498,4.191162
10239,2012,Noviembre,República de Irlanda,5,14,,19,-77.35600000000001,0.81488
10240,2012,Noviembre,República de Irlanda,2,2,,4,-75.527794,10.406342
10241,2012,Noviembre,República de Irlanda,8,15,,23,-75.516486,10.446304
10242,2012,Noviembre,República de Irlanda,0,4,,4,-72.129595,11.360028999999999
10243,2012,Noviembre,República de Irlanda,0,4,,4,-76.532004,3.451668
10244,2012,Noviembre,República de Irlanda,41,131,,172,-74.140516,4.697157
10245,2012,Noviembre,República de Irlanda,3,12,,15,-75.42726,6.170465
10246,2012,Noviembre,República de Irlanda,1,1,,2,-73.181317,7.1280470000000005
10247,2012,Noviembre,República de Irlanda,0,1,,1,-72.453013,7.819
10248,2012,Noviembre,República de Irlanda,0,1,,1,-77.35002,8.63337
10249,2012,Noviembre,Islandia,0,1,,1,-77.35600000000001,0.81488
10250,2012,Noviembre,Islandia,2,6,,8,-75.516486,10.446304
10251,2012,Noviembre,Islandia,5,4,,9,-74.140516,4.697157
10252,2012,Noviembre,Islandia,1,1,,2,-75.42726,6.170465
10253,2012,Noviembre,Islandia,0,1,,1,-72.453013,7.819
10254,2012,Noviembre,Isla de Man,6,18,,24,-77.35600000000001,0.81488
10255,2012,Noviembre,Isla de Man,2,18,,20,-75.516486,10.446304
10256,2012,Noviembre,Isla de Man,2,6,,8,-74.77647900000001,10.886686
10257,2012,Noviembre,Isla de Man,9,14,,23,-76.532004,3.451668
10258,2012,Noviembre,Isla de Man,0,1,,1,-75.76635300000001,4.45285
10259,2012,Noviembre,Isla de Man,46,122,,168,-74.140516,4.697157
10260,2012,Noviembre,Isla de Man,0,1,,1,-75.736374,4.815189
10261,2012,Noviembre,Isla de Man,10,37,,47,-75.42726,6.170465
10262,2012,Noviembre,Isla de Man,0,2,,2,-72.453013,7.819
10263,2012,Noviembre,Isla Johnston,0,1,,1,-77.35600000000001,0.81488
10264,2012,Noviembre,Isla Johnston,0,1,,1,-74.140516,4.697157
10265,2012,Noviembre,Israel,0,3,,3,-69.941498,4.191162
10266,2012,Noviembre,Israel,3,14,,17,-77.35600000000001,0.81488
10267,2012,Noviembre,Israel,0,1,,1,-75.527794,10.406342
10268,2012,Noviembre,Israel,4,25,,29,-75.516486,10.446304
10269,2012,Noviembre,Israel,0,2,,2,-74.77647900000001,10.886686
10270,2012,Noviembre,Israel,1,3,,4,-81.70216500000001,12.5862
10271,2012,Noviembre,Israel,1,13,,14,-76.532004,3.451668
10272,2012,Noviembre,Israel,34,289,,323,-74.140516,4.697157
10273,2012,Noviembre,Israel,0,1,,1,-75.736374,4.815189
10274,2012,Noviembre,Israel,3,29,,32,-75.42726,6.170465
10275,2012,Noviembre,Israel,1,1,,2,-77.35002,8.63337
10276,2012,Noviembre,Italia,2,5,,7,-69.941498,4.191162
10277,2012,Noviembre,Italia,3,11,,14,-77.35600000000001,0.81488
10278,2012,Noviembre,Italia,16,16,,32,-75.527794,10.406342
10279,2012,Noviembre,Italia,43,96,,139,-75.516486,10.446304
10280,2012,Noviembre,Italia,6,10,,16,-74.77647900000001,10.886686
10281,2012,Noviembre,Italia,2,19,,21,-72.129595,11.360028999999999
10282,2012,Noviembre,Italia,6,9,,15,-81.70216500000001,12.5862
10283,2012,Noviembre,Italia,24,74,,98,-76.532004,3.451668
10284,2012,Noviembre,Italia,426,1687,,2113,-74.140516,4.697157
10285,2012,Noviembre,Italia,1,5,,6,-75.736374,4.815189
10286,2012,Noviembre,Italia,23,101,,124,-75.42726,6.170465
10287,2012,Noviembre,Italia,0,3,,3,-73.181317,7.1280470000000005
10288,2012,Noviembre,Italia,2,23,,25,-72.453013,7.819
10289,2012,Noviembre,Italia,1,3,,4,-72.508188,7.927233
10290,2012,Noviembre,Italia,1,6,,7,-77.35002,8.63337
10291,2012,Noviembre,Islas del Canal,0,2,,2,-75.516486,10.446304
10292,2012,Noviembre,Islas del Canal,0,1,,1,-76.532004,3.451668
10293,2012,Noviembre,Islas del Canal,1,0,,1,-74.140516,4.697157
10294,2012,Noviembre,Islas del Canal,0,1,,1,-75.42726,6.170465
10295,2012,Noviembre,Jamaica,0,1,,1,-77.35600000000001,0.81488
10296,2012,Noviembre,Jamaica,2,3,,5,-75.516486,10.446304
10297,2012,Noviembre,Jamaica,1,0,,1,-81.70216500000001,12.5862
10298,2012,Noviembre,Jamaica,14,10,,24,-74.140516,4.697157
10299,2012,Noviembre,Jamaica,0,2,,2,-75.42726,6.170465
10300,2012,Noviembre,Jamaica,0,1,,1,-72.453013,7.819
10301,2012,Noviembre,Jamaica,0,1,,1,-72.508188,7.927233
10302,2012,Noviembre,Islas Midway/Territorio no incorporado de Estados Unidos,0,1,,1,-75.42726,6.170465
10303,2012,Noviembre,Japón,0,1,,1,-69.941498,4.191162
10304,2012,Noviembre,Japón,2,5,,7,-77.35600000000001,0.81488
10305,2012,Noviembre,Japón,1,9,,10,-75.527794,10.406342
10306,2012,Noviembre,Japón,3,13,,16,-75.516486,10.446304
10307,2012,Noviembre,Japón,0,12,,12,-74.77647900000001,10.886686
10308,2012,Noviembre,Japón,1,1,,2,-72.129595,11.360028999999999
10309,2012,Noviembre,Japón,2,1,,3,-81.70216500000001,12.5862
10310,2012,Noviembre,Japón,5,17,,22,-76.532004,3.451668
10311,2012,Noviembre,Japón,124,462,,586,-74.140516,4.697157
10312,2012,Noviembre,Japón,0,3,,3,-75.736374,4.815189
10313,2012,Noviembre,Japón,4,30,,34,-75.42726,6.170465
10314,2012,Noviembre,Japón,3,6,,9,-72.453013,7.819
10315,2012,Noviembre,Japón,0,1,,1,-72.508188,7.927233
10316,2012,Noviembre,Japón,1,1,,2,-77.35002,8.63337
10317,2012,Noviembre,Jordania,1,0,,1,-76.876446,0.33002
10318,2012,Noviembre,Jordania,0,6,,6,-74.140516,4.697157
10319,2012,Noviembre,Jordania,0,1,,1,-75.42726,6.170465
10320,2012,Noviembre,Kazajistán,0,1,,1,-75.516486,10.446304
10321,2012,Noviembre,Kazajistán,3,0,,3,-74.140516,4.697157
10322,2012,Noviembre,Kenia,1,0,,1,-76.532004,3.451668
10323,2012,Noviembre,Kenia,2,7,,9,-74.140516,4.697157
10324,2012,Noviembre,Kenia,2,1,,3,-75.42726,6.170465
10325,2012,Noviembre,Kirguistán,2,0,,2,-74.140516,4.697157
10326,2012,Noviembre,Kuwait,0,2,,2,-74.140516,4.697157
10327,2012,Noviembre,República de Kosovo,0,1,,1,-74.140516,4.697157
10328,2012,Noviembre,Letonia,1,0,,1,-77.35600000000001,0.81488
10329,2012,Noviembre,Letonia,0,1,,1,-75.527794,10.406342
10330,2012,Noviembre,Letonia,0,1,,1,-72.129595,11.360028999999999
10331,2012,Noviembre,Letonia,7,17,,24,-74.140516,4.697157
10332,2012,Noviembre,Letonia,0,4,,4,-75.42726,6.170465
10333,2012,Noviembre,Lituania,1,0,,1,-75.516486,10.446304
10334,2012,Noviembre,Lituania,1,0,,1,-76.532004,3.451668
10335,2012,Noviembre,Lituania,2,6,,8,-74.140516,4.697157
10336,2012,Noviembre,Líbano,1,0,,1,-75.516486,10.446304
10337,2012,Noviembre,Líbano,1,2,,3,-74.77647900000001,10.886686
10338,2012,Noviembre,Líbano,4,3,,7,-72.129595,11.360028999999999
10339,2012,Noviembre,Líbano,2,0,,2,-81.70216500000001,12.5862
10340,2012,Noviembre,Líbano,13,30,,43,-74.140516,4.697157
10341,2012,Noviembre,Liberia,3,1,,4,-74.140516,4.697157
10342,2012,Noviembre,Libia,0,1,,1,-74.140516,4.697157
10343,2012,Noviembre,Liechtenstein,1,2,,3,-74.140516,4.697157
10344,2012,Noviembre,Luxemburgo,3,9,,12,-74.140516,4.697157
10345,2012,Noviembre,Macedonia,5,1,,6,-74.140516,4.697157
10346,2012,Noviembre,Madagascar,5,0,,5,-74.140516,4.697157
10347,2012,Noviembre,Madagascar,1,0,,1,-75.42726,6.170465
10348,2012,Noviembre,Malasia,0,2,,2,-75.516486,10.446304
10349,2012,Noviembre,Malasia,0,2,,2,-76.532004,3.451668
10350,2012,Noviembre,Malasia,9,15,,24,-74.140516,4.697157
10351,2012,Noviembre,Malasia,4,1,,5,-75.42726,6.170465
10352,2012,Noviembre,Malawi,0,1,,1,-74.140516,4.697157
10353,2012,Noviembre,Malí,1,2,,3,-75.42726,6.170465
10354,2012,Noviembre,Malta,0,2,,2,-74.140516,4.697157
10355,2012,Noviembre,Marruecos,0,5,,5,-74.140516,4.697157
10356,2012,Noviembre,Mauricio,0,1,,1,-74.140516,4.697157
10357,2012,Noviembre,Mauritania,0,1,,1,-74.140516,4.697157
10358,2012,Noviembre,México,0,1,,1,-69.941498,4.191162
10359,2012,Noviembre,México,3,0,,3,-76.876446,0.33002
10360,2012,Noviembre,México,10,19,,29,-77.35600000000001,0.81488
10361,2012,Noviembre,México,6,4,,10,-75.527794,10.406342
10362,2012,Noviembre,México,95,184,,279,-75.516486,10.446304
10363,2012,Noviembre,México,13,30,,43,-74.77647900000001,10.886686
10364,2012,Noviembre,México,1,2,,3,-72.129595,11.360028999999999
10365,2012,Noviembre,México,6,6,,12,-81.70216500000001,12.5862
10366,2012,Noviembre,México,57,167,,224,-76.532004,3.451668
10367,2012,Noviembre,México,0,3,,3,-75.76635300000001,4.45285
10368,2012,Noviembre,México,1889,4291,,6180,-74.140516,4.697157
10369,2012,Noviembre,México,4,12,,16,-75.736374,4.815189
10370,2012,Noviembre,México,119,372,,491,-75.42726,6.170465
10371,2012,Noviembre,México,1,8,,9,-73.181317,7.1280470000000005
10372,2012,Noviembre,México,17,40,,57,-72.453013,7.819
10373,2012,Noviembre,México,0,8,,8,-72.508188,7.927233
10374,2012,Noviembre,México,2,8,,10,-77.35002,8.63337
10375,2012,Noviembre,República de Moldavia,0,1,,1,-74.140516,4.697157
10376,2012,Noviembre,Mónaco,0,2,,2,-74.140516,4.697157
10377,2012,Noviembre,Montenegro,0,1,,1,-75.68164200000001,9.402597
10378,2012,Noviembre,Montserrat/Territorio Británico de Ultramar,1,0,,1,-75.516486,10.446304
10379,2012,Noviembre,Montserrat/Territorio Británico de Ultramar,0,1,,1,-74.140516,4.697157
10380,2012,Noviembre,Mozambique,1,1,,2,-74.140516,4.697157
10381,2012,Noviembre,Namibia,2,1,,3,-74.140516,4.697157
10382,2012,Noviembre,Nepal,0,1,,1,-77.35600000000001,0.81488
10383,2012,Noviembre,Nepal,0,2,,2,-74.140516,4.697157
10384,2012,Noviembre,Nepal,1,0,,1,-75.42726,6.170465
10385,2012,Noviembre,Nicaragua,9,8,,17,-75.516486,10.446304
10386,2012,Noviembre,Nicaragua,0,3,,3,-74.77647900000001,10.886686
10387,2012,Noviembre,Nicaragua,0,1,,1,-81.703935,12.574411099999999
10388,2012,Noviembre,Nicaragua,3,3,,6,-81.70216500000001,12.5862
10389,2012,Noviembre,Nicaragua,1,4,,5,-76.532004,3.451668
10390,2012,Noviembre,Nicaragua,0,1,,1,-75.76635300000001,4.45285
10391,2012,Noviembre,Nicaragua,42,66,,108,-74.140516,4.697157
10392,2012,Noviembre,Nicaragua,1,7,,8,-75.736374,4.815189
10393,2012,Noviembre,Nicaragua,13,8,,21,-75.42726,6.170465
10394,2012,Noviembre,Nicaragua,1,0,,1,-73.181317,7.1280470000000005
10395,2012,Noviembre,Nigeria,0,2,,2,-75.516486,10.446304
10396,2012,Noviembre,Nigeria,2,2,,4,-74.140516,4.697157
10397,2012,Noviembre,Nigeria,1,1,,2,-75.42726,6.170465
10398,2012,Noviembre,Níger,0,1,,1,-76.532004,3.451668
10399,2012,Noviembre,Noruega,0,4,,4,-69.941498,4.191162
10400,2012,Noviembre,Noruega,1,1,,2,-77.35600000000001,0.81488
10401,2012,Noviembre,Noruega,3,3,,6,-75.527794,10.406342
10402,2012,Noviembre,Noruega,4,7,,11,-75.516486,10.446304
10403,2012,Noviembre,Noruega,1,6,,7,-74.77647900000001,10.886686
10404,2012,Noviembre,Noruega,0,2,,2,-74.213989,11.247722999999999
10405,2012,Noviembre,Noruega,5,4,,9,-76.532004,3.451668
10406,2012,Noviembre,Noruega,59,113,,172,-74.140516,4.697157
10407,2012,Noviembre,Noruega,6,5,,11,-75.42726,6.170465
10408,2012,Noviembre,Nueva Zelanda,7,17,,24,-77.35600000000001,0.81488
10409,2012,Noviembre,Nueva Zelanda,2,2,,4,-75.516486,10.446304
10410,2012,Noviembre,Nueva Zelanda,0,2,,2,-72.129595,11.360028999999999
10411,2012,Noviembre,Nueva Zelanda,1,2,,3,-76.532004,3.451668
10412,2012,Noviembre,Nueva Zelanda,0,2,,2,-75.76635300000001,4.45285
10413,2012,Noviembre,Nueva Zelanda,25,53,,78,-74.140516,4.697157
10414,2012,Noviembre,Nueva Zelanda,4,6,,10,-75.42726,6.170465
10415,2012,Noviembre,Nueva Zelanda,1,0,,1,-72.453013,7.819
10416,2012,Noviembre,Nueva Zelanda,4,1,,5,-77.35002,8.63337
10417,2012,Noviembre,Omán,0,1,,1,-74.140516,4.697157
10418,2012,Noviembre,Nueva Zelanda,0,1,,1,-69.941498,4.191162
10419,2012,Noviembre,Nueva Zelanda,2,7,,9,-75.527794,10.406342
10420,2012,Noviembre,Nueva Zelanda,1,1,,2,-74.213989,11.247722999999999
10421,2012,Noviembre,Nueva Zelanda,2,0,,2,-74.140516,4.697157
10422,2012,Noviembre,Países Bajos,0,1,,1,-69.941498,4.191162
10423,2012,Noviembre,Países Bajos,4,6,,10,-77.35600000000001,0.81488
10424,2012,Noviembre,Países Bajos,3,4,,7,-75.516486,10.446304
10425,2012,Noviembre,Países Bajos,1,5,,6,-74.77647900000001,10.886686
10426,2012,Noviembre,Países Bajos,1,1,,2,-72.129595,11.360028999999999
10427,2012,Noviembre,Países Bajos,19,18,,37,-72.919186,11.52863
10428,2012,Noviembre,Países Bajos,8,37,,45,-76.532004,3.451668
10429,2012,Noviembre,Países Bajos,12,34,,46,-75.76635300000001,4.45285
10430,2012,Noviembre,Países Bajos,163,289,,452,-74.140516,4.697157
10431,2012,Noviembre,Países Bajos,0,1,,1,-75.736374,4.815189
10432,2012,Noviembre,Países Bajos,120,177,,297,-75.42726,6.170465
10433,2012,Noviembre,Países Bajos,27,24,,51,-73.181317,7.1280470000000005
10434,2012,Noviembre,Países Bajos,0,1,,1,-72.453013,7.819
10435,2012,Noviembre,Países Bajos,0,3,,3,-72.508188,7.927233
10436,2012,Noviembre,Pakistán,0,2,,2,-77.35600000000001,0.81488
10437,2012,Noviembre,Pakistán,0,2,,2,-75.516486,10.446304
10438,2012,Noviembre,Pakistán,0,1,,1,-76.532004,3.451668
10439,2012,Noviembre,Pakistán,3,10,,13,-74.140516,4.697157
10440,2012,Noviembre,Pakistán,0,3,,3,-75.42726,6.170465
10441,2012,Noviembre,Panamá,0,1,,1,-69.941498,4.191162
10442,2012,Noviembre,Panamá,0,2,,2,-77.35600000000001,0.81488
10443,2012,Noviembre,Panamá,0,8,,8,-75.527794,10.406342
10444,2012,Noviembre,Panamá,178,214,,392,-75.516486,10.446304
10445,2012,Noviembre,Panamá,61,141,,202,-74.77647900000001,10.886686
10446,2012,Noviembre,Panamá,0,2,,2,-81.703935,12.574411099999999
10447,2012,Noviembre,Panamá,58,48,,106,-81.70216500000001,12.5862
10448,2012,Noviembre,Panamá,92,180,,272,-76.532004,3.451668
10449,2012,Noviembre,Panamá,444,687,,1131,-74.140516,4.697157
10450,2012,Noviembre,Panamá,51,69,,120,-75.736374,4.815189
10451,2012,Noviembre,Panamá,221,381,,602,-75.42726,6.170465
10452,2012,Noviembre,Panamá,1,2,,3,-77.401154,6.222551999999999
10453,2012,Noviembre,Panamá,0,1,,1,-70.74025300000001,7.088728999999999
10454,2012,Noviembre,Panamá,4,9,,13,-73.181317,7.1280470000000005
10455,2012,Noviembre,Panamá,2,5,,7,-72.453013,7.819
10456,2012,Noviembre,Panamá,4,11,,15,-72.508188,7.927233
10457,2012,Noviembre,Panamá,2,2,,4,-77.35002,8.63337
10458,2012,Noviembre,Papúa Nueva Guinea,0,1,,1,-74.140516,4.697157
10459,2012,Noviembre,Paraguay,2,0,,2,-77.35600000000001,0.81488
10460,2012,Noviembre,Paraguay,41,22,,63,-75.516486,10.446304
10461,2012,Noviembre,Paraguay,1,2,,3,-74.77647900000001,10.886686
10462,2012,Noviembre,Paraguay,3,1,,4,-81.70216500000001,12.5862
10463,2012,Noviembre,Paraguay,3,2,,5,-76.532004,3.451668
10464,2012,Noviembre,Paraguay,122,117,,239,-74.140516,4.697157
10465,2012,Noviembre,Paraguay,7,14,,21,-75.42726,6.170465
10466,2012,Noviembre,Paraguay,1,1,,2,-72.453013,7.819
10467,2012,Noviembre,Perú,25,38,,63,-69.941498,4.191162
10468,2012,Noviembre,Perú,8,14,,22,-76.876446,0.33002
10469,2012,Noviembre,Perú,114,313,,427,-77.35600000000001,0.81488
10470,2012,Noviembre,Perú,0,1,,1,-78.802679,18.00143
10471,2012,Noviembre,Perú,1,6,,7,-75.527794,10.406342
10472,2012,Noviembre,Perú,129,119,,248,-75.516486,10.446304
10473,2012,Noviembre,Perú,28,39,,67,-74.77647900000001,10.886686
10474,2012,Noviembre,Perú,0,6,,6,-74.213989,11.247722999999999
10475,2012,Noviembre,Perú,5,33,,38,-72.129595,11.360028999999999
10476,2012,Noviembre,Perú,189,123,,312,-81.70216500000001,12.5862
10477,2012,Noviembre,Perú,97,134,,231,-76.532004,3.451668
10478,2012,Noviembre,Perú,0,3,,3,-77.061029,3.8844260000000004
10479,2012,Noviembre,Perú,0,1,,1,-75.76635300000001,4.45285
10480,2012,Noviembre,Perú,2443,3204,,5647,-74.140516,4.697157
10481,2012,Noviembre,Perú,1,3,,4,-75.736374,4.815189
10482,2012,Noviembre,Perú,190,342,,532,-75.42726,6.170465
10483,2012,Noviembre,Perú,2,1,,3,-67.48402800000001,6.185536
10484,2012,Noviembre,Perú,0,1,,1,-70.74025300000001,7.088728999999999
10485,2012,Noviembre,Perú,0,1,,1,-73.181317,7.1280470000000005
10486,2012,Noviembre,Perú,32,48,,80,-72.453013,7.819
10487,2012,Noviembre,Perú,1,0,,1,-72.508188,7.927233
10488,2012,Noviembre,Palestina,0,1,,1,-75.42726,6.170465
10489,2012,Noviembre,Polonia,13,2,,15,-69.941498,4.191162
10490,2012,Noviembre,Polonia,2,4,,6,-77.35600000000001,0.81488
10491,2012,Noviembre,Polonia,1,6,,7,-75.527794,10.406342
10492,2012,Noviembre,Polonia,8,5,,13,-75.516486,10.446304
10493,2012,Noviembre,Polonia,0,3,,3,-74.765343,10.970933
10494,2012,Noviembre,Polonia,2,4,,6,-72.129595,11.360028999999999
10495,2012,Noviembre,Polonia,4,2,,6,-76.532004,3.451668
10496,2012,Noviembre,Polonia,0,1,,1,-77.061029,3.8844260000000004
10497,2012,Noviembre,Polonia,95,110,,205,-74.140516,4.697157
10498,2012,Noviembre,Polonia,2,3,,5,-75.42726,6.170465
10499,2012,Noviembre,Polonia,0,5,,5,-72.453013,7.819
10500,2012,Noviembre,Polonia,0,2,,2,-72.508188,7.927233
10501,2012,Noviembre,Polonia,0,1,,1,-77.35002,8.63337
10502,2012,Noviembre,Portugal,1,1,,2,-77.35600000000001,0.81488
10503,2012,Noviembre,Portugal,0,2,,2,-75.527794,10.406342
10504,2012,Noviembre,Portugal,2,5,,7,-75.516486,10.446304
10505,2012,Noviembre,Portugal,1,0,,1,-74.77647900000001,10.886686
10506,2012,Noviembre,Portugal,0,1,,1,-81.70216500000001,12.5862
10507,2012,Noviembre,Portugal,3,9,,12,-76.532004,3.451668
10508,2012,Noviembre,Portugal,84,280,,364,-74.140516,4.697157
10509,2012,Noviembre,Portugal,1,0,,1,-75.736374,4.815189
10510,2012,Noviembre,Portugal,2,13,,15,-75.42726,6.170465
10511,2012,Noviembre,Portugal,2,3,,5,-72.453013,7.819
10512,2012,Noviembre,Portugal,0,2,,2,-72.508188,7.927233
10513,2012,Noviembre,Portugal,0,1,,1,-77.35002,8.63337
10514,2012,Noviembre,Polinesia Francesa/Colectividad de Ultramar Francesa,0,1,,1,-75.527794,10.406342
10515,2012,Noviembre,Puerto Rico/Territorio de Estados Unidos,2,2,,4,-75.516486,10.446304
10516,2012,Noviembre,Puerto Rico/Territorio de Estados Unidos,1,0,,1,-76.532004,3.451668
10517,2012,Noviembre,Puerto Rico/Territorio de Estados Unidos,1,0,,1,-75.42726,6.170465
10518,2012,Noviembre,Qatar,0,1,,1,-75.516486,10.446304
10519,2012,Noviembre,Qatar,1,1,,2,-74.140516,4.697157
10520,2012,Noviembre,Reino Unido de Gran Bretaña e Irlanda del Norte,1,2,,3,-69.941498,4.191162
10521,2012,Noviembre,Reino Unido de Gran Bretaña e Irlanda del Norte,4,5,,9,-77.35600000000001,0.81488
10522,2012,Noviembre,Reino Unido de Gran Bretaña e Irlanda del Norte,10,24,,34,-75.516486,10.446304
10523,2012,Noviembre,Reino Unido de Gran Bretaña e Irlanda del Norte,0,3,,3,-74.77647900000001,10.886686
10524,2012,Noviembre,Reino Unido de Gran Bretaña e Irlanda del Norte,0,4,,4,-72.129595,11.360028999999999
10525,2012,Noviembre,Reino Unido de Gran Bretaña e Irlanda del Norte,0,1,,1,-81.70216500000001,12.5862
10526,2012,Noviembre,Reino Unido de Gran Bretaña e Irlanda del Norte,6,15,,21,-76.532004,3.451668
10527,2012,Noviembre,Reino Unido de Gran Bretaña e Irlanda del Norte,0,1,,1,-75.76635300000001,4.45285
10528,2012,Noviembre,Reino Unido de Gran Bretaña e Irlanda del Norte,186,493,,679,-74.140516,4.697157
10529,2012,Noviembre,Reino Unido de Gran Bretaña e Irlanda del Norte,10,35,,45,-75.42726,6.170465
10530,2012,Noviembre,Reino Unido de Gran Bretaña e Irlanda del Norte,0,2,,2,-72.453013,7.819
10531,2012,Noviembre,República CentroÁfricana,1,0,,1,-74.140516,4.697157
10532,2012,Noviembre,República de Belarús,1,2,,3,-74.140516,4.697157
10533,2012,Noviembre,República Dominicana,0,14,,14,-77.35600000000001,0.81488
10534,2012,Noviembre,República Dominicana,74,45,,119,-75.516486,10.446304
10535,2012,Noviembre,República Dominicana,3,37,,40,-74.77647900000001,10.886686
10536,2012,Noviembre,República Dominicana,0,2,,2,-72.129595,11.360028999999999
10537,2012,Noviembre,República Dominicana,14,18,,32,-76.532004,3.451668
10538,2012,Noviembre,República Dominicana,1,2,,3,-75.76635300000001,4.45285
10539,2012,Noviembre,República Dominicana,294,382,,676,-74.140516,4.697157
10540,2012,Noviembre,República Dominicana,6,37,,43,-75.736374,4.815189
10541,2012,Noviembre,República Dominicana,31,41,,72,-75.42726,6.170465
10542,2012,Noviembre,República Dominicana,3,4,,7,-73.181317,7.1280470000000005
10543,2012,Noviembre,República Dominicana,1,0,,1,-72.453013,7.819
10544,2012,Noviembre,República Dominicana,9,14,,23,-72.508188,7.927233
10545,2012,Noviembre,República Checa,0,1,,1,-75.527794,10.406342
10546,2012,Noviembre,República Checa,0,1,,1,-76.532004,3.451668
10547,2012,Noviembre,República Checa,2,1,,3,-74.140516,4.697157
10548,2012,Noviembre,República Checa,1,0,,1,-75.42726,6.170465
10549,2012,Noviembre,República Checa,0,1,,1,-72.508188,7.927233
10550,2012,Noviembre,Rumania,1,0,,1,-77.35600000000001,0.81488
10551,2012,Noviembre,Rumania,1,1,,2,-75.527794,10.406342
10552,2012,Noviembre,Rumania,9,8,,17,-75.516486,10.446304
10553,2012,Noviembre,Rumania,2,4,,6,-76.532004,3.451668
10554,2012,Noviembre,Rumania,22,54,,76,-74.140516,4.697157
10555,2012,Noviembre,Rumania,5,6,,11,-75.42726,6.170465
10556,2012,Noviembre,Rumania,0,1,,1,-72.453013,7.819
10557,2012,Noviembre,Rumania,0,1,,1,-77.35002,8.63337
10558,2012,Noviembre,Federación de Rusia,3,2,,5,-77.35600000000001,0.81488
10559,2012,Noviembre,Federación de Rusia,1,5,,6,-75.527794,10.406342
10560,2012,Noviembre,Federación de Rusia,5,1,,6,-75.516486,10.446304
10561,2012,Noviembre,Federación de Rusia,2,1,,3,-74.77647900000001,10.886686
10562,2012,Noviembre,Federación de Rusia,3,2,,5,-72.129595,11.360028999999999
10563,2012,Noviembre,Federación de Rusia,1,1,,2,-76.532004,3.451668
10564,2012,Noviembre,Federación de Rusia,37,50,,87,-74.140516,4.697157
10565,2012,Noviembre,Federación de Rusia,1,4,,5,-75.42726,6.170465
10566,2012,Noviembre,San Cristóbal y Nevis,2,1,,3,-74.140516,4.697157
10567,2012,Noviembre,San Cristóbal y Nevis,0,1,,1,-75.42726,6.170465
10568,2012,Noviembre,San  Vicente y las Granadinas,0,2,,2,-74.140516,4.697157
10569,2012,Noviembre,Santa Lucia,0,2,,2,-75.516486,10.446304
10570,2012,Noviembre,Santa Lucia,1,2,,3,-74.140516,4.697157
10571,2012,Noviembre,Santa Lucia,3,1,,4,-73.181317,7.1280470000000005
10572,2012,Noviembre,Senegal,0,1,,1,-74.140516,4.697157
10573,2012,Noviembre,Serbia,0,1,,1,-76.532004,3.451668
10574,2012,Noviembre,Serbia,2,6,,8,-74.140516,4.697157
10575,2012,Noviembre,Singapur,3,0,,3,-75.516486,10.446304
10576,2012,Noviembre,Singapur,13,22,,35,-74.140516,4.697157
10577,2012,Noviembre,Singapur,0,2,,2,-75.42726,6.170465
10578,2012,Noviembre,República Árabe Siria,0,2,,2,-72.129595,11.360028999999999
10579,2012,Noviembre,República Árabe Siria,0,2,,2,-74.140516,4.697157
10580,2012,Noviembre,República Árabe Siria,0,1,,1,-75.42726,6.170465
10581,2012,Noviembre,República Árabe Siria,0,1,,1,-72.453013,7.819
10582,2012,Noviembre,Sri Lanka,0,1,,1,-75.527794,10.406342
10583,2012,Noviembre,Sri Lanka,0,1,,1,-75.516486,10.446304
10584,2012,Noviembre,Sri Lanka,1,0,,1,-74.140516,4.697157
10585,2012,Noviembre,Sudáfrica,0,1,,1,-69.941498,4.191162
10586,2012,Noviembre,Sudáfrica,0,1,,1,-77.35600000000001,0.81488
10587,2012,Noviembre,Sudáfrica,2,1,,3,-75.527794,10.406342
10588,2012,Noviembre,Sudáfrica,2,1,,3,-75.516486,10.446304
10589,2012,Noviembre,Sudáfrica,2,4,,6,-74.77647900000001,10.886686
10590,2012,Noviembre,Sudáfrica,1,1,,2,-76.532004,3.451668
10591,2012,Noviembre,Sudáfrica,19,95,,114,-74.140516,4.697157
10592,2012,Noviembre,Sudáfrica,1,6,,7,-75.42726,6.170465
10593,2012,Noviembre,Sudán,3,1,,4,-74.140516,4.697157
10594,2012,Noviembre,Suecia,0,1,,1,-69.941498,4.191162
10595,2012,Noviembre,Suecia,0,1,,1,-76.876446,0.33002
10596,2012,Noviembre,Suecia,6,10,,16,-77.35600000000001,0.81488
10597,2012,Noviembre,Suecia,6,13,,19,-75.527794,10.406342
10598,2012,Noviembre,Suecia,7,7,,14,-75.516486,10.446304
10599,2012,Noviembre,Suecia,0,3,,3,-74.77647900000001,10.886686
10600,2012,Noviembre,Suecia,3,3,,6,-72.129595,11.360028999999999
10601,2012,Noviembre,Suecia,0,1,,1,-81.70216500000001,12.5862
10602,2012,Noviembre,Suecia,11,12,,23,-76.532004,3.451668
10603,2012,Noviembre,Suecia,151,242,,393,-74.140516,4.697157
10604,2012,Noviembre,Suecia,11,14,,25,-75.42726,6.170465
10605,2012,Noviembre,Suecia,0,1,,1,-73.181317,7.1280470000000005
10606,2012,Noviembre,Suecia,0,1,,1,-72.453013,7.819
10607,2012,Noviembre,Suiza,3,9,,12,-69.941498,4.191162
10608,2012,Noviembre,Suiza,12,13,,25,-77.35600000000001,0.81488
10609,2012,Noviembre,Suiza,15,13,,28,-75.527794,10.406342
10610,2012,Noviembre,Suiza,8,12,,20,-75.516486,10.446304
10611,2012,Noviembre,Suiza,2,3,,5,-74.77647900000001,10.886686
10612,2012,Noviembre,Suiza,1,1,,2,-74.213989,11.247722999999999
10613,2012,Noviembre,Suiza,2,3,,5,-72.129595,11.360028999999999
10614,2012,Noviembre,Suiza,0,2,,2,-81.70216500000001,12.5862
10615,2012,Noviembre,Suiza,1,0,,1,-81.372937,13.338761300000002
10616,2012,Noviembre,Suiza,13,27,,40,-76.532004,3.451668
10617,2012,Noviembre,Suiza,236,469,,705,-74.140516,4.697157
10618,2012,Noviembre,Suiza,11,43,,54,-75.42726,6.170465
10619,2012,Noviembre,Suiza,1,2,,3,-72.453013,7.819
10620,2012,Noviembre,Suiza,1,1,,2,-77.35002,8.63337
10621,2012,Noviembre,Surinam,1,0,,1,-74.77647900000001,10.886686
10622,2012,Noviembre,Surinam,3,15,,18,-74.140516,4.697157
10623,2012,Noviembre,Surinam,21,18,,39,-75.42726,6.170465
10624,2012,Noviembre,Taiwán,0,2,,2,-75.516486,10.446304
10625,2012,Noviembre,Taiwán,2,1,,3,-74.140516,4.697157
10626,2012,Noviembre,Taiwán,1,0,,1,-75.42726,6.170465
10627,2012,Noviembre,Tailandia,1,0,,1,-75.516486,10.446304
10628,2012,Noviembre,Tailandia,1,0,,1,-76.532004,3.451668
10629,2012,Noviembre,Tailandia,6,4,,10,-74.140516,4.697157
10630,2012,Noviembre,Tailandia,0,1,,1,-72.453013,7.819
10631,2012,Noviembre,Tíbet/Región Autónoma de China,0,1,,1,-74.140516,4.697157
10632,2012,Noviembre,Territorio Antártico Británico/Territorio Británico de Ultramar,0,4,,4,-74.140516,4.697157
10633,2012,Noviembre,Territorio Antártico Británico/Territorio Británico de Ultramar,0,1,,1,-75.42726,6.170465
10634,2012,Noviembre,Territorio Antártico Británico/Territorio Británico de Ultramar,0,1,,1,-72.508188,7.927233
10635,2012,Noviembre,Tanzania,1,1,,2,-74.140516,4.697157
10636,2012,Noviembre,Togo,0,1,,1,-75.516486,10.446304
10637,2012,Noviembre,Trinidad y Tobago,7,8,,15,-75.516486,10.446304
10638,2012,Noviembre,Trinidad y Tobago,0,1,,1,-74.77647900000001,10.886686
10639,2012,Noviembre,Trinidad y Tobago,0,4,,4,-74.213989,11.247722999999999
10640,2012,Noviembre,Trinidad y Tobago,0,1,,1,-72.129595,11.360028999999999
10641,2012,Noviembre,Trinidad y Tobago,1,27,,28,-76.532004,3.451668
10642,2012,Noviembre,Trinidad y Tobago,8,31,,39,-74.140516,4.697157
10643,2012,Noviembre,Trinidad y Tobago,0,10,,10,-75.42726,6.170465
10644,2012,Noviembre,Túnez,0,1,,1,-77.35600000000001,0.81488
10645,2012,Noviembre,Túnez,1,0,,1,-74.140516,4.697157
10646,2012,Noviembre,Túnez,0,1,,1,-75.42726,6.170465
10647,2012,Noviembre,Turquía,1,1,,2,-69.941498,4.191162
10648,2012,Noviembre,Turquía,0,1,,1,-77.35600000000001,0.81488
10649,2012,Noviembre,Turquía,2,0,,2,-75.516486,10.446304
10650,2012,Noviembre,Turquía,0,3,,3,-74.77647900000001,10.886686
10651,2012,Noviembre,Turquía,18,52,,70,-74.140516,4.697157
10652,2012,Noviembre,Turquía,0,8,,8,-75.42726,6.170465
10653,2012,Noviembre,Turquía,0,1,,1,-67.48402800000001,6.185536
10654,2012,Noviembre,Turquía,0,1,,1,-72.453013,7.819
10655,2012,Noviembre,Ucrania,1,1,,2,-75.516486,10.446304
10656,2012,Noviembre,Ucrania,0,1,,1,-74.77647900000001,10.886686
10657,2012,Noviembre,Ucrania,0,7,,7,-76.532004,3.451668
10658,2012,Noviembre,Ucrania,12,28,,40,-74.140516,4.697157
10659,2012,Noviembre,Ucrania,4,0,,4,-75.42726,6.170465
10660,2012,Noviembre,Ucrania,0,1,,1,-73.181317,7.1280470000000005
10661,2012,Noviembre,Uganda,3,1,,4,-74.140516,4.697157
10662,2012,Noviembre,Federación de Rusia,1,0,,1,-69.941498,4.191162
10663,2012,Noviembre,Federación de Rusia,0,1,,1,-77.35600000000001,0.81488
10664,2012,Noviembre,Federación de Rusia,1,1,,2,-75.527794,10.406342
10665,2012,Noviembre,Federación de Rusia,0,3,,3,-75.516486,10.446304
10666,2012,Noviembre,Federación de Rusia,0,1,,1,-72.129595,11.360028999999999
10667,2012,Noviembre,Federación de Rusia,1,2,,3,-76.532004,3.451668
10668,2012,Noviembre,Federación de Rusia,95,141,,236,-74.140516,4.697157
10669,2012,Noviembre,Federación de Rusia,3,0,,3,-75.42726,6.170465
10670,2012,Noviembre,Federación de Rusia,1,0,,1,-72.453013,7.819
10671,2012,Noviembre,Uruguay,0,1,,1,-69.941498,4.191162
10672,2012,Noviembre,Uruguay,3,7,,10,-77.35600000000001,0.81488
10673,2012,Noviembre,Uruguay,93,65,,158,-75.516486,10.446304
10674,2012,Noviembre,Uruguay,1,11,,12,-74.77647900000001,10.886686
10675,2012,Noviembre,Uruguay,19,13,,32,-81.70216500000001,12.5862
10676,2012,Noviembre,Uruguay,15,28,,43,-76.532004,3.451668
10677,2012,Noviembre,Uruguay,0,1,,1,-75.76635300000001,4.45285
10678,2012,Noviembre,Uruguay,120,277,,397,-74.140516,4.697157
10679,2012,Noviembre,Uruguay,1,0,,1,-75.736374,4.815189
10680,2012,Noviembre,Uruguay,19,42,,61,-75.42726,6.170465
10681,2012,Noviembre,Uruguay,1,6,,7,-72.453013,7.819
10682,2012,Noviembre,Uruguay,0,1,,1,-72.508188,7.927233
10683,2012,Noviembre,Uruguay,1,0,,1,-77.35002,8.63337
10684,2012,Noviembre,Venezuela,2,4,,6,-69.941498,4.191162
10685,2012,Noviembre,Venezuela,0,2,,2,-76.876446,0.33002
10686,2012,Noviembre,Venezuela,36,64,,100,-77.35600000000001,0.81488
10687,2012,Noviembre,Venezuela,3,5,,8,-75.527794,10.406342
10688,2012,Noviembre,Venezuela,72,90,,162,-75.516486,10.446304
10689,2012,Noviembre,Venezuela,27,63,,90,-74.77647900000001,10.886686
10690,2012,Noviembre,Venezuela,0,5,,5,-74.232675,11.117206
10691,2012,Noviembre,Venezuela,0,2,,2,-74.213989,11.247722999999999
10692,2012,Noviembre,Venezuela,749,1391,,2140,-72.129595,11.360028999999999
10693,2012,Noviembre,Venezuela,0,1,,1,-72.919186,11.52863
10694,2012,Noviembre,Venezuela,16,10,,26,-81.70216500000001,12.5862
10695,2012,Noviembre,Venezuela,62,89,,151,-76.532004,3.451668
10696,2012,Noviembre,Venezuela,2,3,,5,-75.76635300000001,4.45285
10697,2012,Noviembre,Venezuela,5158,6676,,11834,-74.140516,4.697157
10698,2012,Noviembre,Venezuela,7,14,,21,-75.736374,4.815189
10699,2012,Noviembre,Venezuela,372,561,,933,-75.42726,6.170465
10700,2012,Noviembre,Venezuela,197,243,,440,-67.48402800000001,6.185536
10701,2012,Noviembre,Venezuela,40,79,,119,-70.74025300000001,7.088728999999999
10702,2012,Noviembre,Venezuela,11,13,,24,-73.181317,7.1280470000000005
10703,2012,Noviembre,Venezuela,1063,1339,,2402,-72.453013,7.819
10704,2012,Noviembre,Venezuela,179,200,,379,-72.508188,7.927233
10705,2012,Noviembre,Venezuela,1,1,,2,-77.35002,8.63337
10706,2012,Noviembre,Vietnam,0,5,,5,-74.140516,4.697157
10707,2012,Noviembre,República Árabe de Yemen,0,3,,3,-74.140516,4.697157
10708,2012,Noviembre,Yugoslavia,2,1,,3,-74.140516,4.697157
10709,2012,Noviembre,Zambia,0,1,,1,-74.140516,4.697157
10710,2012,Noviembre,Zimbabue,1,5,,6,-74.140516,4.697157
10711,2012,Noviembre,Zimbabue,0,1,,1,-75.42726,6.170465
10712,2012,Noviembre,Reino Unido de Gran Bretaña e Irlanda del Norte,4,7,,11,-69.941498,4.191162
10713,2012,Noviembre,Reino Unido de Gran Bretaña e Irlanda del Norte,23,27,,50,-77.35600000000001,0.81488
10714,2012,Noviembre,Reino Unido de Gran Bretaña e Irlanda del Norte,16,20,,36,-75.527794,10.406342
10715,2012,Noviembre,Reino Unido de Gran Bretaña e Irlanda del Norte,10,24,,34,-75.516486,10.446304
10716,2012,Noviembre,Reino Unido de Gran Bretaña e Irlanda del Norte,1,3,,4,-74.77647900000001,10.886686
10717,2012,Noviembre,Reino Unido de Gran Bretaña e Irlanda del Norte,1,0,,1,-74.213989,11.247722999999999
10718,2012,Noviembre,Reino Unido de Gran Bretaña e Irlanda del Norte,2,1,,3,-72.129595,11.360028999999999
10719,2012,Noviembre,Reino Unido de Gran Bretaña e Irlanda del Norte,1,4,,5,-81.70216500000001,12.5862
10720,2012,Noviembre,Reino Unido de Gran Bretaña e Irlanda del Norte,5,23,,28,-76.532004,3.451668
10721,2012,Noviembre,Reino Unido de Gran Bretaña e Irlanda del Norte,1,0,,1,-75.76635300000001,4.45285
10722,2012,Noviembre,Reino Unido de Gran Bretaña e Irlanda del Norte,250,636,,886,-74.140516,4.697157
10723,2012,Noviembre,Reino Unido de Gran Bretaña e Irlanda del Norte,7,22,,29,-75.42726,6.170465
10724,2012,Noviembre,Reino Unido de Gran Bretaña e Irlanda del Norte,1,0,,1,-73.181317,7.1280470000000005
10725,2012,Noviembre,Reino Unido de Gran Bretaña e Irlanda del Norte,1,4,,5,-72.453013,7.819
10726,2012,Noviembre,Reino Unido de Gran Bretaña e Irlanda del Norte,1,0,,1,-72.508188,7.927233
10727,2012,Noviembre,Reino Unido de Gran Bretaña e Irlanda del Norte,1,5,,6,-77.35002,8.63337
10728,2012,Noviembre,Países Bajos,1,6,,7,-69.941498,4.191162
10729,2012,Noviembre,Países Bajos,11,8,,19,-77.35600000000001,0.81488
10730,2012,Noviembre,Países Bajos,7,12,,19,-75.527794,10.406342
10731,2012,Noviembre,Países Bajos,11,28,,39,-75.516486,10.446304
10732,2012,Noviembre,Países Bajos,3,3,,6,-74.77647900000001,10.886686
10733,2012,Noviembre,Países Bajos,1,1,,2,-74.213989,11.247722999999999
10734,2012,Noviembre,Países Bajos,2,1,,3,-72.129595,11.360028999999999
10735,2012,Noviembre,Países Bajos,1,0,,1,-81.70216500000001,12.5862
10736,2012,Noviembre,Países Bajos,11,45,,56,-76.532004,3.451668
10737,2012,Noviembre,Países Bajos,0,1,,1,-77.061029,3.8844260000000004
10738,2012,Noviembre,Países Bajos,2,1,,3,-75.76635300000001,4.45285
10739,2012,Noviembre,Países Bajos,317,680,,997,-74.140516,4.697157
10740,2012,Noviembre,Países Bajos,1,0,,1,-75.736374,4.815189
10741,2012,Noviembre,Países Bajos,100,168,,268,-75.42726,6.170465
10742,2012,Noviembre,Países Bajos,54,39,,93,-73.181317,7.1280470000000005
10743,2012,Noviembre,Países Bajos,1,9,,10,-72.453013,7.819
10744,2012,Noviembre,Países Bajos,1,1,,2,-72.508188,7.927233
10745,2012,Noviembre,Países Bajos,1,1,,2,-77.35002,8.63337
10746,2012,Noviembre,Eslovenia,1,2,,3,-74.140516,4.697157
10747,2012,Noviembre,Lituania,2,2,,4,-74.140516,4.697157
10748,2012,Noviembre,Reino Unido de Gran Bretaña e Irlanda del Norte,2,2,,4,-74.213989,11.247722999999999
10749,2012,Noviembre,Reino Unido de Gran Bretaña e Irlanda del Norte,4,4,,8,-74.140516,4.697157
10750,2012,Noviembre,Reino Unido de Gran Bretaña e Irlanda del Norte,0,1,,1,-75.42726,6.170465
10751,2012,Noviembre,Reino Unido de Gran Bretaña e Irlanda del Norte,0,1,,1,-77.35600000000001,0.81488
10752,2012,Noviembre,Reino Unido de Gran Bretaña e Irlanda del Norte,8,0,,8,-75.527794,10.406342
10753,2012,Noviembre,Reino Unido de Gran Bretaña e Irlanda del Norte,0,1,,1,-76.532004,3.451668
10754,2012,Noviembre,Reino Unido de Gran Bretaña e Irlanda del Norte,7,19,,26,-74.140516,4.697157
10755,2012,Noviembre,Letonia,0,2,,2,-75.527794,10.406342
10756,2012,Noviembre,República CentroÁfricana,0,3,,3,-74.140516,4.697157
10757,2012,Diciembre,Afganistán,0,1,,1,-74.140516,4.697157
10758,2012,Diciembre,Albania,0,1,,1,-77.35600000000001,0.81488
10759,2012,Diciembre,Albania,1,1,,2,-75.516486,10.446304
10760,2012,Diciembre,Albania,1,2,,3,-74.140516,4.697157
10761,2012,Diciembre,Alemania,13,13,,26,-69.941498,4.191162
10762,2012,Diciembre,Alemania,1,1,,2,-76.876446,0.33002
10763,2012,Diciembre,Alemania,52,72,,124,-77.35600000000001,0.81488
10764,2012,Diciembre,Alemania,26,46,,72,-75.527794,10.406342
10765,2012,Diciembre,Alemania,46,87,,133,-75.516486,10.446304
10766,2012,Diciembre,Alemania,9,17,,26,-74.77647900000001,10.886686
10767,2012,Diciembre,Alemania,2,2,,4,-74.213989,11.247722999999999
10768,2012,Diciembre,Alemania,4,21,,25,-72.129595,11.360028999999999
10769,2012,Diciembre,Alemania,4,4,,8,-81.70216500000001,12.5862
10770,2012,Diciembre,Alemania,42,67,,109,-76.532004,3.451668
10771,2012,Diciembre,Alemania,1412,2176,,3588,-74.140516,4.697157
10772,2012,Diciembre,Alemania,49,95,,144,-75.42726,6.170465
10773,2012,Diciembre,Alemania,2,0,,2,-67.48402800000001,6.185536
10774,2012,Diciembre,Alemania,0,1,,1,-77.401154,6.222551999999999
10775,2012,Diciembre,Alemania,11,14,,25,-72.453013,7.819
10776,2012,Diciembre,Alemania,7,9,,16,-77.35002,8.63337
10777,2012,Diciembre,Andorra,0,1,,1,-74.77647900000001,10.886686
10778,2012,Diciembre,Andorra,1,7,,8,-74.140516,4.697157
10779,2012,Diciembre,Angola,0,1,,1,-74.140516,4.697157
10780,2012,Diciembre,Antigua y Barbuda,0,1,,1,-74.140516,4.697157
10781,2012,Diciembre,Países Bajos,0,1,,1,-75.42726,6.170465
10782,2012,Diciembre,Arabia Saudita,0,1,,1,-74.140516,4.697157
10783,2012,Diciembre,Arabia Saudita,1,6,,7,-75.516486,10.446304
10784,2012,Diciembre,Arabia Saudita,0,7,,7,-74.140516,4.697157
10785,2012,Diciembre,Argelia,3,2,,5,-74.140516,4.697157
10786,2012,Diciembre,Argentina,1,1,,2,-69.941498,4.191162
10787,2012,Diciembre,Argentina,53,95,,148,-77.35600000000001,0.81488
10788,2012,Diciembre,Argentina,61,45,,106,-75.527794,10.406342
10789,2012,Diciembre,Argentina,512,412,,924,-75.516486,10.446304
10790,2012,Diciembre,Argentina,28,37,,65,-74.77647900000001,10.886686
10791,2012,Diciembre,Argentina,21,30,,51,-72.129595,11.360028999999999
10792,2012,Diciembre,Argentina,203,209,,412,-81.70216500000001,12.5862
10793,2012,Diciembre,Argentina,61,95,,156,-76.532004,3.451668
10794,2012,Diciembre,Argentina,0,1,,1,-75.76635300000001,4.45285
10795,2012,Diciembre,Argentina,2615,3678,,6293,-74.140516,4.697157
10796,2012,Diciembre,Argentina,3,4,,7,-75.736374,4.815189
10797,2012,Diciembre,Argentina,171,314,,485,-75.42726,6.170465
10798,2012,Diciembre,Argentina,0,1,,1,-77.401154,6.222551999999999
10799,2012,Diciembre,Argentina,0,3,,3,-73.181317,7.1280470000000005
10800,2012,Diciembre,Argentina,22,41,,63,-72.453013,7.819
10801,2012,Diciembre,Argentina,4,5,,9,-72.508188,7.927233
10802,2012,Diciembre,Argentina,1,5,,6,-77.35002,8.63337
10803,2012,Diciembre,República de Armenia,1,0,,1,-77.35600000000001,0.81488
10804,2012,Diciembre,República de Armenia,2,0,,2,-74.140516,4.697157
10805,2012,Diciembre,Aruba,2,1,,3,-74.140516,4.697157
10806,2012,Diciembre,Aruba,2,3,,5,-75.42726,6.170465
10807,2012,Diciembre,Australia,8,8,,16,-69.941498,4.191162
10808,2012,Diciembre,Australia,25,36,,61,-77.35600000000001,0.81488
10809,2012,Diciembre,Australia,30,48,,78,-75.527794,10.406342
10810,2012,Diciembre,Australia,23,40,,63,-75.516486,10.446304
10811,2012,Diciembre,Australia,5,12,,17,-74.77647900000001,10.886686
10812,2012,Diciembre,Australia,0,1,,1,-74.213989,11.247722999999999
10813,2012,Diciembre,Australia,2,8,,10,-72.129595,11.360028999999999
10814,2012,Diciembre,Australia,26,35,,61,-76.532004,3.451668
10815,2012,Diciembre,Australia,361,598,,959,-74.140516,4.697157
10816,2012,Diciembre,Australia,5,4,,9,-75.736374,4.815189
10817,2012,Diciembre,Australia,33,67,,100,-75.42726,6.170465
10818,2012,Diciembre,Australia,0,1,,1,-73.181317,7.1280470000000005
10819,2012,Diciembre,Australia,5,5,,10,-72.453013,7.819
10820,2012,Diciembre,Australia,7,2,,9,-77.35002,8.63337
10821,2012,Diciembre,Austria,1,1,,2,-69.941498,4.191162
10822,2012,Diciembre,Austria,4,3,,7,-77.35600000000001,0.81488
10823,2012,Diciembre,Austria,1,3,,4,-75.527794,10.406342
10824,2012,Diciembre,Austria,11,20,,31,-75.516486,10.446304
10825,2012,Diciembre,Austria,2,1,,3,-74.77647900000001,10.886686
10826,2012,Diciembre,Austria,1,1,,2,-74.213989,11.247722999999999
10827,2012,Diciembre,Austria,2,5,,7,-72.129595,11.360028999999999
10828,2012,Diciembre,Austria,3,5,,8,-76.532004,3.451668
10829,2012,Diciembre,Austria,132,241,,373,-74.140516,4.697157
10830,2012,Diciembre,Austria,5,8,,13,-75.42726,6.170465
10831,2012,Diciembre,Austria,2,0,,2,-72.453013,7.819
10832,2012,Diciembre,Austria,2,0,,2,-72.508188,7.927233
10833,2012,Diciembre,Austria,1,0,,1,-77.35002,8.63337
10834,2012,Diciembre,Azerbaiyán,1,0,,1,-75.516486,10.446304
10835,2012,Diciembre,Azerbaiyán,0,1,,1,-74.765343,10.970933
10836,2012,Diciembre,Azerbaiyán,0,1,,1,-74.140516,4.697157
10837,2012,Diciembre,Bahamas,1,1,,2,-75.516486,10.446304
10838,2012,Diciembre,Bahamas,0,1,,1,-76.532004,3.451668
10839,2012,Diciembre,Bahamas,3,1,,4,-74.140516,4.697157
10840,2012,Diciembre,Bahamas,0,1,,1,-75.736374,4.815189
10841,2012,Diciembre,Bahamas,0,7,,7,-75.42726,6.170465
10842,2012,Diciembre,Bangladesh,0,1,,1,-75.516486,10.446304
10843,2012,Diciembre,Bangladesh,0,1,,1,-74.140516,4.697157
10844,2012,Diciembre,Barbados,1,0,,1,-74.140516,4.697157
10845,2012,Diciembre,Barbados,2,4,,6,-75.42726,6.170465
10846,2012,Diciembre,República de Belarús,0,1,,1,-74.140516,4.697157
10847,2012,Diciembre,Bélgica,0,1,,1,-69.941498,4.191162
10848,2012,Diciembre,Bélgica,13,14,,27,-77.35600000000001,0.81488
10849,2012,Diciembre,Bélgica,3,0,,3,-75.527794,10.406342
10850,2012,Diciembre,Bélgica,8,20,,28,-75.516486,10.446304
10851,2012,Diciembre,Bélgica,0,9,,9,-74.77647900000001,10.886686
10852,2012,Diciembre,Bélgica,2,4,,6,-72.129595,11.360028999999999
10853,2012,Diciembre,Bélgica,5,9,,14,-76.532004,3.451668
10854,2012,Diciembre,Bélgica,139,328,,467,-74.140516,4.697157
10855,2012,Diciembre,Bélgica,13,31,,44,-75.42726,6.170465
10856,2012,Diciembre,Bélgica,0,1,,1,-72.453013,7.819
10857,2012,Diciembre,Bélgica,2,1,,3,-77.35002,8.63337
10858,2012,Diciembre,Belice,2,4,,6,-75.516486,10.446304
10859,2012,Diciembre,Belice,0,1,,1,-74.77647900000001,10.886686
10860,2012,Diciembre,Belice,0,1,,1,-72.129595,11.360028999999999
10861,2012,Diciembre,Belice,4,5,,9,-74.140516,4.697157
10862,2012,Diciembre,Bermudas/Territorio Británico de Ultramar,0,1,,1,-74.77647900000001,10.886686
10863,2012,Diciembre,Bermudas/Territorio Británico de Ultramar,1,2,,3,-74.140516,4.697157
10864,2012,Diciembre,Bermudas/Territorio Británico de Ultramar,0,2,,2,-75.42726,6.170465
10865,2012,Diciembre,Bermudas/Territorio Británico de Ultramar,0,2,,2,-73.181317,7.1280470000000005
10866,2012,Diciembre,Bolivia,19,24,,43,-77.35600000000001,0.81488
10867,2012,Diciembre,Bolivia,12,12,,24,-75.516486,10.446304
10868,2012,Diciembre,Bolivia,1,3,,4,-74.77647900000001,10.886686
10869,2012,Diciembre,Bolivia,18,11,,29,-81.70216500000001,12.5862
10870,2012,Diciembre,Bolivia,8,9,,17,-76.532004,3.451668
10871,2012,Diciembre,Bolivia,384,454,,838,-74.140516,4.697157
10872,2012,Diciembre,Bolivia,15,21,,36,-75.42726,6.170465
10873,2012,Diciembre,Bolivia,3,8,,11,-72.453013,7.819
10874,2012,Diciembre,Bosnia y Herzegovina,0,1,,1,-75.516486,10.446304
10875,2012,Diciembre,Bosnia y Herzegovina,0,1,,1,-74.140516,4.697157
10876,2012,Diciembre,Brasil,83,68,,151,-69.941498,4.191162
10877,2012,Diciembre,Brasil,9,17,,26,-77.35600000000001,0.81488
10878,2012,Diciembre,Brasil,13,9,,22,-75.527794,10.406342
10879,2012,Diciembre,Brasil,203,156,,359,-75.516486,10.446304
10880,2012,Diciembre,Brasil,9,21,,30,-74.77647900000001,10.886686
10881,2012,Diciembre,Brasil,18,24,,42,-72.129595,11.360028999999999
10882,2012,Diciembre,Brasil,30,18,,48,-81.70216500000001,12.5862
10883,2012,Diciembre,Brasil,23,51,,74,-76.532004,3.451668
10884,2012,Diciembre,Brasil,0,1,,1,-75.76635300000001,4.45285
10885,2012,Diciembre,Brasil,2320,3022,,5342,-74.140516,4.697157
10886,2012,Diciembre,Brasil,1,1,,2,-75.736374,4.815189
10887,2012,Diciembre,Brasil,76,103,,179,-75.42726,6.170465
10888,2012,Diciembre,Brasil,0,1,,1,-67.48402800000001,6.185536
10889,2012,Diciembre,Brasil,1,7,,8,-73.181317,7.1280470000000005
10890,2012,Diciembre,Brasil,9,18,,27,-72.453013,7.819
10891,2012,Diciembre,Brasil,5,10,,15,-72.508188,7.927233
10892,2012,Diciembre,Bulgaria,1,0,,1,-77.35600000000001,0.81488
10893,2012,Diciembre,Bulgaria,1,0,,1,-75.516486,10.446304
10894,2012,Diciembre,Bulgaria,1,0,,1,-76.532004,3.451668
10895,2012,Diciembre,Bulgaria,8,12,,20,-74.140516,4.697157
10896,2012,Diciembre,Bulgaria,0,3,,3,-75.42726,6.170465
10897,2012,Diciembre,Cabo Verde,1,0,,1,-74.140516,4.697157
10898,2012,Diciembre,Islas Caimán/Territorio Británico de Ultramar,14,25,,39,-81.70216500000001,12.5862
10899,2012,Diciembre,Islas Caimán/Territorio Británico de Ultramar,0,1,,1,-74.140516,4.697157
10900,2012,Diciembre,Camboya,1,0,,1,-76.532004,3.451668
10901,2012,Diciembre,Camboya,1,0,,1,-74.140516,4.697157
10902,2012,Diciembre,Camerún,1,0,,1,-77.35600000000001,0.81488
10903,2012,Diciembre,Camerún,0,2,,2,-74.140516,4.697157
10904,2012,Diciembre,Canadá,3,3,,6,-69.941498,4.191162
10905,2012,Diciembre,Canadá,0,1,,1,-76.876446,0.33002
10906,2012,Diciembre,Canadá,6,17,,23,-77.35600000000001,0.81488
10907,2012,Diciembre,Canadá,19,29,,48,-75.527794,10.406342
10908,2012,Diciembre,Canadá,474,550,,1024,-75.516486,10.446304
10909,2012,Diciembre,Canadá,11,33,,44,-74.77647900000001,10.886686
10910,2012,Diciembre,Canadá,3,2,,5,-74.213989,11.247722999999999
10911,2012,Diciembre,Canadá,2,5,,7,-72.129595,11.360028999999999
10912,2012,Diciembre,Canadá,158,172,,330,-81.70216500000001,12.5862
10913,2012,Diciembre,Canadá,2,3,,5,-81.372937,13.338761300000002
10914,2012,Diciembre,Canadá,84,112,,196,-76.532004,3.451668
10915,2012,Diciembre,Canadá,18,19,,37,-75.76635300000001,4.45285
10916,2012,Diciembre,Canadá,1025,1823,,2848,-74.140516,4.697157
10917,2012,Diciembre,Canadá,3,5,,8,-75.736374,4.815189
10918,2012,Diciembre,Canadá,154,263,,417,-75.42726,6.170465
10919,2012,Diciembre,Canadá,3,10,,13,-73.181317,7.1280470000000005
10920,2012,Diciembre,Canadá,7,15,,22,-72.453013,7.819
10921,2012,Diciembre,Canadá,0,5,,5,-72.508188,7.927233
10922,2012,Diciembre,Canadá,6,11,,17,-77.35002,8.63337
10923,2012,Diciembre,España,0,1,,1,-76.876446,0.33002
10924,2012,Diciembre,España,7,14,,21,-77.35600000000001,0.81488
10925,2012,Diciembre,España,3,6,,9,-75.527794,10.406342
10926,2012,Diciembre,España,7,6,,13,-75.516486,10.446304
10927,2012,Diciembre,España,3,17,,20,-74.77647900000001,10.886686
10928,2012,Diciembre,España,0,3,,3,-74.213989,11.247722999999999
10929,2012,Diciembre,España,0,1,,1,-72.129595,11.360028999999999
10930,2012,Diciembre,España,1,0,,1,-81.70216500000001,12.5862
10931,2012,Diciembre,España,1,0,,1,-81.372937,13.338761300000002
10932,2012,Diciembre,España,104,165,,269,-76.532004,3.451668
10933,2012,Diciembre,España,205,377,,582,-74.140516,4.697157
10934,2012,Diciembre,España,0,5,,5,-75.736374,4.815189
10935,2012,Diciembre,España,47,132,,179,-75.42726,6.170465
10936,2012,Diciembre,España,1,10,,11,-72.453013,7.819
10937,2012,Diciembre,España,0,2,,2,-72.508188,7.927233
10938,2012,Diciembre,España,1,0,,1,-77.35002,8.63337
10939,2012,Diciembre,República Democrática del Congo,0,1,,1,-74.140516,4.697157
10940,2012,Diciembre,República de Corea,3,9,,12,-77.35600000000001,0.81488
10941,2012,Diciembre,República de Corea,1,1,,2,-75.527794,10.406342
10942,2012,Diciembre,República de Corea,6,3,,9,-75.516486,10.446304
10943,2012,Diciembre,República de Corea,0,1,,1,-72.129595,11.360028999999999
10944,2012,Diciembre,República de Corea,0,2,,2,-81.70216500000001,12.5862
10945,2012,Diciembre,República de Corea,2,4,,6,-76.532004,3.451668
10946,2012,Diciembre,República de Corea,176,400,,576,-74.140516,4.697157
10947,2012,Diciembre,República de Corea,3,13,,16,-75.42726,6.170465
10948,2012,Diciembre,República de Corea,2,5,,7,-72.453013,7.819
10949,2012,Diciembre,República de Corea,0,1,,1,-77.35002,8.63337
10950,2012,Diciembre,Costa de Marfil,1,1,,2,-74.140516,4.697157
10951,2012,Diciembre,Costa Rica,1,0,,1,-76.876446,0.33002
10952,2012,Diciembre,Costa Rica,1,2,,3,-77.35600000000001,0.81488
10953,2012,Diciembre,Costa Rica,1,1,,2,-75.527794,10.406342
10954,2012,Diciembre,Costa Rica,65,64,,129,-75.516486,10.446304
10955,2012,Diciembre,Costa Rica,38,42,,80,-74.77647900000001,10.886686
10956,2012,Diciembre,Costa Rica,0,3,,3,-72.129595,11.360028999999999
10957,2012,Diciembre,Costa Rica,1,1,,2,-81.703935,12.574411099999999
10958,2012,Diciembre,Costa Rica,363,286,,649,-81.70216500000001,12.5862
10959,2012,Diciembre,Costa Rica,40,55,,95,-76.532004,3.451668
10960,2012,Diciembre,Costa Rica,533,738,,1271,-74.140516,4.697157
10961,2012,Diciembre,Costa Rica,7,9,,16,-75.736374,4.815189
10962,2012,Diciembre,Costa Rica,191,216,,407,-75.42726,6.170465
10963,2012,Diciembre,Costa Rica,0,1,,1,-70.74025300000001,7.088728999999999
10964,2012,Diciembre,Costa Rica,5,4,,9,-73.181317,7.1280470000000005
10965,2012,Diciembre,Costa Rica,2,3,,5,-72.453013,7.819
10966,2012,Diciembre,Costa Rica,4,5,,9,-72.508188,7.927233
10967,2012,Diciembre,Costa Rica,1,1,,2,-77.35002,8.63337
10968,2012,Diciembre,Croacia,1,5,,6,-75.527794,10.406342
10969,2012,Diciembre,Croacia,1,1,,2,-75.516486,10.446304
10970,2012,Diciembre,Croacia,0,1,,1,-74.77647900000001,10.886686
10971,2012,Diciembre,Croacia,0,3,,3,-77.061029,3.8844260000000004
10972,2012,Diciembre,Croacia,10,19,,29,-74.140516,4.697157
10973,2012,Diciembre,Cuba,1,2,,3,-69.941498,4.191162
10974,2012,Diciembre,Cuba,4,5,,9,-77.35600000000001,0.81488
10975,2012,Diciembre,Cuba,1,1,,2,-75.527794,10.406342
10976,2012,Diciembre,Cuba,11,13,,24,-75.516486,10.446304
10977,2012,Diciembre,Cuba,4,10,,14,-74.77647900000001,10.886686
10978,2012,Diciembre,Cuba,1,2,,3,-72.129595,11.360028999999999
10979,2012,Diciembre,Cuba,1,0,,1,-81.70216500000001,12.5862
10980,2012,Diciembre,Cuba,13,45,,58,-76.532004,3.451668
10981,2012,Diciembre,Cuba,90,140,,230,-74.140516,4.697157
10982,2012,Diciembre,Cuba,1,1,,2,-75.736374,4.815189
10983,2012,Diciembre,Cuba,12,16,,28,-75.42726,6.170465
10984,2012,Diciembre,Cuba,0,6,,6,-73.181317,7.1280470000000005
10985,2012,Diciembre,Cuba,0,3,,3,-72.453013,7.819
10986,2012,Diciembre,Cuba,2,1,,3,-72.508188,7.927233
10987,2012,Diciembre,Curazao,4,3,,7,-74.140516,4.697157
10988,2012,Diciembre,Curazao,10,10,,20,-75.42726,6.170465
10989,2012,Diciembre,República Checa,1,2,,3,-77.35600000000001,0.81488
10990,2012,Diciembre,República Checa,1,3,,4,-75.516486,10.446304
10991,2012,Diciembre,República Checa,0,1,,1,-72.129595,11.360028999999999
10992,2012,Diciembre,República Checa,1,3,,4,-81.70216500000001,12.5862
10993,2012,Diciembre,República Checa,0,1,,1,-76.532004,3.451668
10994,2012,Diciembre,República Checa,31,29,,60,-74.140516,4.697157
10995,2012,Diciembre,República Checa,0,1,,1,-75.42726,6.170465
10996,2012,Diciembre,República Checa,0,3,,3,-72.453013,7.819
10997,2012,Diciembre,Chile,47,91,,138,-77.35600000000001,0.81488
10998,2012,Diciembre,Chile,13,14,,27,-75.527794,10.406342
10999,2012,Diciembre,Chile,163,171,,334,-75.516486,10.446304
11000,2012,Diciembre,Chile,11,27,,38,-74.77647900000001,10.886686
11001,2012,Diciembre,Chile,0,4,,4,-74.213989,11.247722999999999
11002,2012,Diciembre,Chile,5,8,,13,-72.129595,11.360028999999999
11003,2012,Diciembre,Chile,31,32,,63,-81.70216500000001,12.5862
11004,2012,Diciembre,Chile,52,92,,144,-76.532004,3.451668
11005,2012,Diciembre,Chile,1798,2925,,4723,-74.140516,4.697157
11006,2012,Diciembre,Chile,1,0,,1,-75.736374,4.815189
11007,2012,Diciembre,Chile,59,134,,193,-75.42726,6.170465
11008,2012,Diciembre,Chile,0,2,,2,-67.48402800000001,6.185536
11009,2012,Diciembre,Chile,1,2,,3,-73.181317,7.1280470000000005
11010,2012,Diciembre,Chile,9,19,,28,-72.453013,7.819
11011,2012,Diciembre,Chile,2,5,,7,-72.508188,7.927233
11012,2012,Diciembre,Chile,2,2,,4,-77.35002,8.63337
11013,2012,Diciembre,China,0,1,,1,-69.941498,4.191162
11014,2012,Diciembre,China,2,4,,6,-77.35600000000001,0.81488
11015,2012,Diciembre,China,7,4,,11,-75.527794,10.406342
11016,2012,Diciembre,China,2,2,,4,-75.516486,10.446304
11017,2012,Diciembre,China,1,6,,7,-74.77647900000001,10.886686
11018,2012,Diciembre,China,0,1,,1,-74.765343,10.970933
11019,2012,Diciembre,China,0,3,,3,-76.532004,3.451668
11020,2012,Diciembre,China,0,1,,1,-77.061029,3.8844260000000004
11021,2012,Diciembre,China,149,357,,506,-74.140516,4.697157
11022,2012,Diciembre,China,2,6,,8,-75.42726,6.170465
11023,2012,Diciembre,China,2,0,,2,-72.453013,7.819
11024,2012,Diciembre,Taiwán,2,2,,4,-77.35600000000001,0.81488
11025,2012,Diciembre,Taiwán,3,1,,4,-75.516486,10.446304
11026,2012,Diciembre,Taiwán,1,2,,3,-74.77647900000001,10.886686
11027,2012,Diciembre,Taiwán,1,1,,2,-81.70216500000001,12.5862
11028,2012,Diciembre,Taiwán,2,3,,5,-76.532004,3.451668
11029,2012,Diciembre,Taiwán,33,58,,91,-74.140516,4.697157
11030,2012,Diciembre,Taiwán,0,1,,1,-75.736374,4.815189
11031,2012,Diciembre,Taiwán,4,1,,5,-75.42726,6.170465
11032,2012,Diciembre,Taiwán,2,1,,3,-72.453013,7.819
11033,2012,Diciembre,Taiwán,0,1,,1,-72.508188,7.927233
11034,2012,Diciembre,Chipre,1,7,,8,-74.140516,4.697157
11035,2012,Diciembre,Dinamarca,1,2,,3,-69.941498,4.191162
11036,2012,Diciembre,Dinamarca,4,1,,5,-77.35600000000001,0.81488
11037,2012,Diciembre,Dinamarca,1,2,,3,-75.527794,10.406342
11038,2012,Diciembre,Dinamarca,3,7,,10,-75.516486,10.446304
11039,2012,Diciembre,Dinamarca,0,1,,1,-74.77647900000001,10.886686
11040,2012,Diciembre,Dinamarca,0,2,,2,-72.129595,11.360028999999999
11041,2012,Diciembre,Dinamarca,3,6,,9,-76.532004,3.451668
11042,2012,Diciembre,Dinamarca,62,131,,193,-74.140516,4.697157
11043,2012,Diciembre,Dinamarca,0,4,,4,-75.42726,6.170465
11044,2012,Diciembre,Dinamarca,0,2,,2,-72.453013,7.819
11045,2012,Diciembre,Dominica,1,0,,1,-72.129595,11.360028999999999
11046,2012,Diciembre,Dominica,0,1,,1,-81.70216500000001,12.5862
11047,2012,Diciembre,Dominica,1,1,,2,-74.140516,4.697157
11048,2012,Diciembre,Dominica,3,0,,3,-77.35002,8.63337
11049,2012,Diciembre,Ecuador,1,3,,4,-69.941498,4.191162
11050,2012,Diciembre,Ecuador,47,70,,117,-76.876446,0.33002
11051,2012,Diciembre,Ecuador,1185,1973,,3158,-77.35600000000001,0.81488
11052,2012,Diciembre,Ecuador,12,67,,79,-78.802679,18.00143
11053,2012,Diciembre,Ecuador,4,15,,19,-75.527794,10.406342
11054,2012,Diciembre,Ecuador,17,34,,51,-75.516486,10.446304
11055,2012,Diciembre,Ecuador,10,12,,22,-74.77647900000001,10.886686
11056,2012,Diciembre,Ecuador,17,25,,42,-72.129595,11.360028999999999
11057,2012,Diciembre,Ecuador,0,6,,6,-81.703935,12.574411099999999
11058,2012,Diciembre,Ecuador,5,3,,8,-81.70216500000001,12.5862
11059,2012,Diciembre,Ecuador,308,383,,691,-76.532004,3.451668
11060,2012,Diciembre,Ecuador,0,1,,1,-75.76635300000001,4.45285
11061,2012,Diciembre,Ecuador,1829,2608,,4437,-74.140516,4.697157
11062,2012,Diciembre,Ecuador,0,3,,3,-75.736374,4.815189
11063,2012,Diciembre,Ecuador,475,513,,988,-75.42726,6.170465
11064,2012,Diciembre,Ecuador,0,1,,1,-70.74025300000001,7.088728999999999
11065,2012,Diciembre,Ecuador,4,4,,8,-73.181317,7.1280470000000005
11066,2012,Diciembre,Ecuador,250,355,,605,-72.453013,7.819
11067,2012,Diciembre,Ecuador,5,6,,11,-72.508188,7.927233
11068,2012,Diciembre,Ecuador,0,1,,1,-77.35002,8.63337
11069,2012,Diciembre,Egipto,2,1,,3,-75.516486,10.446304
11070,2012,Diciembre,Egipto,0,1,,1,-76.532004,3.451668
11071,2012,Diciembre,Egipto,6,20,,26,-74.140516,4.697157
11072,2012,Diciembre,Egipto,0,1,,1,-75.42726,6.170465
11073,2012,Diciembre,El Salvador,0,1,,1,-77.35600000000001,0.81488
11074,2012,Diciembre,El Salvador,8,14,,22,-75.516486,10.446304
11075,2012,Diciembre,El Salvador,2,6,,8,-74.77647900000001,10.886686
11076,2012,Diciembre,El Salvador,1,1,,2,-81.70216500000001,12.5862
11077,2012,Diciembre,El Salvador,34,50,,84,-76.532004,3.451668
11078,2012,Diciembre,El Salvador,298,495,,793,-74.140516,4.697157
11079,2012,Diciembre,El Salvador,1,4,,5,-75.736374,4.815189
11080,2012,Diciembre,El Salvador,15,37,,52,-75.42726,6.170465
11081,2012,Diciembre,El Salvador,2,0,,2,-73.181317,7.1280470000000005
11082,2012,Diciembre,El Salvador,1,1,,2,-72.453013,7.819
11083,2012,Diciembre,El Salvador,0,1,,1,-72.508188,7.927233
11084,2012,Diciembre,El Salvador,0,1,,1,-77.35002,8.63337
11085,2012,Diciembre,Emiratos Árabes,0,1,,1,-75.516486,10.446304
11086,2012,Diciembre,Emiratos Árabes,0,6,,6,-74.140516,4.697157
11087,2012,Diciembre,España,4,4,,8,-69.941498,4.191162
11088,2012,Diciembre,España,33,42,,75,-77.35600000000001,0.81488
11089,2012,Diciembre,España,10,14,,24,-75.527794,10.406342
11090,2012,Diciembre,España,50,94,,144,-75.516486,10.446304
11091,2012,Diciembre,España,3,14,,17,-74.77647900000001,10.886686
11092,2012,Diciembre,España,6,14,,20,-72.129595,11.360028999999999
11093,2012,Diciembre,España,0,1,,1,-81.703935,12.574411099999999
11094,2012,Diciembre,España,2,6,,8,-81.70216500000001,12.5862
11095,2012,Diciembre,España,0,2,,2,-81.372937,13.338761300000002
11096,2012,Diciembre,España,194,348,,542,-76.532004,3.451668
11097,2012,Diciembre,España,1894,4061,,5955,-74.140516,4.697157
11098,2012,Diciembre,España,2,5,,7,-75.736374,4.815189
11099,2012,Diciembre,España,88,212,,300,-75.42726,6.170465
11100,2012,Diciembre,España,1,1,,2,-67.48402800000001,6.185536
11101,2012,Diciembre,España,0,2,,2,-73.181317,7.1280470000000005
11102,2012,Diciembre,España,18,37,,55,-72.453013,7.819
11103,2012,Diciembre,España,3,4,,7,-72.508188,7.927233
11104,2012,Diciembre,España,2,9,,11,-77.35002,8.63337
11105,2012,Diciembre,Eritrea,0,1,,1,-72.453013,7.819
11106,2012,Diciembre,Eslovaquia,1,1,,2,-77.35600000000001,0.81488
11107,2012,Diciembre,Eslovaquia,0,3,,3,-75.516486,10.446304
11108,2012,Diciembre,Eslovaquia,0,1,,1,-74.77647900000001,10.886686
11109,2012,Diciembre,Eslovaquia,0,2,,2,-72.129595,11.360028999999999
11110,2012,Diciembre,Eslovaquia,1,0,,1,-76.532004,3.451668
11111,2012,Diciembre,Eslovaquia,10,14,,24,-74.140516,4.697157
11112,2012,Diciembre,Eslovaquia,0,1,,1,-75.42726,6.170465
11113,2012,Diciembre,Eslovaquia,0,1,,1,-72.453013,7.819
11114,2012,Diciembre,Eslovenia,1,1,,2,-77.35600000000001,0.81488
11115,2012,Diciembre,Eslovenia,0,3,,3,-75.527794,10.406342
11116,2012,Diciembre,Eslovenia,1,1,,2,-72.129595,11.360028999999999
11117,2012,Diciembre,Eslovenia,5,18,,23,-74.140516,4.697157
11118,2012,Diciembre,Estados Unidos de América,10,6,,16,-69.941498,4.191162
11119,2012,Diciembre,Estados Unidos de América,0,2,,2,-76.876446,0.33002
11120,2012,Diciembre,Estados Unidos de América,35,86,,121,-77.35600000000001,0.81488
11121,2012,Diciembre,Estados Unidos de América,1,0,,1,-78.802679,18.00143
11122,2012,Diciembre,Estados Unidos de América,39,81,,120,-75.527794,10.406342
11123,2012,Diciembre,Estados Unidos de América,1358,2295,,3653,-75.516486,10.446304
11124,2012,Diciembre,Estados Unidos de América,512,792,,1304,-74.77647900000001,10.886686
11125,2012,Diciembre,Estados Unidos de América,3,3,,6,-74.213989,11.247722999999999
11126,2012,Diciembre,Estados Unidos de América,5,20,,25,-72.129595,11.360028999999999
11127,2012,Diciembre,Estados Unidos de América,4,1,,5,-72.919186,11.52863
11128,2012,Diciembre,Estados Unidos de América,3,11,,14,-81.703935,12.574411099999999
11129,2012,Diciembre,Estados Unidos de América,31,66,,97,-81.70216500000001,12.5862
11130,2012,Diciembre,Estados Unidos de América,6,4,,10,-81.372937,13.338761300000002
11131,2012,Diciembre,Estados Unidos de América,1226,1926,,3152,-76.532004,3.451668
11132,2012,Diciembre,Estados Unidos de América,100,133,,233,-75.76635300000001,4.45285
11133,2012,Diciembre,Estados Unidos de América,7533,13426,,20959,-74.140516,4.697157
11134,2012,Diciembre,Estados Unidos de América,162,217,,379,-75.736374,4.815189
11135,2012,Diciembre,Estados Unidos de América,1677,3139,,4816,-75.42726,6.170465
11136,2012,Diciembre,Estados Unidos de América,0,1,,1,-77.401154,6.222551999999999
11137,2012,Diciembre,Estados Unidos de América,1,1,,2,-70.74025300000001,7.088728999999999
11138,2012,Diciembre,Estados Unidos de América,60,83,,143,-73.181317,7.1280470000000005
11139,2012,Diciembre,Estados Unidos de América,28,47,,75,-72.453013,7.819
11140,2012,Diciembre,Estados Unidos de América,53,80,,133,-72.508188,7.927233
11141,2012,Diciembre,Estados Unidos de América,6,9,,15,-77.35002,8.63337
11142,2012,Diciembre,Estonia,0,2,,2,-75.516486,10.446304
11143,2012,Diciembre,Estonia,0,1,,1,-76.532004,3.451668
11144,2012,Diciembre,Estonia,6,8,,14,-74.140516,4.697157
11145,2012,Diciembre,Etiopia,1,2,,3,-74.140516,4.697157
11146,2012,Diciembre,Filipinas,0,1,,1,-77.35600000000001,0.81488
11147,2012,Diciembre,Filipinas,0,32,,32,-75.527794,10.406342
11148,2012,Diciembre,Filipinas,0,15,,15,-75.516486,10.446304
11149,2012,Diciembre,Filipinas,0,4,,4,-74.77647900000001,10.886686
11150,2012,Diciembre,Filipinas,0,18,,18,-74.765343,10.970933
11151,2012,Diciembre,Filipinas,0,7,,7,-74.213989,11.247722999999999
11152,2012,Diciembre,Filipinas,0,8,,8,-76.532004,3.451668
11153,2012,Diciembre,Filipinas,0,19,,19,-77.061029,3.8844260000000004
11154,2012,Diciembre,Filipinas,11,57,,68,-74.140516,4.697157
11155,2012,Diciembre,Filipinas,0,2,,2,-75.68164200000001,9.402597
11156,2012,Diciembre,Finlandia,1,2,,3,-77.35600000000001,0.81488
11157,2012,Diciembre,Finlandia,0,3,,3,-75.527794,10.406342
11158,2012,Diciembre,Finlandia,3,7,,10,-75.516486,10.446304
11159,2012,Diciembre,Finlandia,0,1,,1,-76.532004,3.451668
11160,2012,Diciembre,Finlandia,55,90,,145,-74.140516,4.697157
11161,2012,Diciembre,Finlandia,8,5,,13,-75.42726,6.170465
11162,2012,Diciembre,Finlandia,0,1,,1,-73.181317,7.1280470000000005
11163,2012,Diciembre,Francia,3,7,,10,-69.941498,4.191162
11164,2012,Diciembre,Francia,0,1,,1,-76.876446,0.33002
11165,2012,Diciembre,Francia,33,51,,84,-77.35600000000001,0.81488
11166,2012,Diciembre,Francia,10,13,,23,-75.527794,10.406342
11167,2012,Diciembre,Francia,33,63,,96,-75.516486,10.446304
11168,2012,Diciembre,Francia,2,8,,10,-74.77647900000001,10.886686
11169,2012,Diciembre,Francia,5,2,,7,-74.213989,11.247722999999999
11170,2012,Diciembre,Francia,5,10,,15,-72.129595,11.360028999999999
11171,2012,Diciembre,Francia,1,1,,2,-81.703935,12.574411099999999
11172,2012,Diciembre,Francia,1,2,,3,-81.70216500000001,12.5862
11173,2012,Diciembre,Francia,2,3,,5,-81.372937,13.338761300000002
11174,2012,Diciembre,Francia,37,71,,108,-76.532004,3.451668
11175,2012,Diciembre,Francia,1112,2054,,3166,-74.140516,4.697157
11176,2012,Diciembre,Francia,2,3,,5,-75.736374,4.815189
11177,2012,Diciembre,Francia,25,70,,95,-75.42726,6.170465
11178,2012,Diciembre,Francia,1,3,,4,-73.181317,7.1280470000000005
11179,2012,Diciembre,Francia,9,17,,26,-72.453013,7.819
11180,2012,Diciembre,Francia,0,2,,2,-72.508188,7.927233
11181,2012,Diciembre,Francia,6,15,,21,-77.35002,8.63337
11182,2012,Diciembre,Gabón,0,1,,1,-74.140516,4.697157
11183,2012,Diciembre,Gambia,0,1,,1,-76.532004,3.451668
11184,2012,Diciembre,Georgia,0,1,,1,-74.140516,4.697157
11185,2012,Diciembre,Ghana,1,3,,4,-74.140516,4.697157
11186,2012,Diciembre,Ghana,0,1,,1,-75.42726,6.170465
11187,2012,Diciembre,Ghana,0,2,,2,-72.453013,7.819
11188,2012,Diciembre,Granada,0,1,,1,-72.508188,7.927233
11189,2012,Diciembre,Grecia,1,0,,1,-69.941498,4.191162
11190,2012,Diciembre,Grecia,0,1,,1,-76.876446,0.33002
11191,2012,Diciembre,Grecia,2,1,,3,-77.35600000000001,0.81488
11192,2012,Diciembre,Grecia,0,8,,8,-75.527794,10.406342
11193,2012,Diciembre,Grecia,0,6,,6,-75.516486,10.446304
11194,2012,Diciembre,Grecia,0,1,,1,-72.129595,11.360028999999999
11195,2012,Diciembre,Grecia,29,51,,80,-74.140516,4.697157
11196,2012,Diciembre,Grecia,0,3,,3,-75.42726,6.170465
11197,2012,Diciembre,Grecia,0,2,,2,-72.453013,7.819
11198,2012,Diciembre,Guatemala,1,3,,4,-77.35600000000001,0.81488
11199,2012,Diciembre,Guatemala,2,3,,5,-75.527794,10.406342
11200,2012,Diciembre,Guatemala,41,40,,81,-75.516486,10.446304
11201,2012,Diciembre,Guatemala,1,11,,12,-74.77647900000001,10.886686
11202,2012,Diciembre,Guatemala,10,11,,21,-81.70216500000001,12.5862
11203,2012,Diciembre,Guatemala,36,58,,94,-76.532004,3.451668
11204,2012,Diciembre,Guatemala,0,2,,2,-75.76635300000001,4.45285
11205,2012,Diciembre,Guatemala,162,303,,465,-74.140516,4.697157
11206,2012,Diciembre,Guatemala,2,8,,10,-75.736374,4.815189
11207,2012,Diciembre,Guatemala,46,80,,126,-75.42726,6.170465
11208,2012,Diciembre,Guatemala,1,0,,1,-73.181317,7.1280470000000005
11209,2012,Diciembre,Guatemala,7,13,,20,-72.453013,7.819
11210,2012,Diciembre,Guatemala,1,6,,7,-72.508188,7.927233
11211,2012,Diciembre,Guyana,0,2,,2,-77.35600000000001,0.81488
11212,2012,Diciembre,Guyana,0,1,,1,-75.516486,10.446304
11213,2012,Diciembre,Guyana,3,1,,4,-74.77647900000001,10.886686
11214,2012,Diciembre,Guyana,0,1,,1,-72.129595,11.360028999999999
11215,2012,Diciembre,Guyana,0,1,,1,-81.70216500000001,12.5862
11216,2012,Diciembre,Guyana,0,1,,1,-76.532004,3.451668
11217,2012,Diciembre,Guyana,1,3,,4,-74.140516,4.697157
11218,2012,Diciembre,Guyana,1,2,,3,-75.42726,6.170465
11219,2012,Diciembre,Guyana,1,0,,1,-73.181317,7.1280470000000005
11220,2012,Diciembre,Guinea Bissau,0,1,,1,-72.453013,7.819
11221,2012,Diciembre,Guinea Bissau,0,1,,1,-72.508188,7.927233
11222,2012,Diciembre,Haití,0,1,,1,-77.35600000000001,0.81488
11223,2012,Diciembre,Haití,0,1,,1,-75.527794,10.406342
11224,2012,Diciembre,Haití,0,2,,2,-75.516486,10.446304
11225,2012,Diciembre,Haití,2,0,,2,-74.77647900000001,10.886686
11226,2012,Diciembre,Haití,13,16,,29,-74.140516,4.697157
11227,2012,Diciembre,Haití,3,6,,9,-75.42726,6.170465
11228,2012,Diciembre,Honduras,2,1,,3,-77.35600000000001,0.81488
11229,2012,Diciembre,Honduras,0,1,,1,-75.527794,10.406342
11230,2012,Diciembre,Honduras,9,11,,20,-75.516486,10.446304
11231,2012,Diciembre,Honduras,1,5,,6,-74.77647900000001,10.886686
11232,2012,Diciembre,Honduras,0,2,,2,-74.765343,10.970933
11233,2012,Diciembre,Honduras,0,2,,2,-72.129595,11.360028999999999
11234,2012,Diciembre,Honduras,0,27,,27,-81.703935,12.574411099999999
11235,2012,Diciembre,Honduras,2,4,,6,-81.70216500000001,12.5862
11236,2012,Diciembre,Honduras,20,26,,46,-76.532004,3.451668
11237,2012,Diciembre,Honduras,1,0,,1,-75.76635300000001,4.45285
11238,2012,Diciembre,Honduras,103,138,,241,-74.140516,4.697157
11239,2012,Diciembre,Honduras,0,2,,2,-75.736374,4.815189
11240,2012,Diciembre,Honduras,26,40,,66,-75.42726,6.170465
11241,2012,Diciembre,Honduras,0,1,,1,-73.181317,7.1280470000000005
11242,2012,Diciembre,Honduras,1,2,,3,-72.508188,7.927233
11243,2012,Diciembre,Honduras,0,1,,1,-76.7333,8.06667
11244,2012,Diciembre,Hungría,0,1,,1,-77.35600000000001,0.81488
11245,2012,Diciembre,Hungría,0,1,,1,-76.532004,3.451668
11246,2012,Diciembre,Hungría,20,27,,47,-74.140516,4.697157
11247,2012,Diciembre,Hungría,1,0,,1,-75.42726,6.170465
11248,2012,Diciembre,Hungría,0,1,,1,-77.35002,8.63337
11249,2012,Diciembre,India,0,2,,2,-77.35600000000001,0.81488
11250,2012,Diciembre,India,2,5,,7,-75.516486,10.446304
11251,2012,Diciembre,India,0,3,,3,-74.77647900000001,10.886686
11252,2012,Diciembre,India,0,1,,1,-74.213989,11.247722999999999
11253,2012,Diciembre,India,1,17,,18,-76.532004,3.451668
11254,2012,Diciembre,India,0,14,,14,-77.061029,3.8844260000000004
11255,2012,Diciembre,India,28,218,,246,-74.140516,4.697157
11256,2012,Diciembre,India,0,2,,2,-75.736374,4.815189
11257,2012,Diciembre,India,3,16,,19,-75.42726,6.170465
11258,2012,Diciembre,India,0,1,,1,-72.508188,7.927233
11259,2012,Diciembre,Indonesia,0,1,,1,-75.527794,10.406342
11260,2012,Diciembre,Indonesia,9,17,,26,-74.140516,4.697157
11261,2012,Diciembre,Indonesia,2,1,,3,-75.42726,6.170465
11262,2012,Diciembre,Indonesia,0,7,,7,-72.453013,7.819
11263,2012,Diciembre,Irán,12,24,,36,-74.140516,4.697157
11264,2012,Diciembre,Irán,1,0,,1,-72.453013,7.819
11265,2012,Diciembre,República de Irlanda,0,1,,1,-69.941498,4.191162
11266,2012,Diciembre,República de Irlanda,12,10,,22,-77.35600000000001,0.81488
11267,2012,Diciembre,República de Irlanda,0,2,,2,-75.527794,10.406342
11268,2012,Diciembre,República de Irlanda,6,7,,13,-75.516486,10.446304
11269,2012,Diciembre,República de Irlanda,1,2,,3,-72.129595,11.360028999999999
11270,2012,Diciembre,República de Irlanda,2,6,,8,-76.532004,3.451668
11271,2012,Diciembre,República de Irlanda,52,120,,172,-74.140516,4.697157
11272,2012,Diciembre,República de Irlanda,0,1,,1,-75.736374,4.815189
11273,2012,Diciembre,República de Irlanda,6,8,,14,-75.42726,6.170465
11274,2012,Diciembre,República de Irlanda,1,1,,2,-72.453013,7.819
11275,2012,Diciembre,República de Irlanda,0,1,,1,-72.508188,7.927233
11276,2012,Diciembre,Islandia,2,1,,3,-77.35600000000001,0.81488
11277,2012,Diciembre,Islandia,1,3,,4,-75.516486,10.446304
11278,2012,Diciembre,Islandia,0,1,,1,-74.213989,11.247722999999999
11279,2012,Diciembre,Islandia,0,1,,1,-76.532004,3.451668
11280,2012,Diciembre,Islandia,7,6,,13,-74.140516,4.697157
11281,2012,Diciembre,Islandia,0,2,,2,-75.42726,6.170465
11282,2012,Diciembre,Islandia,0,1,,1,-72.453013,7.819
11283,2012,Diciembre,Isla de Man,10,16,,26,-77.35600000000001,0.81488
11284,2012,Diciembre,Isla de Man,8,21,,29,-75.516486,10.446304
11285,2012,Diciembre,Isla de Man,5,6,,11,-74.77647900000001,10.886686
11286,2012,Diciembre,Isla de Man,10,22,,32,-76.532004,3.451668
11287,2012,Diciembre,Isla de Man,1,1,,2,-75.76635300000001,4.45285
11288,2012,Diciembre,Isla de Man,55,132,,187,-74.140516,4.697157
11289,2012,Diciembre,Isla de Man,0,1,,1,-75.736374,4.815189
11290,2012,Diciembre,Isla de Man,15,60,,75,-75.42726,6.170465
11291,2012,Diciembre,Isla de Man,0,2,,2,-72.508188,7.927233
11292,2012,Diciembre,Isla Johnston,1,0,,1,-74.140516,4.697157
11293,2012,Diciembre,Israel,2,4,,6,-77.35600000000001,0.81488
11294,2012,Diciembre,Israel,0,4,,4,-75.527794,10.406342
11295,2012,Diciembre,Israel,12,27,,39,-75.516486,10.446304
11296,2012,Diciembre,Israel,0,5,,5,-74.77647900000001,10.886686
11297,2012,Diciembre,Israel,1,0,,1,-74.213989,11.247722999999999
11298,2012,Diciembre,Israel,3,15,,18,-76.532004,3.451668
11299,2012,Diciembre,Israel,1,0,,1,-75.76635300000001,4.45285
11300,2012,Diciembre,Israel,53,282,,335,-74.140516,4.697157
11301,2012,Diciembre,Israel,7,34,,41,-75.42726,6.170465
11302,2012,Diciembre,Israel,0,1,,1,-72.508188,7.927233
11303,2012,Diciembre,Israel,0,1,,1,-77.35002,8.63337
11304,2012,Diciembre,Islas Aland/Provincia de Finlandia,0,1,,1,-74.140516,4.697157
11305,2012,Diciembre,Italia,0,5,,5,-69.941498,4.191162
11306,2012,Diciembre,Italia,7,27,,34,-77.35600000000001,0.81488
11307,2012,Diciembre,Italia,7,16,,23,-75.527794,10.406342
11308,2012,Diciembre,Italia,39,128,,167,-75.516486,10.446304
11309,2012,Diciembre,Italia,6,16,,22,-74.77647900000001,10.886686
11310,2012,Diciembre,Italia,0,10,,10,-74.213989,11.247722999999999
11311,2012,Diciembre,Italia,9,17,,26,-72.129595,11.360028999999999
11312,2012,Diciembre,Italia,0,1,,1,-81.703935,12.574411099999999
11313,2012,Diciembre,Italia,11,8,,19,-81.70216500000001,12.5862
11314,2012,Diciembre,Italia,1,2,,3,-81.372937,13.338761300000002
11315,2012,Diciembre,Italia,25,95,,120,-76.532004,3.451668
11316,2012,Diciembre,Italia,562,1668,,2230,-74.140516,4.697157
11317,2012,Diciembre,Italia,0,3,,3,-75.736374,4.815189
11318,2012,Diciembre,Italia,30,106,,136,-75.42726,6.170465
11319,2012,Diciembre,Italia,0,1,,1,-77.401154,6.222551999999999
11320,2012,Diciembre,Italia,3,3,,6,-73.181317,7.1280470000000005
11321,2012,Diciembre,Italia,11,17,,28,-72.453013,7.819
11322,2012,Diciembre,Italia,5,2,,7,-72.508188,7.927233
11323,2012,Diciembre,Italia,2,2,,4,-77.35002,8.63337
11324,2012,Diciembre,Islas del Canal,0,1,,1,-75.516486,10.446304
11325,2012,Diciembre,Islas del Canal,0,2,,2,-75.736374,4.815189
11326,2012,Diciembre,Jamaica,2,2,,4,-75.516486,10.446304
11327,2012,Diciembre,Jamaica,1,3,,4,-74.77647900000001,10.886686
11328,2012,Diciembre,Jamaica,4,5,,9,-81.70216500000001,12.5862
11329,2012,Diciembre,Jamaica,1,2,,3,-76.532004,3.451668
11330,2012,Diciembre,Jamaica,6,22,,28,-74.140516,4.697157
11331,2012,Diciembre,Jamaica,0,1,,1,-75.736374,4.815189
11332,2012,Diciembre,Jamaica,2,7,,9,-75.42726,6.170465
11333,2012,Diciembre,Japón,6,10,,16,-77.35600000000001,0.81488
11334,2012,Diciembre,Japón,4,5,,9,-75.516486,10.446304
11335,2012,Diciembre,Japón,0,6,,6,-74.77647900000001,10.886686
11336,2012,Diciembre,Japón,0,2,,2,-72.129595,11.360028999999999
11337,2012,Diciembre,Japón,1,2,,3,-81.70216500000001,12.5862
11338,2012,Diciembre,Japón,9,14,,23,-76.532004,3.451668
11339,2012,Diciembre,Japón,154,323,,477,-74.140516,4.697157
11340,2012,Diciembre,Japón,1,2,,3,-75.736374,4.815189
11341,2012,Diciembre,Japón,6,26,,32,-75.42726,6.170465
11342,2012,Diciembre,Japón,3,5,,8,-72.453013,7.819
11343,2012,Diciembre,Japón,0,1,,1,-77.35002,8.63337
11344,2012,Diciembre,Jordania,5,6,,11,-74.140516,4.697157
11345,2012,Diciembre,Kazajistán,1,2,,3,-74.140516,4.697157
11346,2012,Diciembre,Kazajistán,1,0,,1,-75.42726,6.170465
11347,2012,Diciembre,Kenia,0,1,,1,-72.129595,11.360028999999999
11348,2012,Diciembre,Kenia,2,6,,8,-74.140516,4.697157
11349,2012,Diciembre,Kirguistán,0,1,,1,-74.140516,4.697157
11350,2012,Diciembre,Kuwait,0,6,,6,-74.140516,4.697157
11351,2012,Diciembre,Letonia,0,1,,1,-75.527794,10.406342
11352,2012,Diciembre,Letonia,0,3,,3,-74.765343,10.970933
11353,2012,Diciembre,Letonia,0,1,,1,-77.061029,3.8844260000000004
11354,2012,Diciembre,Letonia,7,6,,13,-74.140516,4.697157
11355,2012,Diciembre,Letonia,3,4,,7,-75.42726,6.170465
11356,2012,Diciembre,Lituania,0,1,,1,-75.516486,10.446304
11357,2012,Diciembre,Lituania,1,0,,1,-76.532004,3.451668
11358,2012,Diciembre,Lituania,11,8,,19,-74.140516,4.697157
11359,2012,Diciembre,Lituania,1,1,,2,-75.42726,6.170465
11360,2012,Diciembre,Líbano,1,0,,1,-77.35600000000001,0.81488
11361,2012,Diciembre,Líbano,0,2,,2,-75.516486,10.446304
11362,2012,Diciembre,Líbano,1,1,,2,-74.77647900000001,10.886686
11363,2012,Diciembre,Líbano,5,3,,8,-72.129595,11.360028999999999
11364,2012,Diciembre,Líbano,10,28,,38,-74.140516,4.697157
11365,2012,Diciembre,Líbano,0,1,,1,-72.453013,7.819
11366,2012,Diciembre,Libia,0,7,,7,-74.140516,4.697157
11367,2012,Diciembre,Liechtenstein,4,6,,10,-74.140516,4.697157
11368,2012,Diciembre,Luxemburgo,4,12,,16,-74.140516,4.697157
11369,2012,Diciembre,Luxemburgo,1,0,,1,-72.453013,7.819
11370,2012,Diciembre,Luxemburgo,0,1,,1,-77.35002,8.63337
11371,2012,Diciembre,Macedonia,1,0,,1,-74.140516,4.697157
11372,2012,Diciembre,Madagascar,0,1,,1,-76.532004,3.451668
11373,2012,Diciembre,Malasia,1,0,,1,-69.941498,4.191162
11374,2012,Diciembre,Malasia,0,2,,2,-75.516486,10.446304
11375,2012,Diciembre,Malasia,9,23,,32,-74.140516,4.697157
11376,2012,Diciembre,Malasia,1,2,,3,-75.42726,6.170465
11377,2012,Diciembre,Malta,0,1,,1,-75.516486,10.446304
11378,2012,Diciembre,Malta,1,4,,5,-74.140516,4.697157
11379,2012,Diciembre,Marruecos,0,6,,6,-74.140516,4.697157
11380,2012,Diciembre,Mauricio,1,2,,3,-74.140516,4.697157
11381,2012,Diciembre,Mauritania,0,1,,1,-75.516486,10.446304
11382,2012,Diciembre,México,0,1,,1,-69.941498,4.191162
11383,2012,Diciembre,México,0,2,,2,-76.876446,0.33002
11384,2012,Diciembre,México,23,27,,50,-77.35600000000001,0.81488
11385,2012,Diciembre,México,9,6,,15,-75.527794,10.406342
11386,2012,Diciembre,México,195,250,,445,-75.516486,10.446304
11387,2012,Diciembre,México,23,70,,93,-74.77647900000001,10.886686
11388,2012,Diciembre,México,4,9,,13,-72.129595,11.360028999999999
11389,2012,Diciembre,México,3,3,,6,-81.70216500000001,12.5862
11390,2012,Diciembre,México,88,164,,252,-76.532004,3.451668
11391,2012,Diciembre,México,2107,3995,,6102,-74.140516,4.697157
11392,2012,Diciembre,México,9,19,,28,-75.736374,4.815189
11393,2012,Diciembre,México,151,316,,467,-75.42726,6.170465
11394,2012,Diciembre,México,1,0,,1,-67.48402800000001,6.185536
11395,2012,Diciembre,México,0,1,,1,-70.74025300000001,7.088728999999999
11396,2012,Diciembre,México,16,17,,33,-73.181317,7.1280470000000005
11397,2012,Diciembre,México,7,31,,38,-72.453013,7.819
11398,2012,Diciembre,México,13,42,,55,-72.508188,7.927233
11399,2012,Diciembre,México,2,5,,7,-77.35002,8.63337
11400,2012,Diciembre,República de Moldavia,1,0,,1,-76.532004,3.451668
11401,2012,Diciembre,República de Moldavia,0,1,,1,-74.140516,4.697157
11402,2012,Diciembre,Mónaco,3,0,,3,-74.140516,4.697157
11403,2012,Diciembre,Mongolia,1,0,,1,-74.140516,4.697157
11404,2012,Diciembre,Montenegro,0,1,,1,-75.42726,6.170465
11405,2012,Diciembre,Mozambique,1,4,,5,-74.140516,4.697157
11406,2012,Diciembre,Nepal,1,1,,2,-74.140516,4.697157
11407,2012,Diciembre,Nicaragua,1,0,,1,-77.35600000000001,0.81488
11408,2012,Diciembre,Nicaragua,5,10,,15,-75.516486,10.446304
11409,2012,Diciembre,Nicaragua,2,3,,5,-74.77647900000001,10.886686
11410,2012,Diciembre,Nicaragua,0,2,,2,-81.703935,12.574411099999999
11411,2012,Diciembre,Nicaragua,1,0,,1,-81.70216500000001,12.5862
11412,2012,Diciembre,Nicaragua,3,5,,8,-76.532004,3.451668
11413,2012,Diciembre,Nicaragua,44,46,,90,-74.140516,4.697157
11414,2012,Diciembre,Nicaragua,1,0,,1,-75.736374,4.815189
11415,2012,Diciembre,Nicaragua,10,17,,27,-75.42726,6.170465
11416,2012,Diciembre,Nicaragua,1,1,,2,-73.181317,7.1280470000000005
11417,2012,Diciembre,Nigeria,0,1,,1,-77.35600000000001,0.81488
11418,2012,Diciembre,Nigeria,0,2,,2,-75.516486,10.446304
11419,2012,Diciembre,Nigeria,2,7,,9,-74.140516,4.697157
11420,2012,Diciembre,Noruega,3,4,,7,-77.35600000000001,0.81488
11421,2012,Diciembre,Noruega,4,3,,7,-75.527794,10.406342
11422,2012,Diciembre,Noruega,11,20,,31,-75.516486,10.446304
11423,2012,Diciembre,Noruega,2,6,,8,-74.77647900000001,10.886686
11424,2012,Diciembre,Noruega,0,1,,1,-74.213989,11.247722999999999
11425,2012,Diciembre,Noruega,10,12,,22,-76.532004,3.451668
11426,2012,Diciembre,Noruega,150,200,,350,-74.140516,4.697157
11427,2012,Diciembre,Noruega,10,8,,18,-75.42726,6.170465
11428,2012,Diciembre,Noruega,0,5,,5,-72.453013,7.819
11429,2012,Diciembre,Nueva Zelanda,1,1,,2,-69.941498,4.191162
11430,2012,Diciembre,Nueva Zelanda,4,11,,15,-77.35600000000001,0.81488
11431,2012,Diciembre,Nueva Zelanda,3,14,,17,-75.516486,10.446304
11432,2012,Diciembre,Nueva Zelanda,1,2,,3,-74.77647900000001,10.886686
11433,2012,Diciembre,Nueva Zelanda,1,7,,8,-72.129595,11.360028999999999
11434,2012,Diciembre,Nueva Zelanda,1,3,,4,-76.532004,3.451668
11435,2012,Diciembre,Nueva Zelanda,43,81,,124,-74.140516,4.697157
11436,2012,Diciembre,Nueva Zelanda,0,2,,2,-75.736374,4.815189
11437,2012,Diciembre,Nueva Zelanda,2,9,,11,-75.42726,6.170465
11438,2012,Diciembre,Nueva Zelanda,2,0,,2,-72.453013,7.819
11439,2012,Diciembre,Nueva Zelanda,2,4,,6,-77.35002,8.63337
11440,2012,Diciembre,Omán,1,0,,1,-74.140516,4.697157
11441,2012,Diciembre,Nueva Zelanda,2,8,,10,-75.527794,10.406342
11442,2012,Diciembre,Nueva Zelanda,0,1,,1,-74.213989,11.247722999999999
11443,2012,Diciembre,Nueva Zelanda,1,1,,2,-81.372937,13.338761300000002
11444,2012,Diciembre,Nueva Zelanda,5,4,,9,-74.140516,4.697157
11445,2012,Diciembre,Nueva Zelanda,0,1,,1,-72.453013,7.819
11446,2012,Diciembre,Países Bajos,0,2,,2,-69.941498,4.191162
11447,2012,Diciembre,Países Bajos,1,1,,2,-76.876446,0.33002
11448,2012,Diciembre,Países Bajos,4,7,,11,-77.35600000000001,0.81488
11449,2012,Diciembre,Países Bajos,3,8,,11,-75.516486,10.446304
11450,2012,Diciembre,Países Bajos,5,9,,14,-74.77647900000001,10.886686
11451,2012,Diciembre,Países Bajos,3,1,,4,-72.129595,11.360028999999999
11452,2012,Diciembre,Países Bajos,26,39,,65,-72.919186,11.52863
11453,2012,Diciembre,Países Bajos,5,18,,23,-76.532004,3.451668
11454,2012,Diciembre,Países Bajos,33,47,,80,-75.76635300000001,4.45285
11455,2012,Diciembre,Países Bajos,207,349,,556,-74.140516,4.697157
11456,2012,Diciembre,Países Bajos,133,206,,339,-75.42726,6.170465
11457,2012,Diciembre,Países Bajos,11,9,,20,-73.181317,7.1280470000000005
11458,2012,Diciembre,Países Bajos,1,7,,8,-72.453013,7.819
11459,2012,Diciembre,Países Bajos,2,0,,2,-72.508188,7.927233
11460,2012,Diciembre,Pakistán,0,1,,1,-77.35600000000001,0.81488
11461,2012,Diciembre,Pakistán,0,1,,1,-72.129595,11.360028999999999
11462,2012,Diciembre,Pakistán,0,11,,11,-74.140516,4.697157
11463,2012,Diciembre,Pakistán,0,1,,1,-72.453013,7.819
11464,2012,Diciembre,Panamá,1,0,,1,-76.876446,0.33002
11465,2012,Diciembre,Panamá,2,11,,13,-75.527794,10.406342
11466,2012,Diciembre,Panamá,237,290,,527,-75.516486,10.446304
11467,2012,Diciembre,Panamá,120,175,,295,-74.77647900000001,10.886686
11468,2012,Diciembre,Panamá,0,3,,3,-72.129595,11.360028999999999
11469,2012,Diciembre,Panamá,0,5,,5,-81.703935,12.574411099999999
11470,2012,Diciembre,Panamá,34,31,,65,-81.70216500000001,12.5862
11471,2012,Diciembre,Panamá,133,254,,387,-76.532004,3.451668
11472,2012,Diciembre,Panamá,515,835,,1350,-74.140516,4.697157
11473,2012,Diciembre,Panamá,64,99,,163,-75.736374,4.815189
11474,2012,Diciembre,Panamá,183,335,,518,-75.42726,6.170465
11475,2012,Diciembre,Panamá,9,3,,12,-77.401154,6.222551999999999
11476,2012,Diciembre,Panamá,7,14,,21,-73.181317,7.1280470000000005
11477,2012,Diciembre,Panamá,2,8,,10,-72.453013,7.819
11478,2012,Diciembre,Panamá,6,18,,24,-72.508188,7.927233
11479,2012,Diciembre,Panamá,11,14,,25,-77.35002,8.63337
11480,2012,Diciembre,Paraguay,2,0,,2,-75.527794,10.406342
11481,2012,Diciembre,Paraguay,22,12,,34,-75.516486,10.446304
11482,2012,Diciembre,Paraguay,0,12,,12,-74.77647900000001,10.886686
11483,2012,Diciembre,Paraguay,1,2,,3,-72.129595,11.360028999999999
11484,2012,Diciembre,Paraguay,7,5,,12,-76.532004,3.451668
11485,2012,Diciembre,Paraguay,50,54,,104,-74.140516,4.697157
11486,2012,Diciembre,Paraguay,1,0,,1,-75.736374,4.815189
11487,2012,Diciembre,Paraguay,11,7,,18,-75.42726,6.170465
11488,2012,Diciembre,Paraguay,1,0,,1,-70.74025300000001,7.088728999999999
11489,2012,Diciembre,Paraguay,1,2,,3,-72.453013,7.819
11490,2012,Diciembre,Paraguay,0,1,,1,-72.508188,7.927233
11491,2012,Diciembre,Perú,25,22,,47,-69.941498,4.191162
11492,2012,Diciembre,Perú,145,346,,491,-77.35600000000001,0.81488
11493,2012,Diciembre,Perú,13,14,,27,-75.527794,10.406342
11494,2012,Diciembre,Perú,130,106,,236,-75.516486,10.446304
11495,2012,Diciembre,Perú,26,37,,63,-74.77647900000001,10.886686
11496,2012,Diciembre,Perú,17,42,,59,-72.129595,11.360028999999999
11497,2012,Diciembre,Perú,105,67,,172,-81.70216500000001,12.5862
11498,2012,Diciembre,Perú,95,148,,243,-76.532004,3.451668
11499,2012,Diciembre,Perú,0,1,,1,-75.76635300000001,4.45285
11500,2012,Diciembre,Perú,1992,2832,,4824,-74.140516,4.697157
11501,2012,Diciembre,Perú,0,7,,7,-75.736374,4.815189
11502,2012,Diciembre,Perú,130,255,,385,-75.42726,6.170465
11503,2012,Diciembre,Perú,0,3,,3,-67.48402800000001,6.185536
11504,2012,Diciembre,Perú,2,2,,4,-73.181317,7.1280470000000005
11505,2012,Diciembre,Perú,50,98,,148,-72.453013,7.819
11506,2012,Diciembre,Perú,3,5,,8,-72.508188,7.927233
11507,2012,Diciembre,Perú,0,1,,1,-77.35002,8.63337
11508,2012,Diciembre,Palestina,1,0,,1,-74.140516,4.697157
11509,2012,Diciembre,Polonia,1,3,,4,-69.941498,4.191162
11510,2012,Diciembre,Polonia,5,6,,11,-77.35600000000001,0.81488
11511,2012,Diciembre,Polonia,1,18,,19,-75.527794,10.406342
11512,2012,Diciembre,Polonia,6,3,,9,-75.516486,10.446304
11513,2012,Diciembre,Polonia,2,1,,3,-74.77647900000001,10.886686
11514,2012,Diciembre,Polonia,0,2,,2,-74.765343,10.970933
11515,2012,Diciembre,Polonia,1,2,,3,-76.532004,3.451668
11516,2012,Diciembre,Polonia,81,89,,170,-74.140516,4.697157
11517,2012,Diciembre,Polonia,1,2,,3,-75.42726,6.170465
11518,2012,Diciembre,Polonia,0,3,,3,-72.453013,7.819
11519,2012,Diciembre,Polonia,0,2,,2,-77.35002,8.63337
11520,2012,Diciembre,Portugal,4,2,,6,-77.35600000000001,0.81488
11521,2012,Diciembre,Portugal,0,4,,4,-75.527794,10.406342
11522,2012,Diciembre,Portugal,2,4,,6,-75.516486,10.446304
11523,2012,Diciembre,Portugal,0,5,,5,-72.129595,11.360028999999999
11524,2012,Diciembre,Portugal,5,22,,27,-76.532004,3.451668
11525,2012,Diciembre,Portugal,81,271,,352,-74.140516,4.697157
11526,2012,Diciembre,Portugal,7,16,,23,-75.42726,6.170465
11527,2012,Diciembre,Portugal,0,1,,1,-73.181317,7.1280470000000005
11528,2012,Diciembre,Portugal,1,2,,3,-72.453013,7.819
11529,2012,Diciembre,Portugal,0,1,,1,-72.508188,7.927233
11530,2012,Diciembre,Qatar,0,5,,5,-74.140516,4.697157
11531,2012,Diciembre,Reino Unido de Gran Bretaña e Irlanda del Norte,3,4,,7,-69.941498,4.191162
11532,2012,Diciembre,Reino Unido de Gran Bretaña e Irlanda del Norte,3,3,,6,-77.35600000000001,0.81488
11533,2012,Diciembre,Reino Unido de Gran Bretaña e Irlanda del Norte,0,1,,1,-75.527794,10.406342
11534,2012,Diciembre,Reino Unido de Gran Bretaña e Irlanda del Norte,21,56,,77,-75.516486,10.446304
11535,2012,Diciembre,Reino Unido de Gran Bretaña e Irlanda del Norte,0,2,,2,-74.77647900000001,10.886686
11536,2012,Diciembre,Reino Unido de Gran Bretaña e Irlanda del Norte,0,1,,1,-74.765343,10.970933
11537,2012,Diciembre,Reino Unido de Gran Bretaña e Irlanda del Norte,0,1,,1,-74.213989,11.247722999999999
11538,2012,Diciembre,Reino Unido de Gran Bretaña e Irlanda del Norte,1,3,,4,-72.129595,11.360028999999999
11539,2012,Diciembre,Reino Unido de Gran Bretaña e Irlanda del Norte,0,2,,2,-81.70216500000001,12.5862
11540,2012,Diciembre,Reino Unido de Gran Bretaña e Irlanda del Norte,10,17,,27,-76.532004,3.451668
11541,2012,Diciembre,Reino Unido de Gran Bretaña e Irlanda del Norte,1,1,,2,-75.76635300000001,4.45285
11542,2012,Diciembre,Reino Unido de Gran Bretaña e Irlanda del Norte,268,604,,872,-74.140516,4.697157
11543,2012,Diciembre,Reino Unido de Gran Bretaña e Irlanda del Norte,1,1,,2,-75.736374,4.815189
11544,2012,Diciembre,Reino Unido de Gran Bretaña e Irlanda del Norte,9,41,,50,-75.42726,6.170465
11545,2012,Diciembre,Reino Unido de Gran Bretaña e Irlanda del Norte,0,1,,1,-73.181317,7.1280470000000005
11546,2012,Diciembre,Reino Unido de Gran Bretaña e Irlanda del Norte,1,6,,7,-72.453013,7.819
11547,2012,Diciembre,Reino Unido de Gran Bretaña e Irlanda del Norte,0,2,,2,-72.508188,7.927233
11548,2012,Diciembre,República CentroÁfricana,1,0,,1,-74.140516,4.697157
11549,2012,Diciembre,República de Belarús,2,0,,2,-74.140516,4.697157
11550,2012,Diciembre,República Dominicana,5,15,,20,-77.35600000000001,0.81488
11551,2012,Diciembre,República Dominicana,0,2,,2,-75.527794,10.406342
11552,2012,Diciembre,República Dominicana,18,20,,38,-75.516486,10.446304
11553,2012,Diciembre,República Dominicana,14,34,,48,-74.77647900000001,10.886686
11554,2012,Diciembre,República Dominicana,0,7,,7,-72.129595,11.360028999999999
11555,2012,Diciembre,República Dominicana,0,2,,2,-81.70216500000001,12.5862
11556,2012,Diciembre,República Dominicana,11,55,,66,-76.532004,3.451668
11557,2012,Diciembre,República Dominicana,1,0,,1,-75.76635300000001,4.45285
11558,2012,Diciembre,República Dominicana,197,341,,538,-74.140516,4.697157
11559,2012,Diciembre,República Dominicana,10,8,,18,-75.736374,4.815189
11560,2012,Diciembre,República Dominicana,39,61,,100,-75.42726,6.170465
11561,2012,Diciembre,República Dominicana,1,1,,2,-73.181317,7.1280470000000005
11562,2012,Diciembre,República Dominicana,0,5,,5,-72.453013,7.819
11563,2012,Diciembre,República Dominicana,2,5,,7,-72.508188,7.927233
11564,2012,Diciembre,República Checa,2,3,,5,-75.527794,10.406342
11565,2012,Diciembre,República Checa,1,0,,1,-72.129595,11.360028999999999
11566,2012,Diciembre,República Checa,3,3,,6,-74.140516,4.697157
11567,2012,Diciembre,República Checa,1,1,,2,-72.453013,7.819
11568,2012,Diciembre,Rumania,1,0,,1,-77.35600000000001,0.81488
11569,2012,Diciembre,Rumania,1,4,,5,-75.527794,10.406342
11570,2012,Diciembre,Rumania,1,2,,3,-75.516486,10.446304
11571,2012,Diciembre,Rumania,0,4,,4,-72.129595,11.360028999999999
11572,2012,Diciembre,Rumania,2,0,,2,-76.532004,3.451668
11573,2012,Diciembre,Rumania,28,62,,90,-74.140516,4.697157
11574,2012,Diciembre,Rumania,6,2,,8,-75.42726,6.170465
11575,2012,Diciembre,Federación de Rusia,1,0,,1,-77.35600000000001,0.81488
11576,2012,Diciembre,Federación de Rusia,0,1,,1,-75.527794,10.406342
11577,2012,Diciembre,Federación de Rusia,2,3,,5,-75.516486,10.446304
11578,2012,Diciembre,Federación de Rusia,0,1,,1,-74.765343,10.970933
11579,2012,Diciembre,Federación de Rusia,1,0,,1,-81.70216500000001,12.5862
11580,2012,Diciembre,Federación de Rusia,2,4,,6,-76.532004,3.451668
11581,2012,Diciembre,Federación de Rusia,26,45,,71,-74.140516,4.697157
11582,2012,Diciembre,Federación de Rusia,2,1,,3,-75.42726,6.170465
11583,2012,Diciembre,Federación de Rusia,1,0,,1,-72.453013,7.819
11584,2012,Diciembre,San Marino,0,3,,3,-74.140516,4.697157
11585,2012,Diciembre,San  Vicente y las Granadinas,0,1,,1,-74.213989,11.247722999999999
11586,2012,Diciembre,San  Vicente y las Granadinas,1,0,,1,-76.532004,3.451668
11587,2012,Diciembre,Santa Lucia,2,1,,3,-77.35600000000001,0.81488
11588,2012,Diciembre,Santa Lucia,4,1,,5,-75.516486,10.446304
11589,2012,Diciembre,Santa Lucia,0,1,,1,-81.70216500000001,12.5862
11590,2012,Diciembre,Santa Lucia,0,1,,1,-73.181317,7.1280470000000005
11591,2012,Diciembre,Santa Sede/Ciudad del Vaticano,0,1,,1,-74.140516,4.697157
11592,2012,Diciembre,Senegal,0,1,,1,-77.35600000000001,0.81488
11593,2012,Diciembre,Senegal,0,3,,3,-74.140516,4.697157
11594,2012,Diciembre,Serbia,7,10,,17,-74.140516,4.697157
11595,2012,Diciembre,Serbia,1,2,,3,-75.42726,6.170465
11596,2012,Diciembre,Singapur,6,14,,20,-74.140516,4.697157
11597,2012,Diciembre,Singapur,0,2,,2,-75.42726,6.170465
11598,2012,Diciembre,República Árabe Siria,0,1,,1,-72.129595,11.360028999999999
11599,2012,Diciembre,República Árabe Siria,1,1,,2,-74.140516,4.697157
11600,2012,Diciembre,Sri Lanka,0,1,,1,-75.516486,10.446304
11601,2012,Diciembre,Sri Lanka,0,1,,1,-75.42726,6.170465
11602,2012,Diciembre,Sudáfrica,3,1,,4,-77.35600000000001,0.81488
11603,2012,Diciembre,Sudáfrica,2,3,,5,-75.527794,10.406342
11604,2012,Diciembre,Sudáfrica,3,1,,4,-75.516486,10.446304
11605,2012,Diciembre,Sudáfrica,1,2,,3,-74.77647900000001,10.886686
11606,2012,Diciembre,Sudáfrica,0,1,,1,-81.70216500000001,12.5862
11607,2012,Diciembre,Sudáfrica,0,2,,2,-76.532004,3.451668
11608,2012,Diciembre,Sudáfrica,24,59,,83,-74.140516,4.697157
11609,2012,Diciembre,Sudáfrica,2,7,,9,-75.42726,6.170465
11610,2012,Diciembre,Suecia,1,0,,1,-69.941498,4.191162
11611,2012,Diciembre,Suecia,0,1,,1,-76.876446,0.33002
11612,2012,Diciembre,Suecia,11,13,,24,-77.35600000000001,0.81488
11613,2012,Diciembre,Suecia,3,6,,9,-75.527794,10.406342
11614,2012,Diciembre,Suecia,11,19,,30,-75.516486,10.446304
11615,2012,Diciembre,Suecia,2,4,,6,-74.77647900000001,10.886686
11616,2012,Diciembre,Suecia,0,1,,1,-74.213989,11.247722999999999
11617,2012,Diciembre,Suecia,1,2,,3,-72.129595,11.360028999999999
11618,2012,Diciembre,Suecia,0,1,,1,-81.70216500000001,12.5862
11619,2012,Diciembre,Suecia,1,1,,2,-81.372937,13.338761300000002
11620,2012,Diciembre,Suecia,12,19,,31,-76.532004,3.451668
11621,2012,Diciembre,Suecia,0,4,,4,-77.061029,3.8844260000000004
11622,2012,Diciembre,Suecia,311,478,,789,-74.140516,4.697157
11623,2012,Diciembre,Suecia,0,1,,1,-75.736374,4.815189
11624,2012,Diciembre,Suecia,7,28,,35,-75.42726,6.170465
11625,2012,Diciembre,Suecia,4,4,,8,-72.453013,7.819
11626,2012,Diciembre,Suecia,0,1,,1,-77.35002,8.63337
11627,2012,Diciembre,Suiza,5,4,,9,-69.941498,4.191162
11628,2012,Diciembre,Suiza,20,26,,46,-77.35600000000001,0.81488
11629,2012,Diciembre,Suiza,13,15,,28,-75.527794,10.406342
11630,2012,Diciembre,Suiza,22,39,,61,-75.516486,10.446304
11631,2012,Diciembre,Suiza,7,8,,15,-74.77647900000001,10.886686
11632,2012,Diciembre,Suiza,1,0,,1,-74.213989,11.247722999999999
11633,2012,Diciembre,Suiza,5,3,,8,-72.129595,11.360028999999999
11634,2012,Diciembre,Suiza,2,0,,2,-81.70216500000001,12.5862
11635,2012,Diciembre,Suiza,20,49,,69,-76.532004,3.451668
11636,2012,Diciembre,Suiza,419,780,,1199,-74.140516,4.697157
11637,2012,Diciembre,Suiza,0,1,,1,-75.736374,4.815189
11638,2012,Diciembre,Suiza,30,48,,78,-75.42726,6.170465
11639,2012,Diciembre,Suiza,1,0,,1,-67.48402800000001,6.185536
11640,2012,Diciembre,Suiza,4,2,,6,-73.181317,7.1280470000000005
11641,2012,Diciembre,Suiza,1,3,,4,-72.453013,7.819
11642,2012,Diciembre,Suiza,0,1,,1,-72.508188,7.927233
11643,2012,Diciembre,Suiza,1,2,,3,-77.35002,8.63337
11644,2012,Diciembre,Surinam,0,1,,1,-72.129595,11.360028999999999
11645,2012,Diciembre,Surinam,3,0,,3,-74.140516,4.697157
11646,2012,Diciembre,Surinam,0,1,,1,-75.42726,6.170465
11647,2012,Diciembre,Taiwán,2,0,,2,-75.527794,10.406342
11648,2012,Diciembre,Taiwán,2,4,,6,-74.140516,4.697157
11649,2012,Diciembre,Taiwán,2,1,,3,-72.453013,7.819
11650,2012,Diciembre,Tailandia,1,1,,2,-77.35600000000001,0.81488
11651,2012,Diciembre,Tailandia,0,3,,3,-76.532004,3.451668
11652,2012,Diciembre,Tailandia,0,4,,4,-74.140516,4.697157
11653,2012,Diciembre,Tíbet/Región Autónoma de China,0,2,,2,-74.140516,4.697157
11654,2012,Diciembre,Territorio Antártico Británico/Territorio Británico de Ultramar,2,3,,5,-74.140516,4.697157
11655,2012,Diciembre,Territorio Antártico Británico/Territorio Británico de Ultramar,0,1,,1,-75.42726,6.170465
11656,2012,Diciembre,Tanzania,0,3,,3,-74.140516,4.697157
11657,2012,Diciembre,Trinidad y Tobago,4,9,,13,-75.516486,10.446304
11658,2012,Diciembre,Trinidad y Tobago,0,1,,1,-74.77647900000001,10.886686
11659,2012,Diciembre,Trinidad y Tobago,0,2,,2,-72.129595,11.360028999999999
11660,2012,Diciembre,Trinidad y Tobago,0,2,,2,-81.703935,12.574411099999999
11661,2012,Diciembre,Trinidad y Tobago,3,7,,10,-76.532004,3.451668
11662,2012,Diciembre,Trinidad y Tobago,40,36,,76,-74.140516,4.697157
11663,2012,Diciembre,Trinidad y Tobago,0,2,,2,-75.736374,4.815189
11664,2012,Diciembre,Trinidad y Tobago,5,16,,21,-75.42726,6.170465
11665,2012,Diciembre,Trinidad y Tobago,1,1,,2,-72.453013,7.819
11666,2012,Diciembre,Trinidad y Tobago,1,2,,3,-72.508188,7.927233
11667,2012,Diciembre,Túnez,1,0,,1,-75.516486,10.446304
11668,2012,Diciembre,Túnez,0,2,,2,-74.140516,4.697157
11669,2012,Diciembre,Túnez,0,1,,1,-75.42726,6.170465
11670,2012,Diciembre,Turquía,0,1,,1,-69.941498,4.191162
11671,2012,Diciembre,Turquía,1,0,,1,-77.35600000000001,0.81488
11672,2012,Diciembre,Turquía,1,1,,2,-75.527794,10.406342
11673,2012,Diciembre,Turquía,0,5,,5,-75.516486,10.446304
11674,2012,Diciembre,Turquía,0,6,,6,-74.765343,10.970933
11675,2012,Diciembre,Turquía,1,3,,4,-76.532004,3.451668
11676,2012,Diciembre,Turquía,31,80,,111,-74.140516,4.697157
11677,2012,Diciembre,Turquía,0,4,,4,-75.42726,6.170465
11678,2012,Diciembre,Turquía,0,1,,1,-73.181317,7.1280470000000005
11679,2012,Diciembre,Turquía,0,2,,2,-72.453013,7.819
11680,2012,Diciembre,Turquía,0,1,,1,-77.35002,8.63337
11681,2012,Diciembre,Ucrania,0,1,,1,-75.527794,10.406342
11682,2012,Diciembre,Ucrania,1,2,,3,-75.516486,10.446304
11683,2012,Diciembre,Ucrania,3,1,,4,-76.532004,3.451668
11684,2012,Diciembre,Ucrania,20,30,,50,-74.140516,4.697157
11685,2012,Diciembre,Ucrania,0,1,,1,-73.181317,7.1280470000000005
11686,2012,Diciembre,Federación de Rusia,0,2,,2,-69.941498,4.191162
11687,2012,Diciembre,Federación de Rusia,3,8,,11,-77.35600000000001,0.81488
11688,2012,Diciembre,Federación de Rusia,2,37,,39,-75.527794,10.406342
11689,2012,Diciembre,Federación de Rusia,7,5,,12,-75.516486,10.446304
11690,2012,Diciembre,Federación de Rusia,0,5,,5,-74.765343,10.970933
11691,2012,Diciembre,Federación de Rusia,109,138,,247,-74.140516,4.697157
11692,2012,Diciembre,Federación de Rusia,5,4,,9,-75.42726,6.170465
11693,2012,Diciembre,Federación de Rusia,3,5,,8,-72.453013,7.819
11694,2012,Diciembre,Federación de Rusia,0,3,,3,-75.68164200000001,9.402597
11695,2012,Diciembre,Uruguay,1,8,,9,-77.35600000000001,0.81488
11696,2012,Diciembre,Uruguay,1,6,,7,-75.527794,10.406342
11697,2012,Diciembre,Uruguay,50,46,,96,-75.516486,10.446304
11698,2012,Diciembre,Uruguay,6,6,,12,-74.77647900000001,10.886686
11699,2012,Diciembre,Uruguay,1,2,,3,-72.129595,11.360028999999999
11700,2012,Diciembre,Uruguay,25,15,,40,-81.70216500000001,12.5862
11701,2012,Diciembre,Uruguay,8,21,,29,-76.532004,3.451668
11702,2012,Diciembre,Uruguay,92,246,,338,-74.140516,4.697157
11703,2012,Diciembre,Uruguay,0,3,,3,-75.736374,4.815189
11704,2012,Diciembre,Uruguay,18,51,,69,-75.42726,6.170465
11705,2012,Diciembre,Uruguay,0,1,,1,-73.181317,7.1280470000000005
11706,2012,Diciembre,Uruguay,5,13,,18,-72.453013,7.819
11707,2012,Diciembre,Uruguay,1,0,,1,-72.508188,7.927233
11708,2012,Diciembre,Uruguay,0,3,,3,-77.35002,8.63337
11709,2012,Diciembre,Venezuela,0,1,,1,-69.941498,4.191162
11710,2012,Diciembre,Venezuela,0,2,,2,-76.876446,0.33002
11711,2012,Diciembre,Venezuela,66,95,,161,-77.35600000000001,0.81488
11712,2012,Diciembre,Venezuela,8,31,,39,-75.527794,10.406342
11713,2012,Diciembre,Venezuela,138,155,,293,-75.516486,10.446304
11714,2012,Diciembre,Venezuela,74,106,,180,-74.77647900000001,10.886686
11715,2012,Diciembre,Venezuela,3349,4331,,7680,-72.129595,11.360028999999999
11716,2012,Diciembre,Venezuela,2,3,,5,-72.919186,11.52863
11717,2012,Diciembre,Venezuela,10,9,,19,-81.70216500000001,12.5862
11718,2012,Diciembre,Venezuela,91,104,,195,-76.532004,3.451668
11719,2012,Diciembre,Venezuela,3,3,,6,-75.76635300000001,4.45285
11720,2012,Diciembre,Venezuela,6518,6896,,13414,-74.140516,4.697157
11721,2012,Diciembre,Venezuela,6,18,,24,-75.736374,4.815189
11722,2012,Diciembre,Venezuela,630,616,,1246,-75.42726,6.170465
11723,2012,Diciembre,Venezuela,174,236,,410,-67.48402800000001,6.185536
11724,2012,Diciembre,Venezuela,115,174,,289,-70.74025300000001,7.088728999999999
11725,2012,Diciembre,Venezuela,11,12,,23,-73.181317,7.1280470000000005
11726,2012,Diciembre,Venezuela,2675,3224,,5899,-72.453013,7.819
11727,2012,Diciembre,Venezuela,648,666,,1314,-72.508188,7.927233
11728,2012,Diciembre,Vietnam,8,8,,16,-74.140516,4.697157
11729,2012,Diciembre,Zambia,0,1,,1,-74.140516,4.697157
11730,2012,Diciembre,Reino Unido de Gran Bretaña e Irlanda del Norte,3,8,,11,-69.941498,4.191162
11731,2012,Diciembre,Reino Unido de Gran Bretaña e Irlanda del Norte,18,32,,50,-77.35600000000001,0.81488
11732,2012,Diciembre,Reino Unido de Gran Bretaña e Irlanda del Norte,20,28,,48,-75.527794,10.406342
11733,2012,Diciembre,Reino Unido de Gran Bretaña e Irlanda del Norte,29,37,,66,-75.516486,10.446304
11734,2012,Diciembre,Reino Unido de Gran Bretaña e Irlanda del Norte,0,2,,2,-74.77647900000001,10.886686
11735,2012,Diciembre,Reino Unido de Gran Bretaña e Irlanda del Norte,1,4,,5,-74.213989,11.247722999999999
11736,2012,Diciembre,Reino Unido de Gran Bretaña e Irlanda del Norte,0,6,,6,-72.129595,11.360028999999999
11737,2012,Diciembre,Reino Unido de Gran Bretaña e Irlanda del Norte,0,7,,7,-81.70216500000001,12.5862
11738,2012,Diciembre,Reino Unido de Gran Bretaña e Irlanda del Norte,2,2,,4,-81.372937,13.338761300000002
11739,2012,Diciembre,Reino Unido de Gran Bretaña e Irlanda del Norte,14,34,,48,-76.532004,3.451668
11740,2012,Diciembre,Reino Unido de Gran Bretaña e Irlanda del Norte,0,1,,1,-75.76635300000001,4.45285
11741,2012,Diciembre,Reino Unido de Gran Bretaña e Irlanda del Norte,362,853,,1215,-74.140516,4.697157
11742,2012,Diciembre,Reino Unido de Gran Bretaña e Irlanda del Norte,4,18,,22,-75.42726,6.170465
11743,2012,Diciembre,Reino Unido de Gran Bretaña e Irlanda del Norte,0,1,,1,-67.48402800000001,6.185536
11744,2012,Diciembre,Reino Unido de Gran Bretaña e Irlanda del Norte,0,1,,1,-73.181317,7.1280470000000005
11745,2012,Diciembre,Reino Unido de Gran Bretaña e Irlanda del Norte,0,1,,1,-72.453013,7.819
11746,2012,Diciembre,Reino Unido de Gran Bretaña e Irlanda del Norte,1,8,,9,-77.35002,8.63337
11747,2012,Diciembre,Países Bajos,0,1,,1,-69.941498,4.191162
11748,2012,Diciembre,Países Bajos,11,17,,28,-77.35600000000001,0.81488
11749,2012,Diciembre,Países Bajos,21,20,,41,-75.527794,10.406342
11750,2012,Diciembre,Países Bajos,11,35,,46,-75.516486,10.446304
11751,2012,Diciembre,Países Bajos,2,3,,5,-74.77647900000001,10.886686
11752,2012,Diciembre,Países Bajos,1,2,,3,-74.213989,11.247722999999999
11753,2012,Diciembre,Países Bajos,3,9,,12,-72.129595,11.360028999999999
11754,2012,Diciembre,Países Bajos,15,42,,57,-76.532004,3.451668
11755,2012,Diciembre,Países Bajos,2,4,,6,-75.76635300000001,4.45285
11756,2012,Diciembre,Países Bajos,467,922,,1389,-74.140516,4.697157
11757,2012,Diciembre,Países Bajos,1,2,,3,-75.736374,4.815189
11758,2012,Diciembre,Países Bajos,70,135,,205,-75.42726,6.170465
11759,2012,Diciembre,Países Bajos,2,3,,5,-73.181317,7.1280470000000005
11760,2012,Diciembre,Países Bajos,5,20,,25,-72.453013,7.819
11761,2012,Diciembre,Países Bajos,0,1,,1,-72.508188,7.927233
11762,2012,Diciembre,Países Bajos,0,2,,2,-76.7333,8.06667
11763,2012,Diciembre,Países Bajos,3,1,,4,-77.35002,8.63337
11764,2012,Diciembre,Eslovenia,0,1,,1,-74.140516,4.697157
11765,2012,Diciembre,Lituania,4,2,,6,-74.140516,4.697157
11766,2012,Diciembre,Reino Unido de Gran Bretaña e Irlanda del Norte,0,1,,1,-74.140516,4.697157
11767,2012,Diciembre,Reino Unido de Gran Bretaña e Irlanda del Norte,0,1,,1,-77.35600000000001,0.81488
11768,2012,Diciembre,Reino Unido de Gran Bretaña e Irlanda del Norte,3,5,,8,-75.527794,10.406342
11769,2012,Diciembre,Reino Unido de Gran Bretaña e Irlanda del Norte,1,1,,2,-75.516486,10.446304
11770,2012,Diciembre,Reino Unido de Gran Bretaña e Irlanda del Norte,1,0,,1,-74.213989,11.247722999999999
11771,2012,Diciembre,Reino Unido de Gran Bretaña e Irlanda del Norte,3,9,,12,-74.140516,4.697157
11772,2012,Diciembre,Marruecos,1,2,,3,-74.140516,4.697157
11773,2013,Enero,Albania,1,1,,2,-74.140516,4.697157
11774,2013,Enero,Alemania,8,9,,17,-69.941498,4.191162
11775,2013,Enero,Alemania,1,0,,1,-76.876446,0.33002
11776,2013,Enero,Alemania,61,82,,143,-77.35600000000001,0.81488
11777,2013,Enero,Alemania,18,20,,38,-75.527794,10.406342
11778,2013,Enero,Alemania,39,61,,100,-75.516486,10.446304
11779,2013,Enero,Alemania,10,7,,17,-74.77647900000001,10.886686
11780,2013,Enero,Alemania,1,1,,2,-74.213989,11.247722999999999
11781,2013,Enero,Alemania,12,8,,20,-72.129595,11.360028999999999
11782,2013,Enero,Alemania,0,1,,1,-72.919186,11.52863
11783,2013,Enero,Alemania,2,2,,4,-81.70216500000001,12.5862
11784,2013,Enero,Alemania,0,1,,1,-81.372937,13.338761300000002
11785,2013,Enero,Alemania,32,41,,73,-76.532004,3.451668
11786,2013,Enero,Alemania,0,1,,1,-77.061029,3.8844260000000004
11787,2013,Enero,Alemania,1,0,,1,-75.76635300000001,4.45285
11788,2013,Enero,Alemania,1257,1942,,3199,-74.140516,4.697157
11789,2013,Enero,Alemania,1,4,,5,-75.736374,4.815189
11790,2013,Enero,Alemania,50,97,,147,-75.42726,6.170465
11791,2013,Enero,Alemania,1,2,,3,-67.48402800000001,6.185536
11792,2013,Enero,Alemania,0,1,,1,-70.74025300000001,7.088728999999999
11793,2013,Enero,Alemania,1,3,,4,-73.181317,7.1280470000000005
11794,2013,Enero,Alemania,9,24,,33,-72.453013,7.819
11795,2013,Enero,Alemania,1,0,,1,-72.508188,7.927233
11796,2013,Enero,Alemania,7,14,,21,-77.35002,8.63337
11797,2013,Enero,Andorra,1,1,,2,-75.516486,10.446304
11798,2013,Enero,Andorra,0,1,,1,-74.77647900000001,10.886686
11799,2013,Enero,Andorra,4,7,,11,-74.140516,4.697157
11800,2013,Enero,Angola,0,9,,9,-74.140516,4.697157
11801,2013,Enero,Antigua y Barbuda,1,0,,1,-81.70216500000001,12.5862
11802,2013,Enero,Antigua y Barbuda,0,1,,1,-76.532004,3.451668
11803,2013,Enero,Antigua y Barbuda,1,0,,1,-75.42726,6.170465
11804,2013,Enero,Países Bajos,0,4,,4,-75.42726,6.170465
11805,2013,Enero,Países Bajos,0,1,,1,-73.181317,7.1280470000000005
11806,2013,Enero,Arabia Saudita,0,1,,1,-74.140516,4.697157
11807,2013,Enero,Arabia Saudita,0,1,,1,-75.42726,6.170465
11808,2013,Enero,Arabia Saudita,0,1,,1,-75.516486,10.446304
11809,2013,Enero,Arabia Saudita,0,1,,1,-76.532004,3.451668
11810,2013,Enero,Arabia Saudita,1,8,,9,-74.140516,4.697157
11811,2013,Enero,Argelia,0,6,,6,-74.140516,4.697157
11812,2013,Enero,Argentina,2,5,,7,-69.941498,4.191162
11813,2013,Enero,Argentina,0,1,,1,-76.876446,0.33002
11814,2013,Enero,Argentina,190,260,,450,-77.35600000000001,0.81488
11815,2013,Enero,Argentina,1,1,,2,-78.802679,18.00143
11816,2013,Enero,Argentina,98,64,,162,-75.527794,10.406342
11817,2013,Enero,Argentina,659,480,,1139,-75.516486,10.446304
11818,2013,Enero,Argentina,17,28,,45,-74.77647900000001,10.886686
11819,2013,Enero,Argentina,58,87,,145,-72.129595,11.360028999999999
11820,2013,Enero,Argentina,255,197,,452,-81.70216500000001,12.5862
11821,2013,Enero,Argentina,67,86,,153,-76.532004,3.451668
11822,2013,Enero,Argentina,5648,5894,,11542,-74.140516,4.697157
11823,2013,Enero,Argentina,1,4,,5,-75.736374,4.815189
11824,2013,Enero,Argentina,176,241,,417,-75.42726,6.170465
11825,2013,Enero,Argentina,0,2,,2,-67.48402800000001,6.185536
11826,2013,Enero,Argentina,21,42,,63,-72.453013,7.819
11827,2013,Enero,Argentina,1,5,,6,-72.508188,7.927233
11828,2013,Enero,Argentina,5,6,,11,-77.35002,8.63337
11829,2013,Enero,República de Armenia,1,1,,2,-72.508188,7.927233
11830,2013,Enero,Aruba,3,0,,3,-76.532004,3.451668
11831,2013,Enero,Aruba,2,4,,6,-74.140516,4.697157
11832,2013,Enero,Aruba,1,2,,3,-75.42726,6.170465
11833,2013,Enero,Australia,5,8,,13,-69.941498,4.191162
11834,2013,Enero,Australia,1,0,,1,-76.876446,0.33002
11835,2013,Enero,Australia,32,44,,76,-77.35600000000001,0.81488
11836,2013,Enero,Australia,35,42,,77,-75.527794,10.406342
11837,2013,Enero,Australia,38,49,,87,-75.516486,10.446304
11838,2013,Enero,Australia,7,10,,17,-74.77647900000001,10.886686
11839,2013,Enero,Australia,2,4,,6,-72.129595,11.360028999999999
11840,2013,Enero,Australia,0,1,,1,-81.70216500000001,12.5862
11841,2013,Enero,Australia,14,27,,41,-76.532004,3.451668
11842,2013,Enero,Australia,248,428,,676,-74.140516,4.697157
11843,2013,Enero,Australia,1,1,,2,-75.736374,4.815189
11844,2013,Enero,Australia,26,66,,92,-75.42726,6.170465
11845,2013,Enero,Australia,1,0,,1,-73.181317,7.1280470000000005
11846,2013,Enero,Australia,0,2,,2,-72.453013,7.819
11847,2013,Enero,Australia,0,1,,1,-72.508188,7.927233
11848,2013,Enero,Australia,3,13,,16,-77.35002,8.63337
11849,2013,Enero,Austria,13,17,,30,-77.35600000000001,0.81488
11850,2013,Enero,Austria,3,2,,5,-75.527794,10.406342
11851,2013,Enero,Austria,3,8,,11,-75.516486,10.446304
11852,2013,Enero,Austria,1,1,,2,-74.77647900000001,10.886686
11853,2013,Enero,Austria,2,1,,3,-72.129595,11.360028999999999
11854,2013,Enero,Austria,4,10,,14,-76.532004,3.451668
11855,2013,Enero,Austria,106,262,,368,-74.140516,4.697157
11856,2013,Enero,Austria,4,11,,15,-75.42726,6.170465
11857,2013,Enero,Austria,3,4,,7,-72.453013,7.819
11858,2013,Enero,Austria,2,1,,3,-77.35002,8.63337
11859,2013,Enero,Azerbaiyán,1,1,,2,-74.140516,4.697157
11860,2013,Enero,Bahamas,0,2,,2,-75.516486,10.446304
11861,2013,Enero,Bahamas,2,1,,3,-76.532004,3.451668
11862,2013,Enero,Bahamas,0,3,,3,-74.140516,4.697157
11863,2013,Enero,Bahamas,1,0,,1,-75.736374,4.815189
11864,2013,Enero,Bahamas,0,1,,1,-75.42726,6.170465
11865,2013,Enero,Bahréin,0,1,,1,-75.42726,6.170465
11866,2013,Enero,Bangladesh,2,4,,6,-74.140516,4.697157
11867,2013,Enero,Bangladesh,0,1,,1,-75.42726,6.170465
11868,2013,Enero,Barbados,7,2,,9,-74.140516,4.697157
11869,2013,Enero,República de Belarús,4,3,,7,-74.140516,4.697157
11870,2013,Enero,República de Belarús,0,1,,1,-75.42726,6.170465
11871,2013,Enero,Bélgica,1,4,,5,-69.941498,4.191162
11872,2013,Enero,Bélgica,0,1,,1,-76.876446,0.33002
11873,2013,Enero,Bélgica,13,12,,25,-77.35600000000001,0.81488
11874,2013,Enero,Bélgica,1,2,,3,-75.527794,10.406342
11875,2013,Enero,Bélgica,4,12,,16,-75.516486,10.446304
11876,2013,Enero,Bélgica,0,1,,1,-74.77647900000001,10.886686
11877,2013,Enero,Bélgica,1,3,,4,-72.129595,11.360028999999999
11878,2013,Enero,Bélgica,0,1,,1,-81.70216500000001,12.5862
11879,2013,Enero,Bélgica,8,23,,31,-76.532004,3.451668
11880,2013,Enero,Bélgica,105,307,,412,-74.140516,4.697157
11881,2013,Enero,Bélgica,9,14,,23,-75.42726,6.170465
11882,2013,Enero,Bélgica,1,0,,1,-73.181317,7.1280470000000005
11883,2013,Enero,Bélgica,1,1,,2,-72.453013,7.819
11884,2013,Enero,Bélgica,0,3,,3,-77.35002,8.63337
11885,2013,Enero,Belice,1,0,,1,-72.129595,11.360028999999999
11886,2013,Enero,Belice,2,6,,8,-74.140516,4.697157
11887,2013,Enero,Belice,0,2,,2,-75.42726,6.170465
11888,2013,Enero,Benín,0,1,,1,-74.140516,4.697157
11889,2013,Enero,Bolivia,38,34,,72,-77.35600000000001,0.81488
11890,2013,Enero,Bolivia,0,2,,2,-75.527794,10.406342
11891,2013,Enero,Bolivia,16,19,,35,-75.516486,10.446304
11892,2013,Enero,Bolivia,2,1,,3,-74.77647900000001,10.886686
11893,2013,Enero,Bolivia,0,1,,1,-72.129595,11.360028999999999
11894,2013,Enero,Bolivia,1,1,,2,-81.70216500000001,12.5862
11895,2013,Enero,Bolivia,12,10,,22,-76.532004,3.451668
11896,2013,Enero,Bolivia,0,1,,1,-75.76635300000001,4.45285
11897,2013,Enero,Bolivia,437,539,,976,-74.140516,4.697157
11898,2013,Enero,Bolivia,12,24,,36,-75.42726,6.170465
11899,2013,Enero,Bolivia,1,0,,1,-70.74025300000001,7.088728999999999
11900,2013,Enero,Bolivia,0,5,,5,-72.453013,7.819
11901,2013,Enero,Bosnia y Herzegovina,0,2,,2,-74.140516,4.697157
11902,2013,Enero,Bosnia y Herzegovina,1,0,,1,-75.42726,6.170465
11903,2013,Enero,Brasil,98,92,,190,-69.941498,4.191162
11904,2013,Enero,Brasil,27,57,,84,-77.35600000000001,0.81488
11905,2013,Enero,Brasil,9,7,,16,-75.527794,10.406342
11906,2013,Enero,Brasil,136,124,,260,-75.516486,10.446304
11907,2013,Enero,Brasil,6,14,,20,-74.77647900000001,10.886686
11908,2013,Enero,Brasil,10,32,,42,-72.129595,11.360028999999999
11909,2013,Enero,Brasil,27,21,,48,-81.70216500000001,12.5862
11910,2013,Enero,Brasil,19,42,,61,-76.532004,3.451668
11911,2013,Enero,Brasil,0,2,,2,-75.76635300000001,4.45285
11912,2013,Enero,Brasil,2894,3920,,6814,-74.140516,4.697157
11913,2013,Enero,Brasil,79,92,,171,-75.42726,6.170465
11914,2013,Enero,Brasil,0,3,,3,-67.48402800000001,6.185536
11915,2013,Enero,Brasil,1,2,,3,-73.181317,7.1280470000000005
11916,2013,Enero,Brasil,19,25,,44,-72.453013,7.819
11917,2013,Enero,Brasil,0,6,,6,-72.508188,7.927233
11918,2013,Enero,Brasil,0,1,,1,-77.35002,8.63337
11919,2013,Enero,Bulgaria,0,1,,1,-75.527794,10.406342
11920,2013,Enero,Bulgaria,0,1,,1,-76.532004,3.451668
11921,2013,Enero,Bulgaria,15,12,,27,-74.140516,4.697157
11922,2013,Enero,Burkina Faso,1,1,,2,-74.140516,4.697157
11923,2013,Enero,Islas Caimán/Territorio Británico de Ultramar,4,17,,21,-81.70216500000001,12.5862
11924,2013,Enero,Camerún,0,6,,6,-74.140516,4.697157
11925,2013,Enero,Canadá,4,5,,9,-69.941498,4.191162
11926,2013,Enero,Canadá,1,0,,1,-76.876446,0.33002
11927,2013,Enero,Canadá,28,41,,69,-77.35600000000001,0.81488
11928,2013,Enero,Canadá,20,33,,53,-75.527794,10.406342
11929,2013,Enero,Canadá,780,784,,1564,-75.516486,10.446304
11930,2013,Enero,Canadá,7,26,,33,-74.77647900000001,10.886686
11931,2013,Enero,Canadá,0,3,,3,-74.213989,11.247722999999999
11932,2013,Enero,Canadá,4,6,,10,-72.129595,11.360028999999999
11933,2013,Enero,Canadá,0,1,,1,-72.919186,11.52863
11934,2013,Enero,Canadá,366,347,,713,-81.70216500000001,12.5862
11935,2013,Enero,Canadá,1,1,,2,-81.372937,13.338761300000002
11936,2013,Enero,Canadá,39,55,,94,-76.532004,3.451668
11937,2013,Enero,Canadá,4,5,,9,-75.76635300000001,4.45285
11938,2013,Enero,Canadá,723,1381,,2104,-74.140516,4.697157
11939,2013,Enero,Canadá,1,9,,10,-75.736374,4.815189
11940,2013,Enero,Canadá,87,199,,286,-75.42726,6.170465
11941,2013,Enero,Canadá,1,6,,7,-73.181317,7.1280470000000005
11942,2013,Enero,Canadá,15,29,,44,-72.453013,7.819
11943,2013,Enero,Canadá,2,1,,3,-72.508188,7.927233
11944,2013,Enero,Canadá,5,8,,13,-77.35002,8.63337
11945,2013,Enero,España,1,1,,2,-76.876446,0.33002
11946,2013,Enero,España,10,14,,24,-77.35600000000001,0.81488
11947,2013,Enero,España,3,7,,10,-75.527794,10.406342
11948,2013,Enero,España,1,6,,7,-75.516486,10.446304
11949,2013,Enero,España,2,8,,10,-74.77647900000001,10.886686
11950,2013,Enero,España,68,137,,205,-76.532004,3.451668
11951,2013,Enero,España,1,1,,2,-75.76635300000001,4.45285
11952,2013,Enero,España,184,408,,592,-74.140516,4.697157
11953,2013,Enero,España,1,12,,13,-75.736374,4.815189
11954,2013,Enero,España,42,114,,156,-75.42726,6.170465
11955,2013,Enero,España,0,1,,1,-73.181317,7.1280470000000005
11956,2013,Enero,España,0,6,,6,-72.453013,7.819
11957,2013,Enero,España,1,0,,1,-72.508188,7.927233
11958,2013,Enero,República Democrática del Congo,0,2,,2,-74.140516,4.697157
11959,2013,Enero,República de Corea,1,0,,1,-76.876446,0.33002
11960,2013,Enero,República de Corea,10,10,,20,-77.35600000000001,0.81488
11961,2013,Enero,República de Corea,1,0,,1,-75.527794,10.406342
11962,2013,Enero,República de Corea,7,4,,11,-75.516486,10.446304
11963,2013,Enero,República de Corea,1,1,,2,-74.77647900000001,10.886686
11964,2013,Enero,República de Corea,1,3,,4,-76.532004,3.451668
11965,2013,Enero,República de Corea,182,398,,580,-74.140516,4.697157
11966,2013,Enero,República de Corea,0,1,,1,-75.736374,4.815189
11967,2013,Enero,República de Corea,6,33,,39,-75.42726,6.170465
11968,2013,Enero,República de Corea,1,5,,6,-72.453013,7.819
11969,2013,Enero,Costa de Marfil,1,0,,1,-74.140516,4.697157
11970,2013,Enero,Costa Rica,0,2,,2,-77.35600000000001,0.81488
11971,2013,Enero,Costa Rica,0,5,,5,-75.527794,10.406342
11972,2013,Enero,Costa Rica,64,42,,106,-75.516486,10.446304
11973,2013,Enero,Costa Rica,10,26,,36,-74.77647900000001,10.886686
11974,2013,Enero,Costa Rica,0,1,,1,-74.213989,11.247722999999999
11975,2013,Enero,Costa Rica,429,283,,712,-81.70216500000001,12.5862
11976,2013,Enero,Costa Rica,22,55,,77,-76.532004,3.451668
11977,2013,Enero,Costa Rica,0,3,,3,-77.061029,3.8844260000000004
11978,2013,Enero,Costa Rica,492,739,,1231,-74.140516,4.697157
11979,2013,Enero,Costa Rica,7,12,,19,-75.736374,4.815189
11980,2013,Enero,Costa Rica,57,119,,176,-75.42726,6.170465
11981,2013,Enero,Costa Rica,1,0,,1,-67.48402800000001,6.185536
11982,2013,Enero,Costa Rica,3,1,,4,-73.181317,7.1280470000000005
11983,2013,Enero,Costa Rica,5,8,,13,-72.453013,7.819
11984,2013,Enero,Costa Rica,0,1,,1,-77.35002,8.63337
11985,2013,Enero,Croacia,0,2,,2,-77.35600000000001,0.81488
11986,2013,Enero,Croacia,0,3,,3,-75.527794,10.406342
11987,2013,Enero,Croacia,1,1,,2,-75.516486,10.446304
11988,2013,Enero,Croacia,1,2,,3,-76.532004,3.451668
11989,2013,Enero,Croacia,4,31,,35,-74.140516,4.697157
11990,2013,Enero,Croacia,1,0,,1,-75.42726,6.170465
11991,2013,Enero,Croacia,0,1,,1,-72.453013,7.819
11992,2013,Enero,Cuba,3,1,,4,-77.35600000000001,0.81488
11993,2013,Enero,Cuba,10,11,,21,-75.516486,10.446304
11994,2013,Enero,Cuba,7,19,,26,-74.77647900000001,10.886686
11995,2013,Enero,Cuba,0,1,,1,-72.129595,11.360028999999999
11996,2013,Enero,Cuba,22,37,,59,-76.532004,3.451668
11997,2013,Enero,Cuba,0,1,,1,-75.76635300000001,4.45285
11998,2013,Enero,Cuba,97,163,,260,-74.140516,4.697157
11999,2013,Enero,Cuba,17,20,,37,-75.42726,6.170465
12000,2013,Enero,Cuba,1,1,,2,-73.181317,7.1280470000000005
12001,2013,Enero,Cuba,0,1,,1,-72.453013,7.819
12002,2013,Enero,Curazao,2,1,,3,-74.140516,4.697157
12003,2013,Enero,Curazao,2,1,,3,-75.42726,6.170465
12004,2013,Enero,República Checa,1,2,,3,-69.941498,4.191162
12005,2013,Enero,República Checa,2,6,,8,-77.35600000000001,0.81488
12006,2013,Enero,República Checa,1,3,,4,-75.516486,10.446304
12007,2013,Enero,República Checa,2,0,,2,-72.129595,11.360028999999999
12008,2013,Enero,República Checa,3,0,,3,-76.532004,3.451668
12009,2013,Enero,República Checa,35,72,,107,-74.140516,4.697157
12010,2013,Enero,República Checa,0,1,,1,-75.736374,4.815189
12011,2013,Enero,República Checa,1,1,,2,-75.42726,6.170465
12012,2013,Enero,República Checa,0,1,,1,-72.453013,7.819
12013,2013,Enero,Chile,2,2,,4,-69.941498,4.191162
12014,2013,Enero,Chile,55,98,,153,-77.35600000000001,0.81488
12015,2013,Enero,Chile,13,12,,25,-75.527794,10.406342
12016,2013,Enero,Chile,213,154,,367,-75.516486,10.446304
12017,2013,Enero,Chile,6,15,,21,-74.77647900000001,10.886686
12018,2013,Enero,Chile,5,6,,11,-72.129595,11.360028999999999
12019,2013,Enero,Chile,97,84,,181,-81.70216500000001,12.5862
12020,2013,Enero,Chile,67,96,,163,-76.532004,3.451668
12021,2013,Enero,Chile,2398,3334,,5732,-74.140516,4.697157
12022,2013,Enero,Chile,2,2,,4,-75.736374,4.815189
12023,2013,Enero,Chile,116,152,,268,-75.42726,6.170465
12024,2013,Enero,Chile,0,2,,2,-70.74025300000001,7.088728999999999
12025,2013,Enero,Chile,3,3,,6,-73.181317,7.1280470000000005
12026,2013,Enero,Chile,9,21,,30,-72.453013,7.819
12027,2013,Enero,Chile,1,1,,2,-72.508188,7.927233
12028,2013,Enero,Chile,1,2,,3,-77.35002,8.63337
12029,2013,Enero,China,1,2,,3,-77.35600000000001,0.81488
12030,2013,Enero,China,1,0,,1,-75.527794,10.406342
12031,2013,Enero,China,1,3,,4,-75.516486,10.446304
12032,2013,Enero,China,4,0,,4,-74.77647900000001,10.886686
12033,2013,Enero,China,2,0,,2,-72.129595,11.360028999999999
12034,2013,Enero,China,2,4,,6,-76.532004,3.451668
12035,2013,Enero,China,128,374,,502,-74.140516,4.697157
12036,2013,Enero,China,0,1,,1,-75.736374,4.815189
12037,2013,Enero,China,4,5,,9,-75.42726,6.170465
12038,2013,Enero,China,1,0,,1,-73.181317,7.1280470000000005
12039,2013,Enero,China,3,3,,6,-72.453013,7.819
12040,2013,Enero,Taiwán,0,2,,2,-77.35600000000001,0.81488
12041,2013,Enero,Taiwán,0,3,,3,-75.516486,10.446304
12042,2013,Enero,Taiwán,0,4,,4,-74.77647900000001,10.886686
12043,2013,Enero,Taiwán,1,1,,2,-72.129595,11.360028999999999
12044,2013,Enero,Taiwán,3,5,,8,-76.532004,3.451668
12045,2013,Enero,Taiwán,27,47,,74,-74.140516,4.697157
12046,2013,Enero,Taiwán,4,9,,13,-75.42726,6.170465
12047,2013,Enero,Chipre,0,1,,1,-74.765343,10.970933
12048,2013,Enero,Chipre,1,3,,4,-74.140516,4.697157
12049,2013,Enero,Dinamarca,0,1,,1,-69.941498,4.191162
12050,2013,Enero,Dinamarca,1,5,,6,-77.35600000000001,0.81488
12051,2013,Enero,Dinamarca,8,7,,15,-75.516486,10.446304
12052,2013,Enero,Dinamarca,0,1,,1,-74.77647900000001,10.886686
12053,2013,Enero,Dinamarca,1,1,,2,-72.129595,11.360028999999999
12054,2013,Enero,Dinamarca,3,4,,7,-76.532004,3.451668
12055,2013,Enero,Dinamarca,65,125,,190,-74.140516,4.697157
12056,2013,Enero,Dinamarca,2,10,,12,-75.42726,6.170465
12057,2013,Enero,Dinamarca,1,1,,2,-72.453013,7.819
12058,2013,Enero,Dinamarca,0,1,,1,-77.35002,8.63337
12059,2013,Enero,Dominica,1,0,,1,-77.35600000000001,0.81488
12060,2013,Enero,Dominica,0,1,,1,-76.532004,3.451668
12061,2013,Enero,Dominica,2,3,,5,-74.140516,4.697157
12062,2013,Enero,Dominica,1,0,,1,-75.42726,6.170465
12063,2013,Enero,Dominica,0,1,,1,-72.453013,7.819
12064,2013,Enero,Ecuador,0,1,,1,-69.941498,4.191162
12065,2013,Enero,Ecuador,16,50,,66,-76.876446,0.33002
12066,2013,Enero,Ecuador,905,1563,,2468,-77.35600000000001,0.81488
12067,2013,Enero,Ecuador,1,5,,6,-78.802679,18.00143
12068,2013,Enero,Ecuador,1,32,,33,-75.527794,10.406342
12069,2013,Enero,Ecuador,6,13,,19,-75.516486,10.446304
12070,2013,Enero,Ecuador,10,12,,22,-74.77647900000001,10.886686
12071,2013,Enero,Ecuador,3,20,,23,-72.129595,11.360028999999999
12072,2013,Enero,Ecuador,0,5,,5,-81.703935,12.574411099999999
12073,2013,Enero,Ecuador,261,311,,572,-76.532004,3.451668
12074,2013,Enero,Ecuador,1,0,,1,-75.76635300000001,4.45285
12075,2013,Enero,Ecuador,1581,2579,,4160,-74.140516,4.697157
12076,2013,Enero,Ecuador,3,7,,10,-75.736374,4.815189
12077,2013,Enero,Ecuador,285,429,,714,-75.42726,6.170465
12078,2013,Enero,Ecuador,1,1,,2,-70.74025300000001,7.088728999999999
12079,2013,Enero,Ecuador,5,7,,12,-73.181317,7.1280470000000005
12080,2013,Enero,Ecuador,113,156,,269,-72.453013,7.819
12081,2013,Enero,Ecuador,0,3,,3,-72.508188,7.927233
12082,2013,Enero,Egipto,0,1,,1,-75.516486,10.446304
12083,2013,Enero,Egipto,0,1,,1,-76.532004,3.451668
12084,2013,Enero,Egipto,4,19,,23,-74.140516,4.697157
12085,2013,Enero,Egipto,2,1,,3,-75.42726,6.170465
12086,2013,Enero,El Salvador,0,1,,1,-77.35600000000001,0.81488
12087,2013,Enero,El Salvador,8,12,,20,-75.516486,10.446304
12088,2013,Enero,El Salvador,1,1,,2,-74.77647900000001,10.886686
12089,2013,Enero,El Salvador,35,61,,96,-76.532004,3.451668
12090,2013,Enero,El Salvador,359,515,,874,-74.140516,4.697157
12091,2013,Enero,El Salvador,1,1,,2,-75.736374,4.815189
12092,2013,Enero,El Salvador,70,106,,176,-75.42726,6.170465
12093,2013,Enero,El Salvador,0,1,,1,-73.181317,7.1280470000000005
12094,2013,Enero,El Salvador,0,1,,1,-77.35002,8.63337
12095,2013,Enero,Emiratos Árabes,0,9,,9,-74.140516,4.697157
12096,2013,Enero,España,3,4,,7,-69.941498,4.191162
12097,2013,Enero,España,19,30,,49,-77.35600000000001,0.81488
12098,2013,Enero,España,7,9,,16,-75.527794,10.406342
12099,2013,Enero,España,40,66,,106,-75.516486,10.446304
12100,2013,Enero,España,3,14,,17,-74.77647900000001,10.886686
12101,2013,Enero,España,7,13,,20,-72.129595,11.360028999999999
12102,2013,Enero,España,4,6,,10,-81.70216500000001,12.5862
12103,2013,Enero,España,160,334,,494,-76.532004,3.451668
12104,2013,Enero,España,1799,4256,,6055,-74.140516,4.697157
12105,2013,Enero,España,2,9,,11,-75.736374,4.815189
12106,2013,Enero,España,70,213,,283,-75.42726,6.170465
12107,2013,Enero,España,0,1,,1,-67.48402800000001,6.185536
12108,2013,Enero,España,0,1,,1,-70.74025300000001,7.088728999999999
12109,2013,Enero,España,0,4,,4,-73.181317,7.1280470000000005
12110,2013,Enero,España,20,65,,85,-72.453013,7.819
12111,2013,Enero,España,0,9,,9,-72.508188,7.927233
12112,2013,Enero,España,0,2,,2,-77.35002,8.63337
12113,2013,Enero,Eslovaquia,2,3,,5,-77.35600000000001,0.81488
12114,2013,Enero,Eslovaquia,1,0,,1,-75.527794,10.406342
12115,2013,Enero,Eslovaquia,0,6,,6,-75.516486,10.446304
12116,2013,Enero,Eslovaquia,1,1,,2,-76.532004,3.451668
12117,2013,Enero,Eslovaquia,22,40,,62,-74.140516,4.697157
12118,2013,Enero,Eslovaquia,3,1,,4,-75.42726,6.170465
12119,2013,Enero,Eslovaquia,0,1,,1,-72.453013,7.819
12120,2013,Enero,Eslovenia,0,3,,3,-75.527794,10.406342
12121,2013,Enero,Eslovenia,1,0,,1,-72.129595,11.360028999999999
12122,2013,Enero,Eslovenia,0,1,,1,-76.532004,3.451668
12123,2013,Enero,Eslovenia,23,30,,53,-74.140516,4.697157
12124,2013,Enero,Eslovenia,0,1,,1,-72.453013,7.819
12125,2013,Enero,Estados Unidos de América,9,23,,32,-69.941498,4.191162
12126,2013,Enero,Estados Unidos de América,49,102,,151,-77.35600000000001,0.81488
12127,2013,Enero,Estados Unidos de América,1,0,,1,-78.802679,18.00143
12128,2013,Enero,Estados Unidos de América,38,61,,99,-75.527794,10.406342
12129,2013,Enero,Estados Unidos de América,1042,1812,,2854,-75.516486,10.446304
12130,2013,Enero,Estados Unidos de América,191,370,,561,-74.77647900000001,10.886686
12131,2013,Enero,Estados Unidos de América,0,7,,7,-74.213989,11.247722999999999
12132,2013,Enero,Estados Unidos de América,10,22,,32,-72.129595,11.360028999999999
12133,2013,Enero,Estados Unidos de América,0,1,,1,-72.919186,11.52863
12134,2013,Enero,Estados Unidos de América,4,3,,7,-81.703935,12.574411099999999
12135,2013,Enero,Estados Unidos de América,18,30,,48,-81.70216500000001,12.5862
12136,2013,Enero,Estados Unidos de América,2,2,,4,-81.372937,13.338761300000002
12137,2013,Enero,Estados Unidos de América,398,825,,1223,-76.532004,3.451668
12138,2013,Enero,Estados Unidos de América,39,88,,127,-75.76635300000001,4.45285
12139,2013,Enero,Estados Unidos de América,4407,8992,,13399,-74.140516,4.697157
12140,2013,Enero,Estados Unidos de América,72,112,,184,-75.736374,4.815189
12141,2013,Enero,Estados Unidos de América,736,2091,,2827,-75.42726,6.170465
12142,2013,Enero,Estados Unidos de América,0,1,,1,-67.48402800000001,6.185536
12143,2013,Enero,Estados Unidos de América,1,2,,3,-70.74025300000001,7.088728999999999
12144,2013,Enero,Estados Unidos de América,21,34,,55,-73.181317,7.1280470000000005
12145,2013,Enero,Estados Unidos de América,50,97,,147,-72.453013,7.819
12146,2013,Enero,Estados Unidos de América,9,13,,22,-72.508188,7.927233
12147,2013,Enero,Estados Unidos de América,11,13,,24,-77.35002,8.63337
12148,2013,Enero,Estonia,0,4,,4,-75.516486,10.446304
12149,2013,Enero,Estonia,0,1,,1,-74.765343,10.970933
12150,2013,Enero,Estonia,0,3,,3,-76.532004,3.451668
12151,2013,Enero,Estonia,15,9,,24,-74.140516,4.697157
12152,2013,Enero,Estonia,0,1,,1,-72.453013,7.819
12153,2013,Enero,Etiopia,2,1,,3,-74.140516,4.697157
12154,2013,Enero,Filipinas,0,2,,2,-77.35600000000001,0.81488
12155,2013,Enero,Filipinas,0,17,,17,-75.527794,10.406342
12156,2013,Enero,Filipinas,1,8,,9,-75.516486,10.446304
12157,2013,Enero,Filipinas,0,4,,4,-74.77647900000001,10.886686
12158,2013,Enero,Filipinas,0,6,,6,-74.765343,10.970933
12159,2013,Enero,Filipinas,0,9,,9,-74.213989,11.247722999999999
12160,2013,Enero,Filipinas,1,3,,4,-76.532004,3.451668
12161,2013,Enero,Filipinas,0,6,,6,-77.061029,3.8844260000000004
12162,2013,Enero,Filipinas,19,41,,60,-74.140516,4.697157
12163,2013,Enero,Filipinas,1,4,,5,-75.42726,6.170465
12164,2013,Enero,Filipinas,1,0,,1,-72.453013,7.819
12165,2013,Enero,Filipinas,0,1,,1,-75.68164200000001,9.402597
12166,2013,Enero,Finlandia,7,0,,7,-77.35600000000001,0.81488
12167,2013,Enero,Finlandia,2,5,,7,-75.527794,10.406342
12168,2013,Enero,Finlandia,9,8,,17,-75.516486,10.446304
12169,2013,Enero,Finlandia,0,1,,1,-74.77647900000001,10.886686
12170,2013,Enero,Finlandia,0,1,,1,-72.129595,11.360028999999999
12171,2013,Enero,Finlandia,1,1,,2,-76.532004,3.451668
12172,2013,Enero,Finlandia,43,72,,115,-74.140516,4.697157
12173,2013,Enero,Finlandia,4,8,,12,-75.42726,6.170465
12174,2013,Enero,Finlandia,2,2,,4,-72.453013,7.819
12175,2013,Enero,Francia,9,10,,19,-69.941498,4.191162
12176,2013,Enero,Francia,1,3,,4,-76.876446,0.33002
12177,2013,Enero,Francia,54,74,,128,-77.35600000000001,0.81488
12178,2013,Enero,Francia,2,1,,3,-78.802679,18.00143
12179,2013,Enero,Francia,11,29,,40,-75.527794,10.406342
12180,2013,Enero,Francia,24,40,,64,-75.516486,10.446304
12181,2013,Enero,Francia,2,6,,8,-74.77647900000001,10.886686
12182,2013,Enero,Francia,0,3,,3,-74.765343,10.970933
12183,2013,Enero,Francia,1,4,,5,-74.213989,11.247722999999999
12184,2013,Enero,Francia,11,10,,21,-72.129595,11.360028999999999
12185,2013,Enero,Francia,1,2,,3,-81.70216500000001,12.5862
12186,2013,Enero,Francia,1,1,,2,-81.372937,13.338761300000002
12187,2013,Enero,Francia,37,88,,125,-76.532004,3.451668
12188,2013,Enero,Francia,1173,1941,,3114,-74.140516,4.697157
12189,2013,Enero,Francia,3,6,,9,-75.736374,4.815189
12190,2013,Enero,Francia,35,62,,97,-75.42726,6.170465
12191,2013,Enero,Francia,0,1,,1,-67.48402800000001,6.185536
12192,2013,Enero,Francia,0,1,,1,-70.74025300000001,7.088728999999999
12193,2013,Enero,Francia,1,1,,2,-73.181317,7.1280470000000005
12194,2013,Enero,Francia,8,11,,19,-72.453013,7.819
12195,2013,Enero,Francia,0,3,,3,-72.508188,7.927233
12196,2013,Enero,Francia,5,9,,14,-77.35002,8.63337
12197,2013,Enero,Gabón,1,1,,2,-74.140516,4.697157
12198,2013,Enero,Georgia,2,0,,2,-74.140516,4.697157
12199,2013,Enero,Ghana,0,1,,1,-72.129595,11.360028999999999
12200,2013,Enero,Ghana,0,2,,2,-74.140516,4.697157
12201,2013,Enero,Grecia,0,1,,1,-75.527794,10.406342
12202,2013,Enero,Grecia,0,2,,2,-75.516486,10.446304
12203,2013,Enero,Grecia,0,2,,2,-74.213989,11.247722999999999
12204,2013,Enero,Grecia,0,1,,1,-72.129595,11.360028999999999
12205,2013,Enero,Grecia,0,3,,3,-76.532004,3.451668
12206,2013,Enero,Grecia,9,46,,55,-74.140516,4.697157
12207,2013,Enero,Grecia,0,4,,4,-75.42726,6.170465
12208,2013,Enero,Grecia,0,2,,2,-72.453013,7.819
12209,2013,Enero,Grecia,0,2,,2,-75.68164200000001,9.402597
12210,2013,Enero,Guatemala,0,2,,2,-77.35600000000001,0.81488
12211,2013,Enero,Guatemala,0,1,,1,-75.527794,10.406342
12212,2013,Enero,Guatemala,15,29,,44,-75.516486,10.446304
12213,2013,Enero,Guatemala,2,10,,12,-74.77647900000001,10.886686
12214,2013,Enero,Guatemala,0,1,,1,-81.70216500000001,12.5862
12215,2013,Enero,Guatemala,21,62,,83,-76.532004,3.451668
12216,2013,Enero,Guatemala,151,294,,445,-74.140516,4.697157
12217,2013,Enero,Guatemala,1,4,,5,-75.736374,4.815189
12218,2013,Enero,Guatemala,44,111,,155,-75.42726,6.170465
12219,2013,Enero,Guatemala,1,1,,2,-73.181317,7.1280470000000005
12220,2013,Enero,Guatemala,12,16,,28,-72.453013,7.819
12221,2013,Enero,Guatemala,3,2,,5,-72.508188,7.927233
12222,2013,Enero,Guatemala,1,1,,2,-77.35002,8.63337
12223,2013,Enero,Guyana,0,1,,1,-69.941498,4.191162
12224,2013,Enero,Guyana,0,1,,1,-75.516486,10.446304
12225,2013,Enero,Guyana,1,2,,3,-76.532004,3.451668
12226,2013,Enero,Guyana,4,10,,14,-74.140516,4.697157
12227,2013,Enero,Guyana,0,4,,4,-75.42726,6.170465
12228,2013,Enero,Guyana,2,0,,2,-73.181317,7.1280470000000005
12229,2013,Enero,Guinea Bissau,0,1,,1,-74.140516,4.697157
12230,2013,Enero,Guayana Francesa/Departamento de Ultramar Francés,0,1,,1,-74.140516,4.697157
12231,2013,Enero,Haití,0,2,,2,-77.35600000000001,0.81488
12232,2013,Enero,Haití,1,0,,1,-75.516486,10.446304
12233,2013,Enero,Haití,0,1,,1,-74.77647900000001,10.886686
12234,2013,Enero,Haití,2,16,,18,-74.140516,4.697157
12235,2013,Enero,Haití,0,1,,1,-75.42726,6.170465
12236,2013,Enero,Honduras,0,1,,1,-77.35600000000001,0.81488
12237,2013,Enero,Honduras,10,15,,25,-75.516486,10.446304
12238,2013,Enero,Honduras,1,1,,2,-74.77647900000001,10.886686
12239,2013,Enero,Honduras,1,0,,1,-74.765343,10.970933
12240,2013,Enero,Honduras,0,2,,2,-81.703935,12.574411099999999
12241,2013,Enero,Honduras,2,4,,6,-81.70216500000001,12.5862
12242,2013,Enero,Honduras,14,23,,37,-76.532004,3.451668
12243,2013,Enero,Honduras,110,127,,237,-74.140516,4.697157
12244,2013,Enero,Honduras,0,1,,1,-75.736374,4.815189
12245,2013,Enero,Honduras,24,46,,70,-75.42726,6.170465
12246,2013,Enero,Honduras,1,0,,1,-72.453013,7.819
12247,2013,Enero,Honduras,1,0,,1,-72.508188,7.927233
12248,2013,Enero,Honduras,0,1,,1,-76.7333,8.06667
12249,2013,Enero,Honduras,0,2,,2,-77.35002,8.63337
12250,2013,Enero,Hong Kong,0,2,,2,-74.140516,4.697157
12251,2013,Enero,Hungría,1,3,,4,-77.35600000000001,0.81488
12252,2013,Enero,Hungría,4,1,,5,-75.516486,10.446304
12253,2013,Enero,Hungría,0,4,,4,-76.532004,3.451668
12254,2013,Enero,Hungría,13,36,,49,-74.140516,4.697157
12255,2013,Enero,Hungría,1,0,,1,-72.453013,7.819
12256,2013,Enero,India,0,5,,5,-77.35600000000001,0.81488
12257,2013,Enero,India,2,9,,11,-75.516486,10.446304
12258,2013,Enero,India,1,2,,3,-74.77647900000001,10.886686
12259,2013,Enero,India,5,16,,21,-76.532004,3.451668
12260,2013,Enero,India,34,190,,224,-74.140516,4.697157
12261,2013,Enero,India,0,1,,1,-75.736374,4.815189
12262,2013,Enero,India,5,44,,49,-75.42726,6.170465
12263,2013,Enero,Indonesia,0,6,,6,-75.527794,10.406342
12264,2013,Enero,Indonesia,1,2,,3,-75.516486,10.446304
12265,2013,Enero,Indonesia,3,14,,17,-74.140516,4.697157
12266,2013,Enero,Indonesia,1,1,,2,-75.42726,6.170465
12267,2013,Enero,Irán,0,1,,1,-76.532004,3.451668
12268,2013,Enero,Irán,4,5,,9,-74.140516,4.697157
12269,2013,Enero,Irán,0,2,,2,-75.42726,6.170465
12270,2013,Enero,República de Irlanda,0,4,,4,-69.941498,4.191162
12271,2013,Enero,República de Irlanda,11,12,,23,-77.35600000000001,0.81488
12272,2013,Enero,República de Irlanda,1,1,,2,-75.527794,10.406342
12273,2013,Enero,República de Irlanda,3,13,,16,-75.516486,10.446304
12274,2013,Enero,República de Irlanda,0,1,,1,-76.532004,3.451668
12275,2013,Enero,República de Irlanda,42,99,,141,-74.140516,4.697157
12276,2013,Enero,República de Irlanda,3,14,,17,-75.42726,6.170465
12277,2013,Enero,República de Irlanda,0,2,,2,-72.453013,7.819
12278,2013,Enero,República de Irlanda,0,1,,1,-72.508188,7.927233
12279,2013,Enero,República de Irlanda,2,2,,4,-77.35002,8.63337
12280,2013,Enero,Islandia,2,7,,9,-74.140516,4.697157
12281,2013,Enero,Isla de Man,10,17,,27,-77.35600000000001,0.81488
12282,2013,Enero,Isla de Man,5,12,,17,-75.516486,10.446304
12283,2013,Enero,Isla de Man,1,3,,4,-74.77647900000001,10.886686
12284,2013,Enero,Isla de Man,14,22,,36,-76.532004,3.451668
12285,2013,Enero,Isla de Man,32,103,,135,-74.140516,4.697157
12286,2013,Enero,Isla de Man,0,1,,1,-75.736374,4.815189
12287,2013,Enero,Isla de Man,13,40,,53,-75.42726,6.170465
12288,2013,Enero,Isla de Man,1,2,,3,-72.453013,7.819
12289,2013,Enero,Isla de Man,2,3,,5,-77.35002,8.63337
12290,2013,Enero,Isla Johnston,0,1,,1,-74.140516,4.697157
12291,2013,Enero,Israel,1,1,,2,-69.941498,4.191162
12292,2013,Enero,Israel,1,2,,3,-77.35600000000001,0.81488
12293,2013,Enero,Israel,0,1,,1,-75.527794,10.406342
12294,2013,Enero,Israel,2,18,,20,-75.516486,10.446304
12295,2013,Enero,Israel,6,14,,20,-76.532004,3.451668
12296,2013,Enero,Israel,86,372,,458,-74.140516,4.697157
12297,2013,Enero,Israel,1,34,,35,-75.42726,6.170465
12298,2013,Enero,Israel,0,1,,1,-73.181317,7.1280470000000005
12299,2013,Enero,Israel,0,1,,1,-72.453013,7.819
12300,2013,Enero,Islas Aland/Provincia de Finlandia,2,0,,2,-74.140516,4.697157
12301,2013,Enero,Italia,0,4,,4,-69.941498,4.191162
12302,2013,Enero,Italia,0,2,,2,-76.876446,0.33002
12303,2013,Enero,Italia,23,40,,63,-77.35600000000001,0.81488
12304,2013,Enero,Italia,4,12,,16,-75.527794,10.406342
12305,2013,Enero,Italia,40,131,,171,-75.516486,10.446304
12306,2013,Enero,Italia,1,22,,23,-74.77647900000001,10.886686
12307,2013,Enero,Italia,0,1,,1,-74.765343,10.970933
12308,2013,Enero,Italia,0,1,,1,-74.213989,11.247722999999999
12309,2013,Enero,Italia,6,33,,39,-72.129595,11.360028999999999
12310,2013,Enero,Italia,4,6,,10,-81.70216500000001,12.5862
12311,2013,Enero,Italia,1,1,,2,-81.372937,13.338761300000002
12312,2013,Enero,Italia,22,109,,131,-76.532004,3.451668
12313,2013,Enero,Italia,0,1,,1,-77.061029,3.8844260000000004
12314,2013,Enero,Italia,555,1873,,2428,-74.140516,4.697157
12315,2013,Enero,Italia,0,4,,4,-75.736374,4.815189
12316,2013,Enero,Italia,39,116,,155,-75.42726,6.170465
12317,2013,Enero,Italia,1,3,,4,-67.48402800000001,6.185536
12318,2013,Enero,Italia,0,2,,2,-73.181317,7.1280470000000005
12319,2013,Enero,Italia,3,20,,23,-72.453013,7.819
12320,2013,Enero,Italia,2,5,,7,-72.508188,7.927233
12321,2013,Enero,Italia,1,4,,5,-77.35002,8.63337
12322,2013,Enero,Jamaica,0,1,,1,-75.527794,10.406342
12323,2013,Enero,Jamaica,0,1,,1,-75.516486,10.446304
12324,2013,Enero,Jamaica,0,1,,1,-74.77647900000001,10.886686
12325,2013,Enero,Jamaica,3,2,,5,-81.70216500000001,12.5862
12326,2013,Enero,Jamaica,2,2,,4,-76.532004,3.451668
12327,2013,Enero,Jamaica,9,11,,20,-74.140516,4.697157
12328,2013,Enero,Jamaica,1,8,,9,-75.42726,6.170465
12329,2013,Enero,Jamaica,1,0,,1,-73.181317,7.1280470000000005
12330,2013,Enero,Jamaica,0,1,,1,-72.453013,7.819
12331,2013,Enero,Islas Marianas del Norte,0,1,,1,-74.140516,4.697157
12332,2013,Enero,Japón,1,1,,2,-69.941498,4.191162
12333,2013,Enero,Japón,4,23,,27,-77.35600000000001,0.81488
12334,2013,Enero,Japón,0,1,,1,-75.527794,10.406342
12335,2013,Enero,Japón,3,8,,11,-75.516486,10.446304
12336,2013,Enero,Japón,0,3,,3,-74.77647900000001,10.886686
12337,2013,Enero,Japón,0,1,,1,-72.129595,11.360028999999999
12338,2013,Enero,Japón,6,25,,31,-76.532004,3.451668
12339,2013,Enero,Japón,118,391,,509,-74.140516,4.697157
12340,2013,Enero,Japón,1,0,,1,-75.736374,4.815189
12341,2013,Enero,Japón,7,36,,43,-75.42726,6.170465
12342,2013,Enero,Japón,0,1,,1,-72.508188,7.927233
12343,2013,Enero,Japón,0,2,,2,-77.35002,8.63337
12344,2013,Enero,Jordania,0,2,,2,-74.140516,4.697157
12345,2013,Enero,Kenia,1,0,,1,-75.516486,10.446304
12346,2013,Enero,Kenia,2,4,,6,-74.140516,4.697157
12347,2013,Enero,Kirguistán,3,1,,4,-74.140516,4.697157
12348,2013,Enero,Kuwait,0,1,,1,-74.140516,4.697157
12349,2013,Enero,Letonia,1,3,,4,-75.527794,10.406342
12350,2013,Enero,Letonia,1,2,,3,-75.516486,10.446304
12351,2013,Enero,Letonia,0,1,,1,-76.532004,3.451668
12352,2013,Enero,Letonia,7,20,,27,-74.140516,4.697157
12353,2013,Enero,Letonia,1,4,,5,-75.42726,6.170465
12354,2013,Enero,Lituania,1,0,,1,-75.516486,10.446304
12355,2013,Enero,Lituania,0,1,,1,-72.129595,11.360028999999999
12356,2013,Enero,Lituania,3,0,,3,-76.532004,3.451668
12357,2013,Enero,Lituania,6,12,,18,-74.140516,4.697157
12358,2013,Enero,Lituania,1,0,,1,-75.42726,6.170465
12359,2013,Enero,Lituania,1,1,,2,-77.35002,8.63337
12360,2013,Enero,Líbano,1,0,,1,-75.516486,10.446304
12361,2013,Enero,Líbano,2,2,,4,-74.77647900000001,10.886686
12362,2013,Enero,Líbano,7,5,,12,-72.129595,11.360028999999999
12363,2013,Enero,Líbano,1,3,,4,-76.532004,3.451668
12364,2013,Enero,Líbano,9,27,,36,-74.140516,4.697157
12365,2013,Enero,Líbano,1,0,,1,-75.736374,4.815189
12366,2013,Enero,Líbano,0,1,,1,-75.42726,6.170465
12367,2013,Enero,Líbano,0,1,,1,-73.181317,7.1280470000000005
12368,2013,Enero,Liechtenstein,1,0,,1,-74.140516,4.697157
12369,2013,Enero,Luxemburgo,7,12,,19,-74.140516,4.697157
12370,2013,Enero,Luxemburgo,1,1,,2,-75.42726,6.170465
12371,2013,Enero,Macedonia,0,2,,2,-74.140516,4.697157
12372,2013,Enero,Malasia,2,4,,6,-75.516486,10.446304
12373,2013,Enero,Malasia,7,8,,15,-74.140516,4.697157
12374,2013,Enero,Malasia,1,0,,1,-72.453013,7.819
12375,2013,Enero,Malawi,0,1,,1,-74.140516,4.697157
12376,2013,Enero,Malta,0,1,,1,-74.140516,4.697157
12377,2013,Enero,Marruecos,0,1,,1,-76.532004,3.451668
12378,2013,Enero,Marruecos,1,13,,14,-74.140516,4.697157
12379,2013,Enero,Mauricio,0,1,,1,-75.516486,10.446304
12380,2013,Enero,México,1,2,,3,-69.941498,4.191162
12381,2013,Enero,México,15,21,,36,-77.35600000000001,0.81488
12382,2013,Enero,México,6,8,,14,-75.527794,10.406342
12383,2013,Enero,México,61,154,,215,-75.516486,10.446304
12384,2013,Enero,México,16,33,,49,-74.77647900000001,10.886686
12385,2013,Enero,México,1,5,,6,-72.129595,11.360028999999999
12386,2013,Enero,México,1,1,,2,-81.70216500000001,12.5862
12387,2013,Enero,México,48,150,,198,-76.532004,3.451668
12388,2013,Enero,México,1731,3448,,5179,-74.140516,4.697157
12389,2013,Enero,México,2,14,,16,-75.736374,4.815189
12390,2013,Enero,México,113,410,,523,-75.42726,6.170465
12391,2013,Enero,México,3,2,,5,-67.48402800000001,6.185536
12392,2013,Enero,México,0,1,,1,-70.74025300000001,7.088728999999999
12393,2013,Enero,México,2,6,,8,-73.181317,7.1280470000000005
12394,2013,Enero,México,22,33,,55,-72.453013,7.819
12395,2013,Enero,México,4,6,,10,-72.508188,7.927233
12396,2013,Enero,México,1,6,,7,-77.35002,8.63337
12397,2013,Enero,República de Moldavia,1,0,,1,-76.532004,3.451668
12398,2013,Enero,República de Moldavia,1,0,,1,-74.140516,4.697157
12399,2013,Enero,Mónaco,0,2,,2,-74.140516,4.697157
12400,2013,Enero,Mongolia,2,0,,2,-74.140516,4.697157
12401,2013,Enero,Montenegro,2,0,,2,-74.140516,4.697157
12402,2013,Enero,Mozambique,0,4,,4,-74.140516,4.697157
12403,2013,Enero,Myanmar,0,2,,2,-74.140516,4.697157
12404,2013,Enero,Nepal,0,1,,1,-75.527794,10.406342
12405,2013,Enero,Nepal,0,2,,2,-74.140516,4.697157
12406,2013,Enero,Nicaragua,4,3,,7,-75.516486,10.446304
12407,2013,Enero,Nicaragua,0,2,,2,-81.703935,12.574411099999999
12408,2013,Enero,Nicaragua,0,1,,1,-81.70216500000001,12.5862
12409,2013,Enero,Nicaragua,8,3,,11,-76.532004,3.451668
12410,2013,Enero,Nicaragua,64,52,,116,-74.140516,4.697157
12411,2013,Enero,Nicaragua,10,16,,26,-75.42726,6.170465
12412,2013,Enero,Nicaragua,2,1,,3,-73.181317,7.1280470000000005
12413,2013,Enero,Nicaragua,0,1,,1,-72.508188,7.927233
12414,2013,Enero,Nicaragua,1,0,,1,-77.35002,8.63337
12415,2013,Enero,Nigeria,0,1,,1,-77.35600000000001,0.81488
12416,2013,Enero,Nigeria,1,0,,1,-75.516486,10.446304
12417,2013,Enero,Nigeria,1,0,,1,-76.532004,3.451668
12418,2013,Enero,Nigeria,1,11,,12,-74.140516,4.697157
12419,2013,Enero,Noruega,1,1,,2,-69.941498,4.191162
12420,2013,Enero,Noruega,5,4,,9,-77.35600000000001,0.81488
12421,2013,Enero,Noruega,1,3,,4,-75.527794,10.406342
12422,2013,Enero,Noruega,13,18,,31,-75.516486,10.446304
12423,2013,Enero,Noruega,1,3,,4,-74.213989,11.247722999999999
12424,2013,Enero,Noruega,3,3,,6,-76.532004,3.451668
12425,2013,Enero,Noruega,68,150,,218,-74.140516,4.697157
12426,2013,Enero,Noruega,0,1,,1,-75.736374,4.815189
12427,2013,Enero,Noruega,10,17,,27,-75.42726,6.170465
12428,2013,Enero,Noruega,0,1,,1,-72.453013,7.819
12429,2013,Enero,Noruega,0,1,,1,-77.35002,8.63337
12430,2013,Enero,Nueva Zelanda,0,1,,1,-69.941498,4.191162
12431,2013,Enero,Nueva Zelanda,7,12,,19,-77.35600000000001,0.81488
12432,2013,Enero,Nueva Zelanda,6,5,,11,-75.516486,10.446304
12433,2013,Enero,Nueva Zelanda,3,2,,5,-74.77647900000001,10.886686
12434,2013,Enero,Nueva Zelanda,3,0,,3,-72.129595,11.360028999999999
12435,2013,Enero,Nueva Zelanda,1,3,,4,-76.532004,3.451668
12436,2013,Enero,Nueva Zelanda,23,49,,72,-74.140516,4.697157
12437,2013,Enero,Nueva Zelanda,4,8,,12,-75.42726,6.170465
12438,2013,Enero,Nueva Zelanda,1,0,,1,-72.453013,7.819
12439,2013,Enero,Nueva Zelanda,1,3,,4,-77.35002,8.63337
12440,2013,Enero,Nueva Zelanda,0,1,,1,-77.35600000000001,0.81488
12441,2013,Enero,Nueva Zelanda,2,2,,4,-75.527794,10.406342
12442,2013,Enero,Nueva Zelanda,1,1,,2,-81.372937,13.338761300000002
12443,2013,Enero,Nueva Zelanda,3,2,,5,-74.140516,4.697157
12444,2013,Enero,Países Bajos,0,1,,1,-69.941498,4.191162
12445,2013,Enero,Países Bajos,8,11,,19,-77.35600000000001,0.81488
12446,2013,Enero,Países Bajos,3,10,,13,-75.516486,10.446304
12447,2013,Enero,Países Bajos,0,4,,4,-74.77647900000001,10.886686
12448,2013,Enero,Países Bajos,0,1,,1,-74.765343,10.970933
12449,2013,Enero,Países Bajos,2,5,,7,-72.129595,11.360028999999999
12450,2013,Enero,Países Bajos,14,22,,36,-72.919186,11.52863
12451,2013,Enero,Países Bajos,0,1,,1,-81.70216500000001,12.5862
12452,2013,Enero,Países Bajos,10,21,,31,-76.532004,3.451668
12453,2013,Enero,Países Bajos,13,20,,33,-75.76635300000001,4.45285
12454,2013,Enero,Países Bajos,160,246,,406,-74.140516,4.697157
12455,2013,Enero,Países Bajos,1,5,,6,-75.736374,4.815189
12456,2013,Enero,Países Bajos,103,154,,257,-75.42726,6.170465
12457,2013,Enero,Países Bajos,11,11,,22,-73.181317,7.1280470000000005
12458,2013,Enero,Países Bajos,0,1,,1,-72.453013,7.819
12459,2013,Enero,Países Bajos,0,1,,1,-72.508188,7.927233
12460,2013,Enero,Pakistán,0,2,,2,-77.35600000000001,0.81488
12461,2013,Enero,Pakistán,1,9,,10,-74.140516,4.697157
12462,2013,Enero,Pakistán,0,2,,2,-75.42726,6.170465
12463,2013,Enero,Pakistán,0,1,,1,-72.453013,7.819
12464,2013,Enero,Panamá,0,1,,1,-76.876446,0.33002
12465,2013,Enero,Panamá,1,0,,1,-77.35600000000001,0.81488
12466,2013,Enero,Panamá,4,28,,32,-75.527794,10.406342
12467,2013,Enero,Panamá,120,193,,313,-75.516486,10.446304
12468,2013,Enero,Panamá,69,83,,152,-74.77647900000001,10.886686
12469,2013,Enero,Panamá,0,10,,10,-74.213989,11.247722999999999
12470,2013,Enero,Panamá,0,1,,1,-72.129595,11.360028999999999
12471,2013,Enero,Panamá,0,2,,2,-81.703935,12.574411099999999
12472,2013,Enero,Panamá,34,28,,62,-81.70216500000001,12.5862
12473,2013,Enero,Panamá,101,125,,226,-76.532004,3.451668
12474,2013,Enero,Panamá,531,767,,1298,-74.140516,4.697157
12475,2013,Enero,Panamá,81,114,,195,-75.736374,4.815189
12476,2013,Enero,Panamá,106,237,,343,-75.42726,6.170465
12477,2013,Enero,Panamá,6,5,,11,-77.401154,6.222551999999999
12478,2013,Enero,Panamá,5,14,,19,-73.181317,7.1280470000000005
12479,2013,Enero,Panamá,7,8,,15,-72.453013,7.819
12480,2013,Enero,Panamá,6,8,,14,-72.508188,7.927233
12481,2013,Enero,Panamá,6,8,,14,-77.35002,8.63337
12482,2013,Enero,Paraguay,0,4,,4,-77.35600000000001,0.81488
12483,2013,Enero,Paraguay,4,9,,13,-75.516486,10.446304
12484,2013,Enero,Paraguay,1,1,,2,-74.77647900000001,10.886686
12485,2013,Enero,Paraguay,1,0,,1,-72.129595,11.360028999999999
12486,2013,Enero,Paraguay,27,16,,43,-81.70216500000001,12.5862
12487,2013,Enero,Paraguay,5,5,,10,-76.532004,3.451668
12488,2013,Enero,Paraguay,79,95,,174,-74.140516,4.697157
12489,2013,Enero,Paraguay,1,1,,2,-75.736374,4.815189
12490,2013,Enero,Paraguay,0,2,,2,-75.42726,6.170465
12491,2013,Enero,Paraguay,0,1,,1,-72.453013,7.819
12492,2013,Enero,Perú,31,29,,60,-69.941498,4.191162
12493,2013,Enero,Perú,2,3,,5,-76.876446,0.33002
12494,2013,Enero,Perú,262,481,,743,-77.35600000000001,0.81488
12495,2013,Enero,Perú,0,1,,1,-78.802679,18.00143
12496,2013,Enero,Perú,1,7,,8,-75.527794,10.406342
12497,2013,Enero,Perú,176,167,,343,-75.516486,10.446304
12498,2013,Enero,Perú,36,38,,74,-74.77647900000001,10.886686
12499,2013,Enero,Perú,0,2,,2,-74.765343,10.970933
12500,2013,Enero,Perú,3,2,,5,-72.129595,11.360028999999999
12501,2013,Enero,Perú,66,51,,117,-81.70216500000001,12.5862
12502,2013,Enero,Perú,1,0,,1,-81.372937,13.338761300000002
12503,2013,Enero,Perú,144,194,,338,-76.532004,3.451668
12504,2013,Enero,Perú,0,2,,2,-75.76635300000001,4.45285
12505,2013,Enero,Perú,1946,2810,,4756,-74.140516,4.697157
12506,2013,Enero,Perú,4,4,,8,-75.736374,4.815189
12507,2013,Enero,Perú,168,349,,517,-75.42726,6.170465
12508,2013,Enero,Perú,3,1,,4,-67.48402800000001,6.185536
12509,2013,Enero,Perú,0,2,,2,-73.181317,7.1280470000000005
12510,2013,Enero,Perú,35,57,,92,-72.453013,7.819
12511,2013,Enero,Perú,0,1,,1,-77.35002,8.63337
12512,2013,Enero,Polonia,0,1,,1,-69.941498,4.191162
12513,2013,Enero,Polonia,9,6,,15,-77.35600000000001,0.81488
12514,2013,Enero,Polonia,0,8,,8,-75.527794,10.406342
12515,2013,Enero,Polonia,2,7,,9,-75.516486,10.446304
12516,2013,Enero,Polonia,0,9,,9,-74.765343,10.970933
12517,2013,Enero,Polonia,1,4,,5,-72.129595,11.360028999999999
12518,2013,Enero,Polonia,1,0,,1,-81.70216500000001,12.5862
12519,2013,Enero,Polonia,1,2,,3,-76.532004,3.451668
12520,2013,Enero,Polonia,0,4,,4,-77.061029,3.8844260000000004
12521,2013,Enero,Polonia,80,114,,194,-74.140516,4.697157
12522,2013,Enero,Polonia,3,1,,4,-75.42726,6.170465
12523,2013,Enero,Polonia,0,3,,3,-72.453013,7.819
12524,2013,Enero,Polonia,1,1,,2,-72.508188,7.927233
12525,2013,Enero,Portugal,5,19,,24,-77.35600000000001,0.81488
12526,2013,Enero,Portugal,0,2,,2,-75.527794,10.406342
12527,2013,Enero,Portugal,1,20,,21,-75.516486,10.446304
12528,2013,Enero,Portugal,0,2,,2,-74.77647900000001,10.886686
12529,2013,Enero,Portugal,0,3,,3,-72.129595,11.360028999999999
12530,2013,Enero,Portugal,7,20,,27,-76.532004,3.451668
12531,2013,Enero,Portugal,111,373,,484,-74.140516,4.697157
12532,2013,Enero,Portugal,0,1,,1,-75.736374,4.815189
12533,2013,Enero,Portugal,6,28,,34,-75.42726,6.170465
12534,2013,Enero,Portugal,3,5,,8,-72.453013,7.819
12535,2013,Enero,Portugal,0,2,,2,-72.508188,7.927233
12536,2013,Enero,Puerto Rico/Territorio de Estados Unidos,1,1,,2,-75.516486,10.446304
12537,2013,Enero,Puerto Rico/Territorio de Estados Unidos,0,3,,3,-74.140516,4.697157
12538,2013,Enero,Qatar,2,22,,24,-74.140516,4.697157
12539,2013,Enero,Reino Unido de Gran Bretaña e Irlanda del Norte,3,2,,5,-69.941498,4.191162
12540,2013,Enero,Reino Unido de Gran Bretaña e Irlanda del Norte,5,10,,15,-77.35600000000001,0.81488
12541,2013,Enero,Reino Unido de Gran Bretaña e Irlanda del Norte,2,6,,8,-75.527794,10.406342
12542,2013,Enero,Reino Unido de Gran Bretaña e Irlanda del Norte,21,37,,58,-75.516486,10.446304
12543,2013,Enero,Reino Unido de Gran Bretaña e Irlanda del Norte,0,2,,2,-74.77647900000001,10.886686
12544,2013,Enero,Reino Unido de Gran Bretaña e Irlanda del Norte,1,2,,3,-74.213989,11.247722999999999
12545,2013,Enero,Reino Unido de Gran Bretaña e Irlanda del Norte,0,2,,2,-72.129595,11.360028999999999
12546,2013,Enero,Reino Unido de Gran Bretaña e Irlanda del Norte,14,22,,36,-76.532004,3.451668
12547,2013,Enero,Reino Unido de Gran Bretaña e Irlanda del Norte,211,487,,698,-74.140516,4.697157
12548,2013,Enero,Reino Unido de Gran Bretaña e Irlanda del Norte,15,50,,65,-75.42726,6.170465
12549,2013,Enero,Reino Unido de Gran Bretaña e Irlanda del Norte,1,8,,9,-72.453013,7.819
12550,2013,Enero,Reino Unido de Gran Bretaña e Irlanda del Norte,0,1,,1,-72.508188,7.927233
12551,2013,Enero,República de Belarús,1,4,,5,-74.140516,4.697157
12552,2013,Enero,República Dominicana,1,4,,5,-77.35600000000001,0.81488
12553,2013,Enero,República Dominicana,0,1,,1,-75.527794,10.406342
12554,2013,Enero,República Dominicana,16,24,,40,-75.516486,10.446304
12555,2013,Enero,República Dominicana,15,84,,99,-74.77647900000001,10.886686
12556,2013,Enero,República Dominicana,1,3,,4,-72.129595,11.360028999999999
12557,2013,Enero,República Dominicana,20,15,,35,-76.532004,3.451668
12558,2013,Enero,República Dominicana,200,260,,460,-74.140516,4.697157
12559,2013,Enero,República Dominicana,2,1,,3,-75.736374,4.815189
12560,2013,Enero,República Dominicana,29,44,,73,-75.42726,6.170465
12561,2013,Enero,República Dominicana,2,0,,2,-73.181317,7.1280470000000005
12562,2013,Enero,República Dominicana,1,2,,3,-72.453013,7.819
12563,2013,Enero,República Dominicana,4,2,,6,-72.508188,7.927233
12564,2013,Enero,República Checa,3,1,,4,-75.527794,10.406342
12565,2013,Enero,República Checa,1,0,,1,-75.516486,10.446304
12566,2013,Enero,República Checa,3,4,,7,-74.140516,4.697157
12567,2013,Enero,República Checa,1,1,,2,-72.453013,7.819
12568,2013,Enero,Rumania,2,1,,3,-77.35600000000001,0.81488
12569,2013,Enero,Rumania,0,2,,2,-75.527794,10.406342
12570,2013,Enero,Rumania,2,3,,5,-75.516486,10.446304
12571,2013,Enero,Rumania,0,1,,1,-74.765343,10.970933
12572,2013,Enero,Rumania,1,1,,2,-72.129595,11.360028999999999
12573,2013,Enero,Rumania,1,3,,4,-76.532004,3.451668
12574,2013,Enero,Rumania,29,39,,68,-74.140516,4.697157
12575,2013,Enero,Rumania,2,6,,8,-75.42726,6.170465
12576,2013,Enero,Rumania,0,1,,1,-72.453013,7.819
12577,2013,Enero,Federación de Rusia,1,4,,5,-77.35600000000001,0.81488
12578,2013,Enero,Federación de Rusia,11,5,,16,-75.516486,10.446304
12579,2013,Enero,Federación de Rusia,1,2,,3,-74.77647900000001,10.886686
12580,2013,Enero,Federación de Rusia,0,1,,1,-72.129595,11.360028999999999
12581,2013,Enero,Federación de Rusia,2,0,,2,-76.532004,3.451668
12582,2013,Enero,Federación de Rusia,47,57,,104,-74.140516,4.697157
12583,2013,Enero,Federación de Rusia,1,0,,1,-75.42726,6.170465
12584,2013,Enero,Federación de Rusia,1,1,,2,-73.181317,7.1280470000000005
12585,2013,Enero,Federación de Rusia,1,0,,1,-72.453013,7.819
12586,2013,Enero,Federación de Rusia,1,0,,1,-77.35002,8.63337
12587,2013,Enero,Federación de Rusia,0,1,,1,-75.68164200000001,9.402597
12588,2013,Enero,Rwanda,0,1,,1,-74.140516,4.697157
12589,2013,Enero,Samoa Occidental,1,0,,1,-74.140516,4.697157
12590,2013,Enero,San  Vicente y las Granadinas,0,1,,1,-75.527794,10.406342
12591,2013,Enero,San  Vicente y las Granadinas,0,1,,1,-75.516486,10.446304
12592,2013,Enero,Santa Lucia,1,0,,1,-75.516486,10.446304
12593,2013,Enero,Santa Lucia,0,1,,1,-81.70216500000001,12.5862
12594,2013,Enero,Santa Lucia,1,0,,1,-76.532004,3.451668
12595,2013,Enero,Santa Lucia,2,0,,2,-74.140516,4.697157
12596,2013,Enero,Santa Lucia,6,3,,9,-73.181317,7.1280470000000005
12597,2013,Enero,Santa Sede/Ciudad del Vaticano,0,1,,1,-74.140516,4.697157
12598,2013,Enero,Senegal,0,1,,1,-74.140516,4.697157
12599,2013,Enero,Serbia,1,0,,1,-75.516486,10.446304
12600,2013,Enero,Serbia,1,0,,1,-76.532004,3.451668
12601,2013,Enero,Serbia,3,5,,8,-74.140516,4.697157
12602,2013,Enero,Sierra Leona,0,2,,2,-74.140516,4.697157
12603,2013,Enero,Singapur,1,1,,2,-75.516486,10.446304
12604,2013,Enero,Singapur,1,0,,1,-76.532004,3.451668
12605,2013,Enero,Singapur,13,24,,37,-74.140516,4.697157
12606,2013,Enero,Singapur,0,1,,1,-75.42726,6.170465
12607,2013,Enero,Singapur,1,0,,1,-73.181317,7.1280470000000005
12608,2013,Enero,República Árabe Siria,1,0,,1,-74.77647900000001,10.886686
12609,2013,Enero,República Árabe Siria,1,2,,3,-74.140516,4.697157
12610,2013,Enero,Sri Lanka,0,9,,9,-74.140516,4.697157
12611,2013,Enero,Sudáfrica,1,0,,1,-69.941498,4.191162
12612,2013,Enero,Sudáfrica,1,3,,4,-75.527794,10.406342
12613,2013,Enero,Sudáfrica,4,3,,7,-75.516486,10.446304
12614,2013,Enero,Sudáfrica,1,2,,3,-74.77647900000001,10.886686
12615,2013,Enero,Sudáfrica,1,2,,3,-74.213989,11.247722999999999
12616,2013,Enero,Sudáfrica,0,1,,1,-76.532004,3.451668
12617,2013,Enero,Sudáfrica,30,58,,88,-74.140516,4.697157
12618,2013,Enero,Sudáfrica,0,2,,2,-75.736374,4.815189
12619,2013,Enero,Sudáfrica,3,6,,9,-75.42726,6.170465
12620,2013,Enero,Suecia,0,5,,5,-69.941498,4.191162
12621,2013,Enero,Suecia,6,12,,18,-77.35600000000001,0.81488
12622,2013,Enero,Suecia,0,1,,1,-78.802679,18.00143
12623,2013,Enero,Suecia,9,10,,19,-75.527794,10.406342
12624,2013,Enero,Suecia,13,31,,44,-75.516486,10.446304
12625,2013,Enero,Suecia,1,1,,2,-74.77647900000001,10.886686
12626,2013,Enero,Suecia,1,2,,3,-72.129595,11.360028999999999
12627,2013,Enero,Suecia,0,1,,1,-81.703935,12.574411099999999
12628,2013,Enero,Suecia,1,1,,2,-81.70216500000001,12.5862
12629,2013,Enero,Suecia,1,0,,1,-81.372937,13.338761300000002
12630,2013,Enero,Suecia,7,10,,17,-76.532004,3.451668
12631,2013,Enero,Suecia,178,299,,477,-74.140516,4.697157
12632,2013,Enero,Suecia,9,29,,38,-75.42726,6.170465
12633,2013,Enero,Suecia,0,1,,1,-73.181317,7.1280470000000005
12634,2013,Enero,Suecia,1,5,,6,-72.453013,7.819
12635,2013,Enero,Suecia,2,2,,4,-77.35002,8.63337
12636,2013,Enero,Suiza,5,7,,12,-69.941498,4.191162
12637,2013,Enero,Suiza,0,1,,1,-76.876446,0.33002
12638,2013,Enero,Suiza,27,28,,55,-77.35600000000001,0.81488
12639,2013,Enero,Suiza,17,19,,36,-75.527794,10.406342
12640,2013,Enero,Suiza,15,30,,45,-75.516486,10.446304
12641,2013,Enero,Suiza,2,10,,12,-74.77647900000001,10.886686
12642,2013,Enero,Suiza,8,5,,13,-72.129595,11.360028999999999
12643,2013,Enero,Suiza,0,1,,1,-81.70216500000001,12.5862
12644,2013,Enero,Suiza,18,39,,57,-76.532004,3.451668
12645,2013,Enero,Suiza,317,538,,855,-74.140516,4.697157
12646,2013,Enero,Suiza,0,1,,1,-75.736374,4.815189
12647,2013,Enero,Suiza,15,43,,58,-75.42726,6.170465
12648,2013,Enero,Suiza,0,1,,1,-73.181317,7.1280470000000005
12649,2013,Enero,Suiza,4,5,,9,-72.453013,7.819
12650,2013,Enero,Suiza,2,1,,3,-72.508188,7.927233
12651,2013,Enero,Suiza,2,9,,11,-77.35002,8.63337
12652,2013,Enero,Surinam,0,1,,1,-69.941498,4.191162
12653,2013,Enero,Surinam,1,0,,1,-75.516486,10.446304
12654,2013,Enero,Surinam,1,0,,1,-74.77647900000001,10.886686
12655,2013,Enero,Surinam,0,2,,2,-76.532004,3.451668
12656,2013,Enero,Surinam,8,10,,18,-74.140516,4.697157
12657,2013,Enero,Surinam,2,5,,7,-75.42726,6.170465
12658,2013,Enero,Surinam,0,1,,1,-72.508188,7.927233
12659,2013,Enero,Taiwán,1,0,,1,-76.532004,3.451668
12660,2013,Enero,Taiwán,2,2,,4,-74.140516,4.697157
12661,2013,Enero,Tailandia,0,4,,4,-74.140516,4.697157
12662,2013,Enero,Tailandia,1,1,,2,-75.42726,6.170465
12663,2013,Enero,Tíbet/Región Autónoma de China,0,1,,1,-74.140516,4.697157
12664,2013,Enero,Territorio Antártico Británico/Territorio Británico de Ultramar,1,1,,2,-75.527794,10.406342
12665,2013,Enero,Territorio Antártico Británico/Territorio Británico de Ultramar,3,1,,4,-74.140516,4.697157
12666,2013,Enero,Tanzania,1,2,,3,-74.140516,4.697157
12667,2013,Enero,Tanzania,0,1,,1,-72.453013,7.819
12668,2013,Enero,Togo,0,1,,1,-75.516486,10.446304
12669,2013,Enero,Togo,0,2,,2,-74.140516,4.697157
12670,2013,Enero,Trinidad y Tobago,1,11,,12,-75.516486,10.446304
12671,2013,Enero,Trinidad y Tobago,1,0,,1,-74.213989,11.247722999999999
12672,2013,Enero,Trinidad y Tobago,0,1,,1,-72.129595,11.360028999999999
12673,2013,Enero,Trinidad y Tobago,0,2,,2,-81.703935,12.574411099999999
12674,2013,Enero,Trinidad y Tobago,5,13,,18,-76.532004,3.451668
12675,2013,Enero,Trinidad y Tobago,18,26,,44,-74.140516,4.697157
12676,2013,Enero,Trinidad y Tobago,0,2,,2,-75.736374,4.815189
12677,2013,Enero,Trinidad y Tobago,3,6,,9,-75.42726,6.170465
12678,2013,Enero,Trinidad y Tobago,0,8,,8,-73.181317,7.1280470000000005
12679,2013,Enero,Trinidad y Tobago,0,1,,1,-72.453013,7.819
12680,2013,Enero,Trinidad y Tobago,0,2,,2,-72.508188,7.927233
12681,2013,Enero,Túnez,3,1,,4,-74.140516,4.697157
12682,2013,Enero,Turquía,2,1,,3,-69.941498,4.191162
12683,2013,Enero,Turquía,2,2,,4,-77.35600000000001,0.81488
12684,2013,Enero,Turquía,0,1,,1,-75.527794,10.406342
12685,2013,Enero,Turquía,0,4,,4,-74.77647900000001,10.886686
12686,2013,Enero,Turquía,50,107,,157,-74.140516,4.697157
12687,2013,Enero,Turquía,6,26,,32,-75.42726,6.170465
12688,2013,Enero,Turquía,1,4,,5,-72.453013,7.819
12689,2013,Enero,Turquía,1,1,,2,-77.35002,8.63337
12690,2013,Enero,Turkmenistán,2,0,,2,-74.140516,4.697157
12691,2013,Enero,Ucrania,0,2,,2,-77.35600000000001,0.81488
12692,2013,Enero,Ucrania,0,1,,1,-75.527794,10.406342
12693,2013,Enero,Ucrania,1,0,,1,-75.516486,10.446304
12694,2013,Enero,Ucrania,0,1,,1,-74.77647900000001,10.886686
12695,2013,Enero,Ucrania,35,41,,76,-74.140516,4.697157
12696,2013,Enero,Ucrania,2,0,,2,-75.42726,6.170465
12697,2013,Enero,Uganda,0,2,,2,-74.140516,4.697157
12698,2013,Enero,Federación de Rusia,0,1,,1,-69.941498,4.191162
12699,2013,Enero,Federación de Rusia,0,5,,5,-77.35600000000001,0.81488
12700,2013,Enero,Federación de Rusia,0,8,,8,-75.527794,10.406342
12701,2013,Enero,Federación de Rusia,8,5,,13,-75.516486,10.446304
12702,2013,Enero,Federación de Rusia,2,0,,2,-74.77647900000001,10.886686
12703,2013,Enero,Federación de Rusia,4,5,,9,-72.129595,11.360028999999999
12704,2013,Enero,Federación de Rusia,2,2,,4,-76.532004,3.451668
12705,2013,Enero,Federación de Rusia,264,331,,595,-74.140516,4.697157
12706,2013,Enero,Federación de Rusia,0,2,,2,-75.42726,6.170465
12707,2013,Enero,Federación de Rusia,2,0,,2,-73.181317,7.1280470000000005
12708,2013,Enero,Federación de Rusia,1,0,,1,-72.453013,7.819
12709,2013,Enero,Federación de Rusia,1,1,,2,-77.35002,8.63337
12710,2013,Enero,Uruguay,12,18,,30,-77.35600000000001,0.81488
12711,2013,Enero,Uruguay,94,70,,164,-75.516486,10.446304
12712,2013,Enero,Uruguay,2,7,,9,-74.77647900000001,10.886686
12713,2013,Enero,Uruguay,2,5,,7,-72.129595,11.360028999999999
12714,2013,Enero,Uruguay,24,15,,39,-81.70216500000001,12.5862
12715,2013,Enero,Uruguay,24,25,,49,-76.532004,3.451668
12716,2013,Enero,Uruguay,140,228,,368,-74.140516,4.697157
12717,2013,Enero,Uruguay,1,4,,5,-75.736374,4.815189
12718,2013,Enero,Uruguay,10,35,,45,-75.42726,6.170465
12719,2013,Enero,Uruguay,0,1,,1,-73.181317,7.1280470000000005
12720,2013,Enero,Uruguay,2,7,,9,-72.453013,7.819
12721,2013,Enero,Uruguay,1,1,,2,-72.508188,7.927233
12722,2013,Enero,Uruguay,1,2,,3,-77.35002,8.63337
12723,2013,Enero,Uzbekistán,1,0,,1,-74.140516,4.697157
12724,2013,Enero,Venezuela,218,230,,448,-77.35600000000001,0.81488
12725,2013,Enero,Venezuela,6,6,,12,-75.527794,10.406342
12726,2013,Enero,Venezuela,110,161,,271,-75.516486,10.446304
12727,2013,Enero,Venezuela,59,90,,149,-74.77647900000001,10.886686
12728,2013,Enero,Venezuela,1209,1878,,3087,-72.129595,11.360028999999999
12729,2013,Enero,Venezuela,1,1,,2,-72.919186,11.52863
12730,2013,Enero,Venezuela,8,2,,10,-81.70216500000001,12.5862
12731,2013,Enero,Venezuela,86,111,,197,-76.532004,3.451668
12732,2013,Enero,Venezuela,1,1,,2,-75.76635300000001,4.45285
12733,2013,Enero,Venezuela,5877,6570,,12447,-74.140516,4.697157
12734,2013,Enero,Venezuela,3,19,,22,-75.736374,4.815189
12735,2013,Enero,Venezuela,358,415,,773,-75.42726,6.170465
12736,2013,Enero,Venezuela,134,204,,338,-67.48402800000001,6.185536
12737,2013,Enero,Venezuela,57,104,,161,-70.74025300000001,7.088728999999999
12738,2013,Enero,Venezuela,4,3,,7,-73.181317,7.1280470000000005
12739,2013,Enero,Venezuela,1408,1586,,2994,-72.453013,7.819
12740,2013,Enero,Venezuela,238,262,,500,-72.508188,7.927233
12741,2013,Enero,Venezuela,1,2,,3,-77.35002,8.63337
12742,2013,Enero,Vietnam,0,1,,1,-75.527794,10.406342
12743,2013,Enero,Vietnam,1,0,,1,-74.140516,4.697157
12744,2013,Enero,Yugoslavia,1,0,,1,-74.140516,4.697157
12745,2013,Enero,Zambia,0,1,,1,-74.140516,4.697157
12746,2013,Enero,Zimbabue,0,2,,2,-74.140516,4.697157
12747,2013,Enero,Reino Unido de Gran Bretaña e Irlanda del Norte,2,5,,7,-69.941498,4.191162
12748,2013,Enero,Reino Unido de Gran Bretaña e Irlanda del Norte,29,38,,67,-77.35600000000001,0.81488
12749,2013,Enero,Reino Unido de Gran Bretaña e Irlanda del Norte,20,38,,58,-75.527794,10.406342
12750,2013,Enero,Reino Unido de Gran Bretaña e Irlanda del Norte,17,32,,49,-75.516486,10.446304
12751,2013,Enero,Reino Unido de Gran Bretaña e Irlanda del Norte,0,2,,2,-74.77647900000001,10.886686
12752,2013,Enero,Reino Unido de Gran Bretaña e Irlanda del Norte,6,7,,13,-74.213989,11.247722999999999
12753,2013,Enero,Reino Unido de Gran Bretaña e Irlanda del Norte,5,2,,7,-72.129595,11.360028999999999
12754,2013,Enero,Reino Unido de Gran Bretaña e Irlanda del Norte,0,1,,1,-81.703935,12.574411099999999
12755,2013,Enero,Reino Unido de Gran Bretaña e Irlanda del Norte,1,5,,6,-81.70216500000001,12.5862
12756,2013,Enero,Reino Unido de Gran Bretaña e Irlanda del Norte,2,3,,5,-81.372937,13.338761300000002
12757,2013,Enero,Reino Unido de Gran Bretaña e Irlanda del Norte,7,24,,31,-76.532004,3.451668
12758,2013,Enero,Reino Unido de Gran Bretaña e Irlanda del Norte,268,626,,894,-74.140516,4.697157
12759,2013,Enero,Reino Unido de Gran Bretaña e Irlanda del Norte,3,23,,26,-75.42726,6.170465
12760,2013,Enero,Reino Unido de Gran Bretaña e Irlanda del Norte,0,1,,1,-67.48402800000001,6.185536
12761,2013,Enero,Reino Unido de Gran Bretaña e Irlanda del Norte,0,1,,1,-73.181317,7.1280470000000005
12762,2013,Enero,Reino Unido de Gran Bretaña e Irlanda del Norte,2,7,,9,-72.453013,7.819
12763,2013,Enero,Reino Unido de Gran Bretaña e Irlanda del Norte,9,8,,17,-77.35002,8.63337
12764,2013,Enero,Países Bajos,0,2,,2,-69.941498,4.191162
12765,2013,Enero,Países Bajos,16,15,,31,-77.35600000000001,0.81488
12766,2013,Enero,Países Bajos,19,24,,43,-75.527794,10.406342
12767,2013,Enero,Países Bajos,11,37,,48,-75.516486,10.446304
12768,2013,Enero,Países Bajos,3,4,,7,-74.77647900000001,10.886686
12769,2013,Enero,Países Bajos,2,6,,8,-72.129595,11.360028999999999
12770,2013,Enero,Países Bajos,1,1,,2,-81.703935,12.574411099999999
12771,2013,Enero,Países Bajos,1,2,,3,-81.70216500000001,12.5862
12772,2013,Enero,Países Bajos,13,29,,42,-76.532004,3.451668
12773,2013,Enero,Países Bajos,390,651,,1041,-74.140516,4.697157
12774,2013,Enero,Países Bajos,0,2,,2,-75.736374,4.815189
12775,2013,Enero,Países Bajos,90,112,,202,-75.42726,6.170465
12776,2013,Enero,Países Bajos,0,1,,1,-70.74025300000001,7.088728999999999
12777,2013,Enero,Países Bajos,1,3,,4,-73.181317,7.1280470000000005
12778,2013,Enero,Países Bajos,0,4,,4,-72.453013,7.819
12779,2013,Enero,Países Bajos,1,3,,4,-72.508188,7.927233
12780,2013,Enero,Países Bajos,7,3,,10,-77.35002,8.63337
12781,2013,Enero,Desconocido,1,0,,1,-74.140516,4.697157
12782,2013,Enero,Lituania,1,1,,2,-75.527794,10.406342
12783,2013,Enero,Lituania,4,1,,5,-74.140516,4.697157
12784,2013,Enero,Reino Unido de Gran Bretaña e Irlanda del Norte,0,1,,1,-76.532004,3.451668
12785,2013,Enero,Reino Unido de Gran Bretaña e Irlanda del Norte,2,0,,2,-74.140516,4.697157
12786,2013,Enero,Reino Unido de Gran Bretaña e Irlanda del Norte,1,0,,1,-72.508188,7.927233
12787,2013,Enero,Reino Unido de Gran Bretaña e Irlanda del Norte,4,3,,7,-75.527794,10.406342
12788,2013,Enero,Reino Unido de Gran Bretaña e Irlanda del Norte,0,1,,1,-75.516486,10.446304
12789,2013,Enero,Reino Unido de Gran Bretaña e Irlanda del Norte,0,1,,1,-72.129595,11.360028999999999
12790,2013,Enero,Reino Unido de Gran Bretaña e Irlanda del Norte,0,2,,2,-81.372937,13.338761300000002
12791,2013,Enero,Reino Unido de Gran Bretaña e Irlanda del Norte,5,6,,11,-74.140516,4.697157
12792,2013,Enero,Reino Unido de Gran Bretaña e Irlanda del Norte,0,1,,1,-72.453013,7.819
12793,2013,Enero,Letonia,1,0,,1,-74.140516,4.697157
12794,2013,Enero,Marruecos,0,1,,1,-74.140516,4.697157
12795,2013,Febrero,Desconocido,31,68,,99,-69.941498,4.191162
12796,2013,Febrero,Afganistán,0,1,,1,-74.140516,4.697157
12797,2013,Febrero,Albania,1,0,,1,-75.516486,10.446304
12798,2013,Febrero,Albania,2,0,,2,-74.140516,4.697157
12799,2013,Febrero,Alemania,0,1,,1,-69.941498,4.191162
12800,2013,Febrero,Alemania,62,65,,127,-77.35600000000001,0.81488
12801,2013,Febrero,Alemania,1,1,,2,-78.802679,18.00143
12802,2013,Febrero,Alemania,8,30,,38,-75.527794,10.406342
12803,2013,Febrero,Alemania,17,55,,72,-75.516486,10.446304
12804,2013,Febrero,Alemania,7,17,,24,-74.77647900000001,10.886686
12805,2013,Febrero,Alemania,3,3,,6,-74.213989,11.247722999999999
12806,2013,Febrero,Alemania,7,8,,15,-72.129595,11.360028999999999
12807,2013,Febrero,Alemania,2,3,,5,-81.70216500000001,12.5862
12808,2013,Febrero,Alemania,38,73,,111,-76.532004,3.451668
12809,2013,Febrero,Alemania,0,1,,1,-75.76635300000001,4.45285
12810,2013,Febrero,Alemania,1323,2067,,3390,-74.140516,4.697157
12811,2013,Febrero,Alemania,1,5,,6,-75.736374,4.815189
12812,2013,Febrero,Alemania,40,113,,153,-75.42726,6.170465
12813,2013,Febrero,Alemania,2,0,,2,-67.48402800000001,6.185536
12814,2013,Febrero,Alemania,0,1,,1,-73.181317,7.1280470000000005
12815,2013,Febrero,Alemania,2,11,,13,-72.453013,7.819
12816,2013,Febrero,Andorra,1,1,,2,-75.527794,10.406342
12817,2013,Febrero,Andorra,0,2,,2,-75.516486,10.446304
12818,2013,Febrero,Andorra,0,1,,1,-74.77647900000001,10.886686
12819,2013,Febrero,Andorra,0,7,,7,-74.140516,4.697157
12820,2013,Febrero,Angola,0,1,,1,-76.532004,3.451668
12821,2013,Febrero,Angola,0,1,,1,-74.140516,4.697157
12822,2013,Febrero,Antigua y Barbuda,0,1,,1,-75.516486,10.446304
12823,2013,Febrero,Antigua y Barbuda,0,2,,2,-74.140516,4.697157
12824,2013,Febrero,Países Bajos,0,1,,1,-75.516486,10.446304
12825,2013,Febrero,Países Bajos,1,0,,1,-75.42726,6.170465
12826,2013,Febrero,Arabia Saudita,0,4,,4,-74.140516,4.697157
12827,2013,Febrero,Argelia,1,2,,3,-74.140516,4.697157
12828,2013,Febrero,Argentina,79,153,,232,-77.35600000000001,0.81488
12829,2013,Febrero,Argentina,0,2,,2,-78.802679,18.00143
12830,2013,Febrero,Argentina,125,86,,211,-75.527794,10.406342
12831,2013,Febrero,Argentina,625,465,,1090,-75.516486,10.446304
12832,2013,Febrero,Argentina,14,30,,44,-74.77647900000001,10.886686
12833,2013,Febrero,Argentina,21,52,,73,-72.129595,11.360028999999999
12834,2013,Febrero,Argentina,235,166,,401,-81.70216500000001,12.5862
12835,2013,Febrero,Argentina,63,87,,150,-76.532004,3.451668
12836,2013,Febrero,Argentina,0,1,,1,-75.76635300000001,4.45285
12837,2013,Febrero,Argentina,3962,5120,,9082,-74.140516,4.697157
12838,2013,Febrero,Argentina,0,4,,4,-75.736374,4.815189
12839,2013,Febrero,Argentina,128,272,,400,-75.42726,6.170465
12840,2013,Febrero,Argentina,28,50,,78,-72.453013,7.819
12841,2013,Febrero,Argentina,0,5,,5,-72.508188,7.927233
12842,2013,Febrero,República de Armenia,2,1,,3,-74.140516,4.697157
12843,2013,Febrero,Aruba,1,0,,1,-76.532004,3.451668
12844,2013,Febrero,Aruba,5,2,,7,-74.140516,4.697157
12845,2013,Febrero,Aruba,4,6,,10,-75.42726,6.170465
12846,2013,Febrero,Australia,7,2,,9,-69.941498,4.191162
12847,2013,Febrero,Australia,17,25,,42,-77.35600000000001,0.81488
12848,2013,Febrero,Australia,12,31,,43,-75.527794,10.406342
12849,2013,Febrero,Australia,14,39,,53,-75.516486,10.446304
12850,2013,Febrero,Australia,7,15,,22,-74.77647900000001,10.886686
12851,2013,Febrero,Australia,0,1,,1,-74.213989,11.247722999999999
12852,2013,Febrero,Australia,1,3,,4,-72.129595,11.360028999999999
12853,2013,Febrero,Australia,3,0,,3,-81.70216500000001,12.5862
12854,2013,Febrero,Australia,7,21,,28,-76.532004,3.451668
12855,2013,Febrero,Australia,203,392,,595,-74.140516,4.697157
12856,2013,Febrero,Australia,1,0,,1,-75.736374,4.815189
12857,2013,Febrero,Australia,16,62,,78,-75.42726,6.170465
12858,2013,Febrero,Australia,5,3,,8,-72.453013,7.819
12859,2013,Febrero,Austria,9,12,,21,-77.35600000000001,0.81488
12860,2013,Febrero,Austria,0,2,,2,-75.527794,10.406342
12861,2013,Febrero,Austria,9,7,,16,-75.516486,10.446304
12862,2013,Febrero,Austria,0,1,,1,-74.77647900000001,10.886686
12863,2013,Febrero,Austria,1,0,,1,-74.213989,11.247722999999999
12864,2013,Febrero,Austria,0,4,,4,-72.129595,11.360028999999999
12865,2013,Febrero,Austria,0,2,,2,-81.70216500000001,12.5862
12866,2013,Febrero,Austria,3,6,,9,-76.532004,3.451668
12867,2013,Febrero,Austria,101,222,,323,-74.140516,4.697157
12868,2013,Febrero,Austria,4,20,,24,-75.42726,6.170465
12869,2013,Febrero,Austria,0,2,,2,-72.453013,7.819
12870,2013,Febrero,Azerbaiyán,0,3,,3,-74.140516,4.697157
12871,2013,Febrero,Bahamas,3,1,,4,-75.516486,10.446304
12872,2013,Febrero,Bahamas,0,1,,1,-74.77647900000001,10.886686
12873,2013,Febrero,Bahamas,0,2,,2,-76.532004,3.451668
12874,2013,Febrero,Bahamas,2,8,,10,-74.140516,4.697157
12875,2013,Febrero,Bahamas,0,1,,1,-75.42726,6.170465
12876,2013,Febrero,Bangladesh,0,20,,20,-74.140516,4.697157
12877,2013,Febrero,Barbados,1,1,,2,-75.516486,10.446304
12878,2013,Febrero,Barbados,0,2,,2,-74.140516,4.697157
12879,2013,Febrero,Barbados,1,0,,1,-72.453013,7.819
12880,2013,Febrero,República de Belarús,2,0,,2,-74.140516,4.697157
12881,2013,Febrero,Bélgica,7,12,,19,-77.35600000000001,0.81488
12882,2013,Febrero,Bélgica,6,4,,10,-75.527794,10.406342
12883,2013,Febrero,Bélgica,4,13,,17,-75.516486,10.446304
12884,2013,Febrero,Bélgica,0,2,,2,-74.77647900000001,10.886686
12885,2013,Febrero,Bélgica,1,0,,1,-72.129595,11.360028999999999
12886,2013,Febrero,Bélgica,9,17,,26,-76.532004,3.451668
12887,2013,Febrero,Bélgica,133,275,,408,-74.140516,4.697157
12888,2013,Febrero,Bélgica,3,14,,17,-75.42726,6.170465
12889,2013,Febrero,Bélgica,0,1,,1,-73.181317,7.1280470000000005
12890,2013,Febrero,Bélgica,1,4,,5,-72.453013,7.819
12891,2013,Febrero,Belice,1,4,,5,-75.516486,10.446304
12892,2013,Febrero,Belice,0,1,,1,-74.77647900000001,10.886686
12893,2013,Febrero,Belice,4,5,,9,-74.140516,4.697157
12894,2013,Febrero,Belice,0,2,,2,-75.42726,6.170465
12895,2013,Febrero,Benín,1,0,,1,-74.140516,4.697157
12896,2013,Febrero,Bermudas/Territorio Británico de Ultramar,2,1,,3,-74.77647900000001,10.886686
12897,2013,Febrero,Bolivia,32,44,,76,-77.35600000000001,0.81488
12898,2013,Febrero,Bolivia,25,13,,38,-75.527794,10.406342
12899,2013,Febrero,Bolivia,10,15,,25,-75.516486,10.446304
12900,2013,Febrero,Bolivia,3,2,,5,-74.77647900000001,10.886686
12901,2013,Febrero,Bolivia,13,9,,22,-81.70216500000001,12.5862
12902,2013,Febrero,Bolivia,9,9,,18,-76.532004,3.451668
12903,2013,Febrero,Bolivia,965,755,,1720,-74.140516,4.697157
12904,2013,Febrero,Bolivia,0,3,,3,-75.736374,4.815189
12905,2013,Febrero,Bolivia,8,8,,16,-75.42726,6.170465
12906,2013,Febrero,Bolivia,1,1,,2,-73.181317,7.1280470000000005
12907,2013,Febrero,Bolivia,2,3,,5,-72.453013,7.819
12908,2013,Febrero,Bosnia y Herzegovina,1,1,,2,-74.140516,4.697157
12909,2013,Febrero,Brasil,43,33,,76,-69.941498,4.191162
12910,2013,Febrero,Brasil,15,22,,37,-77.35600000000001,0.81488
12911,2013,Febrero,Brasil,9,10,,19,-75.527794,10.406342
12912,2013,Febrero,Brasil,283,230,,513,-75.516486,10.446304
12913,2013,Febrero,Brasil,3,20,,23,-74.77647900000001,10.886686
12914,2013,Febrero,Brasil,1,0,,1,-74.213989,11.247722999999999
12915,2013,Febrero,Brasil,5,11,,16,-72.129595,11.360028999999999
12916,2013,Febrero,Brasil,32,20,,52,-81.70216500000001,12.5862
12917,2013,Febrero,Brasil,21,49,,70,-76.532004,3.451668
12918,2013,Febrero,Brasil,1,0,,1,-73.558456,4.076512
12919,2013,Febrero,Brasil,2303,3206,,5509,-74.140516,4.697157
12920,2013,Febrero,Brasil,66,124,,190,-75.42726,6.170465
12921,2013,Febrero,Brasil,1,0,,1,-67.48402800000001,6.185536
12922,2013,Febrero,Brasil,1,2,,3,-73.181317,7.1280470000000005
12923,2013,Febrero,Brasil,7,25,,32,-72.453013,7.819
12924,2013,Febrero,Brasil,2,7,,9,-72.508188,7.927233
12925,2013,Febrero,Bulgaria,2,1,,3,-81.70216500000001,12.5862
12926,2013,Febrero,Bulgaria,0,1,,1,-76.532004,3.451668
12927,2013,Febrero,Bulgaria,10,5,,15,-74.140516,4.697157
12928,2013,Febrero,Bulgaria,1,0,,1,-72.453013,7.819
12929,2013,Febrero,Burundi,0,1,,1,-74.140516,4.697157
12930,2013,Febrero,Islas Caimán/Territorio Británico de Ultramar,2,1,,3,-75.516486,10.446304
12931,2013,Febrero,Islas Caimán/Territorio Británico de Ultramar,0,1,,1,-75.42726,6.170465
12932,2013,Febrero,Camerún,0,1,,1,-77.35600000000001,0.81488
12933,2013,Febrero,Camerún,1,0,,1,-72.129595,11.360028999999999
12934,2013,Febrero,Camerún,1,0,,1,-76.532004,3.451668
12935,2013,Febrero,Camerún,1,2,,3,-74.140516,4.697157
12936,2013,Febrero,Canadá,0,3,,3,-69.941498,4.191162
12937,2013,Febrero,Canadá,22,42,,64,-77.35600000000001,0.81488
12938,2013,Febrero,Canadá,12,24,,36,-75.527794,10.406342
12939,2013,Febrero,Canadá,794,766,,1560,-75.516486,10.446304
12940,2013,Febrero,Canadá,14,21,,35,-74.77647900000001,10.886686
12941,2013,Febrero,Canadá,1,1,,2,-74.213989,11.247722999999999
12942,2013,Febrero,Canadá,2,6,,8,-72.129595,11.360028999999999
12943,2013,Febrero,Canadá,354,321,,675,-81.70216500000001,12.5862
12944,2013,Febrero,Canadá,36,49,,85,-76.532004,3.451668
12945,2013,Febrero,Canadá,4,1,,5,-75.76635300000001,4.45285
12946,2013,Febrero,Canadá,701,1447,,2148,-74.140516,4.697157
12947,2013,Febrero,Canadá,0,4,,4,-75.736374,4.815189
12948,2013,Febrero,Canadá,108,180,,288,-75.42726,6.170465
12949,2013,Febrero,Canadá,0,1,,1,-77.401154,6.222551999999999
12950,2013,Febrero,Canadá,0,4,,4,-73.181317,7.1280470000000005
12951,2013,Febrero,Canadá,7,10,,17,-72.453013,7.819
12952,2013,Febrero,Canadá,0,1,,1,-72.508188,7.927233
12953,2013,Febrero,España,8,4,,12,-77.35600000000001,0.81488
12954,2013,Febrero,España,0,1,,1,-78.802679,18.00143
12955,2013,Febrero,España,5,8,,13,-75.527794,10.406342
12956,2013,Febrero,España,5,5,,10,-75.516486,10.446304
12957,2013,Febrero,España,3,19,,22,-74.77647900000001,10.886686
12958,2013,Febrero,España,0,2,,2,-74.213989,11.247722999999999
12959,2013,Febrero,España,2,1,,3,-72.129595,11.360028999999999
12960,2013,Febrero,España,43,96,,139,-76.532004,3.451668
12961,2013,Febrero,España,126,306,,432,-74.140516,4.697157
12962,2013,Febrero,España,0,2,,2,-75.736374,4.815189
12963,2013,Febrero,España,29,118,,147,-75.42726,6.170465
12964,2013,Febrero,España,0,1,,1,-70.74025300000001,7.088728999999999
12965,2013,Febrero,España,0,1,,1,-72.453013,7.819
12966,2013,Febrero,España,0,1,,1,-72.508188,7.927233
12967,2013,Febrero,República Democrática del Congo,1,2,,3,-74.140516,4.697157
12968,2013,Febrero,República de Corea,0,1,,1,-69.941498,4.191162
12969,2013,Febrero,República de Corea,3,1,,4,-77.35600000000001,0.81488
12970,2013,Febrero,República de Corea,1,1,,2,-75.527794,10.406342
12971,2013,Febrero,República de Corea,1,3,,4,-75.516486,10.446304
12972,2013,Febrero,República de Corea,2,8,,10,-76.532004,3.451668
12973,2013,Febrero,República de Corea,115,374,,489,-74.140516,4.697157
12974,2013,Febrero,República de Corea,0,24,,24,-75.42726,6.170465
12975,2013,Febrero,República de Corea,3,6,,9,-72.453013,7.819
12976,2013,Febrero,República de Corea,1,1,,2,-72.508188,7.927233
12977,2013,Febrero,Costa de Marfil,0,3,,3,-74.140516,4.697157
12978,2013,Febrero,Costa Rica,2,3,,5,-77.35600000000001,0.81488
12979,2013,Febrero,Costa Rica,27,31,,58,-75.516486,10.446304
12980,2013,Febrero,Costa Rica,14,17,,31,-74.77647900000001,10.886686
12981,2013,Febrero,Costa Rica,1,0,,1,-72.129595,11.360028999999999
12982,2013,Febrero,Costa Rica,309,231,,540,-81.70216500000001,12.5862
12983,2013,Febrero,Costa Rica,18,40,,58,-76.532004,3.451668
12984,2013,Febrero,Costa Rica,0,1,,1,-75.76635300000001,4.45285
12985,2013,Febrero,Costa Rica,524,724,,1248,-74.140516,4.697157
12986,2013,Febrero,Costa Rica,4,13,,17,-75.736374,4.815189
12987,2013,Febrero,Costa Rica,55,95,,150,-75.42726,6.170465
12988,2013,Febrero,Costa Rica,0,4,,4,-72.453013,7.819
12989,2013,Febrero,Costa Rica,2,0,,2,-72.508188,7.927233
12990,2013,Febrero,Croacia,1,2,,3,-77.35600000000001,0.81488
12991,2013,Febrero,Croacia,0,2,,2,-75.527794,10.406342
12992,2013,Febrero,Croacia,1,1,,2,-75.516486,10.446304
12993,2013,Febrero,Croacia,1,0,,1,-72.129595,11.360028999999999
12994,2013,Febrero,Croacia,15,19,,34,-74.140516,4.697157
12995,2013,Febrero,Croacia,1,2,,3,-75.42726,6.170465
12996,2013,Febrero,Croacia,0,1,,1,-72.453013,7.819
12997,2013,Febrero,Cuba,0,2,,2,-77.35600000000001,0.81488
12998,2013,Febrero,Cuba,7,10,,17,-75.516486,10.446304
12999,2013,Febrero,Cuba,8,9,,17,-74.77647900000001,10.886686
13000,2013,Febrero,Cuba,1,0,,1,-81.70216500000001,12.5862
13001,2013,Febrero,Cuba,13,11,,24,-76.532004,3.451668
13002,2013,Febrero,Cuba,0,1,,1,-75.76635300000001,4.45285
13003,2013,Febrero,Cuba,84,184,,268,-74.140516,4.697157
13004,2013,Febrero,Cuba,2,1,,3,-75.736374,4.815189
13005,2013,Febrero,Cuba,12,15,,27,-75.42726,6.170465
13006,2013,Febrero,Cuba,0,1,,1,-70.74025300000001,7.088728999999999
13007,2013,Febrero,Cuba,0,1,,1,-73.181317,7.1280470000000005
13008,2013,Febrero,Cuba,0,1,,1,-72.453013,7.819
13009,2013,Febrero,Cuba,1,1,,2,-72.508188,7.927233
13010,2013,Febrero,Curazao,2,1,,3,-74.140516,4.697157
13011,2013,Febrero,Curazao,12,12,,24,-75.42726,6.170465
13012,2013,Febrero,República Checa,8,15,,23,-77.35600000000001,0.81488
13013,2013,Febrero,República Checa,2,2,,4,-75.516486,10.446304
13014,2013,Febrero,República Checa,1,1,,2,-72.129595,11.360028999999999
13015,2013,Febrero,República Checa,29,61,,90,-74.140516,4.697157
13016,2013,Febrero,República Checa,0,3,,3,-75.42726,6.170465
13017,2013,Febrero,Chile,2,2,,4,-69.941498,4.191162
13018,2013,Febrero,Chile,74,127,,201,-77.35600000000001,0.81488
13019,2013,Febrero,Chile,0,3,,3,-78.802679,18.00143
13020,2013,Febrero,Chile,148,107,,255,-75.527794,10.406342
13021,2013,Febrero,Chile,266,263,,529,-75.516486,10.446304
13022,2013,Febrero,Chile,10,16,,26,-74.77647900000001,10.886686
13023,2013,Febrero,Chile,1,4,,5,-74.213989,11.247722999999999
13024,2013,Febrero,Chile,8,10,,18,-72.129595,11.360028999999999
13025,2013,Febrero,Chile,119,85,,204,-81.70216500000001,12.5862
13026,2013,Febrero,Chile,61,99,,160,-76.532004,3.451668
13027,2013,Febrero,Chile,4014,4347,,8361,-74.140516,4.697157
13028,2013,Febrero,Chile,0,6,,6,-75.736374,4.815189
13029,2013,Febrero,Chile,135,240,,375,-75.42726,6.170465
13030,2013,Febrero,Chile,1,2,,3,-73.181317,7.1280470000000005
13031,2013,Febrero,Chile,13,23,,36,-72.453013,7.819
13032,2013,Febrero,Chile,0,2,,2,-72.508188,7.927233
13033,2013,Febrero,China,3,1,,4,-77.35600000000001,0.81488
13034,2013,Febrero,China,3,8,,11,-75.516486,10.446304
13035,2013,Febrero,China,2,0,,2,-74.77647900000001,10.886686
13036,2013,Febrero,China,1,0,,1,-81.70216500000001,12.5862
13037,2013,Febrero,China,4,9,,13,-76.532004,3.451668
13038,2013,Febrero,China,154,380,,534,-74.140516,4.697157
13039,2013,Febrero,China,9,9,,18,-75.42726,6.170465
13040,2013,Febrero,China,0,1,,1,-73.181317,7.1280470000000005
13041,2013,Febrero,China,2,3,,5,-72.453013,7.819
13042,2013,Febrero,China,0,1,,1,-72.508188,7.927233
13043,2013,Febrero,Taiwán,0,1,,1,-77.35600000000001,0.81488
13044,2013,Febrero,Taiwán,1,2,,3,-75.516486,10.446304
13045,2013,Febrero,Taiwán,0,1,,1,-74.77647900000001,10.886686
13046,2013,Febrero,Taiwán,1,1,,2,-76.532004,3.451668
13047,2013,Febrero,Taiwán,32,41,,73,-74.140516,4.697157
13048,2013,Febrero,Taiwán,0,1,,1,-75.736374,4.815189
13049,2013,Febrero,Taiwán,2,0,,2,-75.42726,6.170465
13050,2013,Febrero,Taiwán,0,1,,1,-73.181317,7.1280470000000005
13051,2013,Febrero,Chipre,0,5,,5,-74.140516,4.697157
13052,2013,Febrero,Dinamarca,1,0,,1,-69.941498,4.191162
13053,2013,Febrero,Dinamarca,7,6,,13,-77.35600000000001,0.81488
13054,2013,Febrero,Dinamarca,1,7,,8,-75.527794,10.406342
13055,2013,Febrero,Dinamarca,6,14,,20,-75.516486,10.446304
13056,2013,Febrero,Dinamarca,1,0,,1,-74.77647900000001,10.886686
13057,2013,Febrero,Dinamarca,0,1,,1,-72.129595,11.360028999999999
13058,2013,Febrero,Dinamarca,1,2,,3,-76.532004,3.451668
13059,2013,Febrero,Dinamarca,81,135,,216,-74.140516,4.697157
13060,2013,Febrero,Dinamarca,5,5,,10,-75.42726,6.170465
13061,2013,Febrero,Dinamarca,0,1,,1,-73.181317,7.1280470000000005
13062,2013,Febrero,Dinamarca,1,4,,5,-72.453013,7.819
13063,2013,Febrero,Dominica,3,2,,5,-74.140516,4.697157
13064,2013,Febrero,Dominica,1,0,,1,-75.42726,6.170465
13065,2013,Febrero,Ecuador,0,1,,1,-69.941498,4.191162
13066,2013,Febrero,Ecuador,1543,1590,,3133,-77.35600000000001,0.81488
13067,2013,Febrero,Ecuador,0,3,,3,-78.802679,18.00143
13068,2013,Febrero,Ecuador,6,34,,40,-75.527794,10.406342
13069,2013,Febrero,Ecuador,11,14,,25,-75.516486,10.446304
13070,2013,Febrero,Ecuador,8,12,,20,-74.77647900000001,10.886686
13071,2013,Febrero,Ecuador,2,7,,9,-72.129595,11.360028999999999
13072,2013,Febrero,Ecuador,4,3,,7,-81.70216500000001,12.5862
13073,2013,Febrero,Ecuador,419,466,,885,-76.532004,3.451668
13074,2013,Febrero,Ecuador,0,2,,2,-75.76635300000001,4.45285
13075,2013,Febrero,Ecuador,2091,2808,,4899,-74.140516,4.697157
13076,2013,Febrero,Ecuador,3,8,,11,-75.736374,4.815189
13077,2013,Febrero,Ecuador,383,447,,830,-75.42726,6.170465
13078,2013,Febrero,Ecuador,1,1,,2,-67.48402800000001,6.185536
13079,2013,Febrero,Ecuador,0,3,,3,-73.181317,7.1280470000000005
13080,2013,Febrero,Ecuador,79,130,,209,-72.453013,7.819
13081,2013,Febrero,Ecuador,2,5,,7,-72.508188,7.927233
13082,2013,Febrero,Egipto,0,1,,1,-75.516486,10.446304
13083,2013,Febrero,Egipto,1,13,,14,-74.140516,4.697157
13084,2013,Febrero,Egipto,0,1,,1,-72.453013,7.819
13085,2013,Febrero,El Salvador,1,2,,3,-77.35600000000001,0.81488
13086,2013,Febrero,El Salvador,0,2,,2,-75.527794,10.406342
13087,2013,Febrero,El Salvador,20,13,,33,-75.516486,10.446304
13088,2013,Febrero,El Salvador,0,3,,3,-74.77647900000001,10.886686
13089,2013,Febrero,El Salvador,1,0,,1,-72.129595,11.360028999999999
13090,2013,Febrero,El Salvador,2,0,,2,-81.70216500000001,12.5862
13091,2013,Febrero,El Salvador,24,39,,63,-76.532004,3.451668
13092,2013,Febrero,El Salvador,537,704,,1241,-74.140516,4.697157
13093,2013,Febrero,El Salvador,0,1,,1,-75.736374,4.815189
13094,2013,Febrero,El Salvador,41,92,,133,-75.42726,6.170465
13095,2013,Febrero,El Salvador,0,1,,1,-67.48402800000001,6.185536
13096,2013,Febrero,Emiratos Árabes,1,5,,6,-74.140516,4.697157
13097,2013,Febrero,Emiratos Árabes,0,2,,2,-75.42726,6.170465
13098,2013,Febrero,España,3,4,,7,-69.941498,4.191162
13099,2013,Febrero,España,23,26,,49,-77.35600000000001,0.81488
13100,2013,Febrero,España,16,27,,43,-75.527794,10.406342
13101,2013,Febrero,España,31,80,,111,-75.516486,10.446304
13102,2013,Febrero,España,3,17,,20,-74.77647900000001,10.886686
13103,2013,Febrero,España,1,2,,3,-74.213989,11.247722999999999
13104,2013,Febrero,España,9,13,,22,-72.129595,11.360028999999999
13105,2013,Febrero,España,4,6,,10,-81.70216500000001,12.5862
13106,2013,Febrero,España,145,339,,484,-76.532004,3.451668
13107,2013,Febrero,España,1489,4022,,5511,-74.140516,4.697157
13108,2013,Febrero,España,0,14,,14,-75.736374,4.815189
13109,2013,Febrero,España,81,190,,271,-75.42726,6.170465
13110,2013,Febrero,España,0,1,,1,-70.74025300000001,7.088728999999999
13111,2013,Febrero,España,12,44,,56,-72.453013,7.819
13112,2013,Febrero,España,3,10,,13,-72.508188,7.927233
13113,2013,Febrero,Eslovaquia,1,5,,6,-77.35600000000001,0.81488
13114,2013,Febrero,Eslovaquia,1,0,,1,-75.516486,10.446304
13115,2013,Febrero,Eslovaquia,2,0,,2,-74.77647900000001,10.886686
13116,2013,Febrero,Eslovaquia,1,1,,2,-76.532004,3.451668
13117,2013,Febrero,Eslovaquia,6,23,,29,-74.140516,4.697157
13118,2013,Febrero,Eslovaquia,0,1,,1,-75.42726,6.170465
13119,2013,Febrero,Eslovaquia,0,3,,3,-72.453013,7.819
13120,2013,Febrero,Eslovenia,0,1,,1,-75.527794,10.406342
13121,2013,Febrero,Eslovenia,12,7,,19,-72.129595,11.360028999999999
13122,2013,Febrero,Eslovenia,1,1,,2,-76.532004,3.451668
13123,2013,Febrero,Eslovenia,14,28,,42,-74.140516,4.697157
13124,2013,Febrero,Estados Unidos de América,4,5,,9,-69.941498,4.191162
13125,2013,Febrero,Estados Unidos de América,46,89,,135,-77.35600000000001,0.81488
13126,2013,Febrero,Estados Unidos de América,26,40,,66,-75.527794,10.406342
13127,2013,Febrero,Estados Unidos de América,1335,2123,,3458,-75.516486,10.446304
13128,2013,Febrero,Estados Unidos de América,312,566,,878,-74.77647900000001,10.886686
13129,2013,Febrero,Estados Unidos de América,3,6,,9,-74.213989,11.247722999999999
13130,2013,Febrero,Estados Unidos de América,6,18,,24,-72.129595,11.360028999999999
13131,2013,Febrero,Estados Unidos de América,0,1,,1,-72.919186,11.52863
13132,2013,Febrero,Estados Unidos de América,14,34,,48,-81.70216500000001,12.5862
13133,2013,Febrero,Estados Unidos de América,471,929,,1400,-76.532004,3.451668
13134,2013,Febrero,Estados Unidos de América,0,1,,1,-77.061029,3.8844260000000004
13135,2013,Febrero,Estados Unidos de América,67,126,,193,-75.76635300000001,4.45285
13136,2013,Febrero,Estados Unidos de América,4964,10882,,15846,-74.140516,4.697157
13137,2013,Febrero,Estados Unidos de América,32,67,,99,-75.736374,4.815189
13138,2013,Febrero,Estados Unidos de América,907,2474,,3381,-75.42726,6.170465
13139,2013,Febrero,Estados Unidos de América,0,1,,1,-70.74025300000001,7.088728999999999
13140,2013,Febrero,Estados Unidos de América,7,17,,24,-73.181317,7.1280470000000005
13141,2013,Febrero,Estados Unidos de América,21,44,,65,-72.453013,7.819
13142,2013,Febrero,Estados Unidos de América,7,10,,17,-72.508188,7.927233
13143,2013,Febrero,Estonia,0,1,,1,-77.35600000000001,0.81488
13144,2013,Febrero,Estonia,1,0,,1,-75.516486,10.446304
13145,2013,Febrero,Estonia,1,0,,1,-74.77647900000001,10.886686
13146,2013,Febrero,Estonia,0,1,,1,-76.532004,3.451668
13147,2013,Febrero,Estonia,15,11,,26,-74.140516,4.697157
13148,2013,Febrero,Estonia,2,2,,4,-75.42726,6.170465
13149,2013,Febrero,Etiopia,2,6,,8,-74.140516,4.697157
13150,2013,Febrero,Islas Fiji,0,1,,1,-74.77647900000001,10.886686
13151,2013,Febrero,Islas Fiji,0,1,,1,-74.140516,4.697157
13152,2013,Febrero,Filipinas,0,1,,1,-77.35600000000001,0.81488
13153,2013,Febrero,Filipinas,2,24,,26,-75.527794,10.406342
13154,2013,Febrero,Filipinas,1,17,,18,-75.516486,10.446304
13155,2013,Febrero,Filipinas,0,2,,2,-74.77647900000001,10.886686
13156,2013,Febrero,Filipinas,0,1,,1,-74.213989,11.247722999999999
13157,2013,Febrero,Filipinas,0,6,,6,-76.532004,3.451668
13158,2013,Febrero,Filipinas,0,5,,5,-77.061029,3.8844260000000004
13159,2013,Febrero,Filipinas,18,39,,57,-74.140516,4.697157
13160,2013,Febrero,Filipinas,2,0,,2,-75.42726,6.170465
13161,2013,Febrero,Filipinas,0,3,,3,-72.508188,7.927233
13162,2013,Febrero,Finlandia,5,6,,11,-77.35600000000001,0.81488
13163,2013,Febrero,Finlandia,3,3,,6,-75.527794,10.406342
13164,2013,Febrero,Finlandia,5,1,,6,-75.516486,10.446304
13165,2013,Febrero,Finlandia,0,7,,7,-74.77647900000001,10.886686
13166,2013,Febrero,Finlandia,2,2,,4,-72.129595,11.360028999999999
13167,2013,Febrero,Finlandia,0,1,,1,-81.70216500000001,12.5862
13168,2013,Febrero,Finlandia,1,5,,6,-76.532004,3.451668
13169,2013,Febrero,Finlandia,32,75,,107,-74.140516,4.697157
13170,2013,Febrero,Finlandia,4,3,,7,-75.42726,6.170465
13171,2013,Febrero,Finlandia,0,1,,1,-67.48402800000001,6.185536
13172,2013,Febrero,Finlandia,0,1,,1,-72.453013,7.819
13173,2013,Febrero,Francia,9,13,,22,-69.941498,4.191162
13174,2013,Febrero,Francia,54,77,,131,-77.35600000000001,0.81488
13175,2013,Febrero,Francia,12,16,,28,-75.527794,10.406342
13176,2013,Febrero,Francia,41,67,,108,-75.516486,10.446304
13177,2013,Febrero,Francia,5,7,,12,-74.77647900000001,10.886686
13178,2013,Febrero,Francia,1,2,,3,-74.213989,11.247722999999999
13179,2013,Febrero,Francia,6,15,,21,-72.129595,11.360028999999999
13180,2013,Febrero,Francia,32,54,,86,-76.532004,3.451668
13181,2013,Febrero,Francia,0,1,,1,-75.76635300000001,4.45285
13182,2013,Febrero,Francia,954,1769,,2723,-74.140516,4.697157
13183,2013,Febrero,Francia,1,0,,1,-75.736374,4.815189
13184,2013,Febrero,Francia,41,87,,128,-75.42726,6.170465
13185,2013,Febrero,Francia,0,3,,3,-73.181317,7.1280470000000005
13186,2013,Febrero,Francia,2,17,,19,-72.453013,7.819
13187,2013,Febrero,Francia,0,2,,2,-72.508188,7.927233
13188,2013,Febrero,Gabón,1,0,,1,-76.532004,3.451668
13189,2013,Febrero,Gabón,1,2,,3,-74.140516,4.697157
13190,2013,Febrero,Gambia,0,2,,2,-74.140516,4.697157
13191,2013,Febrero,Georgia,1,0,,1,-75.516486,10.446304
13192,2013,Febrero,Georgia,6,2,,8,-74.140516,4.697157
13193,2013,Febrero,Ghana,1,0,,1,-76.532004,3.451668
13194,2013,Febrero,Ghana,0,5,,5,-74.140516,4.697157
13195,2013,Febrero,Granada,1,0,,1,-74.140516,4.697157
13196,2013,Febrero,Grecia,2,1,,3,-77.35600000000001,0.81488
13197,2013,Febrero,Grecia,0,1,,1,-75.527794,10.406342
13198,2013,Febrero,Grecia,1,2,,3,-75.516486,10.446304
13199,2013,Febrero,Grecia,0,4,,4,-76.532004,3.451668
13200,2013,Febrero,Grecia,0,1,,1,-77.061029,3.8844260000000004
13201,2013,Febrero,Grecia,26,60,,86,-74.140516,4.697157
13202,2013,Febrero,Grecia,0,1,,1,-75.736374,4.815189
13203,2013,Febrero,Grecia,1,1,,2,-75.42726,6.170465
13204,2013,Febrero,Grecia,0,1,,1,-72.453013,7.819
13205,2013,Febrero,Grecia,0,1,,1,-75.68164200000001,9.402597
13206,2013,Febrero,Guatemala,0,5,,5,-77.35600000000001,0.81488
13207,2013,Febrero,Guatemala,0,2,,2,-75.527794,10.406342
13208,2013,Febrero,Guatemala,27,77,,104,-75.516486,10.446304
13209,2013,Febrero,Guatemala,4,17,,21,-74.77647900000001,10.886686
13210,2013,Febrero,Guatemala,0,1,,1,-72.129595,11.360028999999999
13211,2013,Febrero,Guatemala,2,1,,3,-81.70216500000001,12.5862
13212,2013,Febrero,Guatemala,16,42,,58,-76.532004,3.451668
13213,2013,Febrero,Guatemala,265,480,,745,-74.140516,4.697157
13214,2013,Febrero,Guatemala,0,8,,8,-75.736374,4.815189
13215,2013,Febrero,Guatemala,38,91,,129,-75.42726,6.170465
13216,2013,Febrero,Guatemala,0,4,,4,-72.453013,7.819
13217,2013,Febrero,Guatemala,1,0,,1,-72.508188,7.927233
13218,2013,Febrero,Guyana,1,0,,1,-74.77647900000001,10.886686
13219,2013,Febrero,Guyana,7,1,,8,-74.140516,4.697157
13220,2013,Febrero,Guyana,2,3,,5,-75.42726,6.170465
13221,2013,Febrero,Guyana,0,1,,1,-73.181317,7.1280470000000005
13222,2013,Febrero,Guinea Ecuatorial,0,1,,1,-74.140516,4.697157
13223,2013,Febrero,Haití,2,0,,2,-75.516486,10.446304
13224,2013,Febrero,Haití,0,1,,1,-81.70216500000001,12.5862
13225,2013,Febrero,Haití,7,15,,22,-74.140516,4.697157
13226,2013,Febrero,Haití,6,2,,8,-75.42726,6.170465
13227,2013,Febrero,Haití,2,0,,2,-73.181317,7.1280470000000005
13228,2013,Febrero,Honduras,0,7,,7,-75.527794,10.406342
13229,2013,Febrero,Honduras,36,55,,91,-75.516486,10.446304
13230,2013,Febrero,Honduras,7,3,,10,-74.77647900000001,10.886686
13231,2013,Febrero,Honduras,1,3,,4,-81.70216500000001,12.5862
13232,2013,Febrero,Honduras,12,18,,30,-76.532004,3.451668
13233,2013,Febrero,Honduras,150,171,,321,-74.140516,4.697157
13234,2013,Febrero,Honduras,1,1,,2,-75.736374,4.815189
13235,2013,Febrero,Honduras,21,26,,47,-75.42726,6.170465
13236,2013,Febrero,Honduras,0,1,,1,-67.48402800000001,6.185536
13237,2013,Febrero,Honduras,0,2,,2,-72.453013,7.819
13238,2013,Febrero,Honduras,0,1,,1,-72.508188,7.927233
13239,2013,Febrero,Hungría,1,0,,1,-77.35600000000001,0.81488
13240,2013,Febrero,Hungría,1,1,,2,-75.516486,10.446304
13241,2013,Febrero,Hungría,0,3,,3,-76.532004,3.451668
13242,2013,Febrero,Hungría,25,39,,64,-74.140516,4.697157
13243,2013,Febrero,Hungría,2,6,,8,-75.42726,6.170465
13244,2013,Febrero,India,5,3,,8,-77.35600000000001,0.81488
13245,2013,Febrero,India,0,1,,1,-75.527794,10.406342
13246,2013,Febrero,India,0,2,,2,-74.77647900000001,10.886686
13247,2013,Febrero,India,5,18,,23,-76.532004,3.451668
13248,2013,Febrero,India,31,247,,278,-74.140516,4.697157
13249,2013,Febrero,India,2,22,,24,-75.42726,6.170465
13250,2013,Febrero,Indonesia,1,0,,1,-75.527794,10.406342
13251,2013,Febrero,Indonesia,0,4,,4,-75.516486,10.446304
13252,2013,Febrero,Indonesia,8,18,,26,-74.140516,4.697157
13253,2013,Febrero,Indonesia,2,0,,2,-75.42726,6.170465
13254,2013,Febrero,Irán,3,10,,13,-74.140516,4.697157
13255,2013,Febrero,República de Irlanda,2,0,,2,-69.941498,4.191162
13256,2013,Febrero,República de Irlanda,7,8,,15,-77.35600000000001,0.81488
13257,2013,Febrero,República de Irlanda,1,1,,2,-75.527794,10.406342
13258,2013,Febrero,República de Irlanda,4,9,,13,-75.516486,10.446304
13259,2013,Febrero,República de Irlanda,1,1,,2,-72.129595,11.360028999999999
13260,2013,Febrero,República de Irlanda,0,4,,4,-76.532004,3.451668
13261,2013,Febrero,República de Irlanda,35,97,,132,-74.140516,4.697157
13262,2013,Febrero,República de Irlanda,4,10,,14,-75.42726,6.170465
13263,2013,Febrero,República de Irlanda,0,1,,1,-72.453013,7.819
13264,2013,Febrero,Islandia,1,0,,1,-75.527794,10.406342
13265,2013,Febrero,Islandia,0,1,,1,-76.532004,3.451668
13266,2013,Febrero,Islandia,2,3,,5,-74.140516,4.697157
13267,2013,Febrero,Isla de Man,9,13,,22,-77.35600000000001,0.81488
13268,2013,Febrero,Isla de Man,0,11,,11,-75.516486,10.446304
13269,2013,Febrero,Isla de Man,0,6,,6,-74.77647900000001,10.886686
13270,2013,Febrero,Isla de Man,1,2,,3,-72.129595,11.360028999999999
13271,2013,Febrero,Isla de Man,2,9,,11,-76.532004,3.451668
13272,2013,Febrero,Isla de Man,53,91,,144,-74.140516,4.697157
13273,2013,Febrero,Isla de Man,14,40,,54,-75.42726,6.170465
13274,2013,Febrero,Israel,4,8,,12,-77.35600000000001,0.81488
13275,2013,Febrero,Israel,1,3,,4,-75.527794,10.406342
13276,2013,Febrero,Israel,2,38,,40,-75.516486,10.446304
13277,2013,Febrero,Israel,4,10,,14,-76.532004,3.451668
13278,2013,Febrero,Israel,73,369,,442,-74.140516,4.697157
13279,2013,Febrero,Israel,3,55,,58,-75.42726,6.170465
13280,2013,Febrero,Israel,1,0,,1,-72.453013,7.819
13281,2013,Febrero,Israel,0,2,,2,-72.508188,7.927233
13282,2013,Febrero,Islas Aland/Provincia de Finlandia,1,0,,1,-74.140516,4.697157
13283,2013,Febrero,Italia,1,2,,3,-69.941498,4.191162
13284,2013,Febrero,Italia,6,25,,31,-77.35600000000001,0.81488
13285,2013,Febrero,Italia,5,17,,22,-75.527794,10.406342
13286,2013,Febrero,Italia,74,115,,189,-75.516486,10.446304
13287,2013,Febrero,Italia,5,22,,27,-74.77647900000001,10.886686
13288,2013,Febrero,Italia,0,1,,1,-74.213989,11.247722999999999
13289,2013,Febrero,Italia,5,15,,20,-72.129595,11.360028999999999
13290,2013,Febrero,Italia,2,4,,6,-81.70216500000001,12.5862
13291,2013,Febrero,Italia,17,88,,105,-76.532004,3.451668
13292,2013,Febrero,Italia,0,1,,1,-75.76635300000001,4.45285
13293,2013,Febrero,Italia,447,1597,,2044,-74.140516,4.697157
13294,2013,Febrero,Italia,0,5,,5,-75.736374,4.815189
13295,2013,Febrero,Italia,30,112,,142,-75.42726,6.170465
13296,2013,Febrero,Italia,0,1,,1,-67.48402800000001,6.185536
13297,2013,Febrero,Italia,1,2,,3,-73.181317,7.1280470000000005
13298,2013,Febrero,Italia,7,25,,32,-72.453013,7.819
13299,2013,Febrero,Italia,0,5,,5,-72.508188,7.927233
13300,2013,Febrero,Jamaica,2,0,,2,-75.527794,10.406342
13301,2013,Febrero,Jamaica,4,3,,7,-75.516486,10.446304
13302,2013,Febrero,Jamaica,0,2,,2,-74.77647900000001,10.886686
13303,2013,Febrero,Jamaica,0,1,,1,-81.70216500000001,12.5862
13304,2013,Febrero,Jamaica,2,2,,4,-76.532004,3.451668
13305,2013,Febrero,Jamaica,0,1,,1,-77.061029,3.8844260000000004
13306,2013,Febrero,Jamaica,11,16,,27,-74.140516,4.697157
13307,2013,Febrero,Jamaica,1,4,,5,-75.42726,6.170465
13308,2013,Febrero,Islas Salomón,1,0,,1,-74.140516,4.697157
13309,2013,Febrero,Japón,0,2,,2,-69.941498,4.191162
13310,2013,Febrero,Japón,7,14,,21,-77.35600000000001,0.81488
13311,2013,Febrero,Japón,1,3,,4,-75.527794,10.406342
13312,2013,Febrero,Japón,16,16,,32,-75.516486,10.446304
13313,2013,Febrero,Japón,0,2,,2,-74.77647900000001,10.886686
13314,2013,Febrero,Japón,0,2,,2,-72.129595,11.360028999999999
13315,2013,Febrero,Japón,1,21,,22,-76.532004,3.451668
13316,2013,Febrero,Japón,153,415,,568,-74.140516,4.697157
13317,2013,Febrero,Japón,0,1,,1,-75.736374,4.815189
13318,2013,Febrero,Japón,6,17,,23,-75.42726,6.170465
13319,2013,Febrero,Japón,0,2,,2,-73.181317,7.1280470000000005
13320,2013,Febrero,Japón,1,3,,4,-72.453013,7.819
13321,2013,Febrero,Jordania,4,7,,11,-74.140516,4.697157
13322,2013,Febrero,Kazajistán,1,0,,1,-76.532004,3.451668
13323,2013,Febrero,Kazajistán,3,3,,6,-74.140516,4.697157
13324,2013,Febrero,Kenia,2,0,,2,-76.532004,3.451668
13325,2013,Febrero,Kenia,2,10,,12,-74.140516,4.697157
13326,2013,Febrero,Kirguistán,1,0,,1,-74.140516,4.697157
13327,2013,Febrero,Kuwait,0,6,,6,-74.140516,4.697157
13328,2013,Febrero,República de Kosovo,0,1,,1,-74.140516,4.697157
13329,2013,Febrero,Letonia,0,1,,1,-77.35600000000001,0.81488
13330,2013,Febrero,Letonia,0,2,,2,-75.527794,10.406342
13331,2013,Febrero,Letonia,8,10,,18,-74.140516,4.697157
13332,2013,Febrero,Letonia,0,3,,3,-75.42726,6.170465
13333,2013,Febrero,Letonia,1,0,,1,-72.453013,7.819
13334,2013,Febrero,Lituania,1,0,,1,-69.941498,4.191162
13335,2013,Febrero,Lituania,1,0,,1,-77.35600000000001,0.81488
13336,2013,Febrero,Lituania,0,2,,2,-75.527794,10.406342
13337,2013,Febrero,Lituania,0,1,,1,-75.516486,10.446304
13338,2013,Febrero,Lituania,0,2,,2,-76.532004,3.451668
13339,2013,Febrero,Lituania,7,20,,27,-74.140516,4.697157
13340,2013,Febrero,Lituania,1,0,,1,-75.42726,6.170465
13341,2013,Febrero,Lituania,0,2,,2,-72.453013,7.819
13342,2013,Febrero,Líbano,0,1,,1,-77.35600000000001,0.81488
13343,2013,Febrero,Líbano,2,2,,4,-74.77647900000001,10.886686
13344,2013,Febrero,Líbano,6,2,,8,-72.129595,11.360028999999999
13345,2013,Febrero,Líbano,9,19,,28,-74.140516,4.697157
13346,2013,Febrero,Líbano,1,0,,1,-75.42726,6.170465
13347,2013,Febrero,Líbano,0,1,,1,-72.453013,7.819
13348,2013,Febrero,Liberia,1,1,,2,-74.140516,4.697157
13349,2013,Febrero,Liberia,1,0,,1,-75.42726,6.170465
13350,2013,Febrero,Libia,0,2,,2,-74.140516,4.697157
13351,2013,Febrero,Liechtenstein,1,0,,1,-75.516486,10.446304
13352,2013,Febrero,Liechtenstein,1,0,,1,-74.140516,4.697157
13353,2013,Febrero,Luxemburgo,2,0,,2,-76.532004,3.451668
13354,2013,Febrero,Luxemburgo,5,8,,13,-74.140516,4.697157
13355,2013,Febrero,Luxemburgo,2,1,,3,-75.42726,6.170465
13356,2013,Febrero,Macedonia,0,1,,1,-74.140516,4.697157
13357,2013,Febrero,Madagascar,1,0,,1,-74.140516,4.697157
13358,2013,Febrero,Malasia,0,2,,2,-75.516486,10.446304
13359,2013,Febrero,Malasia,13,18,,31,-74.140516,4.697157
13360,2013,Febrero,Malasia,3,1,,4,-75.42726,6.170465
13361,2013,Febrero,Malawi,1,0,,1,-74.140516,4.697157
13362,2013,Febrero,Malta,2,0,,2,-77.35600000000001,0.81488
13363,2013,Febrero,Malta,2,4,,6,-74.140516,4.697157
13364,2013,Febrero,Marruecos,0,1,,1,-77.35600000000001,0.81488
13365,2013,Febrero,Marruecos,4,3,,7,-74.140516,4.697157
13366,2013,Febrero,Mauricio,0,1,,1,-74.140516,4.697157
13367,2013,Febrero,Mauricio,0,1,,1,-75.42726,6.170465
13368,2013,Febrero,Mauritania,3,1,,4,-74.140516,4.697157
13369,2013,Febrero,México,3,13,,16,-77.35600000000001,0.81488
13370,2013,Febrero,México,10,11,,21,-75.527794,10.406342
13371,2013,Febrero,México,82,170,,252,-75.516486,10.446304
13372,2013,Febrero,México,10,43,,53,-74.77647900000001,10.886686
13373,2013,Febrero,México,0,5,,5,-72.129595,11.360028999999999
13374,2013,Febrero,México,2,4,,6,-81.70216500000001,12.5862
13375,2013,Febrero,México,40,142,,182,-76.532004,3.451668
13376,2013,Febrero,México,1,1,,2,-75.76635300000001,4.45285
13377,2013,Febrero,México,1317,3672,,4989,-74.140516,4.697157
13378,2013,Febrero,México,4,9,,13,-75.736374,4.815189
13379,2013,Febrero,México,79,314,,393,-75.42726,6.170465
13380,2013,Febrero,México,3,6,,9,-73.181317,7.1280470000000005
13381,2013,Febrero,México,7,24,,31,-72.453013,7.819
13382,2013,Febrero,México,20,16,,36,-72.508188,7.927233
13383,2013,Febrero,República de Moldavia,0,3,,3,-74.140516,4.697157
13384,2013,Febrero,República de Moldavia,1,1,,2,-75.42726,6.170465
13385,2013,Febrero,Mongolia,1,0,,1,-74.140516,4.697157
13386,2013,Febrero,Mozambique,0,1,,1,-74.140516,4.697157
13387,2013,Febrero,Nepal,0,4,,4,-74.140516,4.697157
13388,2013,Febrero,Nicaragua,1,0,,1,-77.35600000000001,0.81488
13389,2013,Febrero,Nicaragua,13,12,,25,-75.516486,10.446304
13390,2013,Febrero,Nicaragua,1,1,,2,-74.77647900000001,10.886686
13391,2013,Febrero,Nicaragua,3,0,,3,-81.70216500000001,12.5862
13392,2013,Febrero,Nicaragua,3,2,,5,-76.532004,3.451668
13393,2013,Febrero,Nicaragua,40,53,,93,-74.140516,4.697157
13394,2013,Febrero,Nicaragua,0,1,,1,-75.736374,4.815189
13395,2013,Febrero,Nicaragua,6,10,,16,-75.42726,6.170465
13396,2013,Febrero,Nicaragua,1,0,,1,-73.181317,7.1280470000000005
13397,2013,Febrero,Nigeria,0,1,,1,-75.516486,10.446304
13398,2013,Febrero,Nigeria,0,1,,1,-76.532004,3.451668
13399,2013,Febrero,Nigeria,1,12,,13,-74.140516,4.697157
13400,2013,Febrero,Nigeria,1,1,,2,-75.42726,6.170465
13401,2013,Febrero,Nigeria,1,1,,2,-72.453013,7.819
13402,2013,Febrero,Níger,0,1,,1,-74.140516,4.697157
13403,2013,Febrero,Noruega,3,2,,5,-77.35600000000001,0.81488
13404,2013,Febrero,Noruega,3,2,,5,-75.527794,10.406342
13405,2013,Febrero,Noruega,3,14,,17,-75.516486,10.446304
13406,2013,Febrero,Noruega,1,2,,3,-74.77647900000001,10.886686
13407,2013,Febrero,Noruega,4,4,,8,-74.213989,11.247722999999999
13408,2013,Febrero,Noruega,0,1,,1,-72.129595,11.360028999999999
13409,2013,Febrero,Noruega,3,7,,10,-76.532004,3.451668
13410,2013,Febrero,Noruega,55,107,,162,-74.140516,4.697157
13411,2013,Febrero,Noruega,8,12,,20,-75.42726,6.170465
13412,2013,Febrero,Noruega,0,1,,1,-72.453013,7.819
13413,2013,Febrero,Nueva Zelanda,2,0,,2,-69.941498,4.191162
13414,2013,Febrero,Nueva Zelanda,2,4,,6,-77.35600000000001,0.81488
13415,2013,Febrero,Nueva Zelanda,0,1,,1,-78.802679,18.00143
13416,2013,Febrero,Nueva Zelanda,5,9,,14,-75.516486,10.446304
13417,2013,Febrero,Nueva Zelanda,2,1,,3,-76.532004,3.451668
13418,2013,Febrero,Nueva Zelanda,26,46,,72,-74.140516,4.697157
13419,2013,Febrero,Nueva Zelanda,0,7,,7,-75.42726,6.170465
13420,2013,Febrero,Nueva Zelanda,0,1,,1,-72.453013,7.819
13421,2013,Febrero,Omán,0,2,,2,-74.140516,4.697157
13422,2013,Febrero,Nueva Zelanda,0,1,,1,-77.35600000000001,0.81488
13423,2013,Febrero,Nueva Zelanda,4,7,,11,-75.527794,10.406342
13424,2013,Febrero,Nueva Zelanda,0,5,,5,-74.140516,4.697157
13425,2013,Febrero,Nueva Zelanda,0,1,,1,-77.401154,6.222551999999999
13426,2013,Febrero,Países Bajos,0,2,,2,-69.941498,4.191162
13427,2013,Febrero,Países Bajos,6,12,,18,-77.35600000000001,0.81488
13428,2013,Febrero,Países Bajos,1,10,,11,-75.516486,10.446304
13429,2013,Febrero,Países Bajos,3,1,,4,-74.77647900000001,10.886686
13430,2013,Febrero,Países Bajos,2,7,,9,-72.129595,11.360028999999999
13431,2013,Febrero,Países Bajos,10,15,,25,-72.919186,11.52863
13432,2013,Febrero,Países Bajos,5,14,,19,-76.532004,3.451668
13433,2013,Febrero,Países Bajos,15,22,,37,-75.76635300000001,4.45285
13434,2013,Febrero,Países Bajos,183,272,,455,-74.140516,4.697157
13435,2013,Febrero,Países Bajos,176,188,,364,-75.42726,6.170465
13436,2013,Febrero,Países Bajos,4,5,,9,-73.181317,7.1280470000000005
13437,2013,Febrero,Países Bajos,0,3,,3,-72.453013,7.819
13438,2013,Febrero,Pakistán,1,1,,2,-75.516486,10.446304
13439,2013,Febrero,Pakistán,0,20,,20,-74.140516,4.697157
13440,2013,Febrero,Pakistán,0,1,,1,-75.42726,6.170465
13441,2013,Febrero,Panamá,1,2,,3,-77.35600000000001,0.81488
13442,2013,Febrero,Panamá,3,13,,16,-75.527794,10.406342
13443,2013,Febrero,Panamá,161,204,,365,-75.516486,10.446304
13444,2013,Febrero,Panamá,65,100,,165,-74.77647900000001,10.886686
13445,2013,Febrero,Panamá,1,3,,4,-72.129595,11.360028999999999
13446,2013,Febrero,Panamá,22,31,,53,-81.70216500000001,12.5862
13447,2013,Febrero,Panamá,103,140,,243,-76.532004,3.451668
13448,2013,Febrero,Panamá,589,773,,1362,-74.140516,4.697157
13449,2013,Febrero,Panamá,69,106,,175,-75.736374,4.815189
13450,2013,Febrero,Panamá,150,249,,399,-75.42726,6.170465
13451,2013,Febrero,Panamá,1,1,,2,-77.401154,6.222551999999999
13452,2013,Febrero,Panamá,8,5,,13,-73.181317,7.1280470000000005
13453,2013,Febrero,Panamá,2,1,,3,-72.453013,7.819
13454,2013,Febrero,Panamá,3,10,,13,-72.508188,7.927233
13455,2013,Febrero,Paraguay,3,0,,3,-75.527794,10.406342
13456,2013,Febrero,Paraguay,25,17,,42,-75.516486,10.446304
13457,2013,Febrero,Paraguay,4,1,,5,-74.77647900000001,10.886686
13458,2013,Febrero,Paraguay,0,1,,1,-72.129595,11.360028999999999
13459,2013,Febrero,Paraguay,18,11,,29,-81.70216500000001,12.5862
13460,2013,Febrero,Paraguay,6,5,,11,-76.532004,3.451668
13461,2013,Febrero,Paraguay,126,166,,292,-74.140516,4.697157
13462,2013,Febrero,Paraguay,21,15,,36,-75.42726,6.170465
13463,2013,Febrero,Paraguay,1,1,,2,-70.74025300000001,7.088728999999999
13464,2013,Febrero,Paraguay,0,2,,2,-72.453013,7.819
13465,2013,Febrero,Perú,7,11,,18,-69.941498,4.191162
13466,2013,Febrero,Perú,801,786,,1587,-77.35600000000001,0.81488
13467,2013,Febrero,Perú,57,55,,112,-75.527794,10.406342
13468,2013,Febrero,Perú,373,291,,664,-75.516486,10.446304
13469,2013,Febrero,Perú,67,60,,127,-74.77647900000001,10.886686
13470,2013,Febrero,Perú,0,5,,5,-74.213989,11.247722999999999
13471,2013,Febrero,Perú,1,4,,5,-72.129595,11.360028999999999
13472,2013,Febrero,Perú,143,102,,245,-81.70216500000001,12.5862
13473,2013,Febrero,Perú,223,231,,454,-76.532004,3.451668
13474,2013,Febrero,Perú,0,1,,1,-75.76635300000001,4.45285
13475,2013,Febrero,Perú,3614,3529,,7143,-74.140516,4.697157
13476,2013,Febrero,Perú,2,3,,5,-75.736374,4.815189
13477,2013,Febrero,Perú,271,373,,644,-75.42726,6.170465
13478,2013,Febrero,Perú,2,1,,3,-67.48402800000001,6.185536
13479,2013,Febrero,Perú,10,9,,19,-73.181317,7.1280470000000005
13480,2013,Febrero,Perú,28,47,,75,-72.453013,7.819
13481,2013,Febrero,Perú,1,5,,6,-72.508188,7.927233
13482,2013,Febrero,Perú,0,1,,1,-75.68164200000001,9.402597
13483,2013,Febrero,Palestina,2,1,,3,-74.140516,4.697157
13484,2013,Febrero,Polonia,0,1,,1,-69.941498,4.191162
13485,2013,Febrero,Polonia,11,8,,19,-77.35600000000001,0.81488
13486,2013,Febrero,Polonia,3,7,,10,-75.527794,10.406342
13487,2013,Febrero,Polonia,3,11,,14,-75.516486,10.446304
13488,2013,Febrero,Polonia,1,0,,1,-74.77647900000001,10.886686
13489,2013,Febrero,Polonia,0,2,,2,-74.213989,11.247722999999999
13490,2013,Febrero,Polonia,3,6,,9,-72.129595,11.360028999999999
13491,2013,Febrero,Polonia,2,2,,4,-76.532004,3.451668
13492,2013,Febrero,Polonia,83,115,,198,-74.140516,4.697157
13493,2013,Febrero,Polonia,5,6,,11,-75.42726,6.170465
13494,2013,Febrero,Polonia,2,1,,3,-72.453013,7.819
13495,2013,Febrero,Polonia,0,2,,2,-72.508188,7.927233
13496,2013,Febrero,Portugal,3,4,,7,-77.35600000000001,0.81488
13497,2013,Febrero,Portugal,0,2,,2,-75.527794,10.406342
13498,2013,Febrero,Portugal,6,6,,12,-75.516486,10.446304
13499,2013,Febrero,Portugal,8,8,,16,-74.77647900000001,10.886686
13500,2013,Febrero,Portugal,2,2,,4,-72.129595,11.360028999999999
13501,2013,Febrero,Portugal,2,10,,12,-76.532004,3.451668
13502,2013,Febrero,Portugal,99,282,,381,-74.140516,4.697157
13503,2013,Febrero,Portugal,5,20,,25,-75.42726,6.170465
13504,2013,Febrero,Portugal,0,3,,3,-72.453013,7.819
13505,2013,Febrero,Puerto Rico/Territorio de Estados Unidos,0,1,,1,-74.140516,4.697157
13506,2013,Febrero,Qatar,1,78,,79,-74.140516,4.697157
13507,2013,Febrero,Reino Unido de Gran Bretaña e Irlanda del Norte,5,8,,13,-69.941498,4.191162
13508,2013,Febrero,Reino Unido de Gran Bretaña e Irlanda del Norte,3,1,,4,-77.35600000000001,0.81488
13509,2013,Febrero,Reino Unido de Gran Bretaña e Irlanda del Norte,1,5,,6,-75.527794,10.406342
13510,2013,Febrero,Reino Unido de Gran Bretaña e Irlanda del Norte,24,36,,60,-75.516486,10.446304
13511,2013,Febrero,Reino Unido de Gran Bretaña e Irlanda del Norte,1,1,,2,-74.77647900000001,10.886686
13512,2013,Febrero,Reino Unido de Gran Bretaña e Irlanda del Norte,4,2,,6,-74.213989,11.247722999999999
13513,2013,Febrero,Reino Unido de Gran Bretaña e Irlanda del Norte,0,2,,2,-72.129595,11.360028999999999
13514,2013,Febrero,Reino Unido de Gran Bretaña e Irlanda del Norte,8,19,,27,-76.532004,3.451668
13515,2013,Febrero,Reino Unido de Gran Bretaña e Irlanda del Norte,1,0,,1,-75.76635300000001,4.45285
13516,2013,Febrero,Reino Unido de Gran Bretaña e Irlanda del Norte,229,493,,722,-74.140516,4.697157
13517,2013,Febrero,Reino Unido de Gran Bretaña e Irlanda del Norte,10,44,,54,-75.42726,6.170465
13518,2013,Febrero,Reino Unido de Gran Bretaña e Irlanda del Norte,1,3,,4,-72.453013,7.819
13519,2013,Febrero,República de Belarús,0,1,,1,-75.516486,10.446304
13520,2013,Febrero,República de Belarús,3,0,,3,-74.140516,4.697157
13521,2013,Febrero,República Dominicana,2,8,,10,-77.35600000000001,0.81488
13522,2013,Febrero,República Dominicana,1,9,,10,-75.527794,10.406342
13523,2013,Febrero,República Dominicana,9,28,,37,-75.516486,10.446304
13524,2013,Febrero,República Dominicana,10,34,,44,-74.77647900000001,10.886686
13525,2013,Febrero,República Dominicana,0,5,,5,-72.129595,11.360028999999999
13526,2013,Febrero,República Dominicana,0,1,,1,-81.70216500000001,12.5862
13527,2013,Febrero,República Dominicana,14,13,,27,-76.532004,3.451668
13528,2013,Febrero,República Dominicana,1,0,,1,-75.76635300000001,4.45285
13529,2013,Febrero,República Dominicana,289,390,,679,-74.140516,4.697157
13530,2013,Febrero,República Dominicana,3,5,,8,-75.736374,4.815189
13531,2013,Febrero,República Dominicana,31,46,,77,-75.42726,6.170465
13532,2013,Febrero,República Dominicana,1,6,,7,-73.181317,7.1280470000000005
13533,2013,Febrero,República Dominicana,0,2,,2,-72.453013,7.819
13534,2013,Febrero,República Dominicana,4,10,,14,-72.508188,7.927233
13535,2013,Febrero,República Checa,1,0,,1,-75.516486,10.446304
13536,2013,Febrero,República Checa,0,1,,1,-72.129595,11.360028999999999
13537,2013,Febrero,República Checa,5,0,,5,-74.140516,4.697157
13538,2013,Febrero,República Checa,1,0,,1,-75.42726,6.170465
13539,2013,Febrero,República Democrática Popular de Corea,1,0,,1,-69.941498,4.191162
13540,2013,Febrero,Rumania,2,2,,4,-77.35600000000001,0.81488
13541,2013,Febrero,Rumania,1,1,,2,-75.527794,10.406342
13542,2013,Febrero,Rumania,4,0,,4,-75.516486,10.446304
13543,2013,Febrero,Rumania,0,1,,1,-74.77647900000001,10.886686
13544,2013,Febrero,Rumania,2,1,,3,-72.129595,11.360028999999999
13545,2013,Febrero,Rumania,2,3,,5,-76.532004,3.451668
13546,2013,Febrero,Rumania,31,60,,91,-74.140516,4.697157
13547,2013,Febrero,Rumania,1,6,,7,-75.42726,6.170465
13548,2013,Febrero,Rumania,0,1,,1,-72.453013,7.819
13549,2013,Febrero,Federación de Rusia,7,5,,12,-77.35600000000001,0.81488
13550,2013,Febrero,Federación de Rusia,0,9,,9,-75.527794,10.406342
13551,2013,Febrero,Federación de Rusia,5,3,,8,-75.516486,10.446304
13552,2013,Febrero,Federación de Rusia,3,1,,4,-76.532004,3.451668
13553,2013,Febrero,Federación de Rusia,20,38,,58,-74.140516,4.697157
13554,2013,Febrero,Federación de Rusia,1,1,,2,-75.42726,6.170465
13555,2013,Febrero,Federación de Rusia,1,0,,1,-72.453013,7.819
13556,2013,Febrero,San Cristóbal y Nevis,0,2,,2,-75.516486,10.446304
13557,2013,Febrero,San Cristóbal y Nevis,0,1,,1,-75.42726,6.170465
13558,2013,Febrero,San  Vicente y las Granadinas,1,1,,2,-74.77647900000001,10.886686
13559,2013,Febrero,San  Vicente y las Granadinas,0,1,,1,-74.140516,4.697157
13560,2013,Febrero,Santa Lucia,1,1,,2,-74.140516,4.697157
13561,2013,Febrero,Santa Lucia,0,1,,1,-75.42726,6.170465
13562,2013,Febrero,Senegal,0,1,,1,-74.140516,4.697157
13563,2013,Febrero,Serbia,1,3,,4,-75.516486,10.446304
13564,2013,Febrero,Serbia,0,5,,5,-76.532004,3.451668
13565,2013,Febrero,Serbia,7,8,,15,-74.140516,4.697157
13566,2013,Febrero,Serbia,1,0,,1,-75.42726,6.170465
13567,2013,Febrero,Singapur,0,1,,1,-75.527794,10.406342
13568,2013,Febrero,Singapur,1,1,,2,-75.516486,10.446304
13569,2013,Febrero,Singapur,8,12,,20,-74.140516,4.697157
13570,2013,Febrero,República Árabe Siria,0,1,,1,-77.35600000000001,0.81488
13571,2013,Febrero,República Árabe Siria,1,0,,1,-72.129595,11.360028999999999
13572,2013,Febrero,República Árabe Siria,0,1,,1,-74.140516,4.697157
13573,2013,Febrero,Sri Lanka,0,1,,1,-76.532004,3.451668
13574,2013,Febrero,Sri Lanka,0,4,,4,-74.140516,4.697157
13575,2013,Febrero,Sudáfrica,1,1,,2,-77.35600000000001,0.81488
13576,2013,Febrero,Sudáfrica,2,2,,4,-75.516486,10.446304
13577,2013,Febrero,Sudáfrica,2,2,,4,-74.77647900000001,10.886686
13578,2013,Febrero,Sudáfrica,1,0,,1,-75.76635300000001,4.45285
13579,2013,Febrero,Sudáfrica,16,64,,80,-74.140516,4.697157
13580,2013,Febrero,Sudáfrica,1,1,,2,-75.42726,6.170465
13581,2013,Febrero,Sudáfrica,0,1,,1,-72.453013,7.819
13582,2013,Febrero,Sudán,1,4,,5,-74.140516,4.697157
13583,2013,Febrero,Suecia,10,16,,26,-77.35600000000001,0.81488
13584,2013,Febrero,Suecia,17,11,,28,-75.527794,10.406342
13585,2013,Febrero,Suecia,19,17,,36,-75.516486,10.446304
13586,2013,Febrero,Suecia,0,3,,3,-74.77647900000001,10.886686
13587,2013,Febrero,Suecia,2,2,,4,-74.213989,11.247722999999999
13588,2013,Febrero,Suecia,1,8,,9,-72.129595,11.360028999999999
13589,2013,Febrero,Suecia,2,2,,4,-81.70216500000001,12.5862
13590,2013,Febrero,Suecia,5,7,,12,-76.532004,3.451668
13591,2013,Febrero,Suecia,185,272,,457,-74.140516,4.697157
13592,2013,Febrero,Suecia,8,30,,38,-75.42726,6.170465
13593,2013,Febrero,Suecia,0,3,,3,-72.453013,7.819
13594,2013,Febrero,Suiza,0,2,,2,-69.941498,4.191162
13595,2013,Febrero,Suiza,24,22,,46,-77.35600000000001,0.81488
13596,2013,Febrero,Suiza,7,9,,16,-75.527794,10.406342
13597,2013,Febrero,Suiza,19,38,,57,-75.516486,10.446304
13598,2013,Febrero,Suiza,2,5,,7,-74.77647900000001,10.886686
13599,2013,Febrero,Suiza,4,6,,10,-74.213989,11.247722999999999
13600,2013,Febrero,Suiza,3,7,,10,-72.129595,11.360028999999999
13601,2013,Febrero,Suiza,19,42,,61,-76.532004,3.451668
13602,2013,Febrero,Suiza,319,556,,875,-74.140516,4.697157
13603,2013,Febrero,Suiza,0,4,,4,-75.736374,4.815189
13604,2013,Febrero,Suiza,16,58,,74,-75.42726,6.170465
13605,2013,Febrero,Suiza,4,4,,8,-72.453013,7.819
13606,2013,Febrero,Surinam,1,0,,1,-74.77647900000001,10.886686
13607,2013,Febrero,Surinam,0,3,,3,-76.532004,3.451668
13608,2013,Febrero,Surinam,6,14,,20,-74.140516,4.697157
13609,2013,Febrero,Surinam,4,5,,9,-75.42726,6.170465
13610,2013,Febrero,Suazilandia,1,0,,1,-76.532004,3.451668
13611,2013,Febrero,Taiwán,1,0,,1,-69.941498,4.191162
13612,2013,Febrero,Taiwán,0,1,,1,-77.061029,3.8844260000000004
13613,2013,Febrero,Taiwán,2,2,,4,-74.140516,4.697157
13614,2013,Febrero,República de Tayikistán,0,1,,1,-74.140516,4.697157
13615,2013,Febrero,Tailandia,1,0,,1,-75.516486,10.446304
13616,2013,Febrero,Tailandia,1,0,,1,-76.532004,3.451668
13617,2013,Febrero,Tailandia,14,14,,28,-74.140516,4.697157
13618,2013,Febrero,Tíbet/Región Autónoma de China,1,4,,5,-74.140516,4.697157
13619,2013,Febrero,Territorio Antártico Británico/Territorio Británico de Ultramar,1,0,,1,-76.532004,3.451668
13620,2013,Febrero,Territorio Antártico Británico/Territorio Británico de Ultramar,4,4,,8,-74.140516,4.697157
13621,2013,Febrero,Tanzania,1,4,,5,-74.140516,4.697157
13622,2013,Febrero,Togo,0,1,,1,-75.516486,10.446304
13623,2013,Febrero,Togo,0,1,,1,-76.532004,3.451668
13624,2013,Febrero,Trinidad y Tobago,0,1,,1,-75.527794,10.406342
13625,2013,Febrero,Trinidad y Tobago,4,10,,14,-75.516486,10.446304
13626,2013,Febrero,Trinidad y Tobago,1,0,,1,-74.77647900000001,10.886686
13627,2013,Febrero,Trinidad y Tobago,3,6,,9,-76.532004,3.451668
13628,2013,Febrero,Trinidad y Tobago,13,31,,44,-74.140516,4.697157
13629,2013,Febrero,Trinidad y Tobago,1,1,,2,-75.736374,4.815189
13630,2013,Febrero,Trinidad y Tobago,2,3,,5,-75.42726,6.170465
13631,2013,Febrero,Túnez,0,1,,1,-77.35600000000001,0.81488
13632,2013,Febrero,Túnez,0,1,,1,-76.532004,3.451668
13633,2013,Febrero,Túnez,0,2,,2,-74.140516,4.697157
13634,2013,Febrero,Turquía,0,2,,2,-77.35600000000001,0.81488
13635,2013,Febrero,Turquía,1,0,,1,-75.527794,10.406342
13636,2013,Febrero,Turquía,1,0,,1,-75.516486,10.446304
13637,2013,Febrero,Turquía,0,1,,1,-74.213989,11.247722999999999
13638,2013,Febrero,Turquía,0,2,,2,-72.129595,11.360028999999999
13639,2013,Febrero,Turquía,2,4,,6,-76.532004,3.451668
13640,2013,Febrero,Turquía,17,56,,73,-74.140516,4.697157
13641,2013,Febrero,Turquía,2,2,,4,-75.42726,6.170465
13642,2013,Febrero,Turquía,0,2,,2,-72.453013,7.819
13643,2013,Febrero,Turquía,0,2,,2,-75.68164200000001,9.402597
13644,2013,Febrero,Ucrania,1,1,,2,-69.941498,4.191162
13645,2013,Febrero,Ucrania,1,1,,2,-75.527794,10.406342
13646,2013,Febrero,Ucrania,0,1,,1,-74.213989,11.247722999999999
13647,2013,Febrero,Ucrania,1,0,,1,-76.532004,3.451668
13648,2013,Febrero,Ucrania,14,16,,30,-74.140516,4.697157
13649,2013,Febrero,Ucrania,3,1,,4,-75.42726,6.170465
13650,2013,Febrero,Uganda,0,1,,1,-77.35600000000001,0.81488
13651,2013,Febrero,Uganda,2,1,,3,-74.140516,4.697157
13652,2013,Febrero,Federación de Rusia,4,2,,6,-77.35600000000001,0.81488
13653,2013,Febrero,Federación de Rusia,0,5,,5,-75.527794,10.406342
13654,2013,Febrero,Federación de Rusia,1,2,,3,-75.516486,10.446304
13655,2013,Febrero,Federación de Rusia,3,1,,4,-72.129595,11.360028999999999
13656,2013,Febrero,Federación de Rusia,0,4,,4,-81.70216500000001,12.5862
13657,2013,Febrero,Federación de Rusia,2,1,,3,-76.532004,3.451668
13658,2013,Febrero,Federación de Rusia,136,188,,324,-74.140516,4.697157
13659,2013,Febrero,Federación de Rusia,2,3,,5,-75.42726,6.170465
13660,2013,Febrero,Federación de Rusia,3,2,,5,-72.453013,7.819
13661,2013,Febrero,Federación de Rusia,0,1,,1,-75.68164200000001,9.402597
13662,2013,Febrero,Uruguay,5,12,,17,-77.35600000000001,0.81488
13663,2013,Febrero,Uruguay,21,10,,31,-75.527794,10.406342
13664,2013,Febrero,Uruguay,98,96,,194,-75.516486,10.446304
13665,2013,Febrero,Uruguay,22,18,,40,-74.77647900000001,10.886686
13666,2013,Febrero,Uruguay,0,2,,2,-72.129595,11.360028999999999
13667,2013,Febrero,Uruguay,31,29,,60,-81.70216500000001,12.5862
13668,2013,Febrero,Uruguay,4,8,,12,-76.532004,3.451668
13669,2013,Febrero,Uruguay,179,293,,472,-74.140516,4.697157
13670,2013,Febrero,Uruguay,0,2,,2,-75.736374,4.815189
13671,2013,Febrero,Uruguay,11,31,,42,-75.42726,6.170465
13672,2013,Febrero,Uruguay,1,0,,1,-73.181317,7.1280470000000005
13673,2013,Febrero,Uruguay,5,12,,17,-72.453013,7.819
13674,2013,Febrero,Uruguay,2,2,,4,-72.508188,7.927233
13675,2013,Febrero,Venezuela,86,94,,180,-77.35600000000001,0.81488
13676,2013,Febrero,Venezuela,6,5,,11,-75.527794,10.406342
13677,2013,Febrero,Venezuela,97,175,,272,-75.516486,10.446304
13678,2013,Febrero,Venezuela,128,148,,276,-74.77647900000001,10.886686
13679,2013,Febrero,Venezuela,1,0,,1,-74.213989,11.247722999999999
13680,2013,Febrero,Venezuela,1714,2157,,3871,-72.129595,11.360028999999999
13681,2013,Febrero,Venezuela,1,3,,4,-72.919186,11.52863
13682,2013,Febrero,Venezuela,18,10,,28,-81.70216500000001,12.5862
13683,2013,Febrero,Venezuela,58,74,,132,-76.532004,3.451668
13684,2013,Febrero,Venezuela,1,3,,4,-75.76635300000001,4.45285
13685,2013,Febrero,Venezuela,6493,7160,,13653,-74.140516,4.697157
13686,2013,Febrero,Venezuela,6,25,,31,-75.736374,4.815189
13687,2013,Febrero,Venezuela,417,477,,894,-75.42726,6.170465
13688,2013,Febrero,Venezuela,214,333,,547,-67.48402800000001,6.185536
13689,2013,Febrero,Venezuela,45,72,,117,-70.74025300000001,7.088728999999999
13690,2013,Febrero,Venezuela,15,10,,25,-73.181317,7.1280470000000005
13691,2013,Febrero,Venezuela,1629,1570,,3199,-72.453013,7.819
13692,2013,Febrero,Venezuela,353,330,,683,-72.508188,7.927233
13693,2013,Febrero,Vietnam,1,0,,1,-77.35600000000001,0.81488
13694,2013,Febrero,República Árabe de Yemen,0,1,,1,-74.140516,4.697157
13695,2013,Febrero,Zambia,0,1,,1,-75.516486,10.446304
13696,2013,Febrero,Zambia,0,1,,1,-74.140516,4.697157
13697,2013,Febrero,Zimbabue,0,1,,1,-76.532004,3.451668
13698,2013,Febrero,Reino Unido de Gran Bretaña e Irlanda del Norte,19,40,,59,-77.35600000000001,0.81488
13699,2013,Febrero,Reino Unido de Gran Bretaña e Irlanda del Norte,12,20,,32,-75.527794,10.406342
13700,2013,Febrero,Reino Unido de Gran Bretaña e Irlanda del Norte,17,29,,46,-75.516486,10.446304
13701,2013,Febrero,Reino Unido de Gran Bretaña e Irlanda del Norte,1,3,,4,-74.77647900000001,10.886686
13702,2013,Febrero,Reino Unido de Gran Bretaña e Irlanda del Norte,0,2,,2,-74.213989,11.247722999999999
13703,2013,Febrero,Reino Unido de Gran Bretaña e Irlanda del Norte,4,5,,9,-72.129595,11.360028999999999
13704,2013,Febrero,Reino Unido de Gran Bretaña e Irlanda del Norte,2,23,,25,-76.532004,3.451668
13705,2013,Febrero,Reino Unido de Gran Bretaña e Irlanda del Norte,307,654,,961,-74.140516,4.697157
13706,2013,Febrero,Reino Unido de Gran Bretaña e Irlanda del Norte,7,22,,29,-75.42726,6.170465
13707,2013,Febrero,Reino Unido de Gran Bretaña e Irlanda del Norte,2,9,,11,-72.453013,7.819
13708,2013,Febrero,Reino Unido de Gran Bretaña e Irlanda del Norte,0,1,,1,-72.508188,7.927233
13709,2013,Febrero,Países Bajos,17,16,,33,-77.35600000000001,0.81488
13710,2013,Febrero,Países Bajos,7,15,,22,-75.527794,10.406342
13711,2013,Febrero,Países Bajos,19,30,,49,-75.516486,10.446304
13712,2013,Febrero,Países Bajos,3,5,,8,-74.77647900000001,10.886686
13713,2013,Febrero,Países Bajos,0,2,,2,-74.213989,11.247722999999999
13714,2013,Febrero,Países Bajos,4,5,,9,-72.129595,11.360028999999999
13715,2013,Febrero,Países Bajos,1,4,,5,-81.70216500000001,12.5862
13716,2013,Febrero,Países Bajos,14,37,,51,-76.532004,3.451668
13717,2013,Febrero,Países Bajos,0,1,,1,-77.061029,3.8844260000000004
13718,2013,Febrero,Países Bajos,0,1,,1,-75.76635300000001,4.45285
13719,2013,Febrero,Países Bajos,371,690,,1061,-74.140516,4.697157
13720,2013,Febrero,Países Bajos,0,1,,1,-75.736374,4.815189
13721,2013,Febrero,Países Bajos,86,135,,221,-75.42726,6.170465
13722,2013,Febrero,Países Bajos,2,5,,7,-73.181317,7.1280470000000005
13723,2013,Febrero,Países Bajos,0,18,,18,-72.453013,7.819
13724,2013,Febrero,Desconocido,0,1,,1,-74.140516,4.697157
13725,2013,Febrero,Lituania,0,1,,1,-75.527794,10.406342
13726,2013,Febrero,Lituania,1,4,,5,-74.140516,4.697157
13727,2013,Febrero,Reino Unido de Gran Bretaña e Irlanda del Norte,1,1,,2,-75.527794,10.406342
13728,2013,Febrero,Reino Unido de Gran Bretaña e Irlanda del Norte,0,2,,2,-74.140516,4.697157
13729,2013,Febrero,Reino Unido de Gran Bretaña e Irlanda del Norte,0,1,,1,-75.527794,10.406342
13730,2013,Febrero,Reino Unido de Gran Bretaña e Irlanda del Norte,0,1,,1,-74.77647900000001,10.886686
13731,2013,Febrero,Reino Unido de Gran Bretaña e Irlanda del Norte,0,2,,2,-76.532004,3.451668
13732,2013,Febrero,Reino Unido de Gran Bretaña e Irlanda del Norte,5,8,,13,-74.140516,4.697157
13733,2013,Febrero,Reino Unido de Gran Bretaña e Irlanda del Norte,0,1,,1,-75.42726,6.170465
13734,2013,Febrero,Reino Unido de Gran Bretaña e Irlanda del Norte,0,1,,1,-72.453013,7.819
13735,2013,Febrero,Letonia,0,1,,1,-77.061029,3.8844260000000004
13736,2013,Febrero,Marruecos,0,2,,2,-74.140516,4.697157
13737,2013,Febrero,República CentroÁfricana,0,1,,1,-76.532004,3.451668
13738,2013,Febrero,República CentroÁfricana,0,2,,2,-74.140516,4.697157
13739,2013,Marzo,Desconocido,0,1,,1,-74.140516,4.697157
13740,2013,Marzo,Albania,2,2,,4,-74.140516,4.697157
13741,2013,Marzo,Alemania,4,15,,19,-69.941498,4.191162
13742,2013,Marzo,Alemania,62,62,,124,-77.35600000000001,0.81488
13743,2013,Marzo,Alemania,10,22,,32,-75.527794,10.406342
13744,2013,Marzo,Alemania,46,85,,131,-75.516486,10.446304
13745,2013,Marzo,Alemania,8,13,,21,-74.77647900000001,10.886686
13746,2013,Marzo,Alemania,13,19,,32,-72.129595,11.360028999999999
13747,2013,Marzo,Alemania,0,1,,1,-72.919186,11.52863
13748,2013,Marzo,Alemania,2,2,,4,-81.703935,12.574411099999999
13749,2013,Marzo,Alemania,1,4,,5,-81.70216500000001,12.5862
13750,2013,Marzo,Alemania,12,9,,21,-81.372937,13.338761300000002
13751,2013,Marzo,Alemania,34,48,,82,-76.532004,3.451668
13752,2013,Marzo,Alemania,1421,2151,,3572,-74.140516,4.697157
13753,2013,Marzo,Alemania,0,4,,4,-75.736374,4.815189
13754,2013,Marzo,Alemania,47,95,,142,-75.42726,6.170465
13755,2013,Marzo,Alemania,1,0,,1,-73.181317,7.1280470000000005
13756,2013,Marzo,Alemania,8,18,,26,-72.453013,7.819
13757,2013,Marzo,Alemania,0,1,,1,-72.508188,7.927233
13758,2013,Marzo,Alemania,10,21,,31,-77.35002,8.63337
13759,2013,Marzo,Andorra,2,8,,10,-74.140516,4.697157
13760,2013,Marzo,Andorra,0,1,,1,-75.736374,4.815189
13761,2013,Marzo,Angola,0,1,,1,-74.140516,4.697157
13762,2013,Marzo,Antigua y Barbuda,0,2,,2,-74.140516,4.697157
13763,2013,Marzo,Países Bajos,0,1,,1,-76.532004,3.451668
13764,2013,Marzo,Países Bajos,11,6,,17,-75.42726,6.170465
13765,2013,Marzo,Arabia Saudita,0,5,,5,-74.140516,4.697157
13766,2013,Marzo,Arabia Saudita,1,0,,1,-75.42726,6.170465
13767,2013,Marzo,Arabia Saudita,0,10,,10,-74.140516,4.697157
13768,2013,Marzo,Argelia,2,3,,5,-74.140516,4.697157
13769,2013,Marzo,Argentina,7,3,,10,-69.941498,4.191162
13770,2013,Marzo,Argentina,77,122,,199,-77.35600000000001,0.81488
13771,2013,Marzo,Argentina,149,126,,275,-75.527794,10.406342
13772,2013,Marzo,Argentina,933,707,,1640,-75.516486,10.446304
13773,2013,Marzo,Argentina,13,23,,36,-74.77647900000001,10.886686
13774,2013,Marzo,Argentina,20,42,,62,-72.129595,11.360028999999999
13775,2013,Marzo,Argentina,231,222,,453,-81.70216500000001,12.5862
13776,2013,Marzo,Argentina,36,70,,106,-76.532004,3.451668
13777,2013,Marzo,Argentina,3996,4900,,8896,-74.140516,4.697157
13778,2013,Marzo,Argentina,1,12,,13,-75.736374,4.815189
13779,2013,Marzo,Argentina,133,231,,364,-75.42726,6.170465
13780,2013,Marzo,Argentina,1,5,,6,-70.74025300000001,7.088728999999999
13781,2013,Marzo,Argentina,1,2,,3,-73.181317,7.1280470000000005
13782,2013,Marzo,Argentina,16,44,,60,-72.453013,7.819
13783,2013,Marzo,Argentina,0,7,,7,-72.508188,7.927233
13784,2013,Marzo,Argentina,1,14,,15,-77.35002,8.63337
13785,2013,Marzo,República de Armenia,0,1,,1,-74.140516,4.697157
13786,2013,Marzo,Aruba,1,0,,1,-74.140516,4.697157
13787,2013,Marzo,Aruba,1,0,,1,-75.42726,6.170465
13788,2013,Marzo,Australia,7,5,,12,-69.941498,4.191162
13789,2013,Marzo,Australia,13,27,,40,-77.35600000000001,0.81488
13790,2013,Marzo,Australia,7,13,,20,-75.527794,10.406342
13791,2013,Marzo,Australia,34,43,,77,-75.516486,10.446304
13792,2013,Marzo,Australia,11,14,,25,-74.77647900000001,10.886686
13793,2013,Marzo,Australia,1,3,,4,-74.213989,11.247722999999999
13794,2013,Marzo,Australia,2,6,,8,-72.129595,11.360028999999999
13795,2013,Marzo,Australia,1,1,,2,-81.372937,13.338761300000002
13796,2013,Marzo,Australia,7,14,,21,-76.532004,3.451668
13797,2013,Marzo,Australia,204,382,,586,-74.140516,4.697157
13798,2013,Marzo,Australia,0,2,,2,-75.736374,4.815189
13799,2013,Marzo,Australia,10,40,,50,-75.42726,6.170465
13800,2013,Marzo,Australia,0,1,,1,-73.181317,7.1280470000000005
13801,2013,Marzo,Australia,0,2,,2,-72.453013,7.819
13802,2013,Marzo,Australia,2,1,,3,-77.35002,8.63337
13803,2013,Marzo,Austria,4,2,,6,-69.941498,4.191162
13804,2013,Marzo,Austria,9,5,,14,-77.35600000000001,0.81488
13805,2013,Marzo,Austria,2,2,,4,-75.527794,10.406342
13806,2013,Marzo,Austria,6,14,,20,-75.516486,10.446304
13807,2013,Marzo,Austria,0,2,,2,-74.77647900000001,10.886686
13808,2013,Marzo,Austria,1,1,,2,-74.213989,11.247722999999999
13809,2013,Marzo,Austria,2,0,,2,-72.129595,11.360028999999999
13810,2013,Marzo,Austria,2,3,,5,-81.70216500000001,12.5862
13811,2013,Marzo,Austria,1,0,,1,-81.372937,13.338761300000002
13812,2013,Marzo,Austria,4,7,,11,-76.532004,3.451668
13813,2013,Marzo,Austria,90,227,,317,-74.140516,4.697157
13814,2013,Marzo,Austria,4,11,,15,-75.42726,6.170465
13815,2013,Marzo,Austria,1,3,,4,-77.35002,8.63337
13816,2013,Marzo,Azerbaiyán,1,0,,1,-74.140516,4.697157
13817,2013,Marzo,Bahamas,0,1,,1,-75.516486,10.446304
13818,2013,Marzo,Bahamas,1,0,,1,-74.77647900000001,10.886686
13819,2013,Marzo,Bahamas,2,3,,5,-74.140516,4.697157
13820,2013,Marzo,Bahamas,0,1,,1,-75.42726,6.170465
13821,2013,Marzo,Bangladesh,1,3,,4,-74.140516,4.697157
13822,2013,Marzo,Barbados,6,10,,16,-74.140516,4.697157
13823,2013,Marzo,República de Belarús,0,2,,2,-74.140516,4.697157
13824,2013,Marzo,Bélgica,1,3,,4,-69.941498,4.191162
13825,2013,Marzo,Bélgica,12,10,,22,-77.35600000000001,0.81488
13826,2013,Marzo,Bélgica,3,1,,4,-75.527794,10.406342
13827,2013,Marzo,Bélgica,2,7,,9,-75.516486,10.446304
13828,2013,Marzo,Bélgica,0,2,,2,-74.77647900000001,10.886686
13829,2013,Marzo,Bélgica,2,0,,2,-72.129595,11.360028999999999
13830,2013,Marzo,Bélgica,6,19,,25,-76.532004,3.451668
13831,2013,Marzo,Bélgica,105,265,,370,-74.140516,4.697157
13832,2013,Marzo,Bélgica,0,1,,1,-75.736374,4.815189
13833,2013,Marzo,Bélgica,7,8,,15,-75.42726,6.170465
13834,2013,Marzo,Bélgica,1,2,,3,-72.453013,7.819
13835,2013,Marzo,Bélgica,0,3,,3,-77.35002,8.63337
13836,2013,Marzo,Belice,0,1,,1,-75.516486,10.446304
13837,2013,Marzo,Belice,0,1,,1,-74.77647900000001,10.886686
13838,2013,Marzo,Belice,2,2,,4,-76.532004,3.451668
13839,2013,Marzo,Belice,2,7,,9,-74.140516,4.697157
13840,2013,Marzo,Belice,0,3,,3,-75.42726,6.170465
13841,2013,Marzo,Bermudas/Territorio Británico de Ultramar,2,0,,2,-75.516486,10.446304
13842,2013,Marzo,Bermudas/Territorio Británico de Ultramar,0,1,,1,-76.532004,3.451668
13843,2013,Marzo,Bermudas/Territorio Británico de Ultramar,1,0,,1,-74.140516,4.697157
13844,2013,Marzo,Bolivia,0,1,,1,-69.941498,4.191162
13845,2013,Marzo,Bolivia,5,10,,15,-77.35600000000001,0.81488
13846,2013,Marzo,Bolivia,6,2,,8,-75.527794,10.406342
13847,2013,Marzo,Bolivia,4,13,,17,-75.516486,10.446304
13848,2013,Marzo,Bolivia,4,40,,44,-74.77647900000001,10.886686
13849,2013,Marzo,Bolivia,1,1,,2,-81.70216500000001,12.5862
13850,2013,Marzo,Bolivia,14,32,,46,-76.532004,3.451668
13851,2013,Marzo,Bolivia,242,387,,629,-74.140516,4.697157
13852,2013,Marzo,Bolivia,0,2,,2,-75.736374,4.815189
13853,2013,Marzo,Bolivia,8,40,,48,-75.42726,6.170465
13854,2013,Marzo,Bolivia,0,2,,2,-67.48402800000001,6.185536
13855,2013,Marzo,Bolivia,1,0,,1,-73.181317,7.1280470000000005
13856,2013,Marzo,Bolivia,1,2,,3,-72.453013,7.819
13857,2013,Marzo,Bolivia,1,1,,2,-72.508188,7.927233
13858,2013,Marzo,Bolivia,1,0,,1,-77.35002,8.63337
13859,2013,Marzo,Bosnia y Herzegovina,1,1,,2,-74.140516,4.697157
13860,2013,Marzo,Brasil,48,44,,92,-69.941498,4.191162
13861,2013,Marzo,Brasil,6,9,,15,-77.35600000000001,0.81488
13862,2013,Marzo,Brasil,16,14,,30,-75.527794,10.406342
13863,2013,Marzo,Brasil,247,180,,427,-75.516486,10.446304
13864,2013,Marzo,Brasil,11,13,,24,-74.77647900000001,10.886686
13865,2013,Marzo,Brasil,12,13,,25,-72.129595,11.360028999999999
13866,2013,Marzo,Brasil,42,26,,68,-81.70216500000001,12.5862
13867,2013,Marzo,Brasil,18,50,,68,-76.532004,3.451668
13868,2013,Marzo,Brasil,1721,3054,,4775,-74.140516,4.697157
13869,2013,Marzo,Brasil,0,4,,4,-75.736374,4.815189
13870,2013,Marzo,Brasil,29,102,,131,-75.42726,6.170465
13871,2013,Marzo,Brasil,0,3,,3,-67.48402800000001,6.185536
13872,2013,Marzo,Brasil,1,0,,1,-73.181317,7.1280470000000005
13873,2013,Marzo,Brasil,7,20,,27,-72.453013,7.819
13874,2013,Marzo,Brasil,0,6,,6,-72.508188,7.927233
13875,2013,Marzo,Bulgaria,1,0,,1,-77.35600000000001,0.81488
13876,2013,Marzo,Bulgaria,1,2,,3,-72.129595,11.360028999999999
13877,2013,Marzo,Bulgaria,5,6,,11,-74.140516,4.697157
13878,2013,Marzo,Bulgaria,1,1,,2,-75.42726,6.170465
13879,2013,Marzo,Bután,0,1,,1,-74.140516,4.697157
13880,2013,Marzo,Islas Caimán/Territorio Británico de Ultramar,1,1,,2,-75.516486,10.446304
13881,2013,Marzo,Islas Caimán/Territorio Británico de Ultramar,0,16,,16,-81.70216500000001,12.5862
13882,2013,Marzo,Islas Caimán/Territorio Británico de Ultramar,0,1,,1,-75.42726,6.170465
13883,2013,Marzo,Camboya,0,1,,1,-74.140516,4.697157
13884,2013,Marzo,Camerún,0,1,,1,-74.140516,4.697157
13885,2013,Marzo,Canadá,3,5,,8,-69.941498,4.191162
13886,2013,Marzo,Canadá,23,34,,57,-77.35600000000001,0.81488
13887,2013,Marzo,Canadá,6,11,,17,-75.527794,10.406342
13888,2013,Marzo,Canadá,531,546,,1077,-75.516486,10.446304
13889,2013,Marzo,Canadá,7,15,,22,-74.77647900000001,10.886686
13890,2013,Marzo,Canadá,1,1,,2,-74.213989,11.247722999999999
13891,2013,Marzo,Canadá,2,5,,7,-72.129595,11.360028999999999
13892,2013,Marzo,Canadá,374,325,,699,-81.70216500000001,12.5862
13893,2013,Marzo,Canadá,2,7,,9,-81.372937,13.338761300000002
13894,2013,Marzo,Canadá,37,48,,85,-76.532004,3.451668
13895,2013,Marzo,Canadá,0,1,,1,-75.76635300000001,4.45285
13896,2013,Marzo,Canadá,797,1392,,2189,-74.140516,4.697157
13897,2013,Marzo,Canadá,1,5,,6,-75.736374,4.815189
13898,2013,Marzo,Canadá,46,133,,179,-75.42726,6.170465
13899,2013,Marzo,Canadá,0,2,,2,-73.181317,7.1280470000000005
13900,2013,Marzo,Canadá,2,9,,11,-72.453013,7.819
13901,2013,Marzo,Canadá,0,2,,2,-72.508188,7.927233
13902,2013,Marzo,Canadá,3,11,,14,-77.35002,8.63337
13903,2013,Marzo,España,4,18,,22,-77.35600000000001,0.81488
13904,2013,Marzo,España,3,5,,8,-75.527794,10.406342
13905,2013,Marzo,España,3,10,,13,-75.516486,10.446304
13906,2013,Marzo,España,2,5,,7,-74.77647900000001,10.886686
13907,2013,Marzo,España,0,1,,1,-81.70216500000001,12.5862
13908,2013,Marzo,España,17,61,,78,-76.532004,3.451668
13909,2013,Marzo,España,0,1,,1,-75.76635300000001,4.45285
13910,2013,Marzo,España,139,360,,499,-74.140516,4.697157
13911,2013,Marzo,España,0,6,,6,-75.736374,4.815189
13912,2013,Marzo,España,50,124,,174,-75.42726,6.170465
13913,2013,Marzo,España,1,1,,2,-72.453013,7.819
13914,2013,Marzo,República Democrática del Congo,0,1,,1,-74.140516,4.697157
13915,2013,Marzo,República de Corea,1,2,,3,-69.941498,4.191162
13916,2013,Marzo,República de Corea,5,7,,12,-77.35600000000001,0.81488
13917,2013,Marzo,República de Corea,0,1,,1,-75.527794,10.406342
13918,2013,Marzo,República de Corea,4,2,,6,-75.516486,10.446304
13919,2013,Marzo,República de Corea,1,1,,2,-72.129595,11.360028999999999
13920,2013,Marzo,República de Corea,6,9,,15,-76.532004,3.451668
13921,2013,Marzo,República de Corea,133,474,,607,-74.140516,4.697157
13922,2013,Marzo,República de Corea,4,21,,25,-75.42726,6.170465
13923,2013,Marzo,República de Corea,1,6,,7,-72.453013,7.819
13924,2013,Marzo,República de Corea,0,1,,1,-77.35002,8.63337
13925,2013,Marzo,Costa Rica,1,0,,1,-69.941498,4.191162
13926,2013,Marzo,Costa Rica,4,3,,7,-77.35600000000001,0.81488
13927,2013,Marzo,Costa Rica,2,11,,13,-75.527794,10.406342
13928,2013,Marzo,Costa Rica,53,58,,111,-75.516486,10.446304
13929,2013,Marzo,Costa Rica,9,22,,31,-74.77647900000001,10.886686
13930,2013,Marzo,Costa Rica,1,0,,1,-72.129595,11.360028999999999
13931,2013,Marzo,Costa Rica,262,211,,473,-81.70216500000001,12.5862
13932,2013,Marzo,Costa Rica,27,59,,86,-76.532004,3.451668
13933,2013,Marzo,Costa Rica,491,782,,1273,-74.140516,4.697157
13934,2013,Marzo,Costa Rica,8,9,,17,-75.736374,4.815189
13935,2013,Marzo,Costa Rica,59,106,,165,-75.42726,6.170465
13936,2013,Marzo,Costa Rica,0,1,,1,-77.401154,6.222551999999999
13937,2013,Marzo,Costa Rica,0,3,,3,-73.181317,7.1280470000000005
13938,2013,Marzo,Costa Rica,2,3,,5,-72.453013,7.819
13939,2013,Marzo,Costa Rica,1,3,,4,-72.508188,7.927233
13940,2013,Marzo,Costa Rica,0,1,,1,-77.35002,8.63337
13941,2013,Marzo,Croacia,0,2,,2,-77.35600000000001,0.81488
13942,2013,Marzo,Croacia,0,2,,2,-75.527794,10.406342
13943,2013,Marzo,Croacia,0,1,,1,-75.516486,10.446304
13944,2013,Marzo,Croacia,0,1,,1,-72.129595,11.360028999999999
13945,2013,Marzo,Croacia,0,3,,3,-77.061029,3.8844260000000004
13946,2013,Marzo,Croacia,7,20,,27,-74.140516,4.697157
13947,2013,Marzo,Croacia,0,1,,1,-75.736374,4.815189
13948,2013,Marzo,Croacia,1,0,,1,-75.42726,6.170465
13949,2013,Marzo,Croacia,0,2,,2,-75.68164200000001,9.402597
13950,2013,Marzo,Cuba,2,8,,10,-77.35600000000001,0.81488
13951,2013,Marzo,Cuba,6,9,,15,-75.516486,10.446304
13952,2013,Marzo,Cuba,2,14,,16,-74.77647900000001,10.886686
13953,2013,Marzo,Cuba,1,0,,1,-72.129595,11.360028999999999
13954,2013,Marzo,Cuba,0,1,,1,-81.70216500000001,12.5862
13955,2013,Marzo,Cuba,8,17,,25,-76.532004,3.451668
13956,2013,Marzo,Cuba,86,133,,219,-74.140516,4.697157
13957,2013,Marzo,Cuba,14,15,,29,-75.42726,6.170465
13958,2013,Marzo,Cuba,1,0,,1,-73.181317,7.1280470000000005
13959,2013,Marzo,Cuba,1,0,,1,-72.453013,7.819
13960,2013,Marzo,Cuba,0,2,,2,-72.508188,7.927233
13961,2013,Marzo,Curazao,0,3,,3,-74.140516,4.697157
13962,2013,Marzo,Curazao,10,9,,19,-75.42726,6.170465
13963,2013,Marzo,República Checa,0,3,,3,-69.941498,4.191162
13964,2013,Marzo,República Checa,1,2,,3,-75.516486,10.446304
13965,2013,Marzo,República Checa,0,2,,2,-74.77647900000001,10.886686
13966,2013,Marzo,República Checa,0,1,,1,-72.129595,11.360028999999999
13967,2013,Marzo,República Checa,1,2,,3,-76.532004,3.451668
13968,2013,Marzo,República Checa,33,30,,63,-74.140516,4.697157
13969,2013,Marzo,República Checa,1,2,,3,-75.42726,6.170465
13970,2013,Marzo,República Checa,1,3,,4,-72.453013,7.819
13971,2013,Marzo,Chile,2,3,,5,-69.941498,4.191162
13972,2013,Marzo,Chile,25,40,,65,-77.35600000000001,0.81488
13973,2013,Marzo,Chile,32,20,,52,-75.527794,10.406342
13974,2013,Marzo,Chile,167,167,,334,-75.516486,10.446304
13975,2013,Marzo,Chile,10,20,,30,-74.77647900000001,10.886686
13976,2013,Marzo,Chile,9,14,,23,-72.129595,11.360028999999999
13977,2013,Marzo,Chile,106,67,,173,-81.70216500000001,12.5862
13978,2013,Marzo,Chile,35,59,,94,-76.532004,3.451668
13979,2013,Marzo,Chile,0,2,,2,-77.061029,3.8844260000000004
13980,2013,Marzo,Chile,2044,3163,,5207,-74.140516,4.697157
13981,2013,Marzo,Chile,1,5,,6,-75.736374,4.815189
13982,2013,Marzo,Chile,80,149,,229,-75.42726,6.170465
13983,2013,Marzo,Chile,0,3,,3,-67.48402800000001,6.185536
13984,2013,Marzo,Chile,1,1,,2,-73.181317,7.1280470000000005
13985,2013,Marzo,Chile,4,14,,18,-72.453013,7.819
13986,2013,Marzo,Chile,1,2,,3,-72.508188,7.927233
13987,2013,Marzo,Chile,2,3,,5,-77.35002,8.63337
13988,2013,Marzo,China,1,4,,5,-77.35600000000001,0.81488
13989,2013,Marzo,China,7,7,,14,-75.516486,10.446304
13990,2013,Marzo,China,4,7,,11,-74.77647900000001,10.886686
13991,2013,Marzo,China,1,7,,8,-74.765343,10.970933
13992,2013,Marzo,China,2,9,,11,-76.532004,3.451668
13993,2013,Marzo,China,167,498,,665,-74.140516,4.697157
13994,2013,Marzo,China,3,10,,13,-75.42726,6.170465
13995,2013,Marzo,China,1,3,,4,-72.453013,7.819
13996,2013,Marzo,Taiwán,3,1,,4,-77.35600000000001,0.81488
13997,2013,Marzo,Taiwán,0,2,,2,-75.516486,10.446304
13998,2013,Marzo,Taiwán,0,3,,3,-74.77647900000001,10.886686
13999,2013,Marzo,Taiwán,3,4,,7,-76.532004,3.451668
14000,2013,Marzo,Taiwán,73,104,,177,-74.140516,4.697157
14001,2013,Marzo,Taiwán,2,0,,2,-75.736374,4.815189
14002,2013,Marzo,Taiwán,4,9,,13,-75.42726,6.170465
14003,2013,Marzo,Taiwán,2,4,,6,-72.453013,7.819
14004,2013,Marzo,Chipre,0,1,,1,-77.35600000000001,0.81488
14005,2013,Marzo,Chipre,1,1,,2,-74.140516,4.697157
14006,2013,Marzo,Dinamarca,1,4,,5,-69.941498,4.191162
14007,2013,Marzo,Dinamarca,9,7,,16,-77.35600000000001,0.81488
14008,2013,Marzo,Dinamarca,1,0,,1,-75.527794,10.406342
14009,2013,Marzo,Dinamarca,7,12,,19,-75.516486,10.446304
14010,2013,Marzo,Dinamarca,0,2,,2,-74.77647900000001,10.886686
14011,2013,Marzo,Dinamarca,2,4,,6,-72.129595,11.360028999999999
14012,2013,Marzo,Dinamarca,1,4,,5,-76.532004,3.451668
14013,2013,Marzo,Dinamarca,61,130,,191,-74.140516,4.697157
14014,2013,Marzo,Dinamarca,0,1,,1,-75.736374,4.815189
14015,2013,Marzo,Dinamarca,3,12,,15,-75.42726,6.170465
14016,2013,Marzo,Dinamarca,0,4,,4,-72.453013,7.819
14017,2013,Marzo,Dinamarca,0,1,,1,-72.508188,7.927233
14018,2013,Marzo,Dominica,0,1,,1,-75.516486,10.446304
14019,2013,Marzo,Dominica,1,1,,2,-74.140516,4.697157
14020,2013,Marzo,Ecuador,0,1,,1,-69.941498,4.191162
14021,2013,Marzo,Ecuador,1174,1595,,2769,-77.35600000000001,0.81488
14022,2013,Marzo,Ecuador,4,29,,33,-78.802679,18.00143
14023,2013,Marzo,Ecuador,7,47,,54,-75.527794,10.406342
14024,2013,Marzo,Ecuador,10,17,,27,-75.516486,10.446304
14025,2013,Marzo,Ecuador,2,14,,16,-74.77647900000001,10.886686
14026,2013,Marzo,Ecuador,12,12,,24,-72.129595,11.360028999999999
14027,2013,Marzo,Ecuador,11,10,,21,-81.70216500000001,12.5862
14028,2013,Marzo,Ecuador,318,350,,668,-76.532004,3.451668
14029,2013,Marzo,Ecuador,0,3,,3,-77.061029,3.8844260000000004
14030,2013,Marzo,Ecuador,2,0,,2,-75.76635300000001,4.45285
14031,2013,Marzo,Ecuador,1538,2483,,4021,-74.140516,4.697157
14032,2013,Marzo,Ecuador,0,6,,6,-75.736374,4.815189
14033,2013,Marzo,Ecuador,295,334,,629,-75.42726,6.170465
14034,2013,Marzo,Ecuador,0,1,,1,-67.48402800000001,6.185536
14035,2013,Marzo,Ecuador,2,9,,11,-73.181317,7.1280470000000005
14036,2013,Marzo,Ecuador,76,122,,198,-72.453013,7.819
14037,2013,Marzo,Ecuador,5,3,,8,-72.508188,7.927233
14038,2013,Marzo,Ecuador,0,5,,5,-75.68164200000001,9.402597
14039,2013,Marzo,Egipto,0,12,,12,-77.35600000000001,0.81488
14040,2013,Marzo,Egipto,0,1,,1,-74.77647900000001,10.886686
14041,2013,Marzo,Egipto,1,19,,20,-74.140516,4.697157
14042,2013,Marzo,El Salvador,1,1,,2,-77.35600000000001,0.81488
14043,2013,Marzo,El Salvador,18,18,,36,-75.516486,10.446304
14044,2013,Marzo,El Salvador,1,1,,2,-74.77647900000001,10.886686
14045,2013,Marzo,El Salvador,37,46,,83,-76.532004,3.451668
14046,2013,Marzo,El Salvador,350,599,,949,-74.140516,4.697157
14047,2013,Marzo,El Salvador,2,0,,2,-75.736374,4.815189
14048,2013,Marzo,El Salvador,79,121,,200,-75.42726,6.170465
14049,2013,Marzo,El Salvador,1,1,,2,-72.453013,7.819
14050,2013,Marzo,El Salvador,1,0,,1,-72.508188,7.927233
14051,2013,Marzo,Emiratos Árabes,1,0,,1,-75.516486,10.446304
14052,2013,Marzo,España,3,1,,4,-69.941498,4.191162
14053,2013,Marzo,España,27,40,,67,-77.35600000000001,0.81488
14054,2013,Marzo,España,17,24,,41,-75.527794,10.406342
14055,2013,Marzo,España,51,110,,161,-75.516486,10.446304
14056,2013,Marzo,España,4,11,,15,-74.77647900000001,10.886686
14057,2013,Marzo,España,0,1,,1,-74.765343,10.970933
14058,2013,Marzo,España,0,1,,1,-74.213989,11.247722999999999
14059,2013,Marzo,España,15,20,,35,-72.129595,11.360028999999999
14060,2013,Marzo,España,2,4,,6,-81.70216500000001,12.5862
14061,2013,Marzo,España,149,307,,456,-76.532004,3.451668
14062,2013,Marzo,España,1745,4005,,5750,-74.140516,4.697157
14063,2013,Marzo,España,1,7,,8,-75.736374,4.815189
14064,2013,Marzo,España,69,176,,245,-75.42726,6.170465
14065,2013,Marzo,España,0,1,,1,-67.48402800000001,6.185536
14066,2013,Marzo,España,1,0,,1,-70.74025300000001,7.088728999999999
14067,2013,Marzo,España,1,5,,6,-73.181317,7.1280470000000005
14068,2013,Marzo,España,22,46,,68,-72.453013,7.819
14069,2013,Marzo,España,0,3,,3,-72.508188,7.927233
14070,2013,Marzo,España,6,8,,14,-77.35002,8.63337
14071,2013,Marzo,Eslovaquia,0,1,,1,-69.941498,4.191162
14072,2013,Marzo,Eslovaquia,0,1,,1,-77.35600000000001,0.81488
14073,2013,Marzo,Eslovaquia,1,1,,2,-74.77647900000001,10.886686
14074,2013,Marzo,Eslovaquia,0,1,,1,-72.129595,11.360028999999999
14075,2013,Marzo,Eslovaquia,2,0,,2,-81.372937,13.338761300000002
14076,2013,Marzo,Eslovaquia,0,2,,2,-76.532004,3.451668
14077,2013,Marzo,Eslovaquia,15,26,,41,-74.140516,4.697157
14078,2013,Marzo,Eslovaquia,0,2,,2,-75.42726,6.170465
14079,2013,Marzo,Eslovaquia,1,3,,4,-72.453013,7.819
14080,2013,Marzo,Eslovaquia,1,0,,1,-77.35002,8.63337
14081,2013,Marzo,Eslovenia,0,3,,3,-77.35600000000001,0.81488
14082,2013,Marzo,Eslovenia,0,1,,1,-75.527794,10.406342
14083,2013,Marzo,Eslovenia,3,4,,7,-72.129595,11.360028999999999
14084,2013,Marzo,Eslovenia,9,29,,38,-74.140516,4.697157
14085,2013,Marzo,Estados Unidos de América,16,19,,35,-69.941498,4.191162
14086,2013,Marzo,Estados Unidos de América,41,87,,128,-77.35600000000001,0.81488
14087,2013,Marzo,Estados Unidos de América,1,0,,1,-78.802679,18.00143
14088,2013,Marzo,Estados Unidos de América,19,41,,60,-75.527794,10.406342
14089,2013,Marzo,Estados Unidos de América,1343,2156,,3499,-75.516486,10.446304
14090,2013,Marzo,Estados Unidos de América,322,484,,806,-74.77647900000001,10.886686
14091,2013,Marzo,Estados Unidos de América,0,2,,2,-74.765343,10.970933
14092,2013,Marzo,Estados Unidos de América,5,9,,14,-74.213989,11.247722999999999
14093,2013,Marzo,Estados Unidos de América,8,16,,24,-72.129595,11.360028999999999
14094,2013,Marzo,Estados Unidos de América,0,1,,1,-72.919186,11.52863
14095,2013,Marzo,Estados Unidos de América,30,25,,55,-81.70216500000001,12.5862
14096,2013,Marzo,Estados Unidos de América,15,23,,38,-81.372937,13.338761300000002
14097,2013,Marzo,Estados Unidos de América,722,1143,,1865,-76.532004,3.451668
14098,2013,Marzo,Estados Unidos de América,0,2,,2,-77.061029,3.8844260000000004
14099,2013,Marzo,Estados Unidos de América,104,139,,243,-75.76635300000001,4.45285
14100,2013,Marzo,Estados Unidos de América,5797,10789,,16586,-74.140516,4.697157
14101,2013,Marzo,Estados Unidos de América,80,110,,190,-75.736374,4.815189
14102,2013,Marzo,Estados Unidos de América,965,2212,,3177,-75.42726,6.170465
14103,2013,Marzo,Estados Unidos de América,0,2,,2,-67.48402800000001,6.185536
14104,2013,Marzo,Estados Unidos de América,1,4,,5,-70.74025300000001,7.088728999999999
14105,2013,Marzo,Estados Unidos de América,12,26,,38,-73.181317,7.1280470000000005
14106,2013,Marzo,Estados Unidos de América,21,51,,72,-72.453013,7.819
14107,2013,Marzo,Estados Unidos de América,16,12,,28,-72.508188,7.927233
14108,2013,Marzo,Estados Unidos de América,7,15,,22,-77.35002,8.63337
14109,2013,Marzo,Estonia,14,13,,27,-74.140516,4.697157
14110,2013,Marzo,Etiopia,2,3,,5,-74.140516,4.697157
14111,2013,Marzo,Islas Fiji,2,2,,4,-75.516486,10.446304
14112,2013,Marzo,Filipinas,0,2,,2,-77.35600000000001,0.81488
14113,2013,Marzo,Filipinas,1,24,,25,-75.527794,10.406342
14114,2013,Marzo,Filipinas,3,13,,16,-75.516486,10.446304
14115,2013,Marzo,Filipinas,0,27,,27,-74.765343,10.970933
14116,2013,Marzo,Filipinas,0,1,,1,-74.213989,11.247722999999999
14117,2013,Marzo,Filipinas,1,4,,5,-76.532004,3.451668
14118,2013,Marzo,Filipinas,0,18,,18,-77.061029,3.8844260000000004
14119,2013,Marzo,Filipinas,25,73,,98,-74.140516,4.697157
14120,2013,Marzo,Filipinas,1,1,,2,-75.42726,6.170465
14121,2013,Marzo,Filipinas,0,1,,1,-73.181317,7.1280470000000005
14122,2013,Marzo,Finlandia,4,5,,9,-77.35600000000001,0.81488
14123,2013,Marzo,Finlandia,0,1,,1,-75.527794,10.406342
14124,2013,Marzo,Finlandia,0,8,,8,-75.516486,10.446304
14125,2013,Marzo,Finlandia,3,4,,7,-76.532004,3.451668
14126,2013,Marzo,Finlandia,37,54,,91,-74.140516,4.697157
14127,2013,Marzo,Finlandia,2,2,,4,-75.42726,6.170465
14128,2013,Marzo,Finlandia,1,1,,2,-77.35002,8.63337
14129,2013,Marzo,Francia,10,17,,27,-69.941498,4.191162
14130,2013,Marzo,Francia,34,61,,95,-77.35600000000001,0.81488
14131,2013,Marzo,Francia,0,1,,1,-78.802679,18.00143
14132,2013,Marzo,Francia,11,27,,38,-75.527794,10.406342
14133,2013,Marzo,Francia,41,60,,101,-75.516486,10.446304
14134,2013,Marzo,Francia,5,10,,15,-74.77647900000001,10.886686
14135,2013,Marzo,Francia,3,2,,5,-74.213989,11.247722999999999
14136,2013,Marzo,Francia,14,14,,28,-72.129595,11.360028999999999
14137,2013,Marzo,Francia,0,1,,1,-72.919186,11.52863
14138,2013,Marzo,Francia,2,4,,6,-81.70216500000001,12.5862
14139,2013,Marzo,Francia,3,2,,5,-81.372937,13.338761300000002
14140,2013,Marzo,Francia,34,59,,93,-76.532004,3.451668
14141,2013,Marzo,Francia,870,1701,,2571,-74.140516,4.697157
14142,2013,Marzo,Francia,1,5,,6,-75.736374,4.815189
14143,2013,Marzo,Francia,50,79,,129,-75.42726,6.170465
14144,2013,Marzo,Francia,3,3,,6,-73.181317,7.1280470000000005
14145,2013,Marzo,Francia,7,11,,18,-72.453013,7.819
14146,2013,Marzo,Francia,0,2,,2,-72.508188,7.927233
14147,2013,Marzo,Francia,16,20,,36,-77.35002,8.63337
14148,2013,Marzo,Gabón,1,1,,2,-74.140516,4.697157
14149,2013,Marzo,Georgia,2,0,,2,-77.35600000000001,0.81488
14150,2013,Marzo,Georgia,3,3,,6,-74.140516,4.697157
14151,2013,Marzo,Ghana,0,1,,1,-76.532004,3.451668
14152,2013,Marzo,Ghana,2,3,,5,-74.140516,4.697157
14153,2013,Marzo,Grecia,1,2,,3,-69.941498,4.191162
14154,2013,Marzo,Grecia,1,0,,1,-77.35600000000001,0.81488
14155,2013,Marzo,Grecia,1,6,,7,-75.527794,10.406342
14156,2013,Marzo,Grecia,1,1,,2,-75.516486,10.446304
14157,2013,Marzo,Grecia,1,1,,2,-74.77647900000001,10.886686
14158,2013,Marzo,Grecia,0,1,,1,-74.213989,11.247722999999999
14159,2013,Marzo,Grecia,1,0,,1,-72.129595,11.360028999999999
14160,2013,Marzo,Grecia,0,1,,1,-81.70216500000001,12.5862
14161,2013,Marzo,Grecia,2,2,,4,-76.532004,3.451668
14162,2013,Marzo,Grecia,17,46,,63,-74.140516,4.697157
14163,2013,Marzo,Grecia,2,2,,4,-75.42726,6.170465
14164,2013,Marzo,Grecia,0,2,,2,-72.453013,7.819
14165,2013,Marzo,Grecia,0,3,,3,-72.508188,7.927233
14166,2013,Marzo,Guatemala,0,8,,8,-77.35600000000001,0.81488
14167,2013,Marzo,Guatemala,1,1,,2,-75.527794,10.406342
14168,2013,Marzo,Guatemala,42,57,,99,-75.516486,10.446304
14169,2013,Marzo,Guatemala,1,19,,20,-74.77647900000001,10.886686
14170,2013,Marzo,Guatemala,0,1,,1,-72.129595,11.360028999999999
14171,2013,Marzo,Guatemala,21,47,,68,-76.532004,3.451668
14172,2013,Marzo,Guatemala,3,0,,3,-75.76635300000001,4.45285
14173,2013,Marzo,Guatemala,158,375,,533,-74.140516,4.697157
14174,2013,Marzo,Guatemala,9,8,,17,-75.736374,4.815189
14175,2013,Marzo,Guatemala,30,106,,136,-75.42726,6.170465
14176,2013,Marzo,Guatemala,0,1,,1,-67.48402800000001,6.185536
14177,2013,Marzo,Guatemala,2,4,,6,-72.453013,7.819
14178,2013,Marzo,Guatemala,1,0,,1,-77.35002,8.63337
14179,2013,Marzo,Guyana,0,2,,2,-75.516486,10.446304
14180,2013,Marzo,Guyana,3,2,,5,-74.77647900000001,10.886686
14181,2013,Marzo,Guyana,0,1,,1,-72.129595,11.360028999999999
14182,2013,Marzo,Guyana,0,1,,1,-76.532004,3.451668
14183,2013,Marzo,Guyana,6,15,,21,-74.140516,4.697157
14184,2013,Marzo,Guyana,1,1,,2,-75.42726,6.170465
14185,2013,Marzo,Guinea,0,1,,1,-75.42726,6.170465
14186,2013,Marzo,Guayana Francesa/Departamento de Ultramar Francés,0,1,,1,-74.140516,4.697157
14187,2013,Marzo,Haití,1,1,,2,-75.516486,10.446304
14188,2013,Marzo,Haití,1,2,,3,-76.532004,3.451668
14189,2013,Marzo,Haití,2,11,,13,-74.140516,4.697157
14190,2013,Marzo,Haití,1,2,,3,-75.42726,6.170465
14191,2013,Marzo,Honduras,1,0,,1,-77.35600000000001,0.81488
14192,2013,Marzo,Honduras,0,3,,3,-75.527794,10.406342
14193,2013,Marzo,Honduras,22,26,,48,-75.516486,10.446304
14194,2013,Marzo,Honduras,3,5,,8,-74.77647900000001,10.886686
14195,2013,Marzo,Honduras,0,1,,1,-74.765343,10.970933
14196,2013,Marzo,Honduras,0,1,,1,-81.703935,12.574411099999999
14197,2013,Marzo,Honduras,0,1,,1,-81.70216500000001,12.5862
14198,2013,Marzo,Honduras,12,46,,58,-76.532004,3.451668
14199,2013,Marzo,Honduras,120,131,,251,-74.140516,4.697157
14200,2013,Marzo,Honduras,20,25,,45,-75.42726,6.170465
14201,2013,Marzo,Honduras,2,0,,2,-72.453013,7.819
14202,2013,Marzo,Hungría,1,1,,2,-77.35600000000001,0.81488
14203,2013,Marzo,Hungría,1,1,,2,-75.516486,10.446304
14204,2013,Marzo,Hungría,0,1,,1,-74.77647900000001,10.886686
14205,2013,Marzo,Hungría,2,1,,3,-76.532004,3.451668
14206,2013,Marzo,Hungría,39,83,,122,-74.140516,4.697157
14207,2013,Marzo,Hungría,1,3,,4,-75.42726,6.170465
14208,2013,Marzo,Hungría,1,1,,2,-73.181317,7.1280470000000005
14209,2013,Marzo,Hungría,1,1,,2,-72.453013,7.819
14210,2013,Marzo,India,7,0,,7,-77.35600000000001,0.81488
14211,2013,Marzo,India,0,4,,4,-75.516486,10.446304
14212,2013,Marzo,India,0,1,,1,-74.77647900000001,10.886686
14213,2013,Marzo,India,0,1,,1,-72.129595,11.360028999999999
14214,2013,Marzo,India,1,21,,22,-76.532004,3.451668
14215,2013,Marzo,India,0,6,,6,-77.061029,3.8844260000000004
14216,2013,Marzo,India,30,243,,273,-74.140516,4.697157
14217,2013,Marzo,India,2,22,,24,-75.42726,6.170465
14218,2013,Marzo,Indonesia,1,0,,1,-74.77647900000001,10.886686
14219,2013,Marzo,Indonesia,0,4,,4,-74.765343,10.970933
14220,2013,Marzo,Indonesia,0,4,,4,-76.532004,3.451668
14221,2013,Marzo,Indonesia,9,8,,17,-74.140516,4.697157
14222,2013,Marzo,Indonesia,0,1,,1,-75.42726,6.170465
14223,2013,Marzo,Indonesia,0,2,,2,-72.453013,7.819
14224,2013,Marzo,Iraq,0,1,,1,-75.516486,10.446304
14225,2013,Marzo,Iraq,0,1,,1,-74.140516,4.697157
14226,2013,Marzo,Irán,0,1,,1,-75.516486,10.446304
14227,2013,Marzo,Irán,0,1,,1,-76.532004,3.451668
14228,2013,Marzo,Irán,4,35,,39,-74.140516,4.697157
14229,2013,Marzo,República de Irlanda,6,9,,15,-77.35600000000001,0.81488
14230,2013,Marzo,República de Irlanda,0,5,,5,-75.527794,10.406342
14231,2013,Marzo,República de Irlanda,2,11,,13,-75.516486,10.446304
14232,2013,Marzo,República de Irlanda,2,0,,2,-72.129595,11.360028999999999
14233,2013,Marzo,República de Irlanda,1,5,,6,-76.532004,3.451668
14234,2013,Marzo,República de Irlanda,46,110,,156,-74.140516,4.697157
14235,2013,Marzo,República de Irlanda,0,1,,1,-75.736374,4.815189
14236,2013,Marzo,República de Irlanda,6,8,,14,-75.42726,6.170465
14237,2013,Marzo,República de Irlanda,0,1,,1,-72.453013,7.819
14238,2013,Marzo,República de Irlanda,1,0,,1,-77.35002,8.63337
14239,2013,Marzo,Islandia,1,0,,1,-76.532004,3.451668
14240,2013,Marzo,Isla de Man,9,16,,25,-77.35600000000001,0.81488
14241,2013,Marzo,Isla de Man,5,7,,12,-75.516486,10.446304
14242,2013,Marzo,Isla de Man,4,6,,10,-74.77647900000001,10.886686
14243,2013,Marzo,Isla de Man,2,14,,16,-76.532004,3.451668
14244,2013,Marzo,Isla de Man,48,136,,184,-74.140516,4.697157
14245,2013,Marzo,Isla de Man,1,0,,1,-75.736374,4.815189
14246,2013,Marzo,Isla de Man,9,22,,31,-75.42726,6.170465
14247,2013,Marzo,Isla Johnston,0,2,,2,-74.140516,4.697157
14248,2013,Marzo,Israel,0,6,,6,-69.941498,4.191162
14249,2013,Marzo,Israel,3,4,,7,-77.35600000000001,0.81488
14250,2013,Marzo,Israel,1,5,,6,-75.527794,10.406342
14251,2013,Marzo,Israel,8,25,,33,-75.516486,10.446304
14252,2013,Marzo,Israel,3,4,,7,-76.532004,3.451668
14253,2013,Marzo,Israel,71,388,,459,-74.140516,4.697157
14254,2013,Marzo,Israel,0,1,,1,-75.736374,4.815189
14255,2013,Marzo,Israel,9,47,,56,-75.42726,6.170465
14256,2013,Marzo,Israel,0,2,,2,-77.35002,8.63337
14257,2013,Marzo,Islas Aland/Provincia de Finlandia,1,4,,5,-74.140516,4.697157
14258,2013,Marzo,Italia,0,4,,4,-69.941498,4.191162
14259,2013,Marzo,Italia,8,16,,24,-77.35600000000001,0.81488
14260,2013,Marzo,Italia,1,12,,13,-75.527794,10.406342
14261,2013,Marzo,Italia,36,73,,109,-75.516486,10.446304
14262,2013,Marzo,Italia,2,11,,13,-74.77647900000001,10.886686
14263,2013,Marzo,Italia,0,1,,1,-74.765343,10.970933
14264,2013,Marzo,Italia,0,2,,2,-74.213989,11.247722999999999
14265,2013,Marzo,Italia,4,9,,13,-72.129595,11.360028999999999
14266,2013,Marzo,Italia,5,3,,8,-81.70216500000001,12.5862
14267,2013,Marzo,Italia,1,0,,1,-81.372937,13.338761300000002
14268,2013,Marzo,Italia,16,75,,91,-76.532004,3.451668
14269,2013,Marzo,Italia,0,1,,1,-75.76635300000001,4.45285
14270,2013,Marzo,Italia,418,1358,,1776,-74.140516,4.697157
14271,2013,Marzo,Italia,1,4,,5,-75.736374,4.815189
14272,2013,Marzo,Italia,17,83,,100,-75.42726,6.170465
14273,2013,Marzo,Italia,1,0,,1,-73.181317,7.1280470000000005
14274,2013,Marzo,Italia,1,15,,16,-72.453013,7.819
14275,2013,Marzo,Italia,2,3,,5,-72.508188,7.927233
14276,2013,Marzo,Italia,2,6,,8,-77.35002,8.63337
14277,2013,Marzo,Jamaica,0,1,,1,-75.527794,10.406342
14278,2013,Marzo,Jamaica,5,9,,14,-75.516486,10.446304
14279,2013,Marzo,Jamaica,0,3,,3,-74.77647900000001,10.886686
14280,2013,Marzo,Jamaica,0,2,,2,-81.70216500000001,12.5862
14281,2013,Marzo,Jamaica,1,2,,3,-76.532004,3.451668
14282,2013,Marzo,Jamaica,0,1,,1,-75.76635300000001,4.45285
14283,2013,Marzo,Jamaica,16,19,,35,-74.140516,4.697157
14284,2013,Marzo,Jamaica,1,4,,5,-75.42726,6.170465
14285,2013,Marzo,Islas Salomón,1,0,,1,-74.140516,4.697157
14286,2013,Marzo,Japón,0,2,,2,-69.941498,4.191162
14287,2013,Marzo,Japón,9,21,,30,-77.35600000000001,0.81488
14288,2013,Marzo,Japón,0,1,,1,-75.527794,10.406342
14289,2013,Marzo,Japón,5,9,,14,-75.516486,10.446304
14290,2013,Marzo,Japón,0,2,,2,-74.77647900000001,10.886686
14291,2013,Marzo,Japón,1,2,,3,-72.129595,11.360028999999999
14292,2013,Marzo,Japón,0,1,,1,-81.70216500000001,12.5862
14293,2013,Marzo,Japón,12,21,,33,-76.532004,3.451668
14294,2013,Marzo,Japón,138,441,,579,-74.140516,4.697157
14295,2013,Marzo,Japón,6,26,,32,-75.42726,6.170465
14296,2013,Marzo,Japón,4,7,,11,-72.453013,7.819
14297,2013,Marzo,Japón,1,3,,4,-77.35002,8.63337
14298,2013,Marzo,Jordania,1,0,,1,-81.70216500000001,12.5862
14299,2013,Marzo,Jordania,0,2,,2,-74.140516,4.697157
14300,2013,Marzo,Kazajistán,0,2,,2,-75.516486,10.446304
14301,2013,Marzo,Kazajistán,2,6,,8,-74.140516,4.697157
14302,2013,Marzo,Kenia,1,0,,1,-76.532004,3.451668
14303,2013,Marzo,Kenia,3,7,,10,-74.140516,4.697157
14304,2013,Marzo,Lesoto,0,2,,2,-74.140516,4.697157
14305,2013,Marzo,Letonia,0,1,,1,-78.802679,18.00143
14306,2013,Marzo,Letonia,0,1,,1,-75.527794,10.406342
14307,2013,Marzo,Letonia,4,5,,9,-74.140516,4.697157
14308,2013,Marzo,Letonia,0,1,,1,-75.42726,6.170465
14309,2013,Marzo,Lituania,2,2,,4,-77.35600000000001,0.81488
14310,2013,Marzo,Lituania,0,1,,1,-75.527794,10.406342
14311,2013,Marzo,Lituania,1,2,,3,-75.516486,10.446304
14312,2013,Marzo,Lituania,13,9,,22,-74.140516,4.697157
14313,2013,Marzo,Lituania,0,1,,1,-72.453013,7.819
14314,2013,Marzo,Lituania,1,0,,1,-72.508188,7.927233
14315,2013,Marzo,Líbano,0,1,,1,-77.35600000000001,0.81488
14316,2013,Marzo,Líbano,0,1,,1,-74.77647900000001,10.886686
14317,2013,Marzo,Líbano,4,4,,8,-72.129595,11.360028999999999
14318,2013,Marzo,Líbano,0,1,,1,-76.532004,3.451668
14319,2013,Marzo,Líbano,8,25,,33,-74.140516,4.697157
14320,2013,Marzo,Líbano,1,2,,3,-75.42726,6.170465
14321,2013,Marzo,Liechtenstein,0,1,,1,-74.140516,4.697157
14322,2013,Marzo,Luxemburgo,3,0,,3,-77.35600000000001,0.81488
14323,2013,Marzo,Luxemburgo,0,1,,1,-75.516486,10.446304
14324,2013,Marzo,Luxemburgo,8,15,,23,-74.140516,4.697157
14325,2013,Marzo,Luxemburgo,0,1,,1,-75.42726,6.170465
14326,2013,Marzo,Macedonia,0,1,,1,-74.140516,4.697157
14327,2013,Marzo,Malasia,1,0,,1,-75.516486,10.446304
14328,2013,Marzo,Malasia,0,1,,1,-72.129595,11.360028999999999
14329,2013,Marzo,Malasia,13,23,,36,-74.140516,4.697157
14330,2013,Marzo,Malasia,0,2,,2,-75.42726,6.170465
14331,2013,Marzo,Malasia,0,1,,1,-72.508188,7.927233
14332,2013,Marzo,Malasia,1,1,,2,-77.35002,8.63337
14333,2013,Marzo,Malí,1,2,,3,-74.140516,4.697157
14334,2013,Marzo,Malta,1,6,,7,-74.140516,4.697157
14335,2013,Marzo,Marruecos,0,1,,1,-76.532004,3.451668
14336,2013,Marzo,Marruecos,3,7,,10,-74.140516,4.697157
14337,2013,Marzo,Mauricio,0,1,,1,-75.42726,6.170465
14338,2013,Marzo,México,4,1,,5,-69.941498,4.191162
14339,2013,Marzo,México,10,11,,21,-77.35600000000001,0.81488
14340,2013,Marzo,México,17,15,,32,-75.527794,10.406342
14341,2013,Marzo,México,136,208,,344,-75.516486,10.446304
14342,2013,Marzo,México,21,40,,61,-74.77647900000001,10.886686
14343,2013,Marzo,México,0,1,,1,-74.765343,10.970933
14344,2013,Marzo,México,3,8,,11,-72.129595,11.360028999999999
14345,2013,Marzo,México,2,4,,6,-81.70216500000001,12.5862
14346,2013,Marzo,México,0,1,,1,-81.372937,13.338761300000002
14347,2013,Marzo,México,57,128,,185,-76.532004,3.451668
14348,2013,Marzo,México,0,2,,2,-75.76635300000001,4.45285
14349,2013,Marzo,México,1791,3954,,5745,-74.140516,4.697157
14350,2013,Marzo,México,4,15,,19,-75.736374,4.815189
14351,2013,Marzo,México,92,315,,407,-75.42726,6.170465
14352,2013,Marzo,México,0,2,,2,-70.74025300000001,7.088728999999999
14353,2013,Marzo,México,5,3,,8,-73.181317,7.1280470000000005
14354,2013,Marzo,México,7,20,,27,-72.453013,7.819
14355,2013,Marzo,México,3,1,,4,-72.508188,7.927233
14356,2013,Marzo,República de Moldavia,1,0,,1,-74.140516,4.697157
14357,2013,Marzo,Mónaco,0,1,,1,-74.140516,4.697157
14358,2013,Marzo,Mongolia,2,8,,10,-74.140516,4.697157
14359,2013,Marzo,Montenegro,0,1,,1,-75.42726,6.170465
14360,2013,Marzo,Myanmar,1,1,,2,-74.140516,4.697157
14361,2013,Marzo,Namibia,0,1,,1,-74.140516,4.697157
14362,2013,Marzo,Nepal,1,1,,2,-74.140516,4.697157
14363,2013,Marzo,Nicaragua,5,4,,9,-75.516486,10.446304
14364,2013,Marzo,Nicaragua,2,1,,3,-74.77647900000001,10.886686
14365,2013,Marzo,Nicaragua,1,1,,2,-81.70216500000001,12.5862
14366,2013,Marzo,Nicaragua,5,8,,13,-76.532004,3.451668
14367,2013,Marzo,Nicaragua,43,52,,95,-74.140516,4.697157
14368,2013,Marzo,Nicaragua,1,0,,1,-75.736374,4.815189
14369,2013,Marzo,Nicaragua,4,8,,12,-75.42726,6.170465
14370,2013,Marzo,Nigeria,1,0,,1,-75.527794,10.406342
14371,2013,Marzo,Nigeria,1,0,,1,-75.516486,10.446304
14372,2013,Marzo,Nigeria,3,8,,11,-74.140516,4.697157
14373,2013,Marzo,Nigeria,0,1,,1,-75.42726,6.170465
14374,2013,Marzo,Noruega,1,1,,2,-69.941498,4.191162
14375,2013,Marzo,Noruega,2,5,,7,-77.35600000000001,0.81488
14376,2013,Marzo,Noruega,4,6,,10,-75.527794,10.406342
14377,2013,Marzo,Noruega,6,9,,15,-75.516486,10.446304
14378,2013,Marzo,Noruega,1,3,,4,-74.77647900000001,10.886686
14379,2013,Marzo,Noruega,0,1,,1,-74.213989,11.247722999999999
14380,2013,Marzo,Noruega,0,1,,1,-72.129595,11.360028999999999
14381,2013,Marzo,Noruega,0,3,,3,-81.372937,13.338761300000002
14382,2013,Marzo,Noruega,4,4,,8,-76.532004,3.451668
14383,2013,Marzo,Noruega,104,129,,233,-74.140516,4.697157
14384,2013,Marzo,Noruega,1,1,,2,-75.736374,4.815189
14385,2013,Marzo,Noruega,7,11,,18,-75.42726,6.170465
14386,2013,Marzo,Noruega,0,2,,2,-72.453013,7.819
14387,2013,Marzo,Noruega,0,1,,1,-72.508188,7.927233
14388,2013,Marzo,Noruega,0,1,,1,-77.35002,8.63337
14389,2013,Marzo,Nueva Zelanda,7,10,,17,-77.35600000000001,0.81488
14390,2013,Marzo,Nueva Zelanda,27,47,,74,-75.516486,10.446304
14391,2013,Marzo,Nueva Zelanda,1,1,,2,-74.77647900000001,10.886686
14392,2013,Marzo,Nueva Zelanda,1,0,,1,-72.129595,11.360028999999999
14393,2013,Marzo,Nueva Zelanda,3,0,,3,-76.532004,3.451668
14394,2013,Marzo,Nueva Zelanda,24,50,,74,-74.140516,4.697157
14395,2013,Marzo,Nueva Zelanda,1,8,,9,-75.42726,6.170465
14396,2013,Marzo,Nueva Zelanda,0,1,,1,-73.181317,7.1280470000000005
14397,2013,Marzo,Nueva Zelanda,0,2,,2,-72.453013,7.819
14398,2013,Marzo,Nueva Zelanda,0,1,,1,-77.35002,8.63337
14399,2013,Marzo,Nueva Zelanda,1,2,,3,-75.527794,10.406342
14400,2013,Marzo,Nueva Zelanda,0,6,,6,-75.516486,10.446304
14401,2013,Marzo,Nueva Zelanda,1,0,,1,-76.532004,3.451668
14402,2013,Marzo,Nueva Zelanda,1,1,,2,-74.140516,4.697157
14403,2013,Marzo,Países Bajos,1,3,,4,-69.941498,4.191162
14404,2013,Marzo,Países Bajos,13,12,,25,-77.35600000000001,0.81488
14405,2013,Marzo,Países Bajos,0,1,,1,-75.527794,10.406342
14406,2013,Marzo,Países Bajos,2,3,,5,-75.516486,10.446304
14407,2013,Marzo,Países Bajos,4,2,,6,-74.77647900000001,10.886686
14408,2013,Marzo,Países Bajos,5,2,,7,-72.129595,11.360028999999999
14409,2013,Marzo,Países Bajos,28,31,,59,-72.919186,11.52863
14410,2013,Marzo,Países Bajos,6,8,,14,-76.532004,3.451668
14411,2013,Marzo,Países Bajos,0,2,,2,-77.061029,3.8844260000000004
14412,2013,Marzo,Países Bajos,13,23,,36,-75.76635300000001,4.45285
14413,2013,Marzo,Países Bajos,127,226,,353,-74.140516,4.697157
14414,2013,Marzo,Países Bajos,0,1,,1,-75.736374,4.815189
14415,2013,Marzo,Países Bajos,165,200,,365,-75.42726,6.170465
14416,2013,Marzo,Países Bajos,13,10,,23,-73.181317,7.1280470000000005
14417,2013,Marzo,Países Bajos,0,1,,1,-72.453013,7.819
14418,2013,Marzo,Pakistán,1,1,,2,-75.516486,10.446304
14419,2013,Marzo,Pakistán,2,9,,11,-74.140516,4.697157
14420,2013,Marzo,Pakistán,0,1,,1,-75.42726,6.170465
14421,2013,Marzo,Pakistán,0,1,,1,-72.453013,7.819
14422,2013,Marzo,Panamá,2,14,,16,-75.527794,10.406342
14423,2013,Marzo,Panamá,142,197,,339,-75.516486,10.446304
14424,2013,Marzo,Panamá,35,87,,122,-74.77647900000001,10.886686
14425,2013,Marzo,Panamá,0,1,,1,-72.129595,11.360028999999999
14426,2013,Marzo,Panamá,23,25,,48,-81.70216500000001,12.5862
14427,2013,Marzo,Panamá,86,127,,213,-76.532004,3.451668
14428,2013,Marzo,Panamá,373,665,,1038,-74.140516,4.697157
14429,2013,Marzo,Panamá,87,102,,189,-75.736374,4.815189
14430,2013,Marzo,Panamá,106,218,,324,-75.42726,6.170465
14431,2013,Marzo,Panamá,5,12,,17,-73.181317,7.1280470000000005
14432,2013,Marzo,Panamá,0,3,,3,-72.453013,7.819
14433,2013,Marzo,Panamá,2,5,,7,-72.508188,7.927233
14434,2013,Marzo,Panamá,1,5,,6,-77.35002,8.63337
14435,2013,Marzo,Paraguay,1,0,,1,-69.941498,4.191162
14436,2013,Marzo,Paraguay,0,1,,1,-77.35600000000001,0.81488
14437,2013,Marzo,Paraguay,1,2,,3,-75.527794,10.406342
14438,2013,Marzo,Paraguay,16,26,,42,-75.516486,10.446304
14439,2013,Marzo,Paraguay,3,1,,4,-74.77647900000001,10.886686
14440,2013,Marzo,Paraguay,0,1,,1,-81.70216500000001,12.5862
14441,2013,Marzo,Paraguay,0,1,,1,-76.532004,3.451668
14442,2013,Marzo,Paraguay,60,82,,142,-74.140516,4.697157
14443,2013,Marzo,Paraguay,5,5,,10,-75.42726,6.170465
14444,2013,Marzo,Paraguay,0,1,,1,-67.48402800000001,6.185536
14445,2013,Marzo,Paraguay,0,3,,3,-72.453013,7.819
14446,2013,Marzo,Perú,19,17,,36,-69.941498,4.191162
14447,2013,Marzo,Perú,136,284,,420,-77.35600000000001,0.81488
14448,2013,Marzo,Perú,45,30,,75,-75.527794,10.406342
14449,2013,Marzo,Perú,252,234,,486,-75.516486,10.446304
14450,2013,Marzo,Perú,20,44,,64,-74.77647900000001,10.886686
14451,2013,Marzo,Perú,0,2,,2,-74.765343,10.970933
14452,2013,Marzo,Perú,1,2,,3,-72.129595,11.360028999999999
14453,2013,Marzo,Perú,136,102,,238,-81.70216500000001,12.5862
14454,2013,Marzo,Perú,123,175,,298,-76.532004,3.451668
14455,2013,Marzo,Perú,2242,3043,,5285,-74.140516,4.697157
14456,2013,Marzo,Perú,5,6,,11,-75.736374,4.815189
14457,2013,Marzo,Perú,143,347,,490,-75.42726,6.170465
14458,2013,Marzo,Perú,0,1,,1,-67.48402800000001,6.185536
14459,2013,Marzo,Perú,0,1,,1,-77.401154,6.222551999999999
14460,2013,Marzo,Perú,4,7,,11,-73.181317,7.1280470000000005
14461,2013,Marzo,Perú,29,52,,81,-72.453013,7.819
14462,2013,Marzo,Perú,0,1,,1,-72.508188,7.927233
14463,2013,Marzo,Perú,0,2,,2,-77.35002,8.63337
14464,2013,Marzo,Palestina,2,3,,5,-74.140516,4.697157
14465,2013,Marzo,Polonia,1,2,,3,-69.941498,4.191162
14466,2013,Marzo,Polonia,4,10,,14,-77.35600000000001,0.81488
14467,2013,Marzo,Polonia,1,13,,14,-75.527794,10.406342
14468,2013,Marzo,Polonia,7,8,,15,-75.516486,10.446304
14469,2013,Marzo,Polonia,0,1,,1,-74.765343,10.970933
14470,2013,Marzo,Polonia,0,1,,1,-74.213989,11.247722999999999
14471,2013,Marzo,Polonia,3,4,,7,-72.129595,11.360028999999999
14472,2013,Marzo,Polonia,1,3,,4,-76.532004,3.451668
14473,2013,Marzo,Polonia,63,75,,138,-74.140516,4.697157
14474,2013,Marzo,Polonia,4,5,,9,-75.42726,6.170465
14475,2013,Marzo,Polonia,2,1,,3,-72.453013,7.819
14476,2013,Marzo,Polonia,0,1,,1,-72.508188,7.927233
14477,2013,Marzo,Portugal,0,1,,1,-69.941498,4.191162
14478,2013,Marzo,Portugal,1,2,,3,-75.527794,10.406342
14479,2013,Marzo,Portugal,2,6,,8,-75.516486,10.446304
14480,2013,Marzo,Portugal,4,20,,24,-76.532004,3.451668
14481,2013,Marzo,Portugal,123,324,,447,-74.140516,4.697157
14482,2013,Marzo,Portugal,12,22,,34,-75.736374,4.815189
14483,2013,Marzo,Portugal,10,10,,20,-75.42726,6.170465
14484,2013,Marzo,Portugal,0,8,,8,-72.453013,7.819
14485,2013,Marzo,Puerto Rico/Territorio de Estados Unidos,1,0,,1,-75.516486,10.446304
14486,2013,Marzo,Puerto Rico/Territorio de Estados Unidos,1,0,,1,-74.77647900000001,10.886686
14487,2013,Marzo,Puerto Rico/Territorio de Estados Unidos,0,1,,1,-76.532004,3.451668
14488,2013,Marzo,Puerto Rico/Territorio de Estados Unidos,1,0,,1,-74.140516,4.697157
14489,2013,Marzo,Puerto Rico/Territorio de Estados Unidos,2,0,,2,-75.42726,6.170465
14490,2013,Marzo,Reino Unido de Gran Bretaña e Irlanda del Norte,0,4,,4,-69.941498,4.191162
14491,2013,Marzo,Reino Unido de Gran Bretaña e Irlanda del Norte,7,8,,15,-77.35600000000001,0.81488
14492,2013,Marzo,Reino Unido de Gran Bretaña e Irlanda del Norte,6,6,,12,-75.527794,10.406342
14493,2013,Marzo,Reino Unido de Gran Bretaña e Irlanda del Norte,18,40,,58,-75.516486,10.446304
14494,2013,Marzo,Reino Unido de Gran Bretaña e Irlanda del Norte,0,7,,7,-74.77647900000001,10.886686
14495,2013,Marzo,Reino Unido de Gran Bretaña e Irlanda del Norte,8,11,,19,-72.129595,11.360028999999999
14496,2013,Marzo,Reino Unido de Gran Bretaña e Irlanda del Norte,1,2,,3,-81.70216500000001,12.5862
14497,2013,Marzo,Reino Unido de Gran Bretaña e Irlanda del Norte,10,22,,32,-76.532004,3.451668
14498,2013,Marzo,Reino Unido de Gran Bretaña e Irlanda del Norte,238,511,,749,-74.140516,4.697157
14499,2013,Marzo,Reino Unido de Gran Bretaña e Irlanda del Norte,11,30,,41,-75.42726,6.170465
14500,2013,Marzo,Reino Unido de Gran Bretaña e Irlanda del Norte,0,2,,2,-72.453013,7.819
14501,2013,Marzo,Reino Unido de Gran Bretaña e Irlanda del Norte,0,1,,1,-72.508188,7.927233
14502,2013,Marzo,República de Belarús,1,4,,5,-74.140516,4.697157
14503,2013,Marzo,República Dominicana,0,1,,1,-69.941498,4.191162
14504,2013,Marzo,República Dominicana,4,7,,11,-77.35600000000001,0.81488
14505,2013,Marzo,República Dominicana,14,20,,34,-75.516486,10.446304
14506,2013,Marzo,República Dominicana,6,16,,22,-74.77647900000001,10.886686
14507,2013,Marzo,República Dominicana,1,5,,6,-72.129595,11.360028999999999
14508,2013,Marzo,República Dominicana,1,0,,1,-72.919186,11.52863
14509,2013,Marzo,República Dominicana,16,23,,39,-76.532004,3.451668
14510,2013,Marzo,República Dominicana,0,1,,1,-75.76635300000001,4.45285
14511,2013,Marzo,República Dominicana,211,372,,583,-74.140516,4.697157
14512,2013,Marzo,República Dominicana,5,7,,12,-75.736374,4.815189
14513,2013,Marzo,República Dominicana,25,41,,66,-75.42726,6.170465
14514,2013,Marzo,República Dominicana,3,0,,3,-73.181317,7.1280470000000005
14515,2013,Marzo,República Dominicana,3,4,,7,-72.453013,7.819
14516,2013,Marzo,República Dominicana,11,11,,22,-72.508188,7.927233
14517,2013,Marzo,República Checa,2,0,,2,-74.140516,4.697157
14518,2013,Marzo,República Checa,1,0,,1,-72.453013,7.819
14519,2013,Marzo,Rumania,1,1,,2,-77.35600000000001,0.81488
14520,2013,Marzo,Rumania,1,2,,3,-75.527794,10.406342
14521,2013,Marzo,Rumania,0,3,,3,-75.516486,10.446304
14522,2013,Marzo,Rumania,0,2,,2,-74.213989,11.247722999999999
14523,2013,Marzo,Rumania,3,3,,6,-76.532004,3.451668
14524,2013,Marzo,Rumania,31,58,,89,-74.140516,4.697157
14525,2013,Marzo,Rumania,1,0,,1,-75.736374,4.815189
14526,2013,Marzo,Rumania,0,4,,4,-75.42726,6.170465
14527,2013,Marzo,Federación de Rusia,2,9,,11,-77.35600000000001,0.81488
14528,2013,Marzo,Federación de Rusia,3,0,,3,-76.532004,3.451668
14529,2013,Marzo,Federación de Rusia,22,21,,43,-74.140516,4.697157
14530,2013,Marzo,Federación de Rusia,2,0,,2,-75.42726,6.170465
14531,2013,Marzo,San Cristóbal y Nevis,0,1,,1,-75.516486,10.446304
14532,2013,Marzo,San Cristóbal y Nevis,0,1,,1,-74.140516,4.697157
14533,2013,Marzo,San Marino,0,1,,1,-72.129595,11.360028999999999
14534,2013,Marzo,San Marino,1,2,,3,-74.140516,4.697157
14535,2013,Marzo,San  Vicente y las Granadinas,0,1,,1,-75.516486,10.446304
14536,2013,Marzo,San  Vicente y las Granadinas,1,0,,1,-76.532004,3.451668
14537,2013,Marzo,San  Vicente y las Granadinas,1,1,,2,-74.140516,4.697157
14538,2013,Marzo,Santa Lucia,1,0,,1,-75.516486,10.446304
14539,2013,Marzo,Santa Lucia,3,1,,4,-74.140516,4.697157
14540,2013,Marzo,Santa Lucia,0,1,,1,-73.181317,7.1280470000000005
14541,2013,Marzo,Santa Sede/Ciudad del Vaticano,0,1,,1,-74.140516,4.697157
14542,2013,Marzo,Senegal,0,1,,1,-74.140516,4.697157
14543,2013,Marzo,Serbia,0,1,,1,-77.35600000000001,0.81488
14544,2013,Marzo,Serbia,1,2,,3,-75.516486,10.446304
14545,2013,Marzo,Serbia,0,1,,1,-76.532004,3.451668
14546,2013,Marzo,Serbia,5,5,,10,-74.140516,4.697157
14547,2013,Marzo,Serbia,1,0,,1,-75.42726,6.170465
14548,2013,Marzo,Singapur,1,1,,2,-75.516486,10.446304
14549,2013,Marzo,Singapur,0,1,,1,-74.77647900000001,10.886686
14550,2013,Marzo,Singapur,10,11,,21,-74.140516,4.697157
14551,2013,Marzo,Singapur,1,1,,2,-75.42726,6.170465
14552,2013,Marzo,República Árabe Siria,0,1,,1,-72.129595,11.360028999999999
14553,2013,Marzo,República Árabe Siria,0,1,,1,-75.42726,6.170465
14554,2013,Marzo,Sri Lanka,2,1,,3,-74.140516,4.697157
14555,2013,Marzo,Sudáfrica,7,4,,11,-69.941498,4.191162
14556,2013,Marzo,Sudáfrica,2,2,,4,-77.35600000000001,0.81488
14557,2013,Marzo,Sudáfrica,0,1,,1,-75.527794,10.406342
14558,2013,Marzo,Sudáfrica,0,2,,2,-75.516486,10.446304
14559,2013,Marzo,Sudáfrica,0,5,,5,-74.77647900000001,10.886686
14560,2013,Marzo,Sudáfrica,0,1,,1,-72.129595,11.360028999999999
14561,2013,Marzo,Sudáfrica,1,2,,3,-81.372937,13.338761300000002
14562,2013,Marzo,Sudáfrica,0,2,,2,-76.532004,3.451668
14563,2013,Marzo,Sudáfrica,35,60,,95,-74.140516,4.697157
14564,2013,Marzo,Sudáfrica,3,6,,9,-75.42726,6.170465
14565,2013,Marzo,Sudáfrica,1,1,,2,-72.453013,7.819
14566,2013,Marzo,Suecia,1,2,,3,-69.941498,4.191162
14567,2013,Marzo,Suecia,9,10,,19,-77.35600000000001,0.81488
14568,2013,Marzo,Suecia,1,8,,9,-75.527794,10.406342
14569,2013,Marzo,Suecia,8,13,,21,-75.516486,10.446304
14570,2013,Marzo,Suecia,2,3,,5,-74.77647900000001,10.886686
14571,2013,Marzo,Suecia,0,1,,1,-74.213989,11.247722999999999
14572,2013,Marzo,Suecia,1,1,,2,-72.129595,11.360028999999999
14573,2013,Marzo,Suecia,1,3,,4,-81.372937,13.338761300000002
14574,2013,Marzo,Suecia,7,7,,14,-76.532004,3.451668
14575,2013,Marzo,Suecia,126,211,,337,-74.140516,4.697157
14576,2013,Marzo,Suecia,4,18,,22,-75.42726,6.170465
14577,2013,Marzo,Suecia,5,6,,11,-77.35002,8.63337
14578,2013,Marzo,Suiza,2,3,,5,-69.941498,4.191162
14579,2013,Marzo,Suiza,18,18,,36,-77.35600000000001,0.81488
14580,2013,Marzo,Suiza,6,11,,17,-75.527794,10.406342
14581,2013,Marzo,Suiza,13,21,,34,-75.516486,10.446304
14582,2013,Marzo,Suiza,1,7,,8,-74.77647900000001,10.886686
14583,2013,Marzo,Suiza,0,1,,1,-74.213989,11.247722999999999
14584,2013,Marzo,Suiza,0,1,,1,-72.129595,11.360028999999999
14585,2013,Marzo,Suiza,1,2,,3,-81.70216500000001,12.5862
14586,2013,Marzo,Suiza,18,34,,52,-76.532004,3.451668
14587,2013,Marzo,Suiza,1,1,,2,-75.76635300000001,4.45285
14588,2013,Marzo,Suiza,302,510,,812,-74.140516,4.697157
14589,2013,Marzo,Suiza,18,33,,51,-75.42726,6.170465
14590,2013,Marzo,Suiza,0,1,,1,-73.181317,7.1280470000000005
14591,2013,Marzo,Suiza,5,3,,8,-72.453013,7.819
14592,2013,Marzo,Suiza,8,4,,12,-77.35002,8.63337
14593,2013,Marzo,Surinam,0,3,,3,-76.532004,3.451668
14594,2013,Marzo,Surinam,3,16,,19,-74.140516,4.697157
14595,2013,Marzo,Surinam,3,6,,9,-75.42726,6.170465
14596,2013,Marzo,Taiwán,1,7,,8,-74.140516,4.697157
14597,2013,Marzo,Taiwán,0,1,,1,-75.42726,6.170465
14598,2013,Marzo,Taiwán,3,1,,4,-72.453013,7.819
14599,2013,Marzo,Tailandia,1,0,,1,-75.516486,10.446304
14600,2013,Marzo,Tailandia,3,4,,7,-74.140516,4.697157
14601,2013,Marzo,Tíbet/Región Autónoma de China,0,1,,1,-76.532004,3.451668
14602,2013,Marzo,Tíbet/Región Autónoma de China,0,1,,1,-74.140516,4.697157
14603,2013,Marzo,Territorio Antártico Británico/Territorio Británico de Ultramar,1,0,,1,-75.516486,10.446304
14604,2013,Marzo,Territorio Antártico Británico/Territorio Británico de Ultramar,2,3,,5,-74.140516,4.697157
14605,2013,Marzo,Territorio Antártico Británico/Territorio Británico de Ultramar,1,0,,1,-75.42726,6.170465
14606,2013,Marzo,Territorio Antártico Británico/Territorio Británico de Ultramar,1,0,,1,-77.35002,8.63337
14607,2013,Marzo,Tanzania,1,1,,2,-74.140516,4.697157
14608,2013,Marzo,Trinidad y Tobago,3,8,,11,-75.516486,10.446304
14609,2013,Marzo,Trinidad y Tobago,2,3,,5,-74.77647900000001,10.886686
14610,2013,Marzo,Trinidad y Tobago,2,2,,4,-76.532004,3.451668
14611,2013,Marzo,Trinidad y Tobago,14,44,,58,-74.140516,4.697157
14612,2013,Marzo,Trinidad y Tobago,0,1,,1,-75.736374,4.815189
14613,2013,Marzo,Trinidad y Tobago,1,2,,3,-75.42726,6.170465
14614,2013,Marzo,Trinidad y Tobago,1,4,,5,-73.181317,7.1280470000000005
14615,2013,Marzo,Trinidad y Tobago,0,1,,1,-72.453013,7.819
14616,2013,Marzo,Túnez,0,1,,1,-77.35600000000001,0.81488
14617,2013,Marzo,Túnez,1,0,,1,-74.140516,4.697157
14618,2013,Marzo,Túnez,0,1,,1,-75.42726,6.170465
14619,2013,Marzo,Turquía,0,1,,1,-69.941498,4.191162
14620,2013,Marzo,Turquía,2,3,,5,-77.35600000000001,0.81488
14621,2013,Marzo,Turquía,0,1,,1,-75.527794,10.406342
14622,2013,Marzo,Turquía,3,4,,7,-75.516486,10.446304
14623,2013,Marzo,Turquía,0,2,,2,-76.532004,3.451668
14624,2013,Marzo,Turquía,15,54,,69,-74.140516,4.697157
14625,2013,Marzo,Turquía,0,2,,2,-75.42726,6.170465
14626,2013,Marzo,Turquía,1,1,,2,-77.35002,8.63337
14627,2013,Marzo,Ucrania,0,2,,2,-77.35600000000001,0.81488
14628,2013,Marzo,Ucrania,1,0,,1,-75.516486,10.446304
14629,2013,Marzo,Ucrania,0,2,,2,-76.532004,3.451668
14630,2013,Marzo,Ucrania,0,1,,1,-77.061029,3.8844260000000004
14631,2013,Marzo,Ucrania,18,18,,36,-74.140516,4.697157
14632,2013,Marzo,Uganda,0,1,,1,-75.516486,10.446304
14633,2013,Marzo,Uganda,0,2,,2,-74.140516,4.697157
14634,2013,Marzo,Federación de Rusia,0,2,,2,-77.35600000000001,0.81488
14635,2013,Marzo,Federación de Rusia,2,3,,5,-75.527794,10.406342
14636,2013,Marzo,Federación de Rusia,1,3,,4,-75.516486,10.446304
14637,2013,Marzo,Federación de Rusia,1,0,,1,-72.129595,11.360028999999999
14638,2013,Marzo,Federación de Rusia,0,3,,3,-81.372937,13.338761300000002
14639,2013,Marzo,Federación de Rusia,3,2,,5,-76.532004,3.451668
14640,2013,Marzo,Federación de Rusia,114,166,,280,-74.140516,4.697157
14641,2013,Marzo,Federación de Rusia,3,3,,6,-75.42726,6.170465
14642,2013,Marzo,Federación de Rusia,1,2,,3,-72.453013,7.819
14643,2013,Marzo,Uruguay,4,9,,13,-77.35600000000001,0.81488
14644,2013,Marzo,Uruguay,9,6,,15,-75.527794,10.406342
14645,2013,Marzo,Uruguay,76,65,,141,-75.516486,10.446304
14646,2013,Marzo,Uruguay,4,5,,9,-74.77647900000001,10.886686
14647,2013,Marzo,Uruguay,1,4,,5,-72.129595,11.360028999999999
14648,2013,Marzo,Uruguay,31,29,,60,-81.70216500000001,12.5862
14649,2013,Marzo,Uruguay,4,30,,34,-76.532004,3.451668
14650,2013,Marzo,Uruguay,145,284,,429,-74.140516,4.697157
14651,2013,Marzo,Uruguay,0,2,,2,-75.736374,4.815189
14652,2013,Marzo,Uruguay,21,40,,61,-75.42726,6.170465
14653,2013,Marzo,Uruguay,5,15,,20,-72.453013,7.819
14654,2013,Marzo,Uzbekistán,1,0,,1,-74.140516,4.697157
14655,2013,Marzo,Venezuela,0,2,,2,-69.941498,4.191162
14656,2013,Marzo,Venezuela,68,95,,163,-77.35600000000001,0.81488
14657,2013,Marzo,Venezuela,4,10,,14,-75.527794,10.406342
14658,2013,Marzo,Venezuela,104,139,,243,-75.516486,10.446304
14659,2013,Marzo,Venezuela,39,63,,102,-74.77647900000001,10.886686
14660,2013,Marzo,Venezuela,1443,1824,,3267,-72.129595,11.360028999999999
14661,2013,Marzo,Venezuela,2,1,,3,-72.919186,11.52863
14662,2013,Marzo,Venezuela,2,2,,4,-81.70216500000001,12.5862
14663,2013,Marzo,Venezuela,44,74,,118,-76.532004,3.451668
14664,2013,Marzo,Venezuela,0,2,,2,-75.76635300000001,4.45285
14665,2013,Marzo,Venezuela,5349,6141,,11490,-74.140516,4.697157
14666,2013,Marzo,Venezuela,6,11,,17,-75.736374,4.815189
14667,2013,Marzo,Venezuela,348,378,,726,-75.42726,6.170465
14668,2013,Marzo,Venezuela,151,260,,411,-67.48402800000001,6.185536
14669,2013,Marzo,Venezuela,66,117,,183,-70.74025300000001,7.088728999999999
14670,2013,Marzo,Venezuela,3,4,,7,-73.181317,7.1280470000000005
14671,2013,Marzo,Venezuela,1257,1516,,2773,-72.453013,7.819
14672,2013,Marzo,Venezuela,195,208,,403,-72.508188,7.927233
14673,2013,Marzo,Vietnam,1,0,,1,-72.129595,11.360028999999999
14674,2013,Marzo,Vietnam,1,4,,5,-74.140516,4.697157
14675,2013,Marzo,Vietnam,0,2,,2,-75.42726,6.170465
14676,2013,Marzo,Zambia,0,1,,1,-74.140516,4.697157
14677,2013,Marzo,Zimbabue,1,4,,5,-74.140516,4.697157
14678,2013,Marzo,Zimbabue,1,0,,1,-75.42726,6.170465
14679,2013,Marzo,Reino Unido de Gran Bretaña e Irlanda del Norte,6,10,,16,-69.941498,4.191162
14680,2013,Marzo,Reino Unido de Gran Bretaña e Irlanda del Norte,19,33,,52,-77.35600000000001,0.81488
14681,2013,Marzo,Reino Unido de Gran Bretaña e Irlanda del Norte,10,28,,38,-75.527794,10.406342
14682,2013,Marzo,Reino Unido de Gran Bretaña e Irlanda del Norte,24,48,,72,-75.516486,10.446304
14683,2013,Marzo,Reino Unido de Gran Bretaña e Irlanda del Norte,2,7,,9,-74.77647900000001,10.886686
14684,2013,Marzo,Reino Unido de Gran Bretaña e Irlanda del Norte,0,1,,1,-74.765343,10.970933
14685,2013,Marzo,Reino Unido de Gran Bretaña e Irlanda del Norte,6,9,,15,-72.129595,11.360028999999999
14686,2013,Marzo,Reino Unido de Gran Bretaña e Irlanda del Norte,1,1,,2,-81.703935,12.574411099999999
14687,2013,Marzo,Reino Unido de Gran Bretaña e Irlanda del Norte,1,5,,6,-81.70216500000001,12.5862
14688,2013,Marzo,Reino Unido de Gran Bretaña e Irlanda del Norte,6,5,,11,-81.372937,13.338761300000002
14689,2013,Marzo,Reino Unido de Gran Bretaña e Irlanda del Norte,8,26,,34,-76.532004,3.451668
14690,2013,Marzo,Reino Unido de Gran Bretaña e Irlanda del Norte,276,687,,963,-74.140516,4.697157
14691,2013,Marzo,Reino Unido de Gran Bretaña e Irlanda del Norte,11,23,,34,-75.42726,6.170465
14692,2013,Marzo,Reino Unido de Gran Bretaña e Irlanda del Norte,1,11,,12,-72.453013,7.819
14693,2013,Marzo,Reino Unido de Gran Bretaña e Irlanda del Norte,0,1,,1,-72.508188,7.927233
14694,2013,Marzo,Reino Unido de Gran Bretaña e Irlanda del Norte,6,13,,19,-77.35002,8.63337
14695,2013,Marzo,Países Bajos,3,5,,8,-69.941498,4.191162
14696,2013,Marzo,Países Bajos,14,19,,33,-77.35600000000001,0.81488
14697,2013,Marzo,Países Bajos,5,6,,11,-75.527794,10.406342
14698,2013,Marzo,Países Bajos,14,47,,61,-75.516486,10.446304
14699,2013,Marzo,Países Bajos,1,5,,6,-74.77647900000001,10.886686
14700,2013,Marzo,Países Bajos,4,4,,8,-74.213989,11.247722999999999
14701,2013,Marzo,Países Bajos,2,4,,6,-72.129595,11.360028999999999
14702,2013,Marzo,Países Bajos,1,2,,3,-81.70216500000001,12.5862
14703,2013,Marzo,Países Bajos,3,2,,5,-81.372937,13.338761300000002
14704,2013,Marzo,Países Bajos,17,35,,52,-76.532004,3.451668
14705,2013,Marzo,Países Bajos,357,677,,1034,-74.140516,4.697157
14706,2013,Marzo,Países Bajos,0,3,,3,-75.736374,4.815189
14707,2013,Marzo,Países Bajos,107,146,,253,-75.42726,6.170465
14708,2013,Marzo,Países Bajos,5,3,,8,-73.181317,7.1280470000000005
14709,2013,Marzo,Países Bajos,2,30,,32,-72.453013,7.819
14710,2013,Marzo,Países Bajos,0,1,,1,-72.508188,7.927233
14711,2013,Marzo,Países Bajos,2,6,,8,-77.35002,8.63337
14712,2013,Marzo,Desconocido,0,1,,1,-74.140516,4.697157
14713,2013,Marzo,Eslovenia,0,1,,1,-74.140516,4.697157
14714,2013,Marzo,Lituania,3,2,,5,-74.140516,4.697157
14715,2013,Marzo,Reino Unido de Gran Bretaña e Irlanda del Norte,0,1,,1,-75.527794,10.406342
14716,2013,Marzo,Reino Unido de Gran Bretaña e Irlanda del Norte,0,2,,2,-77.35600000000001,0.81488
14717,2013,Marzo,Reino Unido de Gran Bretaña e Irlanda del Norte,1,1,,2,-75.516486,10.446304
14718,2013,Marzo,Reino Unido de Gran Bretaña e Irlanda del Norte,4,14,,18,-74.140516,4.697157
14719,2013,Marzo,Reino Unido de Gran Bretaña e Irlanda del Norte,0,1,,1,-75.42726,6.170465
14720,2013,Marzo,Reino Unido de Gran Bretaña e Irlanda del Norte,1,0,,1,-77.401154,6.222551999999999
14721,2013,Marzo,Marruecos,1,1,,2,-74.140516,4.697157
14722,2013,Abril,Albania,1,0,,1,-76.532004,3.451668
14723,2013,Abril,Albania,5,2,,7,-74.140516,4.697157
14724,2013,Abril,Alemania,16,16,,32,-69.941498,4.191162
14725,2013,Abril,Alemania,45,47,,92,-77.35600000000001,0.81488
14726,2013,Abril,Alemania,15,19,,34,-75.527794,10.406342
14727,2013,Abril,Alemania,23,44,,67,-75.516486,10.446304
14728,2013,Abril,Alemania,5,16,,21,-74.77647900000001,10.886686
14729,2013,Abril,Alemania,1,0,,1,-74.213989,11.247722999999999
14730,2013,Abril,Alemania,9,8,,17,-72.129595,11.360028999999999
14731,2013,Abril,Alemania,2,2,,4,-81.70216500000001,12.5862
14732,2013,Abril,Alemania,28,53,,81,-76.532004,3.451668
14733,2013,Abril,Alemania,940,1651,,2591,-74.140516,4.697157
14734,2013,Abril,Alemania,0,1,,1,-75.736374,4.815189
14735,2013,Abril,Alemania,30,69,,99,-75.42726,6.170465
14736,2013,Abril,Alemania,1,0,,1,-67.48402800000001,6.185536
14737,2013,Abril,Alemania,0,1,,1,-73.181317,7.1280470000000005
14738,2013,Abril,Alemania,3,9,,12,-72.453013,7.819
14739,2013,Abril,Alemania,9,5,,14,-77.35002,8.63337
14740,2013,Abril,Andorra,0,1,,1,-74.77647900000001,10.886686
14741,2013,Abril,Andorra,2,10,,12,-74.140516,4.697157
14742,2013,Abril,Andorra,0,1,,1,-75.42726,6.170465
14743,2013,Abril,Antigua y Barbuda,0,1,,1,-74.77647900000001,10.886686
14744,2013,Abril,Países Bajos,3,5,,8,-75.42726,6.170465
14745,2013,Abril,Arabia Saudita,0,5,,5,-74.140516,4.697157
14746,2013,Abril,Arabia Saudita,0,1,,1,-75.736374,4.815189
14747,2013,Abril,Argelia,1,3,,4,-74.140516,4.697157
14748,2013,Abril,Argentina,2,4,,6,-69.941498,4.191162
14749,2013,Abril,Argentina,7,5,,12,-76.876446,0.33002
14750,2013,Abril,Argentina,70,135,,205,-77.35600000000001,0.81488
14751,2013,Abril,Argentina,2,3,,5,-75.527794,10.406342
14752,2013,Abril,Argentina,1,4,,5,-73.247863,10.433608999999999
14753,2013,Abril,Argentina,977,604,,1581,-75.516486,10.446304
14754,2013,Abril,Argentina,8,30,,38,-74.77647900000001,10.886686
14755,2013,Abril,Argentina,0,1,,1,-74.213989,11.247722999999999
14756,2013,Abril,Argentina,12,30,,42,-72.129595,11.360028999999999
14757,2013,Abril,Argentina,200,158,,358,-81.70216500000001,12.5862
14758,2013,Abril,Argentina,26,78,,104,-76.532004,3.451668
14759,2013,Abril,Argentina,0,1,,1,-75.76635300000001,4.45285
14760,2013,Abril,Argentina,3490,4782,,8272,-74.140516,4.697157
14761,2013,Abril,Argentina,1,5,,6,-75.736374,4.815189
14762,2013,Abril,Argentina,97,243,,340,-75.42726,6.170465
14763,2013,Abril,Argentina,0,4,,4,-67.48402800000001,6.185536
14764,2013,Abril,Argentina,18,31,,49,-72.453013,7.819
14765,2013,Abril,Argentina,3,1,,4,-72.508188,7.927233
14766,2013,Abril,Argentina,1,7,,8,-77.35002,8.63337
14767,2013,Abril,República de Armenia,0,1,,1,-74.140516,4.697157
14768,2013,Abril,Aruba,0,1,,1,-76.532004,3.451668
14769,2013,Abril,Aruba,2,6,,8,-74.140516,4.697157
14770,2013,Abril,Aruba,2,4,,6,-75.42726,6.170465
14771,2013,Abril,Australia,2,3,,5,-69.941498,4.191162
14772,2013,Abril,Australia,35,42,,77,-77.35600000000001,0.81488
14773,2013,Abril,Australia,8,13,,21,-75.527794,10.406342
14774,2013,Abril,Australia,17,39,,56,-75.516486,10.446304
14775,2013,Abril,Australia,3,6,,9,-74.77647900000001,10.886686
14776,2013,Abril,Australia,3,3,,6,-72.129595,11.360028999999999
14777,2013,Abril,Australia,1,1,,2,-81.70216500000001,12.5862
14778,2013,Abril,Australia,13,20,,33,-76.532004,3.451668
14779,2013,Abril,Australia,144,328,,472,-74.140516,4.697157
14780,2013,Abril,Australia,2,3,,5,-75.736374,4.815189
14781,2013,Abril,Australia,24,44,,68,-75.42726,6.170465
14782,2013,Abril,Australia,0,1,,1,-73.181317,7.1280470000000005
14783,2013,Abril,Australia,11,8,,19,-72.453013,7.819
14784,2013,Abril,Australia,1,3,,4,-77.35002,8.63337
14785,2013,Abril,Austria,1,6,,7,-77.35600000000001,0.81488
14786,2013,Abril,Austria,2,2,,4,-75.527794,10.406342
14787,2013,Abril,Austria,3,5,,8,-75.516486,10.446304
14788,2013,Abril,Austria,1,2,,3,-74.77647900000001,10.886686
14789,2013,Abril,Austria,0,1,,1,-74.213989,11.247722999999999
14790,2013,Abril,Austria,1,3,,4,-81.70216500000001,12.5862
14791,2013,Abril,Austria,2,6,,8,-76.532004,3.451668
14792,2013,Abril,Austria,0,1,,1,-75.76635300000001,4.45285
14793,2013,Abril,Austria,61,177,,238,-74.140516,4.697157
14794,2013,Abril,Austria,4,5,,9,-75.42726,6.170465
14795,2013,Abril,Austria,1,1,,2,-77.35002,8.63337
14796,2013,Abril,Azerbaiyán,3,3,,6,-74.140516,4.697157
14797,2013,Abril,Bahamas,0,2,,2,-75.516486,10.446304
14798,2013,Abril,Bahamas,0,2,,2,-74.77647900000001,10.886686
14799,2013,Abril,Bahamas,3,7,,10,-74.140516,4.697157
14800,2013,Abril,Bahamas,0,1,,1,-75.42726,6.170465
14801,2013,Abril,Bangladesh,0,1,,1,-72.129595,11.360028999999999
14802,2013,Abril,Bangladesh,2,2,,4,-74.140516,4.697157
14803,2013,Abril,Bangladesh,0,1,,1,-75.42726,6.170465
14804,2013,Abril,Barbados,0,1,,1,-77.35600000000001,0.81488
14805,2013,Abril,Barbados,1,0,,1,-74.77647900000001,10.886686
14806,2013,Abril,Barbados,0,2,,2,-76.532004,3.451668
14807,2013,Abril,Barbados,1,3,,4,-74.140516,4.697157
14808,2013,Abril,Barbados,1,2,,3,-75.42726,6.170465
14809,2013,Abril,República de Belarús,1,1,,2,-77.35600000000001,0.81488
14810,2013,Abril,República de Belarús,6,2,,8,-74.140516,4.697157
14811,2013,Abril,Bélgica,2,1,,3,-69.941498,4.191162
14812,2013,Abril,Bélgica,5,14,,19,-77.35600000000001,0.81488
14813,2013,Abril,Bélgica,1,3,,4,-75.527794,10.406342
14814,2013,Abril,Bélgica,2,15,,17,-75.516486,10.446304
14815,2013,Abril,Bélgica,1,2,,3,-74.77647900000001,10.886686
14816,2013,Abril,Bélgica,0,12,,12,-74.213989,11.247722999999999
14817,2013,Abril,Bélgica,0,2,,2,-72.129595,11.360028999999999
14818,2013,Abril,Bélgica,2,15,,17,-76.532004,3.451668
14819,2013,Abril,Bélgica,83,277,,360,-74.140516,4.697157
14820,2013,Abril,Bélgica,7,10,,17,-75.42726,6.170465
14821,2013,Abril,Bélgica,3,2,,5,-72.453013,7.819
14822,2013,Abril,Belice,0,1,,1,-75.516486,10.446304
14823,2013,Abril,Belice,0,1,,1,-76.532004,3.451668
14824,2013,Abril,Belice,2,11,,13,-74.140516,4.697157
14825,2013,Abril,Belice,0,3,,3,-75.42726,6.170465
14826,2013,Abril,Bermudas/Territorio Británico de Ultramar,0,1,,1,-76.532004,3.451668
14827,2013,Abril,Bermudas/Territorio Británico de Ultramar,0,2,,2,-74.140516,4.697157
14828,2013,Abril,Bolivia,2,0,,2,-69.941498,4.191162
14829,2013,Abril,Bolivia,4,10,,14,-77.35600000000001,0.81488
14830,2013,Abril,Bolivia,1,0,,1,-78.802679,18.00143
14831,2013,Abril,Bolivia,1,0,,1,-73.247863,10.433608999999999
14832,2013,Abril,Bolivia,20,21,,41,-75.516486,10.446304
14833,2013,Abril,Bolivia,3,5,,8,-74.77647900000001,10.886686
14834,2013,Abril,Bolivia,0,2,,2,-72.129595,11.360028999999999
14835,2013,Abril,Bolivia,1,3,,4,-81.70216500000001,12.5862
14836,2013,Abril,Bolivia,16,12,,28,-76.532004,3.451668
14837,2013,Abril,Bolivia,287,469,,756,-74.140516,4.697157
14838,2013,Abril,Bolivia,0,1,,1,-75.736374,4.815189
14839,2013,Abril,Bolivia,22,36,,58,-75.42726,6.170465
14840,2013,Abril,Bolivia,0,1,,1,-67.48402800000001,6.185536
14841,2013,Abril,Bolivia,0,1,,1,-72.453013,7.819
14842,2013,Abril,Botsuana,0,3,,3,-74.140516,4.697157
14843,2013,Abril,Brasil,45,61,,106,-69.941498,4.191162
14844,2013,Abril,Brasil,0,1,,1,-76.876446,0.33002
14845,2013,Abril,Brasil,2,15,,17,-77.35600000000001,0.81488
14846,2013,Abril,Brasil,104,127,,231,-75.516486,10.446304
14847,2013,Abril,Brasil,11,14,,25,-74.77647900000001,10.886686
14848,2013,Abril,Brasil,3,8,,11,-72.129595,11.360028999999999
14849,2013,Abril,Brasil,24,21,,45,-81.70216500000001,12.5862
14850,2013,Abril,Brasil,23,92,,115,-76.532004,3.451668
14851,2013,Abril,Brasil,2053,3701,,5754,-74.140516,4.697157
14852,2013,Abril,Brasil,0,3,,3,-75.736374,4.815189
14853,2013,Abril,Brasil,53,128,,181,-75.42726,6.170465
14854,2013,Abril,Brasil,1,0,,1,-73.181317,7.1280470000000005
14855,2013,Abril,Brasil,5,11,,16,-72.453013,7.819
14856,2013,Abril,Brasil,2,6,,8,-72.508188,7.927233
14857,2013,Abril,Brasil,1,3,,4,-77.35002,8.63337
14858,2013,Abril,Bulgaria,0,1,,1,-76.532004,3.451668
14859,2013,Abril,Bulgaria,18,10,,28,-74.140516,4.697157
14860,2013,Abril,Bulgaria,1,1,,2,-75.42726,6.170465
14861,2013,Abril,Bután,0,1,,1,-74.140516,4.697157
14862,2013,Abril,Islas Caimán/Territorio Británico de Ultramar,1,1,,2,-75.516486,10.446304
14863,2013,Abril,Islas Caimán/Territorio Británico de Ultramar,4,6,,10,-81.70216500000001,12.5862
14864,2013,Abril,Islas Caimán/Territorio Británico de Ultramar,1,0,,1,-74.140516,4.697157
14865,2013,Abril,Camerún,2,2,,4,-74.140516,4.697157
14866,2013,Abril,Camerún,0,1,,1,-75.42726,6.170465
14867,2013,Abril,Canadá,5,10,,15,-69.941498,4.191162
14868,2013,Abril,Canadá,17,22,,39,-77.35600000000001,0.81488
14869,2013,Abril,Canadá,6,13,,19,-75.527794,10.406342
14870,2013,Abril,Canadá,63,100,,163,-75.516486,10.446304
14871,2013,Abril,Canadá,13,34,,47,-74.77647900000001,10.886686
14872,2013,Abril,Canadá,1,5,,6,-72.129595,11.360028999999999
14873,2013,Abril,Canadá,68,66,,134,-81.70216500000001,12.5862
14874,2013,Abril,Canadá,25,61,,86,-76.532004,3.451668
14875,2013,Abril,Canadá,4,6,,10,-75.76635300000001,4.45285
14876,2013,Abril,Canadá,547,1153,,1700,-74.140516,4.697157
14877,2013,Abril,Canadá,1,7,,8,-75.736374,4.815189
14878,2013,Abril,Canadá,48,154,,202,-75.42726,6.170465
14879,2013,Abril,Canadá,0,2,,2,-73.181317,7.1280470000000005
14880,2013,Abril,Canadá,4,4,,8,-72.453013,7.819
14881,2013,Abril,Canadá,0,1,,1,-72.508188,7.927233
14882,2013,Abril,Canadá,4,4,,8,-77.35002,8.63337
14883,2013,Abril,Chad,0,2,,2,-74.140516,4.697157
14884,2013,Abril,España,3,7,,10,-77.35600000000001,0.81488
14885,2013,Abril,España,1,1,,2,-75.527794,10.406342
14886,2013,Abril,España,3,7,,10,-75.516486,10.446304
14887,2013,Abril,España,2,14,,16,-74.77647900000001,10.886686
14888,2013,Abril,España,1,1,,2,-74.213989,11.247722999999999
14889,2013,Abril,España,27,69,,96,-76.532004,3.451668
14890,2013,Abril,España,88,314,,402,-74.140516,4.697157
14891,2013,Abril,España,0,3,,3,-75.736374,4.815189
14892,2013,Abril,España,38,127,,165,-75.42726,6.170465
14893,2013,Abril,España,0,1,,1,-73.181317,7.1280470000000005
14894,2013,Abril,España,0,1,,1,-72.508188,7.927233
14895,2013,Abril,República Democrática del Congo,0,1,,1,-76.532004,3.451668
14896,2013,Abril,República Democrática del Congo,0,2,,2,-74.140516,4.697157
14897,2013,Abril,República Democrática del Congo,0,1,,1,-75.42726,6.170465
14898,2013,Abril,República de Corea,1,0,,1,-69.941498,4.191162
14899,2013,Abril,República de Corea,12,8,,20,-77.35600000000001,0.81488
14900,2013,Abril,República de Corea,0,1,,1,-75.527794,10.406342
14901,2013,Abril,República de Corea,1,1,,2,-75.516486,10.446304
14902,2013,Abril,República de Corea,0,4,,4,-74.77647900000001,10.886686
14903,2013,Abril,República de Corea,1,5,,6,-76.532004,3.451668
14904,2013,Abril,República de Corea,0,2,,2,-77.061029,3.8844260000000004
14905,2013,Abril,República de Corea,98,346,,444,-74.140516,4.697157
14906,2013,Abril,República de Corea,9,17,,26,-75.42726,6.170465
14907,2013,Abril,República de Corea,0,3,,3,-72.453013,7.819
14908,2013,Abril,Costa de Marfil,0,1,,1,-74.140516,4.697157
14909,2013,Abril,Costa Rica,0,1,,1,-69.941498,4.191162
14910,2013,Abril,Costa Rica,1,0,,1,-76.876446,0.33002
14911,2013,Abril,Costa Rica,2,5,,7,-77.35600000000001,0.81488
14912,2013,Abril,Costa Rica,46,70,,116,-75.516486,10.446304
14913,2013,Abril,Costa Rica,12,23,,35,-74.77647900000001,10.886686
14914,2013,Abril,Costa Rica,264,210,,474,-81.70216500000001,12.5862
14915,2013,Abril,Costa Rica,22,61,,83,-76.532004,3.451668
14916,2013,Abril,Costa Rica,1,1,,2,-75.76635300000001,4.45285
14917,2013,Abril,Costa Rica,451,758,,1209,-74.140516,4.697157
14918,2013,Abril,Costa Rica,2,5,,7,-75.736374,4.815189
14919,2013,Abril,Costa Rica,107,183,,290,-75.42726,6.170465
14920,2013,Abril,Costa Rica,2,2,,4,-72.453013,7.819
14921,2013,Abril,Costa Rica,2,4,,6,-72.508188,7.927233
14922,2013,Abril,Costa Rica,0,1,,1,-77.35002,8.63337
14923,2013,Abril,Croacia,1,1,,2,-77.35600000000001,0.81488
14924,2013,Abril,Croacia,0,1,,1,-75.527794,10.406342
14925,2013,Abril,Croacia,1,1,,2,-75.516486,10.446304
14926,2013,Abril,Croacia,1,22,,23,-74.140516,4.697157
14927,2013,Abril,Croacia,1,2,,3,-75.42726,6.170465
14928,2013,Abril,Cuba,0,2,,2,-77.35600000000001,0.81488
14929,2013,Abril,Cuba,0,1,,1,-75.527794,10.406342
14930,2013,Abril,Cuba,1,0,,1,-73.247863,10.433608999999999
14931,2013,Abril,Cuba,4,8,,12,-75.516486,10.446304
14932,2013,Abril,Cuba,5,22,,27,-74.77647900000001,10.886686
14933,2013,Abril,Cuba,15,28,,43,-76.532004,3.451668
14934,2013,Abril,Cuba,2,0,,2,-75.76635300000001,4.45285
14935,2013,Abril,Cuba,65,143,,208,-74.140516,4.697157
14936,2013,Abril,Cuba,11,16,,27,-75.42726,6.170465
14937,2013,Abril,Cuba,0,1,,1,-73.181317,7.1280470000000005
14938,2013,Abril,Cuba,0,2,,2,-72.453013,7.819
14939,2013,Abril,Cuba,1,3,,4,-72.508188,7.927233
14940,2013,Abril,Curazao,1,2,,3,-74.140516,4.697157
14941,2013,Abril,Curazao,5,8,,13,-75.42726,6.170465
14942,2013,Abril,República Checa,2,1,,3,-77.35600000000001,0.81488
14943,2013,Abril,República Checa,0,4,,4,-75.516486,10.446304
14944,2013,Abril,República Checa,0,1,,1,-74.77647900000001,10.886686
14945,2013,Abril,República Checa,0,2,,2,-72.129595,11.360028999999999
14946,2013,Abril,República Checa,2,1,,3,-76.532004,3.451668
14947,2013,Abril,República Checa,22,33,,55,-74.140516,4.697157
14948,2013,Abril,República Checa,1,2,,3,-75.42726,6.170465
14949,2013,Abril,República Checa,1,0,,1,-72.453013,7.819
14950,2013,Abril,Chile,3,1,,4,-69.941498,4.191162
14951,2013,Abril,Chile,0,1,,1,-76.876446,0.33002
14952,2013,Abril,Chile,20,49,,69,-77.35600000000001,0.81488
14953,2013,Abril,Chile,5,6,,11,-75.527794,10.406342
14954,2013,Abril,Chile,86,63,,149,-75.516486,10.446304
14955,2013,Abril,Chile,7,23,,30,-74.77647900000001,10.886686
14956,2013,Abril,Chile,4,12,,16,-72.129595,11.360028999999999
14957,2013,Abril,Chile,41,32,,73,-81.70216500000001,12.5862
14958,2013,Abril,Chile,43,76,,119,-76.532004,3.451668
14959,2013,Abril,Chile,2449,3688,,6137,-74.140516,4.697157
14960,2013,Abril,Chile,1,5,,6,-75.736374,4.815189
14961,2013,Abril,Chile,37,88,,125,-75.42726,6.170465
14962,2013,Abril,Chile,0,1,,1,-73.181317,7.1280470000000005
14963,2013,Abril,Chile,8,20,,28,-72.453013,7.819
14964,2013,Abril,Chile,0,1,,1,-72.508188,7.927233
14965,2013,Abril,Chile,0,1,,1,-77.35002,8.63337
14966,2013,Abril,China,3,4,,7,-77.35600000000001,0.81488
14967,2013,Abril,China,1,6,,7,-75.516486,10.446304
14968,2013,Abril,China,2,3,,5,-74.77647900000001,10.886686
14969,2013,Abril,China,0,1,,1,-72.129595,11.360028999999999
14970,2013,Abril,China,7,10,,17,-76.532004,3.451668
14971,2013,Abril,China,180,625,,805,-74.140516,4.697157
14972,2013,Abril,China,14,16,,30,-75.42726,6.170465
14973,2013,Abril,Taiwán,0,2,,2,-77.35600000000001,0.81488
14974,2013,Abril,Taiwán,2,3,,5,-75.516486,10.446304
14975,2013,Abril,Taiwán,1,2,,3,-74.77647900000001,10.886686
14976,2013,Abril,Taiwán,1,2,,3,-76.532004,3.451668
14977,2013,Abril,Taiwán,31,55,,86,-74.140516,4.697157
14978,2013,Abril,Taiwán,0,1,,1,-75.736374,4.815189
14979,2013,Abril,Taiwán,3,10,,13,-75.42726,6.170465
14980,2013,Abril,Taiwán,0,1,,1,-73.181317,7.1280470000000005
14981,2013,Abril,Taiwán,3,0,,3,-72.453013,7.819
14982,2013,Abril,Chipre,0,6,,6,-74.140516,4.697157
14983,2013,Abril,Dinamarca,3,2,,5,-69.941498,4.191162
14984,2013,Abril,Dinamarca,0,1,,1,-76.876446,0.33002
14985,2013,Abril,Dinamarca,6,7,,13,-77.35600000000001,0.81488
14986,2013,Abril,Dinamarca,2,0,,2,-75.527794,10.406342
14987,2013,Abril,Dinamarca,4,5,,9,-75.516486,10.446304
14988,2013,Abril,Dinamarca,2,1,,3,-72.129595,11.360028999999999
14989,2013,Abril,Dinamarca,0,8,,8,-76.532004,3.451668
14990,2013,Abril,Dinamarca,42,91,,133,-74.140516,4.697157
14991,2013,Abril,Dinamarca,2,4,,6,-75.736374,4.815189
14992,2013,Abril,Dinamarca,1,6,,7,-75.42726,6.170465
14993,2013,Abril,Dinamarca,3,2,,5,-77.35002,8.63337
14994,2013,Abril,Dominica,0,9,,9,-74.140516,4.697157
14995,2013,Abril,Dominica,0,1,,1,-75.42726,6.170465
14996,2013,Abril,Ecuador,0,2,,2,-69.941498,4.191162
14997,2013,Abril,Ecuador,21,51,,72,-76.876446,0.33002
14998,2013,Abril,Ecuador,876,1393,,2269,-77.35600000000001,0.81488
14999,2013,Abril,Ecuador,2,55,,57,-78.802679,18.00143
15000,2013,Abril,Ecuador,1,2,,3,-75.527794,10.406342
15001,2013,Abril,Ecuador,102,74,,176,-75.516486,10.446304
15002,2013,Abril,Ecuador,9,19,,28,-74.77647900000001,10.886686
15003,2013,Abril,Ecuador,7,13,,20,-72.129595,11.360028999999999
15004,2013,Abril,Ecuador,18,15,,33,-81.70216500000001,12.5862
15005,2013,Abril,Ecuador,449,488,,937,-76.532004,3.451668
15006,2013,Abril,Ecuador,1,0,,1,-77.061029,3.8844260000000004
15007,2013,Abril,Ecuador,1,1,,2,-75.76635300000001,4.45285
15008,2013,Abril,Ecuador,1864,2936,,4800,-74.140516,4.697157
15009,2013,Abril,Ecuador,2,6,,8,-75.736374,4.815189
15010,2013,Abril,Ecuador,714,765,,1479,-75.42726,6.170465
15011,2013,Abril,Ecuador,1,1,,2,-73.181317,7.1280470000000005
15012,2013,Abril,Ecuador,131,145,,276,-72.453013,7.819
15013,2013,Abril,Ecuador,2,1,,3,-72.508188,7.927233
15014,2013,Abril,Ecuador,0,1,,1,-77.35002,8.63337
15015,2013,Abril,Egipto,0,8,,8,-77.35600000000001,0.81488
15016,2013,Abril,Egipto,4,17,,21,-74.140516,4.697157
15017,2013,Abril,Egipto,0,1,,1,-75.42726,6.170465
15018,2013,Abril,El Salvador,1,0,,1,-69.941498,4.191162
15019,2013,Abril,El Salvador,0,1,,1,-77.35600000000001,0.81488
15020,2013,Abril,El Salvador,0,1,,1,-73.247863,10.433608999999999
15021,2013,Abril,El Salvador,10,22,,32,-75.516486,10.446304
15022,2013,Abril,El Salvador,1,4,,5,-74.77647900000001,10.886686
15023,2013,Abril,El Salvador,0,1,,1,-72.129595,11.360028999999999
15024,2013,Abril,El Salvador,55,70,,125,-76.532004,3.451668
15025,2013,Abril,El Salvador,480,670,,1150,-74.140516,4.697157
15026,2013,Abril,El Salvador,76,113,,189,-75.42726,6.170465
15027,2013,Abril,El Salvador,0,1,,1,-72.453013,7.819
15028,2013,Abril,El Salvador,1,1,,2,-72.508188,7.927233
15029,2013,Abril,El Salvador,0,1,,1,-77.35002,8.63337
15030,2013,Abril,Emiratos Árabes,0,4,,4,-74.140516,4.697157
15031,2013,Abril,España,5,9,,14,-69.941498,4.191162
15032,2013,Abril,España,1,3,,4,-76.876446,0.33002
15033,2013,Abril,España,19,31,,50,-77.35600000000001,0.81488
15034,2013,Abril,España,1,8,,9,-75.527794,10.406342
15035,2013,Abril,España,0,4,,4,-73.247863,10.433608999999999
15036,2013,Abril,España,28,88,,116,-75.516486,10.446304
15037,2013,Abril,España,7,20,,27,-74.77647900000001,10.886686
15038,2013,Abril,España,2,10,,12,-72.129595,11.360028999999999
15039,2013,Abril,España,11,8,,19,-81.70216500000001,12.5862
15040,2013,Abril,España,141,286,,427,-76.532004,3.451668
15041,2013,Abril,España,1532,4411,,5943,-74.140516,4.697157
15042,2013,Abril,España,0,8,,8,-75.736374,4.815189
15043,2013,Abril,España,46,162,,208,-75.42726,6.170465
15044,2013,Abril,España,0,1,,1,-67.48402800000001,6.185536
15045,2013,Abril,España,1,2,,3,-70.74025300000001,7.088728999999999
15046,2013,Abril,España,2,4,,6,-73.181317,7.1280470000000005
15047,2013,Abril,España,15,37,,52,-72.453013,7.819
15048,2013,Abril,España,0,6,,6,-72.508188,7.927233
15049,2013,Abril,España,2,5,,7,-77.35002,8.63337
15050,2013,Abril,Eslovaquia,2,1,,3,-77.35600000000001,0.81488
15051,2013,Abril,Eslovaquia,0,1,,1,-74.77647900000001,10.886686
15052,2013,Abril,Eslovaquia,12,12,,24,-74.140516,4.697157
15053,2013,Abril,Eslovaquia,0,1,,1,-75.42726,6.170465
15054,2013,Abril,Eslovaquia,0,1,,1,-77.35002,8.63337
15055,2013,Abril,Eslovenia,0,1,,1,-75.527794,10.406342
15056,2013,Abril,Eslovenia,0,3,,3,-75.516486,10.446304
15057,2013,Abril,Eslovenia,0,1,,1,-72.129595,11.360028999999999
15058,2013,Abril,Eslovenia,1,1,,2,-72.919186,11.52863
15059,2013,Abril,Eslovenia,0,1,,1,-76.532004,3.451668
15060,2013,Abril,Eslovenia,13,29,,42,-74.140516,4.697157
15061,2013,Abril,Estados Unidos de América,13,31,,44,-69.941498,4.191162
15062,2013,Abril,Estados Unidos de América,50,81,,131,-77.35600000000001,0.81488
15063,2013,Abril,Estados Unidos de América,0,1,,1,-78.802679,18.00143
15064,2013,Abril,Estados Unidos de América,5,30,,35,-75.527794,10.406342
15065,2013,Abril,Estados Unidos de América,3,14,,17,-73.247863,10.433608999999999
15066,2013,Abril,Estados Unidos de América,874,1908,,2782,-75.516486,10.446304
15067,2013,Abril,Estados Unidos de América,203,427,,630,-74.77647900000001,10.886686
15068,2013,Abril,Estados Unidos de América,1,7,,8,-74.213989,11.247722999999999
15069,2013,Abril,Estados Unidos de América,8,12,,20,-72.129595,11.360028999999999
15070,2013,Abril,Estados Unidos de América,0,2,,2,-72.919186,11.52863
15071,2013,Abril,Estados Unidos de América,16,27,,43,-81.70216500000001,12.5862
15072,2013,Abril,Estados Unidos de América,9,12,,21,-81.372937,13.338761300000002
15073,2013,Abril,Estados Unidos de América,547,1002,,1549,-76.532004,3.451668
15074,2013,Abril,Estados Unidos de América,76,118,,194,-75.76635300000001,4.45285
15075,2013,Abril,Estados Unidos de América,4719,10066,,14785,-74.140516,4.697157
15076,2013,Abril,Estados Unidos de América,23,52,,75,-75.736374,4.815189
15077,2013,Abril,Estados Unidos de América,799,2326,,3125,-75.42726,6.170465
15078,2013,Abril,Estados Unidos de América,1,1,,2,-67.48402800000001,6.185536
15079,2013,Abril,Estados Unidos de América,3,17,,20,-73.181317,7.1280470000000005
15080,2013,Abril,Estados Unidos de América,17,43,,60,-72.453013,7.819
15081,2013,Abril,Estados Unidos de América,5,16,,21,-72.508188,7.927233
15082,2013,Abril,Estados Unidos de América,4,20,,24,-77.35002,8.63337
15083,2013,Abril,Estonia,3,5,,8,-74.140516,4.697157
15084,2013,Abril,Estonia,0,1,,1,-77.35002,8.63337
15085,2013,Abril,Etiopia,2,5,,7,-74.140516,4.697157
15086,2013,Abril,Filipinas,0,1,,1,-77.35600000000001,0.81488
15087,2013,Abril,Filipinas,0,14,,14,-75.527794,10.406342
15088,2013,Abril,Filipinas,0,14,,14,-75.516486,10.446304
15089,2013,Abril,Filipinas,0,1,,1,-74.77647900000001,10.886686
15090,2013,Abril,Filipinas,1,10,,11,-74.213989,11.247722999999999
15091,2013,Abril,Filipinas,2,0,,2,-81.70216500000001,12.5862
15092,2013,Abril,Filipinas,2,5,,7,-76.532004,3.451668
15093,2013,Abril,Filipinas,0,13,,13,-77.061029,3.8844260000000004
15094,2013,Abril,Filipinas,19,41,,60,-74.140516,4.697157
15095,2013,Abril,Filipinas,1,2,,3,-75.42726,6.170465
15096,2013,Abril,Filipinas,0,2,,2,-75.68164200000001,9.402597
15097,2013,Abril,Finlandia,0,1,,1,-69.941498,4.191162
15098,2013,Abril,Finlandia,3,3,,6,-77.35600000000001,0.81488
15099,2013,Abril,Finlandia,1,1,,2,-75.527794,10.406342
15100,2013,Abril,Finlandia,1,4,,5,-75.516486,10.446304
15101,2013,Abril,Finlandia,0,2,,2,-74.77647900000001,10.886686
15102,2013,Abril,Finlandia,1,3,,4,-72.129595,11.360028999999999
15103,2013,Abril,Finlandia,0,2,,2,-76.532004,3.451668
15104,2013,Abril,Finlandia,34,82,,116,-74.140516,4.697157
15105,2013,Abril,Finlandia,0,1,,1,-75.42726,6.170465
15106,2013,Abril,Finlandia,1,3,,4,-77.35002,8.63337
15107,2013,Abril,Francia,6,18,,24,-69.941498,4.191162
15108,2013,Abril,Francia,1,1,,2,-76.876446,0.33002
15109,2013,Abril,Francia,39,57,,96,-77.35600000000001,0.81488
15110,2013,Abril,Francia,1,1,,2,-78.802679,18.00143
15111,2013,Abril,Francia,6,11,,17,-75.527794,10.406342
15112,2013,Abril,Francia,15,30,,45,-75.516486,10.446304
15113,2013,Abril,Francia,1,9,,10,-74.77647900000001,10.886686
15114,2013,Abril,Francia,1,9,,10,-74.213989,11.247722999999999
15115,2013,Abril,Francia,5,10,,15,-72.129595,11.360028999999999
15116,2013,Abril,Francia,0,1,,1,-72.919186,11.52863
15117,2013,Abril,Francia,25,48,,73,-76.532004,3.451668
15118,2013,Abril,Francia,793,1599,,2392,-74.140516,4.697157
15119,2013,Abril,Francia,0,3,,3,-75.736374,4.815189
15120,2013,Abril,Francia,25,61,,86,-75.42726,6.170465
15121,2013,Abril,Francia,0,1,,1,-73.181317,7.1280470000000005
15122,2013,Abril,Francia,6,10,,16,-72.453013,7.819
15123,2013,Abril,Francia,0,2,,2,-72.508188,7.927233
15124,2013,Abril,Francia,1,4,,5,-77.35002,8.63337
15125,2013,Abril,Gabón,0,2,,2,-74.140516,4.697157
15126,2013,Abril,Gambia,1,0,,1,-74.140516,4.697157
15127,2013,Abril,Georgia,1,0,,1,-75.516486,10.446304
15128,2013,Abril,Georgia,1,1,,2,-74.140516,4.697157
15129,2013,Abril,Ghana,1,0,,1,-76.532004,3.451668
15130,2013,Abril,Ghana,0,1,,1,-74.140516,4.697157
15131,2013,Abril,Granada,1,0,,1,-75.516486,10.446304
15132,2013,Abril,Grecia,1,0,,1,-69.941498,4.191162
15133,2013,Abril,Grecia,1,3,,4,-75.516486,10.446304
15134,2013,Abril,Grecia,1,1,,2,-72.129595,11.360028999999999
15135,2013,Abril,Grecia,2,1,,3,-76.532004,3.451668
15136,2013,Abril,Grecia,12,48,,60,-74.140516,4.697157
15137,2013,Abril,Grecia,0,4,,4,-75.42726,6.170465
15138,2013,Abril,Grecia,0,1,,1,-73.181317,7.1280470000000005
15139,2013,Abril,Grecia,1,3,,4,-72.453013,7.819
15140,2013,Abril,Guatemala,0,4,,4,-77.35600000000001,0.81488
15141,2013,Abril,Guatemala,0,1,,1,-73.247863,10.433608999999999
15142,2013,Abril,Guatemala,38,60,,98,-75.516486,10.446304
15143,2013,Abril,Guatemala,3,16,,19,-74.77647900000001,10.886686
15144,2013,Abril,Guatemala,1,2,,3,-72.129595,11.360028999999999
15145,2013,Abril,Guatemala,1,1,,2,-81.70216500000001,12.5862
15146,2013,Abril,Guatemala,22,69,,91,-76.532004,3.451668
15147,2013,Abril,Guatemala,156,418,,574,-74.140516,4.697157
15148,2013,Abril,Guatemala,1,3,,4,-75.736374,4.815189
15149,2013,Abril,Guatemala,23,74,,97,-75.42726,6.170465
15150,2013,Abril,Guatemala,1,1,,2,-73.181317,7.1280470000000005
15151,2013,Abril,Guatemala,5,6,,11,-72.453013,7.819
15152,2013,Abril,Guatemala,4,2,,6,-72.508188,7.927233
15153,2013,Abril,Guyana,0,1,,1,-76.532004,3.451668
15154,2013,Abril,Guyana,2,16,,18,-74.140516,4.697157
15155,2013,Abril,Guyana,1,3,,4,-75.42726,6.170465
15156,2013,Abril,Guinea Ecuatorial,1,0,,1,-74.140516,4.697157
15157,2013,Abril,Haití,0,1,,1,-75.516486,10.446304
15158,2013,Abril,Haití,0,1,,1,-76.532004,3.451668
15159,2013,Abril,Haití,4,9,,13,-74.140516,4.697157
15160,2013,Abril,Haití,2,3,,5,-75.42726,6.170465
15161,2013,Abril,Honduras,0,3,,3,-77.35600000000001,0.81488
15162,2013,Abril,Honduras,20,55,,75,-75.516486,10.446304
15163,2013,Abril,Honduras,0,2,,2,-74.77647900000001,10.886686
15164,2013,Abril,Honduras,2,5,,7,-81.70216500000001,12.5862
15165,2013,Abril,Honduras,18,15,,33,-76.532004,3.451668
15166,2013,Abril,Honduras,113,180,,293,-74.140516,4.697157
15167,2013,Abril,Honduras,1,0,,1,-75.736374,4.815189
15168,2013,Abril,Honduras,11,25,,36,-75.42726,6.170465
15169,2013,Abril,Honduras,2,1,,3,-73.181317,7.1280470000000005
15170,2013,Abril,Honduras,0,1,,1,-76.7333,8.06667
15171,2013,Abril,Hungría,0,1,,1,-69.941498,4.191162
15172,2013,Abril,Hungría,1,2,,3,-75.527794,10.406342
15173,2013,Abril,Hungría,1,2,,3,-75.516486,10.446304
15174,2013,Abril,Hungría,0,1,,1,-72.129595,11.360028999999999
15175,2013,Abril,Hungría,0,2,,2,-76.532004,3.451668
15176,2013,Abril,Hungría,15,31,,46,-74.140516,4.697157
15177,2013,Abril,Hungría,0,3,,3,-75.42726,6.170465
15178,2013,Abril,Hungría,2,0,,2,-72.453013,7.819
15179,2013,Abril,Hungría,1,0,,1,-77.35002,8.63337
15180,2013,Abril,India,0,3,,3,-77.35600000000001,0.81488
15181,2013,Abril,India,2,9,,11,-75.516486,10.446304
15182,2013,Abril,India,0,6,,6,-74.77647900000001,10.886686
15183,2013,Abril,India,0,1,,1,-81.70216500000001,12.5862
15184,2013,Abril,India,0,11,,11,-76.532004,3.451668
15185,2013,Abril,India,0,1,,1,-77.061029,3.8844260000000004
15186,2013,Abril,India,32,243,,275,-74.140516,4.697157
15187,2013,Abril,India,4,26,,30,-75.42726,6.170465
15188,2013,Abril,Indonesia,16,18,,34,-74.140516,4.697157
15189,2013,Abril,Indonesia,0,5,,5,-72.453013,7.819
15190,2013,Abril,Iraq,0,2,,2,-75.516486,10.446304
15191,2013,Abril,Iraq,0,16,,16,-74.140516,4.697157
15192,2013,Abril,Irán,1,10,,11,-74.140516,4.697157
15193,2013,Abril,República de Irlanda,2,1,,3,-69.941498,4.191162
15194,2013,Abril,República de Irlanda,16,9,,25,-77.35600000000001,0.81488
15195,2013,Abril,República de Irlanda,0,2,,2,-75.527794,10.406342
15196,2013,Abril,República de Irlanda,9,14,,23,-75.516486,10.446304
15197,2013,Abril,República de Irlanda,0,1,,1,-74.77647900000001,10.886686
15198,2013,Abril,República de Irlanda,3,2,,5,-72.129595,11.360028999999999
15199,2013,Abril,República de Irlanda,0,2,,2,-76.532004,3.451668
15200,2013,Abril,República de Irlanda,59,86,,145,-74.140516,4.697157
15201,2013,Abril,República de Irlanda,1,13,,14,-75.42726,6.170465
15202,2013,Abril,República de Irlanda,0,2,,2,-77.35002,8.63337
15203,2013,Abril,Islandia,0,1,,1,-69.941498,4.191162
15204,2013,Abril,Islandia,2,2,,4,-77.35600000000001,0.81488
15205,2013,Abril,Islandia,2,0,,2,-75.527794,10.406342
15206,2013,Abril,Islandia,1,0,,1,-76.532004,3.451668
15207,2013,Abril,Islandia,1,6,,7,-74.140516,4.697157
15208,2013,Abril,Islandia,0,1,,1,-75.42726,6.170465
15209,2013,Abril,Isla de Man,36,30,,66,-77.35600000000001,0.81488
15210,2013,Abril,Isla de Man,1,3,,4,-75.516486,10.446304
15211,2013,Abril,Isla de Man,0,5,,5,-74.77647900000001,10.886686
15212,2013,Abril,Isla de Man,3,7,,10,-76.532004,3.451668
15213,2013,Abril,Isla de Man,2,0,,2,-75.76635300000001,4.45285
15214,2013,Abril,Isla de Man,50,102,,152,-74.140516,4.697157
15215,2013,Abril,Isla de Man,18,39,,57,-75.42726,6.170465
15216,2013,Abril,Israel,0,1,,1,-69.941498,4.191162
15217,2013,Abril,Israel,11,25,,36,-77.35600000000001,0.81488
15218,2013,Abril,Israel,8,47,,55,-75.516486,10.446304
15219,2013,Abril,Israel,0,3,,3,-74.77647900000001,10.886686
15220,2013,Abril,Israel,2,4,,6,-81.70216500000001,12.5862
15221,2013,Abril,Israel,3,16,,19,-76.532004,3.451668
15222,2013,Abril,Israel,111,574,,685,-74.140516,4.697157
15223,2013,Abril,Israel,16,78,,94,-75.42726,6.170465
15224,2013,Abril,Israel,0,1,,1,-72.508188,7.927233
15225,2013,Abril,Israel,1,1,,2,-77.35002,8.63337
15226,2013,Abril,Italia,1,8,,9,-69.941498,4.191162
15227,2013,Abril,Italia,0,2,,2,-76.876446,0.33002
15228,2013,Abril,Italia,12,18,,30,-77.35600000000001,0.81488
15229,2013,Abril,Italia,1,8,,9,-75.527794,10.406342
15230,2013,Abril,Italia,27,60,,87,-75.516486,10.446304
15231,2013,Abril,Italia,2,9,,11,-74.77647900000001,10.886686
15232,2013,Abril,Italia,0,2,,2,-74.213989,11.247722999999999
15233,2013,Abril,Italia,2,7,,9,-72.129595,11.360028999999999
15234,2013,Abril,Italia,3,5,,8,-81.70216500000001,12.5862
15235,2013,Abril,Italia,16,70,,86,-76.532004,3.451668
15236,2013,Abril,Italia,351,1490,,1841,-74.140516,4.697157
15237,2013,Abril,Italia,0,5,,5,-75.736374,4.815189
15238,2013,Abril,Italia,21,90,,111,-75.42726,6.170465
15239,2013,Abril,Italia,0,2,,2,-67.48402800000001,6.185536
15240,2013,Abril,Italia,0,3,,3,-73.181317,7.1280470000000005
15241,2013,Abril,Italia,5,22,,27,-72.453013,7.819
15242,2013,Abril,Italia,1,0,,1,-72.508188,7.927233
15243,2013,Abril,Italia,0,6,,6,-77.35002,8.63337
15244,2013,Abril,Islas del Canal,1,0,,1,-74.140516,4.697157
15245,2013,Abril,Jamaica,0,2,,2,-77.35600000000001,0.81488
15246,2013,Abril,Jamaica,0,2,,2,-75.516486,10.446304
15247,2013,Abril,Jamaica,0,4,,4,-74.77647900000001,10.886686
15248,2013,Abril,Jamaica,1,0,,1,-72.129595,11.360028999999999
15249,2013,Abril,Jamaica,1,1,,2,-76.532004,3.451668
15250,2013,Abril,Jamaica,8,15,,23,-74.140516,4.697157
15251,2013,Abril,Jamaica,1,0,,1,-75.736374,4.815189
15252,2013,Abril,Jamaica,2,4,,6,-75.42726,6.170465
15253,2013,Abril,Jamaica,0,1,,1,-72.453013,7.819
15254,2013,Abril,Japón,1,1,,2,-69.941498,4.191162
15255,2013,Abril,Japón,0,1,,1,-76.876446,0.33002
15256,2013,Abril,Japón,23,30,,53,-77.35600000000001,0.81488
15257,2013,Abril,Japón,0,1,,1,-75.527794,10.406342
15258,2013,Abril,Japón,3,23,,26,-75.516486,10.446304
15259,2013,Abril,Japón,0,3,,3,-74.77647900000001,10.886686
15260,2013,Abril,Japón,1,0,,1,-81.70216500000001,12.5862
15261,2013,Abril,Japón,2,14,,16,-76.532004,3.451668
15262,2013,Abril,Japón,88,431,,519,-74.140516,4.697157
15263,2013,Abril,Japón,0,1,,1,-75.736374,4.815189
15264,2013,Abril,Japón,6,18,,24,-75.42726,6.170465
15265,2013,Abril,Japón,0,2,,2,-72.453013,7.819
15266,2013,Abril,Jordania,1,0,,1,-75.516486,10.446304
15267,2013,Abril,Jordania,2,3,,5,-74.140516,4.697157
15268,2013,Abril,Kenia,2,0,,2,-76.532004,3.451668
15269,2013,Abril,Kenia,0,6,,6,-74.140516,4.697157
15270,2013,Abril,Kuwait,0,1,,1,-74.140516,4.697157
15271,2013,Abril,Lesoto,1,2,,3,-74.140516,4.697157
15272,2013,Abril,Letonia,4,1,,5,-77.35600000000001,0.81488
15273,2013,Abril,Letonia,1,0,,1,-75.516486,10.446304
15274,2013,Abril,Letonia,0,1,,1,-74.213989,11.247722999999999
15275,2013,Abril,Letonia,6,13,,19,-74.140516,4.697157
15276,2013,Abril,Lituania,1,1,,2,-77.35600000000001,0.81488
15277,2013,Abril,Lituania,0,3,,3,-75.527794,10.406342
15278,2013,Abril,Lituania,2,2,,4,-75.516486,10.446304
15279,2013,Abril,Lituania,1,0,,1,-74.77647900000001,10.886686
15280,2013,Abril,Lituania,13,5,,18,-74.140516,4.697157
15281,2013,Abril,Líbano,0,1,,1,-77.35600000000001,0.81488
15282,2013,Abril,Líbano,0,2,,2,-75.516486,10.446304
15283,2013,Abril,Líbano,1,1,,2,-74.77647900000001,10.886686
15284,2013,Abril,Líbano,3,4,,7,-72.129595,11.360028999999999
15285,2013,Abril,Líbano,0,1,,1,-76.532004,3.451668
15286,2013,Abril,Líbano,11,21,,32,-74.140516,4.697157
15287,2013,Abril,Líbano,2,2,,4,-75.42726,6.170465
15288,2013,Abril,Liberia,0,1,,1,-74.140516,4.697157
15289,2013,Abril,Libia,1,0,,1,-74.140516,4.697157
15290,2013,Abril,Luxemburgo,2,1,,3,-77.35600000000001,0.81488
15291,2013,Abril,Luxemburgo,0,1,,1,-75.516486,10.446304
15292,2013,Abril,Luxemburgo,3,13,,16,-74.140516,4.697157
15293,2013,Abril,Macedonia,1,2,,3,-74.140516,4.697157
15294,2013,Abril,Madagascar,2,1,,3,-74.140516,4.697157
15295,2013,Abril,Malasia,2,3,,5,-75.516486,10.446304
15296,2013,Abril,Malasia,0,1,,1,-74.213989,11.247722999999999
15297,2013,Abril,Malasia,0,1,,1,-76.532004,3.451668
15298,2013,Abril,Malasia,6,24,,30,-74.140516,4.697157
15299,2013,Abril,Malasia,2,6,,8,-75.42726,6.170465
15300,2013,Abril,Malta,1,5,,6,-74.140516,4.697157
15301,2013,Abril,Marruecos,0,1,,1,-76.532004,3.451668
15302,2013,Abril,Marruecos,2,14,,16,-74.140516,4.697157
15303,2013,Abril,Marruecos,0,1,,1,-75.42726,6.170465
15304,2013,Abril,Mauricio,0,1,,1,-75.42726,6.170465
15305,2013,Abril,Mauritania,0,1,,1,-74.140516,4.697157
15306,2013,Abril,México,0,1,,1,-69.941498,4.191162
15307,2013,Abril,México,12,16,,28,-77.35600000000001,0.81488
15308,2013,Abril,México,1,2,,3,-75.527794,10.406342
15309,2013,Abril,México,3,33,,36,-73.247863,10.433608999999999
15310,2013,Abril,México,83,202,,285,-75.516486,10.446304
15311,2013,Abril,México,18,35,,53,-74.77647900000001,10.886686
15312,2013,Abril,México,1,4,,5,-72.129595,11.360028999999999
15313,2013,Abril,México,1,0,,1,-81.70216500000001,12.5862
15314,2013,Abril,México,43,164,,207,-76.532004,3.451668
15315,2013,Abril,México,0,1,,1,-75.76635300000001,4.45285
15316,2013,Abril,México,1610,4021,,5631,-74.140516,4.697157
15317,2013,Abril,México,8,10,,18,-75.736374,4.815189
15318,2013,Abril,México,108,316,,424,-75.42726,6.170465
15319,2013,Abril,México,0,1,,1,-67.48402800000001,6.185536
15320,2013,Abril,México,1,0,,1,-70.74025300000001,7.088728999999999
15321,2013,Abril,México,3,6,,9,-73.181317,7.1280470000000005
15322,2013,Abril,México,13,23,,36,-72.453013,7.819
15323,2013,Abril,México,3,9,,12,-72.508188,7.927233
15324,2013,Abril,México,1,3,,4,-77.35002,8.63337
15325,2013,Abril,República de Moldavia,1,1,,2,-74.140516,4.697157
15326,2013,Abril,Montenegro,1,1,,2,-74.140516,4.697157
15327,2013,Abril,Mozambique,2,4,,6,-74.140516,4.697157
15328,2013,Abril,Myanmar,0,1,,1,-74.213989,11.247722999999999
15329,2013,Abril,Myanmar,0,1,,1,-74.140516,4.697157
15330,2013,Abril,Namibia,1,1,,2,-74.140516,4.697157
15331,2013,Abril,Nepal,0,1,,1,-77.35600000000001,0.81488
15332,2013,Abril,Nicaragua,0,1,,1,-77.35600000000001,0.81488
15333,2013,Abril,Nicaragua,1,4,,5,-75.516486,10.446304
15334,2013,Abril,Nicaragua,0,2,,2,-74.77647900000001,10.886686
15335,2013,Abril,Nicaragua,3,1,,4,-81.70216500000001,12.5862
15336,2013,Abril,Nicaragua,8,7,,15,-76.532004,3.451668
15337,2013,Abril,Nicaragua,37,63,,100,-74.140516,4.697157
15338,2013,Abril,Nicaragua,4,7,,11,-75.42726,6.170465
15339,2013,Abril,Nigeria,0,1,,1,-76.532004,3.451668
15340,2013,Abril,Nigeria,2,10,,12,-74.140516,4.697157
15341,2013,Abril,Noruega,1,1,,2,-69.941498,4.191162
15342,2013,Abril,Noruega,9,7,,16,-77.35600000000001,0.81488
15343,2013,Abril,Noruega,0,3,,3,-75.527794,10.406342
15344,2013,Abril,Noruega,4,7,,11,-75.516486,10.446304
15345,2013,Abril,Noruega,1,0,,1,-74.77647900000001,10.886686
15346,2013,Abril,Noruega,2,7,,9,-76.532004,3.451668
15347,2013,Abril,Noruega,56,106,,162,-74.140516,4.697157
15348,2013,Abril,Noruega,4,13,,17,-75.42726,6.170465
15349,2013,Abril,Noruega,1,1,,2,-73.181317,7.1280470000000005
15350,2013,Abril,Noruega,0,1,,1,-72.453013,7.819
15351,2013,Abril,Noruega,0,1,,1,-77.35002,8.63337
15352,2013,Abril,Nueva Zelanda,0,4,,4,-69.941498,4.191162
15353,2013,Abril,Nueva Zelanda,11,5,,16,-77.35600000000001,0.81488
15354,2013,Abril,Nueva Zelanda,6,5,,11,-75.516486,10.446304
15355,2013,Abril,Nueva Zelanda,0,1,,1,-74.77647900000001,10.886686
15356,2013,Abril,Nueva Zelanda,2,2,,4,-72.129595,11.360028999999999
15357,2013,Abril,Nueva Zelanda,3,1,,4,-76.532004,3.451668
15358,2013,Abril,Nueva Zelanda,31,41,,72,-74.140516,4.697157
15359,2013,Abril,Nueva Zelanda,4,10,,14,-75.42726,6.170465
15360,2013,Abril,Nueva Zelanda,1,0,,1,-72.453013,7.819
15361,2013,Abril,Nueva Zelanda,1,2,,3,-77.35002,8.63337
15362,2013,Abril,Nueva Zelanda,0,3,,3,-77.35600000000001,0.81488
15363,2013,Abril,Nueva Zelanda,2,3,,5,-75.527794,10.406342
15364,2013,Abril,Nueva Zelanda,2,5,,7,-74.140516,4.697157
15365,2013,Abril,Países Bajos,5,10,,15,-77.35600000000001,0.81488
15366,2013,Abril,Países Bajos,1,8,,9,-75.516486,10.446304
15367,2013,Abril,Países Bajos,5,13,,18,-74.77647900000001,10.886686
15368,2013,Abril,Países Bajos,3,5,,8,-72.129595,11.360028999999999
15369,2013,Abril,Países Bajos,28,37,,65,-72.919186,11.52863
15370,2013,Abril,Países Bajos,9,16,,25,-76.532004,3.451668
15371,2013,Abril,Países Bajos,15,15,,30,-75.76635300000001,4.45285
15372,2013,Abril,Países Bajos,153,250,,403,-74.140516,4.697157
15373,2013,Abril,Países Bajos,0,3,,3,-75.736374,4.815189
15374,2013,Abril,Países Bajos,263,302,,565,-75.42726,6.170465
15375,2013,Abril,Países Bajos,5,3,,8,-73.181317,7.1280470000000005
15376,2013,Abril,Países Bajos,1,0,,1,-72.453013,7.819
15377,2013,Abril,Pakistán,0,2,,2,-77.35600000000001,0.81488
15378,2013,Abril,Pakistán,0,1,,1,-76.532004,3.451668
15379,2013,Abril,Pakistán,1,4,,5,-74.140516,4.697157
15380,2013,Abril,Palau,0,1,,1,-74.140516,4.697157
15381,2013,Abril,Panamá,0,1,,1,-76.876446,0.33002
15382,2013,Abril,Panamá,1,0,,1,-75.527794,10.406342
15383,2013,Abril,Panamá,130,172,,302,-75.516486,10.446304
15384,2013,Abril,Panamá,46,79,,125,-74.77647900000001,10.886686
15385,2013,Abril,Panamá,0,1,,1,-72.129595,11.360028999999999
15386,2013,Abril,Panamá,29,29,,58,-81.70216500000001,12.5862
15387,2013,Abril,Panamá,87,157,,244,-76.532004,3.451668
15388,2013,Abril,Panamá,534,803,,1337,-74.140516,4.697157
15389,2013,Abril,Panamá,70,109,,179,-75.736374,4.815189
15390,2013,Abril,Panamá,115,236,,351,-75.42726,6.170465
15391,2013,Abril,Panamá,2,0,,2,-77.401154,6.222551999999999
15392,2013,Abril,Panamá,4,11,,15,-73.181317,7.1280470000000005
15393,2013,Abril,Panamá,1,4,,5,-72.453013,7.819
15394,2013,Abril,Panamá,4,9,,13,-72.508188,7.927233
15395,2013,Abril,Panamá,1,6,,7,-77.35002,8.63337
15396,2013,Abril,Paraguay,1,1,,2,-77.35600000000001,0.81488
15397,2013,Abril,Paraguay,40,19,,59,-75.516486,10.446304
15398,2013,Abril,Paraguay,3,2,,5,-74.77647900000001,10.886686
15399,2013,Abril,Paraguay,6,4,,10,-81.70216500000001,12.5862
15400,2013,Abril,Paraguay,3,5,,8,-76.532004,3.451668
15401,2013,Abril,Paraguay,73,130,,203,-74.140516,4.697157
15402,2013,Abril,Paraguay,5,11,,16,-75.42726,6.170465
15403,2013,Abril,Paraguay,0,1,,1,-73.181317,7.1280470000000005
15404,2013,Abril,Perú,16,20,,36,-69.941498,4.191162
15405,2013,Abril,Perú,1,2,,3,-76.876446,0.33002
15406,2013,Abril,Perú,107,294,,401,-77.35600000000001,0.81488
15407,2013,Abril,Perú,0,3,,3,-75.527794,10.406342
15408,2013,Abril,Perú,160,203,,363,-75.516486,10.446304
15409,2013,Abril,Perú,3,17,,20,-74.77647900000001,10.886686
15410,2013,Abril,Perú,3,15,,18,-72.129595,11.360028999999999
15411,2013,Abril,Perú,78,56,,134,-81.70216500000001,12.5862
15412,2013,Abril,Perú,75,165,,240,-76.532004,3.451668
15413,2013,Abril,Perú,0,1,,1,-75.76635300000001,4.45285
15414,2013,Abril,Perú,2871,3834,,6705,-74.140516,4.697157
15415,2013,Abril,Perú,5,7,,12,-75.736374,4.815189
15416,2013,Abril,Perú,151,339,,490,-75.42726,6.170465
15417,2013,Abril,Perú,1,0,,1,-67.48402800000001,6.185536
15418,2013,Abril,Perú,1,4,,5,-73.181317,7.1280470000000005
15419,2013,Abril,Perú,39,45,,84,-72.453013,7.819
15420,2013,Abril,Perú,0,3,,3,-72.508188,7.927233
15421,2013,Abril,Palestina,2,0,,2,-77.35600000000001,0.81488
15422,2013,Abril,Palestina,2,2,,4,-74.140516,4.697157
15423,2013,Abril,Polonia,1,1,,2,-69.941498,4.191162
15424,2013,Abril,Polonia,2,5,,7,-77.35600000000001,0.81488
15425,2013,Abril,Polonia,1,6,,7,-75.527794,10.406342
15426,2013,Abril,Polonia,4,2,,6,-75.516486,10.446304
15427,2013,Abril,Polonia,0,1,,1,-74.77647900000001,10.886686
15428,2013,Abril,Polonia,0,14,,14,-74.213989,11.247722999999999
15429,2013,Abril,Polonia,1,2,,3,-72.129595,11.360028999999999
15430,2013,Abril,Polonia,1,2,,3,-76.532004,3.451668
15431,2013,Abril,Polonia,58,108,,166,-74.140516,4.697157
15432,2013,Abril,Polonia,1,0,,1,-75.736374,4.815189
15433,2013,Abril,Polonia,0,3,,3,-75.42726,6.170465
15434,2013,Abril,Polonia,0,2,,2,-72.453013,7.819
15435,2013,Abril,Polonia,2,0,,2,-77.35002,8.63337
15436,2013,Abril,Portugal,0,1,,1,-69.941498,4.191162
15437,2013,Abril,Portugal,1,0,,1,-76.876446,0.33002
15438,2013,Abril,Portugal,2,6,,8,-77.35600000000001,0.81488
15439,2013,Abril,Portugal,1,1,,2,-75.527794,10.406342
15440,2013,Abril,Portugal,2,8,,10,-75.516486,10.446304
15441,2013,Abril,Portugal,0,1,,1,-74.77647900000001,10.886686
15442,2013,Abril,Portugal,2,1,,3,-81.70216500000001,12.5862
15443,2013,Abril,Portugal,3,17,,20,-76.532004,3.451668
15444,2013,Abril,Portugal,124,406,,530,-74.140516,4.697157
15445,2013,Abril,Portugal,5,14,,19,-75.42726,6.170465
15446,2013,Abril,Portugal,1,4,,5,-72.453013,7.819
15447,2013,Abril,Portugal,1,1,,2,-77.35002,8.63337
15448,2013,Abril,Puerto Rico/Territorio de Estados Unidos,0,1,,1,-76.532004,3.451668
15449,2013,Abril,Puerto Rico/Territorio de Estados Unidos,0,1,,1,-75.42726,6.170465
15450,2013,Abril,Qatar,0,2,,2,-74.140516,4.697157
15451,2013,Abril,Reino Unido de Gran Bretaña e Irlanda del Norte,5,6,,11,-69.941498,4.191162
15452,2013,Abril,Reino Unido de Gran Bretaña e Irlanda del Norte,5,4,,9,-77.35600000000001,0.81488
15453,2013,Abril,Reino Unido de Gran Bretaña e Irlanda del Norte,27,44,,71,-75.516486,10.446304
15454,2013,Abril,Reino Unido de Gran Bretaña e Irlanda del Norte,1,0,,1,-74.77647900000001,10.886686
15455,2013,Abril,Reino Unido de Gran Bretaña e Irlanda del Norte,1,4,,5,-72.129595,11.360028999999999
15456,2013,Abril,Reino Unido de Gran Bretaña e Irlanda del Norte,0,1,,1,-81.70216500000001,12.5862
15457,2013,Abril,Reino Unido de Gran Bretaña e Irlanda del Norte,3,13,,16,-76.532004,3.451668
15458,2013,Abril,Reino Unido de Gran Bretaña e Irlanda del Norte,1,0,,1,-75.76635300000001,4.45285
15459,2013,Abril,Reino Unido de Gran Bretaña e Irlanda del Norte,209,509,,718,-74.140516,4.697157
15460,2013,Abril,Reino Unido de Gran Bretaña e Irlanda del Norte,5,18,,23,-75.42726,6.170465
15461,2013,Abril,Reino Unido de Gran Bretaña e Irlanda del Norte,6,9,,15,-72.453013,7.819
15462,2013,Abril,República de Belarús,0,1,,1,-74.140516,4.697157
15463,2013,Abril,República Dominicana,1,9,,10,-77.35600000000001,0.81488
15464,2013,Abril,República Dominicana,0,3,,3,-75.527794,10.406342
15465,2013,Abril,República Dominicana,23,24,,47,-75.516486,10.446304
15466,2013,Abril,República Dominicana,14,49,,63,-74.77647900000001,10.886686
15467,2013,Abril,República Dominicana,0,2,,2,-72.129595,11.360028999999999
15468,2013,Abril,República Dominicana,1,1,,2,-81.70216500000001,12.5862
15469,2013,Abril,República Dominicana,13,24,,37,-76.532004,3.451668
15470,2013,Abril,República Dominicana,0,2,,2,-75.76635300000001,4.45285
15471,2013,Abril,República Dominicana,201,337,,538,-74.140516,4.697157
15472,2013,Abril,República Dominicana,0,2,,2,-75.736374,4.815189
15473,2013,Abril,República Dominicana,50,45,,95,-75.42726,6.170465
15474,2013,Abril,República Dominicana,1,2,,3,-73.181317,7.1280470000000005
15475,2013,Abril,República Dominicana,4,4,,8,-72.453013,7.819
15476,2013,Abril,República Dominicana,0,3,,3,-72.508188,7.927233
15477,2013,Abril,República Checa,1,2,,3,-74.140516,4.697157
15478,2013,Abril,Rumania,1,0,,1,-77.35600000000001,0.81488
15479,2013,Abril,Rumania,0,1,,1,-75.527794,10.406342
15480,2013,Abril,Rumania,0,2,,2,-75.516486,10.446304
15481,2013,Abril,Rumania,0,1,,1,-74.77647900000001,10.886686
15482,2013,Abril,Rumania,3,2,,5,-72.129595,11.360028999999999
15483,2013,Abril,Rumania,1,8,,9,-76.532004,3.451668
15484,2013,Abril,Rumania,22,66,,88,-74.140516,4.697157
15485,2013,Abril,Rumania,0,1,,1,-72.453013,7.819
15486,2013,Abril,Rumania,0,1,,1,-75.68164200000001,9.402597
15487,2013,Abril,Federación de Rusia,2,5,,7,-77.35600000000001,0.81488
15488,2013,Abril,Federación de Rusia,6,3,,9,-75.516486,10.446304
15489,2013,Abril,Federación de Rusia,0,1,,1,-74.77647900000001,10.886686
15490,2013,Abril,Federación de Rusia,0,1,,1,-74.213989,11.247722999999999
15491,2013,Abril,Federación de Rusia,0,1,,1,-72.129595,11.360028999999999
15492,2013,Abril,Federación de Rusia,2,0,,2,-76.532004,3.451668
15493,2013,Abril,Federación de Rusia,18,28,,46,-74.140516,4.697157
15494,2013,Abril,Federación de Rusia,1,2,,3,-75.42726,6.170465
15495,2013,Abril,Federación de Rusia,1,0,,1,-72.453013,7.819
15496,2013,Abril,Federación de Rusia,0,1,,1,-75.68164200000001,9.402597
15497,2013,Abril,San Cristóbal y Nevis,0,1,,1,-81.70216500000001,12.5862
15498,2013,Abril,San  Vicente y las Granadinas,1,0,,1,-76.532004,3.451668
15499,2013,Abril,San  Vicente y las Granadinas,0,1,,1,-74.140516,4.697157
15500,2013,Abril,San  Vicente y las Granadinas,0,1,,1,-75.42726,6.170465
15501,2013,Abril,Santa Lucia,2,1,,3,-75.516486,10.446304
15502,2013,Abril,Santa Lucia,1,1,,2,-73.181317,7.1280470000000005
15503,2013,Abril,Santa Lucia,0,1,,1,-72.508188,7.927233
15504,2013,Abril,Senegal,0,2,,2,-74.140516,4.697157
15505,2013,Abril,Serbia,1,0,,1,-77.35600000000001,0.81488
15506,2013,Abril,Serbia,0,1,,1,-75.516486,10.446304
15507,2013,Abril,Serbia,1,1,,2,-81.70216500000001,12.5862
15508,2013,Abril,Serbia,2,4,,6,-74.140516,4.697157
15509,2013,Abril,Serbia,1,0,,1,-75.42726,6.170465
15510,2013,Abril,Singapur,1,0,,1,-77.35600000000001,0.81488
15511,2013,Abril,Singapur,0,1,,1,-75.516486,10.446304
15512,2013,Abril,Singapur,0,1,,1,-74.77647900000001,10.886686
15513,2013,Abril,Singapur,5,11,,16,-74.140516,4.697157
15514,2013,Abril,Singapur,2,0,,2,-75.42726,6.170465
15515,2013,Abril,República Árabe Siria,0,1,,1,-74.140516,4.697157
15516,2013,Abril,Sri Lanka,2,1,,3,-74.140516,4.697157
15517,2013,Abril,Sudáfrica,3,4,,7,-77.35600000000001,0.81488
15518,2013,Abril,Sudáfrica,0,1,,1,-75.527794,10.406342
15519,2013,Abril,Sudáfrica,3,12,,15,-75.516486,10.446304
15520,2013,Abril,Sudáfrica,2,2,,4,-74.77647900000001,10.886686
15521,2013,Abril,Sudáfrica,0,2,,2,-72.129595,11.360028999999999
15522,2013,Abril,Sudáfrica,1,1,,2,-76.532004,3.451668
15523,2013,Abril,Sudáfrica,41,136,,177,-74.140516,4.697157
15524,2013,Abril,Sudáfrica,2,3,,5,-75.42726,6.170465
15525,2013,Abril,Sudáfrica,1,1,,2,-77.35002,8.63337
15526,2013,Abril,Suecia,1,7,,8,-69.941498,4.191162
15527,2013,Abril,Suecia,0,1,,1,-76.876446,0.33002
15528,2013,Abril,Suecia,20,12,,32,-77.35600000000001,0.81488
15529,2013,Abril,Suecia,1,0,,1,-78.802679,18.00143
15530,2013,Abril,Suecia,3,4,,7,-75.527794,10.406342
15531,2013,Abril,Suecia,6,6,,12,-75.516486,10.446304
15532,2013,Abril,Suecia,2,2,,4,-72.129595,11.360028999999999
15533,2013,Abril,Suecia,2,13,,15,-76.532004,3.451668
15534,2013,Abril,Suecia,109,178,,287,-74.140516,4.697157
15535,2013,Abril,Suecia,0,1,,1,-75.736374,4.815189
15536,2013,Abril,Suecia,3,14,,17,-75.42726,6.170465
15537,2013,Abril,Suecia,0,3,,3,-72.453013,7.819
15538,2013,Abril,Suiza,4,3,,7,-69.941498,4.191162
15539,2013,Abril,Suiza,2,1,,3,-76.876446,0.33002
15540,2013,Abril,Suiza,19,30,,49,-77.35600000000001,0.81488
15541,2013,Abril,Suiza,5,10,,15,-75.527794,10.406342
15542,2013,Abril,Suiza,10,17,,27,-75.516486,10.446304
15543,2013,Abril,Suiza,0,2,,2,-74.77647900000001,10.886686
15544,2013,Abril,Suiza,2,2,,4,-74.213989,11.247722999999999
15545,2013,Abril,Suiza,0,5,,5,-72.129595,11.360028999999999
15546,2013,Abril,Suiza,3,3,,6,-81.70216500000001,12.5862
15547,2013,Abril,Suiza,14,28,,42,-76.532004,3.451668
15548,2013,Abril,Suiza,1,0,,1,-75.76635300000001,4.45285
15549,2013,Abril,Suiza,235,408,,643,-74.140516,4.697157
15550,2013,Abril,Suiza,16,32,,48,-75.42726,6.170465
15551,2013,Abril,Suiza,0,2,,2,-72.453013,7.819
15552,2013,Abril,Suiza,1,2,,3,-77.35002,8.63337
15553,2013,Abril,Surinam,0,2,,2,-75.527794,10.406342
15554,2013,Abril,Surinam,0,1,,1,-75.516486,10.446304
15555,2013,Abril,Surinam,9,14,,23,-74.140516,4.697157
15556,2013,Abril,Surinam,8,17,,25,-75.42726,6.170465
15557,2013,Abril,Suazilandia,1,0,,1,-74.140516,4.697157
15558,2013,Abril,Taiwán,0,1,,1,-74.77647900000001,10.886686
15559,2013,Abril,Taiwán,3,3,,6,-74.140516,4.697157
15560,2013,Abril,Taiwán,0,1,,1,-75.42726,6.170465
15561,2013,Abril,Taiwán,1,0,,1,-72.508188,7.927233
15562,2013,Abril,Tailandia,0,1,,1,-74.77647900000001,10.886686
15563,2013,Abril,Tailandia,4,9,,13,-74.140516,4.697157
15564,2013,Abril,Tíbet/Región Autónoma de China,1,4,,5,-74.140516,4.697157
15565,2013,Abril,Territorio Antártico Británico/Territorio Británico de Ultramar,0,2,,2,-77.35600000000001,0.81488
15566,2013,Abril,Territorio Antártico Británico/Territorio Británico de Ultramar,0,7,,7,-74.140516,4.697157
15567,2013,Abril,Tanzania,0,2,,2,-74.140516,4.697157
15568,2013,Abril,Trinidad y Tobago,2,9,,11,-75.516486,10.446304
15569,2013,Abril,Trinidad y Tobago,0,1,,1,-74.77647900000001,10.886686
15570,2013,Abril,Trinidad y Tobago,0,1,,1,-72.129595,11.360028999999999
15571,2013,Abril,Trinidad y Tobago,0,8,,8,-76.532004,3.451668
15572,2013,Abril,Trinidad y Tobago,12,45,,57,-74.140516,4.697157
15573,2013,Abril,Trinidad y Tobago,1,0,,1,-75.736374,4.815189
15574,2013,Abril,Trinidad y Tobago,2,7,,9,-75.42726,6.170465
15575,2013,Abril,Trinidad y Tobago,0,1,,1,-73.181317,7.1280470000000005
15576,2013,Abril,Trinidad y Tobago,0,2,,2,-72.453013,7.819
15577,2013,Abril,Trinidad y Tobago,0,1,,1,-77.35002,8.63337
15578,2013,Abril,Túnez,1,2,,3,-74.140516,4.697157
15579,2013,Abril,Túnez,0,1,,1,-75.42726,6.170465
15580,2013,Abril,Turquía,1,0,,1,-69.941498,4.191162
15581,2013,Abril,Turquía,0,2,,2,-77.35600000000001,0.81488
15582,2013,Abril,Turquía,5,7,,12,-75.516486,10.446304
15583,2013,Abril,Turquía,1,0,,1,-76.532004,3.451668
15584,2013,Abril,Turquía,23,65,,88,-74.140516,4.697157
15585,2013,Abril,Turquía,2,6,,8,-75.42726,6.170465
15586,2013,Abril,Turquía,0,2,,2,-72.453013,7.819
15587,2013,Abril,Turquía,0,1,,1,-77.35002,8.63337
15588,2013,Abril,Ucrania,1,3,,4,-77.35600000000001,0.81488
15589,2013,Abril,Ucrania,1,0,,1,-76.532004,3.451668
15590,2013,Abril,Ucrania,18,26,,44,-74.140516,4.697157
15591,2013,Abril,Uganda,0,1,,1,-76.532004,3.451668
15592,2013,Abril,Uganda,0,2,,2,-74.140516,4.697157
15593,2013,Abril,Federación de Rusia,0,1,,1,-69.941498,4.191162
15594,2013,Abril,Federación de Rusia,1,2,,3,-77.35600000000001,0.81488
15595,2013,Abril,Federación de Rusia,0,1,,1,-75.527794,10.406342
15596,2013,Abril,Federación de Rusia,4,1,,5,-75.516486,10.446304
15597,2013,Abril,Federación de Rusia,0,1,,1,-76.532004,3.451668
15598,2013,Abril,Federación de Rusia,119,202,,321,-74.140516,4.697157
15599,2013,Abril,Federación de Rusia,2,2,,4,-75.42726,6.170465
15600,2013,Abril,Federación de Rusia,3,2,,5,-72.453013,7.819
15601,2013,Abril,Federación de Rusia,0,18,,18,-75.68164200000001,9.402597
15602,2013,Abril,Uruguay,0,1,,1,-69.941498,4.191162
15603,2013,Abril,Uruguay,3,9,,12,-77.35600000000001,0.81488
15604,2013,Abril,Uruguay,83,63,,146,-75.516486,10.446304
15605,2013,Abril,Uruguay,1,6,,7,-74.77647900000001,10.886686
15606,2013,Abril,Uruguay,0,3,,3,-72.129595,11.360028999999999
15607,2013,Abril,Uruguay,42,31,,73,-81.70216500000001,12.5862
15608,2013,Abril,Uruguay,9,17,,26,-76.532004,3.451668
15609,2013,Abril,Uruguay,151,313,,464,-74.140516,4.697157
15610,2013,Abril,Uruguay,1,3,,4,-75.736374,4.815189
15611,2013,Abril,Uruguay,16,27,,43,-75.42726,6.170465
15612,2013,Abril,Uruguay,7,9,,16,-72.453013,7.819
15613,2013,Abril,Venezuela,1,3,,4,-76.876446,0.33002
15614,2013,Abril,Venezuela,41,71,,112,-77.35600000000001,0.81488
15615,2013,Abril,Venezuela,2,3,,5,-75.527794,10.406342
15616,2013,Abril,Venezuela,5,24,,29,-73.247863,10.433608999999999
15617,2013,Abril,Venezuela,84,112,,196,-75.516486,10.446304
15618,2013,Abril,Venezuela,33,57,,90,-74.77647900000001,10.886686
15619,2013,Abril,Venezuela,947,1321,,2268,-72.129595,11.360028999999999
15620,2013,Abril,Venezuela,2,2,,4,-72.919186,11.52863
15621,2013,Abril,Venezuela,8,7,,15,-81.70216500000001,12.5862
15622,2013,Abril,Venezuela,52,79,,131,-76.532004,3.451668
15623,2013,Abril,Venezuela,4657,6221,,10878,-74.140516,4.697157
15624,2013,Abril,Venezuela,3,19,,22,-75.736374,4.815189
15625,2013,Abril,Venezuela,237,342,,579,-75.42726,6.170465
15626,2013,Abril,Venezuela,120,225,,345,-67.48402800000001,6.185536
15627,2013,Abril,Venezuela,27,60,,87,-70.74025300000001,7.088728999999999
15628,2013,Abril,Venezuela,5,5,,10,-73.181317,7.1280470000000005
15629,2013,Abril,Venezuela,788,1014,,1802,-72.453013,7.819
15630,2013,Abril,Venezuela,119,132,,251,-72.508188,7.927233
15631,2013,Abril,Venezuela,0,1,,1,-77.35002,8.63337
15632,2013,Abril,Vietnam,2,3,,5,-74.140516,4.697157
15633,2013,Abril,Islas Vírgenes Británicas/Territorio Británico de Ultramar,0,1,,1,-76.532004,3.451668
15634,2013,Abril,República Árabe de Yemen,1,0,,1,-74.140516,4.697157
15635,2013,Abril,República Árabe de Yemen,0,1,,1,-75.42726,6.170465
15636,2013,Abril,Yugoslavia,1,0,,1,-74.140516,4.697157
15637,2013,Abril,Zambia,4,3,,7,-74.140516,4.697157
15638,2013,Abril,Zimbabue,0,5,,5,-74.140516,4.697157
15639,2013,Abril,Reino Unido de Gran Bretaña e Irlanda del Norte,4,5,,9,-69.941498,4.191162
15640,2013,Abril,Reino Unido de Gran Bretaña e Irlanda del Norte,36,47,,83,-77.35600000000001,0.81488
15641,2013,Abril,Reino Unido de Gran Bretaña e Irlanda del Norte,13,9,,22,-75.527794,10.406342
15642,2013,Abril,Reino Unido de Gran Bretaña e Irlanda del Norte,8,21,,29,-75.516486,10.446304
15643,2013,Abril,Reino Unido de Gran Bretaña e Irlanda del Norte,0,2,,2,-74.77647900000001,10.886686
15644,2013,Abril,Reino Unido de Gran Bretaña e Irlanda del Norte,0,1,,1,-74.213989,11.247722999999999
15645,2013,Abril,Reino Unido de Gran Bretaña e Irlanda del Norte,5,15,,20,-72.129595,11.360028999999999
15646,2013,Abril,Reino Unido de Gran Bretaña e Irlanda del Norte,0,1,,1,-81.70216500000001,12.5862
15647,2013,Abril,Reino Unido de Gran Bretaña e Irlanda del Norte,0,2,,2,-81.372937,13.338761300000002
15648,2013,Abril,Reino Unido de Gran Bretaña e Irlanda del Norte,4,22,,26,-76.532004,3.451668
15649,2013,Abril,Reino Unido de Gran Bretaña e Irlanda del Norte,219,588,,807,-74.140516,4.697157
15650,2013,Abril,Reino Unido de Gran Bretaña e Irlanda del Norte,8,34,,42,-75.42726,6.170465
15651,2013,Abril,Reino Unido de Gran Bretaña e Irlanda del Norte,5,8,,13,-72.453013,7.819
15652,2013,Abril,Reino Unido de Gran Bretaña e Irlanda del Norte,1,0,,1,-72.508188,7.927233
15653,2013,Abril,Reino Unido de Gran Bretaña e Irlanda del Norte,2,4,,6,-77.35002,8.63337
15654,2013,Abril,Países Bajos,1,3,,4,-69.941498,4.191162
15655,2013,Abril,Países Bajos,20,13,,33,-77.35600000000001,0.81488
15656,2013,Abril,Países Bajos,5,15,,20,-75.527794,10.406342
15657,2013,Abril,Países Bajos,13,39,,52,-75.516486,10.446304
15658,2013,Abril,Países Bajos,0,15,,15,-74.77647900000001,10.886686
15659,2013,Abril,Países Bajos,0,4,,4,-74.213989,11.247722999999999
15660,2013,Abril,Países Bajos,7,6,,13,-72.129595,11.360028999999999
15661,2013,Abril,Países Bajos,1,1,,2,-81.372937,13.338761300000002
15662,2013,Abril,Países Bajos,18,55,,73,-76.532004,3.451668
15663,2013,Abril,Países Bajos,348,701,,1049,-74.140516,4.697157
15664,2013,Abril,Países Bajos,72,96,,168,-75.42726,6.170465
15665,2013,Abril,Países Bajos,8,13,,21,-73.181317,7.1280470000000005
15666,2013,Abril,Países Bajos,2,17,,19,-72.453013,7.819
15667,2013,Abril,Países Bajos,0,2,,2,-76.7333,8.06667
15668,2013,Abril,Palestina,0,1,,1,-74.140516,4.697157
15669,2013,Abril,Lituania,0,1,,1,-77.35600000000001,0.81488
15670,2013,Abril,Lituania,0,1,,1,-74.77647900000001,10.886686
15671,2013,Abril,Lituania,1,1,,2,-74.140516,4.697157
15672,2013,Abril,Reino Unido de Gran Bretaña e Irlanda del Norte,0,1,,1,-75.42726,6.170465
15673,2013,Abril,Reino Unido de Gran Bretaña e Irlanda del Norte,0,1,,1,-77.35600000000001,0.81488
15674,2013,Abril,Reino Unido de Gran Bretaña e Irlanda del Norte,1,2,,3,-75.527794,10.406342
15675,2013,Abril,Reino Unido de Gran Bretaña e Irlanda del Norte,1,0,,1,-76.532004,3.451668
15676,2013,Abril,Reino Unido de Gran Bretaña e Irlanda del Norte,7,16,,23,-74.140516,4.697157
15677,2013,Abril,Letonia,1,0,,1,-74.140516,4.697157
15678,2013,Abril,República CentroÁfricana,0,1,,1,-75.527794,10.406342
15679,2013,Abril,República CentroÁfricana,0,1,,1,-74.140516,4.697157
15680,2013,Abril,Desconocido,1,0,,1,-76.532004,3.451668
15681,2013,Mayo,Albania,0,1,,1,-76.532004,3.451668
15682,2013,Mayo,Albania,1,0,,1,-74.140516,4.697157
15683,2013,Mayo,Alemania,6,15,,21,-69.941498,4.191162
15684,2013,Mayo,Alemania,56,75,,131,-77.35600000000001,0.81488
15685,2013,Mayo,Alemania,3,5,,8,-75.527794,10.406342
15686,2013,Mayo,Alemania,23,41,,64,-75.516486,10.446304
15687,2013,Mayo,Alemania,2,11,,13,-74.77647900000001,10.886686
15688,2013,Mayo,Alemania,2,8,,10,-72.129595,11.360028999999999
15689,2013,Mayo,Alemania,0,1,,1,-72.919186,11.52863
15690,2013,Mayo,Alemania,1,2,,3,-81.70216500000001,12.5862
15691,2013,Mayo,Alemania,1,2,,3,-81.372937,13.338761300000002
15692,2013,Mayo,Alemania,26,37,,63,-76.532004,3.451668
15693,2013,Mayo,Alemania,0,2,,2,-77.061029,3.8844260000000004
15694,2013,Mayo,Alemania,1002,1622,,2624,-74.140516,4.697157
15695,2013,Mayo,Alemania,0,1,,1,-75.736374,4.815189
15696,2013,Mayo,Alemania,32,66,,98,-75.42726,6.170465
15697,2013,Mayo,Alemania,0,1,,1,-73.181317,7.1280470000000005
15698,2013,Mayo,Alemania,3,8,,11,-72.453013,7.819
15699,2013,Mayo,Alemania,0,1,,1,-76.7333,8.06667
15700,2013,Mayo,Alemania,6,8,,14,-77.35002,8.63337
15701,2013,Mayo,Andorra,0,1,,1,-76.532004,3.451668
15702,2013,Mayo,Andorra,2,11,,13,-74.140516,4.697157
15703,2013,Mayo,Angola,1,1,,2,-76.532004,3.451668
15704,2013,Mayo,Angola,0,1,,1,-74.140516,4.697157
15705,2013,Mayo,Antigua y Barbuda,0,1,,1,-77.35600000000001,0.81488
15706,2013,Mayo,Antigua y Barbuda,0,1,,1,-74.77647900000001,10.886686
15707,2013,Mayo,Arabia Saudita,0,1,,1,-74.140516,4.697157
15708,2013,Mayo,Arabia Saudita,0,1,,1,-75.42726,6.170465
15709,2013,Mayo,Arabia Saudita,1,0,,1,-76.532004,3.451668
15710,2013,Mayo,Arabia Saudita,0,4,,4,-74.140516,4.697157
15711,2013,Mayo,Argelia,0,2,,2,-74.140516,4.697157
15712,2013,Mayo,Argentina,6,7,,13,-69.941498,4.191162
15713,2013,Mayo,Argentina,3,3,,6,-76.876446,0.33002
15714,2013,Mayo,Argentina,73,105,,178,-77.35600000000001,0.81488
15715,2013,Mayo,Argentina,231,160,,391,-75.527794,10.406342
15716,2013,Mayo,Argentina,867,564,,1431,-75.516486,10.446304
15717,2013,Mayo,Argentina,6,27,,33,-74.77647900000001,10.886686
15718,2013,Mayo,Argentina,0,1,,1,-74.213989,11.247722999999999
15719,2013,Mayo,Argentina,10,26,,36,-72.129595,11.360028999999999
15720,2013,Mayo,Argentina,162,127,,289,-81.70216500000001,12.5862
15721,2013,Mayo,Argentina,0,1,,1,-81.372937,13.338761300000002
15722,2013,Mayo,Argentina,29,66,,95,-76.532004,3.451668
15723,2013,Mayo,Argentina,2653,4269,,6922,-74.140516,4.697157
15724,2013,Mayo,Argentina,0,8,,8,-75.736374,4.815189
15725,2013,Mayo,Argentina,85,231,,316,-75.42726,6.170465
15726,2013,Mayo,Argentina,0,1,,1,-67.48402800000001,6.185536
15727,2013,Mayo,Argentina,0,1,,1,-70.74025300000001,7.088728999999999
15728,2013,Mayo,Argentina,1,2,,3,-73.181317,7.1280470000000005
15729,2013,Mayo,Argentina,16,59,,75,-72.453013,7.819
15730,2013,Mayo,Argentina,1,2,,3,-72.508188,7.927233
15731,2013,Mayo,Argentina,10,7,,17,-77.35002,8.63337
15732,2013,Mayo,República de Armenia,0,2,,2,-74.140516,4.697157
15733,2013,Mayo,Aruba,0,1,,1,-72.919186,11.52863
15734,2013,Mayo,Aruba,4,1,,5,-74.140516,4.697157
15735,2013,Mayo,Australia,2,3,,5,-69.941498,4.191162
15736,2013,Mayo,Australia,1,0,,1,-76.876446,0.33002
15737,2013,Mayo,Australia,47,76,,123,-77.35600000000001,0.81488
15738,2013,Mayo,Australia,26,38,,64,-75.516486,10.446304
15739,2013,Mayo,Australia,4,8,,12,-74.77647900000001,10.886686
15740,2013,Mayo,Australia,4,4,,8,-74.213989,11.247722999999999
15741,2013,Mayo,Australia,4,6,,10,-72.129595,11.360028999999999
15742,2013,Mayo,Australia,0,1,,1,-81.372937,13.338761300000002
15743,2013,Mayo,Australia,6,12,,18,-76.532004,3.451668
15744,2013,Mayo,Australia,178,311,,489,-74.140516,4.697157
15745,2013,Mayo,Australia,0,2,,2,-75.736374,4.815189
15746,2013,Mayo,Australia,13,43,,56,-75.42726,6.170465
15747,2013,Mayo,Australia,0,1,,1,-73.181317,7.1280470000000005
15748,2013,Mayo,Australia,2,10,,12,-72.453013,7.819
15749,2013,Mayo,Australia,2,5,,7,-77.35002,8.63337
15750,2013,Mayo,Austria,1,1,,2,-69.941498,4.191162
15751,2013,Mayo,Austria,6,9,,15,-77.35600000000001,0.81488
15752,2013,Mayo,Austria,1,5,,6,-75.516486,10.446304
15753,2013,Mayo,Austria,0,2,,2,-74.77647900000001,10.886686
15754,2013,Mayo,Austria,1,1,,2,-72.129595,11.360028999999999
15755,2013,Mayo,Austria,0,1,,1,-81.70216500000001,12.5862
15756,2013,Mayo,Austria,0,1,,1,-76.532004,3.451668
15757,2013,Mayo,Austria,57,147,,204,-74.140516,4.697157
15758,2013,Mayo,Austria,2,6,,8,-75.42726,6.170465
15759,2013,Mayo,Azerbaiyán,0,3,,3,-74.140516,4.697157
15760,2013,Mayo,Bahamas,7,8,,15,-76.532004,3.451668
15761,2013,Mayo,Bahamas,2,7,,9,-74.140516,4.697157
15762,2013,Mayo,Bahamas,0,5,,5,-75.42726,6.170465
15763,2013,Mayo,Bahréin,1,0,,1,-74.140516,4.697157
15764,2013,Mayo,Bangladesh,1,5,,6,-74.140516,4.697157
15765,2013,Mayo,Barbados,1,0,,1,-75.516486,10.446304
15766,2013,Mayo,Barbados,1,4,,5,-74.140516,4.697157
15767,2013,Mayo,República de Belarús,0,4,,4,-74.140516,4.697157
15768,2013,Mayo,Bélgica,0,1,,1,-69.941498,4.191162
15769,2013,Mayo,Bélgica,7,13,,20,-77.35600000000001,0.81488
15770,2013,Mayo,Bélgica,3,12,,15,-75.516486,10.446304
15771,2013,Mayo,Bélgica,1,2,,3,-74.77647900000001,10.886686
15772,2013,Mayo,Bélgica,0,2,,2,-72.129595,11.360028999999999
15773,2013,Mayo,Bélgica,3,30,,33,-76.532004,3.451668
15774,2013,Mayo,Bélgica,73,243,,316,-74.140516,4.697157
15775,2013,Mayo,Bélgica,0,1,,1,-75.736374,4.815189
15776,2013,Mayo,Bélgica,3,18,,21,-75.42726,6.170465
15777,2013,Mayo,Bélgica,1,3,,4,-72.453013,7.819
15778,2013,Mayo,Bélgica,1,1,,2,-72.508188,7.927233
15779,2013,Mayo,Bélgica,3,8,,11,-77.35002,8.63337
15780,2013,Mayo,Belice,0,1,,1,-74.77647900000001,10.886686
15781,2013,Mayo,Belice,5,15,,20,-74.140516,4.697157
15782,2013,Mayo,Belice,2,0,,2,-75.42726,6.170465
15783,2013,Mayo,Benín,0,1,,1,-74.140516,4.697157
15784,2013,Mayo,Bermudas/Territorio Británico de Ultramar,0,1,,1,-74.77647900000001,10.886686
15785,2013,Mayo,Bermudas/Territorio Británico de Ultramar,0,1,,1,-74.140516,4.697157
15786,2013,Mayo,Bolivia,6,12,,18,-77.35600000000001,0.81488
15787,2013,Mayo,Bolivia,3,3,,6,-75.527794,10.406342
15788,2013,Mayo,Bolivia,15,14,,29,-75.516486,10.446304
15789,2013,Mayo,Bolivia,0,1,,1,-72.129595,11.360028999999999
15790,2013,Mayo,Bolivia,0,2,,2,-81.70216500000001,12.5862
15791,2013,Mayo,Bolivia,4,11,,15,-76.532004,3.451668
15792,2013,Mayo,Bolivia,277,472,,749,-74.140516,4.697157
15793,2013,Mayo,Bolivia,11,24,,35,-75.42726,6.170465
15794,2013,Mayo,Bolivia,0,1,,1,-67.48402800000001,6.185536
15795,2013,Mayo,Bolivia,0,1,,1,-70.74025300000001,7.088728999999999
15796,2013,Mayo,Bolivia,0,3,,3,-72.453013,7.819
15797,2013,Mayo,Bolivia,1,0,,1,-77.35002,8.63337
15798,2013,Mayo,Bosnia y Herzegovina,1,1,,2,-74.140516,4.697157
15799,2013,Mayo,Botsuana,1,1,,2,-74.140516,4.697157
15800,2013,Mayo,Brasil,71,77,,148,-69.941498,4.191162
15801,2013,Mayo,Brasil,1,0,,1,-76.876446,0.33002
15802,2013,Mayo,Brasil,10,21,,31,-77.35600000000001,0.81488
15803,2013,Mayo,Brasil,1,0,,1,-78.802679,18.00143
15804,2013,Mayo,Brasil,15,15,,30,-75.527794,10.406342
15805,2013,Mayo,Brasil,177,144,,321,-75.516486,10.446304
15806,2013,Mayo,Brasil,3,15,,18,-74.77647900000001,10.886686
15807,2013,Mayo,Brasil,7,13,,20,-72.129595,11.360028999999999
15808,2013,Mayo,Brasil,41,40,,81,-81.70216500000001,12.5862
15809,2013,Mayo,Brasil,18,65,,83,-76.532004,3.451668
15810,2013,Mayo,Brasil,2567,4123,,6690,-74.140516,4.697157
15811,2013,Mayo,Brasil,4,1,,5,-75.736374,4.815189
15812,2013,Mayo,Brasil,49,127,,176,-75.42726,6.170465
15813,2013,Mayo,Brasil,1,0,,1,-67.48402800000001,6.185536
15814,2013,Mayo,Brasil,12,41,,53,-72.453013,7.819
15815,2013,Mayo,Brasil,2,5,,7,-72.508188,7.927233
15816,2013,Mayo,Brasil,0,3,,3,-77.35002,8.63337
15817,2013,Mayo,Bulgaria,1,1,,2,-75.516486,10.446304
15818,2013,Mayo,Bulgaria,1,0,,1,-76.532004,3.451668
15819,2013,Mayo,Bulgaria,0,1,,1,-77.061029,3.8844260000000004
15820,2013,Mayo,Bulgaria,5,6,,11,-74.140516,4.697157
15821,2013,Mayo,Bulgaria,1,1,,2,-75.42726,6.170465
15822,2013,Mayo,Burundi,0,1,,1,-74.140516,4.697157
15823,2013,Mayo,Bután,1,1,,2,-74.140516,4.697157
15824,2013,Mayo,Cabo Verde,0,1,,1,-77.35600000000001,0.81488
15825,2013,Mayo,Islas Caimán/Territorio Británico de Ultramar,1,0,,1,-76.532004,3.451668
15826,2013,Mayo,Islas Caimán/Territorio Británico de Ultramar,1,1,,2,-74.140516,4.697157
15827,2013,Mayo,Camerún,1,0,,1,-74.140516,4.697157
15828,2013,Mayo,Canadá,3,3,,6,-69.941498,4.191162
15829,2013,Mayo,Canadá,1,0,,1,-76.876446,0.33002
15830,2013,Mayo,Canadá,17,24,,41,-77.35600000000001,0.81488
15831,2013,Mayo,Canadá,67,133,,200,-75.516486,10.446304
15832,2013,Mayo,Canadá,5,24,,29,-74.77647900000001,10.886686
15833,2013,Mayo,Canadá,0,3,,3,-74.213989,11.247722999999999
15834,2013,Mayo,Canadá,2,2,,4,-72.129595,11.360028999999999
15835,2013,Mayo,Canadá,1,6,,7,-81.70216500000001,12.5862
15836,2013,Mayo,Canadá,32,84,,116,-76.532004,3.451668
15837,2013,Mayo,Canadá,0,5,,5,-75.76635300000001,4.45285
15838,2013,Mayo,Canadá,643,1270,,1913,-74.140516,4.697157
15839,2013,Mayo,Canadá,5,2,,7,-75.736374,4.815189
15840,2013,Mayo,Canadá,46,147,,193,-75.42726,6.170465
15841,2013,Mayo,Canadá,0,1,,1,-73.181317,7.1280470000000005
15842,2013,Mayo,Canadá,2,8,,10,-72.453013,7.819
15843,2013,Mayo,Canadá,4,36,,40,-72.508188,7.927233
15844,2013,Mayo,Canadá,0,3,,3,-77.35002,8.63337
15845,2013,Mayo,España,0,1,,1,-76.876446,0.33002
15846,2013,Mayo,España,7,5,,12,-77.35600000000001,0.81488
15847,2013,Mayo,España,2,1,,3,-75.527794,10.406342
15848,2013,Mayo,España,0,1,,1,-75.516486,10.446304
15849,2013,Mayo,España,2,12,,14,-74.77647900000001,10.886686
15850,2013,Mayo,España,0,1,,1,-74.213989,11.247722999999999
15851,2013,Mayo,España,1,1,,2,-72.129595,11.360028999999999
15852,2013,Mayo,España,38,62,,100,-76.532004,3.451668
15853,2013,Mayo,España,102,292,,394,-74.140516,4.697157
15854,2013,Mayo,España,1,4,,5,-75.736374,4.815189
15855,2013,Mayo,España,32,124,,156,-75.42726,6.170465
15856,2013,Mayo,España,0,2,,2,-72.508188,7.927233
15857,2013,Mayo,República Democrática del Congo,1,2,,3,-74.140516,4.697157
15858,2013,Mayo,República Democrática del Congo,1,0,,1,-75.42726,6.170465
15859,2013,Mayo,República de Corea,1,0,,1,-69.941498,4.191162
15860,2013,Mayo,República de Corea,11,8,,19,-77.35600000000001,0.81488
15861,2013,Mayo,República de Corea,2,2,,4,-75.516486,10.446304
15862,2013,Mayo,República de Corea,0,8,,8,-74.77647900000001,10.886686
15863,2013,Mayo,República de Corea,1,0,,1,-72.129595,11.360028999999999
15864,2013,Mayo,República de Corea,0,3,,3,-76.532004,3.451668
15865,2013,Mayo,República de Corea,125,441,,566,-74.140516,4.697157
15866,2013,Mayo,República de Corea,3,20,,23,-75.42726,6.170465
15867,2013,Mayo,República de Corea,0,2,,2,-73.181317,7.1280470000000005
15868,2013,Mayo,República de Corea,3,12,,15,-72.453013,7.819
15869,2013,Mayo,Costa de Marfil,0,1,,1,-74.140516,4.697157
15870,2013,Mayo,Costa Rica,4,0,,4,-77.35600000000001,0.81488
15871,2013,Mayo,Costa Rica,0,1,,1,-75.527794,10.406342
15872,2013,Mayo,Costa Rica,33,47,,80,-75.516486,10.446304
15873,2013,Mayo,Costa Rica,10,26,,36,-74.77647900000001,10.886686
15874,2013,Mayo,Costa Rica,193,150,,343,-81.70216500000001,12.5862
15875,2013,Mayo,Costa Rica,28,68,,96,-76.532004,3.451668
15876,2013,Mayo,Costa Rica,1,0,,1,-75.76635300000001,4.45285
15877,2013,Mayo,Costa Rica,453,839,,1292,-74.140516,4.697157
15878,2013,Mayo,Costa Rica,1,1,,2,-75.736374,4.815189
15879,2013,Mayo,Costa Rica,80,176,,256,-75.42726,6.170465
15880,2013,Mayo,Costa Rica,1,0,,1,-67.48402800000001,6.185536
15881,2013,Mayo,Costa Rica,1,0,,1,-73.181317,7.1280470000000005
15882,2013,Mayo,Costa Rica,0,4,,4,-72.453013,7.819
15883,2013,Mayo,Croacia,0,1,,1,-75.516486,10.446304
15884,2013,Mayo,Croacia,0,3,,3,-76.532004,3.451668
15885,2013,Mayo,Croacia,0,1,,1,-77.061029,3.8844260000000004
15886,2013,Mayo,Croacia,2,19,,21,-74.140516,4.697157
15887,2013,Mayo,Cuba,0,4,,4,-77.35600000000001,0.81488
15888,2013,Mayo,Cuba,3,8,,11,-75.516486,10.446304
15889,2013,Mayo,Cuba,4,11,,15,-74.77647900000001,10.886686
15890,2013,Mayo,Cuba,14,27,,41,-76.532004,3.451668
15891,2013,Mayo,Cuba,0,2,,2,-75.76635300000001,4.45285
15892,2013,Mayo,Cuba,89,132,,221,-74.140516,4.697157
15893,2013,Mayo,Cuba,12,38,,50,-75.42726,6.170465
15894,2013,Mayo,Cuba,0,1,,1,-72.453013,7.819
15895,2013,Mayo,Cuba,1,3,,4,-72.508188,7.927233
15896,2013,Mayo,Curazao,2,4,,6,-74.140516,4.697157
15897,2013,Mayo,Curazao,4,2,,6,-75.42726,6.170465
15898,2013,Mayo,República Checa,1,1,,2,-69.941498,4.191162
15899,2013,Mayo,República Checa,1,5,,6,-77.35600000000001,0.81488
15900,2013,Mayo,República Checa,3,2,,5,-75.516486,10.446304
15901,2013,Mayo,República Checa,0,1,,1,-72.129595,11.360028999999999
15902,2013,Mayo,República Checa,0,1,,1,-76.532004,3.451668
15903,2013,Mayo,República Checa,16,26,,42,-74.140516,4.697157
15904,2013,Mayo,República Checa,1,1,,2,-72.453013,7.819
15905,2013,Mayo,Chile,2,3,,5,-69.941498,4.191162
15906,2013,Mayo,Chile,3,1,,4,-76.876446,0.33002
15907,2013,Mayo,Chile,37,53,,90,-77.35600000000001,0.81488
15908,2013,Mayo,Chile,64,30,,94,-75.527794,10.406342
15909,2013,Mayo,Chile,90,94,,184,-75.516486,10.446304
15910,2013,Mayo,Chile,3,19,,22,-74.77647900000001,10.886686
15911,2013,Mayo,Chile,6,14,,20,-72.129595,11.360028999999999
15912,2013,Mayo,Chile,37,27,,64,-81.70216500000001,12.5862
15913,2013,Mayo,Chile,33,65,,98,-76.532004,3.451668
15914,2013,Mayo,Chile,2837,3907,,6744,-74.140516,4.697157
15915,2013,Mayo,Chile,1,3,,4,-75.736374,4.815189
15916,2013,Mayo,Chile,74,131,,205,-75.42726,6.170465
15917,2013,Mayo,Chile,2,3,,5,-73.181317,7.1280470000000005
15918,2013,Mayo,Chile,7,30,,37,-72.453013,7.819
15919,2013,Mayo,China,2,0,,2,-77.35600000000001,0.81488
15920,2013,Mayo,China,6,11,,17,-75.516486,10.446304
15921,2013,Mayo,China,2,22,,24,-74.77647900000001,10.886686
15922,2013,Mayo,China,0,2,,2,-74.213989,11.247722999999999
15923,2013,Mayo,China,11,11,,22,-76.532004,3.451668
15924,2013,Mayo,China,148,545,,693,-74.140516,4.697157
15925,2013,Mayo,China,6,13,,19,-75.42726,6.170465
15926,2013,Mayo,China,0,2,,2,-72.453013,7.819
15927,2013,Mayo,Taiwán,0,1,,1,-76.876446,0.33002
15928,2013,Mayo,Taiwán,1,3,,4,-75.516486,10.446304
15929,2013,Mayo,Taiwán,0,3,,3,-74.77647900000001,10.886686
15930,2013,Mayo,Taiwán,3,6,,9,-76.532004,3.451668
15931,2013,Mayo,Taiwán,24,52,,76,-74.140516,4.697157
15932,2013,Mayo,Taiwán,7,15,,22,-75.42726,6.170465
15933,2013,Mayo,Taiwán,1,2,,3,-72.453013,7.819
15934,2013,Mayo,Chipre,0,3,,3,-74.140516,4.697157
15935,2013,Mayo,Dinamarca,1,0,,1,-69.941498,4.191162
15936,2013,Mayo,Dinamarca,18,17,,35,-77.35600000000001,0.81488
15937,2013,Mayo,Dinamarca,2,8,,10,-75.516486,10.446304
15938,2013,Mayo,Dinamarca,0,2,,2,-74.77647900000001,10.886686
15939,2013,Mayo,Dinamarca,3,1,,4,-74.213989,11.247722999999999
15940,2013,Mayo,Dinamarca,1,1,,2,-72.129595,11.360028999999999
15941,2013,Mayo,Dinamarca,4,6,,10,-76.532004,3.451668
15942,2013,Mayo,Dinamarca,38,70,,108,-74.140516,4.697157
15943,2013,Mayo,Dinamarca,0,1,,1,-75.736374,4.815189
15944,2013,Mayo,Dinamarca,3,8,,11,-75.42726,6.170465
15945,2013,Mayo,Dominica,0,2,,2,-74.140516,4.697157
15946,2013,Mayo,Dominica,1,1,,2,-75.42726,6.170465
15947,2013,Mayo,Dominica,0,1,,1,-72.508188,7.927233
15948,2013,Mayo,Ecuador,1,3,,4,-69.941498,4.191162
15949,2013,Mayo,Ecuador,15,55,,70,-76.876446,0.33002
15950,2013,Mayo,Ecuador,903,1378,,2281,-77.35600000000001,0.81488
15951,2013,Mayo,Ecuador,5,164,,169,-78.802679,18.00143
15952,2013,Mayo,Ecuador,4,6,,10,-75.527794,10.406342
15953,2013,Mayo,Ecuador,11,23,,34,-75.516486,10.446304
15954,2013,Mayo,Ecuador,2,8,,10,-74.77647900000001,10.886686
15955,2013,Mayo,Ecuador,16,12,,28,-72.129595,11.360028999999999
15956,2013,Mayo,Ecuador,4,6,,10,-81.70216500000001,12.5862
15957,2013,Mayo,Ecuador,383,450,,833,-76.532004,3.451668
15958,2013,Mayo,Ecuador,0,2,,2,-77.061029,3.8844260000000004
15959,2013,Mayo,Ecuador,1859,2872,,4731,-74.140516,4.697157
15960,2013,Mayo,Ecuador,0,7,,7,-75.736374,4.815189
15961,2013,Mayo,Ecuador,538,649,,1187,-75.42726,6.170465
15962,2013,Mayo,Ecuador,104,140,,244,-72.453013,7.819
15963,2013,Mayo,Ecuador,1,0,,1,-77.35002,8.63337
15964,2013,Mayo,Egipto,5,16,,21,-74.140516,4.697157
15965,2013,Mayo,Egipto,0,1,,1,-75.42726,6.170465
15966,2013,Mayo,El Salvador,3,2,,5,-77.35600000000001,0.81488
15967,2013,Mayo,El Salvador,16,23,,39,-75.516486,10.446304
15968,2013,Mayo,El Salvador,3,1,,4,-74.77647900000001,10.886686
15969,2013,Mayo,El Salvador,45,73,,118,-76.532004,3.451668
15970,2013,Mayo,El Salvador,381,637,,1018,-74.140516,4.697157
15971,2013,Mayo,El Salvador,0,1,,1,-75.736374,4.815189
15972,2013,Mayo,El Salvador,39,64,,103,-75.42726,6.170465
15973,2013,Mayo,El Salvador,0,1,,1,-72.453013,7.819
15974,2013,Mayo,El Salvador,0,1,,1,-72.508188,7.927233
15975,2013,Mayo,Emiratos Árabes,4,2,,6,-74.140516,4.697157
15976,2013,Mayo,España,2,8,,10,-69.941498,4.191162
15977,2013,Mayo,España,22,42,,64,-77.35600000000001,0.81488
15978,2013,Mayo,España,11,8,,19,-75.527794,10.406342
15979,2013,Mayo,España,36,72,,108,-75.516486,10.446304
15980,2013,Mayo,España,2,13,,15,-74.77647900000001,10.886686
15981,2013,Mayo,España,6,7,,13,-72.129595,11.360028999999999
15982,2013,Mayo,España,6,4,,10,-81.70216500000001,12.5862
15983,2013,Mayo,España,0,1,,1,-81.372937,13.338761300000002
15984,2013,Mayo,España,156,301,,457,-76.532004,3.451668
15985,2013,Mayo,España,1546,4440,,5986,-74.140516,4.697157
15986,2013,Mayo,España,2,8,,10,-75.736374,4.815189
15987,2013,Mayo,España,74,214,,288,-75.42726,6.170465
15988,2013,Mayo,España,0,1,,1,-70.74025300000001,7.088728999999999
15989,2013,Mayo,España,0,2,,2,-73.181317,7.1280470000000005
15990,2013,Mayo,España,16,44,,60,-72.453013,7.819
15991,2013,Mayo,España,1,1,,2,-72.508188,7.927233
15992,2013,Mayo,España,2,8,,10,-77.35002,8.63337
15993,2013,Mayo,Eslovaquia,2,0,,2,-75.516486,10.446304
15994,2013,Mayo,Eslovaquia,2,0,,2,-74.77647900000001,10.886686
15995,2013,Mayo,Eslovaquia,13,10,,23,-74.140516,4.697157
15996,2013,Mayo,Eslovaquia,0,1,,1,-72.453013,7.819
15997,2013,Mayo,Eslovenia,0,1,,1,-77.35600000000001,0.81488
15998,2013,Mayo,Eslovenia,0,1,,1,-75.516486,10.446304
15999,2013,Mayo,Eslovenia,1,1,,2,-72.129595,11.360028999999999
16000,2013,Mayo,Eslovenia,1,5,,6,-76.532004,3.451668
16001,2013,Mayo,Eslovenia,8,15,,23,-74.140516,4.697157
16002,2013,Mayo,Eslovenia,0,1,,1,-77.35002,8.63337
16003,2013,Mayo,Estados Unidos de América,5,25,,30,-69.941498,4.191162
16004,2013,Mayo,Estados Unidos de América,52,74,,126,-77.35600000000001,0.81488
16005,2013,Mayo,Estados Unidos de América,1,1,,2,-78.802679,18.00143
16006,2013,Mayo,Estados Unidos de América,1,7,,8,-75.527794,10.406342
16007,2013,Mayo,Estados Unidos de América,1138,2103,,3241,-75.516486,10.446304
16008,2013,Mayo,Estados Unidos de América,340,574,,914,-74.77647900000001,10.886686
16009,2013,Mayo,Estados Unidos de América,3,5,,8,-74.213989,11.247722999999999
16010,2013,Mayo,Estados Unidos de América,1,10,,11,-72.129595,11.360028999999999
16011,2013,Mayo,Estados Unidos de América,0,2,,2,-72.919186,11.52863
16012,2013,Mayo,Estados Unidos de América,7,18,,25,-81.70216500000001,12.5862
16013,2013,Mayo,Estados Unidos de América,7,7,,14,-81.372937,13.338761300000002
16014,2013,Mayo,Estados Unidos de América,717,1242,,1959,-76.532004,3.451668
16015,2013,Mayo,Estados Unidos de América,72,127,,199,-75.76635300000001,4.45285
16016,2013,Mayo,Estados Unidos de América,5807,11372,,17179,-74.140516,4.697157
16017,2013,Mayo,Estados Unidos de América,75,124,,199,-75.736374,4.815189
16018,2013,Mayo,Estados Unidos de América,955,2500,,3455,-75.42726,6.170465
16019,2013,Mayo,Estados Unidos de América,1,1,,2,-67.48402800000001,6.185536
16020,2013,Mayo,Estados Unidos de América,10,23,,33,-73.181317,7.1280470000000005
16021,2013,Mayo,Estados Unidos de América,24,49,,73,-72.453013,7.819
16022,2013,Mayo,Estados Unidos de América,8,11,,19,-72.508188,7.927233
16023,2013,Mayo,Estados Unidos de América,5,12,,17,-77.35002,8.63337
16024,2013,Mayo,Estonia,1,1,,2,-77.35600000000001,0.81488
16025,2013,Mayo,Estonia,3,0,,3,-75.516486,10.446304
16026,2013,Mayo,Estonia,0,1,,1,-74.77647900000001,10.886686
16027,2013,Mayo,Estonia,1,0,,1,-76.532004,3.451668
16028,2013,Mayo,Estonia,6,6,,12,-74.140516,4.697157
16029,2013,Mayo,Estonia,1,0,,1,-75.42726,6.170465
16030,2013,Mayo,Etiopia,1,4,,5,-74.140516,4.697157
16031,2013,Mayo,Filipinas,0,1,,1,-77.35600000000001,0.81488
16032,2013,Mayo,Filipinas,0,1,,1,-75.527794,10.406342
16033,2013,Mayo,Filipinas,2,10,,12,-75.516486,10.446304
16034,2013,Mayo,Filipinas,0,9,,9,-74.77647900000001,10.886686
16035,2013,Mayo,Filipinas,0,8,,8,-74.765343,10.970933
16036,2013,Mayo,Filipinas,0,8,,8,-74.213989,11.247722999999999
16037,2013,Mayo,Filipinas,0,15,,15,-76.532004,3.451668
16038,2013,Mayo,Filipinas,0,18,,18,-77.061029,3.8844260000000004
16039,2013,Mayo,Filipinas,13,66,,79,-74.140516,4.697157
16040,2013,Mayo,Filipinas,1,5,,6,-75.42726,6.170465
16041,2013,Mayo,Filipinas,0,10,,10,-75.68164200000001,9.402597
16042,2013,Mayo,Finlandia,0,1,,1,-69.941498,4.191162
16043,2013,Mayo,Finlandia,3,5,,8,-77.35600000000001,0.81488
16044,2013,Mayo,Finlandia,0,1,,1,-75.516486,10.446304
16045,2013,Mayo,Finlandia,1,1,,2,-76.532004,3.451668
16046,2013,Mayo,Finlandia,45,98,,143,-74.140516,4.697157
16047,2013,Mayo,Finlandia,0,2,,2,-75.42726,6.170465
16048,2013,Mayo,Finlandia,1,0,,1,-72.453013,7.819
16049,2013,Mayo,Francia,8,19,,27,-69.941498,4.191162
16050,2013,Mayo,Francia,0,2,,2,-76.876446,0.33002
16051,2013,Mayo,Francia,39,63,,102,-77.35600000000001,0.81488
16052,2013,Mayo,Francia,1,1,,2,-78.802679,18.00143
16053,2013,Mayo,Francia,4,7,,11,-75.527794,10.406342
16054,2013,Mayo,Francia,21,30,,51,-75.516486,10.446304
16055,2013,Mayo,Francia,2,14,,16,-74.77647900000001,10.886686
16056,2013,Mayo,Francia,1,6,,7,-74.213989,11.247722999999999
16057,2013,Mayo,Francia,1,7,,8,-72.129595,11.360028999999999
16058,2013,Mayo,Francia,0,1,,1,-81.70216500000001,12.5862
16059,2013,Mayo,Francia,1,1,,2,-81.372937,13.338761300000002
16060,2013,Mayo,Francia,28,56,,84,-76.532004,3.451668
16061,2013,Mayo,Francia,0,1,,1,-77.061029,3.8844260000000004
16062,2013,Mayo,Francia,730,1555,,2285,-74.140516,4.697157
16063,2013,Mayo,Francia,0,4,,4,-75.736374,4.815189
16064,2013,Mayo,Francia,30,73,,103,-75.42726,6.170465
16065,2013,Mayo,Francia,1,2,,3,-73.181317,7.1280470000000005
16066,2013,Mayo,Francia,7,18,,25,-72.453013,7.819
16067,2013,Mayo,Francia,4,8,,12,-77.35002,8.63337
16068,2013,Mayo,Georgia,2,0,,2,-74.140516,4.697157
16069,2013,Mayo,Ghana,1,3,,4,-74.140516,4.697157
16070,2013,Mayo,Granada,0,1,,1,-76.532004,3.451668
16071,2013,Mayo,Granada,0,1,,1,-75.42726,6.170465
16072,2013,Mayo,Grecia,0,1,,1,-69.941498,4.191162
16073,2013,Mayo,Grecia,0,1,,1,-77.35600000000001,0.81488
16074,2013,Mayo,Grecia,1,4,,5,-75.516486,10.446304
16075,2013,Mayo,Grecia,0,1,,1,-74.765343,10.970933
16076,2013,Mayo,Grecia,0,4,,4,-72.129595,11.360028999999999
16077,2013,Mayo,Grecia,1,3,,4,-76.532004,3.451668
16078,2013,Mayo,Grecia,17,48,,65,-74.140516,4.697157
16079,2013,Mayo,Grecia,1,3,,4,-75.42726,6.170465
16080,2013,Mayo,Grecia,0,1,,1,-72.453013,7.819
16081,2013,Mayo,Guatemala,0,5,,5,-77.35600000000001,0.81488
16082,2013,Mayo,Guatemala,0,1,,1,-75.527794,10.406342
16083,2013,Mayo,Guatemala,27,33,,60,-75.516486,10.446304
16084,2013,Mayo,Guatemala,5,11,,16,-74.77647900000001,10.886686
16085,2013,Mayo,Guatemala,0,4,,4,-72.129595,11.360028999999999
16086,2013,Mayo,Guatemala,2,3,,5,-81.70216500000001,12.5862
16087,2013,Mayo,Guatemala,27,63,,90,-76.532004,3.451668
16088,2013,Mayo,Guatemala,163,462,,625,-74.140516,4.697157
16089,2013,Mayo,Guatemala,1,2,,3,-75.736374,4.815189
16090,2013,Mayo,Guatemala,36,96,,132,-75.42726,6.170465
16091,2013,Mayo,Guatemala,1,1,,2,-73.181317,7.1280470000000005
16092,2013,Mayo,Guatemala,7,15,,22,-72.453013,7.819
16093,2013,Mayo,Guatemala,1,2,,3,-72.508188,7.927233
16094,2013,Mayo,Guatemala,1,2,,3,-77.35002,8.63337
16095,2013,Mayo,Guyana,0,2,,2,-75.516486,10.446304
16096,2013,Mayo,Guyana,0,2,,2,-76.532004,3.451668
16097,2013,Mayo,Guyana,5,7,,12,-74.140516,4.697157
16098,2013,Mayo,Guyana,0,1,,1,-75.736374,4.815189
16099,2013,Mayo,Guyana,1,3,,4,-75.42726,6.170465
16100,2013,Mayo,Haití,1,0,,1,-77.35600000000001,0.81488
16101,2013,Mayo,Haití,0,1,,1,-75.516486,10.446304
16102,2013,Mayo,Haití,0,1,,1,-74.77647900000001,10.886686
16103,2013,Mayo,Haití,4,23,,27,-74.140516,4.697157
16104,2013,Mayo,Haití,0,3,,3,-75.42726,6.170465
16105,2013,Mayo,Honduras,0,1,,1,-77.35600000000001,0.81488
16106,2013,Mayo,Honduras,0,2,,2,-75.527794,10.406342
16107,2013,Mayo,Honduras,13,17,,30,-75.516486,10.446304
16108,2013,Mayo,Honduras,2,6,,8,-74.77647900000001,10.886686
16109,2013,Mayo,Honduras,0,1,,1,-74.765343,10.970933
16110,2013,Mayo,Honduras,0,1,,1,-72.129595,11.360028999999999
16111,2013,Mayo,Honduras,2,1,,3,-81.70216500000001,12.5862
16112,2013,Mayo,Honduras,15,36,,51,-76.532004,3.451668
16113,2013,Mayo,Honduras,99,174,,273,-74.140516,4.697157
16114,2013,Mayo,Honduras,1,2,,3,-75.736374,4.815189
16115,2013,Mayo,Honduras,17,33,,50,-75.42726,6.170465
16116,2013,Mayo,Honduras,0,1,,1,-76.7333,8.06667
16117,2013,Mayo,Honduras,1,3,,4,-77.35002,8.63337
16118,2013,Mayo,Hungría,0,1,,1,-69.941498,4.191162
16119,2013,Mayo,Hungría,3,0,,3,-77.35600000000001,0.81488
16120,2013,Mayo,Hungría,0,1,,1,-76.532004,3.451668
16121,2013,Mayo,Hungría,16,19,,35,-74.140516,4.697157
16122,2013,Mayo,Hungría,0,1,,1,-75.42726,6.170465
16123,2013,Mayo,India,0,2,,2,-77.35600000000001,0.81488
16124,2013,Mayo,India,3,8,,11,-75.516486,10.446304
16125,2013,Mayo,India,0,2,,2,-74.77647900000001,10.886686
16126,2013,Mayo,India,5,17,,22,-76.532004,3.451668
16127,2013,Mayo,India,0,1,,1,-77.061029,3.8844260000000004
16128,2013,Mayo,India,32,250,,282,-74.140516,4.697157
16129,2013,Mayo,India,3,28,,31,-75.42726,6.170465
16130,2013,Mayo,India,0,1,,1,-72.508188,7.927233
16131,2013,Mayo,Indonesia,2,0,,2,-77.35600000000001,0.81488
16132,2013,Mayo,Indonesia,0,1,,1,-75.516486,10.446304
16133,2013,Mayo,Indonesia,1,0,,1,-76.532004,3.451668
16134,2013,Mayo,Indonesia,11,29,,40,-74.140516,4.697157
16135,2013,Mayo,Iraq,1,1,,2,-74.140516,4.697157
16136,2013,Mayo,Irán,1,10,,11,-74.140516,4.697157
16137,2013,Mayo,República de Irlanda,1,0,,1,-69.941498,4.191162
16138,2013,Mayo,República de Irlanda,8,18,,26,-77.35600000000001,0.81488
16139,2013,Mayo,República de Irlanda,9,15,,24,-75.516486,10.446304
16140,2013,Mayo,República de Irlanda,2,0,,2,-74.77647900000001,10.886686
16141,2013,Mayo,República de Irlanda,0,1,,1,-72.129595,11.360028999999999
16142,2013,Mayo,República de Irlanda,0,1,,1,-76.532004,3.451668
16143,2013,Mayo,República de Irlanda,37,88,,125,-74.140516,4.697157
16144,2013,Mayo,República de Irlanda,3,14,,17,-75.42726,6.170465
16145,2013,Mayo,República de Irlanda,0,1,,1,-72.453013,7.819
16146,2013,Mayo,Islandia,1,1,,2,-75.516486,10.446304
16147,2013,Mayo,Islandia,2,2,,4,-76.532004,3.451668
16148,2013,Mayo,Islandia,7,7,,14,-74.140516,4.697157
16149,2013,Mayo,Isla de Man,21,22,,43,-77.35600000000001,0.81488
16150,2013,Mayo,Isla de Man,3,6,,9,-75.516486,10.446304
16151,2013,Mayo,Isla de Man,1,6,,7,-74.77647900000001,10.886686
16152,2013,Mayo,Isla de Man,4,11,,15,-76.532004,3.451668
16153,2013,Mayo,Isla de Man,34,89,,123,-74.140516,4.697157
16154,2013,Mayo,Isla de Man,13,34,,47,-75.42726,6.170465
16155,2013,Mayo,Israel,0,3,,3,-69.941498,4.191162
16156,2013,Mayo,Israel,17,67,,84,-77.35600000000001,0.81488
16157,2013,Mayo,Israel,7,30,,37,-75.516486,10.446304
16158,2013,Mayo,Israel,0,1,,1,-74.77647900000001,10.886686
16159,2013,Mayo,Israel,0,1,,1,-81.70216500000001,12.5862
16160,2013,Mayo,Israel,6,15,,21,-76.532004,3.451668
16161,2013,Mayo,Israel,121,561,,682,-74.140516,4.697157
16162,2013,Mayo,Israel,0,1,,1,-75.736374,4.815189
16163,2013,Mayo,Israel,5,52,,57,-75.42726,6.170465
16164,2013,Mayo,Israel,1,5,,6,-77.35002,8.63337
16165,2013,Mayo,Islas Aland/Provincia de Finlandia,0,2,,2,-74.140516,4.697157
16166,2013,Mayo,Italia,0,3,,3,-69.941498,4.191162
16167,2013,Mayo,Italia,10,19,,29,-77.35600000000001,0.81488
16168,2013,Mayo,Italia,0,1,,1,-78.802679,18.00143
16169,2013,Mayo,Italia,3,3,,6,-75.527794,10.406342
16170,2013,Mayo,Italia,33,50,,83,-75.516486,10.446304
16171,2013,Mayo,Italia,1,12,,13,-74.77647900000001,10.886686
16172,2013,Mayo,Italia,2,1,,3,-74.213989,11.247722999999999
16173,2013,Mayo,Italia,1,8,,9,-72.129595,11.360028999999999
16174,2013,Mayo,Italia,0,1,,1,-72.919186,11.52863
16175,2013,Mayo,Italia,0,2,,2,-81.70216500000001,12.5862
16176,2013,Mayo,Italia,28,76,,104,-76.532004,3.451668
16177,2013,Mayo,Italia,336,1433,,1769,-74.140516,4.697157
16178,2013,Mayo,Italia,0,3,,3,-75.736374,4.815189
16179,2013,Mayo,Italia,16,77,,93,-75.42726,6.170465
16180,2013,Mayo,Italia,1,0,,1,-73.181317,7.1280470000000005
16181,2013,Mayo,Italia,5,14,,19,-72.453013,7.819
16182,2013,Mayo,Italia,0,1,,1,-72.508188,7.927233
16183,2013,Mayo,Italia,2,5,,7,-77.35002,8.63337
16184,2013,Mayo,Islas del Canal,1,4,,5,-75.516486,10.446304
16185,2013,Mayo,Islas del Canal,0,1,,1,-74.140516,4.697157
16186,2013,Mayo,Jamaica,2,0,,2,-75.516486,10.446304
16187,2013,Mayo,Jamaica,0,2,,2,-74.77647900000001,10.886686
16188,2013,Mayo,Jamaica,1,0,,1,-74.213989,11.247722999999999
16189,2013,Mayo,Jamaica,0,1,,1,-81.70216500000001,12.5862
16190,2013,Mayo,Jamaica,1,1,,2,-76.532004,3.451668
16191,2013,Mayo,Jamaica,11,28,,39,-74.140516,4.697157
16192,2013,Mayo,Japón,2,5,,7,-69.941498,4.191162
16193,2013,Mayo,Japón,26,20,,46,-77.35600000000001,0.81488
16194,2013,Mayo,Japón,1,15,,16,-75.516486,10.446304
16195,2013,Mayo,Japón,0,8,,8,-74.77647900000001,10.886686
16196,2013,Mayo,Japón,0,1,,1,-81.70216500000001,12.5862
16197,2013,Mayo,Japón,0,2,,2,-81.372937,13.338761300000002
16198,2013,Mayo,Japón,4,24,,28,-76.532004,3.451668
16199,2013,Mayo,Japón,0,1,,1,-77.061029,3.8844260000000004
16200,2013,Mayo,Japón,75,410,,485,-74.140516,4.697157
16201,2013,Mayo,Japón,4,23,,27,-75.42726,6.170465
16202,2013,Mayo,Japón,1,4,,5,-72.453013,7.819
16203,2013,Mayo,Japón,0,1,,1,-72.508188,7.927233
16204,2013,Mayo,Japón,0,2,,2,-77.35002,8.63337
16205,2013,Mayo,Jordania,0,1,,1,-76.532004,3.451668
16206,2013,Mayo,Jordania,1,6,,7,-74.140516,4.697157
16207,2013,Mayo,Kazajistán,1,0,,1,-74.140516,4.697157
16208,2013,Mayo,Kenia,0,1,,1,-75.516486,10.446304
16209,2013,Mayo,Kenia,3,0,,3,-76.532004,3.451668
16210,2013,Mayo,Kenia,2,1,,3,-74.140516,4.697157
16211,2013,Mayo,Kenia,0,1,,1,-75.42726,6.170465
16212,2013,Mayo,Kirguistán,0,1,,1,-74.140516,4.697157
16213,2013,Mayo,Kuwait,0,2,,2,-75.516486,10.446304
16214,2013,Mayo,Kuwait,1,1,,2,-74.140516,4.697157
16215,2013,Mayo,República de Kosovo,2,0,,2,-74.140516,4.697157
16216,2013,Mayo,Letonia,2,1,,3,-75.516486,10.446304
16217,2013,Mayo,Letonia,1,1,,2,-81.70216500000001,12.5862
16218,2013,Mayo,Letonia,1,13,,14,-74.140516,4.697157
16219,2013,Mayo,Lituania,1,2,,3,-75.516486,10.446304
16220,2013,Mayo,Lituania,0,1,,1,-72.129595,11.360028999999999
16221,2013,Mayo,Lituania,7,9,,16,-74.140516,4.697157
16222,2013,Mayo,Lituania,2,0,,2,-75.42726,6.170465
16223,2013,Mayo,Líbano,1,1,,2,-74.77647900000001,10.886686
16224,2013,Mayo,Líbano,8,2,,10,-72.129595,11.360028999999999
16225,2013,Mayo,Líbano,1,3,,4,-76.532004,3.451668
16226,2013,Mayo,Líbano,9,25,,34,-74.140516,4.697157
16227,2013,Mayo,Líbano,0,1,,1,-75.42726,6.170465
16228,2013,Mayo,Liechtenstein,0,1,,1,-74.140516,4.697157
16229,2013,Mayo,Luxemburgo,1,8,,9,-74.140516,4.697157
16230,2013,Mayo,Macedonia,1,2,,3,-74.140516,4.697157
16231,2013,Mayo,Malasia,0,1,,1,-75.516486,10.446304
16232,2013,Mayo,Malasia,8,32,,40,-74.140516,4.697157
16233,2013,Mayo,Malasia,0,1,,1,-75.42726,6.170465
16234,2013,Mayo,Malasia,0,1,,1,-72.453013,7.819
16235,2013,Mayo,Malta,0,7,,7,-74.140516,4.697157
16236,2013,Mayo,Malta,0,1,,1,-72.453013,7.819
16237,2013,Mayo,Marruecos,2,6,,8,-74.140516,4.697157
16238,2013,Mayo,Mauricio,1,1,,2,-75.42726,6.170465
16239,2013,Mayo,México,0,4,,4,-69.941498,4.191162
16240,2013,Mayo,México,2,0,,2,-76.876446,0.33002
16241,2013,Mayo,México,6,12,,18,-77.35600000000001,0.81488
16242,2013,Mayo,México,12,10,,22,-75.527794,10.406342
16243,2013,Mayo,México,281,345,,626,-75.516486,10.446304
16244,2013,Mayo,México,15,58,,73,-74.77647900000001,10.886686
16245,2013,Mayo,México,1,4,,5,-72.129595,11.360028999999999
16246,2013,Mayo,México,72,271,,343,-76.532004,3.451668
16247,2013,Mayo,México,0,2,,2,-77.061029,3.8844260000000004
16248,2013,Mayo,México,1,1,,2,-75.76635300000001,4.45285
16249,2013,Mayo,México,1650,4200,,5850,-74.140516,4.697157
16250,2013,Mayo,México,6,15,,21,-75.736374,4.815189
16251,2013,Mayo,México,123,351,,474,-75.42726,6.170465
16252,2013,Mayo,México,0,1,,1,-67.48402800000001,6.185536
16253,2013,Mayo,México,2,3,,5,-73.181317,7.1280470000000005
16254,2013,Mayo,México,15,31,,46,-72.453013,7.819
16255,2013,Mayo,México,6,3,,9,-72.508188,7.927233
16256,2013,Mayo,México,1,2,,3,-77.35002,8.63337
16257,2013,Mayo,República de Moldavia,0,1,,1,-74.140516,4.697157
16258,2013,Mayo,Mozambique,0,1,,1,-76.532004,3.451668
16259,2013,Mayo,Mozambique,1,0,,1,-74.140516,4.697157
16260,2013,Mayo,Nepal,0,1,,1,-75.516486,10.446304
16261,2013,Mayo,Nepal,1,1,,2,-74.140516,4.697157
16262,2013,Mayo,Nicaragua,4,7,,11,-75.516486,10.446304
16263,2013,Mayo,Nicaragua,1,0,,1,-74.77647900000001,10.886686
16264,2013,Mayo,Nicaragua,2,3,,5,-81.70216500000001,12.5862
16265,2013,Mayo,Nicaragua,2,5,,7,-76.532004,3.451668
16266,2013,Mayo,Nicaragua,45,62,,107,-74.140516,4.697157
16267,2013,Mayo,Nicaragua,1,0,,1,-75.736374,4.815189
16268,2013,Mayo,Nicaragua,2,7,,9,-75.42726,6.170465
16269,2013,Mayo,Nicaragua,1,0,,1,-73.181317,7.1280470000000005
16270,2013,Mayo,Nigeria,0,1,,1,-75.516486,10.446304
16271,2013,Mayo,Nigeria,4,25,,29,-74.140516,4.697157
16272,2013,Mayo,Noruega,0,1,,1,-69.941498,4.191162
16273,2013,Mayo,Noruega,8,5,,13,-77.35600000000001,0.81488
16274,2013,Mayo,Noruega,1,4,,5,-75.516486,10.446304
16275,2013,Mayo,Noruega,0,3,,3,-74.77647900000001,10.886686
16276,2013,Mayo,Noruega,0,1,,1,-72.129595,11.360028999999999
16277,2013,Mayo,Noruega,4,6,,10,-76.532004,3.451668
16278,2013,Mayo,Noruega,36,59,,95,-74.140516,4.697157
16279,2013,Mayo,Noruega,1,8,,9,-75.42726,6.170465
16280,2013,Mayo,Noruega,2,0,,2,-73.181317,7.1280470000000005
16281,2013,Mayo,Noruega,2,0,,2,-72.453013,7.819
16282,2013,Mayo,Noruega,0,1,,1,-77.35002,8.63337
16283,2013,Mayo,Nueva Zelanda,2,2,,4,-69.941498,4.191162
16284,2013,Mayo,Nueva Zelanda,3,11,,14,-77.35600000000001,0.81488
16285,2013,Mayo,Nueva Zelanda,3,11,,14,-75.516486,10.446304
16286,2013,Mayo,Nueva Zelanda,0,1,,1,-74.77647900000001,10.886686
16287,2013,Mayo,Nueva Zelanda,0,2,,2,-72.129595,11.360028999999999
16288,2013,Mayo,Nueva Zelanda,0,1,,1,-72.919186,11.52863
16289,2013,Mayo,Nueva Zelanda,2,3,,5,-76.532004,3.451668
16290,2013,Mayo,Nueva Zelanda,28,55,,83,-74.140516,4.697157
16291,2013,Mayo,Nueva Zelanda,0,1,,1,-75.736374,4.815189
16292,2013,Mayo,Nueva Zelanda,0,3,,3,-75.42726,6.170465
16293,2013,Mayo,Nueva Zelanda,0,1,,1,-77.35002,8.63337
16294,2013,Mayo,Omán,4,4,,8,-74.140516,4.697157
16295,2013,Mayo,Nueva Zelanda,0,1,,1,-69.941498,4.191162
16296,2013,Mayo,Nueva Zelanda,0,1,,1,-76.532004,3.451668
16297,2013,Mayo,Nueva Zelanda,2,5,,7,-74.140516,4.697157
16298,2013,Mayo,Países Bajos,1,1,,2,-69.941498,4.191162
16299,2013,Mayo,Países Bajos,7,3,,10,-77.35600000000001,0.81488
16300,2013,Mayo,Países Bajos,1,5,,6,-75.516486,10.446304
16301,2013,Mayo,Países Bajos,1,7,,8,-74.77647900000001,10.886686
16302,2013,Mayo,Países Bajos,1,10,,11,-72.129595,11.360028999999999
16303,2013,Mayo,Países Bajos,11,17,,28,-72.919186,11.52863
16304,2013,Mayo,Países Bajos,0,1,,1,-81.70216500000001,12.5862
16305,2013,Mayo,Países Bajos,13,12,,25,-76.532004,3.451668
16306,2013,Mayo,Países Bajos,0,1,,1,-77.061029,3.8844260000000004
16307,2013,Mayo,Países Bajos,1,0,,1,-75.76635300000001,4.45285
16308,2013,Mayo,Países Bajos,123,248,,371,-74.140516,4.697157
16309,2013,Mayo,Países Bajos,1,0,,1,-75.736374,4.815189
16310,2013,Mayo,Países Bajos,220,237,,457,-75.42726,6.170465
16311,2013,Mayo,Países Bajos,6,3,,9,-73.181317,7.1280470000000005
16312,2013,Mayo,Países Bajos,0,2,,2,-72.453013,7.819
16313,2013,Mayo,Países Bajos,0,1,,1,-72.508188,7.927233
16314,2013,Mayo,Pakistán,0,1,,1,-76.532004,3.451668
16315,2013,Mayo,Pakistán,0,7,,7,-74.140516,4.697157
16316,2013,Mayo,Palau,0,1,,1,-74.140516,4.697157
16317,2013,Mayo,Panamá,1,0,,1,-69.941498,4.191162
16318,2013,Mayo,Panamá,0,1,,1,-78.802679,18.00143
16319,2013,Mayo,Panamá,351,413,,764,-75.516486,10.446304
16320,2013,Mayo,Panamá,39,76,,115,-74.77647900000001,10.886686
16321,2013,Mayo,Panamá,0,1,,1,-74.765343,10.970933
16322,2013,Mayo,Panamá,1,4,,5,-72.129595,11.360028999999999
16323,2013,Mayo,Panamá,36,30,,66,-81.70216500000001,12.5862
16324,2013,Mayo,Panamá,118,153,,271,-76.532004,3.451668
16325,2013,Mayo,Panamá,522,845,,1367,-74.140516,4.697157
16326,2013,Mayo,Panamá,76,85,,161,-75.736374,4.815189
16327,2013,Mayo,Panamá,115,233,,348,-75.42726,6.170465
16328,2013,Mayo,Panamá,5,18,,23,-73.181317,7.1280470000000005
16329,2013,Mayo,Panamá,3,4,,7,-72.453013,7.819
16330,2013,Mayo,Panamá,2,15,,17,-72.508188,7.927233
16331,2013,Mayo,Panamá,7,11,,18,-77.35002,8.63337
16332,2013,Mayo,Paraguay,1,0,,1,-69.941498,4.191162
16333,2013,Mayo,Paraguay,2,1,,3,-77.35600000000001,0.81488
16334,2013,Mayo,Paraguay,30,32,,62,-75.516486,10.446304
16335,2013,Mayo,Paraguay,5,2,,7,-81.70216500000001,12.5862
16336,2013,Mayo,Paraguay,2,2,,4,-76.532004,3.451668
16337,2013,Mayo,Paraguay,61,93,,154,-74.140516,4.697157
16338,2013,Mayo,Paraguay,8,15,,23,-75.42726,6.170465
16339,2013,Mayo,Paraguay,0,1,,1,-72.508188,7.927233
16340,2013,Mayo,Perú,14,28,,42,-69.941498,4.191162
16341,2013,Mayo,Perú,1,5,,6,-76.876446,0.33002
16342,2013,Mayo,Perú,101,253,,354,-77.35600000000001,0.81488
16343,2013,Mayo,Perú,0,1,,1,-78.802679,18.00143
16344,2013,Mayo,Perú,71,36,,107,-75.527794,10.406342
16345,2013,Mayo,Perú,114,99,,213,-75.516486,10.446304
16346,2013,Mayo,Perú,7,16,,23,-74.77647900000001,10.886686
16347,2013,Mayo,Perú,0,1,,1,-74.765343,10.970933
16348,2013,Mayo,Perú,8,26,,34,-72.129595,11.360028999999999
16349,2013,Mayo,Perú,44,31,,75,-81.70216500000001,12.5862
16350,2013,Mayo,Perú,118,178,,296,-76.532004,3.451668
16351,2013,Mayo,Perú,1,0,,1,-75.76635300000001,4.45285
16352,2013,Mayo,Perú,3144,3696,,6840,-74.140516,4.697157
16353,2013,Mayo,Perú,2,8,,10,-75.736374,4.815189
16354,2013,Mayo,Perú,221,390,,611,-75.42726,6.170465
16355,2013,Mayo,Perú,0,2,,2,-67.48402800000001,6.185536
16356,2013,Mayo,Perú,2,2,,4,-73.181317,7.1280470000000005
16357,2013,Mayo,Perú,23,53,,76,-72.453013,7.819
16358,2013,Mayo,Perú,1,2,,3,-72.508188,7.927233
16359,2013,Mayo,Perú,0,1,,1,-77.35002,8.63337
16360,2013,Mayo,Palestina,0,4,,4,-74.140516,4.697157
16361,2013,Mayo,Polonia,1,1,,2,-69.941498,4.191162
16362,2013,Mayo,Polonia,11,9,,20,-77.35600000000001,0.81488
16363,2013,Mayo,Polonia,2,2,,4,-75.516486,10.446304
16364,2013,Mayo,Polonia,0,1,,1,-74.765343,10.970933
16365,2013,Mayo,Polonia,0,3,,3,-72.129595,11.360028999999999
16366,2013,Mayo,Polonia,0,1,,1,-76.532004,3.451668
16367,2013,Mayo,Polonia,37,82,,119,-74.140516,4.697157
16368,2013,Mayo,Polonia,3,4,,7,-75.42726,6.170465
16369,2013,Mayo,Polonia,0,2,,2,-72.453013,7.819
16370,2013,Mayo,Polonia,0,1,,1,-76.7333,8.06667
16371,2013,Mayo,Polonia,5,2,,7,-77.35002,8.63337
16372,2013,Mayo,Portugal,0,1,,1,-69.941498,4.191162
16373,2013,Mayo,Portugal,0,1,,1,-76.876446,0.33002
16374,2013,Mayo,Portugal,1,4,,5,-77.35600000000001,0.81488
16375,2013,Mayo,Portugal,0,1,,1,-75.527794,10.406342
16376,2013,Mayo,Portugal,2,10,,12,-75.516486,10.446304
16377,2013,Mayo,Portugal,1,0,,1,-74.77647900000001,10.886686
16378,2013,Mayo,Portugal,0,1,,1,-74.765343,10.970933
16379,2013,Mayo,Portugal,1,0,,1,-81.70216500000001,12.5862
16380,2013,Mayo,Portugal,4,10,,14,-76.532004,3.451668
16381,2013,Mayo,Portugal,194,470,,664,-74.140516,4.697157
16382,2013,Mayo,Portugal,0,11,,11,-75.42726,6.170465
16383,2013,Mayo,Portugal,0,1,,1,-72.453013,7.819
16384,2013,Mayo,Portugal,1,0,,1,-77.35002,8.63337
16385,2013,Mayo,Puerto Rico/Territorio de Estados Unidos,1,0,,1,-74.77647900000001,10.886686
16386,2013,Mayo,Puerto Rico/Territorio de Estados Unidos,1,0,,1,-76.532004,3.451668
16387,2013,Mayo,Puerto Rico/Territorio de Estados Unidos,2,0,,2,-75.42726,6.170465
16388,2013,Mayo,Qatar,0,1,,1,-74.77647900000001,10.886686
16389,2013,Mayo,Qatar,0,1,,1,-74.140516,4.697157
16390,2013,Mayo,Reino Unido de Gran Bretaña e Irlanda del Norte,6,13,,19,-69.941498,4.191162
16391,2013,Mayo,Reino Unido de Gran Bretaña e Irlanda del Norte,20,38,,58,-77.35600000000001,0.81488
16392,2013,Mayo,Reino Unido de Gran Bretaña e Irlanda del Norte,13,38,,51,-75.516486,10.446304
16393,2013,Mayo,Reino Unido de Gran Bretaña e Irlanda del Norte,0,4,,4,-74.77647900000001,10.886686
16394,2013,Mayo,Reino Unido de Gran Bretaña e Irlanda del Norte,1,1,,2,-72.129595,11.360028999999999
16395,2013,Mayo,Reino Unido de Gran Bretaña e Irlanda del Norte,0,1,,1,-81.70216500000001,12.5862
16396,2013,Mayo,Reino Unido de Gran Bretaña e Irlanda del Norte,6,18,,24,-76.532004,3.451668
16397,2013,Mayo,Reino Unido de Gran Bretaña e Irlanda del Norte,181,479,,660,-74.140516,4.697157
16398,2013,Mayo,Reino Unido de Gran Bretaña e Irlanda del Norte,10,25,,35,-75.42726,6.170465
16399,2013,Mayo,República de Belarús,1,0,,1,-76.532004,3.451668
16400,2013,Mayo,República de Belarús,1,3,,4,-74.140516,4.697157
16401,2013,Mayo,República Dominicana,1,15,,16,-77.35600000000001,0.81488
16402,2013,Mayo,República Dominicana,17,47,,64,-75.516486,10.446304
16403,2013,Mayo,República Dominicana,8,17,,25,-74.77647900000001,10.886686
16404,2013,Mayo,República Dominicana,2,3,,5,-72.129595,11.360028999999999
16405,2013,Mayo,República Dominicana,0,2,,2,-81.70216500000001,12.5862
16406,2013,Mayo,República Dominicana,15,22,,37,-76.532004,3.451668
16407,2013,Mayo,República Dominicana,1,0,,1,-75.76635300000001,4.45285
16408,2013,Mayo,República Dominicana,212,354,,566,-74.140516,4.697157
16409,2013,Mayo,República Dominicana,0,1,,1,-75.736374,4.815189
16410,2013,Mayo,República Dominicana,45,80,,125,-75.42726,6.170465
16411,2013,Mayo,República Dominicana,1,0,,1,-73.181317,7.1280470000000005
16412,2013,Mayo,República Dominicana,0,3,,3,-72.453013,7.819
16413,2013,Mayo,República Dominicana,2,7,,9,-72.508188,7.927233
16414,2013,Mayo,República Checa,2,2,,4,-74.140516,4.697157
16415,2013,Mayo,Rumania,4,7,,11,-75.527794,10.406342
16416,2013,Mayo,Rumania,4,6,,10,-75.516486,10.446304
16417,2013,Mayo,Rumania,0,1,,1,-74.765343,10.970933
16418,2013,Mayo,Rumania,0,1,,1,-72.129595,11.360028999999999
16419,2013,Mayo,Rumania,3,2,,5,-76.532004,3.451668
16420,2013,Mayo,Rumania,20,38,,58,-74.140516,4.697157
16421,2013,Mayo,Rumania,0,3,,3,-75.42726,6.170465
16422,2013,Mayo,Federación de Rusia,20,18,,38,-77.35600000000001,0.81488
16423,2013,Mayo,Federación de Rusia,3,1,,4,-75.516486,10.446304
16424,2013,Mayo,Federación de Rusia,0,8,,8,-74.77647900000001,10.886686
16425,2013,Mayo,Federación de Rusia,0,1,,1,-72.129595,11.360028999999999
16426,2013,Mayo,Federación de Rusia,1,0,,1,-76.532004,3.451668
16427,2013,Mayo,Federación de Rusia,0,1,,1,-77.061029,3.8844260000000004
16428,2013,Mayo,Federación de Rusia,20,14,,34,-74.140516,4.697157
16429,2013,Mayo,Federación de Rusia,0,1,,1,-75.42726,6.170465
16430,2013,Mayo,Federación de Rusia,1,0,,1,-73.181317,7.1280470000000005
16431,2013,Mayo,Federación de Rusia,0,4,,4,-75.68164200000001,9.402597
16432,2013,Mayo,San Cristóbal y Nevis,1,1,,2,-75.516486,10.446304
16433,2013,Mayo,San Cristóbal y Nevis,1,0,,1,-76.532004,3.451668
16434,2013,Mayo,San Cristóbal y Nevis,1,1,,2,-75.42726,6.170465
16435,2013,Mayo,San  Vicente y las Granadinas,0,1,,1,-74.140516,4.697157
16436,2013,Mayo,Santa Lucia,1,0,,1,-75.516486,10.446304
16437,2013,Mayo,Santa Lucia,1,1,,2,-74.140516,4.697157
16438,2013,Mayo,Santa Sede/Ciudad del Vaticano,0,3,,3,-74.140516,4.697157
16439,2013,Mayo,Senegal,0,1,,1,-74.140516,4.697157
16440,2013,Mayo,Serbia,1,1,,2,-75.516486,10.446304
16441,2013,Mayo,Serbia,0,1,,1,-76.532004,3.451668
16442,2013,Mayo,Serbia,3,7,,10,-74.140516,4.697157
16443,2013,Mayo,Serbia,0,1,,1,-75.42726,6.170465
16444,2013,Mayo,Singapur,3,1,,4,-75.516486,10.446304
16445,2013,Mayo,Singapur,1,0,,1,-74.77647900000001,10.886686
16446,2013,Mayo,Singapur,6,11,,17,-74.140516,4.697157
16447,2013,Mayo,Singapur,3,4,,7,-75.42726,6.170465
16448,2013,Mayo,Singapur,0,1,,1,-72.453013,7.819
16449,2013,Mayo,República Árabe Siria,0,1,,1,-74.140516,4.697157
16450,2013,Mayo,Sri Lanka,3,5,,8,-74.140516,4.697157
16451,2013,Mayo,Sudáfrica,0,1,,1,-77.35600000000001,0.81488
16452,2013,Mayo,Sudáfrica,2,2,,4,-75.516486,10.446304
16453,2013,Mayo,Sudáfrica,0,2,,2,-74.77647900000001,10.886686
16454,2013,Mayo,Sudáfrica,2,1,,3,-74.213989,11.247722999999999
16455,2013,Mayo,Sudáfrica,0,1,,1,-72.129595,11.360028999999999
16456,2013,Mayo,Sudáfrica,25,69,,94,-74.140516,4.697157
16457,2013,Mayo,Sudáfrica,4,5,,9,-75.42726,6.170465
16458,2013,Mayo,Sudáfrica,1,0,,1,-72.453013,7.819
16459,2013,Mayo,Suecia,1,0,,1,-69.941498,4.191162
16460,2013,Mayo,Suecia,8,16,,24,-77.35600000000001,0.81488
16461,2013,Mayo,Suecia,2,5,,7,-75.516486,10.446304
16462,2013,Mayo,Suecia,0,3,,3,-74.213989,11.247722999999999
16463,2013,Mayo,Suecia,7,9,,16,-76.532004,3.451668
16464,2013,Mayo,Suecia,96,160,,256,-74.140516,4.697157
16465,2013,Mayo,Suecia,3,10,,13,-75.42726,6.170465
16466,2013,Mayo,Suecia,0,1,,1,-73.181317,7.1280470000000005
16467,2013,Mayo,Suecia,0,2,,2,-72.453013,7.819
16468,2013,Mayo,Suiza,2,3,,5,-69.941498,4.191162
16469,2013,Mayo,Suiza,2,0,,2,-76.876446,0.33002
16470,2013,Mayo,Suiza,28,25,,53,-77.35600000000001,0.81488
16471,2013,Mayo,Suiza,4,2,,6,-75.527794,10.406342
16472,2013,Mayo,Suiza,88,98,,186,-75.516486,10.446304
16473,2013,Mayo,Suiza,3,3,,6,-74.77647900000001,10.886686
16474,2013,Mayo,Suiza,0,1,,1,-74.213989,11.247722999999999
16475,2013,Mayo,Suiza,2,4,,6,-72.129595,11.360028999999999
16476,2013,Mayo,Suiza,2,2,,4,-81.70216500000001,12.5862
16477,2013,Mayo,Suiza,15,32,,47,-76.532004,3.451668
16478,2013,Mayo,Suiza,168,380,,548,-74.140516,4.697157
16479,2013,Mayo,Suiza,1,0,,1,-75.736374,4.815189
16480,2013,Mayo,Suiza,15,32,,47,-75.42726,6.170465
16481,2013,Mayo,Suiza,0,1,,1,-73.181317,7.1280470000000005
16482,2013,Mayo,Suiza,1,3,,4,-72.453013,7.819
16483,2013,Mayo,Suiza,3,7,,10,-77.35002,8.63337
16484,2013,Mayo,Surinam,1,0,,1,-75.516486,10.446304
16485,2013,Mayo,Surinam,0,1,,1,-74.77647900000001,10.886686
16486,2013,Mayo,Surinam,4,14,,18,-74.140516,4.697157
16487,2013,Mayo,Surinam,7,9,,16,-75.42726,6.170465
16488,2013,Mayo,Surinam,0,1,,1,-73.181317,7.1280470000000005
16489,2013,Mayo,Taiwán,4,4,,8,-74.140516,4.697157
16490,2013,Mayo,Tailandia,1,1,,2,-77.35600000000001,0.81488
16491,2013,Mayo,Tailandia,1,0,,1,-75.516486,10.446304
16492,2013,Mayo,Tailandia,5,3,,8,-74.140516,4.697157
16493,2013,Mayo,Tailandia,1,4,,5,-75.42726,6.170465
16494,2013,Mayo,Tíbet/Región Autónoma de China,2,1,,3,-74.140516,4.697157
16495,2013,Mayo,Territorio Antártico Británico/Territorio Británico de Ultramar,1,0,,1,-75.516486,10.446304
16496,2013,Mayo,Territorio Antártico Británico/Territorio Británico de Ultramar,0,1,,1,-74.140516,4.697157
16497,2013,Mayo,Tanzania,0,1,,1,-75.516486,10.446304
16498,2013,Mayo,Tanzania,0,3,,3,-74.140516,4.697157
16499,2013,Mayo,Togo,0,1,,1,-75.516486,10.446304
16500,2013,Mayo,Togo,0,2,,2,-74.140516,4.697157
16501,2013,Mayo,Trinidad y Tobago,2,7,,9,-75.516486,10.446304
16502,2013,Mayo,Trinidad y Tobago,0,1,,1,-74.77647900000001,10.886686
16503,2013,Mayo,Trinidad y Tobago,0,1,,1,-72.129595,11.360028999999999
16504,2013,Mayo,Trinidad y Tobago,1,2,,3,-76.532004,3.451668
16505,2013,Mayo,Trinidad y Tobago,11,35,,46,-74.140516,4.697157
16506,2013,Mayo,Trinidad y Tobago,0,2,,2,-75.736374,4.815189
16507,2013,Mayo,Trinidad y Tobago,2,10,,12,-75.42726,6.170465
16508,2013,Mayo,Trinidad y Tobago,1,1,,2,-73.181317,7.1280470000000005
16509,2013,Mayo,Trinidad y Tobago,0,1,,1,-72.453013,7.819
16510,2013,Mayo,Trinidad y Tobago,0,1,,1,-72.508188,7.927233
16511,2013,Mayo,Túnez,0,3,,3,-74.140516,4.697157
16512,2013,Mayo,Turquía,0,1,,1,-77.35600000000001,0.81488
16513,2013,Mayo,Turquía,0,1,,1,-75.527794,10.406342
16514,2013,Mayo,Turquía,0,4,,4,-75.516486,10.446304
16515,2013,Mayo,Turquía,0,1,,1,-74.765343,10.970933
16516,2013,Mayo,Turquía,0,2,,2,-76.532004,3.451668
16517,2013,Mayo,Turquía,0,2,,2,-77.061029,3.8844260000000004
16518,2013,Mayo,Turquía,23,69,,92,-74.140516,4.697157
16519,2013,Mayo,Turquía,1,4,,5,-75.42726,6.170465
16520,2013,Mayo,Turquía,0,2,,2,-72.453013,7.819
16521,2013,Mayo,Turquía,0,2,,2,-75.68164200000001,9.402597
16522,2013,Mayo,Turkmenistán,1,0,,1,-74.140516,4.697157
16523,2013,Mayo,Ucrania,0,1,,1,-77.35600000000001,0.81488
16524,2013,Mayo,Ucrania,0,2,,2,-75.516486,10.446304
16525,2013,Mayo,Ucrania,0,1,,1,-76.532004,3.451668
16526,2013,Mayo,Ucrania,14,18,,32,-74.140516,4.697157
16527,2013,Mayo,Ucrania,0,2,,2,-75.42726,6.170465
16528,2013,Mayo,Uganda,1,2,,3,-74.140516,4.697157
16529,2013,Mayo,Federación de Rusia,1,0,,1,-69.941498,4.191162
16530,2013,Mayo,Federación de Rusia,1,2,,3,-77.35600000000001,0.81488
16531,2013,Mayo,Federación de Rusia,4,5,,9,-75.516486,10.446304
16532,2013,Mayo,Federación de Rusia,0,4,,4,-74.765343,10.970933
16533,2013,Mayo,Federación de Rusia,0,10,,10,-74.213989,11.247722999999999
16534,2013,Mayo,Federación de Rusia,0,1,,1,-72.129595,11.360028999999999
16535,2013,Mayo,Federación de Rusia,1,2,,3,-76.532004,3.451668
16536,2013,Mayo,Federación de Rusia,58,125,,183,-74.140516,4.697157
16537,2013,Mayo,Federación de Rusia,2,2,,4,-75.42726,6.170465
16538,2013,Mayo,Federación de Rusia,0,5,,5,-72.453013,7.819
16539,2013,Mayo,Uruguay,1,2,,3,-69.941498,4.191162
16540,2013,Mayo,Uruguay,3,11,,14,-77.35600000000001,0.81488
16541,2013,Mayo,Uruguay,1,2,,3,-75.527794,10.406342
16542,2013,Mayo,Uruguay,159,84,,243,-75.516486,10.446304
16543,2013,Mayo,Uruguay,0,1,,1,-72.129595,11.360028999999999
16544,2013,Mayo,Uruguay,25,20,,45,-81.70216500000001,12.5862
16545,2013,Mayo,Uruguay,10,34,,44,-76.532004,3.451668
16546,2013,Mayo,Uruguay,167,332,,499,-74.140516,4.697157
16547,2013,Mayo,Uruguay,1,3,,4,-75.736374,4.815189
16548,2013,Mayo,Uruguay,25,40,,65,-75.42726,6.170465
16549,2013,Mayo,Uruguay,1,27,,28,-72.453013,7.819
16550,2013,Mayo,Uzbekistán,0,1,,1,-75.516486,10.446304
16551,2013,Mayo,Venezuela,1,1,,2,-69.941498,4.191162
16552,2013,Mayo,Venezuela,0,1,,1,-76.876446,0.33002
16553,2013,Mayo,Venezuela,40,57,,97,-77.35600000000001,0.81488
16554,2013,Mayo,Venezuela,0,1,,1,-75.527794,10.406342
16555,2013,Mayo,Venezuela,117,178,,295,-75.516486,10.446304
16556,2013,Mayo,Venezuela,42,82,,124,-74.77647900000001,10.886686
16557,2013,Mayo,Venezuela,0,1,,1,-74.765343,10.970933
16558,2013,Mayo,Venezuela,0,1,,1,-74.213989,11.247722999999999
16559,2013,Mayo,Venezuela,909,1365,,2274,-72.129595,11.360028999999999
16560,2013,Mayo,Venezuela,1,1,,2,-72.919186,11.52863
16561,2013,Mayo,Venezuela,4,4,,8,-81.70216500000001,12.5862
16562,2013,Mayo,Venezuela,46,102,,148,-76.532004,3.451668
16563,2013,Mayo,Venezuela,1,0,,1,-75.76635300000001,4.45285
16564,2013,Mayo,Venezuela,4629,6187,,10816,-74.140516,4.697157
16565,2013,Mayo,Venezuela,2,11,,13,-75.736374,4.815189
16566,2013,Mayo,Venezuela,267,440,,707,-75.42726,6.170465
16567,2013,Mayo,Venezuela,78,176,,254,-67.48402800000001,6.185536
16568,2013,Mayo,Venezuela,52,67,,119,-70.74025300000001,7.088728999999999
16569,2013,Mayo,Venezuela,4,3,,7,-73.181317,7.1280470000000005
16570,2013,Mayo,Venezuela,905,1117,,2022,-72.453013,7.819
16571,2013,Mayo,Venezuela,100,151,,251,-72.508188,7.927233
16572,2013,Mayo,Vietnam,0,1,,1,-74.140516,4.697157
16573,2013,Mayo,Vietnam,0,12,,12,-75.736374,4.815189
16574,2013,Mayo,Islas Vírgenes Británicas/Territorio Británico de Ultramar,0,1,,1,-76.532004,3.451668
16575,2013,Mayo,Zimbabue,0,4,,4,-74.140516,4.697157
16576,2013,Mayo,Islas Turcas y Caicos/Territorio Británico de Ultramar,1,1,,2,-74.140516,4.697157
16577,2013,Mayo,Reino Unido de Gran Bretaña e Irlanda del Norte,7,7,,14,-69.941498,4.191162
16578,2013,Mayo,Reino Unido de Gran Bretaña e Irlanda del Norte,81,89,,170,-77.35600000000001,0.81488
16579,2013,Mayo,Reino Unido de Gran Bretaña e Irlanda del Norte,1,2,,3,-75.527794,10.406342
16580,2013,Mayo,Reino Unido de Gran Bretaña e Irlanda del Norte,16,40,,56,-75.516486,10.446304
16581,2013,Mayo,Reino Unido de Gran Bretaña e Irlanda del Norte,0,3,,3,-74.77647900000001,10.886686
16582,2013,Mayo,Reino Unido de Gran Bretaña e Irlanda del Norte,0,1,,1,-74.213989,11.247722999999999
16583,2013,Mayo,Reino Unido de Gran Bretaña e Irlanda del Norte,3,5,,8,-72.129595,11.360028999999999
16584,2013,Mayo,Reino Unido de Gran Bretaña e Irlanda del Norte,0,1,,1,-81.70216500000001,12.5862
16585,2013,Mayo,Reino Unido de Gran Bretaña e Irlanda del Norte,2,2,,4,-81.372937,13.338761300000002
16586,2013,Mayo,Reino Unido de Gran Bretaña e Irlanda del Norte,8,22,,30,-76.532004,3.451668
16587,2013,Mayo,Reino Unido de Gran Bretaña e Irlanda del Norte,210,530,,740,-74.140516,4.697157
16588,2013,Mayo,Reino Unido de Gran Bretaña e Irlanda del Norte,0,2,,2,-75.736374,4.815189
16589,2013,Mayo,Reino Unido de Gran Bretaña e Irlanda del Norte,8,17,,25,-75.42726,6.170465
16590,2013,Mayo,Reino Unido de Gran Bretaña e Irlanda del Norte,3,2,,5,-72.453013,7.819
16591,2013,Mayo,Reino Unido de Gran Bretaña e Irlanda del Norte,0,1,,1,-72.508188,7.927233
16592,2013,Mayo,Reino Unido de Gran Bretaña e Irlanda del Norte,9,10,,19,-77.35002,8.63337
16593,2013,Mayo,Países Bajos,3,2,,5,-69.941498,4.191162
16594,2013,Mayo,Países Bajos,20,26,,46,-77.35600000000001,0.81488
16595,2013,Mayo,Países Bajos,9,37,,46,-75.516486,10.446304
16596,2013,Mayo,Países Bajos,0,4,,4,-74.77647900000001,10.886686
16597,2013,Mayo,Países Bajos,3,2,,5,-74.213989,11.247722999999999
16598,2013,Mayo,Países Bajos,2,2,,4,-72.129595,11.360028999999999
16599,2013,Mayo,Países Bajos,1,1,,2,-81.70216500000001,12.5862
16600,2013,Mayo,Países Bajos,1,1,,2,-81.372937,13.338761300000002
16601,2013,Mayo,Países Bajos,20,66,,86,-76.532004,3.451668
16602,2013,Mayo,Países Bajos,312,669,,981,-74.140516,4.697157
16603,2013,Mayo,Países Bajos,0,4,,4,-75.736374,4.815189
16604,2013,Mayo,Países Bajos,70,96,,166,-75.42726,6.170465
16605,2013,Mayo,Países Bajos,1,6,,7,-73.181317,7.1280470000000005
16606,2013,Mayo,Países Bajos,1,4,,5,-72.453013,7.819
16607,2013,Mayo,Países Bajos,0,3,,3,-77.35002,8.63337
16608,2013,Mayo,Lituania,0,2,,2,-75.516486,10.446304
16609,2013,Mayo,Lituania,1,1,,2,-74.140516,4.697157
16610,2013,Mayo,Reino Unido de Gran Bretaña e Irlanda del Norte,1,1,,2,-74.213989,11.247722999999999
16611,2013,Mayo,Reino Unido de Gran Bretaña e Irlanda del Norte,0,1,,1,-77.35600000000001,0.81488
16612,2013,Mayo,Reino Unido de Gran Bretaña e Irlanda del Norte,0,1,,1,-76.532004,3.451668
16613,2013,Mayo,Reino Unido de Gran Bretaña e Irlanda del Norte,1,1,,2,-77.35600000000001,0.81488
16614,2013,Mayo,Reino Unido de Gran Bretaña e Irlanda del Norte,0,3,,3,-75.516486,10.446304
16615,2013,Mayo,Reino Unido de Gran Bretaña e Irlanda del Norte,5,8,,13,-74.140516,4.697157
16616,2013,Mayo,Letonia,1,0,,1,-74.140516,4.697157
16617,2013,Mayo,Letonia,0,2,,2,-75.68164200000001,9.402597
16618,2013,Mayo,Marruecos,0,1,,1,-75.42726,6.170465
16619,2013,Junio,Afganistán,0,3,,3,-74.140516,4.697157
16620,2013,Junio,Albania,0,2,,2,-76.532004,3.451668
16621,2013,Junio,Albania,1,2,,3,-74.140516,4.697157
16622,2013,Junio,Alemania,6,15,,21,-69.941498,4.191162
16623,2013,Junio,Alemania,1,0,,1,-76.876446,0.33002
16624,2013,Junio,Alemania,58,64,,122,-77.35600000000001,0.81488
16625,2013,Junio,Alemania,0,1,,1,-78.802679,18.00143
16626,2013,Junio,Alemania,14,20,,34,-75.527794,10.406342
16627,2013,Junio,Alemania,22,35,,57,-75.516486,10.446304
16628,2013,Junio,Alemania,7,15,,22,-74.77647900000001,10.886686
16629,2013,Junio,Alemania,1,1,,2,-74.765343,10.970933
16630,2013,Junio,Alemania,1,2,,3,-74.213989,11.247722999999999
16631,2013,Junio,Alemania,5,5,,10,-72.129595,11.360028999999999
16632,2013,Junio,Alemania,2,1,,3,-81.70216500000001,12.5862
16633,2013,Junio,Alemania,2,2,,4,-81.372937,13.338761300000002
16634,2013,Junio,Alemania,26,51,,77,-76.532004,3.451668
16635,2013,Junio,Alemania,981,1511,,2492,-74.140516,4.697157
16636,2013,Junio,Alemania,32,81,,113,-75.42726,6.170465
16637,2013,Junio,Alemania,0,1,,1,-70.74025300000001,7.088728999999999
16638,2013,Junio,Alemania,1,3,,4,-73.181317,7.1280470000000005
16639,2013,Junio,Alemania,3,15,,18,-72.453013,7.819
16640,2013,Junio,Alemania,2,0,,2,-72.508188,7.927233
16641,2013,Junio,Alemania,5,5,,10,-77.35002,8.63337
16642,2013,Junio,Andorra,0,8,,8,-74.140516,4.697157
16643,2013,Junio,Andorra,0,1,,1,-75.736374,4.815189
16644,2013,Junio,Andorra,0,2,,2,-75.42726,6.170465
16645,2013,Junio,Andorra,0,1,,1,-70.74025300000001,7.088728999999999
16646,2013,Junio,Angola,0,1,,1,-76.532004,3.451668
16647,2013,Junio,Angola,1,1,,2,-74.140516,4.697157
16648,2013,Junio,Antigua y Barbuda,0,2,,2,-74.140516,4.697157
16649,2013,Junio,Países Bajos,1,0,,1,-73.181317,7.1280470000000005
16650,2013,Junio,Arabia Saudita,1,1,,2,-75.42726,6.170465
16651,2013,Junio,Arabia Saudita,0,1,,1,-75.516486,10.446304
16652,2013,Junio,Arabia Saudita,0,9,,9,-74.140516,4.697157
16653,2013,Junio,Argelia,1,3,,4,-74.140516,4.697157
16654,2013,Junio,Argentina,3,4,,7,-69.941498,4.191162
16655,2013,Junio,Argentina,3,9,,12,-76.876446,0.33002
16656,2013,Junio,Argentina,70,144,,214,-77.35600000000001,0.81488
16657,2013,Junio,Argentina,117,95,,212,-75.527794,10.406342
16658,2013,Junio,Argentina,699,463,,1162,-75.516486,10.446304
16659,2013,Junio,Argentina,5,30,,35,-74.77647900000001,10.886686
16660,2013,Junio,Argentina,6,18,,24,-72.129595,11.360028999999999
16661,2013,Junio,Argentina,217,171,,388,-81.70216500000001,12.5862
16662,2013,Junio,Argentina,0,1,,1,-81.372937,13.338761300000002
16663,2013,Junio,Argentina,27,57,,84,-76.532004,3.451668
16664,2013,Junio,Argentina,1,1,,2,-75.76635300000001,4.45285
16665,2013,Junio,Argentina,2725,4243,,6968,-74.140516,4.697157
16666,2013,Junio,Argentina,0,3,,3,-75.736374,4.815189
16667,2013,Junio,Argentina,122,229,,351,-75.42726,6.170465
16668,2013,Junio,Argentina,2,3,,5,-73.181317,7.1280470000000005
16669,2013,Junio,Argentina,12,59,,71,-72.453013,7.819
16670,2013,Junio,Argentina,2,1,,3,-72.508188,7.927233
16671,2013,Junio,Argentina,2,13,,15,-77.35002,8.63337
16672,2013,Junio,Aruba,4,6,,10,-74.140516,4.697157
16673,2013,Junio,Australia,7,10,,17,-69.941498,4.191162
16674,2013,Junio,Australia,1,0,,1,-76.876446,0.33002
16675,2013,Junio,Australia,43,44,,87,-77.35600000000001,0.81488
16676,2013,Junio,Australia,21,30,,51,-75.527794,10.406342
16677,2013,Junio,Australia,25,20,,45,-75.516486,10.446304
16678,2013,Junio,Australia,1,9,,10,-74.77647900000001,10.886686
16679,2013,Junio,Australia,2,1,,3,-72.129595,11.360028999999999
16680,2013,Junio,Australia,0,2,,2,-81.372937,13.338761300000002
16681,2013,Junio,Australia,9,19,,28,-76.532004,3.451668
16682,2013,Junio,Australia,0,1,,1,-75.76635300000001,4.45285
16683,2013,Junio,Australia,182,328,,510,-74.140516,4.697157
16684,2013,Junio,Australia,1,1,,2,-75.736374,4.815189
16685,2013,Junio,Australia,14,45,,59,-75.42726,6.170465
16686,2013,Junio,Australia,3,2,,5,-72.453013,7.819
16687,2013,Junio,Australia,1,4,,5,-77.35002,8.63337
16688,2013,Junio,Austria,1,1,,2,-69.941498,4.191162
16689,2013,Junio,Austria,6,2,,8,-77.35600000000001,0.81488
16690,2013,Junio,Austria,1,3,,4,-75.527794,10.406342
16691,2013,Junio,Austria,5,5,,10,-75.516486,10.446304
16692,2013,Junio,Austria,2,1,,3,-74.77647900000001,10.886686
16693,2013,Junio,Austria,0,1,,1,-81.372937,13.338761300000002
16694,2013,Junio,Austria,1,10,,11,-76.532004,3.451668
16695,2013,Junio,Austria,67,162,,229,-74.140516,4.697157
16696,2013,Junio,Austria,1,14,,15,-75.42726,6.170465
16697,2013,Junio,Austria,0,1,,1,-72.453013,7.819
16698,2013,Junio,Austria,0,1,,1,-72.508188,7.927233
16699,2013,Junio,Austria,0,1,,1,-77.35002,8.63337
16700,2013,Junio,Azerbaiyán,0,1,,1,-76.532004,3.451668
16701,2013,Junio,Azerbaiyán,1,1,,2,-74.140516,4.697157
16702,2013,Junio,Bahamas,1,0,,1,-76.532004,3.451668
16703,2013,Junio,Bahamas,5,3,,8,-74.140516,4.697157
16704,2013,Junio,Bahamas,0,2,,2,-75.42726,6.170465
16705,2013,Junio,Bangladesh,1,0,,1,-76.532004,3.451668
16706,2013,Junio,Bangladesh,0,1,,1,-74.140516,4.697157
16707,2013,Junio,Bangladesh,0,2,,2,-72.453013,7.819
16708,2013,Junio,Barbados,0,1,,1,-75.516486,10.446304
16709,2013,Junio,Barbados,0,1,,1,-76.532004,3.451668
16710,2013,Junio,Barbados,5,6,,11,-74.140516,4.697157
16711,2013,Junio,Barbados,0,2,,2,-75.42726,6.170465
16712,2013,Junio,República de Belarús,1,0,,1,-75.527794,10.406342
16713,2013,Junio,República de Belarús,1,0,,1,-75.516486,10.446304
16714,2013,Junio,República de Belarús,1,3,,4,-74.140516,4.697157
16715,2013,Junio,Bélgica,1,3,,4,-69.941498,4.191162
16716,2013,Junio,Bélgica,14,13,,27,-77.35600000000001,0.81488
16717,2013,Junio,Bélgica,1,4,,5,-75.527794,10.406342
16718,2013,Junio,Bélgica,3,5,,8,-75.516486,10.446304
16719,2013,Junio,Bélgica,0,1,,1,-74.765343,10.970933
16720,2013,Junio,Bélgica,0,1,,1,-72.129595,11.360028999999999
16721,2013,Junio,Bélgica,1,2,,3,-81.372937,13.338761300000002
16722,2013,Junio,Bélgica,8,46,,54,-76.532004,3.451668
16723,2013,Junio,Bélgica,154,275,,429,-74.140516,4.697157
16724,2013,Junio,Bélgica,17,25,,42,-75.42726,6.170465
16725,2013,Junio,Bélgica,2,1,,3,-72.453013,7.819
16726,2013,Junio,Bélgica,0,1,,1,-77.35002,8.63337
16727,2013,Junio,Belice,0,3,,3,-75.516486,10.446304
16728,2013,Junio,Belice,0,1,,1,-81.70216500000001,12.5862
16729,2013,Junio,Belice,3,10,,13,-74.140516,4.697157
16730,2013,Junio,Belice,0,3,,3,-75.42726,6.170465
16731,2013,Junio,Bermudas/Territorio Británico de Ultramar,0,1,,1,-76.532004,3.451668
16732,2013,Junio,Bermudas/Territorio Británico de Ultramar,1,2,,3,-74.140516,4.697157
16733,2013,Junio,Bolivia,1,1,,2,-69.941498,4.191162
16734,2013,Junio,Bolivia,0,1,,1,-76.876446,0.33002
16735,2013,Junio,Bolivia,9,16,,25,-77.35600000000001,0.81488
16736,2013,Junio,Bolivia,1,1,,2,-75.527794,10.406342
16737,2013,Junio,Bolivia,11,7,,18,-75.516486,10.446304
16738,2013,Junio,Bolivia,1,0,,1,-74.77647900000001,10.886686
16739,2013,Junio,Bolivia,4,3,,7,-81.70216500000001,12.5862
16740,2013,Junio,Bolivia,7,19,,26,-76.532004,3.451668
16741,2013,Junio,Bolivia,0,1,,1,-75.76635300000001,4.45285
16742,2013,Junio,Bolivia,293,475,,768,-74.140516,4.697157
16743,2013,Junio,Bolivia,1,2,,3,-75.736374,4.815189
16744,2013,Junio,Bolivia,22,38,,60,-75.42726,6.170465
16745,2013,Junio,Bolivia,0,1,,1,-67.48402800000001,6.185536
16746,2013,Junio,Bolivia,1,3,,4,-72.453013,7.819
16747,2013,Junio,Bolivia,0,1,,1,-77.35002,8.63337
16748,2013,Junio,Bosnia y Herzegovina,2,8,,10,-74.140516,4.697157
16749,2013,Junio,Botsuana,0,2,,2,-74.140516,4.697157
16750,2013,Junio,Brasil,66,53,,119,-69.941498,4.191162
16751,2013,Junio,Brasil,10,17,,27,-77.35600000000001,0.81488
16752,2013,Junio,Brasil,41,24,,65,-75.527794,10.406342
16753,2013,Junio,Brasil,145,134,,279,-75.516486,10.446304
16754,2013,Junio,Brasil,7,28,,35,-74.77647900000001,10.886686
16755,2013,Junio,Brasil,0,1,,1,-74.213989,11.247722999999999
16756,2013,Junio,Brasil,11,11,,22,-72.129595,11.360028999999999
16757,2013,Junio,Brasil,31,23,,54,-81.70216500000001,12.5862
16758,2013,Junio,Brasil,20,65,,85,-76.532004,3.451668
16759,2013,Junio,Brasil,2310,3694,,6004,-74.140516,4.697157
16760,2013,Junio,Brasil,0,3,,3,-75.736374,4.815189
16761,2013,Junio,Brasil,64,137,,201,-75.42726,6.170465
16762,2013,Junio,Brasil,0,1,,1,-67.48402800000001,6.185536
16763,2013,Junio,Brasil,1,3,,4,-73.181317,7.1280470000000005
16764,2013,Junio,Brasil,7,41,,48,-72.453013,7.819
16765,2013,Junio,Brasil,1,2,,3,-72.508188,7.927233
16766,2013,Junio,Brasil,0,1,,1,-77.35002,8.63337
16767,2013,Junio,Bulgaria,0,1,,1,-75.516486,10.446304
16768,2013,Junio,Bulgaria,10,8,,18,-74.140516,4.697157
16769,2013,Junio,Burkina Faso,1,1,,2,-74.140516,4.697157
16770,2013,Junio,Cabo Verde,0,1,,1,-76.532004,3.451668
16771,2013,Junio,Cabo Verde,0,1,,1,-74.140516,4.697157
16772,2013,Junio,Islas Caimán/Territorio Británico de Ultramar,0,1,,1,-74.77647900000001,10.886686
16773,2013,Junio,Islas Caimán/Territorio Británico de Ultramar,2,4,,6,-81.70216500000001,12.5862
16774,2013,Junio,Islas Caimán/Territorio Británico de Ultramar,1,0,,1,-74.140516,4.697157
16775,2013,Junio,Camerún,1,0,,1,-77.35600000000001,0.81488
16776,2013,Junio,Camerún,1,0,,1,-72.129595,11.360028999999999
16777,2013,Junio,Camerún,0,1,,1,-76.532004,3.451668
16778,2013,Junio,Camerún,0,2,,2,-74.140516,4.697157
16779,2013,Junio,Camerún,0,1,,1,-75.42726,6.170465
16780,2013,Junio,Canadá,3,10,,13,-69.941498,4.191162
16781,2013,Junio,Canadá,12,16,,28,-77.35600000000001,0.81488
16782,2013,Junio,Canadá,6,9,,15,-75.527794,10.406342
16783,2013,Junio,Canadá,42,79,,121,-75.516486,10.446304
16784,2013,Junio,Canadá,8,27,,35,-74.77647900000001,10.886686
16785,2013,Junio,Canadá,0,2,,2,-74.213989,11.247722999999999
16786,2013,Junio,Canadá,1,4,,5,-72.129595,11.360028999999999
16787,2013,Junio,Canadá,0,3,,3,-81.70216500000001,12.5862
16788,2013,Junio,Canadá,56,54,,110,-76.532004,3.451668
16789,2013,Junio,Canadá,2,1,,3,-75.76635300000001,4.45285
16790,2013,Junio,Canadá,687,1206,,1893,-74.140516,4.697157
16791,2013,Junio,Canadá,0,3,,3,-75.736374,4.815189
16792,2013,Junio,Canadá,70,150,,220,-75.42726,6.170465
16793,2013,Junio,Canadá,2,4,,6,-73.181317,7.1280470000000005
16794,2013,Junio,Canadá,6,10,,16,-72.453013,7.819
16795,2013,Junio,Canadá,3,0,,3,-72.508188,7.927233
16796,2013,Junio,Canadá,3,1,,4,-77.35002,8.63337
16797,2013,Junio,España,0,1,,1,-76.876446,0.33002
16798,2013,Junio,España,3,15,,18,-77.35600000000001,0.81488
16799,2013,Junio,España,4,4,,8,-75.527794,10.406342
16800,2013,Junio,España,0,1,,1,-75.516486,10.446304
16801,2013,Junio,España,2,4,,6,-74.77647900000001,10.886686
16802,2013,Junio,España,0,1,,1,-74.213989,11.247722999999999
16803,2013,Junio,España,44,71,,115,-76.532004,3.451668
16804,2013,Junio,España,112,295,,407,-74.140516,4.697157
16805,2013,Junio,España,0,2,,2,-75.736374,4.815189
16806,2013,Junio,España,48,130,,178,-75.42726,6.170465
16807,2013,Junio,España,0,1,,1,-70.74025300000001,7.088728999999999
16808,2013,Junio,España,0,1,,1,-72.453013,7.819
16809,2013,Junio,República Democrática del Congo,1,0,,1,-74.140516,4.697157
16810,2013,Junio,República Democrática del Congo,0,2,,2,-72.453013,7.819
16811,2013,Junio,República de Corea,2,1,,3,-69.941498,4.191162
16812,2013,Junio,República de Corea,6,7,,13,-77.35600000000001,0.81488
16813,2013,Junio,República de Corea,4,8,,12,-75.516486,10.446304
16814,2013,Junio,República de Corea,0,1,,1,-74.77647900000001,10.886686
16815,2013,Junio,República de Corea,0,1,,1,-74.765343,10.970933
16816,2013,Junio,República de Corea,1,0,,1,-72.129595,11.360028999999999
16817,2013,Junio,República de Corea,1,0,,1,-81.70216500000001,12.5862
16818,2013,Junio,República de Corea,3,8,,11,-76.532004,3.451668
16819,2013,Junio,República de Corea,111,334,,445,-74.140516,4.697157
16820,2013,Junio,República de Corea,3,25,,28,-75.42726,6.170465
16821,2013,Junio,República de Corea,0,5,,5,-72.453013,7.819
16822,2013,Junio,Costa de Marfil,0,4,,4,-74.140516,4.697157
16823,2013,Junio,Costa Rica,1,2,,3,-77.35600000000001,0.81488
16824,2013,Junio,Costa Rica,30,44,,74,-75.516486,10.446304
16825,2013,Junio,Costa Rica,11,25,,36,-74.77647900000001,10.886686
16826,2013,Junio,Costa Rica,1,1,,2,-72.129595,11.360028999999999
16827,2013,Junio,Costa Rica,224,188,,412,-81.70216500000001,12.5862
16828,2013,Junio,Costa Rica,25,58,,83,-76.532004,3.451668
16829,2013,Junio,Costa Rica,489,871,,1360,-74.140516,4.697157
16830,2013,Junio,Costa Rica,1,9,,10,-75.736374,4.815189
16831,2013,Junio,Costa Rica,83,152,,235,-75.42726,6.170465
16832,2013,Junio,Costa Rica,2,2,,4,-72.453013,7.819
16833,2013,Junio,Costa Rica,0,1,,1,-72.508188,7.927233
16834,2013,Junio,Costa Rica,0,1,,1,-77.35002,8.63337
16835,2013,Junio,Croacia,0,3,,3,-75.527794,10.406342
16836,2013,Junio,Croacia,1,1,,2,-75.516486,10.446304
16837,2013,Junio,Croacia,0,9,,9,-76.532004,3.451668
16838,2013,Junio,Croacia,5,17,,22,-74.140516,4.697157
16839,2013,Junio,Croacia,0,2,,2,-75.42726,6.170465
16840,2013,Junio,Croacia,0,1,,1,-72.453013,7.819
16841,2013,Junio,Cuba,2,16,,18,-75.516486,10.446304
16842,2013,Junio,Cuba,4,5,,9,-74.77647900000001,10.886686
16843,2013,Junio,Cuba,18,40,,58,-76.532004,3.451668
16844,2013,Junio,Cuba,84,138,,222,-74.140516,4.697157
16845,2013,Junio,Cuba,1,1,,2,-75.736374,4.815189
16846,2013,Junio,Cuba,12,15,,27,-75.42726,6.170465
16847,2013,Junio,Cuba,1,1,,2,-73.181317,7.1280470000000005
16848,2013,Junio,Cuba,0,1,,1,-72.453013,7.819
16849,2013,Junio,Cuba,1,1,,2,-72.508188,7.927233
16850,2013,Junio,Curazao,3,5,,8,-74.140516,4.697157
16851,2013,Junio,Curazao,2,1,,3,-75.42726,6.170465
16852,2013,Junio,República Checa,2,5,,7,-77.35600000000001,0.81488
16853,2013,Junio,República Checa,0,1,,1,-75.516486,10.446304
16854,2013,Junio,República Checa,1,0,,1,-72.129595,11.360028999999999
16855,2013,Junio,República Checa,17,28,,45,-74.140516,4.697157
16856,2013,Junio,República Checa,3,0,,3,-75.42726,6.170465
16857,2013,Junio,República Checa,1,0,,1,-72.453013,7.819
16858,2013,Junio,República Checa,0,3,,3,-77.35002,8.63337
16859,2013,Junio,Chile,1,0,,1,-69.941498,4.191162
16860,2013,Junio,Chile,27,53,,80,-77.35600000000001,0.81488
16861,2013,Junio,Chile,46,41,,87,-75.527794,10.406342
16862,2013,Junio,Chile,88,66,,154,-75.516486,10.446304
16863,2013,Junio,Chile,3,13,,16,-74.77647900000001,10.886686
16864,2013,Junio,Chile,4,12,,16,-72.129595,11.360028999999999
16865,2013,Junio,Chile,41,25,,66,-81.70216500000001,12.5862
16866,2013,Junio,Chile,30,109,,139,-76.532004,3.451668
16867,2013,Junio,Chile,2499,3770,,6269,-74.140516,4.697157
16868,2013,Junio,Chile,0,5,,5,-75.736374,4.815189
16869,2013,Junio,Chile,39,87,,126,-75.42726,6.170465
16870,2013,Junio,Chile,1,1,,2,-73.181317,7.1280470000000005
16871,2013,Junio,Chile,7,31,,38,-72.453013,7.819
16872,2013,Junio,Chile,0,2,,2,-72.508188,7.927233
16873,2013,Junio,Chile,1,1,,2,-77.35002,8.63337
16874,2013,Junio,China,1,0,,1,-69.941498,4.191162
16875,2013,Junio,China,3,2,,5,-77.35600000000001,0.81488
16876,2013,Junio,China,4,3,,7,-75.516486,10.446304
16877,2013,Junio,China,2,4,,6,-74.77647900000001,10.886686
16878,2013,Junio,China,4,11,,15,-76.532004,3.451668
16879,2013,Junio,China,161,440,,601,-74.140516,4.697157
16880,2013,Junio,China,6,12,,18,-75.42726,6.170465
16881,2013,Junio,China,1,1,,2,-72.508188,7.927233
16882,2013,Junio,Taiwán,1,3,,4,-74.77647900000001,10.886686
16883,2013,Junio,Taiwán,3,5,,8,-76.532004,3.451668
16884,2013,Junio,Taiwán,43,61,,104,-74.140516,4.697157
16885,2013,Junio,Taiwán,0,1,,1,-75.736374,4.815189
16886,2013,Junio,Taiwán,5,8,,13,-75.42726,6.170465
16887,2013,Junio,Taiwán,0,1,,1,-72.453013,7.819
16888,2013,Junio,Chipre,0,2,,2,-74.140516,4.697157
16889,2013,Junio,Chipre,0,1,,1,-75.42726,6.170465
16890,2013,Junio,Dinamarca,0,5,,5,-69.941498,4.191162
16891,2013,Junio,Dinamarca,8,5,,13,-77.35600000000001,0.81488
16892,2013,Junio,Dinamarca,0,2,,2,-75.527794,10.406342
16893,2013,Junio,Dinamarca,3,7,,10,-75.516486,10.446304
16894,2013,Junio,Dinamarca,1,0,,1,-74.77647900000001,10.886686
16895,2013,Junio,Dinamarca,0,5,,5,-76.532004,3.451668
16896,2013,Junio,Dinamarca,51,111,,162,-74.140516,4.697157
16897,2013,Junio,Dinamarca,7,17,,24,-75.42726,6.170465
16898,2013,Junio,Dominica,0,1,,1,-75.527794,10.406342
16899,2013,Junio,Dominica,0,1,,1,-72.129595,11.360028999999999
16900,2013,Junio,Dominica,0,3,,3,-74.140516,4.697157
16901,2013,Junio,Ecuador,0,1,,1,-69.941498,4.191162
16902,2013,Junio,Ecuador,22,66,,88,-76.876446,0.33002
16903,2013,Junio,Ecuador,764,1506,,2270,-77.35600000000001,0.81488
16904,2013,Junio,Ecuador,1,141,,142,-78.802679,18.00143
16905,2013,Junio,Ecuador,11,51,,62,-75.527794,10.406342
16906,2013,Junio,Ecuador,18,23,,41,-75.516486,10.446304
16907,2013,Junio,Ecuador,1,5,,6,-74.77647900000001,10.886686
16908,2013,Junio,Ecuador,11,12,,23,-72.129595,11.360028999999999
16909,2013,Junio,Ecuador,5,6,,11,-81.70216500000001,12.5862
16910,2013,Junio,Ecuador,303,371,,674,-76.532004,3.451668
16911,2013,Junio,Ecuador,0,2,,2,-75.76635300000001,4.45285
16912,2013,Junio,Ecuador,1566,2670,,4236,-74.140516,4.697157
16913,2013,Junio,Ecuador,0,1,,1,-75.736374,4.815189
16914,2013,Junio,Ecuador,367,445,,812,-75.42726,6.170465
16915,2013,Junio,Ecuador,0,1,,1,-70.74025300000001,7.088728999999999
16916,2013,Junio,Ecuador,94,144,,238,-72.453013,7.819
16917,2013,Junio,Ecuador,0,7,,7,-72.508188,7.927233
16918,2013,Junio,Egipto,0,1,,1,-77.35600000000001,0.81488
16919,2013,Junio,Egipto,2,14,,16,-74.140516,4.697157
16920,2013,Junio,El Salvador,1,0,,1,-69.941498,4.191162
16921,2013,Junio,El Salvador,0,2,,2,-75.527794,10.406342
16922,2013,Junio,El Salvador,7,6,,13,-75.516486,10.446304
16923,2013,Junio,El Salvador,1,4,,5,-74.77647900000001,10.886686
16924,2013,Junio,El Salvador,2,2,,4,-81.70216500000001,12.5862
16925,2013,Junio,El Salvador,52,73,,125,-76.532004,3.451668
16926,2013,Junio,El Salvador,0,1,,1,-75.76635300000001,4.45285
16927,2013,Junio,El Salvador,373,633,,1006,-74.140516,4.697157
16928,2013,Junio,El Salvador,32,56,,88,-75.42726,6.170465
16929,2013,Junio,El Salvador,0,1,,1,-73.181317,7.1280470000000005
16930,2013,Junio,El Salvador,0,1,,1,-72.453013,7.819
16931,2013,Junio,El Salvador,0,1,,1,-77.35002,8.63337
16932,2013,Junio,Emiratos Árabes,0,1,,1,-76.532004,3.451668
16933,2013,Junio,Emiratos Árabes,2,11,,13,-74.140516,4.697157
16934,2013,Junio,España,4,3,,7,-69.941498,4.191162
16935,2013,Junio,España,1,2,,3,-76.876446,0.33002
16936,2013,Junio,España,20,33,,53,-77.35600000000001,0.81488
16937,2013,Junio,España,10,26,,36,-75.527794,10.406342
16938,2013,Junio,España,22,53,,75,-75.516486,10.446304
16939,2013,Junio,España,5,15,,20,-74.77647900000001,10.886686
16940,2013,Junio,España,2,2,,4,-74.765343,10.970933
16941,2013,Junio,España,0,1,,1,-74.213989,11.247722999999999
16942,2013,Junio,España,1,10,,11,-72.129595,11.360028999999999
16943,2013,Junio,España,1,0,,1,-72.919186,11.52863
16944,2013,Junio,España,4,7,,11,-81.70216500000001,12.5862
16945,2013,Junio,España,258,400,,658,-76.532004,3.451668
16946,2013,Junio,España,1,1,,2,-75.76635300000001,4.45285
16947,2013,Junio,España,1929,4588,,6517,-74.140516,4.697157
16948,2013,Junio,España,1,7,,8,-75.736374,4.815189
16949,2013,Junio,España,80,201,,281,-75.42726,6.170465
16950,2013,Junio,España,2,2,,4,-70.74025300000001,7.088728999999999
16951,2013,Junio,España,2,4,,6,-73.181317,7.1280470000000005
16952,2013,Junio,España,17,46,,63,-72.453013,7.819
16953,2013,Junio,España,3,1,,4,-77.35002,8.63337
16954,2013,Junio,Eslovaquia,2,3,,5,-77.35600000000001,0.81488
16955,2013,Junio,Eslovaquia,1,1,,2,-75.527794,10.406342
16956,2013,Junio,Eslovaquia,1,0,,1,-75.516486,10.446304
16957,2013,Junio,Eslovaquia,7,18,,25,-74.140516,4.697157
16958,2013,Junio,Eslovaquia,0,4,,4,-75.42726,6.170465
16959,2013,Junio,Eslovenia,0,2,,2,-75.527794,10.406342
16960,2013,Junio,Eslovenia,0,1,,1,-72.129595,11.360028999999999
16961,2013,Junio,Eslovenia,0,2,,2,-76.532004,3.451668
16962,2013,Junio,Eslovenia,11,21,,32,-74.140516,4.697157
16963,2013,Junio,Estados Unidos de América,13,31,,44,-69.941498,4.191162
16964,2013,Junio,Estados Unidos de América,0,1,,1,-76.876446,0.33002
16965,2013,Junio,Estados Unidos de América,57,84,,141,-77.35600000000001,0.81488
16966,2013,Junio,Estados Unidos de América,22,59,,81,-75.527794,10.406342
16967,2013,Junio,Estados Unidos de América,1461,2179,,3640,-75.516486,10.446304
16968,2013,Junio,Estados Unidos de América,505,778,,1283,-74.77647900000001,10.886686
16969,2013,Junio,Estados Unidos de América,6,10,,16,-72.129595,11.360028999999999
16970,2013,Junio,Estados Unidos de América,0,1,,1,-72.919186,11.52863
16971,2013,Junio,Estados Unidos de América,16,20,,36,-81.70216500000001,12.5862
16972,2013,Junio,Estados Unidos de América,1,4,,5,-81.372937,13.338761300000002
16973,2013,Junio,Estados Unidos de América,1526,1916,,3442,-76.532004,3.451668
16974,2013,Junio,Estados Unidos de América,162,165,,327,-75.76635300000001,4.45285
16975,2013,Junio,Estados Unidos de América,8580,13489,,22069,-74.140516,4.697157
16976,2013,Junio,Estados Unidos de América,182,212,,394,-75.736374,4.815189
16977,2013,Junio,Estados Unidos de América,2105,3378,,5483,-75.42726,6.170465
16978,2013,Junio,Estados Unidos de América,1,4,,5,-70.74025300000001,7.088728999999999
16979,2013,Junio,Estados Unidos de América,43,56,,99,-73.181317,7.1280470000000005
16980,2013,Junio,Estados Unidos de América,30,39,,69,-72.453013,7.819
16981,2013,Junio,Estados Unidos de América,21,19,,40,-72.508188,7.927233
16982,2013,Junio,Estados Unidos de América,5,7,,12,-77.35002,8.63337
16983,2013,Junio,Estonia,0,1,,1,-77.35600000000001,0.81488
16984,2013,Junio,Estonia,1,0,,1,-75.527794,10.406342
16985,2013,Junio,Estonia,3,0,,3,-74.140516,4.697157
16986,2013,Junio,Estonia,1,0,,1,-75.42726,6.170465
16987,2013,Junio,Etiopia,0,4,,4,-74.140516,4.697157
16988,2013,Junio,Filipinas,0,25,,25,-75.527794,10.406342
16989,2013,Junio,Filipinas,1,21,,22,-75.516486,10.446304
16990,2013,Junio,Filipinas,0,21,,21,-74.765343,10.970933
16991,2013,Junio,Filipinas,0,7,,7,-74.213989,11.247722999999999
16992,2013,Junio,Filipinas,0,17,,17,-76.532004,3.451668
16993,2013,Junio,Filipinas,0,1,,1,-77.061029,3.8844260000000004
16994,2013,Junio,Filipinas,17,75,,92,-74.140516,4.697157
16995,2013,Junio,Filipinas,2,3,,5,-75.42726,6.170465
16996,2013,Junio,Filipinas,0,1,,1,-72.453013,7.819
16997,2013,Junio,Filipinas,0,5,,5,-75.68164200000001,9.402597
16998,2013,Junio,Finlandia,4,3,,7,-77.35600000000001,0.81488
16999,2013,Junio,Finlandia,1,0,,1,-75.527794,10.406342
17000,2013,Junio,Finlandia,2,2,,4,-74.77647900000001,10.886686
17001,2013,Junio,Finlandia,0,1,,1,-76.532004,3.451668
17002,2013,Junio,Finlandia,36,40,,76,-74.140516,4.697157
17003,2013,Junio,Finlandia,0,2,,2,-75.42726,6.170465
17004,2013,Junio,Finlandia,1,0,,1,-72.453013,7.819
17005,2013,Junio,Francia,8,7,,15,-69.941498,4.191162
17006,2013,Junio,Francia,1,2,,3,-76.876446,0.33002
17007,2013,Junio,Francia,51,65,,116,-77.35600000000001,0.81488
17008,2013,Junio,Francia,6,15,,21,-75.527794,10.406342
17009,2013,Junio,Francia,13,15,,28,-75.516486,10.446304
17010,2013,Junio,Francia,3,4,,7,-74.77647900000001,10.886686
17011,2013,Junio,Francia,0,1,,1,-74.765343,10.970933
17012,2013,Junio,Francia,1,0,,1,-74.213989,11.247722999999999
17013,2013,Junio,Francia,4,5,,9,-72.129595,11.360028999999999
17014,2013,Junio,Francia,0,1,,1,-81.703935,12.574411099999999
17015,2013,Junio,Francia,2,3,,5,-81.70216500000001,12.5862
17016,2013,Junio,Francia,2,4,,6,-81.372937,13.338761300000002
17017,2013,Junio,Francia,28,48,,76,-76.532004,3.451668
17018,2013,Junio,Francia,864,1588,,2452,-74.140516,4.697157
17019,2013,Junio,Francia,0,2,,2,-75.736374,4.815189
17020,2013,Junio,Francia,41,86,,127,-75.42726,6.170465
17021,2013,Junio,Francia,5,8,,13,-72.453013,7.819
17022,2013,Junio,Francia,3,8,,11,-77.35002,8.63337
17023,2013,Junio,Georgia,1,1,,2,-74.140516,4.697157
17024,2013,Junio,Granada,0,1,,1,-76.532004,3.451668
17025,2013,Junio,Granada,0,2,,2,-74.140516,4.697157
17026,2013,Junio,Grecia,0,2,,2,-75.527794,10.406342
17027,2013,Junio,Grecia,0,1,,1,-75.516486,10.446304
17028,2013,Junio,Grecia,0,1,,1,-74.77647900000001,10.886686
17029,2013,Junio,Grecia,0,1,,1,-74.765343,10.970933
17030,2013,Junio,Grecia,0,1,,1,-74.213989,11.247722999999999
17031,2013,Junio,Grecia,0,3,,3,-76.532004,3.451668
17032,2013,Junio,Grecia,0,1,,1,-77.061029,3.8844260000000004
17033,2013,Junio,Grecia,13,50,,63,-74.140516,4.697157
17034,2013,Junio,Grecia,3,3,,6,-75.42726,6.170465
17035,2013,Junio,Grecia,0,2,,2,-72.453013,7.819
17036,2013,Junio,Guatemala,2,0,,2,-77.35600000000001,0.81488
17037,2013,Junio,Guatemala,2,4,,6,-75.527794,10.406342
17038,2013,Junio,Guatemala,32,51,,83,-75.516486,10.446304
17039,2013,Junio,Guatemala,3,12,,15,-74.77647900000001,10.886686
17040,2013,Junio,Guatemala,0,1,,1,-72.129595,11.360028999999999
17041,2013,Junio,Guatemala,6,6,,12,-81.70216500000001,12.5862
17042,2013,Junio,Guatemala,19,79,,98,-76.532004,3.451668
17043,2013,Junio,Guatemala,210,439,,649,-74.140516,4.697157
17044,2013,Junio,Guatemala,3,1,,4,-75.736374,4.815189
17045,2013,Junio,Guatemala,73,129,,202,-75.42726,6.170465
17046,2013,Junio,Guatemala,4,0,,4,-73.181317,7.1280470000000005
17047,2013,Junio,Guatemala,9,43,,52,-72.453013,7.819
17048,2013,Junio,Guatemala,6,38,,44,-72.508188,7.927233
17049,2013,Junio,Guatemala,0,4,,4,-77.35002,8.63337
17050,2013,Junio,Guyana,0,2,,2,-75.516486,10.446304
17051,2013,Junio,Guyana,0,1,,1,-74.77647900000001,10.886686
17052,2013,Junio,Guyana,9,12,,21,-74.140516,4.697157
17053,2013,Junio,Guyana,0,2,,2,-75.736374,4.815189
17054,2013,Junio,Guyana,1,2,,3,-75.42726,6.170465
17055,2013,Junio,Guayana Francesa/Departamento de Ultramar Francés,0,1,,1,-74.140516,4.697157
17056,2013,Junio,Haití,1,1,,2,-75.516486,10.446304
17057,2013,Junio,Haití,0,1,,1,-74.77647900000001,10.886686
17058,2013,Junio,Haití,0,2,,2,-76.532004,3.451668
17059,2013,Junio,Haití,6,9,,15,-74.140516,4.697157
17060,2013,Junio,Haití,2,1,,3,-75.42726,6.170465
17061,2013,Junio,Honduras,1,0,,1,-77.35600000000001,0.81488
17062,2013,Junio,Honduras,1,7,,8,-75.527794,10.406342
17063,2013,Junio,Honduras,12,18,,30,-75.516486,10.446304
17064,2013,Junio,Honduras,6,7,,13,-74.77647900000001,10.886686
17065,2013,Junio,Honduras,0,1,,1,-74.765343,10.970933
17066,2013,Junio,Honduras,1,2,,3,-81.70216500000001,12.5862
17067,2013,Junio,Honduras,16,32,,48,-76.532004,3.451668
17068,2013,Junio,Honduras,0,1,,1,-75.76635300000001,4.45285
17069,2013,Junio,Honduras,121,206,,327,-74.140516,4.697157
17070,2013,Junio,Honduras,19,28,,47,-75.42726,6.170465
17071,2013,Junio,Honduras,1,0,,1,-73.181317,7.1280470000000005
17072,2013,Junio,Honduras,2,0,,2,-72.453013,7.819
17073,2013,Junio,Honduras,1,0,,1,-72.508188,7.927233
17074,2013,Junio,Honduras,0,1,,1,-77.35002,8.63337
17075,2013,Junio,Hong Kong,2,0,,2,-74.140516,4.697157
17076,2013,Junio,Hungría,1,1,,2,-77.35600000000001,0.81488
17077,2013,Junio,Hungría,10,17,,27,-74.140516,4.697157
17078,2013,Junio,Hungría,1,0,,1,-75.42726,6.170465
17079,2013,Junio,India,3,2,,5,-77.35600000000001,0.81488
17080,2013,Junio,India,0,1,,1,-75.527794,10.406342
17081,2013,Junio,India,0,4,,4,-75.516486,10.446304
17082,2013,Junio,India,2,5,,7,-74.77647900000001,10.886686
17083,2013,Junio,India,0,1,,1,-74.765343,10.970933
17084,2013,Junio,India,0,1,,1,-74.213989,11.247722999999999
17085,2013,Junio,India,0,2,,2,-81.70216500000001,12.5862
17086,2013,Junio,India,5,44,,49,-76.532004,3.451668
17087,2013,Junio,India,33,220,,253,-74.140516,4.697157
17088,2013,Junio,India,5,23,,28,-75.42726,6.170465
17089,2013,Junio,Indonesia,1,0,,1,-75.516486,10.446304
17090,2013,Junio,Indonesia,0,3,,3,-76.532004,3.451668
17091,2013,Junio,Indonesia,9,34,,43,-74.140516,4.697157
17092,2013,Junio,Iraq,0,1,,1,-74.140516,4.697157
17093,2013,Junio,Irán,9,16,,25,-74.140516,4.697157
17094,2013,Junio,Irán,0,1,,1,-75.42726,6.170465
17095,2013,Junio,República de Irlanda,2,2,,4,-69.941498,4.191162
17096,2013,Junio,República de Irlanda,1,0,,1,-76.876446,0.33002
17097,2013,Junio,República de Irlanda,31,17,,48,-77.35600000000001,0.81488
17098,2013,Junio,República de Irlanda,4,4,,8,-75.527794,10.406342
17099,2013,Junio,República de Irlanda,5,8,,13,-75.516486,10.446304
17100,2013,Junio,República de Irlanda,1,4,,5,-72.129595,11.360028999999999
17101,2013,Junio,República de Irlanda,1,1,,2,-81.70216500000001,12.5862
17102,2013,Junio,República de Irlanda,0,2,,2,-76.532004,3.451668
17103,2013,Junio,República de Irlanda,81,114,,195,-74.140516,4.697157
17104,2013,Junio,República de Irlanda,9,6,,15,-75.42726,6.170465
17105,2013,Junio,República de Irlanda,2,0,,2,-72.453013,7.819
17106,2013,Junio,República de Irlanda,0,1,,1,-72.508188,7.927233
17107,2013,Junio,República de Irlanda,0,1,,1,-77.35002,8.63337
17108,2013,Junio,Islandia,0,1,,1,-76.532004,3.451668
17109,2013,Junio,Islandia,5,3,,8,-74.140516,4.697157
17110,2013,Junio,Islandia,1,0,,1,-72.453013,7.819
17111,2013,Junio,Isla de Man,0,1,,1,-69.941498,4.191162
17112,2013,Junio,Isla de Man,22,32,,54,-77.35600000000001,0.81488
17113,2013,Junio,Isla de Man,3,9,,12,-75.516486,10.446304
17114,2013,Junio,Isla de Man,0,1,,1,-74.77647900000001,10.886686
17115,2013,Junio,Isla de Man,2,11,,13,-76.532004,3.451668
17116,2013,Junio,Isla de Man,30,72,,102,-74.140516,4.697157
17117,2013,Junio,Isla de Man,18,37,,55,-75.42726,6.170465
17118,2013,Junio,Isla Johnston,0,1,,1,-76.532004,3.451668
17119,2013,Junio,Israel,2,0,,2,-69.941498,4.191162
17120,2013,Junio,Israel,22,85,,107,-77.35600000000001,0.81488
17121,2013,Junio,Israel,1,7,,8,-75.527794,10.406342
17122,2013,Junio,Israel,1,22,,23,-75.516486,10.446304
17123,2013,Junio,Israel,0,1,,1,-74.77647900000001,10.886686
17124,2013,Junio,Israel,0,1,,1,-74.213989,11.247722999999999
17125,2013,Junio,Israel,10,16,,26,-76.532004,3.451668
17126,2013,Junio,Israel,94,388,,482,-74.140516,4.697157
17127,2013,Junio,Israel,7,32,,39,-75.42726,6.170465
17128,2013,Junio,Israel,0,2,,2,-72.508188,7.927233
17129,2013,Junio,Israel,1,3,,4,-77.35002,8.63337
17130,2013,Junio,Isla Wake,12,5,,17,-72.508188,7.927233
17131,2013,Junio,Italia,1,1,,2,-69.941498,4.191162
17132,2013,Junio,Italia,12,31,,43,-77.35600000000001,0.81488
17133,2013,Junio,Italia,6,6,,12,-75.527794,10.406342
17134,2013,Junio,Italia,17,43,,60,-75.516486,10.446304
17135,2013,Junio,Italia,5,11,,16,-74.77647900000001,10.886686
17136,2013,Junio,Italia,1,3,,4,-74.213989,11.247722999999999
17137,2013,Junio,Italia,3,9,,12,-72.129595,11.360028999999999
17138,2013,Junio,Italia,9,5,,14,-81.70216500000001,12.5862
17139,2013,Junio,Italia,34,82,,116,-76.532004,3.451668
17140,2013,Junio,Italia,429,1351,,1780,-74.140516,4.697157
17141,2013,Junio,Italia,0,2,,2,-75.736374,4.815189
17142,2013,Junio,Italia,22,55,,77,-75.42726,6.170465
17143,2013,Junio,Italia,0,1,,1,-70.74025300000001,7.088728999999999
17144,2013,Junio,Italia,0,3,,3,-73.181317,7.1280470000000005
17145,2013,Junio,Italia,4,13,,17,-72.453013,7.819
17146,2013,Junio,Italia,0,1,,1,-72.508188,7.927233
17147,2013,Junio,Italia,1,7,,8,-77.35002,8.63337
17148,2013,Junio,Islas del Canal,0,1,,1,-74.77647900000001,10.886686
17149,2013,Junio,Islas del Canal,1,1,,2,-77.35002,8.63337
17150,2013,Junio,Jamaica,1,5,,6,-75.516486,10.446304
17151,2013,Junio,Jamaica,0,1,,1,-74.77647900000001,10.886686
17152,2013,Junio,Jamaica,2,11,,13,-81.70216500000001,12.5862
17153,2013,Junio,Jamaica,3,5,,8,-76.532004,3.451668
17154,2013,Junio,Jamaica,13,20,,33,-74.140516,4.697157
17155,2013,Junio,Jamaica,0,1,,1,-75.736374,4.815189
17156,2013,Junio,Jamaica,3,5,,8,-75.42726,6.170465
17157,2013,Junio,Japón,1,2,,3,-69.941498,4.191162
17158,2013,Junio,Japón,13,19,,32,-77.35600000000001,0.81488
17159,2013,Junio,Japón,1,2,,3,-75.527794,10.406342
17160,2013,Junio,Japón,3,6,,9,-75.516486,10.446304
17161,2013,Junio,Japón,2,6,,8,-74.77647900000001,10.886686
17162,2013,Junio,Japón,1,1,,2,-72.129595,11.360028999999999
17163,2013,Junio,Japón,5,17,,22,-76.532004,3.451668
17164,2013,Junio,Japón,82,400,,482,-74.140516,4.697157
17165,2013,Junio,Japón,2,36,,38,-75.42726,6.170465
17166,2013,Junio,Japón,4,2,,6,-72.453013,7.819
17167,2013,Junio,Japón,1,1,,2,-77.35002,8.63337
17168,2013,Junio,Jordania,0,1,,1,-76.532004,3.451668
17169,2013,Junio,Jordania,1,1,,2,-74.140516,4.697157
17170,2013,Junio,Jordania,0,1,,1,-75.42726,6.170465
17171,2013,Junio,Kazajistán,4,1,,5,-74.140516,4.697157
17172,2013,Junio,Kazajistán,0,1,,1,-75.42726,6.170465
17173,2013,Junio,Kenia,1,0,,1,-76.532004,3.451668
17174,2013,Junio,Kenia,2,8,,10,-74.140516,4.697157
17175,2013,Junio,Kenia,0,1,,1,-75.42726,6.170465
17176,2013,Junio,Kenia,1,1,,2,-72.453013,7.819
17177,2013,Junio,Kirguistán,0,1,,1,-74.140516,4.697157
17178,2013,Junio,Kuwait,1,3,,4,-74.140516,4.697157
17179,2013,Junio,República de Kosovo,0,1,,1,-74.140516,4.697157
17180,2013,Junio,Letonia,0,1,,1,-75.527794,10.406342
17181,2013,Junio,Letonia,9,3,,12,-74.140516,4.697157
17182,2013,Junio,Letonia,1,0,,1,-75.42726,6.170465
17183,2013,Junio,Letonia,0,1,,1,-72.453013,7.819
17184,2013,Junio,Lituania,1,1,,2,-77.35600000000001,0.81488
17185,2013,Junio,Lituania,0,2,,2,-75.527794,10.406342
17186,2013,Junio,Lituania,1,2,,3,-75.516486,10.446304
17187,2013,Junio,Lituania,0,1,,1,-76.532004,3.451668
17188,2013,Junio,Lituania,8,11,,19,-74.140516,4.697157
17189,2013,Junio,Lituania,2,0,,2,-75.42726,6.170465
17190,2013,Junio,Líbano,0,1,,1,-77.35600000000001,0.81488
17191,2013,Junio,Líbano,0,2,,2,-74.77647900000001,10.886686
17192,2013,Junio,Líbano,5,5,,10,-72.129595,11.360028999999999
17193,2013,Junio,Líbano,0,1,,1,-76.532004,3.451668
17194,2013,Junio,Líbano,14,34,,48,-74.140516,4.697157
17195,2013,Junio,Líbano,1,1,,2,-75.42726,6.170465
17196,2013,Junio,Líbano,0,1,,1,-73.181317,7.1280470000000005
17197,2013,Junio,Libia,0,1,,1,-74.140516,4.697157
17198,2013,Junio,Luxemburgo,1,6,,7,-74.140516,4.697157
17199,2013,Junio,Macedonia,0,1,,1,-75.516486,10.446304
17200,2013,Junio,Macedonia,0,2,,2,-74.140516,4.697157
17201,2013,Junio,Madagascar,0,1,,1,-74.140516,4.697157
17202,2013,Junio,Malasia,1,0,,1,-69.941498,4.191162
17203,2013,Junio,Malasia,2,1,,3,-77.35600000000001,0.81488
17204,2013,Junio,Malasia,0,1,,1,-75.516486,10.446304
17205,2013,Junio,Malasia,0,1,,1,-76.532004,3.451668
17206,2013,Junio,Malasia,6,20,,26,-74.140516,4.697157
17207,2013,Junio,Malasia,0,1,,1,-75.42726,6.170465
17208,2013,Junio,Malasia,1,0,,1,-77.35002,8.63337
17209,2013,Junio,Malí,0,1,,1,-74.140516,4.697157
17210,2013,Junio,Malta,1,1,,2,-74.140516,4.697157
17211,2013,Junio,Marruecos,3,7,,10,-74.140516,4.697157
17212,2013,Junio,Marruecos,0,2,,2,-75.42726,6.170465
17213,2013,Junio,Mauricio,1,1,,2,-74.140516,4.697157
17214,2013,Junio,México,2,0,,2,-69.941498,4.191162
17215,2013,Junio,México,1,1,,2,-76.876446,0.33002
17216,2013,Junio,México,17,19,,36,-77.35600000000001,0.81488
17217,2013,Junio,México,7,17,,24,-75.527794,10.406342
17218,2013,Junio,México,94,193,,287,-75.516486,10.446304
17219,2013,Junio,México,19,56,,75,-74.77647900000001,10.886686
17220,2013,Junio,México,1,5,,6,-72.129595,11.360028999999999
17221,2013,Junio,México,1,3,,4,-81.70216500000001,12.5862
17222,2013,Junio,México,75,199,,274,-76.532004,3.451668
17223,2013,Junio,México,0,1,,1,-75.76635300000001,4.45285
17224,2013,Junio,México,1881,4328,,6209,-74.140516,4.697157
17225,2013,Junio,México,3,22,,25,-75.736374,4.815189
17226,2013,Junio,México,177,477,,654,-75.42726,6.170465
17227,2013,Junio,México,0,1,,1,-70.74025300000001,7.088728999999999
17228,2013,Junio,México,3,3,,6,-73.181317,7.1280470000000005
17229,2013,Junio,México,6,27,,33,-72.453013,7.819
17230,2013,Junio,México,2,2,,4,-72.508188,7.927233
17231,2013,Junio,México,1,4,,5,-77.35002,8.63337
17232,2013,Junio,República de Moldavia,1,1,,2,-74.140516,4.697157
17233,2013,Junio,República de Moldavia,1,0,,1,-75.42726,6.170465
17234,2013,Junio,Mónaco,0,1,,1,-74.140516,4.697157
17235,2013,Junio,Montenegro,0,1,,1,-74.140516,4.697157
17236,2013,Junio,Mozambique,0,1,,1,-76.876446,0.33002
17237,2013,Junio,Mozambique,0,1,,1,-74.140516,4.697157
17238,2013,Junio,Myanmar,2,3,,5,-74.140516,4.697157
17239,2013,Junio,Nepal,0,1,,1,-75.516486,10.446304
17240,2013,Junio,Nepal,4,4,,8,-74.140516,4.697157
17241,2013,Junio,Nepal,0,1,,1,-75.42726,6.170465
17242,2013,Junio,Nicaragua,1,0,,1,-77.35600000000001,0.81488
17243,2013,Junio,Nicaragua,4,7,,11,-75.516486,10.446304
17244,2013,Junio,Nicaragua,0,2,,2,-74.77647900000001,10.886686
17245,2013,Junio,Nicaragua,0,1,,1,-81.703935,12.574411099999999
17246,2013,Junio,Nicaragua,1,0,,1,-81.70216500000001,12.5862
17247,2013,Junio,Nicaragua,9,7,,16,-76.532004,3.451668
17248,2013,Junio,Nicaragua,48,60,,108,-74.140516,4.697157
17249,2013,Junio,Nicaragua,6,11,,17,-75.42726,6.170465
17250,2013,Junio,Nigeria,1,0,,1,-75.516486,10.446304
17251,2013,Junio,Nigeria,1,2,,3,-74.140516,4.697157
17252,2013,Junio,Noruega,0,1,,1,-69.941498,4.191162
17253,2013,Junio,Noruega,2,2,,4,-75.527794,10.406342
17254,2013,Junio,Noruega,5,7,,12,-75.516486,10.446304
17255,2013,Junio,Noruega,3,4,,7,-74.77647900000001,10.886686
17256,2013,Junio,Noruega,0,2,,2,-74.213989,11.247722999999999
17257,2013,Junio,Noruega,1,0,,1,-81.70216500000001,12.5862
17258,2013,Junio,Noruega,6,9,,15,-76.532004,3.451668
17259,2013,Junio,Noruega,79,120,,199,-74.140516,4.697157
17260,2013,Junio,Noruega,0,1,,1,-75.736374,4.815189
17261,2013,Junio,Noruega,8,17,,25,-75.42726,6.170465
17262,2013,Junio,Nueva Zelanda,1,0,,1,-69.941498,4.191162
17263,2013,Junio,Nueva Zelanda,3,14,,17,-77.35600000000001,0.81488
17264,2013,Junio,Nueva Zelanda,5,3,,8,-75.516486,10.446304
17265,2013,Junio,Nueva Zelanda,0,1,,1,-74.77647900000001,10.886686
17266,2013,Junio,Nueva Zelanda,0,1,,1,-76.532004,3.451668
17267,2013,Junio,Nueva Zelanda,25,54,,79,-74.140516,4.697157
17268,2013,Junio,Nueva Zelanda,2,6,,8,-75.42726,6.170465
17269,2013,Junio,Nueva Zelanda,0,1,,1,-72.453013,7.819
17270,2013,Junio,Nueva Zelanda,0,2,,2,-77.35002,8.63337
17271,2013,Junio,Nueva Zelanda,1,1,,2,-77.35600000000001,0.81488
17272,2013,Junio,Nueva Zelanda,2,6,,8,-75.527794,10.406342
17273,2013,Junio,Nueva Zelanda,1,2,,3,-75.516486,10.446304
17274,2013,Junio,Nueva Zelanda,1,0,,1,-74.77647900000001,10.886686
17275,2013,Junio,Nueva Zelanda,1,4,,5,-74.140516,4.697157
17276,2013,Junio,Nueva Zelanda,1,0,,1,-77.35002,8.63337
17277,2013,Junio,Países Bajos,0,2,,2,-69.941498,4.191162
17278,2013,Junio,Países Bajos,3,6,,9,-77.35600000000001,0.81488
17279,2013,Junio,Países Bajos,2,3,,5,-75.516486,10.446304
17280,2013,Junio,Países Bajos,1,5,,6,-74.77647900000001,10.886686
17281,2013,Junio,Países Bajos,5,8,,13,-72.129595,11.360028999999999
17282,2013,Junio,Países Bajos,22,19,,41,-72.919186,11.52863
17283,2013,Junio,Países Bajos,6,19,,25,-76.532004,3.451668
17284,2013,Junio,Países Bajos,190,229,,419,-74.140516,4.697157
17285,2013,Junio,Países Bajos,208,238,,446,-75.42726,6.170465
17286,2013,Junio,Países Bajos,4,2,,6,-73.181317,7.1280470000000005
17287,2013,Junio,Países Bajos,0,1,,1,-72.453013,7.819
17288,2013,Junio,Pakistán,0,1,,1,-77.35600000000001,0.81488
17289,2013,Junio,Pakistán,1,0,,1,-75.516486,10.446304
17290,2013,Junio,Pakistán,1,9,,10,-74.140516,4.697157
17291,2013,Junio,Pakistán,0,1,,1,-72.453013,7.819
17292,2013,Junio,Panamá,1,3,,4,-77.35600000000001,0.81488
17293,2013,Junio,Panamá,1,14,,15,-75.527794,10.406342
17294,2013,Junio,Panamá,105,132,,237,-75.516486,10.446304
17295,2013,Junio,Panamá,47,81,,128,-74.77647900000001,10.886686
17296,2013,Junio,Panamá,0,1,,1,-81.703935,12.574411099999999
17297,2013,Junio,Panamá,19,20,,39,-81.70216500000001,12.5862
17298,2013,Junio,Panamá,91,156,,247,-76.532004,3.451668
17299,2013,Junio,Panamá,432,778,,1210,-74.140516,4.697157
17300,2013,Junio,Panamá,72,82,,154,-75.736374,4.815189
17301,2013,Junio,Panamá,103,234,,337,-75.42726,6.170465
17302,2013,Junio,Panamá,0,1,,1,-67.48402800000001,6.185536
17303,2013,Junio,Panamá,6,8,,14,-73.181317,7.1280470000000005
17304,2013,Junio,Panamá,0,2,,2,-72.453013,7.819
17305,2013,Junio,Panamá,6,7,,13,-72.508188,7.927233
17306,2013,Junio,Panamá,2,3,,5,-77.35002,8.63337
17307,2013,Junio,Paraguay,0,2,,2,-77.35600000000001,0.81488
17308,2013,Junio,Paraguay,6,7,,13,-75.516486,10.446304
17309,2013,Junio,Paraguay,0,1,,1,-74.77647900000001,10.886686
17310,2013,Junio,Paraguay,1,2,,3,-72.129595,11.360028999999999
17311,2013,Junio,Paraguay,7,5,,12,-81.70216500000001,12.5862
17312,2013,Junio,Paraguay,5,5,,10,-76.532004,3.451668
17313,2013,Junio,Paraguay,132,237,,369,-74.140516,4.697157
17314,2013,Junio,Paraguay,5,10,,15,-75.42726,6.170465
17315,2013,Junio,Paraguay,2,23,,25,-72.453013,7.819
17316,2013,Junio,Perú,14,39,,53,-69.941498,4.191162
17317,2013,Junio,Perú,2,7,,9,-76.876446,0.33002
17318,2013,Junio,Perú,98,332,,430,-77.35600000000001,0.81488
17319,2013,Junio,Perú,24,21,,45,-75.527794,10.406342
17320,2013,Junio,Perú,137,117,,254,-75.516486,10.446304
17321,2013,Junio,Perú,22,167,,189,-74.77647900000001,10.886686
17322,2013,Junio,Perú,0,1,,1,-74.765343,10.970933
17323,2013,Junio,Perú,11,29,,40,-72.129595,11.360028999999999
17324,2013,Junio,Perú,69,45,,114,-81.70216500000001,12.5862
17325,2013,Junio,Perú,91,206,,297,-76.532004,3.451668
17326,2013,Junio,Perú,2126,3122,,5248,-74.140516,4.697157
17327,2013,Junio,Perú,2,4,,6,-75.736374,4.815189
17328,2013,Junio,Perú,225,451,,676,-75.42726,6.170465
17329,2013,Junio,Perú,1,1,,2,-70.74025300000001,7.088728999999999
17330,2013,Junio,Perú,0,2,,2,-73.181317,7.1280470000000005
17331,2013,Junio,Perú,39,78,,117,-72.453013,7.819
17332,2013,Junio,Perú,4,11,,15,-72.508188,7.927233
17333,2013,Junio,Perú,1,0,,1,-77.35002,8.63337
17334,2013,Junio,Palestina,1,2,,3,-74.140516,4.697157
17335,2013,Junio,Polonia,2,1,,3,-69.941498,4.191162
17336,2013,Junio,Polonia,8,3,,11,-77.35600000000001,0.81488
17337,2013,Junio,Polonia,3,5,,8,-75.527794,10.406342
17338,2013,Junio,Polonia,0,2,,2,-75.516486,10.446304
17339,2013,Junio,Polonia,0,3,,3,-74.765343,10.970933
17340,2013,Junio,Polonia,0,5,,5,-76.532004,3.451668
17341,2013,Junio,Polonia,0,1,,1,-77.061029,3.8844260000000004
17342,2013,Junio,Polonia,42,54,,96,-74.140516,4.697157
17343,2013,Junio,Polonia,1,0,,1,-75.736374,4.815189
17344,2013,Junio,Polonia,4,2,,6,-75.42726,6.170465
17345,2013,Junio,Polonia,1,2,,3,-72.453013,7.819
17346,2013,Junio,Polonia,0,1,,1,-76.7333,8.06667
17347,2013,Junio,Polonia,2,1,,3,-77.35002,8.63337
17348,2013,Junio,Portugal,1,1,,2,-69.941498,4.191162
17349,2013,Junio,Portugal,0,3,,3,-77.35600000000001,0.81488
17350,2013,Junio,Portugal,5,6,,11,-75.516486,10.446304
17351,2013,Junio,Portugal,0,1,,1,-72.129595,11.360028999999999
17352,2013,Junio,Portugal,1,8,,9,-76.532004,3.451668
17353,2013,Junio,Portugal,85,303,,388,-74.140516,4.697157
17354,2013,Junio,Portugal,0,1,,1,-75.736374,4.815189
17355,2013,Junio,Portugal,4,13,,17,-75.42726,6.170465
17356,2013,Junio,Portugal,1,5,,6,-72.453013,7.819
17357,2013,Junio,Portugal,0,2,,2,-72.508188,7.927233
17358,2013,Junio,Portugal,0,1,,1,-77.35002,8.63337
17359,2013,Junio,Puerto Rico/Territorio de Estados Unidos,1,0,,1,-75.516486,10.446304
17360,2013,Junio,Puerto Rico/Territorio de Estados Unidos,1,0,,1,-74.77647900000001,10.886686
17361,2013,Junio,Puerto Rico/Territorio de Estados Unidos,0,1,,1,-76.532004,3.451668
17362,2013,Junio,Puerto Rico/Territorio de Estados Unidos,1,0,,1,-74.140516,4.697157
17363,2013,Junio,Qatar,0,1,,1,-77.35600000000001,0.81488
17364,2013,Junio,Qatar,1,3,,4,-74.140516,4.697157
17365,2013,Junio,Qatar,0,1,,1,-75.42726,6.170465
17366,2013,Junio,Reino Unido de Gran Bretaña e Irlanda del Norte,4,7,,11,-69.941498,4.191162
17367,2013,Junio,Reino Unido de Gran Bretaña e Irlanda del Norte,7,10,,17,-77.35600000000001,0.81488
17368,2013,Junio,Reino Unido de Gran Bretaña e Irlanda del Norte,2,6,,8,-75.527794,10.406342
17369,2013,Junio,Reino Unido de Gran Bretaña e Irlanda del Norte,14,22,,36,-75.516486,10.446304
17370,2013,Junio,Reino Unido de Gran Bretaña e Irlanda del Norte,1,1,,2,-74.77647900000001,10.886686
17371,2013,Junio,Reino Unido de Gran Bretaña e Irlanda del Norte,0,1,,1,-74.213989,11.247722999999999
17372,2013,Junio,Reino Unido de Gran Bretaña e Irlanda del Norte,4,4,,8,-72.129595,11.360028999999999
17373,2013,Junio,Reino Unido de Gran Bretaña e Irlanda del Norte,0,3,,3,-72.919186,11.52863
17374,2013,Junio,Reino Unido de Gran Bretaña e Irlanda del Norte,12,22,,34,-76.532004,3.451668
17375,2013,Junio,Reino Unido de Gran Bretaña e Irlanda del Norte,234,498,,732,-74.140516,4.697157
17376,2013,Junio,Reino Unido de Gran Bretaña e Irlanda del Norte,1,1,,2,-75.736374,4.815189
17377,2013,Junio,Reino Unido de Gran Bretaña e Irlanda del Norte,10,23,,33,-75.42726,6.170465
17378,2013,Junio,Reino Unido de Gran Bretaña e Irlanda del Norte,0,4,,4,-72.453013,7.819
17379,2013,Junio,Reino Unido de Gran Bretaña e Irlanda del Norte,1,0,,1,-72.508188,7.927233
17380,2013,Junio,República de Belarús,1,0,,1,-75.516486,10.446304
17381,2013,Junio,República de Belarús,0,1,,1,-74.140516,4.697157
17382,2013,Junio,República Dominicana,2,7,,9,-77.35600000000001,0.81488
17383,2013,Junio,República Dominicana,0,1,,1,-75.527794,10.406342
17384,2013,Junio,República Dominicana,40,39,,79,-75.516486,10.446304
17385,2013,Junio,República Dominicana,7,52,,59,-74.77647900000001,10.886686
17386,2013,Junio,República Dominicana,0,2,,2,-72.129595,11.360028999999999
17387,2013,Junio,República Dominicana,0,2,,2,-72.919186,11.52863
17388,2013,Junio,República Dominicana,0,2,,2,-81.70216500000001,12.5862
17389,2013,Junio,República Dominicana,15,46,,61,-76.532004,3.451668
17390,2013,Junio,República Dominicana,198,357,,555,-74.140516,4.697157
17391,2013,Junio,República Dominicana,2,0,,2,-75.736374,4.815189
17392,2013,Junio,República Dominicana,35,59,,94,-75.42726,6.170465
17393,2013,Junio,República Dominicana,2,5,,7,-73.181317,7.1280470000000005
17394,2013,Junio,República Dominicana,0,3,,3,-72.453013,7.819
17395,2013,Junio,República Dominicana,0,1,,1,-72.508188,7.927233
17396,2013,Junio,República Checa,0,1,,1,-75.527794,10.406342
17397,2013,Junio,República Checa,1,0,,1,-74.77647900000001,10.886686
17398,2013,Junio,República Checa,6,6,,12,-74.140516,4.697157
17399,2013,Junio,República Checa,1,0,,1,-72.453013,7.819
17400,2013,Junio,Rumania,1,1,,2,-77.35600000000001,0.81488
17401,2013,Junio,Rumania,0,5,,5,-75.527794,10.406342
17402,2013,Junio,Rumania,1,0,,1,-75.516486,10.446304
17403,2013,Junio,Rumania,1,1,,2,-74.77647900000001,10.886686
17404,2013,Junio,Rumania,0,1,,1,-74.765343,10.970933
17405,2013,Junio,Rumania,1,3,,4,-76.532004,3.451668
17406,2013,Junio,Rumania,25,55,,80,-74.140516,4.697157
17407,2013,Junio,Rumania,3,6,,9,-75.42726,6.170465
17408,2013,Junio,Rumania,0,1,,1,-72.453013,7.819
17409,2013,Junio,Federación de Rusia,1,1,,2,-77.35600000000001,0.81488
17410,2013,Junio,Federación de Rusia,0,1,,1,-75.527794,10.406342
17411,2013,Junio,Federación de Rusia,1,1,,2,-75.516486,10.446304
17412,2013,Junio,Federación de Rusia,0,4,,4,-72.129595,11.360028999999999
17413,2013,Junio,Federación de Rusia,0,3,,3,-76.532004,3.451668
17414,2013,Junio,Federación de Rusia,1,0,,1,-75.76635300000001,4.45285
17415,2013,Junio,Federación de Rusia,15,18,,33,-74.140516,4.697157
17416,2013,Junio,Federación de Rusia,2,4,,6,-75.42726,6.170465
17417,2013,Junio,Federación de Rusia,1,1,,2,-73.181317,7.1280470000000005
17418,2013,Junio,Federación de Rusia,0,2,,2,-77.35002,8.63337
17419,2013,Junio,Federación de Rusia,0,1,,1,-75.68164200000001,9.402597
17420,2013,Junio,Rwanda,0,1,,1,-76.532004,3.451668
17421,2013,Junio,Rwanda,0,1,,1,-74.140516,4.697157
17422,2013,Junio,San Cristóbal y Nevis,0,6,,6,-74.140516,4.697157
17423,2013,Junio,San Cristóbal y Nevis,1,0,,1,-75.42726,6.170465
17424,2013,Junio,Samoa Occidental,1,0,,1,-74.140516,4.697157
17425,2013,Junio,San  Vicente y las Granadinas,1,5,,6,-74.140516,4.697157
17426,2013,Junio,San  Vicente y las Granadinas,0,1,,1,-75.42726,6.170465
17427,2013,Junio,Santa Lucia,1,0,,1,-75.516486,10.446304
17428,2013,Junio,Santa Lucia,0,1,,1,-74.77647900000001,10.886686
17429,2013,Junio,Santa Lucia,0,1,,1,-81.70216500000001,12.5862
17430,2013,Junio,Santa Lucia,2,1,,3,-74.140516,4.697157
17431,2013,Junio,Santa Lucia,0,1,,1,-75.42726,6.170465
17432,2013,Junio,Senegal,1,1,,2,-74.140516,4.697157
17433,2013,Junio,Serbia,1,1,,2,-75.527794,10.406342
17434,2013,Junio,Serbia,0,1,,1,-75.516486,10.446304
17435,2013,Junio,Serbia,3,7,,10,-74.140516,4.697157
17436,2013,Junio,Serbia,1,1,,2,-75.42726,6.170465
17437,2013,Junio,Singapur,2,1,,3,-75.516486,10.446304
17438,2013,Junio,Singapur,0,1,,1,-74.77647900000001,10.886686
17439,2013,Junio,Singapur,9,22,,31,-74.140516,4.697157
17440,2013,Junio,Singapur,5,0,,5,-75.42726,6.170465
17441,2013,Junio,República Árabe Siria,1,0,,1,-75.516486,10.446304
17442,2013,Junio,República Árabe Siria,1,1,,2,-74.140516,4.697157
17443,2013,Junio,República Árabe Siria,0,1,,1,-77.35002,8.63337
17444,2013,Junio,Sri Lanka,1,2,,3,-74.140516,4.697157
17445,2013,Junio,Sri Lanka,0,1,,1,-75.42726,6.170465
17446,2013,Junio,Sudáfrica,2,2,,4,-69.941498,4.191162
17447,2013,Junio,Sudáfrica,0,4,,4,-77.35600000000001,0.81488
17448,2013,Junio,Sudáfrica,3,0,,3,-75.527794,10.406342
17449,2013,Junio,Sudáfrica,1,5,,6,-75.516486,10.446304
17450,2013,Junio,Sudáfrica,1,0,,1,-74.77647900000001,10.886686
17451,2013,Junio,Sudáfrica,2,0,,2,-76.532004,3.451668
17452,2013,Junio,Sudáfrica,22,68,,90,-74.140516,4.697157
17453,2013,Junio,Sudáfrica,2,5,,7,-75.42726,6.170465
17454,2013,Junio,Suecia,2,11,,13,-69.941498,4.191162
17455,2013,Junio,Suecia,5,10,,15,-77.35600000000001,0.81488
17456,2013,Junio,Suecia,3,4,,7,-75.527794,10.406342
17457,2013,Junio,Suecia,9,10,,19,-75.516486,10.446304
17458,2013,Junio,Suecia,0,3,,3,-74.77647900000001,10.886686
17459,2013,Junio,Suecia,0,1,,1,-74.213989,11.247722999999999
17460,2013,Junio,Suecia,1,1,,2,-72.129595,11.360028999999999
17461,2013,Junio,Suecia,11,9,,20,-76.532004,3.451668
17462,2013,Junio,Suecia,160,223,,383,-74.140516,4.697157
17463,2013,Junio,Suecia,7,24,,31,-75.42726,6.170465
17464,2013,Junio,Suecia,0,1,,1,-73.181317,7.1280470000000005
17465,2013,Junio,Suecia,0,1,,1,-77.35002,8.63337
17466,2013,Junio,Suiza,2,5,,7,-69.941498,4.191162
17467,2013,Junio,Suiza,0,1,,1,-76.876446,0.33002
17468,2013,Junio,Suiza,16,23,,39,-77.35600000000001,0.81488
17469,2013,Junio,Suiza,6,12,,18,-75.527794,10.406342
17470,2013,Junio,Suiza,16,14,,30,-75.516486,10.446304
17471,2013,Junio,Suiza,0,3,,3,-74.77647900000001,10.886686
17472,2013,Junio,Suiza,5,1,,6,-72.129595,11.360028999999999
17473,2013,Junio,Suiza,1,0,,1,-81.70216500000001,12.5862
17474,2013,Junio,Suiza,12,44,,56,-76.532004,3.451668
17475,2013,Junio,Suiza,263,458,,721,-74.140516,4.697157
17476,2013,Junio,Suiza,0,1,,1,-75.736374,4.815189
17477,2013,Junio,Suiza,15,35,,50,-75.42726,6.170465
17478,2013,Junio,Suiza,2,3,,5,-72.453013,7.819
17479,2013,Junio,Suiza,0,1,,1,-77.35002,8.63337
17480,2013,Junio,Surinam,11,13,,24,-74.140516,4.697157
17481,2013,Junio,Surinam,3,4,,7,-75.42726,6.170465
17482,2013,Junio,Taiwán,2,2,,4,-75.527794,10.406342
17483,2013,Junio,Taiwán,1,2,,3,-76.532004,3.451668
17484,2013,Junio,Taiwán,3,4,,7,-74.140516,4.697157
17485,2013,Junio,República de Tayikistán,0,1,,1,-74.140516,4.697157
17486,2013,Junio,Tailandia,0,1,,1,-75.527794,10.406342
17487,2013,Junio,Tailandia,1,0,,1,-75.516486,10.446304
17488,2013,Junio,Tailandia,1,3,,4,-74.140516,4.697157
17489,2013,Junio,Territorio Antártico Británico/Territorio Británico de Ultramar,1,0,,1,-77.35600000000001,0.81488
17490,2013,Junio,Territorio Antártico Británico/Territorio Británico de Ultramar,1,0,,1,-74.77647900000001,10.886686
17491,2013,Junio,Territorio Antártico Británico/Territorio Británico de Ultramar,0,2,,2,-74.140516,4.697157
17492,2013,Junio,Tanzania,0,2,,2,-74.140516,4.697157
17493,2013,Junio,Trinidad y Tobago,0,1,,1,-69.941498,4.191162
17494,2013,Junio,Trinidad y Tobago,3,6,,9,-75.516486,10.446304
17495,2013,Junio,Trinidad y Tobago,0,2,,2,-74.77647900000001,10.886686
17496,2013,Junio,Trinidad y Tobago,0,1,,1,-72.129595,11.360028999999999
17497,2013,Junio,Trinidad y Tobago,2,1,,3,-76.532004,3.451668
17498,2013,Junio,Trinidad y Tobago,22,49,,71,-74.140516,4.697157
17499,2013,Junio,Trinidad y Tobago,3,8,,11,-75.42726,6.170465
17500,2013,Junio,Trinidad y Tobago,0,2,,2,-72.453013,7.819
17501,2013,Junio,Trinidad y Tobago,0,1,,1,-72.508188,7.927233
17502,2013,Junio,Túnez,2,1,,3,-74.140516,4.697157
17503,2013,Junio,Túnez,0,1,,1,-75.42726,6.170465
17504,2013,Junio,Turquía,1,0,,1,-69.941498,4.191162
17505,2013,Junio,Turquía,0,1,,1,-77.35600000000001,0.81488
17506,2013,Junio,Turquía,0,4,,4,-75.527794,10.406342
17507,2013,Junio,Turquía,0,4,,4,-75.516486,10.446304
17508,2013,Junio,Turquía,0,2,,2,-74.77647900000001,10.886686
17509,2013,Junio,Turquía,0,1,,1,-74.765343,10.970933
17510,2013,Junio,Turquía,0,8,,8,-76.532004,3.451668
17511,2013,Junio,Turquía,28,75,,103,-74.140516,4.697157
17512,2013,Junio,Turquía,0,2,,2,-75.42726,6.170465
17513,2013,Junio,Turquía,0,1,,1,-72.453013,7.819
17514,2013,Junio,Ucrania,0,3,,3,-77.35600000000001,0.81488
17515,2013,Junio,Ucrania,1,0,,1,-76.532004,3.451668
17516,2013,Junio,Ucrania,18,14,,32,-74.140516,4.697157
17517,2013,Junio,Ucrania,1,1,,2,-75.42726,6.170465
17518,2013,Junio,Ucrania,0,1,,1,-75.68164200000001,9.402597
17519,2013,Junio,Uganda,0,3,,3,-74.140516,4.697157
17520,2013,Junio,Federación de Rusia,1,0,,1,-77.35600000000001,0.81488
17521,2013,Junio,Federación de Rusia,1,4,,5,-75.516486,10.446304
17522,2013,Junio,Federación de Rusia,0,2,,2,-74.765343,10.970933
17523,2013,Junio,Federación de Rusia,0,1,,1,-76.532004,3.451668
17524,2013,Junio,Federación de Rusia,83,110,,193,-74.140516,4.697157
17525,2013,Junio,Federación de Rusia,4,6,,10,-75.42726,6.170465
17526,2013,Junio,Federación de Rusia,3,2,,5,-72.453013,7.819
17527,2013,Junio,Federación de Rusia,0,18,,18,-75.68164200000001,9.402597
17528,2013,Junio,Uruguay,4,13,,17,-77.35600000000001,0.81488
17529,2013,Junio,Uruguay,5,2,,7,-75.527794,10.406342
17530,2013,Junio,Uruguay,70,61,,131,-75.516486,10.446304
17531,2013,Junio,Uruguay,3,3,,6,-74.77647900000001,10.886686
17532,2013,Junio,Uruguay,4,6,,10,-72.129595,11.360028999999999
17533,2013,Junio,Uruguay,36,26,,62,-81.70216500000001,12.5862
17534,2013,Junio,Uruguay,13,17,,30,-76.532004,3.451668
17535,2013,Junio,Uruguay,0,1,,1,-75.76635300000001,4.45285
17536,2013,Junio,Uruguay,234,402,,636,-74.140516,4.697157
17537,2013,Junio,Uruguay,0,2,,2,-75.736374,4.815189
17538,2013,Junio,Uruguay,23,47,,70,-75.42726,6.170465
17539,2013,Junio,Uruguay,5,33,,38,-72.453013,7.819
17540,2013,Junio,Uruguay,0,1,,1,-77.35002,8.63337
17541,2013,Junio,Venezuela,0,2,,2,-69.941498,4.191162
17542,2013,Junio,Venezuela,0,1,,1,-76.876446,0.33002
17543,2013,Junio,Venezuela,44,57,,101,-77.35600000000001,0.81488
17544,2013,Junio,Venezuela,4,41,,45,-75.527794,10.406342
17545,2013,Junio,Venezuela,75,116,,191,-75.516486,10.446304
17546,2013,Junio,Venezuela,31,76,,107,-74.77647900000001,10.886686
17547,2013,Junio,Venezuela,0,1,,1,-74.213989,11.247722999999999
17548,2013,Junio,Venezuela,994,1553,,2547,-72.129595,11.360028999999999
17549,2013,Junio,Venezuela,0,1,,1,-72.919186,11.52863
17550,2013,Junio,Venezuela,7,7,,14,-81.70216500000001,12.5862
17551,2013,Junio,Venezuela,84,95,,179,-76.532004,3.451668
17552,2013,Junio,Venezuela,4884,6240,,11124,-74.140516,4.697157
17553,2013,Junio,Venezuela,1,7,,8,-75.736374,4.815189
17554,2013,Junio,Venezuela,332,457,,789,-75.42726,6.170465
17555,2013,Junio,Venezuela,132,198,,330,-67.48402800000001,6.185536
17556,2013,Junio,Venezuela,76,149,,225,-70.74025300000001,7.088728999999999
17557,2013,Junio,Venezuela,5,0,,5,-73.181317,7.1280470000000005
17558,2013,Junio,Venezuela,991,1247,,2238,-72.453013,7.819
17559,2013,Junio,Venezuela,116,131,,247,-72.508188,7.927233
17560,2013,Junio,Vietnam,1,1,,2,-74.140516,4.697157
17561,2013,Junio,República Árabe de Yemen,0,1,,1,-74.140516,4.697157
17562,2013,Junio,Zambia,0,1,,1,-74.140516,4.697157
17563,2013,Junio,Zimbabue,0,2,,2,-74.140516,4.697157
17564,2013,Junio,Reino Unido de Gran Bretaña e Irlanda del Norte,3,9,,12,-69.941498,4.191162
17565,2013,Junio,Reino Unido de Gran Bretaña e Irlanda del Norte,51,63,,114,-77.35600000000001,0.81488
17566,2013,Junio,Reino Unido de Gran Bretaña e Irlanda del Norte,18,27,,45,-75.527794,10.406342
17567,2013,Junio,Reino Unido de Gran Bretaña e Irlanda del Norte,9,16,,25,-75.516486,10.446304
17568,2013,Junio,Reino Unido de Gran Bretaña e Irlanda del Norte,2,1,,3,-74.77647900000001,10.886686
17569,2013,Junio,Reino Unido de Gran Bretaña e Irlanda del Norte,0,2,,2,-74.213989,11.247722999999999
17570,2013,Junio,Reino Unido de Gran Bretaña e Irlanda del Norte,1,0,,1,-72.129595,11.360028999999999
17571,2013,Junio,Reino Unido de Gran Bretaña e Irlanda del Norte,0,1,,1,-81.70216500000001,12.5862
17572,2013,Junio,Reino Unido de Gran Bretaña e Irlanda del Norte,10,24,,34,-76.532004,3.451668
17573,2013,Junio,Reino Unido de Gran Bretaña e Irlanda del Norte,262,516,,778,-74.140516,4.697157
17574,2013,Junio,Reino Unido de Gran Bretaña e Irlanda del Norte,9,41,,50,-75.42726,6.170465
17575,2013,Junio,Reino Unido de Gran Bretaña e Irlanda del Norte,0,1,,1,-73.181317,7.1280470000000005
17576,2013,Junio,Reino Unido de Gran Bretaña e Irlanda del Norte,1,7,,8,-72.453013,7.819
17577,2013,Junio,Reino Unido de Gran Bretaña e Irlanda del Norte,0,1,,1,-72.508188,7.927233
17578,2013,Junio,Reino Unido de Gran Bretaña e Irlanda del Norte,1,5,,6,-77.35002,8.63337
17579,2013,Junio,Países Bajos,0,2,,2,-69.941498,4.191162
17580,2013,Junio,Países Bajos,20,18,,38,-77.35600000000001,0.81488
17581,2013,Junio,Países Bajos,11,11,,22,-75.527794,10.406342
17582,2013,Junio,Países Bajos,13,27,,40,-75.516486,10.446304
17583,2013,Junio,Países Bajos,6,10,,16,-74.77647900000001,10.886686
17584,2013,Junio,Países Bajos,0,2,,2,-74.213989,11.247722999999999
17585,2013,Junio,Países Bajos,0,1,,1,-72.129595,11.360028999999999
17586,2013,Junio,Países Bajos,1,0,,1,-81.70216500000001,12.5862
17587,2013,Junio,Países Bajos,12,37,,49,-76.532004,3.451668
17588,2013,Junio,Países Bajos,412,710,,1122,-74.140516,4.697157
17589,2013,Junio,Países Bajos,1,1,,2,-75.736374,4.815189
17590,2013,Junio,Países Bajos,67,99,,166,-75.42726,6.170465
17591,2013,Junio,Países Bajos,3,6,,9,-73.181317,7.1280470000000005
17592,2013,Junio,Países Bajos,4,9,,13,-72.453013,7.819
17593,2013,Junio,Países Bajos,1,2,,3,-77.35002,8.63337
17594,2013,Junio,Desconocido,0,1,,1,-74.77647900000001,10.886686
17595,2013,Junio,Eslovenia,0,1,,1,-74.140516,4.697157
17596,2013,Junio,Lituania,1,0,,1,-77.35600000000001,0.81488
17597,2013,Junio,Lituania,0,1,,1,-75.516486,10.446304
17598,2013,Junio,Reino Unido de Gran Bretaña e Irlanda del Norte,1,0,,1,-77.35600000000001,0.81488
17599,2013,Junio,Reino Unido de Gran Bretaña e Irlanda del Norte,1,0,,1,-74.140516,4.697157
17600,2013,Junio,Reino Unido de Gran Bretaña e Irlanda del Norte,1,1,,2,-77.35002,8.63337
17601,2013,Junio,Reino Unido de Gran Bretaña e Irlanda del Norte,2,1,,3,-77.35600000000001,0.81488
17602,2013,Junio,Reino Unido de Gran Bretaña e Irlanda del Norte,0,8,,8,-74.140516,4.697157
17603,2013,Junio,Marruecos,0,1,,1,-74.140516,4.697157
17604,2013,Junio,Desconocido,0,1,,1,-74.140516,4.697157
17605,2013,Julio,Afganistán,0,1,,1,-74.140516,4.697157
17606,2013,Julio,Afganistán,0,1,,1,-75.736374,4.815189
17607,2013,Julio,Albania,0,1,,1,-72.129595,11.360028999999999
17608,2013,Julio,Albania,2,0,,2,-74.140516,4.697157
17609,2013,Julio,Albania,0,1,,1,-73.181317,7.1280470000000005
17610,2013,Julio,Alemania,14,16,,30,-69.941498,4.191162
17611,2013,Julio,Alemania,1,1,,2,-76.876446,0.33002
17612,2013,Julio,Alemania,87,74,,161,-77.35600000000001,0.81488
17613,2013,Julio,Alemania,0,1,,1,-78.802679,18.00143
17614,2013,Julio,Alemania,18,38,,56,-75.527794,10.406342
17615,2013,Julio,Alemania,28,50,,78,-75.516486,10.446304
17616,2013,Julio,Alemania,10,15,,25,-74.77647900000001,10.886686
17617,2013,Julio,Alemania,1,3,,4,-74.213989,11.247722999999999
17618,2013,Julio,Alemania,7,12,,19,-72.129595,11.360028999999999
17619,2013,Julio,Alemania,1,3,,4,-81.70216500000001,12.5862
17620,2013,Julio,Alemania,97,183,,280,-76.532004,3.451668
17621,2013,Julio,Alemania,1495,2127,,3622,-74.140516,4.697157
17622,2013,Julio,Alemania,0,1,,1,-75.736374,4.815189
17623,2013,Julio,Alemania,84,141,,225,-75.42726,6.170465
17624,2013,Julio,Alemania,0,1,,1,-67.48402800000001,6.185536
17625,2013,Julio,Alemania,4,3,,7,-73.181317,7.1280470000000005
17626,2013,Julio,Alemania,7,15,,22,-72.453013,7.819
17627,2013,Julio,Alemania,3,5,,8,-77.35002,8.63337
17628,2013,Julio,Andorra,0,1,,1,-74.77647900000001,10.886686
17629,2013,Julio,Andorra,2,10,,12,-74.140516,4.697157
17630,2013,Julio,Andorra,0,1,,1,-75.42726,6.170465
17631,2013,Julio,Angola,0,1,,1,-75.516486,10.446304
17632,2013,Julio,Angola,0,1,,1,-76.532004,3.451668
17633,2013,Julio,Angola,1,0,,1,-74.140516,4.697157
17634,2013,Julio,Antigua y Barbuda,0,1,,1,-75.527794,10.406342
17635,2013,Julio,Antigua y Barbuda,2,2,,4,-74.140516,4.697157
17636,2013,Julio,Países Bajos,6,3,,9,-75.42726,6.170465
17637,2013,Julio,Arabia Saudita,1,5,,6,-74.140516,4.697157
17638,2013,Julio,Arabia Saudita,1,0,,1,-72.129595,11.360028999999999
17639,2013,Julio,Arabia Saudita,1,11,,12,-74.140516,4.697157
17640,2013,Julio,Argelia,2,8,,10,-74.140516,4.697157
17641,2013,Julio,Argentina,7,6,,13,-69.941498,4.191162
17642,2013,Julio,Argentina,2,5,,7,-76.876446,0.33002
17643,2013,Julio,Argentina,76,124,,200,-77.35600000000001,0.81488
17644,2013,Julio,Argentina,117,84,,201,-75.527794,10.406342
17645,2013,Julio,Argentina,441,327,,768,-75.516486,10.446304
17646,2013,Julio,Argentina,7,21,,28,-74.77647900000001,10.886686
17647,2013,Julio,Argentina,26,16,,42,-72.129595,11.360028999999999
17648,2013,Julio,Argentina,160,116,,276,-81.70216500000001,12.5862
17649,2013,Julio,Argentina,55,88,,143,-76.532004,3.451668
17650,2013,Julio,Argentina,3505,4909,,8414,-74.140516,4.697157
17651,2013,Julio,Argentina,0,5,,5,-75.736374,4.815189
17652,2013,Julio,Argentina,119,240,,359,-75.42726,6.170465
17653,2013,Julio,Argentina,0,1,,1,-67.48402800000001,6.185536
17654,2013,Julio,Argentina,3,2,,5,-73.181317,7.1280470000000005
17655,2013,Julio,Argentina,26,32,,58,-72.453013,7.819
17656,2013,Julio,Argentina,0,3,,3,-72.508188,7.927233
17657,2013,Julio,Argentina,3,8,,11,-77.35002,8.63337
17658,2013,Julio,República de Armenia,0,9,,9,-74.140516,4.697157
17659,2013,Julio,Aruba,3,0,,3,-72.129595,11.360028999999999
17660,2013,Julio,Aruba,4,3,,7,-74.140516,4.697157
17661,2013,Julio,Australia,5,6,,11,-69.941498,4.191162
17662,2013,Julio,Australia,2,1,,3,-76.876446,0.33002
17663,2013,Julio,Australia,30,50,,80,-77.35600000000001,0.81488
17664,2013,Julio,Australia,24,41,,65,-75.527794,10.406342
17665,2013,Julio,Australia,29,31,,60,-75.516486,10.446304
17666,2013,Julio,Australia,6,7,,13,-74.77647900000001,10.886686
17667,2013,Julio,Australia,2,1,,3,-72.129595,11.360028999999999
17668,2013,Julio,Australia,13,10,,23,-81.70216500000001,12.5862
17669,2013,Julio,Australia,56,79,,135,-76.532004,3.451668
17670,2013,Julio,Australia,212,369,,581,-74.140516,4.697157
17671,2013,Julio,Australia,15,62,,77,-75.42726,6.170465
17672,2013,Julio,Australia,0,1,,1,-73.181317,7.1280470000000005
17673,2013,Julio,Australia,0,3,,3,-72.453013,7.819
17674,2013,Julio,Australia,2,3,,5,-77.35002,8.63337
17675,2013,Julio,Austria,1,1,,2,-69.941498,4.191162
17676,2013,Julio,Austria,6,13,,19,-77.35600000000001,0.81488
17677,2013,Julio,Austria,6,4,,10,-75.527794,10.406342
17678,2013,Julio,Austria,2,5,,7,-75.516486,10.446304
17679,2013,Julio,Austria,0,1,,1,-74.77647900000001,10.886686
17680,2013,Julio,Austria,28,27,,55,-76.532004,3.451668
17681,2013,Julio,Austria,198,271,,469,-74.140516,4.697157
17682,2013,Julio,Austria,4,13,,17,-75.42726,6.170465
17683,2013,Julio,Austria,0,2,,2,-72.453013,7.819
17684,2013,Julio,Austria,1,0,,1,-77.35002,8.63337
17685,2013,Julio,Azerbaiyán,0,6,,6,-76.532004,3.451668
17686,2013,Julio,Azerbaiyán,2,8,,10,-74.140516,4.697157
17687,2013,Julio,Bahamas,2,2,,4,-75.516486,10.446304
17688,2013,Julio,Bahamas,0,3,,3,-74.77647900000001,10.886686
17689,2013,Julio,Bahamas,0,2,,2,-76.532004,3.451668
17690,2013,Julio,Bahamas,4,5,,9,-74.140516,4.697157
17691,2013,Julio,Bahamas,1,0,,1,-75.42726,6.170465
17692,2013,Julio,Bangladesh,1,9,,10,-74.140516,4.697157
17693,2013,Julio,Bangladesh,0,1,,1,-75.42726,6.170465
17694,2013,Julio,Barbados,3,2,,5,-75.516486,10.446304
17695,2013,Julio,Barbados,0,1,,1,-74.77647900000001,10.886686
17696,2013,Julio,Barbados,15,9,,24,-74.140516,4.697157
17697,2013,Julio,Barbados,5,9,,14,-75.42726,6.170465
17698,2013,Julio,Barbados,1,0,,1,-72.453013,7.819
17699,2013,Julio,República de Belarús,0,4,,4,-74.77647900000001,10.886686
17700,2013,Julio,República de Belarús,0,1,,1,-76.532004,3.451668
17701,2013,Julio,República de Belarús,12,8,,20,-74.140516,4.697157
17702,2013,Julio,Bélgica,3,5,,8,-69.941498,4.191162
17703,2013,Julio,Bélgica,10,13,,23,-77.35600000000001,0.81488
17704,2013,Julio,Bélgica,1,3,,4,-75.527794,10.406342
17705,2013,Julio,Bélgica,3,7,,10,-75.516486,10.446304
17706,2013,Julio,Bélgica,1,2,,3,-74.77647900000001,10.886686
17707,2013,Julio,Bélgica,0,11,,11,-74.213989,11.247722999999999
17708,2013,Julio,Bélgica,0,1,,1,-72.129595,11.360028999999999
17709,2013,Julio,Bélgica,68,107,,175,-76.532004,3.451668
17710,2013,Julio,Bélgica,222,377,,599,-74.140516,4.697157
17711,2013,Julio,Bélgica,35,61,,96,-75.42726,6.170465
17712,2013,Julio,Bélgica,0,1,,1,-73.181317,7.1280470000000005
17713,2013,Julio,Bélgica,0,4,,4,-72.453013,7.819
17714,2013,Julio,Bélgica,2,5,,7,-77.35002,8.63337
17715,2013,Julio,Belice,2,2,,4,-75.516486,10.446304
17716,2013,Julio,Belice,4,0,,4,-76.532004,3.451668
17717,2013,Julio,Belice,11,13,,24,-74.140516,4.697157
17718,2013,Julio,Belice,0,1,,1,-75.42726,6.170465
17719,2013,Julio,Belice,1,0,,1,-72.453013,7.819
17720,2013,Julio,Benín,1,0,,1,-74.77647900000001,10.886686
17721,2013,Julio,Bermudas/Territorio Británico de Ultramar,0,1,,1,-75.516486,10.446304
17722,2013,Julio,Bermudas/Territorio Británico de Ultramar,1,4,,5,-76.532004,3.451668
17723,2013,Julio,Bermudas/Territorio Británico de Ultramar,0,1,,1,-75.42726,6.170465
17724,2013,Julio,Bolivia,1,1,,2,-76.876446,0.33002
17725,2013,Julio,Bolivia,11,11,,22,-77.35600000000001,0.81488
17726,2013,Julio,Bolivia,4,3,,7,-75.527794,10.406342
17727,2013,Julio,Bolivia,23,27,,50,-75.516486,10.446304
17728,2013,Julio,Bolivia,2,2,,4,-74.77647900000001,10.886686
17729,2013,Julio,Bolivia,0,1,,1,-81.70216500000001,12.5862
17730,2013,Julio,Bolivia,8,18,,26,-76.532004,3.451668
17731,2013,Julio,Bolivia,340,479,,819,-74.140516,4.697157
17732,2013,Julio,Bolivia,1,2,,3,-75.736374,4.815189
17733,2013,Julio,Bolivia,15,33,,48,-75.42726,6.170465
17734,2013,Julio,Bolivia,0,1,,1,-70.74025300000001,7.088728999999999
17735,2013,Julio,Bolivia,1,4,,5,-72.453013,7.819
17736,2013,Julio,Bosnia y Herzegovina,2,7,,9,-74.140516,4.697157
17737,2013,Julio,Brasil,68,63,,131,-69.941498,4.191162
17738,2013,Julio,Brasil,38,38,,76,-77.35600000000001,0.81488
17739,2013,Julio,Brasil,65,45,,110,-75.527794,10.406342
17740,2013,Julio,Brasil,227,215,,442,-75.516486,10.446304
17741,2013,Julio,Brasil,9,25,,34,-74.77647900000001,10.886686
17742,2013,Julio,Brasil,1,13,,14,-72.129595,11.360028999999999
17743,2013,Julio,Brasil,31,20,,51,-81.70216500000001,12.5862
17744,2013,Julio,Brasil,35,111,,146,-76.532004,3.451668
17745,2013,Julio,Brasil,3051,4410,,7461,-74.140516,4.697157
17746,2013,Julio,Brasil,4,7,,11,-75.736374,4.815189
17747,2013,Julio,Brasil,100,199,,299,-75.42726,6.170465
17748,2013,Julio,Brasil,0,1,,1,-67.48402800000001,6.185536
17749,2013,Julio,Brasil,3,2,,5,-73.181317,7.1280470000000005
17750,2013,Julio,Brasil,12,18,,30,-72.453013,7.819
17751,2013,Julio,Brasil,1,2,,3,-72.508188,7.927233
17752,2013,Julio,Brasil,1,1,,2,-77.35002,8.63337
17753,2013,Julio,Bulgaria,1,1,,2,-77.35600000000001,0.81488
17754,2013,Julio,Bulgaria,4,1,,5,-76.532004,3.451668
17755,2013,Julio,Bulgaria,14,18,,32,-74.140516,4.697157
17756,2013,Julio,Burkina Faso,1,0,,1,-77.35600000000001,0.81488
17757,2013,Julio,Burkina Faso,1,1,,2,-74.140516,4.697157
17758,2013,Julio,Islas Caimán/Territorio Británico de Ultramar,3,1,,4,-81.70216500000001,12.5862
17759,2013,Julio,Islas Caimán/Territorio Británico de Ultramar,2,2,,4,-74.140516,4.697157
17760,2013,Julio,Camboya,0,1,,1,-74.140516,4.697157
17761,2013,Julio,Camerún,0,1,,1,-76.532004,3.451668
17762,2013,Julio,Camerún,0,1,,1,-74.140516,4.697157
17763,2013,Julio,Camerún,0,1,,1,-72.453013,7.819
17764,2013,Julio,Canadá,3,3,,6,-69.941498,4.191162
17765,2013,Julio,Canadá,30,26,,56,-77.35600000000001,0.81488
17766,2013,Julio,Canadá,13,14,,27,-75.527794,10.406342
17767,2013,Julio,Canadá,55,77,,132,-75.516486,10.446304
17768,2013,Julio,Canadá,10,25,,35,-74.77647900000001,10.886686
17769,2013,Julio,Canadá,1,9,,10,-72.129595,11.360028999999999
17770,2013,Julio,Canadá,4,2,,6,-81.70216500000001,12.5862
17771,2013,Julio,Canadá,58,100,,158,-76.532004,3.451668
17772,2013,Julio,Canadá,2,7,,9,-75.76635300000001,4.45285
17773,2013,Julio,Canadá,863,1517,,2380,-74.140516,4.697157
17774,2013,Julio,Canadá,4,10,,14,-75.736374,4.815189
17775,2013,Julio,Canadá,145,291,,436,-75.42726,6.170465
17776,2013,Julio,Canadá,1,2,,3,-73.181317,7.1280470000000005
17777,2013,Julio,Canadá,8,2,,10,-72.453013,7.819
17778,2013,Julio,Canadá,1,1,,2,-72.508188,7.927233
17779,2013,Julio,Canadá,2,0,,2,-77.35002,8.63337
17780,2013,Julio,España,2,0,,2,-69.941498,4.191162
17781,2013,Julio,España,19,16,,35,-77.35600000000001,0.81488
17782,2013,Julio,España,3,2,,5,-75.527794,10.406342
17783,2013,Julio,España,1,5,,6,-75.516486,10.446304
17784,2013,Julio,España,1,12,,13,-74.77647900000001,10.886686
17785,2013,Julio,España,45,93,,138,-76.532004,3.451668
17786,2013,Julio,España,126,263,,389,-74.140516,4.697157
17787,2013,Julio,España,43,104,,147,-75.42726,6.170465
17788,2013,Julio,España,1,2,,3,-72.453013,7.819
17789,2013,Julio,España,0,1,,1,-72.508188,7.927233
17790,2013,Julio,República Del Congo,0,2,,2,-74.140516,4.697157
17791,2013,Julio,República Democrática del Congo,0,2,,2,-77.35600000000001,0.81488
17792,2013,Julio,República Democrática del Congo,1,2,,3,-74.140516,4.697157
17793,2013,Julio,República de Corea,3,12,,15,-77.35600000000001,0.81488
17794,2013,Julio,República de Corea,0,1,,1,-75.527794,10.406342
17795,2013,Julio,República de Corea,2,1,,3,-75.516486,10.446304
17796,2013,Julio,República de Corea,0,1,,1,-74.77647900000001,10.886686
17797,2013,Julio,República de Corea,1,0,,1,-72.129595,11.360028999999999
17798,2013,Julio,República de Corea,3,6,,9,-76.532004,3.451668
17799,2013,Julio,República de Corea,149,372,,521,-74.140516,4.697157
17800,2013,Julio,República de Corea,8,29,,37,-75.42726,6.170465
17801,2013,Julio,República de Corea,0,1,,1,-73.181317,7.1280470000000005
17802,2013,Julio,República de Corea,5,6,,11,-72.453013,7.819
17803,2013,Julio,República de Corea,1,4,,5,-77.35002,8.63337
17804,2013,Julio,Costa de Marfil,1,1,,2,-74.140516,4.697157
17805,2013,Julio,Costa Rica,3,1,,4,-77.35600000000001,0.81488
17806,2013,Julio,Costa Rica,1,2,,3,-75.527794,10.406342
17807,2013,Julio,Costa Rica,68,74,,142,-75.516486,10.446304
17808,2013,Julio,Costa Rica,10,26,,36,-74.77647900000001,10.886686
17809,2013,Julio,Costa Rica,390,273,,663,-81.70216500000001,12.5862
17810,2013,Julio,Costa Rica,30,55,,85,-76.532004,3.451668
17811,2013,Julio,Costa Rica,595,940,,1535,-74.140516,4.697157
17812,2013,Julio,Costa Rica,2,2,,4,-75.736374,4.815189
17813,2013,Julio,Costa Rica,159,216,,375,-75.42726,6.170465
17814,2013,Julio,Costa Rica,1,2,,3,-73.181317,7.1280470000000005
17815,2013,Julio,Costa Rica,2,4,,6,-72.453013,7.819
17816,2013,Julio,Costa Rica,1,1,,2,-72.508188,7.927233
17817,2013,Julio,Costa Rica,0,1,,1,-77.35002,8.63337
17818,2013,Julio,Croacia,0,2,,2,-75.527794,10.406342
17819,2013,Julio,Croacia,0,1,,1,-75.516486,10.446304
17820,2013,Julio,Croacia,3,12,,15,-76.532004,3.451668
17821,2013,Julio,Croacia,9,37,,46,-74.140516,4.697157
17822,2013,Julio,Croacia,1,2,,3,-75.42726,6.170465
17823,2013,Julio,Croacia,0,1,,1,-72.453013,7.819
17824,2013,Julio,Croacia,0,1,,1,-75.68164200000001,9.402597
17825,2013,Julio,Cuba,0,1,,1,-69.941498,4.191162
17826,2013,Julio,Cuba,6,3,,9,-77.35600000000001,0.81488
17827,2013,Julio,Cuba,1,0,,1,-75.527794,10.406342
17828,2013,Julio,Cuba,9,22,,31,-75.516486,10.446304
17829,2013,Julio,Cuba,5,11,,16,-74.77647900000001,10.886686
17830,2013,Julio,Cuba,0,1,,1,-72.129595,11.360028999999999
17831,2013,Julio,Cuba,26,24,,50,-76.532004,3.451668
17832,2013,Julio,Cuba,0,1,,1,-75.76635300000001,4.45285
17833,2013,Julio,Cuba,109,245,,354,-74.140516,4.697157
17834,2013,Julio,Cuba,1,3,,4,-75.736374,4.815189
17835,2013,Julio,Cuba,17,31,,48,-75.42726,6.170465
17836,2013,Julio,Cuba,5,4,,9,-73.181317,7.1280470000000005
17837,2013,Julio,Cuba,2,0,,2,-72.453013,7.819
17838,2013,Julio,Cuba,2,1,,3,-72.508188,7.927233
17839,2013,Julio,Curazao,4,2,,6,-74.140516,4.697157
17840,2013,Julio,Curazao,0,5,,5,-75.42726,6.170465
17841,2013,Julio,República Checa,0,2,,2,-77.35600000000001,0.81488
17842,2013,Julio,República Checa,1,4,,5,-72.129595,11.360028999999999
17843,2013,Julio,República Checa,18,64,,82,-76.532004,3.451668
17844,2013,Julio,República Checa,32,64,,96,-74.140516,4.697157
17845,2013,Julio,República Checa,1,0,,1,-75.736374,4.815189
17846,2013,Julio,República Checa,2,5,,7,-75.42726,6.170465
17847,2013,Julio,República Checa,1,1,,2,-72.453013,7.819
17848,2013,Julio,República Checa,1,1,,2,-77.35002,8.63337
17849,2013,Julio,Chile,6,6,,12,-69.941498,4.191162
17850,2013,Julio,Chile,31,59,,90,-77.35600000000001,0.81488
17851,2013,Julio,Chile,57,42,,99,-75.527794,10.406342
17852,2013,Julio,Chile,95,88,,183,-75.516486,10.446304
17853,2013,Julio,Chile,1,12,,13,-74.77647900000001,10.886686
17854,2013,Julio,Chile,3,10,,13,-72.129595,11.360028999999999
17855,2013,Julio,Chile,54,42,,96,-81.70216500000001,12.5862
17856,2013,Julio,Chile,31,65,,96,-76.532004,3.451668
17857,2013,Julio,Chile,3645,4431,,8076,-74.140516,4.697157
17858,2013,Julio,Chile,1,0,,1,-75.736374,4.815189
17859,2013,Julio,Chile,69,130,,199,-75.42726,6.170465
17860,2013,Julio,Chile,0,1,,1,-70.74025300000001,7.088728999999999
17861,2013,Julio,Chile,0,1,,1,-73.181317,7.1280470000000005
17862,2013,Julio,Chile,8,20,,28,-72.453013,7.819
17863,2013,Julio,Chile,1,2,,3,-72.508188,7.927233
17864,2013,Julio,Chile,2,1,,3,-77.35002,8.63337
17865,2013,Julio,China,1,0,,1,-77.35600000000001,0.81488
17866,2013,Julio,China,0,1,,1,-75.527794,10.406342
17867,2013,Julio,China,3,3,,6,-75.516486,10.446304
17868,2013,Julio,China,1,2,,3,-74.77647900000001,10.886686
17869,2013,Julio,China,1,1,,2,-72.129595,11.360028999999999
17870,2013,Julio,China,10,22,,32,-76.532004,3.451668
17871,2013,Julio,China,249,496,,745,-74.140516,4.697157
17872,2013,Julio,China,0,1,,1,-75.736374,4.815189
17873,2013,Julio,China,17,21,,38,-75.42726,6.170465
17874,2013,Julio,China,2,2,,4,-72.453013,7.819
17875,2013,Julio,Taiwán,1,0,,1,-77.35600000000001,0.81488
17876,2013,Julio,Taiwán,2,2,,4,-74.77647900000001,10.886686
17877,2013,Julio,Taiwán,44,43,,87,-76.532004,3.451668
17878,2013,Julio,Taiwán,41,82,,123,-74.140516,4.697157
17879,2013,Julio,Taiwán,7,10,,17,-75.42726,6.170465
17880,2013,Julio,Chipre,1,0,,1,-76.532004,3.451668
17881,2013,Julio,Chipre,0,15,,15,-74.140516,4.697157
17882,2013,Julio,Chipre,0,2,,2,-75.42726,6.170465
17883,2013,Julio,Chipre,0,1,,1,-75.68164200000001,9.402597
17884,2013,Julio,Dinamarca,5,7,,12,-77.35600000000001,0.81488
17885,2013,Julio,Dinamarca,0,2,,2,-75.527794,10.406342
17886,2013,Julio,Dinamarca,1,5,,6,-75.516486,10.446304
17887,2013,Julio,Dinamarca,4,7,,11,-74.77647900000001,10.886686
17888,2013,Julio,Dinamarca,0,1,,1,-74.765343,10.970933
17889,2013,Julio,Dinamarca,1,0,,1,-72.129595,11.360028999999999
17890,2013,Julio,Dinamarca,1,0,,1,-81.70216500000001,12.5862
17891,2013,Julio,Dinamarca,5,26,,31,-76.532004,3.451668
17892,2013,Julio,Dinamarca,93,159,,252,-74.140516,4.697157
17893,2013,Julio,Dinamarca,0,1,,1,-75.736374,4.815189
17894,2013,Julio,Dinamarca,7,10,,17,-75.42726,6.170465
17895,2013,Julio,Dinamarca,2,2,,4,-72.453013,7.819
17896,2013,Julio,Dominica,0,4,,4,-74.140516,4.697157
17897,2013,Julio,Ecuador,0,4,,4,-69.941498,4.191162
17898,2013,Julio,Ecuador,34,92,,126,-76.876446,0.33002
17899,2013,Julio,Ecuador,1604,2232,,3836,-77.35600000000001,0.81488
17900,2013,Julio,Ecuador,6,119,,125,-78.802679,18.00143
17901,2013,Julio,Ecuador,16,84,,100,-75.527794,10.406342
17902,2013,Julio,Ecuador,29,32,,61,-75.516486,10.446304
17903,2013,Julio,Ecuador,3,8,,11,-74.77647900000001,10.886686
17904,2013,Julio,Ecuador,13,16,,29,-72.129595,11.360028999999999
17905,2013,Julio,Ecuador,12,15,,27,-81.70216500000001,12.5862
17906,2013,Julio,Ecuador,348,402,,750,-76.532004,3.451668
17907,2013,Julio,Ecuador,0,1,,1,-77.061029,3.8844260000000004
17908,2013,Julio,Ecuador,1858,2864,,4722,-74.140516,4.697157
17909,2013,Julio,Ecuador,438,516,,954,-75.42726,6.170465
17910,2013,Julio,Ecuador,0,1,,1,-67.48402800000001,6.185536
17911,2013,Julio,Ecuador,0,1,,1,-70.74025300000001,7.088728999999999
17912,2013,Julio,Ecuador,2,3,,5,-73.181317,7.1280470000000005
17913,2013,Julio,Ecuador,128,220,,348,-72.453013,7.819
17914,2013,Julio,Ecuador,2,2,,4,-72.508188,7.927233
17915,2013,Julio,Ecuador,1,0,,1,-77.35002,8.63337
17916,2013,Julio,Egipto,0,1,,1,-75.516486,10.446304
17917,2013,Julio,Egipto,2,5,,7,-76.532004,3.451668
17918,2013,Julio,Egipto,9,24,,33,-74.140516,4.697157
17919,2013,Julio,Egipto,0,1,,1,-75.42726,6.170465
17920,2013,Julio,El Salvador,1,2,,3,-77.35600000000001,0.81488
17921,2013,Julio,El Salvador,18,18,,36,-75.516486,10.446304
17922,2013,Julio,El Salvador,2,3,,5,-74.77647900000001,10.886686
17923,2013,Julio,El Salvador,3,3,,6,-81.70216500000001,12.5862
17924,2013,Julio,El Salvador,40,63,,103,-76.532004,3.451668
17925,2013,Julio,El Salvador,0,1,,1,-75.76635300000001,4.45285
17926,2013,Julio,El Salvador,482,778,,1260,-74.140516,4.697157
17927,2013,Julio,El Salvador,1,1,,2,-75.736374,4.815189
17928,2013,Julio,El Salvador,50,76,,126,-75.42726,6.170465
17929,2013,Julio,El Salvador,1,0,,1,-73.181317,7.1280470000000005
17930,2013,Julio,El Salvador,0,1,,1,-72.508188,7.927233
17931,2013,Julio,El Salvador,0,3,,3,-77.35002,8.63337
17932,2013,Julio,Emiratos Árabes,0,2,,2,-76.532004,3.451668
17933,2013,Julio,Emiratos Árabes,1,0,,1,-74.140516,4.697157
17934,2013,Julio,España,6,10,,16,-69.941498,4.191162
17935,2013,Julio,España,0,1,,1,-76.876446,0.33002
17936,2013,Julio,España,21,34,,55,-77.35600000000001,0.81488
17937,2013,Julio,España,1,0,,1,-78.802679,18.00143
17938,2013,Julio,España,2,16,,18,-75.527794,10.406342
17939,2013,Julio,España,32,81,,113,-75.516486,10.446304
17940,2013,Julio,España,7,16,,23,-74.77647900000001,10.886686
17941,2013,Julio,España,1,1,,2,-74.213989,11.247722999999999
17942,2013,Julio,España,5,13,,18,-72.129595,11.360028999999999
17943,2013,Julio,España,8,10,,18,-81.70216500000001,12.5862
17944,2013,Julio,España,232,412,,644,-76.532004,3.451668
17945,2013,Julio,España,1962,4582,,6544,-74.140516,4.697157
17946,2013,Julio,España,1,6,,7,-75.736374,4.815189
17947,2013,Julio,España,120,257,,377,-75.42726,6.170465
17948,2013,Julio,España,0,1,,1,-70.74025300000001,7.088728999999999
17949,2013,Julio,España,1,2,,3,-73.181317,7.1280470000000005
17950,2013,Julio,España,20,46,,66,-72.453013,7.819
17951,2013,Julio,España,3,4,,7,-72.508188,7.927233
17952,2013,Julio,España,5,6,,11,-77.35002,8.63337
17953,2013,Julio,Eritrea,1,1,,2,-74.140516,4.697157
17954,2013,Julio,Eslovaquia,1,1,,2,-75.527794,10.406342
17955,2013,Julio,Eslovaquia,2,1,,3,-75.516486,10.446304
17956,2013,Julio,Eslovaquia,1,0,,1,-72.129595,11.360028999999999
17957,2013,Julio,Eslovaquia,12,14,,26,-76.532004,3.451668
17958,2013,Julio,Eslovaquia,7,22,,29,-74.140516,4.697157
17959,2013,Julio,Eslovaquia,2,0,,2,-75.42726,6.170465
17960,2013,Julio,Eslovenia,1,1,,2,-77.35600000000001,0.81488
17961,2013,Julio,Eslovenia,0,2,,2,-75.527794,10.406342
17962,2013,Julio,Eslovenia,2,1,,3,-75.516486,10.446304
17963,2013,Julio,Eslovenia,1,10,,11,-76.532004,3.451668
17964,2013,Julio,Eslovenia,16,27,,43,-74.140516,4.697157
17965,2013,Julio,Eslovenia,1,0,,1,-72.453013,7.819
17966,2013,Julio,Estados Unidos de América,50,53,,103,-69.941498,4.191162
17967,2013,Julio,Estados Unidos de América,1,2,,3,-76.876446,0.33002
17968,2013,Julio,Estados Unidos de América,90,121,,211,-77.35600000000001,0.81488
17969,2013,Julio,Estados Unidos de América,40,63,,103,-75.527794,10.406342
17970,2013,Julio,Estados Unidos de América,1474,2050,,3524,-75.516486,10.446304
17971,2013,Julio,Estados Unidos de América,361,591,,952,-74.77647900000001,10.886686
17972,2013,Julio,Estados Unidos de América,0,2,,2,-74.765343,10.970933
17973,2013,Julio,Estados Unidos de América,4,4,,8,-74.213989,11.247722999999999
17974,2013,Julio,Estados Unidos de América,11,22,,33,-72.129595,11.360028999999999
17975,2013,Julio,Estados Unidos de América,34,38,,72,-81.70216500000001,12.5862
17976,2013,Julio,Estados Unidos de América,1264,1817,,3081,-76.532004,3.451668
17977,2013,Julio,Estados Unidos de América,143,171,,314,-75.76635300000001,4.45285
17978,2013,Julio,Estados Unidos de América,7841,12776,,20617,-74.140516,4.697157
17979,2013,Julio,Estados Unidos de América,169,164,,333,-75.736374,4.815189
17980,2013,Julio,Estados Unidos de América,2491,4279,,6770,-75.42726,6.170465
17981,2013,Julio,Estados Unidos de América,38,43,,81,-73.181317,7.1280470000000005
17982,2013,Julio,Estados Unidos de América,43,64,,107,-72.453013,7.819
17983,2013,Julio,Estados Unidos de América,26,23,,49,-72.508188,7.927233
17984,2013,Julio,Estados Unidos de América,4,6,,10,-77.35002,8.63337
17985,2013,Julio,Estonia,0,1,,1,-75.516486,10.446304
17986,2013,Julio,Estonia,0,2,,2,-74.77647900000001,10.886686
17987,2013,Julio,Estonia,4,5,,9,-76.532004,3.451668
17988,2013,Julio,Estonia,11,18,,29,-74.140516,4.697157
17989,2013,Julio,Estonia,2,1,,3,-75.42726,6.170465
17990,2013,Julio,Etiopia,3,0,,3,-74.140516,4.697157
17991,2013,Julio,Filipinas,0,65,,65,-75.527794,10.406342
17992,2013,Julio,Filipinas,1,27,,28,-75.516486,10.446304
17993,2013,Julio,Filipinas,0,17,,17,-74.77647900000001,10.886686
17994,2013,Julio,Filipinas,0,53,,53,-74.765343,10.970933
17995,2013,Julio,Filipinas,0,26,,26,-74.213989,11.247722999999999
17996,2013,Julio,Filipinas,3,23,,26,-76.532004,3.451668
17997,2013,Julio,Filipinas,0,20,,20,-77.061029,3.8844260000000004
17998,2013,Julio,Filipinas,21,82,,103,-74.140516,4.697157
17999,2013,Julio,Filipinas,4,4,,8,-75.42726,6.170465
18000,2013,Julio,Filipinas,0,4,,4,-75.68164200000001,9.402597
18001,2013,Julio,Finlandia,2,2,,4,-69.941498,4.191162
18002,2013,Julio,Finlandia,2,2,,4,-77.35600000000001,0.81488
18003,2013,Julio,Finlandia,2,1,,3,-75.527794,10.406342
18004,2013,Julio,Finlandia,1,0,,1,-75.516486,10.446304
18005,2013,Julio,Finlandia,1,0,,1,-72.129595,11.360028999999999
18006,2013,Julio,Finlandia,7,6,,13,-76.532004,3.451668
18007,2013,Julio,Finlandia,40,54,,94,-74.140516,4.697157
18008,2013,Julio,Finlandia,2,1,,3,-75.42726,6.170465
18009,2013,Julio,Finlandia,1,0,,1,-72.453013,7.819
18010,2013,Julio,Francia,9,13,,22,-69.941498,4.191162
18011,2013,Julio,Francia,63,94,,157,-77.35600000000001,0.81488
18012,2013,Julio,Francia,0,1,,1,-78.802679,18.00143
18013,2013,Julio,Francia,14,48,,62,-75.527794,10.406342
18014,2013,Julio,Francia,22,33,,55,-75.516486,10.446304
18015,2013,Julio,Francia,2,8,,10,-74.77647900000001,10.886686
18016,2013,Julio,Francia,4,23,,27,-74.765343,10.970933
18017,2013,Julio,Francia,0,1,,1,-74.213989,11.247722999999999
18018,2013,Julio,Francia,7,21,,28,-72.129595,11.360028999999999
18019,2013,Julio,Francia,2,2,,4,-81.70216500000001,12.5862
18020,2013,Julio,Francia,68,146,,214,-76.532004,3.451668
18021,2013,Julio,Francia,1585,2582,,4167,-74.140516,4.697157
18022,2013,Julio,Francia,0,1,,1,-75.736374,4.815189
18023,2013,Julio,Francia,100,141,,241,-75.42726,6.170465
18024,2013,Julio,Francia,9,15,,24,-72.453013,7.819
18025,2013,Julio,Francia,6,9,,15,-77.35002,8.63337
18026,2013,Julio,Georgia,0,1,,1,-75.527794,10.406342
18027,2013,Julio,Georgia,2,8,,10,-74.140516,4.697157
18028,2013,Julio,Ghana,1,1,,2,-74.140516,4.697157
18029,2013,Julio,Granada,1,3,,4,-74.140516,4.697157
18030,2013,Julio,Granada,1,0,,1,-75.42726,6.170465
18031,2013,Julio,Grecia,1,0,,1,-77.35600000000001,0.81488
18032,2013,Julio,Grecia,0,3,,3,-75.527794,10.406342
18033,2013,Julio,Grecia,0,3,,3,-75.516486,10.446304
18034,2013,Julio,Grecia,0,9,,9,-76.532004,3.451668
18035,2013,Julio,Grecia,13,52,,65,-74.140516,4.697157
18036,2013,Julio,Grecia,0,7,,7,-75.42726,6.170465
18037,2013,Julio,Grecia,0,2,,2,-72.453013,7.819
18038,2013,Julio,Grecia,0,2,,2,-77.35002,8.63337
18039,2013,Julio,Grecia,0,2,,2,-75.68164200000001,9.402597
18040,2013,Julio,Guatemala,0,1,,1,-77.35600000000001,0.81488
18041,2013,Julio,Guatemala,0,1,,1,-75.527794,10.406342
18042,2013,Julio,Guatemala,20,41,,61,-75.516486,10.446304
18043,2013,Julio,Guatemala,2,7,,9,-74.77647900000001,10.886686
18044,2013,Julio,Guatemala,0,2,,2,-72.129595,11.360028999999999
18045,2013,Julio,Guatemala,2,2,,4,-81.70216500000001,12.5862
18046,2013,Julio,Guatemala,39,63,,102,-76.532004,3.451668
18047,2013,Julio,Guatemala,202,490,,692,-74.140516,4.697157
18048,2013,Julio,Guatemala,2,1,,3,-75.736374,4.815189
18049,2013,Julio,Guatemala,77,183,,260,-75.42726,6.170465
18050,2013,Julio,Guatemala,1,2,,3,-73.181317,7.1280470000000005
18051,2013,Julio,Guatemala,10,14,,24,-72.453013,7.819
18052,2013,Julio,Guatemala,1,0,,1,-72.508188,7.927233
18053,2013,Julio,Guatemala,0,1,,1,-77.35002,8.63337
18054,2013,Julio,Guyana,0,2,,2,-69.941498,4.191162
18055,2013,Julio,Guyana,1,5,,6,-75.516486,10.446304
18056,2013,Julio,Guyana,3,0,,3,-76.532004,3.451668
18057,2013,Julio,Guyana,3,7,,10,-74.140516,4.697157
18058,2013,Julio,Guyana,2,2,,4,-75.42726,6.170465
18059,2013,Julio,Guinea,0,1,,1,-75.42726,6.170465
18060,2013,Julio,Guinea Ecuatorial,2,1,,3,-74.140516,4.697157
18061,2013,Julio,Guinea Bissau,0,1,,1,-72.508188,7.927233
18062,2013,Julio,Haití,1,3,,4,-75.516486,10.446304
18063,2013,Julio,Haití,6,14,,20,-74.140516,4.697157
18064,2013,Julio,Haití,0,3,,3,-75.42726,6.170465
18065,2013,Julio,Honduras,2,3,,5,-77.35600000000001,0.81488
18066,2013,Julio,Honduras,2,7,,9,-75.527794,10.406342
18067,2013,Julio,Honduras,8,30,,38,-75.516486,10.446304
18068,2013,Julio,Honduras,3,6,,9,-74.77647900000001,10.886686
18069,2013,Julio,Honduras,2,1,,3,-81.70216500000001,12.5862
18070,2013,Julio,Honduras,9,12,,21,-76.532004,3.451668
18071,2013,Julio,Honduras,151,231,,382,-74.140516,4.697157
18072,2013,Julio,Honduras,2,1,,3,-75.736374,4.815189
18073,2013,Julio,Honduras,59,68,,127,-75.42726,6.170465
18074,2013,Julio,Honduras,2,0,,2,-72.453013,7.819
18075,2013,Julio,Honduras,0,3,,3,-76.7333,8.06667
18076,2013,Julio,Honduras,1,3,,4,-77.35002,8.63337
18077,2013,Julio,Honduras,0,3,,3,-75.68164200000001,9.402597
18078,2013,Julio,Hungría,1,0,,1,-75.527794,10.406342
18079,2013,Julio,Hungría,19,23,,42,-76.532004,3.451668
18080,2013,Julio,Hungría,51,63,,114,-74.140516,4.697157
18081,2013,Julio,Hungría,1,3,,4,-75.42726,6.170465
18082,2013,Julio,India,1,0,,1,-69.941498,4.191162
18083,2013,Julio,India,0,1,,1,-77.35600000000001,0.81488
18084,2013,Julio,India,1,10,,11,-75.516486,10.446304
18085,2013,Julio,India,1,5,,6,-74.77647900000001,10.886686
18086,2013,Julio,India,0,1,,1,-81.70216500000001,12.5862
18087,2013,Julio,India,4,17,,21,-76.532004,3.451668
18088,2013,Julio,India,50,279,,329,-74.140516,4.697157
18089,2013,Julio,India,8,33,,41,-75.42726,6.170465
18090,2013,Julio,Indonesia,0,3,,3,-77.35600000000001,0.81488
18091,2013,Julio,Indonesia,0,1,,1,-75.527794,10.406342
18092,2013,Julio,Indonesia,0,1,,1,-75.516486,10.446304
18093,2013,Julio,Indonesia,1,4,,5,-76.532004,3.451668
18094,2013,Julio,Indonesia,14,34,,48,-74.140516,4.697157
18095,2013,Julio,Indonesia,1,2,,3,-75.42726,6.170465
18096,2013,Julio,Iraq,0,1,,1,-75.516486,10.446304
18097,2013,Julio,Irán,0,1,,1,-75.516486,10.446304
18098,2013,Julio,Irán,8,41,,49,-74.140516,4.697157
18099,2013,Julio,Irán,0,2,,2,-75.42726,6.170465
18100,2013,Julio,República de Irlanda,1,1,,2,-69.941498,4.191162
18101,2013,Julio,República de Irlanda,17,11,,28,-77.35600000000001,0.81488
18102,2013,Julio,República de Irlanda,2,7,,9,-75.527794,10.406342
18103,2013,Julio,República de Irlanda,2,16,,18,-75.516486,10.446304
18104,2013,Julio,República de Irlanda,0,1,,1,-81.70216500000001,12.5862
18105,2013,Julio,República de Irlanda,6,11,,17,-76.532004,3.451668
18106,2013,Julio,República de Irlanda,115,166,,281,-74.140516,4.697157
18107,2013,Julio,República de Irlanda,9,12,,21,-75.42726,6.170465
18108,2013,Julio,República de Irlanda,0,3,,3,-72.453013,7.819
18109,2013,Julio,República de Irlanda,1,1,,2,-77.35002,8.63337
18110,2013,Julio,Islandia,0,2,,2,-75.527794,10.406342
18111,2013,Julio,Islandia,3,9,,12,-74.140516,4.697157
18112,2013,Julio,Islandia,2,1,,3,-75.42726,6.170465
18113,2013,Julio,Isla de Man,24,32,,56,-77.35600000000001,0.81488
18114,2013,Julio,Isla de Man,2,4,,6,-75.516486,10.446304
18115,2013,Julio,Isla de Man,30,51,,81,-76.532004,3.451668
18116,2013,Julio,Isla de Man,64,132,,196,-74.140516,4.697157
18117,2013,Julio,Isla de Man,27,54,,81,-75.42726,6.170465
18118,2013,Julio,Islas Pitcairn/Territorio Británico de Ultramar,0,1,,1,-74.140516,4.697157
18119,2013,Julio,Isla Johnston,2,0,,2,-74.140516,4.697157
18120,2013,Julio,Israel,1,9,,10,-69.941498,4.191162
18121,2013,Julio,Israel,19,57,,76,-77.35600000000001,0.81488
18122,2013,Julio,Israel,1,7,,8,-75.527794,10.406342
18123,2013,Julio,Israel,6,27,,33,-75.516486,10.446304
18124,2013,Julio,Israel,0,1,,1,-74.77647900000001,10.886686
18125,2013,Julio,Israel,1,0,,1,-81.70216500000001,12.5862
18126,2013,Julio,Israel,8,38,,46,-76.532004,3.451668
18127,2013,Julio,Israel,110,461,,571,-74.140516,4.697157
18128,2013,Julio,Israel,11,65,,76,-75.42726,6.170465
18129,2013,Julio,Israel,0,1,,1,-73.181317,7.1280470000000005
18130,2013,Julio,Islas Aland/Provincia de Finlandia,0,1,,1,-74.140516,4.697157
18131,2013,Julio,Isla Wake,4,2,,6,-72.508188,7.927233
18132,2013,Julio,Italia,0,9,,9,-69.941498,4.191162
18133,2013,Julio,Italia,1,0,,1,-76.876446,0.33002
18134,2013,Julio,Italia,12,27,,39,-77.35600000000001,0.81488
18135,2013,Julio,Italia,3,9,,12,-75.527794,10.406342
18136,2013,Julio,Italia,28,67,,95,-75.516486,10.446304
18137,2013,Julio,Italia,6,14,,20,-74.77647900000001,10.886686
18138,2013,Julio,Italia,0,1,,1,-74.213989,11.247722999999999
18139,2013,Julio,Italia,6,19,,25,-72.129595,11.360028999999999
18140,2013,Julio,Italia,1,2,,3,-81.70216500000001,12.5862
18141,2013,Julio,Italia,74,166,,240,-76.532004,3.451668
18142,2013,Julio,Italia,558,1537,,2095,-74.140516,4.697157
18143,2013,Julio,Italia,1,3,,4,-75.736374,4.815189
18144,2013,Julio,Italia,38,105,,143,-75.42726,6.170465
18145,2013,Julio,Italia,0,1,,1,-67.48402800000001,6.185536
18146,2013,Julio,Italia,0,3,,3,-73.181317,7.1280470000000005
18147,2013,Julio,Italia,1,18,,19,-72.453013,7.819
18148,2013,Julio,Italia,0,1,,1,-72.508188,7.927233
18149,2013,Julio,Italia,2,3,,5,-77.35002,8.63337
18150,2013,Julio,Islas del Canal,1,0,,1,-75.516486,10.446304
18151,2013,Julio,Islas del Canal,0,7,,7,-74.77647900000001,10.886686
18152,2013,Julio,Jamaica,7,5,,12,-75.516486,10.446304
18153,2013,Julio,Jamaica,2,5,,7,-74.77647900000001,10.886686
18154,2013,Julio,Jamaica,2,1,,3,-76.532004,3.451668
18155,2013,Julio,Jamaica,18,15,,33,-74.140516,4.697157
18156,2013,Julio,Jamaica,0,2,,2,-75.736374,4.815189
18157,2013,Julio,Jamaica,9,8,,17,-75.42726,6.170465
18158,2013,Julio,Jamaica,0,1,,1,-73.181317,7.1280470000000005
18159,2013,Julio,Jamaica,1,0,,1,-72.453013,7.819
18160,2013,Julio,Islas Salomón,1,0,,1,-76.532004,3.451668
18161,2013,Julio,Japón,1,0,,1,-69.941498,4.191162
18162,2013,Julio,Japón,9,15,,24,-77.35600000000001,0.81488
18163,2013,Julio,Japón,3,11,,14,-75.516486,10.446304
18164,2013,Julio,Japón,0,6,,6,-74.77647900000001,10.886686
18165,2013,Julio,Japón,1,1,,2,-72.129595,11.360028999999999
18166,2013,Julio,Japón,1,1,,2,-81.70216500000001,12.5862
18167,2013,Julio,Japón,26,66,,92,-76.532004,3.451668
18168,2013,Julio,Japón,143,501,,644,-74.140516,4.697157
18169,2013,Julio,Japón,7,24,,31,-75.42726,6.170465
18170,2013,Julio,Japón,0,1,,1,-73.181317,7.1280470000000005
18171,2013,Julio,Japón,7,6,,13,-72.453013,7.819
18172,2013,Julio,Jordania,2,2,,4,-75.516486,10.446304
18173,2013,Julio,Jordania,1,6,,7,-74.140516,4.697157
18174,2013,Julio,Kazajistán,0,9,,9,-74.77647900000001,10.886686
18175,2013,Julio,Kazajistán,4,2,,6,-76.532004,3.451668
18176,2013,Julio,Kazajistán,1,1,,2,-74.140516,4.697157
18177,2013,Julio,Kenia,8,10,,18,-74.140516,4.697157
18178,2013,Julio,Kirguistán,1,10,,11,-74.140516,4.697157
18179,2013,Julio,Kuwait,0,1,,1,-74.140516,4.697157
18180,2013,Julio,República de Kosovo,1,7,,8,-74.140516,4.697157
18181,2013,Julio,República de Kosovo,0,1,,1,-75.42726,6.170465
18182,2013,Julio,Letonia,0,1,,1,-75.527794,10.406342
18183,2013,Julio,Letonia,0,1,,1,-75.516486,10.446304
18184,2013,Julio,Letonia,0,1,,1,-74.765343,10.970933
18185,2013,Julio,Letonia,0,11,,11,-76.532004,3.451668
18186,2013,Julio,Letonia,12,36,,48,-74.140516,4.697157
18187,2013,Julio,Letonia,2,1,,3,-75.42726,6.170465
18188,2013,Julio,Lituania,0,1,,1,-77.35600000000001,0.81488
18189,2013,Julio,Lituania,0,1,,1,-75.527794,10.406342
18190,2013,Julio,Lituania,0,1,,1,-72.129595,11.360028999999999
18191,2013,Julio,Lituania,3,1,,4,-76.532004,3.451668
18192,2013,Julio,Lituania,12,15,,27,-74.140516,4.697157
18193,2013,Julio,Lituania,0,1,,1,-75.42726,6.170465
18194,2013,Julio,Lituania,2,0,,2,-72.453013,7.819
18195,2013,Julio,Líbano,1,0,,1,-75.516486,10.446304
18196,2013,Julio,Líbano,0,2,,2,-74.77647900000001,10.886686
18197,2013,Julio,Líbano,6,2,,8,-72.129595,11.360028999999999
18198,2013,Julio,Líbano,2,5,,7,-76.532004,3.451668
18199,2013,Julio,Líbano,16,23,,39,-74.140516,4.697157
18200,2013,Julio,Líbano,0,1,,1,-75.42726,6.170465
18201,2013,Julio,Liechtenstein,1,0,,1,-76.532004,3.451668
18202,2013,Julio,Liechtenstein,4,5,,9,-74.140516,4.697157
18203,2013,Julio,Luxemburgo,0,2,,2,-69.941498,4.191162
18204,2013,Julio,Luxemburgo,1,0,,1,-77.35600000000001,0.81488
18205,2013,Julio,Luxemburgo,2,1,,3,-76.532004,3.451668
18206,2013,Julio,Luxemburgo,6,22,,28,-74.140516,4.697157
18207,2013,Julio,Macedonia,0,1,,1,-76.532004,3.451668
18208,2013,Julio,Macedonia,2,10,,12,-74.140516,4.697157
18209,2013,Julio,Madagascar,2,1,,3,-74.140516,4.697157
18210,2013,Julio,Malasia,0,1,,1,-75.516486,10.446304
18211,2013,Julio,Malasia,0,8,,8,-74.77647900000001,10.886686
18212,2013,Julio,Malasia,0,2,,2,-74.213989,11.247722999999999
18213,2013,Julio,Malasia,3,6,,9,-76.532004,3.451668
18214,2013,Julio,Malasia,16,29,,45,-74.140516,4.697157
18215,2013,Julio,Malasia,0,4,,4,-75.42726,6.170465
18216,2013,Julio,Malta,1,4,,5,-74.140516,4.697157
18217,2013,Julio,Marruecos,0,1,,1,-77.35600000000001,0.81488
18218,2013,Julio,Marruecos,4,17,,21,-74.140516,4.697157
18219,2013,Julio,Mauricio,0,2,,2,-76.532004,3.451668
18220,2013,Julio,Mauricio,1,1,,2,-74.140516,4.697157
18221,2013,Julio,Mauricio,0,1,,1,-75.42726,6.170465
18222,2013,Julio,Mauritania,0,1,,1,-74.140516,4.697157
18223,2013,Julio,México,0,4,,4,-69.941498,4.191162
18224,2013,Julio,México,0,1,,1,-76.876446,0.33002
18225,2013,Julio,México,13,31,,44,-77.35600000000001,0.81488
18226,2013,Julio,México,0,1,,1,-78.802679,18.00143
18227,2013,Julio,México,16,21,,37,-75.527794,10.406342
18228,2013,Julio,México,239,339,,578,-75.516486,10.446304
18229,2013,Julio,México,35,37,,72,-74.77647900000001,10.886686
18230,2013,Julio,México,2,18,,20,-72.129595,11.360028999999999
18231,2013,Julio,México,7,10,,17,-81.70216500000001,12.5862
18232,2013,Julio,México,113,212,,325,-76.532004,3.451668
18233,2013,Julio,México,3046,5547,,8593,-74.140516,4.697157
18234,2013,Julio,México,7,15,,22,-75.736374,4.815189
18235,2013,Julio,México,418,741,,1159,-75.42726,6.170465
18236,2013,Julio,México,2,0,,2,-67.48402800000001,6.185536
18237,2013,Julio,México,18,20,,38,-73.181317,7.1280470000000005
18238,2013,Julio,México,24,49,,73,-72.453013,7.819
18239,2013,Julio,México,28,70,,98,-72.508188,7.927233
18240,2013,Julio,México,1,4,,5,-77.35002,8.63337
18241,2013,Julio,Mayotte/Colectividad Territorial Francesa,0,1,,1,-74.140516,4.697157
18242,2013,Julio,República de Moldavia,4,5,,9,-74.140516,4.697157
18243,2013,Julio,Mónaco,1,0,,1,-74.140516,4.697157
18244,2013,Julio,Mongolia,1,14,,15,-76.532004,3.451668
18245,2013,Julio,Mongolia,4,11,,15,-74.140516,4.697157
18246,2013,Julio,Montenegro,2,3,,5,-76.532004,3.451668
18247,2013,Julio,Montenegro,4,4,,8,-74.140516,4.697157
18248,2013,Julio,Namibia,0,1,,1,-74.140516,4.697157
18249,2013,Julio,Nepal,1,1,,2,-74.140516,4.697157
18250,2013,Julio,Nicaragua,0,1,,1,-77.35600000000001,0.81488
18251,2013,Julio,Nicaragua,3,8,,11,-75.516486,10.446304
18252,2013,Julio,Nicaragua,3,2,,5,-74.77647900000001,10.886686
18253,2013,Julio,Nicaragua,1,3,,4,-81.70216500000001,12.5862
18254,2013,Julio,Nicaragua,5,1,,6,-76.532004,3.451668
18255,2013,Julio,Nicaragua,58,77,,135,-74.140516,4.697157
18256,2013,Julio,Nicaragua,2,1,,3,-75.736374,4.815189
18257,2013,Julio,Nicaragua,15,15,,30,-75.42726,6.170465
18258,2013,Julio,Nicaragua,0,1,,1,-73.181317,7.1280470000000005
18259,2013,Julio,Nicaragua,1,0,,1,-72.508188,7.927233
18260,2013,Julio,Nigeria,1,1,,2,-75.516486,10.446304
18261,2013,Julio,Nigeria,0,1,,1,-74.77647900000001,10.886686
18262,2013,Julio,Nigeria,4,9,,13,-74.140516,4.697157
18263,2013,Julio,Nigeria,0,1,,1,-75.42726,6.170465
18264,2013,Julio,Noruega,3,2,,5,-69.941498,4.191162
18265,2013,Julio,Noruega,4,9,,13,-77.35600000000001,0.81488
18266,2013,Julio,Noruega,3,6,,9,-75.527794,10.406342
18267,2013,Julio,Noruega,12,22,,34,-75.516486,10.446304
18268,2013,Julio,Noruega,2,5,,7,-74.77647900000001,10.886686
18269,2013,Julio,Noruega,1,4,,5,-74.213989,11.247722999999999
18270,2013,Julio,Noruega,9,14,,23,-76.532004,3.451668
18271,2013,Julio,Noruega,136,192,,328,-74.140516,4.697157
18272,2013,Julio,Noruega,10,12,,22,-75.42726,6.170465
18273,2013,Julio,Noruega,0,1,,1,-72.453013,7.819
18274,2013,Julio,Noruega,0,2,,2,-77.35002,8.63337
18275,2013,Julio,Nueva Caledonia/Territorio francés,1,0,,1,-74.140516,4.697157
18276,2013,Julio,Nueva Zelanda,11,14,,25,-77.35600000000001,0.81488
18277,2013,Julio,Nueva Zelanda,5,7,,12,-75.516486,10.446304
18278,2013,Julio,Nueva Zelanda,0,1,,1,-72.129595,11.360028999999999
18279,2013,Julio,Nueva Zelanda,9,12,,21,-76.532004,3.451668
18280,2013,Julio,Nueva Zelanda,1,0,,1,-75.76635300000001,4.45285
18281,2013,Julio,Nueva Zelanda,47,63,,110,-74.140516,4.697157
18282,2013,Julio,Nueva Zelanda,0,1,,1,-75.736374,4.815189
18283,2013,Julio,Nueva Zelanda,3,10,,13,-75.42726,6.170465
18284,2013,Julio,Papúa Nueva Guinea,1,0,,1,-75.516486,10.446304
18285,2013,Julio,Nueva Zelanda,7,14,,21,-75.527794,10.406342
18286,2013,Julio,Nueva Zelanda,0,1,,1,-74.77647900000001,10.886686
18287,2013,Julio,Nueva Zelanda,0,2,,2,-76.532004,3.451668
18288,2013,Julio,Nueva Zelanda,1,4,,5,-74.140516,4.697157
18289,2013,Julio,Países Bajos,0,3,,3,-69.941498,4.191162
18290,2013,Julio,Países Bajos,7,15,,22,-77.35600000000001,0.81488
18291,2013,Julio,Países Bajos,7,20,,27,-75.516486,10.446304
18292,2013,Julio,Países Bajos,0,1,,1,-74.77647900000001,10.886686
18293,2013,Julio,Países Bajos,12,20,,32,-72.129595,11.360028999999999
18294,2013,Julio,Países Bajos,42,50,,92,-72.919186,11.52863
18295,2013,Julio,Países Bajos,26,45,,71,-76.532004,3.451668
18296,2013,Julio,Países Bajos,300,379,,679,-74.140516,4.697157
18297,2013,Julio,Países Bajos,0,3,,3,-75.736374,4.815189
18298,2013,Julio,Países Bajos,298,302,,600,-75.42726,6.170465
18299,2013,Julio,Países Bajos,6,3,,9,-73.181317,7.1280470000000005
18300,2013,Julio,Países Bajos,5,0,,5,-72.453013,7.819
18301,2013,Julio,Pakistán,0,3,,3,-77.35600000000001,0.81488
18302,2013,Julio,Pakistán,0,2,,2,-75.516486,10.446304
18303,2013,Julio,Pakistán,0,1,,1,-76.532004,3.451668
18304,2013,Julio,Pakistán,3,13,,16,-74.140516,4.697157
18305,2013,Julio,Panamá,1,1,,2,-77.35600000000001,0.81488
18306,2013,Julio,Panamá,0,1,,1,-78.802679,18.00143
18307,2013,Julio,Panamá,2,12,,14,-75.527794,10.406342
18308,2013,Julio,Panamá,100,174,,274,-75.516486,10.446304
18309,2013,Julio,Panamá,51,143,,194,-74.77647900000001,10.886686
18310,2013,Julio,Panamá,1,2,,3,-72.129595,11.360028999999999
18311,2013,Julio,Panamá,24,31,,55,-81.70216500000001,12.5862
18312,2013,Julio,Panamá,72,122,,194,-76.532004,3.451668
18313,2013,Julio,Panamá,0,1,,1,-75.76635300000001,4.45285
18314,2013,Julio,Panamá,583,945,,1528,-74.140516,4.697157
18315,2013,Julio,Panamá,67,95,,162,-75.736374,4.815189
18316,2013,Julio,Panamá,151,280,,431,-75.42726,6.170465
18317,2013,Julio,Panamá,6,9,,15,-73.181317,7.1280470000000005
18318,2013,Julio,Panamá,0,7,,7,-72.453013,7.819
18319,2013,Julio,Panamá,6,15,,21,-72.508188,7.927233
18320,2013,Julio,Panamá,5,5,,10,-77.35002,8.63337
18321,2013,Julio,Papúa Nueva Guinea,0,1,,1,-74.140516,4.697157
18322,2013,Julio,Paraguay,0,4,,4,-69.941498,4.191162
18323,2013,Julio,Paraguay,0,2,,2,-77.35600000000001,0.81488
18324,2013,Julio,Paraguay,17,22,,39,-75.516486,10.446304
18325,2013,Julio,Paraguay,1,4,,5,-74.77647900000001,10.886686
18326,2013,Julio,Paraguay,0,1,,1,-72.129595,11.360028999999999
18327,2013,Julio,Paraguay,3,3,,6,-81.70216500000001,12.5862
18328,2013,Julio,Paraguay,8,9,,17,-76.532004,3.451668
18329,2013,Julio,Paraguay,131,349,,480,-74.140516,4.697157
18330,2013,Julio,Paraguay,10,23,,33,-75.42726,6.170465
18331,2013,Julio,Paraguay,0,4,,4,-72.453013,7.819
18332,2013,Julio,Perú,55,96,,151,-69.941498,4.191162
18333,2013,Julio,Perú,3,3,,6,-76.876446,0.33002
18334,2013,Julio,Perú,163,398,,561,-77.35600000000001,0.81488
18335,2013,Julio,Perú,18,16,,34,-75.527794,10.406342
18336,2013,Julio,Perú,127,130,,257,-75.516486,10.446304
18337,2013,Julio,Perú,9,16,,25,-74.77647900000001,10.886686
18338,2013,Julio,Perú,16,33,,49,-72.129595,11.360028999999999
18339,2013,Julio,Perú,76,53,,129,-81.70216500000001,12.5862
18340,2013,Julio,Perú,107,134,,241,-76.532004,3.451668
18341,2013,Julio,Perú,3064,3694,,6758,-74.140516,4.697157
18342,2013,Julio,Perú,2,2,,4,-75.736374,4.815189
18343,2013,Julio,Perú,308,402,,710,-75.42726,6.170465
18344,2013,Julio,Perú,1,0,,1,-70.74025300000001,7.088728999999999
18345,2013,Julio,Perú,0,2,,2,-73.181317,7.1280470000000005
18346,2013,Julio,Perú,36,89,,125,-72.453013,7.819
18347,2013,Julio,Perú,0,2,,2,-72.508188,7.927233
18348,2013,Julio,Palestina,1,1,,2,-74.140516,4.697157
18349,2013,Julio,Polonia,8,4,,12,-77.35600000000001,0.81488
18350,2013,Julio,Polonia,1,15,,16,-75.527794,10.406342
18351,2013,Julio,Polonia,2,7,,9,-75.516486,10.446304
18352,2013,Julio,Polonia,0,1,,1,-74.77647900000001,10.886686
18353,2013,Julio,Polonia,0,2,,2,-74.765343,10.970933
18354,2013,Julio,Polonia,0,11,,11,-74.213989,11.247722999999999
18355,2013,Julio,Polonia,2,1,,3,-72.129595,11.360028999999999
18356,2013,Julio,Polonia,14,19,,33,-76.532004,3.451668
18357,2013,Julio,Polonia,0,2,,2,-77.061029,3.8844260000000004
18358,2013,Julio,Polonia,75,108,,183,-74.140516,4.697157
18359,2013,Julio,Polonia,4,5,,9,-75.42726,6.170465
18360,2013,Julio,Polonia,3,1,,4,-72.453013,7.819
18361,2013,Julio,Polonia,0,2,,2,-76.7333,8.06667
18362,2013,Julio,Polonia,1,1,,2,-77.35002,8.63337
18363,2013,Julio,Portugal,0,3,,3,-69.941498,4.191162
18364,2013,Julio,Portugal,4,5,,9,-77.35600000000001,0.81488
18365,2013,Julio,Portugal,0,1,,1,-78.802679,18.00143
18366,2013,Julio,Portugal,0,1,,1,-75.527794,10.406342
18367,2013,Julio,Portugal,1,6,,7,-75.516486,10.446304
18368,2013,Julio,Portugal,2,3,,5,-74.77647900000001,10.886686
18369,2013,Julio,Portugal,1,2,,3,-72.129595,11.360028999999999
18370,2013,Julio,Portugal,0,2,,2,-81.70216500000001,12.5862
18371,2013,Julio,Portugal,4,18,,22,-76.532004,3.451668
18372,2013,Julio,Portugal,115,361,,476,-74.140516,4.697157
18373,2013,Julio,Portugal,12,40,,52,-75.42726,6.170465
18374,2013,Julio,Portugal,0,1,,1,-67.48402800000001,6.185536
18375,2013,Julio,Portugal,0,1,,1,-70.74025300000001,7.088728999999999
18376,2013,Julio,Portugal,4,2,,6,-72.453013,7.819
18377,2013,Julio,Portugal,0,2,,2,-72.508188,7.927233
18378,2013,Julio,Portugal,0,1,,1,-77.35002,8.63337
18379,2013,Julio,Puerto Rico/Territorio de Estados Unidos,1,1,,2,-76.532004,3.451668
18380,2013,Julio,Puerto Rico/Territorio de Estados Unidos,0,2,,2,-74.140516,4.697157
18381,2013,Julio,Qatar,0,2,,2,-76.532004,3.451668
18382,2013,Julio,Qatar,0,14,,14,-74.140516,4.697157
18383,2013,Julio,Reino Unido de Gran Bretaña e Irlanda del Norte,3,5,,8,-69.941498,4.191162
18384,2013,Julio,Reino Unido de Gran Bretaña e Irlanda del Norte,18,31,,49,-77.35600000000001,0.81488
18385,2013,Julio,Reino Unido de Gran Bretaña e Irlanda del Norte,7,3,,10,-75.527794,10.406342
18386,2013,Julio,Reino Unido de Gran Bretaña e Irlanda del Norte,26,52,,78,-75.516486,10.446304
18387,2013,Julio,Reino Unido de Gran Bretaña e Irlanda del Norte,0,2,,2,-74.77647900000001,10.886686
18388,2013,Julio,Reino Unido de Gran Bretaña e Irlanda del Norte,7,12,,19,-72.129595,11.360028999999999
18389,2013,Julio,Reino Unido de Gran Bretaña e Irlanda del Norte,37,72,,109,-76.532004,3.451668
18390,2013,Julio,Reino Unido de Gran Bretaña e Irlanda del Norte,0,1,,1,-75.76635300000001,4.45285
18391,2013,Julio,Reino Unido de Gran Bretaña e Irlanda del Norte,340,722,,1062,-74.140516,4.697157
18392,2013,Julio,Reino Unido de Gran Bretaña e Irlanda del Norte,0,1,,1,-75.736374,4.815189
18393,2013,Julio,Reino Unido de Gran Bretaña e Irlanda del Norte,26,73,,99,-75.42726,6.170465
18394,2013,Julio,Reino Unido de Gran Bretaña e Irlanda del Norte,0,2,,2,-72.453013,7.819
18395,2013,Julio,República de Belarús,2,2,,4,-74.77647900000001,10.886686
18396,2013,Julio,República de Belarús,9,1,,10,-74.140516,4.697157
18397,2013,Julio,República de Belarús,0,1,,1,-75.42726,6.170465
18398,2013,Julio,República Dominicana,2,8,,10,-77.35600000000001,0.81488
18399,2013,Julio,República Dominicana,2,0,,2,-75.527794,10.406342
18400,2013,Julio,República Dominicana,29,41,,70,-75.516486,10.446304
18401,2013,Julio,República Dominicana,13,52,,65,-74.77647900000001,10.886686
18402,2013,Julio,República Dominicana,1,1,,2,-72.129595,11.360028999999999
18403,2013,Julio,República Dominicana,23,23,,46,-76.532004,3.451668
18404,2013,Julio,República Dominicana,212,414,,626,-74.140516,4.697157
18405,2013,Julio,República Dominicana,1,5,,6,-75.736374,4.815189
18406,2013,Julio,República Dominicana,58,73,,131,-75.42726,6.170465
18407,2013,Julio,República Dominicana,1,1,,2,-73.181317,7.1280470000000005
18408,2013,Julio,República Dominicana,1,0,,1,-72.508188,7.927233
18409,2013,Julio,República Dominicana,0,2,,2,-77.35002,8.63337
18410,2013,Julio,República Checa,0,3,,3,-76.532004,3.451668
18411,2013,Julio,República Checa,2,4,,6,-74.140516,4.697157
18412,2013,Julio,República Checa,1,0,,1,-75.42726,6.170465
18413,2013,Julio,República Democrática Popular de Corea,0,8,,8,-74.140516,4.697157
18414,2013,Julio,Rumania,4,3,,7,-77.35600000000001,0.81488
18415,2013,Julio,Rumania,0,3,,3,-75.527794,10.406342
18416,2013,Julio,Rumania,0,2,,2,-74.77647900000001,10.886686
18417,2013,Julio,Rumania,0,1,,1,-74.213989,11.247722999999999
18418,2013,Julio,Rumania,2,2,,4,-72.129595,11.360028999999999
18419,2013,Julio,Rumania,0,1,,1,-81.70216500000001,12.5862
18420,2013,Julio,Rumania,14,6,,20,-76.532004,3.451668
18421,2013,Julio,Rumania,32,46,,78,-74.140516,4.697157
18422,2013,Julio,Rumania,3,2,,5,-75.42726,6.170465
18423,2013,Julio,Rumania,0,1,,1,-72.453013,7.819
18424,2013,Julio,Federación de Rusia,1,1,,2,-77.35600000000001,0.81488
18425,2013,Julio,Federación de Rusia,0,3,,3,-75.527794,10.406342
18426,2013,Julio,Federación de Rusia,2,2,,4,-75.516486,10.446304
18427,2013,Julio,Federación de Rusia,0,2,,2,-74.77647900000001,10.886686
18428,2013,Julio,Federación de Rusia,2,2,,4,-72.129595,11.360028999999999
18429,2013,Julio,Federación de Rusia,7,13,,20,-76.532004,3.451668
18430,2013,Julio,Federación de Rusia,36,30,,66,-74.140516,4.697157
18431,2013,Julio,Federación de Rusia,5,1,,6,-75.42726,6.170465
18432,2013,Julio,San Cristóbal y Nevis,0,3,,3,-76.532004,3.451668
18433,2013,Julio,San Cristóbal y Nevis,1,1,,2,-75.42726,6.170465
18434,2013,Julio,San  Vicente y las Granadinas,0,1,,1,-77.35600000000001,0.81488
18435,2013,Julio,San  Vicente y las Granadinas,0,1,,1,-75.516486,10.446304
18436,2013,Julio,San  Vicente y las Granadinas,0,2,,2,-74.140516,4.697157
18437,2013,Julio,San  Vicente y las Granadinas,0,1,,1,-75.42726,6.170465
18438,2013,Julio,Santa Lucia,0,1,,1,-75.516486,10.446304
18439,2013,Julio,Santa Lucia,0,4,,4,-76.532004,3.451668
18440,2013,Julio,Santa Lucia,3,6,,9,-74.140516,4.697157
18441,2013,Julio,Santa Sede/Ciudad del Vaticano,0,1,,1,-76.532004,3.451668
18442,2013,Julio,Santa Sede/Ciudad del Vaticano,0,2,,2,-74.140516,4.697157
18443,2013,Julio,Santo Tomé y Príncipe,0,1,,1,-74.140516,4.697157
18444,2013,Julio,Senegal,1,1,,2,-75.516486,10.446304
18445,2013,Julio,Senegal,1,4,,5,-74.140516,4.697157
18446,2013,Julio,Serbia,1,0,,1,-77.35600000000001,0.81488
18447,2013,Julio,Serbia,1,0,,1,-75.516486,10.446304
18448,2013,Julio,Serbia,1,2,,3,-76.532004,3.451668
18449,2013,Julio,Serbia,7,18,,25,-74.140516,4.697157
18450,2013,Julio,Serbia,1,0,,1,-75.42726,6.170465
18451,2013,Julio,Singapur,0,1,,1,-75.516486,10.446304
18452,2013,Julio,Singapur,24,38,,62,-74.140516,4.697157
18453,2013,Julio,Singapur,0,3,,3,-75.42726,6.170465
18454,2013,Julio,Singapur,0,1,,1,-72.453013,7.819
18455,2013,Julio,Singapur,0,1,,1,-77.35002,8.63337
18456,2013,Julio,República Árabe Siria,0,4,,4,-74.140516,4.697157
18457,2013,Julio,Sri Lanka,2,3,,5,-76.532004,3.451668
18458,2013,Julio,Sri Lanka,1,7,,8,-74.140516,4.697157
18459,2013,Julio,Sudáfrica,0,1,,1,-69.941498,4.191162
18460,2013,Julio,Sudáfrica,1,4,,5,-77.35600000000001,0.81488
18461,2013,Julio,Sudáfrica,4,0,,4,-75.527794,10.406342
18462,2013,Julio,Sudáfrica,1,2,,3,-75.516486,10.446304
18463,2013,Julio,Sudáfrica,26,43,,69,-76.532004,3.451668
18464,2013,Julio,Sudáfrica,25,81,,106,-74.140516,4.697157
18465,2013,Julio,Sudáfrica,2,4,,6,-75.42726,6.170465
18466,2013,Julio,Sudáfrica,0,1,,1,-72.453013,7.819
18467,2013,Julio,Suecia,2,2,,4,-69.941498,4.191162
18468,2013,Julio,Suecia,3,4,,7,-77.35600000000001,0.81488
18469,2013,Julio,Suecia,5,3,,8,-75.527794,10.406342
18470,2013,Julio,Suecia,4,8,,12,-75.516486,10.446304
18471,2013,Julio,Suecia,0,3,,3,-74.77647900000001,10.886686
18472,2013,Julio,Suecia,1,1,,2,-72.129595,11.360028999999999
18473,2013,Julio,Suecia,19,33,,52,-76.532004,3.451668
18474,2013,Julio,Suecia,126,251,,377,-74.140516,4.697157
18475,2013,Julio,Suecia,1,1,,2,-75.736374,4.815189
18476,2013,Julio,Suecia,6,16,,22,-75.42726,6.170465
18477,2013,Julio,Suecia,0,1,,1,-73.181317,7.1280470000000005
18478,2013,Julio,Suiza,2,6,,8,-69.941498,4.191162
18479,2013,Julio,Suiza,1,0,,1,-76.876446,0.33002
18480,2013,Julio,Suiza,31,34,,65,-77.35600000000001,0.81488
18481,2013,Julio,Suiza,13,15,,28,-75.527794,10.406342
18482,2013,Julio,Suiza,23,20,,43,-75.516486,10.446304
18483,2013,Julio,Suiza,3,5,,8,-74.77647900000001,10.886686
18484,2013,Julio,Suiza,1,3,,4,-72.129595,11.360028999999999
18485,2013,Julio,Suiza,75,138,,213,-76.532004,3.451668
18486,2013,Julio,Suiza,541,805,,1346,-74.140516,4.697157
18487,2013,Julio,Suiza,43,63,,106,-75.42726,6.170465
18488,2013,Julio,Suiza,1,0,,1,-70.74025300000001,7.088728999999999
18489,2013,Julio,Suiza,0,1,,1,-73.181317,7.1280470000000005
18490,2013,Julio,Suiza,3,4,,7,-72.453013,7.819
18491,2013,Julio,Suiza,0,1,,1,-72.508188,7.927233
18492,2013,Julio,Suiza,0,2,,2,-77.35002,8.63337
18493,2013,Julio,Surinam,0,1,,1,-76.532004,3.451668
18494,2013,Julio,Surinam,5,30,,35,-74.140516,4.697157
18495,2013,Julio,Surinam,3,2,,5,-75.42726,6.170465
18496,2013,Julio,Taiwán,0,3,,3,-75.516486,10.446304
18497,2013,Julio,Taiwán,1,3,,4,-76.532004,3.451668
18498,2013,Julio,Taiwán,3,2,,5,-74.140516,4.697157
18499,2013,Julio,Taiwán,1,1,,2,-75.736374,4.815189
18500,2013,Julio,República de Tayikistán,0,1,,1,-74.140516,4.697157
18501,2013,Julio,Tailandia,1,0,,1,-75.527794,10.406342
18502,2013,Julio,Tailandia,4,7,,11,-76.532004,3.451668
18503,2013,Julio,Tailandia,13,23,,36,-74.140516,4.697157
18504,2013,Julio,Tíbet/Región Autónoma de China,2,1,,3,-74.140516,4.697157
18505,2013,Julio,Territorio Antártico Británico/Territorio Británico de Ultramar,3,2,,5,-74.140516,4.697157
18506,2013,Julio,Territorio Antártico Británico/Territorio Británico de Ultramar,0,1,,1,-75.42726,6.170465
18507,2013,Julio,Territorio Antártico Británico/Territorio Británico de Ultramar,1,2,,3,-72.453013,7.819
18508,2013,Julio,Tanzania,0,1,,1,-74.140516,4.697157
18509,2013,Julio,Tanzania,0,1,,1,-72.453013,7.819
18510,2013,Julio,República Democrática de Timor Oriental,0,1,,1,-74.140516,4.697157
18511,2013,Julio,Trinidad y Tobago,46,28,,74,-75.516486,10.446304
18512,2013,Julio,Trinidad y Tobago,7,10,,17,-74.77647900000001,10.886686
18513,2013,Julio,Trinidad y Tobago,5,5,,10,-72.129595,11.360028999999999
18514,2013,Julio,Trinidad y Tobago,9,34,,43,-76.532004,3.451668
18515,2013,Julio,Trinidad y Tobago,26,49,,75,-74.140516,4.697157
18516,2013,Julio,Trinidad y Tobago,0,1,,1,-75.736374,4.815189
18517,2013,Julio,Trinidad y Tobago,6,9,,15,-75.42726,6.170465
18518,2013,Julio,Trinidad y Tobago,3,2,,5,-73.181317,7.1280470000000005
18519,2013,Julio,Túnez,7,12,,19,-74.140516,4.697157
18520,2013,Julio,Túnez,0,1,,1,-75.42726,6.170465
18521,2013,Julio,Turkmenistán,0,6,,6,-74.140516,4.697157
18522,2013,Julio,Turquía,0,1,,1,-69.941498,4.191162
18523,2013,Julio,Turquía,0,1,,1,-77.35600000000001,0.81488
18524,2013,Julio,Turquía,0,1,,1,-75.527794,10.406342
18525,2013,Julio,Turquía,0,3,,3,-75.516486,10.446304
18526,2013,Julio,Turquía,0,1,,1,-74.765343,10.970933
18527,2013,Julio,Turquía,1,0,,1,-72.129595,11.360028999999999
18528,2013,Julio,Turquía,5,20,,25,-76.532004,3.451668
18529,2013,Julio,Turquía,31,88,,119,-74.140516,4.697157
18530,2013,Julio,Turquía,1,11,,12,-75.42726,6.170465
18531,2013,Julio,Turquía,0,1,,1,-72.453013,7.819
18532,2013,Julio,Turkmenistán,0,7,,7,-74.140516,4.697157
18533,2013,Julio,Ucrania,0,2,,2,-75.527794,10.406342
18534,2013,Julio,Ucrania,3,8,,11,-75.516486,10.446304
18535,2013,Julio,Ucrania,0,1,,1,-74.77647900000001,10.886686
18536,2013,Julio,Ucrania,0,1,,1,-74.765343,10.970933
18537,2013,Julio,Ucrania,0,7,,7,-74.213989,11.247722999999999
18538,2013,Julio,Ucrania,11,18,,29,-76.532004,3.451668
18539,2013,Julio,Ucrania,0,1,,1,-77.061029,3.8844260000000004
18540,2013,Julio,Ucrania,73,92,,165,-74.140516,4.697157
18541,2013,Julio,Ucrania,1,1,,2,-75.42726,6.170465
18542,2013,Julio,Uganda,2,3,,5,-76.532004,3.451668
18543,2013,Julio,Uganda,2,7,,9,-74.140516,4.697157
18544,2013,Julio,Federación de Rusia,1,2,,3,-69.941498,4.191162
18545,2013,Julio,Federación de Rusia,2,4,,6,-77.35600000000001,0.81488
18546,2013,Julio,Federación de Rusia,1,5,,6,-75.527794,10.406342
18547,2013,Julio,Federación de Rusia,0,1,,1,-75.516486,10.446304
18548,2013,Julio,Federación de Rusia,0,1,,1,-74.77647900000001,10.886686
18549,2013,Julio,Federación de Rusia,0,1,,1,-74.765343,10.970933
18550,2013,Julio,Federación de Rusia,0,14,,14,-74.213989,11.247722999999999
18551,2013,Julio,Federación de Rusia,5,13,,18,-76.532004,3.451668
18552,2013,Julio,Federación de Rusia,153,273,,426,-74.140516,4.697157
18553,2013,Julio,Federación de Rusia,4,3,,7,-75.42726,6.170465
18554,2013,Julio,Federación de Rusia,1,1,,2,-72.453013,7.819
18555,2013,Julio,Uruguay,4,4,,8,-77.35600000000001,0.81488
18556,2013,Julio,Uruguay,2,1,,3,-75.527794,10.406342
18557,2013,Julio,Uruguay,72,43,,115,-75.516486,10.446304
18558,2013,Julio,Uruguay,2,9,,11,-74.77647900000001,10.886686
18559,2013,Julio,Uruguay,2,2,,4,-72.129595,11.360028999999999
18560,2013,Julio,Uruguay,25,22,,47,-81.70216500000001,12.5862
18561,2013,Julio,Uruguay,15,36,,51,-76.532004,3.451668
18562,2013,Julio,Uruguay,163,358,,521,-74.140516,4.697157
18563,2013,Julio,Uruguay,0,3,,3,-75.736374,4.815189
18564,2013,Julio,Uruguay,26,60,,86,-75.42726,6.170465
18565,2013,Julio,Uruguay,5,8,,13,-72.453013,7.819
18566,2013,Julio,Venezuela,0,1,,1,-76.876446,0.33002
18567,2013,Julio,Venezuela,69,115,,184,-77.35600000000001,0.81488
18568,2013,Julio,Venezuela,6,9,,15,-75.527794,10.406342
18569,2013,Julio,Venezuela,88,168,,256,-75.516486,10.446304
18570,2013,Julio,Venezuela,45,128,,173,-74.77647900000001,10.886686
18571,2013,Julio,Venezuela,0,2,,2,-74.213989,11.247722999999999
18572,2013,Julio,Venezuela,1367,1949,,3316,-72.129595,11.360028999999999
18573,2013,Julio,Venezuela,1,0,,1,-72.919186,11.52863
18574,2013,Julio,Venezuela,7,6,,13,-81.70216500000001,12.5862
18575,2013,Julio,Venezuela,88,177,,265,-76.532004,3.451668
18576,2013,Julio,Venezuela,5972,6774,,12746,-74.140516,4.697157
18577,2013,Julio,Venezuela,4,11,,15,-75.736374,4.815189
18578,2013,Julio,Venezuela,476,614,,1090,-75.42726,6.170465
18579,2013,Julio,Venezuela,151,259,,410,-67.48402800000001,6.185536
18580,2013,Julio,Venezuela,31,53,,84,-70.74025300000001,7.088728999999999
18581,2013,Julio,Venezuela,7,9,,16,-73.181317,7.1280470000000005
18582,2013,Julio,Venezuela,1625,1944,,3569,-72.453013,7.819
18583,2013,Julio,Venezuela,195,278,,473,-72.508188,7.927233
18584,2013,Julio,Venezuela,0,2,,2,-77.35002,8.63337
18585,2013,Julio,Vietnam,10,24,,34,-74.140516,4.697157
18586,2013,Julio,Zambia,0,1,,1,-74.140516,4.697157
18587,2013,Julio,Zimbabue,1,1,,2,-74.140516,4.697157
18588,2013,Julio,Reino Unido de Gran Bretaña e Irlanda del Norte,12,12,,24,-69.941498,4.191162
18589,2013,Julio,Reino Unido de Gran Bretaña e Irlanda del Norte,54,68,,122,-77.35600000000001,0.81488
18590,2013,Julio,Reino Unido de Gran Bretaña e Irlanda del Norte,11,24,,35,-75.527794,10.406342
18591,2013,Julio,Reino Unido de Gran Bretaña e Irlanda del Norte,3,8,,11,-75.516486,10.446304
18592,2013,Julio,Reino Unido de Gran Bretaña e Irlanda del Norte,0,1,,1,-74.77647900000001,10.886686
18593,2013,Julio,Reino Unido de Gran Bretaña e Irlanda del Norte,0,2,,2,-74.765343,10.970933
18594,2013,Julio,Reino Unido de Gran Bretaña e Irlanda del Norte,2,1,,3,-81.70216500000001,12.5862
18595,2013,Julio,Reino Unido de Gran Bretaña e Irlanda del Norte,34,74,,108,-76.532004,3.451668
18596,2013,Julio,Reino Unido de Gran Bretaña e Irlanda del Norte,394,651,,1045,-74.140516,4.697157
18597,2013,Julio,Reino Unido de Gran Bretaña e Irlanda del Norte,18,33,,51,-75.42726,6.170465
18598,2013,Julio,Reino Unido de Gran Bretaña e Irlanda del Norte,1,0,,1,-70.74025300000001,7.088728999999999
18599,2013,Julio,Reino Unido de Gran Bretaña e Irlanda del Norte,0,1,,1,-73.181317,7.1280470000000005
18600,2013,Julio,Reino Unido de Gran Bretaña e Irlanda del Norte,4,14,,18,-72.453013,7.819
18601,2013,Julio,Reino Unido de Gran Bretaña e Irlanda del Norte,2,9,,11,-77.35002,8.63337
18602,2013,Julio,Países Bajos,5,4,,9,-69.941498,4.191162
18603,2013,Julio,Países Bajos,16,32,,48,-77.35600000000001,0.81488
18604,2013,Julio,Países Bajos,14,6,,20,-75.527794,10.406342
18605,2013,Julio,Países Bajos,7,8,,15,-75.516486,10.446304
18606,2013,Julio,Países Bajos,12,33,,45,-74.77647900000001,10.886686
18607,2013,Julio,Países Bajos,0,4,,4,-74.213989,11.247722999999999
18608,2013,Julio,Países Bajos,0,1,,1,-72.129595,11.360028999999999
18609,2013,Julio,Países Bajos,2,0,,2,-81.70216500000001,12.5862
18610,2013,Julio,Países Bajos,59,101,,160,-76.532004,3.451668
18611,2013,Julio,Países Bajos,744,1068,,1812,-74.140516,4.697157
18612,2013,Julio,Países Bajos,127,135,,262,-75.42726,6.170465
18613,2013,Julio,Países Bajos,2,9,,11,-73.181317,7.1280470000000005
18614,2013,Julio,Países Bajos,18,9,,27,-72.453013,7.819
18615,2013,Julio,Países Bajos,1,3,,4,-72.508188,7.927233
18616,2013,Julio,Países Bajos,1,0,,1,-77.35002,8.63337
18617,2013,Julio,Desconocido,0,1,,1,-74.140516,4.697157
18618,2013,Julio,Lituania,0,1,,1,-75.516486,10.446304
18619,2013,Julio,Lituania,1,2,,3,-76.532004,3.451668
18620,2013,Julio,Lituania,1,2,,3,-74.140516,4.697157
18621,2013,Julio,Lituania,1,0,,1,-72.453013,7.819
18622,2013,Julio,Reino Unido de Gran Bretaña e Irlanda del Norte,0,2,,2,-74.140516,4.697157
18623,2013,Julio,Reino Unido de Gran Bretaña e Irlanda del Norte,2,5,,7,-75.527794,10.406342
18624,2013,Julio,Reino Unido de Gran Bretaña e Irlanda del Norte,1,1,,2,-76.532004,3.451668
18625,2013,Julio,Reino Unido de Gran Bretaña e Irlanda del Norte,2,9,,11,-74.140516,4.697157
18626,2013,Julio,Reino Unido de Gran Bretaña e Irlanda del Norte,0,1,,1,-75.42726,6.170465
18627,2013,Julio,Reino Unido de Gran Bretaña e Irlanda del Norte,0,3,,3,-72.453013,7.819
18628,2013,Julio,Letonia,0,7,,7,-75.527794,10.406342
18629,2013,Julio,Letonia,0,1,,1,-76.532004,3.451668
18630,2013,Julio,Marruecos,1,0,,1,-74.140516,4.697157
18631,2013,Julio,República CentroÁfricana,0,1,,1,-75.516486,10.446304
18632,2013,Julio,República CentroÁfricana,0,1,,1,-74.140516,4.697157
18633,2013,Agosto,Desconocido,0,1,,1,-74.140516,4.697157
18634,2013,Agosto,Albania,3,5,,8,-74.140516,4.697157
18635,2013,Agosto,Alemania,13,22,,35,-69.941498,4.191162
18636,2013,Agosto,Alemania,45,57,,102,-77.35600000000001,0.81488
18637,2013,Agosto,Alemania,1,0,,1,-78.802679,18.00143
18638,2013,Agosto,Alemania,20,33,,53,-75.527794,10.406342
18639,2013,Agosto,Alemania,35,55,,90,-75.516486,10.446304
18640,2013,Agosto,Alemania,9,17,,26,-74.77647900000001,10.886686
18641,2013,Agosto,Alemania,8,13,,21,-72.129595,11.360028999999999
18642,2013,Agosto,Alemania,0,2,,2,-81.70216500000001,12.5862
18643,2013,Agosto,Alemania,49,62,,111,-76.532004,3.451668
18644,2013,Agosto,Alemania,1621,2174,,3795,-74.140516,4.697157
18645,2013,Agosto,Alemania,3,2,,5,-75.736374,4.815189
18646,2013,Agosto,Alemania,61,115,,176,-75.42726,6.170465
18647,2013,Agosto,Alemania,2,2,,4,-73.181317,7.1280470000000005
18648,2013,Agosto,Alemania,5,16,,21,-72.453013,7.819
18649,2013,Agosto,Alemania,1,0,,1,-72.508188,7.927233
18650,2013,Agosto,Alemania,6,2,,8,-77.35002,8.63337
18651,2013,Agosto,Andorra,0,4,,4,-75.516486,10.446304
18652,2013,Agosto,Andorra,0,1,,1,-72.129595,11.360028999999999
18653,2013,Agosto,Andorra,3,10,,13,-74.140516,4.697157
18654,2013,Agosto,Angola,1,1,,2,-74.140516,4.697157
18655,2013,Agosto,Antigua y Barbuda,0,1,,1,-75.516486,10.446304
18656,2013,Agosto,Antigua y Barbuda,1,2,,3,-74.140516,4.697157
18657,2013,Agosto,Antigua y Barbuda,0,1,,1,-75.42726,6.170465
18658,2013,Agosto,Países Bajos,0,1,,1,-75.42726,6.170465
18659,2013,Agosto,Arabia Saudita,0,1,,1,-74.140516,4.697157
18660,2013,Agosto,Arabia Saudita,0,2,,2,-75.42726,6.170465
18661,2013,Agosto,Arabia Saudita,0,2,,2,-74.140516,4.697157
18662,2013,Agosto,Argelia,1,2,,3,-74.140516,4.697157
18663,2013,Agosto,Argentina,0,2,,2,-69.941498,4.191162
18664,2013,Agosto,Argentina,2,3,,5,-76.876446,0.33002
18665,2013,Agosto,Argentina,33,76,,109,-77.35600000000001,0.81488
18666,2013,Agosto,Argentina,0,2,,2,-78.802679,18.00143
18667,2013,Agosto,Argentina,153,119,,272,-75.527794,10.406342
18668,2013,Agosto,Argentina,783,605,,1388,-75.516486,10.446304
18669,2013,Agosto,Argentina,19,39,,58,-74.77647900000001,10.886686
18670,2013,Agosto,Argentina,12,25,,37,-72.129595,11.360028999999999
18671,2013,Agosto,Argentina,201,186,,387,-81.70216500000001,12.5862
18672,2013,Agosto,Argentina,43,100,,143,-76.532004,3.451668
18673,2013,Agosto,Argentina,2966,4493,,7459,-74.140516,4.697157
18674,2013,Agosto,Argentina,14,22,,36,-75.736374,4.815189
18675,2013,Agosto,Argentina,139,256,,395,-75.42726,6.170465
18676,2013,Agosto,Argentina,2,5,,7,-73.181317,7.1280470000000005
18677,2013,Agosto,Argentina,24,35,,59,-72.453013,7.819
18678,2013,Agosto,Argentina,1,6,,7,-72.508188,7.927233
18679,2013,Agosto,Argentina,0,3,,3,-76.7333,8.06667
18680,2013,Agosto,Argentina,8,7,,15,-77.35002,8.63337
18681,2013,Agosto,República de Armenia,1,2,,3,-74.140516,4.697157
18682,2013,Agosto,Aruba,1,1,,2,-74.77647900000001,10.886686
18683,2013,Agosto,Aruba,3,3,,6,-74.140516,4.697157
18684,2013,Agosto,Australia,8,7,,15,-69.941498,4.191162
18685,2013,Agosto,Australia,26,27,,53,-77.35600000000001,0.81488
18686,2013,Agosto,Australia,32,29,,61,-75.527794,10.406342
18687,2013,Agosto,Australia,23,26,,49,-75.516486,10.446304
18688,2013,Agosto,Australia,3,11,,14,-74.77647900000001,10.886686
18689,2013,Agosto,Australia,0,1,,1,-74.213989,11.247722999999999
18690,2013,Agosto,Australia,0,7,,7,-72.129595,11.360028999999999
18691,2013,Agosto,Australia,6,19,,25,-76.532004,3.451668
18692,2013,Agosto,Australia,204,334,,538,-74.140516,4.697157
18693,2013,Agosto,Australia,0,2,,2,-75.736374,4.815189
18694,2013,Agosto,Australia,22,61,,83,-75.42726,6.170465
18695,2013,Agosto,Australia,2,1,,3,-73.181317,7.1280470000000005
18696,2013,Agosto,Australia,3,1,,4,-72.453013,7.819
18697,2013,Agosto,Australia,0,1,,1,-72.508188,7.927233
18698,2013,Agosto,Australia,2,6,,8,-77.35002,8.63337
18699,2013,Agosto,Austria,2,2,,4,-69.941498,4.191162
18700,2013,Agosto,Austria,7,10,,17,-77.35600000000001,0.81488
18701,2013,Agosto,Austria,5,8,,13,-75.527794,10.406342
18702,2013,Agosto,Austria,8,6,,14,-75.516486,10.446304
18703,2013,Agosto,Austria,1,0,,1,-74.77647900000001,10.886686
18704,2013,Agosto,Austria,3,0,,3,-72.129595,11.360028999999999
18705,2013,Agosto,Austria,11,10,,21,-76.532004,3.451668
18706,2013,Agosto,Austria,134,215,,349,-74.140516,4.697157
18707,2013,Agosto,Austria,6,12,,18,-75.42726,6.170465
18708,2013,Agosto,Austria,1,1,,2,-72.453013,7.819
18709,2013,Agosto,Austria,1,1,,2,-77.35002,8.63337
18710,2013,Agosto,Azerbaiyán,0,2,,2,-74.140516,4.697157
18711,2013,Agosto,Bahamas,0,2,,2,-75.516486,10.446304
18712,2013,Agosto,Bahamas,0,3,,3,-74.77647900000001,10.886686
18713,2013,Agosto,Bahamas,1,2,,3,-76.532004,3.451668
18714,2013,Agosto,Bahamas,3,1,,4,-74.140516,4.697157
18715,2013,Agosto,Bahamas,4,8,,12,-75.42726,6.170465
18716,2013,Agosto,Bangladesh,1,0,,1,-69.941498,4.191162
18717,2013,Agosto,Bangladesh,0,1,,1,-74.140516,4.697157
18718,2013,Agosto,Bangladesh,0,1,,1,-75.42726,6.170465
18719,2013,Agosto,Barbados,1,2,,3,-74.140516,4.697157
18720,2013,Agosto,Barbados,7,12,,19,-75.42726,6.170465
18721,2013,Agosto,República de Belarús,1,0,,1,-72.129595,11.360028999999999
18722,2013,Agosto,República de Belarús,1,0,,1,-74.140516,4.697157
18723,2013,Agosto,Bélgica,5,1,,6,-69.941498,4.191162
18724,2013,Agosto,Bélgica,10,11,,21,-77.35600000000001,0.81488
18725,2013,Agosto,Bélgica,3,3,,6,-75.527794,10.406342
18726,2013,Agosto,Bélgica,3,6,,9,-75.516486,10.446304
18727,2013,Agosto,Bélgica,2,5,,7,-74.77647900000001,10.886686
18728,2013,Agosto,Bélgica,2,3,,5,-72.129595,11.360028999999999
18729,2013,Agosto,Bélgica,9,30,,39,-76.532004,3.451668
18730,2013,Agosto,Bélgica,126,266,,392,-74.140516,4.697157
18731,2013,Agosto,Bélgica,14,27,,41,-75.42726,6.170465
18732,2013,Agosto,Bélgica,0,1,,1,-73.181317,7.1280470000000005
18733,2013,Agosto,Bélgica,0,1,,1,-72.453013,7.819
18734,2013,Agosto,Bélgica,0,1,,1,-77.35002,8.63337
18735,2013,Agosto,Belice,0,1,,1,-75.516486,10.446304
18736,2013,Agosto,Belice,0,1,,1,-81.70216500000001,12.5862
18737,2013,Agosto,Belice,7,15,,22,-74.140516,4.697157
18738,2013,Agosto,Belice,2,1,,3,-75.42726,6.170465
18739,2013,Agosto,Belice,2,0,,2,-72.453013,7.819
18740,2013,Agosto,Bermudas/Territorio Británico de Ultramar,0,3,,3,-75.42726,6.170465
18741,2013,Agosto,Bolivia,1,0,,1,-69.941498,4.191162
18742,2013,Agosto,Bolivia,4,8,,12,-77.35600000000001,0.81488
18743,2013,Agosto,Bolivia,1,1,,2,-75.527794,10.406342
18744,2013,Agosto,Bolivia,28,23,,51,-75.516486,10.446304
18745,2013,Agosto,Bolivia,3,5,,8,-74.77647900000001,10.886686
18746,2013,Agosto,Bolivia,2,2,,4,-72.129595,11.360028999999999
18747,2013,Agosto,Bolivia,5,3,,8,-81.70216500000001,12.5862
18748,2013,Agosto,Bolivia,21,22,,43,-76.532004,3.451668
18749,2013,Agosto,Bolivia,303,416,,719,-74.140516,4.697157
18750,2013,Agosto,Bolivia,0,1,,1,-75.736374,4.815189
18751,2013,Agosto,Bolivia,14,29,,43,-75.42726,6.170465
18752,2013,Agosto,Bolivia,1,5,,6,-72.453013,7.819
18753,2013,Agosto,Bosnia y Herzegovina,3,0,,3,-74.140516,4.697157
18754,2013,Agosto,Bosnia y Herzegovina,1,0,,1,-75.42726,6.170465
18755,2013,Agosto,Botsuana,1,0,,1,-74.140516,4.697157
18756,2013,Agosto,Brasil,64,75,,139,-69.941498,4.191162
18757,2013,Agosto,Brasil,0,2,,2,-76.876446,0.33002
18758,2013,Agosto,Brasil,7,25,,32,-77.35600000000001,0.81488
18759,2013,Agosto,Brasil,0,1,,1,-78.802679,18.00143
18760,2013,Agosto,Brasil,66,51,,117,-75.527794,10.406342
18761,2013,Agosto,Brasil,206,190,,396,-75.516486,10.446304
18762,2013,Agosto,Brasil,9,20,,29,-74.77647900000001,10.886686
18763,2013,Agosto,Brasil,2,9,,11,-72.129595,11.360028999999999
18764,2013,Agosto,Brasil,33,20,,53,-81.70216500000001,12.5862
18765,2013,Agosto,Brasil,27,64,,91,-76.532004,3.451668
18766,2013,Agosto,Brasil,2636,4057,,6693,-74.140516,4.697157
18767,2013,Agosto,Brasil,0,1,,1,-75.736374,4.815189
18768,2013,Agosto,Brasil,81,170,,251,-75.42726,6.170465
18769,2013,Agosto,Brasil,1,2,,3,-73.181317,7.1280470000000005
18770,2013,Agosto,Brasil,4,26,,30,-72.453013,7.819
18771,2013,Agosto,Brasil,0,1,,1,-72.508188,7.927233
18772,2013,Agosto,Brasil,1,2,,3,-77.35002,8.63337
18773,2013,Agosto,Bulgaria,0,1,,1,-76.532004,3.451668
18774,2013,Agosto,Bulgaria,0,1,,1,-77.061029,3.8844260000000004
18775,2013,Agosto,Bulgaria,7,14,,21,-74.140516,4.697157
18776,2013,Agosto,Bulgaria,1,0,,1,-75.42726,6.170465
18777,2013,Agosto,Bulgaria,1,0,,1,-72.453013,7.819
18778,2013,Agosto,Bulgaria,1,1,,2,-72.508188,7.927233
18779,2013,Agosto,Bulgaria,0,1,,1,-75.68164200000001,9.402597
18780,2013,Agosto,Burkina Faso,0,1,,1,-75.42726,6.170465
18781,2013,Agosto,Burundi,1,4,,5,-74.140516,4.697157
18782,2013,Agosto,Bután,1,0,,1,-75.42726,6.170465
18783,2013,Agosto,Islas Caimán/Territorio Británico de Ultramar,0,1,,1,-75.516486,10.446304
18784,2013,Agosto,Islas Caimán/Territorio Británico de Ultramar,1,0,,1,-74.77647900000001,10.886686
18785,2013,Agosto,Islas Caimán/Territorio Británico de Ultramar,1,1,,2,-81.70216500000001,12.5862
18786,2013,Agosto,Islas Caimán/Territorio Británico de Ultramar,2,0,,2,-75.42726,6.170465
18787,2013,Agosto,Camboya,3,4,,7,-74.140516,4.697157
18788,2013,Agosto,Canadá,5,4,,9,-69.941498,4.191162
18789,2013,Agosto,Canadá,10,7,,17,-77.35600000000001,0.81488
18790,2013,Agosto,Canadá,9,13,,22,-75.527794,10.406342
18791,2013,Agosto,Canadá,40,53,,93,-75.516486,10.446304
18792,2013,Agosto,Canadá,9,25,,34,-74.77647900000001,10.886686
18793,2013,Agosto,Canadá,1,4,,5,-72.129595,11.360028999999999
18794,2013,Agosto,Canadá,4,4,,8,-81.70216500000001,12.5862
18795,2013,Agosto,Canadá,42,62,,104,-76.532004,3.451668
18796,2013,Agosto,Canadá,3,2,,5,-75.76635300000001,4.45285
18797,2013,Agosto,Canadá,820,1357,,2177,-74.140516,4.697157
18798,2013,Agosto,Canadá,1,1,,2,-75.736374,4.815189
18799,2013,Agosto,Canadá,151,272,,423,-75.42726,6.170465
18800,2013,Agosto,Canadá,0,2,,2,-73.181317,7.1280470000000005
18801,2013,Agosto,Canadá,2,10,,12,-72.453013,7.819
18802,2013,Agosto,Canadá,0,1,,1,-72.508188,7.927233
18803,2013,Agosto,Canadá,1,0,,1,-76.7333,8.06667
18804,2013,Agosto,Canadá,2,1,,3,-77.35002,8.63337
18805,2013,Agosto,España,0,1,,1,-76.876446,0.33002
18806,2013,Agosto,España,2,7,,9,-77.35600000000001,0.81488
18807,2013,Agosto,España,0,1,,1,-75.527794,10.406342
18808,2013,Agosto,España,3,9,,12,-74.77647900000001,10.886686
18809,2013,Agosto,España,49,99,,148,-76.532004,3.451668
18810,2013,Agosto,España,148,280,,428,-74.140516,4.697157
18811,2013,Agosto,España,53,115,,168,-75.42726,6.170465
18812,2013,Agosto,España,1,0,,1,-73.181317,7.1280470000000005
18813,2013,Agosto,España,4,1,,5,-72.508188,7.927233
18814,2013,Agosto,República Democrática del Congo,1,0,,1,-76.532004,3.451668
18815,2013,Agosto,República Democrática del Congo,4,5,,9,-74.140516,4.697157
18816,2013,Agosto,República Democrática del Congo,0,1,,1,-75.42726,6.170465
18817,2013,Agosto,República de Corea,2,1,,3,-69.941498,4.191162
18818,2013,Agosto,República de Corea,7,16,,23,-77.35600000000001,0.81488
18819,2013,Agosto,República de Corea,0,1,,1,-78.802679,18.00143
18820,2013,Agosto,República de Corea,1,3,,4,-75.516486,10.446304
18821,2013,Agosto,República de Corea,1,0,,1,-74.77647900000001,10.886686
18822,2013,Agosto,República de Corea,0,1,,1,-72.129595,11.360028999999999
18823,2013,Agosto,República de Corea,0,8,,8,-76.532004,3.451668
18824,2013,Agosto,República de Corea,250,434,,684,-74.140516,4.697157
18825,2013,Agosto,República de Corea,8,17,,25,-75.42726,6.170465
18826,2013,Agosto,República de Corea,0,2,,2,-73.181317,7.1280470000000005
18827,2013,Agosto,República de Corea,2,7,,9,-72.453013,7.819
18828,2013,Agosto,República de Corea,0,1,,1,-72.508188,7.927233
18829,2013,Agosto,Costa de Marfil,0,1,,1,-76.532004,3.451668
18830,2013,Agosto,Costa Rica,1,2,,3,-77.35600000000001,0.81488
18831,2013,Agosto,Costa Rica,1,0,,1,-75.527794,10.406342
18832,2013,Agosto,Costa Rica,62,52,,114,-75.516486,10.446304
18833,2013,Agosto,Costa Rica,9,11,,20,-74.77647900000001,10.886686
18834,2013,Agosto,Costa Rica,1,2,,3,-72.129595,11.360028999999999
18835,2013,Agosto,Costa Rica,205,144,,349,-81.70216500000001,12.5862
18836,2013,Agosto,Costa Rica,29,50,,79,-76.532004,3.451668
18837,2013,Agosto,Costa Rica,578,885,,1463,-74.140516,4.697157
18838,2013,Agosto,Costa Rica,6,17,,23,-75.736374,4.815189
18839,2013,Agosto,Costa Rica,113,234,,347,-75.42726,6.170465
18840,2013,Agosto,Costa Rica,1,0,,1,-67.48402800000001,6.185536
18841,2013,Agosto,Costa Rica,0,1,,1,-73.181317,7.1280470000000005
18842,2013,Agosto,Costa Rica,1,0,,1,-72.453013,7.819
18843,2013,Agosto,Costa Rica,1,1,,2,-72.508188,7.927233
18844,2013,Agosto,Costa Rica,1,1,,2,-77.35002,8.63337
18845,2013,Agosto,Croacia,0,1,,1,-77.35600000000001,0.81488
18846,2013,Agosto,Croacia,0,1,,1,-75.527794,10.406342
18847,2013,Agosto,Croacia,1,0,,1,-75.516486,10.446304
18848,2013,Agosto,Croacia,1,1,,2,-72.129595,11.360028999999999
18849,2013,Agosto,Croacia,0,7,,7,-76.532004,3.451668
18850,2013,Agosto,Croacia,8,15,,23,-74.140516,4.697157
18851,2013,Agosto,Cuba,0,3,,3,-77.35600000000001,0.81488
18852,2013,Agosto,Cuba,8,12,,20,-75.516486,10.446304
18853,2013,Agosto,Cuba,7,10,,17,-74.77647900000001,10.886686
18854,2013,Agosto,Cuba,0,1,,1,-72.129595,11.360028999999999
18855,2013,Agosto,Cuba,4,1,,5,-81.70216500000001,12.5862
18856,2013,Agosto,Cuba,15,21,,36,-76.532004,3.451668
18857,2013,Agosto,Cuba,114,233,,347,-74.140516,4.697157
18858,2013,Agosto,Cuba,1,2,,3,-75.736374,4.815189
18859,2013,Agosto,Cuba,16,52,,68,-75.42726,6.170465
18860,2013,Agosto,Cuba,0,2,,2,-73.181317,7.1280470000000005
18861,2013,Agosto,Cuba,2,1,,3,-72.453013,7.819
18862,2013,Agosto,Cuba,0,1,,1,-72.508188,7.927233
18863,2013,Agosto,Curazao,7,3,,10,-74.140516,4.697157
18864,2013,Agosto,República Checa,3,0,,3,-77.35600000000001,0.81488
18865,2013,Agosto,República Checa,0,1,,1,-75.527794,10.406342
18866,2013,Agosto,República Checa,0,1,,1,-74.77647900000001,10.886686
18867,2013,Agosto,República Checa,1,1,,2,-72.129595,11.360028999999999
18868,2013,Agosto,República Checa,2,1,,3,-76.532004,3.451668
18869,2013,Agosto,República Checa,21,37,,58,-74.140516,4.697157
18870,2013,Agosto,República Checa,2,2,,4,-75.42726,6.170465
18871,2013,Agosto,República Checa,0,1,,1,-72.453013,7.819
18872,2013,Agosto,Chile,1,2,,3,-69.941498,4.191162
18873,2013,Agosto,Chile,25,71,,96,-77.35600000000001,0.81488
18874,2013,Agosto,Chile,50,32,,82,-75.527794,10.406342
18875,2013,Agosto,Chile,93,88,,181,-75.516486,10.446304
18876,2013,Agosto,Chile,3,17,,20,-74.77647900000001,10.886686
18877,2013,Agosto,Chile,0,1,,1,-74.213989,11.247722999999999
18878,2013,Agosto,Chile,8,12,,20,-72.129595,11.360028999999999
18879,2013,Agosto,Chile,32,31,,63,-81.70216500000001,12.5862
18880,2013,Agosto,Chile,51,60,,111,-76.532004,3.451668
18881,2013,Agosto,Chile,3055,4040,,7095,-74.140516,4.697157
18882,2013,Agosto,Chile,1,0,,1,-75.736374,4.815189
18883,2013,Agosto,Chile,70,191,,261,-75.42726,6.170465
18884,2013,Agosto,Chile,0,1,,1,-70.74025300000001,7.088728999999999
18885,2013,Agosto,Chile,0,1,,1,-73.181317,7.1280470000000005
18886,2013,Agosto,Chile,6,7,,13,-72.453013,7.819
18887,2013,Agosto,Chile,0,1,,1,-72.508188,7.927233
18888,2013,Agosto,Chile,0,2,,2,-77.35002,8.63337
18889,2013,Agosto,China,0,1,,1,-69.941498,4.191162
18890,2013,Agosto,China,1,1,,2,-77.35600000000001,0.81488
18891,2013,Agosto,China,9,5,,14,-75.516486,10.446304
18892,2013,Agosto,China,5,1,,6,-74.77647900000001,10.886686
18893,2013,Agosto,China,0,1,,1,-72.129595,11.360028999999999
18894,2013,Agosto,China,6,7,,13,-76.532004,3.451668
18895,2013,Agosto,China,160,401,,561,-74.140516,4.697157
18896,2013,Agosto,China,7,10,,17,-75.42726,6.170465
18897,2013,Agosto,China,1,0,,1,-73.181317,7.1280470000000005
18898,2013,Agosto,Taiwán,4,0,,4,-77.35600000000001,0.81488
18899,2013,Agosto,Taiwán,1,2,,3,-74.77647900000001,10.886686
18900,2013,Agosto,Taiwán,0,1,,1,-76.532004,3.451668
18901,2013,Agosto,Taiwán,42,66,,108,-74.140516,4.697157
18902,2013,Agosto,Taiwán,9,11,,20,-75.42726,6.170465
18903,2013,Agosto,Taiwán,0,1,,1,-73.181317,7.1280470000000005
18904,2013,Agosto,Chipre,0,5,,5,-74.140516,4.697157
18905,2013,Agosto,Dinamarca,1,2,,3,-69.941498,4.191162
18906,2013,Agosto,Dinamarca,3,3,,6,-77.35600000000001,0.81488
18907,2013,Agosto,Dinamarca,1,1,,2,-75.527794,10.406342
18908,2013,Agosto,Dinamarca,2,3,,5,-75.516486,10.446304
18909,2013,Agosto,Dinamarca,1,2,,3,-74.77647900000001,10.886686
18910,2013,Agosto,Dinamarca,0,1,,1,-74.765343,10.970933
18911,2013,Agosto,Dinamarca,0,1,,1,-74.213989,11.247722999999999
18912,2013,Agosto,Dinamarca,0,1,,1,-72.129595,11.360028999999999
18913,2013,Agosto,Dinamarca,4,6,,10,-76.532004,3.451668
18914,2013,Agosto,Dinamarca,40,89,,129,-74.140516,4.697157
18915,2013,Agosto,Dinamarca,9,13,,22,-75.42726,6.170465
18916,2013,Agosto,Dinamarca,1,0,,1,-70.74025300000001,7.088728999999999
18917,2013,Agosto,Dinamarca,0,3,,3,-77.35002,8.63337
18918,2013,Agosto,Dominica,0,2,,2,-74.140516,4.697157
18919,2013,Agosto,Dominica,1,1,,2,-75.42726,6.170465
18920,2013,Agosto,Ecuador,24,44,,68,-76.876446,0.33002
18921,2013,Agosto,Ecuador,1142,1564,,2706,-77.35600000000001,0.81488
18922,2013,Agosto,Ecuador,1,143,,144,-78.802679,18.00143
18923,2013,Agosto,Ecuador,48,53,,101,-75.527794,10.406342
18924,2013,Agosto,Ecuador,22,38,,60,-75.516486,10.446304
18925,2013,Agosto,Ecuador,5,4,,9,-74.77647900000001,10.886686
18926,2013,Agosto,Ecuador,14,21,,35,-72.129595,11.360028999999999
18927,2013,Agosto,Ecuador,0,1,,1,-81.703935,12.574411099999999
18928,2013,Agosto,Ecuador,4,0,,4,-81.70216500000001,12.5862
18929,2013,Agosto,Ecuador,596,582,,1178,-76.532004,3.451668
18930,2013,Agosto,Ecuador,2088,2894,,4982,-74.140516,4.697157
18931,2013,Agosto,Ecuador,2,1,,3,-75.736374,4.815189
18932,2013,Agosto,Ecuador,675,807,,1482,-75.42726,6.170465
18933,2013,Agosto,Ecuador,0,1,,1,-73.181317,7.1280470000000005
18934,2013,Agosto,Ecuador,95,154,,249,-72.453013,7.819
18935,2013,Agosto,Ecuador,2,2,,4,-72.508188,7.927233
18936,2013,Agosto,Ecuador,0,3,,3,-77.35002,8.63337
18937,2013,Agosto,Egipto,1,1,,2,-77.35600000000001,0.81488
18938,2013,Agosto,Egipto,5,13,,18,-74.140516,4.697157
18939,2013,Agosto,Egipto,0,1,,1,-75.42726,6.170465
18940,2013,Agosto,El Salvador,1,0,,1,-69.941498,4.191162
18941,2013,Agosto,El Salvador,1,2,,3,-77.35600000000001,0.81488
18942,2013,Agosto,El Salvador,48,19,,67,-75.516486,10.446304
18943,2013,Agosto,El Salvador,2,0,,2,-74.77647900000001,10.886686
18944,2013,Agosto,El Salvador,50,34,,84,-81.70216500000001,12.5862
18945,2013,Agosto,El Salvador,57,78,,135,-76.532004,3.451668
18946,2013,Agosto,El Salvador,0,1,,1,-75.76635300000001,4.45285
18947,2013,Agosto,El Salvador,516,732,,1248,-74.140516,4.697157
18948,2013,Agosto,El Salvador,1,0,,1,-75.736374,4.815189
18949,2013,Agosto,El Salvador,49,65,,114,-75.42726,6.170465
18950,2013,Agosto,El Salvador,0,1,,1,-67.48402800000001,6.185536
18951,2013,Agosto,El Salvador,1,0,,1,-72.508188,7.927233
18952,2013,Agosto,El Salvador,0,2,,2,-77.35002,8.63337
18953,2013,Agosto,Emiratos Árabes,1,9,,10,-74.140516,4.697157
18954,2013,Agosto,Emiratos Árabes,0,1,,1,-75.42726,6.170465
18955,2013,Agosto,España,7,11,,18,-69.941498,4.191162
18956,2013,Agosto,España,1,0,,1,-76.876446,0.33002
18957,2013,Agosto,España,32,44,,76,-77.35600000000001,0.81488
18958,2013,Agosto,España,0,1,,1,-78.802679,18.00143
18959,2013,Agosto,España,29,39,,68,-75.527794,10.406342
18960,2013,Agosto,España,66,110,,176,-75.516486,10.446304
18961,2013,Agosto,España,1,15,,16,-74.77647900000001,10.886686
18962,2013,Agosto,España,7,16,,23,-72.129595,11.360028999999999
18963,2013,Agosto,España,6,3,,9,-81.70216500000001,12.5862
18964,2013,Agosto,España,192,336,,528,-76.532004,3.451668
18965,2013,Agosto,España,2,0,,2,-75.76635300000001,4.45285
18966,2013,Agosto,España,2340,4522,,6862,-74.140516,4.697157
18967,2013,Agosto,España,0,12,,12,-75.736374,4.815189
18968,2013,Agosto,España,140,267,,407,-75.42726,6.170465
18969,2013,Agosto,España,0,1,,1,-70.74025300000001,7.088728999999999
18970,2013,Agosto,España,1,4,,5,-73.181317,7.1280470000000005
18971,2013,Agosto,España,35,49,,84,-72.453013,7.819
18972,2013,Agosto,España,1,3,,4,-72.508188,7.927233
18973,2013,Agosto,España,2,7,,9,-77.35002,8.63337
18974,2013,Agosto,Eslovaquia,1,3,,4,-77.35600000000001,0.81488
18975,2013,Agosto,Eslovaquia,1,0,,1,-75.527794,10.406342
18976,2013,Agosto,Eslovaquia,0,1,,1,-75.516486,10.446304
18977,2013,Agosto,Eslovaquia,0,1,,1,-72.129595,11.360028999999999
18978,2013,Agosto,Eslovaquia,0,2,,2,-76.532004,3.451668
18979,2013,Agosto,Eslovaquia,15,10,,25,-74.140516,4.697157
18980,2013,Agosto,Eslovaquia,0,1,,1,-75.42726,6.170465
18981,2013,Agosto,Eslovenia,1,2,,3,-75.527794,10.406342
18982,2013,Agosto,Eslovenia,8,1,,9,-72.129595,11.360028999999999
18983,2013,Agosto,Eslovenia,11,15,,26,-74.140516,4.697157
18984,2013,Agosto,Estados Unidos de América,24,37,,61,-69.941498,4.191162
18985,2013,Agosto,Estados Unidos de América,2,0,,2,-76.876446,0.33002
18986,2013,Agosto,Estados Unidos de América,47,82,,129,-77.35600000000001,0.81488
18987,2013,Agosto,Estados Unidos de América,0,1,,1,-78.802679,18.00143
18988,2013,Agosto,Estados Unidos de América,45,47,,92,-75.527794,10.406342
18989,2013,Agosto,Estados Unidos de América,1232,1770,,3002,-75.516486,10.446304
18990,2013,Agosto,Estados Unidos de América,290,503,,793,-74.77647900000001,10.886686
18991,2013,Agosto,Estados Unidos de América,0,1,,1,-74.765343,10.970933
18992,2013,Agosto,Estados Unidos de América,3,5,,8,-74.213989,11.247722999999999
18993,2013,Agosto,Estados Unidos de América,7,20,,27,-72.129595,11.360028999999999
18994,2013,Agosto,Estados Unidos de América,16,30,,46,-81.70216500000001,12.5862
18995,2013,Agosto,Estados Unidos de América,900,1481,,2381,-76.532004,3.451668
18996,2013,Agosto,Estados Unidos de América,91,136,,227,-75.76635300000001,4.45285
18997,2013,Agosto,Estados Unidos de América,6695,12117,,18812,-74.140516,4.697157
18998,2013,Agosto,Estados Unidos de América,124,172,,296,-75.736374,4.815189
18999,2013,Agosto,Estados Unidos de América,1820,3996,,5816,-75.42726,6.170465
19000,2013,Agosto,Estados Unidos de América,1,0,,1,-67.48402800000001,6.185536
19001,2013,Agosto,Estados Unidos de América,41,63,,104,-73.181317,7.1280470000000005
19002,2013,Agosto,Estados Unidos de América,46,52,,98,-72.453013,7.819
19003,2013,Agosto,Estados Unidos de América,13,21,,34,-72.508188,7.927233
19004,2013,Agosto,Estados Unidos de América,6,10,,16,-77.35002,8.63337
19005,2013,Agosto,Estonia,0,1,,1,-75.516486,10.446304
19006,2013,Agosto,Estonia,5,4,,9,-74.140516,4.697157
19007,2013,Agosto,Estonia,0,1,,1,-75.42726,6.170465
19008,2013,Agosto,Etiopia,0,1,,1,-76.532004,3.451668
19009,2013,Agosto,Etiopia,2,5,,7,-74.140516,4.697157
19010,2013,Agosto,Islas Fiji,1,0,,1,-74.140516,4.697157
19011,2013,Agosto,Filipinas,0,25,,25,-75.527794,10.406342
19012,2013,Agosto,Filipinas,2,13,,15,-75.516486,10.446304
19013,2013,Agosto,Filipinas,0,1,,1,-74.77647900000001,10.886686
19014,2013,Agosto,Filipinas,0,36,,36,-74.765343,10.970933
19015,2013,Agosto,Filipinas,0,38,,38,-74.213989,11.247722999999999
19016,2013,Agosto,Filipinas,1,7,,8,-76.532004,3.451668
19017,2013,Agosto,Filipinas,0,14,,14,-77.061029,3.8844260000000004
19018,2013,Agosto,Filipinas,16,78,,94,-74.140516,4.697157
19019,2013,Agosto,Filipinas,0,1,,1,-75.42726,6.170465
19020,2013,Agosto,Filipinas,0,1,,1,-75.68164200000001,9.402597
19021,2013,Agosto,Finlandia,2,1,,3,-75.527794,10.406342
19022,2013,Agosto,Finlandia,1,2,,3,-75.516486,10.446304
19023,2013,Agosto,Finlandia,0,2,,2,-74.77647900000001,10.886686
19024,2013,Agosto,Finlandia,1,0,,1,-72.129595,11.360028999999999
19025,2013,Agosto,Finlandia,1,2,,3,-76.532004,3.451668
19026,2013,Agosto,Finlandia,26,54,,80,-74.140516,4.697157
19027,2013,Agosto,Finlandia,0,5,,5,-75.42726,6.170465
19028,2013,Agosto,Finlandia,0,1,,1,-72.453013,7.819
19029,2013,Agosto,Finlandia,1,0,,1,-77.35002,8.63337
19030,2013,Agosto,Francia,3,8,,11,-69.941498,4.191162
19031,2013,Agosto,Francia,1,1,,2,-76.876446,0.33002
19032,2013,Agosto,Francia,37,75,,112,-77.35600000000001,0.81488
19033,2013,Agosto,Francia,8,10,,18,-75.527794,10.406342
19034,2013,Agosto,Francia,29,38,,67,-75.516486,10.446304
19035,2013,Agosto,Francia,2,21,,23,-74.77647900000001,10.886686
19036,2013,Agosto,Francia,0,27,,27,-74.765343,10.970933
19037,2013,Agosto,Francia,2,3,,5,-74.213989,11.247722999999999
19038,2013,Agosto,Francia,9,9,,18,-72.129595,11.360028999999999
19039,2013,Agosto,Francia,0,1,,1,-81.70216500000001,12.5862
19040,2013,Agosto,Francia,60,106,,166,-76.532004,3.451668
19041,2013,Agosto,Francia,1414,2334,,3748,-74.140516,4.697157
19042,2013,Agosto,Francia,2,2,,4,-75.736374,4.815189
19043,2013,Agosto,Francia,54,115,,169,-75.42726,6.170465
19044,2013,Agosto,Francia,0,1,,1,-70.74025300000001,7.088728999999999
19045,2013,Agosto,Francia,1,2,,3,-73.181317,7.1280470000000005
19046,2013,Agosto,Francia,3,27,,30,-72.453013,7.819
19047,2013,Agosto,Francia,2,1,,3,-72.508188,7.927233
19048,2013,Agosto,Francia,7,5,,12,-77.35002,8.63337
19049,2013,Agosto,Gabón,2,2,,4,-74.140516,4.697157
19050,2013,Agosto,Georgia,4,1,,5,-74.140516,4.697157
19051,2013,Agosto,Ghana,1,0,,1,-76.532004,3.451668
19052,2013,Agosto,Ghana,2,2,,4,-74.140516,4.697157
19053,2013,Agosto,Ghana,0,2,,2,-75.42726,6.170465
19054,2013,Agosto,Granada,0,2,,2,-75.42726,6.170465
19055,2013,Agosto,Grecia,3,0,,3,-77.35600000000001,0.81488
19056,2013,Agosto,Grecia,1,2,,3,-75.527794,10.406342
19057,2013,Agosto,Grecia,5,4,,9,-75.516486,10.446304
19058,2013,Agosto,Grecia,0,1,,1,-74.77647900000001,10.886686
19059,2013,Agosto,Grecia,1,3,,4,-74.765343,10.970933
19060,2013,Agosto,Grecia,0,1,,1,-72.129595,11.360028999999999
19061,2013,Agosto,Grecia,0,1,,1,-81.70216500000001,12.5862
19062,2013,Agosto,Grecia,1,1,,2,-76.532004,3.451668
19063,2013,Agosto,Grecia,19,44,,63,-74.140516,4.697157
19064,2013,Agosto,Grecia,1,2,,3,-75.42726,6.170465
19065,2013,Agosto,Grecia,3,2,,5,-72.453013,7.819
19066,2013,Agosto,Guatemala,0,1,,1,-77.35600000000001,0.81488
19067,2013,Agosto,Guatemala,0,2,,2,-75.527794,10.406342
19068,2013,Agosto,Guatemala,50,47,,97,-75.516486,10.446304
19069,2013,Agosto,Guatemala,3,11,,14,-74.77647900000001,10.886686
19070,2013,Agosto,Guatemala,0,1,,1,-72.129595,11.360028999999999
19071,2013,Agosto,Guatemala,3,1,,4,-81.70216500000001,12.5862
19072,2013,Agosto,Guatemala,12,84,,96,-76.532004,3.451668
19073,2013,Agosto,Guatemala,0,1,,1,-75.76635300000001,4.45285
19074,2013,Agosto,Guatemala,168,378,,546,-74.140516,4.697157
19075,2013,Agosto,Guatemala,1,1,,2,-75.736374,4.815189
19076,2013,Agosto,Guatemala,63,189,,252,-75.42726,6.170465
19077,2013,Agosto,Guatemala,1,1,,2,-73.181317,7.1280470000000005
19078,2013,Agosto,Guatemala,5,3,,8,-72.453013,7.819
19079,2013,Agosto,Guyana,1,1,,2,-75.516486,10.446304
19080,2013,Agosto,Guyana,0,1,,1,-72.129595,11.360028999999999
19081,2013,Agosto,Guyana,0,1,,1,-76.532004,3.451668
19082,2013,Agosto,Guyana,3,6,,9,-74.140516,4.697157
19083,2013,Agosto,Guyana,1,5,,6,-75.42726,6.170465
19084,2013,Agosto,Guinea,0,1,,1,-74.140516,4.697157
19085,2013,Agosto,Guinea Bissau,0,1,,1,-72.453013,7.819
19086,2013,Agosto,Guayana Francesa/Departamento de Ultramar Francés,0,1,,1,-74.140516,4.697157
19087,2013,Agosto,Haití,0,1,,1,-75.516486,10.446304
19088,2013,Agosto,Haití,1,1,,2,-76.532004,3.451668
19089,2013,Agosto,Haití,4,13,,17,-74.140516,4.697157
19090,2013,Agosto,Haití,1,1,,2,-75.42726,6.170465
19091,2013,Agosto,Honduras,3,1,,4,-69.941498,4.191162
19092,2013,Agosto,Honduras,2,9,,11,-75.527794,10.406342
19093,2013,Agosto,Honduras,16,22,,38,-75.516486,10.446304
19094,2013,Agosto,Honduras,2,2,,4,-74.77647900000001,10.886686
19095,2013,Agosto,Honduras,0,1,,1,-74.765343,10.970933
19096,2013,Agosto,Honduras,2,14,,16,-81.703935,12.574411099999999
19097,2013,Agosto,Honduras,3,0,,3,-81.70216500000001,12.5862
19098,2013,Agosto,Honduras,7,16,,23,-76.532004,3.451668
19099,2013,Agosto,Honduras,0,1,,1,-75.76635300000001,4.45285
19100,2013,Agosto,Honduras,164,205,,369,-74.140516,4.697157
19101,2013,Agosto,Honduras,1,4,,5,-75.736374,4.815189
19102,2013,Agosto,Honduras,53,71,,124,-75.42726,6.170465
19103,2013,Agosto,Honduras,1,0,,1,-73.181317,7.1280470000000005
19104,2013,Agosto,Honduras,2,0,,2,-72.453013,7.819
19105,2013,Agosto,Honduras,2,2,,4,-72.508188,7.927233
19106,2013,Agosto,Honduras,0,2,,2,-76.7333,8.06667
19107,2013,Agosto,Hong Kong,0,1,,1,-74.140516,4.697157
19108,2013,Agosto,Hungría,0,1,,1,-77.35600000000001,0.81488
19109,2013,Agosto,Hungría,1,1,,2,-75.527794,10.406342
19110,2013,Agosto,Hungría,1,1,,2,-75.516486,10.446304
19111,2013,Agosto,Hungría,0,1,,1,-76.532004,3.451668
19112,2013,Agosto,Hungría,22,22,,44,-74.140516,4.697157
19113,2013,Agosto,Hungría,0,2,,2,-75.42726,6.170465
19114,2013,Agosto,India,2,0,,2,-69.941498,4.191162
19115,2013,Agosto,India,0,1,,1,-77.35600000000001,0.81488
19116,2013,Agosto,India,0,1,,1,-75.527794,10.406342
19117,2013,Agosto,India,4,10,,14,-75.516486,10.446304
19118,2013,Agosto,India,0,6,,6,-74.77647900000001,10.886686
19119,2013,Agosto,India,0,2,,2,-74.765343,10.970933
19120,2013,Agosto,India,0,1,,1,-81.70216500000001,12.5862
19121,2013,Agosto,India,0,14,,14,-76.532004,3.451668
19122,2013,Agosto,India,0,1,,1,-77.061029,3.8844260000000004
19123,2013,Agosto,India,59,260,,319,-74.140516,4.697157
19124,2013,Agosto,India,0,2,,2,-75.736374,4.815189
19125,2013,Agosto,India,8,34,,42,-75.42726,6.170465
19126,2013,Agosto,Indonesia,1,2,,3,-75.527794,10.406342
19127,2013,Agosto,Indonesia,0,1,,1,-75.516486,10.446304
19128,2013,Agosto,Indonesia,0,2,,2,-76.532004,3.451668
19129,2013,Agosto,Indonesia,19,20,,39,-74.140516,4.697157
19130,2013,Agosto,Iraq,0,1,,1,-75.516486,10.446304
19131,2013,Agosto,Iraq,2,18,,20,-74.140516,4.697157
19132,2013,Agosto,Irán,9,12,,21,-74.140516,4.697157
19133,2013,Agosto,República de Irlanda,1,7,,8,-69.941498,4.191162
19134,2013,Agosto,República de Irlanda,22,26,,48,-77.35600000000001,0.81488
19135,2013,Agosto,República de Irlanda,5,8,,13,-75.527794,10.406342
19136,2013,Agosto,República de Irlanda,6,14,,20,-75.516486,10.446304
19137,2013,Agosto,República de Irlanda,0,1,,1,-74.77647900000001,10.886686
19138,2013,Agosto,República de Irlanda,0,1,,1,-72.129595,11.360028999999999
19139,2013,Agosto,República de Irlanda,2,1,,3,-76.532004,3.451668
19140,2013,Agosto,República de Irlanda,70,100,,170,-74.140516,4.697157
19141,2013,Agosto,República de Irlanda,3,11,,14,-75.42726,6.170465
19142,2013,Agosto,República de Irlanda,0,4,,4,-72.453013,7.819
19143,2013,Agosto,República de Irlanda,1,2,,3,-77.35002,8.63337
19144,2013,Agosto,Islandia,5,2,,7,-74.140516,4.697157
19145,2013,Agosto,Isla de Man,9,11,,20,-77.35600000000001,0.81488
19146,2013,Agosto,Isla de Man,6,17,,23,-76.532004,3.451668
19147,2013,Agosto,Isla de Man,50,98,,148,-74.140516,4.697157
19148,2013,Agosto,Isla de Man,21,51,,72,-75.42726,6.170465
19149,2013,Agosto,Isla Johnston,0,1,,1,-76.532004,3.451668
19150,2013,Agosto,Isla Johnston,1,0,,1,-75.42726,6.170465
19151,2013,Agosto,Israel,1,6,,7,-69.941498,4.191162
19152,2013,Agosto,Israel,11,30,,41,-77.35600000000001,0.81488
19153,2013,Agosto,Israel,1,2,,3,-75.527794,10.406342
19154,2013,Agosto,Israel,5,26,,31,-75.516486,10.446304
19155,2013,Agosto,Israel,0,1,,1,-74.77647900000001,10.886686
19156,2013,Agosto,Israel,0,1,,1,-81.70216500000001,12.5862
19157,2013,Agosto,Israel,14,24,,38,-76.532004,3.451668
19158,2013,Agosto,Israel,133,462,,595,-74.140516,4.697157
19159,2013,Agosto,Israel,5,32,,37,-75.42726,6.170465
19160,2013,Agosto,Israel,1,5,,6,-77.35002,8.63337
19161,2013,Agosto,Islas Aland/Provincia de Finlandia,1,0,,1,-74.140516,4.697157
19162,2013,Agosto,Isla Wake,2,1,,3,-72.508188,7.927233
19163,2013,Agosto,Italia,5,7,,12,-69.941498,4.191162
19164,2013,Agosto,Italia,0,1,,1,-76.876446,0.33002
19165,2013,Agosto,Italia,10,21,,31,-77.35600000000001,0.81488
19166,2013,Agosto,Italia,12,16,,28,-75.527794,10.406342
19167,2013,Agosto,Italia,43,103,,146,-75.516486,10.446304
19168,2013,Agosto,Italia,4,21,,25,-74.77647900000001,10.886686
19169,2013,Agosto,Italia,3,16,,19,-72.129595,11.360028999999999
19170,2013,Agosto,Italia,8,7,,15,-81.70216500000001,12.5862
19171,2013,Agosto,Italia,28,92,,120,-76.532004,3.451668
19172,2013,Agosto,Italia,692,1807,,2499,-74.140516,4.697157
19173,2013,Agosto,Italia,0,3,,3,-75.736374,4.815189
19174,2013,Agosto,Italia,50,121,,171,-75.42726,6.170465
19175,2013,Agosto,Italia,0,2,,2,-67.48402800000001,6.185536
19176,2013,Agosto,Italia,1,0,,1,-70.74025300000001,7.088728999999999
19177,2013,Agosto,Italia,11,26,,37,-72.453013,7.819
19178,2013,Agosto,Italia,0,2,,2,-72.508188,7.927233
19179,2013,Agosto,Italia,6,6,,12,-77.35002,8.63337
19180,2013,Agosto,Islas del Canal,1,8,,9,-74.77647900000001,10.886686
19181,2013,Agosto,Islas del Canal,1,0,,1,-72.453013,7.819
19182,2013,Agosto,Jamaica,2,4,,6,-75.516486,10.446304
19183,2013,Agosto,Jamaica,0,1,,1,-74.77647900000001,10.886686
19184,2013,Agosto,Jamaica,0,1,,1,-76.532004,3.451668
19185,2013,Agosto,Jamaica,14,17,,31,-74.140516,4.697157
19186,2013,Agosto,Jamaica,8,20,,28,-75.42726,6.170465
19187,2013,Agosto,Japón,0,1,,1,-69.941498,4.191162
19188,2013,Agosto,Japón,6,14,,20,-77.35600000000001,0.81488
19189,2013,Agosto,Japón,2,1,,3,-75.527794,10.406342
19190,2013,Agosto,Japón,6,8,,14,-75.516486,10.446304
19191,2013,Agosto,Japón,1,6,,7,-74.77647900000001,10.886686
19192,2013,Agosto,Japón,1,2,,3,-72.129595,11.360028999999999
19193,2013,Agosto,Japón,9,19,,28,-76.532004,3.451668
19194,2013,Agosto,Japón,136,461,,597,-74.140516,4.697157
19195,2013,Agosto,Japón,1,1,,2,-75.736374,4.815189
19196,2013,Agosto,Japón,9,37,,46,-75.42726,6.170465
19197,2013,Agosto,Japón,2,9,,11,-72.453013,7.819
19198,2013,Agosto,Japón,0,1,,1,-72.508188,7.927233
19199,2013,Agosto,Jordania,0,1,,1,-75.516486,10.446304
19200,2013,Agosto,Jordania,1,1,,2,-74.140516,4.697157
19201,2013,Agosto,Kazajistán,1,0,,1,-74.140516,4.697157
19202,2013,Agosto,Kenia,0,2,,2,-76.532004,3.451668
19203,2013,Agosto,Kenia,5,6,,11,-74.140516,4.697157
19204,2013,Agosto,Kenia,0,1,,1,-75.42726,6.170465
19205,2013,Agosto,Kenia,1,1,,2,-72.453013,7.819
19206,2013,Agosto,Kirguistán,1,1,,2,-74.140516,4.697157
19207,2013,Agosto,Kuwait,0,2,,2,-74.140516,4.697157
19208,2013,Agosto,República Democrática Popular  Lao,2,2,,4,-74.140516,4.697157
19209,2013,Agosto,Letonia,0,1,,1,-75.516486,10.446304
19210,2013,Agosto,Letonia,5,3,,8,-74.140516,4.697157
19211,2013,Agosto,Lituania,0,1,,1,-69.941498,4.191162
19212,2013,Agosto,Lituania,8,2,,10,-74.140516,4.697157
19213,2013,Agosto,Lituania,1,0,,1,-75.42726,6.170465
19214,2013,Agosto,Líbano,0,2,,2,-77.35600000000001,0.81488
19215,2013,Agosto,Líbano,1,1,,2,-74.77647900000001,10.886686
19216,2013,Agosto,Líbano,3,4,,7,-72.129595,11.360028999999999
19217,2013,Agosto,Líbano,1,0,,1,-81.70216500000001,12.5862
19218,2013,Agosto,Líbano,10,27,,37,-74.140516,4.697157
19219,2013,Agosto,Líbano,0,1,,1,-72.508188,7.927233
19220,2013,Agosto,Liberia,1,0,,1,-72.129595,11.360028999999999
19221,2013,Agosto,Libia,1,0,,1,-75.516486,10.446304
19222,2013,Agosto,Libia,1,0,,1,-72.129595,11.360028999999999
19223,2013,Agosto,Liechtenstein,1,0,,1,-76.532004,3.451668
19224,2013,Agosto,Liechtenstein,0,1,,1,-74.140516,4.697157
19225,2013,Agosto,Luxemburgo,1,0,,1,-69.941498,4.191162
19226,2013,Agosto,Luxemburgo,6,15,,21,-74.140516,4.697157
19227,2013,Agosto,Luxemburgo,0,1,,1,-77.35002,8.63337
19228,2013,Agosto,Macedonia,2,2,,4,-74.140516,4.697157
19229,2013,Agosto,Madagascar,0,1,,1,-74.140516,4.697157
19230,2013,Agosto,Malasia,1,2,,3,-75.516486,10.446304
19231,2013,Agosto,Malasia,1,1,,2,-76.532004,3.451668
19232,2013,Agosto,Malasia,10,17,,27,-74.140516,4.697157
19233,2013,Agosto,Malasia,1,0,,1,-75.42726,6.170465
19234,2013,Agosto,Malawi,0,1,,1,-76.532004,3.451668
19235,2013,Agosto,Maldivas,0,1,,1,-76.7333,8.06667
19236,2013,Agosto,Malta,3,0,,3,-74.140516,4.697157
19237,2013,Agosto,Malta,0,1,,1,-75.42726,6.170465
19238,2013,Agosto,Marruecos,2,8,,10,-74.140516,4.697157
19239,2013,Agosto,Mauritania,0,1,,1,-75.516486,10.446304
19240,2013,Agosto,Mauritania,0,1,,1,-74.140516,4.697157
19241,2013,Agosto,México,1,3,,4,-69.941498,4.191162
19242,2013,Agosto,México,2,0,,2,-76.876446,0.33002
19243,2013,Agosto,México,7,12,,19,-77.35600000000001,0.81488
19244,2013,Agosto,México,0,1,,1,-78.802679,18.00143
19245,2013,Agosto,México,31,26,,57,-75.527794,10.406342
19246,2013,Agosto,México,99,171,,270,-75.516486,10.446304
19247,2013,Agosto,México,16,46,,62,-74.77647900000001,10.886686
19248,2013,Agosto,México,5,8,,13,-72.129595,11.360028999999999
19249,2013,Agosto,México,2,5,,7,-81.70216500000001,12.5862
19250,2013,Agosto,México,75,158,,233,-76.532004,3.451668
19251,2013,Agosto,México,2,0,,2,-75.76635300000001,4.45285
19252,2013,Agosto,México,2594,5323,,7917,-74.140516,4.697157
19253,2013,Agosto,México,3,17,,20,-75.736374,4.815189
19254,2013,Agosto,México,274,655,,929,-75.42726,6.170465
19255,2013,Agosto,México,1,1,,2,-70.74025300000001,7.088728999999999
19256,2013,Agosto,México,3,7,,10,-73.181317,7.1280470000000005
19257,2013,Agosto,México,27,53,,80,-72.453013,7.819
19258,2013,Agosto,México,2,21,,23,-72.508188,7.927233
19259,2013,Agosto,México,0,3,,3,-77.35002,8.63337
19260,2013,Agosto,Mayotte/Colectividad Territorial Francesa,0,1,,1,-74.140516,4.697157
19261,2013,Agosto,Mónaco,4,4,,8,-74.140516,4.697157
19262,2013,Agosto,Mongolia,0,1,,1,-74.140516,4.697157
19263,2013,Agosto,Montenegro,1,0,,1,-76.532004,3.451668
19264,2013,Agosto,Mozambique,0,1,,1,-74.140516,4.697157
19265,2013,Agosto,Myanmar,1,3,,4,-74.140516,4.697157
19266,2013,Agosto,Namibia,0,1,,1,-74.140516,4.697157
19267,2013,Agosto,Nepal,1,1,,2,-74.140516,4.697157
19268,2013,Agosto,Nicaragua,3,4,,7,-75.516486,10.446304
19269,2013,Agosto,Nicaragua,1,0,,1,-74.77647900000001,10.886686
19270,2013,Agosto,Nicaragua,2,0,,2,-81.70216500000001,12.5862
19271,2013,Agosto,Nicaragua,6,11,,17,-76.532004,3.451668
19272,2013,Agosto,Nicaragua,36,108,,144,-74.140516,4.697157
19273,2013,Agosto,Nicaragua,18,15,,33,-75.42726,6.170465
19274,2013,Agosto,Nigeria,0,1,,1,-75.516486,10.446304
19275,2013,Agosto,Nigeria,0,6,,6,-74.140516,4.697157
19276,2013,Agosto,Nigeria,1,1,,2,-75.42726,6.170465
19277,2013,Agosto,Noruega,1,1,,2,-69.941498,4.191162
19278,2013,Agosto,Noruega,0,2,,2,-77.35600000000001,0.81488
19279,2013,Agosto,Noruega,2,1,,3,-75.527794,10.406342
19280,2013,Agosto,Noruega,3,11,,14,-75.516486,10.446304
19281,2013,Agosto,Noruega,0,1,,1,-72.129595,11.360028999999999
19282,2013,Agosto,Noruega,0,4,,4,-76.532004,3.451668
19283,2013,Agosto,Noruega,42,83,,125,-74.140516,4.697157
19284,2013,Agosto,Noruega,0,1,,1,-75.736374,4.815189
19285,2013,Agosto,Noruega,4,6,,10,-75.42726,6.170465
19286,2013,Agosto,Noruega,0,1,,1,-72.453013,7.819
19287,2013,Agosto,Noruega,1,0,,1,-77.35002,8.63337
19288,2013,Agosto,Nueva Zelanda,1,1,,2,-69.941498,4.191162
19289,2013,Agosto,Nueva Zelanda,6,10,,16,-77.35600000000001,0.81488
19290,2013,Agosto,Nueva Zelanda,14,11,,25,-75.516486,10.446304
19291,2013,Agosto,Nueva Zelanda,1,0,,1,-74.77647900000001,10.886686
19292,2013,Agosto,Nueva Zelanda,0,1,,1,-81.70216500000001,12.5862
19293,2013,Agosto,Nueva Zelanda,0,1,,1,-76.532004,3.451668
19294,2013,Agosto,Nueva Zelanda,26,62,,88,-74.140516,4.697157
19295,2013,Agosto,Nueva Zelanda,5,13,,18,-75.42726,6.170465
19296,2013,Agosto,Nueva Zelanda,0,1,,1,-72.453013,7.819
19297,2013,Agosto,Nueva Zelanda,1,1,,2,-77.35002,8.63337
19298,2013,Agosto,Papúa Nueva Guinea,0,1,,1,-74.140516,4.697157
19299,2013,Agosto,Nueva Zelanda,8,12,,20,-75.527794,10.406342
19300,2013,Agosto,Nueva Zelanda,2,2,,4,-74.77647900000001,10.886686
19301,2013,Agosto,Nueva Zelanda,2,1,,3,-74.140516,4.697157
19302,2013,Agosto,Nueva Zelanda,0,1,,1,-72.453013,7.819
19303,2013,Agosto,Países Bajos,2,5,,7,-77.35600000000001,0.81488
19304,2013,Agosto,Países Bajos,19,36,,55,-75.516486,10.446304
19305,2013,Agosto,Países Bajos,1,5,,6,-74.77647900000001,10.886686
19306,2013,Agosto,Países Bajos,9,13,,22,-72.129595,11.360028999999999
19307,2013,Agosto,Países Bajos,13,9,,22,-72.919186,11.52863
19308,2013,Agosto,Países Bajos,5,17,,22,-76.532004,3.451668
19309,2013,Agosto,Países Bajos,174,251,,425,-74.140516,4.697157
19310,2013,Agosto,Países Bajos,1,5,,6,-75.736374,4.815189
19311,2013,Agosto,Países Bajos,127,164,,291,-75.42726,6.170465
19312,2013,Agosto,Países Bajos,6,6,,12,-73.181317,7.1280470000000005
19313,2013,Agosto,Países Bajos,0,1,,1,-72.453013,7.819
19314,2013,Agosto,Pakistán,0,1,,1,-77.35600000000001,0.81488
19315,2013,Agosto,Pakistán,0,1,,1,-75.527794,10.406342
19316,2013,Agosto,Pakistán,4,10,,14,-74.140516,4.697157
19317,2013,Agosto,Pakistán,0,1,,1,-75.42726,6.170465
19318,2013,Agosto,Panamá,0,1,,1,-69.941498,4.191162
19319,2013,Agosto,Panamá,0,1,,1,-77.35600000000001,0.81488
19320,2013,Agosto,Panamá,0,16,,16,-75.527794,10.406342
19321,2013,Agosto,Panamá,105,141,,246,-75.516486,10.446304
19322,2013,Agosto,Panamá,35,85,,120,-74.77647900000001,10.886686
19323,2013,Agosto,Panamá,0,1,,1,-81.703935,12.574411099999999
19324,2013,Agosto,Panamá,14,30,,44,-81.70216500000001,12.5862
19325,2013,Agosto,Panamá,88,181,,269,-76.532004,3.451668
19326,2013,Agosto,Panamá,576,958,,1534,-74.140516,4.697157
19327,2013,Agosto,Panamá,87,107,,194,-75.736374,4.815189
19328,2013,Agosto,Panamá,164,316,,480,-75.42726,6.170465
19329,2013,Agosto,Panamá,9,12,,21,-73.181317,7.1280470000000005
19330,2013,Agosto,Panamá,7,8,,15,-72.453013,7.819
19331,2013,Agosto,Panamá,9,12,,21,-72.508188,7.927233
19332,2013,Agosto,Panamá,3,8,,11,-77.35002,8.63337
19333,2013,Agosto,Paraguay,0,1,,1,-77.35600000000001,0.81488
19334,2013,Agosto,Paraguay,9,15,,24,-75.516486,10.446304
19335,2013,Agosto,Paraguay,0,1,,1,-74.77647900000001,10.886686
19336,2013,Agosto,Paraguay,1,0,,1,-72.129595,11.360028999999999
19337,2013,Agosto,Paraguay,3,0,,3,-81.70216500000001,12.5862
19338,2013,Agosto,Paraguay,7,8,,15,-76.532004,3.451668
19339,2013,Agosto,Paraguay,75,86,,161,-74.140516,4.697157
19340,2013,Agosto,Paraguay,22,63,,85,-75.42726,6.170465
19341,2013,Agosto,Paraguay,0,1,,1,-72.453013,7.819
19342,2013,Agosto,Perú,13,12,,25,-69.941498,4.191162
19343,2013,Agosto,Perú,1,3,,4,-76.876446,0.33002
19344,2013,Agosto,Perú,211,349,,560,-77.35600000000001,0.81488
19345,2013,Agosto,Perú,56,56,,112,-75.527794,10.406342
19346,2013,Agosto,Perú,180,153,,333,-75.516486,10.446304
19347,2013,Agosto,Perú,25,31,,56,-74.77647900000001,10.886686
19348,2013,Agosto,Perú,0,2,,2,-74.765343,10.970933
19349,2013,Agosto,Perú,14,34,,48,-72.129595,11.360028999999999
19350,2013,Agosto,Perú,139,77,,216,-81.70216500000001,12.5862
19351,2013,Agosto,Perú,122,169,,291,-76.532004,3.451668
19352,2013,Agosto,Perú,0,1,,1,-75.76635300000001,4.45285
19353,2013,Agosto,Perú,3054,3773,,6827,-74.140516,4.697157
19354,2013,Agosto,Perú,1,8,,9,-75.736374,4.815189
19355,2013,Agosto,Perú,311,684,,995,-75.42726,6.170465
19356,2013,Agosto,Perú,1,0,,1,-70.74025300000001,7.088728999999999
19357,2013,Agosto,Perú,5,9,,14,-73.181317,7.1280470000000005
19358,2013,Agosto,Perú,47,78,,125,-72.453013,7.819
19359,2013,Agosto,Perú,3,7,,10,-72.508188,7.927233
19360,2013,Agosto,Perú,0,1,,1,-77.35002,8.63337
19361,2013,Agosto,Palestina,2,1,,3,-74.140516,4.697157
19362,2013,Agosto,Polonia,2,1,,3,-69.941498,4.191162
19363,2013,Agosto,Polonia,1,4,,5,-77.35600000000001,0.81488
19364,2013,Agosto,Polonia,2,3,,5,-75.527794,10.406342
19365,2013,Agosto,Polonia,0,4,,4,-75.516486,10.446304
19366,2013,Agosto,Polonia,2,5,,7,-74.77647900000001,10.886686
19367,2013,Agosto,Polonia,0,3,,3,-74.765343,10.970933
19368,2013,Agosto,Polonia,2,2,,4,-72.129595,11.360028999999999
19369,2013,Agosto,Polonia,4,1,,5,-76.532004,3.451668
19370,2013,Agosto,Polonia,88,92,,180,-74.140516,4.697157
19371,2013,Agosto,Polonia,3,8,,11,-75.42726,6.170465
19372,2013,Agosto,Polonia,2,3,,5,-72.453013,7.819
19373,2013,Agosto,Portugal,2,6,,8,-77.35600000000001,0.81488
19374,2013,Agosto,Portugal,1,2,,3,-75.527794,10.406342
19375,2013,Agosto,Portugal,3,9,,12,-75.516486,10.446304
19376,2013,Agosto,Portugal,0,4,,4,-74.77647900000001,10.886686
19377,2013,Agosto,Portugal,0,2,,2,-72.129595,11.360028999999999
19378,2013,Agosto,Portugal,0,1,,1,-81.70216500000001,12.5862
19379,2013,Agosto,Portugal,5,19,,24,-76.532004,3.451668
19380,2013,Agosto,Portugal,116,299,,415,-74.140516,4.697157
19381,2013,Agosto,Portugal,5,15,,20,-75.42726,6.170465
19382,2013,Agosto,Portugal,2,5,,7,-72.453013,7.819
19383,2013,Agosto,Portugal,0,1,,1,-77.35002,8.63337
19384,2013,Agosto,Puerto Rico/Territorio de Estados Unidos,1,1,,2,-75.516486,10.446304
19385,2013,Agosto,Qatar,0,1,,1,-74.140516,4.697157
19386,2013,Agosto,Reino Unido de Gran Bretaña e Irlanda del Norte,6,6,,12,-69.941498,4.191162
19387,2013,Agosto,Reino Unido de Gran Bretaña e Irlanda del Norte,10,11,,21,-77.35600000000001,0.81488
19388,2013,Agosto,Reino Unido de Gran Bretaña e Irlanda del Norte,13,18,,31,-75.527794,10.406342
19389,2013,Agosto,Reino Unido de Gran Bretaña e Irlanda del Norte,26,47,,73,-75.516486,10.446304
19390,2013,Agosto,Reino Unido de Gran Bretaña e Irlanda del Norte,1,0,,1,-74.77647900000001,10.886686
19391,2013,Agosto,Reino Unido de Gran Bretaña e Irlanda del Norte,8,4,,12,-72.129595,11.360028999999999
19392,2013,Agosto,Reino Unido de Gran Bretaña e Irlanda del Norte,16,28,,44,-76.532004,3.451668
19393,2013,Agosto,Reino Unido de Gran Bretaña e Irlanda del Norte,300,600,,900,-74.140516,4.697157
19394,2013,Agosto,Reino Unido de Gran Bretaña e Irlanda del Norte,0,1,,1,-75.736374,4.815189
19395,2013,Agosto,Reino Unido de Gran Bretaña e Irlanda del Norte,17,49,,66,-75.42726,6.170465
19396,2013,Agosto,Reino Unido de Gran Bretaña e Irlanda del Norte,0,4,,4,-72.453013,7.819
19397,2013,Agosto,Reino Unido de Gran Bretaña e Irlanda del Norte,0,1,,1,-72.508188,7.927233
19398,2013,Agosto,Reino Unido de Gran Bretaña e Irlanda del Norte,0,1,,1,-77.35002,8.63337
19399,2013,Agosto,República de Belarús,1,2,,3,-74.140516,4.697157
19400,2013,Agosto,República Dominicana,4,5,,9,-77.35600000000001,0.81488
19401,2013,Agosto,República Dominicana,6,2,,8,-75.527794,10.406342
19402,2013,Agosto,República Dominicana,18,31,,49,-75.516486,10.446304
19403,2013,Agosto,República Dominicana,10,18,,28,-74.77647900000001,10.886686
19404,2013,Agosto,República Dominicana,0,5,,5,-72.129595,11.360028999999999
19405,2013,Agosto,República Dominicana,10,28,,38,-76.532004,3.451668
19406,2013,Agosto,República Dominicana,282,407,,689,-74.140516,4.697157
19407,2013,Agosto,República Dominicana,7,24,,31,-75.736374,4.815189
19408,2013,Agosto,República Dominicana,38,114,,152,-75.42726,6.170465
19409,2013,Agosto,República Dominicana,1,0,,1,-73.181317,7.1280470000000005
19410,2013,Agosto,República Dominicana,6,6,,12,-72.453013,7.819
19411,2013,Agosto,República Dominicana,4,5,,9,-72.508188,7.927233
19412,2013,Agosto,República Checa,0,1,,1,-76.532004,3.451668
19413,2013,Agosto,República Checa,0,1,,1,-74.140516,4.697157
19414,2013,Agosto,Rumania,0,1,,1,-69.941498,4.191162
19415,2013,Agosto,Rumania,0,1,,1,-77.35600000000001,0.81488
19416,2013,Agosto,Rumania,0,2,,2,-75.527794,10.406342
19417,2013,Agosto,Rumania,0,2,,2,-75.516486,10.446304
19418,2013,Agosto,Rumania,0,2,,2,-74.77647900000001,10.886686
19419,2013,Agosto,Rumania,4,4,,8,-76.532004,3.451668
19420,2013,Agosto,Rumania,0,1,,1,-77.061029,3.8844260000000004
19421,2013,Agosto,Rumania,25,47,,72,-74.140516,4.697157
19422,2013,Agosto,Rumania,1,1,,2,-72.453013,7.819
19423,2013,Agosto,Rumania,0,1,,1,-75.68164200000001,9.402597
19424,2013,Agosto,Federación de Rusia,2,3,,5,-77.35600000000001,0.81488
19425,2013,Agosto,Federación de Rusia,4,5,,9,-75.527794,10.406342
19426,2013,Agosto,Federación de Rusia,5,3,,8,-75.516486,10.446304
19427,2013,Agosto,Federación de Rusia,2,0,,2,-74.77647900000001,10.886686
19428,2013,Agosto,Federación de Rusia,2,2,,4,-72.129595,11.360028999999999
19429,2013,Agosto,Federación de Rusia,2,1,,3,-76.532004,3.451668
19430,2013,Agosto,Federación de Rusia,13,17,,30,-74.140516,4.697157
19431,2013,Agosto,Federación de Rusia,0,1,,1,-75.42726,6.170465
19432,2013,Agosto,Federación de Rusia,1,0,,1,-72.453013,7.819
19433,2013,Agosto,Federación de Rusia,0,3,,3,-76.7333,8.06667
19434,2013,Agosto,Federación de Rusia,0,4,,4,-75.68164200000001,9.402597
19435,2013,Agosto,Rwanda,2,0,,2,-76.532004,3.451668
19436,2013,Agosto,Rwanda,0,1,,1,-75.42726,6.170465
19437,2013,Agosto,San Cristóbal y Nevis,2,12,,14,-75.42726,6.170465
19438,2013,Agosto,San  Vicente y las Granadinas,0,1,,1,-74.140516,4.697157
19439,2013,Agosto,San  Vicente y las Granadinas,1,4,,5,-75.42726,6.170465
19440,2013,Agosto,Santa Lucia,1,1,,2,-75.516486,10.446304
19441,2013,Agosto,Santa Lucia,1,0,,1,-74.140516,4.697157
19442,2013,Agosto,Santa Lucia,1,0,,1,-75.42726,6.170465
19443,2013,Agosto,Santa Sede/Ciudad del Vaticano,0,2,,2,-74.140516,4.697157
19444,2013,Agosto,Senegal,0,1,,1,-77.35600000000001,0.81488
19445,2013,Agosto,Senegal,0,4,,4,-74.140516,4.697157
19446,2013,Agosto,Serbia,7,9,,16,-74.140516,4.697157
19447,2013,Agosto,Singapur,0,1,,1,-77.35600000000001,0.81488
19448,2013,Agosto,Singapur,0,1,,1,-75.516486,10.446304
19449,2013,Agosto,Singapur,0,1,,1,-74.213989,11.247722999999999
19450,2013,Agosto,Singapur,8,21,,29,-74.140516,4.697157
19451,2013,Agosto,Singapur,0,4,,4,-75.42726,6.170465
19452,2013,Agosto,República Árabe Siria,1,1,,2,-72.129595,11.360028999999999
19453,2013,Agosto,República Árabe Siria,0,7,,7,-74.140516,4.697157
19454,2013,Agosto,Sri Lanka,0,1,,1,-76.532004,3.451668
19455,2013,Agosto,Sri Lanka,0,1,,1,-74.140516,4.697157
19456,2013,Agosto,Sri Lanka,0,1,,1,-75.42726,6.170465
19457,2013,Agosto,Sudáfrica,1,3,,4,-77.35600000000001,0.81488
19458,2013,Agosto,Sudáfrica,1,3,,4,-75.527794,10.406342
19459,2013,Agosto,Sudáfrica,4,5,,9,-75.516486,10.446304
19460,2013,Agosto,Sudáfrica,1,4,,5,-74.77647900000001,10.886686
19461,2013,Agosto,Sudáfrica,0,1,,1,-74.213989,11.247722999999999
19462,2013,Agosto,Sudáfrica,2,0,,2,-76.532004,3.451668
19463,2013,Agosto,Sudáfrica,35,78,,113,-74.140516,4.697157
19464,2013,Agosto,Sudáfrica,1,3,,4,-75.42726,6.170465
19465,2013,Agosto,Sudáfrica,2,3,,5,-72.453013,7.819
19466,2013,Agosto,Sudán,0,1,,1,-74.140516,4.697157
19467,2013,Agosto,Suecia,1,1,,2,-69.941498,4.191162
19468,2013,Agosto,Suecia,4,1,,5,-77.35600000000001,0.81488
19469,2013,Agosto,Suecia,7,3,,10,-75.527794,10.406342
19470,2013,Agosto,Suecia,1,5,,6,-75.516486,10.446304
19471,2013,Agosto,Suecia,0,5,,5,-74.77647900000001,10.886686
19472,2013,Agosto,Suecia,1,0,,1,-72.129595,11.360028999999999
19473,2013,Agosto,Suecia,7,7,,14,-76.532004,3.451668
19474,2013,Agosto,Suecia,85,147,,232,-74.140516,4.697157
19475,2013,Agosto,Suecia,9,13,,22,-75.42726,6.170465
19476,2013,Agosto,Suecia,1,1,,2,-73.181317,7.1280470000000005
19477,2013,Agosto,Suecia,0,3,,3,-72.453013,7.819
19478,2013,Agosto,Suecia,1,0,,1,-72.508188,7.927233
19479,2013,Agosto,Suecia,0,2,,2,-77.35002,8.63337
19480,2013,Agosto,Suiza,7,10,,17,-69.941498,4.191162
19481,2013,Agosto,Suiza,0,1,,1,-76.876446,0.33002
19482,2013,Agosto,Suiza,20,18,,38,-77.35600000000001,0.81488
19483,2013,Agosto,Suiza,9,13,,22,-75.527794,10.406342
19484,2013,Agosto,Suiza,15,18,,33,-75.516486,10.446304
19485,2013,Agosto,Suiza,2,2,,4,-74.77647900000001,10.886686
19486,2013,Agosto,Suiza,1,4,,5,-72.129595,11.360028999999999
19487,2013,Agosto,Suiza,0,1,,1,-72.919186,11.52863
19488,2013,Agosto,Suiza,10,25,,35,-76.532004,3.451668
19489,2013,Agosto,Suiza,280,415,,695,-74.140516,4.697157
19490,2013,Agosto,Suiza,1,1,,2,-75.736374,4.815189
19491,2013,Agosto,Suiza,19,41,,60,-75.42726,6.170465
19492,2013,Agosto,Suiza,1,2,,3,-72.453013,7.819
19493,2013,Agosto,Suiza,0,4,,4,-77.35002,8.63337
19494,2013,Agosto,Surinam,15,12,,27,-74.140516,4.697157
19495,2013,Agosto,Surinam,31,15,,46,-75.42726,6.170465
19496,2013,Agosto,Taiwán,3,3,,6,-75.527794,10.406342
19497,2013,Agosto,Taiwán,10,7,,17,-75.516486,10.446304
19498,2013,Agosto,Taiwán,2,2,,4,-74.140516,4.697157
19499,2013,Agosto,Tailandia,0,1,,1,-77.35600000000001,0.81488
19500,2013,Agosto,Tailandia,0,1,,1,-74.765343,10.970933
19501,2013,Agosto,Tailandia,5,8,,13,-74.140516,4.697157
19502,2013,Agosto,Tailandia,0,1,,1,-75.736374,4.815189
19503,2013,Agosto,Tailandia,1,0,,1,-75.42726,6.170465
19504,2013,Agosto,Territorio Antártico Británico/Territorio Británico de Ultramar,0,1,,1,-77.35600000000001,0.81488
19505,2013,Agosto,Territorio Antártico Británico/Territorio Británico de Ultramar,1,2,,3,-74.140516,4.697157
19506,2013,Agosto,Territorio Antártico Británico/Territorio Británico de Ultramar,0,1,,1,-75.42726,6.170465
19507,2013,Agosto,Trinidad y Tobago,1,6,,7,-75.516486,10.446304
19508,2013,Agosto,Trinidad y Tobago,4,2,,6,-76.532004,3.451668
19509,2013,Agosto,Trinidad y Tobago,24,33,,57,-74.140516,4.697157
19510,2013,Agosto,Trinidad y Tobago,6,25,,31,-75.42726,6.170465
19511,2013,Agosto,Trinidad y Tobago,0,1,,1,-72.453013,7.819
19512,2013,Agosto,Trinidad y Tobago,0,2,,2,-72.508188,7.927233
19513,2013,Agosto,Túnez,2,5,,7,-74.140516,4.697157
19514,2013,Agosto,Turquía,0,1,,1,-77.35600000000001,0.81488
19515,2013,Agosto,Turquía,1,4,,5,-75.516486,10.446304
19516,2013,Agosto,Turquía,1,0,,1,-74.77647900000001,10.886686
19517,2013,Agosto,Turquía,0,2,,2,-76.532004,3.451668
19518,2013,Agosto,Turquía,0,2,,2,-77.061029,3.8844260000000004
19519,2013,Agosto,Turquía,32,57,,89,-74.140516,4.697157
19520,2013,Agosto,Turquía,0,10,,10,-75.42726,6.170465
19521,2013,Agosto,Turquía,0,3,,3,-72.453013,7.819
19522,2013,Agosto,Ucrania,0,5,,5,-76.532004,3.451668
19523,2013,Agosto,Ucrania,0,2,,2,-77.061029,3.8844260000000004
19524,2013,Agosto,Ucrania,18,32,,50,-74.140516,4.697157
19525,2013,Agosto,Ucrania,0,1,,1,-75.42726,6.170465
19526,2013,Agosto,Uganda,6,4,,10,-74.140516,4.697157
19527,2013,Agosto,Federación de Rusia,1,2,,3,-69.941498,4.191162
19528,2013,Agosto,Federación de Rusia,1,1,,2,-77.35600000000001,0.81488
19529,2013,Agosto,Federación de Rusia,0,1,,1,-75.527794,10.406342
19530,2013,Agosto,Federación de Rusia,0,1,,1,-74.213989,11.247722999999999
19531,2013,Agosto,Federación de Rusia,3,2,,5,-76.532004,3.451668
19532,2013,Agosto,Federación de Rusia,88,101,,189,-74.140516,4.697157
19533,2013,Agosto,Federación de Rusia,10,7,,17,-72.453013,7.819
19534,2013,Agosto,Federación de Rusia,0,1,,1,-75.68164200000001,9.402597
19535,2013,Agosto,Myanmar,1,0,,1,-74.140516,4.697157
19536,2013,Agosto,Uruguay,4,7,,11,-77.35600000000001,0.81488
19537,2013,Agosto,Uruguay,3,2,,5,-75.527794,10.406342
19538,2013,Agosto,Uruguay,87,66,,153,-75.516486,10.446304
19539,2013,Agosto,Uruguay,2,5,,7,-74.77647900000001,10.886686
19540,2013,Agosto,Uruguay,0,3,,3,-72.129595,11.360028999999999
19541,2013,Agosto,Uruguay,35,33,,68,-81.70216500000001,12.5862
19542,2013,Agosto,Uruguay,10,21,,31,-76.532004,3.451668
19543,2013,Agosto,Uruguay,167,327,,494,-74.140516,4.697157
19544,2013,Agosto,Uruguay,0,4,,4,-75.736374,4.815189
19545,2013,Agosto,Uruguay,14,58,,72,-75.42726,6.170465
19546,2013,Agosto,Uruguay,4,5,,9,-72.453013,7.819
19547,2013,Agosto,Uruguay,0,2,,2,-77.35002,8.63337
19548,2013,Agosto,Uzbekistán,1,0,,1,-76.532004,3.451668
19549,2013,Agosto,Uzbekistán,1,0,,1,-75.42726,6.170465
19550,2013,Agosto,Venezuela,0,1,,1,-69.941498,4.191162
19551,2013,Agosto,Venezuela,2,0,,2,-76.876446,0.33002
19552,2013,Agosto,Venezuela,44,77,,121,-77.35600000000001,0.81488
19553,2013,Agosto,Venezuela,21,30,,51,-75.527794,10.406342
19554,2013,Agosto,Venezuela,79,113,,192,-75.516486,10.446304
19555,2013,Agosto,Venezuela,38,109,,147,-74.77647900000001,10.886686
19556,2013,Agosto,Venezuela,2147,2313,,4460,-72.129595,11.360028999999999
19557,2013,Agosto,Venezuela,0,1,,1,-72.919186,11.52863
19558,2013,Agosto,Venezuela,6,5,,11,-81.70216500000001,12.5862
19559,2013,Agosto,Venezuela,71,100,,171,-76.532004,3.451668
19560,2013,Agosto,Venezuela,6306,6796,,13102,-74.140516,4.697157
19561,2013,Agosto,Venezuela,2,9,,11,-75.736374,4.815189
19562,2013,Agosto,Venezuela,481,589,,1070,-75.42726,6.170465
19563,2013,Agosto,Venezuela,23,49,,72,-67.48402800000001,6.185536
19564,2013,Agosto,Venezuela,122,164,,286,-70.74025300000001,7.088728999999999
19565,2013,Agosto,Venezuela,6,3,,9,-73.181317,7.1280470000000005
19566,2013,Agosto,Venezuela,1945,2330,,4275,-72.453013,7.819
19567,2013,Agosto,Venezuela,252,316,,568,-72.508188,7.927233
19568,2013,Agosto,Vietnam,1,8,,9,-74.140516,4.697157
19569,2013,Agosto,Islas Vírgenes Británicas/Territorio Británico de Ultramar,0,1,,1,-75.42726,6.170465
19570,2013,Agosto,República Árabe de Yemen,1,0,,1,-74.140516,4.697157
19571,2013,Agosto,Zambia,1,1,,2,-74.140516,4.697157
19572,2013,Agosto,Zimbabue,0,3,,3,-74.140516,4.697157
19573,2013,Agosto,Anguila/Territorio Británico de Ultramar,0,1,,1,-75.516486,10.446304
19574,2013,Agosto,Reino Unido de Gran Bretaña e Irlanda del Norte,10,14,,24,-69.941498,4.191162
19575,2013,Agosto,Reino Unido de Gran Bretaña e Irlanda del Norte,26,39,,65,-77.35600000000001,0.81488
19576,2013,Agosto,Reino Unido de Gran Bretaña e Irlanda del Norte,26,13,,39,-75.527794,10.406342
19577,2013,Agosto,Reino Unido de Gran Bretaña e Irlanda del Norte,1,6,,7,-74.77647900000001,10.886686
19578,2013,Agosto,Reino Unido de Gran Bretaña e Irlanda del Norte,0,4,,4,-74.765343,10.970933
19579,2013,Agosto,Reino Unido de Gran Bretaña e Irlanda del Norte,3,15,,18,-74.213989,11.247722999999999
19580,2013,Agosto,Reino Unido de Gran Bretaña e Irlanda del Norte,10,26,,36,-76.532004,3.451668
19581,2013,Agosto,Reino Unido de Gran Bretaña e Irlanda del Norte,273,578,,851,-74.140516,4.697157
19582,2013,Agosto,Reino Unido de Gran Bretaña e Irlanda del Norte,17,39,,56,-75.42726,6.170465
19583,2013,Agosto,Reino Unido de Gran Bretaña e Irlanda del Norte,2,3,,5,-72.453013,7.819
19584,2013,Agosto,Reino Unido de Gran Bretaña e Irlanda del Norte,2,9,,11,-77.35002,8.63337
19585,2013,Agosto,Países Bajos,0,1,,1,-69.941498,4.191162
19586,2013,Agosto,Países Bajos,14,18,,32,-77.35600000000001,0.81488
19587,2013,Agosto,Países Bajos,3,12,,15,-75.527794,10.406342
19588,2013,Agosto,Países Bajos,2,2,,4,-75.516486,10.446304
19589,2013,Agosto,Países Bajos,2,17,,19,-74.77647900000001,10.886686
19590,2013,Agosto,Países Bajos,0,1,,1,-74.213989,11.247722999999999
19591,2013,Agosto,Países Bajos,3,5,,8,-81.70216500000001,12.5862
19592,2013,Agosto,Países Bajos,11,45,,56,-76.532004,3.451668
19593,2013,Agosto,Países Bajos,410,662,,1072,-74.140516,4.697157
19594,2013,Agosto,Países Bajos,72,93,,165,-75.42726,6.170465
19595,2013,Agosto,Países Bajos,3,1,,4,-73.181317,7.1280470000000005
19596,2013,Agosto,Países Bajos,1,5,,6,-72.453013,7.819
19597,2013,Agosto,Países Bajos,0,1,,1,-72.508188,7.927233
19598,2013,Agosto,Países Bajos,3,4,,7,-77.35002,8.63337
19599,2013,Agosto,Lituania,1,0,,1,-76.532004,3.451668
19600,2013,Agosto,Lituania,0,4,,4,-74.140516,4.697157
19601,2013,Agosto,Reino Unido de Gran Bretaña e Irlanda del Norte,0,2,,2,-75.527794,10.406342
19602,2013,Agosto,Reino Unido de Gran Bretaña e Irlanda del Norte,0,1,,1,-74.77647900000001,10.886686
19603,2013,Agosto,Reino Unido de Gran Bretaña e Irlanda del Norte,4,8,,12,-75.527794,10.406342
19604,2013,Agosto,Reino Unido de Gran Bretaña e Irlanda del Norte,1,0,,1,-76.532004,3.451668
19605,2013,Agosto,Reino Unido de Gran Bretaña e Irlanda del Norte,1,6,,7,-74.140516,4.697157
19606,2013,Agosto,Reino Unido de Gran Bretaña e Irlanda del Norte,1,0,,1,-72.453013,7.819
19607,2013,Agosto,Letonia,1,0,,1,-74.140516,4.697157
19608,2013,Septiembre,Albania,0,1,,1,-76.532004,3.451668
19609,2013,Septiembre,Albania,2,2,,4,-74.140516,4.697157
19610,2013,Septiembre,Albania,0,1,,1,-75.42726,6.170465
19611,2013,Septiembre,Alemania,7,13,,20,-69.941498,4.191162
19612,2013,Septiembre,Alemania,34,40,,74,-77.35600000000001,0.81488
19613,2013,Septiembre,Alemania,18,27,,45,-75.527794,10.406342
19614,2013,Septiembre,Alemania,20,35,,55,-75.516486,10.446304
19615,2013,Septiembre,Alemania,2,6,,8,-74.77647900000001,10.886686
19616,2013,Septiembre,Alemania,0,1,,1,-74.765343,10.970933
19617,2013,Septiembre,Alemania,2,2,,4,-74.213989,11.247722999999999
19618,2013,Septiembre,Alemania,8,12,,20,-72.129595,11.360028999999999
19619,2013,Septiembre,Alemania,1,0,,1,-72.919186,11.52863
19620,2013,Septiembre,Alemania,0,1,,1,-81.70216500000001,12.5862
19621,2013,Septiembre,Alemania,33,54,,87,-76.532004,3.451668
19622,2013,Septiembre,Alemania,1,0,,1,-77.061029,3.8844260000000004
19623,2013,Septiembre,Alemania,1070,1744,,2814,-74.140516,4.697157
19624,2013,Septiembre,Alemania,0,4,,4,-75.736374,4.815189
19625,2013,Septiembre,Alemania,39,93,,132,-75.42726,6.170465
19626,2013,Septiembre,Alemania,0,1,,1,-73.181317,7.1280470000000005
19627,2013,Septiembre,Alemania,3,8,,11,-72.453013,7.819
19628,2013,Septiembre,Alemania,5,6,,11,-77.35002,8.63337
19629,2013,Septiembre,Andorra,1,5,,6,-74.140516,4.697157
19630,2013,Septiembre,Antigua y Barbuda,0,7,,7,-75.516486,10.446304
19631,2013,Septiembre,Antigua y Barbuda,3,2,,5,-74.140516,4.697157
19632,2013,Septiembre,Antigua y Barbuda,1,0,,1,-75.42726,6.170465
19633,2013,Septiembre,Países Bajos,1,0,,1,-75.42726,6.170465
19634,2013,Septiembre,Arabia Saudita,0,2,,2,-74.140516,4.697157
19635,2013,Septiembre,Arabia Saudita,0,2,,2,-75.516486,10.446304
19636,2013,Septiembre,Arabia Saudita,0,9,,9,-74.140516,4.697157
19637,2013,Septiembre,Arabia Saudita,0,1,,1,-75.736374,4.815189
19638,2013,Septiembre,Argelia,1,3,,4,-74.140516,4.697157
19639,2013,Septiembre,Argentina,4,4,,8,-69.941498,4.191162
19640,2013,Septiembre,Argentina,6,2,,8,-76.876446,0.33002
19641,2013,Septiembre,Argentina,45,80,,125,-77.35600000000001,0.81488
19642,2013,Septiembre,Argentina,119,100,,219,-75.527794,10.406342
19643,2013,Septiembre,Argentina,898,627,,1525,-75.516486,10.446304
19644,2013,Septiembre,Argentina,11,30,,41,-74.77647900000001,10.886686
19645,2013,Septiembre,Argentina,18,25,,43,-72.129595,11.360028999999999
19646,2013,Septiembre,Argentina,194,139,,333,-81.70216500000001,12.5862
19647,2013,Septiembre,Argentina,38,74,,112,-76.532004,3.451668
19648,2013,Septiembre,Argentina,0,1,,1,-75.76635300000001,4.45285
19649,2013,Septiembre,Argentina,2892,4297,,7189,-74.140516,4.697157
19650,2013,Septiembre,Argentina,8,12,,20,-75.736374,4.815189
19651,2013,Septiembre,Argentina,100,236,,336,-75.42726,6.170465
19652,2013,Septiembre,Argentina,0,2,,2,-73.181317,7.1280470000000005
19653,2013,Septiembre,Argentina,21,36,,57,-72.453013,7.819
19654,2013,Septiembre,Argentina,1,4,,5,-77.35002,8.63337
19655,2013,Septiembre,República de Armenia,1,1,,2,-74.140516,4.697157
19656,2013,Septiembre,Aruba,1,0,,1,-74.77647900000001,10.886686
19657,2013,Septiembre,Aruba,1,0,,1,-74.140516,4.697157
19658,2013,Septiembre,Australia,5,6,,11,-69.941498,4.191162
19659,2013,Septiembre,Australia,23,31,,54,-77.35600000000001,0.81488
19660,2013,Septiembre,Australia,15,27,,42,-75.527794,10.406342
19661,2013,Septiembre,Australia,33,40,,73,-75.516486,10.446304
19662,2013,Septiembre,Australia,5,12,,17,-74.77647900000001,10.886686
19663,2013,Septiembre,Australia,0,1,,1,-74.213989,11.247722999999999
19664,2013,Septiembre,Australia,1,0,,1,-81.70216500000001,12.5862
19665,2013,Septiembre,Australia,10,18,,28,-76.532004,3.451668
19666,2013,Septiembre,Australia,171,312,,483,-74.140516,4.697157
19667,2013,Septiembre,Australia,0,2,,2,-75.736374,4.815189
19668,2013,Septiembre,Australia,12,46,,58,-75.42726,6.170465
19669,2013,Septiembre,Australia,0,1,,1,-73.181317,7.1280470000000005
19670,2013,Septiembre,Australia,0,4,,4,-72.453013,7.819
19671,2013,Septiembre,Australia,0,1,,1,-72.508188,7.927233
19672,2013,Septiembre,Australia,3,7,,10,-77.35002,8.63337
19673,2013,Septiembre,Austria,4,0,,4,-77.35600000000001,0.81488
19674,2013,Septiembre,Austria,2,4,,6,-75.527794,10.406342
19675,2013,Septiembre,Austria,1,2,,3,-75.516486,10.446304
19676,2013,Septiembre,Austria,0,3,,3,-74.77647900000001,10.886686
19677,2013,Septiembre,Austria,3,5,,8,-72.129595,11.360028999999999
19678,2013,Septiembre,Austria,2,3,,5,-76.532004,3.451668
19679,2013,Septiembre,Austria,68,180,,248,-74.140516,4.697157
19680,2013,Septiembre,Austria,3,15,,18,-75.42726,6.170465
19681,2013,Septiembre,Austria,3,0,,3,-72.453013,7.819
19682,2013,Septiembre,Austria,1,0,,1,-77.35002,8.63337
19683,2013,Septiembre,Azerbaiyán,1,0,,1,-74.140516,4.697157
19684,2013,Septiembre,Bahamas,1,5,,6,-75.516486,10.446304
19685,2013,Septiembre,Bahamas,3,8,,11,-74.140516,4.697157
19686,2013,Septiembre,Bahamas,0,2,,2,-75.42726,6.170465
19687,2013,Septiembre,Bangladesh,0,3,,3,-75.516486,10.446304
19688,2013,Septiembre,Bangladesh,0,3,,3,-74.140516,4.697157
19689,2013,Septiembre,Bangladesh,1,0,,1,-75.42726,6.170465
19690,2013,Septiembre,Barbados,7,9,,16,-75.516486,10.446304
19691,2013,Septiembre,Barbados,0,8,,8,-76.532004,3.451668
19692,2013,Septiembre,Barbados,1,3,,4,-74.140516,4.697157
19693,2013,Septiembre,Barbados,1,0,,1,-75.736374,4.815189
19694,2013,Septiembre,Barbados,2,0,,2,-75.42726,6.170465
19695,2013,Septiembre,República de Belarús,1,4,,5,-77.35600000000001,0.81488
19696,2013,Septiembre,República de Belarús,0,3,,3,-74.140516,4.697157
19697,2013,Septiembre,Bélgica,5,2,,7,-77.35600000000001,0.81488
19698,2013,Septiembre,Bélgica,2,6,,8,-75.527794,10.406342
19699,2013,Septiembre,Bélgica,0,6,,6,-75.516486,10.446304
19700,2013,Septiembre,Bélgica,0,1,,1,-74.77647900000001,10.886686
19701,2013,Septiembre,Bélgica,0,9,,9,-74.213989,11.247722999999999
19702,2013,Septiembre,Bélgica,1,1,,2,-72.129595,11.360028999999999
19703,2013,Septiembre,Bélgica,5,31,,36,-76.532004,3.451668
19704,2013,Septiembre,Bélgica,112,299,,411,-74.140516,4.697157
19705,2013,Septiembre,Bélgica,0,1,,1,-75.736374,4.815189
19706,2013,Septiembre,Bélgica,8,14,,22,-75.42726,6.170465
19707,2013,Septiembre,Bélgica,1,3,,4,-72.453013,7.819
19708,2013,Septiembre,Belice,0,4,,4,-75.516486,10.446304
19709,2013,Septiembre,Belice,4,19,,23,-74.140516,4.697157
19710,2013,Septiembre,Belice,0,1,,1,-75.736374,4.815189
19711,2013,Septiembre,Belice,0,1,,1,-75.42726,6.170465
19712,2013,Septiembre,Belice,0,2,,2,-77.35002,8.63337
19713,2013,Septiembre,Benín,1,0,,1,-74.140516,4.697157
19714,2013,Septiembre,Bermudas/Territorio Británico de Ultramar,0,1,,1,-75.516486,10.446304
19715,2013,Septiembre,Bermudas/Territorio Británico de Ultramar,0,2,,2,-76.532004,3.451668
19716,2013,Septiembre,Bolivia,1,1,,2,-69.941498,4.191162
19717,2013,Septiembre,Bolivia,9,27,,36,-77.35600000000001,0.81488
19718,2013,Septiembre,Bolivia,3,3,,6,-75.527794,10.406342
19719,2013,Septiembre,Bolivia,20,36,,56,-75.516486,10.446304
19720,2013,Septiembre,Bolivia,2,0,,2,-74.77647900000001,10.886686
19721,2013,Septiembre,Bolivia,1,0,,1,-72.129595,11.360028999999999
19722,2013,Septiembre,Bolivia,1,1,,2,-81.70216500000001,12.5862
19723,2013,Septiembre,Bolivia,7,5,,12,-76.532004,3.451668
19724,2013,Septiembre,Bolivia,303,431,,734,-74.140516,4.697157
19725,2013,Septiembre,Bolivia,0,2,,2,-75.736374,4.815189
19726,2013,Septiembre,Bolivia,18,21,,39,-75.42726,6.170465
19727,2013,Septiembre,Bolivia,1,0,,1,-73.181317,7.1280470000000005
19728,2013,Septiembre,Bolivia,0,5,,5,-72.453013,7.819
19729,2013,Septiembre,Bolivia,1,0,,1,-77.35002,8.63337
19730,2013,Septiembre,Botsuana,1,2,,3,-74.140516,4.697157
19731,2013,Septiembre,Brasil,68,82,,150,-69.941498,4.191162
19732,2013,Septiembre,Brasil,12,19,,31,-77.35600000000001,0.81488
19733,2013,Septiembre,Brasil,68,51,,119,-75.527794,10.406342
19734,2013,Septiembre,Brasil,259,235,,494,-75.516486,10.446304
19735,2013,Septiembre,Brasil,7,24,,31,-74.77647900000001,10.886686
19736,2013,Septiembre,Brasil,1,3,,4,-74.213989,11.247722999999999
19737,2013,Septiembre,Brasil,6,16,,22,-72.129595,11.360028999999999
19738,2013,Septiembre,Brasil,26,9,,35,-81.70216500000001,12.5862
19739,2013,Septiembre,Brasil,15,92,,107,-76.532004,3.451668
19740,2013,Septiembre,Brasil,3085,4488,,7573,-74.140516,4.697157
19741,2013,Septiembre,Brasil,5,4,,9,-75.736374,4.815189
19742,2013,Septiembre,Brasil,89,212,,301,-75.42726,6.170465
19743,2013,Septiembre,Brasil,1,0,,1,-73.181317,7.1280470000000005
19744,2013,Septiembre,Brasil,9,14,,23,-72.453013,7.819
19745,2013,Septiembre,Brasil,0,1,,1,-72.508188,7.927233
19746,2013,Septiembre,Bulgaria,0,1,,1,-74.765343,10.970933
19747,2013,Septiembre,Bulgaria,10,13,,23,-74.140516,4.697157
19748,2013,Septiembre,Burkina Faso,0,1,,1,-75.516486,10.446304
19749,2013,Septiembre,Burkina Faso,0,1,,1,-76.532004,3.451668
19750,2013,Septiembre,Burkina Faso,2,7,,9,-74.140516,4.697157
19751,2013,Septiembre,Islas Caimán/Territorio Británico de Ultramar,1,0,,1,-74.77647900000001,10.886686
19752,2013,Septiembre,Camerún,0,2,,2,-75.516486,10.446304
19753,2013,Septiembre,Camerún,0,4,,4,-74.140516,4.697157
19754,2013,Septiembre,Canadá,2,2,,4,-69.941498,4.191162
19755,2013,Septiembre,Canadá,8,13,,21,-77.35600000000001,0.81488
19756,2013,Septiembre,Canadá,10,35,,45,-75.527794,10.406342
19757,2013,Septiembre,Canadá,30,97,,127,-75.516486,10.446304
19758,2013,Septiembre,Canadá,3,19,,22,-74.77647900000001,10.886686
19759,2013,Septiembre,Canadá,0,1,,1,-74.765343,10.970933
19760,2013,Septiembre,Canadá,1,0,,1,-74.213989,11.247722999999999
19761,2013,Septiembre,Canadá,0,4,,4,-81.70216500000001,12.5862
19762,2013,Septiembre,Canadá,24,34,,58,-76.532004,3.451668
19763,2013,Septiembre,Canadá,2,1,,3,-75.76635300000001,4.45285
19764,2013,Septiembre,Canadá,508,1176,,1684,-74.140516,4.697157
19765,2013,Septiembre,Canadá,1,3,,4,-75.736374,4.815189
19766,2013,Septiembre,Canadá,55,168,,223,-75.42726,6.170465
19767,2013,Septiembre,Canadá,1,1,,2,-73.181317,7.1280470000000005
19768,2013,Septiembre,Canadá,0,3,,3,-72.453013,7.819
19769,2013,Septiembre,Canadá,0,1,,1,-72.508188,7.927233
19770,2013,Septiembre,Canadá,5,3,,8,-77.35002,8.63337
19771,2013,Septiembre,Chad,0,2,,2,-74.140516,4.697157
19772,2013,Septiembre,España,5,9,,14,-77.35600000000001,0.81488
19773,2013,Septiembre,España,1,7,,8,-74.77647900000001,10.886686
19774,2013,Septiembre,España,0,1,,1,-81.703935,12.574411099999999
19775,2013,Septiembre,España,0,1,,1,-81.70216500000001,12.5862
19776,2013,Septiembre,España,86,113,,199,-76.532004,3.451668
19777,2013,Septiembre,España,41,91,,132,-74.140516,4.697157
19778,2013,Septiembre,España,38,151,,189,-75.42726,6.170465
19779,2013,Septiembre,España,0,1,,1,-72.453013,7.819
19780,2013,Septiembre,República Democrática del Congo,0,2,,2,-74.140516,4.697157
19781,2013,Septiembre,República Democrática del Congo,1,0,,1,-75.42726,6.170465
19782,2013,Septiembre,República de Corea,0,1,,1,-69.941498,4.191162
19783,2013,Septiembre,República de Corea,3,2,,5,-77.35600000000001,0.81488
19784,2013,Septiembre,República de Corea,1,3,,4,-75.527794,10.406342
19785,2013,Septiembre,República de Corea,0,3,,3,-75.516486,10.446304
19786,2013,Septiembre,República de Corea,0,1,,1,-74.77647900000001,10.886686
19787,2013,Septiembre,República de Corea,0,1,,1,-72.129595,11.360028999999999
19788,2013,Septiembre,República de Corea,0,12,,12,-76.532004,3.451668
19789,2013,Septiembre,República de Corea,113,365,,478,-74.140516,4.697157
19790,2013,Septiembre,República de Corea,1,0,,1,-75.736374,4.815189
19791,2013,Septiembre,República de Corea,4,14,,18,-75.42726,6.170465
19792,2013,Septiembre,República de Corea,4,6,,10,-72.453013,7.819
19793,2013,Septiembre,Costa de Marfil,1,7,,8,-74.140516,4.697157
19794,2013,Septiembre,Costa Rica,0,3,,3,-77.35600000000001,0.81488
19795,2013,Septiembre,Costa Rica,1,2,,3,-75.527794,10.406342
19796,2013,Septiembre,Costa Rica,36,46,,82,-75.516486,10.446304
19797,2013,Septiembre,Costa Rica,13,32,,45,-74.77647900000001,10.886686
19798,2013,Septiembre,Costa Rica,272,197,,469,-81.70216500000001,12.5862
19799,2013,Septiembre,Costa Rica,14,57,,71,-76.532004,3.451668
19800,2013,Septiembre,Costa Rica,521,873,,1394,-74.140516,4.697157
19801,2013,Septiembre,Costa Rica,2,8,,10,-75.736374,4.815189
19802,2013,Septiembre,Costa Rica,85,198,,283,-75.42726,6.170465
19803,2013,Septiembre,Costa Rica,1,1,,2,-73.181317,7.1280470000000005
19804,2013,Septiembre,Costa Rica,2,2,,4,-72.453013,7.819
19805,2013,Septiembre,Costa Rica,0,1,,1,-76.7333,8.06667
19806,2013,Septiembre,Costa Rica,2,2,,4,-77.35002,8.63337
19807,2013,Septiembre,Croacia,0,1,,1,-75.516486,10.446304
19808,2013,Septiembre,Croacia,0,1,,1,-74.213989,11.247722999999999
19809,2013,Septiembre,Croacia,0,4,,4,-76.532004,3.451668
19810,2013,Septiembre,Croacia,5,22,,27,-74.140516,4.697157
19811,2013,Septiembre,Croacia,1,2,,3,-75.42726,6.170465
19812,2013,Septiembre,Cuba,7,14,,21,-75.516486,10.446304
19813,2013,Septiembre,Cuba,8,35,,43,-74.77647900000001,10.886686
19814,2013,Septiembre,Cuba,0,1,,1,-72.129595,11.360028999999999
19815,2013,Septiembre,Cuba,1,0,,1,-81.70216500000001,12.5862
19816,2013,Septiembre,Cuba,5,16,,21,-76.532004,3.451668
19817,2013,Septiembre,Cuba,0,1,,1,-75.76635300000001,4.45285
19818,2013,Septiembre,Cuba,91,165,,256,-74.140516,4.697157
19819,2013,Septiembre,Cuba,0,1,,1,-75.736374,4.815189
19820,2013,Septiembre,Cuba,5,30,,35,-75.42726,6.170465
19821,2013,Septiembre,Cuba,1,0,,1,-67.48402800000001,6.185536
19822,2013,Septiembre,Cuba,1,2,,3,-73.181317,7.1280470000000005
19823,2013,Septiembre,Cuba,1,1,,2,-72.508188,7.927233
19824,2013,Septiembre,Curazao,1,2,,3,-74.140516,4.697157
19825,2013,Septiembre,Curazao,1,2,,3,-75.42726,6.170465
19826,2013,Septiembre,República Checa,0,1,,1,-77.35600000000001,0.81488
19827,2013,Septiembre,República Checa,1,1,,2,-75.516486,10.446304
19828,2013,Septiembre,República Checa,1,2,,3,-72.129595,11.360028999999999
19829,2013,Septiembre,República Checa,29,39,,68,-74.140516,4.697157
19830,2013,Septiembre,República Checa,1,3,,4,-75.42726,6.170465
19831,2013,Septiembre,Chile,3,2,,5,-69.941498,4.191162
19832,2013,Septiembre,Chile,0,1,,1,-76.876446,0.33002
19833,2013,Septiembre,Chile,19,43,,62,-77.35600000000001,0.81488
19834,2013,Septiembre,Chile,218,161,,379,-75.527794,10.406342
19835,2013,Septiembre,Chile,156,133,,289,-75.516486,10.446304
19836,2013,Septiembre,Chile,9,23,,32,-74.77647900000001,10.886686
19837,2013,Septiembre,Chile,1,11,,12,-72.129595,11.360028999999999
19838,2013,Septiembre,Chile,33,20,,53,-81.70216500000001,12.5862
19839,2013,Septiembre,Chile,36,83,,119,-76.532004,3.451668
19840,2013,Septiembre,Chile,0,1,,1,-77.061029,3.8844260000000004
19841,2013,Septiembre,Chile,2953,3797,,6750,-74.140516,4.697157
19842,2013,Septiembre,Chile,2,3,,5,-75.736374,4.815189
19843,2013,Septiembre,Chile,76,172,,248,-75.42726,6.170465
19844,2013,Septiembre,Chile,0,1,,1,-70.74025300000001,7.088728999999999
19845,2013,Septiembre,Chile,1,2,,3,-73.181317,7.1280470000000005
19846,2013,Septiembre,Chile,9,19,,28,-72.453013,7.819
19847,2013,Septiembre,China,0,1,,1,-69.941498,4.191162
19848,2013,Septiembre,China,2,3,,5,-77.35600000000001,0.81488
19849,2013,Septiembre,China,1,5,,6,-75.516486,10.446304
19850,2013,Septiembre,China,0,6,,6,-74.77647900000001,10.886686
19851,2013,Septiembre,China,0,2,,2,-74.213989,11.247722999999999
19852,2013,Septiembre,China,0,2,,2,-72.129595,11.360028999999999
19853,2013,Septiembre,China,2,9,,11,-76.532004,3.451668
19854,2013,Septiembre,China,113,341,,454,-74.140516,4.697157
19855,2013,Septiembre,China,10,14,,24,-75.42726,6.170465
19856,2013,Septiembre,China,0,1,,1,-72.453013,7.819
19857,2013,Septiembre,Taiwán,1,2,,3,-77.35600000000001,0.81488
19858,2013,Septiembre,Taiwán,0,2,,2,-74.77647900000001,10.886686
19859,2013,Septiembre,Taiwán,0,2,,2,-76.532004,3.451668
19860,2013,Septiembre,Taiwán,15,12,,27,-74.140516,4.697157
19861,2013,Septiembre,Taiwán,5,9,,14,-75.42726,6.170465
19862,2013,Septiembre,Chipre,2,3,,5,-74.140516,4.697157
19863,2013,Septiembre,Dinamarca,1,2,,3,-77.35600000000001,0.81488
19864,2013,Septiembre,Dinamarca,1,2,,3,-75.527794,10.406342
19865,2013,Septiembre,Dinamarca,2,2,,4,-75.516486,10.446304
19866,2013,Septiembre,Dinamarca,0,1,,1,-74.77647900000001,10.886686
19867,2013,Septiembre,Dinamarca,0,1,,1,-72.129595,11.360028999999999
19868,2013,Septiembre,Dinamarca,0,4,,4,-76.532004,3.451668
19869,2013,Septiembre,Dinamarca,38,109,,147,-74.140516,4.697157
19870,2013,Septiembre,Dinamarca,1,2,,3,-75.42726,6.170465
19871,2013,Septiembre,Dinamarca,0,1,,1,-73.181317,7.1280470000000005
19872,2013,Septiembre,Dinamarca,0,1,,1,-72.453013,7.819
19873,2013,Septiembre,Dominica,3,1,,4,-75.516486,10.446304
19874,2013,Septiembre,Dominica,2,4,,6,-74.140516,4.697157
19875,2013,Septiembre,Ecuador,12,60,,72,-76.876446,0.33002
19876,2013,Septiembre,Ecuador,951,1675,,2626,-77.35600000000001,0.81488
19877,2013,Septiembre,Ecuador,2,116,,118,-78.802679,18.00143
19878,2013,Septiembre,Ecuador,4,21,,25,-75.527794,10.406342
19879,2013,Septiembre,Ecuador,46,174,,220,-75.516486,10.446304
19880,2013,Septiembre,Ecuador,81,307,,388,-74.77647900000001,10.886686
19881,2013,Septiembre,Ecuador,15,14,,29,-72.129595,11.360028999999999
19882,2013,Septiembre,Ecuador,3,8,,11,-81.70216500000001,12.5862
19883,2013,Septiembre,Ecuador,451,511,,962,-76.532004,3.451668
19884,2013,Septiembre,Ecuador,0,1,,1,-75.76635300000001,4.45285
19885,2013,Septiembre,Ecuador,1837,2883,,4720,-74.140516,4.697157
19886,2013,Septiembre,Ecuador,1,4,,5,-75.736374,4.815189
19887,2013,Septiembre,Ecuador,432,592,,1024,-75.42726,6.170465
19888,2013,Septiembre,Ecuador,1,0,,1,-73.181317,7.1280470000000005
19889,2013,Septiembre,Ecuador,140,199,,339,-72.453013,7.819
19890,2013,Septiembre,Ecuador,1,5,,6,-72.508188,7.927233
19891,2013,Septiembre,Ecuador,0,1,,1,-77.35002,8.63337
19892,2013,Septiembre,Egipto,0,1,,1,-75.527794,10.406342
19893,2013,Septiembre,Egipto,0,3,,3,-75.516486,10.446304
19894,2013,Septiembre,Egipto,2,0,,2,-76.532004,3.451668
19895,2013,Septiembre,Egipto,1,21,,22,-74.140516,4.697157
19896,2013,Septiembre,El Salvador,0,2,,2,-75.527794,10.406342
19897,2013,Septiembre,El Salvador,16,20,,36,-75.516486,10.446304
19898,2013,Septiembre,El Salvador,2,4,,6,-74.77647900000001,10.886686
19899,2013,Septiembre,El Salvador,0,1,,1,-81.70216500000001,12.5862
19900,2013,Septiembre,El Salvador,44,74,,118,-76.532004,3.451668
19901,2013,Septiembre,El Salvador,442,689,,1131,-74.140516,4.697157
19902,2013,Septiembre,El Salvador,0,1,,1,-75.736374,4.815189
19903,2013,Septiembre,El Salvador,31,71,,102,-75.42726,6.170465
19904,2013,Septiembre,El Salvador,0,1,,1,-77.762647,7.102626
19905,2013,Septiembre,El Salvador,0,2,,2,-73.181317,7.1280470000000005
19906,2013,Septiembre,Emiratos Árabes,1,9,,10,-74.140516,4.697157
19907,2013,Septiembre,España,3,7,,10,-69.941498,4.191162
19908,2013,Septiembre,España,21,42,,63,-77.35600000000001,0.81488
19909,2013,Septiembre,España,13,20,,33,-75.527794,10.406342
19910,2013,Septiembre,España,47,73,,120,-75.516486,10.446304
19911,2013,Septiembre,España,3,24,,27,-74.77647900000001,10.886686
19912,2013,Septiembre,España,4,8,,12,-72.129595,11.360028999999999
19913,2013,Septiembre,España,3,1,,4,-81.703935,12.574411099999999
19914,2013,Septiembre,España,8,5,,13,-81.70216500000001,12.5862
19915,2013,Septiembre,España,160,312,,472,-76.532004,3.451668
19916,2013,Septiembre,España,0,1,,1,-75.76635300000001,4.45285
19917,2013,Septiembre,España,1766,5013,,6779,-74.140516,4.697157
19918,2013,Septiembre,España,0,9,,9,-75.736374,4.815189
19919,2013,Septiembre,España,72,187,,259,-75.42726,6.170465
19920,2013,Septiembre,España,2,0,,2,-70.74025300000001,7.088728999999999
19921,2013,Septiembre,España,0,3,,3,-73.181317,7.1280470000000005
19922,2013,Septiembre,España,4,25,,29,-72.453013,7.819
19923,2013,Septiembre,España,0,2,,2,-72.508188,7.927233
19924,2013,Septiembre,España,2,7,,9,-77.35002,8.63337
19925,2013,Septiembre,Eslovaquia,1,0,,1,-75.527794,10.406342
19926,2013,Septiembre,Eslovaquia,1,5,,6,-75.516486,10.446304
19927,2013,Septiembre,Eslovaquia,0,1,,1,-74.77647900000001,10.886686
19928,2013,Septiembre,Eslovaquia,1,1,,2,-72.129595,11.360028999999999
19929,2013,Septiembre,Eslovaquia,1,0,,1,-76.532004,3.451668
19930,2013,Septiembre,Eslovaquia,8,13,,21,-74.140516,4.697157
19931,2013,Septiembre,Eslovaquia,0,1,,1,-72.453013,7.819
19932,2013,Septiembre,Eslovaquia,0,1,,1,-77.35002,8.63337
19933,2013,Septiembre,Eslovenia,0,1,,1,-75.527794,10.406342
19934,2013,Septiembre,Eslovenia,0,1,,1,-75.516486,10.446304
19935,2013,Septiembre,Eslovenia,0,2,,2,-72.129595,11.360028999999999
19936,2013,Septiembre,Eslovenia,5,19,,24,-74.140516,4.697157
19937,2013,Septiembre,Estados Unidos de América,8,27,,35,-69.941498,4.191162
19938,2013,Septiembre,Estados Unidos de América,23,47,,70,-77.35600000000001,0.81488
19939,2013,Septiembre,Estados Unidos de América,23,40,,63,-75.527794,10.406342
19940,2013,Septiembre,Estados Unidos de América,806,1695,,2501,-75.516486,10.446304
19941,2013,Septiembre,Estados Unidos de América,159,442,,601,-74.77647900000001,10.886686
19942,2013,Septiembre,Estados Unidos de América,1,1,,2,-74.765343,10.970933
19943,2013,Septiembre,Estados Unidos de América,0,4,,4,-74.213989,11.247722999999999
19944,2013,Septiembre,Estados Unidos de América,5,8,,13,-72.129595,11.360028999999999
19945,2013,Septiembre,Estados Unidos de América,0,3,,3,-72.919186,11.52863
19946,2013,Septiembre,Estados Unidos de América,0,3,,3,-81.703935,12.574411099999999
19947,2013,Septiembre,Estados Unidos de América,13,21,,34,-81.70216500000001,12.5862
19948,2013,Septiembre,Estados Unidos de América,1,1,,2,-81.372937,13.338761300000002
19949,2013,Septiembre,Estados Unidos de América,456,875,,1331,-76.532004,3.451668
19950,2013,Septiembre,Estados Unidos de América,52,83,,135,-75.76635300000001,4.45285
19951,2013,Septiembre,Estados Unidos de América,4176,9603,,13779,-74.140516,4.697157
19952,2013,Septiembre,Estados Unidos de América,51,114,,165,-75.736374,4.815189
19953,2013,Septiembre,Estados Unidos de América,829,2344,,3173,-75.42726,6.170465
19954,2013,Septiembre,Estados Unidos de América,1,4,,5,-70.74025300000001,7.088728999999999
19955,2013,Septiembre,Estados Unidos de América,0,1,,1,-77.762647,7.102626
19956,2013,Septiembre,Estados Unidos de América,12,35,,47,-73.181317,7.1280470000000005
19957,2013,Septiembre,Estados Unidos de América,17,41,,58,-72.453013,7.819
19958,2013,Septiembre,Estados Unidos de América,11,11,,22,-72.508188,7.927233
19959,2013,Septiembre,Estados Unidos de América,8,10,,18,-77.35002,8.63337
19960,2013,Septiembre,Estonia,0,1,,1,-74.77647900000001,10.886686
19961,2013,Septiembre,Estonia,5,4,,9,-74.140516,4.697157
19962,2013,Septiembre,Etiopia,3,7,,10,-74.140516,4.697157
19963,2013,Septiembre,Filipinas,0,1,,1,-77.35600000000001,0.81488
19964,2013,Septiembre,Filipinas,0,1,,1,-78.802679,18.00143
19965,2013,Septiembre,Filipinas,0,61,,61,-75.527794,10.406342
19966,2013,Septiembre,Filipinas,1,30,,31,-75.516486,10.446304
19967,2013,Septiembre,Filipinas,0,7,,7,-74.77647900000001,10.886686
19968,2013,Septiembre,Filipinas,0,28,,28,-74.765343,10.970933
19969,2013,Septiembre,Filipinas,0,2,,2,-74.213989,11.247722999999999
19970,2013,Septiembre,Filipinas,1,12,,13,-76.532004,3.451668
19971,2013,Septiembre,Filipinas,0,16,,16,-77.061029,3.8844260000000004
19972,2013,Septiembre,Filipinas,19,100,,119,-74.140516,4.697157
19973,2013,Septiembre,Filipinas,3,3,,6,-75.42726,6.170465
19974,2013,Septiembre,Filipinas,1,0,,1,-73.181317,7.1280470000000005
19975,2013,Septiembre,Filipinas,0,1,,1,-76.7333,8.06667
19976,2013,Septiembre,Finlandia,1,0,,1,-69.941498,4.191162
19977,2013,Septiembre,Finlandia,1,0,,1,-77.35600000000001,0.81488
19978,2013,Septiembre,Finlandia,0,3,,3,-74.77647900000001,10.886686
19979,2013,Septiembre,Finlandia,1,1,,2,-72.129595,11.360028999999999
19980,2013,Septiembre,Finlandia,0,1,,1,-76.532004,3.451668
19981,2013,Septiembre,Finlandia,24,54,,78,-74.140516,4.697157
19982,2013,Septiembre,Finlandia,1,6,,7,-75.42726,6.170465
19983,2013,Septiembre,Francia,8,9,,17,-69.941498,4.191162
19984,2013,Septiembre,Francia,0,1,,1,-76.876446,0.33002
19985,2013,Septiembre,Francia,17,26,,43,-77.35600000000001,0.81488
19986,2013,Septiembre,Francia,6,13,,19,-75.527794,10.406342
19987,2013,Septiembre,Francia,23,49,,72,-75.516486,10.446304
19988,2013,Septiembre,Francia,1,8,,9,-74.77647900000001,10.886686
19989,2013,Septiembre,Francia,1,1,,2,-74.213989,11.247722999999999
19990,2013,Septiembre,Francia,2,6,,8,-72.129595,11.360028999999999
19991,2013,Septiembre,Francia,2,1,,3,-72.919186,11.52863
19992,2013,Septiembre,Francia,0,1,,1,-81.70216500000001,12.5862
19993,2013,Septiembre,Francia,25,61,,86,-76.532004,3.451668
19994,2013,Septiembre,Francia,0,1,,1,-75.76635300000001,4.45285
19995,2013,Septiembre,Francia,687,1484,,2171,-74.140516,4.697157
19996,2013,Septiembre,Francia,0,3,,3,-75.736374,4.815189
19997,2013,Septiembre,Francia,34,93,,127,-75.42726,6.170465
19998,2013,Septiembre,Francia,3,12,,15,-72.453013,7.819
19999,2013,Septiembre,Francia,0,2,,2,-72.508188,7.927233
20000,2013,Septiembre,Francia,3,5,,8,-77.35002,8.63337
20001,2013,Septiembre,Gabón,1,4,,5,-74.140516,4.697157
20002,2013,Septiembre,Georgia,1,0,,1,-77.35600000000001,0.81488
20003,2013,Septiembre,Georgia,0,1,,1,-74.765343,10.970933
20004,2013,Septiembre,Ghana,0,2,,2,-75.516486,10.446304
20005,2013,Septiembre,Ghana,1,5,,6,-74.140516,4.697157
20006,2013,Septiembre,Gibraltar/Territorio Británico de Ultramar,1,0,,1,-74.140516,4.697157
20007,2013,Septiembre,Granada,2,1,,3,-75.516486,10.446304
20008,2013,Septiembre,Granada,3,1,,4,-74.140516,4.697157
20009,2013,Septiembre,Grecia,0,5,,5,-75.527794,10.406342
20010,2013,Septiembre,Grecia,0,1,,1,-74.77647900000001,10.886686
20011,2013,Septiembre,Grecia,1,9,,10,-74.765343,10.970933
20012,2013,Septiembre,Grecia,0,3,,3,-76.532004,3.451668
20013,2013,Septiembre,Grecia,21,49,,70,-74.140516,4.697157
20014,2013,Septiembre,Grecia,1,1,,2,-75.42726,6.170465
20015,2013,Septiembre,Grecia,3,2,,5,-72.508188,7.927233
20016,2013,Septiembre,Guatemala,2,6,,8,-77.35600000000001,0.81488
20017,2013,Septiembre,Guatemala,1,2,,3,-75.527794,10.406342
20018,2013,Septiembre,Guatemala,24,45,,69,-75.516486,10.446304
20019,2013,Septiembre,Guatemala,3,4,,7,-74.77647900000001,10.886686
20020,2013,Septiembre,Guatemala,1,0,,1,-72.129595,11.360028999999999
20021,2013,Septiembre,Guatemala,28,31,,59,-81.70216500000001,12.5862
20022,2013,Septiembre,Guatemala,32,86,,118,-76.532004,3.451668
20023,2013,Septiembre,Guatemala,0,2,,2,-75.76635300000001,4.45285
20024,2013,Septiembre,Guatemala,203,454,,657,-74.140516,4.697157
20025,2013,Septiembre,Guatemala,0,6,,6,-75.736374,4.815189
20026,2013,Septiembre,Guatemala,30,84,,114,-75.42726,6.170465
20027,2013,Septiembre,Guatemala,1,6,,7,-73.181317,7.1280470000000005
20028,2013,Septiembre,Guatemala,0,8,,8,-72.453013,7.819
20029,2013,Septiembre,Guatemala,1,0,,1,-72.508188,7.927233
20030,2013,Septiembre,Guyana,0,1,,1,-69.941498,4.191162
20031,2013,Septiembre,Guyana,0,1,,1,-77.35600000000001,0.81488
20032,2013,Septiembre,Guyana,0,1,,1,-75.527794,10.406342
20033,2013,Septiembre,Guyana,1,0,,1,-75.516486,10.446304
20034,2013,Septiembre,Guyana,0,1,,1,-76.532004,3.451668
20035,2013,Septiembre,Guyana,10,12,,22,-74.140516,4.697157
20036,2013,Septiembre,Guyana,2,4,,6,-75.42726,6.170465
20037,2013,Septiembre,Guinea Ecuatorial,1,1,,2,-74.140516,4.697157
20038,2013,Septiembre,Haití,2,2,,4,-75.516486,10.446304
20039,2013,Septiembre,Haití,0,2,,2,-74.77647900000001,10.886686
20040,2013,Septiembre,Haití,3,5,,8,-76.532004,3.451668
20041,2013,Septiembre,Haití,3,21,,24,-74.140516,4.697157
20042,2013,Septiembre,Haití,3,7,,10,-75.42726,6.170465
20043,2013,Septiembre,Honduras,0,5,,5,-75.527794,10.406342
20044,2013,Septiembre,Honduras,25,29,,54,-75.516486,10.446304
20045,2013,Septiembre,Honduras,2,11,,13,-74.77647900000001,10.886686
20046,2013,Septiembre,Honduras,0,5,,5,-81.703935,12.574411099999999
20047,2013,Septiembre,Honduras,0,1,,1,-81.70216500000001,12.5862
20048,2013,Septiembre,Honduras,18,35,,53,-76.532004,3.451668
20049,2013,Septiembre,Honduras,166,216,,382,-74.140516,4.697157
20050,2013,Septiembre,Honduras,0,2,,2,-75.736374,4.815189
20051,2013,Septiembre,Honduras,17,37,,54,-75.42726,6.170465
20052,2013,Septiembre,Honduras,0,2,,2,-73.181317,7.1280470000000005
20053,2013,Septiembre,Honduras,1,0,,1,-72.453013,7.819
20054,2013,Septiembre,Honduras,0,2,,2,-72.508188,7.927233
20055,2013,Septiembre,Honduras,0,2,,2,-76.7333,8.06667
20056,2013,Septiembre,Honduras,1,0,,1,-77.35002,8.63337
20057,2013,Septiembre,Hong Kong,0,1,,1,-74.140516,4.697157
20058,2013,Septiembre,Hungría,1,1,,2,-75.527794,10.406342
20059,2013,Septiembre,Hungría,1,4,,5,-75.516486,10.446304
20060,2013,Septiembre,Hungría,2,1,,3,-76.532004,3.451668
20061,2013,Septiembre,Hungría,19,24,,43,-74.140516,4.697157
20062,2013,Septiembre,Hungría,0,1,,1,-75.736374,4.815189
20063,2013,Septiembre,Hungría,0,3,,3,-75.42726,6.170465
20064,2013,Septiembre,India,0,2,,2,-75.527794,10.406342
20065,2013,Septiembre,India,1,10,,11,-75.516486,10.446304
20066,2013,Septiembre,India,0,7,,7,-74.77647900000001,10.886686
20067,2013,Septiembre,India,0,1,,1,-74.765343,10.970933
20068,2013,Septiembre,India,0,1,,1,-72.129595,11.360028999999999
20069,2013,Septiembre,India,4,8,,12,-76.532004,3.451668
20070,2013,Septiembre,India,27,197,,224,-74.140516,4.697157
20071,2013,Septiembre,India,0,1,,1,-75.736374,4.815189
20072,2013,Septiembre,India,3,29,,32,-75.42726,6.170465
20073,2013,Septiembre,Indonesia,0,1,,1,-75.527794,10.406342
20074,2013,Septiembre,Indonesia,0,1,,1,-75.516486,10.446304
20075,2013,Septiembre,Indonesia,0,6,,6,-74.77647900000001,10.886686
20076,2013,Septiembre,Indonesia,0,11,,11,-74.765343,10.970933
20077,2013,Septiembre,Indonesia,1,0,,1,-76.532004,3.451668
20078,2013,Septiembre,Indonesia,9,19,,28,-74.140516,4.697157
20079,2013,Septiembre,Iraq,0,1,,1,-74.140516,4.697157
20080,2013,Septiembre,Irán,1,1,,2,-75.516486,10.446304
20081,2013,Septiembre,Irán,0,1,,1,-76.532004,3.451668
20082,2013,Septiembre,Irán,3,6,,9,-74.140516,4.697157
20083,2013,Septiembre,República de Irlanda,2,0,,2,-69.941498,4.191162
20084,2013,Septiembre,República de Irlanda,5,5,,10,-77.35600000000001,0.81488
20085,2013,Septiembre,República de Irlanda,5,9,,14,-75.527794,10.406342
20086,2013,Septiembre,República de Irlanda,3,10,,13,-75.516486,10.446304
20087,2013,Septiembre,República de Irlanda,0,1,,1,-74.77647900000001,10.886686
20088,2013,Septiembre,República de Irlanda,1,5,,6,-76.532004,3.451668
20089,2013,Septiembre,República de Irlanda,63,127,,190,-74.140516,4.697157
20090,2013,Septiembre,República de Irlanda,7,20,,27,-75.42726,6.170465
20091,2013,Septiembre,República de Irlanda,1,2,,3,-77.35002,8.63337
20092,2013,Septiembre,Islandia,1,0,,1,-75.516486,10.446304
20093,2013,Septiembre,Islandia,0,10,,10,-74.765343,10.970933
20094,2013,Septiembre,Islandia,1,3,,4,-74.140516,4.697157
20095,2013,Septiembre,Islandia,0,11,,11,-72.453013,7.819
20096,2013,Septiembre,Islandia,0,10,,10,-72.508188,7.927233
20097,2013,Septiembre,Isla de Man,3,9,,12,-77.35600000000001,0.81488
20098,2013,Septiembre,Isla de Man,4,14,,18,-76.532004,3.451668
20099,2013,Septiembre,Isla de Man,12,23,,35,-74.140516,4.697157
20100,2013,Septiembre,Isla de Man,21,42,,63,-75.42726,6.170465
20101,2013,Septiembre,Isla de Man,1,0,,1,-73.181317,7.1280470000000005
20102,2013,Septiembre,Isla Johnston,0,2,,2,-75.42726,6.170465
20103,2013,Septiembre,Israel,1,2,,3,-69.941498,4.191162
20104,2013,Septiembre,Israel,4,18,,22,-77.35600000000001,0.81488
20105,2013,Septiembre,Israel,1,4,,5,-75.527794,10.406342
20106,2013,Septiembre,Israel,5,40,,45,-75.516486,10.446304
20107,2013,Septiembre,Israel,2,1,,3,-74.77647900000001,10.886686
20108,2013,Septiembre,Israel,3,2,,5,-81.70216500000001,12.5862
20109,2013,Septiembre,Israel,11,16,,27,-76.532004,3.451668
20110,2013,Septiembre,Israel,73,312,,385,-74.140516,4.697157
20111,2013,Septiembre,Israel,4,27,,31,-75.42726,6.170465
20112,2013,Septiembre,Israel,0,4,,4,-77.35002,8.63337
20113,2013,Septiembre,Italia,1,2,,3,-69.941498,4.191162
20114,2013,Septiembre,Italia,9,15,,24,-77.35600000000001,0.81488
20115,2013,Septiembre,Italia,4,5,,9,-75.527794,10.406342
20116,2013,Septiembre,Italia,16,51,,67,-75.516486,10.446304
20117,2013,Septiembre,Italia,2,9,,11,-74.77647900000001,10.886686
20118,2013,Septiembre,Italia,3,12,,15,-72.129595,11.360028999999999
20119,2013,Septiembre,Italia,9,9,,18,-81.70216500000001,12.5862
20120,2013,Septiembre,Italia,21,85,,106,-76.532004,3.451668
20121,2013,Septiembre,Italia,350,1347,,1697,-74.140516,4.697157
20122,2013,Septiembre,Italia,0,2,,2,-75.736374,4.815189
20123,2013,Septiembre,Italia,26,99,,125,-75.42726,6.170465
20124,2013,Septiembre,Italia,1,0,,1,-70.74025300000001,7.088728999999999
20125,2013,Septiembre,Italia,0,3,,3,-73.181317,7.1280470000000005
20126,2013,Septiembre,Italia,3,14,,17,-72.453013,7.819
20127,2013,Septiembre,Italia,3,0,,3,-72.508188,7.927233
20128,2013,Septiembre,Italia,0,2,,2,-77.35002,8.63337
20129,2013,Septiembre,Islas del Canal,1,6,,7,-74.77647900000001,10.886686
20130,2013,Septiembre,Islas del Canal,0,1,,1,-72.453013,7.819
20131,2013,Septiembre,Jamaica,6,6,,12,-75.516486,10.446304
20132,2013,Septiembre,Jamaica,0,2,,2,-81.70216500000001,12.5862
20133,2013,Septiembre,Jamaica,2,5,,7,-76.532004,3.451668
20134,2013,Septiembre,Jamaica,11,24,,35,-74.140516,4.697157
20135,2013,Septiembre,Jamaica,1,0,,1,-75.736374,4.815189
20136,2013,Septiembre,Jamaica,0,7,,7,-75.42726,6.170465
20137,2013,Septiembre,Jamaica,0,1,,1,-72.453013,7.819
20138,2013,Septiembre,Japón,0,1,,1,-69.941498,4.191162
20139,2013,Septiembre,Japón,3,6,,9,-77.35600000000001,0.81488
20140,2013,Septiembre,Japón,3,16,,19,-75.516486,10.446304
20141,2013,Septiembre,Japón,1,8,,9,-74.77647900000001,10.886686
20142,2013,Septiembre,Japón,1,1,,2,-81.70216500000001,12.5862
20143,2013,Septiembre,Japón,5,12,,17,-76.532004,3.451668
20144,2013,Septiembre,Japón,104,418,,522,-74.140516,4.697157
20145,2013,Septiembre,Japón,3,1,,4,-75.736374,4.815189
20146,2013,Septiembre,Japón,9,32,,41,-75.42726,6.170465
20147,2013,Septiembre,Japón,2,1,,3,-73.181317,7.1280470000000005
20148,2013,Septiembre,Japón,3,2,,5,-72.453013,7.819
20149,2013,Septiembre,Japón,1,2,,3,-77.35002,8.63337
20150,2013,Septiembre,Jordania,0,5,,5,-74.140516,4.697157
20151,2013,Septiembre,Kazajistán,0,2,,2,-77.35600000000001,0.81488
20152,2013,Septiembre,Kazajistán,4,4,,8,-74.140516,4.697157
20153,2013,Septiembre,Kenia,0,1,,1,-75.516486,10.446304
20154,2013,Septiembre,Kenia,0,1,,1,-76.532004,3.451668
20155,2013,Septiembre,Kenia,9,13,,22,-74.140516,4.697157
20156,2013,Septiembre,Kenia,0,2,,2,-75.42726,6.170465
20157,2013,Septiembre,Kirguistán,0,1,,1,-74.140516,4.697157
20158,2013,Septiembre,Kuwait,0,4,,4,-75.516486,10.446304
20159,2013,Septiembre,Kuwait,0,2,,2,-74.140516,4.697157
20160,2013,Septiembre,República de Kosovo,1,0,,1,-74.140516,4.697157
20161,2013,Septiembre,Letonia,0,1,,1,-75.527794,10.406342
20162,2013,Septiembre,Letonia,2,1,,3,-75.516486,10.446304
20163,2013,Septiembre,Letonia,1,1,,2,-76.532004,3.451668
20164,2013,Septiembre,Letonia,6,5,,11,-74.140516,4.697157
20165,2013,Septiembre,Lituania,1,0,,1,-69.941498,4.191162
20166,2013,Septiembre,Lituania,1,1,,2,-75.516486,10.446304
20167,2013,Septiembre,Lituania,13,10,,23,-74.140516,4.697157
20168,2013,Septiembre,Lituania,2,1,,3,-75.42726,6.170465
20169,2013,Septiembre,Líbano,3,5,,8,-72.129595,11.360028999999999
20170,2013,Septiembre,Líbano,1,2,,3,-76.532004,3.451668
20171,2013,Septiembre,Líbano,21,27,,48,-74.140516,4.697157
20172,2013,Septiembre,Líbano,0,1,,1,-75.42726,6.170465
20173,2013,Septiembre,Liberia,1,0,,1,-74.140516,4.697157
20174,2013,Septiembre,Liechtenstein,3,2,,5,-74.140516,4.697157
20175,2013,Septiembre,Luxemburgo,0,1,,1,-75.516486,10.446304
20176,2013,Septiembre,Luxemburgo,3,8,,11,-74.140516,4.697157
20177,2013,Septiembre,Macedonia,1,1,,2,-74.140516,4.697157
20178,2013,Septiembre,Madagascar,0,1,,1,-74.140516,4.697157
20179,2013,Septiembre,Malasia,2,2,,4,-75.516486,10.446304
20180,2013,Septiembre,Malasia,1,0,,1,-74.77647900000001,10.886686
20181,2013,Septiembre,Malasia,0,1,,1,-74.213989,11.247722999999999
20182,2013,Septiembre,Malasia,7,25,,32,-74.140516,4.697157
20183,2013,Septiembre,Malasia,1,0,,1,-75.736374,4.815189
20184,2013,Septiembre,Malasia,1,0,,1,-75.42726,6.170465
20185,2013,Septiembre,Malasia,1,0,,1,-72.453013,7.819
20186,2013,Septiembre,Malawi,1,2,,3,-76.532004,3.451668
20187,2013,Septiembre,Malí,2,2,,4,-74.140516,4.697157
20188,2013,Septiembre,Malta,1,0,,1,-81.70216500000001,12.5862
20189,2013,Septiembre,Malta,3,2,,5,-74.140516,4.697157
20190,2013,Septiembre,Marruecos,0,1,,1,-74.213989,11.247722999999999
20191,2013,Septiembre,Marruecos,7,7,,14,-74.140516,4.697157
20192,2013,Septiembre,Mauricio,1,0,,1,-74.140516,4.697157
20193,2013,Septiembre,Mauritania,3,1,,4,-74.140516,4.697157
20194,2013,Septiembre,México,3,1,,4,-69.941498,4.191162
20195,2013,Septiembre,México,12,19,,31,-77.35600000000001,0.81488
20196,2013,Septiembre,México,17,30,,47,-75.527794,10.406342
20197,2013,Septiembre,México,113,233,,346,-75.516486,10.446304
20198,2013,Septiembre,México,32,61,,93,-74.77647900000001,10.886686
20199,2013,Septiembre,México,3,5,,8,-72.129595,11.360028999999999
20200,2013,Septiembre,México,2,2,,4,-81.70216500000001,12.5862
20201,2013,Septiembre,México,42,135,,177,-76.532004,3.451668
20202,2013,Septiembre,México,1,0,,1,-75.76635300000001,4.45285
20203,2013,Septiembre,México,2528,5245,,7773,-74.140516,4.697157
20204,2013,Septiembre,México,3,18,,21,-75.736374,4.815189
20205,2013,Septiembre,México,107,363,,470,-75.42726,6.170465
20206,2013,Septiembre,México,3,7,,10,-73.181317,7.1280470000000005
20207,2013,Septiembre,México,9,26,,35,-72.453013,7.819
20208,2013,Septiembre,México,3,6,,9,-72.508188,7.927233
20209,2013,Septiembre,México,10,13,,23,-77.35002,8.63337
20210,2013,Septiembre,República de Moldavia,4,0,,4,-74.140516,4.697157
20211,2013,Septiembre,Mongolia,2,0,,2,-74.140516,4.697157
20212,2013,Septiembre,Mozambique,1,0,,1,-76.532004,3.451668
20213,2013,Septiembre,Mozambique,1,3,,4,-74.140516,4.697157
20214,2013,Septiembre,Namibia,2,5,,7,-74.140516,4.697157
20215,2013,Septiembre,Nepal,0,1,,1,-76.532004,3.451668
20216,2013,Septiembre,Nepal,0,2,,2,-74.140516,4.697157
20217,2013,Septiembre,Nicaragua,1,5,,6,-75.527794,10.406342
20218,2013,Septiembre,Nicaragua,7,13,,20,-75.516486,10.446304
20219,2013,Septiembre,Nicaragua,0,1,,1,-74.77647900000001,10.886686
20220,2013,Septiembre,Nicaragua,0,1,,1,-81.703935,12.574411099999999
20221,2013,Septiembre,Nicaragua,4,0,,4,-81.70216500000001,12.5862
20222,2013,Septiembre,Nicaragua,4,11,,15,-76.532004,3.451668
20223,2013,Septiembre,Nicaragua,46,80,,126,-74.140516,4.697157
20224,2013,Septiembre,Nicaragua,1,1,,2,-75.736374,4.815189
20225,2013,Septiembre,Nicaragua,12,18,,30,-75.42726,6.170465
20226,2013,Septiembre,Nicaragua,1,1,,2,-73.181317,7.1280470000000005
20227,2013,Septiembre,Nicaragua,1,0,,1,-72.508188,7.927233
20228,2013,Septiembre,Nigeria,0,2,,2,-75.516486,10.446304
20229,2013,Septiembre,Nigeria,0,1,,1,-76.532004,3.451668
20230,2013,Septiembre,Nigeria,3,16,,19,-74.140516,4.697157
20231,2013,Septiembre,Nigeria,0,1,,1,-72.453013,7.819
20232,2013,Septiembre,Níger,0,5,,5,-74.140516,4.697157
20233,2013,Septiembre,Noruega,0,6,,6,-75.527794,10.406342
20234,2013,Septiembre,Noruega,1,9,,10,-75.516486,10.446304
20235,2013,Septiembre,Noruega,0,1,,1,-74.77647900000001,10.886686
20236,2013,Septiembre,Noruega,0,7,,7,-76.532004,3.451668
20237,2013,Septiembre,Noruega,35,92,,127,-74.140516,4.697157
20238,2013,Septiembre,Noruega,3,4,,7,-75.42726,6.170465
20239,2013,Septiembre,Noruega,1,1,,2,-72.453013,7.819
20240,2013,Septiembre,Nueva Zelanda,1,2,,3,-69.941498,4.191162
20241,2013,Septiembre,Nueva Zelanda,5,8,,13,-77.35600000000001,0.81488
20242,2013,Septiembre,Nueva Zelanda,2,7,,9,-75.516486,10.446304
20243,2013,Septiembre,Nueva Zelanda,1,4,,5,-76.532004,3.451668
20244,2013,Septiembre,Nueva Zelanda,24,58,,82,-74.140516,4.697157
20245,2013,Septiembre,Nueva Zelanda,0,8,,8,-75.42726,6.170465
20246,2013,Septiembre,Nueva Zelanda,1,0,,1,-77.35002,8.63337
20247,2013,Septiembre,Omán,0,1,,1,-74.140516,4.697157
20248,2013,Septiembre,Nueva Zelanda,0,6,,6,-75.527794,10.406342
20249,2013,Septiembre,Nueva Zelanda,0,1,,1,-74.77647900000001,10.886686
20250,2013,Septiembre,Nueva Zelanda,0,1,,1,-76.532004,3.451668
20251,2013,Septiembre,Nueva Zelanda,1,1,,2,-74.140516,4.697157
20252,2013,Septiembre,Nueva Zelanda,0,1,,1,-72.453013,7.819
20253,2013,Septiembre,Nueva Zelanda,0,1,,1,-72.508188,7.927233
20254,2013,Septiembre,Países Bajos,0,3,,3,-77.35600000000001,0.81488
20255,2013,Septiembre,Países Bajos,1,1,,2,-75.527794,10.406342
20256,2013,Septiembre,Países Bajos,9,50,,59,-75.516486,10.446304
20257,2013,Septiembre,Países Bajos,0,3,,3,-74.77647900000001,10.886686
20258,2013,Septiembre,Países Bajos,2,5,,7,-72.129595,11.360028999999999
20259,2013,Septiembre,Países Bajos,6,15,,21,-72.919186,11.52863
20260,2013,Septiembre,Países Bajos,7,26,,33,-76.532004,3.451668
20261,2013,Septiembre,Países Bajos,373,676,,1049,-74.140516,4.697157
20262,2013,Septiembre,Países Bajos,0,5,,5,-75.736374,4.815189
20263,2013,Septiembre,Países Bajos,183,252,,435,-75.42726,6.170465
20264,2013,Septiembre,Países Bajos,4,2,,6,-73.181317,7.1280470000000005
20265,2013,Septiembre,Pakistán,0,2,,2,-77.35600000000001,0.81488
20266,2013,Septiembre,Pakistán,0,1,,1,-75.516486,10.446304
20267,2013,Septiembre,Pakistán,0,1,,1,-76.532004,3.451668
20268,2013,Septiembre,Pakistán,0,7,,7,-74.140516,4.697157
20269,2013,Septiembre,Panamá,1,18,,19,-75.527794,10.406342
20270,2013,Septiembre,Panamá,140,201,,341,-75.516486,10.446304
20271,2013,Septiembre,Panamá,51,96,,147,-74.77647900000001,10.886686
20272,2013,Septiembre,Panamá,0,1,,1,-74.765343,10.970933
20273,2013,Septiembre,Panamá,1,2,,3,-74.213989,11.247722999999999
20274,2013,Septiembre,Panamá,0,2,,2,-72.129595,11.360028999999999
20275,2013,Septiembre,Panamá,0,4,,4,-81.703935,12.574411099999999
20276,2013,Septiembre,Panamá,55,36,,91,-81.70216500000001,12.5862
20277,2013,Septiembre,Panamá,139,129,,268,-76.532004,3.451668
20278,2013,Septiembre,Panamá,0,3,,3,-77.061029,3.8844260000000004
20279,2013,Septiembre,Panamá,550,812,,1362,-74.140516,4.697157
20280,2013,Septiembre,Panamá,67,97,,164,-75.736374,4.815189
20281,2013,Septiembre,Panamá,146,260,,406,-75.42726,6.170465
20282,2013,Septiembre,Panamá,1,0,,1,-70.74025300000001,7.088728999999999
20283,2013,Septiembre,Panamá,0,1,,1,-77.762647,7.102626
20284,2013,Septiembre,Panamá,12,15,,27,-73.181317,7.1280470000000005
20285,2013,Septiembre,Panamá,1,1,,2,-72.453013,7.819
20286,2013,Septiembre,Panamá,4,9,,13,-72.508188,7.927233
20287,2013,Septiembre,Panamá,3,5,,8,-77.35002,8.63337
20288,2013,Septiembre,Paraguay,0,2,,2,-77.35600000000001,0.81488
20289,2013,Septiembre,Paraguay,1,1,,2,-75.527794,10.406342
20290,2013,Septiembre,Paraguay,44,46,,90,-75.516486,10.446304
20291,2013,Septiembre,Paraguay,0,5,,5,-74.77647900000001,10.886686
20292,2013,Septiembre,Paraguay,4,1,,5,-81.70216500000001,12.5862
20293,2013,Septiembre,Paraguay,3,5,,8,-76.532004,3.451668
20294,2013,Septiembre,Paraguay,73,106,,179,-74.140516,4.697157
20295,2013,Septiembre,Paraguay,10,33,,43,-75.42726,6.170465
20296,2013,Septiembre,Paraguay,0,1,,1,-72.453013,7.819
20297,2013,Septiembre,Perú,6,20,,26,-69.941498,4.191162
20298,2013,Septiembre,Perú,163,373,,536,-77.35600000000001,0.81488
20299,2013,Septiembre,Perú,1,0,,1,-78.802679,18.00143
20300,2013,Septiembre,Perú,15,9,,24,-75.527794,10.406342
20301,2013,Septiembre,Perú,273,231,,504,-75.516486,10.446304
20302,2013,Septiembre,Perú,26,39,,65,-74.77647900000001,10.886686
20303,2013,Septiembre,Perú,0,1,,1,-74.765343,10.970933
20304,2013,Septiembre,Perú,0,2,,2,-74.213989,11.247722999999999
20305,2013,Septiembre,Perú,15,50,,65,-72.129595,11.360028999999999
20306,2013,Septiembre,Perú,0,3,,3,-81.703935,12.574411099999999
20307,2013,Septiembre,Perú,167,98,,265,-81.70216500000001,12.5862
20308,2013,Septiembre,Perú,83,171,,254,-76.532004,3.451668
20309,2013,Septiembre,Perú,0,1,,1,-77.061029,3.8844260000000004
20310,2013,Septiembre,Perú,0,1,,1,-75.76635300000001,4.45285
20311,2013,Septiembre,Perú,2414,3201,,5615,-74.140516,4.697157
20312,2013,Septiembre,Perú,4,6,,10,-75.736374,4.815189
20313,2013,Septiembre,Perú,251,426,,677,-75.42726,6.170465
20314,2013,Septiembre,Perú,0,2,,2,-67.48402800000001,6.185536
20315,2013,Septiembre,Perú,1,0,,1,-70.74025300000001,7.088728999999999
20316,2013,Septiembre,Perú,2,5,,7,-73.181317,7.1280470000000005
20317,2013,Septiembre,Perú,65,97,,162,-72.453013,7.819
20318,2013,Septiembre,Perú,0,7,,7,-72.508188,7.927233
20319,2013,Septiembre,Perú,0,1,,1,-77.35002,8.63337
20320,2013,Septiembre,Palestina,0,1,,1,-74.140516,4.697157
20321,2013,Septiembre,Polonia,1,2,,3,-69.941498,4.191162
20322,2013,Septiembre,Polonia,3,4,,7,-77.35600000000001,0.81488
20323,2013,Septiembre,Polonia,1,3,,4,-75.527794,10.406342
20324,2013,Septiembre,Polonia,1,6,,7,-75.516486,10.446304
20325,2013,Septiembre,Polonia,1,1,,2,-74.77647900000001,10.886686
20326,2013,Septiembre,Polonia,0,2,,2,-74.765343,10.970933
20327,2013,Septiembre,Polonia,1,1,,2,-76.532004,3.451668
20328,2013,Septiembre,Polonia,1,0,,1,-77.061029,3.8844260000000004
20329,2013,Septiembre,Polonia,59,96,,155,-74.140516,4.697157
20330,2013,Septiembre,Polonia,2,3,,5,-75.42726,6.170465
20331,2013,Septiembre,Polonia,0,1,,1,-73.181317,7.1280470000000005
20332,2013,Septiembre,Polonia,1,0,,1,-72.453013,7.819
20333,2013,Septiembre,Polonia,0,1,,1,-76.7333,8.06667
20334,2013,Septiembre,Polonia,0,1,,1,-77.35002,8.63337
20335,2013,Septiembre,Portugal,0,1,,1,-69.941498,4.191162
20336,2013,Septiembre,Portugal,2,4,,6,-77.35600000000001,0.81488
20337,2013,Septiembre,Portugal,0,1,,1,-78.802679,18.00143
20338,2013,Septiembre,Portugal,0,1,,1,-75.527794,10.406342
20339,2013,Septiembre,Portugal,0,7,,7,-75.516486,10.446304
20340,2013,Septiembre,Portugal,1,1,,2,-72.129595,11.360028999999999
20341,2013,Septiembre,Portugal,1,1,,2,-81.70216500000001,12.5862
20342,2013,Septiembre,Portugal,5,17,,22,-76.532004,3.451668
20343,2013,Septiembre,Portugal,87,335,,422,-74.140516,4.697157
20344,2013,Septiembre,Portugal,5,8,,13,-75.42726,6.170465
20345,2013,Septiembre,Portugal,2,4,,6,-72.453013,7.819
20346,2013,Septiembre,Qatar,0,1,,1,-74.140516,4.697157
20347,2013,Septiembre,Qatar,0,1,,1,-75.42726,6.170465
20348,2013,Septiembre,Reino Unido de Gran Bretaña e Irlanda del Norte,4,7,,11,-69.941498,4.191162
20349,2013,Septiembre,Reino Unido de Gran Bretaña e Irlanda del Norte,5,5,,10,-77.35600000000001,0.81488
20350,2013,Septiembre,Reino Unido de Gran Bretaña e Irlanda del Norte,0,2,,2,-75.527794,10.406342
20351,2013,Septiembre,Reino Unido de Gran Bretaña e Irlanda del Norte,45,108,,153,-75.516486,10.446304
20352,2013,Septiembre,Reino Unido de Gran Bretaña e Irlanda del Norte,2,8,,10,-74.77647900000001,10.886686
20353,2013,Septiembre,Reino Unido de Gran Bretaña e Irlanda del Norte,1,2,,3,-74.765343,10.970933
20354,2013,Septiembre,Reino Unido de Gran Bretaña e Irlanda del Norte,1,0,,1,-72.129595,11.360028999999999
20355,2013,Septiembre,Reino Unido de Gran Bretaña e Irlanda del Norte,1,19,,20,-76.532004,3.451668
20356,2013,Septiembre,Reino Unido de Gran Bretaña e Irlanda del Norte,1,0,,1,-75.76635300000001,4.45285
20357,2013,Septiembre,Reino Unido de Gran Bretaña e Irlanda del Norte,373,966,,1339,-74.140516,4.697157
20358,2013,Septiembre,Reino Unido de Gran Bretaña e Irlanda del Norte,2,3,,5,-75.736374,4.815189
20359,2013,Septiembre,Reino Unido de Gran Bretaña e Irlanda del Norte,2,40,,42,-75.42726,6.170465
20360,2013,Septiembre,Reino Unido de Gran Bretaña e Irlanda del Norte,0,1,,1,-73.181317,7.1280470000000005
20361,2013,Septiembre,Reino Unido de Gran Bretaña e Irlanda del Norte,3,2,,5,-72.453013,7.819
20362,2013,Septiembre,Reino Unido de Gran Bretaña e Irlanda del Norte,0,5,,5,-72.508188,7.927233
20363,2013,Septiembre,Reino Unido de Gran Bretaña e Irlanda del Norte,4,7,,11,-77.35002,8.63337
20364,2013,Septiembre,República CentroÁfricana,5,0,,5,-74.140516,4.697157
20365,2013,Septiembre,República de Belarús,1,0,,1,-74.140516,4.697157
20366,2013,Septiembre,República Dominicana,4,9,,13,-77.35600000000001,0.81488
20367,2013,Septiembre,República Dominicana,1,1,,2,-75.527794,10.406342
20368,2013,Septiembre,República Dominicana,35,42,,77,-75.516486,10.446304
20369,2013,Septiembre,República Dominicana,30,42,,72,-74.77647900000001,10.886686
20370,2013,Septiembre,República Dominicana,1,2,,3,-72.129595,11.360028999999999
20371,2013,Septiembre,República Dominicana,2,2,,4,-81.70216500000001,12.5862
20372,2013,Septiembre,República Dominicana,20,36,,56,-76.532004,3.451668
20373,2013,Septiembre,República Dominicana,215,370,,585,-74.140516,4.697157
20374,2013,Septiembre,República Dominicana,2,0,,2,-75.736374,4.815189
20375,2013,Septiembre,República Dominicana,39,65,,104,-75.42726,6.170465
20376,2013,Septiembre,República Dominicana,2,21,,23,-73.181317,7.1280470000000005
20377,2013,Septiembre,República Dominicana,1,4,,5,-72.453013,7.819
20378,2013,Septiembre,República Dominicana,1,4,,5,-72.508188,7.927233
20379,2013,Septiembre,República Checa,1,1,,2,-76.532004,3.451668
20380,2013,Septiembre,República Checa,0,1,,1,-74.140516,4.697157
20381,2013,Septiembre,República Democrática Popular de Corea,0,1,,1,-74.140516,4.697157
20382,2013,Septiembre,Rumania,1,0,,1,-75.527794,10.406342
20383,2013,Septiembre,Rumania,1,1,,2,-75.516486,10.446304
20384,2013,Septiembre,Rumania,0,1,,1,-74.213989,11.247722999999999
20385,2013,Septiembre,Rumania,2,0,,2,-76.532004,3.451668
20386,2013,Septiembre,Rumania,28,53,,81,-74.140516,4.697157
20387,2013,Septiembre,Rumania,1,0,,1,-75.736374,4.815189
20388,2013,Septiembre,Rumania,4,3,,7,-75.42726,6.170465
20389,2013,Septiembre,Rumania,0,1,,1,-72.453013,7.819
20390,2013,Septiembre,Federación de Rusia,5,12,,17,-77.35600000000001,0.81488
20391,2013,Septiembre,Federación de Rusia,0,1,,1,-75.527794,10.406342
20392,2013,Septiembre,Federación de Rusia,3,9,,12,-75.516486,10.446304
20393,2013,Septiembre,Federación de Rusia,1,1,,2,-74.77647900000001,10.886686
20394,2013,Septiembre,Federación de Rusia,0,1,,1,-72.129595,11.360028999999999
20395,2013,Septiembre,Federación de Rusia,1,1,,2,-76.532004,3.451668
20396,2013,Septiembre,Federación de Rusia,100,135,,235,-74.140516,4.697157
20397,2013,Septiembre,Federación de Rusia,1,0,,1,-75.42726,6.170465
20398,2013,Septiembre,Federación de Rusia,1,0,,1,-72.453013,7.819
20399,2013,Septiembre,Federación de Rusia,0,1,,1,-76.7333,8.06667
20400,2013,Septiembre,Federación de Rusia,0,1,,1,-77.35002,8.63337
20401,2013,Septiembre,San Cristóbal y Nevis,0,1,,1,-74.77647900000001,10.886686
20402,2013,Septiembre,San Cristóbal y Nevis,0,1,,1,-81.372937,13.338761300000002
20403,2013,Septiembre,San Cristóbal y Nevis,0,1,,1,-76.532004,3.451668
20404,2013,Septiembre,San Cristóbal y Nevis,3,5,,8,-74.140516,4.697157
20405,2013,Septiembre,San Cristóbal y Nevis,0,1,,1,-75.42726,6.170465
20406,2013,Septiembre,San  Vicente y las Granadinas,1,2,,3,-75.516486,10.446304
20407,2013,Septiembre,San  Vicente y las Granadinas,1,2,,3,-74.140516,4.697157
20408,2013,Septiembre,Santa Lucia,1,2,,3,-75.516486,10.446304
20409,2013,Septiembre,Santa Lucia,3,7,,10,-74.140516,4.697157
20410,2013,Septiembre,Senegal,0,1,,1,-76.532004,3.451668
20411,2013,Septiembre,Senegal,3,7,,10,-74.140516,4.697157
20412,2013,Septiembre,Serbia,1,0,,1,-75.516486,10.446304
20413,2013,Septiembre,Serbia,3,3,,6,-74.140516,4.697157
20414,2013,Septiembre,Seychelles,1,0,,1,-75.516486,10.446304
20415,2013,Septiembre,Singapur,0,1,,1,-75.527794,10.406342
20416,2013,Septiembre,Singapur,1,0,,1,-75.516486,10.446304
20417,2013,Septiembre,Singapur,7,24,,31,-74.140516,4.697157
20418,2013,Septiembre,Singapur,2,2,,4,-75.42726,6.170465
20419,2013,Septiembre,República Árabe Siria,1,0,,1,-74.77647900000001,10.886686
20420,2013,Septiembre,Sri Lanka,1,0,,1,-76.532004,3.451668
20421,2013,Septiembre,Sri Lanka,1,1,,2,-74.140516,4.697157
20422,2013,Septiembre,Sri Lanka,0,1,,1,-75.42726,6.170465
20423,2013,Septiembre,Sudáfrica,0,1,,1,-69.941498,4.191162
20424,2013,Septiembre,Sudáfrica,0,1,,1,-75.527794,10.406342
20425,2013,Septiembre,Sudáfrica,2,7,,9,-75.516486,10.446304
20426,2013,Septiembre,Sudáfrica,0,3,,3,-76.532004,3.451668
20427,2013,Septiembre,Sudáfrica,39,69,,108,-74.140516,4.697157
20428,2013,Septiembre,Sudáfrica,1,4,,5,-75.42726,6.170465
20429,2013,Septiembre,Sudán,1,2,,3,-74.140516,4.697157
20430,2013,Septiembre,Suecia,3,3,,6,-77.35600000000001,0.81488
20431,2013,Septiembre,Suecia,0,3,,3,-75.527794,10.406342
20432,2013,Septiembre,Suecia,0,3,,3,-75.516486,10.446304
20433,2013,Septiembre,Suecia,5,0,,5,-74.77647900000001,10.886686
20434,2013,Septiembre,Suecia,2,8,,10,-76.532004,3.451668
20435,2013,Septiembre,Suecia,97,172,,269,-74.140516,4.697157
20436,2013,Septiembre,Suecia,7,21,,28,-75.42726,6.170465
20437,2013,Septiembre,Suecia,0,1,,1,-73.181317,7.1280470000000005
20438,2013,Septiembre,Suecia,0,1,,1,-72.453013,7.819
20439,2013,Septiembre,Suiza,2,3,,5,-69.941498,4.191162
20440,2013,Septiembre,Suiza,8,11,,19,-77.35600000000001,0.81488
20441,2013,Septiembre,Suiza,5,9,,14,-75.527794,10.406342
20442,2013,Septiembre,Suiza,10,21,,31,-75.516486,10.446304
20443,2013,Septiembre,Suiza,1,4,,5,-74.77647900000001,10.886686
20444,2013,Septiembre,Suiza,1,3,,4,-72.129595,11.360028999999999
20445,2013,Septiembre,Suiza,1,1,,2,-81.70216500000001,12.5862
20446,2013,Septiembre,Suiza,0,1,,1,-81.372937,13.338761300000002
20447,2013,Septiembre,Suiza,12,25,,37,-76.532004,3.451668
20448,2013,Septiembre,Suiza,213,416,,629,-74.140516,4.697157
20449,2013,Septiembre,Suiza,14,31,,45,-75.42726,6.170465
20450,2013,Septiembre,Suiza,0,4,,4,-72.453013,7.819
20451,2013,Septiembre,Suiza,1,4,,5,-77.35002,8.63337
20452,2013,Septiembre,Surinam,1,0,,1,-74.77647900000001,10.886686
20453,2013,Septiembre,Surinam,0,1,,1,-76.532004,3.451668
20454,2013,Septiembre,Surinam,13,25,,38,-74.140516,4.697157
20455,2013,Septiembre,Surinam,1,0,,1,-75.736374,4.815189
20456,2013,Septiembre,Surinam,11,9,,20,-75.42726,6.170465
20457,2013,Septiembre,Taiwán,4,8,,12,-75.516486,10.446304
20458,2013,Septiembre,Taiwán,12,35,,47,-74.140516,4.697157
20459,2013,Septiembre,Taiwán,1,1,,2,-75.736374,4.815189
20460,2013,Septiembre,Tailandia,4,6,,10,-74.140516,4.697157
20461,2013,Septiembre,Tailandia,0,2,,2,-75.42726,6.170465
20462,2013,Septiembre,Territorio Antártico Británico/Territorio Británico de Ultramar,0,1,,1,-75.527794,10.406342
20463,2013,Septiembre,Territorio Antártico Británico/Territorio Británico de Ultramar,0,1,,1,-76.532004,3.451668
20464,2013,Septiembre,Territorio Antártico Británico/Territorio Británico de Ultramar,1,0,,1,-74.140516,4.697157
20465,2013,Septiembre,Tanzania,1,3,,4,-75.516486,10.446304
20466,2013,Septiembre,Tanzania,0,1,,1,-76.532004,3.451668
20467,2013,Septiembre,Tanzania,2,2,,4,-74.140516,4.697157
20468,2013,Septiembre,Togo,0,4,,4,-74.140516,4.697157
20469,2013,Septiembre,Trinidad y Tobago,28,19,,47,-75.516486,10.446304
20470,2013,Septiembre,Trinidad y Tobago,0,3,,3,-74.77647900000001,10.886686
20471,2013,Septiembre,Trinidad y Tobago,0,1,,1,-74.765343,10.970933
20472,2013,Septiembre,Trinidad y Tobago,0,1,,1,-81.70216500000001,12.5862
20473,2013,Septiembre,Trinidad y Tobago,11,15,,26,-76.532004,3.451668
20474,2013,Septiembre,Trinidad y Tobago,34,40,,74,-74.140516,4.697157
20475,2013,Septiembre,Trinidad y Tobago,0,1,,1,-75.736374,4.815189
20476,2013,Septiembre,Trinidad y Tobago,5,2,,7,-75.42726,6.170465
20477,2013,Septiembre,Trinidad y Tobago,0,1,,1,-73.181317,7.1280470000000005
20478,2013,Septiembre,Trinidad y Tobago,0,2,,2,-72.453013,7.819
20479,2013,Septiembre,Trinidad y Tobago,1,1,,2,-72.508188,7.927233
20480,2013,Septiembre,Túnez,1,2,,3,-74.140516,4.697157
20481,2013,Septiembre,Turquía,0,1,,1,-69.941498,4.191162
20482,2013,Septiembre,Turquía,0,1,,1,-77.35600000000001,0.81488
20483,2013,Septiembre,Turquía,0,1,,1,-75.527794,10.406342
20484,2013,Septiembre,Turquía,3,11,,14,-75.516486,10.446304
20485,2013,Septiembre,Turquía,0,4,,4,-76.532004,3.451668
20486,2013,Septiembre,Turquía,22,131,,153,-74.140516,4.697157
20487,2013,Septiembre,Turquía,2,3,,5,-75.42726,6.170465
20488,2013,Septiembre,Turquía,0,1,,1,-72.453013,7.819
20489,2013,Septiembre,Turquía,0,14,,14,-75.68164200000001,9.402597
20490,2013,Septiembre,Turkmenistán,1,0,,1,-74.140516,4.697157
20491,2013,Septiembre,Ucrania,1,8,,9,-75.527794,10.406342
20492,2013,Septiembre,Ucrania,0,13,,13,-74.77647900000001,10.886686
20493,2013,Septiembre,Ucrania,0,21,,21,-74.765343,10.970933
20494,2013,Septiembre,Ucrania,0,2,,2,-74.213989,11.247722999999999
20495,2013,Septiembre,Ucrania,0,2,,2,-76.532004,3.451668
20496,2013,Septiembre,Ucrania,20,26,,46,-74.140516,4.697157
20497,2013,Septiembre,Ucrania,0,1,,1,-75.42726,6.170465
20498,2013,Septiembre,Uganda,0,1,,1,-75.516486,10.446304
20499,2013,Septiembre,Uganda,4,1,,5,-76.532004,3.451668
20500,2013,Septiembre,Uganda,3,7,,10,-74.140516,4.697157
20501,2013,Septiembre,Federación de Rusia,7,10,,17,-77.35600000000001,0.81488
20502,2013,Septiembre,Federación de Rusia,1,4,,5,-75.527794,10.406342
20503,2013,Septiembre,Federación de Rusia,0,1,,1,-74.77647900000001,10.886686
20504,2013,Septiembre,Federación de Rusia,1,8,,9,-74.765343,10.970933
20505,2013,Septiembre,Federación de Rusia,2,0,,2,-76.532004,3.451668
20506,2013,Septiembre,Federación de Rusia,41,32,,73,-74.140516,4.697157
20507,2013,Septiembre,Federación de Rusia,2,4,,6,-75.42726,6.170465
20508,2013,Septiembre,Federación de Rusia,1,2,,3,-72.453013,7.819
20509,2013,Septiembre,Uruguay,0,5,,5,-69.941498,4.191162
20510,2013,Septiembre,Uruguay,0,7,,7,-77.35600000000001,0.81488
20511,2013,Septiembre,Uruguay,2,3,,5,-75.527794,10.406342
20512,2013,Septiembre,Uruguay,100,90,,190,-75.516486,10.446304
20513,2013,Septiembre,Uruguay,4,4,,8,-74.77647900000001,10.886686
20514,2013,Septiembre,Uruguay,1,4,,5,-72.129595,11.360028999999999
20515,2013,Septiembre,Uruguay,33,23,,56,-81.70216500000001,12.5862
20516,2013,Septiembre,Uruguay,9,19,,28,-76.532004,3.451668
20517,2013,Septiembre,Uruguay,163,349,,512,-74.140516,4.697157
20518,2013,Septiembre,Uruguay,1,1,,2,-75.736374,4.815189
20519,2013,Septiembre,Uruguay,13,34,,47,-75.42726,6.170465
20520,2013,Septiembre,Uruguay,1,4,,5,-72.453013,7.819
20521,2013,Septiembre,Uzbekistán,0,3,,3,-74.140516,4.697157
20522,2013,Septiembre,Venezuela,0,2,,2,-69.941498,4.191162
20523,2013,Septiembre,Venezuela,193,234,,427,-77.35600000000001,0.81488
20524,2013,Septiembre,Venezuela,6,9,,15,-75.527794,10.406342
20525,2013,Septiembre,Venezuela,81,140,,221,-75.516486,10.446304
20526,2013,Septiembre,Venezuela,32,100,,132,-74.77647900000001,10.886686
20527,2013,Septiembre,Venezuela,6,5,,11,-74.765343,10.970933
20528,2013,Septiembre,Venezuela,1130,1867,,2997,-72.129595,11.360028999999999
20529,2013,Septiembre,Venezuela,2,4,,6,-72.919186,11.52863
20530,2013,Septiembre,Venezuela,4,2,,6,-81.70216500000001,12.5862
20531,2013,Septiembre,Venezuela,47,70,,117,-76.532004,3.451668
20532,2013,Septiembre,Venezuela,0,2,,2,-75.76635300000001,4.45285
20533,2013,Septiembre,Venezuela,5626,6289,,11915,-74.140516,4.697157
20534,2013,Septiembre,Venezuela,3,15,,18,-75.736374,4.815189
20535,2013,Septiembre,Venezuela,347,463,,810,-75.42726,6.170465
20536,2013,Septiembre,Venezuela,10,49,,59,-67.48402800000001,6.185536
20537,2013,Septiembre,Venezuela,25,48,,73,-70.74025300000001,7.088728999999999
20538,2013,Septiembre,Venezuela,10,11,,21,-73.181317,7.1280470000000005
20539,2013,Septiembre,Venezuela,1235,1549,,2784,-72.453013,7.819
20540,2013,Septiembre,Venezuela,199,269,,468,-72.508188,7.927233
20541,2013,Septiembre,Vietnam,6,20,,26,-74.140516,4.697157
20542,2013,Septiembre,Islas Vírgenes Británicas/Territorio Británico de Ultramar,1,0,,1,-75.516486,10.446304
20543,2013,Septiembre,Yugoslavia,1,0,,1,-74.140516,4.697157
20544,2013,Septiembre,Zambia,0,1,,1,-75.516486,10.446304
20545,2013,Septiembre,Zambia,0,1,,1,-76.532004,3.451668
20546,2013,Septiembre,Zambia,1,5,,6,-74.140516,4.697157
20547,2013,Septiembre,Zimbabue,1,0,,1,-77.35600000000001,0.81488
20548,2013,Septiembre,Zimbabue,0,3,,3,-75.516486,10.446304
20549,2013,Septiembre,Zimbabue,0,1,,1,-76.532004,3.451668
20550,2013,Septiembre,Zimbabue,2,1,,3,-74.140516,4.697157
20551,2013,Septiembre,Países Bajos,0,1,,1,-75.516486,10.446304
20552,2013,Septiembre,Reino Unido de Gran Bretaña e Irlanda del Norte,2,5,,7,-69.941498,4.191162
20553,2013,Septiembre,Reino Unido de Gran Bretaña e Irlanda del Norte,17,28,,45,-77.35600000000001,0.81488
20554,2013,Septiembre,Reino Unido de Gran Bretaña e Irlanda del Norte,15,23,,38,-75.527794,10.406342
20555,2013,Septiembre,Reino Unido de Gran Bretaña e Irlanda del Norte,0,5,,5,-74.77647900000001,10.886686
20556,2013,Septiembre,Reino Unido de Gran Bretaña e Irlanda del Norte,0,12,,12,-74.765343,10.970933
20557,2013,Septiembre,Reino Unido de Gran Bretaña e Irlanda del Norte,1,1,,2,-81.70216500000001,12.5862
20558,2013,Septiembre,Reino Unido de Gran Bretaña e Irlanda del Norte,5,21,,26,-76.532004,3.451668
20559,2013,Septiembre,Reino Unido de Gran Bretaña e Irlanda del Norte,73,238,,311,-74.140516,4.697157
20560,2013,Septiembre,Reino Unido de Gran Bretaña e Irlanda del Norte,9,12,,21,-75.42726,6.170465
20561,2013,Septiembre,Reino Unido de Gran Bretaña e Irlanda del Norte,0,1,,1,-73.181317,7.1280470000000005
20562,2013,Septiembre,Reino Unido de Gran Bretaña e Irlanda del Norte,3,10,,13,-72.453013,7.819
20563,2013,Septiembre,Reino Unido de Gran Bretaña e Irlanda del Norte,1,1,,2,-77.35002,8.63337
20564,2013,Septiembre,Países Bajos,1,3,,4,-69.941498,4.191162
20565,2013,Septiembre,Países Bajos,5,6,,11,-77.35600000000001,0.81488
20566,2013,Septiembre,Países Bajos,5,11,,16,-75.527794,10.406342
20567,2013,Septiembre,Países Bajos,2,4,,6,-75.516486,10.446304
20568,2013,Septiembre,Países Bajos,3,15,,18,-74.77647900000001,10.886686
20569,2013,Septiembre,Países Bajos,0,4,,4,-74.213989,11.247722999999999
20570,2013,Septiembre,Países Bajos,14,32,,46,-76.532004,3.451668
20571,2013,Septiembre,Países Bajos,144,262,,406,-74.140516,4.697157
20572,2013,Septiembre,Países Bajos,58,80,,138,-75.42726,6.170465
20573,2013,Septiembre,Países Bajos,1,2,,3,-73.181317,7.1280470000000005
20574,2013,Septiembre,Países Bajos,0,5,,5,-72.453013,7.819
20575,2013,Septiembre,Países Bajos,0,1,,1,-77.35002,8.63337
20576,2013,Septiembre,Lituania,1,0,,1,-74.140516,4.697157
20577,2013,Septiembre,Reino Unido de Gran Bretaña e Irlanda del Norte,1,0,,1,-74.77647900000001,10.886686
20578,2013,Septiembre,Reino Unido de Gran Bretaña e Irlanda del Norte,0,1,,1,-72.453013,7.819
20579,2013,Septiembre,Reino Unido de Gran Bretaña e Irlanda del Norte,4,8,,12,-75.527794,10.406342
20580,2013,Septiembre,Reino Unido de Gran Bretaña e Irlanda del Norte,2,3,,5,-74.140516,4.697157
20581,2013,Septiembre,Reino Unido de Gran Bretaña e Irlanda del Norte,0,1,,1,-72.453013,7.819
20582,2013,Septiembre,Letonia,0,1,,1,-75.68164200000001,9.402597
20583,2013,Septiembre,Desconocido,4,21,,25,-74.140516,4.697157
20584,2013,Septiembre,República CentroÁfricana,0,1,,1,-74.140516,4.697157
20585,2013,Septiembre,Desconocido,0,3,,3,-74.140516,4.697157
20586,2013,Octubre,Afganistán,2,2,,4,-74.140516,4.697157
20587,2013,Octubre,Albania,0,2,,2,-77.35600000000001,0.81488
20588,2013,Octubre,Alemania,7,11,,18,-69.941498,4.191162
20589,2013,Octubre,Alemania,23,25,,48,-77.35600000000001,0.81488
20590,2013,Octubre,Alemania,35,42,,77,-75.527794,10.406342
20591,2013,Octubre,Alemania,23,41,,64,-75.516486,10.446304
20592,2013,Octubre,Alemania,4,12,,16,-74.77647900000001,10.886686
20593,2013,Octubre,Alemania,1,1,,2,-74.765343,10.970933
20594,2013,Octubre,Alemania,0,3,,3,-74.213989,11.247722999999999
20595,2013,Octubre,Alemania,2,14,,16,-72.129595,11.360028999999999
20596,2013,Octubre,Alemania,1,6,,7,-81.70216500000001,12.5862
20597,2013,Octubre,Alemania,28,39,,67,-76.532004,3.451668
20598,2013,Octubre,Alemania,1171,1970,,3141,-74.140516,4.697157
20599,2013,Octubre,Alemania,1,0,,1,-75.736374,4.815189
20600,2013,Octubre,Alemania,34,93,,127,-75.42726,6.170465
20601,2013,Octubre,Alemania,0,12,,12,-72.453013,7.819
20602,2013,Octubre,Alemania,0,2,,2,-72.508188,7.927233
20603,2013,Octubre,Andorra,2,17,,19,-74.140516,4.697157
20604,2013,Octubre,Angola,1,11,,12,-75.516486,10.446304
20605,2013,Octubre,Angola,2,20,,22,-74.140516,4.697157
20606,2013,Octubre,Antigua y Barbuda,2,9,,11,-74.140516,4.697157
20607,2013,Octubre,Arabia Saudita,0,1,,1,-74.140516,4.697157
20608,2013,Octubre,Arabia Saudita,0,1,,1,-75.516486,10.446304
20609,2013,Octubre,Arabia Saudita,0,7,,7,-74.140516,4.697157
20610,2013,Octubre,Arabia Saudita,0,1,,1,-75.42726,6.170465
20611,2013,Octubre,Argelia,0,1,,1,-77.35600000000001,0.81488
20612,2013,Octubre,Argelia,0,1,,1,-75.527794,10.406342
20613,2013,Octubre,Argelia,0,7,,7,-74.140516,4.697157
20614,2013,Octubre,Argelia,0,1,,1,-72.453013,7.819
20615,2013,Octubre,Argentina,3,6,,9,-69.941498,4.191162
20616,2013,Octubre,Argentina,0,3,,3,-76.876446,0.33002
20617,2013,Octubre,Argentina,47,102,,149,-77.35600000000001,0.81488
20618,2013,Octubre,Argentina,123,98,,221,-75.527794,10.406342
20619,2013,Octubre,Argentina,895,587,,1482,-75.516486,10.446304
20620,2013,Octubre,Argentina,13,38,,51,-74.77647900000001,10.886686
20621,2013,Octubre,Argentina,8,23,,31,-72.129595,11.360028999999999
20622,2013,Octubre,Argentina,2,2,,4,-72.919186,11.52863
20623,2013,Octubre,Argentina,225,182,,407,-81.70216500000001,12.5862
20624,2013,Octubre,Argentina,37,71,,108,-76.532004,3.451668
20625,2013,Octubre,Argentina,2601,4189,,6790,-74.140516,4.697157
20626,2013,Octubre,Argentina,1,6,,7,-75.736374,4.815189
20627,2013,Octubre,Argentina,87,198,,285,-75.42726,6.170465
20628,2013,Octubre,Argentina,0,4,,4,-73.181317,7.1280470000000005
20629,2013,Octubre,Argentina,12,25,,37,-72.453013,7.819
20630,2013,Octubre,Argentina,2,10,,12,-72.508188,7.927233
20631,2013,Octubre,Argentina,0,2,,2,-77.35002,8.63337
20632,2013,Octubre,República de Armenia,0,1,,1,-74.140516,4.697157
20633,2013,Octubre,República de Armenia,0,1,,1,-75.42726,6.170465
20634,2013,Octubre,Aruba,1,3,,4,-74.140516,4.697157
20635,2013,Octubre,Australia,6,7,,13,-69.941498,4.191162
20636,2013,Octubre,Australia,14,20,,34,-77.35600000000001,0.81488
20637,2013,Octubre,Australia,18,31,,49,-75.527794,10.406342
20638,2013,Octubre,Australia,33,36,,69,-75.516486,10.446304
20639,2013,Octubre,Australia,3,6,,9,-74.77647900000001,10.886686
20640,2013,Octubre,Australia,2,2,,4,-74.213989,11.247722999999999
20641,2013,Octubre,Australia,1,4,,5,-72.129595,11.360028999999999
20642,2013,Octubre,Australia,9,14,,23,-76.532004,3.451668
20643,2013,Octubre,Australia,172,333,,505,-74.140516,4.697157
20644,2013,Octubre,Australia,1,3,,4,-75.736374,4.815189
20645,2013,Octubre,Australia,20,50,,70,-75.42726,6.170465
20646,2013,Octubre,Australia,1,4,,5,-72.453013,7.819
20647,2013,Octubre,Austria,0,1,,1,-69.941498,4.191162
20648,2013,Octubre,Austria,5,4,,9,-77.35600000000001,0.81488
20649,2013,Octubre,Austria,0,4,,4,-75.527794,10.406342
20650,2013,Octubre,Austria,5,6,,11,-75.516486,10.446304
20651,2013,Octubre,Austria,1,2,,3,-74.77647900000001,10.886686
20652,2013,Octubre,Austria,1,0,,1,-74.213989,11.247722999999999
20653,2013,Octubre,Austria,1,6,,7,-76.532004,3.451668
20654,2013,Octubre,Austria,74,186,,260,-74.140516,4.697157
20655,2013,Octubre,Austria,7,9,,16,-75.42726,6.170465
20656,2013,Octubre,Austria,0,1,,1,-72.453013,7.819
20657,2013,Octubre,Azerbaiyán,0,2,,2,-75.516486,10.446304
20658,2013,Octubre,Azerbaiyán,2,2,,4,-74.140516,4.697157
20659,2013,Octubre,Bahamas,0,2,,2,-75.516486,10.446304
20660,2013,Octubre,Bahamas,0,1,,1,-74.77647900000001,10.886686
20661,2013,Octubre,Bahamas,1,4,,5,-74.140516,4.697157
20662,2013,Octubre,Bahamas,1,1,,2,-75.736374,4.815189
20663,2013,Octubre,Bahamas,2,2,,4,-75.42726,6.170465
20664,2013,Octubre,Bahréin,0,2,,2,-75.516486,10.446304
20665,2013,Octubre,Bahréin,0,3,,3,-74.140516,4.697157
20666,2013,Octubre,Bangladesh,0,2,,2,-75.516486,10.446304
20667,2013,Octubre,Bangladesh,0,2,,2,-74.140516,4.697157
20668,2013,Octubre,Barbados,0,1,,1,-75.516486,10.446304
20669,2013,Octubre,Barbados,0,2,,2,-76.532004,3.451668
20670,2013,Octubre,Barbados,4,14,,18,-74.140516,4.697157
20671,2013,Octubre,República de Belarús,0,1,,1,-75.516486,10.446304
20672,2013,Octubre,República de Belarús,1,0,,1,-76.532004,3.451668
20673,2013,Octubre,República de Belarús,1,4,,5,-74.140516,4.697157
20674,2013,Octubre,Bélgica,3,3,,6,-69.941498,4.191162
20675,2013,Octubre,Bélgica,1,0,,1,-76.876446,0.33002
20676,2013,Octubre,Bélgica,6,6,,12,-77.35600000000001,0.81488
20677,2013,Octubre,Bélgica,0,1,,1,-75.527794,10.406342
20678,2013,Octubre,Bélgica,2,6,,8,-75.516486,10.446304
20679,2013,Octubre,Bélgica,2,3,,5,-74.77647900000001,10.886686
20680,2013,Octubre,Bélgica,0,16,,16,-74.213989,11.247722999999999
20681,2013,Octubre,Bélgica,5,28,,33,-76.532004,3.451668
20682,2013,Octubre,Bélgica,0,6,,6,-77.061029,3.8844260000000004
20683,2013,Octubre,Bélgica,1,1,,2,-75.76635300000001,4.45285
20684,2013,Octubre,Bélgica,128,312,,440,-74.140516,4.697157
20685,2013,Octubre,Bélgica,0,3,,3,-75.736374,4.815189
20686,2013,Octubre,Bélgica,4,20,,24,-75.42726,6.170465
20687,2013,Octubre,Bélgica,1,2,,3,-72.453013,7.819
20688,2013,Octubre,Belice,0,1,,1,-75.516486,10.446304
20689,2013,Octubre,Belice,0,1,,1,-72.129595,11.360028999999999
20690,2013,Octubre,Belice,5,13,,18,-74.140516,4.697157
20691,2013,Octubre,Benín,2,2,,4,-74.140516,4.697157
20692,2013,Octubre,Bermudas/Territorio Británico de Ultramar,1,0,,1,-75.516486,10.446304
20693,2013,Octubre,Bermudas/Territorio Británico de Ultramar,0,2,,2,-76.532004,3.451668
20694,2013,Octubre,Bermudas/Territorio Británico de Ultramar,0,1,,1,-74.140516,4.697157
20695,2013,Octubre,Bolivia,1,0,,1,-69.941498,4.191162
20696,2013,Octubre,Bolivia,1,0,,1,-76.876446,0.33002
20697,2013,Octubre,Bolivia,14,15,,29,-77.35600000000001,0.81488
20698,2013,Octubre,Bolivia,0,1,,1,-75.527794,10.406342
20699,2013,Octubre,Bolivia,11,13,,24,-75.516486,10.446304
20700,2013,Octubre,Bolivia,0,3,,3,-74.77647900000001,10.886686
20701,2013,Octubre,Bolivia,1,0,,1,-72.129595,11.360028999999999
20702,2013,Octubre,Bolivia,1,1,,2,-81.70216500000001,12.5862
20703,2013,Octubre,Bolivia,2,6,,8,-76.532004,3.451668
20704,2013,Octubre,Bolivia,0,1,,1,-75.76635300000001,4.45285
20705,2013,Octubre,Bolivia,289,454,,743,-74.140516,4.697157
20706,2013,Octubre,Bolivia,0,3,,3,-75.736374,4.815189
20707,2013,Octubre,Bolivia,14,22,,36,-75.42726,6.170465
20708,2013,Octubre,Bolivia,0,2,,2,-72.453013,7.819
20709,2013,Octubre,Bolivia,0,3,,3,-72.508188,7.927233
20710,2013,Octubre,Bosnia y Herzegovina,2,1,,3,-74.140516,4.697157
20711,2013,Octubre,Botsuana,0,2,,2,-75.516486,10.446304
20712,2013,Octubre,Botsuana,0,3,,3,-74.140516,4.697157
20713,2013,Octubre,Brasil,59,83,,142,-69.941498,4.191162
20714,2013,Octubre,Brasil,12,13,,25,-77.35600000000001,0.81488
20715,2013,Octubre,Brasil,111,84,,195,-75.527794,10.406342
20716,2013,Octubre,Brasil,209,166,,375,-75.516486,10.446304
20717,2013,Octubre,Brasil,10,33,,43,-74.77647900000001,10.886686
20718,2013,Octubre,Brasil,9,6,,15,-72.129595,11.360028999999999
20719,2013,Octubre,Brasil,24,15,,39,-81.70216500000001,12.5862
20720,2013,Octubre,Brasil,35,84,,119,-76.532004,3.451668
20721,2013,Octubre,Brasil,2868,4306,,7174,-74.140516,4.697157
20722,2013,Octubre,Brasil,3,12,,15,-75.736374,4.815189
20723,2013,Octubre,Brasil,80,167,,247,-75.42726,6.170465
20724,2013,Octubre,Brasil,1,2,,3,-70.74025300000001,7.088728999999999
20725,2013,Octubre,Brasil,1,3,,4,-73.181317,7.1280470000000005
20726,2013,Octubre,Brasil,18,25,,43,-72.453013,7.819
20727,2013,Octubre,Brasil,0,3,,3,-72.508188,7.927233
20728,2013,Octubre,Brunei Darussalam,0,5,,5,-74.140516,4.697157
20729,2013,Octubre,Bulgaria,0,3,,3,-75.527794,10.406342
20730,2013,Octubre,Bulgaria,1,0,,1,-75.516486,10.446304
20731,2013,Octubre,Bulgaria,0,1,,1,-74.765343,10.970933
20732,2013,Octubre,Bulgaria,1,0,,1,-76.532004,3.451668
20733,2013,Octubre,Bulgaria,7,17,,24,-74.140516,4.697157
20734,2013,Octubre,Bulgaria,2,1,,3,-72.453013,7.819
20735,2013,Octubre,Burkina Faso,0,2,,2,-74.140516,4.697157
20736,2013,Octubre,Burundi,0,1,,1,-75.516486,10.446304
20737,2013,Octubre,Burundi,0,2,,2,-74.140516,4.697157
20738,2013,Octubre,Bután,0,2,,2,-74.140516,4.697157
20739,2013,Octubre,Cabo Verde,1,0,,1,-74.140516,4.697157
20740,2013,Octubre,Islas Caimán/Territorio Británico de Ultramar,2,1,,3,-81.70216500000001,12.5862
20741,2013,Octubre,Camboya,0,1,,1,-75.516486,10.446304
20742,2013,Octubre,Camerún,0,1,,1,-75.516486,10.446304
20743,2013,Octubre,Camerún,4,8,,12,-74.140516,4.697157
20744,2013,Octubre,Canadá,2,2,,4,-69.941498,4.191162
20745,2013,Octubre,Canadá,10,8,,18,-77.35600000000001,0.81488
20746,2013,Octubre,Canadá,13,17,,30,-75.527794,10.406342
20747,2013,Octubre,Canadá,95,126,,221,-75.516486,10.446304
20748,2013,Octubre,Canadá,2,12,,14,-74.77647900000001,10.886686
20749,2013,Octubre,Canadá,1,0,,1,-74.213989,11.247722999999999
20750,2013,Octubre,Canadá,1,8,,9,-72.129595,11.360028999999999
20751,2013,Octubre,Canadá,2,5,,7,-81.70216500000001,12.5862
20752,2013,Octubre,Canadá,17,41,,58,-76.532004,3.451668
20753,2013,Octubre,Canadá,0,1,,1,-77.061029,3.8844260000000004
20754,2013,Octubre,Canadá,2,1,,3,-75.76635300000001,4.45285
20755,2013,Octubre,Canadá,572,1225,,1797,-74.140516,4.697157
20756,2013,Octubre,Canadá,1,4,,5,-75.736374,4.815189
20757,2013,Octubre,Canadá,34,104,,138,-75.42726,6.170465
20758,2013,Octubre,Canadá,0,2,,2,-73.181317,7.1280470000000005
20759,2013,Octubre,Canadá,4,4,,8,-72.453013,7.819
20760,2013,Octubre,Canadá,1,2,,3,-72.508188,7.927233
20761,2013,Octubre,Chad,0,1,,1,-74.140516,4.697157
20762,2013,Octubre,España,0,1,,1,-77.35600000000001,0.81488
20763,2013,Octubre,España,2,3,,5,-75.527794,10.406342
20764,2013,Octubre,España,0,1,,1,-74.77647900000001,10.886686
20765,2013,Octubre,España,11,22,,33,-76.532004,3.451668
20766,2013,Octubre,España,13,27,,40,-74.140516,4.697157
20767,2013,Octubre,España,4,9,,13,-72.453013,7.819
20768,2013,Octubre,República Del Congo,0,2,,2,-74.140516,4.697157
20769,2013,Octubre,Comoras,0,2,,2,-74.140516,4.697157
20770,2013,Octubre,República Democrática del Congo,0,2,,2,-75.516486,10.446304
20771,2013,Octubre,República Democrática del Congo,3,17,,20,-74.140516,4.697157
20772,2013,Octubre,República Democrática del Congo,1,0,,1,-72.453013,7.819
20773,2013,Octubre,República de Corea,2,4,,6,-77.35600000000001,0.81488
20774,2013,Octubre,República de Corea,0,2,,2,-75.527794,10.406342
20775,2013,Octubre,República de Corea,2,11,,13,-75.516486,10.446304
20776,2013,Octubre,República de Corea,0,4,,4,-74.77647900000001,10.886686
20777,2013,Octubre,República de Corea,0,1,,1,-72.129595,11.360028999999999
20778,2013,Octubre,República de Corea,3,13,,16,-76.532004,3.451668
20779,2013,Octubre,República de Corea,133,417,,550,-74.140516,4.697157
20780,2013,Octubre,República de Corea,0,2,,2,-75.736374,4.815189
20781,2013,Octubre,República de Corea,6,26,,32,-75.42726,6.170465
20782,2013,Octubre,República de Corea,1,3,,4,-72.453013,7.819
20783,2013,Octubre,Costa de Marfil,1,6,,7,-74.140516,4.697157
20784,2013,Octubre,Costa Rica,0,1,,1,-69.941498,4.191162
20785,2013,Octubre,Costa Rica,1,0,,1,-77.35600000000001,0.81488
20786,2013,Octubre,Costa Rica,0,2,,2,-75.527794,10.406342
20787,2013,Octubre,Costa Rica,39,57,,96,-75.516486,10.446304
20788,2013,Octubre,Costa Rica,12,22,,34,-74.77647900000001,10.886686
20789,2013,Octubre,Costa Rica,2,6,,8,-81.70216500000001,12.5862
20790,2013,Octubre,Costa Rica,20,45,,65,-76.532004,3.451668
20791,2013,Octubre,Costa Rica,1,0,,1,-75.76635300000001,4.45285
20792,2013,Octubre,Costa Rica,464,781,,1245,-74.140516,4.697157
20793,2013,Octubre,Costa Rica,5,2,,7,-75.736374,4.815189
20794,2013,Octubre,Costa Rica,71,173,,244,-75.42726,6.170465
20795,2013,Octubre,Costa Rica,3,1,,4,-73.181317,7.1280470000000005
20796,2013,Octubre,Costa Rica,1,2,,3,-72.453013,7.819
20797,2013,Octubre,Costa Rica,0,1,,1,-72.508188,7.927233
20798,2013,Octubre,Croacia,0,1,,1,-69.941498,4.191162
20799,2013,Octubre,Croacia,0,1,,1,-75.516486,10.446304
20800,2013,Octubre,Croacia,0,1,,1,-76.532004,3.451668
20801,2013,Octubre,Croacia,0,6,,6,-77.061029,3.8844260000000004
20802,2013,Octubre,Croacia,3,36,,39,-74.140516,4.697157
20803,2013,Octubre,Croacia,0,1,,1,-75.736374,4.815189
20804,2013,Octubre,Croacia,0,1,,1,-75.42726,6.170465
20805,2013,Octubre,Cuba,0,1,,1,-69.941498,4.191162
20806,2013,Octubre,Cuba,0,3,,3,-75.527794,10.406342
20807,2013,Octubre,Cuba,2,11,,13,-75.516486,10.446304
20808,2013,Octubre,Cuba,4,11,,15,-74.77647900000001,10.886686
20809,2013,Octubre,Cuba,16,20,,36,-76.532004,3.451668
20810,2013,Octubre,Cuba,1,0,,1,-77.061029,3.8844260000000004
20811,2013,Octubre,Cuba,0,1,,1,-75.76635300000001,4.45285
20812,2013,Octubre,Cuba,108,200,,308,-74.140516,4.697157
20813,2013,Octubre,Cuba,1,3,,4,-75.736374,4.815189
20814,2013,Octubre,Cuba,15,26,,41,-75.42726,6.170465
20815,2013,Octubre,Cuba,0,1,,1,-73.181317,7.1280470000000005
20816,2013,Octubre,Cuba,0,2,,2,-72.508188,7.927233
20817,2013,Octubre,Curazao,0,1,,1,-76.532004,3.451668
20818,2013,Octubre,Curazao,0,1,,1,-74.140516,4.697157
20819,2013,Octubre,República Checa,4,9,,13,-77.35600000000001,0.81488
20820,2013,Octubre,República Checa,1,0,,1,-75.516486,10.446304
20821,2013,Octubre,República Checa,0,1,,1,-74.77647900000001,10.886686
20822,2013,Octubre,República Checa,1,0,,1,-76.532004,3.451668
20823,2013,Octubre,República Checa,32,49,,81,-74.140516,4.697157
20824,2013,Octubre,República Checa,2,2,,4,-75.42726,6.170465
20825,2013,Octubre,República Checa,0,1,,1,-72.453013,7.819
20826,2013,Octubre,Chile,1,2,,3,-69.941498,4.191162
20827,2013,Octubre,Chile,1,1,,2,-76.876446,0.33002
20828,2013,Octubre,Chile,43,60,,103,-77.35600000000001,0.81488
20829,2013,Octubre,Chile,43,25,,68,-75.527794,10.406342
20830,2013,Octubre,Chile,85,178,,263,-75.516486,10.446304
20831,2013,Octubre,Chile,25,347,,372,-74.77647900000001,10.886686
20832,2013,Octubre,Chile,1,6,,7,-72.129595,11.360028999999999
20833,2013,Octubre,Chile,28,19,,47,-81.70216500000001,12.5862
20834,2013,Octubre,Chile,24,57,,81,-76.532004,3.451668
20835,2013,Octubre,Chile,1,0,,1,-75.76635300000001,4.45285
20836,2013,Octubre,Chile,3015,4802,,7817,-74.140516,4.697157
20837,2013,Octubre,Chile,0,2,,2,-75.736374,4.815189
20838,2013,Octubre,Chile,44,118,,162,-75.42726,6.170465
20839,2013,Octubre,Chile,3,23,,26,-72.453013,7.819
20840,2013,Octubre,Chile,1,3,,4,-72.508188,7.927233
20841,2013,Octubre,China,1,1,,2,-77.35600000000001,0.81488
20842,2013,Octubre,China,2,8,,10,-75.527794,10.406342
20843,2013,Octubre,China,0,11,,11,-75.516486,10.446304
20844,2013,Octubre,China,2,0,,2,-74.77647900000001,10.886686
20845,2013,Octubre,China,2,5,,7,-76.532004,3.451668
20846,2013,Octubre,China,2,7,,9,-77.061029,3.8844260000000004
20847,2013,Octubre,China,150,457,,607,-74.140516,4.697157
20848,2013,Octubre,China,0,1,,1,-75.736374,4.815189
20849,2013,Octubre,China,8,8,,16,-75.42726,6.170465
20850,2013,Octubre,Taiwán,0,1,,1,-76.532004,3.451668
20851,2013,Octubre,Taiwán,5,5,,10,-74.140516,4.697157
20852,2013,Octubre,Taiwán,0,1,,1,-75.42726,6.170465
20853,2013,Octubre,Taiwán,2,0,,2,-72.453013,7.819
20854,2013,Octubre,Chipre,0,1,,1,-74.765343,10.970933
20855,2013,Octubre,Chipre,1,3,,4,-74.140516,4.697157
20856,2013,Octubre,Dinamarca,2,8,,10,-75.516486,10.446304
20857,2013,Octubre,Dinamarca,0,1,,1,-74.77647900000001,10.886686
20858,2013,Octubre,Dinamarca,0,1,,1,-72.129595,11.360028999999999
20859,2013,Octubre,Dinamarca,0,8,,8,-76.532004,3.451668
20860,2013,Octubre,Dinamarca,44,98,,142,-74.140516,4.697157
20861,2013,Octubre,Dinamarca,5,9,,14,-75.42726,6.170465
20862,2013,Octubre,Dominica,2,4,,6,-74.140516,4.697157
20863,2013,Octubre,Dominica,0,1,,1,-75.736374,4.815189
20864,2013,Octubre,Ecuador,29,63,,92,-76.876446,0.33002
20865,2013,Octubre,Ecuador,1444,2111,,3555,-77.35600000000001,0.81488
20866,2013,Octubre,Ecuador,2,119,,121,-78.802679,18.00143
20867,2013,Octubre,Ecuador,3,15,,18,-75.527794,10.406342
20868,2013,Octubre,Ecuador,8,27,,35,-75.516486,10.446304
20869,2013,Octubre,Ecuador,3,12,,15,-74.77647900000001,10.886686
20870,2013,Octubre,Ecuador,14,15,,29,-72.129595,11.360028999999999
20871,2013,Octubre,Ecuador,0,1,,1,-81.703935,12.574411099999999
20872,2013,Octubre,Ecuador,5,4,,9,-81.70216500000001,12.5862
20873,2013,Octubre,Ecuador,539,613,,1152,-76.532004,3.451668
20874,2013,Octubre,Ecuador,1716,2624,,4340,-74.140516,4.697157
20875,2013,Octubre,Ecuador,0,1,,1,-75.736374,4.815189
20876,2013,Octubre,Ecuador,477,545,,1022,-75.42726,6.170465
20877,2013,Octubre,Ecuador,0,1,,1,-70.74025300000001,7.088728999999999
20878,2013,Octubre,Ecuador,0,1,,1,-73.181317,7.1280470000000005
20879,2013,Octubre,Ecuador,146,222,,368,-72.453013,7.819
20880,2013,Octubre,Ecuador,1,3,,4,-72.508188,7.927233
20881,2013,Octubre,Ecuador,1,0,,1,-77.35002,8.63337
20882,2013,Octubre,Egipto,1,2,,3,-75.516486,10.446304
20883,2013,Octubre,Egipto,4,13,,17,-74.140516,4.697157
20884,2013,Octubre,Egipto,0,1,,1,-75.42726,6.170465
20885,2013,Octubre,El Salvador,0,2,,2,-77.35600000000001,0.81488
20886,2013,Octubre,El Salvador,11,13,,24,-75.516486,10.446304
20887,2013,Octubre,El Salvador,3,4,,7,-74.77647900000001,10.886686
20888,2013,Octubre,El Salvador,55,95,,150,-76.532004,3.451668
20889,2013,Octubre,El Salvador,498,821,,1319,-74.140516,4.697157
20890,2013,Octubre,El Salvador,0,2,,2,-75.736374,4.815189
20891,2013,Octubre,El Salvador,26,43,,69,-75.42726,6.170465
20892,2013,Octubre,El Salvador,0,2,,2,-72.453013,7.819
20893,2013,Octubre,El Salvador,0,1,,1,-72.508188,7.927233
20894,2013,Octubre,Emiratos Árabes,0,2,,2,-75.516486,10.446304
20895,2013,Octubre,Emiratos Árabes,3,10,,13,-74.140516,4.697157
20896,2013,Octubre,España,1,5,,6,-69.941498,4.191162
20897,2013,Octubre,España,0,1,,1,-76.876446,0.33002
20898,2013,Octubre,España,26,49,,75,-77.35600000000001,0.81488
20899,2013,Octubre,España,25,27,,52,-75.527794,10.406342
20900,2013,Octubre,España,34,71,,105,-75.516486,10.446304
20901,2013,Octubre,España,8,26,,34,-74.77647900000001,10.886686
20902,2013,Octubre,España,0,2,,2,-74.765343,10.970933
20903,2013,Octubre,España,6,15,,21,-72.129595,11.360028999999999
20904,2013,Octubre,España,2,3,,5,-81.70216500000001,12.5862
20905,2013,Octubre,España,186,329,,515,-76.532004,3.451668
20906,2013,Octubre,España,0,2,,2,-75.76635300000001,4.45285
20907,2013,Octubre,España,1920,5298,,7218,-74.140516,4.697157
20908,2013,Octubre,España,2,8,,10,-75.736374,4.815189
20909,2013,Octubre,España,123,373,,496,-75.42726,6.170465
20910,2013,Octubre,España,0,1,,1,-67.48402800000001,6.185536
20911,2013,Octubre,España,1,0,,1,-73.181317,7.1280470000000005
20912,2013,Octubre,España,11,39,,50,-72.453013,7.819
20913,2013,Octubre,España,2,4,,6,-72.508188,7.927233
20914,2013,Octubre,España,0,1,,1,-76.7333,8.06667
20915,2013,Octubre,España,0,1,,1,-77.35002,8.63337
20916,2013,Octubre,Eslovaquia,0,1,,1,-69.941498,4.191162
20917,2013,Octubre,Eslovaquia,0,1,,1,-75.527794,10.406342
20918,2013,Octubre,Eslovaquia,1,0,,1,-76.532004,3.451668
20919,2013,Octubre,Eslovaquia,9,19,,28,-74.140516,4.697157
20920,2013,Octubre,Eslovaquia,0,1,,1,-75.736374,4.815189
20921,2013,Octubre,Eslovaquia,0,3,,3,-75.42726,6.170465
20922,2013,Octubre,Eslovenia,1,0,,1,-77.35600000000001,0.81488
20923,2013,Octubre,Eslovenia,0,1,,1,-75.527794,10.406342
20924,2013,Octubre,Eslovenia,0,1,,1,-75.516486,10.446304
20925,2013,Octubre,Eslovenia,12,19,,31,-74.140516,4.697157
20926,2013,Octubre,Eslovenia,0,2,,2,-75.42726,6.170465
20927,2013,Octubre,Estados Unidos de América,5,16,,21,-69.941498,4.191162
20928,2013,Octubre,Estados Unidos de América,32,52,,84,-77.35600000000001,0.81488
20929,2013,Octubre,Estados Unidos de América,28,70,,98,-75.527794,10.406342
20930,2013,Octubre,Estados Unidos de América,790,1573,,2363,-75.516486,10.446304
20931,2013,Octubre,Estados Unidos de América,216,394,,610,-74.77647900000001,10.886686
20932,2013,Octubre,Estados Unidos de América,1,4,,5,-74.213989,11.247722999999999
20933,2013,Octubre,Estados Unidos de América,9,8,,17,-72.129595,11.360028999999999
20934,2013,Octubre,Estados Unidos de América,0,2,,2,-81.703935,12.574411099999999
20935,2013,Octubre,Estados Unidos de América,7,8,,15,-81.70216500000001,12.5862
20936,2013,Octubre,Estados Unidos de América,458,837,,1295,-76.532004,3.451668
20937,2013,Octubre,Estados Unidos de América,0,1,,1,-77.061029,3.8844260000000004
20938,2013,Octubre,Estados Unidos de América,82,102,,184,-75.76635300000001,4.45285
20939,2013,Octubre,Estados Unidos de América,4523,9878,,14401,-74.140516,4.697157
20940,2013,Octubre,Estados Unidos de América,53,89,,142,-75.736374,4.815189
20941,2013,Octubre,Estados Unidos de América,882,2458,,3340,-75.42726,6.170465
20942,2013,Octubre,Estados Unidos de América,14,20,,34,-73.181317,7.1280470000000005
20943,2013,Octubre,Estados Unidos de América,26,54,,80,-72.453013,7.819
20944,2013,Octubre,Estados Unidos de América,7,27,,34,-72.508188,7.927233
20945,2013,Octubre,Estados Unidos de América,2,3,,5,-76.7333,8.06667
20946,2013,Octubre,Estonia,2,1,,3,-69.941498,4.191162
20947,2013,Octubre,Estonia,2,7,,9,-74.140516,4.697157
20948,2013,Octubre,Estonia,0,1,,1,-77.35002,8.63337
20949,2013,Octubre,Etiopia,0,3,,3,-75.516486,10.446304
20950,2013,Octubre,Etiopia,1,9,,10,-74.140516,4.697157
20951,2013,Octubre,Islas Fiji,0,1,,1,-75.516486,10.446304
20952,2013,Octubre,Islas Fiji,1,0,,1,-74.77647900000001,10.886686
20953,2013,Octubre,Islas Fiji,0,5,,5,-74.140516,4.697157
20954,2013,Octubre,Filipinas,2,1,,3,-77.35600000000001,0.81488
20955,2013,Octubre,Filipinas,1,78,,79,-75.527794,10.406342
20956,2013,Octubre,Filipinas,0,45,,45,-75.516486,10.446304
20957,2013,Octubre,Filipinas,0,3,,3,-74.77647900000001,10.886686
20958,2013,Octubre,Filipinas,0,10,,10,-74.765343,10.970933
20959,2013,Octubre,Filipinas,0,10,,10,-74.213989,11.247722999999999
20960,2013,Octubre,Filipinas,0,7,,7,-76.532004,3.451668
20961,2013,Octubre,Filipinas,0,32,,32,-77.061029,3.8844260000000004
20962,2013,Octubre,Filipinas,24,71,,95,-74.140516,4.697157
20963,2013,Octubre,Filipinas,0,5,,5,-75.68164200000001,9.402597
20964,2013,Octubre,Finlandia,0,1,,1,-76.876446,0.33002
20965,2013,Octubre,Finlandia,2,1,,3,-77.35600000000001,0.81488
20966,2013,Octubre,Finlandia,0,1,,1,-75.527794,10.406342
20967,2013,Octubre,Finlandia,1,2,,3,-75.516486,10.446304
20968,2013,Octubre,Finlandia,0,2,,2,-74.77647900000001,10.886686
20969,2013,Octubre,Finlandia,0,1,,1,-72.919186,11.52863
20970,2013,Octubre,Finlandia,2,4,,6,-76.532004,3.451668
20971,2013,Octubre,Finlandia,30,57,,87,-74.140516,4.697157
20972,2013,Octubre,Finlandia,0,1,,1,-75.42726,6.170465
20973,2013,Octubre,Finlandia,1,1,,2,-72.453013,7.819
20974,2013,Octubre,Francia,5,15,,20,-69.941498,4.191162
20975,2013,Octubre,Francia,31,46,,77,-77.35600000000001,0.81488
20976,2013,Octubre,Francia,16,31,,47,-75.527794,10.406342
20977,2013,Octubre,Francia,20,49,,69,-75.516486,10.446304
20978,2013,Octubre,Francia,4,9,,13,-74.77647900000001,10.886686
20979,2013,Octubre,Francia,2,2,,4,-74.213989,11.247722999999999
20980,2013,Octubre,Francia,2,4,,6,-72.129595,11.360028999999999
20981,2013,Octubre,Francia,2,0,,2,-81.70216500000001,12.5862
20982,2013,Octubre,Francia,27,63,,90,-76.532004,3.451668
20983,2013,Octubre,Francia,849,1745,,2594,-74.140516,4.697157
20984,2013,Octubre,Francia,0,5,,5,-75.736374,4.815189
20985,2013,Octubre,Francia,38,91,,129,-75.42726,6.170465
20986,2013,Octubre,Francia,1,1,,2,-77.401154,6.222551999999999
20987,2013,Octubre,Francia,0,1,,1,-73.181317,7.1280470000000005
20988,2013,Octubre,Francia,8,15,,23,-72.453013,7.819
20989,2013,Octubre,Francia,0,1,,1,-72.508188,7.927233
20990,2013,Octubre,Gabón,0,3,,3,-74.140516,4.697157
20991,2013,Octubre,Georgia,0,1,,1,-75.527794,10.406342
20992,2013,Octubre,Georgia,1,1,,2,-75.516486,10.446304
20993,2013,Octubre,Georgia,0,2,,2,-74.140516,4.697157
20994,2013,Octubre,Georgia,0,1,,1,-75.42726,6.170465
20995,2013,Octubre,Georgia,0,1,,1,-75.68164200000001,9.402597
20996,2013,Octubre,Ghana,0,4,,4,-75.516486,10.446304
20997,2013,Octubre,Ghana,0,1,,1,-74.140516,4.697157
20998,2013,Octubre,Granada,0,1,,1,-75.516486,10.446304
20999,2013,Octubre,Grecia,1,0,,1,-69.941498,4.191162
21000,2013,Octubre,Grecia,0,3,,3,-75.527794,10.406342
21001,2013,Octubre,Grecia,0,6,,6,-75.516486,10.446304
21002,2013,Octubre,Grecia,0,4,,4,-74.765343,10.970933
21003,2013,Octubre,Grecia,2,1,,3,-76.532004,3.451668
21004,2013,Octubre,Grecia,17,54,,71,-74.140516,4.697157
21005,2013,Octubre,Grecia,1,1,,2,-75.42726,6.170465
21006,2013,Octubre,Grecia,1,2,,3,-75.68164200000001,9.402597
21007,2013,Octubre,Guatemala,0,1,,1,-77.35600000000001,0.81488
21008,2013,Octubre,Guatemala,1,2,,3,-75.527794,10.406342
21009,2013,Octubre,Guatemala,26,34,,60,-75.516486,10.446304
21010,2013,Octubre,Guatemala,8,31,,39,-74.77647900000001,10.886686
21011,2013,Octubre,Guatemala,1,0,,1,-74.765343,10.970933
21012,2013,Octubre,Guatemala,0,3,,3,-72.129595,11.360028999999999
21013,2013,Octubre,Guatemala,10,4,,14,-81.70216500000001,12.5862
21014,2013,Octubre,Guatemala,14,41,,55,-76.532004,3.451668
21015,2013,Octubre,Guatemala,1,0,,1,-75.76635300000001,4.45285
21016,2013,Octubre,Guatemala,243,511,,754,-74.140516,4.697157
21017,2013,Octubre,Guatemala,2,4,,6,-75.736374,4.815189
21018,2013,Octubre,Guatemala,29,76,,105,-75.42726,6.170465
21019,2013,Octubre,Guatemala,0,1,,1,-73.181317,7.1280470000000005
21020,2013,Octubre,Guatemala,2,4,,6,-72.453013,7.819
21021,2013,Octubre,Guatemala,0,1,,1,-72.508188,7.927233
21022,2013,Octubre,Guyana,0,3,,3,-75.516486,10.446304
21023,2013,Octubre,Guyana,0,1,,1,-76.532004,3.451668
21024,2013,Octubre,Guyana,3,5,,8,-74.140516,4.697157
21025,2013,Octubre,Guyana,0,1,,1,-75.736374,4.815189
21026,2013,Octubre,Guyana,2,2,,4,-75.42726,6.170465
21027,2013,Octubre,Guyana,0,2,,2,-72.453013,7.819
21028,2013,Octubre,Guinea,0,4,,4,-74.140516,4.697157
21029,2013,Octubre,Guinea Ecuatorial,1,0,,1,-74.140516,4.697157
21030,2013,Octubre,Guinea Bissau,0,2,,2,-76.532004,3.451668
21031,2013,Octubre,Haití,0,2,,2,-75.527794,10.406342
21032,2013,Octubre,Haití,0,3,,3,-75.516486,10.446304
21033,2013,Octubre,Haití,1,3,,4,-74.77647900000001,10.886686
21034,2013,Octubre,Haití,2,14,,16,-74.140516,4.697157
21035,2013,Octubre,Haití,0,15,,15,-75.42726,6.170465
21036,2013,Octubre,Honduras,2,1,,3,-77.35600000000001,0.81488
21037,2013,Octubre,Honduras,0,4,,4,-75.527794,10.406342
21038,2013,Octubre,Honduras,28,44,,72,-75.516486,10.446304
21039,2013,Octubre,Honduras,4,4,,8,-74.77647900000001,10.886686
21040,2013,Octubre,Honduras,0,2,,2,-74.765343,10.970933
21041,2013,Octubre,Honduras,0,15,,15,-81.703935,12.574411099999999
21042,2013,Octubre,Honduras,0,2,,2,-81.372937,13.338761300000002
21043,2013,Octubre,Honduras,8,28,,36,-76.532004,3.451668
21044,2013,Octubre,Honduras,124,198,,322,-74.140516,4.697157
21045,2013,Octubre,Honduras,5,3,,8,-75.736374,4.815189
21046,2013,Octubre,Honduras,25,39,,64,-75.42726,6.170465
21047,2013,Octubre,Honduras,0,1,,1,-73.181317,7.1280470000000005
21048,2013,Octubre,Honduras,1,1,,2,-72.453013,7.819
21049,2013,Octubre,Honduras,0,2,,2,-76.7333,8.06667
21050,2013,Octubre,Hong Kong,0,1,,1,-74.140516,4.697157
21051,2013,Octubre,Hungría,2,2,,4,-77.35600000000001,0.81488
21052,2013,Octubre,Hungría,0,1,,1,-75.527794,10.406342
21053,2013,Octubre,Hungría,0,1,,1,-75.516486,10.446304
21054,2013,Octubre,Hungría,0,2,,2,-76.532004,3.451668
21055,2013,Octubre,Hungría,16,33,,49,-74.140516,4.697157
21056,2013,Octubre,Hungría,0,5,,5,-75.42726,6.170465
21057,2013,Octubre,Hungría,2,1,,3,-72.453013,7.819
21058,2013,Octubre,India,0,3,,3,-77.35600000000001,0.81488
21059,2013,Octubre,India,2,3,,5,-75.527794,10.406342
21060,2013,Octubre,India,1,16,,17,-75.516486,10.446304
21061,2013,Octubre,India,0,4,,4,-74.77647900000001,10.886686
21062,2013,Octubre,India,1,0,,1,-74.765343,10.970933
21063,2013,Octubre,India,0,2,,2,-74.213989,11.247722999999999
21064,2013,Octubre,India,0,1,,1,-81.70216500000001,12.5862
21065,2013,Octubre,India,5,10,,15,-76.532004,3.451668
21066,2013,Octubre,India,34,227,,261,-74.140516,4.697157
21067,2013,Octubre,India,1,22,,23,-75.42726,6.170465
21068,2013,Octubre,India,0,2,,2,-75.68164200000001,9.402597
21069,2013,Octubre,Indonesia,0,2,,2,-77.35600000000001,0.81488
21070,2013,Octubre,Indonesia,0,13,,13,-75.527794,10.406342
21071,2013,Octubre,Indonesia,1,11,,12,-75.516486,10.446304
21072,2013,Octubre,Indonesia,0,1,,1,-74.213989,11.247722999999999
21073,2013,Octubre,Indonesia,0,3,,3,-76.532004,3.451668
21074,2013,Octubre,Indonesia,0,8,,8,-77.061029,3.8844260000000004
21075,2013,Octubre,Indonesia,6,18,,24,-74.140516,4.697157
21076,2013,Octubre,Indonesia,0,1,,1,-75.42726,6.170465
21077,2013,Octubre,Iraq,0,9,,9,-74.140516,4.697157
21078,2013,Octubre,Irán,3,25,,28,-74.140516,4.697157
21079,2013,Octubre,Irán,0,1,,1,-75.42726,6.170465
21080,2013,Octubre,República de Irlanda,0,4,,4,-69.941498,4.191162
21081,2013,Octubre,República de Irlanda,13,7,,20,-77.35600000000001,0.81488
21082,2013,Octubre,República de Irlanda,2,4,,6,-75.527794,10.406342
21083,2013,Octubre,República de Irlanda,7,10,,17,-75.516486,10.446304
21084,2013,Octubre,República de Irlanda,5,3,,8,-76.532004,3.451668
21085,2013,Octubre,República de Irlanda,32,97,,129,-74.140516,4.697157
21086,2013,Octubre,República de Irlanda,4,15,,19,-75.42726,6.170465
21087,2013,Octubre,República de Irlanda,0,1,,1,-72.453013,7.819
21088,2013,Octubre,Islandia,1,2,,3,-75.516486,10.446304
21089,2013,Octubre,Islandia,1,0,,1,-76.532004,3.451668
21090,2013,Octubre,Islandia,3,5,,8,-74.140516,4.697157
21091,2013,Octubre,Isla de Man,1,1,,2,-77.35600000000001,0.81488
21092,2013,Octubre,Isla de Man,1,0,,1,-74.77647900000001,10.886686
21093,2013,Octubre,Isla de Man,1,2,,3,-76.532004,3.451668
21094,2013,Octubre,Isla de Man,6,8,,14,-74.140516,4.697157
21095,2013,Octubre,Isla de Man,0,1,,1,-73.181317,7.1280470000000005
21096,2013,Octubre,Israel,0,2,,2,-69.941498,4.191162
21097,2013,Octubre,Israel,3,13,,16,-77.35600000000001,0.81488
21098,2013,Octubre,Israel,0,2,,2,-75.527794,10.406342
21099,2013,Octubre,Israel,3,36,,39,-75.516486,10.446304
21100,2013,Octubre,Israel,0,1,,1,-74.77647900000001,10.886686
21101,2013,Octubre,Israel,2,7,,9,-76.532004,3.451668
21102,2013,Octubre,Israel,61,405,,466,-74.140516,4.697157
21103,2013,Octubre,Israel,1,33,,34,-75.42726,6.170465
21104,2013,Octubre,Italia,5,14,,19,-69.941498,4.191162
21105,2013,Octubre,Italia,0,1,,1,-76.876446,0.33002
21106,2013,Octubre,Italia,6,16,,22,-77.35600000000001,0.81488
21107,2013,Octubre,Italia,4,7,,11,-75.527794,10.406342
21108,2013,Octubre,Italia,23,61,,84,-75.516486,10.446304
21109,2013,Octubre,Italia,3,11,,14,-74.77647900000001,10.886686
21110,2013,Octubre,Italia,1,2,,3,-74.213989,11.247722999999999
21111,2013,Octubre,Italia,0,5,,5,-72.129595,11.360028999999999
21112,2013,Octubre,Italia,0,1,,1,-81.703935,12.574411099999999
21113,2013,Octubre,Italia,0,3,,3,-81.70216500000001,12.5862
21114,2013,Octubre,Italia,15,61,,76,-76.532004,3.451668
21115,2013,Octubre,Italia,404,1615,,2019,-74.140516,4.697157
21116,2013,Octubre,Italia,0,3,,3,-75.736374,4.815189
21117,2013,Octubre,Italia,38,94,,132,-75.42726,6.170465
21118,2013,Octubre,Italia,0,1,,1,-73.181317,7.1280470000000005
21119,2013,Octubre,Italia,7,20,,27,-72.453013,7.819
21120,2013,Octubre,Italia,1,4,,5,-72.508188,7.927233
21121,2013,Octubre,Islas del Canal,0,1,,1,-74.77647900000001,10.886686
21122,2013,Octubre,Islas del Canal,1,1,,2,-72.453013,7.819
21123,2013,Octubre,Jamaica,1,5,,6,-75.516486,10.446304
21124,2013,Octubre,Jamaica,2,0,,2,-74.77647900000001,10.886686
21125,2013,Octubre,Jamaica,1,2,,3,-81.70216500000001,12.5862
21126,2013,Octubre,Jamaica,1,3,,4,-76.532004,3.451668
21127,2013,Octubre,Jamaica,8,30,,38,-74.140516,4.697157
21128,2013,Octubre,Jamaica,2,3,,5,-75.42726,6.170465
21129,2013,Octubre,Japón,1,0,,1,-69.941498,4.191162
21130,2013,Octubre,Japón,5,8,,13,-77.35600000000001,0.81488
21131,2013,Octubre,Japón,2,2,,4,-75.527794,10.406342
21132,2013,Octubre,Japón,3,17,,20,-75.516486,10.446304
21133,2013,Octubre,Japón,1,9,,10,-74.77647900000001,10.886686
21134,2013,Octubre,Japón,1,0,,1,-72.129595,11.360028999999999
21135,2013,Octubre,Japón,2,0,,2,-81.70216500000001,12.5862
21136,2013,Octubre,Japón,5,10,,15,-76.532004,3.451668
21137,2013,Octubre,Japón,97,397,,494,-74.140516,4.697157
21138,2013,Octubre,Japón,0,1,,1,-75.736374,4.815189
21139,2013,Octubre,Japón,7,37,,44,-75.42726,6.170465
21140,2013,Octubre,Japón,0,2,,2,-73.181317,7.1280470000000005
21141,2013,Octubre,Japón,2,3,,5,-72.453013,7.819
21142,2013,Octubre,Jordania,0,2,,2,-76.532004,3.451668
21143,2013,Octubre,Jordania,1,5,,6,-74.140516,4.697157
21144,2013,Octubre,Kazajistán,0,1,,1,-74.140516,4.697157
21145,2013,Octubre,Kenia,0,1,,1,-76.876446,0.33002
21146,2013,Octubre,Kenia,2,1,,3,-75.516486,10.446304
21147,2013,Octubre,Kenia,2,11,,13,-74.140516,4.697157
21148,2013,Octubre,Kenia,0,1,,1,-75.42726,6.170465
21149,2013,Octubre,Kirguistán,2,1,,3,-74.140516,4.697157
21150,2013,Octubre,Kuwait,0,10,,10,-74.140516,4.697157
21151,2013,Octubre,República de Kosovo,1,0,,1,-74.140516,4.697157
21152,2013,Octubre,Lesoto,0,4,,4,-75.516486,10.446304
21153,2013,Octubre,Letonia,0,6,,6,-75.516486,10.446304
21154,2013,Octubre,Letonia,0,2,,2,-74.765343,10.970933
21155,2013,Octubre,Letonia,6,5,,11,-74.140516,4.697157
21156,2013,Octubre,Letonia,3,0,,3,-75.42726,6.170465
21157,2013,Octubre,Lituania,1,4,,5,-75.516486,10.446304
21158,2013,Octubre,Lituania,4,4,,8,-74.140516,4.697157
21159,2013,Octubre,Lituania,1,0,,1,-75.42726,6.170465
21160,2013,Octubre,Lituania,0,1,,1,-72.453013,7.819
21161,2013,Octubre,Líbano,0,3,,3,-74.77647900000001,10.886686
21162,2013,Octubre,Líbano,6,7,,13,-72.129595,11.360028999999999
21163,2013,Octubre,Líbano,0,1,,1,-76.532004,3.451668
21164,2013,Octubre,Líbano,11,24,,35,-74.140516,4.697157
21165,2013,Octubre,Liberia,0,1,,1,-74.140516,4.697157
21166,2013,Octubre,Libia,0,1,,1,-74.140516,4.697157
21167,2013,Octubre,Liechtenstein,1,3,,4,-74.140516,4.697157
21168,2013,Octubre,Luxemburgo,0,1,,1,-77.35600000000001,0.81488
21169,2013,Octubre,Luxemburgo,1,0,,1,-75.516486,10.446304
21170,2013,Octubre,Luxemburgo,4,15,,19,-74.140516,4.697157
21171,2013,Octubre,Luxemburgo,0,1,,1,-75.42726,6.170465
21172,2013,Octubre,Macedonia,0,1,,1,-75.516486,10.446304
21173,2013,Octubre,Macedonia,2,0,,2,-74.140516,4.697157
21174,2013,Octubre,Madagascar,1,0,,1,-76.532004,3.451668
21175,2013,Octubre,Madagascar,1,2,,3,-74.140516,4.697157
21176,2013,Octubre,Malasia,0,2,,2,-75.527794,10.406342
21177,2013,Octubre,Malasia,1,5,,6,-75.516486,10.446304
21178,2013,Octubre,Malasia,0,1,,1,-74.213989,11.247722999999999
21179,2013,Octubre,Malasia,0,1,,1,-76.532004,3.451668
21180,2013,Octubre,Malasia,10,23,,33,-74.140516,4.697157
21181,2013,Octubre,Malasia,0,1,,1,-75.42726,6.170465
21182,2013,Octubre,Malasia,1,0,,1,-72.453013,7.819
21183,2013,Octubre,Malawi,1,1,,2,-75.516486,10.446304
21184,2013,Octubre,Malawi,1,4,,5,-74.140516,4.697157
21185,2013,Octubre,Malí,0,3,,3,-74.140516,4.697157
21186,2013,Octubre,Malta,2,8,,10,-74.140516,4.697157
21187,2013,Octubre,Marruecos,1,1,,2,-75.527794,10.406342
21188,2013,Octubre,Marruecos,0,1,,1,-76.532004,3.451668
21189,2013,Octubre,Marruecos,2,6,,8,-74.140516,4.697157
21190,2013,Octubre,Marruecos,1,0,,1,-75.42726,6.170465
21191,2013,Octubre,Islas Marshall,0,1,,1,-74.140516,4.697157
21192,2013,Octubre,Mauritania,0,2,,2,-74.140516,4.697157
21193,2013,Octubre,México,0,2,,2,-69.941498,4.191162
21194,2013,Octubre,México,0,1,,1,-76.876446,0.33002
21195,2013,Octubre,México,10,14,,24,-77.35600000000001,0.81488
21196,2013,Octubre,México,0,1,,1,-78.802679,18.00143
21197,2013,Octubre,México,7,10,,17,-75.527794,10.406342
21198,2013,Octubre,México,84,183,,267,-75.516486,10.446304
21199,2013,Octubre,México,11,35,,46,-74.77647900000001,10.886686
21200,2013,Octubre,México,13,11,,24,-72.129595,11.360028999999999
21201,2013,Octubre,México,0,1,,1,-81.70216500000001,12.5862
21202,2013,Octubre,México,48,115,,163,-76.532004,3.451668
21203,2013,Octubre,México,2371,5217,,7588,-74.140516,4.697157
21204,2013,Octubre,México,2,37,,39,-75.736374,4.815189
21205,2013,Octubre,México,106,319,,425,-75.42726,6.170465
21206,2013,Octubre,México,0,1,,1,-67.48402800000001,6.185536
21207,2013,Octubre,México,1,4,,5,-73.181317,7.1280470000000005
21208,2013,Octubre,México,14,63,,77,-72.453013,7.819
21209,2013,Octubre,México,0,3,,3,-72.508188,7.927233
21210,2013,Octubre,República de Moldavia,2,3,,5,-74.140516,4.697157
21211,2013,Octubre,Mónaco,2,3,,5,-74.140516,4.697157
21212,2013,Octubre,Mongolia,1,0,,1,-75.516486,10.446304
21213,2013,Octubre,Mongolia,1,3,,4,-74.140516,4.697157
21214,2013,Octubre,Montenegro,0,1,,1,-75.527794,10.406342
21215,2013,Octubre,Montenegro,0,1,,1,-74.140516,4.697157
21216,2013,Octubre,Mozambique,0,1,,1,-76.876446,0.33002
21217,2013,Octubre,Mozambique,0,7,,7,-74.140516,4.697157
21218,2013,Octubre,Myanmar,0,3,,3,-74.140516,4.697157
21219,2013,Octubre,Namibia,2,6,,8,-74.140516,4.697157
21220,2013,Octubre,Nepal,0,1,,1,-76.532004,3.451668
21221,2013,Octubre,Nepal,0,4,,4,-74.140516,4.697157
21222,2013,Octubre,Nepal,0,1,,1,-75.42726,6.170465
21223,2013,Octubre,Nicaragua,0,5,,5,-75.527794,10.406342
21224,2013,Octubre,Nicaragua,8,6,,14,-75.516486,10.446304
21225,2013,Octubre,Nicaragua,1,6,,7,-74.77647900000001,10.886686
21226,2013,Octubre,Nicaragua,0,2,,2,-81.703935,12.574411099999999
21227,2013,Octubre,Nicaragua,0,1,,1,-81.70216500000001,12.5862
21228,2013,Octubre,Nicaragua,13,16,,29,-76.532004,3.451668
21229,2013,Octubre,Nicaragua,68,99,,167,-74.140516,4.697157
21230,2013,Octubre,Nicaragua,1,1,,2,-75.736374,4.815189
21231,2013,Octubre,Nicaragua,12,13,,25,-75.42726,6.170465
21232,2013,Octubre,Nicaragua,1,0,,1,-73.181317,7.1280470000000005
21233,2013,Octubre,Nigeria,0,5,,5,-75.516486,10.446304
21234,2013,Octubre,Nigeria,2,8,,10,-74.140516,4.697157
21235,2013,Octubre,Nigeria,0,1,,1,-75.42726,6.170465
21236,2013,Octubre,Níger,0,2,,2,-75.516486,10.446304
21237,2013,Octubre,Níger,0,1,,1,-74.140516,4.697157
21238,2013,Octubre,Noruega,1,2,,3,-69.941498,4.191162
21239,2013,Octubre,Noruega,3,0,,3,-77.35600000000001,0.81488
21240,2013,Octubre,Noruega,2,3,,5,-75.527794,10.406342
21241,2013,Octubre,Noruega,2,8,,10,-75.516486,10.446304
21242,2013,Octubre,Noruega,0,3,,3,-74.77647900000001,10.886686
21243,2013,Octubre,Noruega,0,1,,1,-72.129595,11.360028999999999
21244,2013,Octubre,Noruega,0,4,,4,-76.532004,3.451668
21245,2013,Octubre,Noruega,56,110,,166,-74.140516,4.697157
21246,2013,Octubre,Noruega,3,8,,11,-75.42726,6.170465
21247,2013,Octubre,Nueva Caledonia/Territorio francés,0,1,,1,-74.140516,4.697157
21248,2013,Octubre,Nueva Zelanda,0,1,,1,-69.941498,4.191162
21249,2013,Octubre,Nueva Zelanda,7,8,,15,-77.35600000000001,0.81488
21250,2013,Octubre,Nueva Zelanda,3,9,,12,-75.516486,10.446304
21251,2013,Octubre,Nueva Zelanda,0,2,,2,-74.77647900000001,10.886686
21252,2013,Octubre,Nueva Zelanda,0,1,,1,-72.129595,11.360028999999999
21253,2013,Octubre,Nueva Zelanda,2,5,,7,-76.532004,3.451668
21254,2013,Octubre,Nueva Zelanda,27,49,,76,-74.140516,4.697157
21255,2013,Octubre,Nueva Zelanda,1,1,,2,-75.736374,4.815189
21256,2013,Octubre,Nueva Zelanda,2,7,,9,-75.42726,6.170465
21257,2013,Octubre,Nueva Zelanda,0,1,,1,-72.453013,7.819
21258,2013,Octubre,Omán,0,3,,3,-74.140516,4.697157
21259,2013,Octubre,Nueva Zelanda,1,8,,9,-75.527794,10.406342
21260,2013,Octubre,Nueva Zelanda,0,1,,1,-74.77647900000001,10.886686
21261,2013,Octubre,Nueva Zelanda,1,0,,1,-74.213989,11.247722999999999
21262,2013,Octubre,Nueva Zelanda,0,4,,4,-72.453013,7.819
21263,2013,Octubre,Países Bajos,17,15,,32,-77.35600000000001,0.81488
21264,2013,Octubre,Países Bajos,2,1,,3,-75.527794,10.406342
21265,2013,Octubre,Países Bajos,10,48,,58,-75.516486,10.446304
21266,2013,Octubre,Países Bajos,3,21,,24,-74.77647900000001,10.886686
21267,2013,Octubre,Países Bajos,1,8,,9,-72.129595,11.360028999999999
21268,2013,Octubre,Países Bajos,7,24,,31,-72.919186,11.52863
21269,2013,Octubre,Países Bajos,15,48,,63,-76.532004,3.451668
21270,2013,Octubre,Países Bajos,0,8,,8,-77.061029,3.8844260000000004
21271,2013,Octubre,Países Bajos,612,1004,,1616,-74.140516,4.697157
21272,2013,Octubre,Países Bajos,0,5,,5,-75.736374,4.815189
21273,2013,Octubre,Países Bajos,282,334,,616,-75.42726,6.170465
21274,2013,Octubre,Países Bajos,8,8,,16,-73.181317,7.1280470000000005
21275,2013,Octubre,Países Bajos,0,2,,2,-72.453013,7.819
21276,2013,Octubre,Pakistán,0,1,,1,-77.35600000000001,0.81488
21277,2013,Octubre,Pakistán,0,3,,3,-75.516486,10.446304
21278,2013,Octubre,Pakistán,0,9,,9,-74.140516,4.697157
21279,2013,Octubre,Panamá,2,16,,18,-75.527794,10.406342
21280,2013,Octubre,Panamá,101,179,,280,-75.516486,10.446304
21281,2013,Octubre,Panamá,43,78,,121,-74.77647900000001,10.886686
21282,2013,Octubre,Panamá,1,1,,2,-72.129595,11.360028999999999
21283,2013,Octubre,Panamá,0,2,,2,-81.703935,12.574411099999999
21284,2013,Octubre,Panamá,16,32,,48,-81.70216500000001,12.5862
21285,2013,Octubre,Panamá,72,144,,216,-76.532004,3.451668
21286,2013,Octubre,Panamá,550,886,,1436,-74.140516,4.697157
21287,2013,Octubre,Panamá,75,135,,210,-75.736374,4.815189
21288,2013,Octubre,Panamá,109,236,,345,-75.42726,6.170465
21289,2013,Octubre,Panamá,1,0,,1,-77.401154,6.222551999999999
21290,2013,Octubre,Panamá,1,1,,2,-77.762647,7.102626
21291,2013,Octubre,Panamá,5,17,,22,-73.181317,7.1280470000000005
21292,2013,Octubre,Panamá,4,9,,13,-72.453013,7.819
21293,2013,Octubre,Panamá,4,11,,15,-72.508188,7.927233
21294,2013,Octubre,Panamá,0,9,,9,-76.7333,8.06667
21295,2013,Octubre,Paraguay,1,2,,3,-77.35600000000001,0.81488
21296,2013,Octubre,Paraguay,0,1,,1,-75.527794,10.406342
21297,2013,Octubre,Paraguay,12,13,,25,-75.516486,10.446304
21298,2013,Octubre,Paraguay,0,8,,8,-74.77647900000001,10.886686
21299,2013,Octubre,Paraguay,3,1,,4,-72.129595,11.360028999999999
21300,2013,Octubre,Paraguay,10,4,,14,-81.70216500000001,12.5862
21301,2013,Octubre,Paraguay,5,10,,15,-76.532004,3.451668
21302,2013,Octubre,Paraguay,76,121,,197,-74.140516,4.697157
21303,2013,Octubre,Paraguay,8,4,,12,-75.42726,6.170465
21304,2013,Octubre,Paraguay,1,1,,2,-72.453013,7.819
21305,2013,Octubre,Perú,25,26,,51,-69.941498,4.191162
21306,2013,Octubre,Perú,2,6,,8,-76.876446,0.33002
21307,2013,Octubre,Perú,200,362,,562,-77.35600000000001,0.81488
21308,2013,Octubre,Perú,40,30,,70,-75.527794,10.406342
21309,2013,Octubre,Perú,150,126,,276,-75.516486,10.446304
21310,2013,Octubre,Perú,6,17,,23,-74.77647900000001,10.886686
21311,2013,Octubre,Perú,10,41,,51,-72.129595,11.360028999999999
21312,2013,Octubre,Perú,129,98,,227,-81.70216500000001,12.5862
21313,2013,Octubre,Perú,117,199,,316,-76.532004,3.451668
21314,2013,Octubre,Perú,2879,3415,,6294,-74.140516,4.697157
21315,2013,Octubre,Perú,0,4,,4,-75.736374,4.815189
21316,2013,Octubre,Perú,241,404,,645,-75.42726,6.170465
21317,2013,Octubre,Perú,0,2,,2,-67.48402800000001,6.185536
21318,2013,Octubre,Perú,1,0,,1,-70.74025300000001,7.088728999999999
21319,2013,Octubre,Perú,7,8,,15,-73.181317,7.1280470000000005
21320,2013,Octubre,Perú,50,110,,160,-72.453013,7.819
21321,2013,Octubre,Perú,4,11,,15,-72.508188,7.927233
21322,2013,Octubre,Perú,0,1,,1,-77.35002,8.63337
21323,2013,Octubre,Palestina,3,3,,6,-74.140516,4.697157
21324,2013,Octubre,Polonia,2,1,,3,-69.941498,4.191162
21325,2013,Octubre,Polonia,2,5,,7,-77.35600000000001,0.81488
21326,2013,Octubre,Polonia,0,13,,13,-75.527794,10.406342
21327,2013,Octubre,Polonia,0,5,,5,-75.516486,10.446304
21328,2013,Octubre,Polonia,1,2,,3,-74.77647900000001,10.886686
21329,2013,Octubre,Polonia,1,2,,3,-76.532004,3.451668
21330,2013,Octubre,Polonia,75,87,,162,-74.140516,4.697157
21331,2013,Octubre,Polonia,3,5,,8,-75.42726,6.170465
21332,2013,Octubre,Polonia,2,0,,2,-67.48402800000001,6.185536
21333,2013,Octubre,Polonia,0,2,,2,-76.7333,8.06667
21334,2013,Octubre,Portugal,0,2,,2,-75.527794,10.406342
21335,2013,Octubre,Portugal,3,9,,12,-75.516486,10.446304
21336,2013,Octubre,Portugal,1,1,,2,-74.77647900000001,10.886686
21337,2013,Octubre,Portugal,1,2,,3,-72.129595,11.360028999999999
21338,2013,Octubre,Portugal,3,12,,15,-76.532004,3.451668
21339,2013,Octubre,Portugal,158,387,,545,-74.140516,4.697157
21340,2013,Octubre,Portugal,1,2,,3,-75.736374,4.815189
21341,2013,Octubre,Portugal,2,11,,13,-75.42726,6.170465
21342,2013,Octubre,Portugal,3,0,,3,-67.48402800000001,6.185536
21343,2013,Octubre,Portugal,0,5,,5,-72.453013,7.819
21344,2013,Octubre,Portugal,0,1,,1,-72.508188,7.927233
21345,2013,Octubre,Puerto Rico/Territorio de Estados Unidos,0,2,,2,-74.77647900000001,10.886686
21346,2013,Octubre,Qatar,0,4,,4,-74.140516,4.697157
21347,2013,Octubre,Qatar,0,1,,1,-75.42726,6.170465
21348,2013,Octubre,Reino Unido de Gran Bretaña e Irlanda del Norte,1,4,,5,-69.941498,4.191162
21349,2013,Octubre,Reino Unido de Gran Bretaña e Irlanda del Norte,20,28,,48,-77.35600000000001,0.81488
21350,2013,Octubre,Reino Unido de Gran Bretaña e Irlanda del Norte,3,7,,10,-75.527794,10.406342
21351,2013,Octubre,Reino Unido de Gran Bretaña e Irlanda del Norte,33,66,,99,-75.516486,10.446304
21352,2013,Octubre,Reino Unido de Gran Bretaña e Irlanda del Norte,3,9,,12,-74.77647900000001,10.886686
21353,2013,Octubre,Reino Unido de Gran Bretaña e Irlanda del Norte,5,7,,12,-72.129595,11.360028999999999
21354,2013,Octubre,Reino Unido de Gran Bretaña e Irlanda del Norte,16,39,,55,-76.532004,3.451668
21355,2013,Octubre,Reino Unido de Gran Bretaña e Irlanda del Norte,0,1,,1,-77.061029,3.8844260000000004
21356,2013,Octubre,Reino Unido de Gran Bretaña e Irlanda del Norte,2,0,,2,-75.76635300000001,4.45285
21357,2013,Octubre,Reino Unido de Gran Bretaña e Irlanda del Norte,454,1181,,1635,-74.140516,4.697157
21358,2013,Octubre,Reino Unido de Gran Bretaña e Irlanda del Norte,1,2,,3,-75.736374,4.815189
21359,2013,Octubre,Reino Unido de Gran Bretaña e Irlanda del Norte,35,83,,118,-75.42726,6.170465
21360,2013,Octubre,Reino Unido de Gran Bretaña e Irlanda del Norte,1,0,,1,-73.181317,7.1280470000000005
21361,2013,Octubre,Reino Unido de Gran Bretaña e Irlanda del Norte,1,0,,1,-72.453013,7.819
21362,2013,Octubre,República Dominicana,5,8,,13,-77.35600000000001,0.81488
21363,2013,Octubre,República Dominicana,2,3,,5,-75.527794,10.406342
21364,2013,Octubre,República Dominicana,28,43,,71,-75.516486,10.446304
21365,2013,Octubre,República Dominicana,11,12,,23,-74.77647900000001,10.886686
21366,2013,Octubre,República Dominicana,1,3,,4,-72.129595,11.360028999999999
21367,2013,Octubre,República Dominicana,19,25,,44,-76.532004,3.451668
21368,2013,Octubre,República Dominicana,223,327,,550,-74.140516,4.697157
21369,2013,Octubre,República Dominicana,4,3,,7,-75.736374,4.815189
21370,2013,Octubre,República Dominicana,25,36,,61,-75.42726,6.170465
21371,2013,Octubre,República Dominicana,1,0,,1,-77.762647,7.102626
21372,2013,Octubre,República Dominicana,0,3,,3,-73.181317,7.1280470000000005
21373,2013,Octubre,República Dominicana,0,1,,1,-72.453013,7.819
21374,2013,Octubre,República Dominicana,1,0,,1,-72.508188,7.927233
21375,2013,Octubre,República Checa,1,1,,2,-75.527794,10.406342
21376,2013,Octubre,Rumania,0,1,,1,-77.35600000000001,0.81488
21377,2013,Octubre,Rumania,2,2,,4,-75.527794,10.406342
21378,2013,Octubre,Rumania,1,2,,3,-75.516486,10.446304
21379,2013,Octubre,Rumania,0,3,,3,-74.765343,10.970933
21380,2013,Octubre,Rumania,1,1,,2,-72.129595,11.360028999999999
21381,2013,Octubre,Rumania,0,1,,1,-76.532004,3.451668
21382,2013,Octubre,Rumania,37,81,,118,-74.140516,4.697157
21383,2013,Octubre,Rumania,9,9,,18,-75.42726,6.170465
21384,2013,Octubre,Rumania,1,1,,2,-72.453013,7.819
21385,2013,Octubre,Federación de Rusia,11,11,,22,-77.35600000000001,0.81488
21386,2013,Octubre,Federación de Rusia,7,3,,10,-75.527794,10.406342
21387,2013,Octubre,Federación de Rusia,1,4,,5,-75.516486,10.446304
21388,2013,Octubre,Federación de Rusia,0,1,,1,-72.129595,11.360028999999999
21389,2013,Octubre,Federación de Rusia,1,2,,3,-76.532004,3.451668
21390,2013,Octubre,Federación de Rusia,0,1,,1,-77.061029,3.8844260000000004
21391,2013,Octubre,Federación de Rusia,1,0,,1,-75.76635300000001,4.45285
21392,2013,Octubre,Federación de Rusia,141,213,,354,-74.140516,4.697157
21393,2013,Octubre,Federación de Rusia,1,5,,6,-75.42726,6.170465
21394,2013,Octubre,Rwanda,0,3,,3,-74.140516,4.697157
21395,2013,Octubre,Sahara Occidental/Desierto Sahara,0,1,,1,-74.140516,4.697157
21396,2013,Octubre,San Cristóbal y Nevis,0,1,,1,-72.129595,11.360028999999999
21397,2013,Octubre,San Cristóbal y Nevis,0,1,,1,-74.140516,4.697157
21398,2013,Octubre,San Cristóbal y Nevis,1,1,,2,-75.42726,6.170465
21399,2013,Octubre,Samoa Occidental,1,0,,1,-74.140516,4.697157
21400,2013,Octubre,San Marino,1,0,,1,-74.140516,4.697157
21401,2013,Octubre,San  Vicente y las Granadinas,1,4,,5,-75.516486,10.446304
21402,2013,Octubre,San  Vicente y las Granadinas,0,1,,1,-74.140516,4.697157
21403,2013,Octubre,Santa Lucia,1,0,,1,-75.527794,10.406342
21404,2013,Octubre,Santa Lucia,2,1,,3,-74.140516,4.697157
21405,2013,Octubre,Santa Lucia,1,0,,1,-75.42726,6.170465
21406,2013,Octubre,Santa Sede/Ciudad del Vaticano,0,1,,1,-75.516486,10.446304
21407,2013,Octubre,Santa Sede/Ciudad del Vaticano,0,1,,1,-74.140516,4.697157
21408,2013,Octubre,Senegal,0,1,,1,-74.77647900000001,10.886686
21409,2013,Octubre,Senegal,0,3,,3,-74.140516,4.697157
21410,2013,Octubre,Serbia,0,1,,1,-75.527794,10.406342
21411,2013,Octubre,Serbia,6,15,,21,-74.140516,4.697157
21412,2013,Octubre,Sierra Leona,0,2,,2,-75.516486,10.446304
21413,2013,Octubre,Singapur,2,12,,14,-75.516486,10.446304
21414,2013,Octubre,Singapur,22,27,,49,-74.140516,4.697157
21415,2013,Octubre,Singapur,1,2,,3,-75.42726,6.170465
21416,2013,Octubre,República Árabe Siria,0,3,,3,-74.140516,4.697157
21417,2013,Octubre,Sri Lanka,1,0,,1,-76.532004,3.451668
21418,2013,Octubre,Sri Lanka,2,4,,6,-74.140516,4.697157
21419,2013,Octubre,Sri Lanka,0,1,,1,-75.42726,6.170465
21420,2013,Octubre,Sudáfrica,0,1,,1,-69.941498,4.191162
21421,2013,Octubre,Sudáfrica,3,4,,7,-77.35600000000001,0.81488
21422,2013,Octubre,Sudáfrica,2,3,,5,-75.527794,10.406342
21423,2013,Octubre,Sudáfrica,1,5,,6,-75.516486,10.446304
21424,2013,Octubre,Sudáfrica,0,1,,1,-74.77647900000001,10.886686
21425,2013,Octubre,Sudáfrica,0,5,,5,-76.532004,3.451668
21426,2013,Octubre,Sudáfrica,25,67,,92,-74.140516,4.697157
21427,2013,Octubre,Sudáfrica,0,1,,1,-75.42726,6.170465
21428,2013,Octubre,Sudáfrica,1,0,,1,-72.453013,7.819
21429,2013,Octubre,Sudán,0,6,,6,-75.516486,10.446304
21430,2013,Octubre,Sudán,0,10,,10,-74.140516,4.697157
21431,2013,Octubre,Suecia,4,0,,4,-69.941498,4.191162
21432,2013,Octubre,Suecia,3,5,,8,-77.35600000000001,0.81488
21433,2013,Octubre,Suecia,4,6,,10,-75.527794,10.406342
21434,2013,Octubre,Suecia,8,15,,23,-75.516486,10.446304
21435,2013,Octubre,Suecia,2,2,,4,-74.213989,11.247722999999999
21436,2013,Octubre,Suecia,9,8,,17,-76.532004,3.451668
21437,2013,Octubre,Suecia,100,209,,309,-74.140516,4.697157
21438,2013,Octubre,Suecia,0,1,,1,-75.736374,4.815189
21439,2013,Octubre,Suecia,5,17,,22,-75.42726,6.170465
21440,2013,Octubre,Suecia,0,2,,2,-73.181317,7.1280470000000005
21441,2013,Octubre,Suecia,5,5,,10,-72.453013,7.819
21442,2013,Octubre,Suiza,9,11,,20,-69.941498,4.191162
21443,2013,Octubre,Suiza,16,18,,34,-77.35600000000001,0.81488
21444,2013,Octubre,Suiza,13,12,,25,-75.527794,10.406342
21445,2013,Octubre,Suiza,13,21,,34,-75.516486,10.446304
21446,2013,Octubre,Suiza,6,8,,14,-74.77647900000001,10.886686
21447,2013,Octubre,Suiza,2,3,,5,-72.129595,11.360028999999999
21448,2013,Octubre,Suiza,18,29,,47,-76.532004,3.451668
21449,2013,Octubre,Suiza,266,502,,768,-74.140516,4.697157
21450,2013,Octubre,Suiza,0,1,,1,-75.736374,4.815189
21451,2013,Octubre,Suiza,27,41,,68,-75.42726,6.170465
21452,2013,Octubre,Suiza,2,3,,5,-72.453013,7.819
21453,2013,Octubre,Surinam,0,2,,2,-76.532004,3.451668
21454,2013,Octubre,Surinam,10,17,,27,-74.140516,4.697157
21455,2013,Octubre,Surinam,0,10,,10,-75.42726,6.170465
21456,2013,Octubre,Suazilandia,1,1,,2,-75.516486,10.446304
21457,2013,Octubre,Taiwán,3,1,,4,-75.516486,10.446304
21458,2013,Octubre,Taiwán,0,3,,3,-74.77647900000001,10.886686
21459,2013,Octubre,Taiwán,0,1,,1,-72.129595,11.360028999999999
21460,2013,Octubre,Taiwán,1,3,,4,-76.532004,3.451668
21461,2013,Octubre,Taiwán,34,56,,90,-74.140516,4.697157
21462,2013,Octubre,Taiwán,0,2,,2,-75.736374,4.815189
21463,2013,Octubre,Taiwán,2,11,,13,-75.42726,6.170465
21464,2013,Octubre,Tailandia,2,3,,5,-75.516486,10.446304
21465,2013,Octubre,Tailandia,5,5,,10,-74.140516,4.697157
21466,2013,Octubre,Tailandia,1,0,,1,-75.42726,6.170465
21467,2013,Octubre,Tíbet/Región Autónoma de China,1,0,,1,-74.140516,4.697157
21468,2013,Octubre,Territorio Antártico Británico/Territorio Británico de Ultramar,0,2,,2,-74.140516,4.697157
21469,2013,Octubre,Tanzania,1,4,,5,-75.516486,10.446304
21470,2013,Octubre,Tanzania,2,0,,2,-74.140516,4.697157
21471,2013,Octubre,Togo,0,1,,1,-74.140516,4.697157
21472,2013,Octubre,Trinidad y Tobago,5,11,,16,-75.516486,10.446304
21473,2013,Octubre,Trinidad y Tobago,1,0,,1,-74.77647900000001,10.886686
21474,2013,Octubre,Trinidad y Tobago,0,1,,1,-74.213989,11.247722999999999
21475,2013,Octubre,Trinidad y Tobago,0,1,,1,-72.129595,11.360028999999999
21476,2013,Octubre,Trinidad y Tobago,0,27,,27,-76.532004,3.451668
21477,2013,Octubre,Trinidad y Tobago,43,51,,94,-74.140516,4.697157
21478,2013,Octubre,Trinidad y Tobago,1,4,,5,-75.42726,6.170465
21479,2013,Octubre,Trinidad y Tobago,5,7,,12,-73.181317,7.1280470000000005
21480,2013,Octubre,Trinidad y Tobago,0,1,,1,-72.508188,7.927233
21481,2013,Octubre,Túnez,0,2,,2,-74.140516,4.697157
21482,2013,Octubre,Turquía,0,1,,1,-77.35600000000001,0.81488
21483,2013,Octubre,Turquía,0,5,,5,-75.527794,10.406342
21484,2013,Octubre,Turquía,1,5,,6,-75.516486,10.446304
21485,2013,Octubre,Turquía,1,0,,1,-74.77647900000001,10.886686
21486,2013,Octubre,Turquía,6,4,,10,-76.532004,3.451668
21487,2013,Octubre,Turquía,0,1,,1,-77.061029,3.8844260000000004
21488,2013,Octubre,Turquía,32,86,,118,-74.140516,4.697157
21489,2013,Octubre,Turquía,1,3,,4,-75.42726,6.170465
21490,2013,Octubre,Turquía,0,2,,2,-72.453013,7.819
21491,2013,Octubre,Turquía,0,1,,1,-75.68164200000001,9.402597
21492,2013,Octubre,Turkmenistán,0,3,,3,-74.140516,4.697157
21493,2013,Octubre,Ucrania,0,3,,3,-74.765343,10.970933
21494,2013,Octubre,Ucrania,24,24,,48,-74.140516,4.697157
21495,2013,Octubre,Ucrania,0,1,,1,-75.42726,6.170465
21496,2013,Octubre,Ucrania,1,0,,1,-72.508188,7.927233
21497,2013,Octubre,Uganda,1,1,,2,-75.516486,10.446304
21498,2013,Octubre,Uganda,2,8,,10,-74.140516,4.697157
21499,2013,Octubre,Federación de Rusia,0,2,,2,-75.527794,10.406342
21500,2013,Octubre,Federación de Rusia,0,1,,1,-74.765343,10.970933
21501,2013,Octubre,Federación de Rusia,23,9,,32,-74.140516,4.697157
21502,2013,Octubre,Federación de Rusia,0,2,,2,-72.453013,7.819
21503,2013,Octubre,Federación de Rusia,0,2,,2,-75.68164200000001,9.402597
21504,2013,Octubre,Uruguay,3,3,,6,-77.35600000000001,0.81488
21505,2013,Octubre,Uruguay,1,2,,3,-75.527794,10.406342
21506,2013,Octubre,Uruguay,76,66,,142,-75.516486,10.446304
21507,2013,Octubre,Uruguay,2,5,,7,-74.77647900000001,10.886686
21508,2013,Octubre,Uruguay,2,0,,2,-72.129595,11.360028999999999
21509,2013,Octubre,Uruguay,26,19,,45,-81.70216500000001,12.5862
21510,2013,Octubre,Uruguay,13,29,,42,-76.532004,3.451668
21511,2013,Octubre,Uruguay,148,316,,464,-74.140516,4.697157
21512,2013,Octubre,Uruguay,0,4,,4,-75.736374,4.815189
21513,2013,Octubre,Uruguay,18,30,,48,-75.42726,6.170465
21514,2013,Octubre,Uruguay,2,2,,4,-72.453013,7.819
21515,2013,Octubre,Uruguay,0,5,,5,-72.508188,7.927233
21516,2013,Octubre,Uzbekistán,1,0,,1,-74.140516,4.697157
21517,2013,Octubre,Venezuela,0,2,,2,-69.941498,4.191162
21518,2013,Octubre,Venezuela,1,3,,4,-76.876446,0.33002
21519,2013,Octubre,Venezuela,214,252,,466,-77.35600000000001,0.81488
21520,2013,Octubre,Venezuela,7,26,,33,-75.527794,10.406342
21521,2013,Octubre,Venezuela,59,122,,181,-75.516486,10.446304
21522,2013,Octubre,Venezuela,33,86,,119,-74.77647900000001,10.886686
21523,2013,Octubre,Venezuela,0,1,,1,-74.765343,10.970933
21524,2013,Octubre,Venezuela,1208,1953,,3161,-72.129595,11.360028999999999
21525,2013,Octubre,Venezuela,0,2,,2,-72.919186,11.52863
21526,2013,Octubre,Venezuela,2,5,,7,-81.70216500000001,12.5862
21527,2013,Octubre,Venezuela,67,87,,154,-76.532004,3.451668
21528,2013,Octubre,Venezuela,0,1,,1,-75.76635300000001,4.45285
21529,2013,Octubre,Venezuela,5535,6683,,12218,-74.140516,4.697157
21530,2013,Octubre,Venezuela,1,10,,11,-75.736374,4.815189
21531,2013,Octubre,Venezuela,583,579,,1162,-75.42726,6.170465
21532,2013,Octubre,Venezuela,17,81,,98,-67.48402800000001,6.185536
21533,2013,Octubre,Venezuela,119,159,,278,-70.74025300000001,7.088728999999999
21534,2013,Octubre,Venezuela,2,7,,9,-73.181317,7.1280470000000005
21535,2013,Octubre,Venezuela,1749,2071,,3820,-72.453013,7.819
21536,2013,Octubre,Venezuela,248,326,,574,-72.508188,7.927233
21537,2013,Octubre,Vietnam,1,0,,1,-75.516486,10.446304
21538,2013,Octubre,Vietnam,1,0,,1,-76.532004,3.451668
21539,2013,Octubre,Vietnam,1,8,,9,-74.140516,4.697157
21540,2013,Octubre,República Árabe de Yemen,0,1,,1,-75.516486,10.446304
21541,2013,Octubre,Zambia,3,2,,5,-75.516486,10.446304
21542,2013,Octubre,Zambia,0,1,,1,-74.140516,4.697157
21543,2013,Octubre,Zimbabue,2,2,,4,-75.516486,10.446304
21544,2013,Octubre,Zimbabue,1,3,,4,-74.140516,4.697157
21545,2013,Octubre,Islas Turcas y Caicos/Territorio Británico de Ultramar,0,1,,1,-75.516486,10.446304
21546,2013,Octubre,Islas Turcas y Caicos/Territorio Británico de Ultramar,1,1,,2,-74.140516,4.697157
21547,2013,Octubre,Reino Unido de Gran Bretaña e Irlanda del Norte,5,6,,11,-69.941498,4.191162
21548,2013,Octubre,Reino Unido de Gran Bretaña e Irlanda del Norte,3,8,,11,-77.35600000000001,0.81488
21549,2013,Octubre,Reino Unido de Gran Bretaña e Irlanda del Norte,7,20,,27,-75.527794,10.406342
21550,2013,Octubre,Reino Unido de Gran Bretaña e Irlanda del Norte,0,1,,1,-74.213989,11.247722999999999
21551,2013,Octubre,Reino Unido de Gran Bretaña e Irlanda del Norte,0,4,,4,-76.532004,3.451668
21552,2013,Octubre,Reino Unido de Gran Bretaña e Irlanda del Norte,0,1,,1,-77.061029,3.8844260000000004
21553,2013,Octubre,Reino Unido de Gran Bretaña e Irlanda del Norte,15,51,,66,-74.140516,4.697157
21554,2013,Octubre,Reino Unido de Gran Bretaña e Irlanda del Norte,0,2,,2,-75.42726,6.170465
21555,2013,Octubre,Reino Unido de Gran Bretaña e Irlanda del Norte,3,1,,4,-72.453013,7.819
21556,2013,Octubre,Países Bajos,0,1,,1,-69.941498,4.191162
21557,2013,Octubre,Países Bajos,2,2,,4,-77.35600000000001,0.81488
21558,2013,Octubre,Países Bajos,13,26,,39,-75.527794,10.406342
21559,2013,Octubre,Países Bajos,1,4,,5,-75.516486,10.446304
21560,2013,Octubre,Países Bajos,0,2,,2,-74.77647900000001,10.886686
21561,2013,Octubre,Países Bajos,1,0,,1,-81.70216500000001,12.5862
21562,2013,Octubre,Países Bajos,6,7,,13,-76.532004,3.451668
21563,2013,Octubre,Países Bajos,71,103,,174,-74.140516,4.697157
21564,2013,Octubre,Países Bajos,17,21,,38,-75.42726,6.170465
21565,2013,Octubre,Países Bajos,0,1,,1,-73.181317,7.1280470000000005
21566,2013,Octubre,Países Bajos,4,6,,10,-72.453013,7.819
21567,2013,Octubre,Países Bajos,0,1,,1,-72.508188,7.927233
21568,2013,Octubre,Lituania,1,0,,1,-72.453013,7.819
21569,2013,Octubre,Reino Unido de Gran Bretaña e Irlanda del Norte,0,4,,4,-74.213989,11.247722999999999
21570,2013,Octubre,Reino Unido de Gran Bretaña e Irlanda del Norte,0,2,,2,-74.77647900000001,10.886686
21571,2013,Octubre,Reino Unido de Gran Bretaña e Irlanda del Norte,5,5,,10,-75.527794,10.406342
21572,2013,Octubre,Letonia,0,1,,1,-75.527794,10.406342
21573,2013,Octubre,Desconocido,2,1,,3,-75.516486,10.446304
21574,2013,Octubre,Desconocido,1,1,,2,-76.532004,3.451668
21575,2013,Octubre,Desconocido,36,65,,101,-74.140516,4.697157
21576,2013,Octubre,Desconocido,7,3,,10,-75.42726,6.170465
21577,2013,Octubre,República CentroÁfricana,0,1,,1,-74.140516,4.697157
21578,2013,Noviembre,Afganistán,0,1,,1,-74.140516,4.697157
21579,2013,Noviembre,Albania,0,2,,2,-74.140516,4.697157
21580,2013,Noviembre,Albania,0,1,,1,-72.453013,7.819
21581,2013,Noviembre,Alemania,9,19,,28,-69.941498,4.191162
21582,2013,Noviembre,Alemania,28,32,,60,-77.35600000000001,0.81488
21583,2013,Noviembre,Alemania,22,28,,50,-75.527794,10.406342
21584,2013,Noviembre,Alemania,12,44,,56,-75.516486,10.446304
21585,2013,Noviembre,Alemania,7,13,,20,-74.77647900000001,10.886686
21586,2013,Noviembre,Alemania,3,4,,7,-74.213989,11.247722999999999
21587,2013,Noviembre,Alemania,6,7,,13,-72.129595,11.360028999999999
21588,2013,Noviembre,Alemania,2,10,,12,-81.70216500000001,12.5862
21589,2013,Noviembre,Alemania,1,3,,4,-81.372937,13.338761300000002
21590,2013,Noviembre,Alemania,27,49,,76,-76.532004,3.451668
21591,2013,Noviembre,Alemania,1215,2143,,3358,-74.140516,4.697157
21592,2013,Noviembre,Alemania,1,2,,3,-75.736374,4.815189
21593,2013,Noviembre,Alemania,40,100,,140,-75.42726,6.170465
21594,2013,Noviembre,Alemania,0,3,,3,-73.181317,7.1280470000000005
21595,2013,Noviembre,Alemania,8,10,,18,-72.453013,7.819
21596,2013,Noviembre,Andorra,0,7,,7,-74.140516,4.697157
21597,2013,Noviembre,Andorra,0,1,,1,-75.42726,6.170465
21598,2013,Noviembre,Angola,3,1,,4,-74.140516,4.697157
21599,2013,Noviembre,Antigua y Barbuda,1,1,,2,-74.140516,4.697157
21600,2013,Noviembre,Antigua y Barbuda,0,3,,3,-75.42726,6.170465
21601,2013,Noviembre,Países Bajos,1,0,,1,-74.140516,4.697157
21602,2013,Noviembre,Arabia Saudita,0,6,,6,-74.140516,4.697157
21603,2013,Noviembre,Argelia,1,3,,4,-74.140516,4.697157
21604,2013,Noviembre,Argelia,0,1,,1,-75.42726,6.170465
21605,2013,Noviembre,Argentina,2,3,,5,-69.941498,4.191162
21606,2013,Noviembre,Argentina,1,2,,3,-76.876446,0.33002
21607,2013,Noviembre,Argentina,54,93,,147,-77.35600000000001,0.81488
21608,2013,Noviembre,Argentina,1,1,,2,-78.802679,18.00143
21609,2013,Noviembre,Argentina,190,154,,344,-75.527794,10.406342
21610,2013,Noviembre,Argentina,870,641,,1511,-75.516486,10.446304
21611,2013,Noviembre,Argentina,14,39,,53,-74.77647900000001,10.886686
21612,2013,Noviembre,Argentina,1,3,,4,-74.213989,11.247722999999999
21613,2013,Noviembre,Argentina,11,23,,34,-72.129595,11.360028999999999
21614,2013,Noviembre,Argentina,194,138,,332,-81.70216500000001,12.5862
21615,2013,Noviembre,Argentina,65,90,,155,-76.532004,3.451668
21616,2013,Noviembre,Argentina,2994,4927,,7921,-74.140516,4.697157
21617,2013,Noviembre,Argentina,4,6,,10,-75.736374,4.815189
21618,2013,Noviembre,Argentina,107,251,,358,-75.42726,6.170465
21619,2013,Noviembre,Argentina,12,37,,49,-72.453013,7.819
21620,2013,Noviembre,Argentina,0,8,,8,-72.508188,7.927233
21621,2013,Noviembre,República de Armenia,1,1,,2,-74.140516,4.697157
21622,2013,Noviembre,Aruba,0,1,,1,-74.140516,4.697157
21623,2013,Noviembre,Australia,6,5,,11,-69.941498,4.191162
21624,2013,Noviembre,Australia,27,35,,62,-77.35600000000001,0.81488
21625,2013,Noviembre,Australia,30,40,,70,-75.527794,10.406342
21626,2013,Noviembre,Australia,18,28,,46,-75.516486,10.446304
21627,2013,Noviembre,Australia,2,16,,18,-74.77647900000001,10.886686
21628,2013,Noviembre,Australia,2,1,,3,-74.213989,11.247722999999999
21629,2013,Noviembre,Australia,3,0,,3,-72.129595,11.360028999999999
21630,2013,Noviembre,Australia,3,1,,4,-81.70216500000001,12.5862
21631,2013,Noviembre,Australia,1,3,,4,-81.372937,13.338761300000002
21632,2013,Noviembre,Australia,13,17,,30,-76.532004,3.451668
21633,2013,Noviembre,Australia,1,1,,2,-75.76635300000001,4.45285
21634,2013,Noviembre,Australia,272,388,,660,-74.140516,4.697157
21635,2013,Noviembre,Australia,0,5,,5,-75.736374,4.815189
21636,2013,Noviembre,Australia,31,63,,94,-75.42726,6.170465
21637,2013,Noviembre,Australia,0,1,,1,-73.181317,7.1280470000000005
21638,2013,Noviembre,Australia,0,4,,4,-72.453013,7.819
21639,2013,Noviembre,Australia,3,3,,6,-77.35002,8.63337
21640,2013,Noviembre,Austria,3,1,,4,-69.941498,4.191162
21641,2013,Noviembre,Austria,7,6,,13,-77.35600000000001,0.81488
21642,2013,Noviembre,Austria,6,4,,10,-75.527794,10.406342
21643,2013,Noviembre,Austria,8,16,,24,-75.516486,10.446304
21644,2013,Noviembre,Austria,0,3,,3,-74.77647900000001,10.886686
21645,2013,Noviembre,Austria,0,1,,1,-72.129595,11.360028999999999
21646,2013,Noviembre,Austria,0,1,,1,-81.70216500000001,12.5862
21647,2013,Noviembre,Austria,1,6,,7,-76.532004,3.451668
21648,2013,Noviembre,Austria,104,205,,309,-74.140516,4.697157
21649,2013,Noviembre,Austria,1,10,,11,-75.42726,6.170465
21650,2013,Noviembre,Austria,0,2,,2,-73.181317,7.1280470000000005
21651,2013,Noviembre,Austria,1,1,,2,-72.453013,7.819
21652,2013,Noviembre,Azerbaiyán,0,2,,2,-74.140516,4.697157
21653,2013,Noviembre,Bahamas,0,1,,1,-75.516486,10.446304
21654,2013,Noviembre,Bahamas,0,1,,1,-74.765343,10.970933
21655,2013,Noviembre,Bahamas,0,1,,1,-72.129595,11.360028999999999
21656,2013,Noviembre,Bahamas,1,0,,1,-81.703935,12.574411099999999
21657,2013,Noviembre,Bahamas,3,2,,5,-76.532004,3.451668
21658,2013,Noviembre,Bahamas,0,4,,4,-74.140516,4.697157
21659,2013,Noviembre,Bahamas,4,5,,9,-75.42726,6.170465
21660,2013,Noviembre,Bahréin,1,1,,2,-74.140516,4.697157
21661,2013,Noviembre,Bangladesh,0,1,,1,-74.140516,4.697157
21662,2013,Noviembre,Barbados,0,1,,1,-76.532004,3.451668
21663,2013,Noviembre,Barbados,2,2,,4,-74.140516,4.697157
21664,2013,Noviembre,Barbados,3,3,,6,-75.42726,6.170465
21665,2013,Noviembre,Barbados,0,1,,1,-72.453013,7.819
21666,2013,Noviembre,República de Belarús,1,0,,1,-77.35600000000001,0.81488
21667,2013,Noviembre,República de Belarús,1,0,,1,-75.42726,6.170465
21668,2013,Noviembre,Bélgica,1,1,,2,-69.941498,4.191162
21669,2013,Noviembre,Bélgica,8,6,,14,-77.35600000000001,0.81488
21670,2013,Noviembre,Bélgica,1,2,,3,-75.527794,10.406342
21671,2013,Noviembre,Bélgica,1,10,,11,-75.516486,10.446304
21672,2013,Noviembre,Bélgica,0,1,,1,-74.213989,11.247722999999999
21673,2013,Noviembre,Bélgica,1,0,,1,-72.129595,11.360028999999999
21674,2013,Noviembre,Bélgica,0,1,,1,-81.70216500000001,12.5862
21675,2013,Noviembre,Bélgica,11,35,,46,-76.532004,3.451668
21676,2013,Noviembre,Bélgica,121,335,,456,-74.140516,4.697157
21677,2013,Noviembre,Bélgica,5,23,,28,-75.42726,6.170465
21678,2013,Noviembre,Bélgica,3,2,,5,-72.453013,7.819
21679,2013,Noviembre,Belice,0,1,,1,-75.516486,10.446304
21680,2013,Noviembre,Belice,0,1,,1,-81.70216500000001,12.5862
21681,2013,Noviembre,Belice,1,2,,3,-76.532004,3.451668
21682,2013,Noviembre,Belice,3,10,,13,-74.140516,4.697157
21683,2013,Noviembre,Belice,0,1,,1,-75.736374,4.815189
21684,2013,Noviembre,Belice,2,4,,6,-75.42726,6.170465
21685,2013,Noviembre,Bermudas/Territorio Británico de Ultramar,0,1,,1,-75.516486,10.446304
21686,2013,Noviembre,Bermudas/Territorio Británico de Ultramar,0,1,,1,-76.532004,3.451668
21687,2013,Noviembre,Bermudas/Territorio Británico de Ultramar,0,2,,2,-74.140516,4.697157
21688,2013,Noviembre,Bolivia,20,14,,34,-77.35600000000001,0.81488
21689,2013,Noviembre,Bolivia,1,0,,1,-75.527794,10.406342
21690,2013,Noviembre,Bolivia,30,38,,68,-75.516486,10.446304
21691,2013,Noviembre,Bolivia,0,3,,3,-74.77647900000001,10.886686
21692,2013,Noviembre,Bolivia,1,2,,3,-72.129595,11.360028999999999
21693,2013,Noviembre,Bolivia,4,41,,45,-81.70216500000001,12.5862
21694,2013,Noviembre,Bolivia,24,40,,64,-76.532004,3.451668
21695,2013,Noviembre,Bolivia,442,621,,1063,-74.140516,4.697157
21696,2013,Noviembre,Bolivia,1,3,,4,-75.736374,4.815189
21697,2013,Noviembre,Bolivia,34,29,,63,-75.42726,6.170465
21698,2013,Noviembre,Bolivia,0,1,,1,-67.48402800000001,6.185536
21699,2013,Noviembre,Bolivia,4,10,,14,-72.453013,7.819
21700,2013,Noviembre,Bolivia,0,2,,2,-72.508188,7.927233
21701,2013,Noviembre,Bolivia,0,1,,1,-77.35002,8.63337
21702,2013,Noviembre,Bosnia y Herzegovina,2,0,,2,-74.140516,4.697157
21703,2013,Noviembre,Brasil,61,78,,139,-69.941498,4.191162
21704,2013,Noviembre,Brasil,12,21,,33,-77.35600000000001,0.81488
21705,2013,Noviembre,Brasil,114,94,,208,-75.527794,10.406342
21706,2013,Noviembre,Brasil,255,219,,474,-75.516486,10.446304
21707,2013,Noviembre,Brasil,15,24,,39,-74.77647900000001,10.886686
21708,2013,Noviembre,Brasil,5,17,,22,-72.129595,11.360028999999999
21709,2013,Noviembre,Brasil,24,8,,32,-81.70216500000001,12.5862
21710,2013,Noviembre,Brasil,46,112,,158,-76.532004,3.451668
21711,2013,Noviembre,Brasil,3040,4562,,7602,-74.140516,4.697157
21712,2013,Noviembre,Brasil,6,5,,11,-75.736374,4.815189
21713,2013,Noviembre,Brasil,82,232,,314,-75.42726,6.170465
21714,2013,Noviembre,Brasil,1,5,,6,-73.181317,7.1280470000000005
21715,2013,Noviembre,Brasil,12,14,,26,-72.453013,7.819
21716,2013,Noviembre,Brasil,3,4,,7,-72.508188,7.927233
21717,2013,Noviembre,Brasil,0,1,,1,-77.35002,8.63337
21718,2013,Noviembre,Bulgaria,0,1,,1,-77.35600000000001,0.81488
21719,2013,Noviembre,Bulgaria,0,1,,1,-74.213989,11.247722999999999
21720,2013,Noviembre,Bulgaria,0,1,,1,-76.532004,3.451668
21721,2013,Noviembre,Bulgaria,13,12,,25,-74.140516,4.697157
21722,2013,Noviembre,Bulgaria,1,2,,3,-75.42726,6.170465
21723,2013,Noviembre,Bulgaria,1,0,,1,-77.35002,8.63337
21724,2013,Noviembre,Burkina Faso,0,2,,2,-74.140516,4.697157
21725,2013,Noviembre,Burundi,1,0,,1,-76.532004,3.451668
21726,2013,Noviembre,Bután,0,1,,1,-74.140516,4.697157
21727,2013,Noviembre,Islas Caimán/Territorio Británico de Ultramar,1,0,,1,-74.77647900000001,10.886686
21728,2013,Noviembre,Islas Caimán/Territorio Británico de Ultramar,1,0,,1,-81.70216500000001,12.5862
21729,2013,Noviembre,Islas Caimán/Territorio Británico de Ultramar,1,0,,1,-74.140516,4.697157
21730,2013,Noviembre,Islas Caimán/Territorio Británico de Ultramar,0,1,,1,-75.42726,6.170465
21731,2013,Noviembre,Camboya,0,2,,2,-74.140516,4.697157
21732,2013,Noviembre,Antártida,0,1,,1,-74.140516,4.697157
21733,2013,Noviembre,Camerún,1,1,,2,-74.140516,4.697157
21734,2013,Noviembre,Canadá,1,1,,2,-69.941498,4.191162
21735,2013,Noviembre,Canadá,14,24,,38,-77.35600000000001,0.81488
21736,2013,Noviembre,Canadá,13,20,,33,-75.527794,10.406342
21737,2013,Noviembre,Canadá,144,187,,331,-75.516486,10.446304
21738,2013,Noviembre,Canadá,6,17,,23,-74.77647900000001,10.886686
21739,2013,Noviembre,Canadá,1,10,,11,-74.765343,10.970933
21740,2013,Noviembre,Canadá,1,1,,2,-74.213989,11.247722999999999
21741,2013,Noviembre,Canadá,2,5,,7,-72.129595,11.360028999999999
21742,2013,Noviembre,Canadá,4,3,,7,-81.70216500000001,12.5862
21743,2013,Noviembre,Canadá,2,1,,3,-81.372937,13.338761300000002
21744,2013,Noviembre,Canadá,32,63,,95,-76.532004,3.451668
21745,2013,Noviembre,Canadá,1,5,,6,-75.76635300000001,4.45285
21746,2013,Noviembre,Canadá,722,1508,,2230,-74.140516,4.697157
21747,2013,Noviembre,Canadá,5,7,,12,-75.736374,4.815189
21748,2013,Noviembre,Canadá,75,173,,248,-75.42726,6.170465
21749,2013,Noviembre,Canadá,3,3,,6,-73.181317,7.1280470000000005
21750,2013,Noviembre,Canadá,2,10,,12,-72.453013,7.819
21751,2013,Noviembre,Canadá,1,1,,2,-72.508188,7.927233
21752,2013,Noviembre,España,0,1,,1,-70.74025300000001,7.088728999999999
21753,2013,Noviembre,España,1,5,,6,-72.453013,7.819
21754,2013,Noviembre,República Democrática del Congo,2,1,,3,-74.140516,4.697157
21755,2013,Noviembre,República de Corea,3,1,,4,-69.941498,4.191162
21756,2013,Noviembre,República de Corea,3,5,,8,-77.35600000000001,0.81488
21757,2013,Noviembre,República de Corea,0,1,,1,-78.802679,18.00143
21758,2013,Noviembre,República de Corea,0,3,,3,-75.527794,10.406342
21759,2013,Noviembre,República de Corea,2,5,,7,-75.516486,10.446304
21760,2013,Noviembre,República de Corea,5,10,,15,-76.532004,3.451668
21761,2013,Noviembre,República de Corea,157,448,,605,-74.140516,4.697157
21762,2013,Noviembre,República de Corea,1,4,,5,-75.736374,4.815189
21763,2013,Noviembre,República de Corea,3,22,,25,-75.42726,6.170465
21764,2013,Noviembre,República de Corea,1,2,,3,-73.181317,7.1280470000000005
21765,2013,Noviembre,República de Corea,0,7,,7,-72.453013,7.819
21766,2013,Noviembre,Costa de Marfil,0,7,,7,-74.140516,4.697157
21767,2013,Noviembre,Costa Rica,0,1,,1,-69.941498,4.191162
21768,2013,Noviembre,Costa Rica,0,2,,2,-77.35600000000001,0.81488
21769,2013,Noviembre,Costa Rica,0,6,,6,-75.527794,10.406342
21770,2013,Noviembre,Costa Rica,48,45,,93,-75.516486,10.446304
21771,2013,Noviembre,Costa Rica,14,21,,35,-74.77647900000001,10.886686
21772,2013,Noviembre,Costa Rica,1,4,,5,-72.129595,11.360028999999999
21773,2013,Noviembre,Costa Rica,10,8,,18,-81.70216500000001,12.5862
21774,2013,Noviembre,Costa Rica,19,45,,64,-76.532004,3.451668
21775,2013,Noviembre,Costa Rica,1,0,,1,-75.76635300000001,4.45285
21776,2013,Noviembre,Costa Rica,531,906,,1437,-74.140516,4.697157
21777,2013,Noviembre,Costa Rica,5,0,,5,-75.736374,4.815189
21778,2013,Noviembre,Costa Rica,97,205,,302,-75.42726,6.170465
21779,2013,Noviembre,Costa Rica,1,1,,2,-73.181317,7.1280470000000005
21780,2013,Noviembre,Costa Rica,5,1,,6,-72.453013,7.819
21781,2013,Noviembre,Costa Rica,0,1,,1,-72.508188,7.927233
21782,2013,Noviembre,Costa Rica,0,1,,1,-77.35002,8.63337
21783,2013,Noviembre,Croacia,0,1,,1,-69.941498,4.191162
21784,2013,Noviembre,Croacia,0,2,,2,-77.35600000000001,0.81488
21785,2013,Noviembre,Croacia,0,1,,1,-75.527794,10.406342
21786,2013,Noviembre,Croacia,0,1,,1,-75.516486,10.446304
21787,2013,Noviembre,Croacia,0,4,,4,-74.765343,10.970933
21788,2013,Noviembre,Croacia,0,1,,1,-76.532004,3.451668
21789,2013,Noviembre,Croacia,0,34,,34,-74.140516,4.697157
21790,2013,Noviembre,Croacia,1,0,,1,-77.35002,8.63337
21791,2013,Noviembre,Croacia,0,2,,2,-75.68164200000001,9.402597
21792,2013,Noviembre,Cuba,2,0,,2,-69.941498,4.191162
21793,2013,Noviembre,Cuba,0,3,,3,-77.35600000000001,0.81488
21794,2013,Noviembre,Cuba,0,1,,1,-75.527794,10.406342
21795,2013,Noviembre,Cuba,1,8,,9,-75.516486,10.446304
21796,2013,Noviembre,Cuba,6,8,,14,-74.77647900000001,10.886686
21797,2013,Noviembre,Cuba,0,1,,1,-72.129595,11.360028999999999
21798,2013,Noviembre,Cuba,16,36,,52,-76.532004,3.451668
21799,2013,Noviembre,Cuba,0,1,,1,-75.76635300000001,4.45285
21800,2013,Noviembre,Cuba,84,166,,250,-74.140516,4.697157
21801,2013,Noviembre,Cuba,1,1,,2,-75.736374,4.815189
21802,2013,Noviembre,Cuba,17,33,,50,-75.42726,6.170465
21803,2013,Noviembre,Cuba,1,1,,2,-73.181317,7.1280470000000005
21804,2013,Noviembre,Cuba,2,3,,5,-72.453013,7.819
21805,2013,Noviembre,Cuba,0,3,,3,-72.508188,7.927233
21806,2013,Noviembre,Curazao,0,1,,1,-74.140516,4.697157
21807,2013,Noviembre,República Checa,2,1,,3,-77.35600000000001,0.81488
21808,2013,Noviembre,República Checa,0,1,,1,-75.527794,10.406342
21809,2013,Noviembre,República Checa,0,2,,2,-75.516486,10.446304
21810,2013,Noviembre,República Checa,1,0,,1,-74.77647900000001,10.886686
21811,2013,Noviembre,República Checa,1,1,,2,-72.129595,11.360028999999999
21812,2013,Noviembre,República Checa,0,2,,2,-76.532004,3.451668
21813,2013,Noviembre,República Checa,52,67,,119,-74.140516,4.697157
21814,2013,Noviembre,República Checa,1,3,,4,-75.42726,6.170465
21815,2013,Noviembre,República Checa,0,1,,1,-77.35002,8.63337
21816,2013,Noviembre,Chile,1,5,,6,-69.941498,4.191162
21817,2013,Noviembre,Chile,1,2,,3,-76.876446,0.33002
21818,2013,Noviembre,Chile,28,51,,79,-77.35600000000001,0.81488
21819,2013,Noviembre,Chile,0,2,,2,-78.802679,18.00143
21820,2013,Noviembre,Chile,121,80,,201,-75.527794,10.406342
21821,2013,Noviembre,Chile,48,35,,83,-75.516486,10.446304
21822,2013,Noviembre,Chile,8,20,,28,-74.77647900000001,10.886686
21823,2013,Noviembre,Chile,0,2,,2,-74.765343,10.970933
21824,2013,Noviembre,Chile,0,1,,1,-74.213989,11.247722999999999
21825,2013,Noviembre,Chile,5,5,,10,-72.129595,11.360028999999999
21826,2013,Noviembre,Chile,20,16,,36,-81.70216500000001,12.5862
21827,2013,Noviembre,Chile,43,84,,127,-76.532004,3.451668
21828,2013,Noviembre,Chile,2361,3695,,6056,-74.140516,4.697157
21829,2013,Noviembre,Chile,1,1,,2,-75.736374,4.815189
21830,2013,Noviembre,Chile,33,125,,158,-75.42726,6.170465
21831,2013,Noviembre,Chile,0,5,,5,-70.74025300000001,7.088728999999999
21832,2013,Noviembre,Chile,2,0,,2,-73.181317,7.1280470000000005
21833,2013,Noviembre,Chile,9,21,,30,-72.453013,7.819
21834,2013,Noviembre,Chile,2,6,,8,-72.508188,7.927233
21835,2013,Noviembre,Chile,1,2,,3,-77.35002,8.63337
21836,2013,Noviembre,China,1,1,,2,-77.35600000000001,0.81488
21837,2013,Noviembre,China,1,1,,2,-75.527794,10.406342
21838,2013,Noviembre,China,6,8,,14,-75.516486,10.446304
21839,2013,Noviembre,China,0,2,,2,-74.77647900000001,10.886686
21840,2013,Noviembre,China,1,0,,1,-72.129595,11.360028999999999
21841,2013,Noviembre,China,3,7,,10,-76.532004,3.451668
21842,2013,Noviembre,China,182,482,,664,-74.140516,4.697157
21843,2013,Noviembre,China,0,1,,1,-75.736374,4.815189
21844,2013,Noviembre,China,12,26,,38,-75.42726,6.170465
21845,2013,Noviembre,China,1,1,,2,-73.181317,7.1280470000000005
21846,2013,Noviembre,China,0,1,,1,-72.453013,7.819
21847,2013,Noviembre,Chipre,1,0,,1,-76.532004,3.451668
21848,2013,Noviembre,Chipre,1,4,,5,-74.140516,4.697157
21849,2013,Noviembre,Dinamarca,5,7,,12,-77.35600000000001,0.81488
21850,2013,Noviembre,Dinamarca,2,1,,3,-75.527794,10.406342
21851,2013,Noviembre,Dinamarca,0,9,,9,-75.516486,10.446304
21852,2013,Noviembre,Dinamarca,0,1,,1,-74.77647900000001,10.886686
21853,2013,Noviembre,Dinamarca,0,1,,1,-72.129595,11.360028999999999
21854,2013,Noviembre,Dinamarca,0,6,,6,-76.532004,3.451668
21855,2013,Noviembre,Dinamarca,0,1,,1,-75.76635300000001,4.45285
21856,2013,Noviembre,Dinamarca,41,100,,141,-74.140516,4.697157
21857,2013,Noviembre,Dinamarca,0,2,,2,-75.736374,4.815189
21858,2013,Noviembre,Dinamarca,5,10,,15,-75.42726,6.170465
21859,2013,Noviembre,Dinamarca,2,1,,3,-72.453013,7.819
21860,2013,Noviembre,Dinamarca,0,1,,1,-72.508188,7.927233
21861,2013,Noviembre,Dominica,0,1,,1,-75.516486,10.446304
21862,2013,Noviembre,Dominica,0,1,,1,-72.129595,11.360028999999999
21863,2013,Noviembre,Dominica,1,1,,2,-74.140516,4.697157
21864,2013,Noviembre,Dominica,0,1,,1,-75.42726,6.170465
21865,2013,Noviembre,Ecuador,28,83,,111,-76.876446,0.33002
21866,2013,Noviembre,Ecuador,1352,1962,,3314,-77.35600000000001,0.81488
21867,2013,Noviembre,Ecuador,13,113,,126,-78.802679,18.00143
21868,2013,Noviembre,Ecuador,1,43,,44,-75.527794,10.406342
21869,2013,Noviembre,Ecuador,6,25,,31,-75.516486,10.446304
21870,2013,Noviembre,Ecuador,1,11,,12,-74.77647900000001,10.886686
21871,2013,Noviembre,Ecuador,15,11,,26,-72.129595,11.360028999999999
21872,2013,Noviembre,Ecuador,2,1,,3,-81.70216500000001,12.5862
21873,2013,Noviembre,Ecuador,390,509,,899,-76.532004,3.451668
21874,2013,Noviembre,Ecuador,1420,2501,,3921,-74.140516,4.697157
21875,2013,Noviembre,Ecuador,3,4,,7,-75.736374,4.815189
21876,2013,Noviembre,Ecuador,423,530,,953,-75.42726,6.170465
21877,2013,Noviembre,Ecuador,0,2,,2,-70.74025300000001,7.088728999999999
21878,2013,Noviembre,Ecuador,155,222,,377,-72.453013,7.819
21879,2013,Noviembre,Ecuador,3,8,,11,-72.508188,7.927233
21880,2013,Noviembre,Egipto,0,1,,1,-75.516486,10.446304
21881,2013,Noviembre,Egipto,2,7,,9,-74.140516,4.697157
21882,2013,Noviembre,El Salvador,1,0,,1,-77.35600000000001,0.81488
21883,2013,Noviembre,El Salvador,13,23,,36,-75.516486,10.446304
21884,2013,Noviembre,El Salvador,1,3,,4,-74.77647900000001,10.886686
21885,2013,Noviembre,El Salvador,63,86,,149,-76.532004,3.451668
21886,2013,Noviembre,El Salvador,576,838,,1414,-74.140516,4.697157
21887,2013,Noviembre,El Salvador,0,3,,3,-75.736374,4.815189
21888,2013,Noviembre,El Salvador,45,69,,114,-75.42726,6.170465
21889,2013,Noviembre,Emiratos Árabes,0,2,,2,-74.140516,4.697157
21890,2013,Noviembre,España,4,8,,12,-69.941498,4.191162
21891,2013,Noviembre,España,0,2,,2,-76.876446,0.33002
21892,2013,Noviembre,España,23,51,,74,-77.35600000000001,0.81488
21893,2013,Noviembre,España,48,59,,107,-75.527794,10.406342
21894,2013,Noviembre,España,50,118,,168,-75.516486,10.446304
21895,2013,Noviembre,España,8,27,,35,-74.77647900000001,10.886686
21896,2013,Noviembre,España,6,9,,15,-72.129595,11.360028999999999
21897,2013,Noviembre,España,0,1,,1,-81.703935,12.574411099999999
21898,2013,Noviembre,España,6,5,,11,-81.70216500000001,12.5862
21899,2013,Noviembre,España,0,1,,1,-81.372937,13.338761300000002
21900,2013,Noviembre,España,208,349,,557,-76.532004,3.451668
21901,2013,Noviembre,España,1,1,,2,-75.76635300000001,4.45285
21902,2013,Noviembre,España,2155,5950,,8105,-74.140516,4.697157
21903,2013,Noviembre,España,3,23,,26,-75.736374,4.815189
21904,2013,Noviembre,España,172,454,,626,-75.42726,6.170465
21905,2013,Noviembre,España,2,2,,4,-73.181317,7.1280470000000005
21906,2013,Noviembre,España,6,40,,46,-72.453013,7.819
21907,2013,Noviembre,España,6,4,,10,-72.508188,7.927233
21908,2013,Noviembre,España,0,5,,5,-77.35002,8.63337
21909,2013,Noviembre,Eslovaquia,1,0,,1,-69.941498,4.191162
21910,2013,Noviembre,Eslovaquia,1,0,,1,-77.35600000000001,0.81488
21911,2013,Noviembre,Eslovaquia,1,0,,1,-75.527794,10.406342
21912,2013,Noviembre,Eslovaquia,1,0,,1,-75.516486,10.446304
21913,2013,Noviembre,Eslovaquia,1,0,,1,-74.77647900000001,10.886686
21914,2013,Noviembre,Eslovaquia,0,1,,1,-74.765343,10.970933
21915,2013,Noviembre,Eslovaquia,0,1,,1,-81.70216500000001,12.5862
21916,2013,Noviembre,Eslovaquia,0,1,,1,-76.532004,3.451668
21917,2013,Noviembre,Eslovaquia,11,29,,40,-74.140516,4.697157
21918,2013,Noviembre,Eslovaquia,0,1,,1,-75.42726,6.170465
21919,2013,Noviembre,Eslovenia,0,1,,1,-77.35600000000001,0.81488
21920,2013,Noviembre,Eslovenia,0,2,,2,-75.527794,10.406342
21921,2013,Noviembre,Eslovenia,0,1,,1,-76.532004,3.451668
21922,2013,Noviembre,Eslovenia,19,29,,48,-74.140516,4.697157
21923,2013,Noviembre,Eslovenia,0,6,,6,-75.42726,6.170465
21924,2013,Noviembre,Estados Unidos de América,4,11,,15,-69.941498,4.191162
21925,2013,Noviembre,Estados Unidos de América,38,51,,89,-77.35600000000001,0.81488
21926,2013,Noviembre,Estados Unidos de América,38,74,,112,-75.527794,10.406342
21927,2013,Noviembre,Estados Unidos de América,856,1763,,2619,-75.516486,10.446304
21928,2013,Noviembre,Estados Unidos de América,241,443,,684,-74.77647900000001,10.886686
21929,2013,Noviembre,Estados Unidos de América,7,2,,9,-74.213989,11.247722999999999
21930,2013,Noviembre,Estados Unidos de América,9,19,,28,-72.129595,11.360028999999999
21931,2013,Noviembre,Estados Unidos de América,1,0,,1,-72.919186,11.52863
21932,2013,Noviembre,Estados Unidos de América,0,4,,4,-81.703935,12.574411099999999
21933,2013,Noviembre,Estados Unidos de América,15,16,,31,-81.70216500000001,12.5862
21934,2013,Noviembre,Estados Unidos de América,3,6,,9,-81.372937,13.338761300000002
21935,2013,Noviembre,Estados Unidos de América,602,1003,,1605,-76.532004,3.451668
21936,2013,Noviembre,Estados Unidos de América,68,138,,206,-75.76635300000001,4.45285
21937,2013,Noviembre,Estados Unidos de América,5440,10883,,16323,-74.140516,4.697157
21938,2013,Noviembre,Estados Unidos de América,75,106,,181,-75.736374,4.815189
21939,2013,Noviembre,Estados Unidos de América,1187,2954,,4141,-75.42726,6.170465
21940,2013,Noviembre,Estados Unidos de América,2,3,,5,-67.48402800000001,6.185536
21941,2013,Noviembre,Estados Unidos de América,16,23,,39,-73.181317,7.1280470000000005
21942,2013,Noviembre,Estados Unidos de América,26,51,,77,-72.453013,7.819
21943,2013,Noviembre,Estados Unidos de América,24,19,,43,-72.508188,7.927233
21944,2013,Noviembre,Estados Unidos de América,2,3,,5,-77.35002,8.63337
21945,2013,Noviembre,Estonia,0,1,,1,-75.527794,10.406342
21946,2013,Noviembre,Estonia,0,2,,2,-75.516486,10.446304
21947,2013,Noviembre,Estonia,4,4,,8,-74.140516,4.697157
21948,2013,Noviembre,Estonia,2,0,,2,-75.42726,6.170465
21949,2013,Noviembre,Etiopia,0,1,,1,-75.516486,10.446304
21950,2013,Noviembre,Etiopia,0,1,,1,-76.532004,3.451668
21951,2013,Noviembre,Etiopia,0,1,,1,-74.140516,4.697157
21952,2013,Noviembre,Islas Fiji,0,1,,1,-74.77647900000001,10.886686
21953,2013,Noviembre,Filipinas,0,1,,1,-77.35600000000001,0.81488
21954,2013,Noviembre,Filipinas,3,41,,44,-75.527794,10.406342
21955,2013,Noviembre,Filipinas,1,33,,34,-75.516486,10.446304
21956,2013,Noviembre,Filipinas,1,8,,9,-74.77647900000001,10.886686
21957,2013,Noviembre,Filipinas,0,8,,8,-74.765343,10.970933
21958,2013,Noviembre,Filipinas,0,14,,14,-74.213989,11.247722999999999
21959,2013,Noviembre,Filipinas,1,4,,5,-76.532004,3.451668
21960,2013,Noviembre,Filipinas,0,4,,4,-77.061029,3.8844260000000004
21961,2013,Noviembre,Filipinas,18,61,,79,-74.140516,4.697157
21962,2013,Noviembre,Filipinas,5,5,,10,-75.42726,6.170465
21963,2013,Noviembre,Filipinas,0,1,,1,-75.68164200000001,9.402597
21964,2013,Noviembre,Finlandia,4,2,,6,-77.35600000000001,0.81488
21965,2013,Noviembre,Finlandia,0,1,,1,-75.527794,10.406342
21966,2013,Noviembre,Finlandia,4,5,,9,-75.516486,10.446304
21967,2013,Noviembre,Finlandia,1,1,,2,-74.77647900000001,10.886686
21968,2013,Noviembre,Finlandia,1,0,,1,-72.129595,11.360028999999999
21969,2013,Noviembre,Finlandia,2,2,,4,-76.532004,3.451668
21970,2013,Noviembre,Finlandia,1,0,,1,-75.76635300000001,4.45285
21971,2013,Noviembre,Finlandia,42,62,,104,-74.140516,4.697157
21972,2013,Noviembre,Finlandia,4,4,,8,-75.42726,6.170465
21973,2013,Noviembre,Francia,2,6,,8,-69.941498,4.191162
21974,2013,Noviembre,Francia,0,1,,1,-76.876446,0.33002
21975,2013,Noviembre,Francia,22,28,,50,-77.35600000000001,0.81488
21976,2013,Noviembre,Francia,10,12,,22,-75.527794,10.406342
21977,2013,Noviembre,Francia,31,53,,84,-75.516486,10.446304
21978,2013,Noviembre,Francia,3,15,,18,-74.77647900000001,10.886686
21979,2013,Noviembre,Francia,1,1,,2,-74.765343,10.970933
21980,2013,Noviembre,Francia,3,4,,7,-74.213989,11.247722999999999
21981,2013,Noviembre,Francia,5,17,,22,-72.129595,11.360028999999999
21982,2013,Noviembre,Francia,2,0,,2,-81.70216500000001,12.5862
21983,2013,Noviembre,Francia,1,1,,2,-81.372937,13.338761300000002
21984,2013,Noviembre,Francia,39,70,,109,-76.532004,3.451668
21985,2013,Noviembre,Francia,817,1752,,2569,-74.140516,4.697157
21986,2013,Noviembre,Francia,1,4,,5,-75.736374,4.815189
21987,2013,Noviembre,Francia,27,105,,132,-75.42726,6.170465
21988,2013,Noviembre,Francia,5,7,,12,-72.453013,7.819
21989,2013,Noviembre,Francia,0,3,,3,-77.35002,8.63337
21990,2013,Noviembre,Georgia,1,0,,1,-74.140516,4.697157
21991,2013,Noviembre,Georgia,0,1,,1,-75.68164200000001,9.402597
21992,2013,Noviembre,Ghana,1,0,,1,-75.516486,10.446304
21993,2013,Noviembre,Ghana,0,6,,6,-74.140516,4.697157
21994,2013,Noviembre,Ghana,0,1,,1,-75.42726,6.170465
21995,2013,Noviembre,Granada,0,1,,1,-74.140516,4.697157
21996,2013,Noviembre,Grecia,0,2,,2,-75.527794,10.406342
21997,2013,Noviembre,Grecia,0,1,,1,-75.516486,10.446304
21998,2013,Noviembre,Grecia,0,1,,1,-74.77647900000001,10.886686
21999,2013,Noviembre,Grecia,0,1,,1,-74.765343,10.970933
22000,2013,Noviembre,Grecia,0,1,,1,-76.532004,3.451668
22001,2013,Noviembre,Grecia,14,59,,73,-74.140516,4.697157
22002,2013,Noviembre,Grecia,0,8,,8,-75.42726,6.170465
22003,2013,Noviembre,Grecia,0,2,,2,-75.68164200000001,9.402597
22004,2013,Noviembre,Guatemala,1,4,,5,-77.35600000000001,0.81488
22005,2013,Noviembre,Guatemala,36,44,,80,-75.516486,10.446304
22006,2013,Noviembre,Guatemala,9,20,,29,-74.77647900000001,10.886686
22007,2013,Noviembre,Guatemala,1,2,,3,-72.129595,11.360028999999999
22008,2013,Noviembre,Guatemala,3,3,,6,-81.70216500000001,12.5862
22009,2013,Noviembre,Guatemala,17,50,,67,-76.532004,3.451668
22010,2013,Noviembre,Guatemala,370,659,,1029,-74.140516,4.697157
22011,2013,Noviembre,Guatemala,4,2,,6,-75.736374,4.815189
22012,2013,Noviembre,Guatemala,49,124,,173,-75.42726,6.170465
22013,2013,Noviembre,Guatemala,0,3,,3,-73.181317,7.1280470000000005
22014,2013,Noviembre,Guatemala,1,8,,9,-72.453013,7.819
22015,2013,Noviembre,Guatemala,0,2,,2,-72.508188,7.927233
22016,2013,Noviembre,Guyana,0,1,,1,-75.516486,10.446304
22017,2013,Noviembre,Guyana,4,4,,8,-76.532004,3.451668
22018,2013,Noviembre,Guyana,1,7,,8,-74.140516,4.697157
22019,2013,Noviembre,Guyana,0,3,,3,-75.42726,6.170465
22020,2013,Noviembre,Guyana,1,1,,2,-72.453013,7.819
22021,2013,Noviembre,Guinea,0,1,,1,-76.532004,3.451668
22022,2013,Noviembre,Guinea Bissau,0,1,,1,-74.140516,4.697157
22023,2013,Noviembre,Haití,0,1,,1,-75.516486,10.446304
22024,2013,Noviembre,Haití,1,0,,1,-74.77647900000001,10.886686
22025,2013,Noviembre,Haití,0,3,,3,-76.532004,3.451668
22026,2013,Noviembre,Haití,7,26,,33,-74.140516,4.697157
22027,2013,Noviembre,Haití,3,6,,9,-75.42726,6.170465
22028,2013,Noviembre,Honduras,2,0,,2,-77.35600000000001,0.81488
22029,2013,Noviembre,Honduras,0,1,,1,-78.802679,18.00143
22030,2013,Noviembre,Honduras,0,3,,3,-75.527794,10.406342
22031,2013,Noviembre,Honduras,9,27,,36,-75.516486,10.446304
22032,2013,Noviembre,Honduras,7,5,,12,-74.77647900000001,10.886686
22033,2013,Noviembre,Honduras,1,5,,6,-72.129595,11.360028999999999
22034,2013,Noviembre,Honduras,17,24,,41,-76.532004,3.451668
22035,2013,Noviembre,Honduras,115,207,,322,-74.140516,4.697157
22036,2013,Noviembre,Honduras,1,0,,1,-75.736374,4.815189
22037,2013,Noviembre,Honduras,19,35,,54,-75.42726,6.170465
22038,2013,Noviembre,Honduras,0,1,,1,-72.453013,7.819
22039,2013,Noviembre,Honduras,0,1,,1,-77.35002,8.63337
22040,2013,Noviembre,Hong Kong,0,1,,1,-74.140516,4.697157
22041,2013,Noviembre,Hungría,0,1,,1,-69.941498,4.191162
22042,2013,Noviembre,Hungría,0,1,,1,-77.35600000000001,0.81488
22043,2013,Noviembre,Hungría,0,1,,1,-75.527794,10.406342
22044,2013,Noviembre,Hungría,3,0,,3,-75.516486,10.446304
22045,2013,Noviembre,Hungría,0,3,,3,-72.919186,11.52863
22046,2013,Noviembre,Hungría,0,1,,1,-81.70216500000001,12.5862
22047,2013,Noviembre,Hungría,0,1,,1,-76.532004,3.451668
22048,2013,Noviembre,Hungría,25,46,,71,-74.140516,4.697157
22049,2013,Noviembre,Hungría,1,2,,3,-75.42726,6.170465
22050,2013,Noviembre,Hungría,1,0,,1,-72.453013,7.819
22051,2013,Noviembre,India,0,1,,1,-77.35600000000001,0.81488
22052,2013,Noviembre,India,0,7,,7,-75.527794,10.406342
22053,2013,Noviembre,India,2,11,,13,-75.516486,10.446304
22054,2013,Noviembre,India,1,1,,2,-74.77647900000001,10.886686
22055,2013,Noviembre,India,0,2,,2,-74.765343,10.970933
22056,2013,Noviembre,India,0,1,,1,-81.70216500000001,12.5862
22057,2013,Noviembre,India,3,10,,13,-76.532004,3.451668
22058,2013,Noviembre,India,0,2,,2,-77.061029,3.8844260000000004
22059,2013,Noviembre,India,0,1,,1,-75.76635300000001,4.45285
22060,2013,Noviembre,India,30,231,,261,-74.140516,4.697157
22061,2013,Noviembre,India,0,2,,2,-75.736374,4.815189
22062,2013,Noviembre,India,3,29,,32,-75.42726,6.170465
22063,2013,Noviembre,Indonesia,0,1,,1,-77.35600000000001,0.81488
22064,2013,Noviembre,Indonesia,0,3,,3,-75.527794,10.406342
22065,2013,Noviembre,Indonesia,1,0,,1,-75.516486,10.446304
22066,2013,Noviembre,Indonesia,0,1,,1,-76.532004,3.451668
22067,2013,Noviembre,Indonesia,11,24,,35,-74.140516,4.697157
22068,2013,Noviembre,Indonesia,0,2,,2,-75.42726,6.170465
22069,2013,Noviembre,Iraq,1,0,,1,-74.77647900000001,10.886686
22070,2013,Noviembre,Iraq,0,3,,3,-74.140516,4.697157
22071,2013,Noviembre,Irán,1,0,,1,-77.35600000000001,0.81488
22072,2013,Noviembre,Irán,4,17,,21,-74.140516,4.697157
22073,2013,Noviembre,Irán,1,0,,1,-72.453013,7.819
22074,2013,Noviembre,República de Irlanda,11,8,,19,-77.35600000000001,0.81488
22075,2013,Noviembre,República de Irlanda,5,5,,10,-75.527794,10.406342
22076,2013,Noviembre,República de Irlanda,11,15,,26,-75.516486,10.446304
22077,2013,Noviembre,República de Irlanda,0,1,,1,-74.77647900000001,10.886686
22078,2013,Noviembre,República de Irlanda,0,2,,2,-72.129595,11.360028999999999
22079,2013,Noviembre,República de Irlanda,1,2,,3,-76.532004,3.451668
22080,2013,Noviembre,República de Irlanda,59,131,,190,-74.140516,4.697157
22081,2013,Noviembre,República de Irlanda,1,11,,12,-75.42726,6.170465
22082,2013,Noviembre,República de Irlanda,0,1,,1,-70.74025300000001,7.088728999999999
22083,2013,Noviembre,Islandia,1,1,,2,-75.527794,10.406342
22084,2013,Noviembre,Islandia,6,3,,9,-74.140516,4.697157
22085,2013,Noviembre,Islandia,0,1,,1,-75.42726,6.170465
22086,2013,Noviembre,Israel,3,11,,14,-77.35600000000001,0.81488
22087,2013,Noviembre,Israel,1,2,,3,-75.527794,10.406342
22088,2013,Noviembre,Israel,1,17,,18,-75.516486,10.446304
22089,2013,Noviembre,Israel,0,2,,2,-74.77647900000001,10.886686
22090,2013,Noviembre,Israel,2,0,,2,-81.70216500000001,12.5862
22091,2013,Noviembre,Israel,7,8,,15,-76.532004,3.451668
22092,2013,Noviembre,Israel,49,357,,406,-74.140516,4.697157
22093,2013,Noviembre,Israel,0,1,,1,-75.736374,4.815189
22094,2013,Noviembre,Israel,4,31,,35,-75.42726,6.170465
22095,2013,Noviembre,Italia,1,7,,8,-69.941498,4.191162
22096,2013,Noviembre,Italia,7,34,,41,-77.35600000000001,0.81488
22097,2013,Noviembre,Italia,5,6,,11,-75.527794,10.406342
22098,2013,Noviembre,Italia,29,84,,113,-75.516486,10.446304
22099,2013,Noviembre,Italia,3,15,,18,-74.77647900000001,10.886686
22100,2013,Noviembre,Italia,0,1,,1,-74.213989,11.247722999999999
22101,2013,Noviembre,Italia,0,12,,12,-72.129595,11.360028999999999
22102,2013,Noviembre,Italia,0,1,,1,-81.703935,12.574411099999999
22103,2013,Noviembre,Italia,5,8,,13,-81.70216500000001,12.5862
22104,2013,Noviembre,Italia,16,67,,83,-76.532004,3.451668
22105,2013,Noviembre,Italia,0,1,,1,-75.76635300000001,4.45285
22106,2013,Noviembre,Italia,470,1856,,2326,-74.140516,4.697157
22107,2013,Noviembre,Italia,1,6,,7,-75.736374,4.815189
22108,2013,Noviembre,Italia,19,95,,114,-75.42726,6.170465
22109,2013,Noviembre,Italia,0,1,,1,-67.48402800000001,6.185536
22110,2013,Noviembre,Italia,1,2,,3,-70.74025300000001,7.088728999999999
22111,2013,Noviembre,Italia,0,1,,1,-73.181317,7.1280470000000005
22112,2013,Noviembre,Italia,12,16,,28,-72.453013,7.819
22113,2013,Noviembre,Italia,2,3,,5,-72.508188,7.927233
22114,2013,Noviembre,Italia,0,1,,1,-77.35002,8.63337
22115,2013,Noviembre,Italia,0,2,,2,-75.68164200000001,9.402597
22116,2013,Noviembre,Jamaica,1,1,,2,-75.516486,10.446304
22117,2013,Noviembre,Jamaica,1,1,,2,-72.129595,11.360028999999999
22118,2013,Noviembre,Jamaica,2,1,,3,-76.532004,3.451668
22119,2013,Noviembre,Jamaica,8,20,,28,-74.140516,4.697157
22120,2013,Noviembre,Jamaica,5,19,,24,-75.42726,6.170465
22121,2013,Noviembre,Japón,0,1,,1,-69.941498,4.191162
22122,2013,Noviembre,Japón,6,10,,16,-77.35600000000001,0.81488
22123,2013,Noviembre,Japón,0,3,,3,-75.527794,10.406342
22124,2013,Noviembre,Japón,4,26,,30,-75.516486,10.446304
22125,2013,Noviembre,Japón,1,14,,15,-74.77647900000001,10.886686
22126,2013,Noviembre,Japón,0,2,,2,-72.129595,11.360028999999999
22127,2013,Noviembre,Japón,0,1,,1,-81.70216500000001,12.5862
22128,2013,Noviembre,Japón,4,18,,22,-76.532004,3.451668
22129,2013,Noviembre,Japón,102,456,,558,-74.140516,4.697157
22130,2013,Noviembre,Japón,5,33,,38,-75.42726,6.170465
22131,2013,Noviembre,Japón,0,1,,1,-67.48402800000001,6.185536
22132,2013,Noviembre,Japón,4,6,,10,-72.453013,7.819
22133,2013,Noviembre,Japón,0,1,,1,-72.508188,7.927233
22134,2013,Noviembre,Jordania,0,1,,1,-77.35600000000001,0.81488
22135,2013,Noviembre,Jordania,1,6,,7,-74.140516,4.697157
22136,2013,Noviembre,Kazajistán,3,6,,9,-74.140516,4.697157
22137,2013,Noviembre,Kenia,1,3,,4,-76.532004,3.451668
22138,2013,Noviembre,Kenia,1,7,,8,-74.140516,4.697157
22139,2013,Noviembre,Kirguistán,1,1,,2,-74.140516,4.697157
22140,2013,Noviembre,Kuwait,0,2,,2,-74.140516,4.697157
22141,2013,Noviembre,Letonia,1,0,,1,-77.35600000000001,0.81488
22142,2013,Noviembre,Letonia,0,2,,2,-75.527794,10.406342
22143,2013,Noviembre,Letonia,0,1,,1,-74.77647900000001,10.886686
22144,2013,Noviembre,Letonia,14,11,,25,-74.140516,4.697157
22145,2013,Noviembre,Letonia,2,3,,5,-75.42726,6.170465
22146,2013,Noviembre,Lituania,0,1,,1,-77.35600000000001,0.81488
22147,2013,Noviembre,Lituania,1,1,,2,-75.527794,10.406342
22148,2013,Noviembre,Lituania,0,1,,1,-75.516486,10.446304
22149,2013,Noviembre,Lituania,1,1,,2,-76.532004,3.451668
22150,2013,Noviembre,Lituania,23,8,,31,-74.140516,4.697157
22151,2013,Noviembre,Lituania,2,0,,2,-75.42726,6.170465
22152,2013,Noviembre,Líbano,1,2,,3,-74.77647900000001,10.886686
22153,2013,Noviembre,Líbano,4,0,,4,-72.129595,11.360028999999999
22154,2013,Noviembre,Líbano,11,33,,44,-74.140516,4.697157
22155,2013,Noviembre,Liechtenstein,0,2,,2,-74.140516,4.697157
22156,2013,Noviembre,Liechtenstein,0,1,,1,-75.42726,6.170465
22157,2013,Noviembre,Luxemburgo,7,5,,12,-74.140516,4.697157
22158,2013,Noviembre,Luxemburgo,0,1,,1,-75.42726,6.170465
22159,2013,Noviembre,Madagascar,0,1,,1,-74.140516,4.697157
22160,2013,Noviembre,Malasia,3,2,,5,-75.516486,10.446304
22161,2013,Noviembre,Malasia,0,1,,1,-74.77647900000001,10.886686
22162,2013,Noviembre,Malasia,0,1,,1,-76.532004,3.451668
22163,2013,Noviembre,Malasia,13,18,,31,-74.140516,4.697157
22164,2013,Noviembre,Malasia,1,0,,1,-75.42726,6.170465
22165,2013,Noviembre,Malasia,1,0,,1,-72.453013,7.819
22166,2013,Noviembre,Malta,0,1,,1,-76.532004,3.451668
22167,2013,Noviembre,Malta,1,3,,4,-74.140516,4.697157
22168,2013,Noviembre,Malta,0,1,,1,-75.42726,6.170465
22169,2013,Noviembre,Malta,0,1,,1,-72.453013,7.819
22170,2013,Noviembre,Marruecos,0,1,,1,-75.516486,10.446304
22171,2013,Noviembre,Marruecos,4,13,,17,-74.140516,4.697157
22172,2013,Noviembre,Mauricio,1,1,,2,-74.140516,4.697157
22173,2013,Noviembre,Mauritania,0,2,,2,-74.140516,4.697157
22174,2013,Noviembre,México,1,0,,1,-69.941498,4.191162
22175,2013,Noviembre,México,12,25,,37,-77.35600000000001,0.81488
22176,2013,Noviembre,México,367,242,,609,-75.527794,10.406342
22177,2013,Noviembre,México,327,321,,648,-75.516486,10.446304
22178,2013,Noviembre,México,37,81,,118,-74.77647900000001,10.886686
22179,2013,Noviembre,México,4,14,,18,-72.129595,11.360028999999999
22180,2013,Noviembre,México,4,2,,6,-81.70216500000001,12.5862
22181,2013,Noviembre,México,58,157,,215,-76.532004,3.451668
22182,2013,Noviembre,México,0,1,,1,-75.76635300000001,4.45285
22183,2013,Noviembre,México,2656,5610,,8266,-74.140516,4.697157
22184,2013,Noviembre,México,2,13,,15,-75.736374,4.815189
22185,2013,Noviembre,México,151,500,,651,-75.42726,6.170465
22186,2013,Noviembre,México,1,2,,3,-67.48402800000001,6.185536
22187,2013,Noviembre,México,4,8,,12,-73.181317,7.1280470000000005
22188,2013,Noviembre,México,26,61,,87,-72.453013,7.819
22189,2013,Noviembre,México,4,13,,17,-72.508188,7.927233
22190,2013,Noviembre,México,1,0,,1,-77.35002,8.63337
22191,2013,Noviembre,República de Moldavia,4,1,,5,-74.140516,4.697157
22192,2013,Noviembre,Mónaco,1,0,,1,-77.35600000000001,0.81488
22193,2013,Noviembre,Mónaco,2,1,,3,-74.140516,4.697157
22194,2013,Noviembre,Mongolia,0,1,,1,-75.42726,6.170465
22195,2013,Noviembre,Mozambique,0,2,,2,-74.140516,4.697157
22196,2013,Noviembre,Myanmar,0,1,,1,-75.527794,10.406342
22197,2013,Noviembre,Namibia,0,1,,1,-74.140516,4.697157
22198,2013,Noviembre,Nepal,0,1,,1,-76.532004,3.451668
22199,2013,Noviembre,Nepal,0,1,,1,-74.140516,4.697157
22200,2013,Noviembre,Nicaragua,0,2,,2,-75.527794,10.406342
22201,2013,Noviembre,Nicaragua,9,4,,13,-75.516486,10.446304
22202,2013,Noviembre,Nicaragua,1,5,,6,-74.77647900000001,10.886686
22203,2013,Noviembre,Nicaragua,0,7,,7,-81.703935,12.574411099999999
22204,2013,Noviembre,Nicaragua,0,1,,1,-81.70216500000001,12.5862
22205,2013,Noviembre,Nicaragua,5,4,,9,-76.532004,3.451668
22206,2013,Noviembre,Nicaragua,72,88,,160,-74.140516,4.697157
22207,2013,Noviembre,Nicaragua,11,13,,24,-75.736374,4.815189
22208,2013,Noviembre,Nicaragua,4,13,,17,-75.42726,6.170465
22209,2013,Noviembre,Nicaragua,1,0,,1,-72.453013,7.819
22210,2013,Noviembre,Nigeria,3,9,,12,-74.140516,4.697157
22211,2013,Noviembre,Nigeria,1,1,,2,-75.42726,6.170465
22212,2013,Noviembre,Noruega,1,2,,3,-77.35600000000001,0.81488
22213,2013,Noviembre,Noruega,1,4,,5,-75.527794,10.406342
22214,2013,Noviembre,Noruega,1,21,,22,-75.516486,10.446304
22215,2013,Noviembre,Noruega,0,4,,4,-74.77647900000001,10.886686
22216,2013,Noviembre,Noruega,1,1,,2,-81.70216500000001,12.5862
22217,2013,Noviembre,Noruega,2,1,,3,-76.532004,3.451668
22218,2013,Noviembre,Noruega,56,134,,190,-74.140516,4.697157
22219,2013,Noviembre,Noruega,0,1,,1,-75.736374,4.815189
22220,2013,Noviembre,Noruega,2,3,,5,-75.42726,6.170465
22221,2013,Noviembre,Nueva Zelanda,8,8,,16,-77.35600000000001,0.81488
22222,2013,Noviembre,Nueva Zelanda,6,6,,12,-75.527794,10.406342
22223,2013,Noviembre,Nueva Zelanda,3,7,,10,-75.516486,10.446304
22224,2013,Noviembre,Nueva Zelanda,1,2,,3,-74.77647900000001,10.886686
22225,2013,Noviembre,Nueva Zelanda,1,1,,2,-81.70216500000001,12.5862
22226,2013,Noviembre,Nueva Zelanda,2,2,,4,-76.532004,3.451668
22227,2013,Noviembre,Nueva Zelanda,32,79,,111,-74.140516,4.697157
22228,2013,Noviembre,Nueva Zelanda,7,11,,18,-75.42726,6.170465
22229,2013,Noviembre,Nueva Zelanda,3,2,,5,-72.453013,7.819
22230,2013,Noviembre,Nueva Zelanda,0,1,,1,-77.35002,8.63337
22231,2013,Noviembre,Nueva Zelanda,1,1,,2,-69.941498,4.191162
22232,2013,Noviembre,Países Bajos,0,1,,1,-69.941498,4.191162
22233,2013,Noviembre,Países Bajos,13,24,,37,-77.35600000000001,0.81488
22234,2013,Noviembre,Países Bajos,8,22,,30,-75.527794,10.406342
22235,2013,Noviembre,Países Bajos,14,52,,66,-75.516486,10.446304
22236,2013,Noviembre,Países Bajos,4,15,,19,-74.77647900000001,10.886686
22237,2013,Noviembre,Países Bajos,2,7,,9,-72.129595,11.360028999999999
22238,2013,Noviembre,Países Bajos,10,10,,20,-72.919186,11.52863
22239,2013,Noviembre,Países Bajos,17,42,,59,-76.532004,3.451668
22240,2013,Noviembre,Países Bajos,519,1000,,1519,-74.140516,4.697157
22241,2013,Noviembre,Países Bajos,1,2,,3,-75.736374,4.815189
22242,2013,Noviembre,Países Bajos,224,360,,584,-75.42726,6.170465
22243,2013,Noviembre,Países Bajos,1,4,,5,-73.181317,7.1280470000000005
22244,2013,Noviembre,Países Bajos,1,3,,4,-72.453013,7.819
22245,2013,Noviembre,Países Bajos,0,1,,1,-72.508188,7.927233
22246,2013,Noviembre,Países Bajos,1,2,,3,-77.35002,8.63337
22247,2013,Noviembre,Pakistán,1,0,,1,-75.516486,10.446304
22248,2013,Noviembre,Pakistán,0,1,,1,-72.129595,11.360028999999999
22249,2013,Noviembre,Pakistán,0,1,,1,-76.532004,3.451668
22250,2013,Noviembre,Pakistán,1,14,,15,-74.140516,4.697157
22251,2013,Noviembre,Pakistán,0,3,,3,-72.453013,7.819
22252,2013,Noviembre,Panamá,0,2,,2,-77.35600000000001,0.81488
22253,2013,Noviembre,Panamá,2,22,,24,-75.527794,10.406342
22254,2013,Noviembre,Panamá,140,217,,357,-75.516486,10.446304
22255,2013,Noviembre,Panamá,43,74,,117,-74.77647900000001,10.886686
22256,2013,Noviembre,Panamá,1,4,,5,-72.129595,11.360028999999999
22257,2013,Noviembre,Panamá,53,48,,101,-81.70216500000001,12.5862
22258,2013,Noviembre,Panamá,101,127,,228,-76.532004,3.451668
22259,2013,Noviembre,Panamá,695,938,,1633,-74.140516,4.697157
22260,2013,Noviembre,Panamá,81,143,,224,-75.736374,4.815189
22261,2013,Noviembre,Panamá,145,300,,445,-75.42726,6.170465
22262,2013,Noviembre,Panamá,10,9,,19,-73.181317,7.1280470000000005
22263,2013,Noviembre,Panamá,1,9,,10,-72.453013,7.819
22264,2013,Noviembre,Panamá,3,14,,17,-72.508188,7.927233
22265,2013,Noviembre,Panamá,1,0,,1,-76.7333,8.06667
22266,2013,Noviembre,Panamá,0,2,,2,-77.35002,8.63337
22267,2013,Noviembre,Paraguay,18,11,,29,-75.516486,10.446304
22268,2013,Noviembre,Paraguay,3,4,,7,-74.77647900000001,10.886686
22269,2013,Noviembre,Paraguay,4,2,,6,-72.129595,11.360028999999999
22270,2013,Noviembre,Paraguay,5,4,,9,-81.70216500000001,12.5862
22271,2013,Noviembre,Paraguay,8,17,,25,-76.532004,3.451668
22272,2013,Noviembre,Paraguay,94,109,,203,-74.140516,4.697157
22273,2013,Noviembre,Paraguay,15,49,,64,-75.42726,6.170465
22274,2013,Noviembre,Perú,20,25,,45,-69.941498,4.191162
22275,2013,Noviembre,Perú,0,2,,2,-76.876446,0.33002
22276,2013,Noviembre,Perú,171,378,,549,-77.35600000000001,0.81488
22277,2013,Noviembre,Perú,0,1,,1,-78.802679,18.00143
22278,2013,Noviembre,Perú,48,32,,80,-75.527794,10.406342
22279,2013,Noviembre,Perú,193,171,,364,-75.516486,10.446304
22280,2013,Noviembre,Perú,15,21,,36,-74.77647900000001,10.886686
22281,2013,Noviembre,Perú,0,2,,2,-74.213989,11.247722999999999
22282,2013,Noviembre,Perú,8,35,,43,-72.129595,11.360028999999999
22283,2013,Noviembre,Perú,61,49,,110,-81.70216500000001,12.5862
22284,2013,Noviembre,Perú,152,249,,401,-76.532004,3.451668
22285,2013,Noviembre,Perú,2224,3250,,5474,-74.140516,4.697157
22286,2013,Noviembre,Perú,9,17,,26,-75.736374,4.815189
22287,2013,Noviembre,Perú,210,436,,646,-75.42726,6.170465
22288,2013,Noviembre,Perú,0,1,,1,-67.48402800000001,6.185536
22289,2013,Noviembre,Perú,0,2,,2,-73.181317,7.1280470000000005
22290,2013,Noviembre,Perú,95,124,,219,-72.453013,7.819
22291,2013,Noviembre,Perú,4,12,,16,-72.508188,7.927233
22292,2013,Noviembre,Palestina,0,1,,1,-74.140516,4.697157
22293,2013,Noviembre,Polonia,7,8,,15,-69.941498,4.191162
22294,2013,Noviembre,Polonia,2,2,,4,-77.35600000000001,0.81488
22295,2013,Noviembre,Polonia,4,5,,9,-75.527794,10.406342
22296,2013,Noviembre,Polonia,10,19,,29,-75.516486,10.446304
22297,2013,Noviembre,Polonia,1,0,,1,-74.77647900000001,10.886686
22298,2013,Noviembre,Polonia,0,1,,1,-74.213989,11.247722999999999
22299,2013,Noviembre,Polonia,1,2,,3,-72.129595,11.360028999999999
22300,2013,Noviembre,Polonia,80,119,,199,-74.140516,4.697157
22301,2013,Noviembre,Polonia,1,4,,5,-75.42726,6.170465
22302,2013,Noviembre,Portugal,1,0,,1,-69.941498,4.191162
22303,2013,Noviembre,Portugal,2,6,,8,-77.35600000000001,0.81488
22304,2013,Noviembre,Portugal,2,4,,6,-75.527794,10.406342
22305,2013,Noviembre,Portugal,5,10,,15,-75.516486,10.446304
22306,2013,Noviembre,Portugal,0,1,,1,-74.77647900000001,10.886686
22307,2013,Noviembre,Portugal,3,3,,6,-72.129595,11.360028999999999
22308,2013,Noviembre,Portugal,0,1,,1,-81.70216500000001,12.5862
22309,2013,Noviembre,Portugal,3,17,,20,-76.532004,3.451668
22310,2013,Noviembre,Portugal,121,376,,497,-74.140516,4.697157
22311,2013,Noviembre,Portugal,0,2,,2,-75.736374,4.815189
22312,2013,Noviembre,Portugal,5,20,,25,-75.42726,6.170465
22313,2013,Noviembre,Portugal,1,5,,6,-72.453013,7.819
22314,2013,Noviembre,Puerto Rico/Territorio de Estados Unidos,1,0,,1,-76.532004,3.451668
22315,2013,Noviembre,Qatar,0,1,,1,-74.140516,4.697157
22316,2013,Noviembre,Reino Unido de Gran Bretaña e Irlanda del Norte,1,1,,2,-69.941498,4.191162
22317,2013,Noviembre,Reino Unido de Gran Bretaña e Irlanda del Norte,25,46,,71,-77.35600000000001,0.81488
22318,2013,Noviembre,Reino Unido de Gran Bretaña e Irlanda del Norte,16,28,,44,-75.527794,10.406342
22319,2013,Noviembre,Reino Unido de Gran Bretaña e Irlanda del Norte,34,71,,105,-75.516486,10.446304
22320,2013,Noviembre,Reino Unido de Gran Bretaña e Irlanda del Norte,4,10,,14,-74.77647900000001,10.886686
22321,2013,Noviembre,Reino Unido de Gran Bretaña e Irlanda del Norte,0,1,,1,-74.213989,11.247722999999999
22322,2013,Noviembre,Reino Unido de Gran Bretaña e Irlanda del Norte,6,3,,9,-72.129595,11.360028999999999
22323,2013,Noviembre,Reino Unido de Gran Bretaña e Irlanda del Norte,0,1,,1,-72.919186,11.52863
22324,2013,Noviembre,Reino Unido de Gran Bretaña e Irlanda del Norte,0,1,,1,-81.372937,13.338761300000002
22325,2013,Noviembre,Reino Unido de Gran Bretaña e Irlanda del Norte,16,44,,60,-76.532004,3.451668
22326,2013,Noviembre,Reino Unido de Gran Bretaña e Irlanda del Norte,1,1,,2,-75.76635300000001,4.45285
22327,2013,Noviembre,Reino Unido de Gran Bretaña e Irlanda del Norte,589,1313,,1902,-74.140516,4.697157
22328,2013,Noviembre,Reino Unido de Gran Bretaña e Irlanda del Norte,2,4,,6,-75.736374,4.815189
22329,2013,Noviembre,Reino Unido de Gran Bretaña e Irlanda del Norte,30,112,,142,-75.42726,6.170465
22330,2013,Noviembre,Reino Unido de Gran Bretaña e Irlanda del Norte,1,0,,1,-70.74025300000001,7.088728999999999
22331,2013,Noviembre,Reino Unido de Gran Bretaña e Irlanda del Norte,0,1,,1,-73.181317,7.1280470000000005
22332,2013,Noviembre,Reino Unido de Gran Bretaña e Irlanda del Norte,1,2,,3,-72.453013,7.819
22333,2013,Noviembre,Reino Unido de Gran Bretaña e Irlanda del Norte,2,2,,4,-77.35002,8.63337
22334,2013,Noviembre,República Dominicana,2,3,,5,-77.35600000000001,0.81488
22335,2013,Noviembre,República Dominicana,0,1,,1,-78.802679,18.00143
22336,2013,Noviembre,República Dominicana,2,8,,10,-75.527794,10.406342
22337,2013,Noviembre,República Dominicana,23,71,,94,-75.516486,10.446304
22338,2013,Noviembre,República Dominicana,12,29,,41,-74.77647900000001,10.886686
22339,2013,Noviembre,República Dominicana,1,2,,3,-72.129595,11.360028999999999
22340,2013,Noviembre,República Dominicana,0,1,,1,-81.70216500000001,12.5862
22341,2013,Noviembre,República Dominicana,19,30,,49,-76.532004,3.451668
22342,2013,Noviembre,República Dominicana,227,416,,643,-74.140516,4.697157
22343,2013,Noviembre,República Dominicana,0,3,,3,-75.736374,4.815189
22344,2013,Noviembre,República Dominicana,39,75,,114,-75.42726,6.170465
22345,2013,Noviembre,República Dominicana,0,2,,2,-73.181317,7.1280470000000005
22346,2013,Noviembre,República Dominicana,1,7,,8,-72.453013,7.819
22347,2013,Noviembre,República Dominicana,0,1,,1,-72.508188,7.927233
22348,2013,Noviembre,República Dominicana,0,1,,1,-77.35002,8.63337
22349,2013,Noviembre,República Checa,0,1,,1,-69.941498,4.191162
22350,2013,Noviembre,República Checa,1,1,,2,-76.876446,0.33002
22351,2013,Noviembre,República Checa,0,1,,1,-74.213989,11.247722999999999
22352,2013,Noviembre,República Democrática Popular de Corea,0,1,,1,-74.140516,4.697157
22353,2013,Noviembre,Rumania,0,1,,1,-77.35600000000001,0.81488
22354,2013,Noviembre,Rumania,2,9,,11,-75.527794,10.406342
22355,2013,Noviembre,Rumania,2,0,,2,-75.516486,10.446304
22356,2013,Noviembre,Rumania,2,4,,6,-76.532004,3.451668
22357,2013,Noviembre,Rumania,0,1,,1,-77.061029,3.8844260000000004
22358,2013,Noviembre,Rumania,31,59,,90,-74.140516,4.697157
22359,2013,Noviembre,Rumania,1,2,,3,-75.42726,6.170465
22360,2013,Noviembre,Rumania,1,1,,2,-72.453013,7.819
22361,2013,Noviembre,Rumania,0,2,,2,-75.68164200000001,9.402597
22362,2013,Noviembre,Federación de Rusia,3,7,,10,-77.35600000000001,0.81488
22363,2013,Noviembre,Federación de Rusia,2,5,,7,-75.527794,10.406342
22364,2013,Noviembre,Federación de Rusia,5,9,,14,-75.516486,10.446304
22365,2013,Noviembre,Federación de Rusia,3,0,,3,-74.77647900000001,10.886686
22366,2013,Noviembre,Federación de Rusia,3,9,,12,-72.129595,11.360028999999999
22367,2013,Noviembre,Federación de Rusia,0,1,,1,-81.70216500000001,12.5862
22368,2013,Noviembre,Federación de Rusia,5,5,,10,-76.532004,3.451668
22369,2013,Noviembre,Federación de Rusia,0,1,,1,-77.061029,3.8844260000000004
22370,2013,Noviembre,Federación de Rusia,172,238,,410,-74.140516,4.697157
22371,2013,Noviembre,Federación de Rusia,7,6,,13,-75.42726,6.170465
22372,2013,Noviembre,Federación de Rusia,3,4,,7,-72.453013,7.819
22373,2013,Noviembre,Federación de Rusia,2,0,,2,-72.508188,7.927233
22374,2013,Noviembre,Federación de Rusia,0,1,,1,-77.35002,8.63337
22375,2013,Noviembre,San Cristóbal y Nevis,1,0,,1,-75.42726,6.170465
22376,2013,Noviembre,Samoa Occidental,1,0,,1,-74.140516,4.697157
22377,2013,Noviembre,San Marino,0,1,,1,-74.140516,4.697157
22378,2013,Noviembre,San  Vicente y las Granadinas,1,0,,1,-81.70216500000001,12.5862
22379,2013,Noviembre,San  Vicente y las Granadinas,0,1,,1,-74.140516,4.697157
22380,2013,Noviembre,San  Vicente y las Granadinas,0,1,,1,-75.42726,6.170465
22381,2013,Noviembre,Santa Lucia,0,1,,1,-75.516486,10.446304
22382,2013,Noviembre,Santa Lucia,4,0,,4,-74.140516,4.697157
22383,2013,Noviembre,Santa Lucia,0,1,,1,-75.42726,6.170465
22384,2013,Noviembre,Senegal,0,2,,2,-74.140516,4.697157
22385,2013,Noviembre,Serbia,0,2,,2,-75.516486,10.446304
22386,2013,Noviembre,Serbia,2,11,,13,-74.140516,4.697157
22387,2013,Noviembre,Serbia,1,0,,1,-75.42726,6.170465
22388,2013,Noviembre,Singapur,1,0,,1,-77.35600000000001,0.81488
22389,2013,Noviembre,Singapur,0,2,,2,-75.527794,10.406342
22390,2013,Noviembre,Singapur,3,1,,4,-75.516486,10.446304
22391,2013,Noviembre,Singapur,9,11,,20,-74.140516,4.697157
22392,2013,Noviembre,Singapur,0,2,,2,-75.42726,6.170465
22393,2013,Noviembre,República Árabe Siria,0,1,,1,-74.140516,4.697157
22394,2013,Noviembre,Sri Lanka,0,1,,1,-74.140516,4.697157
22395,2013,Noviembre,Sudáfrica,0,1,,1,-69.941498,4.191162
22396,2013,Noviembre,Sudáfrica,0,1,,1,-77.35600000000001,0.81488
22397,2013,Noviembre,Sudáfrica,2,4,,6,-75.527794,10.406342
22398,2013,Noviembre,Sudáfrica,0,5,,5,-75.516486,10.446304
22399,2013,Noviembre,Sudáfrica,0,3,,3,-74.77647900000001,10.886686
22400,2013,Noviembre,Sudáfrica,1,3,,4,-74.765343,10.970933
22401,2013,Noviembre,Sudáfrica,1,1,,2,-72.129595,11.360028999999999
22402,2013,Noviembre,Sudáfrica,2,0,,2,-81.70216500000001,12.5862
22403,2013,Noviembre,Sudáfrica,0,2,,2,-81.372937,13.338761300000002
22404,2013,Noviembre,Sudáfrica,2,2,,4,-76.532004,3.451668
22405,2013,Noviembre,Sudáfrica,48,108,,156,-74.140516,4.697157
22406,2013,Noviembre,Sudáfrica,2,7,,9,-75.42726,6.170465
22407,2013,Noviembre,Sudáfrica,0,2,,2,-72.453013,7.819
22408,2013,Noviembre,Sudáfrica,1,1,,2,-77.35002,8.63337
22409,2013,Noviembre,Sudán,0,1,,1,-74.140516,4.697157
22410,2013,Noviembre,Suecia,1,2,,3,-69.941498,4.191162
22411,2013,Noviembre,Suecia,8,14,,22,-77.35600000000001,0.81488
22412,2013,Noviembre,Suecia,4,5,,9,-75.527794,10.406342
22413,2013,Noviembre,Suecia,7,19,,26,-75.516486,10.446304
22414,2013,Noviembre,Suecia,2,2,,4,-74.77647900000001,10.886686
22415,2013,Noviembre,Suecia,2,2,,4,-74.213989,11.247722999999999
22416,2013,Noviembre,Suecia,0,1,,1,-72.129595,11.360028999999999
22417,2013,Noviembre,Suecia,19,15,,34,-76.532004,3.451668
22418,2013,Noviembre,Suecia,142,250,,392,-74.140516,4.697157
22419,2013,Noviembre,Suecia,14,19,,33,-75.42726,6.170465
22420,2013,Noviembre,Suecia,0,1,,1,-67.48402800000001,6.185536
22421,2013,Noviembre,Suecia,0,1,,1,-73.181317,7.1280470000000005
22422,2013,Noviembre,Suecia,2,4,,6,-72.453013,7.819
22423,2013,Noviembre,Suiza,2,4,,6,-69.941498,4.191162
22424,2013,Noviembre,Suiza,18,27,,45,-77.35600000000001,0.81488
22425,2013,Noviembre,Suiza,6,8,,14,-75.527794,10.406342
22426,2013,Noviembre,Suiza,11,27,,38,-75.516486,10.446304
22427,2013,Noviembre,Suiza,3,4,,7,-74.77647900000001,10.886686
22428,2013,Noviembre,Suiza,2,1,,3,-74.213989,11.247722999999999
22429,2013,Noviembre,Suiza,2,3,,5,-72.129595,11.360028999999999
22430,2013,Noviembre,Suiza,1,1,,2,-81.70216500000001,12.5862
22431,2013,Noviembre,Suiza,15,20,,35,-76.532004,3.451668
22432,2013,Noviembre,Suiza,1,0,,1,-75.76635300000001,4.45285
22433,2013,Noviembre,Suiza,264,497,,761,-74.140516,4.697157
22434,2013,Noviembre,Suiza,0,1,,1,-75.736374,4.815189
22435,2013,Noviembre,Suiza,21,46,,67,-75.42726,6.170465
22436,2013,Noviembre,Suiza,8,6,,14,-72.453013,7.819
22437,2013,Noviembre,Suiza,2,1,,3,-72.508188,7.927233
22438,2013,Noviembre,Surinam,2,1,,3,-75.516486,10.446304
22439,2013,Noviembre,Surinam,1,1,,2,-76.532004,3.451668
22440,2013,Noviembre,Surinam,14,17,,31,-74.140516,4.697157
22441,2013,Noviembre,Surinam,5,14,,19,-75.42726,6.170465
22442,2013,Noviembre,Taiwán,2,2,,4,-77.35600000000001,0.81488
22443,2013,Noviembre,Taiwán,1,4,,5,-75.516486,10.446304
22444,2013,Noviembre,Taiwán,1,3,,4,-74.77647900000001,10.886686
22445,2013,Noviembre,Taiwán,1,4,,5,-76.532004,3.451668
22446,2013,Noviembre,Taiwán,37,78,,115,-74.140516,4.697157
22447,2013,Noviembre,Taiwán,0,1,,1,-75.736374,4.815189
22448,2013,Noviembre,Taiwán,9,11,,20,-75.42726,6.170465
22449,2013,Noviembre,Tailandia,1,0,,1,-75.516486,10.446304
22450,2013,Noviembre,Tailandia,10,7,,17,-74.140516,4.697157
22451,2013,Noviembre,Tanzania,0,1,,1,-74.140516,4.697157
22452,2013,Noviembre,Togo,0,1,,1,-75.516486,10.446304
22453,2013,Noviembre,Trinidad y Tobago,0,1,,1,-69.941498,4.191162
22454,2013,Noviembre,Trinidad y Tobago,0,1,,1,-77.35600000000001,0.81488
22455,2013,Noviembre,Trinidad y Tobago,4,5,,9,-75.516486,10.446304
22456,2013,Noviembre,Trinidad y Tobago,1,2,,3,-74.77647900000001,10.886686
22457,2013,Noviembre,Trinidad y Tobago,0,1,,1,-81.70216500000001,12.5862
22458,2013,Noviembre,Trinidad y Tobago,3,10,,13,-76.532004,3.451668
22459,2013,Noviembre,Trinidad y Tobago,8,30,,38,-74.140516,4.697157
22460,2013,Noviembre,Trinidad y Tobago,9,19,,28,-75.42726,6.170465
22461,2013,Noviembre,Trinidad y Tobago,0,3,,3,-72.453013,7.819
22462,2013,Noviembre,Trinidad y Tobago,0,1,,1,-72.508188,7.927233
22463,2013,Noviembre,Túnez,0,1,,1,-76.532004,3.451668
22464,2013,Noviembre,Túnez,1,2,,3,-74.140516,4.697157
22465,2013,Noviembre,Turquía,0,2,,2,-77.35600000000001,0.81488
22466,2013,Noviembre,Turquía,1,5,,6,-75.527794,10.406342
22467,2013,Noviembre,Turquía,4,8,,12,-75.516486,10.446304
22468,2013,Noviembre,Turquía,0,1,,1,-74.77647900000001,10.886686
22469,2013,Noviembre,Turquía,0,4,,4,-74.765343,10.970933
22470,2013,Noviembre,Turquía,23,117,,140,-74.140516,4.697157
22471,2013,Noviembre,Turquía,0,10,,10,-75.42726,6.170465
22472,2013,Noviembre,Turquía,0,1,,1,-72.453013,7.819
22473,2013,Noviembre,Ucrania,0,3,,3,-75.527794,10.406342
22474,2013,Noviembre,Ucrania,1,1,,2,-75.516486,10.446304
22475,2013,Noviembre,Ucrania,0,1,,1,-74.765343,10.970933
22476,2013,Noviembre,Ucrania,0,3,,3,-74.213989,11.247722999999999
22477,2013,Noviembre,Ucrania,1,1,,2,-76.532004,3.451668
22478,2013,Noviembre,Ucrania,0,3,,3,-77.061029,3.8844260000000004
22479,2013,Noviembre,Ucrania,12,44,,56,-74.140516,4.697157
22480,2013,Noviembre,Ucrania,5,1,,6,-75.42726,6.170465
22481,2013,Noviembre,Uganda,0,1,,1,-76.532004,3.451668
22482,2013,Noviembre,Uganda,0,1,,1,-74.140516,4.697157
22483,2013,Noviembre,Federación de Rusia,0,3,,3,-69.941498,4.191162
22484,2013,Noviembre,Federación de Rusia,1,1,,2,-78.802679,18.00143
22485,2013,Noviembre,Federación de Rusia,0,1,,1,-74.765343,10.970933
22486,2013,Noviembre,Federación de Rusia,0,1,,1,-72.453013,7.819
22487,2013,Noviembre,Uruguay,6,9,,15,-77.35600000000001,0.81488
22488,2013,Noviembre,Uruguay,35,18,,53,-75.527794,10.406342
22489,2013,Noviembre,Uruguay,100,68,,168,-75.516486,10.446304
22490,2013,Noviembre,Uruguay,5,8,,13,-74.77647900000001,10.886686
22491,2013,Noviembre,Uruguay,20,19,,39,-81.70216500000001,12.5862
22492,2013,Noviembre,Uruguay,21,32,,53,-76.532004,3.451668
22493,2013,Noviembre,Uruguay,139,285,,424,-74.140516,4.697157
22494,2013,Noviembre,Uruguay,0,3,,3,-75.736374,4.815189
22495,2013,Noviembre,Uruguay,29,66,,95,-75.42726,6.170465
22496,2013,Noviembre,Uruguay,0,2,,2,-73.181317,7.1280470000000005
22497,2013,Noviembre,Uruguay,2,3,,5,-72.453013,7.819
22498,2013,Noviembre,Uruguay,0,1,,1,-72.508188,7.927233
22499,2013,Noviembre,Venezuela,2,0,,2,-69.941498,4.191162
22500,2013,Noviembre,Venezuela,172,241,,413,-77.35600000000001,0.81488
22501,2013,Noviembre,Venezuela,9,34,,43,-75.527794,10.406342
22502,2013,Noviembre,Venezuela,80,133,,213,-75.516486,10.446304
22503,2013,Noviembre,Venezuela,37,91,,128,-74.77647900000001,10.886686
22504,2013,Noviembre,Venezuela,0,1,,1,-74.765343,10.970933
22505,2013,Noviembre,Venezuela,1016,1966,,2982,-72.129595,11.360028999999999
22506,2013,Noviembre,Venezuela,2,3,,5,-72.919186,11.52863
22507,2013,Noviembre,Venezuela,0,1,,1,-81.703935,12.574411099999999
22508,2013,Noviembre,Venezuela,4,3,,7,-81.70216500000001,12.5862
22509,2013,Noviembre,Venezuela,77,133,,210,-76.532004,3.451668
22510,2013,Noviembre,Venezuela,0,1,,1,-75.76635300000001,4.45285
22511,2013,Noviembre,Venezuela,5512,6300,,11812,-74.140516,4.697157
22512,2013,Noviembre,Venezuela,2,10,,12,-75.736374,4.815189
22513,2013,Noviembre,Venezuela,795,783,,1578,-75.42726,6.170465
22514,2013,Noviembre,Venezuela,136,189,,325,-67.48402800000001,6.185536
22515,2013,Noviembre,Venezuela,69,132,,201,-70.74025300000001,7.088728999999999
22516,2013,Noviembre,Venezuela,2,10,,12,-73.181317,7.1280470000000005
22517,2013,Noviembre,Venezuela,1678,2290,,3968,-72.453013,7.819
22518,2013,Noviembre,Venezuela,388,536,,924,-72.508188,7.927233
22519,2013,Noviembre,Venezuela,0,1,,1,-77.35002,8.63337
22520,2013,Noviembre,Vietnam,3,4,,7,-74.140516,4.697157
22521,2013,Noviembre,República Árabe de Yemen,0,1,,1,-74.140516,4.697157
22522,2013,Noviembre,Zimbabue,0,1,,1,-77.35600000000001,0.81488
22523,2013,Noviembre,Zimbabue,0,1,,1,-75.42726,6.170465
22524,2013,Noviembre,Zimbabue,1,0,,1,-72.453013,7.819
22525,2013,Noviembre,Reino Unido de Gran Bretaña e Irlanda del Norte,3,3,,6,-69.941498,4.191162
22526,2013,Noviembre,Reino Unido de Gran Bretaña e Irlanda del Norte,2,2,,4,-75.527794,10.406342
22527,2013,Noviembre,Reino Unido de Gran Bretaña e Irlanda del Norte,3,1,,4,-74.213989,11.247722999999999
22528,2013,Noviembre,Reino Unido de Gran Bretaña e Irlanda del Norte,2,1,,3,-81.703935,12.574411099999999
22529,2013,Noviembre,Reino Unido de Gran Bretaña e Irlanda del Norte,0,1,,1,-72.453013,7.819
22530,2013,Noviembre,Países Bajos,1,3,,4,-69.941498,4.191162
22531,2013,Noviembre,Países Bajos,0,1,,1,-77.35600000000001,0.81488
22532,2013,Noviembre,Países Bajos,3,4,,7,-75.527794,10.406342
22533,2013,Noviembre,Países Bajos,1,2,,3,-75.516486,10.446304
22534,2013,Noviembre,Países Bajos,1,2,,3,-74.213989,11.247722999999999
22535,2013,Noviembre,Países Bajos,1,2,,3,-72.919186,11.52863
22536,2013,Noviembre,Países Bajos,1,0,,1,-81.70216500000001,12.5862
22537,2013,Noviembre,Países Bajos,2,4,,6,-76.532004,3.451668
22538,2013,Noviembre,Países Bajos,4,5,,9,-74.140516,4.697157
22539,2013,Noviembre,Países Bajos,0,1,,1,-75.42726,6.170465
22540,2013,Noviembre,Países Bajos,0,3,,3,-73.181317,7.1280470000000005
22541,2013,Noviembre,Países Bajos,2,4,,6,-72.453013,7.819
22542,2013,Noviembre,Reino Unido de Gran Bretaña e Irlanda del Norte,0,1,,1,-75.527794,10.406342
22543,2013,Noviembre,Desconocido,4,3,,7,-75.516486,10.446304
22544,2013,Noviembre,Desconocido,0,3,,3,-74.77647900000001,10.886686
22545,2013,Noviembre,Desconocido,1,4,,5,-76.532004,3.451668
22546,2013,Noviembre,Desconocido,38,71,,109,-74.140516,4.697157
22547,2013,Noviembre,Desconocido,5,2,,7,-75.42726,6.170465
22548,2013,Noviembre,República CentroÁfricana,0,1,,1,-74.140516,4.697157
22549,2013,Diciembre,Albania,0,1,,1,-77.35600000000001,0.81488
22550,2013,Diciembre,Albania,0,1,,1,-76.532004,3.451668
22551,2013,Diciembre,Albania,0,2,,2,-74.140516,4.697157
22552,2013,Diciembre,Albania,0,1,,1,-75.42726,6.170465
22553,2013,Diciembre,Alemania,15,15,,30,-69.941498,4.191162
22554,2013,Diciembre,Alemania,1,1,,2,-76.876446,0.33002
22555,2013,Diciembre,Alemania,44,52,,96,-77.35600000000001,0.81488
22556,2013,Diciembre,Alemania,27,31,,58,-75.527794,10.406342
22557,2013,Diciembre,Alemania,31,63,,94,-75.516486,10.446304
22558,2013,Diciembre,Alemania,9,22,,31,-74.77647900000001,10.886686
22559,2013,Diciembre,Alemania,4,5,,9,-74.213989,11.247722999999999
22560,2013,Diciembre,Alemania,7,10,,17,-72.129595,11.360028999999999
22561,2013,Diciembre,Alemania,5,3,,8,-81.70216500000001,12.5862
22562,2013,Diciembre,Alemania,48,92,,140,-76.532004,3.451668
22563,2013,Diciembre,Alemania,0,1,,1,-75.76635300000001,4.45285
22564,2013,Diciembre,Alemania,1329,2079,,3408,-74.140516,4.697157
22565,2013,Diciembre,Alemania,0,3,,3,-75.736374,4.815189
22566,2013,Diciembre,Alemania,49,127,,176,-75.42726,6.170465
22567,2013,Diciembre,Alemania,2,2,,4,-73.181317,7.1280470000000005
22568,2013,Diciembre,Alemania,9,14,,23,-72.453013,7.819
22569,2013,Diciembre,Alemania,7,8,,15,-77.35002,8.63337
22570,2013,Diciembre,Andorra,0,4,,4,-74.140516,4.697157
22571,2013,Diciembre,Angola,1,0,,1,-76.532004,3.451668
22572,2013,Diciembre,Antigua y Barbuda,0,7,,7,-74.140516,4.697157
22573,2013,Diciembre,Arabia Saudita,1,3,,4,-75.516486,10.446304
22574,2013,Diciembre,Arabia Saudita,1,20,,21,-74.140516,4.697157
22575,2013,Diciembre,Arabia Saudita,0,2,,2,-75.42726,6.170465
22576,2013,Diciembre,Arabia Saudita,0,1,,1,-72.508188,7.927233
22577,2013,Diciembre,Argelia,3,3,,6,-74.140516,4.697157
22578,2013,Diciembre,Argelia,0,1,,1,-72.453013,7.819
22579,2013,Diciembre,Argentina,0,4,,4,-69.941498,4.191162
22580,2013,Diciembre,Argentina,0,1,,1,-76.876446,0.33002
22581,2013,Diciembre,Argentina,60,133,,193,-77.35600000000001,0.81488
22582,2013,Diciembre,Argentina,44,21,,65,-75.527794,10.406342
22583,2013,Diciembre,Argentina,586,445,,1031,-75.516486,10.446304
22584,2013,Diciembre,Argentina,7,32,,39,-74.77647900000001,10.886686
22585,2013,Diciembre,Argentina,16,30,,46,-72.129595,11.360028999999999
22586,2013,Diciembre,Argentina,237,221,,458,-81.70216500000001,12.5862
22587,2013,Diciembre,Argentina,63,108,,171,-76.532004,3.451668
22588,2013,Diciembre,Argentina,2590,3677,,6267,-74.140516,4.697157
22589,2013,Diciembre,Argentina,108,210,,318,-75.42726,6.170465
22590,2013,Diciembre,Argentina,1,0,,1,-70.74025300000001,7.088728999999999
22591,2013,Diciembre,Argentina,2,3,,5,-73.181317,7.1280470000000005
22592,2013,Diciembre,Argentina,8,24,,32,-72.453013,7.819
22593,2013,Diciembre,Argentina,1,9,,10,-72.508188,7.927233
22594,2013,Diciembre,Argentina,3,7,,10,-77.35002,8.63337
22595,2013,Diciembre,República de Armenia,0,1,,1,-72.453013,7.819
22596,2013,Diciembre,Australia,9,9,,18,-69.941498,4.191162
22597,2013,Diciembre,Australia,40,40,,80,-77.35600000000001,0.81488
22598,2013,Diciembre,Australia,23,31,,54,-75.527794,10.406342
22599,2013,Diciembre,Australia,51,81,,132,-75.516486,10.446304
22600,2013,Diciembre,Australia,4,12,,16,-74.77647900000001,10.886686
22601,2013,Diciembre,Australia,2,2,,4,-74.213989,11.247722999999999
22602,2013,Diciembre,Australia,0,6,,6,-72.129595,11.360028999999999
22603,2013,Diciembre,Australia,4,1,,5,-81.70216500000001,12.5862
22604,2013,Diciembre,Australia,19,33,,52,-76.532004,3.451668
22605,2013,Diciembre,Australia,291,557,,848,-74.140516,4.697157
22606,2013,Diciembre,Australia,5,7,,12,-75.736374,4.815189
22607,2013,Diciembre,Australia,42,81,,123,-75.42726,6.170465
22608,2013,Diciembre,Australia,1,3,,4,-73.181317,7.1280470000000005
22609,2013,Diciembre,Australia,3,3,,6,-72.453013,7.819
22610,2013,Diciembre,Australia,0,1,,1,-72.508188,7.927233
22611,2013,Diciembre,Australia,2,8,,10,-77.35002,8.63337
22612,2013,Diciembre,Austria,0,2,,2,-69.941498,4.191162
22613,2013,Diciembre,Austria,5,6,,11,-77.35600000000001,0.81488
22614,2013,Diciembre,Austria,4,6,,10,-75.527794,10.406342
22615,2013,Diciembre,Austria,14,17,,31,-75.516486,10.446304
22616,2013,Diciembre,Austria,2,1,,3,-74.77647900000001,10.886686
22617,2013,Diciembre,Austria,0,2,,2,-72.129595,11.360028999999999
22618,2013,Diciembre,Austria,0,1,,1,-81.70216500000001,12.5862
22619,2013,Diciembre,Austria,2,8,,10,-76.532004,3.451668
22620,2013,Diciembre,Austria,105,219,,324,-74.140516,4.697157
22621,2013,Diciembre,Austria,5,16,,21,-75.42726,6.170465
22622,2013,Diciembre,Austria,2,5,,7,-72.453013,7.819
22623,2013,Diciembre,Austria,0,1,,1,-77.35002,8.63337
22624,2013,Diciembre,Azerbaiyán,3,0,,3,-74.140516,4.697157
22625,2013,Diciembre,Bahamas,0,1,,1,-74.140516,4.697157
22626,2013,Diciembre,Bahamas,0,1,,1,-75.736374,4.815189
22627,2013,Diciembre,Bahamas,0,3,,3,-75.42726,6.170465
22628,2013,Diciembre,Bahréin,3,1,,4,-74.140516,4.697157
22629,2013,Diciembre,Bangladesh,0,3,,3,-74.140516,4.697157
22630,2013,Diciembre,Barbados,2,0,,2,-75.527794,10.406342
22631,2013,Diciembre,Barbados,0,1,,1,-75.516486,10.446304
22632,2013,Diciembre,Barbados,0,1,,1,-76.532004,3.451668
22633,2013,Diciembre,Barbados,8,4,,12,-74.140516,4.697157
22634,2013,Diciembre,Barbados,3,0,,3,-75.42726,6.170465
22635,2013,Diciembre,República de Belarús,1,1,,2,-77.35600000000001,0.81488
22636,2013,Diciembre,República de Belarús,1,0,,1,-74.213989,11.247722999999999
22637,2013,Diciembre,República de Belarús,1,0,,1,-76.532004,3.451668
22638,2013,Diciembre,República de Belarús,0,1,,1,-75.42726,6.170465
22639,2013,Diciembre,Bélgica,1,0,,1,-69.941498,4.191162
22640,2013,Diciembre,Bélgica,12,13,,25,-77.35600000000001,0.81488
22641,2013,Diciembre,Bélgica,2,6,,8,-75.527794,10.406342
22642,2013,Diciembre,Bélgica,12,14,,26,-75.516486,10.446304
22643,2013,Diciembre,Bélgica,1,3,,4,-74.77647900000001,10.886686
22644,2013,Diciembre,Bélgica,1,9,,10,-74.213989,11.247722999999999
22645,2013,Diciembre,Bélgica,0,1,,1,-72.129595,11.360028999999999
22646,2013,Diciembre,Bélgica,1,0,,1,-81.70216500000001,12.5862
22647,2013,Diciembre,Bélgica,5,27,,32,-76.532004,3.451668
22648,2013,Diciembre,Bélgica,118,346,,464,-74.140516,4.697157
22649,2013,Diciembre,Bélgica,1,3,,4,-75.736374,4.815189
22650,2013,Diciembre,Bélgica,13,28,,41,-75.42726,6.170465
22651,2013,Diciembre,Bélgica,0,1,,1,-72.453013,7.819
22652,2013,Diciembre,Bélgica,0,2,,2,-72.508188,7.927233
22653,2013,Diciembre,Bélgica,2,3,,5,-77.35002,8.63337
22654,2013,Diciembre,Belice,0,1,,1,-75.516486,10.446304
22655,2013,Diciembre,Belice,3,1,,4,-74.77647900000001,10.886686
22656,2013,Diciembre,Belice,0,1,,1,-72.129595,11.360028999999999
22657,2013,Diciembre,Belice,1,0,,1,-76.532004,3.451668
22658,2013,Diciembre,Belice,6,11,,17,-74.140516,4.697157
22659,2013,Diciembre,Belice,1,1,,2,-75.42726,6.170465
22660,2013,Diciembre,Benín,3,0,,3,-72.129595,11.360028999999999
22661,2013,Diciembre,Benín,0,1,,1,-74.140516,4.697157
22662,2013,Diciembre,Bermudas/Territorio Británico de Ultramar,0,2,,2,-74.140516,4.697157
22663,2013,Diciembre,Bolivia,1,0,,1,-69.941498,4.191162
22664,2013,Diciembre,Bolivia,13,19,,32,-77.35600000000001,0.81488
22665,2013,Diciembre,Bolivia,7,4,,11,-75.527794,10.406342
22666,2013,Diciembre,Bolivia,18,26,,44,-75.516486,10.446304
22667,2013,Diciembre,Bolivia,3,2,,5,-74.77647900000001,10.886686
22668,2013,Diciembre,Bolivia,2,1,,3,-72.129595,11.360028999999999
22669,2013,Diciembre,Bolivia,24,17,,41,-81.70216500000001,12.5862
22670,2013,Diciembre,Bolivia,16,22,,38,-76.532004,3.451668
22671,2013,Diciembre,Bolivia,501,448,,949,-74.140516,4.697157
22672,2013,Diciembre,Bolivia,1,1,,2,-75.736374,4.815189
22673,2013,Diciembre,Bolivia,21,22,,43,-75.42726,6.170465
22674,2013,Diciembre,Bolivia,8,13,,21,-72.453013,7.819
22675,2013,Diciembre,Bolivia,1,6,,7,-72.508188,7.927233
22676,2013,Diciembre,Bosnia y Herzegovina,0,1,,1,-74.140516,4.697157
22677,2013,Diciembre,Brasil,92,121,,213,-69.941498,4.191162
22678,2013,Diciembre,Brasil,18,17,,35,-77.35600000000001,0.81488
22679,2013,Diciembre,Brasil,68,61,,129,-75.527794,10.406342
22680,2013,Diciembre,Brasil,335,269,,604,-75.516486,10.446304
22681,2013,Diciembre,Brasil,17,24,,41,-74.77647900000001,10.886686
22682,2013,Diciembre,Brasil,16,20,,36,-72.129595,11.360028999999999
22683,2013,Diciembre,Brasil,55,41,,96,-81.70216500000001,12.5862
22684,2013,Diciembre,Brasil,46,84,,130,-76.532004,3.451668
22685,2013,Diciembre,Brasil,3168,3922,,7090,-74.140516,4.697157
22686,2013,Diciembre,Brasil,0,4,,4,-75.736374,4.815189
22687,2013,Diciembre,Brasil,69,137,,206,-75.42726,6.170465
22688,2013,Diciembre,Brasil,0,3,,3,-67.48402800000001,6.185536
22689,2013,Diciembre,Brasil,1,0,,1,-70.74025300000001,7.088728999999999
22690,2013,Diciembre,Brasil,0,3,,3,-73.181317,7.1280470000000005
22691,2013,Diciembre,Brasil,12,27,,39,-72.453013,7.819
22692,2013,Diciembre,Brasil,4,4,,8,-72.508188,7.927233
22693,2013,Diciembre,Brasil,1,0,,1,-77.35002,8.63337
22694,2013,Diciembre,Bulgaria,0,1,,1,-75.527794,10.406342
22695,2013,Diciembre,Bulgaria,1,2,,3,-75.516486,10.446304
22696,2013,Diciembre,Bulgaria,1,2,,3,-76.532004,3.451668
22697,2013,Diciembre,Bulgaria,0,1,,1,-77.061029,3.8844260000000004
22698,2013,Diciembre,Bulgaria,13,12,,25,-74.140516,4.697157
22699,2013,Diciembre,Bulgaria,1,3,,4,-75.42726,6.170465
22700,2013,Diciembre,Bulgaria,1,0,,1,-77.35002,8.63337
22701,2013,Diciembre,Burkina Faso,0,1,,1,-74.140516,4.697157
22702,2013,Diciembre,Burundi,0,1,,1,-74.140516,4.697157
22703,2013,Diciembre,Cabo Verde,0,1,,1,-74.140516,4.697157
22704,2013,Diciembre,Islas Caimán/Territorio Británico de Ultramar,2,9,,11,-81.70216500000001,12.5862
22705,2013,Diciembre,Islas Caimán/Territorio Británico de Ultramar,2,1,,3,-74.140516,4.697157
22706,2013,Diciembre,Camboya,0,1,,1,-74.140516,4.697157
22707,2013,Diciembre,Camerún,0,1,,1,-74.140516,4.697157
22708,2013,Diciembre,Canadá,3,4,,7,-69.941498,4.191162
22709,2013,Diciembre,Canadá,1,2,,3,-76.876446,0.33002
22710,2013,Diciembre,Canadá,13,21,,34,-77.35600000000001,0.81488
22711,2013,Diciembre,Canadá,9,17,,26,-75.527794,10.406342
22712,2013,Diciembre,Canadá,561,615,,1176,-75.516486,10.446304
22713,2013,Diciembre,Canadá,19,57,,76,-74.77647900000001,10.886686
22714,2013,Diciembre,Canadá,0,3,,3,-72.129595,11.360028999999999
22715,2013,Diciembre,Canadá,212,228,,440,-81.70216500000001,12.5862
22716,2013,Diciembre,Canadá,89,133,,222,-76.532004,3.451668
22717,2013,Diciembre,Canadá,25,22,,47,-75.76635300000001,4.45285
22718,2013,Diciembre,Canadá,1167,1963,,3130,-74.140516,4.697157
22719,2013,Diciembre,Canadá,13,10,,23,-75.736374,4.815189
22720,2013,Diciembre,Canadá,211,327,,538,-75.42726,6.170465
22721,2013,Diciembre,Canadá,3,9,,12,-73.181317,7.1280470000000005
22722,2013,Diciembre,Canadá,3,8,,11,-72.453013,7.819
22723,2013,Diciembre,Canadá,3,7,,10,-72.508188,7.927233
22724,2013,Diciembre,Canadá,6,7,,13,-77.35002,8.63337
22725,2013,Diciembre,República Democrática del Congo,0,1,,1,-72.129595,11.360028999999999
22726,2013,Diciembre,República Democrática del Congo,2,4,,6,-74.140516,4.697157
22727,2013,Diciembre,República Democrática del Congo,2,0,,2,-75.42726,6.170465
22728,2013,Diciembre,República de Corea,2,1,,3,-69.941498,4.191162
22729,2013,Diciembre,República de Corea,5,10,,15,-77.35600000000001,0.81488
22730,2013,Diciembre,República de Corea,5,2,,7,-75.516486,10.446304
22731,2013,Diciembre,República de Corea,0,5,,5,-72.129595,11.360028999999999
22732,2013,Diciembre,República de Corea,1,1,,2,-81.70216500000001,12.5862
22733,2013,Diciembre,República de Corea,3,9,,12,-76.532004,3.451668
22734,2013,Diciembre,República de Corea,159,303,,462,-74.140516,4.697157
22735,2013,Diciembre,República de Corea,12,22,,34,-75.42726,6.170465
22736,2013,Diciembre,República de Corea,0,1,,1,-73.181317,7.1280470000000005
22737,2013,Diciembre,República de Corea,2,3,,5,-72.453013,7.819
22738,2013,Diciembre,República de Corea,0,1,,1,-77.35002,8.63337
22739,2013,Diciembre,Costa de Marfil,1,0,,1,-74.140516,4.697157
22740,2013,Diciembre,Costa Rica,1,8,,9,-77.35600000000001,0.81488
22741,2013,Diciembre,Costa Rica,0,2,,2,-75.527794,10.406342
22742,2013,Diciembre,Costa Rica,53,62,,115,-75.516486,10.446304
22743,2013,Diciembre,Costa Rica,25,37,,62,-74.77647900000001,10.886686
22744,2013,Diciembre,Costa Rica,2,2,,4,-72.129595,11.360028999999999
22745,2013,Diciembre,Costa Rica,371,305,,676,-81.70216500000001,12.5862
22746,2013,Diciembre,Costa Rica,39,70,,109,-76.532004,3.451668
22747,2013,Diciembre,Costa Rica,679,889,,1568,-74.140516,4.697157
22748,2013,Diciembre,Costa Rica,5,13,,18,-75.736374,4.815189
22749,2013,Diciembre,Costa Rica,144,232,,376,-75.42726,6.170465
22750,2013,Diciembre,Costa Rica,1,2,,3,-73.181317,7.1280470000000005
22751,2013,Diciembre,Costa Rica,0,5,,5,-72.453013,7.819
22752,2013,Diciembre,Costa Rica,4,4,,8,-72.508188,7.927233
22753,2013,Diciembre,Costa Rica,1,0,,1,-77.35002,8.63337
22754,2013,Diciembre,Croacia,1,0,,1,-69.941498,4.191162
22755,2013,Diciembre,Croacia,0,2,,2,-75.527794,10.406342
22756,2013,Diciembre,Croacia,0,1,,1,-75.516486,10.446304
22757,2013,Diciembre,Croacia,0,6,,6,-74.213989,11.247722999999999
22758,2013,Diciembre,Croacia,7,27,,34,-74.140516,4.697157
22759,2013,Diciembre,Croacia,0,1,,1,-75.42726,6.170465
22760,2013,Diciembre,Croacia,0,1,,1,-72.453013,7.819
22761,2013,Diciembre,Cuba,0,1,,1,-69.941498,4.191162
22762,2013,Diciembre,Cuba,0,5,,5,-77.35600000000001,0.81488
22763,2013,Diciembre,Cuba,5,13,,18,-75.516486,10.446304
22764,2013,Diciembre,Cuba,7,11,,18,-74.77647900000001,10.886686
22765,2013,Diciembre,Cuba,1,0,,1,-81.70216500000001,12.5862
22766,2013,Diciembre,Cuba,11,44,,55,-76.532004,3.451668
22767,2013,Diciembre,Cuba,97,172,,269,-74.140516,4.697157
22768,2013,Diciembre,Cuba,16,33,,49,-75.42726,6.170465
22769,2013,Diciembre,Cuba,0,1,,1,-73.181317,7.1280470000000005
22770,2013,Diciembre,Cuba,0,2,,2,-72.453013,7.819
22771,2013,Diciembre,Curazao,3,4,,7,-74.140516,4.697157
22772,2013,Diciembre,República Checa,0,2,,2,-69.941498,4.191162
22773,2013,Diciembre,República Checa,4,6,,10,-77.35600000000001,0.81488
22774,2013,Diciembre,República Checa,1,4,,5,-75.527794,10.406342
22775,2013,Diciembre,República Checa,1,0,,1,-75.516486,10.446304
22776,2013,Diciembre,República Checa,1,0,,1,-74.77647900000001,10.886686
22777,2013,Diciembre,República Checa,1,1,,2,-72.129595,11.360028999999999
22778,2013,Diciembre,República Checa,2,5,,7,-76.532004,3.451668
22779,2013,Diciembre,República Checa,28,30,,58,-74.140516,4.697157
22780,2013,Diciembre,República Checa,5,3,,8,-75.42726,6.170465
22781,2013,Diciembre,República Checa,0,2,,2,-73.181317,7.1280470000000005
22782,2013,Diciembre,República Checa,0,2,,2,-72.453013,7.819
22783,2013,Diciembre,Chile,2,2,,4,-69.941498,4.191162
22784,2013,Diciembre,Chile,42,97,,139,-77.35600000000001,0.81488
22785,2013,Diciembre,Chile,10,9,,19,-75.527794,10.406342
22786,2013,Diciembre,Chile,49,63,,112,-75.516486,10.446304
22787,2013,Diciembre,Chile,5,14,,19,-74.77647900000001,10.886686
22788,2013,Diciembre,Chile,2,6,,8,-72.129595,11.360028999999999
22789,2013,Diciembre,Chile,22,19,,41,-81.70216500000001,12.5862
22790,2013,Diciembre,Chile,88,145,,233,-76.532004,3.451668
22791,2013,Diciembre,Chile,0,1,,1,-75.76635300000001,4.45285
22792,2013,Diciembre,Chile,1703,2650,,4353,-74.140516,4.697157
22793,2013,Diciembre,Chile,0,1,,1,-75.736374,4.815189
22794,2013,Diciembre,Chile,36,125,,161,-75.42726,6.170465
22795,2013,Diciembre,Chile,1,2,,3,-70.74025300000001,7.088728999999999
22796,2013,Diciembre,Chile,0,2,,2,-73.181317,7.1280470000000005
22797,2013,Diciembre,Chile,11,24,,35,-72.453013,7.819
22798,2013,Diciembre,China,1,0,,1,-69.941498,4.191162
22799,2013,Diciembre,China,0,2,,2,-77.35600000000001,0.81488
22800,2013,Diciembre,China,4,5,,9,-75.516486,10.446304
22801,2013,Diciembre,China,1,4,,5,-74.77647900000001,10.886686
22802,2013,Diciembre,China,1,1,,2,-72.129595,11.360028999999999
22803,2013,Diciembre,China,3,6,,9,-76.532004,3.451668
22804,2013,Diciembre,China,0,1,,1,-77.061029,3.8844260000000004
22805,2013,Diciembre,China,1,1,,2,-75.76635300000001,4.45285
22806,2013,Diciembre,China,127,383,,510,-74.140516,4.697157
22807,2013,Diciembre,China,9,5,,14,-75.42726,6.170465
22808,2013,Diciembre,China,0,1,,1,-72.453013,7.819
22809,2013,Diciembre,Chipre,1,3,,4,-75.516486,10.446304
22810,2013,Diciembre,Chipre,0,8,,8,-74.140516,4.697157
22811,2013,Diciembre,Dinamarca,2,2,,4,-69.941498,4.191162
22812,2013,Diciembre,Dinamarca,2,2,,4,-77.35600000000001,0.81488
22813,2013,Diciembre,Dinamarca,3,4,,7,-75.527794,10.406342
22814,2013,Diciembre,Dinamarca,5,7,,12,-75.516486,10.446304
22815,2013,Diciembre,Dinamarca,0,2,,2,-74.77647900000001,10.886686
22816,2013,Diciembre,Dinamarca,1,1,,2,-72.129595,11.360028999999999
22817,2013,Diciembre,Dinamarca,2,9,,11,-76.532004,3.451668
22818,2013,Diciembre,Dinamarca,77,141,,218,-74.140516,4.697157
22819,2013,Diciembre,Dinamarca,10,19,,29,-75.42726,6.170465
22820,2013,Diciembre,Dinamarca,0,2,,2,-72.453013,7.819
22821,2013,Diciembre,Dominica,0,3,,3,-74.140516,4.697157
22822,2013,Diciembre,Ecuador,0,4,,4,-69.941498,4.191162
22823,2013,Diciembre,Ecuador,30,94,,124,-76.876446,0.33002
22824,2013,Diciembre,Ecuador,1659,2555,,4214,-77.35600000000001,0.81488
22825,2013,Diciembre,Ecuador,7,2,,9,-78.802679,18.00143
22826,2013,Diciembre,Ecuador,2,18,,20,-75.527794,10.406342
22827,2013,Diciembre,Ecuador,12,16,,28,-75.516486,10.446304
22828,2013,Diciembre,Ecuador,7,12,,19,-74.77647900000001,10.886686
22829,2013,Diciembre,Ecuador,28,44,,72,-72.129595,11.360028999999999
22830,2013,Diciembre,Ecuador,3,4,,7,-81.70216500000001,12.5862
22831,2013,Diciembre,Ecuador,454,541,,995,-76.532004,3.451668
22832,2013,Diciembre,Ecuador,0,1,,1,-75.76635300000001,4.45285
22833,2013,Diciembre,Ecuador,1743,2544,,4287,-74.140516,4.697157
22834,2013,Diciembre,Ecuador,2,1,,3,-75.736374,4.815189
22835,2013,Diciembre,Ecuador,621,662,,1283,-75.42726,6.170465
22836,2013,Diciembre,Ecuador,1,2,,3,-73.181317,7.1280470000000005
22837,2013,Diciembre,Ecuador,279,390,,669,-72.453013,7.819
22838,2013,Diciembre,Ecuador,2,2,,4,-72.508188,7.927233
22839,2013,Diciembre,Ecuador,0,2,,2,-77.35002,8.63337
22840,2013,Diciembre,Egipto,0,1,,1,-75.516486,10.446304
22841,2013,Diciembre,Egipto,1,0,,1,-81.70216500000001,12.5862
22842,2013,Diciembre,Egipto,1,12,,13,-74.140516,4.697157
22843,2013,Diciembre,El Salvador,1,2,,3,-75.527794,10.406342
22844,2013,Diciembre,El Salvador,9,9,,18,-75.516486,10.446304
22845,2013,Diciembre,El Salvador,6,7,,13,-74.77647900000001,10.886686
22846,2013,Diciembre,El Salvador,0,1,,1,-74.213989,11.247722999999999
22847,2013,Diciembre,El Salvador,0,1,,1,-72.129595,11.360028999999999
22848,2013,Diciembre,El Salvador,0,1,,1,-81.70216500000001,12.5862
22849,2013,Diciembre,El Salvador,61,101,,162,-76.532004,3.451668
22850,2013,Diciembre,El Salvador,0,1,,1,-75.76635300000001,4.45285
22851,2013,Diciembre,El Salvador,418,610,,1028,-74.140516,4.697157
22852,2013,Diciembre,El Salvador,1,2,,3,-75.736374,4.815189
22853,2013,Diciembre,El Salvador,34,53,,87,-75.42726,6.170465
22854,2013,Diciembre,El Salvador,2,1,,3,-72.453013,7.819
22855,2013,Diciembre,Emiratos Árabes,3,2,,5,-76.532004,3.451668
22856,2013,Diciembre,Emiratos Árabes,1,2,,3,-74.140516,4.697157
22857,2013,Diciembre,Emiratos Árabes,0,1,,1,-75.42726,6.170465
22858,2013,Diciembre,España,5,6,,11,-69.941498,4.191162
22859,2013,Diciembre,España,0,1,,1,-76.876446,0.33002
22860,2013,Diciembre,España,31,54,,85,-77.35600000000001,0.81488
22861,2013,Diciembre,España,18,28,,46,-75.527794,10.406342
22862,2013,Diciembre,España,62,95,,157,-75.516486,10.446304
22863,2013,Diciembre,España,16,38,,54,-74.77647900000001,10.886686
22864,2013,Diciembre,España,9,15,,24,-72.129595,11.360028999999999
22865,2013,Diciembre,España,2,6,,8,-81.70216500000001,12.5862
22866,2013,Diciembre,España,1,0,,1,-81.372937,13.338761300000002
22867,2013,Diciembre,España,198,417,,615,-76.532004,3.451668
22868,2013,Diciembre,España,1,1,,2,-75.76635300000001,4.45285
22869,2013,Diciembre,España,2321,5031,,7352,-74.140516,4.697157
22870,2013,Diciembre,España,4,8,,12,-75.736374,4.815189
22871,2013,Diciembre,España,171,362,,533,-75.42726,6.170465
22872,2013,Diciembre,España,2,1,,3,-70.74025300000001,7.088728999999999
22873,2013,Diciembre,España,0,4,,4,-73.181317,7.1280470000000005
22874,2013,Diciembre,España,13,44,,57,-72.453013,7.819
22875,2013,Diciembre,España,6,3,,9,-72.508188,7.927233
22876,2013,Diciembre,España,2,3,,5,-77.35002,8.63337
22877,2013,Diciembre,Eslovaquia,1,0,,1,-77.35600000000001,0.81488
22878,2013,Diciembre,Eslovaquia,1,1,,2,-75.527794,10.406342
22879,2013,Diciembre,Eslovaquia,2,1,,3,-75.516486,10.446304
22880,2013,Diciembre,Eslovaquia,0,2,,2,-72.129595,11.360028999999999
22881,2013,Diciembre,Eslovaquia,1,0,,1,-76.532004,3.451668
22882,2013,Diciembre,Eslovaquia,5,6,,11,-74.140516,4.697157
22883,2013,Diciembre,Eslovaquia,2,3,,5,-75.42726,6.170465
22884,2013,Diciembre,Eslovaquia,0,1,,1,-77.35002,8.63337
22885,2013,Diciembre,Eslovenia,1,1,,2,-77.35600000000001,0.81488
22886,2013,Diciembre,Eslovenia,0,2,,2,-75.527794,10.406342
22887,2013,Diciembre,Eslovenia,0,2,,2,-74.77647900000001,10.886686
22888,2013,Diciembre,Eslovenia,2,1,,3,-76.532004,3.451668
22889,2013,Diciembre,Eslovenia,17,29,,46,-74.140516,4.697157
22890,2013,Diciembre,Eslovenia,0,1,,1,-75.42726,6.170465
22891,2013,Diciembre,Eslovenia,1,0,,1,-77.35002,8.63337
22892,2013,Diciembre,Estados Unidos de América,8,9,,17,-69.941498,4.191162
22893,2013,Diciembre,Estados Unidos de América,45,90,,135,-77.35600000000001,0.81488
22894,2013,Diciembre,Estados Unidos de América,53,78,,131,-75.527794,10.406342
22895,2013,Diciembre,Estados Unidos de América,1670,2615,,4285,-75.516486,10.446304
22896,2013,Diciembre,Estados Unidos de América,489,721,,1210,-74.77647900000001,10.886686
22897,2013,Diciembre,Estados Unidos de América,2,8,,10,-74.765343,10.970933
22898,2013,Diciembre,Estados Unidos de América,3,3,,6,-74.213989,11.247722999999999
22899,2013,Diciembre,Estados Unidos de América,7,13,,20,-72.129595,11.360028999999999
22900,2013,Diciembre,Estados Unidos de América,52,65,,117,-81.70216500000001,12.5862
22901,2013,Diciembre,Estados Unidos de América,4,5,,9,-81.372937,13.338761300000002
22902,2013,Diciembre,Estados Unidos de América,1434,2241,,3675,-76.532004,3.451668
22903,2013,Diciembre,Estados Unidos de América,107,145,,252,-75.76635300000001,4.45285
22904,2013,Diciembre,Estados Unidos de América,8663,14673,,23336,-74.140516,4.697157
22905,2013,Diciembre,Estados Unidos de América,205,275,,480,-75.736374,4.815189
22906,2013,Diciembre,Estados Unidos de América,2347,4330,,6677,-75.42726,6.170465
22907,2013,Diciembre,Estados Unidos de América,1,5,,6,-70.74025300000001,7.088728999999999
22908,2013,Diciembre,Estados Unidos de América,42,81,,123,-73.181317,7.1280470000000005
22909,2013,Diciembre,Estados Unidos de América,20,59,,79,-72.453013,7.819
22910,2013,Diciembre,Estados Unidos de América,48,56,,104,-72.508188,7.927233
22911,2013,Diciembre,Estados Unidos de América,4,12,,16,-77.35002,8.63337
22912,2013,Diciembre,Estonia,0,1,,1,-77.35600000000001,0.81488
22913,2013,Diciembre,Estonia,1,0,,1,-76.532004,3.451668
22914,2013,Diciembre,Estonia,5,8,,13,-74.140516,4.697157
22915,2013,Diciembre,Estonia,1,1,,2,-75.42726,6.170465
22916,2013,Diciembre,Estonia,0,1,,1,-72.453013,7.819
22917,2013,Diciembre,Estonia,0,1,,1,-77.35002,8.63337
22918,2013,Diciembre,Filipinas,1,1,,2,-77.35600000000001,0.81488
22919,2013,Diciembre,Filipinas,3,42,,45,-75.527794,10.406342
22920,2013,Diciembre,Filipinas,0,5,,5,-75.516486,10.446304
22921,2013,Diciembre,Filipinas,1,5,,6,-74.77647900000001,10.886686
22922,2013,Diciembre,Filipinas,0,20,,20,-74.765343,10.970933
22923,2013,Diciembre,Filipinas,0,15,,15,-74.213989,11.247722999999999
22924,2013,Diciembre,Filipinas,1,2,,3,-76.532004,3.451668
22925,2013,Diciembre,Filipinas,0,3,,3,-77.061029,3.8844260000000004
22926,2013,Diciembre,Filipinas,18,65,,83,-74.140516,4.697157
22927,2013,Diciembre,Filipinas,1,3,,4,-75.42726,6.170465
22928,2013,Diciembre,Finlandia,1,1,,2,-69.941498,4.191162
22929,2013,Diciembre,Finlandia,1,0,,1,-77.35600000000001,0.81488
22930,2013,Diciembre,Finlandia,3,0,,3,-75.527794,10.406342
22931,2013,Diciembre,Finlandia,4,5,,9,-75.516486,10.446304
22932,2013,Diciembre,Finlandia,0,3,,3,-74.77647900000001,10.886686
22933,2013,Diciembre,Finlandia,0,1,,1,-74.232675,11.117206
22934,2013,Diciembre,Finlandia,1,5,,6,-76.532004,3.451668
22935,2013,Diciembre,Finlandia,58,91,,149,-74.140516,4.697157
22936,2013,Diciembre,Finlandia,6,8,,14,-75.42726,6.170465
22937,2013,Diciembre,Finlandia,1,0,,1,-77.35002,8.63337
22938,2013,Diciembre,Francia,1,8,,9,-69.941498,4.191162
22939,2013,Diciembre,Francia,0,1,,1,-76.876446,0.33002
22940,2013,Diciembre,Francia,32,61,,93,-77.35600000000001,0.81488
22941,2013,Diciembre,Francia,6,11,,17,-75.527794,10.406342
22942,2013,Diciembre,Francia,39,60,,99,-75.516486,10.446304
22943,2013,Diciembre,Francia,5,9,,14,-74.77647900000001,10.886686
22944,2013,Diciembre,Francia,1,1,,2,-74.213989,11.247722999999999
22945,2013,Diciembre,Francia,8,16,,24,-72.129595,11.360028999999999
22946,2013,Diciembre,Francia,1,3,,4,-81.70216500000001,12.5862
22947,2013,Diciembre,Francia,3,3,,6,-81.372937,13.338761300000002
22948,2013,Diciembre,Francia,43,86,,129,-76.532004,3.451668
22949,2013,Diciembre,Francia,1,0,,1,-75.76635300000001,4.45285
22950,2013,Diciembre,Francia,1291,2266,,3557,-74.140516,4.697157
22951,2013,Diciembre,Francia,3,4,,7,-75.736374,4.815189
22952,2013,Diciembre,Francia,74,128,,202,-75.42726,6.170465
22953,2013,Diciembre,Francia,1,0,,1,-70.74025300000001,7.088728999999999
22954,2013,Diciembre,Francia,0,2,,2,-73.181317,7.1280470000000005
22955,2013,Diciembre,Francia,4,12,,16,-72.453013,7.819
22956,2013,Diciembre,Francia,2,4,,6,-72.508188,7.927233
22957,2013,Diciembre,Francia,8,16,,24,-77.35002,8.63337
22958,2013,Diciembre,Gabón,0,1,,1,-74.140516,4.697157
22959,2013,Diciembre,Georgia,1,0,,1,-77.35600000000001,0.81488
22960,2013,Diciembre,Georgia,1,2,,3,-74.140516,4.697157
22961,2013,Diciembre,Ghana,1,0,,1,-77.35600000000001,0.81488
22962,2013,Diciembre,Ghana,1,0,,1,-74.140516,4.697157
22963,2013,Diciembre,Granada,0,1,,1,-75.527794,10.406342
22964,2013,Diciembre,Granada,0,2,,2,-74.140516,4.697157
22965,2013,Diciembre,Granada,0,1,,1,-72.508188,7.927233
22966,2013,Diciembre,Grecia,4,2,,6,-77.35600000000001,0.81488
22967,2013,Diciembre,Grecia,0,6,,6,-75.527794,10.406342
22968,2013,Diciembre,Grecia,4,4,,8,-75.516486,10.446304
22969,2013,Diciembre,Grecia,0,1,,1,-74.77647900000001,10.886686
22970,2013,Diciembre,Grecia,0,1,,1,-74.765343,10.970933
22971,2013,Diciembre,Grecia,0,1,,1,-72.129595,11.360028999999999
22972,2013,Diciembre,Grecia,2,3,,5,-76.532004,3.451668
22973,2013,Diciembre,Grecia,25,62,,87,-74.140516,4.697157
22974,2013,Diciembre,Grecia,3,3,,6,-75.42726,6.170465
22975,2013,Diciembre,Grecia,0,1,,1,-77.35002,8.63337
22976,2013,Diciembre,Guatemala,1,6,,7,-77.35600000000001,0.81488
22977,2013,Diciembre,Guatemala,0,5,,5,-75.527794,10.406342
22978,2013,Diciembre,Guatemala,51,50,,101,-75.516486,10.446304
22979,2013,Diciembre,Guatemala,6,7,,13,-74.77647900000001,10.886686
22980,2013,Diciembre,Guatemala,0,1,,1,-74.765343,10.970933
22981,2013,Diciembre,Guatemala,0,1,,1,-72.129595,11.360028999999999
22982,2013,Diciembre,Guatemala,13,12,,25,-81.70216500000001,12.5862
22983,2013,Diciembre,Guatemala,23,52,,75,-76.532004,3.451668
22984,2013,Diciembre,Guatemala,293,532,,825,-74.140516,4.697157
22985,2013,Diciembre,Guatemala,2,7,,9,-75.736374,4.815189
22986,2013,Diciembre,Guatemala,42,93,,135,-75.42726,6.170465
22987,2013,Diciembre,Guatemala,3,4,,7,-73.181317,7.1280470000000005
22988,2013,Diciembre,Guatemala,4,6,,10,-72.453013,7.819
22989,2013,Diciembre,Guatemala,1,4,,5,-72.508188,7.927233
22990,2013,Diciembre,Guyana,1,0,,1,-77.35600000000001,0.81488
22991,2013,Diciembre,Guyana,2,1,,3,-75.516486,10.446304
22992,2013,Diciembre,Guyana,0,1,,1,-76.532004,3.451668
22993,2013,Diciembre,Guyana,10,16,,26,-74.140516,4.697157
22994,2013,Diciembre,Guyana,0,1,,1,-75.42726,6.170465
22995,2013,Diciembre,Guinea Ecuatorial,0,2,,2,-74.140516,4.697157
22996,2013,Diciembre,Haití,2,2,,4,-77.35600000000001,0.81488
22997,2013,Diciembre,Haití,3,16,,19,-75.516486,10.446304
22998,2013,Diciembre,Haití,0,1,,1,-74.77647900000001,10.886686
22999,2013,Diciembre,Haití,7,11,,18,-76.532004,3.451668
23000,2013,Diciembre,Haití,3,7,,10,-74.140516,4.697157
23001,2013,Diciembre,Haití,2,1,,3,-75.42726,6.170465
23002,2013,Diciembre,Honduras,1,2,,3,-77.35600000000001,0.81488
23003,2013,Diciembre,Honduras,0,6,,6,-75.527794,10.406342
23004,2013,Diciembre,Honduras,21,36,,57,-75.516486,10.446304
23005,2013,Diciembre,Honduras,3,8,,11,-74.77647900000001,10.886686
23006,2013,Diciembre,Honduras,0,1,,1,-74.765343,10.970933
23007,2013,Diciembre,Honduras,1,1,,2,-72.129595,11.360028999999999
23008,2013,Diciembre,Honduras,1,0,,1,-81.70216500000001,12.5862
23009,2013,Diciembre,Honduras,17,21,,38,-76.532004,3.451668
23010,2013,Diciembre,Honduras,0,1,,1,-75.76635300000001,4.45285
23011,2013,Diciembre,Honduras,141,177,,318,-74.140516,4.697157
23012,2013,Diciembre,Honduras,2,2,,4,-75.736374,4.815189
23013,2013,Diciembre,Honduras,39,40,,79,-75.42726,6.170465
23014,2013,Diciembre,Honduras,3,0,,3,-73.181317,7.1280470000000005
23015,2013,Diciembre,Honduras,0,2,,2,-76.7333,8.06667
23016,2013,Diciembre,Honduras,1,1,,2,-77.35002,8.63337
23017,2013,Diciembre,Hungría,2,2,,4,-77.35600000000001,0.81488
23018,2013,Diciembre,Hungría,2,1,,3,-75.516486,10.446304
23019,2013,Diciembre,Hungría,0,2,,2,-76.532004,3.451668
23020,2013,Diciembre,Hungría,26,33,,59,-74.140516,4.697157
23021,2013,Diciembre,Hungría,1,0,,1,-75.736374,4.815189
23022,2013,Diciembre,Hungría,2,2,,4,-75.42726,6.170465
23023,2013,Diciembre,Hungría,1,0,,1,-72.453013,7.819
23024,2013,Diciembre,India,0,2,,2,-77.35600000000001,0.81488
23025,2013,Diciembre,India,0,3,,3,-75.527794,10.406342
23026,2013,Diciembre,India,5,7,,12,-75.516486,10.446304
23027,2013,Diciembre,India,0,11,,11,-74.77647900000001,10.886686
23028,2013,Diciembre,India,0,1,,1,-74.765343,10.970933
23029,2013,Diciembre,India,0,1,,1,-74.213989,11.247722999999999
23030,2013,Diciembre,India,0,1,,1,-72.129595,11.360028999999999
23031,2013,Diciembre,India,0,1,,1,-81.70216500000001,12.5862
23032,2013,Diciembre,India,1,7,,8,-76.532004,3.451668
23033,2013,Diciembre,India,51,205,,256,-74.140516,4.697157
23034,2013,Diciembre,India,5,14,,19,-75.42726,6.170465
23035,2013,Diciembre,India,1,0,,1,-72.453013,7.819
23036,2013,Diciembre,Indonesia,0,4,,4,-75.527794,10.406342
23037,2013,Diciembre,Indonesia,0,2,,2,-75.516486,10.446304
23038,2013,Diciembre,Indonesia,0,1,,1,-76.532004,3.451668
23039,2013,Diciembre,Indonesia,13,31,,44,-74.140516,4.697157
23040,2013,Diciembre,Iraq,0,2,,2,-74.140516,4.697157
23041,2013,Diciembre,Irán,0,1,,1,-69.941498,4.191162
23042,2013,Diciembre,Irán,0,1,,1,-76.532004,3.451668
23043,2013,Diciembre,Irán,1,13,,14,-74.140516,4.697157
23044,2013,Diciembre,Irán,0,1,,1,-75.42726,6.170465
23045,2013,Diciembre,República de Irlanda,2,1,,3,-69.941498,4.191162
23046,2013,Diciembre,República de Irlanda,3,4,,7,-77.35600000000001,0.81488
23047,2013,Diciembre,República de Irlanda,4,3,,7,-75.527794,10.406342
23048,2013,Diciembre,República de Irlanda,2,9,,11,-75.516486,10.446304
23049,2013,Diciembre,República de Irlanda,1,4,,5,-76.532004,3.451668
23050,2013,Diciembre,República de Irlanda,70,131,,201,-74.140516,4.697157
23051,2013,Diciembre,República de Irlanda,5,15,,20,-75.42726,6.170465
23052,2013,Diciembre,República de Irlanda,0,1,,1,-70.74025300000001,7.088728999999999
23053,2013,Diciembre,República de Irlanda,0,4,,4,-72.453013,7.819
23054,2013,Diciembre,República de Irlanda,0,2,,2,-77.35002,8.63337
23055,2013,Diciembre,Islandia,0,1,,1,-69.941498,4.191162
23056,2013,Diciembre,Islandia,2,1,,3,-77.35600000000001,0.81488
23057,2013,Diciembre,Islandia,0,1,,1,-75.516486,10.446304
23058,2013,Diciembre,Islandia,10,13,,23,-74.140516,4.697157
23059,2013,Diciembre,Islandia,0,1,,1,-75.42726,6.170465
23060,2013,Diciembre,Israel,0,6,,6,-77.35600000000001,0.81488
23061,2013,Diciembre,Israel,2,2,,4,-75.527794,10.406342
23062,2013,Diciembre,Israel,3,40,,43,-75.516486,10.446304
23063,2013,Diciembre,Israel,0,5,,5,-74.77647900000001,10.886686
23064,2013,Diciembre,Israel,0,18,,18,-76.532004,3.451668
23065,2013,Diciembre,Israel,0,1,,1,-75.76635300000001,4.45285
23066,2013,Diciembre,Israel,63,325,,388,-74.140516,4.697157
23067,2013,Diciembre,Israel,0,1,,1,-75.736374,4.815189
23068,2013,Diciembre,Israel,1,38,,39,-75.42726,6.170465
23069,2013,Diciembre,Israel,2,1,,3,-73.181317,7.1280470000000005
23070,2013,Diciembre,Israel,0,1,,1,-72.508188,7.927233
23071,2013,Diciembre,Italia,1,4,,5,-69.941498,4.191162
23072,2013,Diciembre,Italia,1,0,,1,-76.876446,0.33002
23073,2013,Diciembre,Italia,9,18,,27,-77.35600000000001,0.81488
23074,2013,Diciembre,Italia,2,13,,15,-75.527794,10.406342
23075,2013,Diciembre,Italia,40,130,,170,-75.516486,10.446304
23076,2013,Diciembre,Italia,2,16,,18,-74.77647900000001,10.886686
23077,2013,Diciembre,Italia,0,1,,1,-74.213989,11.247722999999999
23078,2013,Diciembre,Italia,12,17,,29,-72.129595,11.360028999999999
23079,2013,Diciembre,Italia,2,6,,8,-81.70216500000001,12.5862
23080,2013,Diciembre,Italia,29,76,,105,-76.532004,3.451668
23081,2013,Diciembre,Italia,1,0,,1,-75.76635300000001,4.45285
23082,2013,Diciembre,Italia,544,1674,,2218,-74.140516,4.697157
23083,2013,Diciembre,Italia,1,2,,3,-75.736374,4.815189
23084,2013,Diciembre,Italia,43,127,,170,-75.42726,6.170465
23085,2013,Diciembre,Italia,0,3,,3,-67.48402800000001,6.185536
23086,2013,Diciembre,Italia,1,3,,4,-70.74025300000001,7.088728999999999
23087,2013,Diciembre,Italia,3,3,,6,-73.181317,7.1280470000000005
23088,2013,Diciembre,Italia,10,29,,39,-72.453013,7.819
23089,2013,Diciembre,Italia,4,2,,6,-72.508188,7.927233
23090,2013,Diciembre,Italia,1,5,,6,-77.35002,8.63337
23091,2013,Diciembre,Jamaica,1,0,,1,-75.527794,10.406342
23092,2013,Diciembre,Jamaica,0,2,,2,-75.516486,10.446304
23093,2013,Diciembre,Jamaica,3,6,,9,-74.77647900000001,10.886686
23094,2013,Diciembre,Jamaica,1,1,,2,-81.70216500000001,12.5862
23095,2013,Diciembre,Jamaica,1,1,,2,-76.532004,3.451668
23096,2013,Diciembre,Jamaica,5,9,,14,-74.140516,4.697157
23097,2013,Diciembre,Jamaica,0,1,,1,-75.736374,4.815189
23098,2013,Diciembre,Jamaica,0,3,,3,-75.42726,6.170465
23099,2013,Diciembre,Jamaica,0,1,,1,-72.508188,7.927233
23100,2013,Diciembre,Japón,0,1,,1,-69.941498,4.191162
23101,2013,Diciembre,Japón,11,5,,16,-77.35600000000001,0.81488
23102,2013,Diciembre,Japón,1,3,,4,-75.527794,10.406342
23103,2013,Diciembre,Japón,4,8,,12,-75.516486,10.446304
23104,2013,Diciembre,Japón,0,1,,1,-74.77647900000001,10.886686
23105,2013,Diciembre,Japón,0,1,,1,-72.129595,11.360028999999999
23106,2013,Diciembre,Japón,20,14,,34,-76.532004,3.451668
23107,2013,Diciembre,Japón,134,364,,498,-74.140516,4.697157
23108,2013,Diciembre,Japón,0,1,,1,-75.736374,4.815189
23109,2013,Diciembre,Japón,6,42,,48,-75.42726,6.170465
23110,2013,Diciembre,Japón,0,5,,5,-72.453013,7.819
23111,2013,Diciembre,Japón,0,2,,2,-72.508188,7.927233
23112,2013,Diciembre,Japón,2,4,,6,-77.35002,8.63337
23113,2013,Diciembre,Jordania,1,0,,1,-77.35600000000001,0.81488
23114,2013,Diciembre,Jordania,1,3,,4,-74.140516,4.697157
23115,2013,Diciembre,Jordania,0,3,,3,-75.42726,6.170465
23116,2013,Diciembre,Kazajistán,4,1,,5,-74.140516,4.697157
23117,2013,Diciembre,Kenia,1,3,,4,-75.516486,10.446304
23118,2013,Diciembre,Kenia,1,0,,1,-72.129595,11.360028999999999
23119,2013,Diciembre,Kenia,6,9,,15,-74.140516,4.697157
23120,2013,Diciembre,Kenia,0,1,,1,-75.42726,6.170465
23121,2013,Diciembre,Kirguistán,0,1,,1,-74.140516,4.697157
23122,2013,Diciembre,Kuwait,0,11,,11,-75.516486,10.446304
23123,2013,Diciembre,Kuwait,1,0,,1,-74.77647900000001,10.886686
23124,2013,Diciembre,Kuwait,1,1,,2,-76.532004,3.451668
23125,2013,Diciembre,Kuwait,0,3,,3,-74.140516,4.697157
23126,2013,Diciembre,República de Kosovo,2,1,,3,-74.140516,4.697157
23127,2013,Diciembre,República Democrática Popular  Lao,1,0,,1,-74.140516,4.697157
23128,2013,Diciembre,Letonia,5,4,,9,-74.140516,4.697157
23129,2013,Diciembre,Letonia,2,1,,3,-75.42726,6.170465
23130,2013,Diciembre,Lituania,2,0,,2,-77.35600000000001,0.81488
23131,2013,Diciembre,Lituania,0,1,,1,-75.527794,10.406342
23132,2013,Diciembre,Lituania,2,1,,3,-75.516486,10.446304
23133,2013,Diciembre,Lituania,0,1,,1,-74.77647900000001,10.886686
23134,2013,Diciembre,Lituania,0,3,,3,-74.765343,10.970933
23135,2013,Diciembre,Lituania,1,0,,1,-72.129595,11.360028999999999
23136,2013,Diciembre,Lituania,2,0,,2,-76.532004,3.451668
23137,2013,Diciembre,Lituania,15,14,,29,-74.140516,4.697157
23138,2013,Diciembre,Lituania,0,1,,1,-75.42726,6.170465
23139,2013,Diciembre,Líbano,1,2,,3,-74.77647900000001,10.886686
23140,2013,Diciembre,Líbano,0,1,,1,-74.213989,11.247722999999999
23141,2013,Diciembre,Líbano,2,2,,4,-72.129595,11.360028999999999
23142,2013,Diciembre,Líbano,1,3,,4,-76.532004,3.451668
23143,2013,Diciembre,Líbano,11,18,,29,-74.140516,4.697157
23144,2013,Diciembre,Líbano,0,1,,1,-75.42726,6.170465
23145,2013,Diciembre,Liberia,1,2,,3,-74.140516,4.697157
23146,2013,Diciembre,Libia,0,2,,2,-74.140516,4.697157
23147,2013,Diciembre,Liechtenstein,0,4,,4,-74.140516,4.697157
23148,2013,Diciembre,Liechtenstein,0,1,,1,-75.42726,6.170465
23149,2013,Diciembre,Liechtenstein,1,1,,2,-77.35002,8.63337
23150,2013,Diciembre,Luxemburgo,1,0,,1,-77.35600000000001,0.81488
23151,2013,Diciembre,Luxemburgo,1,0,,1,-75.527794,10.406342
23152,2013,Diciembre,Luxemburgo,0,1,,1,-76.532004,3.451668
23153,2013,Diciembre,Luxemburgo,2,8,,10,-74.140516,4.697157
23154,2013,Diciembre,Luxemburgo,1,0,,1,-75.42726,6.170465
23155,2013,Diciembre,Macedonia,0,1,,1,-75.516486,10.446304
23156,2013,Diciembre,Macedonia,0,1,,1,-74.140516,4.697157
23157,2013,Diciembre,Malasia,2,0,,2,-77.35600000000001,0.81488
23158,2013,Diciembre,Malasia,20,28,,48,-74.140516,4.697157
23159,2013,Diciembre,Malasia,0,1,,1,-75.42726,6.170465
23160,2013,Diciembre,Malta,1,0,,1,-75.516486,10.446304
23161,2013,Diciembre,Malta,1,2,,3,-72.129595,11.360028999999999
23162,2013,Diciembre,Malta,2,4,,6,-74.140516,4.697157
23163,2013,Diciembre,Marruecos,2,0,,2,-75.516486,10.446304
23164,2013,Diciembre,Marruecos,0,1,,1,-76.532004,3.451668
23165,2013,Diciembre,Marruecos,7,7,,14,-74.140516,4.697157
23166,2013,Diciembre,Marruecos,0,1,,1,-72.453013,7.819
23167,2013,Diciembre,Mauricio,0,2,,2,-74.140516,4.697157
23168,2013,Diciembre,Mauritania,0,3,,3,-74.140516,4.697157
23169,2013,Diciembre,Mauritania,0,1,,1,-75.42726,6.170465
23170,2013,Diciembre,México,1,1,,2,-69.941498,4.191162
23171,2013,Diciembre,México,2,0,,2,-76.876446,0.33002
23172,2013,Diciembre,México,31,41,,72,-77.35600000000001,0.81488
23173,2013,Diciembre,México,5,18,,23,-75.527794,10.406342
23174,2013,Diciembre,México,167,187,,354,-75.516486,10.446304
23175,2013,Diciembre,México,30,69,,99,-74.77647900000001,10.886686
23176,2013,Diciembre,México,21,43,,64,-72.129595,11.360028999999999
23177,2013,Diciembre,México,1,3,,4,-81.70216500000001,12.5862
23178,2013,Diciembre,México,75,210,,285,-76.532004,3.451668
23179,2013,Diciembre,México,0,1,,1,-75.76635300000001,4.45285
23180,2013,Diciembre,México,2827,4926,,7753,-74.140516,4.697157
23181,2013,Diciembre,México,5,13,,18,-75.736374,4.815189
23182,2013,Diciembre,México,123,314,,437,-75.42726,6.170465
23183,2013,Diciembre,México,0,1,,1,-67.48402800000001,6.185536
23184,2013,Diciembre,México,4,8,,12,-73.181317,7.1280470000000005
23185,2013,Diciembre,México,16,45,,61,-72.453013,7.819
23186,2013,Diciembre,México,12,13,,25,-72.508188,7.927233
23187,2013,Diciembre,México,1,4,,5,-77.35002,8.63337
23188,2013,Diciembre,República de Moldavia,1,0,,1,-76.532004,3.451668
23189,2013,Diciembre,República de Moldavia,1,0,,1,-74.140516,4.697157
23190,2013,Diciembre,Mónaco,2,1,,3,-81.372937,13.338761300000002
23191,2013,Diciembre,Mónaco,1,1,,2,-74.140516,4.697157
23192,2013,Diciembre,Mongolia,0,1,,1,-74.140516,4.697157
23193,2013,Diciembre,Montenegro,0,1,,1,-75.527794,10.406342
23194,2013,Diciembre,Montenegro,0,1,,1,-74.140516,4.697157
23195,2013,Diciembre,Montenegro,2,3,,5,-75.42726,6.170465
23196,2013,Diciembre,Mozambique,3,1,,4,-74.140516,4.697157
23197,2013,Diciembre,Myanmar,0,29,,29,-75.516486,10.446304
23198,2013,Diciembre,Myanmar,0,10,,10,-77.061029,3.8844260000000004
23199,2013,Diciembre,Myanmar,0,14,,14,-74.140516,4.697157
23200,2013,Diciembre,Nepal,0,1,,1,-75.527794,10.406342
23201,2013,Diciembre,Nepal,0,3,,3,-74.140516,4.697157
23202,2013,Diciembre,Nicaragua,0,11,,11,-75.527794,10.406342
23203,2013,Diciembre,Nicaragua,6,7,,13,-75.516486,10.446304
23204,2013,Diciembre,Nicaragua,4,0,,4,-74.77647900000001,10.886686
23205,2013,Diciembre,Nicaragua,2,3,,5,-81.70216500000001,12.5862
23206,2013,Diciembre,Nicaragua,1,3,,4,-76.532004,3.451668
23207,2013,Diciembre,Nicaragua,37,65,,102,-74.140516,4.697157
23208,2013,Diciembre,Nicaragua,2,0,,2,-75.736374,4.815189
23209,2013,Diciembre,Nicaragua,10,13,,23,-75.42726,6.170465
23210,2013,Diciembre,Nicaragua,0,1,,1,-72.453013,7.819
23211,2013,Diciembre,Nicaragua,0,1,,1,-72.508188,7.927233
23212,2013,Diciembre,Nigeria,1,1,,2,-75.516486,10.446304
23213,2013,Diciembre,Nigeria,0,1,,1,-74.77647900000001,10.886686
23214,2013,Diciembre,Nigeria,0,1,,1,-74.765343,10.970933
23215,2013,Diciembre,Nigeria,3,8,,11,-74.140516,4.697157
23216,2013,Diciembre,Noruega,1,1,,2,-69.941498,4.191162
23217,2013,Diciembre,Noruega,2,4,,6,-77.35600000000001,0.81488
23218,2013,Diciembre,Noruega,2,2,,4,-75.527794,10.406342
23219,2013,Diciembre,Noruega,13,11,,24,-75.516486,10.446304
23220,2013,Diciembre,Noruega,0,2,,2,-74.77647900000001,10.886686
23221,2013,Diciembre,Noruega,0,2,,2,-74.765343,10.970933
23222,2013,Diciembre,Noruega,0,1,,1,-72.129595,11.360028999999999
23223,2013,Diciembre,Noruega,0,2,,2,-81.70216500000001,12.5862
23224,2013,Diciembre,Noruega,3,8,,11,-76.532004,3.451668
23225,2013,Diciembre,Noruega,150,206,,356,-74.140516,4.697157
23226,2013,Diciembre,Noruega,14,18,,32,-75.42726,6.170465
23227,2013,Diciembre,Noruega,0,3,,3,-73.181317,7.1280470000000005
23228,2013,Diciembre,Noruega,0,1,,1,-72.508188,7.927233
23229,2013,Diciembre,Noruega,1,3,,4,-77.35002,8.63337
23230,2013,Diciembre,Nueva Zelanda,1,0,,1,-69.941498,4.191162
23231,2013,Diciembre,Nueva Zelanda,5,6,,11,-77.35600000000001,0.81488
23232,2013,Diciembre,Nueva Zelanda,4,5,,9,-75.527794,10.406342
23233,2013,Diciembre,Nueva Zelanda,5,9,,14,-75.516486,10.446304
23234,2013,Diciembre,Nueva Zelanda,0,1,,1,-74.77647900000001,10.886686
23235,2013,Diciembre,Nueva Zelanda,0,1,,1,-81.70216500000001,12.5862
23236,2013,Diciembre,Nueva Zelanda,1,2,,3,-76.532004,3.451668
23237,2013,Diciembre,Nueva Zelanda,53,86,,139,-74.140516,4.697157
23238,2013,Diciembre,Nueva Zelanda,3,10,,13,-75.42726,6.170465
23239,2013,Diciembre,Nueva Zelanda,0,1,,1,-72.453013,7.819
23240,2013,Diciembre,Nueva Zelanda,3,2,,5,-72.508188,7.927233
23241,2013,Diciembre,Nueva Zelanda,0,2,,2,-77.35002,8.63337
23242,2013,Diciembre,Países Bajos,3,3,,6,-69.941498,4.191162
23243,2013,Diciembre,Países Bajos,1,0,,1,-76.876446,0.33002
23244,2013,Diciembre,Países Bajos,17,14,,31,-77.35600000000001,0.81488
23245,2013,Diciembre,Países Bajos,0,1,,1,-78.802679,18.00143
23246,2013,Diciembre,Países Bajos,12,7,,19,-75.527794,10.406342
23247,2013,Diciembre,Países Bajos,22,57,,79,-75.516486,10.446304
23248,2013,Diciembre,Países Bajos,11,31,,42,-74.77647900000001,10.886686
23249,2013,Diciembre,Países Bajos,4,10,,14,-72.129595,11.360028999999999
23250,2013,Diciembre,Países Bajos,15,38,,53,-72.919186,11.52863
23251,2013,Diciembre,Países Bajos,0,1,,1,-81.70216500000001,12.5862
23252,2013,Diciembre,Países Bajos,37,72,,109,-76.532004,3.451668
23253,2013,Diciembre,Países Bajos,690,1292,,1982,-74.140516,4.697157
23254,2013,Diciembre,Países Bajos,1,2,,3,-75.736374,4.815189
23255,2013,Diciembre,Países Bajos,206,314,,520,-75.42726,6.170465
23256,2013,Diciembre,Países Bajos,0,1,,1,-70.74025300000001,7.088728999999999
23257,2013,Diciembre,Países Bajos,7,13,,20,-73.181317,7.1280470000000005
23258,2013,Diciembre,Países Bajos,0,5,,5,-72.453013,7.819
23259,2013,Diciembre,Países Bajos,1,2,,3,-77.35002,8.63337
23260,2013,Diciembre,Pakistán,1,8,,9,-74.140516,4.697157
23261,2013,Diciembre,Pakistán,1,3,,4,-75.42726,6.170465
23262,2013,Diciembre,Panamá,3,1,,4,-77.35600000000001,0.81488
23263,2013,Diciembre,Panamá,1,20,,21,-75.527794,10.406342
23264,2013,Diciembre,Panamá,178,217,,395,-75.516486,10.446304
23265,2013,Diciembre,Panamá,68,131,,199,-74.77647900000001,10.886686
23266,2013,Diciembre,Panamá,0,1,,1,-74.765343,10.970933
23267,2013,Diciembre,Panamá,0,2,,2,-74.213989,11.247722999999999
23268,2013,Diciembre,Panamá,2,3,,5,-72.129595,11.360028999999999
23269,2013,Diciembre,Panamá,30,32,,62,-81.70216500000001,12.5862
23270,2013,Diciembre,Panamá,173,262,,435,-76.532004,3.451668
23271,2013,Diciembre,Panamá,604,927,,1531,-74.140516,4.697157
23272,2013,Diciembre,Panamá,44,92,,136,-75.736374,4.815189
23273,2013,Diciembre,Panamá,179,309,,488,-75.42726,6.170465
23274,2013,Diciembre,Panamá,7,20,,27,-73.181317,7.1280470000000005
23275,2013,Diciembre,Panamá,1,17,,18,-72.453013,7.819
23276,2013,Diciembre,Panamá,13,26,,39,-72.508188,7.927233
23277,2013,Diciembre,Panamá,8,11,,19,-77.35002,8.63337
23278,2013,Diciembre,Paraguay,1,0,,1,-75.527794,10.406342
23279,2013,Diciembre,Paraguay,21,26,,47,-75.516486,10.446304
23280,2013,Diciembre,Paraguay,2,2,,4,-74.77647900000001,10.886686
23281,2013,Diciembre,Paraguay,1,1,,2,-72.129595,11.360028999999999
23282,2013,Diciembre,Paraguay,9,13,,22,-81.70216500000001,12.5862
23283,2013,Diciembre,Paraguay,7,3,,10,-76.532004,3.451668
23284,2013,Diciembre,Paraguay,71,53,,124,-74.140516,4.697157
23285,2013,Diciembre,Paraguay,1,0,,1,-75.736374,4.815189
23286,2013,Diciembre,Paraguay,8,8,,16,-75.42726,6.170465
23287,2013,Diciembre,Paraguay,1,0,,1,-70.74025300000001,7.088728999999999
23288,2013,Diciembre,Paraguay,0,1,,1,-72.453013,7.819
23289,2013,Diciembre,Perú,59,74,,133,-69.941498,4.191162
23290,2013,Diciembre,Perú,0,4,,4,-76.876446,0.33002
23291,2013,Diciembre,Perú,217,417,,634,-77.35600000000001,0.81488
23292,2013,Diciembre,Perú,24,29,,53,-75.527794,10.406342
23293,2013,Diciembre,Perú,132,107,,239,-75.516486,10.446304
23294,2013,Diciembre,Perú,9,30,,39,-74.77647900000001,10.886686
23295,2013,Diciembre,Perú,0,2,,2,-74.765343,10.970933
23296,2013,Diciembre,Perú,43,44,,87,-72.129595,11.360028999999999
23297,2013,Diciembre,Perú,1,0,,1,-72.919186,11.52863
23298,2013,Diciembre,Perú,88,52,,140,-81.70216500000001,12.5862
23299,2013,Diciembre,Perú,126,203,,329,-76.532004,3.451668
23300,2013,Diciembre,Perú,0,1,,1,-77.061029,3.8844260000000004
23301,2013,Diciembre,Perú,0,1,,1,-75.76635300000001,4.45285
23302,2013,Diciembre,Perú,1969,2680,,4649,-74.140516,4.697157
23303,2013,Diciembre,Perú,2,5,,7,-75.736374,4.815189
23304,2013,Diciembre,Perú,255,424,,679,-75.42726,6.170465
23305,2013,Diciembre,Perú,0,1,,1,-67.48402800000001,6.185536
23306,2013,Diciembre,Perú,1,4,,5,-73.181317,7.1280470000000005
23307,2013,Diciembre,Perú,75,150,,225,-72.453013,7.819
23308,2013,Diciembre,Perú,2,2,,4,-72.508188,7.927233
23309,2013,Diciembre,Perú,0,2,,2,-77.35002,8.63337
23310,2013,Diciembre,Palestina,0,1,,1,-74.140516,4.697157
23311,2013,Diciembre,Polonia,2,2,,4,-77.35600000000001,0.81488
23312,2013,Diciembre,Polonia,1,6,,7,-75.527794,10.406342
23313,2013,Diciembre,Polonia,9,4,,13,-75.516486,10.446304
23314,2013,Diciembre,Polonia,0,6,,6,-74.765343,10.970933
23315,2013,Diciembre,Polonia,0,1,,1,-72.129595,11.360028999999999
23316,2013,Diciembre,Polonia,2,0,,2,-81.70216500000001,12.5862
23317,2013,Diciembre,Polonia,1,4,,5,-76.532004,3.451668
23318,2013,Diciembre,Polonia,0,5,,5,-77.061029,3.8844260000000004
23319,2013,Diciembre,Polonia,69,127,,196,-74.140516,4.697157
23320,2013,Diciembre,Polonia,2,6,,8,-75.42726,6.170465
23321,2013,Diciembre,Polonia,0,1,,1,-73.181317,7.1280470000000005
23322,2013,Diciembre,Polonia,1,4,,5,-72.453013,7.819
23323,2013,Diciembre,Polonia,0,1,,1,-76.7333,8.06667
23324,2013,Diciembre,Polonia,1,1,,2,-77.35002,8.63337
23325,2013,Diciembre,Portugal,0,1,,1,-69.941498,4.191162
23326,2013,Diciembre,Portugal,0,4,,4,-77.35600000000001,0.81488
23327,2013,Diciembre,Portugal,2,3,,5,-75.527794,10.406342
23328,2013,Diciembre,Portugal,0,14,,14,-75.516486,10.446304
23329,2013,Diciembre,Portugal,0,2,,2,-74.77647900000001,10.886686
23330,2013,Diciembre,Portugal,2,4,,6,-72.129595,11.360028999999999
23331,2013,Diciembre,Portugal,0,3,,3,-81.70216500000001,12.5862
23332,2013,Diciembre,Portugal,6,23,,29,-76.532004,3.451668
23333,2013,Diciembre,Portugal,112,327,,439,-74.140516,4.697157
23334,2013,Diciembre,Portugal,3,18,,21,-75.42726,6.170465
23335,2013,Diciembre,Portugal,0,3,,3,-72.453013,7.819
23336,2013,Diciembre,Portugal,1,0,,1,-72.508188,7.927233
23337,2013,Diciembre,Puerto Rico/Territorio de Estados Unidos,0,1,,1,-75.516486,10.446304
23338,2013,Diciembre,Puerto Rico/Territorio de Estados Unidos,2,0,,2,-74.140516,4.697157
23339,2013,Diciembre,Qatar,0,4,,4,-74.140516,4.697157
23340,2013,Diciembre,Reino Unido de Gran Bretaña e Irlanda del Norte,3,13,,16,-69.941498,4.191162
23341,2013,Diciembre,Reino Unido de Gran Bretaña e Irlanda del Norte,1,0,,1,-76.876446,0.33002
23342,2013,Diciembre,Reino Unido de Gran Bretaña e Irlanda del Norte,41,57,,98,-77.35600000000001,0.81488
23343,2013,Diciembre,Reino Unido de Gran Bretaña e Irlanda del Norte,29,32,,61,-75.527794,10.406342
23344,2013,Diciembre,Reino Unido de Gran Bretaña e Irlanda del Norte,45,106,,151,-75.516486,10.446304
23345,2013,Diciembre,Reino Unido de Gran Bretaña e Irlanda del Norte,6,17,,23,-74.77647900000001,10.886686
23346,2013,Diciembre,Reino Unido de Gran Bretaña e Irlanda del Norte,2,3,,5,-74.232675,11.117206
23347,2013,Diciembre,Reino Unido de Gran Bretaña e Irlanda del Norte,3,2,,5,-72.129595,11.360028999999999
23348,2013,Diciembre,Reino Unido de Gran Bretaña e Irlanda del Norte,0,3,,3,-81.70216500000001,12.5862
23349,2013,Diciembre,Reino Unido de Gran Bretaña e Irlanda del Norte,41,91,,132,-76.532004,3.451668
23350,2013,Diciembre,Reino Unido de Gran Bretaña e Irlanda del Norte,1,1,,2,-75.76635300000001,4.45285
23351,2013,Diciembre,Reino Unido de Gran Bretaña e Irlanda del Norte,717,1562,,2279,-74.140516,4.697157
23352,2013,Diciembre,Reino Unido de Gran Bretaña e Irlanda del Norte,2,8,,10,-75.736374,4.815189
23353,2013,Diciembre,Reino Unido de Gran Bretaña e Irlanda del Norte,52,121,,173,-75.42726,6.170465
23354,2013,Diciembre,Reino Unido de Gran Bretaña e Irlanda del Norte,0,2,,2,-73.181317,7.1280470000000005
23355,2013,Diciembre,Reino Unido de Gran Bretaña e Irlanda del Norte,0,12,,12,-72.453013,7.819
23356,2013,Diciembre,Reino Unido de Gran Bretaña e Irlanda del Norte,1,5,,6,-77.35002,8.63337
23357,2013,Diciembre,República Dominicana,1,10,,11,-77.35600000000001,0.81488
23358,2013,Diciembre,República Dominicana,2,1,,3,-75.527794,10.406342
23359,2013,Diciembre,República Dominicana,14,32,,46,-75.516486,10.446304
23360,2013,Diciembre,República Dominicana,20,21,,41,-74.77647900000001,10.886686
23361,2013,Diciembre,República Dominicana,0,4,,4,-72.129595,11.360028999999999
23362,2013,Diciembre,República Dominicana,1,1,,2,-72.919186,11.52863
23363,2013,Diciembre,República Dominicana,0,3,,3,-81.70216500000001,12.5862
23364,2013,Diciembre,República Dominicana,18,39,,57,-76.532004,3.451668
23365,2013,Diciembre,República Dominicana,0,1,,1,-75.76635300000001,4.45285
23366,2013,Diciembre,República Dominicana,231,307,,538,-74.140516,4.697157
23367,2013,Diciembre,República Dominicana,2,0,,2,-75.736374,4.815189
23368,2013,Diciembre,República Dominicana,32,53,,85,-75.42726,6.170465
23369,2013,Diciembre,República Dominicana,2,4,,6,-73.181317,7.1280470000000005
23370,2013,Diciembre,República Dominicana,0,3,,3,-72.453013,7.819
23371,2013,Diciembre,República Dominicana,0,3,,3,-72.508188,7.927233
23372,2013,Diciembre,Rumania,0,1,,1,-69.941498,4.191162
23373,2013,Diciembre,Rumania,1,5,,6,-75.527794,10.406342
23374,2013,Diciembre,Rumania,3,7,,10,-75.516486,10.446304
23375,2013,Diciembre,Rumania,0,1,,1,-74.77647900000001,10.886686
23376,2013,Diciembre,Rumania,0,2,,2,-72.129595,11.360028999999999
23377,2013,Diciembre,Rumania,4,1,,5,-76.532004,3.451668
23378,2013,Diciembre,Rumania,43,73,,116,-74.140516,4.697157
23379,2013,Diciembre,Rumania,6,4,,10,-75.42726,6.170465
23380,2013,Diciembre,Rumania,0,2,,2,-72.453013,7.819
23381,2013,Diciembre,Federación de Rusia,0,1,,1,-69.941498,4.191162
23382,2013,Diciembre,Federación de Rusia,3,7,,10,-77.35600000000001,0.81488
23383,2013,Diciembre,Federación de Rusia,1,10,,11,-75.527794,10.406342
23384,2013,Diciembre,Federación de Rusia,9,7,,16,-75.516486,10.446304
23385,2013,Diciembre,Federación de Rusia,0,1,,1,-74.77647900000001,10.886686
23386,2013,Diciembre,Federación de Rusia,0,1,,1,-74.765343,10.970933
23387,2013,Diciembre,Federación de Rusia,2,7,,9,-72.129595,11.360028999999999
23388,2013,Diciembre,Federación de Rusia,2,1,,3,-81.70216500000001,12.5862
23389,2013,Diciembre,Federación de Rusia,9,4,,13,-76.532004,3.451668
23390,2013,Diciembre,Federación de Rusia,0,2,,2,-77.061029,3.8844260000000004
23391,2013,Diciembre,Federación de Rusia,131,162,,293,-74.140516,4.697157
23392,2013,Diciembre,Federación de Rusia,5,4,,9,-75.42726,6.170465
23393,2013,Diciembre,Federación de Rusia,5,6,,11,-72.453013,7.819
23394,2013,Diciembre,Federación de Rusia,0,1,,1,-77.35002,8.63337
23395,2013,Diciembre,Rwanda,0,1,,1,-74.140516,4.697157
23396,2013,Diciembre,San Cristóbal y Nevis,1,1,,2,-74.140516,4.697157
23397,2013,Diciembre,Santa Lucia,0,1,,1,-75.527794,10.406342
23398,2013,Diciembre,Santa Lucia,3,7,,10,-74.140516,4.697157
23399,2013,Diciembre,Santa Sede/Ciudad del Vaticano,0,1,,1,-74.140516,4.697157
23400,2013,Diciembre,Senegal,0,2,,2,-74.140516,4.697157
23401,2013,Diciembre,Serbia,0,1,,1,-75.516486,10.446304
23402,2013,Diciembre,Serbia,10,3,,13,-74.140516,4.697157
23403,2013,Diciembre,Serbia,1,1,,2,-75.42726,6.170465
23404,2013,Diciembre,Singapur,0,1,,1,-69.941498,4.191162
23405,2013,Diciembre,Singapur,1,0,,1,-77.35600000000001,0.81488
23406,2013,Diciembre,Singapur,0,1,,1,-75.527794,10.406342
23407,2013,Diciembre,Singapur,1,1,,2,-75.516486,10.446304
23408,2013,Diciembre,Singapur,13,28,,41,-74.140516,4.697157
23409,2013,Diciembre,Singapur,0,1,,1,-75.42726,6.170465
23410,2013,Diciembre,República Árabe Siria,1,1,,2,-76.532004,3.451668
23411,2013,Diciembre,República Árabe Siria,0,1,,1,-74.140516,4.697157
23412,2013,Diciembre,República Árabe Siria,0,1,,1,-75.42726,6.170465
23413,2013,Diciembre,Somalia,1,0,,1,-74.140516,4.697157
23414,2013,Diciembre,Sri Lanka,1,0,,1,-76.532004,3.451668
23415,2013,Diciembre,Sri Lanka,0,5,,5,-74.140516,4.697157
23416,2013,Diciembre,Sudáfrica,1,0,,1,-77.35600000000001,0.81488
23417,2013,Diciembre,Sudáfrica,2,3,,5,-75.527794,10.406342
23418,2013,Diciembre,Sudáfrica,0,1,,1,-75.516486,10.446304
23419,2013,Diciembre,Sudáfrica,1,1,,2,-74.77647900000001,10.886686
23420,2013,Diciembre,Sudáfrica,1,1,,2,-74.765343,10.970933
23421,2013,Diciembre,Sudáfrica,1,3,,4,-76.532004,3.451668
23422,2013,Diciembre,Sudáfrica,35,44,,79,-74.140516,4.697157
23423,2013,Diciembre,Sudáfrica,1,6,,7,-75.42726,6.170465
23424,2013,Diciembre,Sudán,0,2,,2,-74.140516,4.697157
23425,2013,Diciembre,Suecia,3,2,,5,-69.941498,4.191162
23426,2013,Diciembre,Suecia,5,15,,20,-77.35600000000001,0.81488
23427,2013,Diciembre,Suecia,7,9,,16,-75.527794,10.406342
23428,2013,Diciembre,Suecia,19,20,,39,-75.516486,10.446304
23429,2013,Diciembre,Suecia,4,9,,13,-74.77647900000001,10.886686
23430,2013,Diciembre,Suecia,1,1,,2,-74.213989,11.247722999999999
23431,2013,Diciembre,Suecia,1,1,,2,-72.129595,11.360028999999999
23432,2013,Diciembre,Suecia,0,1,,1,-72.919186,11.52863
23433,2013,Diciembre,Suecia,29,46,,75,-76.532004,3.451668
23434,2013,Diciembre,Suecia,300,460,,760,-74.140516,4.697157
23435,2013,Diciembre,Suecia,0,3,,3,-75.736374,4.815189
23436,2013,Diciembre,Suecia,17,38,,55,-75.42726,6.170465
23437,2013,Diciembre,Suecia,1,3,,4,-73.181317,7.1280470000000005
23438,2013,Diciembre,Suecia,1,2,,3,-72.453013,7.819
23439,2013,Diciembre,Suecia,1,0,,1,-77.35002,8.63337
23440,2013,Diciembre,Suiza,7,5,,12,-69.941498,4.191162
23441,2013,Diciembre,Suiza,1,0,,1,-76.876446,0.33002
23442,2013,Diciembre,Suiza,18,21,,39,-77.35600000000001,0.81488
23443,2013,Diciembre,Suiza,0,1,,1,-78.802679,18.00143
23444,2013,Diciembre,Suiza,9,9,,18,-75.527794,10.406342
23445,2013,Diciembre,Suiza,13,25,,38,-75.516486,10.446304
23446,2013,Diciembre,Suiza,5,10,,15,-74.77647900000001,10.886686
23447,2013,Diciembre,Suiza,1,3,,4,-72.129595,11.360028999999999
23448,2013,Diciembre,Suiza,0,1,,1,-81.372937,13.338761300000002
23449,2013,Diciembre,Suiza,15,50,,65,-76.532004,3.451668
23450,2013,Diciembre,Suiza,419,762,,1181,-74.140516,4.697157
23451,2013,Diciembre,Suiza,0,3,,3,-75.736374,4.815189
23452,2013,Diciembre,Suiza,29,65,,94,-75.42726,6.170465
23453,2013,Diciembre,Suiza,1,3,,4,-72.453013,7.819
23454,2013,Diciembre,Suiza,1,0,,1,-72.508188,7.927233
23455,2013,Diciembre,Suiza,3,2,,5,-77.35002,8.63337
23456,2013,Diciembre,Surinam,0,1,,1,-76.532004,3.451668
23457,2013,Diciembre,Surinam,20,25,,45,-74.140516,4.697157
23458,2013,Diciembre,Surinam,23,16,,39,-75.42726,6.170465
23459,2013,Diciembre,Surinam,0,1,,1,-72.453013,7.819
23460,2013,Diciembre,Taiwán,0,1,,1,-69.941498,4.191162
23461,2013,Diciembre,Taiwán,2,4,,6,-77.35600000000001,0.81488
23462,2013,Diciembre,Taiwán,1,2,,3,-75.516486,10.446304
23463,2013,Diciembre,Taiwán,3,6,,9,-76.532004,3.451668
23464,2013,Diciembre,Taiwán,41,41,,82,-74.140516,4.697157
23465,2013,Diciembre,Taiwán,1,0,,1,-75.736374,4.815189
23466,2013,Diciembre,Taiwán,2,7,,9,-75.42726,6.170465
23467,2013,Diciembre,Taiwán,0,1,,1,-73.181317,7.1280470000000005
23468,2013,Diciembre,Taiwán,1,0,,1,-72.453013,7.819
23469,2013,Diciembre,Tailandia,1,0,,1,-77.35600000000001,0.81488
23470,2013,Diciembre,Tailandia,1,0,,1,-75.516486,10.446304
23471,2013,Diciembre,Tailandia,1,0,,1,-74.213989,11.247722999999999
23472,2013,Diciembre,Tailandia,4,5,,9,-74.140516,4.697157
23473,2013,Diciembre,Tanzania,3,0,,3,-74.140516,4.697157
23474,2013,Diciembre,Tonga,0,5,,5,-74.140516,4.697157
23475,2013,Diciembre,Trinidad y Tobago,0,1,,1,-69.941498,4.191162
23476,2013,Diciembre,Trinidad y Tobago,6,8,,14,-75.516486,10.446304
23477,2013,Diciembre,Trinidad y Tobago,1,1,,2,-74.77647900000001,10.886686
23478,2013,Diciembre,Trinidad y Tobago,0,1,,1,-81.70216500000001,12.5862
23479,2013,Diciembre,Trinidad y Tobago,1,8,,9,-76.532004,3.451668
23480,2013,Diciembre,Trinidad y Tobago,19,43,,62,-74.140516,4.697157
23481,2013,Diciembre,Trinidad y Tobago,1,1,,2,-75.736374,4.815189
23482,2013,Diciembre,Trinidad y Tobago,4,13,,17,-75.42726,6.170465
23483,2013,Diciembre,Trinidad y Tobago,0,3,,3,-73.181317,7.1280470000000005
23484,2013,Diciembre,Trinidad y Tobago,1,0,,1,-72.453013,7.819
23485,2013,Diciembre,Trinidad y Tobago,0,3,,3,-72.508188,7.927233
23486,2013,Diciembre,Túnez,0,2,,2,-76.532004,3.451668
23487,2013,Diciembre,Turquía,1,0,,1,-77.35600000000001,0.81488
23488,2013,Diciembre,Turquía,0,2,,2,-75.527794,10.406342
23489,2013,Diciembre,Turquía,0,1,,1,-75.516486,10.446304
23490,2013,Diciembre,Turquía,0,1,,1,-74.77647900000001,10.886686
23491,2013,Diciembre,Turquía,0,1,,1,-74.765343,10.970933
23492,2013,Diciembre,Turquía,0,3,,3,-74.213989,11.247722999999999
23493,2013,Diciembre,Turquía,0,1,,1,-72.129595,11.360028999999999
23494,2013,Diciembre,Turquía,1,1,,2,-81.70216500000001,12.5862
23495,2013,Diciembre,Turquía,1,3,,4,-76.532004,3.451668
23496,2013,Diciembre,Turquía,21,62,,83,-74.140516,4.697157
23497,2013,Diciembre,Turquía,0,1,,1,-75.736374,4.815189
23498,2013,Diciembre,Turquía,0,2,,2,-75.42726,6.170465
23499,2013,Diciembre,Turquía,0,1,,1,-72.453013,7.819
23500,2013,Diciembre,Tuvalu,0,4,,4,-75.527794,10.406342
23501,2013,Diciembre,Turkmenistán,1,0,,1,-74.140516,4.697157
23502,2013,Diciembre,Ucrania,0,1,,1,-77.35600000000001,0.81488
23503,2013,Diciembre,Ucrania,1,4,,5,-75.527794,10.406342
23504,2013,Diciembre,Ucrania,1,7,,8,-75.516486,10.446304
23505,2013,Diciembre,Ucrania,0,1,,1,-74.765343,10.970933
23506,2013,Diciembre,Ucrania,0,5,,5,-77.061029,3.8844260000000004
23507,2013,Diciembre,Ucrania,17,28,,45,-74.140516,4.697157
23508,2013,Diciembre,Ucrania,2,0,,2,-75.42726,6.170465
23509,2013,Diciembre,Uganda,0,1,,1,-75.516486,10.446304
23510,2013,Diciembre,Uganda,0,1,,1,-74.77647900000001,10.886686
23511,2013,Diciembre,Uganda,4,6,,10,-74.140516,4.697157
23512,2013,Diciembre,Federación de Rusia,0,1,,1,-74.765343,10.970933
23513,2013,Diciembre,Federación de Rusia,0,1,,1,-74.213989,11.247722999999999
23514,2013,Diciembre,Uruguay,4,10,,14,-77.35600000000001,0.81488
23515,2013,Diciembre,Uruguay,2,1,,3,-75.527794,10.406342
23516,2013,Diciembre,Uruguay,53,45,,98,-75.516486,10.446304
23517,2013,Diciembre,Uruguay,20,20,,40,-81.70216500000001,12.5862
23518,2013,Diciembre,Uruguay,7,22,,29,-76.532004,3.451668
23519,2013,Diciembre,Uruguay,0,1,,1,-75.76635300000001,4.45285
23520,2013,Diciembre,Uruguay,111,234,,345,-74.140516,4.697157
23521,2013,Diciembre,Uruguay,24,42,,66,-75.42726,6.170465
23522,2013,Diciembre,Uruguay,0,2,,2,-73.181317,7.1280470000000005
23523,2013,Diciembre,Uruguay,1,4,,5,-72.453013,7.819
23524,2013,Diciembre,Uruguay,0,2,,2,-72.508188,7.927233
23525,2013,Diciembre,Uzbekistán,1,1,,2,-74.140516,4.697157
23526,2013,Diciembre,Venezuela,0,1,,1,-76.876446,0.33002
23527,2013,Diciembre,Venezuela,149,218,,367,-77.35600000000001,0.81488
23528,2013,Diciembre,Venezuela,13,30,,43,-75.527794,10.406342
23529,2013,Diciembre,Venezuela,139,168,,307,-75.516486,10.446304
23530,2013,Diciembre,Venezuela,67,115,,182,-74.77647900000001,10.886686
23531,2013,Diciembre,Venezuela,2996,4237,,7233,-72.129595,11.360028999999999
23532,2013,Diciembre,Venezuela,7,6,,13,-72.919186,11.52863
23533,2013,Diciembre,Venezuela,4,4,,8,-81.70216500000001,12.5862
23534,2013,Diciembre,Venezuela,118,130,,248,-76.532004,3.451668
23535,2013,Diciembre,Venezuela,0,1,,1,-77.061029,3.8844260000000004
23536,2013,Diciembre,Venezuela,0,3,,3,-75.76635300000001,4.45285
23537,2013,Diciembre,Venezuela,6548,7145,,13693,-74.140516,4.697157
23538,2013,Diciembre,Venezuela,12,13,,25,-75.736374,4.815189
23539,2013,Diciembre,Venezuela,834,784,,1618,-75.42726,6.170465
23540,2013,Diciembre,Venezuela,48,105,,153,-67.48402800000001,6.185536
23541,2013,Diciembre,Venezuela,165,271,,436,-70.74025300000001,7.088728999999999
23542,2013,Diciembre,Venezuela,8,11,,19,-73.181317,7.1280470000000005
23543,2013,Diciembre,Venezuela,2803,3371,,6174,-72.453013,7.819
23544,2013,Diciembre,Venezuela,454,552,,1006,-72.508188,7.927233
23545,2013,Diciembre,Venezuela,0,1,,1,-77.35002,8.63337
23546,2013,Diciembre,Vietnam,2,1,,3,-74.140516,4.697157
23547,2013,Diciembre,República Árabe de Yemen,0,1,,1,-74.140516,4.697157
23548,2013,Diciembre,Zambia,0,1,,1,-75.516486,10.446304
23549,2013,Diciembre,Zambia,0,1,,1,-74.140516,4.697157
23550,2013,Diciembre,Zimbabue,1,1,,2,-76.532004,3.451668
23551,2013,Diciembre,Anguila/Territorio Británico de Ultramar,0,1,,1,-74.140516,4.697157
23552,2013,Diciembre,Reino Unido de Gran Bretaña e Irlanda del Norte,0,4,,4,-74.765343,10.970933
23553,2013,Diciembre,Países Bajos,0,2,,2,-75.527794,10.406342
23554,2013,Diciembre,Países Bajos,2,1,,3,-75.516486,10.446304
23555,2013,Diciembre,Países Bajos,0,1,,1,-74.77647900000001,10.886686
23556,2013,Diciembre,Países Bajos,1,7,,8,-74.213989,11.247722999999999
23557,2013,Diciembre,Países Bajos,2,6,,8,-76.532004,3.451668
23558,2013,Diciembre,Países Bajos,12,33,,45,-74.140516,4.697157
23559,2013,Diciembre,Lituania,0,1,,1,-74.765343,10.970933
23560,2013,Diciembre,Reino Unido de Gran Bretaña e Irlanda del Norte,4,4,,8,-74.213989,11.247722999999999
23561,2013,Diciembre,Desconocido,0,2,,2,-77.35600000000001,0.81488
23562,2013,Diciembre,Desconocido,0,2,,2,-75.516486,10.446304
23563,2013,Diciembre,Desconocido,1,3,,4,-76.532004,3.451668
23564,2013,Diciembre,Desconocido,28,73,,101,-74.140516,4.697157
23565,2013,Diciembre,Desconocido,1,5,,6,-75.42726,6.170465
23566,2013,Diciembre,Desconocido,1,0,,1,-70.74025300000001,7.088728999999999
23567,2013,Diciembre,Desconocido,0,1,,1,-73.181317,7.1280470000000005
23568,2013,Diciembre,Desconocido,0,1,,1,-72.453013,7.819
23569,2013,Diciembre,República CentroÁfricana,0,1,,1,-76.532004,3.451668
23570,2014,Enero,Afganistán,1,2,,3,-74.140516,4.697157
23571,2014,Enero,Afganistán,0,1,,1,-75.42726,6.170465
23572,2014,Enero,Alemania,4,5,,9,-75.516486,10.446304
23573,2014,Enero,Alemania,5,1,,6,-74.77647900000001,10.886686
23574,2014,Enero,Alemania,13,14,,27,-76.532004,3.451668
23575,2014,Enero,Alemania,1411,2306,,3717,-74.140516,4.697157
23576,2014,Enero,Alemania,4,16,,20,-75.42726,6.170465
23577,2014,Enero,Angola,0,1,,1,-76.532004,3.451668
23578,2014,Enero,Países Bajos,12,8,,20,-75.527794,10.406342
23579,2014,Enero,Países Bajos,2,9,,11,-75.516486,10.446304
23580,2014,Enero,Países Bajos,2,3,,5,-74.77647900000001,10.886686
23581,2014,Enero,Países Bajos,0,1,,1,-81.70216500000001,12.5862
23582,2014,Enero,Países Bajos,10,32,,42,-76.532004,3.451668
23583,2014,Enero,Países Bajos,37,81,,118,-74.140516,4.697157
23584,2014,Enero,Países Bajos,1,3,,4,-75.736374,4.815189
23585,2014,Enero,Países Bajos,34,66,,100,-75.42726,6.170465
23586,2014,Enero,Países Bajos,0,1,,1,-73.181317,7.1280470000000005
23587,2014,Enero,Arabia Saudita,0,1,,1,-74.140516,4.697157
23588,2014,Enero,Argelia,1,0,,1,-81.70216500000001,12.5862
23589,2014,Enero,Argelia,2,1,,3,-74.140516,4.697157
23590,2014,Enero,Argelia,1,0,,1,-75.42726,6.170465
23591,2014,Enero,Argentina,12,13,,25,-77.35600000000001,0.81488
23592,2014,Enero,Argentina,143,96,,239,-75.516486,10.446304
23593,2014,Enero,Argentina,13,15,,28,-74.77647900000001,10.886686
23594,2014,Enero,Argentina,70,41,,111,-81.70216500000001,12.5862
23595,2014,Enero,Argentina,73,90,,163,-76.532004,3.451668
23596,2014,Enero,Argentina,3231,3239,,6470,-74.140516,4.697157
23597,2014,Enero,Argentina,0,1,,1,-75.736374,4.815189
23598,2014,Enero,Argentina,178,201,,379,-75.42726,6.170465
23599,2014,Enero,Argentina,1,2,,3,-73.181317,7.1280470000000005
23600,2014,Enero,Aruba,62,67,,129,-75.527794,10.406342
23601,2014,Enero,Aruba,0,4,,4,-74.77647900000001,10.886686
23602,2014,Enero,Aruba,0,2,,2,-74.765343,10.970933
23603,2014,Enero,Aruba,2,2,,4,-74.213989,11.247722999999999
23604,2014,Enero,Aruba,16,11,,27,-72.919186,11.52863
23605,2014,Enero,Aruba,6,8,,14,-76.532004,3.451668
23606,2014,Enero,Aruba,459,590,,1049,-74.140516,4.697157
23607,2014,Enero,Aruba,10,17,,27,-75.42726,6.170465
23608,2014,Enero,Aruba,2,2,,4,-73.181317,7.1280470000000005
23609,2014,Enero,Australia,3,3,,6,-75.516486,10.446304
23610,2014,Enero,Australia,1,3,,4,-74.77647900000001,10.886686
23611,2014,Enero,Australia,2,5,,7,-76.532004,3.451668
23612,2014,Enero,Australia,20,30,,50,-74.140516,4.697157
23613,2014,Enero,Australia,3,0,,3,-75.736374,4.815189
23614,2014,Enero,Australia,4,9,,13,-75.42726,6.170465
23615,2014,Enero,Australia,1,1,,2,-73.181317,7.1280470000000005
23616,2014,Enero,Austria,0,1,,1,-74.77647900000001,10.886686
23617,2014,Enero,Austria,0,2,,2,-76.532004,3.451668
23618,2014,Enero,Austria,15,39,,54,-74.140516,4.697157
23619,2014,Enero,Austria,0,1,,1,-75.42726,6.170465
23620,2014,Enero,Azerbaiyán,0,1,,1,-74.140516,4.697157
23621,2014,Enero,Bahamas,0,3,,3,-75.527794,10.406342
23622,2014,Enero,Bahamas,9,12,,21,-75.516486,10.446304
23623,2014,Enero,Bahamas,0,2,,2,-74.77647900000001,10.886686
23624,2014,Enero,Bahamas,0,2,,2,-74.140516,4.697157
23625,2014,Enero,Bahamas,1,0,,1,-75.736374,4.815189
23626,2014,Enero,Bahamas,2,1,,3,-75.42726,6.170465
23627,2014,Enero,Bahréin,0,1,,1,-74.140516,4.697157
23628,2014,Enero,Barbados,0,1,,1,-76.532004,3.451668
23629,2014,Enero,Barbados,1,1,,2,-74.140516,4.697157
23630,2014,Enero,Barbados,0,1,,1,-75.42726,6.170465
23631,2014,Enero,Barbados,0,1,,1,-73.181317,7.1280470000000005
23632,2014,Enero,República de Belarús,1,1,,2,-74.140516,4.697157
23633,2014,Enero,República de Belarús,0,1,,1,-72.453013,7.819
23634,2014,Enero,Bélgica,0,2,,2,-75.516486,10.446304
23635,2014,Enero,Bélgica,1,2,,3,-74.77647900000001,10.886686
23636,2014,Enero,Bélgica,0,9,,9,-76.532004,3.451668
23637,2014,Enero,Bélgica,26,49,,75,-74.140516,4.697157
23638,2014,Enero,Bélgica,4,2,,6,-75.42726,6.170465
23639,2014,Enero,Bermudas/Territorio Británico de Ultramar,0,1,,1,-74.213989,11.247722999999999
23640,2014,Enero,Bermudas/Territorio Británico de Ultramar,0,2,,2,-74.140516,4.697157
23641,2014,Enero,Bolivia,0,1,,1,-77.35600000000001,0.81488
23642,2014,Enero,Bolivia,9,11,,20,-75.516486,10.446304
23643,2014,Enero,Bolivia,3,0,,3,-74.77647900000001,10.886686
23644,2014,Enero,Bolivia,6,3,,9,-81.70216500000001,12.5862
23645,2014,Enero,Bolivia,8,13,,21,-76.532004,3.451668
23646,2014,Enero,Bolivia,417,494,,911,-74.140516,4.697157
23647,2014,Enero,Bolivia,16,21,,37,-75.42726,6.170465
23648,2014,Enero,Brasil,119,178,,297,-69.941498,4.191162
23649,2014,Enero,Brasil,2,4,,6,-77.35600000000001,0.81488
23650,2014,Enero,Brasil,0,3,,3,-75.527794,10.406342
23651,2014,Enero,Brasil,68,55,,123,-75.516486,10.446304
23652,2014,Enero,Brasil,5,16,,21,-74.77647900000001,10.886686
23653,2014,Enero,Brasil,6,7,,13,-81.70216500000001,12.5862
23654,2014,Enero,Brasil,74,91,,165,-76.532004,3.451668
23655,2014,Enero,Brasil,3247,4436,,7683,-74.140516,4.697157
23656,2014,Enero,Brasil,1,2,,3,-75.736374,4.815189
23657,2014,Enero,Brasil,61,91,,152,-75.42726,6.170465
23658,2014,Enero,Brasil,1,4,,5,-73.181317,7.1280470000000005
23659,2014,Enero,Brunei Darussalam,2,0,,2,-74.140516,4.697157
23660,2014,Enero,Bulgaria,4,1,,5,-74.140516,4.697157
23661,2014,Enero,Burkina Faso,1,0,,1,-76.532004,3.451668
23662,2014,Enero,Cabo Verde,0,9,,9,-74.140516,4.697157
23663,2014,Enero,Islas Caimán/Territorio Británico de Ultramar,3,5,,8,-75.527794,10.406342
23664,2014,Enero,Islas Caimán/Territorio Británico de Ultramar,0,1,,1,-75.516486,10.446304
23665,2014,Enero,Islas Caimán/Territorio Británico de Ultramar,1,0,,1,-74.77647900000001,10.886686
23666,2014,Enero,Islas Caimán/Territorio Británico de Ultramar,2,1,,3,-81.70216500000001,12.5862
23667,2014,Enero,Islas Caimán/Territorio Británico de Ultramar,1,5,,6,-74.140516,4.697157
23668,2014,Enero,Canadá,784,750,,1534,-75.516486,10.446304
23669,2014,Enero,Canadá,6,9,,15,-74.77647900000001,10.886686
23670,2014,Enero,Canadá,471,461,,932,-81.70216500000001,12.5862
23671,2014,Enero,Canadá,14,36,,50,-76.532004,3.451668
23672,2014,Enero,Canadá,0,1,,1,-75.76635300000001,4.45285
23673,2014,Enero,Canadá,530,898,,1428,-74.140516,4.697157
23674,2014,Enero,Canadá,2,7,,9,-75.736374,4.815189
23675,2014,Enero,Canadá,21,53,,74,-75.42726,6.170465
23676,2014,Enero,Canadá,0,1,,1,-72.508188,7.927233
23677,2014,Enero,Chad,0,2,,2,-74.140516,4.697157
23678,2014,Enero,España,0,2,,2,-75.527794,10.406342
23679,2014,Enero,España,5,4,,9,-75.516486,10.446304
23680,2014,Enero,España,1,1,,2,-74.77647900000001,10.886686
23681,2014,Enero,España,215,401,,616,-76.532004,3.451668
23682,2014,Enero,España,2964,6129,,9093,-74.140516,4.697157
23683,2014,Enero,España,0,2,,2,-75.736374,4.815189
23684,2014,Enero,España,139,382,,521,-75.42726,6.170465
23685,2014,Enero,España,0,1,,1,-73.181317,7.1280470000000005
23686,2014,Enero,República de Corea,18,17,,35,-74.140516,4.697157
23687,2014,Enero,Costa de Marfil,1,0,,1,-75.516486,10.446304
23688,2014,Enero,Costa de Marfil,3,1,,4,-74.140516,4.697157
23689,2014,Enero,Costa de Marfil,0,2,,2,-75.42726,6.170465
23690,2014,Enero,Costa Rica,59,57,,116,-75.527794,10.406342
23691,2014,Enero,Costa Rica,16,17,,33,-75.516486,10.446304
23692,2014,Enero,Costa Rica,14,14,,28,-74.77647900000001,10.886686
23693,2014,Enero,Costa Rica,0,2,,2,-74.765343,10.970933
23694,2014,Enero,Costa Rica,642,474,,1116,-81.70216500000001,12.5862
23695,2014,Enero,Costa Rica,7,24,,31,-76.532004,3.451668
23696,2014,Enero,Costa Rica,595,874,,1469,-74.140516,4.697157
23697,2014,Enero,Costa Rica,4,3,,7,-75.736374,4.815189
23698,2014,Enero,Costa Rica,37,65,,102,-75.42726,6.170465
23699,2014,Enero,Costa Rica,2,3,,5,-72.508188,7.927233
23700,2014,Enero,Croacia,0,1,,1,-76.532004,3.451668
23701,2014,Enero,Croacia,0,6,,6,-74.140516,4.697157
23702,2014,Enero,Cuba,113,103,,216,-75.516486,10.446304
23703,2014,Enero,Cuba,7,10,,17,-74.77647900000001,10.886686
23704,2014,Enero,Cuba,15,17,,32,-76.532004,3.451668
23705,2014,Enero,Cuba,192,281,,473,-74.140516,4.697157
23706,2014,Enero,Cuba,3,5,,8,-75.736374,4.815189
23707,2014,Enero,Cuba,15,16,,31,-75.42726,6.170465
23708,2014,Enero,Cuba,2,1,,3,-73.181317,7.1280470000000005
23709,2014,Enero,Cuba,1,2,,3,-72.508188,7.927233
23710,2014,Enero,Curazao,1,2,,3,-75.527794,10.406342
23711,2014,Enero,Curazao,1,12,,13,-75.516486,10.446304
23712,2014,Enero,Curazao,0,4,,4,-74.77647900000001,10.886686
23713,2014,Enero,Curazao,1,1,,2,-76.532004,3.451668
23714,2014,Enero,Curazao,154,227,,381,-74.140516,4.697157
23715,2014,Enero,Curazao,131,179,,310,-75.42726,6.170465
23716,2014,Enero,República Checa,5,7,,12,-74.140516,4.697157
23717,2014,Enero,Chile,0,7,,7,-77.35600000000001,0.81488
23718,2014,Enero,Chile,20,24,,44,-75.516486,10.446304
23719,2014,Enero,Chile,3,18,,21,-74.77647900000001,10.886686
23720,2014,Enero,Chile,23,19,,42,-81.70216500000001,12.5862
23721,2014,Enero,Chile,68,96,,164,-76.532004,3.451668
23722,2014,Enero,Chile,3381,3693,,7074,-74.140516,4.697157
23723,2014,Enero,Chile,86,109,,195,-75.42726,6.170465
23724,2014,Enero,China,1,0,,1,-75.516486,10.446304
23725,2014,Enero,China,0,3,,3,-76.532004,3.451668
23726,2014,Enero,China,20,50,,70,-74.140516,4.697157
23727,2014,Enero,China,1,2,,3,-75.42726,6.170465
23728,2014,Enero,Chipre,0,1,,1,-75.42726,6.170465
23729,2014,Enero,Dinamarca,1,1,,2,-75.516486,10.446304
23730,2014,Enero,Dinamarca,0,4,,4,-76.532004,3.451668
23731,2014,Enero,Dinamarca,11,18,,29,-74.140516,4.697157
23732,2014,Enero,Dinamarca,0,2,,2,-75.42726,6.170465
23733,2014,Enero,Ecuador,32,100,,132,-76.876446,0.33002
23734,2014,Enero,Ecuador,2624,4073,,6697,-77.35600000000001,0.81488
23735,2014,Enero,Ecuador,10,12,,22,-78.802679,18.00143
23736,2014,Enero,Ecuador,0,7,,7,-75.516486,10.446304
23737,2014,Enero,Ecuador,1,2,,3,-74.77647900000001,10.886686
23738,2014,Enero,Ecuador,2,1,,3,-81.70216500000001,12.5862
23739,2014,Enero,Ecuador,367,448,,815,-76.532004,3.451668
23740,2014,Enero,Ecuador,2101,3587,,5688,-74.140516,4.697157
23741,2014,Enero,Ecuador,2,1,,3,-75.736374,4.815189
23742,2014,Enero,Ecuador,440,603,,1043,-75.42726,6.170465
23743,2014,Enero,Ecuador,2,2,,4,-72.508188,7.927233
23744,2014,Enero,Egipto,3,2,,5,-74.140516,4.697157
23745,2014,Enero,El Salvador,1,3,,4,-75.516486,10.446304
23746,2014,Enero,El Salvador,1,2,,3,-74.77647900000001,10.886686
23747,2014,Enero,El Salvador,82,132,,214,-76.532004,3.451668
23748,2014,Enero,El Salvador,710,1173,,1883,-74.140516,4.697157
23749,2014,Enero,El Salvador,1,0,,1,-75.736374,4.815189
23750,2014,Enero,El Salvador,93,188,,281,-75.42726,6.170465
23751,2014,Enero,El Salvador,0,1,,1,-73.181317,7.1280470000000005
23752,2014,Enero,El Salvador,1,0,,1,-72.508188,7.927233
23753,2014,Enero,Emiratos Árabes,1,5,,6,-74.140516,4.697157
23754,2014,Enero,Eslovaquia,4,2,,6,-74.140516,4.697157
23755,2014,Enero,Eslovenia,0,5,,5,-74.140516,4.697157
23756,2014,Enero,Estados Unidos de América,4,15,,19,-75.527794,10.406342
23757,2014,Enero,Estados Unidos de América,1208,2102,,3310,-75.516486,10.446304
23758,2014,Enero,Estados Unidos de América,204,379,,583,-74.77647900000001,10.886686
23759,2014,Enero,Estados Unidos de América,0,10,,10,-74.765343,10.970933
23760,2014,Enero,Estados Unidos de América,3,3,,6,-81.70216500000001,12.5862
23761,2014,Enero,Estados Unidos de América,562,939,,1501,-76.532004,3.451668
23762,2014,Enero,Estados Unidos de América,64,110,,174,-75.76635300000001,4.45285
23763,2014,Enero,Estados Unidos de América,6635,12485,,19120,-74.140516,4.697157
23764,2014,Enero,Estados Unidos de América,46,100,,146,-75.736374,4.815189
23765,2014,Enero,Estados Unidos de América,1149,2797,,3946,-75.42726,6.170465
23766,2014,Enero,Estados Unidos de América,4,13,,17,-73.181317,7.1280470000000005
23767,2014,Enero,Estados Unidos de América,14,22,,36,-72.508188,7.927233
23768,2014,Enero,Estonia,0,3,,3,-75.42726,6.170465
23769,2014,Enero,Filipinas,0,1,,1,-75.516486,10.446304
23770,2014,Enero,Filipinas,0,1,,1,-76.532004,3.451668
23771,2014,Enero,Filipinas,1,8,,9,-74.140516,4.697157
23772,2014,Enero,Finlandia,0,1,,1,-74.77647900000001,10.886686
23773,2014,Enero,Finlandia,1,4,,5,-76.532004,3.451668
23774,2014,Enero,Finlandia,4,6,,10,-74.140516,4.697157
23775,2014,Enero,Finlandia,0,1,,1,-75.42726,6.170465
23776,2014,Enero,Francia,3,2,,5,-75.516486,10.446304
23777,2014,Enero,Francia,1,0,,1,-74.77647900000001,10.886686
23778,2014,Enero,Francia,21,22,,43,-76.532004,3.451668
23779,2014,Enero,Francia,1226,2148,,3374,-74.140516,4.697157
23780,2014,Enero,Francia,7,25,,32,-75.42726,6.170465
23781,2014,Enero,Francia,0,1,,1,-72.508188,7.927233
23782,2014,Enero,Georgia,1,1,,2,-74.140516,4.697157
23783,2014,Enero,Grecia,1,1,,2,-76.532004,3.451668
23784,2014,Enero,Grecia,1,5,,6,-74.140516,4.697157
23785,2014,Enero,Guatemala,4,2,,6,-75.516486,10.446304
23786,2014,Enero,Guatemala,1,6,,7,-74.77647900000001,10.886686
23787,2014,Enero,Guatemala,12,28,,40,-76.532004,3.451668
23788,2014,Enero,Guatemala,151,337,,488,-74.140516,4.697157
23789,2014,Enero,Guatemala,1,3,,4,-75.736374,4.815189
23790,2014,Enero,Guatemala,22,55,,77,-75.42726,6.170465
23791,2014,Enero,Guatemala,1,3,,4,-72.508188,7.927233
23792,2014,Enero,Guyana,0,5,,5,-74.140516,4.697157
23793,2014,Enero,Guyana,2,0,,2,-75.42726,6.170465
23794,2014,Enero,Guinea,1,0,,1,-77.35600000000001,0.81488
23795,2014,Enero,Guinea Ecuatorial,0,1,,1,-74.140516,4.697157
23796,2014,Enero,Guadalupe/Territorio Francés,0,1,,1,-76.532004,3.451668
23797,2014,Enero,Guayana Francesa/Departamento de Ultramar Francés,1,3,,4,-74.140516,4.697157
23798,2014,Enero,Haití,0,19,,19,-74.140516,4.697157
23799,2014,Enero,Haití,1,1,,2,-75.42726,6.170465
23800,2014,Enero,Honduras,1,2,,3,-75.516486,10.446304
23801,2014,Enero,Honduras,3,8,,11,-74.77647900000001,10.886686
23802,2014,Enero,Honduras,1,5,,6,-81.70216500000001,12.5862
23803,2014,Enero,Honduras,13,18,,31,-81.372937,13.338761300000002
23804,2014,Enero,Honduras,6,12,,18,-76.532004,3.451668
23805,2014,Enero,Honduras,39,49,,88,-74.140516,4.697157
23806,2014,Enero,Honduras,1,1,,2,-75.736374,4.815189
23807,2014,Enero,Honduras,11,31,,42,-75.42726,6.170465
23808,2014,Enero,Honduras,1,0,,1,-73.181317,7.1280470000000005
23809,2014,Enero,Honduras,2,1,,3,-72.508188,7.927233
23810,2014,Enero,Hong Kong,0,1,,1,-75.516486,10.446304
23811,2014,Enero,Hong Kong,2,2,,4,-74.140516,4.697157
23812,2014,Enero,Hungría,0,2,,2,-75.516486,10.446304
23813,2014,Enero,Hungría,2,2,,4,-74.140516,4.697157
23814,2014,Enero,India,1,1,,2,-74.77647900000001,10.886686
23815,2014,Enero,India,0,2,,2,-76.532004,3.451668
23816,2014,Enero,India,6,26,,32,-74.140516,4.697157
23817,2014,Enero,India,2,6,,8,-75.42726,6.170465
23818,2014,Enero,Indonesia,0,1,,1,-75.516486,10.446304
23819,2014,Enero,Indonesia,0,1,,1,-74.77647900000001,10.886686
23820,2014,Enero,Iraq,0,1,,1,-74.140516,4.697157
23821,2014,Enero,República de Irlanda,1,1,,2,-75.516486,10.446304
23822,2014,Enero,República de Irlanda,2,10,,12,-74.140516,4.697157
23823,2014,Enero,República de Irlanda,0,1,,1,-75.42726,6.170465
23824,2014,Enero,Islandia,0,3,,3,-74.140516,4.697157
23825,2014,Enero,Israel,0,3,,3,-75.516486,10.446304
23826,2014,Enero,Israel,1,4,,5,-76.532004,3.451668
23827,2014,Enero,Israel,12,58,,70,-74.140516,4.697157
23828,2014,Enero,Israel,2,2,,4,-75.42726,6.170465
23829,2014,Enero,Islas Aland/Provincia de Finlandia,0,1,,1,-74.140516,4.697157
23830,2014,Enero,Italia,5,11,,16,-75.516486,10.446304
23831,2014,Enero,Italia,1,0,,1,-74.77647900000001,10.886686
23832,2014,Enero,Italia,9,39,,48,-76.532004,3.451668
23833,2014,Enero,Italia,106,319,,425,-74.140516,4.697157
23834,2014,Enero,Italia,6,20,,26,-75.42726,6.170465
23835,2014,Enero,Jamaica,0,2,,2,-75.527794,10.406342
23836,2014,Enero,Jamaica,1,1,,2,-75.516486,10.446304
23837,2014,Enero,Jamaica,0,1,,1,-74.77647900000001,10.886686
23838,2014,Enero,Jamaica,1,1,,2,-76.532004,3.451668
23839,2014,Enero,Jamaica,2,6,,8,-74.140516,4.697157
23840,2014,Enero,Jamaica,0,1,,1,-75.736374,4.815189
23841,2014,Enero,Jamaica,1,0,,1,-75.42726,6.170465
23842,2014,Enero,Japón,0,1,,1,-75.516486,10.446304
23843,2014,Enero,Japón,0,2,,2,-74.77647900000001,10.886686
23844,2014,Enero,Japón,1,2,,3,-76.532004,3.451668
23845,2014,Enero,Japón,11,26,,37,-74.140516,4.697157
23846,2014,Enero,Japón,0,5,,5,-75.42726,6.170465
23847,2014,Enero,Jordania,0,1,,1,-74.140516,4.697157
23848,2014,Enero,Kazajistán,0,1,,1,-74.77647900000001,10.886686
23849,2014,Enero,Letonia,1,3,,4,-74.140516,4.697157
23850,2014,Enero,Líbano,1,2,,3,-74.140516,4.697157
23851,2014,Enero,Luxemburgo,0,1,,1,-75.42726,6.170465
23852,2014,Enero,Malasia,0,1,,1,-74.140516,4.697157
23853,2014,Enero,Malasia,0,1,,1,-75.42726,6.170465
23854,2014,Enero,Malta,1,2,,3,-74.140516,4.697157
23855,2014,Enero,Marruecos,0,2,,2,-74.140516,4.697157
23856,2014,Enero,Martinica/Departamento de Ultramar Francés,1,0,,1,-74.140516,4.697157
23857,2014,Enero,México,1,30,,31,-75.527794,10.406342
23858,2014,Enero,México,33,69,,102,-75.516486,10.446304
23859,2014,Enero,México,4,16,,20,-74.77647900000001,10.886686
23860,2014,Enero,México,32,80,,112,-76.532004,3.451668
23861,2014,Enero,México,2802,5198,,8000,-74.140516,4.697157
23862,2014,Enero,México,3,6,,9,-75.736374,4.815189
23863,2014,Enero,México,64,215,,279,-75.42726,6.170465
23864,2014,Enero,México,1,2,,3,-73.181317,7.1280470000000005
23865,2014,Enero,México,15,10,,25,-72.508188,7.927233
23866,2014,Enero,República de Moldavia,0,1,,1,-74.140516,4.697157
23867,2014,Enero,Mónaco,1,0,,1,-74.140516,4.697157
23868,2014,Enero,Montenegro,0,1,,1,-74.77647900000001,10.886686
23869,2014,Enero,Nicaragua,2,3,,5,-75.516486,10.446304
23870,2014,Enero,Nicaragua,3,1,,4,-74.77647900000001,10.886686
23871,2014,Enero,Nicaragua,3,2,,5,-76.532004,3.451668
23872,2014,Enero,Nicaragua,10,31,,41,-74.140516,4.697157
23873,2014,Enero,Nicaragua,0,1,,1,-75.736374,4.815189
23874,2014,Enero,Nicaragua,4,9,,13,-75.42726,6.170465
23875,2014,Enero,Nicaragua,0,1,,1,-72.508188,7.927233
23876,2014,Enero,Nigeria,0,3,,3,-74.140516,4.697157
23877,2014,Enero,Nigeria,0,1,,1,-75.42726,6.170465
23878,2014,Enero,Noruega,2,3,,5,-75.516486,10.446304
23879,2014,Enero,Noruega,1,0,,1,-74.77647900000001,10.886686
23880,2014,Enero,Noruega,7,4,,11,-76.532004,3.451668
23881,2014,Enero,Noruega,13,19,,32,-74.140516,4.697157
23882,2014,Enero,Noruega,0,1,,1,-75.736374,4.815189
23883,2014,Enero,Noruega,1,2,,3,-75.42726,6.170465
23884,2014,Enero,Nueva Zelanda,0,1,,1,-74.77647900000001,10.886686
23885,2014,Enero,Nueva Zelanda,0,1,,1,-76.532004,3.451668
23886,2014,Enero,Nueva Zelanda,1,1,,2,-74.140516,4.697157
23887,2014,Enero,Nueva Zelanda,2,0,,2,-75.42726,6.170465
23888,2014,Enero,Omán,0,1,,1,-74.140516,4.697157
23889,2014,Enero,Papúa Nueva Guinea,0,1,,1,-74.140516,4.697157
23890,2014,Enero,Panamá,540,726,,1266,-75.527794,10.406342
23891,2014,Enero,Panamá,1902,2251,,4153,-75.516486,10.446304
23892,2014,Enero,Panamá,187,345,,532,-74.77647900000001,10.886686
23893,2014,Enero,Panamá,0,14,,14,-74.765343,10.970933
23894,2014,Enero,Panamá,610,512,,1122,-81.70216500000001,12.5862
23895,2014,Enero,Panamá,7,15,,22,-81.372937,13.338761300000002
23896,2014,Enero,Panamá,313,467,,780,-76.532004,3.451668
23897,2014,Enero,Panamá,0,5,,5,-77.061029,3.8844260000000004
23898,2014,Enero,Panamá,2356,3686,,6042,-74.140516,4.697157
23899,2014,Enero,Panamá,53,116,,169,-75.736374,4.815189
23900,2014,Enero,Panamá,538,1108,,1646,-75.42726,6.170465
23901,2014,Enero,Panamá,4,0,,4,-77.401154,6.222551999999999
23902,2014,Enero,Panamá,5,9,,14,-77.762647,7.102626
23903,2014,Enero,Panamá,36,58,,94,-73.181317,7.1280470000000005
23904,2014,Enero,Panamá,97,132,,229,-72.508188,7.927233
23905,2014,Enero,Panamá,98,159,,257,-77.35002,8.63337
23906,2014,Enero,Paraguay,1,0,,1,-77.35600000000001,0.81488
23907,2014,Enero,Paraguay,2,0,,2,-75.516486,10.446304
23908,2014,Enero,Paraguay,3,8,,11,-74.77647900000001,10.886686
23909,2014,Enero,Paraguay,8,4,,12,-81.70216500000001,12.5862
23910,2014,Enero,Paraguay,4,6,,10,-76.532004,3.451668
23911,2014,Enero,Paraguay,22,21,,43,-74.140516,4.697157
23912,2014,Enero,Paraguay,5,5,,10,-75.42726,6.170465
23913,2014,Enero,Paraguay,0,1,,1,-73.181317,7.1280470000000005
23914,2014,Enero,Paraguay,1,0,,1,-72.508188,7.927233
23915,2014,Enero,Perú,155,201,,356,-69.941498,4.191162
23916,2014,Enero,Perú,17,34,,51,-77.35600000000001,0.81488
23917,2014,Enero,Perú,42,24,,66,-75.516486,10.446304
23918,2014,Enero,Perú,14,29,,43,-74.77647900000001,10.886686
23919,2014,Enero,Perú,42,32,,74,-81.70216500000001,12.5862
23920,2014,Enero,Perú,320,408,,728,-76.532004,3.451668
23921,2014,Enero,Perú,4089,5255,,9344,-74.140516,4.697157
23922,2014,Enero,Perú,3,6,,9,-75.736374,4.815189
23923,2014,Enero,Perú,442,638,,1080,-75.42726,6.170465
23924,2014,Enero,Perú,2,2,,4,-73.181317,7.1280470000000005
23925,2014,Enero,Perú,2,17,,19,-72.508188,7.927233
23926,2014,Enero,Polonia,0,2,,2,-76.532004,3.451668
23927,2014,Enero,Polonia,28,23,,51,-74.140516,4.697157
23928,2014,Enero,Portugal,1,2,,3,-76.532004,3.451668
23929,2014,Enero,Portugal,19,56,,75,-74.140516,4.697157
23930,2014,Enero,Portugal,0,10,,10,-75.42726,6.170465
23931,2014,Enero,Puerto Rico/Territorio de Estados Unidos,2,17,,19,-75.516486,10.446304
23932,2014,Enero,Puerto Rico/Territorio de Estados Unidos,4,19,,23,-74.77647900000001,10.886686
23933,2014,Enero,Puerto Rico/Territorio de Estados Unidos,19,89,,108,-76.532004,3.451668
23934,2014,Enero,Puerto Rico/Territorio de Estados Unidos,142,196,,338,-74.140516,4.697157
23935,2014,Enero,Puerto Rico/Territorio de Estados Unidos,6,20,,26,-75.736374,4.815189
23936,2014,Enero,Puerto Rico/Territorio de Estados Unidos,20,36,,56,-75.42726,6.170465
23937,2014,Enero,Puerto Rico/Territorio de Estados Unidos,1,1,,2,-73.181317,7.1280470000000005
23938,2014,Enero,Puerto Rico/Territorio de Estados Unidos,1,1,,2,-72.508188,7.927233
23939,2014,Enero,Qatar,0,1,,1,-75.42726,6.170465
23940,2014,Enero,Reino Unido de Gran Bretaña e Irlanda del Norte,7,9,,16,-75.516486,10.446304
23941,2014,Enero,Reino Unido de Gran Bretaña e Irlanda del Norte,0,1,,1,-74.77647900000001,10.886686
23942,2014,Enero,Reino Unido de Gran Bretaña e Irlanda del Norte,5,16,,21,-76.532004,3.451668
23943,2014,Enero,Reino Unido de Gran Bretaña e Irlanda del Norte,97,180,,277,-74.140516,4.697157
23944,2014,Enero,Reino Unido de Gran Bretaña e Irlanda del Norte,10,22,,32,-75.42726,6.170465
23945,2014,Enero,Federación de Rusia,1,1,,2,-74.77647900000001,10.886686
23946,2014,Enero,Federación de Rusia,62,91,,153,-74.140516,4.697157
23947,2014,Enero,Federación de Rusia,0,2,,2,-75.42726,6.170465
23948,2014,Enero,República Dominicana,5,15,,20,-75.516486,10.446304
23949,2014,Enero,República Dominicana,9,33,,42,-74.77647900000001,10.886686
23950,2014,Enero,República Dominicana,0,2,,2,-74.765343,10.970933
23951,2014,Enero,República Dominicana,0,16,,16,-74.232675,11.117206
23952,2014,Enero,República Dominicana,0,4,,4,-81.70216500000001,12.5862
23953,2014,Enero,República Dominicana,17,20,,37,-76.532004,3.451668
23954,2014,Enero,República Dominicana,322,510,,832,-74.140516,4.697157
23955,2014,Enero,República Dominicana,2,8,,10,-75.736374,4.815189
23956,2014,Enero,República Dominicana,15,56,,71,-75.42726,6.170465
23957,2014,Enero,República Dominicana,0,1,,1,-73.181317,7.1280470000000005
23958,2014,Enero,Rumania,4,5,,9,-74.140516,4.697157
23959,2014,Enero,Rwanda,0,1,,1,-74.140516,4.697157
23960,2014,Enero,San  Vicente y las Granadinas,0,1,,1,-75.516486,10.446304
23961,2014,Enero,Senegal,1,0,,1,-74.140516,4.697157
23962,2014,Enero,Singapur,2,4,,6,-74.140516,4.697157
23963,2014,Enero,Sudáfrica,1,6,,7,-74.140516,4.697157
23964,2014,Enero,Sudáfrica,1,2,,3,-75.42726,6.170465
23965,2014,Enero,Suecia,3,1,,4,-75.516486,10.446304
23966,2014,Enero,Suecia,1,0,,1,-74.77647900000001,10.886686
23967,2014,Enero,Suecia,2,2,,4,-76.532004,3.451668
23968,2014,Enero,Suecia,33,53,,86,-74.140516,4.697157
23969,2014,Enero,Suecia,4,0,,4,-75.42726,6.170465
23970,2014,Enero,Suiza,2,3,,5,-75.516486,10.446304
23971,2014,Enero,Suiza,1,0,,1,-74.77647900000001,10.886686
23972,2014,Enero,Suiza,12,14,,26,-76.532004,3.451668
23973,2014,Enero,Suiza,58,91,,149,-74.140516,4.697157
23974,2014,Enero,Suiza,7,12,,19,-75.42726,6.170465
23975,2014,Enero,Surinam,1,3,,4,-74.140516,4.697157
23976,2014,Enero,Surinam,0,6,,6,-75.736374,4.815189
23977,2014,Enero,Surinam,3,3,,6,-75.42726,6.170465
23978,2014,Enero,Taiwán,0,1,,1,-75.516486,10.446304
23979,2014,Enero,Taiwán,1,0,,1,-76.532004,3.451668
23980,2014,Enero,Taiwán,2,3,,5,-74.140516,4.697157
23981,2014,Enero,Tailandia,0,1,,1,-74.140516,4.697157
23982,2014,Enero,Togo,0,1,,1,-74.140516,4.697157
23983,2014,Enero,Trinidad y Tobago,2,0,,2,-75.516486,10.446304
23984,2014,Enero,Trinidad y Tobago,3,4,,7,-76.532004,3.451668
23985,2014,Enero,Trinidad y Tobago,4,9,,13,-74.140516,4.697157
23986,2014,Enero,Trinidad y Tobago,1,2,,3,-75.42726,6.170465
23987,2014,Enero,Trinidad y Tobago,1,1,,2,-72.508188,7.927233
23988,2014,Enero,Turquía,0,3,,3,-74.77647900000001,10.886686
23989,2014,Enero,Turquía,0,1,,1,-76.532004,3.451668
23990,2014,Enero,Turquía,2,9,,11,-74.140516,4.697157
23991,2014,Enero,Turquía,2,4,,6,-75.42726,6.170465
23992,2014,Enero,Ucrania,0,1,,1,-76.532004,3.451668
23993,2014,Enero,Ucrania,1,4,,5,-74.140516,4.697157
23994,2014,Enero,Uruguay,5,10,,15,-75.516486,10.446304
23995,2014,Enero,Uruguay,2,1,,3,-74.77647900000001,10.886686
23996,2014,Enero,Uruguay,9,6,,15,-81.70216500000001,12.5862
23997,2014,Enero,Uruguay,10,18,,28,-76.532004,3.451668
23998,2014,Enero,Uruguay,42,64,,106,-74.140516,4.697157
23999,2014,Enero,Uruguay,17,27,,44,-75.42726,6.170465
24000,2014,Enero,Venezuela,2,11,,13,-75.527794,10.406342
24001,2014,Enero,Venezuela,22,48,,70,-75.516486,10.446304
24002,2014,Enero,Venezuela,29,67,,96,-74.77647900000001,10.886686
24003,2014,Enero,Venezuela,0,3,,3,-74.232675,11.117206
24004,2014,Enero,Venezuela,1689,2919,,4608,-72.129595,11.360028999999999
24005,2014,Enero,Venezuela,40,48,,88,-76.532004,3.451668
24006,2014,Enero,Venezuela,4501,5321,,9822,-74.140516,4.697157
24007,2014,Enero,Venezuela,3,18,,21,-75.736374,4.815189
24008,2014,Enero,Venezuela,365,440,,805,-75.42726,6.170465
24009,2014,Enero,Venezuela,45,75,,120,-67.48402800000001,6.185536
24010,2014,Enero,Venezuela,79,183,,262,-70.74025300000001,7.088728999999999
24011,2014,Enero,Venezuela,0,2,,2,-73.181317,7.1280470000000005
24012,2014,Enero,Venezuela,2849,3141,,5990,-72.453013,7.819
24013,2014,Enero,Venezuela,140,181,,321,-72.508188,7.927233
24014,2014,Enero,Desconocido,28,27,,55,-75.527794,10.406342
24015,2014,Enero,Desconocido,0,7,,7,-74.140516,4.697157
24016,2014,Enero,Desconocido,1,0,,1,-75.42726,6.170465
24017,2014,Enero,Desconocido,0,5,,5,-73.181317,7.1280470000000005
24018,2014,Enero,Desconocido,1,2,,3,-77.35002,8.63337
24019,2014,Enero,Desconocido,0,12,,12,-75.68164200000001,9.402597
24020,2014,Febrero,Desconocido,0,11,,11,-81.703935,12.574411099999999
24021,2014,Febrero,Desconocido,1,1,,2,-67.48402800000001,6.185536
24022,2014,Febrero,Desconocido,1,2,,3,-73.181317,7.1280470000000005
24023,2014,Febrero,Desconocido,0,7,,7,-75.68164200000001,9.402597
24024,2014,Febrero,Afganistán,0,1,,1,-75.527794,10.406342
24025,2014,Febrero,Afganistán,1,1,,2,-74.140516,4.697157
24026,2014,Febrero,Albania,1,0,,1,-74.140516,4.697157
24027,2014,Febrero,Alemania,0,3,,3,-75.516486,10.446304
24028,2014,Febrero,Alemania,4,5,,9,-74.77647900000001,10.886686
24029,2014,Febrero,Alemania,7,17,,24,-76.532004,3.451668
24030,2014,Febrero,Alemania,1467,2334,,3801,-74.140516,4.697157
24031,2014,Febrero,Alemania,5,16,,21,-75.42726,6.170465
24032,2014,Febrero,Andorra,0,1,,1,-74.140516,4.697157
24033,2014,Febrero,Antigua y Barbuda,0,3,,3,-75.527794,10.406342
24034,2014,Febrero,Antigua y Barbuda,0,6,,6,-74.140516,4.697157
24035,2014,Febrero,Países Bajos,11,4,,15,-75.527794,10.406342
24036,2014,Febrero,Países Bajos,0,7,,7,-75.516486,10.446304
24037,2014,Febrero,Países Bajos,1,2,,3,-74.77647900000001,10.886686
24038,2014,Febrero,Países Bajos,8,22,,30,-76.532004,3.451668
24039,2014,Febrero,Países Bajos,30,84,,114,-74.140516,4.697157
24040,2014,Febrero,Países Bajos,2,0,,2,-75.736374,4.815189
24041,2014,Febrero,Países Bajos,33,44,,77,-75.42726,6.170465
24042,2014,Febrero,Países Bajos,6,1,,7,-73.181317,7.1280470000000005
24043,2014,Febrero,Argelia,1,0,,1,-74.140516,4.697157
24044,2014,Febrero,Argentina,7,10,,17,-77.35600000000001,0.81488
24045,2014,Febrero,Argentina,198,138,,336,-75.516486,10.446304
24046,2014,Febrero,Argentina,13,18,,31,-74.77647900000001,10.886686
24047,2014,Febrero,Argentina,60,50,,110,-81.70216500000001,12.5862
24048,2014,Febrero,Argentina,42,46,,88,-76.532004,3.451668
24049,2014,Febrero,Argentina,2244,2728,,4972,-74.140516,4.697157
24050,2014,Febrero,Argentina,0,1,,1,-75.736374,4.815189
24051,2014,Febrero,Argentina,65,95,,160,-75.42726,6.170465
24052,2014,Febrero,República de Armenia,0,1,,1,-74.140516,4.697157
24053,2014,Febrero,Aruba,103,74,,177,-75.527794,10.406342
24054,2014,Febrero,Aruba,2,3,,5,-75.516486,10.446304
24055,2014,Febrero,Aruba,1,1,,2,-74.77647900000001,10.886686
24056,2014,Febrero,Aruba,11,13,,24,-72.919186,11.52863
24057,2014,Febrero,Aruba,1,6,,7,-76.532004,3.451668
24058,2014,Febrero,Aruba,348,450,,798,-74.140516,4.697157
24059,2014,Febrero,Aruba,7,3,,10,-75.42726,6.170465
24060,2014,Febrero,Aruba,6,6,,12,-73.181317,7.1280470000000005
24061,2014,Febrero,Australia,1,2,,3,-75.516486,10.446304
24062,2014,Febrero,Australia,1,1,,2,-74.77647900000001,10.886686
24063,2014,Febrero,Australia,5,7,,12,-76.532004,3.451668
24064,2014,Febrero,Australia,12,21,,33,-74.140516,4.697157
24065,2014,Febrero,Australia,8,16,,24,-75.42726,6.170465
24066,2014,Febrero,Austria,0,1,,1,-75.516486,10.446304
24067,2014,Febrero,Austria,1,1,,2,-76.532004,3.451668
24068,2014,Febrero,Austria,18,28,,46,-74.140516,4.697157
24069,2014,Febrero,Austria,1,1,,2,-75.42726,6.170465
24070,2014,Febrero,Bahamas,0,3,,3,-75.516486,10.446304
24071,2014,Febrero,Bahamas,0,2,,2,-74.77647900000001,10.886686
24072,2014,Febrero,Bahamas,0,5,,5,-74.140516,4.697157
24073,2014,Febrero,Bahréin,0,1,,1,-74.140516,4.697157
24074,2014,Febrero,República de Belarús,1,0,,1,-74.140516,4.697157
24075,2014,Febrero,Bélgica,1,2,,3,-74.77647900000001,10.886686
24076,2014,Febrero,Bélgica,0,11,,11,-76.532004,3.451668
24077,2014,Febrero,Bélgica,26,49,,75,-74.140516,4.697157
24078,2014,Febrero,Bélgica,1,8,,9,-75.42726,6.170465
24079,2014,Febrero,Belice,0,5,,5,-74.140516,4.697157
24080,2014,Febrero,Bolivia,1,4,,5,-77.35600000000001,0.81488
24081,2014,Febrero,Bolivia,1,6,,7,-75.516486,10.446304
24082,2014,Febrero,Bolivia,2,0,,2,-74.77647900000001,10.886686
24083,2014,Febrero,Bolivia,5,1,,6,-81.70216500000001,12.5862
24084,2014,Febrero,Bolivia,2,7,,9,-76.532004,3.451668
24085,2014,Febrero,Bolivia,203,317,,520,-74.140516,4.697157
24086,2014,Febrero,Bolivia,0,1,,1,-75.736374,4.815189
24087,2014,Febrero,Bolivia,11,19,,30,-75.42726,6.170465
24088,2014,Febrero,Bolivia,0,1,,1,-73.181317,7.1280470000000005
24089,2014,Febrero,Brasil,129,149,,278,-69.941498,4.191162
24090,2014,Febrero,Brasil,0,1,,1,-77.35600000000001,0.81488
24091,2014,Febrero,Brasil,0,2,,2,-75.527794,10.406342
24092,2014,Febrero,Brasil,141,96,,237,-75.516486,10.446304
24093,2014,Febrero,Brasil,9,11,,20,-74.77647900000001,10.886686
24094,2014,Febrero,Brasil,23,15,,38,-81.70216500000001,12.5862
24095,2014,Febrero,Brasil,26,69,,95,-76.532004,3.451668
24096,2014,Febrero,Brasil,2724,4317,,7041,-74.140516,4.697157
24097,2014,Febrero,Brasil,43,66,,109,-75.42726,6.170465
24098,2014,Febrero,Brasil,2,0,,2,-73.181317,7.1280470000000005
24099,2014,Febrero,Brunei Darussalam,0,1,,1,-74.140516,4.697157
24100,2014,Febrero,Bulgaria,1,1,,2,-74.140516,4.697157
24101,2014,Febrero,Islas Caimán/Territorio Británico de Ultramar,2,2,,4,-75.527794,10.406342
24102,2014,Febrero,Islas Caimán/Territorio Británico de Ultramar,0,8,,8,-75.516486,10.446304
24103,2014,Febrero,Islas Caimán/Territorio Británico de Ultramar,0,2,,2,-74.140516,4.697157
24104,2014,Febrero,Canadá,725,705,,1430,-75.516486,10.446304
24105,2014,Febrero,Canadá,6,10,,16,-74.77647900000001,10.886686
24106,2014,Febrero,Canadá,387,352,,739,-81.70216500000001,12.5862
24107,2014,Febrero,Canadá,15,26,,41,-76.532004,3.451668
24108,2014,Febrero,Canadá,0,3,,3,-77.061029,3.8844260000000004
24109,2014,Febrero,Canadá,501,847,,1348,-74.140516,4.697157
24110,2014,Febrero,Canadá,0,3,,3,-75.736374,4.815189
24111,2014,Febrero,Canadá,24,72,,96,-75.42726,6.170465
24112,2014,Febrero,Canadá,0,3,,3,-73.181317,7.1280470000000005
24113,2014,Febrero,España,2,6,,8,-75.527794,10.406342
24114,2014,Febrero,España,3,6,,9,-75.516486,10.446304
24115,2014,Febrero,España,2,3,,5,-74.77647900000001,10.886686
24116,2014,Febrero,España,0,1,,1,-81.70216500000001,12.5862
24117,2014,Febrero,España,209,362,,571,-76.532004,3.451668
24118,2014,Febrero,España,2511,5392,,7903,-74.140516,4.697157
24119,2014,Febrero,España,1,1,,2,-75.736374,4.815189
24120,2014,Febrero,España,117,292,,409,-75.42726,6.170465
24121,2014,Febrero,España,1,0,,1,-73.181317,7.1280470000000005
24122,2014,Febrero,República Democrática del Congo,0,1,,1,-74.140516,4.697157
24123,2014,Febrero,República de Corea,1,1,,2,-76.532004,3.451668
24124,2014,Febrero,República de Corea,8,15,,23,-74.140516,4.697157
24125,2014,Febrero,República de Corea,0,3,,3,-75.42726,6.170465
24126,2014,Febrero,Costa de Marfil,0,4,,4,-74.140516,4.697157
24127,2014,Febrero,Costa de Marfil,1,0,,1,-72.508188,7.927233
24128,2014,Febrero,Costa Rica,37,39,,76,-75.527794,10.406342
24129,2014,Febrero,Costa Rica,15,17,,32,-75.516486,10.446304
24130,2014,Febrero,Costa Rica,5,13,,18,-74.77647900000001,10.886686
24131,2014,Febrero,Costa Rica,173,154,,327,-81.70216500000001,12.5862
24132,2014,Febrero,Costa Rica,15,20,,35,-76.532004,3.451668
24133,2014,Febrero,Costa Rica,613,966,,1579,-74.140516,4.697157
24134,2014,Febrero,Costa Rica,3,2,,5,-75.736374,4.815189
24135,2014,Febrero,Costa Rica,24,98,,122,-75.42726,6.170465
24136,2014,Febrero,Costa Rica,0,2,,2,-72.508188,7.927233
24137,2014,Febrero,Croacia,1,13,,14,-75.527794,10.406342
24138,2014,Febrero,Croacia,2,5,,7,-74.140516,4.697157
24139,2014,Febrero,Cuba,3,8,,11,-75.516486,10.446304
24140,2014,Febrero,Cuba,1,5,,6,-74.77647900000001,10.886686
24141,2014,Febrero,Cuba,3,16,,19,-76.532004,3.451668
24142,2014,Febrero,Cuba,137,246,,383,-74.140516,4.697157
24143,2014,Febrero,Cuba,0,2,,2,-75.736374,4.815189
24144,2014,Febrero,Cuba,10,15,,25,-75.42726,6.170465
24145,2014,Febrero,Cuba,1,1,,2,-73.181317,7.1280470000000005
24146,2014,Febrero,Cuba,0,1,,1,-72.508188,7.927233
24147,2014,Febrero,Curazao,2,7,,9,-75.527794,10.406342
24148,2014,Febrero,Curazao,0,1,,1,-74.77647900000001,10.886686
24149,2014,Febrero,Curazao,192,263,,455,-74.140516,4.697157
24150,2014,Febrero,Curazao,159,186,,345,-75.42726,6.170465
24151,2014,Febrero,República Checa,1,1,,2,-75.516486,10.446304
24152,2014,Febrero,República Checa,10,9,,19,-74.140516,4.697157
24153,2014,Febrero,Chile,2,3,,5,-77.35600000000001,0.81488
24154,2014,Febrero,Chile,33,50,,83,-75.516486,10.446304
24155,2014,Febrero,Chile,2,2,,4,-74.77647900000001,10.886686
24156,2014,Febrero,Chile,37,23,,60,-81.70216500000001,12.5862
24157,2014,Febrero,Chile,47,71,,118,-76.532004,3.451668
24158,2014,Febrero,Chile,3837,4187,,8024,-74.140516,4.697157
24159,2014,Febrero,Chile,92,133,,225,-75.42726,6.170465
24160,2014,Febrero,China,0,1,,1,-75.516486,10.446304
24161,2014,Febrero,China,1,4,,5,-76.532004,3.451668
24162,2014,Febrero,China,30,65,,95,-74.140516,4.697157
24163,2014,Febrero,China,1,2,,3,-75.42726,6.170465
24164,2014,Febrero,Chipre,0,1,,1,-74.140516,4.697157
24165,2014,Febrero,Dinamarca,1,4,,5,-75.516486,10.446304
24166,2014,Febrero,Dinamarca,2,11,,13,-76.532004,3.451668
24167,2014,Febrero,Dinamarca,12,22,,34,-74.140516,4.697157
24168,2014,Febrero,Dinamarca,1,2,,3,-75.42726,6.170465
24169,2014,Febrero,Dominica,0,1,,1,-74.140516,4.697157
24170,2014,Febrero,Ecuador,34,83,,117,-76.876446,0.33002
24171,2014,Febrero,Ecuador,2420,3262,,5682,-77.35600000000001,0.81488
24172,2014,Febrero,Ecuador,3,24,,27,-78.802679,18.00143
24173,2014,Febrero,Ecuador,0,1,,1,-75.527794,10.406342
24174,2014,Febrero,Ecuador,6,18,,24,-75.516486,10.446304
24175,2014,Febrero,Ecuador,10,15,,25,-74.77647900000001,10.886686
24176,2014,Febrero,Ecuador,8,4,,12,-81.70216500000001,12.5862
24177,2014,Febrero,Ecuador,506,544,,1050,-76.532004,3.451668
24178,2014,Febrero,Ecuador,0,1,,1,-77.061029,3.8844260000000004
24179,2014,Febrero,Ecuador,1934,3575,,5509,-74.140516,4.697157
24180,2014,Febrero,Ecuador,0,1,,1,-75.736374,4.815189
24181,2014,Febrero,Ecuador,399,534,,933,-75.42726,6.170465
24182,2014,Febrero,Egipto,0,3,,3,-74.140516,4.697157
24183,2014,Febrero,Egipto,1,0,,1,-75.42726,6.170465
24184,2014,Febrero,El Salvador,0,1,,1,-75.516486,10.446304
24185,2014,Febrero,El Salvador,0,1,,1,-74.77647900000001,10.886686
24186,2014,Febrero,El Salvador,62,53,,115,-81.70216500000001,12.5862
24187,2014,Febrero,El Salvador,59,135,,194,-76.532004,3.451668
24188,2014,Febrero,El Salvador,702,1269,,1971,-74.140516,4.697157
24189,2014,Febrero,El Salvador,0,1,,1,-75.736374,4.815189
24190,2014,Febrero,El Salvador,81,184,,265,-75.42726,6.170465
24191,2014,Febrero,Emiratos Árabes,1,1,,2,-74.140516,4.697157
24192,2014,Febrero,Eslovaquia,1,1,,2,-76.532004,3.451668
24193,2014,Febrero,Eslovaquia,2,3,,5,-74.140516,4.697157
24194,2014,Febrero,Eslovenia,0,1,,1,-76.532004,3.451668
24195,2014,Febrero,Eslovenia,1,2,,3,-74.140516,4.697157
24196,2014,Febrero,Estados Unidos de América,6,33,,39,-75.527794,10.406342
24197,2014,Febrero,Estados Unidos de América,1582,2286,,3868,-75.516486,10.446304
24198,2014,Febrero,Estados Unidos de América,307,556,,863,-74.77647900000001,10.886686
24199,2014,Febrero,Estados Unidos de América,0,1,,1,-81.703935,12.574411099999999
24200,2014,Febrero,Estados Unidos de América,2,6,,8,-81.70216500000001,12.5862
24201,2014,Febrero,Estados Unidos de América,666,1108,,1774,-76.532004,3.451668
24202,2014,Febrero,Estados Unidos de América,0,1,,1,-77.061029,3.8844260000000004
24203,2014,Febrero,Estados Unidos de América,71,128,,199,-75.76635300000001,4.45285
24204,2014,Febrero,Estados Unidos de América,7281,14173,,21454,-74.140516,4.697157
24205,2014,Febrero,Estados Unidos de América,36,47,,83,-75.736374,4.815189
24206,2014,Febrero,Estados Unidos de América,1183,2963,,4146,-75.42726,6.170465
24207,2014,Febrero,Estados Unidos de América,7,17,,24,-73.181317,7.1280470000000005
24208,2014,Febrero,Estados Unidos de América,0,7,,7,-72.508188,7.927233
24209,2014,Febrero,Estonia,2,0,,2,-74.140516,4.697157
24210,2014,Febrero,Filipinas,1,2,,3,-75.516486,10.446304
24211,2014,Febrero,Filipinas,0,4,,4,-74.77647900000001,10.886686
24212,2014,Febrero,Filipinas,0,5,,5,-76.532004,3.451668
24213,2014,Febrero,Filipinas,2,15,,17,-74.140516,4.697157
24214,2014,Febrero,Finlandia,1,0,,1,-76.532004,3.451668
24215,2014,Febrero,Finlandia,4,13,,17,-74.140516,4.697157
24216,2014,Febrero,Francia,0,1,,1,-75.527794,10.406342
24217,2014,Febrero,Francia,5,7,,12,-75.516486,10.446304
24218,2014,Febrero,Francia,2,2,,4,-74.77647900000001,10.886686
24219,2014,Febrero,Francia,12,26,,38,-76.532004,3.451668
24220,2014,Febrero,Francia,1130,2220,,3350,-74.140516,4.697157
24221,2014,Febrero,Francia,5,15,,20,-75.42726,6.170465
24222,2014,Febrero,Georgia,0,1,,1,-74.140516,4.697157
24223,2014,Febrero,Ghana,0,1,,1,-74.140516,4.697157
24224,2014,Febrero,Granada,0,1,,1,-74.140516,4.697157
24225,2014,Febrero,Grecia,1,0,,1,-75.516486,10.446304
24226,2014,Febrero,Grecia,1,0,,1,-76.532004,3.451668
24227,2014,Febrero,Grecia,2,7,,9,-74.140516,4.697157
24228,2014,Febrero,Grecia,1,3,,4,-75.42726,6.170465
24229,2014,Febrero,Guatemala,4,10,,14,-75.516486,10.446304
24230,2014,Febrero,Guatemala,1,1,,2,-74.77647900000001,10.886686
24231,2014,Febrero,Guatemala,9,16,,25,-76.532004,3.451668
24232,2014,Febrero,Guatemala,139,303,,442,-74.140516,4.697157
24233,2014,Febrero,Guatemala,1,1,,2,-75.736374,4.815189
24234,2014,Febrero,Guatemala,15,47,,62,-75.42726,6.170465
24235,2014,Febrero,Guatemala,0,1,,1,-73.181317,7.1280470000000005
24236,2014,Febrero,Guyana,0,1,,1,-75.527794,10.406342
24237,2014,Febrero,Guyana,0,1,,1,-74.140516,4.697157
24238,2014,Febrero,Guadalupe/Territorio Francés,0,1,,1,-74.77647900000001,10.886686
24239,2014,Febrero,Guadalupe/Territorio Francés,1,4,,5,-74.140516,4.697157
24240,2014,Febrero,Guayana Francesa/Departamento de Ultramar Francés,2,0,,2,-74.140516,4.697157
24241,2014,Febrero,Haití,0,4,,4,-75.527794,10.406342
24242,2014,Febrero,Haití,0,1,,1,-75.516486,10.446304
24243,2014,Febrero,Haití,3,15,,18,-74.140516,4.697157
24244,2014,Febrero,Haití,1,2,,3,-75.42726,6.170465
24245,2014,Febrero,Honduras,0,1,,1,-75.516486,10.446304
24246,2014,Febrero,Honduras,5,3,,8,-74.77647900000001,10.886686
24247,2014,Febrero,Honduras,0,5,,5,-81.70216500000001,12.5862
24248,2014,Febrero,Honduras,6,2,,8,-76.532004,3.451668
24249,2014,Febrero,Honduras,17,31,,48,-74.140516,4.697157
24250,2014,Febrero,Honduras,2,2,,4,-75.736374,4.815189
24251,2014,Febrero,Honduras,20,15,,35,-75.42726,6.170465
24252,2014,Febrero,Honduras,0,1,,1,-73.181317,7.1280470000000005
24253,2014,Febrero,Hong Kong,2,5,,7,-74.140516,4.697157
24254,2014,Febrero,Hungría,0,5,,5,-74.140516,4.697157
24255,2014,Febrero,India,7,21,,28,-74.140516,4.697157
24256,2014,Febrero,India,0,3,,3,-75.42726,6.170465
24257,2014,Febrero,Indonesia,0,2,,2,-75.516486,10.446304
24258,2014,Febrero,Indonesia,0,1,,1,-74.77647900000001,10.886686
24259,2014,Febrero,Indonesia,1,4,,5,-74.140516,4.697157
24260,2014,Febrero,Irán,0,1,,1,-74.140516,4.697157
24261,2014,Febrero,República de Irlanda,1,1,,2,-75.516486,10.446304
24262,2014,Febrero,República de Irlanda,0,1,,1,-76.532004,3.451668
24263,2014,Febrero,República de Irlanda,6,12,,18,-74.140516,4.697157
24264,2014,Febrero,República de Irlanda,0,2,,2,-75.42726,6.170465
24265,2014,Febrero,Islandia,1,0,,1,-76.532004,3.451668
24266,2014,Febrero,Israel,0,1,,1,-75.516486,10.446304
24267,2014,Febrero,Israel,0,3,,3,-76.532004,3.451668
24268,2014,Febrero,Israel,6,53,,59,-74.140516,4.697157
24269,2014,Febrero,Israel,0,2,,2,-75.42726,6.170465
24270,2014,Febrero,Italia,5,7,,12,-75.516486,10.446304
24271,2014,Febrero,Italia,3,2,,5,-74.77647900000001,10.886686
24272,2014,Febrero,Italia,5,12,,17,-76.532004,3.451668
24273,2014,Febrero,Italia,79,229,,308,-74.140516,4.697157
24274,2014,Febrero,Italia,10,8,,18,-75.42726,6.170465
24275,2014,Febrero,Italia,0,1,,1,-73.181317,7.1280470000000005
24276,2014,Febrero,Jamaica,0,3,,3,-75.527794,10.406342
24277,2014,Febrero,Jamaica,3,8,,11,-75.516486,10.446304
24278,2014,Febrero,Jamaica,1,3,,4,-74.77647900000001,10.886686
24279,2014,Febrero,Jamaica,3,2,,5,-76.532004,3.451668
24280,2014,Febrero,Jamaica,0,4,,4,-74.140516,4.697157
24281,2014,Febrero,Japón,1,1,,2,-75.516486,10.446304
24282,2014,Febrero,Japón,0,1,,1,-74.77647900000001,10.886686
24283,2014,Febrero,Japón,2,12,,14,-76.532004,3.451668
24284,2014,Febrero,Japón,10,23,,33,-74.140516,4.697157
24285,2014,Febrero,Japón,0,1,,1,-75.736374,4.815189
24286,2014,Febrero,Japón,1,1,,2,-75.42726,6.170465
24287,2014,Febrero,Japón,0,1,,1,-73.181317,7.1280470000000005
24288,2014,Febrero,Jordania,1,0,,1,-74.140516,4.697157
24289,2014,Febrero,Kazajistán,0,1,,1,-74.140516,4.697157
24290,2014,Febrero,Kazajistán,0,2,,2,-75.42726,6.170465
24291,2014,Febrero,Kenia,0,2,,2,-74.140516,4.697157
24292,2014,Febrero,República Democrática Popular  Lao,3,1,,4,-74.140516,4.697157
24293,2014,Febrero,Letonia,0,7,,7,-74.140516,4.697157
24294,2014,Febrero,Lituania,1,0,,1,-76.532004,3.451668
24295,2014,Febrero,Lituania,0,2,,2,-74.140516,4.697157
24296,2014,Febrero,Líbano,2,2,,4,-74.140516,4.697157
24297,2014,Febrero,Luxemburgo,3,4,,7,-74.140516,4.697157
24298,2014,Febrero,Malasia,2,1,,3,-76.532004,3.451668
24299,2014,Febrero,Malasia,3,2,,5,-74.140516,4.697157
24300,2014,Febrero,Malta,0,1,,1,-74.140516,4.697157
24301,2014,Febrero,Marruecos,0,1,,1,-74.140516,4.697157
24302,2014,Febrero,México,0,3,,3,-75.527794,10.406342
24303,2014,Febrero,México,33,73,,106,-75.516486,10.446304
24304,2014,Febrero,México,14,29,,43,-74.77647900000001,10.886686
24305,2014,Febrero,México,1,4,,5,-81.703935,12.574411099999999
24306,2014,Febrero,México,28,84,,112,-76.532004,3.451668
24307,2014,Febrero,México,2560,5658,,8218,-74.140516,4.697157
24308,2014,Febrero,México,2,8,,10,-75.736374,4.815189
24309,2014,Febrero,México,52,174,,226,-75.42726,6.170465
24310,2014,Febrero,México,3,4,,7,-73.181317,7.1280470000000005
24311,2014,Febrero,México,1,0,,1,-72.508188,7.927233
24312,2014,Febrero,Mónaco,0,1,,1,-74.140516,4.697157
24313,2014,Febrero,Montenegro,0,1,,1,-75.42726,6.170465
24314,2014,Febrero,Mozambique,0,1,,1,-74.140516,4.697157
24315,2014,Febrero,Myanmar,0,3,,3,-74.140516,4.697157
24316,2014,Febrero,Nepal,0,1,,1,-74.140516,4.697157
24317,2014,Febrero,Nicaragua,2,5,,7,-75.516486,10.446304
24318,2014,Febrero,Nicaragua,1,1,,2,-74.77647900000001,10.886686
24319,2014,Febrero,Nicaragua,0,1,,1,-81.70216500000001,12.5862
24320,2014,Febrero,Nicaragua,3,5,,8,-76.532004,3.451668
24321,2014,Febrero,Nicaragua,18,21,,39,-74.140516,4.697157
24322,2014,Febrero,Nicaragua,0,2,,2,-75.736374,4.815189
24323,2014,Febrero,Nicaragua,5,7,,12,-75.42726,6.170465
24324,2014,Febrero,Nicaragua,0,1,,1,-72.508188,7.927233
24325,2014,Febrero,Nigeria,0,2,,2,-74.140516,4.697157
24326,2014,Febrero,Noruega,0,3,,3,-75.516486,10.446304
24327,2014,Febrero,Noruega,1,3,,4,-76.532004,3.451668
24328,2014,Febrero,Noruega,10,31,,41,-74.140516,4.697157
24329,2014,Febrero,Noruega,0,2,,2,-75.736374,4.815189
24330,2014,Febrero,Noruega,1,2,,3,-75.42726,6.170465
24331,2014,Febrero,Nueva Zelanda,0,3,,3,-76.532004,3.451668
24332,2014,Febrero,Nueva Zelanda,3,2,,5,-74.140516,4.697157
24333,2014,Febrero,Nueva Zelanda,0,1,,1,-75.42726,6.170465
24334,2014,Febrero,Pakistán,0,1,,1,-76.532004,3.451668
24335,2014,Febrero,Panamá,929,950,,1879,-75.527794,10.406342
24336,2014,Febrero,Panamá,1976,2146,,4122,-75.516486,10.446304
24337,2014,Febrero,Panamá,258,484,,742,-74.77647900000001,10.886686
24338,2014,Febrero,Panamá,0,1,,1,-81.703935,12.574411099999999
24339,2014,Febrero,Panamá,578,503,,1081,-81.70216500000001,12.5862
24340,2014,Febrero,Panamá,3,10,,13,-81.372937,13.338761300000002
24341,2014,Febrero,Panamá,196,492,,688,-76.532004,3.451668
24342,2014,Febrero,Panamá,0,8,,8,-77.061029,3.8844260000000004
24343,2014,Febrero,Panamá,2140,4156,,6296,-74.140516,4.697157
24344,2014,Febrero,Panamá,59,109,,168,-75.736374,4.815189
24345,2014,Febrero,Panamá,434,1149,,1583,-75.42726,6.170465
24346,2014,Febrero,Panamá,0,3,,3,-77.401154,6.222551999999999
24347,2014,Febrero,Panamá,3,12,,15,-77.762647,7.102626
24348,2014,Febrero,Panamá,26,66,,92,-73.181317,7.1280470000000005
24349,2014,Febrero,Panamá,60,78,,138,-72.508188,7.927233
24350,2014,Febrero,Panamá,1,1,,2,-76.7333,8.06667
24351,2014,Febrero,Panamá,101,144,,245,-77.35002,8.63337
24352,2014,Febrero,Paraguay,6,5,,11,-75.516486,10.446304
24353,2014,Febrero,Paraguay,3,2,,5,-74.77647900000001,10.886686
24354,2014,Febrero,Paraguay,8,8,,16,-81.70216500000001,12.5862
24355,2014,Febrero,Paraguay,8,29,,37,-76.532004,3.451668
24356,2014,Febrero,Paraguay,21,32,,53,-74.140516,4.697157
24357,2014,Febrero,Paraguay,5,5,,10,-75.42726,6.170465
24358,2014,Febrero,Paraguay,3,1,,4,-73.181317,7.1280470000000005
24359,2014,Febrero,Perú,124,182,,306,-69.941498,4.191162
24360,2014,Febrero,Perú,5,13,,18,-77.35600000000001,0.81488
24361,2014,Febrero,Perú,1,6,,7,-75.527794,10.406342
24362,2014,Febrero,Perú,83,50,,133,-75.516486,10.446304
24363,2014,Febrero,Perú,23,34,,57,-74.77647900000001,10.886686
24364,2014,Febrero,Perú,60,45,,105,-81.70216500000001,12.5862
24365,2014,Febrero,Perú,186,298,,484,-76.532004,3.451668
24366,2014,Febrero,Perú,5276,6750,,12026,-74.140516,4.697157
24367,2014,Febrero,Perú,0,6,,6,-75.736374,4.815189
24368,2014,Febrero,Perú,557,743,,1300,-75.42726,6.170465
24369,2014,Febrero,Perú,0,3,,3,-73.181317,7.1280470000000005
24370,2014,Febrero,Perú,1,2,,3,-72.508188,7.927233
24371,2014,Febrero,Polonia,5,1,,6,-75.516486,10.446304
24372,2014,Febrero,Polonia,1,0,,1,-76.532004,3.451668
24373,2014,Febrero,Polonia,18,16,,34,-74.140516,4.697157
24374,2014,Febrero,Polonia,2,1,,3,-75.42726,6.170465
24375,2014,Febrero,Portugal,0,3,,3,-76.532004,3.451668
24376,2014,Febrero,Portugal,14,31,,45,-74.140516,4.697157
24377,2014,Febrero,Portugal,0,3,,3,-75.42726,6.170465
24378,2014,Febrero,Puerto Rico/Territorio de Estados Unidos,0,1,,1,-75.527794,10.406342
24379,2014,Febrero,Puerto Rico/Territorio de Estados Unidos,2,14,,16,-75.516486,10.446304
24380,2014,Febrero,Puerto Rico/Territorio de Estados Unidos,3,20,,23,-74.77647900000001,10.886686
24381,2014,Febrero,Puerto Rico/Territorio de Estados Unidos,14,35,,49,-76.532004,3.451668
24382,2014,Febrero,Puerto Rico/Territorio de Estados Unidos,128,217,,345,-74.140516,4.697157
24383,2014,Febrero,Puerto Rico/Territorio de Estados Unidos,1,1,,2,-75.736374,4.815189
24384,2014,Febrero,Puerto Rico/Territorio de Estados Unidos,14,44,,58,-75.42726,6.170465
24385,2014,Febrero,Puerto Rico/Territorio de Estados Unidos,1,1,,2,-73.181317,7.1280470000000005
24386,2014,Febrero,Reino Unido de Gran Bretaña e Irlanda del Norte,3,9,,12,-75.516486,10.446304
24387,2014,Febrero,Reino Unido de Gran Bretaña e Irlanda del Norte,1,2,,3,-74.77647900000001,10.886686
24388,2014,Febrero,Reino Unido de Gran Bretaña e Irlanda del Norte,9,16,,25,-76.532004,3.451668
24389,2014,Febrero,Reino Unido de Gran Bretaña e Irlanda del Norte,118,172,,290,-74.140516,4.697157
24390,2014,Febrero,Reino Unido de Gran Bretaña e Irlanda del Norte,0,1,,1,-75.736374,4.815189
24391,2014,Febrero,Reino Unido de Gran Bretaña e Irlanda del Norte,6,13,,19,-75.42726,6.170465
24392,2014,Febrero,Federación de Rusia,2,0,,2,-75.516486,10.446304
24393,2014,Febrero,Federación de Rusia,24,28,,52,-74.140516,4.697157
24394,2014,Febrero,República Dominicana,5,8,,13,-75.516486,10.446304
24395,2014,Febrero,República Dominicana,21,56,,77,-74.77647900000001,10.886686
24396,2014,Febrero,República Dominicana,7,19,,26,-76.532004,3.451668
24397,2014,Febrero,República Dominicana,274,533,,807,-74.140516,4.697157
24398,2014,Febrero,República Dominicana,2,1,,3,-75.736374,4.815189
24399,2014,Febrero,República Dominicana,12,47,,59,-75.42726,6.170465
24400,2014,Febrero,República Dominicana,1,2,,3,-73.181317,7.1280470000000005
24401,2014,Febrero,República Dominicana,1,0,,1,-72.508188,7.927233
24402,2014,Febrero,República Democrática Popular de Corea,1,1,,2,-74.140516,4.697157
24403,2014,Febrero,Rumania,2,3,,5,-74.140516,4.697157
24404,2014,Febrero,San Cristóbal y Nevis,0,1,,1,-74.140516,4.697157
24405,2014,Febrero,San  Vicente y las Granadinas,0,4,,4,-75.516486,10.446304
24406,2014,Febrero,Santa Lucia,0,1,,1,-74.140516,4.697157
24407,2014,Febrero,Serbia,1,0,,1,-74.140516,4.697157
24408,2014,Febrero,Singapur,0,1,,1,-75.516486,10.446304
24409,2014,Febrero,Singapur,0,1,,1,-74.77647900000001,10.886686
24410,2014,Febrero,Singapur,0,4,,4,-74.140516,4.697157
24411,2014,Febrero,Sudáfrica,1,0,,1,-75.516486,10.446304
24412,2014,Febrero,Sudáfrica,1,0,,1,-76.532004,3.451668
24413,2014,Febrero,Sudáfrica,3,8,,11,-74.140516,4.697157
24414,2014,Febrero,Suecia,4,1,,5,-75.516486,10.446304
24415,2014,Febrero,Suecia,4,3,,7,-76.532004,3.451668
24416,2014,Febrero,Suecia,29,42,,71,-74.140516,4.697157
24417,2014,Febrero,Suecia,0,1,,1,-75.42726,6.170465
24418,2014,Febrero,Suiza,2,3,,5,-75.516486,10.446304
24419,2014,Febrero,Suiza,3,10,,13,-76.532004,3.451668
24420,2014,Febrero,Suiza,53,75,,128,-74.140516,4.697157
24421,2014,Febrero,Suiza,7,18,,25,-75.42726,6.170465
24422,2014,Febrero,Surinam,0,1,,1,-75.527794,10.406342
24423,2014,Febrero,Surinam,1,1,,2,-74.140516,4.697157
24424,2014,Febrero,Surinam,1,1,,2,-75.42726,6.170465
24425,2014,Febrero,Surinam,1,1,,2,-73.181317,7.1280470000000005
24426,2014,Febrero,Taiwán,1,4,,5,-74.140516,4.697157
24427,2014,Febrero,Taiwán,1,2,,3,-75.42726,6.170465
24428,2014,Febrero,Tailandia,2,0,,2,-74.140516,4.697157
24429,2014,Febrero,Trinidad y Tobago,0,3,,3,-75.516486,10.446304
24430,2014,Febrero,Trinidad y Tobago,0,2,,2,-74.77647900000001,10.886686
24431,2014,Febrero,Trinidad y Tobago,1,3,,4,-76.532004,3.451668
24432,2014,Febrero,Trinidad y Tobago,13,15,,28,-74.140516,4.697157
24433,2014,Febrero,Trinidad y Tobago,0,2,,2,-75.736374,4.815189
24434,2014,Febrero,Trinidad y Tobago,0,4,,4,-75.42726,6.170465
24435,2014,Febrero,Trinidad y Tobago,0,5,,5,-73.181317,7.1280470000000005
24436,2014,Febrero,Túnez,0,1,,1,-74.140516,4.697157
24437,2014,Febrero,Turquía,0,1,,1,-75.516486,10.446304
24438,2014,Febrero,Turquía,0,1,,1,-76.532004,3.451668
24439,2014,Febrero,Turquía,5,10,,15,-74.140516,4.697157
24440,2014,Febrero,Turquía,1,1,,2,-75.42726,6.170465
24441,2014,Febrero,Ucrania,0,2,,2,-75.516486,10.446304
24442,2014,Febrero,Ucrania,0,8,,8,-74.140516,4.697157
24443,2014,Febrero,Uganda,0,1,,1,-76.532004,3.451668
24444,2014,Febrero,Uganda,0,1,,1,-74.140516,4.697157
24445,2014,Febrero,Uruguay,0,1,,1,-77.35600000000001,0.81488
24446,2014,Febrero,Uruguay,30,25,,55,-75.516486,10.446304
24447,2014,Febrero,Uruguay,14,15,,29,-81.70216500000001,12.5862
24448,2014,Febrero,Uruguay,4,22,,26,-76.532004,3.451668
24449,2014,Febrero,Uruguay,38,45,,83,-74.140516,4.697157
24450,2014,Febrero,Uruguay,10,22,,32,-75.42726,6.170465
24451,2014,Febrero,Uruguay,1,2,,3,-73.181317,7.1280470000000005
24452,2014,Febrero,Venezuela,0,19,,19,-75.527794,10.406342
24453,2014,Febrero,Venezuela,9,44,,53,-75.516486,10.446304
24454,2014,Febrero,Venezuela,44,76,,120,-74.77647900000001,10.886686
24455,2014,Febrero,Venezuela,1646,2334,,3980,-72.129595,11.360028999999999
24456,2014,Febrero,Venezuela,11,19,,30,-76.532004,3.451668
24457,2014,Febrero,Venezuela,3035,4130,,7165,-74.140516,4.697157
24458,2014,Febrero,Venezuela,3,3,,6,-75.736374,4.815189
24459,2014,Febrero,Venezuela,193,268,,461,-75.42726,6.170465
24460,2014,Febrero,Venezuela,43,90,,133,-67.48402800000001,6.185536
24461,2014,Febrero,Venezuela,55,84,,139,-70.74025300000001,7.088728999999999
24462,2014,Febrero,Venezuela,1,4,,5,-73.181317,7.1280470000000005
24463,2014,Febrero,Venezuela,1558,2162,,3720,-72.453013,7.819
24464,2014,Febrero,Venezuela,89,132,,221,-72.508188,7.927233
24465,2014,Febrero,Vietnam,0,2,,2,-74.140516,4.697157
24466,2014,Febrero,República Árabe de Yemen,0,1,,1,-74.140516,4.697157
24467,2014,Febrero,Desconocido,1,22,,23,-81.703935,12.574411099999999
24468,2014,Febrero,Desconocido,0,1,,1,-81.372937,13.338761300000002
24469,2014,Marzo,Desconocido,0,4,,4,-75.527794,10.406342
24470,2014,Marzo,Desconocido,1,0,,1,-74.213989,11.247722999999999
24471,2014,Marzo,Desconocido,8,20,,28,-81.703935,12.574411099999999
24472,2014,Marzo,Desconocido,3,1,,4,-81.372937,13.338761300000002
24473,2014,Marzo,Desconocido,1,12,,13,-74.140516,4.697157
24474,2014,Marzo,Desconocido,0,8,,8,-75.42726,6.170465
24475,2014,Marzo,Desconocido,0,18,,18,-75.68164200000001,9.402597
24476,2014,Marzo,Afganistán,1,0,,1,-75.527794,10.406342
24477,2014,Marzo,Alemania,2,2,,4,-75.516486,10.446304
24478,2014,Marzo,Alemania,0,5,,5,-74.77647900000001,10.886686
24479,2014,Marzo,Alemania,0,1,,1,-81.70216500000001,12.5862
24480,2014,Marzo,Alemania,3,7,,10,-76.532004,3.451668
24481,2014,Marzo,Alemania,1214,2424,,3638,-74.140516,4.697157
24482,2014,Marzo,Alemania,10,11,,21,-75.42726,6.170465
24483,2014,Marzo,Andorra,0,1,,1,-74.140516,4.697157
24484,2014,Marzo,Angola,0,1,,1,-76.532004,3.451668
24485,2014,Marzo,Angola,0,1,,1,-74.140516,4.697157
24486,2014,Marzo,Países Bajos,0,4,,4,-75.527794,10.406342
24487,2014,Marzo,Países Bajos,5,4,,9,-75.516486,10.446304
24488,2014,Marzo,Países Bajos,0,8,,8,-74.77647900000001,10.886686
24489,2014,Marzo,Países Bajos,8,24,,32,-76.532004,3.451668
24490,2014,Marzo,Países Bajos,39,76,,115,-74.140516,4.697157
24491,2014,Marzo,Países Bajos,1,1,,2,-75.736374,4.815189
24492,2014,Marzo,Países Bajos,55,60,,115,-75.42726,6.170465
24493,2014,Marzo,Países Bajos,9,5,,14,-73.181317,7.1280470000000005
24494,2014,Marzo,Arabia Saudita,1,5,,6,-74.140516,4.697157
24495,2014,Marzo,Argelia,1,0,,1,-76.532004,3.451668
24496,2014,Marzo,Argelia,0,1,,1,-74.140516,4.697157
24497,2014,Marzo,Argentina,1,1,,2,-75.527794,10.406342
24498,2014,Marzo,Argentina,244,195,,439,-75.516486,10.446304
24499,2014,Marzo,Argentina,9,12,,21,-74.77647900000001,10.886686
24500,2014,Marzo,Argentina,172,132,,304,-81.70216500000001,12.5862
24501,2014,Marzo,Argentina,19,59,,78,-76.532004,3.451668
24502,2014,Marzo,Argentina,2592,3293,,5885,-74.140516,4.697157
24503,2014,Marzo,Argentina,1,0,,1,-75.736374,4.815189
24504,2014,Marzo,Argentina,77,116,,193,-75.42726,6.170465
24505,2014,Marzo,Argentina,0,1,,1,-72.508188,7.927233
24506,2014,Marzo,Aruba,93,95,,188,-75.527794,10.406342
24507,2014,Marzo,Aruba,0,3,,3,-74.77647900000001,10.886686
24508,2014,Marzo,Aruba,2,10,,12,-74.213989,11.247722999999999
24509,2014,Marzo,Aruba,0,2,,2,-72.919186,11.52863
24510,2014,Marzo,Aruba,2,2,,4,-76.532004,3.451668
24511,2014,Marzo,Aruba,521,656,,1177,-74.140516,4.697157
24512,2014,Marzo,Aruba,0,1,,1,-75.736374,4.815189
24513,2014,Marzo,Aruba,9,8,,17,-75.42726,6.170465
24514,2014,Marzo,Aruba,2,9,,11,-73.181317,7.1280470000000005
24515,2014,Marzo,Australia,1,4,,5,-75.516486,10.446304
24516,2014,Marzo,Australia,0,3,,3,-74.77647900000001,10.886686
24517,2014,Marzo,Australia,3,5,,8,-76.532004,3.451668
24518,2014,Marzo,Australia,16,33,,49,-74.140516,4.697157
24519,2014,Marzo,Australia,11,18,,29,-75.42726,6.170465
24520,2014,Marzo,Austria,0,2,,2,-75.516486,10.446304
24521,2014,Marzo,Austria,5,34,,39,-74.140516,4.697157
24522,2014,Marzo,Austria,1,2,,3,-75.42726,6.170465
24523,2014,Marzo,Azerbaiyán,1,3,,4,-74.140516,4.697157
24524,2014,Marzo,Bahamas,6,10,,16,-75.516486,10.446304
24525,2014,Marzo,Bahamas,1,0,,1,-74.77647900000001,10.886686
24526,2014,Marzo,Bahamas,0,5,,5,-74.140516,4.697157
24527,2014,Marzo,Bahamas,0,1,,1,-75.42726,6.170465
24528,2014,Marzo,Barbados,1,1,,2,-75.516486,10.446304
24529,2014,Marzo,Barbados,1,3,,4,-74.140516,4.697157
24530,2014,Marzo,Barbados,0,1,,1,-75.42726,6.170465
24531,2014,Marzo,República de Belarús,1,0,,1,-74.140516,4.697157
24532,2014,Marzo,Bélgica,1,1,,2,-75.516486,10.446304
24533,2014,Marzo,Bélgica,2,3,,5,-74.77647900000001,10.886686
24534,2014,Marzo,Bélgica,0,3,,3,-74.213989,11.247722999999999
24535,2014,Marzo,Bélgica,0,7,,7,-76.532004,3.451668
24536,2014,Marzo,Bélgica,22,28,,50,-74.140516,4.697157
24537,2014,Marzo,Bélgica,2,4,,6,-75.42726,6.170465
24538,2014,Marzo,Belice,2,2,,4,-76.532004,3.451668
24539,2014,Marzo,Belice,0,1,,1,-74.140516,4.697157
24540,2014,Marzo,Bermudas/Territorio Británico de Ultramar,1,0,,1,-75.516486,10.446304
24541,2014,Marzo,Bermudas/Territorio Británico de Ultramar,0,1,,1,-75.42726,6.170465
24542,2014,Marzo,Bolivia,2,5,,7,-75.516486,10.446304
24543,2014,Marzo,Bolivia,2,2,,4,-74.77647900000001,10.886686
24544,2014,Marzo,Bolivia,3,6,,9,-81.70216500000001,12.5862
24545,2014,Marzo,Bolivia,5,8,,13,-76.532004,3.451668
24546,2014,Marzo,Bolivia,250,407,,657,-74.140516,4.697157
24547,2014,Marzo,Bolivia,1,2,,3,-75.736374,4.815189
24548,2014,Marzo,Bolivia,19,16,,35,-75.42726,6.170465
24549,2014,Marzo,Bosnia y Herzegovina,1,0,,1,-75.42726,6.170465
24550,2014,Marzo,Brasil,141,184,,325,-69.941498,4.191162
24551,2014,Marzo,Brasil,98,73,,171,-75.516486,10.446304
24552,2014,Marzo,Brasil,9,13,,22,-74.77647900000001,10.886686
24553,2014,Marzo,Brasil,0,3,,3,-74.213989,11.247722999999999
24554,2014,Marzo,Brasil,39,24,,63,-81.70216500000001,12.5862
24555,2014,Marzo,Brasil,13,82,,95,-76.532004,3.451668
24556,2014,Marzo,Brasil,2983,5117,,8100,-74.140516,4.697157
24557,2014,Marzo,Brasil,2,5,,7,-75.736374,4.815189
24558,2014,Marzo,Brasil,71,174,,245,-75.42726,6.170465
24559,2014,Marzo,Brasil,0,3,,3,-73.181317,7.1280470000000005
24560,2014,Marzo,Brunei Darussalam,0,2,,2,-74.140516,4.697157
24561,2014,Marzo,Bulgaria,0,1,,1,-76.532004,3.451668
24562,2014,Marzo,Bulgaria,2,3,,5,-74.140516,4.697157
24563,2014,Marzo,Cabo Verde,0,1,,1,-74.140516,4.697157
24564,2014,Marzo,Islas Caimán/Territorio Británico de Ultramar,4,8,,12,-75.516486,10.446304
24565,2014,Marzo,Islas Caimán/Territorio Británico de Ultramar,0,1,,1,-81.372937,13.338761300000002
24566,2014,Marzo,Islas Caimán/Territorio Británico de Ultramar,1,9,,10,-74.140516,4.697157
24567,2014,Marzo,Camboya,0,1,,1,-72.129595,11.360028999999999
24568,2014,Marzo,Camerún,1,0,,1,-74.140516,4.697157
24569,2014,Marzo,Canadá,493,483,,976,-75.516486,10.446304
24570,2014,Marzo,Canadá,1,7,,8,-74.77647900000001,10.886686
24571,2014,Marzo,Canadá,424,373,,797,-81.70216500000001,12.5862
24572,2014,Marzo,Canadá,13,24,,37,-76.532004,3.451668
24573,2014,Marzo,Canadá,0,7,,7,-77.061029,3.8844260000000004
24574,2014,Marzo,Canadá,463,807,,1270,-74.140516,4.697157
24575,2014,Marzo,Canadá,0,4,,4,-75.736374,4.815189
24576,2014,Marzo,Canadá,32,55,,87,-75.42726,6.170465
24577,2014,Marzo,Canadá,1,0,,1,-73.181317,7.1280470000000005
24578,2014,Marzo,Canadá,0,2,,2,-72.508188,7.927233
24579,2014,Marzo,España,2,5,,7,-75.516486,10.446304
24580,2014,Marzo,España,1,2,,3,-74.77647900000001,10.886686
24581,2014,Marzo,España,1,0,,1,-81.70216500000001,12.5862
24582,2014,Marzo,España,141,275,,416,-76.532004,3.451668
24583,2014,Marzo,España,2236,5453,,7689,-74.140516,4.697157
24584,2014,Marzo,España,2,0,,2,-75.736374,4.815189
24585,2014,Marzo,España,95,226,,321,-75.42726,6.170465
24586,2014,Marzo,España,0,1,,1,-73.181317,7.1280470000000005
24587,2014,Marzo,República de Corea,1,1,,2,-76.532004,3.451668
24588,2014,Marzo,República de Corea,0,1,,1,-77.061029,3.8844260000000004
24589,2014,Marzo,República de Corea,7,17,,24,-74.140516,4.697157
24590,2014,Marzo,República de Corea,0,1,,1,-75.736374,4.815189
24591,2014,Marzo,República de Corea,0,3,,3,-75.42726,6.170465
24592,2014,Marzo,Costa de Marfil,4,4,,8,-74.140516,4.697157
24593,2014,Marzo,Costa Rica,68,62,,130,-75.527794,10.406342
24594,2014,Marzo,Costa Rica,9,21,,30,-75.516486,10.446304
24595,2014,Marzo,Costa Rica,7,20,,27,-74.77647900000001,10.886686
24596,2014,Marzo,Costa Rica,0,1,,1,-74.213989,11.247722999999999
24597,2014,Marzo,Costa Rica,6,4,,10,-81.70216500000001,12.5862
24598,2014,Marzo,Costa Rica,12,35,,47,-76.532004,3.451668
24599,2014,Marzo,Costa Rica,595,1155,,1750,-74.140516,4.697157
24600,2014,Marzo,Costa Rica,1,3,,4,-75.736374,4.815189
24601,2014,Marzo,Costa Rica,40,82,,122,-75.42726,6.170465
24602,2014,Marzo,Costa Rica,0,1,,1,-73.181317,7.1280470000000005
24603,2014,Marzo,Croacia,0,1,,1,-74.77647900000001,10.886686
24604,2014,Marzo,Croacia,0,6,,6,-74.140516,4.697157
24605,2014,Marzo,Cuba,2,5,,7,-75.516486,10.446304
24606,2014,Marzo,Cuba,1,3,,4,-74.77647900000001,10.886686
24607,2014,Marzo,Cuba,9,20,,29,-76.532004,3.451668
24608,2014,Marzo,Cuba,146,258,,404,-74.140516,4.697157
24609,2014,Marzo,Cuba,0,1,,1,-75.736374,4.815189
24610,2014,Marzo,Cuba,10,11,,21,-75.42726,6.170465
24611,2014,Marzo,Cuba,0,1,,1,-72.508188,7.927233
24612,2014,Marzo,Curazao,0,1,,1,-74.77647900000001,10.886686
24613,2014,Marzo,Curazao,0,1,,1,-74.213989,11.247722999999999
24614,2014,Marzo,Curazao,161,225,,386,-74.140516,4.697157
24615,2014,Marzo,Curazao,151,200,,351,-75.42726,6.170465
24616,2014,Marzo,República Checa,0,1,,1,-74.77647900000001,10.886686
24617,2014,Marzo,República Checa,4,8,,12,-74.140516,4.697157
24618,2014,Marzo,Chile,37,34,,71,-75.516486,10.446304
24619,2014,Marzo,Chile,8,15,,23,-74.77647900000001,10.886686
24620,2014,Marzo,Chile,73,44,,117,-81.70216500000001,12.5862
24621,2014,Marzo,Chile,51,187,,238,-76.532004,3.451668
24622,2014,Marzo,Chile,3321,4425,,7746,-74.140516,4.697157
24623,2014,Marzo,Chile,69,118,,187,-75.42726,6.170465
24624,2014,Marzo,China,1,0,,1,-74.77647900000001,10.886686
24625,2014,Marzo,China,35,75,,110,-74.140516,4.697157
24626,2014,Marzo,China,2,1,,3,-75.42726,6.170465
24627,2014,Marzo,Chipre,0,1,,1,-76.532004,3.451668
24628,2014,Marzo,Chipre,0,1,,1,-74.140516,4.697157
24629,2014,Marzo,Dinamarca,1,0,,1,-74.77647900000001,10.886686
24630,2014,Marzo,Dinamarca,0,3,,3,-76.532004,3.451668
24631,2014,Marzo,Dinamarca,1,18,,19,-74.140516,4.697157
24632,2014,Marzo,Dominica,1,0,,1,-74.140516,4.697157
24633,2014,Marzo,Dominica,0,1,,1,-75.42726,6.170465
24634,2014,Marzo,Ecuador,35,77,,112,-76.876446,0.33002
24635,2014,Marzo,Ecuador,2346,3818,,6164,-77.35600000000001,0.81488
24636,2014,Marzo,Ecuador,5,30,,35,-78.802679,18.00143
24637,2014,Marzo,Ecuador,0,1,,1,-75.527794,10.406342
24638,2014,Marzo,Ecuador,5,10,,15,-75.516486,10.446304
24639,2014,Marzo,Ecuador,7,8,,15,-74.77647900000001,10.886686
24640,2014,Marzo,Ecuador,256,190,,446,-81.70216500000001,12.5862
24641,2014,Marzo,Ecuador,524,617,,1141,-76.532004,3.451668
24642,2014,Marzo,Ecuador,2247,4025,,6272,-74.140516,4.697157
24643,2014,Marzo,Ecuador,411,582,,993,-75.42726,6.170465
24644,2014,Marzo,Ecuador,1,2,,3,-73.181317,7.1280470000000005
24645,2014,Marzo,El Salvador,1,3,,4,-75.516486,10.446304
24646,2014,Marzo,El Salvador,1,3,,4,-74.77647900000001,10.886686
24647,2014,Marzo,El Salvador,2,2,,4,-81.70216500000001,12.5862
24648,2014,Marzo,El Salvador,98,178,,276,-76.532004,3.451668
24649,2014,Marzo,El Salvador,645,1159,,1804,-74.140516,4.697157
24650,2014,Marzo,El Salvador,1,0,,1,-75.736374,4.815189
24651,2014,Marzo,El Salvador,96,197,,293,-75.42726,6.170465
24652,2014,Marzo,Emiratos Árabes,1,5,,6,-74.140516,4.697157
24653,2014,Marzo,Eslovaquia,2,4,,6,-74.140516,4.697157
24654,2014,Marzo,Eslovenia,0,1,,1,-75.516486,10.446304
24655,2014,Marzo,Eslovenia,0,1,,1,-74.77647900000001,10.886686
24656,2014,Marzo,Eslovenia,1,3,,4,-74.140516,4.697157
24657,2014,Marzo,Estados Unidos de América,5,19,,24,-75.527794,10.406342
24658,2014,Marzo,Estados Unidos de América,1455,2305,,3760,-75.516486,10.446304
24659,2014,Marzo,Estados Unidos de América,321,511,,832,-74.77647900000001,10.886686
24660,2014,Marzo,Estados Unidos de América,4,7,,11,-74.232675,11.117206
24661,2014,Marzo,Estados Unidos de América,0,10,,10,-74.213989,11.247722999999999
24662,2014,Marzo,Estados Unidos de América,12,7,,19,-81.70216500000001,12.5862
24663,2014,Marzo,Estados Unidos de América,830,1228,,2058,-76.532004,3.451668
24664,2014,Marzo,Estados Unidos de América,0,3,,3,-77.061029,3.8844260000000004
24665,2014,Marzo,Estados Unidos de América,117,127,,244,-75.76635300000001,4.45285
24666,2014,Marzo,Estados Unidos de América,7662,14779,,22441,-74.140516,4.697157
24667,2014,Marzo,Estados Unidos de América,31,47,,78,-75.736374,4.815189
24668,2014,Marzo,Estados Unidos de América,1723,3656,,5379,-75.42726,6.170465
24669,2014,Marzo,Estados Unidos de América,5,13,,18,-73.181317,7.1280470000000005
24670,2014,Marzo,Estados Unidos de América,6,10,,16,-72.508188,7.927233
24671,2014,Marzo,Estados Unidos de América,0,1,,1,-76.7333,8.06667
24672,2014,Marzo,Estonia,1,3,,4,-74.140516,4.697157
24673,2014,Marzo,Filipinas,0,4,,4,-74.77647900000001,10.886686
24674,2014,Marzo,Filipinas,0,1,,1,-76.532004,3.451668
24675,2014,Marzo,Filipinas,1,7,,8,-74.140516,4.697157
24676,2014,Marzo,Finlandia,2,1,,3,-76.532004,3.451668
24677,2014,Marzo,Finlandia,5,5,,10,-74.140516,4.697157
24678,2014,Marzo,Francia,1,1,,2,-75.516486,10.446304
24679,2014,Marzo,Francia,1,0,,1,-74.77647900000001,10.886686
24680,2014,Marzo,Francia,10,14,,24,-76.532004,3.451668
24681,2014,Marzo,Francia,1076,2211,,3287,-74.140516,4.697157
24682,2014,Marzo,Francia,1,1,,2,-75.736374,4.815189
24683,2014,Marzo,Francia,3,8,,11,-75.42726,6.170465
24684,2014,Marzo,Francia,0,1,,1,-73.181317,7.1280470000000005
24685,2014,Marzo,Gambia,0,1,,1,-74.140516,4.697157
24686,2014,Marzo,Granada,1,1,,2,-74.213989,11.247722999999999
24687,2014,Marzo,Grecia,0,1,,1,-78.802679,18.00143
24688,2014,Marzo,Grecia,1,9,,10,-74.140516,4.697157
24689,2014,Marzo,Guatemala,3,9,,12,-75.516486,10.446304
24690,2014,Marzo,Guatemala,2,4,,6,-74.77647900000001,10.886686
24691,2014,Marzo,Guatemala,2,3,,5,-81.70216500000001,12.5862
24692,2014,Marzo,Guatemala,11,22,,33,-76.532004,3.451668
24693,2014,Marzo,Guatemala,143,337,,480,-74.140516,4.697157
24694,2014,Marzo,Guatemala,1,2,,3,-75.736374,4.815189
24695,2014,Marzo,Guatemala,23,47,,70,-75.42726,6.170465
24696,2014,Marzo,Guatemala,0,1,,1,-73.181317,7.1280470000000005
24697,2014,Marzo,Guatemala,0,2,,2,-72.508188,7.927233
24698,2014,Marzo,Guyana,0,1,,1,-75.516486,10.446304
24699,2014,Marzo,Guyana,0,1,,1,-74.77647900000001,10.886686
24700,2014,Marzo,Guyana,0,1,,1,-74.140516,4.697157
24701,2014,Marzo,Guyana,1,0,,1,-75.42726,6.170465
24702,2014,Marzo,Guinea Ecuatorial,1,1,,2,-74.140516,4.697157
24703,2014,Marzo,Guadalupe/Territorio Francés,2,3,,5,-74.140516,4.697157
24704,2014,Marzo,Guayana Francesa/Departamento de Ultramar Francés,0,1,,1,-74.140516,4.697157
24705,2014,Marzo,Haití,7,19,,26,-74.140516,4.697157
24706,2014,Marzo,Haití,0,2,,2,-75.42726,6.170465
24707,2014,Marzo,Honduras,0,1,,1,-75.516486,10.446304
24708,2014,Marzo,Honduras,1,4,,5,-74.77647900000001,10.886686
24709,2014,Marzo,Honduras,1,7,,8,-81.70216500000001,12.5862
24710,2014,Marzo,Honduras,1,1,,2,-81.372937,13.338761300000002
24711,2014,Marzo,Honduras,6,7,,13,-76.532004,3.451668
24712,2014,Marzo,Honduras,22,63,,85,-74.140516,4.697157
24713,2014,Marzo,Honduras,0,1,,1,-75.736374,4.815189
24714,2014,Marzo,Honduras,17,14,,31,-75.42726,6.170465
24715,2014,Marzo,Hong Kong,0,3,,3,-74.140516,4.697157
24716,2014,Marzo,Hong Kong,1,1,,2,-75.42726,6.170465
24717,2014,Marzo,Hungría,5,9,,14,-74.140516,4.697157
24718,2014,Marzo,Hungría,0,1,,1,-75.42726,6.170465
24719,2014,Marzo,India,0,1,,1,-74.77647900000001,10.886686
24720,2014,Marzo,India,0,6,,6,-76.532004,3.451668
24721,2014,Marzo,India,4,30,,34,-74.140516,4.697157
24722,2014,Marzo,India,0,1,,1,-75.42726,6.170465
24723,2014,Marzo,Irán,0,2,,2,-74.140516,4.697157
24724,2014,Marzo,República de Irlanda,1,1,,2,-76.532004,3.451668
24725,2014,Marzo,República de Irlanda,5,11,,16,-74.140516,4.697157
24726,2014,Marzo,República de Irlanda,1,2,,3,-75.42726,6.170465
24727,2014,Marzo,Islandia,1,0,,1,-74.140516,4.697157
24728,2014,Marzo,Israel,0,2,,2,-76.532004,3.451668
24729,2014,Marzo,Israel,6,65,,71,-74.140516,4.697157
24730,2014,Marzo,Israel,0,1,,1,-75.42726,6.170465
24731,2014,Marzo,Italia,48,76,,124,-75.516486,10.446304
24732,2014,Marzo,Italia,1,3,,4,-74.77647900000001,10.886686
24733,2014,Marzo,Italia,2,17,,19,-76.532004,3.451668
24734,2014,Marzo,Italia,42,197,,239,-74.140516,4.697157
24735,2014,Marzo,Italia,1,0,,1,-75.736374,4.815189
24736,2014,Marzo,Italia,3,2,,5,-75.42726,6.170465
24737,2014,Marzo,Jamaica,1,0,,1,-74.77647900000001,10.886686
24738,2014,Marzo,Jamaica,0,2,,2,-81.70216500000001,12.5862
24739,2014,Marzo,Jamaica,1,1,,2,-76.532004,3.451668
24740,2014,Marzo,Jamaica,6,13,,19,-74.140516,4.697157
24741,2014,Marzo,Jamaica,0,2,,2,-75.42726,6.170465
24742,2014,Marzo,Japón,0,2,,2,-74.77647900000001,10.886686
24743,2014,Marzo,Japón,3,2,,5,-76.532004,3.451668
24744,2014,Marzo,Japón,17,26,,43,-74.140516,4.697157
24745,2014,Marzo,Japón,2,3,,5,-75.42726,6.170465
24746,2014,Marzo,Japón,0,1,,1,-73.181317,7.1280470000000005
24747,2014,Marzo,Kenia,1,1,,2,-76.532004,3.451668
24748,2014,Marzo,Kenia,1,1,,2,-75.42726,6.170465
24749,2014,Marzo,Lituania,1,2,,3,-74.140516,4.697157
24750,2014,Marzo,Líbano,2,2,,4,-74.140516,4.697157
24751,2014,Marzo,Luxemburgo,0,2,,2,-74.140516,4.697157
24752,2014,Marzo,Malasia,1,2,,3,-74.140516,4.697157
24753,2014,Marzo,Malasia,0,1,,1,-75.42726,6.170465
24754,2014,Marzo,México,21,56,,77,-75.516486,10.446304
24755,2014,Marzo,México,12,34,,46,-74.77647900000001,10.886686
24756,2014,Marzo,México,7,6,,13,-81.70216500000001,12.5862
24757,2014,Marzo,México,23,72,,95,-76.532004,3.451668
24758,2014,Marzo,México,0,14,,14,-77.061029,3.8844260000000004
24759,2014,Marzo,México,2553,6130,,8683,-74.140516,4.697157
24760,2014,Marzo,México,5,4,,9,-75.736374,4.815189
24761,2014,Marzo,México,60,236,,296,-75.42726,6.170465
24762,2014,Marzo,México,2,1,,3,-73.181317,7.1280470000000005
24763,2014,Marzo,México,3,0,,3,-72.508188,7.927233
24764,2014,Marzo,Nicaragua,4,0,,4,-75.516486,10.446304
24765,2014,Marzo,Nicaragua,2,1,,3,-74.77647900000001,10.886686
24766,2014,Marzo,Nicaragua,6,9,,15,-76.532004,3.451668
24767,2014,Marzo,Nicaragua,17,25,,42,-74.140516,4.697157
24768,2014,Marzo,Nicaragua,4,14,,18,-75.42726,6.170465
24769,2014,Marzo,Nicaragua,0,1,,1,-72.508188,7.927233
24770,2014,Marzo,Noruega,1,1,,2,-76.532004,3.451668
24771,2014,Marzo,Noruega,12,18,,30,-74.140516,4.697157
24772,2014,Marzo,Noruega,0,1,,1,-75.42726,6.170465
24773,2014,Marzo,Nueva Zelanda,1,0,,1,-75.516486,10.446304
24774,2014,Marzo,Nueva Zelanda,0,4,,4,-74.140516,4.697157
24775,2014,Marzo,Nueva Zelanda,1,0,,1,-75.736374,4.815189
24776,2014,Marzo,Nueva Zelanda,1,1,,2,-75.42726,6.170465
24777,2014,Marzo,Palau,0,1,,1,-74.140516,4.697157
24778,2014,Marzo,Panamá,769,656,,1425,-75.527794,10.406342
24779,2014,Marzo,Panamá,2254,2524,,4778,-75.516486,10.446304
24780,2014,Marzo,Panamá,177,412,,589,-74.77647900000001,10.886686
24781,2014,Marzo,Panamá,0,1,,1,-74.232675,11.117206
24782,2014,Marzo,Panamá,0,4,,4,-74.213989,11.247722999999999
24783,2014,Marzo,Panamá,594,455,,1049,-81.70216500000001,12.5862
24784,2014,Marzo,Panamá,4,9,,13,-81.372937,13.338761300000002
24785,2014,Marzo,Panamá,250,571,,821,-76.532004,3.451668
24786,2014,Marzo,Panamá,0,12,,12,-77.061029,3.8844260000000004
24787,2014,Marzo,Panamá,2086,4212,,6298,-74.140516,4.697157
24788,2014,Marzo,Panamá,60,126,,186,-75.736374,4.815189
24789,2014,Marzo,Panamá,463,1156,,1619,-75.42726,6.170465
24790,2014,Marzo,Panamá,1,0,,1,-77.401154,6.222551999999999
24791,2014,Marzo,Panamá,5,12,,17,-77.762647,7.102626
24792,2014,Marzo,Panamá,23,52,,75,-73.181317,7.1280470000000005
24793,2014,Marzo,Panamá,50,83,,133,-72.508188,7.927233
24794,2014,Marzo,Panamá,95,153,,248,-77.35002,8.63337
24795,2014,Marzo,Paraguay,16,10,,26,-75.516486,10.446304
24796,2014,Marzo,Paraguay,2,2,,4,-74.77647900000001,10.886686
24797,2014,Marzo,Paraguay,14,11,,25,-81.70216500000001,12.5862
24798,2014,Marzo,Paraguay,7,7,,14,-76.532004,3.451668
24799,2014,Marzo,Paraguay,16,24,,40,-74.140516,4.697157
24800,2014,Marzo,Paraguay,2,0,,2,-75.736374,4.815189
24801,2014,Marzo,Paraguay,10,11,,21,-75.42726,6.170465
24802,2014,Marzo,Perú,110,187,,297,-69.941498,4.191162
24803,2014,Marzo,Perú,0,1,,1,-77.35600000000001,0.81488
24804,2014,Marzo,Perú,1,0,,1,-75.527794,10.406342
24805,2014,Marzo,Perú,55,51,,106,-75.516486,10.446304
24806,2014,Marzo,Perú,10,25,,35,-74.77647900000001,10.886686
24807,2014,Marzo,Perú,129,81,,210,-81.70216500000001,12.5862
24808,2014,Marzo,Perú,184,312,,496,-76.532004,3.451668
24809,2014,Marzo,Perú,0,1,,1,-77.061029,3.8844260000000004
24810,2014,Marzo,Perú,5388,7277,,12665,-74.140516,4.697157
24811,2014,Marzo,Perú,0,2,,2,-75.736374,4.815189
24812,2014,Marzo,Perú,409,743,,1152,-75.42726,6.170465
24813,2014,Marzo,Perú,0,1,,1,-73.181317,7.1280470000000005
24814,2014,Marzo,Polonia,0,1,,1,-74.77647900000001,10.886686
24815,2014,Marzo,Polonia,12,14,,26,-74.140516,4.697157
24816,2014,Marzo,Portugal,0,9,,9,-76.532004,3.451668
24817,2014,Marzo,Portugal,17,51,,68,-74.140516,4.697157
24818,2014,Marzo,Portugal,0,1,,1,-75.42726,6.170465
24819,2014,Marzo,Puerto Rico/Territorio de Estados Unidos,0,8,,8,-75.527794,10.406342
24820,2014,Marzo,Puerto Rico/Territorio de Estados Unidos,6,29,,35,-75.516486,10.446304
24821,2014,Marzo,Puerto Rico/Territorio de Estados Unidos,0,12,,12,-74.77647900000001,10.886686
24822,2014,Marzo,Puerto Rico/Territorio de Estados Unidos,13,43,,56,-76.532004,3.451668
24823,2014,Marzo,Puerto Rico/Territorio de Estados Unidos,119,188,,307,-74.140516,4.697157
24824,2014,Marzo,Puerto Rico/Territorio de Estados Unidos,0,1,,1,-75.736374,4.815189
24825,2014,Marzo,Puerto Rico/Territorio de Estados Unidos,16,50,,66,-75.42726,6.170465
24826,2014,Marzo,Puerto Rico/Territorio de Estados Unidos,0,1,,1,-72.508188,7.927233
24827,2014,Marzo,Reino Unido de Gran Bretaña e Irlanda del Norte,6,7,,13,-75.516486,10.446304
24828,2014,Marzo,Reino Unido de Gran Bretaña e Irlanda del Norte,1,6,,7,-76.532004,3.451668
24829,2014,Marzo,Reino Unido de Gran Bretaña e Irlanda del Norte,89,168,,257,-74.140516,4.697157
24830,2014,Marzo,Reino Unido de Gran Bretaña e Irlanda del Norte,11,19,,30,-75.42726,6.170465
24831,2014,Marzo,República CentroÁfricana,0,1,,1,-74.140516,4.697157
24832,2014,Marzo,Federación de Rusia,0,1,,1,-74.77647900000001,10.886686
24833,2014,Marzo,Federación de Rusia,15,34,,49,-74.140516,4.697157
24834,2014,Marzo,Federación de Rusia,2,0,,2,-75.42726,6.170465
24835,2014,Marzo,República Dominicana,0,1,,1,-75.527794,10.406342
24836,2014,Marzo,República Dominicana,7,14,,21,-75.516486,10.446304
24837,2014,Marzo,República Dominicana,7,24,,31,-74.77647900000001,10.886686
24838,2014,Marzo,República Dominicana,0,1,,1,-74.213989,11.247722999999999
24839,2014,Marzo,República Dominicana,4,5,,9,-81.70216500000001,12.5862
24840,2014,Marzo,República Dominicana,9,22,,31,-76.532004,3.451668
24841,2014,Marzo,República Dominicana,292,590,,882,-74.140516,4.697157
24842,2014,Marzo,República Dominicana,1,2,,3,-75.736374,4.815189
24843,2014,Marzo,República Dominicana,11,31,,42,-75.42726,6.170465
24844,2014,Marzo,Rumania,3,4,,7,-74.140516,4.697157
24845,2014,Marzo,San  Vicente y las Granadinas,0,1,,1,-75.516486,10.446304
24846,2014,Marzo,Santa Elena/Territorio Británico de Ultramar,1,0,,1,-74.140516,4.697157
24847,2014,Marzo,Senegal,0,1,,1,-74.140516,4.697157
24848,2014,Marzo,Singapur,0,1,,1,-74.77647900000001,10.886686
24849,2014,Marzo,Singapur,3,3,,6,-74.140516,4.697157
24850,2014,Marzo,Singapur,1,0,,1,-75.42726,6.170465
24851,2014,Marzo,Sudáfrica,1,1,,2,-75.516486,10.446304
24852,2014,Marzo,Sudáfrica,3,8,,11,-74.140516,4.697157
24853,2014,Marzo,Sudáfrica,0,1,,1,-75.42726,6.170465
24854,2014,Marzo,Suecia,1,1,,2,-75.516486,10.446304
24855,2014,Marzo,Suecia,1,0,,1,-76.532004,3.451668
24856,2014,Marzo,Suecia,17,35,,52,-74.140516,4.697157
24857,2014,Marzo,Suecia,0,2,,2,-75.42726,6.170465
24858,2014,Marzo,Suiza,4,2,,6,-75.516486,10.446304
24859,2014,Marzo,Suiza,2,6,,8,-76.532004,3.451668
24860,2014,Marzo,Suiza,45,74,,119,-74.140516,4.697157
24861,2014,Marzo,Suiza,2,4,,6,-75.42726,6.170465
24862,2014,Marzo,Surinam,0,1,,1,-75.516486,10.446304
24863,2014,Marzo,Surinam,2,2,,4,-74.140516,4.697157
24864,2014,Marzo,Surinam,5,16,,21,-75.42726,6.170465
24865,2014,Marzo,Suazilandia,0,1,,1,-75.42726,6.170465
24866,2014,Marzo,Taiwán,0,1,,1,-76.532004,3.451668
24867,2014,Marzo,Taiwán,3,8,,11,-74.140516,4.697157
24868,2014,Marzo,Tailandia,3,2,,5,-74.140516,4.697157
24869,2014,Marzo,Trinidad y Tobago,1,1,,2,-75.516486,10.446304
24870,2014,Marzo,Trinidad y Tobago,0,1,,1,-74.77647900000001,10.886686
24871,2014,Marzo,Trinidad y Tobago,0,10,,10,-76.532004,3.451668
24872,2014,Marzo,Trinidad y Tobago,2,11,,13,-74.140516,4.697157
24873,2014,Marzo,Trinidad y Tobago,0,1,,1,-75.42726,6.170465
24874,2014,Marzo,Turquía,4,14,,18,-74.140516,4.697157
24875,2014,Marzo,Ucrania,3,7,,10,-74.140516,4.697157
24876,2014,Marzo,Uganda,0,1,,1,-74.140516,4.697157
24877,2014,Marzo,Uruguay,25,19,,44,-75.516486,10.446304
24878,2014,Marzo,Uruguay,0,1,,1,-74.77647900000001,10.886686
24879,2014,Marzo,Uruguay,41,38,,79,-81.70216500000001,12.5862
24880,2014,Marzo,Uruguay,10,12,,22,-76.532004,3.451668
24881,2014,Marzo,Uruguay,37,72,,109,-74.140516,4.697157
24882,2014,Marzo,Uruguay,1,1,,2,-75.736374,4.815189
24883,2014,Marzo,Uruguay,24,38,,62,-75.42726,6.170465
24884,2014,Marzo,Venezuela,0,2,,2,-75.527794,10.406342
24885,2014,Marzo,Venezuela,31,75,,106,-75.516486,10.446304
24886,2014,Marzo,Venezuela,22,61,,83,-74.77647900000001,10.886686
24887,2014,Marzo,Venezuela,0,1,,1,-74.213989,11.247722999999999
24888,2014,Marzo,Venezuela,1061,1865,,2926,-72.129595,11.360028999999999
24889,2014,Marzo,Venezuela,2,7,,9,-81.70216500000001,12.5862
24890,2014,Marzo,Venezuela,13,27,,40,-76.532004,3.451668
24891,2014,Marzo,Venezuela,2743,3709,,6452,-74.140516,4.697157
24892,2014,Marzo,Venezuela,4,3,,7,-75.736374,4.815189
24893,2014,Marzo,Venezuela,135,214,,349,-75.42726,6.170465
24894,2014,Marzo,Venezuela,69,135,,204,-67.48402800000001,6.185536
24895,2014,Marzo,Venezuela,85,164,,249,-70.74025300000001,7.088728999999999
24896,2014,Marzo,Venezuela,5,7,,12,-73.181317,7.1280470000000005
24897,2014,Marzo,Venezuela,1159,1827,,2986,-72.453013,7.819
24898,2014,Marzo,Venezuela,64,79,,143,-72.508188,7.927233
24899,2014,Marzo,Vietnam,0,1,,1,-74.140516,4.697157
24900,2014,Marzo,Islas Turcas y Caicos/Territorio Británico de Ultramar,0,1,,1,-75.516486,10.446304
24901,2014,Abril,Desconocido,5,56,,61,-74.140516,4.697157
24902,2014,Abril,Afganistán,0,1,,1,-74.140516,4.697157
24903,2014,Abril,Afganistán,1,1,,2,-75.42726,6.170465
24904,2014,Abril,Albania,1,0,,1,-74.140516,4.697157
24905,2014,Abril,Alemania,0,1,,1,-75.527794,10.406342
24906,2014,Abril,Alemania,0,8,,8,-75.516486,10.446304
24907,2014,Abril,Alemania,3,2,,5,-74.77647900000001,10.886686
24908,2014,Abril,Alemania,9,8,,17,-76.532004,3.451668
24909,2014,Abril,Alemania,1367,2077,,3444,-74.140516,4.697157
24910,2014,Abril,Alemania,10,17,,27,-75.42726,6.170465
24911,2014,Abril,Angola,1,0,,1,-76.532004,3.451668
24912,2014,Abril,Angola,0,1,,1,-74.140516,4.697157
24913,2014,Abril,Angola,0,5,,5,-75.42726,6.170465
24914,2014,Abril,Países Bajos,2,1,,3,-75.516486,10.446304
24915,2014,Abril,Países Bajos,1,5,,6,-74.77647900000001,10.886686
24916,2014,Abril,Países Bajos,0,1,,1,-74.213989,11.247722999999999
24917,2014,Abril,Países Bajos,17,18,,35,-76.532004,3.451668
24918,2014,Abril,Países Bajos,33,51,,84,-74.140516,4.697157
24919,2014,Abril,Países Bajos,43,43,,86,-75.42726,6.170465
24920,2014,Abril,Países Bajos,1,1,,2,-73.181317,7.1280470000000005
24921,2014,Abril,Arabia Saudita,0,4,,4,-74.140516,4.697157
24922,2014,Abril,Arabia Saudita,0,1,,1,-75.42726,6.170465
24923,2014,Abril,Argelia,3,1,,4,-74.140516,4.697157
24924,2014,Abril,Argentina,0,2,,2,-77.35600000000001,0.81488
24925,2014,Abril,Argentina,0,5,,5,-75.527794,10.406342
24926,2014,Abril,Argentina,225,135,,360,-75.516486,10.446304
24927,2014,Abril,Argentina,3,5,,8,-74.77647900000001,10.886686
24928,2014,Abril,Argentina,80,77,,157,-81.70216500000001,12.5862
24929,2014,Abril,Argentina,41,67,,108,-76.532004,3.451668
24930,2014,Abril,Argentina,1760,2559,,4319,-74.140516,4.697157
24931,2014,Abril,Argentina,2,3,,5,-75.736374,4.815189
24932,2014,Abril,Argentina,104,119,,223,-75.42726,6.170465
24933,2014,Abril,Argentina,1,0,,1,-73.181317,7.1280470000000005
24934,2014,Abril,Aruba,76,63,,139,-75.527794,10.406342
24935,2014,Abril,Aruba,5,4,,9,-75.516486,10.446304
24936,2014,Abril,Aruba,2,2,,4,-74.77647900000001,10.886686
24937,2014,Abril,Aruba,2,4,,6,-74.213989,11.247722999999999
24938,2014,Abril,Aruba,3,1,,4,-72.919186,11.52863
24939,2014,Abril,Aruba,3,6,,9,-76.532004,3.451668
24940,2014,Abril,Aruba,542,633,,1175,-74.140516,4.697157
24941,2014,Abril,Aruba,7,11,,18,-75.42726,6.170465
24942,2014,Abril,Aruba,2,2,,4,-73.181317,7.1280470000000005
24943,2014,Abril,Australia,0,3,,3,-75.516486,10.446304
24944,2014,Abril,Australia,1,1,,2,-74.77647900000001,10.886686
24945,2014,Abril,Australia,3,2,,5,-76.532004,3.451668
24946,2014,Abril,Australia,14,25,,39,-74.140516,4.697157
24947,2014,Abril,Australia,1,1,,2,-75.736374,4.815189
24948,2014,Abril,Australia,5,6,,11,-75.42726,6.170465
24949,2014,Abril,Austria,2,3,,5,-75.516486,10.446304
24950,2014,Abril,Austria,0,1,,1,-76.532004,3.451668
24951,2014,Abril,Austria,22,27,,49,-74.140516,4.697157
24952,2014,Abril,Austria,2,3,,5,-75.42726,6.170465
24953,2014,Abril,Azerbaiyán,1,0,,1,-75.516486,10.446304
24954,2014,Abril,Bahamas,0,2,,2,-74.77647900000001,10.886686
24955,2014,Abril,Bahamas,0,1,,1,-76.532004,3.451668
24956,2014,Abril,Bahamas,2,15,,17,-75.42726,6.170465
24957,2014,Abril,Bahréin,1,0,,1,-74.140516,4.697157
24958,2014,Abril,Bangladesh,0,1,,1,-74.140516,4.697157
24959,2014,Abril,Bangladesh,0,2,,2,-75.42726,6.170465
24960,2014,Abril,Barbados,2,0,,2,-75.516486,10.446304
24961,2014,Abril,Barbados,0,1,,1,-74.140516,4.697157
24962,2014,Abril,República de Belarús,1,0,,1,-72.129595,11.360028999999999
24963,2014,Abril,República de Belarús,1,0,,1,-74.140516,4.697157
24964,2014,Abril,República de Belarús,0,1,,1,-72.453013,7.819
24965,2014,Abril,Bélgica,0,4,,4,-74.77647900000001,10.886686
24966,2014,Abril,Bélgica,0,1,,1,-74.213989,11.247722999999999
24967,2014,Abril,Bélgica,1,6,,7,-76.532004,3.451668
24968,2014,Abril,Bélgica,16,40,,56,-74.140516,4.697157
24969,2014,Abril,Bélgica,4,4,,8,-75.42726,6.170465
24970,2014,Abril,Belice,1,4,,5,-75.516486,10.446304
24971,2014,Abril,Belice,0,1,,1,-74.140516,4.697157
24972,2014,Abril,Belice,0,1,,1,-75.42726,6.170465
24973,2014,Abril,Bolivia,4,2,,6,-75.516486,10.446304
24974,2014,Abril,Bolivia,1,1,,2,-74.77647900000001,10.886686
24975,2014,Abril,Bolivia,9,4,,13,-81.70216500000001,12.5862
24976,2014,Abril,Bolivia,10,13,,23,-76.532004,3.451668
24977,2014,Abril,Bolivia,207,339,,546,-74.140516,4.697157
24978,2014,Abril,Bolivia,0,1,,1,-75.736374,4.815189
24979,2014,Abril,Bolivia,26,30,,56,-75.42726,6.170465
24980,2014,Abril,Botsuana,0,1,,1,-75.42726,6.170465
24981,2014,Abril,Brasil,106,124,,230,-69.941498,4.191162
24982,2014,Abril,Brasil,113,80,,193,-75.516486,10.446304
24983,2014,Abril,Brasil,3,8,,11,-74.77647900000001,10.886686
24984,2014,Abril,Brasil,64,48,,112,-81.70216500000001,12.5862
24985,2014,Abril,Brasil,20,51,,71,-76.532004,3.451668
24986,2014,Abril,Brasil,3158,4872,,8030,-74.140516,4.697157
24987,2014,Abril,Brasil,4,2,,6,-75.736374,4.815189
24988,2014,Abril,Brasil,98,166,,264,-75.42726,6.170465
24989,2014,Abril,Brunei Darussalam,0,1,,1,-74.140516,4.697157
24990,2014,Abril,Bulgaria,0,1,,1,-75.516486,10.446304
24991,2014,Abril,Bulgaria,0,1,,1,-74.140516,4.697157
24992,2014,Abril,Burkina Faso,2,1,,3,-74.140516,4.697157
24993,2014,Abril,Burundi,0,2,,2,-76.532004,3.451668
24994,2014,Abril,Bután,0,2,,2,-75.42726,6.170465
24995,2014,Abril,Cabo Verde,5,6,,11,-75.516486,10.446304
24996,2014,Abril,Cabo Verde,0,1,,1,-74.140516,4.697157
24997,2014,Abril,Islas Caimán/Territorio Británico de Ultramar,7,28,,35,-81.70216500000001,12.5862
24998,2014,Abril,Camboya,0,1,,1,-74.140516,4.697157
24999,2014,Abril,Camerún,0,2,,2,-74.140516,4.697157
25000,2014,Abril,Camerún,1,2,,3,-75.42726,6.170465
25001,2014,Abril,Canadá,10,15,,25,-75.516486,10.446304
25002,2014,Abril,Canadá,8,8,,16,-74.77647900000001,10.886686
25003,2014,Abril,Canadá,2,1,,3,-81.70216500000001,12.5862
25004,2014,Abril,Canadá,14,24,,38,-76.532004,3.451668
25005,2014,Abril,Canadá,478,718,,1196,-74.140516,4.697157
25006,2014,Abril,Canadá,0,2,,2,-75.736374,4.815189
25007,2014,Abril,Canadá,29,62,,91,-75.42726,6.170465
25008,2014,Abril,Chad,0,1,,1,-74.140516,4.697157
25009,2014,Abril,España,4,5,,9,-75.516486,10.446304
25010,2014,Abril,España,0,4,,4,-74.77647900000001,10.886686
25011,2014,Abril,España,192,362,,554,-76.532004,3.451668
25012,2014,Abril,España,2525,5035,,7560,-74.140516,4.697157
25013,2014,Abril,España,170,362,,532,-75.42726,6.170465
25014,2014,Abril,República de Corea,0,3,,3,-75.516486,10.446304
25015,2014,Abril,República de Corea,0,1,,1,-76.532004,3.451668
25016,2014,Abril,República de Corea,8,18,,26,-74.140516,4.697157
25017,2014,Abril,República de Corea,3,3,,6,-75.42726,6.170465
25018,2014,Abril,Costa de Marfil,2,7,,9,-74.140516,4.697157
25019,2014,Abril,Costa Rica,0,15,,15,-75.527794,10.406342
25020,2014,Abril,Costa Rica,11,12,,23,-75.516486,10.446304
25021,2014,Abril,Costa Rica,7,14,,21,-74.77647900000001,10.886686
25022,2014,Abril,Costa Rica,226,176,,402,-81.70216500000001,12.5862
25023,2014,Abril,Costa Rica,13,29,,42,-76.532004,3.451668
25024,2014,Abril,Costa Rica,590,1034,,1624,-74.140516,4.697157
25025,2014,Abril,Costa Rica,1,5,,6,-75.736374,4.815189
25026,2014,Abril,Costa Rica,34,62,,96,-75.42726,6.170465
25027,2014,Abril,Costa Rica,1,0,,1,-72.508188,7.927233
25028,2014,Abril,Croacia,4,22,,26,-74.140516,4.697157
25029,2014,Abril,Cuba,2,3,,5,-75.516486,10.446304
25030,2014,Abril,Cuba,3,8,,11,-74.77647900000001,10.886686
25031,2014,Abril,Cuba,0,2,,2,-74.765343,10.970933
25032,2014,Abril,Cuba,20,53,,73,-76.532004,3.451668
25033,2014,Abril,Cuba,131,225,,356,-74.140516,4.697157
25034,2014,Abril,Cuba,1,7,,8,-75.736374,4.815189
25035,2014,Abril,Cuba,9,12,,21,-75.42726,6.170465
25036,2014,Abril,Curazao,2,2,,4,-75.527794,10.406342
25037,2014,Abril,Curazao,0,2,,2,-75.516486,10.446304
25038,2014,Abril,Curazao,2,0,,2,-74.77647900000001,10.886686
25039,2014,Abril,Curazao,7,11,,18,-74.213989,11.247722999999999
25040,2014,Abril,Curazao,0,9,,9,-81.70216500000001,12.5862
25041,2014,Abril,Curazao,3,1,,4,-76.532004,3.451668
25042,2014,Abril,Curazao,207,255,,462,-74.140516,4.697157
25043,2014,Abril,Curazao,232,269,,501,-75.42726,6.170465
25044,2014,Abril,República Checa,0,2,,2,-75.516486,10.446304
25045,2014,Abril,República Checa,7,9,,16,-74.140516,4.697157
25046,2014,Abril,República Checa,1,0,,1,-75.42726,6.170465
25047,2014,Abril,Chile,32,23,,55,-75.516486,10.446304
25048,2014,Abril,Chile,2,7,,9,-74.77647900000001,10.886686
25049,2014,Abril,Chile,50,42,,92,-81.70216500000001,12.5862
25050,2014,Abril,Chile,39,72,,111,-76.532004,3.451668
25051,2014,Abril,Chile,2644,3623,,6267,-74.140516,4.697157
25052,2014,Abril,Chile,0,5,,5,-75.736374,4.815189
25053,2014,Abril,Chile,64,114,,178,-75.42726,6.170465
25054,2014,Abril,Chile,0,1,,1,-73.181317,7.1280470000000005
25055,2014,Abril,China,0,1,,1,-75.516486,10.446304
25056,2014,Abril,China,1,1,,2,-76.532004,3.451668
25057,2014,Abril,China,0,1,,1,-77.061029,3.8844260000000004
25058,2014,Abril,China,31,120,,151,-74.140516,4.697157
25059,2014,Abril,China,2,8,,10,-75.42726,6.170465
25060,2014,Abril,Dinamarca,0,1,,1,-75.516486,10.446304
25061,2014,Abril,Dinamarca,0,1,,1,-74.77647900000001,10.886686
25062,2014,Abril,Dinamarca,0,1,,1,-76.532004,3.451668
25063,2014,Abril,Dinamarca,8,10,,18,-74.140516,4.697157
25064,2014,Abril,Dinamarca,2,0,,2,-75.42726,6.170465
25065,2014,Abril,Dominica,0,1,,1,-75.516486,10.446304
25066,2014,Abril,Ecuador,46,78,,124,-76.876446,0.33002
25067,2014,Abril,Ecuador,2391,3762,,6153,-77.35600000000001,0.81488
25068,2014,Abril,Ecuador,3,20,,23,-78.802679,18.00143
25069,2014,Abril,Ecuador,2,10,,12,-75.516486,10.446304
25070,2014,Abril,Ecuador,3,10,,13,-74.77647900000001,10.886686
25071,2014,Abril,Ecuador,14,12,,26,-81.70216500000001,12.5862
25072,2014,Abril,Ecuador,562,588,,1150,-76.532004,3.451668
25073,2014,Abril,Ecuador,2618,3861,,6479,-74.140516,4.697157
25074,2014,Abril,Ecuador,0,3,,3,-75.736374,4.815189
25075,2014,Abril,Ecuador,475,486,,961,-75.42726,6.170465
25076,2014,Abril,Ecuador,49,47,,96,-77.401154,6.222551999999999
25077,2014,Abril,Ecuador,1,0,,1,-73.181317,7.1280470000000005
25078,2014,Abril,Egipto,0,1,,1,-76.532004,3.451668
25079,2014,Abril,Egipto,2,2,,4,-74.140516,4.697157
25080,2014,Abril,El Salvador,1,3,,4,-75.516486,10.446304
25081,2014,Abril,El Salvador,0,6,,6,-74.77647900000001,10.886686
25082,2014,Abril,El Salvador,10,13,,23,-81.70216500000001,12.5862
25083,2014,Abril,El Salvador,70,133,,203,-76.532004,3.451668
25084,2014,Abril,El Salvador,634,1033,,1667,-74.140516,4.697157
25085,2014,Abril,El Salvador,103,175,,278,-75.42726,6.170465
25086,2014,Abril,Emiratos Árabes,0,1,,1,-76.532004,3.451668
25087,2014,Abril,Emiratos Árabes,1,5,,6,-74.140516,4.697157
25088,2014,Abril,Emiratos Árabes,1,0,,1,-75.42726,6.170465
25089,2014,Abril,Eritrea,0,1,,1,-76.532004,3.451668
25090,2014,Abril,Eslovaquia,1,0,,1,-81.70216500000001,12.5862
25091,2014,Abril,Eslovaquia,0,2,,2,-76.532004,3.451668
25092,2014,Abril,Eslovaquia,1,1,,2,-74.140516,4.697157
25093,2014,Abril,Eslovenia,5,4,,9,-74.140516,4.697157
25094,2014,Abril,Estados Unidos de América,6,25,,31,-75.527794,10.406342
25095,2014,Abril,Estados Unidos de América,1083,1760,,2843,-75.516486,10.446304
25096,2014,Abril,Estados Unidos de América,205,383,,588,-74.77647900000001,10.886686
25097,2014,Abril,Estados Unidos de América,0,14,,14,-74.765343,10.970933
25098,2014,Abril,Estados Unidos de América,1,16,,17,-74.213989,11.247722999999999
25099,2014,Abril,Estados Unidos de América,4,11,,15,-81.70216500000001,12.5862
25100,2014,Abril,Estados Unidos de América,601,1019,,1620,-76.532004,3.451668
25101,2014,Abril,Estados Unidos de América,0,4,,4,-77.061029,3.8844260000000004
25102,2014,Abril,Estados Unidos de América,79,105,,184,-75.76635300000001,4.45285
25103,2014,Abril,Estados Unidos de América,5964,11542,,17506,-74.140516,4.697157
25104,2014,Abril,Estados Unidos de América,62,69,,131,-75.736374,4.815189
25105,2014,Abril,Estados Unidos de América,1522,3332,,4854,-75.42726,6.170465
25106,2014,Abril,Estados Unidos de América,7,19,,26,-73.181317,7.1280470000000005
25107,2014,Abril,Estados Unidos de América,3,4,,7,-72.508188,7.927233
25108,2014,Abril,Estonia,1,1,,2,-74.140516,4.697157
25109,2014,Abril,Etiopia,0,1,,1,-76.532004,3.451668
25110,2014,Abril,Etiopia,0,2,,2,-74.140516,4.697157
25111,2014,Abril,Etiopia,1,4,,5,-75.42726,6.170465
25112,2014,Abril,Islas Fiji,1,2,,3,-75.42726,6.170465
25113,2014,Abril,Filipinas,1,5,,6,-74.77647900000001,10.886686
25114,2014,Abril,Filipinas,2,4,,6,-76.532004,3.451668
25115,2014,Abril,Filipinas,3,10,,13,-74.140516,4.697157
25116,2014,Abril,Filipinas,1,2,,3,-75.42726,6.170465
25117,2014,Abril,Finlandia,2,5,,7,-75.516486,10.446304
25118,2014,Abril,Finlandia,1,1,,2,-76.532004,3.451668
25119,2014,Abril,Finlandia,1,4,,5,-74.140516,4.697157
25120,2014,Abril,Francia,2,1,,3,-75.516486,10.446304
25121,2014,Abril,Francia,12,19,,31,-76.532004,3.451668
25122,2014,Abril,Francia,1082,1947,,3029,-74.140516,4.697157
25123,2014,Abril,Francia,17,23,,40,-75.42726,6.170465
25124,2014,Abril,Ghana,0,11,,11,-74.140516,4.697157
25125,2014,Abril,Ghana,5,9,,14,-75.42726,6.170465
25126,2014,Abril,Granada,0,1,,1,-75.516486,10.446304
25127,2014,Abril,Grecia,0,1,,1,-76.532004,3.451668
25128,2014,Abril,Grecia,0,2,,2,-77.061029,3.8844260000000004
25129,2014,Abril,Grecia,3,4,,7,-74.140516,4.697157
25130,2014,Abril,Guatemala,12,22,,34,-75.516486,10.446304
25131,2014,Abril,Guatemala,0,2,,2,-74.77647900000001,10.886686
25132,2014,Abril,Guatemala,16,19,,35,-81.70216500000001,12.5862
25133,2014,Abril,Guatemala,16,51,,67,-76.532004,3.451668
25134,2014,Abril,Guatemala,0,1,,1,-77.061029,3.8844260000000004
25135,2014,Abril,Guatemala,168,309,,477,-74.140516,4.697157
25136,2014,Abril,Guatemala,2,1,,3,-75.736374,4.815189
25137,2014,Abril,Guatemala,16,28,,44,-75.42726,6.170465
25138,2014,Abril,Guyana,2,0,,2,-74.140516,4.697157
25139,2014,Abril,Guyana,1,2,,3,-75.42726,6.170465
25140,2014,Abril,Guadalupe/Territorio Francés,1,2,,3,-74.140516,4.697157
25141,2014,Abril,Haití,2,3,,5,-74.140516,4.697157
25142,2014,Abril,Haití,1,2,,3,-75.42726,6.170465
25143,2014,Abril,Honduras,0,7,,7,-75.527794,10.406342
25144,2014,Abril,Honduras,5,6,,11,-75.516486,10.446304
25145,2014,Abril,Honduras,3,1,,4,-74.77647900000001,10.886686
25146,2014,Abril,Honduras,0,1,,1,-74.765343,10.970933
25147,2014,Abril,Honduras,4,9,,13,-81.372937,13.338761300000002
25148,2014,Abril,Honduras,7,7,,14,-76.532004,3.451668
25149,2014,Abril,Honduras,43,33,,76,-74.140516,4.697157
25150,2014,Abril,Honduras,0,1,,1,-75.736374,4.815189
25151,2014,Abril,Honduras,13,17,,30,-75.42726,6.170465
25152,2014,Abril,Hong Kong,0,1,,1,-75.42726,6.170465
25153,2014,Abril,Hungría,0,1,,1,-74.140516,4.697157
25154,2014,Abril,India,0,3,,3,-75.516486,10.446304
25155,2014,Abril,India,0,1,,1,-74.77647900000001,10.886686
25156,2014,Abril,India,1,0,,1,-76.532004,3.451668
25157,2014,Abril,India,4,20,,24,-74.140516,4.697157
25158,2014,Abril,India,0,1,,1,-75.736374,4.815189
25159,2014,Abril,India,6,4,,10,-75.42726,6.170465
25160,2014,Abril,Indonesia,2,1,,3,-75.516486,10.446304
25161,2014,Abril,Indonesia,0,1,,1,-76.532004,3.451668
25162,2014,Abril,Indonesia,0,4,,4,-74.140516,4.697157
25163,2014,Abril,Indonesia,3,4,,7,-75.42726,6.170465
25164,2014,Abril,República de Irlanda,2,1,,3,-75.516486,10.446304
25165,2014,Abril,República de Irlanda,0,3,,3,-74.213989,11.247722999999999
25166,2014,Abril,República de Irlanda,0,1,,1,-81.70216500000001,12.5862
25167,2014,Abril,República de Irlanda,0,1,,1,-76.532004,3.451668
25168,2014,Abril,República de Irlanda,4,8,,12,-74.140516,4.697157
25169,2014,Abril,República de Irlanda,0,1,,1,-75.736374,4.815189
25170,2014,Abril,República de Irlanda,1,0,,1,-75.42726,6.170465
25171,2014,Abril,Islandia,1,0,,1,-74.140516,4.697157
25172,2014,Abril,Israel,0,2,,2,-75.516486,10.446304
25173,2014,Abril,Israel,0,1,,1,-74.77647900000001,10.886686
25174,2014,Abril,Israel,1,4,,5,-76.532004,3.451668
25175,2014,Abril,Israel,17,59,,76,-74.140516,4.697157
25176,2014,Abril,Israel,1,2,,3,-75.42726,6.170465
25177,2014,Abril,Italia,1,4,,5,-75.516486,10.446304
25178,2014,Abril,Italia,0,2,,2,-74.77647900000001,10.886686
25179,2014,Abril,Italia,0,7,,7,-76.532004,3.451668
25180,2014,Abril,Italia,65,194,,259,-74.140516,4.697157
25181,2014,Abril,Italia,7,14,,21,-75.42726,6.170465
25182,2014,Abril,Jamaica,0,2,,2,-75.527794,10.406342
25183,2014,Abril,Jamaica,1,2,,3,-75.516486,10.446304
25184,2014,Abril,Jamaica,0,3,,3,-76.532004,3.451668
25185,2014,Abril,Jamaica,0,3,,3,-74.140516,4.697157
25186,2014,Abril,Jamaica,1,2,,3,-75.42726,6.170465
25187,2014,Abril,Japón,0,1,,1,-75.516486,10.446304
25188,2014,Abril,Japón,2,5,,7,-76.532004,3.451668
25189,2014,Abril,Japón,11,17,,28,-74.140516,4.697157
25190,2014,Abril,Japón,0,1,,1,-75.736374,4.815189
25191,2014,Abril,Japón,2,9,,11,-75.42726,6.170465
25192,2014,Abril,Kazajistán,1,0,,1,-74.140516,4.697157
25193,2014,Abril,Kenia,3,2,,5,-76.532004,3.451668
25194,2014,Abril,Kenia,4,6,,10,-74.140516,4.697157
25195,2014,Abril,Kenia,8,15,,23,-75.42726,6.170465
25196,2014,Abril,Kiribati,2,0,,2,-75.42726,6.170465
25197,2014,Abril,Lesoto,1,0,,1,-74.140516,4.697157
25198,2014,Abril,Lituania,0,1,,1,-74.140516,4.697157
25199,2014,Abril,Líbano,1,4,,5,-74.140516,4.697157
25200,2014,Abril,Líbano,0,1,,1,-75.42726,6.170465
25201,2014,Abril,Libia,0,2,,2,-76.532004,3.451668
25202,2014,Abril,Liechtenstein,2,0,,2,-74.140516,4.697157
25203,2014,Abril,Luxemburgo,0,1,,1,-75.42726,6.170465
25204,2014,Abril,Madagascar,1,1,,2,-75.42726,6.170465
25205,2014,Abril,Malasia,1,3,,4,-74.140516,4.697157
25206,2014,Abril,Marruecos,0,2,,2,-76.532004,3.451668
25207,2014,Abril,Marruecos,1,1,,2,-75.42726,6.170465
25208,2014,Abril,México,0,1,,1,-75.527794,10.406342
25209,2014,Abril,México,43,51,,94,-75.516486,10.446304
25210,2014,Abril,México,17,33,,50,-74.77647900000001,10.886686
25211,2014,Abril,México,0,1,,1,-74.765343,10.970933
25212,2014,Abril,México,0,1,,1,-74.213989,11.247722999999999
25213,2014,Abril,México,5,3,,8,-81.70216500000001,12.5862
25214,2014,Abril,México,31,85,,116,-76.532004,3.451668
25215,2014,Abril,México,0,2,,2,-77.061029,3.8844260000000004
25216,2014,Abril,México,3227,5629,,8856,-74.140516,4.697157
25217,2014,Abril,México,2,4,,6,-75.736374,4.815189
25218,2014,Abril,México,105,260,,365,-75.42726,6.170465
25219,2014,Abril,México,5,3,,8,-73.181317,7.1280470000000005
25220,2014,Abril,México,1,1,,2,-72.508188,7.927233
25221,2014,Abril,Mozambique,0,1,,1,-74.140516,4.697157
25222,2014,Abril,Mozambique,1,1,,2,-75.42726,6.170465
25223,2014,Abril,Myanmar,0,1,,1,-74.140516,4.697157
25224,2014,Abril,Myanmar,1,5,,6,-75.42726,6.170465
25225,2014,Abril,Nauru,1,0,,1,-75.527794,10.406342
25226,2014,Abril,Namibia,0,2,,2,-74.140516,4.697157
25227,2014,Abril,Nepal,0,3,,3,-74.140516,4.697157
25228,2014,Abril,Nicaragua,1,6,,7,-75.516486,10.446304
25229,2014,Abril,Nicaragua,0,2,,2,-74.77647900000001,10.886686
25230,2014,Abril,Nicaragua,0,1,,1,-81.70216500000001,12.5862
25231,2014,Abril,Nicaragua,1,4,,5,-76.532004,3.451668
25232,2014,Abril,Nicaragua,13,18,,31,-74.140516,4.697157
25233,2014,Abril,Nicaragua,0,1,,1,-75.736374,4.815189
25234,2014,Abril,Nicaragua,6,6,,12,-75.42726,6.170465
25235,2014,Abril,Nigeria,1,1,,2,-76.532004,3.451668
25236,2014,Abril,Nigeria,1,5,,6,-74.140516,4.697157
25237,2014,Abril,Nigeria,0,1,,1,-75.42726,6.170465
25238,2014,Abril,Níger,0,1,,1,-74.140516,4.697157
25239,2014,Abril,Noruega,1,0,,1,-75.516486,10.446304
25240,2014,Abril,Noruega,1,2,,3,-76.532004,3.451668
25241,2014,Abril,Noruega,14,7,,21,-74.140516,4.697157
25242,2014,Abril,Noruega,2,4,,6,-75.42726,6.170465
25243,2014,Abril,Nueva Zelanda,1,0,,1,-74.77647900000001,10.886686
25244,2014,Abril,Nueva Zelanda,0,3,,3,-76.532004,3.451668
25245,2014,Abril,Nueva Zelanda,2,6,,8,-74.140516,4.697157
25246,2014,Abril,Nueva Zelanda,0,1,,1,-75.42726,6.170465
25247,2014,Abril,Panamá,603,685,,1288,-75.527794,10.406342
25248,2014,Abril,Panamá,1853,2169,,4022,-75.516486,10.446304
25249,2014,Abril,Panamá,161,356,,517,-74.77647900000001,10.886686
25250,2014,Abril,Panamá,0,15,,15,-74.765343,10.970933
25251,2014,Abril,Panamá,0,1,,1,-74.213989,11.247722999999999
25252,2014,Abril,Panamá,1121,956,,2077,-81.70216500000001,12.5862
25253,2014,Abril,Panamá,19,28,,47,-81.372937,13.338761300000002
25254,2014,Abril,Panamá,301,582,,883,-76.532004,3.451668
25255,2014,Abril,Panamá,0,48,,48,-77.061029,3.8844260000000004
25256,2014,Abril,Panamá,1977,3607,,5584,-74.140516,4.697157
25257,2014,Abril,Panamá,71,140,,211,-75.736374,4.815189
25258,2014,Abril,Panamá,566,1289,,1855,-75.42726,6.170465
25259,2014,Abril,Panamá,2,1,,3,-77.401154,6.222551999999999
25260,2014,Abril,Panamá,1,4,,5,-77.762647,7.102626
25261,2014,Abril,Panamá,46,61,,107,-73.181317,7.1280470000000005
25262,2014,Abril,Panamá,78,97,,175,-72.508188,7.927233
25263,2014,Abril,Panamá,0,3,,3,-76.7333,8.06667
25264,2014,Abril,Panamá,1,3,,4,-77.35002,8.63337
25265,2014,Abril,Paraguay,7,6,,13,-75.516486,10.446304
25266,2014,Abril,Paraguay,1,0,,1,-74.77647900000001,10.886686
25267,2014,Abril,Paraguay,17,9,,26,-81.70216500000001,12.5862
25268,2014,Abril,Paraguay,4,7,,11,-76.532004,3.451668
25269,2014,Abril,Paraguay,16,13,,29,-74.140516,4.697157
25270,2014,Abril,Paraguay,9,19,,28,-75.42726,6.170465
25271,2014,Abril,Perú,123,143,,266,-69.941498,4.191162
25272,2014,Abril,Perú,0,2,,2,-77.35600000000001,0.81488
25273,2014,Abril,Perú,46,31,,77,-75.516486,10.446304
25274,2014,Abril,Perú,7,11,,18,-74.77647900000001,10.886686
25275,2014,Abril,Perú,176,111,,287,-81.70216500000001,12.5862
25276,2014,Abril,Perú,191,339,,530,-76.532004,3.451668
25277,2014,Abril,Perú,3737,5538,,9275,-74.140516,4.697157
25278,2014,Abril,Perú,3,3,,6,-75.736374,4.815189
25279,2014,Abril,Perú,384,708,,1092,-75.42726,6.170465
25280,2014,Abril,Perú,2,1,,3,-73.181317,7.1280470000000005
25281,2014,Abril,Palestina,1,1,,2,-74.140516,4.697157
25282,2014,Abril,Polonia,3,2,,5,-75.516486,10.446304
25283,2014,Abril,Polonia,10,11,,21,-74.140516,4.697157
25284,2014,Abril,Portugal,0,2,,2,-76.532004,3.451668
25285,2014,Abril,Portugal,14,33,,47,-74.140516,4.697157
25286,2014,Abril,Portugal,0,3,,3,-75.42726,6.170465
25287,2014,Abril,Puerto Rico/Territorio de Estados Unidos,5,36,,41,-75.516486,10.446304
25288,2014,Abril,Puerto Rico/Territorio de Estados Unidos,6,20,,26,-74.77647900000001,10.886686
25289,2014,Abril,Puerto Rico/Territorio de Estados Unidos,1,1,,2,-74.213989,11.247722999999999
25290,2014,Abril,Puerto Rico/Territorio de Estados Unidos,24,63,,87,-76.532004,3.451668
25291,2014,Abril,Puerto Rico/Territorio de Estados Unidos,188,236,,424,-74.140516,4.697157
25292,2014,Abril,Puerto Rico/Territorio de Estados Unidos,0,5,,5,-75.736374,4.815189
25293,2014,Abril,Puerto Rico/Territorio de Estados Unidos,36,57,,93,-75.42726,6.170465
25294,2014,Abril,Puerto Rico/Territorio de Estados Unidos,3,1,,4,-73.181317,7.1280470000000005
25295,2014,Abril,Reino Unido de Gran Bretaña e Irlanda del Norte,4,6,,10,-75.516486,10.446304
25296,2014,Abril,Reino Unido de Gran Bretaña e Irlanda del Norte,2,2,,4,-74.77647900000001,10.886686
25297,2014,Abril,Reino Unido de Gran Bretaña e Irlanda del Norte,4,17,,21,-76.532004,3.451668
25298,2014,Abril,Reino Unido de Gran Bretaña e Irlanda del Norte,109,205,,314,-74.140516,4.697157
25299,2014,Abril,Reino Unido de Gran Bretaña e Irlanda del Norte,18,27,,45,-75.42726,6.170465
25300,2014,Abril,Federación de Rusia,9,18,,27,-74.140516,4.697157
25301,2014,Abril,Federación de Rusia,3,1,,4,-75.42726,6.170465
25302,2014,Abril,República Dominicana,0,1,,1,-75.527794,10.406342
25303,2014,Abril,República Dominicana,7,11,,18,-75.516486,10.446304
25304,2014,Abril,República Dominicana,9,31,,40,-74.77647900000001,10.886686
25305,2014,Abril,República Dominicana,0,2,,2,-74.765343,10.970933
25306,2014,Abril,República Dominicana,0,2,,2,-74.232675,11.117206
25307,2014,Abril,República Dominicana,3,5,,8,-81.70216500000001,12.5862
25308,2014,Abril,República Dominicana,6,14,,20,-76.532004,3.451668
25309,2014,Abril,República Dominicana,352,593,,945,-74.140516,4.697157
25310,2014,Abril,República Dominicana,5,7,,12,-75.736374,4.815189
25311,2014,Abril,República Dominicana,20,45,,65,-75.42726,6.170465
25312,2014,Abril,República Democrática Popular de Corea,0,1,,1,-74.140516,4.697157
25313,2014,Abril,Rumania,2,1,,3,-74.140516,4.697157
25314,2014,Abril,Rumania,0,1,,1,-75.42726,6.170465
25315,2014,Abril,Samoa Occidental,1,1,,2,-75.42726,6.170465
25316,2014,Abril,San  Vicente y las Granadinas,1,1,,2,-74.213989,11.247722999999999
25317,2014,Abril,Senegal,0,1,,1,-75.42726,6.170465
25318,2014,Abril,Serbia,0,2,,2,-74.140516,4.697157
25319,2014,Abril,Singapur,1,2,,3,-74.140516,4.697157
25320,2014,Abril,Sudáfrica,0,1,,1,-76.532004,3.451668
25321,2014,Abril,Sudáfrica,9,7,,16,-74.140516,4.697157
25322,2014,Abril,Sudáfrica,4,8,,12,-75.42726,6.170465
25323,2014,Abril,Sudán,2,2,,4,-74.140516,4.697157
25324,2014,Abril,Sudán,2,2,,4,-75.42726,6.170465
25325,2014,Abril,Suecia,1,3,,4,-75.516486,10.446304
25326,2014,Abril,Suecia,3,0,,3,-76.532004,3.451668
25327,2014,Abril,Suecia,12,33,,45,-74.140516,4.697157
25328,2014,Abril,Suecia,6,10,,16,-75.42726,6.170465
25329,2014,Abril,Suiza,1,2,,3,-75.516486,10.446304
25330,2014,Abril,Suiza,2,6,,8,-76.532004,3.451668
25331,2014,Abril,Suiza,58,65,,123,-74.140516,4.697157
25332,2014,Abril,Suiza,3,6,,9,-75.42726,6.170465
25333,2014,Abril,Surinam,0,1,,1,-75.527794,10.406342
25334,2014,Abril,Surinam,1,4,,5,-74.140516,4.697157
25335,2014,Abril,Surinam,1,2,,3,-75.42726,6.170465
25336,2014,Abril,Taiwán,2,1,,3,-74.140516,4.697157
25337,2014,Abril,Taiwán,0,2,,2,-75.736374,4.815189
25338,2014,Abril,Taiwán,1,0,,1,-73.181317,7.1280470000000005
25339,2014,Abril,Tailandia,1,1,,2,-74.140516,4.697157
25340,2014,Abril,Tailandia,1,0,,1,-75.42726,6.170465
25341,2014,Abril,Tanzania,0,4,,4,-76.532004,3.451668
25342,2014,Abril,Tanzania,0,2,,2,-74.140516,4.697157
25343,2014,Abril,Tanzania,3,2,,5,-75.42726,6.170465
25344,2014,Abril,Togo,0,2,,2,-74.140516,4.697157
25345,2014,Abril,Togo,0,1,,1,-75.42726,6.170465
25346,2014,Abril,Trinidad y Tobago,0,2,,2,-75.527794,10.406342
25347,2014,Abril,Trinidad y Tobago,1,0,,1,-75.516486,10.446304
25348,2014,Abril,Trinidad y Tobago,1,1,,2,-74.77647900000001,10.886686
25349,2014,Abril,Trinidad y Tobago,0,1,,1,-74.232675,11.117206
25350,2014,Abril,Trinidad y Tobago,2,5,,7,-76.532004,3.451668
25351,2014,Abril,Trinidad y Tobago,4,13,,17,-74.140516,4.697157
25352,2014,Abril,Trinidad y Tobago,4,4,,8,-75.42726,6.170465
25353,2014,Abril,Túnez,1,0,,1,-75.42726,6.170465
25354,2014,Abril,Turquía,0,1,,1,-76.532004,3.451668
25355,2014,Abril,Turquía,3,8,,11,-74.140516,4.697157
25356,2014,Abril,Turquía,1,1,,2,-75.42726,6.170465
25357,2014,Abril,Ucrania,2,5,,7,-74.140516,4.697157
25358,2014,Abril,Ucrania,1,2,,3,-75.42726,6.170465
25359,2014,Abril,Uganda,0,2,,2,-74.140516,4.697157
25360,2014,Abril,Uganda,0,1,,1,-75.42726,6.170465
25361,2014,Abril,Uruguay,22,18,,40,-75.516486,10.446304
25362,2014,Abril,Uruguay,2,2,,4,-74.77647900000001,10.886686
25363,2014,Abril,Uruguay,17,14,,31,-81.70216500000001,12.5862
25364,2014,Abril,Uruguay,2,11,,13,-76.532004,3.451668
25365,2014,Abril,Uruguay,31,59,,90,-74.140516,4.697157
25366,2014,Abril,Uruguay,20,51,,71,-75.42726,6.170465
25367,2014,Abril,Venezuela,0,9,,9,-75.527794,10.406342
25368,2014,Abril,Venezuela,14,58,,72,-75.516486,10.446304
25369,2014,Abril,Venezuela,18,73,,91,-74.77647900000001,10.886686
25370,2014,Abril,Venezuela,0,2,,2,-74.765343,10.970933
25371,2014,Abril,Venezuela,0,2,,2,-74.213989,11.247722999999999
25372,2014,Abril,Venezuela,1885,2916,,4801,-72.129595,11.360028999999999
25373,2014,Abril,Venezuela,4,5,,9,-81.70216500000001,12.5862
25374,2014,Abril,Venezuela,9,18,,27,-76.532004,3.451668
25375,2014,Abril,Venezuela,3862,4057,,7919,-74.140516,4.697157
25376,2014,Abril,Venezuela,5,8,,13,-75.736374,4.815189
25377,2014,Abril,Venezuela,260,317,,577,-75.42726,6.170465
25378,2014,Abril,Venezuela,21,34,,55,-67.48402800000001,6.185536
25379,2014,Abril,Venezuela,65,124,,189,-70.74025300000001,7.088728999999999
25380,2014,Abril,Venezuela,4,13,,17,-73.181317,7.1280470000000005
25381,2014,Abril,Venezuela,1845,2486,,4331,-72.453013,7.819
25382,2014,Abril,Venezuela,119,134,,253,-72.508188,7.927233
25383,2014,Abril,República Árabe de Yemen,1,1,,2,-74.140516,4.697157
25384,2014,Abril,Zambia,0,1,,1,-74.140516,4.697157
25385,2014,Abril,Zimbabue,0,1,,1,-75.42726,6.170465
25386,2014,Abril,Desconocido,1,4,,5,-75.527794,10.406342
25387,2014,Abril,Desconocido,8,34,,42,-81.703935,12.574411099999999
25388,2014,Abril,Desconocido,1,1,,2,-81.70216500000001,12.5862
25389,2014,Abril,Desconocido,0,1,,1,-77.061029,3.8844260000000004
25390,2014,Abril,Desconocido,0,6,,6,-74.140516,4.697157
25391,2014,Abril,Desconocido,3,11,,14,-75.42726,6.170465
25392,2014,Mayo,Albania,2,0,,2,-74.140516,4.697157
25393,2014,Mayo,Alemania,1,2,,3,-75.516486,10.446304
25394,2014,Mayo,Alemania,1,1,,2,-74.77647900000001,10.886686
25395,2014,Mayo,Alemania,5,9,,14,-76.532004,3.451668
25396,2014,Mayo,Alemania,957,1816,,2773,-74.140516,4.697157
25397,2014,Mayo,Alemania,2,8,,10,-75.42726,6.170465
25398,2014,Mayo,Alemania,0,1,,1,-73.181317,7.1280470000000005
25399,2014,Mayo,Andorra,1,0,,1,-74.140516,4.697157
25400,2014,Mayo,Angola,0,1,,1,-74.140516,4.697157
25401,2014,Mayo,Países Bajos,1,1,,2,-75.527794,10.406342
25402,2014,Mayo,Países Bajos,2,8,,10,-75.516486,10.446304
25403,2014,Mayo,Países Bajos,0,3,,3,-74.77647900000001,10.886686
25404,2014,Mayo,Países Bajos,1,2,,3,-74.213989,11.247722999999999
25405,2014,Mayo,Países Bajos,7,13,,20,-76.532004,3.451668
25406,2014,Mayo,Países Bajos,29,54,,83,-74.140516,4.697157
25407,2014,Mayo,Países Bajos,38,62,,100,-75.42726,6.170465
25408,2014,Mayo,Países Bajos,6,2,,8,-73.181317,7.1280470000000005
25409,2014,Mayo,Arabia Saudita,3,0,,3,-74.140516,4.697157
25410,2014,Mayo,Argelia,0,4,,4,-74.140516,4.697157
25411,2014,Mayo,Argentina,0,1,,1,-77.35600000000001,0.81488
25412,2014,Mayo,Argentina,139,124,,263,-75.516486,10.446304
25413,2014,Mayo,Argentina,2,2,,4,-74.77647900000001,10.886686
25414,2014,Mayo,Argentina,51,29,,80,-81.70216500000001,12.5862
25415,2014,Mayo,Argentina,26,74,,100,-76.532004,3.451668
25416,2014,Mayo,Argentina,0,7,,7,-77.061029,3.8844260000000004
25417,2014,Mayo,Argentina,1762,2636,,4398,-74.140516,4.697157
25418,2014,Mayo,Argentina,0,1,,1,-75.736374,4.815189
25419,2014,Mayo,Argentina,69,144,,213,-75.42726,6.170465
25420,2014,Mayo,Argentina,0,1,,1,-72.508188,7.927233
25421,2014,Mayo,Aruba,61,52,,113,-75.527794,10.406342
25422,2014,Mayo,Aruba,2,0,,2,-74.77647900000001,10.886686
25423,2014,Mayo,Aruba,0,2,,2,-74.765343,10.970933
25424,2014,Mayo,Aruba,6,14,,20,-74.213989,11.247722999999999
25425,2014,Mayo,Aruba,3,0,,3,-76.532004,3.451668
25426,2014,Mayo,Aruba,556,662,,1218,-74.140516,4.697157
25427,2014,Mayo,Aruba,5,9,,14,-75.42726,6.170465
25428,2014,Mayo,Aruba,1,1,,2,-73.181317,7.1280470000000005
25429,2014,Mayo,Australia,2,3,,5,-75.516486,10.446304
25430,2014,Mayo,Australia,1,4,,5,-74.77647900000001,10.886686
25431,2014,Mayo,Australia,4,3,,7,-76.532004,3.451668
25432,2014,Mayo,Australia,14,29,,43,-74.140516,4.697157
25433,2014,Mayo,Australia,0,2,,2,-75.736374,4.815189
25434,2014,Mayo,Australia,7,12,,19,-75.42726,6.170465
25435,2014,Mayo,Austria,0,1,,1,-74.77647900000001,10.886686
25436,2014,Mayo,Austria,0,1,,1,-76.532004,3.451668
25437,2014,Mayo,Austria,9,20,,29,-74.140516,4.697157
25438,2014,Mayo,Bahamas,0,1,,1,-75.516486,10.446304
25439,2014,Mayo,Bahamas,0,2,,2,-74.77647900000001,10.886686
25440,2014,Mayo,Bahamas,1,0,,1,-76.532004,3.451668
25441,2014,Mayo,Bahamas,1,6,,7,-75.42726,6.170465
25442,2014,Mayo,Bahréin,0,1,,1,-74.140516,4.697157
25443,2014,Mayo,Barbados,1,4,,5,-74.140516,4.697157
25444,2014,Mayo,República de Belarús,3,0,,3,-74.140516,4.697157
25445,2014,Mayo,Bélgica,0,5,,5,-74.77647900000001,10.886686
25446,2014,Mayo,Bélgica,0,1,,1,-74.213989,11.247722999999999
25447,2014,Mayo,Bélgica,2,3,,5,-76.532004,3.451668
25448,2014,Mayo,Bélgica,13,31,,44,-74.140516,4.697157
25449,2014,Mayo,Bélgica,2,2,,4,-75.42726,6.170465
25450,2014,Mayo,Belice,0,2,,2,-75.516486,10.446304
25451,2014,Mayo,Belice,1,4,,5,-74.140516,4.697157
25452,2014,Mayo,Belice,0,1,,1,-75.42726,6.170465
25453,2014,Mayo,Benín,0,1,,1,-74.140516,4.697157
25454,2014,Mayo,Bermudas/Territorio Británico de Ultramar,0,1,,1,-75.42726,6.170465
25455,2014,Mayo,Bolivia,1,1,,2,-75.516486,10.446304
25456,2014,Mayo,Bolivia,2,1,,3,-81.70216500000001,12.5862
25457,2014,Mayo,Bolivia,4,7,,11,-76.532004,3.451668
25458,2014,Mayo,Bolivia,289,408,,697,-74.140516,4.697157
25459,2014,Mayo,Bolivia,17,30,,47,-75.42726,6.170465
25460,2014,Mayo,Botsuana,0,1,,1,-74.140516,4.697157
25461,2014,Mayo,Brasil,105,127,,232,-69.941498,4.191162
25462,2014,Mayo,Brasil,0,8,,8,-75.527794,10.406342
25463,2014,Mayo,Brasil,87,64,,151,-75.516486,10.446304
25464,2014,Mayo,Brasil,4,11,,15,-74.77647900000001,10.886686
25465,2014,Mayo,Brasil,23,17,,40,-81.70216500000001,12.5862
25466,2014,Mayo,Brasil,13,62,,75,-76.532004,3.451668
25467,2014,Mayo,Brasil,2577,4569,,7146,-74.140516,4.697157
25468,2014,Mayo,Brasil,1,1,,2,-75.736374,4.815189
25469,2014,Mayo,Brasil,57,107,,164,-75.42726,6.170465
25470,2014,Mayo,Brasil,0,1,,1,-73.181317,7.1280470000000005
25471,2014,Mayo,Bulgaria,1,0,,1,-74.77647900000001,10.886686
25472,2014,Mayo,Bulgaria,1,4,,5,-74.140516,4.697157
25473,2014,Mayo,Burkina Faso,1,0,,1,-74.140516,4.697157
25474,2014,Mayo,Islas Caimán/Territorio Británico de Ultramar,1,1,,2,-75.527794,10.406342
25475,2014,Mayo,Islas Caimán/Territorio Británico de Ultramar,1,0,,1,-81.372937,13.338761300000002
25476,2014,Mayo,Islas Caimán/Territorio Británico de Ultramar,0,1,,1,-76.532004,3.451668
25477,2014,Mayo,Camerún,0,1,,1,-74.140516,4.697157
25478,2014,Mayo,Canadá,3,6,,9,-75.516486,10.446304
25479,2014,Mayo,Canadá,2,7,,9,-74.77647900000001,10.886686
25480,2014,Mayo,Canadá,13,22,,35,-76.532004,3.451668
25481,2014,Mayo,Canadá,394,737,,1131,-74.140516,4.697157
25482,2014,Mayo,Canadá,0,2,,2,-75.736374,4.815189
25483,2014,Mayo,Canadá,36,87,,123,-75.42726,6.170465
25484,2014,Mayo,Canadá,0,1,,1,-73.181317,7.1280470000000005
25485,2014,Mayo,Canadá,1,0,,1,-72.508188,7.927233
25486,2014,Mayo,España,1,27,,28,-75.527794,10.406342
25487,2014,Mayo,España,2,3,,5,-75.516486,10.446304
25488,2014,Mayo,España,0,2,,2,-74.77647900000001,10.886686
25489,2014,Mayo,España,1,51,,52,-74.765343,10.970933
25490,2014,Mayo,España,162,311,,473,-76.532004,3.451668
25491,2014,Mayo,España,2020,4642,,6662,-74.140516,4.697157
25492,2014,Mayo,España,1,1,,2,-75.736374,4.815189
25493,2014,Mayo,España,120,237,,357,-75.42726,6.170465
25494,2014,Mayo,España,0,1,,1,-75.736374,4.815189
25495,2014,Mayo,España,3,10,,13,-75.42726,6.170465
25496,2014,Mayo,República de Corea,1,1,,2,-76.532004,3.451668
25497,2014,Mayo,República de Corea,5,21,,26,-74.140516,4.697157
25498,2014,Mayo,República de Corea,1,1,,2,-75.42726,6.170465
25499,2014,Mayo,Costa de Marfil,0,12,,12,-74.213989,11.247722999999999
25500,2014,Mayo,Costa de Marfil,2,2,,4,-74.140516,4.697157
25501,2014,Mayo,Costa Rica,3,13,,16,-75.527794,10.406342
25502,2014,Mayo,Costa Rica,6,11,,17,-75.516486,10.446304
25503,2014,Mayo,Costa Rica,8,15,,23,-74.77647900000001,10.886686
25504,2014,Mayo,Costa Rica,2,5,,7,-81.70216500000001,12.5862
25505,2014,Mayo,Costa Rica,7,34,,41,-76.532004,3.451668
25506,2014,Mayo,Costa Rica,559,1005,,1564,-74.140516,4.697157
25507,2014,Mayo,Costa Rica,1,2,,3,-75.736374,4.815189
25508,2014,Mayo,Costa Rica,56,59,,115,-75.42726,6.170465
25509,2014,Mayo,Costa Rica,1,1,,2,-73.181317,7.1280470000000005
25510,2014,Mayo,Costa Rica,1,1,,2,-72.508188,7.927233
25511,2014,Mayo,Croacia,0,2,,2,-74.77647900000001,10.886686
25512,2014,Mayo,Croacia,0,1,,1,-76.532004,3.451668
25513,2014,Mayo,Cuba,1,2,,3,-75.516486,10.446304
25514,2014,Mayo,Cuba,5,11,,16,-74.77647900000001,10.886686
25515,2014,Mayo,Cuba,2,4,,6,-74.213989,11.247722999999999
25516,2014,Mayo,Cuba,11,13,,24,-76.532004,3.451668
25517,2014,Mayo,Cuba,165,278,,443,-74.140516,4.697157
25518,2014,Mayo,Cuba,0,2,,2,-75.736374,4.815189
25519,2014,Mayo,Cuba,9,22,,31,-75.42726,6.170465
25520,2014,Mayo,Cuba,1,1,,2,-72.508188,7.927233
25521,2014,Mayo,Curazao,2,6,,8,-75.527794,10.406342
25522,2014,Mayo,Curazao,3,10,,13,-74.77647900000001,10.886686
25523,2014,Mayo,Curazao,11,12,,23,-74.213989,11.247722999999999
25524,2014,Mayo,Curazao,194,247,,441,-74.140516,4.697157
25525,2014,Mayo,Curazao,166,240,,406,-75.42726,6.170465
25526,2014,Mayo,República Checa,5,3,,8,-74.140516,4.697157
25527,2014,Mayo,Chile,22,97,,119,-75.527794,10.406342
25528,2014,Mayo,Chile,18,20,,38,-75.516486,10.446304
25529,2014,Mayo,Chile,1,7,,8,-74.77647900000001,10.886686
25530,2014,Mayo,Chile,14,10,,24,-81.70216500000001,12.5862
25531,2014,Mayo,Chile,28,59,,87,-76.532004,3.451668
25532,2014,Mayo,Chile,3343,4421,,7764,-74.140516,4.697157
25533,2014,Mayo,Chile,1,0,,1,-75.736374,4.815189
25534,2014,Mayo,Chile,67,136,,203,-75.42726,6.170465
25535,2014,Mayo,Chile,0,1,,1,-73.181317,7.1280470000000005
25536,2014,Mayo,China,0,1,,1,-74.77647900000001,10.886686
25537,2014,Mayo,China,0,1,,1,-74.213989,11.247722999999999
25538,2014,Mayo,China,0,5,,5,-77.061029,3.8844260000000004
25539,2014,Mayo,China,31,94,,125,-74.140516,4.697157
25540,2014,Mayo,China,1,1,,2,-75.42726,6.170465
25541,2014,Mayo,Dinamarca,1,0,,1,-75.516486,10.446304
25542,2014,Mayo,Dinamarca,3,6,,9,-74.140516,4.697157
25543,2014,Mayo,Dinamarca,2,2,,4,-75.42726,6.170465
25544,2014,Mayo,Ecuador,29,70,,99,-76.876446,0.33002
25545,2014,Mayo,Ecuador,1892,3293,,5185,-77.35600000000001,0.81488
25546,2014,Mayo,Ecuador,9,225,,234,-78.802679,18.00143
25547,2014,Mayo,Ecuador,17,237,,254,-75.527794,10.406342
25548,2014,Mayo,Ecuador,3,3,,6,-75.516486,10.446304
25549,2014,Mayo,Ecuador,1,9,,10,-74.77647900000001,10.886686
25550,2014,Mayo,Ecuador,4,3,,7,-81.70216500000001,12.5862
25551,2014,Mayo,Ecuador,408,535,,943,-76.532004,3.451668
25552,2014,Mayo,Ecuador,0,1,,1,-77.061029,3.8844260000000004
25553,2014,Mayo,Ecuador,1950,3856,,5806,-74.140516,4.697157
25554,2014,Mayo,Ecuador,0,1,,1,-75.736374,4.815189
25555,2014,Mayo,Ecuador,409,654,,1063,-75.42726,6.170465
25556,2014,Mayo,Ecuador,2,1,,3,-72.508188,7.927233
25557,2014,Mayo,Egipto,2,4,,6,-74.140516,4.697157
25558,2014,Mayo,El Salvador,1,5,,6,-75.516486,10.446304
25559,2014,Mayo,El Salvador,3,3,,6,-81.70216500000001,12.5862
25560,2014,Mayo,El Salvador,82,140,,222,-76.532004,3.451668
25561,2014,Mayo,El Salvador,725,1286,,2011,-74.140516,4.697157
25562,2014,Mayo,El Salvador,0,1,,1,-75.736374,4.815189
25563,2014,Mayo,El Salvador,88,205,,293,-75.42726,6.170465
25564,2014,Mayo,Emiratos Árabes,0,3,,3,-74.140516,4.697157
25565,2014,Mayo,Eslovaquia,3,1,,4,-74.140516,4.697157
25566,2014,Mayo,Eslovenia,0,4,,4,-74.140516,4.697157
25567,2014,Mayo,Estados Unidos de América,0,1,,1,-78.802679,18.00143
25568,2014,Mayo,Estados Unidos de América,2,15,,17,-75.527794,10.406342
25569,2014,Mayo,Estados Unidos de América,0,8,,8,-73.247863,10.433608999999999
25570,2014,Mayo,Estados Unidos de América,1187,1867,,3054,-75.516486,10.446304
25571,2014,Mayo,Estados Unidos de América,290,546,,836,-74.77647900000001,10.886686
25572,2014,Mayo,Estados Unidos de América,0,8,,8,-74.213989,11.247722999999999
25573,2014,Mayo,Estados Unidos de América,3,9,,12,-81.70216500000001,12.5862
25574,2014,Mayo,Estados Unidos de América,787,1229,,2016,-76.532004,3.451668
25575,2014,Mayo,Estados Unidos de América,0,6,,6,-77.061029,3.8844260000000004
25576,2014,Mayo,Estados Unidos de América,79,119,,198,-75.76635300000001,4.45285
25577,2014,Mayo,Estados Unidos de América,6746,13656,,20402,-74.140516,4.697157
25578,2014,Mayo,Estados Unidos de América,61,84,,145,-75.736374,4.815189
25579,2014,Mayo,Estados Unidos de América,1532,3617,,5149,-75.42726,6.170465
25580,2014,Mayo,Estados Unidos de América,9,24,,33,-73.181317,7.1280470000000005
25581,2014,Mayo,Estados Unidos de América,22,20,,42,-72.508188,7.927233
25582,2014,Mayo,Estonia,1,2,,3,-74.140516,4.697157
25583,2014,Mayo,Filipinas,0,4,,4,-75.516486,10.446304
25584,2014,Mayo,Filipinas,1,9,,10,-74.77647900000001,10.886686
25585,2014,Mayo,Filipinas,0,4,,4,-74.765343,10.970933
25586,2014,Mayo,Filipinas,0,5,,5,-76.532004,3.451668
25587,2014,Mayo,Filipinas,1,10,,11,-74.140516,4.697157
25588,2014,Mayo,Finlandia,0,1,,1,-75.516486,10.446304
25589,2014,Mayo,Finlandia,3,6,,9,-74.140516,4.697157
25590,2014,Mayo,Francia,1,0,,1,-77.35600000000001,0.81488
25591,2014,Mayo,Francia,3,2,,5,-75.516486,10.446304
25592,2014,Mayo,Francia,1,1,,2,-74.77647900000001,10.886686
25593,2014,Mayo,Francia,2,7,,9,-76.532004,3.451668
25594,2014,Mayo,Francia,928,2019,,2947,-74.140516,4.697157
25595,2014,Mayo,Francia,0,1,,1,-75.736374,4.815189
25596,2014,Mayo,Francia,7,11,,18,-75.42726,6.170465
25597,2014,Mayo,Francia,0,1,,1,-77.762647,7.102626
25598,2014,Mayo,Georgia,0,1,,1,-74.140516,4.697157
25599,2014,Mayo,Grecia,1,4,,5,-74.140516,4.697157
25600,2014,Mayo,Guatemala,4,3,,7,-75.516486,10.446304
25601,2014,Mayo,Guatemala,0,2,,2,-74.77647900000001,10.886686
25602,2014,Mayo,Guatemala,6,4,,10,-81.70216500000001,12.5862
25603,2014,Mayo,Guatemala,7,20,,27,-76.532004,3.451668
25604,2014,Mayo,Guatemala,115,293,,408,-74.140516,4.697157
25605,2014,Mayo,Guatemala,0,2,,2,-75.736374,4.815189
25606,2014,Mayo,Guatemala,19,56,,75,-75.42726,6.170465
25607,2014,Mayo,Guatemala,2,0,,2,-72.508188,7.927233
25608,2014,Mayo,Guyana,0,1,,1,-76.532004,3.451668
25609,2014,Mayo,Guyana,1,0,,1,-74.140516,4.697157
25610,2014,Mayo,Guadalupe/Territorio Francés,0,2,,2,-74.140516,4.697157
25611,2014,Mayo,Guadalupe/Territorio Francés,0,1,,1,-75.42726,6.170465
25612,2014,Mayo,Guayana Francesa/Departamento de Ultramar Francés,0,1,,1,-75.42726,6.170465
25613,2014,Mayo,Haití,0,8,,8,-75.527794,10.406342
25614,2014,Mayo,Haití,0,18,,18,-75.516486,10.446304
25615,2014,Mayo,Haití,0,1,,1,-74.140516,4.697157
25616,2014,Mayo,Honduras,2,9,,11,-75.516486,10.446304
25617,2014,Mayo,Honduras,3,3,,6,-74.77647900000001,10.886686
25618,2014,Mayo,Honduras,1,13,,14,-81.70216500000001,12.5862
25619,2014,Mayo,Honduras,2,6,,8,-81.372937,13.338761300000002
25620,2014,Mayo,Honduras,5,20,,25,-76.532004,3.451668
25621,2014,Mayo,Honduras,40,65,,105,-74.140516,4.697157
25622,2014,Mayo,Honduras,1,0,,1,-75.736374,4.815189
25623,2014,Mayo,Honduras,10,19,,29,-75.42726,6.170465
25624,2014,Mayo,Honduras,0,2,,2,-72.508188,7.927233
25625,2014,Mayo,Hong Kong,1,9,,10,-74.140516,4.697157
25626,2014,Mayo,Hong Kong,0,1,,1,-75.42726,6.170465
25627,2014,Mayo,Hungría,1,3,,4,-74.140516,4.697157
25628,2014,Mayo,India,0,1,,1,-74.77647900000001,10.886686
25629,2014,Mayo,India,0,3,,3,-76.532004,3.451668
25630,2014,Mayo,India,2,18,,20,-74.140516,4.697157
25631,2014,Mayo,India,6,6,,12,-75.42726,6.170465
25632,2014,Mayo,Indonesia,2,1,,3,-74.140516,4.697157
25633,2014,Mayo,República de Irlanda,1,1,,2,-75.516486,10.446304
25634,2014,Mayo,República de Irlanda,0,1,,1,-74.77647900000001,10.886686
25635,2014,Mayo,República de Irlanda,3,13,,16,-74.140516,4.697157
25636,2014,Mayo,República de Irlanda,0,1,,1,-75.736374,4.815189
25637,2014,Mayo,Islandia,1,0,,1,-74.140516,4.697157
25638,2014,Mayo,Israel,1,0,,1,-75.516486,10.446304
25639,2014,Mayo,Israel,9,47,,56,-74.140516,4.697157
25640,2014,Mayo,Israel,0,3,,3,-75.42726,6.170465
25641,2014,Mayo,Italia,0,3,,3,-74.77647900000001,10.886686
25642,2014,Mayo,Italia,0,1,,1,-74.213989,11.247722999999999
25643,2014,Mayo,Italia,6,16,,22,-76.532004,3.451668
25644,2014,Mayo,Italia,68,194,,262,-74.140516,4.697157
25645,2014,Mayo,Italia,0,3,,3,-75.736374,4.815189
25646,2014,Mayo,Italia,1,12,,13,-75.42726,6.170465
25647,2014,Mayo,Italia,0,1,,1,-72.508188,7.927233
25648,2014,Mayo,Jamaica,0,5,,5,-75.527794,10.406342
25649,2014,Mayo,Jamaica,0,3,,3,-75.516486,10.446304
25650,2014,Mayo,Jamaica,0,2,,2,-74.77647900000001,10.886686
25651,2014,Mayo,Jamaica,1,0,,1,-76.532004,3.451668
25652,2014,Mayo,Jamaica,1,16,,17,-74.140516,4.697157
25653,2014,Mayo,Jamaica,2,1,,3,-75.42726,6.170465
25654,2014,Mayo,Jamaica,0,1,,1,-73.181317,7.1280470000000005
25655,2014,Mayo,Japón,0,1,,1,-74.77647900000001,10.886686
25656,2014,Mayo,Japón,0,1,,1,-76.532004,3.451668
25657,2014,Mayo,Japón,10,21,,31,-74.140516,4.697157
25658,2014,Mayo,Japón,0,4,,4,-75.42726,6.170465
25659,2014,Mayo,Jordania,2,0,,2,-74.140516,4.697157
25660,2014,Mayo,Kazajistán,1,1,,2,-74.140516,4.697157
25661,2014,Mayo,Kenia,2,0,,2,-76.532004,3.451668
25662,2014,Mayo,Kenia,2,2,,4,-74.140516,4.697157
25663,2014,Mayo,Líbano,3,8,,11,-74.140516,4.697157
25664,2014,Mayo,Luxemburgo,0,1,,1,-74.140516,4.697157
25665,2014,Mayo,Malasia,1,3,,4,-74.140516,4.697157
25666,2014,Mayo,Marruecos,0,1,,1,-75.516486,10.446304
25667,2014,Mayo,Marruecos,1,2,,3,-74.140516,4.697157
25668,2014,Mayo,Martinica/Departamento de Ultramar Francés,1,2,,3,-75.527794,10.406342
25669,2014,Mayo,Martinica/Departamento de Ultramar Francés,1,2,,3,-74.213989,11.247722999999999
25670,2014,Mayo,México,2,11,,13,-75.527794,10.406342
25671,2014,Mayo,México,22,46,,68,-75.516486,10.446304
25672,2014,Mayo,México,5,18,,23,-74.77647900000001,10.886686
25673,2014,Mayo,México,0,4,,4,-74.765343,10.970933
25674,2014,Mayo,México,0,1,,1,-81.70216500000001,12.5862
25675,2014,Mayo,México,24,78,,102,-76.532004,3.451668
25676,2014,Mayo,México,3009,6373,,9382,-74.140516,4.697157
25677,2014,Mayo,México,4,6,,10,-75.736374,4.815189
25678,2014,Mayo,México,43,156,,199,-75.42726,6.170465
25679,2014,Mayo,México,0,2,,2,-73.181317,7.1280470000000005
25680,2014,Mayo,México,1,1,,2,-72.508188,7.927233
25681,2014,Mayo,Myanmar,3,0,,3,-74.140516,4.697157
25682,2014,Mayo,Nicaragua,2,1,,3,-75.516486,10.446304
25683,2014,Mayo,Nicaragua,0,1,,1,-74.77647900000001,10.886686
25684,2014,Mayo,Nicaragua,2,1,,3,-81.372937,13.338761300000002
25685,2014,Mayo,Nicaragua,2,4,,6,-76.532004,3.451668
25686,2014,Mayo,Nicaragua,24,27,,51,-74.140516,4.697157
25687,2014,Mayo,Nicaragua,2,2,,4,-75.736374,4.815189
25688,2014,Mayo,Nicaragua,1,6,,7,-75.42726,6.170465
25689,2014,Mayo,Nigeria,0,2,,2,-74.140516,4.697157
25690,2014,Mayo,Noruega,0,1,,1,-75.516486,10.446304
25691,2014,Mayo,Noruega,0,3,,3,-74.77647900000001,10.886686
25692,2014,Mayo,Noruega,0,1,,1,-76.532004,3.451668
25693,2014,Mayo,Noruega,5,11,,16,-74.140516,4.697157
25694,2014,Mayo,Nueva Zelanda,1,0,,1,-76.532004,3.451668
25695,2014,Mayo,Nueva Zelanda,2,13,,15,-74.140516,4.697157
25696,2014,Mayo,Papúa Nueva Guinea,0,1,,1,-74.140516,4.697157
25697,2014,Mayo,Panamá,1006,962,,1968,-75.527794,10.406342
25698,2014,Mayo,Panamá,1623,2037,,3660,-75.516486,10.446304
25699,2014,Mayo,Panamá,226,473,,699,-74.77647900000001,10.886686
25700,2014,Mayo,Panamá,1,25,,26,-74.765343,10.970933
25701,2014,Mayo,Panamá,2,5,,7,-74.213989,11.247722999999999
25702,2014,Mayo,Panamá,1385,1050,,2435,-81.70216500000001,12.5862
25703,2014,Mayo,Panamá,6,9,,15,-81.372937,13.338761300000002
25704,2014,Mayo,Panamá,253,514,,767,-76.532004,3.451668
25705,2014,Mayo,Panamá,0,18,,18,-77.061029,3.8844260000000004
25706,2014,Mayo,Panamá,1943,3981,,5924,-74.140516,4.697157
25707,2014,Mayo,Panamá,69,131,,200,-75.736374,4.815189
25708,2014,Mayo,Panamá,446,1273,,1719,-75.42726,6.170465
25709,2014,Mayo,Panamá,0,2,,2,-77.401154,6.222551999999999
25710,2014,Mayo,Panamá,2,10,,12,-77.762647,7.102626
25711,2014,Mayo,Panamá,24,57,,81,-73.181317,7.1280470000000005
25712,2014,Mayo,Panamá,90,111,,201,-72.508188,7.927233
25713,2014,Mayo,Panamá,0,1,,1,-76.7333,8.06667
25714,2014,Mayo,Panamá,69,143,,212,-77.35002,8.63337
25715,2014,Mayo,Paraguay,2,1,,3,-75.516486,10.446304
25716,2014,Mayo,Paraguay,12,7,,19,-81.70216500000001,12.5862
25717,2014,Mayo,Paraguay,4,4,,8,-76.532004,3.451668
25718,2014,Mayo,Paraguay,13,31,,44,-74.140516,4.697157
25719,2014,Mayo,Paraguay,5,8,,13,-75.42726,6.170465
25720,2014,Mayo,Perú,182,239,,421,-69.941498,4.191162
25721,2014,Mayo,Perú,21,21,,42,-75.516486,10.446304
25722,2014,Mayo,Perú,4,14,,18,-74.77647900000001,10.886686
25723,2014,Mayo,Perú,133,72,,205,-81.70216500000001,12.5862
25724,2014,Mayo,Perú,208,330,,538,-76.532004,3.451668
25725,2014,Mayo,Perú,4592,6795,,11387,-74.140516,4.697157
25726,2014,Mayo,Perú,1,2,,3,-75.736374,4.815189
25727,2014,Mayo,Perú,340,639,,979,-75.42726,6.170465
25728,2014,Mayo,Perú,1,2,,3,-73.181317,7.1280470000000005
25729,2014,Mayo,Perú,0,2,,2,-72.508188,7.927233
25730,2014,Mayo,Polonia,8,18,,26,-74.140516,4.697157
25731,2014,Mayo,Portugal,1,3,,4,-76.532004,3.451668
25732,2014,Mayo,Portugal,10,30,,40,-74.140516,4.697157
25733,2014,Mayo,Puerto Rico/Territorio de Estados Unidos,0,7,,7,-73.247863,10.433608999999999
25734,2014,Mayo,Puerto Rico/Territorio de Estados Unidos,3,23,,26,-75.516486,10.446304
25735,2014,Mayo,Puerto Rico/Territorio de Estados Unidos,2,25,,27,-74.77647900000001,10.886686
25736,2014,Mayo,Puerto Rico/Territorio de Estados Unidos,1,3,,4,-74.213989,11.247722999999999
25737,2014,Mayo,Puerto Rico/Territorio de Estados Unidos,9,29,,38,-76.532004,3.451668
25738,2014,Mayo,Puerto Rico/Territorio de Estados Unidos,158,224,,382,-74.140516,4.697157
25739,2014,Mayo,Puerto Rico/Territorio de Estados Unidos,2,13,,15,-75.736374,4.815189
25740,2014,Mayo,Puerto Rico/Territorio de Estados Unidos,20,58,,78,-75.42726,6.170465
25741,2014,Mayo,Puerto Rico/Territorio de Estados Unidos,1,3,,4,-73.181317,7.1280470000000005
25742,2014,Mayo,Puerto Rico/Territorio de Estados Unidos,2,1,,3,-72.508188,7.927233
25743,2014,Mayo,Qatar,0,1,,1,-74.140516,4.697157
25744,2014,Mayo,Reino Unido de Gran Bretaña e Irlanda del Norte,2,7,,9,-75.516486,10.446304
25745,2014,Mayo,Reino Unido de Gran Bretaña e Irlanda del Norte,2,3,,5,-74.77647900000001,10.886686
25746,2014,Mayo,Reino Unido de Gran Bretaña e Irlanda del Norte,2,6,,8,-76.532004,3.451668
25747,2014,Mayo,Reino Unido de Gran Bretaña e Irlanda del Norte,65,144,,209,-74.140516,4.697157
25748,2014,Mayo,Reino Unido de Gran Bretaña e Irlanda del Norte,4,8,,12,-75.42726,6.170465
25749,2014,Mayo,Federación de Rusia,1,0,,1,-75.516486,10.446304
25750,2014,Mayo,Federación de Rusia,1,0,,1,-76.532004,3.451668
25751,2014,Mayo,Federación de Rusia,16,24,,40,-74.140516,4.697157
25752,2014,Mayo,República Dominicana,3,4,,7,-75.516486,10.446304
25753,2014,Mayo,República Dominicana,1,16,,17,-74.77647900000001,10.886686
25754,2014,Mayo,República Dominicana,0,3,,3,-74.765343,10.970933
25755,2014,Mayo,República Dominicana,1,4,,5,-74.213989,11.247722999999999
25756,2014,Mayo,República Dominicana,1,0,,1,-81.70216500000001,12.5862
25757,2014,Mayo,República Dominicana,9,19,,28,-76.532004,3.451668
25758,2014,Mayo,República Dominicana,334,511,,845,-74.140516,4.697157
25759,2014,Mayo,República Dominicana,2,2,,4,-75.736374,4.815189
25760,2014,Mayo,República Dominicana,17,39,,56,-75.42726,6.170465
25761,2014,Mayo,República Democrática Popular de Corea,0,1,,1,-74.140516,4.697157
25762,2014,Mayo,Rumania,2,0,,2,-75.527794,10.406342
25763,2014,Mayo,Rumania,4,6,,10,-74.140516,4.697157
25764,2014,Mayo,Santa Sede/Ciudad del Vaticano,1,1,,2,-74.140516,4.697157
25765,2014,Mayo,Senegal,2,9,,11,-74.140516,4.697157
25766,2014,Mayo,Serbia,1,0,,1,-74.140516,4.697157
25767,2014,Mayo,Singapur,1,3,,4,-74.140516,4.697157
25768,2014,Mayo,Sudáfrica,1,6,,7,-74.140516,4.697157
25769,2014,Mayo,Suecia,0,1,,1,-75.516486,10.446304
25770,2014,Mayo,Suecia,0,3,,3,-74.77647900000001,10.886686
25771,2014,Mayo,Suecia,0,2,,2,-76.532004,3.451668
25772,2014,Mayo,Suecia,10,18,,28,-74.140516,4.697157
25773,2014,Mayo,Suecia,0,2,,2,-75.42726,6.170465
25774,2014,Mayo,Suiza,2,2,,4,-75.516486,10.446304
25775,2014,Mayo,Suiza,4,6,,10,-76.532004,3.451668
25776,2014,Mayo,Suiza,30,71,,101,-74.140516,4.697157
25777,2014,Mayo,Suiza,0,6,,6,-75.42726,6.170465
25778,2014,Mayo,Surinam,0,1,,1,-75.527794,10.406342
25779,2014,Mayo,Surinam,0,1,,1,-74.140516,4.697157
25780,2014,Mayo,Surinam,2,8,,10,-75.42726,6.170465
25781,2014,Mayo,Taiwán,2,0,,2,-74.140516,4.697157
25782,2014,Mayo,Tailandia,3,1,,4,-74.140516,4.697157
25783,2014,Mayo,Trinidad y Tobago,0,1,,1,-75.516486,10.446304
25784,2014,Mayo,Trinidad y Tobago,0,1,,1,-74.77647900000001,10.886686
25785,2014,Mayo,Trinidad y Tobago,0,12,,12,-74.213989,11.247722999999999
25786,2014,Mayo,Trinidad y Tobago,2,6,,8,-76.532004,3.451668
25787,2014,Mayo,Trinidad y Tobago,2,5,,7,-74.140516,4.697157
25788,2014,Mayo,Trinidad y Tobago,1,12,,13,-75.42726,6.170465
25789,2014,Mayo,Túnez,0,1,,1,-76.532004,3.451668
25790,2014,Mayo,Túnez,0,1,,1,-75.42726,6.170465
25791,2014,Mayo,Turquía,1,6,,7,-74.140516,4.697157
25792,2014,Mayo,Turquía,0,3,,3,-75.42726,6.170465
25793,2014,Mayo,Ucrania,0,1,,1,-75.516486,10.446304
25794,2014,Mayo,Ucrania,0,1,,1,-74.765343,10.970933
25795,2014,Mayo,Ucrania,0,2,,2,-74.140516,4.697157
25796,2014,Mayo,Uruguay,22,8,,30,-75.516486,10.446304
25797,2014,Mayo,Uruguay,1,2,,3,-74.77647900000001,10.886686
25798,2014,Mayo,Uruguay,8,8,,16,-81.70216500000001,12.5862
25799,2014,Mayo,Uruguay,6,11,,17,-76.532004,3.451668
25800,2014,Mayo,Uruguay,37,51,,88,-74.140516,4.697157
25801,2014,Mayo,Uruguay,14,85,,99,-75.42726,6.170465
25802,2014,Mayo,Uruguay,0,1,,1,-72.508188,7.927233
25803,2014,Mayo,Venezuela,0,17,,17,-75.527794,10.406342
25804,2014,Mayo,Venezuela,4,6,,10,-73.247863,10.433608999999999
25805,2014,Mayo,Venezuela,11,32,,43,-75.516486,10.446304
25806,2014,Mayo,Venezuela,14,48,,62,-74.77647900000001,10.886686
25807,2014,Mayo,Venezuela,0,1,,1,-74.765343,10.970933
25808,2014,Mayo,Venezuela,0,1,,1,-74.213989,11.247722999999999
25809,2014,Mayo,Venezuela,1033,1669,,2702,-72.129595,11.360028999999999
25810,2014,Mayo,Venezuela,1,0,,1,-81.70216500000001,12.5862
25811,2014,Mayo,Venezuela,19,42,,61,-76.532004,3.451668
25812,2014,Mayo,Venezuela,3038,4216,,7254,-74.140516,4.697157
25813,2014,Mayo,Venezuela,4,10,,14,-75.736374,4.815189
25814,2014,Mayo,Venezuela,246,445,,691,-75.42726,6.170465
25815,2014,Mayo,Venezuela,15,29,,44,-67.48402800000001,6.185536
25816,2014,Mayo,Venezuela,27,35,,62,-70.74025300000001,7.088728999999999
25817,2014,Mayo,Venezuela,0,2,,2,-73.181317,7.1280470000000005
25818,2014,Mayo,Venezuela,1303,1879,,3182,-72.453013,7.819
25819,2014,Mayo,Venezuela,104,120,,224,-72.508188,7.927233
25820,2014,Mayo,Vietnam,0,1,,1,-76.532004,3.451668
25821,2014,Mayo,Zimbabue,0,1,,1,-74.140516,4.697157
25822,2014,Mayo,Desconocido,0,2,,2,-75.527794,10.406342
25823,2014,Mayo,Desconocido,17,62,,79,-81.703935,12.574411099999999
25824,2014,Mayo,Desconocido,0,1,,1,-81.372937,13.338761300000002
25825,2014,Mayo,Desconocido,0,19,,19,-74.140516,4.697157
25826,2014,Mayo,Desconocido,0,1,,1,-75.68164200000001,9.402597
25827,2014,Junio,Desconocido,0,79,,79,-72.919186,11.52863
25828,2014,Junio,Desconocido,7,22,,29,-81.703935,12.574411099999999
25829,2014,Junio,Desconocido,0,1,,1,-81.372937,13.338761300000002
25830,2014,Junio,Desconocido,0,1,,1,-77.061029,3.8844260000000004
25831,2014,Junio,Desconocido,1,30,,31,-74.140516,4.697157
25832,2014,Junio,Desconocido,6,9,,15,-75.42726,6.170465
25833,2014,Junio,Desconocido,1,0,,1,-77.35002,8.63337
25834,2014,Junio,Afganistán,1,1,,2,-74.140516,4.697157
25835,2014,Junio,Alemania,0,1,,1,-75.516486,10.446304
25836,2014,Junio,Alemania,1,4,,5,-74.77647900000001,10.886686
25837,2014,Junio,Alemania,0,1,,1,-81.70216500000001,12.5862
25838,2014,Junio,Alemania,3,5,,8,-76.532004,3.451668
25839,2014,Junio,Alemania,1176,2080,,3256,-74.140516,4.697157
25840,2014,Junio,Alemania,1,7,,8,-75.42726,6.170465
25841,2014,Junio,Antigua y Barbuda,0,3,,3,-75.527794,10.406342
25842,2014,Junio,Países Bajos,1,2,,3,-75.516486,10.446304
25843,2014,Junio,Países Bajos,2,5,,7,-74.77647900000001,10.886686
25844,2014,Junio,Países Bajos,0,3,,3,-74.213989,11.247722999999999
25845,2014,Junio,Países Bajos,4,7,,11,-76.532004,3.451668
25846,2014,Junio,Países Bajos,35,62,,97,-74.140516,4.697157
25847,2014,Junio,Países Bajos,0,1,,1,-75.736374,4.815189
25848,2014,Junio,Países Bajos,31,36,,67,-75.42726,6.170465
25849,2014,Junio,Países Bajos,3,2,,5,-73.181317,7.1280470000000005
25850,2014,Junio,Arabia Saudita,1,1,,2,-74.140516,4.697157
25851,2014,Junio,Argelia,2,2,,4,-74.140516,4.697157
25852,2014,Junio,Argentina,2,11,,13,-77.35600000000001,0.81488
25853,2014,Junio,Argentina,90,56,,146,-75.516486,10.446304
25854,2014,Junio,Argentina,5,7,,12,-74.77647900000001,10.886686
25855,2014,Junio,Argentina,72,75,,147,-81.70216500000001,12.5862
25856,2014,Junio,Argentina,15,31,,46,-76.532004,3.451668
25857,2014,Junio,Argentina,0,3,,3,-77.061029,3.8844260000000004
25858,2014,Junio,Argentina,1459,2283,,3742,-74.140516,4.697157
25859,2014,Junio,Argentina,1,0,,1,-75.736374,4.815189
25860,2014,Junio,Argentina,52,115,,167,-75.42726,6.170465
25861,2014,Junio,Argentina,2,2,,4,-73.181317,7.1280470000000005
25862,2014,Junio,Aruba,0,6,,6,-75.527794,10.406342
25863,2014,Junio,Aruba,1,2,,3,-74.77647900000001,10.886686
25864,2014,Junio,Aruba,2,5,,7,-74.213989,11.247722999999999
25865,2014,Junio,Aruba,4,2,,6,-76.532004,3.451668
25866,2014,Junio,Aruba,577,691,,1268,-74.140516,4.697157
25867,2014,Junio,Aruba,0,1,,1,-75.736374,4.815189
25868,2014,Junio,Aruba,4,4,,8,-75.42726,6.170465
25869,2014,Junio,Aruba,5,1,,6,-73.181317,7.1280470000000005
25870,2014,Junio,Australia,1,0,,1,-77.35600000000001,0.81488
25871,2014,Junio,Australia,1,1,,2,-75.516486,10.446304
25872,2014,Junio,Australia,1,2,,3,-74.77647900000001,10.886686
25873,2014,Junio,Australia,2,4,,6,-76.532004,3.451668
25874,2014,Junio,Australia,23,31,,54,-74.140516,4.697157
25875,2014,Junio,Australia,8,14,,22,-75.42726,6.170465
25876,2014,Junio,Austria,0,1,,1,-76.532004,3.451668
25877,2014,Junio,Austria,11,17,,28,-74.140516,4.697157
25878,2014,Junio,Bahamas,0,1,,1,-75.516486,10.446304
25879,2014,Junio,Bahamas,0,1,,1,-76.532004,3.451668
25880,2014,Junio,Bahamas,3,3,,6,-74.140516,4.697157
25881,2014,Junio,Bahréin,0,3,,3,-74.140516,4.697157
25882,2014,Junio,Bahréin,0,1,,1,-75.42726,6.170465
25883,2014,Junio,Barbados,0,1,,1,-74.140516,4.697157
25884,2014,Junio,República de Belarús,0,2,,2,-74.140516,4.697157
25885,2014,Junio,Bélgica,0,2,,2,-74.77647900000001,10.886686
25886,2014,Junio,Bélgica,0,1,,1,-81.70216500000001,12.5862
25887,2014,Junio,Bélgica,0,2,,2,-76.532004,3.451668
25888,2014,Junio,Bélgica,18,28,,46,-74.140516,4.697157
25889,2014,Junio,Bélgica,7,9,,16,-75.42726,6.170465
25890,2014,Junio,Belice,0,3,,3,-74.140516,4.697157
25891,2014,Junio,Bolivia,0,3,,3,-77.35600000000001,0.81488
25892,2014,Junio,Bolivia,5,8,,13,-75.516486,10.446304
25893,2014,Junio,Bolivia,1,1,,2,-74.77647900000001,10.886686
25894,2014,Junio,Bolivia,7,7,,14,-76.532004,3.451668
25895,2014,Junio,Bolivia,320,420,,740,-74.140516,4.697157
25896,2014,Junio,Bolivia,14,15,,29,-75.42726,6.170465
25897,2014,Junio,Bolivia,1,0,,1,-73.181317,7.1280470000000005
25898,2014,Junio,Brasil,132,208,,340,-69.941498,4.191162
25899,2014,Junio,Brasil,0,1,,1,-77.35600000000001,0.81488
25900,2014,Junio,Brasil,65,55,,120,-75.516486,10.446304
25901,2014,Junio,Brasil,5,6,,11,-74.77647900000001,10.886686
25902,2014,Junio,Brasil,64,50,,114,-81.70216500000001,12.5862
25903,2014,Junio,Brasil,17,22,,39,-76.532004,3.451668
25904,2014,Junio,Brasil,1764,3473,,5237,-74.140516,4.697157
25905,2014,Junio,Brasil,1,2,,3,-75.736374,4.815189
25906,2014,Junio,Brasil,26,96,,122,-75.42726,6.170465
25907,2014,Junio,Brasil,0,1,,1,-73.181317,7.1280470000000005
25908,2014,Junio,Brasil,1,1,,2,-72.508188,7.927233
25909,2014,Junio,Bulgaria,1,2,,3,-74.140516,4.697157
25910,2014,Junio,Islas Caimán/Territorio Británico de Ultramar,2,5,,7,-75.527794,10.406342
25911,2014,Junio,Islas Caimán/Territorio Británico de Ultramar,0,1,,1,-81.372937,13.338761300000002
25912,2014,Junio,Islas Caimán/Territorio Británico de Ultramar,0,3,,3,-74.140516,4.697157
25913,2014,Junio,Canadá,9,10,,19,-75.516486,10.446304
25914,2014,Junio,Canadá,8,6,,14,-74.77647900000001,10.886686
25915,2014,Junio,Canadá,25,28,,53,-76.532004,3.451668
25916,2014,Junio,Canadá,1,0,,1,-75.76635300000001,4.45285
25917,2014,Junio,Canadá,491,778,,1269,-74.140516,4.697157
25918,2014,Junio,Canadá,6,4,,10,-75.736374,4.815189
25919,2014,Junio,Canadá,30,60,,90,-75.42726,6.170465
25920,2014,Junio,Canadá,1,4,,5,-73.181317,7.1280470000000005
25921,2014,Junio,Canadá,2,1,,3,-72.508188,7.927233
25922,2014,Junio,España,0,2,,2,-75.527794,10.406342
25923,2014,Junio,España,0,1,,1,-75.516486,10.446304
25924,2014,Junio,España,0,2,,2,-74.77647900000001,10.886686
25925,2014,Junio,España,224,389,,613,-76.532004,3.451668
25926,2014,Junio,España,2558,4825,,7383,-74.140516,4.697157
25927,2014,Junio,España,2,1,,3,-75.736374,4.815189
25928,2014,Junio,España,153,304,,457,-75.42726,6.170465
25929,2014,Junio,España,0,1,,1,-73.181317,7.1280470000000005
25930,2014,Junio,España,3,5,,8,-77.35002,8.63337
25931,2014,Junio,República de Corea,0,2,,2,-74.77647900000001,10.886686
25932,2014,Junio,República de Corea,7,17,,24,-74.140516,4.697157
25933,2014,Junio,República de Corea,0,1,,1,-75.42726,6.170465
25934,2014,Junio,Costa de Marfil,5,2,,7,-74.140516,4.697157
25935,2014,Junio,Costa Rica,4,7,,11,-75.527794,10.406342
25936,2014,Junio,Costa Rica,14,21,,35,-75.516486,10.446304
25937,2014,Junio,Costa Rica,7,22,,29,-74.77647900000001,10.886686
25938,2014,Junio,Costa Rica,3,2,,5,-81.70216500000001,12.5862
25939,2014,Junio,Costa Rica,5,13,,18,-76.532004,3.451668
25940,2014,Junio,Costa Rica,595,1035,,1630,-74.140516,4.697157
25941,2014,Junio,Costa Rica,0,4,,4,-75.736374,4.815189
25942,2014,Junio,Costa Rica,30,60,,90,-75.42726,6.170465
25943,2014,Junio,Costa Rica,0,2,,2,-73.181317,7.1280470000000005
25944,2014,Junio,Croacia,0,1,,1,-74.77647900000001,10.886686
25945,2014,Junio,Croacia,1,17,,18,-74.140516,4.697157
25946,2014,Junio,Cuba,2,1,,3,-75.516486,10.446304
25947,2014,Junio,Cuba,5,1,,6,-74.77647900000001,10.886686
25948,2014,Junio,Cuba,11,24,,35,-76.532004,3.451668
25949,2014,Junio,Cuba,140,215,,355,-74.140516,4.697157
25950,2014,Junio,Cuba,2,0,,2,-75.736374,4.815189
25951,2014,Junio,Cuba,3,4,,7,-75.42726,6.170465
25952,2014,Junio,Cuba,2,0,,2,-73.181317,7.1280470000000005
25953,2014,Junio,Cuba,1,0,,1,-72.508188,7.927233
25954,2014,Junio,Curazao,1,1,,2,-75.527794,10.406342
25955,2014,Junio,Curazao,17,36,,53,-74.77647900000001,10.886686
25956,2014,Junio,Curazao,4,9,,13,-74.213989,11.247722999999999
25957,2014,Junio,Curazao,191,248,,439,-74.140516,4.697157
25958,2014,Junio,Curazao,124,191,,315,-75.42726,6.170465
25959,2014,Junio,República Checa,4,2,,6,-74.140516,4.697157
25960,2014,Junio,Chile,4,4,,8,-77.35600000000001,0.81488
25961,2014,Junio,Chile,16,10,,26,-75.516486,10.446304
25962,2014,Junio,Chile,0,3,,3,-74.77647900000001,10.886686
25963,2014,Junio,Chile,0,1,,1,-74.765343,10.970933
25964,2014,Junio,Chile,49,26,,75,-81.70216500000001,12.5862
25965,2014,Junio,Chile,19,31,,50,-76.532004,3.451668
25966,2014,Junio,Chile,1922,3284,,5206,-74.140516,4.697157
25967,2014,Junio,Chile,23,55,,78,-75.42726,6.170465
25968,2014,Junio,China,0,1,,1,-76.532004,3.451668
25969,2014,Junio,China,35,64,,99,-74.140516,4.697157
25970,2014,Junio,Dinamarca,1,1,,2,-74.77647900000001,10.886686
25971,2014,Junio,Dinamarca,6,11,,17,-74.140516,4.697157
25972,2014,Junio,Dinamarca,0,1,,1,-75.42726,6.170465
25973,2014,Junio,Dominica,0,1,,1,-75.42726,6.170465
25974,2014,Junio,Ecuador,37,93,,130,-76.876446,0.33002
25975,2014,Junio,Ecuador,1875,3110,,4985,-77.35600000000001,0.81488
25976,2014,Junio,Ecuador,5,111,,116,-78.802679,18.00143
25977,2014,Junio,Ecuador,0,1,,1,-75.527794,10.406342
25978,2014,Junio,Ecuador,2,9,,11,-75.516486,10.446304
25979,2014,Junio,Ecuador,1,0,,1,-74.77647900000001,10.886686
25980,2014,Junio,Ecuador,3,0,,3,-81.70216500000001,12.5862
25981,2014,Junio,Ecuador,385,478,,863,-76.532004,3.451668
25982,2014,Junio,Ecuador,2427,4044,,6471,-74.140516,4.697157
25983,2014,Junio,Ecuador,371,510,,881,-75.42726,6.170465
25984,2014,Junio,Ecuador,0,1,,1,-73.181317,7.1280470000000005
25985,2014,Junio,Egipto,0,4,,4,-74.140516,4.697157
25986,2014,Junio,El Salvador,5,4,,9,-75.516486,10.446304
25987,2014,Junio,El Salvador,0,2,,2,-74.77647900000001,10.886686
25988,2014,Junio,El Salvador,111,156,,267,-76.532004,3.451668
25989,2014,Junio,El Salvador,727,1147,,1874,-74.140516,4.697157
25990,2014,Junio,El Salvador,0,1,,1,-75.736374,4.815189
25991,2014,Junio,El Salvador,103,202,,305,-75.42726,6.170465
25992,2014,Junio,Emiratos Árabes,4,7,,11,-74.140516,4.697157
25993,2014,Junio,Eslovaquia,5,2,,7,-74.140516,4.697157
25994,2014,Junio,Eslovaquia,0,1,,1,-75.42726,6.170465
25995,2014,Junio,Eslovenia,0,1,,1,-74.140516,4.697157
25996,2014,Junio,Eslovenia,1,0,,1,-75.42726,6.170465
25997,2014,Junio,Estados Unidos de América,4,36,,40,-75.527794,10.406342
25998,2014,Junio,Estados Unidos de América,1484,2223,,3707,-75.516486,10.446304
25999,2014,Junio,Estados Unidos de América,495,674,,1169,-74.77647900000001,10.886686
26000,2014,Junio,Estados Unidos de América,0,1,,1,-74.232675,11.117206
26001,2014,Junio,Estados Unidos de América,0,8,,8,-74.213989,11.247722999999999
26002,2014,Junio,Estados Unidos de América,4,10,,14,-81.70216500000001,12.5862
26003,2014,Junio,Estados Unidos de América,1458,1906,,3364,-76.532004,3.451668
26004,2014,Junio,Estados Unidos de América,0,3,,3,-77.061029,3.8844260000000004
26005,2014,Junio,Estados Unidos de América,174,190,,364,-75.76635300000001,4.45285
26006,2014,Junio,Estados Unidos de América,10253,16837,,27090,-74.140516,4.697157
26007,2014,Junio,Estados Unidos de América,167,181,,348,-75.736374,4.815189
26008,2014,Junio,Estados Unidos de América,2502,4216,,6718,-75.42726,6.170465
26009,2014,Junio,Estados Unidos de América,23,33,,56,-73.181317,7.1280470000000005
26010,2014,Junio,Estados Unidos de América,30,37,,67,-72.508188,7.927233
26011,2014,Junio,Estados Unidos de América,0,23,,23,-75.68164200000001,9.402597
26012,2014,Junio,Filipinas,0,1,,1,-75.516486,10.446304
26013,2014,Junio,Filipinas,0,3,,3,-74.77647900000001,10.886686
26014,2014,Junio,Filipinas,1,0,,1,-76.532004,3.451668
26015,2014,Junio,Filipinas,3,13,,16,-74.140516,4.697157
26016,2014,Junio,Filipinas,1,1,,2,-75.42726,6.170465
26017,2014,Junio,Finlandia,0,2,,2,-76.532004,3.451668
26018,2014,Junio,Finlandia,6,6,,12,-74.140516,4.697157
26019,2014,Junio,Francia,0,1,,1,-77.35600000000001,0.81488
26020,2014,Junio,Francia,0,1,,1,-75.527794,10.406342
26021,2014,Junio,Francia,0,1,,1,-75.516486,10.446304
26022,2014,Junio,Francia,3,8,,11,-76.532004,3.451668
26023,2014,Junio,Francia,1055,1940,,2995,-74.140516,4.697157
26024,2014,Junio,Francia,1,0,,1,-75.736374,4.815189
26025,2014,Junio,Francia,7,10,,17,-75.42726,6.170465
26026,2014,Junio,Grecia,1,3,,4,-74.140516,4.697157
26027,2014,Junio,Guatemala,5,3,,8,-75.516486,10.446304
26028,2014,Junio,Guatemala,5,3,,8,-74.77647900000001,10.886686
26029,2014,Junio,Guatemala,2,0,,2,-81.70216500000001,12.5862
26030,2014,Junio,Guatemala,8,26,,34,-76.532004,3.451668
26031,2014,Junio,Guatemala,163,351,,514,-74.140516,4.697157
26032,2014,Junio,Guatemala,0,3,,3,-75.736374,4.815189
26033,2014,Junio,Guatemala,13,58,,71,-75.42726,6.170465
26034,2014,Junio,Guatemala,1,0,,1,-72.508188,7.927233
26035,2014,Junio,Guyana,1,0,,1,-76.532004,3.451668
26036,2014,Junio,Guyana,2,2,,4,-74.140516,4.697157
26037,2014,Junio,Guadalupe/Territorio Francés,0,1,,1,-74.77647900000001,10.886686
26038,2014,Junio,Guadalupe/Territorio Francés,0,2,,2,-74.140516,4.697157
26039,2014,Junio,Haití,4,17,,21,-75.516486,10.446304
26040,2014,Junio,Haití,0,1,,1,-74.77647900000001,10.886686
26041,2014,Junio,Haití,0,1,,1,-76.532004,3.451668
26042,2014,Junio,Haití,1,2,,3,-74.140516,4.697157
26043,2014,Junio,Haití,0,2,,2,-75.42726,6.170465
26044,2014,Junio,Honduras,1,0,,1,-75.516486,10.446304
26045,2014,Junio,Honduras,1,4,,5,-74.77647900000001,10.886686
26046,2014,Junio,Honduras,0,8,,8,-81.70216500000001,12.5862
26047,2014,Junio,Honduras,6,11,,17,-76.532004,3.451668
26048,2014,Junio,Honduras,36,61,,97,-74.140516,4.697157
26049,2014,Junio,Honduras,0,2,,2,-75.736374,4.815189
26050,2014,Junio,Honduras,12,17,,29,-75.42726,6.170465
26051,2014,Junio,Honduras,1,0,,1,-72.508188,7.927233
26052,2014,Junio,Hong Kong,0,1,,1,-75.516486,10.446304
26053,2014,Junio,Hong Kong,4,8,,12,-74.140516,4.697157
26054,2014,Junio,Hungría,0,1,,1,-74.140516,4.697157
26055,2014,Junio,India,0,1,,1,-75.516486,10.446304
26056,2014,Junio,India,0,1,,1,-74.77647900000001,10.886686
26057,2014,Junio,India,0,1,,1,-76.532004,3.451668
26058,2014,Junio,India,10,30,,40,-74.140516,4.697157
26059,2014,Junio,India,0,1,,1,-75.42726,6.170465
26060,2014,Junio,Indonesia,2,5,,7,-74.140516,4.697157
26061,2014,Junio,Iraq,0,1,,1,-74.140516,4.697157
26062,2014,Junio,Irán,0,1,,1,-74.140516,4.697157
26063,2014,Junio,Irán,1,0,,1,-75.42726,6.170465
26064,2014,Junio,República de Irlanda,1,1,,2,-74.77647900000001,10.886686
26065,2014,Junio,República de Irlanda,8,11,,19,-74.140516,4.697157
26066,2014,Junio,República de Irlanda,1,1,,2,-75.42726,6.170465
26067,2014,Junio,Israel,0,1,,1,-75.516486,10.446304
26068,2014,Junio,Israel,0,2,,2,-76.532004,3.451668
26069,2014,Junio,Israel,16,79,,95,-74.140516,4.697157
26070,2014,Junio,Israel,1,2,,3,-75.42726,6.170465
26071,2014,Junio,Italia,0,2,,2,-75.516486,10.446304
26072,2014,Junio,Italia,1,1,,2,-81.70216500000001,12.5862
26073,2014,Junio,Italia,5,10,,15,-76.532004,3.451668
26074,2014,Junio,Italia,115,221,,336,-74.140516,4.697157
26075,2014,Junio,Italia,0,1,,1,-75.736374,4.815189
26076,2014,Junio,Italia,7,7,,14,-75.42726,6.170465
26077,2014,Junio,Jamaica,1,0,,1,-75.527794,10.406342
26078,2014,Junio,Jamaica,1,1,,2,-75.516486,10.446304
26079,2014,Junio,Jamaica,0,2,,2,-74.77647900000001,10.886686
26080,2014,Junio,Jamaica,0,2,,2,-74.765343,10.970933
26081,2014,Junio,Jamaica,1,3,,4,-74.213989,11.247722999999999
26082,2014,Junio,Jamaica,1,5,,6,-81.70216500000001,12.5862
26083,2014,Junio,Jamaica,0,1,,1,-76.532004,3.451668
26084,2014,Junio,Jamaica,4,16,,20,-74.140516,4.697157
26085,2014,Junio,Jamaica,0,1,,1,-75.42726,6.170465
26086,2014,Junio,Jamaica,0,1,,1,-72.508188,7.927233
26087,2014,Junio,Japón,2,0,,2,-74.77647900000001,10.886686
26088,2014,Junio,Japón,1,1,,2,-76.532004,3.451668
26089,2014,Junio,Japón,13,19,,32,-74.140516,4.697157
26090,2014,Junio,Japón,1,1,,2,-75.42726,6.170465
26091,2014,Junio,Jordania,0,1,,1,-74.140516,4.697157
26092,2014,Junio,Letonia,0,1,,1,-75.516486,10.446304
26093,2014,Junio,Líbano,3,5,,8,-74.140516,4.697157
26094,2014,Junio,Liechtenstein,1,0,,1,-74.140516,4.697157
26095,2014,Junio,Luxemburgo,1,2,,3,-74.140516,4.697157
26096,2014,Junio,Malasia,0,1,,1,-75.516486,10.446304
26097,2014,Junio,Malasia,1,1,,2,-74.140516,4.697157
26098,2014,Junio,Malta,1,0,,1,-74.140516,4.697157
26099,2014,Junio,Malta,0,1,,1,-75.736374,4.815189
26100,2014,Junio,Marruecos,0,2,,2,-74.213989,11.247722999999999
26101,2014,Junio,Marruecos,0,1,,1,-74.140516,4.697157
26102,2014,Junio,Mauritania,0,2,,2,-74.140516,4.697157
26103,2014,Junio,Martinica/Departamento de Ultramar Francés,0,2,,2,-74.140516,4.697157
26104,2014,Junio,Martinica/Departamento de Ultramar Francés,0,1,,1,-75.42726,6.170465
26105,2014,Junio,México,0,2,,2,-75.527794,10.406342
26106,2014,Junio,México,9,28,,37,-75.516486,10.446304
26107,2014,Junio,México,13,25,,38,-74.77647900000001,10.886686
26108,2014,Junio,México,8,10,,18,-81.70216500000001,12.5862
26109,2014,Junio,México,2,7,,9,-81.372937,13.338761300000002
26110,2014,Junio,México,20,62,,82,-76.532004,3.451668
26111,2014,Junio,México,3342,6183,,9525,-74.140516,4.697157
26112,2014,Junio,México,1,6,,7,-75.736374,4.815189
26113,2014,Junio,México,56,116,,172,-75.42726,6.170465
26114,2014,Junio,México,3,3,,6,-73.181317,7.1280470000000005
26115,2014,Junio,México,2,3,,5,-72.508188,7.927233
26116,2014,Junio,Mónaco,2,1,,3,-74.140516,4.697157
26117,2014,Junio,Nicaragua,1,1,,2,-75.516486,10.446304
26118,2014,Junio,Nicaragua,0,2,,2,-74.77647900000001,10.886686
26119,2014,Junio,Nicaragua,1,3,,4,-76.532004,3.451668
26120,2014,Junio,Nicaragua,23,18,,41,-74.140516,4.697157
26121,2014,Junio,Nicaragua,4,2,,6,-75.42726,6.170465
26122,2014,Junio,Nigeria,2,4,,6,-74.140516,4.697157
26123,2014,Junio,Noruega,0,1,,1,-75.516486,10.446304
26124,2014,Junio,Noruega,1,0,,1,-74.77647900000001,10.886686
26125,2014,Junio,Noruega,2,2,,4,-76.532004,3.451668
26126,2014,Junio,Noruega,23,14,,37,-74.140516,4.697157
26127,2014,Junio,Noruega,5,6,,11,-75.42726,6.170465
26128,2014,Junio,Nueva Zelanda,0,1,,1,-76.532004,3.451668
26129,2014,Junio,Nueva Zelanda,4,4,,8,-74.140516,4.697157
26130,2014,Junio,Nueva Zelanda,0,2,,2,-75.736374,4.815189
26131,2014,Junio,Omán,0,1,,1,-74.140516,4.697157
26132,2014,Junio,Papúa Nueva Guinea,0,1,,1,-74.140516,4.697157
26133,2014,Junio,Panamá,115,231,,346,-75.527794,10.406342
26134,2014,Junio,Panamá,1573,1781,,3354,-75.516486,10.446304
26135,2014,Junio,Panamá,201,448,,649,-74.77647900000001,10.886686
26136,2014,Junio,Panamá,1,45,,46,-74.765343,10.970933
26137,2014,Junio,Panamá,1,4,,5,-74.213989,11.247722999999999
26138,2014,Junio,Panamá,1321,1035,,2356,-81.70216500000001,12.5862
26139,2014,Junio,Panamá,0,10,,10,-81.372937,13.338761300000002
26140,2014,Junio,Panamá,625,911,,1536,-76.532004,3.451668
26141,2014,Junio,Panamá,0,29,,29,-77.061029,3.8844260000000004
26142,2014,Junio,Panamá,2170,3790,,5960,-74.140516,4.697157
26143,2014,Junio,Panamá,115,203,,318,-75.736374,4.815189
26144,2014,Junio,Panamá,504,1167,,1671,-75.42726,6.170465
26145,2014,Junio,Panamá,1,5,,6,-77.762647,7.102626
26146,2014,Junio,Panamá,55,87,,142,-73.181317,7.1280470000000005
26147,2014,Junio,Panamá,82,101,,183,-72.508188,7.927233
26148,2014,Junio,Panamá,0,10,,10,-76.7333,8.06667
26149,2014,Junio,Panamá,61,111,,172,-77.35002,8.63337
26150,2014,Junio,Paraguay,0,2,,2,-75.516486,10.446304
26151,2014,Junio,Paraguay,3,1,,4,-81.70216500000001,12.5862
26152,2014,Junio,Paraguay,4,2,,6,-76.532004,3.451668
26153,2014,Junio,Paraguay,27,40,,67,-74.140516,4.697157
26154,2014,Junio,Paraguay,2,14,,16,-75.42726,6.170465
26155,2014,Junio,Perú,151,251,,402,-69.941498,4.191162
26156,2014,Junio,Perú,7,32,,39,-77.35600000000001,0.81488
26157,2014,Junio,Perú,20,16,,36,-75.516486,10.446304
26158,2014,Junio,Perú,2,3,,5,-74.77647900000001,10.886686
26159,2014,Junio,Perú,73,47,,120,-81.70216500000001,12.5862
26160,2014,Junio,Perú,190,311,,501,-76.532004,3.451668
26161,2014,Junio,Perú,4061,6014,,10075,-74.140516,4.697157
26162,2014,Junio,Perú,1,1,,2,-75.736374,4.815189
26163,2014,Junio,Perú,275,538,,813,-75.42726,6.170465
26164,2014,Junio,Perú,1,1,,2,-73.181317,7.1280470000000005
26165,2014,Junio,Perú,0,4,,4,-72.508188,7.927233
26166,2014,Junio,Polonia,1,0,,1,-74.77647900000001,10.886686
26167,2014,Junio,Polonia,28,46,,74,-74.140516,4.697157
26168,2014,Junio,Polonia,1,0,,1,-75.42726,6.170465
26169,2014,Junio,Portugal,0,2,,2,-76.532004,3.451668
26170,2014,Junio,Portugal,30,62,,92,-74.140516,4.697157
26171,2014,Junio,Portugal,3,3,,6,-75.42726,6.170465
26172,2014,Junio,Puerto Rico/Territorio de Estados Unidos,0,1,,1,-75.527794,10.406342
26173,2014,Junio,Puerto Rico/Territorio de Estados Unidos,4,19,,23,-75.516486,10.446304
26174,2014,Junio,Puerto Rico/Territorio de Estados Unidos,5,15,,20,-74.77647900000001,10.886686
26175,2014,Junio,Puerto Rico/Territorio de Estados Unidos,0,1,,1,-81.70216500000001,12.5862
26176,2014,Junio,Puerto Rico/Territorio de Estados Unidos,15,27,,42,-76.532004,3.451668
26177,2014,Junio,Puerto Rico/Territorio de Estados Unidos,278,326,,604,-74.140516,4.697157
26178,2014,Junio,Puerto Rico/Territorio de Estados Unidos,29,24,,53,-75.736374,4.815189
26179,2014,Junio,Puerto Rico/Territorio de Estados Unidos,28,64,,92,-75.42726,6.170465
26180,2014,Junio,Puerto Rico/Territorio de Estados Unidos,0,1,,1,-73.181317,7.1280470000000005
26181,2014,Junio,Puerto Rico/Territorio de Estados Unidos,1,1,,2,-72.508188,7.927233
26182,2014,Junio,Reino Unido de Gran Bretaña e Irlanda del Norte,2,0,,2,-75.516486,10.446304
26183,2014,Junio,Reino Unido de Gran Bretaña e Irlanda del Norte,0,2,,2,-74.77647900000001,10.886686
26184,2014,Junio,Reino Unido de Gran Bretaña e Irlanda del Norte,0,2,,2,-74.213989,11.247722999999999
26185,2014,Junio,Reino Unido de Gran Bretaña e Irlanda del Norte,7,7,,14,-76.532004,3.451668
26186,2014,Junio,Reino Unido de Gran Bretaña e Irlanda del Norte,92,178,,270,-74.140516,4.697157
26187,2014,Junio,Reino Unido de Gran Bretaña e Irlanda del Norte,5,6,,11,-75.42726,6.170465
26188,2014,Junio,Reino Unido de Gran Bretaña e Irlanda del Norte,1,0,,1,-73.181317,7.1280470000000005
26189,2014,Junio,Federación de Rusia,1,0,,1,-74.77647900000001,10.886686
26190,2014,Junio,Federación de Rusia,16,19,,35,-74.140516,4.697157
26191,2014,Junio,Federación de Rusia,2,1,,3,-75.42726,6.170465
26192,2014,Junio,República Dominicana,24,20,,44,-75.527794,10.406342
26193,2014,Junio,República Dominicana,6,4,,10,-75.516486,10.446304
26194,2014,Junio,República Dominicana,1,18,,19,-74.77647900000001,10.886686
26195,2014,Junio,República Dominicana,2,4,,6,-74.213989,11.247722999999999
26196,2014,Junio,República Dominicana,21,24,,45,-76.532004,3.451668
26197,2014,Junio,República Dominicana,422,631,,1053,-74.140516,4.697157
26198,2014,Junio,República Dominicana,2,2,,4,-75.736374,4.815189
26199,2014,Junio,República Dominicana,22,22,,44,-75.42726,6.170465
26200,2014,Junio,República Dominicana,0,1,,1,-73.181317,7.1280470000000005
26201,2014,Junio,República Democrática Popular de Corea,0,1,,1,-74.140516,4.697157
26202,2014,Junio,Rumania,0,2,,2,-74.140516,4.697157
26203,2014,Junio,Senegal,2,0,,2,-74.140516,4.697157
26204,2014,Junio,Serbia,1,1,,2,-74.140516,4.697157
26205,2014,Junio,Singapur,5,1,,6,-74.140516,4.697157
26206,2014,Junio,República Árabe Siria,0,1,,1,-74.140516,4.697157
26207,2014,Junio,Sudáfrica,1,0,,1,-76.532004,3.451668
26208,2014,Junio,Sudáfrica,1,6,,7,-74.140516,4.697157
26209,2014,Junio,Sudán,1,0,,1,-74.140516,4.697157
26210,2014,Junio,Sudán,0,1,,1,-75.42726,6.170465
26211,2014,Junio,Suecia,1,0,,1,-74.77647900000001,10.886686
26212,2014,Junio,Suecia,3,4,,7,-76.532004,3.451668
26213,2014,Junio,Suecia,28,25,,53,-74.140516,4.697157
26214,2014,Junio,Suecia,2,3,,5,-75.42726,6.170465
26215,2014,Junio,Suiza,0,4,,4,-75.516486,10.446304
26216,2014,Junio,Suiza,0,2,,2,-74.77647900000001,10.886686
26217,2014,Junio,Suiza,6,2,,8,-76.532004,3.451668
26218,2014,Junio,Suiza,57,92,,149,-74.140516,4.697157
26219,2014,Junio,Suiza,7,4,,11,-75.42726,6.170465
26220,2014,Junio,Surinam,0,3,,3,-75.527794,10.406342
26221,2014,Junio,Surinam,2,4,,6,-74.140516,4.697157
26222,2014,Junio,Surinam,2,1,,3,-75.42726,6.170465
26223,2014,Junio,Taiwán,1,0,,1,-75.516486,10.446304
26224,2014,Junio,Taiwán,2,4,,6,-74.140516,4.697157
26225,2014,Junio,Taiwán,1,1,,2,-75.42726,6.170465
26226,2014,Junio,Tailandia,3,3,,6,-74.140516,4.697157
26227,2014,Junio,Trinidad y Tobago,0,32,,32,-75.527794,10.406342
26228,2014,Junio,Trinidad y Tobago,135,106,,241,-75.516486,10.446304
26229,2014,Junio,Trinidad y Tobago,0,3,,3,-74.77647900000001,10.886686
26230,2014,Junio,Trinidad y Tobago,0,19,,19,-74.213989,11.247722999999999
26231,2014,Junio,Trinidad y Tobago,1,0,,1,-76.532004,3.451668
26232,2014,Junio,Trinidad y Tobago,5,43,,48,-74.140516,4.697157
26233,2014,Junio,Trinidad y Tobago,0,4,,4,-75.42726,6.170465
26234,2014,Junio,Trinidad y Tobago,3,6,,9,-73.181317,7.1280470000000005
26235,2014,Junio,Túnez,1,1,,2,-74.140516,4.697157
26236,2014,Junio,Turquía,0,2,,2,-74.77647900000001,10.886686
26237,2014,Junio,Turquía,5,14,,19,-74.140516,4.697157
26238,2014,Junio,Ucrania,1,3,,4,-74.140516,4.697157
26239,2014,Junio,Uruguay,1,1,,2,-77.35600000000001,0.81488
26240,2014,Junio,Uruguay,15,11,,26,-75.516486,10.446304
26241,2014,Junio,Uruguay,0,1,,1,-74.77647900000001,10.886686
26242,2014,Junio,Uruguay,4,6,,10,-81.70216500000001,12.5862
26243,2014,Junio,Uruguay,3,3,,6,-76.532004,3.451668
26244,2014,Junio,Uruguay,36,75,,111,-74.140516,4.697157
26245,2014,Junio,Uruguay,14,29,,43,-75.42726,6.170465
26246,2014,Junio,Vanuatu,1,1,,2,-74.140516,4.697157
26247,2014,Junio,Venezuela,0,18,,18,-75.527794,10.406342
26248,2014,Junio,Venezuela,4,10,,14,-75.516486,10.446304
26249,2014,Junio,Venezuela,20,56,,76,-74.77647900000001,10.886686
26250,2014,Junio,Venezuela,0,2,,2,-74.765343,10.970933
26251,2014,Junio,Venezuela,1,2,,3,-74.232675,11.117206
26252,2014,Junio,Venezuela,1189,1867,,3056,-72.129595,11.360028999999999
26253,2014,Junio,Venezuela,9,18,,27,-76.532004,3.451668
26254,2014,Junio,Venezuela,4483,5441,,9924,-74.140516,4.697157
26255,2014,Junio,Venezuela,1,1,,2,-75.736374,4.815189
26256,2014,Junio,Venezuela,64,104,,168,-75.42726,6.170465
26257,2014,Junio,Venezuela,35,51,,86,-67.48402800000001,6.185536
26258,2014,Junio,Venezuela,82,169,,251,-70.74025300000001,7.088728999999999
26259,2014,Junio,Venezuela,4,12,,16,-73.181317,7.1280470000000005
26260,2014,Junio,Venezuela,1494,2076,,3570,-72.453013,7.819
26261,2014,Junio,Venezuela,156,172,,328,-72.508188,7.927233
26262,2014,Junio,Vietnam,0,1,,1,-74.140516,4.697157
26263,2014,Junio,Zambia,2,0,,2,-76.532004,3.451668
26264,2014,Junio,Zimbabue,0,1,,1,-74.140516,4.697157
26265,2014,Junio,Islas Turcas y Caicos/Territorio Británico de Ultramar,0,1,,1,-74.77647900000001,10.886686
26266,2014,Junio,Desconocido,0,1,,1,-74.140516,4.697157
26267,2014,Junio,Desconocido,6,14,,20,-77.35002,8.63337
26268,2014,Julio,Afganistán,0,1,,1,-74.140516,4.697157
26269,2014,Julio,Afganistán,0,1,,1,-75.42726,6.170465
26270,2014,Julio,Alemania,2,3,,5,-75.516486,10.446304
26271,2014,Julio,Alemania,5,3,,8,-74.77647900000001,10.886686
26272,2014,Julio,Alemania,0,1,,1,-74.765343,10.970933
26273,2014,Julio,Alemania,17,12,,29,-76.532004,3.451668
26274,2014,Julio,Alemania,1666,2309,,3975,-74.140516,4.697157
26275,2014,Julio,Alemania,0,1,,1,-75.736374,4.815189
26276,2014,Julio,Alemania,12,25,,37,-75.42726,6.170465
26277,2014,Julio,Andorra,1,1,,2,-74.140516,4.697157
26278,2014,Julio,Antigua y Barbuda,0,3,,3,-75.527794,10.406342
26279,2014,Julio,Países Bajos,21,14,,35,-75.527794,10.406342
26280,2014,Julio,Países Bajos,1,2,,3,-75.516486,10.446304
26281,2014,Julio,Países Bajos,2,7,,9,-74.77647900000001,10.886686
26282,2014,Julio,Países Bajos,1,1,,2,-74.213989,11.247722999999999
26283,2014,Julio,Países Bajos,6,8,,14,-76.532004,3.451668
26284,2014,Julio,Países Bajos,89,129,,218,-74.140516,4.697157
26285,2014,Julio,Países Bajos,2,4,,6,-75.736374,4.815189
26286,2014,Julio,Países Bajos,43,66,,109,-75.42726,6.170465
26287,2014,Julio,Países Bajos,5,4,,9,-73.181317,7.1280470000000005
26288,2014,Julio,Arabia Saudita,1,3,,4,-74.140516,4.697157
26289,2014,Julio,Argelia,3,8,,11,-74.140516,4.697157
26290,2014,Julio,Argelia,0,1,,1,-75.42726,6.170465
26291,2014,Julio,Argentina,2,0,,2,-77.35600000000001,0.81488
26292,2014,Julio,Argentina,0,18,,18,-75.527794,10.406342
26293,2014,Julio,Argentina,66,60,,126,-75.516486,10.446304
26294,2014,Julio,Argentina,10,14,,24,-74.77647900000001,10.886686
26295,2014,Julio,Argentina,23,14,,37,-81.70216500000001,12.5862
26296,2014,Julio,Argentina,36,51,,87,-76.532004,3.451668
26297,2014,Julio,Argentina,0,10,,10,-77.061029,3.8844260000000004
26298,2014,Julio,Argentina,2252,2743,,4995,-74.140516,4.697157
26299,2014,Julio,Argentina,3,3,,6,-75.736374,4.815189
26300,2014,Julio,Argentina,74,138,,212,-75.42726,6.170465
26301,2014,Julio,Aruba,62,57,,119,-75.527794,10.406342
26302,2014,Julio,Aruba,0,1,,1,-75.516486,10.446304
26303,2014,Julio,Aruba,2,5,,7,-74.77647900000001,10.886686
26304,2014,Julio,Aruba,4,9,,13,-74.213989,11.247722999999999
26305,2014,Julio,Aruba,6,4,,10,-76.532004,3.451668
26306,2014,Julio,Aruba,888,967,,1855,-74.140516,4.697157
26307,2014,Julio,Aruba,2,1,,3,-75.736374,4.815189
26308,2014,Julio,Aruba,2,9,,11,-75.42726,6.170465
26309,2014,Julio,Aruba,4,2,,6,-73.181317,7.1280470000000005
26310,2014,Julio,Australia,4,5,,9,-75.516486,10.446304
26311,2014,Julio,Australia,2,0,,2,-74.77647900000001,10.886686
26312,2014,Julio,Australia,1,3,,4,-76.532004,3.451668
26313,2014,Julio,Australia,24,25,,49,-74.140516,4.697157
26314,2014,Julio,Australia,11,16,,27,-75.42726,6.170465
26315,2014,Julio,Austria,0,1,,1,-74.77647900000001,10.886686
26316,2014,Julio,Austria,2,2,,4,-76.532004,3.451668
26317,2014,Julio,Austria,32,30,,62,-74.140516,4.697157
26318,2014,Julio,Austria,0,2,,2,-75.42726,6.170465
26319,2014,Julio,Bahamas,0,2,,2,-75.516486,10.446304
26320,2014,Julio,Bahamas,0,1,,1,-81.70216500000001,12.5862
26321,2014,Julio,Bahamas,2,6,,8,-74.140516,4.697157
26322,2014,Julio,Bahamas,0,2,,2,-75.42726,6.170465
26323,2014,Julio,Bahréin,1,0,,1,-75.516486,10.446304
26324,2014,Julio,Barbados,0,2,,2,-75.516486,10.446304
26325,2014,Julio,Barbados,1,0,,1,-75.42726,6.170465
26326,2014,Julio,Barbados,1,0,,1,-73.181317,7.1280470000000005
26327,2014,Julio,República de Belarús,1,2,,3,-72.129595,11.360028999999999
26328,2014,Julio,República de Belarús,1,1,,2,-74.140516,4.697157
26329,2014,Julio,Bélgica,0,6,,6,-74.77647900000001,10.886686
26330,2014,Julio,Bélgica,0,2,,2,-74.213989,11.247722999999999
26331,2014,Julio,Bélgica,1,6,,7,-76.532004,3.451668
26332,2014,Julio,Bélgica,52,56,,108,-74.140516,4.697157
26333,2014,Julio,Bélgica,3,11,,14,-75.42726,6.170465
26334,2014,Julio,Belice,0,1,,1,-76.532004,3.451668
26335,2014,Julio,Belice,1,4,,5,-74.140516,4.697157
26336,2014,Julio,Bermudas/Territorio Británico de Ultramar,1,3,,4,-75.516486,10.446304
26337,2014,Julio,Bolivia,5,2,,7,-75.516486,10.446304
26338,2014,Julio,Bolivia,0,2,,2,-74.77647900000001,10.886686
26339,2014,Julio,Bolivia,5,3,,8,-76.532004,3.451668
26340,2014,Julio,Bolivia,385,503,,888,-74.140516,4.697157
26341,2014,Julio,Bolivia,11,19,,30,-75.42726,6.170465
26342,2014,Julio,Botsuana,0,2,,2,-74.140516,4.697157
26343,2014,Julio,Brasil,151,252,,403,-69.941498,4.191162
26344,2014,Julio,Brasil,4,13,,17,-69.94143100000001,4.214082
26345,2014,Julio,Brasil,0,6,,6,-75.527794,10.406342
26346,2014,Julio,Brasil,93,62,,155,-75.516486,10.446304
26347,2014,Julio,Brasil,8,29,,37,-74.77647900000001,10.886686
26348,2014,Julio,Brasil,46,46,,92,-81.70216500000001,12.5862
26349,2014,Julio,Brasil,15,46,,61,-76.532004,3.451668
26350,2014,Julio,Brasil,3079,4811,,7890,-74.140516,4.697157
26351,2014,Julio,Brasil,5,3,,8,-75.736374,4.815189
26352,2014,Julio,Brasil,102,189,,291,-75.42726,6.170465
26353,2014,Julio,Brasil,0,1,,1,-73.181317,7.1280470000000005
26354,2014,Julio,Brasil,1,1,,2,-72.508188,7.927233
26355,2014,Julio,Brunei Darussalam,0,1,,1,-74.140516,4.697157
26356,2014,Julio,Bulgaria,2,1,,3,-74.140516,4.697157
26357,2014,Julio,Burkina Faso,0,1,,1,-74.140516,4.697157
26358,2014,Julio,Islas Caimán/Territorio Británico de Ultramar,0,3,,3,-81.70216500000001,12.5862
26359,2014,Julio,Islas Caimán/Territorio Británico de Ultramar,0,2,,2,-81.372937,13.338761300000002
26360,2014,Julio,Islas Caimán/Territorio Británico de Ultramar,0,1,,1,-74.140516,4.697157
26361,2014,Julio,Camerún,0,1,,1,-74.140516,4.697157
26362,2014,Julio,Canadá,0,19,,19,-75.527794,10.406342
26363,2014,Julio,Canadá,4,8,,12,-75.516486,10.446304
26364,2014,Julio,Canadá,2,5,,7,-74.77647900000001,10.886686
26365,2014,Julio,Canadá,3,0,,3,-81.70216500000001,12.5862
26366,2014,Julio,Canadá,16,28,,44,-76.532004,3.451668
26367,2014,Julio,Canadá,735,1130,,1865,-74.140516,4.697157
26368,2014,Julio,Canadá,3,5,,8,-75.736374,4.815189
26369,2014,Julio,Canadá,99,111,,210,-75.42726,6.170465
26370,2014,Julio,Canadá,0,5,,5,-73.181317,7.1280470000000005
26371,2014,Julio,Canadá,0,1,,1,-72.508188,7.927233
26372,2014,Julio,España,0,3,,3,-75.527794,10.406342
26373,2014,Julio,España,2,4,,6,-75.516486,10.446304
26374,2014,Julio,España,0,2,,2,-74.77647900000001,10.886686
26375,2014,Julio,España,292,401,,693,-76.532004,3.451668
26376,2014,Julio,España,2635,4550,,7185,-74.140516,4.697157
26377,2014,Julio,España,0,3,,3,-75.736374,4.815189
26378,2014,Julio,España,198,352,,550,-75.42726,6.170465
26379,2014,Julio,España,1,0,,1,-73.181317,7.1280470000000005
26380,2014,Julio,España,0,1,,1,-72.508188,7.927233
26381,2014,Julio,Comoras,1,1,,2,-74.140516,4.697157
26382,2014,Julio,República de Corea,11,12,,23,-74.140516,4.697157
26383,2014,Julio,República de Corea,2,5,,7,-75.42726,6.170465
26384,2014,Julio,Costa de Marfil,0,6,,6,-74.140516,4.697157
26385,2014,Julio,Costa Rica,9,17,,26,-75.516486,10.446304
26386,2014,Julio,Costa Rica,9,17,,26,-74.77647900000001,10.886686
26387,2014,Julio,Costa Rica,0,6,,6,-74.213989,11.247722999999999
26388,2014,Julio,Costa Rica,6,7,,13,-81.70216500000001,12.5862
26389,2014,Julio,Costa Rica,4,13,,17,-76.532004,3.451668
26390,2014,Julio,Costa Rica,0,3,,3,-77.061029,3.8844260000000004
26391,2014,Julio,Costa Rica,583,1016,,1599,-74.140516,4.697157
26392,2014,Julio,Costa Rica,7,13,,20,-75.736374,4.815189
26393,2014,Julio,Costa Rica,58,71,,129,-75.42726,6.170465
26394,2014,Julio,Costa Rica,0,1,,1,-73.181317,7.1280470000000005
26395,2014,Julio,Costa Rica,0,1,,1,-72.508188,7.927233
26396,2014,Julio,Costa Rica,0,2,,2,-76.7333,8.06667
26397,2014,Julio,Croacia,0,1,,1,-75.516486,10.446304
26398,2014,Julio,Croacia,0,1,,1,-74.77647900000001,10.886686
26399,2014,Julio,Croacia,2,4,,6,-74.140516,4.697157
26400,2014,Julio,Cuba,9,4,,13,-75.516486,10.446304
26401,2014,Julio,Cuba,7,6,,13,-74.77647900000001,10.886686
26402,2014,Julio,Cuba,12,11,,23,-76.532004,3.451668
26403,2014,Julio,Cuba,190,316,,506,-74.140516,4.697157
26404,2014,Julio,Cuba,0,1,,1,-75.736374,4.815189
26405,2014,Julio,Cuba,11,7,,18,-75.42726,6.170465
26406,2014,Julio,Cuba,0,1,,1,-73.181317,7.1280470000000005
26407,2014,Julio,Cuba,1,1,,2,-72.508188,7.927233
26408,2014,Julio,Curazao,1,1,,2,-75.527794,10.406342
26409,2014,Julio,Curazao,77,76,,153,-74.77647900000001,10.886686
26410,2014,Julio,Curazao,4,9,,13,-74.213989,11.247722999999999
26411,2014,Julio,Curazao,1,3,,4,-76.532004,3.451668
26412,2014,Julio,Curazao,237,328,,565,-74.140516,4.697157
26413,2014,Julio,Curazao,243,269,,512,-75.42726,6.170465
26414,2014,Julio,República Checa,0,1,,1,-75.516486,10.446304
26415,2014,Julio,República Checa,7,4,,11,-74.140516,4.697157
26416,2014,Julio,Chile,11,9,,20,-75.516486,10.446304
26417,2014,Julio,Chile,6,6,,12,-74.77647900000001,10.886686
26418,2014,Julio,Chile,23,24,,47,-81.70216500000001,12.5862
26419,2014,Julio,Chile,28,35,,63,-76.532004,3.451668
26420,2014,Julio,Chile,3526,4367,,7893,-74.140516,4.697157
26421,2014,Julio,Chile,1,1,,2,-75.736374,4.815189
26422,2014,Julio,Chile,30,89,,119,-75.42726,6.170465
26423,2014,Julio,China,1,0,,1,-75.516486,10.446304
26424,2014,Julio,China,1,0,,1,-74.77647900000001,10.886686
26425,2014,Julio,China,1,1,,2,-76.532004,3.451668
26426,2014,Julio,China,30,79,,109,-74.140516,4.697157
26427,2014,Julio,China,1,2,,3,-75.42726,6.170465
26428,2014,Julio,Dinamarca,1,0,,1,-81.70216500000001,12.5862
26429,2014,Julio,Dinamarca,1,2,,3,-76.532004,3.451668
26430,2014,Julio,Dinamarca,8,9,,17,-74.140516,4.697157
26431,2014,Julio,Dinamarca,3,2,,5,-75.42726,6.170465
26432,2014,Julio,Dominica,1,0,,1,-76.532004,3.451668
26433,2014,Julio,Ecuador,72,127,,199,-76.876446,0.33002
26434,2014,Julio,Ecuador,3148,4243,,7391,-77.35600000000001,0.81488
26435,2014,Julio,Ecuador,6,260,,266,-78.802679,18.00143
26436,2014,Julio,Ecuador,0,10,,10,-75.527794,10.406342
26437,2014,Julio,Ecuador,51,29,,80,-75.516486,10.446304
26438,2014,Julio,Ecuador,3,8,,11,-74.77647900000001,10.886686
26439,2014,Julio,Ecuador,2,2,,4,-81.70216500000001,12.5862
26440,2014,Julio,Ecuador,618,758,,1376,-76.532004,3.451668
26441,2014,Julio,Ecuador,0,5,,5,-77.061029,3.8844260000000004
26442,2014,Julio,Ecuador,2942,4534,,7476,-74.140516,4.697157
26443,2014,Julio,Ecuador,0,3,,3,-75.736374,4.815189
26444,2014,Julio,Ecuador,581,642,,1223,-75.42726,6.170465
26445,2014,Julio,Ecuador,2,2,,4,-72.508188,7.927233
26446,2014,Julio,Egipto,0,2,,2,-75.527794,10.406342
26447,2014,Julio,Egipto,3,2,,5,-74.140516,4.697157
26448,2014,Julio,El Salvador,2,5,,7,-75.516486,10.446304
26449,2014,Julio,El Salvador,1,2,,3,-74.77647900000001,10.886686
26450,2014,Julio,El Salvador,106,159,,265,-76.532004,3.451668
26451,2014,Julio,El Salvador,746,1178,,1924,-74.140516,4.697157
26452,2014,Julio,El Salvador,1,0,,1,-75.736374,4.815189
26453,2014,Julio,El Salvador,123,231,,354,-75.42726,6.170465
26454,2014,Julio,Emiratos Árabes,4,4,,8,-74.140516,4.697157
26455,2014,Julio,Eritrea,0,2,,2,-74.140516,4.697157
26456,2014,Julio,Eslovaquia,2,2,,4,-74.140516,4.697157
26457,2014,Julio,Eslovenia,4,3,,7,-74.140516,4.697157
26458,2014,Julio,Eslovenia,0,1,,1,-75.42726,6.170465
26459,2014,Julio,Estados Unidos de América,1,18,,19,-75.527794,10.406342
26460,2014,Julio,Estados Unidos de América,1804,2664,,4468,-75.516486,10.446304
26461,2014,Julio,Estados Unidos de América,448,622,,1070,-74.77647900000001,10.886686
26462,2014,Julio,Estados Unidos de América,0,1,,1,-74.765343,10.970933
26463,2014,Julio,Estados Unidos de América,0,4,,4,-74.213989,11.247722999999999
26464,2014,Julio,Estados Unidos de América,14,22,,36,-81.70216500000001,12.5862
26465,2014,Julio,Estados Unidos de América,1385,1751,,3136,-76.532004,3.451668
26466,2014,Julio,Estados Unidos de América,0,3,,3,-77.061029,3.8844260000000004
26467,2014,Julio,Estados Unidos de América,197,198,,395,-75.76635300000001,4.45285
26468,2014,Julio,Estados Unidos de América,10238,16690,,26928,-74.140516,4.697157
26469,2014,Julio,Estados Unidos de América,188,183,,371,-75.736374,4.815189
26470,2014,Julio,Estados Unidos de América,2694,4564,,7258,-75.42726,6.170465
26471,2014,Julio,Estados Unidos de América,32,31,,63,-73.181317,7.1280470000000005
26472,2014,Julio,Estados Unidos de América,26,37,,63,-72.508188,7.927233
26473,2014,Julio,Estados Unidos de América,0,14,,14,-75.68164200000001,9.402597
26474,2014,Julio,Estonia,1,1,,2,-76.532004,3.451668
26475,2014,Julio,Estonia,2,0,,2,-74.140516,4.697157
26476,2014,Julio,Etiopia,0,1,,1,-74.140516,4.697157
26477,2014,Julio,Islas Fiji,0,1,,1,-74.140516,4.697157
26478,2014,Julio,Filipinas,0,1,,1,-75.516486,10.446304
26479,2014,Julio,Filipinas,0,3,,3,-74.77647900000001,10.886686
26480,2014,Julio,Filipinas,0,3,,3,-76.532004,3.451668
26481,2014,Julio,Filipinas,1,3,,4,-74.140516,4.697157
26482,2014,Julio,Finlandia,1,1,,2,-75.516486,10.446304
26483,2014,Julio,Finlandia,1,1,,2,-74.77647900000001,10.886686
26484,2014,Julio,Finlandia,0,4,,4,-77.061029,3.8844260000000004
26485,2014,Julio,Finlandia,4,1,,5,-74.140516,4.697157
26486,2014,Julio,Finlandia,0,1,,1,-75.42726,6.170465
26487,2014,Julio,Francia,2,4,,6,-75.516486,10.446304
26488,2014,Julio,Francia,7,10,,17,-74.77647900000001,10.886686
26489,2014,Julio,Francia,10,16,,26,-76.532004,3.451668
26490,2014,Julio,Francia,1474,2399,,3873,-74.140516,4.697157
26491,2014,Julio,Francia,3,2,,5,-75.736374,4.815189
26492,2014,Julio,Francia,11,29,,40,-75.42726,6.170465
26493,2014,Julio,Francia,2,3,,5,-73.181317,7.1280470000000005
26494,2014,Julio,Gabón,0,1,,1,-74.140516,4.697157
26495,2014,Julio,Georgia,0,1,,1,-76.532004,3.451668
26496,2014,Julio,Georgia,3,0,,3,-74.140516,4.697157
26497,2014,Julio,Granada,2,1,,3,-74.140516,4.697157
26498,2014,Julio,Grecia,7,13,,20,-74.140516,4.697157
26499,2014,Julio,Guatemala,5,6,,11,-75.516486,10.446304
26500,2014,Julio,Guatemala,4,7,,11,-74.77647900000001,10.886686
26501,2014,Julio,Guatemala,3,0,,3,-81.70216500000001,12.5862
26502,2014,Julio,Guatemala,11,31,,42,-76.532004,3.451668
26503,2014,Julio,Guatemala,187,342,,529,-74.140516,4.697157
26504,2014,Julio,Guatemala,0,5,,5,-75.736374,4.815189
26505,2014,Julio,Guatemala,22,32,,54,-75.42726,6.170465
26506,2014,Julio,Guatemala,0,1,,1,-72.508188,7.927233
26507,2014,Julio,Guyana,2,3,,5,-74.140516,4.697157
26508,2014,Julio,Guinea,2,0,,2,-74.140516,4.697157
26509,2014,Julio,Guinea Ecuatorial,0,1,,1,-74.140516,4.697157
26510,2014,Julio,Guadalupe/Territorio Francés,0,1,,1,-74.77647900000001,10.886686
26511,2014,Julio,Guadalupe/Territorio Francés,3,4,,7,-74.140516,4.697157
26512,2014,Julio,Guayana Francesa/Departamento de Ultramar Francés,0,1,,1,-74.140516,4.697157
26513,2014,Julio,Guayana Francesa/Departamento de Ultramar Francés,1,0,,1,-75.42726,6.170465
26514,2014,Julio,Haití,0,11,,11,-75.527794,10.406342
26515,2014,Julio,Haití,0,1,,1,-75.516486,10.446304
26516,2014,Julio,Haití,1,0,,1,-76.532004,3.451668
26517,2014,Julio,Haití,0,9,,9,-74.140516,4.697157
26518,2014,Julio,Haití,0,1,,1,-75.736374,4.815189
26519,2014,Julio,Haití,2,0,,2,-75.42726,6.170465
26520,2014,Julio,Honduras,1,4,,5,-75.516486,10.446304
26521,2014,Julio,Honduras,1,2,,3,-74.77647900000001,10.886686
26522,2014,Julio,Honduras,1,1,,2,-81.70216500000001,12.5862
26523,2014,Julio,Honduras,1,2,,3,-76.532004,3.451668
26524,2014,Julio,Honduras,27,61,,88,-74.140516,4.697157
26525,2014,Julio,Honduras,2,3,,5,-75.736374,4.815189
26526,2014,Julio,Honduras,20,16,,36,-75.42726,6.170465
26527,2014,Julio,Honduras,0,1,,1,-72.508188,7.927233
26528,2014,Julio,Hong Kong,1,0,,1,-75.516486,10.446304
26529,2014,Julio,Hong Kong,4,1,,5,-74.140516,4.697157
26530,2014,Julio,Hungría,2,1,,3,-75.516486,10.446304
26531,2014,Julio,Hungría,4,4,,8,-74.140516,4.697157
26532,2014,Julio,India,0,1,,1,-74.77647900000001,10.886686
26533,2014,Julio,India,0,2,,2,-76.532004,3.451668
26534,2014,Julio,India,5,24,,29,-74.140516,4.697157
26535,2014,Julio,India,0,2,,2,-75.736374,4.815189
26536,2014,Julio,India,1,1,,2,-75.42726,6.170465
26537,2014,Julio,Indonesia,0,1,,1,-76.532004,3.451668
26538,2014,Julio,República de Irlanda,1,0,,1,-75.516486,10.446304
26539,2014,Julio,República de Irlanda,12,12,,24,-74.140516,4.697157
26540,2014,Julio,República de Irlanda,0,1,,1,-75.42726,6.170465
26541,2014,Julio,Israel,0,1,,1,-75.516486,10.446304
26542,2014,Julio,Israel,0,1,,1,-74.77647900000001,10.886686
26543,2014,Julio,Israel,0,1,,1,-76.532004,3.451668
26544,2014,Julio,Israel,18,45,,63,-74.140516,4.697157
26545,2014,Julio,Israel,0,1,,1,-75.42726,6.170465
26546,2014,Julio,Islas Aland/Provincia de Finlandia,0,1,,1,-74.140516,4.697157
26547,2014,Julio,Italia,0,5,,5,-75.516486,10.446304
26548,2014,Julio,Italia,3,5,,8,-74.77647900000001,10.886686
26549,2014,Julio,Italia,2,9,,11,-76.532004,3.451668
26550,2014,Julio,Italia,81,165,,246,-74.140516,4.697157
26551,2014,Julio,Italia,7,15,,22,-75.42726,6.170465
26552,2014,Julio,Jamaica,0,1,,1,-75.527794,10.406342
26553,2014,Julio,Jamaica,1,5,,6,-75.516486,10.446304
26554,2014,Julio,Jamaica,0,2,,2,-74.77647900000001,10.886686
26555,2014,Julio,Jamaica,0,1,,1,-74.232675,11.117206
26556,2014,Julio,Jamaica,1,1,,2,-76.532004,3.451668
26557,2014,Julio,Jamaica,3,17,,20,-74.140516,4.697157
26558,2014,Julio,Jamaica,2,0,,2,-75.42726,6.170465
26559,2014,Julio,Jamaica,2,1,,3,-73.181317,7.1280470000000005
26560,2014,Julio,Japón,0,1,,1,-74.77647900000001,10.886686
26561,2014,Julio,Japón,0,2,,2,-76.532004,3.451668
26562,2014,Julio,Japón,59,216,,275,-74.140516,4.697157
26563,2014,Julio,Japón,0,1,,1,-75.736374,4.815189
26564,2014,Julio,Japón,3,1,,4,-75.42726,6.170465
26565,2014,Julio,Jordania,0,1,,1,-74.140516,4.697157
26566,2014,Julio,Kenia,0,1,,1,-74.140516,4.697157
26567,2014,Julio,República Democrática Popular  Lao,2,0,,2,-74.140516,4.697157
26568,2014,Julio,Letonia,0,1,,1,-74.77647900000001,10.886686
26569,2014,Julio,Letonia,2,3,,5,-74.140516,4.697157
26570,2014,Julio,Lituania,2,1,,3,-74.140516,4.697157
26571,2014,Julio,Líbano,4,4,,8,-74.140516,4.697157
26572,2014,Julio,Luxemburgo,4,1,,5,-74.140516,4.697157
26573,2014,Julio,Malasia,0,3,,3,-74.140516,4.697157
26574,2014,Julio,Malasia,0,1,,1,-75.42726,6.170465
26575,2014,Julio,Malta,1,1,,2,-74.140516,4.697157
26576,2014,Julio,Marruecos,0,1,,1,-74.213989,11.247722999999999
26577,2014,Julio,Marruecos,0,1,,1,-74.140516,4.697157
26578,2014,Julio,Mauritania,0,1,,1,-74.140516,4.697157
26579,2014,Julio,México,0,1,,1,-75.527794,10.406342
26580,2014,Julio,México,31,48,,79,-75.516486,10.446304
26581,2014,Julio,México,27,38,,65,-74.77647900000001,10.886686
26582,2014,Julio,México,5,8,,13,-81.70216500000001,12.5862
26583,2014,Julio,México,36,45,,81,-76.532004,3.451668
26584,2014,Julio,México,4500,7360,,11860,-74.140516,4.697157
26585,2014,Julio,México,15,20,,35,-75.736374,4.815189
26586,2014,Julio,México,162,238,,400,-75.42726,6.170465
26587,2014,Julio,México,5,4,,9,-73.181317,7.1280470000000005
26588,2014,Julio,México,5,7,,12,-72.508188,7.927233
26589,2014,Julio,Mónaco,0,10,,10,-74.140516,4.697157
26590,2014,Julio,Nicaragua,3,0,,3,-75.516486,10.446304
26591,2014,Julio,Nicaragua,1,1,,2,-74.77647900000001,10.886686
26592,2014,Julio,Nicaragua,0,1,,1,-81.70216500000001,12.5862
26593,2014,Julio,Nicaragua,2,3,,5,-76.532004,3.451668
26594,2014,Julio,Nicaragua,24,21,,45,-74.140516,4.697157
26595,2014,Julio,Nicaragua,1,1,,2,-75.736374,4.815189
26596,2014,Julio,Nicaragua,12,9,,21,-75.42726,6.170465
26597,2014,Julio,Nigeria,10,9,,19,-76.532004,3.451668
26598,2014,Julio,Nigeria,2,2,,4,-74.140516,4.697157
26599,2014,Julio,Nigeria,0,1,,1,-75.42726,6.170465
26600,2014,Julio,Noruega,1,1,,2,-75.516486,10.446304
26601,2014,Julio,Noruega,0,1,,1,-74.77647900000001,10.886686
26602,2014,Julio,Noruega,15,23,,38,-74.140516,4.697157
26603,2014,Julio,Noruega,1,1,,2,-75.42726,6.170465
26604,2014,Julio,Nueva Zelanda,1,0,,1,-75.516486,10.446304
26605,2014,Julio,Nueva Zelanda,0,1,,1,-76.532004,3.451668
26606,2014,Julio,Nueva Zelanda,2,8,,10,-74.140516,4.697157
26607,2014,Julio,Nueva Zelanda,0,1,,1,-75.42726,6.170465
26608,2014,Julio,Omán,1,0,,1,-74.140516,4.697157
26609,2014,Julio,Papúa Nueva Guinea,0,1,,1,-74.140516,4.697157
26610,2014,Julio,Panamá,443,507,,950,-75.527794,10.406342
26611,2014,Julio,Panamá,1730,2129,,3859,-75.516486,10.446304
26612,2014,Julio,Panamá,231,425,,656,-74.77647900000001,10.886686
26613,2014,Julio,Panamá,1,17,,18,-74.765343,10.970933
26614,2014,Julio,Panamá,889,793,,1682,-81.70216500000001,12.5862
26615,2014,Julio,Panamá,5,7,,12,-81.372937,13.338761300000002
26616,2014,Julio,Panamá,629,936,,1565,-76.532004,3.451668
26617,2014,Julio,Panamá,0,33,,33,-77.061029,3.8844260000000004
26618,2014,Julio,Panamá,2344,4333,,6677,-74.140516,4.697157
26619,2014,Julio,Panamá,171,171,,342,-75.736374,4.815189
26620,2014,Julio,Panamá,905,1709,,2614,-75.42726,6.170465
26621,2014,Julio,Panamá,4,4,,8,-77.762647,7.102626
26622,2014,Julio,Panamá,55,82,,137,-73.181317,7.1280470000000005
26623,2014,Julio,Panamá,89,134,,223,-72.508188,7.927233
26624,2014,Julio,Panamá,0,2,,2,-76.7333,8.06667
26625,2014,Julio,Paraguay,2,2,,4,-75.516486,10.446304
26626,2014,Julio,Paraguay,1,4,,5,-74.77647900000001,10.886686
26627,2014,Julio,Paraguay,5,2,,7,-81.70216500000001,12.5862
26628,2014,Julio,Paraguay,4,4,,8,-76.532004,3.451668
26629,2014,Julio,Paraguay,12,39,,51,-74.140516,4.697157
26630,2014,Julio,Paraguay,33,18,,51,-75.42726,6.170465
26631,2014,Julio,Perú,210,310,,520,-69.941498,4.191162
26632,2014,Julio,Perú,27,52,,79,-69.94143100000001,4.214082
26633,2014,Julio,Perú,1,4,,5,-76.876446,0.33002
26634,2014,Julio,Perú,5,8,,13,-77.35600000000001,0.81488
26635,2014,Julio,Perú,26,28,,54,-75.516486,10.446304
26636,2014,Julio,Perú,8,14,,22,-74.77647900000001,10.886686
26637,2014,Julio,Perú,51,19,,70,-81.70216500000001,12.5862
26638,2014,Julio,Perú,304,417,,721,-76.532004,3.451668
26639,2014,Julio,Perú,6334,8132,,14466,-74.140516,4.697157
26640,2014,Julio,Perú,2,3,,5,-75.736374,4.815189
26641,2014,Julio,Perú,536,650,,1186,-75.42726,6.170465
26642,2014,Julio,Perú,1,2,,3,-73.181317,7.1280470000000005
26643,2014,Julio,Perú,2,0,,2,-72.508188,7.927233
26644,2014,Julio,Polonia,1,1,,2,-74.77647900000001,10.886686
26645,2014,Julio,Polonia,1,0,,1,-76.532004,3.451668
26646,2014,Julio,Polonia,20,14,,34,-74.140516,4.697157
26647,2014,Julio,Polonia,1,0,,1,-75.42726,6.170465
26648,2014,Julio,Portugal,2,2,,4,-76.532004,3.451668
26649,2014,Julio,Portugal,1007,1214,,2221,-74.140516,4.697157
26650,2014,Julio,Portugal,10,17,,27,-75.42726,6.170465
26651,2014,Julio,Puerto Rico/Territorio de Estados Unidos,0,7,,7,-75.527794,10.406342
26652,2014,Julio,Puerto Rico/Territorio de Estados Unidos,3,31,,34,-75.516486,10.446304
26653,2014,Julio,Puerto Rico/Territorio de Estados Unidos,3,12,,15,-74.77647900000001,10.886686
26654,2014,Julio,Puerto Rico/Territorio de Estados Unidos,0,1,,1,-81.70216500000001,12.5862
26655,2014,Julio,Puerto Rico/Territorio de Estados Unidos,14,13,,27,-76.532004,3.451668
26656,2014,Julio,Puerto Rico/Territorio de Estados Unidos,339,395,,734,-74.140516,4.697157
26657,2014,Julio,Puerto Rico/Territorio de Estados Unidos,11,4,,15,-75.736374,4.815189
26658,2014,Julio,Puerto Rico/Territorio de Estados Unidos,20,62,,82,-75.42726,6.170465
26659,2014,Julio,Puerto Rico/Territorio de Estados Unidos,7,12,,19,-73.181317,7.1280470000000005
26660,2014,Julio,Puerto Rico/Territorio de Estados Unidos,1,1,,2,-72.508188,7.927233
26661,2014,Julio,Reino Unido de Gran Bretaña e Irlanda del Norte,4,2,,6,-75.516486,10.446304
26662,2014,Julio,Reino Unido de Gran Bretaña e Irlanda del Norte,1,1,,2,-74.77647900000001,10.886686
26663,2014,Julio,Reino Unido de Gran Bretaña e Irlanda del Norte,5,17,,22,-76.532004,3.451668
26664,2014,Julio,Reino Unido de Gran Bretaña e Irlanda del Norte,580,860,,1440,-74.140516,4.697157
26665,2014,Julio,Reino Unido de Gran Bretaña e Irlanda del Norte,13,11,,24,-75.42726,6.170465
26666,2014,Julio,Federación de Rusia,0,1,,1,-76.532004,3.451668
26667,2014,Julio,Federación de Rusia,19,19,,38,-74.140516,4.697157
26668,2014,Julio,Federación de Rusia,3,2,,5,-75.42726,6.170465
26669,2014,Julio,República Dominicana,1,15,,16,-75.527794,10.406342
26670,2014,Julio,República Dominicana,5,5,,10,-75.516486,10.446304
26671,2014,Julio,República Dominicana,6,21,,27,-74.77647900000001,10.886686
26672,2014,Julio,República Dominicana,0,1,,1,-81.70216500000001,12.5862
26673,2014,Julio,República Dominicana,17,14,,31,-76.532004,3.451668
26674,2014,Julio,República Dominicana,451,725,,1176,-74.140516,4.697157
26675,2014,Julio,República Dominicana,1,1,,2,-75.736374,4.815189
26676,2014,Julio,República Dominicana,47,33,,80,-75.42726,6.170465
26677,2014,Julio,República Dominicana,1,0,,1,-73.181317,7.1280470000000005
26678,2014,Julio,República Dominicana,0,1,,1,-72.508188,7.927233
26679,2014,Julio,Reunión,2,0,,2,-74.140516,4.697157
26680,2014,Julio,República Democrática Popular de Corea,0,1,,1,-74.140516,4.697157
26681,2014,Julio,Rumania,1,2,,3,-74.140516,4.697157
26682,2014,Julio,San  Vicente y las Granadinas,0,1,,1,-75.516486,10.446304
26683,2014,Julio,San  Vicente y las Granadinas,0,1,,1,-76.532004,3.451668
26684,2014,Julio,Serbia,1,0,,1,-74.140516,4.697157
26685,2014,Julio,Singapur,0,1,,1,-76.532004,3.451668
26686,2014,Julio,Singapur,0,2,,2,-74.140516,4.697157
26687,2014,Julio,Singapur,1,2,,3,-75.42726,6.170465
26688,2014,Julio,Sudáfrica,0,1,,1,-74.77647900000001,10.886686
26689,2014,Julio,Sudáfrica,6,9,,15,-74.140516,4.697157
26690,2014,Julio,Suecia,1,1,,2,-76.532004,3.451668
26691,2014,Julio,Suecia,24,31,,55,-74.140516,4.697157
26692,2014,Julio,Suecia,0,1,,1,-75.736374,4.815189
26693,2014,Julio,Suecia,4,2,,6,-75.42726,6.170465
26694,2014,Julio,Suecia,0,3,,3,-75.516486,10.446304
26695,2014,Julio,Suecia,0,1,,1,-74.77647900000001,10.886686
26696,2014,Julio,Suecia,1,0,,1,-81.70216500000001,12.5862
26697,2014,Julio,Suecia,5,3,,8,-76.532004,3.451668
26698,2014,Julio,Suecia,114,146,,260,-74.140516,4.697157
26699,2014,Julio,Suecia,6,10,,16,-75.42726,6.170465
26700,2014,Julio,Surinam,0,3,,3,-75.527794,10.406342
26701,2014,Julio,Surinam,15,11,,26,-74.140516,4.697157
26702,2014,Julio,Surinam,1,2,,3,-75.42726,6.170465
26703,2014,Julio,Taiwán,1,2,,3,-74.77647900000001,10.886686
26704,2014,Julio,Taiwán,6,3,,9,-74.140516,4.697157
26705,2014,Julio,Tailandia,1,0,,1,-75.516486,10.446304
26706,2014,Julio,Tailandia,0,1,,1,-74.77647900000001,10.886686
26707,2014,Julio,Tailandia,1,1,,2,-74.140516,4.697157
26708,2014,Julio,Trinidad y Tobago,0,1,,1,-75.527794,10.406342
26709,2014,Julio,Trinidad y Tobago,0,1,,1,-75.516486,10.446304
26710,2014,Julio,Trinidad y Tobago,0,1,,1,-74.77647900000001,10.886686
26711,2014,Julio,Trinidad y Tobago,0,1,,1,-74.213989,11.247722999999999
26712,2014,Julio,Trinidad y Tobago,9,6,,15,-76.532004,3.451668
26713,2014,Julio,Trinidad y Tobago,4,17,,21,-74.140516,4.697157
26714,2014,Julio,Trinidad y Tobago,2,1,,3,-75.736374,4.815189
26715,2014,Julio,Trinidad y Tobago,4,8,,12,-75.42726,6.170465
26716,2014,Julio,Trinidad y Tobago,2,1,,3,-73.181317,7.1280470000000005
26717,2014,Julio,Trinidad y Tobago,1,1,,2,-72.508188,7.927233
26718,2014,Julio,Túnez,0,1,,1,-74.140516,4.697157
26719,2014,Julio,Turquía,0,4,,4,-75.516486,10.446304
26720,2014,Julio,Turquía,1,0,,1,-74.77647900000001,10.886686
26721,2014,Julio,Turquía,0,1,,1,-74.765343,10.970933
26722,2014,Julio,Turquía,7,6,,13,-74.140516,4.697157
26723,2014,Julio,Turquía,2,4,,6,-75.42726,6.170465
26724,2014,Julio,Ucrania,4,4,,8,-74.140516,4.697157
26725,2014,Julio,Ucrania,0,1,,1,-75.42726,6.170465
26726,2014,Julio,Uganda,0,1,,1,-74.140516,4.697157
26727,2014,Julio,Uruguay,26,17,,43,-75.516486,10.446304
26728,2014,Julio,Uruguay,1,2,,3,-74.77647900000001,10.886686
26729,2014,Julio,Uruguay,13,16,,29,-81.70216500000001,12.5862
26730,2014,Julio,Uruguay,7,15,,22,-76.532004,3.451668
26731,2014,Julio,Uruguay,57,81,,138,-74.140516,4.697157
26732,2014,Julio,Uruguay,41,32,,73,-75.42726,6.170465
26733,2014,Julio,Venezuela,0,44,,44,-75.527794,10.406342
26734,2014,Julio,Venezuela,23,105,,128,-75.516486,10.446304
26735,2014,Julio,Venezuela,15,50,,65,-74.77647900000001,10.886686
26736,2014,Julio,Venezuela,0,12,,12,-74.232675,11.117206
26737,2014,Julio,Venezuela,0,2,,2,-74.213989,11.247722999999999
26738,2014,Julio,Venezuela,1692,2297,,3989,-72.129595,11.360028999999999
26739,2014,Julio,Venezuela,3,22,,25,-76.532004,3.451668
26740,2014,Julio,Venezuela,4963,5311,,10274,-74.140516,4.697157
26741,2014,Julio,Venezuela,0,1,,1,-75.736374,4.815189
26742,2014,Julio,Venezuela,94,157,,251,-75.42726,6.170465
26743,2014,Julio,Venezuela,13,23,,36,-67.48402800000001,6.185536
26744,2014,Julio,Venezuela,55,88,,143,-70.74025300000001,7.088728999999999
26745,2014,Julio,Venezuela,2817,3509,,6326,-72.453013,7.819
26746,2014,Julio,Venezuela,274,278,,552,-72.508188,7.927233
26747,2014,Julio,Vietnam,0,2,,2,-74.140516,4.697157
26748,2014,Julio,Islas Vírgenes Estadounidenses/Territorio de Estados Unidos,0,1,,1,-75.42726,6.170465
26749,2014,Julio,Zimbabue,0,1,,1,-74.140516,4.697157
26750,2014,Julio,Anguila/Territorio Británico de Ultramar,0,1,,1,-74.140516,4.697157
26751,2014,Julio,Islas Turcas y Caicos/Territorio Británico de Ultramar,1,1,,2,-74.140516,4.697157
26752,2014,Julio,Desconocido,1,43,,44,-81.703935,12.574411099999999
26753,2014,Julio,Desconocido,4,7,,11,-81.372937,13.338761300000002
26754,2014,Julio,Desconocido,2,36,,38,-74.140516,4.697157
26755,2014,Julio,Desconocido,0,2,,2,-67.48402800000001,6.185536
26756,2014,Julio,Desconocido,2,3,,5,-77.35002,8.63337
26757,2014,Agosto,Afganistán,0,1,,1,-74.140516,4.697157
26758,2014,Agosto,Alemania,1,3,,4,-75.516486,10.446304
26759,2014,Agosto,Alemania,1,7,,8,-74.77647900000001,10.886686
26760,2014,Agosto,Alemania,0,1,,1,-81.70216500000001,12.5862
26761,2014,Agosto,Alemania,7,6,,13,-76.532004,3.451668
26762,2014,Agosto,Alemania,1723,2409,,4132,-74.140516,4.697157
26763,2014,Agosto,Alemania,1,1,,2,-75.736374,4.815189
26764,2014,Agosto,Alemania,19,27,,46,-75.42726,6.170465
26765,2014,Agosto,Alemania,2,3,,5,-73.181317,7.1280470000000005
26766,2014,Agosto,Angola,0,2,,2,-74.140516,4.697157
26767,2014,Agosto,Antigua y Barbuda,0,1,,1,-75.527794,10.406342
26768,2014,Agosto,Antigua y Barbuda,0,1,,1,-74.140516,4.697157
26769,2014,Agosto,Antigua y Barbuda,1,0,,1,-75.42726,6.170465
26770,2014,Agosto,Países Bajos,72,43,,115,-75.527794,10.406342
26771,2014,Agosto,Países Bajos,0,1,,1,-75.516486,10.446304
26772,2014,Agosto,Países Bajos,2,5,,7,-74.77647900000001,10.886686
26773,2014,Agosto,Países Bajos,5,10,,15,-76.532004,3.451668
26774,2014,Agosto,Países Bajos,34,55,,89,-74.140516,4.697157
26775,2014,Agosto,Países Bajos,0,1,,1,-75.736374,4.815189
26776,2014,Agosto,Países Bajos,35,41,,76,-75.42726,6.170465
26777,2014,Agosto,Países Bajos,1,5,,6,-73.181317,7.1280470000000005
26778,2014,Agosto,Países Bajos,1,1,,2,-72.508188,7.927233
26779,2014,Agosto,Arabia Saudita,0,1,,1,-74.140516,4.697157
26780,2014,Agosto,Argelia,5,5,,10,-74.140516,4.697157
26781,2014,Agosto,Argelia,1,0,,1,-77.35002,8.63337
26782,2014,Agosto,Argentina,0,5,,5,-75.527794,10.406342
26783,2014,Agosto,Argentina,120,121,,241,-75.516486,10.446304
26784,2014,Agosto,Argentina,7,12,,19,-74.77647900000001,10.886686
26785,2014,Agosto,Argentina,139,95,,234,-81.70216500000001,12.5862
26786,2014,Agosto,Argentina,21,50,,71,-76.532004,3.451668
26787,2014,Agosto,Argentina,0,13,,13,-77.061029,3.8844260000000004
26788,2014,Agosto,Argentina,1936,2846,,4782,-74.140516,4.697157
26789,2014,Agosto,Argentina,1,3,,4,-75.736374,4.815189
26790,2014,Agosto,Argentina,73,143,,216,-75.42726,6.170465
26791,2014,Agosto,Argentina,1,0,,1,-73.181317,7.1280470000000005
26792,2014,Agosto,Argentina,2,2,,4,-72.508188,7.927233
26793,2014,Agosto,Aruba,90,60,,150,-75.527794,10.406342
26794,2014,Agosto,Aruba,0,3,,3,-75.516486,10.446304
26795,2014,Agosto,Aruba,2,3,,5,-74.77647900000001,10.886686
26796,2014,Agosto,Aruba,2,7,,9,-74.213989,11.247722999999999
26797,2014,Agosto,Aruba,5,4,,9,-76.532004,3.451668
26798,2014,Agosto,Aruba,552,760,,1312,-74.140516,4.697157
26799,2014,Agosto,Aruba,2,4,,6,-75.42726,6.170465
26800,2014,Agosto,Aruba,2,2,,4,-73.181317,7.1280470000000005
26801,2014,Agosto,Australia,1,0,,1,-75.516486,10.446304
26802,2014,Agosto,Australia,1,4,,5,-74.77647900000001,10.886686
26803,2014,Agosto,Australia,2,5,,7,-76.532004,3.451668
26804,2014,Agosto,Australia,18,34,,52,-74.140516,4.697157
26805,2014,Agosto,Australia,0,1,,1,-75.736374,4.815189
26806,2014,Agosto,Australia,2,14,,16,-75.42726,6.170465
26807,2014,Agosto,Austria,0,1,,1,-76.532004,3.451668
26808,2014,Agosto,Austria,19,23,,42,-74.140516,4.697157
26809,2014,Agosto,Austria,0,2,,2,-75.42726,6.170465
26810,2014,Agosto,Bahamas,1,3,,4,-74.140516,4.697157
26811,2014,Agosto,Bahamas,0,1,,1,-75.42726,6.170465
26812,2014,Agosto,Bahréin,1,1,,2,-74.140516,4.697157
26813,2014,Agosto,Bahréin,0,1,,1,-75.42726,6.170465
26814,2014,Agosto,Barbados,0,2,,2,-76.532004,3.451668
26815,2014,Agosto,Barbados,2,2,,4,-74.140516,4.697157
26816,2014,Agosto,Barbados,0,1,,1,-75.42726,6.170465
26817,2014,Agosto,República de Belarús,1,0,,1,-72.129595,11.360028999999999
26818,2014,Agosto,República de Belarús,1,0,,1,-74.140516,4.697157
26819,2014,Agosto,República de Belarús,0,1,,1,-72.453013,7.819
26820,2014,Agosto,Bélgica,1,1,,2,-75.516486,10.446304
26821,2014,Agosto,Bélgica,0,2,,2,-74.77647900000001,10.886686
26822,2014,Agosto,Bélgica,0,1,,1,-74.213989,11.247722999999999
26823,2014,Agosto,Bélgica,1,1,,2,-76.532004,3.451668
26824,2014,Agosto,Bélgica,23,36,,59,-74.140516,4.697157
26825,2014,Agosto,Bélgica,2,3,,5,-75.42726,6.170465
26826,2014,Agosto,Belice,0,1,,1,-76.532004,3.451668
26827,2014,Agosto,Belice,1,3,,4,-74.140516,4.697157
26828,2014,Agosto,Belice,1,3,,4,-75.42726,6.170465
26829,2014,Agosto,Benín,0,1,,1,-74.140516,4.697157
26830,2014,Agosto,Bolivia,8,9,,17,-75.516486,10.446304
26831,2014,Agosto,Bolivia,8,7,,15,-81.70216500000001,12.5862
26832,2014,Agosto,Bolivia,8,6,,14,-76.532004,3.451668
26833,2014,Agosto,Bolivia,403,504,,907,-74.140516,4.697157
26834,2014,Agosto,Bolivia,18,34,,52,-75.42726,6.170465
26835,2014,Agosto,Bolivia,1,0,,1,-72.508188,7.927233
26836,2014,Agosto,Brasil,140,174,,314,-69.941498,4.191162
26837,2014,Agosto,Brasil,1,11,,12,-69.94143100000001,4.214082
26838,2014,Agosto,Brasil,0,3,,3,-75.527794,10.406342
26839,2014,Agosto,Brasil,131,106,,237,-75.516486,10.446304
26840,2014,Agosto,Brasil,2,7,,9,-74.77647900000001,10.886686
26841,2014,Agosto,Brasil,68,62,,130,-81.70216500000001,12.5862
26842,2014,Agosto,Brasil,21,38,,59,-76.532004,3.451668
26843,2014,Agosto,Brasil,3444,5482,,8926,-74.140516,4.697157
26844,2014,Agosto,Brasil,0,2,,2,-75.736374,4.815189
26845,2014,Agosto,Brasil,92,136,,228,-75.42726,6.170465
26846,2014,Agosto,Brasil,0,1,,1,-73.181317,7.1280470000000005
26847,2014,Agosto,Brunei Darussalam,0,1,,1,-74.140516,4.697157
26848,2014,Agosto,Bulgaria,1,3,,4,-74.140516,4.697157
26849,2014,Agosto,Cabo Verde,2,2,,4,-74.140516,4.697157
26850,2014,Agosto,Islas Caimán/Territorio Británico de Ultramar,1,9,,10,-75.527794,10.406342
26851,2014,Agosto,Islas Caimán/Territorio Británico de Ultramar,0,2,,2,-81.70216500000001,12.5862
26852,2014,Agosto,Islas Caimán/Territorio Británico de Ultramar,0,1,,1,-76.532004,3.451668
26853,2014,Agosto,Islas Caimán/Territorio Británico de Ultramar,1,2,,3,-74.140516,4.697157
26854,2014,Agosto,Islas Caimán/Territorio Británico de Ultramar,0,1,,1,-75.42726,6.170465
26855,2014,Agosto,Camboya,1,0,,1,-74.140516,4.697157
26856,2014,Agosto,Canadá,2,2,,4,-75.516486,10.446304
26857,2014,Agosto,Canadá,4,10,,14,-74.77647900000001,10.886686
26858,2014,Agosto,Canadá,1,0,,1,-81.70216500000001,12.5862
26859,2014,Agosto,Canadá,23,29,,52,-76.532004,3.451668
26860,2014,Agosto,Canadá,634,986,,1620,-74.140516,4.697157
26861,2014,Agosto,Canadá,2,3,,5,-75.736374,4.815189
26862,2014,Agosto,Canadá,32,72,,104,-75.42726,6.170465
26863,2014,Agosto,Canadá,5,8,,13,-73.181317,7.1280470000000005
26864,2014,Agosto,Canadá,0,1,,1,-72.508188,7.927233
26865,2014,Agosto,España,0,2,,2,-75.527794,10.406342
26866,2014,Agosto,España,0,1,,1,-75.516486,10.446304
26867,2014,Agosto,España,2,3,,5,-74.77647900000001,10.886686
26868,2014,Agosto,España,0,8,,8,-74.213989,11.247722999999999
26869,2014,Agosto,España,193,342,,535,-76.532004,3.451668
26870,2014,Agosto,España,3305,5155,,8460,-74.140516,4.697157
26871,2014,Agosto,España,0,3,,3,-75.736374,4.815189
26872,2014,Agosto,España,217,387,,604,-75.42726,6.170465
26873,2014,Agosto,España,0,1,,1,-73.181317,7.1280470000000005
26874,2014,Agosto,España,1,0,,1,-72.453013,7.819
26875,2014,Agosto,República de Corea,6,37,,43,-74.140516,4.697157
26876,2014,Agosto,República de Corea,1,8,,9,-75.42726,6.170465
26877,2014,Agosto,Costa de Marfil,1,7,,8,-74.140516,4.697157
26878,2014,Agosto,Costa Rica,6,7,,13,-75.516486,10.446304
26879,2014,Agosto,Costa Rica,9,12,,21,-74.77647900000001,10.886686
26880,2014,Agosto,Costa Rica,121,82,,203,-81.70216500000001,12.5862
26881,2014,Agosto,Costa Rica,8,19,,27,-76.532004,3.451668
26882,2014,Agosto,Costa Rica,611,1116,,1727,-74.140516,4.697157
26883,2014,Agosto,Costa Rica,3,11,,14,-75.736374,4.815189
26884,2014,Agosto,Costa Rica,38,86,,124,-75.42726,6.170465
26885,2014,Agosto,Costa Rica,0,1,,1,-73.181317,7.1280470000000005
26886,2014,Agosto,Costa Rica,1,5,,6,-72.508188,7.927233
26887,2014,Agosto,Croacia,1,8,,9,-74.140516,4.697157
26888,2014,Agosto,Cuba,3,3,,6,-75.516486,10.446304
26889,2014,Agosto,Cuba,6,21,,27,-74.77647900000001,10.886686
26890,2014,Agosto,Cuba,1,1,,2,-81.70216500000001,12.5862
26891,2014,Agosto,Cuba,9,13,,22,-76.532004,3.451668
26892,2014,Agosto,Cuba,235,341,,576,-74.140516,4.697157
26893,2014,Agosto,Cuba,1,2,,3,-75.736374,4.815189
26894,2014,Agosto,Cuba,8,11,,19,-75.42726,6.170465
26895,2014,Agosto,Cuba,1,5,,6,-73.181317,7.1280470000000005
26896,2014,Agosto,Cuba,0,1,,1,-72.508188,7.927233
26897,2014,Agosto,Curazao,2,21,,23,-75.527794,10.406342
26898,2014,Agosto,Curazao,38,66,,104,-74.77647900000001,10.886686
26899,2014,Agosto,Curazao,1,1,,2,-74.765343,10.970933
26900,2014,Agosto,Curazao,1,1,,2,-74.232675,11.117206
26901,2014,Agosto,Curazao,6,7,,13,-74.213989,11.247722999999999
26902,2014,Agosto,Curazao,1,2,,3,-76.532004,3.451668
26903,2014,Agosto,Curazao,166,242,,408,-74.140516,4.697157
26904,2014,Agosto,Curazao,114,176,,290,-75.42726,6.170465
26905,2014,Agosto,República Checa,3,7,,10,-74.140516,4.697157
26906,2014,Agosto,Chile,16,18,,34,-75.516486,10.446304
26907,2014,Agosto,Chile,2,3,,5,-74.77647900000001,10.886686
26908,2014,Agosto,Chile,33,23,,56,-81.70216500000001,12.5862
26909,2014,Agosto,Chile,15,30,,45,-76.532004,3.451668
26910,2014,Agosto,Chile,3919,5030,,8949,-74.140516,4.697157
26911,2014,Agosto,Chile,0,1,,1,-75.736374,4.815189
26912,2014,Agosto,Chile,36,76,,112,-75.42726,6.170465
26913,2014,Agosto,Chile,0,1,,1,-73.181317,7.1280470000000005
26914,2014,Agosto,China,1,3,,4,-76.532004,3.451668
26915,2014,Agosto,China,35,94,,129,-74.140516,4.697157
26916,2014,Agosto,China,1,0,,1,-75.736374,4.815189
26917,2014,Agosto,Dinamarca,7,8,,15,-74.140516,4.697157
26918,2014,Agosto,Dinamarca,3,2,,5,-75.42726,6.170465
26919,2014,Agosto,Dominica,1,1,,2,-75.42726,6.170465
26920,2014,Agosto,Ecuador,71,118,,189,-76.876446,0.33002
26921,2014,Agosto,Ecuador,3290,4755,,8045,-77.35600000000001,0.81488
26922,2014,Agosto,Ecuador,4,236,,240,-78.802679,18.00143
26923,2014,Agosto,Ecuador,1,4,,5,-75.527794,10.406342
26924,2014,Agosto,Ecuador,134,77,,211,-75.516486,10.446304
26925,2014,Agosto,Ecuador,0,4,,4,-74.77647900000001,10.886686
26926,2014,Agosto,Ecuador,4,3,,7,-81.70216500000001,12.5862
26927,2014,Agosto,Ecuador,685,844,,1529,-76.532004,3.451668
26928,2014,Agosto,Ecuador,0,1,,1,-77.061029,3.8844260000000004
26929,2014,Agosto,Ecuador,3263,4884,,8147,-74.140516,4.697157
26930,2014,Agosto,Ecuador,718,750,,1468,-75.42726,6.170465
26931,2014,Agosto,Ecuador,1,2,,3,-72.508188,7.927233
26932,2014,Agosto,Egipto,3,6,,9,-74.140516,4.697157
26933,2014,Agosto,El Salvador,5,11,,16,-75.516486,10.446304
26934,2014,Agosto,El Salvador,48,46,,94,-81.70216500000001,12.5862
26935,2014,Agosto,El Salvador,120,207,,327,-76.532004,3.451668
26936,2014,Agosto,El Salvador,884,1309,,2193,-74.140516,4.697157
26937,2014,Agosto,El Salvador,123,241,,364,-75.42726,6.170465
26938,2014,Agosto,Emiratos Árabes,1,2,,3,-74.140516,4.697157
26939,2014,Agosto,Eritrea,1,1,,2,-74.140516,4.697157
26940,2014,Agosto,Eslovaquia,1,2,,3,-74.140516,4.697157
26941,2014,Agosto,Eslovenia,1,5,,6,-74.140516,4.697157
26942,2014,Agosto,Estados Unidos de América,1,30,,31,-75.527794,10.406342
26943,2014,Agosto,Estados Unidos de América,2088,2768,,4856,-75.516486,10.446304
26944,2014,Agosto,Estados Unidos de América,289,498,,787,-74.77647900000001,10.886686
26945,2014,Agosto,Estados Unidos de América,0,1,,1,-74.765343,10.970933
26946,2014,Agosto,Estados Unidos de América,0,2,,2,-74.213989,11.247722999999999
26947,2014,Agosto,Estados Unidos de América,13,15,,28,-81.70216500000001,12.5862
26948,2014,Agosto,Estados Unidos de América,925,1340,,2265,-76.532004,3.451668
26949,2014,Agosto,Estados Unidos de América,108,163,,271,-75.76635300000001,4.45285
26950,2014,Agosto,Estados Unidos de América,8803,15370,,24173,-74.140516,4.697157
26951,2014,Agosto,Estados Unidos de América,107,167,,274,-75.736374,4.815189
26952,2014,Agosto,Estados Unidos de América,1800,4183,,5983,-75.42726,6.170465
26953,2014,Agosto,Estados Unidos de América,15,22,,37,-73.181317,7.1280470000000005
26954,2014,Agosto,Estados Unidos de América,62,62,,124,-72.508188,7.927233
26955,2014,Agosto,Estados Unidos de América,1,11,,12,-75.68164200000001,9.402597
26956,2014,Agosto,Etiopia,0,1,,1,-74.140516,4.697157
26957,2014,Agosto,Filipinas,0,3,,3,-74.77647900000001,10.886686
26958,2014,Agosto,Filipinas,1,0,,1,-74.765343,10.970933
26959,2014,Agosto,Filipinas,0,3,,3,-76.532004,3.451668
26960,2014,Agosto,Filipinas,0,1,,1,-77.061029,3.8844260000000004
26961,2014,Agosto,Filipinas,7,11,,18,-74.140516,4.697157
26962,2014,Agosto,Filipinas,0,1,,1,-75.736374,4.815189
26963,2014,Agosto,Filipinas,0,1,,1,-75.68164200000001,9.402597
26964,2014,Agosto,Finlandia,6,6,,12,-74.140516,4.697157
26965,2014,Agosto,Francia,0,1,,1,-75.527794,10.406342
26966,2014,Agosto,Francia,0,6,,6,-75.516486,10.446304
26967,2014,Agosto,Francia,1,0,,1,-74.77647900000001,10.886686
26968,2014,Agosto,Francia,0,1,,1,-81.70216500000001,12.5862
26969,2014,Agosto,Francia,10,22,,32,-76.532004,3.451668
26970,2014,Agosto,Francia,1375,2357,,3732,-74.140516,4.697157
26971,2014,Agosto,Francia,0,3,,3,-75.736374,4.815189
26972,2014,Agosto,Francia,5,16,,21,-75.42726,6.170465
26973,2014,Agosto,Ghana,1,3,,4,-74.140516,4.697157
26974,2014,Agosto,Granada,0,1,,1,-75.42726,6.170465
26975,2014,Agosto,Grecia,0,1,,1,-76.532004,3.451668
26976,2014,Agosto,Grecia,4,7,,11,-74.140516,4.697157
26977,2014,Agosto,Guatemala,0,8,,8,-75.527794,10.406342
26978,2014,Agosto,Guatemala,6,8,,14,-75.516486,10.446304
26979,2014,Agosto,Guatemala,0,7,,7,-74.77647900000001,10.886686
26980,2014,Agosto,Guatemala,22,38,,60,-76.532004,3.451668
26981,2014,Agosto,Guatemala,0,5,,5,-77.061029,3.8844260000000004
26982,2014,Agosto,Guatemala,190,459,,649,-74.140516,4.697157
26983,2014,Agosto,Guatemala,4,3,,7,-75.736374,4.815189
26984,2014,Agosto,Guatemala,34,93,,127,-75.42726,6.170465
26985,2014,Agosto,Guatemala,1,3,,4,-73.181317,7.1280470000000005
26986,2014,Agosto,Guatemala,7,0,,7,-72.508188,7.927233
26987,2014,Agosto,Guyana,1,0,,1,-75.516486,10.446304
26988,2014,Agosto,Guyana,0,2,,2,-74.140516,4.697157
26989,2014,Agosto,Guyana,0,3,,3,-75.42726,6.170465
26990,2014,Agosto,Guadalupe/Territorio Francés,0,3,,3,-74.140516,4.697157
26991,2014,Agosto,Haití,0,1,,1,-76.532004,3.451668
26992,2014,Agosto,Haití,5,11,,16,-74.140516,4.697157
26993,2014,Agosto,Haití,0,1,,1,-75.42726,6.170465
26994,2014,Agosto,Haití,0,1,,1,-72.508188,7.927233
26995,2014,Agosto,Honduras,2,5,,7,-75.516486,10.446304
26996,2014,Agosto,Honduras,1,6,,7,-74.77647900000001,10.886686
26997,2014,Agosto,Honduras,1,1,,2,-81.372937,13.338761300000002
26998,2014,Agosto,Honduras,2,6,,8,-76.532004,3.451668
26999,2014,Agosto,Honduras,51,97,,148,-74.140516,4.697157
27000,2014,Agosto,Honduras,1,0,,1,-75.736374,4.815189
27001,2014,Agosto,Honduras,12,20,,32,-75.42726,6.170465
27002,2014,Agosto,Hong Kong,2,6,,8,-74.140516,4.697157
27003,2014,Agosto,Hungría,1,2,,3,-74.140516,4.697157
27004,2014,Agosto,India,1,2,,3,-75.516486,10.446304
27005,2014,Agosto,India,0,1,,1,-74.77647900000001,10.886686
27006,2014,Agosto,India,0,1,,1,-76.532004,3.451668
27007,2014,Agosto,India,4,15,,19,-74.140516,4.697157
27008,2014,Agosto,Indonesia,3,1,,4,-74.140516,4.697157
27009,2014,Agosto,Indonesia,0,3,,3,-75.42726,6.170465
27010,2014,Agosto,Irán,0,1,,1,-74.140516,4.697157
27011,2014,Agosto,República de Irlanda,0,1,,1,-75.516486,10.446304
27012,2014,Agosto,República de Irlanda,5,6,,11,-74.140516,4.697157
27013,2014,Agosto,República de Irlanda,0,2,,2,-75.42726,6.170465
27014,2014,Agosto,Israel,0,2,,2,-75.516486,10.446304
27015,2014,Agosto,Israel,4,6,,10,-76.532004,3.451668
27016,2014,Agosto,Israel,9,48,,57,-74.140516,4.697157
27017,2014,Agosto,Israel,0,1,,1,-75.42726,6.170465
27018,2014,Agosto,Italia,3,10,,13,-75.516486,10.446304
27019,2014,Agosto,Italia,2,2,,4,-74.77647900000001,10.886686
27020,2014,Agosto,Italia,0,1,,1,-72.129595,11.360028999999999
27021,2014,Agosto,Italia,5,14,,19,-76.532004,3.451668
27022,2014,Agosto,Italia,129,259,,388,-74.140516,4.697157
27023,2014,Agosto,Italia,2,1,,3,-75.736374,4.815189
27024,2014,Agosto,Italia,7,18,,25,-75.42726,6.170465
27025,2014,Agosto,Italia,0,1,,1,-73.181317,7.1280470000000005
27026,2014,Agosto,Jamaica,0,3,,3,-75.527794,10.406342
27027,2014,Agosto,Jamaica,0,1,,1,-75.516486,10.446304
27028,2014,Agosto,Jamaica,0,1,,1,-74.77647900000001,10.886686
27029,2014,Agosto,Jamaica,0,1,,1,-74.213989,11.247722999999999
27030,2014,Agosto,Jamaica,1,2,,3,-76.532004,3.451668
27031,2014,Agosto,Jamaica,3,6,,9,-74.140516,4.697157
27032,2014,Agosto,Jamaica,0,1,,1,-75.736374,4.815189
27033,2014,Agosto,Jamaica,4,7,,11,-75.42726,6.170465
27034,2014,Agosto,Jamaica,0,1,,1,-73.181317,7.1280470000000005
27035,2014,Agosto,Japón,0,2,,2,-74.77647900000001,10.886686
27036,2014,Agosto,Japón,1,2,,3,-76.532004,3.451668
27037,2014,Agosto,Japón,16,35,,51,-74.140516,4.697157
27038,2014,Agosto,Japón,2,5,,7,-75.42726,6.170465
27039,2014,Agosto,Jordania,1,0,,1,-74.140516,4.697157
27040,2014,Agosto,Kazajistán,0,2,,2,-74.140516,4.697157
27041,2014,Agosto,Kenia,2,1,,3,-76.532004,3.451668
27042,2014,Agosto,Kenia,1,1,,2,-74.140516,4.697157
27043,2014,Agosto,Kuwait,3,2,,5,-74.140516,4.697157
27044,2014,Agosto,Letonia,1,0,,1,-74.140516,4.697157
27045,2014,Agosto,Líbano,0,1,,1,-74.77647900000001,10.886686
27046,2014,Agosto,Líbano,1,3,,4,-74.140516,4.697157
27047,2014,Agosto,Luxemburgo,1,2,,3,-74.140516,4.697157
27048,2014,Agosto,Malasia,3,5,,8,-74.140516,4.697157
27049,2014,Agosto,Malawi,0,1,,1,-76.532004,3.451668
27050,2014,Agosto,Malí,0,3,,3,-74.140516,4.697157
27051,2014,Agosto,Malta,1,1,,2,-74.140516,4.697157
27052,2014,Agosto,Marruecos,0,1,,1,-76.532004,3.451668
27053,2014,Agosto,Marruecos,0,2,,2,-74.140516,4.697157
27054,2014,Agosto,Martinica/Departamento de Ultramar Francés,0,1,,1,-74.213989,11.247722999999999
27055,2014,Agosto,Martinica/Departamento de Ultramar Francés,0,1,,1,-74.140516,4.697157
27056,2014,Agosto,México,0,4,,4,-75.527794,10.406342
27057,2014,Agosto,México,25,33,,58,-75.516486,10.446304
27058,2014,Agosto,México,9,23,,32,-74.77647900000001,10.886686
27059,2014,Agosto,México,3,7,,10,-81.70216500000001,12.5862
27060,2014,Agosto,México,28,73,,101,-76.532004,3.451668
27061,2014,Agosto,México,3260,6291,,9551,-74.140516,4.697157
27062,2014,Agosto,México,2,5,,7,-75.736374,4.815189
27063,2014,Agosto,México,56,205,,261,-75.42726,6.170465
27064,2014,Agosto,México,0,3,,3,-73.181317,7.1280470000000005
27065,2014,Agosto,México,11,32,,43,-72.508188,7.927233
27066,2014,Agosto,Nicaragua,5,3,,8,-75.516486,10.446304
27067,2014,Agosto,Nicaragua,0,2,,2,-74.77647900000001,10.886686
27068,2014,Agosto,Nicaragua,1,6,,7,-76.532004,3.451668
27069,2014,Agosto,Nicaragua,22,32,,54,-74.140516,4.697157
27070,2014,Agosto,Nicaragua,3,6,,9,-75.42726,6.170465
27071,2014,Agosto,Nicaragua,1,0,,1,-73.181317,7.1280470000000005
27072,2014,Agosto,Nicaragua,0,1,,1,-72.508188,7.927233
27073,2014,Agosto,Nigeria,2,4,,6,-74.140516,4.697157
27074,2014,Agosto,Noruega,0,1,,1,-74.77647900000001,10.886686
27075,2014,Agosto,Noruega,2,1,,3,-76.532004,3.451668
27076,2014,Agosto,Noruega,5,6,,11,-74.140516,4.697157
27077,2014,Agosto,Nueva Zelanda,1,0,,1,-76.532004,3.451668
27078,2014,Agosto,Nueva Zelanda,3,7,,10,-74.140516,4.697157
27079,2014,Agosto,Omán,0,2,,2,-74.140516,4.697157
27080,2014,Agosto,Papúa Nueva Guinea,1,0,,1,-74.140516,4.697157
27081,2014,Agosto,Panamá,1048,878,,1926,-75.527794,10.406342
27082,2014,Agosto,Panamá,1952,2186,,4138,-75.516486,10.446304
27083,2014,Agosto,Panamá,163,397,,560,-74.77647900000001,10.886686
27084,2014,Agosto,Panamá,0,12,,12,-74.765343,10.970933
27085,2014,Agosto,Panamá,0,2,,2,-74.213989,11.247722999999999
27086,2014,Agosto,Panamá,884,704,,1588,-81.70216500000001,12.5862
27087,2014,Agosto,Panamá,396,817,,1213,-76.532004,3.451668
27088,2014,Agosto,Panamá,0,2,,2,-77.061029,3.8844260000000004
27089,2014,Agosto,Panamá,3007,4996,,8003,-74.140516,4.697157
27090,2014,Agosto,Panamá,66,168,,234,-75.736374,4.815189
27091,2014,Agosto,Panamá,1183,2324,,3507,-75.42726,6.170465
27092,2014,Agosto,Panamá,0,1,,1,-77.401154,6.222551999999999
27093,2014,Agosto,Panamá,17,35,,52,-77.762647,7.102626
27094,2014,Agosto,Panamá,34,87,,121,-73.181317,7.1280470000000005
27095,2014,Agosto,Panamá,138,176,,314,-72.508188,7.927233
27096,2014,Agosto,Panamá,0,2,,2,-76.7333,8.06667
27097,2014,Agosto,Panamá,59,80,,139,-77.35002,8.63337
27098,2014,Agosto,Paraguay,4,5,,9,-75.516486,10.446304
27099,2014,Agosto,Paraguay,2,0,,2,-74.77647900000001,10.886686
27100,2014,Agosto,Paraguay,4,3,,7,-81.70216500000001,12.5862
27101,2014,Agosto,Paraguay,4,8,,12,-76.532004,3.451668
27102,2014,Agosto,Paraguay,40,45,,85,-74.140516,4.697157
27103,2014,Agosto,Paraguay,10,16,,26,-75.42726,6.170465
27104,2014,Agosto,Paraguay,1,1,,2,-73.181317,7.1280470000000005
27105,2014,Agosto,Perú,156,219,,375,-69.941498,4.191162
27106,2014,Agosto,Perú,15,22,,37,-69.94143100000001,4.214082
27107,2014,Agosto,Perú,1,1,,2,-77.35600000000001,0.81488
27108,2014,Agosto,Perú,0,1,,1,-75.527794,10.406342
27109,2014,Agosto,Perú,16,16,,32,-75.516486,10.446304
27110,2014,Agosto,Perú,1,10,,11,-74.77647900000001,10.886686
27111,2014,Agosto,Perú,124,88,,212,-81.70216500000001,12.5862
27112,2014,Agosto,Perú,269,392,,661,-76.532004,3.451668
27113,2014,Agosto,Perú,6704,8334,,15038,-74.140516,4.697157
27114,2014,Agosto,Perú,1,2,,3,-75.736374,4.815189
27115,2014,Agosto,Perú,564,1002,,1566,-75.42726,6.170465
27116,2014,Agosto,Perú,0,1,,1,-73.181317,7.1280470000000005
27117,2014,Agosto,Polonia,0,2,,2,-75.516486,10.446304
27118,2014,Agosto,Polonia,5,12,,17,-74.140516,4.697157
27119,2014,Agosto,Polonia,2,0,,2,-75.42726,6.170465
27120,2014,Agosto,Portugal,0,1,,1,-75.516486,10.446304
27121,2014,Agosto,Portugal,0,1,,1,-74.213989,11.247722999999999
27122,2014,Agosto,Portugal,0,2,,2,-76.532004,3.451668
27123,2014,Agosto,Portugal,605,799,,1404,-74.140516,4.697157
27124,2014,Agosto,Portugal,1,0,,1,-75.42726,6.170465
27125,2014,Agosto,Puerto Rico/Territorio de Estados Unidos,0,7,,7,-75.527794,10.406342
27126,2014,Agosto,Puerto Rico/Territorio de Estados Unidos,2,15,,17,-75.516486,10.446304
27127,2014,Agosto,Puerto Rico/Territorio de Estados Unidos,6,46,,52,-74.77647900000001,10.886686
27128,2014,Agosto,Puerto Rico/Territorio de Estados Unidos,1,0,,1,-81.70216500000001,12.5862
27129,2014,Agosto,Puerto Rico/Territorio de Estados Unidos,24,29,,53,-76.532004,3.451668
27130,2014,Agosto,Puerto Rico/Territorio de Estados Unidos,235,325,,560,-74.140516,4.697157
27131,2014,Agosto,Puerto Rico/Territorio de Estados Unidos,2,2,,4,-75.736374,4.815189
27132,2014,Agosto,Puerto Rico/Territorio de Estados Unidos,29,138,,167,-75.42726,6.170465
27133,2014,Agosto,Puerto Rico/Territorio de Estados Unidos,0,1,,1,-73.181317,7.1280470000000005
27134,2014,Agosto,Puerto Rico/Territorio de Estados Unidos,1,0,,1,-72.508188,7.927233
27135,2014,Agosto,Qatar,0,12,,12,-74.140516,4.697157
27136,2014,Agosto,Reino Unido de Gran Bretaña e Irlanda del Norte,2,4,,6,-75.516486,10.446304
27137,2014,Agosto,Reino Unido de Gran Bretaña e Irlanda del Norte,0,3,,3,-74.77647900000001,10.886686
27138,2014,Agosto,Reino Unido de Gran Bretaña e Irlanda del Norte,2,7,,9,-76.532004,3.451668
27139,2014,Agosto,Reino Unido de Gran Bretaña e Irlanda del Norte,399,609,,1008,-74.140516,4.697157
27140,2014,Agosto,Reino Unido de Gran Bretaña e Irlanda del Norte,1,1,,2,-75.736374,4.815189
27141,2014,Agosto,Reino Unido de Gran Bretaña e Irlanda del Norte,10,12,,22,-75.42726,6.170465
27142,2014,Agosto,Reino Unido de Gran Bretaña e Irlanda del Norte,1,2,,3,-73.181317,7.1280470000000005
27143,2014,Agosto,República CentroÁfricana,1,0,,1,-74.140516,4.697157
27144,2014,Agosto,Federación de Rusia,0,1,,1,-74.213989,11.247722999999999
27145,2014,Agosto,Federación de Rusia,18,20,,38,-74.140516,4.697157
27146,2014,Agosto,Federación de Rusia,0,1,,1,-75.42726,6.170465
27147,2014,Agosto,Federación de Rusia,0,1,,1,-75.68164200000001,9.402597
27148,2014,Agosto,República Dominicana,1,5,,6,-75.527794,10.406342
27149,2014,Agosto,República Dominicana,3,6,,9,-75.516486,10.446304
27150,2014,Agosto,República Dominicana,8,48,,56,-74.77647900000001,10.886686
27151,2014,Agosto,República Dominicana,1,0,,1,-81.70216500000001,12.5862
27152,2014,Agosto,República Dominicana,9,23,,32,-76.532004,3.451668
27153,2014,Agosto,República Dominicana,475,700,,1175,-74.140516,4.697157
27154,2014,Agosto,República Dominicana,3,3,,6,-75.736374,4.815189
27155,2014,Agosto,República Dominicana,49,84,,133,-75.42726,6.170465
27156,2014,Agosto,República Dominicana,1,3,,4,-73.181317,7.1280470000000005
27157,2014,Agosto,República Dominicana,1,4,,5,-72.508188,7.927233
27158,2014,Agosto,Reunión,1,1,,2,-74.140516,4.697157
27159,2014,Agosto,República Democrática Popular de Corea,0,2,,2,-74.140516,4.697157
27160,2014,Agosto,Rumania,4,4,,8,-74.140516,4.697157
27161,2014,Agosto,Rwanda,0,1,,1,-76.532004,3.451668
27162,2014,Agosto,San Marino,1,0,,1,-75.42726,6.170465
27163,2014,Agosto,San  Vicente y las Granadinas,2,1,,3,-74.77647900000001,10.886686
27164,2014,Agosto,Santa Lucia,0,1,,1,-74.140516,4.697157
27165,2014,Agosto,Santa Lucia,2,0,,2,-75.42726,6.170465
27166,2014,Agosto,Senegal,0,2,,2,-74.140516,4.697157
27167,2014,Agosto,Singapur,2,3,,5,-74.140516,4.697157
27168,2014,Agosto,Singapur,0,1,,1,-75.42726,6.170465
27169,2014,Agosto,Sudáfrica,0,1,,1,-74.77647900000001,10.886686
27170,2014,Agosto,Sudáfrica,6,9,,15,-74.140516,4.697157
27171,2014,Agosto,Suecia,0,2,,2,-74.77647900000001,10.886686
27172,2014,Agosto,Suecia,1,0,,1,-76.532004,3.451668
27173,2014,Agosto,Suecia,11,14,,25,-74.140516,4.697157
27174,2014,Agosto,Suecia,1,2,,3,-75.42726,6.170465
27175,2014,Agosto,Suiza,2,2,,4,-75.516486,10.446304
27176,2014,Agosto,Suiza,1,0,,1,-74.77647900000001,10.886686
27177,2014,Agosto,Suiza,7,6,,13,-76.532004,3.451668
27178,2014,Agosto,Suiza,39,75,,114,-74.140516,4.697157
27179,2014,Agosto,Suiza,2,7,,9,-75.42726,6.170465
27180,2014,Agosto,Surinam,0,2,,2,-76.532004,3.451668
27181,2014,Agosto,Surinam,3,1,,4,-74.140516,4.697157
27182,2014,Agosto,Surinam,2,3,,5,-75.42726,6.170465
27183,2014,Agosto,Taiwán,1,0,,1,-75.516486,10.446304
27184,2014,Agosto,Taiwán,0,4,,4,-74.140516,4.697157
27185,2014,Agosto,Taiwán,0,2,,2,-75.42726,6.170465
27186,2014,Agosto,Taiwán,0,2,,2,-72.508188,7.927233
27187,2014,Agosto,Tailandia,0,3,,3,-74.140516,4.697157
27188,2014,Agosto,Trinidad y Tobago,4,7,,11,-76.532004,3.451668
27189,2014,Agosto,Trinidad y Tobago,3,9,,12,-74.140516,4.697157
27190,2014,Agosto,Trinidad y Tobago,2,4,,6,-75.736374,4.815189
27191,2014,Agosto,Trinidad y Tobago,1,10,,11,-75.42726,6.170465
27192,2014,Agosto,Trinidad y Tobago,4,2,,6,-73.181317,7.1280470000000005
27193,2014,Agosto,Trinidad y Tobago,1,1,,2,-72.508188,7.927233
27194,2014,Agosto,Túnez,2,0,,2,-74.140516,4.697157
27195,2014,Agosto,Turquía,2,0,,2,-75.516486,10.446304
27196,2014,Agosto,Turquía,4,8,,12,-74.140516,4.697157
27197,2014,Agosto,Turquía,0,1,,1,-75.42726,6.170465
27198,2014,Agosto,Ucrania,0,1,,1,-75.516486,10.446304
27199,2014,Agosto,Ucrania,2,3,,5,-74.140516,4.697157
27200,2014,Agosto,Ucrania,1,0,,1,-75.42726,6.170465
27201,2014,Agosto,Uganda,2,1,,3,-76.532004,3.451668
27202,2014,Agosto,Uruguay,24,13,,37,-75.516486,10.446304
27203,2014,Agosto,Uruguay,0,2,,2,-74.77647900000001,10.886686
27204,2014,Agosto,Uruguay,42,22,,64,-81.70216500000001,12.5862
27205,2014,Agosto,Uruguay,11,14,,25,-76.532004,3.451668
27206,2014,Agosto,Uruguay,44,77,,121,-74.140516,4.697157
27207,2014,Agosto,Uruguay,0,1,,1,-75.736374,4.815189
27208,2014,Agosto,Uruguay,20,43,,63,-75.42726,6.170465
27209,2014,Agosto,Venezuela,1,19,,20,-75.527794,10.406342
27210,2014,Agosto,Venezuela,18,83,,101,-75.516486,10.446304
27211,2014,Agosto,Venezuela,10,43,,53,-74.77647900000001,10.886686
27212,2014,Agosto,Venezuela,3,5,,8,-74.232675,11.117206
27213,2014,Agosto,Venezuela,2767,3257,,6024,-72.129595,11.360028999999999
27214,2014,Agosto,Venezuela,1,3,,4,-81.70216500000001,12.5862
27215,2014,Agosto,Venezuela,1,6,,7,-76.532004,3.451668
27216,2014,Agosto,Venezuela,4499,4398,,8897,-74.140516,4.697157
27217,2014,Agosto,Venezuela,2,2,,4,-75.736374,4.815189
27218,2014,Agosto,Venezuela,84,184,,268,-75.42726,6.170465
27219,2014,Agosto,Venezuela,32,207,,239,-67.48402800000001,6.185536
27220,2014,Agosto,Venezuela,177,289,,466,-70.74025300000001,7.088728999999999
27221,2014,Agosto,Venezuela,16,19,,35,-73.181317,7.1280470000000005
27222,2014,Agosto,Venezuela,4781,5584,,10365,-72.453013,7.819
27223,2014,Agosto,Venezuela,586,722,,1308,-72.508188,7.927233
27224,2014,Agosto,Vietnam,0,1,,1,-77.061029,3.8844260000000004
27225,2014,Agosto,Islas Vírgenes Británicas/Territorio Británico de Ultramar,0,1,,1,-74.140516,4.697157
27226,2014,Agosto,Zimbabue,0,1,,1,-76.532004,3.451668
27227,2014,Agosto,Desconocido,6,38,,44,-81.703935,12.574411099999999
27228,2014,Agosto,Desconocido,0,3,,3,-76.532004,3.451668
27229,2014,Agosto,Desconocido,0,22,,22,-74.140516,4.697157
27230,2014,Agosto,Desconocido,3,7,,10,-67.48402800000001,6.185536
27231,2014,Septiembre,Afganistán,0,2,,2,-74.140516,4.697157
27232,2014,Septiembre,Alemania,1,0,,1,-75.516486,10.446304
27233,2014,Septiembre,Alemania,1,1,,2,-74.77647900000001,10.886686
27234,2014,Septiembre,Alemania,3,6,,9,-76.532004,3.451668
27235,2014,Septiembre,Alemania,1176,2350,,3526,-74.140516,4.697157
27236,2014,Septiembre,Alemania,0,1,,1,-75.736374,4.815189
27237,2014,Septiembre,Alemania,10,9,,19,-75.42726,6.170465
27238,2014,Septiembre,Angola,0,2,,2,-74.140516,4.697157
27239,2014,Septiembre,Antigua y Barbuda,0,1,,1,-74.140516,4.697157
27240,2014,Septiembre,Países Bajos,22,15,,37,-75.527794,10.406342
27241,2014,Septiembre,Países Bajos,0,1,,1,-75.516486,10.446304
27242,2014,Septiembre,Países Bajos,0,1,,1,-74.77647900000001,10.886686
27243,2014,Septiembre,Países Bajos,1,0,,1,-74.213989,11.247722999999999
27244,2014,Septiembre,Países Bajos,1,10,,11,-76.532004,3.451668
27245,2014,Septiembre,Países Bajos,37,92,,129,-74.140516,4.697157
27246,2014,Septiembre,Países Bajos,2,0,,2,-75.736374,4.815189
27247,2014,Septiembre,Países Bajos,55,55,,110,-75.42726,6.170465
27248,2014,Septiembre,Países Bajos,1,2,,3,-73.181317,7.1280470000000005
27249,2014,Septiembre,Arabia Saudita,0,2,,2,-74.140516,4.697157
27250,2014,Septiembre,Argelia,0,1,,1,-76.532004,3.451668
27251,2014,Septiembre,Argelia,5,3,,8,-74.140516,4.697157
27252,2014,Septiembre,Argentina,1,0,,1,-77.35600000000001,0.81488
27253,2014,Septiembre,Argentina,86,63,,149,-75.516486,10.446304
27254,2014,Septiembre,Argentina,3,4,,7,-74.77647900000001,10.886686
27255,2014,Septiembre,Argentina,80,62,,142,-81.70216500000001,12.5862
27256,2014,Septiembre,Argentina,35,63,,98,-76.532004,3.451668
27257,2014,Septiembre,Argentina,0,1,,1,-77.061029,3.8844260000000004
27258,2014,Septiembre,Argentina,1877,2743,,4620,-74.140516,4.697157
27259,2014,Septiembre,Argentina,120,168,,288,-75.42726,6.170465
27260,2014,Septiembre,Aruba,87,118,,205,-75.527794,10.406342
27261,2014,Septiembre,Aruba,1,5,,6,-74.77647900000001,10.886686
27262,2014,Septiembre,Aruba,7,58,,65,-74.213989,11.247722999999999
27263,2014,Septiembre,Aruba,6,5,,11,-76.532004,3.451668
27264,2014,Septiembre,Aruba,459,516,,975,-74.140516,4.697157
27265,2014,Septiembre,Aruba,6,8,,14,-75.42726,6.170465
27266,2014,Septiembre,Aruba,2,2,,4,-73.181317,7.1280470000000005
27267,2014,Septiembre,Australia,1,2,,3,-75.516486,10.446304
27268,2014,Septiembre,Australia,0,2,,2,-76.532004,3.451668
27269,2014,Septiembre,Australia,22,31,,53,-74.140516,4.697157
27270,2014,Septiembre,Australia,9,16,,25,-75.42726,6.170465
27271,2014,Septiembre,Australia,0,1,,1,-72.508188,7.927233
27272,2014,Septiembre,Austria,0,1,,1,-76.532004,3.451668
27273,2014,Septiembre,Austria,16,18,,34,-74.140516,4.697157
27274,2014,Septiembre,Austria,0,1,,1,-75.42726,6.170465
27275,2014,Septiembre,Bahamas,2,37,,39,-75.527794,10.406342
27276,2014,Septiembre,Bahamas,0,1,,1,-74.77647900000001,10.886686
27277,2014,Septiembre,Bahamas,1,0,,1,-76.532004,3.451668
27278,2014,Septiembre,Bahamas,1,0,,1,-74.140516,4.697157
27279,2014,Septiembre,Bahamas,0,1,,1,-75.736374,4.815189
27280,2014,Septiembre,Bahamas,0,1,,1,-75.42726,6.170465
27281,2014,Septiembre,Bahréin,0,1,,1,-74.140516,4.697157
27282,2014,Septiembre,Barbados,0,4,,4,-76.532004,3.451668
27283,2014,Septiembre,Barbados,1,0,,1,-74.140516,4.697157
27284,2014,Septiembre,República de Belarús,1,0,,1,-72.129595,11.360028999999999
27285,2014,Septiembre,República de Belarús,0,1,,1,-72.453013,7.819
27286,2014,Septiembre,Bélgica,0,3,,3,-75.516486,10.446304
27287,2014,Septiembre,Bélgica,0,1,,1,-74.213989,11.247722999999999
27288,2014,Septiembre,Bélgica,1,1,,2,-76.532004,3.451668
27289,2014,Septiembre,Bélgica,23,41,,64,-74.140516,4.697157
27290,2014,Septiembre,Bélgica,0,3,,3,-75.42726,6.170465
27291,2014,Septiembre,Belice,1,0,,1,-76.532004,3.451668
27292,2014,Septiembre,Belice,1,1,,2,-74.140516,4.697157
27293,2014,Septiembre,Belice,0,1,,1,-75.42726,6.170465
27294,2014,Septiembre,Benín,3,1,,4,-74.140516,4.697157
27295,2014,Septiembre,Bermudas/Territorio Británico de Ultramar,1,0,,1,-74.140516,4.697157
27296,2014,Septiembre,Bolivia,1,0,,1,-74.77647900000001,10.886686
27297,2014,Septiembre,Bolivia,5,2,,7,-81.70216500000001,12.5862
27298,2014,Septiembre,Bolivia,7,7,,14,-76.532004,3.451668
27299,2014,Septiembre,Bolivia,367,488,,855,-74.140516,4.697157
27300,2014,Septiembre,Bolivia,0,1,,1,-75.736374,4.815189
27301,2014,Septiembre,Bolivia,17,23,,40,-75.42726,6.170465
27302,2014,Septiembre,Botsuana,0,1,,1,-74.140516,4.697157
27303,2014,Septiembre,Brasil,142,155,,297,-69.941498,4.191162
27304,2014,Septiembre,Brasil,0,1,,1,-77.35600000000001,0.81488
27305,2014,Septiembre,Brasil,0,6,,6,-75.527794,10.406342
27306,2014,Septiembre,Brasil,108,94,,202,-75.516486,10.446304
27307,2014,Septiembre,Brasil,2,7,,9,-74.77647900000001,10.886686
27308,2014,Septiembre,Brasil,0,1,,1,-74.213989,11.247722999999999
27309,2014,Septiembre,Brasil,95,71,,166,-81.70216500000001,12.5862
27310,2014,Septiembre,Brasil,18,42,,60,-76.532004,3.451668
27311,2014,Septiembre,Brasil,3751,5485,,9236,-74.140516,4.697157
27312,2014,Septiembre,Brasil,0,6,,6,-75.736374,4.815189
27313,2014,Septiembre,Brasil,120,208,,328,-75.42726,6.170465
27314,2014,Septiembre,Bulgaria,1,2,,3,-74.140516,4.697157
27315,2014,Septiembre,Islas Caimán/Territorio Británico de Ultramar,0,3,,3,-75.516486,10.446304
27316,2014,Septiembre,Islas Caimán/Territorio Británico de Ultramar,1,2,,3,-74.77647900000001,10.886686
27317,2014,Septiembre,Islas Caimán/Territorio Británico de Ultramar,0,2,,2,-74.140516,4.697157
27318,2014,Septiembre,Islas Caimán/Territorio Británico de Ultramar,0,1,,1,-75.736374,4.815189
27319,2014,Septiembre,Islas Caimán/Territorio Británico de Ultramar,0,1,,1,-75.42726,6.170465
27320,2014,Septiembre,Canadá,0,12,,12,-75.527794,10.406342
27321,2014,Septiembre,Canadá,2,3,,5,-75.516486,10.446304
27322,2014,Septiembre,Canadá,0,6,,6,-74.77647900000001,10.886686
27323,2014,Septiembre,Canadá,0,1,,1,-81.70216500000001,12.5862
27324,2014,Septiembre,Canadá,13,13,,26,-76.532004,3.451668
27325,2014,Septiembre,Canadá,0,2,,2,-77.061029,3.8844260000000004
27326,2014,Septiembre,Canadá,398,658,,1056,-74.140516,4.697157
27327,2014,Septiembre,Canadá,3,4,,7,-75.736374,4.815189
27328,2014,Septiembre,Canadá,43,63,,106,-75.42726,6.170465
27329,2014,Septiembre,Canadá,0,1,,1,-73.181317,7.1280470000000005
27330,2014,Septiembre,Canadá,6,3,,9,-72.508188,7.927233
27331,2014,Septiembre,España,0,1,,1,-75.527794,10.406342
27332,2014,Septiembre,España,0,1,,1,-75.516486,10.446304
27333,2014,Septiembre,España,0,1,,1,-74.77647900000001,10.886686
27334,2014,Septiembre,España,154,212,,366,-76.532004,3.451668
27335,2014,Septiembre,España,2433,5093,,7526,-74.140516,4.697157
27336,2014,Septiembre,España,1,0,,1,-75.736374,4.815189
27337,2014,Septiembre,España,111,240,,351,-75.42726,6.170465
27338,2014,Septiembre,España,0,2,,2,-73.181317,7.1280470000000005
27339,2014,Septiembre,España,0,4,,4,-81.703935,12.574411099999999
27340,2014,Septiembre,España,1,3,,4,-74.140516,4.697157
27341,2014,Septiembre,España,1,1,,2,-72.453013,7.819
27342,2014,Septiembre,República Democrática del Congo,0,1,,1,-74.140516,4.697157
27343,2014,Septiembre,República de Corea,0,1,,1,-76.532004,3.451668
27344,2014,Septiembre,República de Corea,6,20,,26,-74.140516,4.697157
27345,2014,Septiembre,República de Corea,0,5,,5,-75.42726,6.170465
27346,2014,Septiembre,Costa de Marfil,3,4,,7,-74.140516,4.697157
27347,2014,Septiembre,Costa Rica,1,8,,9,-75.527794,10.406342
27348,2014,Septiembre,Costa Rica,2,3,,5,-75.516486,10.446304
27349,2014,Septiembre,Costa Rica,3,13,,16,-74.77647900000001,10.886686
27350,2014,Septiembre,Costa Rica,0,1,,1,-74.213989,11.247722999999999
27351,2014,Septiembre,Costa Rica,162,127,,289,-81.70216500000001,12.5862
27352,2014,Septiembre,Costa Rica,9,34,,43,-76.532004,3.451668
27353,2014,Septiembre,Costa Rica,596,1012,,1608,-74.140516,4.697157
27354,2014,Septiembre,Costa Rica,1,5,,6,-75.736374,4.815189
27355,2014,Septiembre,Costa Rica,40,79,,119,-75.42726,6.170465
27356,2014,Septiembre,Costa Rica,0,3,,3,-73.181317,7.1280470000000005
27357,2014,Septiembre,Costa Rica,1,3,,4,-72.508188,7.927233
27358,2014,Septiembre,Croacia,0,4,,4,-74.140516,4.697157
27359,2014,Septiembre,Cuba,4,12,,16,-74.77647900000001,10.886686
27360,2014,Septiembre,Cuba,1,3,,4,-81.70216500000001,12.5862
27361,2014,Septiembre,Cuba,6,6,,12,-76.532004,3.451668
27362,2014,Septiembre,Cuba,189,265,,454,-74.140516,4.697157
27363,2014,Septiembre,Cuba,0,1,,1,-75.736374,4.815189
27364,2014,Septiembre,Cuba,12,20,,32,-75.42726,6.170465
27365,2014,Septiembre,Cuba,1,3,,4,-73.181317,7.1280470000000005
27366,2014,Septiembre,Cuba,0,2,,2,-72.508188,7.927233
27367,2014,Septiembre,Curazao,0,1,,1,-75.527794,10.406342
27368,2014,Septiembre,Curazao,48,61,,109,-74.77647900000001,10.886686
27369,2014,Septiembre,Curazao,2,2,,4,-74.213989,11.247722999999999
27370,2014,Septiembre,Curazao,2,13,,15,-81.70216500000001,12.5862
27371,2014,Septiembre,Curazao,1,1,,2,-76.532004,3.451668
27372,2014,Septiembre,Curazao,247,346,,593,-74.140516,4.697157
27373,2014,Septiembre,Curazao,160,218,,378,-75.42726,6.170465
27374,2014,Septiembre,Curazao,1,5,,6,-73.181317,7.1280470000000005
27375,2014,Septiembre,República Checa,2,8,,10,-74.140516,4.697157
27376,2014,Septiembre,Chile,1,0,,1,-77.35600000000001,0.81488
27377,2014,Septiembre,Chile,20,92,,112,-75.516486,10.446304
27378,2014,Septiembre,Chile,0,4,,4,-74.77647900000001,10.886686
27379,2014,Septiembre,Chile,21,16,,37,-81.70216500000001,12.5862
27380,2014,Septiembre,Chile,14,25,,39,-76.532004,3.451668
27381,2014,Septiembre,Chile,3987,5166,,9153,-74.140516,4.697157
27382,2014,Septiembre,Chile,0,1,,1,-75.736374,4.815189
27383,2014,Septiembre,Chile,34,90,,124,-75.42726,6.170465
27384,2014,Septiembre,Chile,0,2,,2,-72.508188,7.927233
27385,2014,Septiembre,China,0,2,,2,-74.77647900000001,10.886686
27386,2014,Septiembre,China,28,89,,117,-74.140516,4.697157
27387,2014,Septiembre,China,0,2,,2,-75.42726,6.170465
27388,2014,Septiembre,Chipre,0,1,,1,-74.140516,4.697157
27389,2014,Septiembre,Dinamarca,1,0,,1,-74.77647900000001,10.886686
27390,2014,Septiembre,Dinamarca,0,1,,1,-76.532004,3.451668
27391,2014,Septiembre,Dinamarca,5,12,,17,-74.140516,4.697157
27392,2014,Septiembre,Dinamarca,0,2,,2,-75.42726,6.170465
27393,2014,Septiembre,Dominica,0,1,,1,-74.140516,4.697157
27394,2014,Septiembre,Ecuador,41,83,,124,-76.876446,0.33002
27395,2014,Septiembre,Ecuador,2157,3504,,5661,-77.35600000000001,0.81488
27396,2014,Septiembre,Ecuador,6,237,,243,-78.802679,18.00143
27397,2014,Septiembre,Ecuador,1,7,,8,-75.516486,10.446304
27398,2014,Septiembre,Ecuador,2,6,,8,-74.77647900000001,10.886686
27399,2014,Septiembre,Ecuador,7,12,,19,-81.70216500000001,12.5862
27400,2014,Septiembre,Ecuador,568,688,,1256,-76.532004,3.451668
27401,2014,Septiembre,Ecuador,2672,4410,,7082,-74.140516,4.697157
27402,2014,Septiembre,Ecuador,0,1,,1,-75.736374,4.815189
27403,2014,Septiembre,Ecuador,477,600,,1077,-75.42726,6.170465
27404,2014,Septiembre,Ecuador,2,0,,2,-73.181317,7.1280470000000005
27405,2014,Septiembre,Ecuador,1,0,,1,-72.508188,7.927233
27406,2014,Septiembre,Egipto,1,3,,4,-74.140516,4.697157
27407,2014,Septiembre,El Salvador,1,3,,4,-74.77647900000001,10.886686
27408,2014,Septiembre,El Salvador,2,9,,11,-81.70216500000001,12.5862
27409,2014,Septiembre,El Salvador,98,161,,259,-76.532004,3.451668
27410,2014,Septiembre,El Salvador,817,1218,,2035,-74.140516,4.697157
27411,2014,Septiembre,El Salvador,0,1,,1,-75.736374,4.815189
27412,2014,Septiembre,El Salvador,90,207,,297,-75.42726,6.170465
27413,2014,Septiembre,El Salvador,1,0,,1,-73.181317,7.1280470000000005
27414,2014,Septiembre,El Salvador,2,2,,4,-72.508188,7.927233
27415,2014,Septiembre,Emiratos Árabes,1,0,,1,-76.532004,3.451668
27416,2014,Septiembre,Emiratos Árabes,1,2,,3,-74.140516,4.697157
27417,2014,Septiembre,Emiratos Árabes,1,0,,1,-75.42726,6.170465
27418,2014,Septiembre,Eslovaquia,1,0,,1,-76.532004,3.451668
27419,2014,Septiembre,Eslovaquia,2,1,,3,-74.140516,4.697157
27420,2014,Septiembre,Eslovaquia,0,2,,2,-74.140516,4.697157
27421,2014,Septiembre,Eslovaquia,0,1,,1,-75.42726,6.170465
27422,2014,Septiembre,Estados Unidos de América,1,38,,39,-75.527794,10.406342
27423,2014,Septiembre,Estados Unidos de América,858,1630,,2488,-75.516486,10.446304
27424,2014,Septiembre,Estados Unidos de América,182,408,,590,-74.77647900000001,10.886686
27425,2014,Septiembre,Estados Unidos de América,0,11,,11,-74.765343,10.970933
27426,2014,Septiembre,Estados Unidos de América,1,27,,28,-74.213989,11.247722999999999
27427,2014,Septiembre,Estados Unidos de América,6,6,,12,-81.70216500000001,12.5862
27428,2014,Septiembre,Estados Unidos de América,567,906,,1473,-76.532004,3.451668
27429,2014,Septiembre,Estados Unidos de América,0,1,,1,-77.061029,3.8844260000000004
27430,2014,Septiembre,Estados Unidos de América,66,123,,189,-75.76635300000001,4.45285
27431,2014,Septiembre,Estados Unidos de América,6245,13081,,19326,-74.140516,4.697157
27432,2014,Septiembre,Estados Unidos de América,38,59,,97,-75.736374,4.815189
27433,2014,Septiembre,Estados Unidos de América,992,2818,,3810,-75.42726,6.170465
27434,2014,Septiembre,Estados Unidos de América,7,16,,23,-73.181317,7.1280470000000005
27435,2014,Septiembre,Estados Unidos de América,73,111,,184,-72.508188,7.927233
27436,2014,Septiembre,Estados Unidos de América,0,9,,9,-75.68164200000001,9.402597
27437,2014,Septiembre,Etiopia,1,1,,2,-74.140516,4.697157
27438,2014,Septiembre,Filipinas,0,2,,2,-75.516486,10.446304
27439,2014,Septiembre,Filipinas,0,5,,5,-74.77647900000001,10.886686
27440,2014,Septiembre,Filipinas,0,2,,2,-74.213989,11.247722999999999
27441,2014,Septiembre,Filipinas,1,10,,11,-74.140516,4.697157
27442,2014,Septiembre,Filipinas,1,0,,1,-75.42726,6.170465
27443,2014,Septiembre,Finlandia,4,11,,15,-74.140516,4.697157
27444,2014,Septiembre,Finlandia,0,1,,1,-75.42726,6.170465
27445,2014,Septiembre,Francia,2,2,,4,-74.77647900000001,10.886686
27446,2014,Septiembre,Francia,0,1,,1,-74.213989,11.247722999999999
27447,2014,Septiembre,Francia,3,5,,8,-76.532004,3.451668
27448,2014,Septiembre,Francia,720,1404,,2124,-74.140516,4.697157
27449,2014,Septiembre,Francia,5,18,,23,-75.42726,6.170465
27450,2014,Septiembre,Ghana,0,1,,1,-78.802679,18.00143
27451,2014,Septiembre,Ghana,0,1,,1,-74.140516,4.697157
27452,2014,Septiembre,Grecia,1,2,,3,-76.532004,3.451668
27453,2014,Septiembre,Grecia,5,6,,11,-74.140516,4.697157
27454,2014,Septiembre,Guatemala,0,1,,1,-75.516486,10.446304
27455,2014,Septiembre,Guatemala,1,11,,12,-74.77647900000001,10.886686
27456,2014,Septiembre,Guatemala,1,1,,2,-81.70216500000001,12.5862
27457,2014,Septiembre,Guatemala,8,37,,45,-76.532004,3.451668
27458,2014,Septiembre,Guatemala,0,2,,2,-77.061029,3.8844260000000004
27459,2014,Septiembre,Guatemala,180,354,,534,-74.140516,4.697157
27460,2014,Septiembre,Guatemala,0,2,,2,-75.736374,4.815189
27461,2014,Septiembre,Guatemala,9,53,,62,-75.42726,6.170465
27462,2014,Septiembre,Guatemala,0,1,,1,-73.181317,7.1280470000000005
27463,2014,Septiembre,Guatemala,4,4,,8,-72.508188,7.927233
27464,2014,Septiembre,Guyana,1,0,,1,-76.532004,3.451668
27465,2014,Septiembre,Guyana,0,2,,2,-74.140516,4.697157
27466,2014,Septiembre,Guyana,0,2,,2,-75.42726,6.170465
27467,2014,Septiembre,Guadalupe/Territorio Francés,1,2,,3,-74.140516,4.697157
27468,2014,Septiembre,Guadalupe/Territorio Francés,1,0,,1,-75.42726,6.170465
27469,2014,Septiembre,Haití,1,2,,3,-76.532004,3.451668
27470,2014,Septiembre,Haití,0,3,,3,-74.140516,4.697157
27471,2014,Septiembre,Haití,1,2,,3,-75.42726,6.170465
27472,2014,Septiembre,Honduras,5,4,,9,-75.516486,10.446304
27473,2014,Septiembre,Honduras,2,22,,24,-74.77647900000001,10.886686
27474,2014,Septiembre,Honduras,0,13,,13,-81.703935,12.574411099999999
27475,2014,Septiembre,Honduras,4,7,,11,-81.70216500000001,12.5862
27476,2014,Septiembre,Honduras,2,6,,8,-81.372937,13.338761300000002
27477,2014,Septiembre,Honduras,8,7,,15,-76.532004,3.451668
27478,2014,Septiembre,Honduras,36,55,,91,-74.140516,4.697157
27479,2014,Septiembre,Honduras,1,0,,1,-75.736374,4.815189
27480,2014,Septiembre,Honduras,13,31,,44,-75.42726,6.170465
27481,2014,Septiembre,Honduras,0,1,,1,-73.181317,7.1280470000000005
27482,2014,Septiembre,Hong Kong,1,0,,1,-75.516486,10.446304
27483,2014,Septiembre,Hong Kong,0,1,,1,-74.77647900000001,10.886686
27484,2014,Septiembre,Hong Kong,1,0,,1,-76.532004,3.451668
27485,2014,Septiembre,Hong Kong,3,7,,10,-74.140516,4.697157
27486,2014,Septiembre,Hungría,1,2,,3,-74.140516,4.697157
27487,2014,Septiembre,Hungría,1,0,,1,-75.42726,6.170465
27488,2014,Septiembre,India,0,1,,1,-75.516486,10.446304
27489,2014,Septiembre,India,0,1,,1,-74.77647900000001,10.886686
27490,2014,Septiembre,India,0,1,,1,-76.532004,3.451668
27491,2014,Septiembre,India,2,15,,17,-74.140516,4.697157
27492,2014,Septiembre,Indonesia,0,1,,1,-74.77647900000001,10.886686
27493,2014,Septiembre,Indonesia,0,3,,3,-74.140516,4.697157
27494,2014,Septiembre,República de Irlanda,6,13,,19,-74.140516,4.697157
27495,2014,Septiembre,Israel,0,1,,1,-75.516486,10.446304
27496,2014,Septiembre,Israel,0,1,,1,-74.77647900000001,10.886686
27497,2014,Septiembre,Israel,2,2,,4,-76.532004,3.451668
27498,2014,Septiembre,Israel,10,55,,65,-74.140516,4.697157
27499,2014,Septiembre,Israel,0,3,,3,-75.42726,6.170465
27500,2014,Septiembre,Italia,1,0,,1,-74.77647900000001,10.886686
27501,2014,Septiembre,Italia,3,11,,14,-76.532004,3.451668
27502,2014,Septiembre,Italia,69,221,,290,-74.140516,4.697157
27503,2014,Septiembre,Italia,2,7,,9,-75.42726,6.170465
27504,2014,Septiembre,Italia,1,0,,1,-73.181317,7.1280470000000005
27505,2014,Septiembre,Jamaica,0,1,,1,-75.527794,10.406342
27506,2014,Septiembre,Jamaica,0,2,,2,-75.516486,10.446304
27507,2014,Septiembre,Jamaica,0,3,,3,-74.77647900000001,10.886686
27508,2014,Septiembre,Jamaica,2,5,,7,-74.140516,4.697157
27509,2014,Septiembre,Jamaica,0,1,,1,-75.736374,4.815189
27510,2014,Septiembre,Jamaica,1,2,,3,-75.42726,6.170465
27511,2014,Septiembre,Japón,1,0,,1,-75.516486,10.446304
27512,2014,Septiembre,Japón,0,1,,1,-74.77647900000001,10.886686
27513,2014,Septiembre,Japón,0,1,,1,-76.532004,3.451668
27514,2014,Septiembre,Japón,12,25,,37,-74.140516,4.697157
27515,2014,Septiembre,Japón,1,2,,3,-75.42726,6.170465
27516,2014,Septiembre,Jordania,1,1,,2,-74.140516,4.697157
27517,2014,Septiembre,Kenia,3,3,,6,-74.140516,4.697157
27518,2014,Septiembre,Kenia,0,1,,1,-75.42726,6.170465
27519,2014,Septiembre,Lituania,2,2,,4,-74.140516,4.697157
27520,2014,Septiembre,Líbano,0,1,,1,-74.77647900000001,10.886686
27521,2014,Septiembre,Líbano,6,5,,11,-74.140516,4.697157
27522,2014,Septiembre,Luxemburgo,0,1,,1,-74.140516,4.697157
27523,2014,Septiembre,Luxemburgo,0,1,,1,-72.508188,7.927233
27524,2014,Septiembre,Malasia,1,4,,5,-74.140516,4.697157
27525,2014,Septiembre,Marruecos,1,0,,1,-74.140516,4.697157
27526,2014,Septiembre,Mauritania,0,1,,1,-75.42726,6.170465
27527,2014,Septiembre,México,0,1,,1,-75.527794,10.406342
27528,2014,Septiembre,México,8,25,,33,-75.516486,10.446304
27529,2014,Septiembre,México,20,22,,42,-74.77647900000001,10.886686
27530,2014,Septiembre,México,1,2,,3,-81.70216500000001,12.5862
27531,2014,Septiembre,México,26,58,,84,-76.532004,3.451668
27532,2014,Septiembre,México,3287,6592,,9879,-74.140516,4.697157
27533,2014,Septiembre,México,2,8,,10,-75.736374,4.815189
27534,2014,Septiembre,México,87,244,,331,-75.42726,6.170465
27535,2014,Septiembre,México,0,5,,5,-73.181317,7.1280470000000005
27536,2014,Septiembre,México,26,27,,53,-72.508188,7.927233
27537,2014,Septiembre,República de Moldavia,1,0,,1,-74.140516,4.697157
27538,2014,Septiembre,Mónaco,0,1,,1,-74.140516,4.697157
27539,2014,Septiembre,Myanmar,0,1,,1,-76.532004,3.451668
27540,2014,Septiembre,Nauru,0,1,,1,-75.42726,6.170465
27541,2014,Septiembre,Namibia,1,0,,1,-74.140516,4.697157
27542,2014,Septiembre,Nepal,0,2,,2,-74.140516,4.697157
27543,2014,Septiembre,Nicaragua,1,3,,4,-74.77647900000001,10.886686
27544,2014,Septiembre,Nicaragua,4,14,,18,-76.532004,3.451668
27545,2014,Septiembre,Nicaragua,18,24,,42,-74.140516,4.697157
27546,2014,Septiembre,Nicaragua,0,1,,1,-75.736374,4.815189
27547,2014,Septiembre,Nicaragua,4,11,,15,-75.42726,6.170465
27548,2014,Septiembre,Noruega,2,0,,2,-74.77647900000001,10.886686
27549,2014,Septiembre,Noruega,0,3,,3,-76.532004,3.451668
27550,2014,Septiembre,Noruega,7,13,,20,-74.140516,4.697157
27551,2014,Septiembre,Noruega,0,1,,1,-75.42726,6.170465
27552,2014,Septiembre,Nueva Zelanda,0,1,,1,-74.77647900000001,10.886686
27553,2014,Septiembre,Nueva Zelanda,1,2,,3,-76.532004,3.451668
27554,2014,Septiembre,Nueva Zelanda,7,7,,14,-74.140516,4.697157
27555,2014,Septiembre,Nueva Zelanda,0,1,,1,-75.42726,6.170465
27556,2014,Septiembre,Pakistán,0,1,,1,-74.140516,4.697157
27557,2014,Septiembre,Panamá,917,835,,1752,-75.527794,10.406342
27558,2014,Septiembre,Panamá,1709,1955,,3664,-75.516486,10.446304
27559,2014,Septiembre,Panamá,116,385,,501,-74.77647900000001,10.886686
27560,2014,Septiembre,Panamá,0,4,,4,-74.765343,10.970933
27561,2014,Septiembre,Panamá,0,1,,1,-74.213989,11.247722999999999
27562,2014,Septiembre,Panamá,799,684,,1483,-81.70216500000001,12.5862
27563,2014,Septiembre,Panamá,316,660,,976,-76.532004,3.451668
27564,2014,Septiembre,Panamá,0,16,,16,-77.061029,3.8844260000000004
27565,2014,Septiembre,Panamá,2556,4673,,7229,-74.140516,4.697157
27566,2014,Septiembre,Panamá,49,90,,139,-75.736374,4.815189
27567,2014,Septiembre,Panamá,852,1609,,2461,-75.42726,6.170465
27568,2014,Septiembre,Panamá,4,3,,7,-77.762647,7.102626
27569,2014,Septiembre,Panamá,21,54,,75,-73.181317,7.1280470000000005
27570,2014,Septiembre,Panamá,191,245,,436,-72.508188,7.927233
27571,2014,Septiembre,Panamá,0,9,,9,-76.7333,8.06667
27572,2014,Septiembre,Panamá,35,64,,99,-77.35002,8.63337
27573,2014,Septiembre,Paraguay,1,0,,1,-75.516486,10.446304
27574,2014,Septiembre,Paraguay,7,12,,19,-81.70216500000001,12.5862
27575,2014,Septiembre,Paraguay,3,6,,9,-76.532004,3.451668
27576,2014,Septiembre,Paraguay,32,54,,86,-74.140516,4.697157
27577,2014,Septiembre,Paraguay,17,48,,65,-75.42726,6.170465
27578,2014,Septiembre,Paraguay,0,7,,7,-72.508188,7.927233
27579,2014,Septiembre,Perú,64,117,,181,-69.941498,4.191162
27580,2014,Septiembre,Perú,1,0,,1,-77.35600000000001,0.81488
27581,2014,Septiembre,Perú,5,8,,13,-75.516486,10.446304
27582,2014,Septiembre,Perú,2,3,,5,-74.77647900000001,10.886686
27583,2014,Septiembre,Perú,112,87,,199,-81.70216500000001,12.5862
27584,2014,Septiembre,Perú,236,375,,611,-76.532004,3.451668
27585,2014,Septiembre,Perú,0,1,,1,-77.061029,3.8844260000000004
27586,2014,Septiembre,Perú,5233,7052,,12285,-74.140516,4.697157
27587,2014,Septiembre,Perú,367,684,,1051,-75.42726,6.170465
27588,2014,Septiembre,Perú,1,0,,1,-73.181317,7.1280470000000005
27589,2014,Septiembre,Perú,0,1,,1,-72.508188,7.927233
27590,2014,Septiembre,Polonia,10,13,,23,-74.140516,4.697157
27591,2014,Septiembre,Polonia,1,0,,1,-75.42726,6.170465
27592,2014,Septiembre,Portugal,0,1,,1,-74.77647900000001,10.886686
27593,2014,Septiembre,Portugal,407,617,,1024,-74.140516,4.697157
27594,2014,Septiembre,Portugal,0,1,,1,-75.736374,4.815189
27595,2014,Septiembre,Polinesia Francesa/Colectividad de Ultramar Francesa,1,0,,1,-74.140516,4.697157
27596,2014,Septiembre,Puerto Rico/Territorio de Estados Unidos,3,28,,31,-74.77647900000001,10.886686
27597,2014,Septiembre,Puerto Rico/Territorio de Estados Unidos,3,8,,11,-81.70216500000001,12.5862
27598,2014,Septiembre,Puerto Rico/Territorio de Estados Unidos,15,16,,31,-76.532004,3.451668
27599,2014,Septiembre,Puerto Rico/Territorio de Estados Unidos,168,273,,441,-74.140516,4.697157
27600,2014,Septiembre,Puerto Rico/Territorio de Estados Unidos,2,2,,4,-75.736374,4.815189
27601,2014,Septiembre,Puerto Rico/Territorio de Estados Unidos,14,42,,56,-75.42726,6.170465
27602,2014,Septiembre,Puerto Rico/Territorio de Estados Unidos,2,15,,17,-73.181317,7.1280470000000005
27603,2014,Septiembre,Qatar,1,0,,1,-74.140516,4.697157
27604,2014,Septiembre,Reino Unido de Gran Bretaña e Irlanda del Norte,0,2,,2,-75.516486,10.446304
27605,2014,Septiembre,Reino Unido de Gran Bretaña e Irlanda del Norte,0,2,,2,-74.77647900000001,10.886686
27606,2014,Septiembre,Reino Unido de Gran Bretaña e Irlanda del Norte,0,1,,1,-74.213989,11.247722999999999
27607,2014,Septiembre,Reino Unido de Gran Bretaña e Irlanda del Norte,3,5,,8,-76.532004,3.451668
27608,2014,Septiembre,Reino Unido de Gran Bretaña e Irlanda del Norte,376,680,,1056,-74.140516,4.697157
27609,2014,Septiembre,Reino Unido de Gran Bretaña e Irlanda del Norte,1,1,,2,-75.736374,4.815189
27610,2014,Septiembre,Reino Unido de Gran Bretaña e Irlanda del Norte,6,15,,21,-75.42726,6.170465
27611,2014,Septiembre,Reino Unido de Gran Bretaña e Irlanda del Norte,0,1,,1,-73.181317,7.1280470000000005
27612,2014,Septiembre,Federación de Rusia,0,1,,1,-76.532004,3.451668
27613,2014,Septiembre,Federación de Rusia,21,31,,52,-74.140516,4.697157
27614,2014,Septiembre,Federación de Rusia,1,0,,1,-75.42726,6.170465
27615,2014,Septiembre,República Dominicana,0,3,,3,-75.527794,10.406342
27616,2014,Septiembre,República Dominicana,2,4,,6,-75.516486,10.446304
27617,2014,Septiembre,República Dominicana,6,13,,19,-74.77647900000001,10.886686
27618,2014,Septiembre,República Dominicana,7,8,,15,-81.70216500000001,12.5862
27619,2014,Septiembre,República Dominicana,16,15,,31,-76.532004,3.451668
27620,2014,Septiembre,República Dominicana,329,597,,926,-74.140516,4.697157
27621,2014,Septiembre,República Dominicana,2,6,,8,-75.736374,4.815189
27622,2014,Septiembre,República Dominicana,10,45,,55,-75.42726,6.170465
27623,2014,Septiembre,República Dominicana,0,6,,6,-73.181317,7.1280470000000005
27624,2014,Septiembre,República Dominicana,0,1,,1,-72.508188,7.927233
27625,2014,Septiembre,Reunión,1,1,,2,-74.140516,4.697157
27626,2014,Septiembre,República Democrática Popular de Corea,0,1,,1,-74.140516,4.697157
27627,2014,Septiembre,Rumania,2,9,,11,-74.140516,4.697157
27628,2014,Septiembre,Rumania,1,1,,2,-75.42726,6.170465
27629,2014,Septiembre,Santa Sede/Ciudad del Vaticano,0,2,,2,-74.140516,4.697157
27630,2014,Septiembre,Serbia,1,0,,1,-74.140516,4.697157
27631,2014,Septiembre,Singapur,1,3,,4,-74.140516,4.697157
27632,2014,Septiembre,Singapur,0,3,,3,-75.42726,6.170465
27633,2014,Septiembre,Sudáfrica,6,10,,16,-74.140516,4.697157
27634,2014,Septiembre,Sudáfrica,0,1,,1,-75.42726,6.170465
27635,2014,Septiembre,Suecia,0,1,,1,-76.532004,3.451668
27636,2014,Septiembre,Suecia,14,21,,35,-74.140516,4.697157
27637,2014,Septiembre,Suecia,0,2,,2,-75.42726,6.170465
27638,2014,Septiembre,Suiza,0,1,,1,-74.77647900000001,10.886686
27639,2014,Septiembre,Suiza,3,6,,9,-76.532004,3.451668
27640,2014,Septiembre,Suiza,46,56,,102,-74.140516,4.697157
27641,2014,Septiembre,Suiza,4,7,,11,-75.42726,6.170465
27642,2014,Septiembre,Surinam,1,1,,2,-74.140516,4.697157
27643,2014,Septiembre,Surinam,8,7,,15,-75.42726,6.170465
27644,2014,Septiembre,Taiwán,0,1,,1,-76.532004,3.451668
27645,2014,Septiembre,Taiwán,0,5,,5,-74.140516,4.697157
27646,2014,Septiembre,Taiwán,1,0,,1,-75.42726,6.170465
27647,2014,Septiembre,Tailandia,1,1,,2,-74.140516,4.697157
27648,2014,Septiembre,Tanzania,1,3,,4,-74.140516,4.697157
27649,2014,Septiembre,Trinidad y Tobago,0,16,,16,-75.527794,10.406342
27650,2014,Septiembre,Trinidad y Tobago,1,4,,5,-76.532004,3.451668
27651,2014,Septiembre,Trinidad y Tobago,2,7,,9,-74.140516,4.697157
27652,2014,Septiembre,Trinidad y Tobago,0,3,,3,-75.736374,4.815189
27653,2014,Septiembre,Trinidad y Tobago,2,4,,6,-75.42726,6.170465
27654,2014,Septiembre,Turquía,0,8,,8,-74.765343,10.970933
27655,2014,Septiembre,Turquía,4,14,,18,-74.140516,4.697157
27656,2014,Septiembre,Ucrania,0,7,,7,-76.532004,3.451668
27657,2014,Septiembre,Ucrania,1,2,,3,-74.140516,4.697157
27658,2014,Septiembre,Uruguay,11,9,,20,-75.516486,10.446304
27659,2014,Septiembre,Uruguay,1,1,,2,-74.77647900000001,10.886686
27660,2014,Septiembre,Uruguay,16,13,,29,-81.70216500000001,12.5862
27661,2014,Septiembre,Uruguay,23,23,,46,-76.532004,3.451668
27662,2014,Septiembre,Uruguay,35,98,,133,-74.140516,4.697157
27663,2014,Septiembre,Uruguay,38,59,,97,-75.42726,6.170465
27664,2014,Septiembre,Uruguay,0,1,,1,-73.181317,7.1280470000000005
27665,2014,Septiembre,Venezuela,0,3,,3,-75.527794,10.406342
27666,2014,Septiembre,Venezuela,9,42,,51,-75.516486,10.446304
27667,2014,Septiembre,Venezuela,5,73,,78,-74.77647900000001,10.886686
27668,2014,Septiembre,Venezuela,0,1,,1,-74.213989,11.247722999999999
27669,2014,Septiembre,Venezuela,1527,2192,,3719,-72.129595,11.360028999999999
27670,2014,Septiembre,Venezuela,2,3,,5,-81.70216500000001,12.5862
27671,2014,Septiembre,Venezuela,14,17,,31,-76.532004,3.451668
27672,2014,Septiembre,Venezuela,3421,3870,,7291,-74.140516,4.697157
27673,2014,Septiembre,Venezuela,1,1,,2,-75.736374,4.815189
27674,2014,Septiembre,Venezuela,29,75,,104,-75.42726,6.170465
27675,2014,Septiembre,Venezuela,22,40,,62,-67.48402800000001,6.185536
27676,2014,Septiembre,Venezuela,69,85,,154,-70.74025300000001,7.088728999999999
27677,2014,Septiembre,Venezuela,3,2,,5,-73.181317,7.1280470000000005
27678,2014,Septiembre,Venezuela,3120,4014,,7134,-72.453013,7.819
27679,2014,Septiembre,Venezuela,393,399,,792,-72.508188,7.927233
27680,2014,Septiembre,Zimbabue,0,1,,1,-74.140516,4.697157
27681,2014,Septiembre,Desconocido,0,1,,1,-71.983761,12.165168
27682,2014,Septiembre,Desconocido,3,22,,25,-81.703935,12.574411099999999
27683,2014,Septiembre,Desconocido,0,1,,1,-76.532004,3.451668
27684,2014,Septiembre,Desconocido,2,44,,46,-74.140516,4.697157
27685,2014,Septiembre,Desconocido,0,1,,1,-77.35002,8.63337
27686,2014,Octubre,Afganistán,0,1,,1,-74.140516,4.697157
27687,2014,Octubre,Alemania,1,2,,3,-75.516486,10.446304
27688,2014,Octubre,Alemania,3,6,,9,-74.77647900000001,10.886686
27689,2014,Octubre,Alemania,0,2,,2,-74.213989,11.247722999999999
27690,2014,Octubre,Alemania,5,5,,10,-76.532004,3.451668
27691,2014,Octubre,Alemania,1366,2354,,3720,-74.140516,4.697157
27692,2014,Octubre,Alemania,1,0,,1,-75.736374,4.815189
27693,2014,Octubre,Alemania,13,18,,31,-75.42726,6.170465
27694,2014,Octubre,Antigua y Barbuda,0,1,,1,-75.527794,10.406342
27695,2014,Octubre,Antigua y Barbuda,0,2,,2,-74.77647900000001,10.886686
27696,2014,Octubre,Antigua y Barbuda,1,2,,3,-74.140516,4.697157
27697,2014,Octubre,Países Bajos,4,4,,8,-75.516486,10.446304
27698,2014,Octubre,Países Bajos,0,5,,5,-74.77647900000001,10.886686
27699,2014,Octubre,Países Bajos,7,26,,33,-76.532004,3.451668
27700,2014,Octubre,Países Bajos,45,77,,122,-74.140516,4.697157
27701,2014,Octubre,Países Bajos,0,5,,5,-75.736374,4.815189
27702,2014,Octubre,Países Bajos,66,80,,146,-75.42726,6.170465
27703,2014,Octubre,Países Bajos,7,4,,11,-73.181317,7.1280470000000005
27704,2014,Octubre,Arabia Saudita,0,1,,1,-74.140516,4.697157
27705,2014,Octubre,Argelia,0,1,,1,-76.532004,3.451668
27706,2014,Octubre,Argelia,4,7,,11,-74.140516,4.697157
27707,2014,Octubre,Argentina,1,2,,3,-77.35600000000001,0.81488
27708,2014,Octubre,Argentina,0,1,,1,-75.527794,10.406342
27709,2014,Octubre,Argentina,138,105,,243,-75.516486,10.446304
27710,2014,Octubre,Argentina,5,3,,8,-74.77647900000001,10.886686
27711,2014,Octubre,Argentina,81,66,,147,-81.70216500000001,12.5862
27712,2014,Octubre,Argentina,35,71,,106,-76.532004,3.451668
27713,2014,Octubre,Argentina,1720,2683,,4403,-74.140516,4.697157
27714,2014,Octubre,Argentina,0,6,,6,-75.736374,4.815189
27715,2014,Octubre,Argentina,97,165,,262,-75.42726,6.170465
27716,2014,Octubre,Argentina,1,1,,2,-73.181317,7.1280470000000005
27717,2014,Octubre,Argentina,1,2,,3,-72.508188,7.927233
27718,2014,Octubre,Aruba,42,41,,83,-75.527794,10.406342
27719,2014,Octubre,Aruba,5,1,,6,-74.77647900000001,10.886686
27720,2014,Octubre,Aruba,0,3,,3,-74.765343,10.970933
27721,2014,Octubre,Aruba,12,18,,30,-74.213989,11.247722999999999
27722,2014,Octubre,Aruba,1,4,,5,-76.532004,3.451668
27723,2014,Octubre,Aruba,487,608,,1095,-74.140516,4.697157
27724,2014,Octubre,Aruba,2,11,,13,-75.42726,6.170465
27725,2014,Octubre,Aruba,2,1,,3,-73.181317,7.1280470000000005
27726,2014,Octubre,Aruba,1,1,,2,-72.508188,7.927233
27727,2014,Octubre,Australia,0,2,,2,-75.516486,10.446304
27728,2014,Octubre,Australia,0,3,,3,-74.77647900000001,10.886686
27729,2014,Octubre,Australia,0,3,,3,-76.532004,3.451668
27730,2014,Octubre,Australia,18,25,,43,-74.140516,4.697157
27731,2014,Octubre,Australia,10,14,,24,-75.42726,6.170465
27732,2014,Octubre,Austria,1,0,,1,-75.516486,10.446304
27733,2014,Octubre,Austria,13,17,,30,-74.140516,4.697157
27734,2014,Octubre,Azerbaiyán,1,1,,2,-74.140516,4.697157
27735,2014,Octubre,Bahamas,1,4,,5,-74.140516,4.697157
27736,2014,Octubre,Bahamas,1,0,,1,-75.736374,4.815189
27737,2014,Octubre,Bahamas,1,1,,2,-75.42726,6.170465
27738,2014,Octubre,Bahréin,1,1,,2,-74.140516,4.697157
27739,2014,Octubre,Bahréin,1,0,,1,-75.42726,6.170465
27740,2014,Octubre,Bahréin,1,0,,1,-72.453013,7.819
27741,2014,Octubre,Bangladesh,0,1,,1,-74.140516,4.697157
27742,2014,Octubre,Barbados,0,2,,2,-74.140516,4.697157
27743,2014,Octubre,República de Belarús,1,1,,2,-72.129595,11.360028999999999
27744,2014,Octubre,República de Belarús,0,2,,2,-72.453013,7.819
27745,2014,Octubre,Bélgica,1,1,,2,-75.516486,10.446304
27746,2014,Octubre,Bélgica,4,4,,8,-76.532004,3.451668
27747,2014,Octubre,Bélgica,26,59,,85,-74.140516,4.697157
27748,2014,Octubre,Bélgica,0,4,,4,-75.42726,6.170465
27749,2014,Octubre,Belice,1,1,,2,-74.140516,4.697157
27750,2014,Octubre,Belice,0,1,,1,-75.42726,6.170465
27751,2014,Octubre,Bermudas/Territorio Británico de Ultramar,0,1,,1,-74.140516,4.697157
27752,2014,Octubre,Bermudas/Territorio Británico de Ultramar,1,2,,3,-75.42726,6.170465
27753,2014,Octubre,Bolivia,9,2,,11,-75.516486,10.446304
27754,2014,Octubre,Bolivia,13,8,,21,-81.70216500000001,12.5862
27755,2014,Octubre,Bolivia,15,15,,30,-76.532004,3.451668
27756,2014,Octubre,Bolivia,426,564,,990,-74.140516,4.697157
27757,2014,Octubre,Bolivia,14,41,,55,-75.42726,6.170465
27758,2014,Octubre,Brasil,84,115,,199,-69.941498,4.191162
27759,2014,Octubre,Brasil,0,3,,3,-69.94143100000001,4.214082
27760,2014,Octubre,Brasil,1,0,,1,-77.35600000000001,0.81488
27761,2014,Octubre,Brasil,0,12,,12,-75.527794,10.406342
27762,2014,Octubre,Brasil,98,84,,182,-75.516486,10.446304
27763,2014,Octubre,Brasil,3,8,,11,-74.77647900000001,10.886686
27764,2014,Octubre,Brasil,0,1,,1,-74.213989,11.247722999999999
27765,2014,Octubre,Brasil,65,53,,118,-81.70216500000001,12.5862
27766,2014,Octubre,Brasil,34,72,,106,-76.532004,3.451668
27767,2014,Octubre,Brasil,3673,5270,,8943,-74.140516,4.697157
27768,2014,Octubre,Brasil,3,31,,34,-75.736374,4.815189
27769,2014,Octubre,Brasil,138,191,,329,-75.42726,6.170465
27770,2014,Octubre,Brasil,1,2,,3,-73.181317,7.1280470000000005
27771,2014,Octubre,Brasil,3,4,,7,-72.508188,7.927233
27772,2014,Octubre,Bulgaria,0,3,,3,-74.140516,4.697157
27773,2014,Octubre,Islas Caimán/Territorio Británico de Ultramar,0,1,,1,-75.527794,10.406342
27774,2014,Octubre,Islas Caimán/Territorio Británico de Ultramar,0,11,,11,-74.77647900000001,10.886686
27775,2014,Octubre,Islas Caimán/Territorio Británico de Ultramar,0,8,,8,-74.140516,4.697157
27776,2014,Octubre,Canadá,1,0,,1,-69.941498,4.191162
27777,2014,Octubre,Canadá,5,4,,9,-75.516486,10.446304
27778,2014,Octubre,Canadá,2,12,,14,-74.77647900000001,10.886686
27779,2014,Octubre,Canadá,0,4,,4,-74.765343,10.970933
27780,2014,Octubre,Canadá,1,2,,3,-81.70216500000001,12.5862
27781,2014,Octubre,Canadá,16,31,,47,-76.532004,3.451668
27782,2014,Octubre,Canadá,493,756,,1249,-74.140516,4.697157
27783,2014,Octubre,Canadá,3,5,,8,-75.736374,4.815189
27784,2014,Octubre,Canadá,45,83,,128,-75.42726,6.170465
27785,2014,Octubre,Canadá,1,5,,6,-73.181317,7.1280470000000005
27786,2014,Octubre,Canadá,3,3,,6,-72.508188,7.927233
27787,2014,Octubre,España,1,1,,2,-75.527794,10.406342
27788,2014,Octubre,España,1,1,,2,-75.516486,10.446304
27789,2014,Octubre,España,0,4,,4,-74.77647900000001,10.886686
27790,2014,Octubre,España,1,0,,1,-81.70216500000001,12.5862
27791,2014,Octubre,España,146,312,,458,-76.532004,3.451668
27792,2014,Octubre,España,2388,5126,,7514,-74.140516,4.697157
27793,2014,Octubre,España,0,4,,4,-75.736374,4.815189
27794,2014,Octubre,España,137,334,,471,-75.42726,6.170465
27795,2014,Octubre,España,2,0,,2,-72.508188,7.927233
27796,2014,Octubre,República de Corea,1,0,,1,-76.532004,3.451668
27797,2014,Octubre,República de Corea,0,3,,3,-77.061029,3.8844260000000004
27798,2014,Octubre,República de Corea,22,33,,55,-74.140516,4.697157
27799,2014,Octubre,República de Corea,0,1,,1,-75.736374,4.815189
27800,2014,Octubre,República de Corea,0,2,,2,-75.42726,6.170465
27801,2014,Octubre,Costa de Marfil,1,2,,3,-74.140516,4.697157
27802,2014,Octubre,Costa Rica,10,27,,37,-75.527794,10.406342
27803,2014,Octubre,Costa Rica,4,11,,15,-75.516486,10.446304
27804,2014,Octubre,Costa Rica,3,8,,11,-74.77647900000001,10.886686
27805,2014,Octubre,Costa Rica,0,1,,1,-74.213989,11.247722999999999
27806,2014,Octubre,Costa Rica,1,15,,16,-81.703935,12.574411099999999
27807,2014,Octubre,Costa Rica,7,13,,20,-81.70216500000001,12.5862
27808,2014,Octubre,Costa Rica,31,46,,77,-76.532004,3.451668
27809,2014,Octubre,Costa Rica,0,1,,1,-77.061029,3.8844260000000004
27810,2014,Octubre,Costa Rica,599,1107,,1706,-74.140516,4.697157
27811,2014,Octubre,Costa Rica,4,9,,13,-75.736374,4.815189
27812,2014,Octubre,Costa Rica,54,119,,173,-75.42726,6.170465
27813,2014,Octubre,Costa Rica,4,2,,6,-73.181317,7.1280470000000005
27814,2014,Octubre,Costa Rica,5,10,,15,-72.508188,7.927233
27815,2014,Octubre,Croacia,3,6,,9,-74.140516,4.697157
27816,2014,Octubre,Cuba,0,6,,6,-75.516486,10.446304
27817,2014,Octubre,Cuba,2,6,,8,-74.77647900000001,10.886686
27818,2014,Octubre,Cuba,0,1,,1,-74.765343,10.970933
27819,2014,Octubre,Cuba,0,8,,8,-81.70216500000001,12.5862
27820,2014,Octubre,Cuba,19,17,,36,-76.532004,3.451668
27821,2014,Octubre,Cuba,183,309,,492,-74.140516,4.697157
27822,2014,Octubre,Cuba,1,2,,3,-75.736374,4.815189
27823,2014,Octubre,Cuba,9,22,,31,-75.42726,6.170465
27824,2014,Octubre,Cuba,1,4,,5,-73.181317,7.1280470000000005
27825,2014,Octubre,Cuba,0,5,,5,-72.508188,7.927233
27826,2014,Octubre,Cuba,0,2,,2,-76.7333,8.06667
27827,2014,Octubre,Curazao,0,3,,3,-75.527794,10.406342
27828,2014,Octubre,Curazao,4,7,,11,-75.516486,10.446304
27829,2014,Octubre,Curazao,49,82,,131,-74.77647900000001,10.886686
27830,2014,Octubre,Curazao,1,3,,4,-74.213989,11.247722999999999
27831,2014,Octubre,Curazao,332,428,,760,-74.140516,4.697157
27832,2014,Octubre,Curazao,185,196,,381,-75.42726,6.170465
27833,2014,Octubre,Curazao,0,1,,1,-73.181317,7.1280470000000005
27834,2014,Octubre,República Checa,7,7,,14,-74.140516,4.697157
27835,2014,Octubre,República Checa,0,1,,1,-75.736374,4.815189
27836,2014,Octubre,Chile,1,1,,2,-77.35600000000001,0.81488
27837,2014,Octubre,Chile,0,1,,1,-78.802679,18.00143
27838,2014,Octubre,Chile,18,8,,26,-75.516486,10.446304
27839,2014,Octubre,Chile,1,3,,4,-74.77647900000001,10.886686
27840,2014,Octubre,Chile,17,7,,24,-81.70216500000001,12.5862
27841,2014,Octubre,Chile,41,64,,105,-76.532004,3.451668
27842,2014,Octubre,Chile,0,10,,10,-77.061029,3.8844260000000004
27843,2014,Octubre,Chile,3776,5119,,8895,-74.140516,4.697157
27844,2014,Octubre,Chile,0,1,,1,-75.736374,4.815189
27845,2014,Octubre,Chile,38,72,,110,-75.42726,6.170465
27846,2014,Octubre,Chile,0,1,,1,-73.181317,7.1280470000000005
27847,2014,Octubre,China,0,1,,1,-76.532004,3.451668
27848,2014,Octubre,China,32,100,,132,-74.140516,4.697157
27849,2014,Octubre,China,0,2,,2,-75.42726,6.170465
27850,2014,Octubre,Chipre,1,0,,1,-75.42726,6.170465
27851,2014,Octubre,Dinamarca,0,1,,1,-74.77647900000001,10.886686
27852,2014,Octubre,Dinamarca,0,2,,2,-76.532004,3.451668
27853,2014,Octubre,Dinamarca,7,6,,13,-74.140516,4.697157
27854,2014,Octubre,Dinamarca,0,1,,1,-75.42726,6.170465
27855,2014,Octubre,Dominica,2,0,,2,-74.140516,4.697157
27856,2014,Octubre,Ecuador,46,129,,175,-76.876446,0.33002
27857,2014,Octubre,Ecuador,2454,3755,,6209,-77.35600000000001,0.81488
27858,2014,Octubre,Ecuador,13,329,,342,-78.802679,18.00143
27859,2014,Octubre,Ecuador,0,2,,2,-75.527794,10.406342
27860,2014,Octubre,Ecuador,0,3,,3,-75.516486,10.446304
27861,2014,Octubre,Ecuador,2,9,,11,-74.77647900000001,10.886686
27862,2014,Octubre,Ecuador,7,7,,14,-81.70216500000001,12.5862
27863,2014,Octubre,Ecuador,507,744,,1251,-76.532004,3.451668
27864,2014,Octubre,Ecuador,0,4,,4,-77.061029,3.8844260000000004
27865,2014,Octubre,Ecuador,2569,4433,,7002,-74.140516,4.697157
27866,2014,Octubre,Ecuador,2,1,,3,-75.736374,4.815189
27867,2014,Octubre,Ecuador,471,670,,1141,-75.42726,6.170465
27868,2014,Octubre,Ecuador,10,9,,19,-72.508188,7.927233
27869,2014,Octubre,Egipto,0,2,,2,-74.140516,4.697157
27870,2014,Octubre,El Salvador,4,4,,8,-75.516486,10.446304
27871,2014,Octubre,El Salvador,0,1,,1,-74.77647900000001,10.886686
27872,2014,Octubre,El Salvador,1,1,,2,-81.70216500000001,12.5862
27873,2014,Octubre,El Salvador,93,147,,240,-76.532004,3.451668
27874,2014,Octubre,El Salvador,639,1019,,1658,-74.140516,4.697157
27875,2014,Octubre,El Salvador,1,0,,1,-75.736374,4.815189
27876,2014,Octubre,El Salvador,80,199,,279,-75.42726,6.170465
27877,2014,Octubre,El Salvador,0,1,,1,-73.181317,7.1280470000000005
27878,2014,Octubre,Emiratos Árabes,1,7,,8,-74.140516,4.697157
27879,2014,Octubre,Emiratos Árabes,0,1,,1,-75.42726,6.170465
27880,2014,Octubre,Eslovaquia,0,2,,2,-74.140516,4.697157
27881,2014,Octubre,Eslovenia,1,0,,1,-74.140516,4.697157
27882,2014,Octubre,Estados Unidos de América,4,25,,29,-75.527794,10.406342
27883,2014,Octubre,Estados Unidos de América,1000,1791,,2791,-75.516486,10.446304
27884,2014,Octubre,Estados Unidos de América,174,418,,592,-74.77647900000001,10.886686
27885,2014,Octubre,Estados Unidos de América,0,17,,17,-74.765343,10.970933
27886,2014,Octubre,Estados Unidos de América,0,10,,10,-74.213989,11.247722999999999
27887,2014,Octubre,Estados Unidos de América,1,8,,9,-81.70216500000001,12.5862
27888,2014,Octubre,Estados Unidos de América,0,1,,1,-81.372937,13.338761300000002
27889,2014,Octubre,Estados Unidos de América,570,979,,1549,-76.532004,3.451668
27890,2014,Octubre,Estados Unidos de América,91,139,,230,-75.76635300000001,4.45285
27891,2014,Octubre,Estados Unidos de América,6438,13248,,19686,-74.140516,4.697157
27892,2014,Octubre,Estados Unidos de América,57,95,,152,-75.736374,4.815189
27893,2014,Octubre,Estados Unidos de América,1027,2889,,3916,-75.42726,6.170465
27894,2014,Octubre,Estados Unidos de América,12,32,,44,-73.181317,7.1280470000000005
27895,2014,Octubre,Estados Unidos de América,89,61,,150,-72.508188,7.927233
27896,2014,Octubre,Estados Unidos de América,0,4,,4,-76.7333,8.06667
27897,2014,Octubre,Estados Unidos de América,0,8,,8,-75.68164200000001,9.402597
27898,2014,Octubre,Estonia,0,1,,1,-76.532004,3.451668
27899,2014,Octubre,Estonia,4,4,,8,-74.140516,4.697157
27900,2014,Octubre,Estonia,0,1,,1,-75.42726,6.170465
27901,2014,Octubre,Filipinas,0,1,,1,-75.516486,10.446304
27902,2014,Octubre,Filipinas,0,1,,1,-74.77647900000001,10.886686
27903,2014,Octubre,Filipinas,0,6,,6,-76.532004,3.451668
27904,2014,Octubre,Filipinas,0,1,,1,-77.061029,3.8844260000000004
27905,2014,Octubre,Filipinas,1,23,,24,-74.140516,4.697157
27906,2014,Octubre,Finlandia,6,7,,13,-74.140516,4.697157
27907,2014,Octubre,Finlandia,1,0,,1,-72.508188,7.927233
27908,2014,Octubre,Francia,0,1,,1,-75.527794,10.406342
27909,2014,Octubre,Francia,1,1,,2,-74.77647900000001,10.886686
27910,2014,Octubre,Francia,4,12,,16,-76.532004,3.451668
27911,2014,Octubre,Francia,1263,2330,,3593,-74.140516,4.697157
27912,2014,Octubre,Francia,6,17,,23,-75.42726,6.170465
27913,2014,Octubre,Francia,0,1,,1,-72.508188,7.927233
27914,2014,Octubre,Gabón,0,1,,1,-74.140516,4.697157
27915,2014,Octubre,Ghana,1,2,,3,-74.140516,4.697157
27916,2014,Octubre,Grecia,2,2,,4,-74.140516,4.697157
27917,2014,Octubre,Guatemala,3,13,,16,-75.516486,10.446304
27918,2014,Octubre,Guatemala,0,4,,4,-74.77647900000001,10.886686
27919,2014,Octubre,Guatemala,1,2,,3,-81.70216500000001,12.5862
27920,2014,Octubre,Guatemala,32,60,,92,-76.532004,3.451668
27921,2014,Octubre,Guatemala,0,6,,6,-77.061029,3.8844260000000004
27922,2014,Octubre,Guatemala,194,450,,644,-74.140516,4.697157
27923,2014,Octubre,Guatemala,2,6,,8,-75.736374,4.815189
27924,2014,Octubre,Guatemala,19,72,,91,-75.42726,6.170465
27925,2014,Octubre,Guatemala,1,2,,3,-73.181317,7.1280470000000005
27926,2014,Octubre,Guatemala,0,4,,4,-72.508188,7.927233
27927,2014,Octubre,Guyana,1,0,,1,-74.140516,4.697157
27928,2014,Octubre,Guadalupe/Territorio Francés,0,1,,1,-76.532004,3.451668
27929,2014,Octubre,Guadalupe/Territorio Francés,0,1,,1,-74.140516,4.697157
27930,2014,Octubre,Guayana Francesa/Departamento de Ultramar Francés,0,1,,1,-75.527794,10.406342
27931,2014,Octubre,Guayana Francesa/Departamento de Ultramar Francés,0,1,,1,-74.140516,4.697157
27932,2014,Octubre,Haití,0,1,,1,-74.77647900000001,10.886686
27933,2014,Octubre,Haití,1,0,,1,-76.532004,3.451668
27934,2014,Octubre,Haití,2,18,,20,-74.140516,4.697157
27935,2014,Octubre,Haití,2,2,,4,-75.42726,6.170465
27936,2014,Octubre,Honduras,1,2,,3,-75.516486,10.446304
27937,2014,Octubre,Honduras,0,28,,28,-74.77647900000001,10.886686
27938,2014,Octubre,Honduras,0,6,,6,-81.703935,12.574411099999999
27939,2014,Octubre,Honduras,1,2,,3,-81.70216500000001,12.5862
27940,2014,Octubre,Honduras,0,3,,3,-81.372937,13.338761300000002
27941,2014,Octubre,Honduras,8,11,,19,-76.532004,3.451668
27942,2014,Octubre,Honduras,32,63,,95,-74.140516,4.697157
27943,2014,Octubre,Honduras,1,1,,2,-75.736374,4.815189
27944,2014,Octubre,Honduras,18,30,,48,-75.42726,6.170465
27945,2014,Octubre,Honduras,0,1,,1,-73.181317,7.1280470000000005
27946,2014,Octubre,Honduras,1,0,,1,-72.508188,7.927233
27947,2014,Octubre,Hong Kong,1,7,,8,-74.140516,4.697157
27948,2014,Octubre,Hong Kong,0,1,,1,-75.42726,6.170465
27949,2014,Octubre,Hungría,5,4,,9,-74.140516,4.697157
27950,2014,Octubre,India,0,2,,2,-74.77647900000001,10.886686
27951,2014,Octubre,India,3,17,,20,-74.140516,4.697157
27952,2014,Octubre,India,0,1,,1,-75.736374,4.815189
27953,2014,Octubre,India,0,2,,2,-75.42726,6.170465
27954,2014,Octubre,Indonesia,1,4,,5,-74.140516,4.697157
27955,2014,Octubre,Irán,0,3,,3,-74.140516,4.697157
27956,2014,Octubre,República de Irlanda,0,1,,1,-75.516486,10.446304
27957,2014,Octubre,República de Irlanda,3,10,,13,-74.140516,4.697157
27958,2014,Octubre,República de Irlanda,0,1,,1,-75.42726,6.170465
27959,2014,Octubre,Israel,0,2,,2,-75.516486,10.446304
27960,2014,Octubre,Israel,0,1,,1,-74.77647900000001,10.886686
27961,2014,Octubre,Israel,1,3,,4,-76.532004,3.451668
27962,2014,Octubre,Israel,12,99,,111,-74.140516,4.697157
27963,2014,Octubre,Israel,2,6,,8,-75.42726,6.170465
27964,2014,Octubre,Italia,0,2,,2,-75.516486,10.446304
27965,2014,Octubre,Italia,1,2,,3,-74.77647900000001,10.886686
27966,2014,Octubre,Italia,6,17,,23,-76.532004,3.451668
27967,2014,Octubre,Italia,59,206,,265,-74.140516,4.697157
27968,2014,Octubre,Italia,5,27,,32,-75.42726,6.170465
27969,2014,Octubre,Italia,0,1,,1,-73.181317,7.1280470000000005
27970,2014,Octubre,Jamaica,0,7,,7,-75.527794,10.406342
27971,2014,Octubre,Jamaica,1,2,,3,-75.516486,10.446304
27972,2014,Octubre,Jamaica,0,1,,1,-74.77647900000001,10.886686
27973,2014,Octubre,Jamaica,0,1,,1,-81.70216500000001,12.5862
27974,2014,Octubre,Jamaica,3,5,,8,-76.532004,3.451668
27975,2014,Octubre,Jamaica,5,8,,13,-74.140516,4.697157
27976,2014,Octubre,Jamaica,1,2,,3,-75.42726,6.170465
27977,2014,Octubre,Japón,0,1,,1,-74.77647900000001,10.886686
27978,2014,Octubre,Japón,2,6,,8,-76.532004,3.451668
27979,2014,Octubre,Japón,8,29,,37,-74.140516,4.697157
27980,2014,Octubre,Japón,0,1,,1,-75.736374,4.815189
27981,2014,Octubre,Japón,1,3,,4,-75.42726,6.170465
27982,2014,Octubre,Jordania,1,1,,2,-74.140516,4.697157
27983,2014,Octubre,Kazajistán,0,2,,2,-74.140516,4.697157
27984,2014,Octubre,Kenia,2,2,,4,-76.532004,3.451668
27985,2014,Octubre,Kenia,0,3,,3,-74.140516,4.697157
27986,2014,Octubre,República de Kosovo,0,1,,1,-74.140516,4.697157
27987,2014,Octubre,Letonia,0,1,,1,-74.140516,4.697157
27988,2014,Octubre,Lituania,4,5,,9,-74.140516,4.697157
27989,2014,Octubre,Líbano,6,6,,12,-74.140516,4.697157
27990,2014,Octubre,Luxemburgo,0,2,,2,-74.140516,4.697157
27991,2014,Octubre,Malasia,2,1,,3,-74.140516,4.697157
27992,2014,Octubre,Malasia,1,0,,1,-75.42726,6.170465
27993,2014,Octubre,Malta,2,1,,3,-74.140516,4.697157
27994,2014,Octubre,México,0,1,,1,-75.527794,10.406342
27995,2014,Octubre,México,10,28,,38,-75.516486,10.446304
27996,2014,Octubre,México,11,37,,48,-74.77647900000001,10.886686
27997,2014,Octubre,México,0,1,,1,-74.213989,11.247722999999999
27998,2014,Octubre,México,1,4,,5,-81.70216500000001,12.5862
27999,2014,Octubre,México,84,157,,241,-76.532004,3.451668
28000,2014,Octubre,México,3024,6400,,9424,-74.140516,4.697157
28001,2014,Octubre,México,5,16,,21,-75.736374,4.815189
28002,2014,Octubre,México,122,251,,373,-75.42726,6.170465
28003,2014,Octubre,México,7,15,,22,-73.181317,7.1280470000000005
28004,2014,Octubre,México,10,16,,26,-72.508188,7.927233
28005,2014,Octubre,Mónaco,0,2,,2,-74.140516,4.697157
28006,2014,Octubre,Namibia,1,1,,2,-74.140516,4.697157
28007,2014,Octubre,Nicaragua,0,3,,3,-75.516486,10.446304
28008,2014,Octubre,Nicaragua,1,1,,2,-74.77647900000001,10.886686
28009,2014,Octubre,Nicaragua,0,5,,5,-76.532004,3.451668
28010,2014,Octubre,Nicaragua,29,42,,71,-74.140516,4.697157
28011,2014,Octubre,Nicaragua,2,1,,3,-75.736374,4.815189
28012,2014,Octubre,Nicaragua,7,25,,32,-75.42726,6.170465
28013,2014,Octubre,Nicaragua,3,24,,27,-72.508188,7.927233
28014,2014,Octubre,Nigeria,0,2,,2,-74.140516,4.697157
28015,2014,Octubre,Nigeria,0,5,,5,-75.42726,6.170465
28016,2014,Octubre,Noruega,13,26,,39,-74.140516,4.697157
28017,2014,Octubre,Noruega,1,1,,2,-75.42726,6.170465
28018,2014,Octubre,Nueva Zelanda,0,2,,2,-75.516486,10.446304
28019,2014,Octubre,Nueva Zelanda,1,3,,4,-76.532004,3.451668
28020,2014,Octubre,Nueva Zelanda,4,6,,10,-74.140516,4.697157
28021,2014,Octubre,Omán,0,1,,1,-74.140516,4.697157
28022,2014,Octubre,Panamá,796,765,,1561,-75.527794,10.406342
28023,2014,Octubre,Panamá,1848,2320,,4168,-75.516486,10.446304
28024,2014,Octubre,Panamá,219,455,,674,-74.77647900000001,10.886686
28025,2014,Octubre,Panamá,0,14,,14,-74.765343,10.970933
28026,2014,Octubre,Panamá,3,5,,8,-74.213989,11.247722999999999
28027,2014,Octubre,Panamá,1,3,,4,-81.703935,12.574411099999999
28028,2014,Octubre,Panamá,1124,877,,2001,-81.70216500000001,12.5862
28029,2014,Octubre,Panamá,1,2,,3,-81.372937,13.338761300000002
28030,2014,Octubre,Panamá,304,684,,988,-76.532004,3.451668
28031,2014,Octubre,Panamá,0,28,,28,-77.061029,3.8844260000000004
28032,2014,Octubre,Panamá,2670,5003,,7673,-74.140516,4.697157
28033,2014,Octubre,Panamá,58,142,,200,-75.736374,4.815189
28034,2014,Octubre,Panamá,781,1620,,2401,-75.42726,6.170465
28035,2014,Octubre,Panamá,0,1,,1,-77.401154,6.222551999999999
28036,2014,Octubre,Panamá,2,7,,9,-77.762647,7.102626
28037,2014,Octubre,Panamá,21,32,,53,-73.181317,7.1280470000000005
28038,2014,Octubre,Panamá,97,143,,240,-72.508188,7.927233
28039,2014,Octubre,Panamá,0,1,,1,-76.7333,8.06667
28040,2014,Octubre,Panamá,42,69,,111,-77.35002,8.63337
28041,2014,Octubre,Panamá,0,1,,1,-75.68164200000001,9.402597
28042,2014,Octubre,Paraguay,8,8,,16,-75.516486,10.446304
28043,2014,Octubre,Paraguay,2,1,,3,-74.77647900000001,10.886686
28044,2014,Octubre,Paraguay,11,10,,21,-81.70216500000001,12.5862
28045,2014,Octubre,Paraguay,12,32,,44,-76.532004,3.451668
28046,2014,Octubre,Paraguay,36,50,,86,-74.140516,4.697157
28047,2014,Octubre,Paraguay,12,13,,25,-75.42726,6.170465
28048,2014,Octubre,Paraguay,1,0,,1,-72.508188,7.927233
28049,2014,Octubre,Perú,73,101,,174,-69.941498,4.191162
28050,2014,Octubre,Perú,1,3,,4,-69.94143100000001,4.214082
28051,2014,Octubre,Perú,2,11,,13,-77.35600000000001,0.81488
28052,2014,Octubre,Perú,11,10,,21,-75.516486,10.446304
28053,2014,Octubre,Perú,1,3,,4,-74.77647900000001,10.886686
28054,2014,Octubre,Perú,221,186,,407,-81.70216500000001,12.5862
28055,2014,Octubre,Perú,263,375,,638,-76.532004,3.451668
28056,2014,Octubre,Perú,5623,7864,,13487,-74.140516,4.697157
28057,2014,Octubre,Perú,3,0,,3,-75.736374,4.815189
28058,2014,Octubre,Perú,319,552,,871,-75.42726,6.170465
28059,2014,Octubre,Perú,1,0,,1,-73.181317,7.1280470000000005
28060,2014,Octubre,Perú,2,2,,4,-72.508188,7.927233
28061,2014,Octubre,Polonia,16,26,,42,-74.140516,4.697157
28062,2014,Octubre,Portugal,2,2,,4,-75.516486,10.446304
28063,2014,Octubre,Portugal,0,1,,1,-74.77647900000001,10.886686
28064,2014,Octubre,Portugal,1,2,,3,-76.532004,3.451668
28065,2014,Octubre,Portugal,308,589,,897,-74.140516,4.697157
28066,2014,Octubre,Portugal,2,4,,6,-75.42726,6.170465
28067,2014,Octubre,Puerto Rico/Territorio de Estados Unidos,3,6,,9,-75.516486,10.446304
28068,2014,Octubre,Puerto Rico/Territorio de Estados Unidos,2,17,,19,-74.77647900000001,10.886686
28069,2014,Octubre,Puerto Rico/Territorio de Estados Unidos,18,37,,55,-76.532004,3.451668
28070,2014,Octubre,Puerto Rico/Territorio de Estados Unidos,184,273,,457,-74.140516,4.697157
28071,2014,Octubre,Puerto Rico/Territorio de Estados Unidos,0,8,,8,-75.736374,4.815189
28072,2014,Octubre,Puerto Rico/Territorio de Estados Unidos,21,58,,79,-75.42726,6.170465
28073,2014,Octubre,Puerto Rico/Territorio de Estados Unidos,0,2,,2,-73.181317,7.1280470000000005
28074,2014,Octubre,Puerto Rico/Territorio de Estados Unidos,0,2,,2,-72.508188,7.927233
28075,2014,Octubre,Reino Unido de Gran Bretaña e Irlanda del Norte,1,3,,4,-75.527794,10.406342
28076,2014,Octubre,Reino Unido de Gran Bretaña e Irlanda del Norte,2,1,,3,-75.516486,10.446304
28077,2014,Octubre,Reino Unido de Gran Bretaña e Irlanda del Norte,1,10,,11,-74.77647900000001,10.886686
28078,2014,Octubre,Reino Unido de Gran Bretaña e Irlanda del Norte,0,1,,1,-74.213989,11.247722999999999
28079,2014,Octubre,Reino Unido de Gran Bretaña e Irlanda del Norte,4,20,,24,-76.532004,3.451668
28080,2014,Octubre,Reino Unido de Gran Bretaña e Irlanda del Norte,380,746,,1126,-74.140516,4.697157
28081,2014,Octubre,Reino Unido de Gran Bretaña e Irlanda del Norte,0,1,,1,-75.736374,4.815189
28082,2014,Octubre,Reino Unido de Gran Bretaña e Irlanda del Norte,4,13,,17,-75.42726,6.170465
28083,2014,Octubre,República CentroÁfricana,1,1,,2,-74.140516,4.697157
28084,2014,Octubre,Federación de Rusia,0,1,,1,-75.516486,10.446304
28085,2014,Octubre,Federación de Rusia,0,1,,1,-74.77647900000001,10.886686
28086,2014,Octubre,Federación de Rusia,0,1,,1,-74.213989,11.247722999999999
28087,2014,Octubre,Federación de Rusia,19,30,,49,-74.140516,4.697157
28088,2014,Octubre,Federación de Rusia,2,1,,3,-75.736374,4.815189
28089,2014,Octubre,República Dominicana,1,8,,9,-75.527794,10.406342
28090,2014,Octubre,República Dominicana,6,10,,16,-75.516486,10.446304
28091,2014,Octubre,República Dominicana,4,17,,21,-74.77647900000001,10.886686
28092,2014,Octubre,República Dominicana,0,1,,1,-81.70216500000001,12.5862
28093,2014,Octubre,República Dominicana,19,25,,44,-76.532004,3.451668
28094,2014,Octubre,República Dominicana,423,670,,1093,-74.140516,4.697157
28095,2014,Octubre,República Dominicana,1,3,,4,-75.736374,4.815189
28096,2014,Octubre,República Dominicana,24,76,,100,-75.42726,6.170465
28097,2014,Octubre,República Dominicana,0,1,,1,-73.181317,7.1280470000000005
28098,2014,Octubre,República Dominicana,0,6,,6,-72.508188,7.927233
28099,2014,Octubre,Rumania,2,7,,9,-74.140516,4.697157
28100,2014,Octubre,San  Vicente y las Granadinas,1,0,,1,-75.516486,10.446304
28101,2014,Octubre,Santa Lucia,0,1,,1,-74.140516,4.697157
28102,2014,Octubre,Serbia,0,1,,1,-74.140516,4.697157
28103,2014,Octubre,Singapur,1,3,,4,-74.140516,4.697157
28104,2014,Octubre,Sudáfrica,2,5,,7,-74.140516,4.697157
28105,2014,Octubre,Sudán,0,1,,1,-74.140516,4.697157
28106,2014,Octubre,Suecia,0,1,,1,-75.516486,10.446304
28107,2014,Octubre,Suecia,17,24,,41,-74.140516,4.697157
28108,2014,Octubre,Suecia,0,1,,1,-72.508188,7.927233
28109,2014,Octubre,Suiza,2,0,,2,-75.516486,10.446304
28110,2014,Octubre,Suiza,0,1,,1,-74.77647900000001,10.886686
28111,2014,Octubre,Suiza,0,6,,6,-76.532004,3.451668
28112,2014,Octubre,Suiza,45,83,,128,-74.140516,4.697157
28113,2014,Octubre,Suiza,4,7,,11,-75.42726,6.170465
28114,2014,Octubre,Surinam,0,2,,2,-75.527794,10.406342
28115,2014,Octubre,Surinam,1,0,,1,-76.532004,3.451668
28116,2014,Octubre,Surinam,2,3,,5,-74.140516,4.697157
28117,2014,Octubre,Surinam,5,4,,9,-75.42726,6.170465
28118,2014,Octubre,Taiwán,2,5,,7,-74.140516,4.697157
28119,2014,Octubre,Taiwán,0,5,,5,-75.42726,6.170465
28120,2014,Octubre,Tailandia,2,3,,5,-76.532004,3.451668
28121,2014,Octubre,Tailandia,1,3,,4,-74.140516,4.697157
28122,2014,Octubre,Tailandia,0,1,,1,-75.42726,6.170465
28123,2014,Octubre,Trinidad y Tobago,0,1,,1,-75.527794,10.406342
28124,2014,Octubre,Trinidad y Tobago,2,0,,2,-75.516486,10.446304
28125,2014,Octubre,Trinidad y Tobago,1,3,,4,-74.77647900000001,10.886686
28126,2014,Octubre,Trinidad y Tobago,0,14,,14,-74.765343,10.970933
28127,2014,Octubre,Trinidad y Tobago,9,22,,31,-76.532004,3.451668
28128,2014,Octubre,Trinidad y Tobago,7,16,,23,-74.140516,4.697157
28129,2014,Octubre,Trinidad y Tobago,0,2,,2,-75.736374,4.815189
28130,2014,Octubre,Trinidad y Tobago,1,4,,5,-75.42726,6.170465
28131,2014,Octubre,Trinidad y Tobago,2,0,,2,-73.181317,7.1280470000000005
28132,2014,Octubre,Turquía,1,0,,1,-74.77647900000001,10.886686
28133,2014,Octubre,Turquía,1,0,,1,-76.532004,3.451668
28134,2014,Octubre,Turquía,3,14,,17,-74.140516,4.697157
28135,2014,Octubre,Turquía,0,4,,4,-75.42726,6.170465
28136,2014,Octubre,Ucrania,0,1,,1,-76.532004,3.451668
28137,2014,Octubre,Ucrania,5,7,,12,-74.140516,4.697157
28138,2014,Octubre,Ucrania,1,0,,1,-75.42726,6.170465
28139,2014,Octubre,Uganda,1,0,,1,-74.140516,4.697157
28140,2014,Octubre,Uruguay,21,9,,30,-75.516486,10.446304
28141,2014,Octubre,Uruguay,1,2,,3,-74.77647900000001,10.886686
28142,2014,Octubre,Uruguay,20,16,,36,-81.70216500000001,12.5862
28143,2014,Octubre,Uruguay,22,24,,46,-76.532004,3.451668
28144,2014,Octubre,Uruguay,45,94,,139,-74.140516,4.697157
28145,2014,Octubre,Uruguay,65,75,,140,-75.42726,6.170465
28146,2014,Octubre,Uruguay,0,1,,1,-72.508188,7.927233
28147,2014,Octubre,Venezuela,0,11,,11,-75.527794,10.406342
28148,2014,Octubre,Venezuela,7,35,,42,-75.516486,10.446304
28149,2014,Octubre,Venezuela,19,74,,93,-74.77647900000001,10.886686
28150,2014,Octubre,Venezuela,0,3,,3,-74.765343,10.970933
28151,2014,Octubre,Venezuela,1236,2044,,3280,-72.129595,11.360028999999999
28152,2014,Octubre,Venezuela,18,38,,56,-76.532004,3.451668
28153,2014,Octubre,Venezuela,3765,4607,,8372,-74.140516,4.697157
28154,2014,Octubre,Venezuela,0,2,,2,-75.736374,4.815189
28155,2014,Octubre,Venezuela,68,92,,160,-75.42726,6.170465
28156,2014,Octubre,Venezuela,224,423,,647,-67.48402800000001,6.185536
28157,2014,Octubre,Venezuela,108,155,,263,-70.74025300000001,7.088728999999999
28158,2014,Octubre,Venezuela,0,3,,3,-73.181317,7.1280470000000005
28159,2014,Octubre,Venezuela,2798,3919,,6717,-72.453013,7.819
28160,2014,Octubre,Venezuela,282,386,,668,-72.508188,7.927233
28161,2014,Octubre,Venezuela,0,2,,2,-75.68164200000001,9.402597
28162,2014,Octubre,Islas Turcas y Caicos/Territorio Británico de Ultramar,2,2,,4,-74.140516,4.697157
28163,2014,Octubre,Desconocido,2,34,,36,-74.140516,4.697157
28164,2014,Octubre,Desconocido,0,1,,1,-75.42726,6.170465
28165,2014,Octubre,Desconocido,0,1,,1,-67.48402800000001,6.185536
28166,2014,Noviembre,Afganistán,0,2,,2,-74.140516,4.697157
28167,2014,Noviembre,Albania,0,1,,1,-74.140516,4.697157
28168,2014,Noviembre,Alemania,0,1,,1,-77.35600000000001,0.81488
28169,2014,Noviembre,Alemania,0,2,,2,-75.516486,10.446304
28170,2014,Noviembre,Alemania,2,1,,3,-74.77647900000001,10.886686
28171,2014,Noviembre,Alemania,1,0,,1,-81.70216500000001,12.5862
28172,2014,Noviembre,Alemania,4,7,,11,-76.532004,3.451668
28173,2014,Noviembre,Alemania,1439,2705,,4144,-74.140516,4.697157
28174,2014,Noviembre,Alemania,0,2,,2,-75.736374,4.815189
28175,2014,Noviembre,Alemania,8,10,,18,-75.42726,6.170465
28176,2014,Noviembre,Andorra,0,1,,1,-74.140516,4.697157
28177,2014,Noviembre,Antigua y Barbuda,0,7,,7,-75.527794,10.406342
28178,2014,Noviembre,Antigua y Barbuda,1,1,,2,-75.42726,6.170465
28179,2014,Noviembre,Países Bajos,8,3,,11,-75.527794,10.406342
28180,2014,Noviembre,Países Bajos,0,4,,4,-75.516486,10.446304
28181,2014,Noviembre,Países Bajos,0,1,,1,-74.77647900000001,10.886686
28182,2014,Noviembre,Países Bajos,0,1,,1,-81.70216500000001,12.5862
28183,2014,Noviembre,Países Bajos,8,18,,26,-76.532004,3.451668
28184,2014,Noviembre,Países Bajos,71,110,,181,-74.140516,4.697157
28185,2014,Noviembre,Países Bajos,0,3,,3,-75.736374,4.815189
28186,2014,Noviembre,Países Bajos,44,70,,114,-75.42726,6.170465
28187,2014,Noviembre,Países Bajos,1,3,,4,-73.181317,7.1280470000000005
28188,2014,Noviembre,Argelia,3,4,,7,-74.140516,4.697157
28189,2014,Noviembre,Argelia,1,0,,1,-75.42726,6.170465
28190,2014,Noviembre,Argentina,0,1,,1,-77.35600000000001,0.81488
28191,2014,Noviembre,Argentina,101,86,,187,-75.516486,10.446304
28192,2014,Noviembre,Argentina,7,8,,15,-74.77647900000001,10.886686
28193,2014,Noviembre,Argentina,68,53,,121,-81.70216500000001,12.5862
28194,2014,Noviembre,Argentina,69,86,,155,-76.532004,3.451668
28195,2014,Noviembre,Argentina,2024,3082,,5106,-74.140516,4.697157
28196,2014,Noviembre,Argentina,1,1,,2,-75.736374,4.815189
28197,2014,Noviembre,Argentina,104,171,,275,-75.42726,6.170465
28198,2014,Noviembre,Argentina,4,2,,6,-73.181317,7.1280470000000005
28199,2014,Noviembre,Argentina,1,2,,3,-72.508188,7.927233
28200,2014,Noviembre,Aruba,54,62,,116,-75.527794,10.406342
28201,2014,Noviembre,Aruba,0,8,,8,-75.516486,10.446304
28202,2014,Noviembre,Aruba,3,3,,6,-74.77647900000001,10.886686
28203,2014,Noviembre,Aruba,0,3,,3,-74.765343,10.970933
28204,2014,Noviembre,Aruba,18,21,,39,-74.213989,11.247722999999999
28205,2014,Noviembre,Aruba,3,5,,8,-76.532004,3.451668
28206,2014,Noviembre,Aruba,396,516,,912,-74.140516,4.697157
28207,2014,Noviembre,Aruba,3,4,,7,-75.42726,6.170465
28208,2014,Noviembre,Aruba,0,2,,2,-73.181317,7.1280470000000005
28209,2014,Noviembre,Aruba,0,1,,1,-72.508188,7.927233
28210,2014,Noviembre,Australia,1,2,,3,-75.516486,10.446304
28211,2014,Noviembre,Australia,1,3,,4,-74.77647900000001,10.886686
28212,2014,Noviembre,Australia,4,9,,13,-76.532004,3.451668
28213,2014,Noviembre,Australia,39,44,,83,-74.140516,4.697157
28214,2014,Noviembre,Australia,1,1,,2,-75.736374,4.815189
28215,2014,Noviembre,Australia,24,18,,42,-75.42726,6.170465
28216,2014,Noviembre,Australia,0,2,,2,-73.181317,7.1280470000000005
28217,2014,Noviembre,Austria,1,1,,2,-76.532004,3.451668
28218,2014,Noviembre,Austria,12,40,,52,-74.140516,4.697157
28219,2014,Noviembre,Austria,0,1,,1,-75.42726,6.170465
28220,2014,Noviembre,Bahamas,0,2,,2,-74.213989,11.247722999999999
28221,2014,Noviembre,Bahamas,1,0,,1,-76.532004,3.451668
28222,2014,Noviembre,Bahamas,0,1,,1,-74.140516,4.697157
28223,2014,Noviembre,Bahamas,0,2,,2,-75.42726,6.170465
28224,2014,Noviembre,Barbados,0,1,,1,-76.532004,3.451668
28225,2014,Noviembre,República de Belarús,2,0,,2,-74.140516,4.697157
28226,2014,Noviembre,República de Belarús,0,2,,2,-72.453013,7.819
28227,2014,Noviembre,Bélgica,0,2,,2,-75.516486,10.446304
28228,2014,Noviembre,Bélgica,2,2,,4,-76.532004,3.451668
28229,2014,Noviembre,Bélgica,22,43,,65,-74.140516,4.697157
28230,2014,Noviembre,Bélgica,1,8,,9,-75.42726,6.170465
28231,2014,Noviembre,Belice,1,0,,1,-76.532004,3.451668
28232,2014,Noviembre,Belice,0,2,,2,-74.140516,4.697157
28233,2014,Noviembre,Benín,1,0,,1,-74.140516,4.697157
28234,2014,Noviembre,Bolivia,1,0,,1,-77.35600000000001,0.81488
28235,2014,Noviembre,Bolivia,5,2,,7,-75.516486,10.446304
28236,2014,Noviembre,Bolivia,0,3,,3,-74.77647900000001,10.886686
28237,2014,Noviembre,Bolivia,3,3,,6,-81.70216500000001,12.5862
28238,2014,Noviembre,Bolivia,8,16,,24,-76.532004,3.451668
28239,2014,Noviembre,Bolivia,442,522,,964,-74.140516,4.697157
28240,2014,Noviembre,Bolivia,0,1,,1,-75.736374,4.815189
28241,2014,Noviembre,Bolivia,34,46,,80,-75.42726,6.170465
28242,2014,Noviembre,Bolivia,0,1,,1,-73.181317,7.1280470000000005
28243,2014,Noviembre,Botsuana,1,0,,1,-74.140516,4.697157
28244,2014,Noviembre,Brasil,111,131,,242,-69.941498,4.191162
28245,2014,Noviembre,Brasil,1,3,,4,-69.94143100000001,4.214082
28246,2014,Noviembre,Brasil,1,9,,10,-75.527794,10.406342
28247,2014,Noviembre,Brasil,73,49,,122,-75.516486,10.446304
28248,2014,Noviembre,Brasil,2,17,,19,-74.77647900000001,10.886686
28249,2014,Noviembre,Brasil,81,61,,142,-81.70216500000001,12.5862
28250,2014,Noviembre,Brasil,53,71,,124,-76.532004,3.451668
28251,2014,Noviembre,Brasil,3865,5661,,9526,-74.140516,4.697157
28252,2014,Noviembre,Brasil,0,2,,2,-75.736374,4.815189
28253,2014,Noviembre,Brasil,122,229,,351,-75.42726,6.170465
28254,2014,Noviembre,Brasil,9,9,,18,-73.181317,7.1280470000000005
28255,2014,Noviembre,Brasil,0,2,,2,-72.508188,7.927233
28256,2014,Noviembre,Brunei Darussalam,1,0,,1,-74.140516,4.697157
28257,2014,Noviembre,Bulgaria,2,5,,7,-74.140516,4.697157
28258,2014,Noviembre,Burkina Faso,2,1,,3,-74.140516,4.697157
28259,2014,Noviembre,Islas Caimán/Territorio Británico de Ultramar,2,4,,6,-75.527794,10.406342
28260,2014,Noviembre,Islas Caimán/Territorio Británico de Ultramar,0,2,,2,-74.77647900000001,10.886686
28261,2014,Noviembre,Islas Caimán/Territorio Británico de Ultramar,0,6,,6,-74.140516,4.697157
28262,2014,Noviembre,Islas Caimán/Territorio Británico de Ultramar,0,1,,1,-75.736374,4.815189
28263,2014,Noviembre,Camerún,0,1,,1,-75.42726,6.170465
28264,2014,Noviembre,Canadá,9,12,,21,-75.516486,10.446304
28265,2014,Noviembre,Canadá,3,6,,9,-74.77647900000001,10.886686
28266,2014,Noviembre,Canadá,23,20,,43,-76.532004,3.451668
28267,2014,Noviembre,Canadá,508,826,,1334,-74.140516,4.697157
28268,2014,Noviembre,Canadá,3,6,,9,-75.736374,4.815189
28269,2014,Noviembre,Canadá,60,114,,174,-75.42726,6.170465
28270,2014,Noviembre,Canadá,4,3,,7,-73.181317,7.1280470000000005
28271,2014,Noviembre,Canadá,6,4,,10,-72.508188,7.927233
28272,2014,Noviembre,España,0,5,,5,-75.527794,10.406342
28273,2014,Noviembre,España,3,2,,5,-75.516486,10.446304
28274,2014,Noviembre,España,0,3,,3,-74.77647900000001,10.886686
28275,2014,Noviembre,España,200,300,,500,-76.532004,3.451668
28276,2014,Noviembre,España,2500,5581,,8081,-74.140516,4.697157
28277,2014,Noviembre,España,2,4,,6,-75.736374,4.815189
28278,2014,Noviembre,España,136,342,,478,-75.42726,6.170465
28279,2014,Noviembre,España,0,1,,1,-72.508188,7.927233
28280,2014,Noviembre,España,0,36,,36,-74.140516,4.697157
28281,2014,Noviembre,España,0,1,,1,-75.42726,6.170465
28282,2014,Noviembre,República de Corea,0,1,,1,-74.77647900000001,10.886686
28283,2014,Noviembre,República de Corea,2,23,,25,-74.140516,4.697157
28284,2014,Noviembre,República de Corea,0,1,,1,-75.42726,6.170465
28285,2014,Noviembre,Costa de Marfil,0,1,,1,-76.532004,3.451668
28286,2014,Noviembre,Costa de Marfil,1,1,,2,-74.140516,4.697157
28287,2014,Noviembre,Noviembre,2,16,,18,-75.527794,10.406342
28288,2014,Noviembre,Noviembre,8,13,,21,-75.516486,10.446304
28289,2014,Noviembre,Noviembre,5,9,,14,-74.77647900000001,10.886686
28290,2014,Noviembre,Noviembre,0,1,,1,-74.765343,10.970933
28291,2014,Noviembre,Noviembre,0,2,,2,-81.703935,12.574411099999999
28292,2014,Noviembre,Noviembre,2,4,,6,-81.70216500000001,12.5862
28293,2014,Noviembre,Noviembre,20,34,,54,-76.532004,3.451668
28294,2014,Noviembre,Noviembre,621,1126,,1747,-74.140516,4.697157
28295,2014,Noviembre,Noviembre,3,22,,25,-75.736374,4.815189
28296,2014,Noviembre,Noviembre,80,168,,248,-75.42726,6.170465
28297,2014,Noviembre,Noviembre,1,1,,2,-73.181317,7.1280470000000005
28298,2014,Noviembre,Noviembre,3,4,,7,-72.508188,7.927233
28299,2014,Noviembre,Croacia,0,1,,1,-75.516486,10.446304
28300,2014,Noviembre,Croacia,2,9,,11,-74.140516,4.697157
28301,2014,Noviembre,Cuba,104,97,,201,-75.516486,10.446304
28302,2014,Noviembre,Cuba,4,12,,16,-74.77647900000001,10.886686
28303,2014,Noviembre,Cuba,0,3,,3,-74.213989,11.247722999999999
28304,2014,Noviembre,Cuba,2,5,,7,-81.70216500000001,12.5862
28305,2014,Noviembre,Cuba,20,18,,38,-76.532004,3.451668
28306,2014,Noviembre,Cuba,224,394,,618,-74.140516,4.697157
28307,2014,Noviembre,Cuba,3,1,,4,-75.736374,4.815189
28308,2014,Noviembre,Cuba,12,16,,28,-75.42726,6.170465
28309,2014,Noviembre,Cuba,0,2,,2,-73.181317,7.1280470000000005
28310,2014,Noviembre,Cuba,21,21,,42,-72.508188,7.927233
28311,2014,Noviembre,Curazao,3,3,,6,-75.527794,10.406342
28312,2014,Noviembre,Curazao,50,47,,97,-74.77647900000001,10.886686
28313,2014,Noviembre,Curazao,0,1,,1,-74.765343,10.970933
28314,2014,Noviembre,Curazao,8,10,,18,-74.213989,11.247722999999999
28315,2014,Noviembre,Curazao,0,2,,2,-76.532004,3.451668
28316,2014,Noviembre,Curazao,290,387,,677,-74.140516,4.697157
28317,2014,Noviembre,Curazao,141,218,,359,-75.42726,6.170465
28318,2014,Noviembre,Curazao,1,1,,2,-73.181317,7.1280470000000005
28319,2014,Noviembre,República Checa,5,14,,19,-74.140516,4.697157
28320,2014,Noviembre,República Checa,0,3,,3,-75.42726,6.170465
28321,2014,Noviembre,Chile,1,1,,2,-77.35600000000001,0.81488
28322,2014,Noviembre,Chile,10,13,,23,-75.516486,10.446304
28323,2014,Noviembre,Chile,1,2,,3,-74.77647900000001,10.886686
28324,2014,Noviembre,Chile,16,18,,34,-81.70216500000001,12.5862
28325,2014,Noviembre,Chile,15,39,,54,-76.532004,3.451668
28326,2014,Noviembre,Chile,3743,5161,,8904,-74.140516,4.697157
28327,2014,Noviembre,Chile,3,0,,3,-75.736374,4.815189
28328,2014,Noviembre,Chile,30,83,,113,-75.42726,6.170465
28329,2014,Noviembre,Chile,2,0,,2,-73.181317,7.1280470000000005
28330,2014,Noviembre,Chile,1,0,,1,-72.508188,7.927233
28331,2014,Noviembre,China,0,1,,1,-76.532004,3.451668
28332,2014,Noviembre,China,30,135,,165,-74.140516,4.697157
28333,2014,Noviembre,China,0,2,,2,-75.42726,6.170465
28334,2014,Noviembre,Chipre,0,1,,1,-74.140516,4.697157
28335,2014,Noviembre,Chipre,0,1,,1,-75.42726,6.170465
28336,2014,Noviembre,Dinamarca,0,2,,2,-74.77647900000001,10.886686
28337,2014,Noviembre,Dinamarca,0,1,,1,-76.532004,3.451668
28338,2014,Noviembre,Dinamarca,8,10,,18,-74.140516,4.697157
28339,2014,Noviembre,Dinamarca,1,3,,4,-75.42726,6.170465
28340,2014,Noviembre,Dominica,1,0,,1,-74.140516,4.697157
28341,2014,Noviembre,Ecuador,52,102,,154,-76.876446,0.33002
28342,2014,Noviembre,Ecuador,2385,3518,,5903,-77.35600000000001,0.81488
28343,2014,Noviembre,Ecuador,4,137,,141,-78.802679,18.00143
28344,2014,Noviembre,Ecuador,2,9,,11,-75.516486,10.446304
28345,2014,Noviembre,Ecuador,2,5,,7,-74.77647900000001,10.886686
28346,2014,Noviembre,Ecuador,1,2,,3,-81.70216500000001,12.5862
28347,2014,Noviembre,Ecuador,548,538,,1086,-76.532004,3.451668
28348,2014,Noviembre,Ecuador,0,1,,1,-77.061029,3.8844260000000004
28349,2014,Noviembre,Ecuador,2748,4855,,7603,-74.140516,4.697157
28350,2014,Noviembre,Ecuador,1,2,,3,-75.736374,4.815189
28351,2014,Noviembre,Ecuador,462,633,,1095,-75.42726,6.170465
28352,2014,Noviembre,Ecuador,0,2,,2,-73.181317,7.1280470000000005
28353,2014,Noviembre,Ecuador,16,22,,38,-72.508188,7.927233
28354,2014,Noviembre,Egipto,2,3,,5,-74.140516,4.697157
28355,2014,Noviembre,El Salvador,2,3,,5,-75.516486,10.446304
28356,2014,Noviembre,El Salvador,1,2,,3,-74.77647900000001,10.886686
28357,2014,Noviembre,El Salvador,2,4,,6,-81.70216500000001,12.5862
28358,2014,Noviembre,El Salvador,82,162,,244,-76.532004,3.451668
28359,2014,Noviembre,El Salvador,652,1048,,1700,-74.140516,4.697157
28360,2014,Noviembre,El Salvador,95,240,,335,-75.42726,6.170465
28361,2014,Noviembre,Emiratos Árabes,0,5,,5,-74.140516,4.697157
28362,2014,Noviembre,Eslovaquia,0,1,,1,-76.532004,3.451668
28363,2014,Noviembre,Eslovaquia,2,1,,3,-74.140516,4.697157
28364,2014,Noviembre,Eslovenia,3,5,,8,-74.140516,4.697157
28365,2014,Noviembre,Estados Unidos de América,2,25,,27,-75.527794,10.406342
28366,2014,Noviembre,Estados Unidos de América,1590,2617,,4207,-75.516486,10.446304
28367,2014,Noviembre,Estados Unidos de América,183,405,,588,-74.77647900000001,10.886686
28368,2014,Noviembre,Estados Unidos de América,0,3,,3,-74.765343,10.970933
28369,2014,Noviembre,Estados Unidos de América,0,27,,27,-74.213989,11.247722999999999
28370,2014,Noviembre,Estados Unidos de América,7,9,,16,-81.70216500000001,12.5862
28371,2014,Noviembre,Estados Unidos de América,695,1209,,1904,-76.532004,3.451668
28372,2014,Noviembre,Estados Unidos de América,0,1,,1,-77.061029,3.8844260000000004
28373,2014,Noviembre,Estados Unidos de América,65,87,,152,-75.76635300000001,4.45285
28374,2014,Noviembre,Estados Unidos de América,7129,14301,,21430,-74.140516,4.697157
28375,2014,Noviembre,Estados Unidos de América,106,142,,248,-75.736374,4.815189
28376,2014,Noviembre,Estados Unidos de América,1514,3542,,5056,-75.42726,6.170465
28377,2014,Noviembre,Estados Unidos de América,18,48,,66,-73.181317,7.1280470000000005
28378,2014,Noviembre,Estados Unidos de América,50,54,,104,-72.508188,7.927233
28379,2014,Noviembre,Estados Unidos de América,0,1,,1,-76.7333,8.06667
28380,2014,Noviembre,Estados Unidos de América,0,12,,12,-75.68164200000001,9.402597
28381,2014,Noviembre,Estonia,0,2,,2,-74.140516,4.697157
28382,2014,Noviembre,Filipinas,0,3,,3,-75.516486,10.446304
28383,2014,Noviembre,Filipinas,0,2,,2,-74.77647900000001,10.886686
28384,2014,Noviembre,Filipinas,3,5,,8,-76.532004,3.451668
28385,2014,Noviembre,Filipinas,0,3,,3,-77.061029,3.8844260000000004
28386,2014,Noviembre,Filipinas,3,9,,12,-74.140516,4.697157
28387,2014,Noviembre,Finlandia,2,2,,4,-76.532004,3.451668
28388,2014,Noviembre,Finlandia,9,11,,20,-74.140516,4.697157
28389,2014,Noviembre,Finlandia,0,1,,1,-75.42726,6.170465
28390,2014,Noviembre,Francia,0,1,,1,-75.516486,10.446304
28391,2014,Noviembre,Francia,0,2,,2,-74.77647900000001,10.886686
28392,2014,Noviembre,Francia,6,12,,18,-76.532004,3.451668
28393,2014,Noviembre,Francia,1179,2242,,3421,-74.140516,4.697157
28394,2014,Noviembre,Francia,0,2,,2,-75.736374,4.815189
28395,2014,Noviembre,Francia,14,26,,40,-75.42726,6.170465
28396,2014,Noviembre,Georgia,1,0,,1,-74.140516,4.697157
28397,2014,Noviembre,Granada,1,3,,4,-74.213989,11.247722999999999
28398,2014,Noviembre,Grecia,1,5,,6,-74.140516,4.697157
28399,2014,Noviembre,Guatemala,7,25,,32,-75.516486,10.446304
28400,2014,Noviembre,Guatemala,4,6,,10,-74.77647900000001,10.886686
28401,2014,Noviembre,Guatemala,1,2,,3,-81.70216500000001,12.5862
28402,2014,Noviembre,Guatemala,20,29,,49,-76.532004,3.451668
28403,2014,Noviembre,Guatemala,242,469,,711,-74.140516,4.697157
28404,2014,Noviembre,Guatemala,0,4,,4,-75.736374,4.815189
28405,2014,Noviembre,Guatemala,31,107,,138,-75.42726,6.170465
28406,2014,Noviembre,Guatemala,0,1,,1,-73.181317,7.1280470000000005
28407,2014,Noviembre,Guatemala,4,9,,13,-72.508188,7.927233
28408,2014,Noviembre,Guyana,0,2,,2,-74.77647900000001,10.886686
28409,2014,Noviembre,Guyana,2,1,,3,-76.532004,3.451668
28410,2014,Noviembre,Guyana,0,4,,4,-74.140516,4.697157
28411,2014,Noviembre,Guinea,0,1,,1,-74.140516,4.697157
28412,2014,Noviembre,Guadalupe/Territorio Francés,0,2,,2,-74.140516,4.697157
28413,2014,Noviembre,Haití,0,11,,11,-75.516486,10.446304
28414,2014,Noviembre,Haití,1,0,,1,-76.532004,3.451668
28415,2014,Noviembre,Haití,1,0,,1,-75.42726,6.170465
28416,2014,Noviembre,Honduras,1,3,,4,-75.516486,10.446304
28417,2014,Noviembre,Honduras,3,5,,8,-74.77647900000001,10.886686
28418,2014,Noviembre,Honduras,1,15,,16,-81.703935,12.574411099999999
28419,2014,Noviembre,Honduras,0,3,,3,-81.70216500000001,12.5862
28420,2014,Noviembre,Honduras,4,2,,6,-81.372937,13.338761300000002
28421,2014,Noviembre,Honduras,6,4,,10,-76.532004,3.451668
28422,2014,Noviembre,Honduras,38,102,,140,-74.140516,4.697157
28423,2014,Noviembre,Honduras,0,1,,1,-75.736374,4.815189
28424,2014,Noviembre,Honduras,33,37,,70,-75.42726,6.170465
28425,2014,Noviembre,Honduras,1,1,,2,-72.508188,7.927233
28426,2014,Noviembre,Hong Kong,3,4,,7,-74.140516,4.697157
28427,2014,Noviembre,Hong Kong,0,1,,1,-75.42726,6.170465
28428,2014,Noviembre,Hungría,10,7,,17,-74.140516,4.697157
28429,2014,Noviembre,India,0,1,,1,-74.77647900000001,10.886686
28430,2014,Noviembre,India,0,12,,12,-76.532004,3.451668
28431,2014,Noviembre,India,5,22,,27,-74.140516,4.697157
28432,2014,Noviembre,India,0,1,,1,-75.42726,6.170465
28433,2014,Noviembre,Indonesia,1,2,,3,-76.532004,3.451668
28434,2014,Noviembre,Indonesia,3,11,,14,-74.140516,4.697157
28435,2014,Noviembre,Irán,0,3,,3,-74.140516,4.697157
28436,2014,Noviembre,República de Irlanda,0,1,,1,-76.532004,3.451668
28437,2014,Noviembre,República de Irlanda,4,8,,12,-74.140516,4.697157
28438,2014,Noviembre,Islandia,0,1,,1,-74.140516,4.697157
28439,2014,Noviembre,Israel,0,1,,1,-76.532004,3.451668
28440,2014,Noviembre,Israel,15,92,,107,-74.140516,4.697157
28441,2014,Noviembre,Israel,1,4,,5,-75.42726,6.170465
28442,2014,Noviembre,Italia,0,3,,3,-75.516486,10.446304
28443,2014,Noviembre,Italia,0,2,,2,-74.77647900000001,10.886686
28444,2014,Noviembre,Italia,0,1,,1,-74.213989,11.247722999999999
28445,2014,Noviembre,Italia,6,19,,25,-76.532004,3.451668
28446,2014,Noviembre,Italia,92,301,,393,-74.140516,4.697157
28447,2014,Noviembre,Italia,5,19,,24,-75.42726,6.170465
28448,2014,Noviembre,Italia,0,2,,2,-73.181317,7.1280470000000005
28449,2014,Noviembre,Jamaica,0,7,,7,-75.527794,10.406342
28450,2014,Noviembre,Jamaica,0,1,,1,-75.516486,10.446304
28451,2014,Noviembre,Jamaica,0,3,,3,-74.77647900000001,10.886686
28452,2014,Noviembre,Jamaica,0,3,,3,-81.703935,12.574411099999999
28453,2014,Noviembre,Jamaica,2,7,,9,-81.70216500000001,12.5862
28454,2014,Noviembre,Jamaica,2,13,,15,-74.140516,4.697157
28455,2014,Noviembre,Jamaica,0,1,,1,-75.42726,6.170465
28456,2014,Noviembre,Jamaica,0,2,,2,-73.181317,7.1280470000000005
28457,2014,Noviembre,Japón,0,3,,3,-76.532004,3.451668
28458,2014,Noviembre,Japón,8,22,,30,-74.140516,4.697157
28459,2014,Noviembre,Japón,0,1,,1,-75.736374,4.815189
28460,2014,Noviembre,Japón,2,6,,8,-75.42726,6.170465
28461,2014,Noviembre,Kazajistán,1,1,,2,-74.140516,4.697157
28462,2014,Noviembre,Kenia,0,1,,1,-76.532004,3.451668
28463,2014,Noviembre,Kenia,4,4,,8,-74.140516,4.697157
28464,2014,Noviembre,Kirguistán,1,0,,1,-76.532004,3.451668
28465,2014,Noviembre,República de Kosovo,1,1,,2,-74.140516,4.697157
28466,2014,Noviembre,Letonia,4,2,,6,-74.140516,4.697157
28467,2014,Noviembre,Lituania,4,1,,5,-74.140516,4.697157
28468,2014,Noviembre,Líbano,2,6,,8,-74.140516,4.697157
28469,2014,Noviembre,Luxemburgo,0,2,,2,-74.140516,4.697157
28470,2014,Noviembre,Malasia,1,3,,4,-74.140516,4.697157
28471,2014,Noviembre,México,0,3,,3,-75.527794,10.406342
28472,2014,Noviembre,México,17,26,,43,-75.516486,10.446304
28473,2014,Noviembre,México,10,30,,40,-74.77647900000001,10.886686
28474,2014,Noviembre,México,1,2,,3,-74.765343,10.970933
28475,2014,Noviembre,México,0,1,,1,-74.213989,11.247722999999999
28476,2014,Noviembre,México,0,11,,11,-81.703935,12.574411099999999
28477,2014,Noviembre,México,1,2,,3,-81.70216500000001,12.5862
28478,2014,Noviembre,México,1,2,,3,-81.372937,13.338761300000002
28479,2014,Noviembre,México,45,118,,163,-76.532004,3.451668
28480,2014,Noviembre,México,3069,6504,,9573,-74.140516,4.697157
28481,2014,Noviembre,México,2,19,,21,-75.736374,4.815189
28482,2014,Noviembre,México,105,294,,399,-75.42726,6.170465
28483,2014,Noviembre,México,4,4,,8,-73.181317,7.1280470000000005
28484,2014,Noviembre,México,14,18,,32,-72.508188,7.927233
28485,2014,Noviembre,Mónaco,1,1,,2,-74.140516,4.697157
28486,2014,Noviembre,Micronesia,0,1,,1,-76.532004,3.451668
28487,2014,Noviembre,Nicaragua,1,1,,2,-75.516486,10.446304
28488,2014,Noviembre,Nicaragua,0,2,,2,-74.77647900000001,10.886686
28489,2014,Noviembre,Nicaragua,0,1,,1,-81.372937,13.338761300000002
28490,2014,Noviembre,Nicaragua,5,9,,14,-76.532004,3.451668
28491,2014,Noviembre,Nicaragua,24,29,,53,-74.140516,4.697157
28492,2014,Noviembre,Nicaragua,0,2,,2,-75.736374,4.815189
28493,2014,Noviembre,Nicaragua,3,23,,26,-75.42726,6.170465
28494,2014,Noviembre,Nicaragua,1,0,,1,-73.181317,7.1280470000000005
28495,2014,Noviembre,Nicaragua,0,3,,3,-72.508188,7.927233
28496,2014,Noviembre,Nigeria,1,1,,2,-74.140516,4.697157
28497,2014,Noviembre,Noruega,0,1,,1,-75.516486,10.446304
28498,2014,Noviembre,Noruega,0,1,,1,-74.765343,10.970933
28499,2014,Noviembre,Noruega,1,0,,1,-76.532004,3.451668
28500,2014,Noviembre,Noruega,11,26,,37,-74.140516,4.697157
28501,2014,Noviembre,Noruega,0,1,,1,-75.42726,6.170465
28502,2014,Noviembre,Nueva Zelanda,0,1,,1,-76.532004,3.451668
28503,2014,Noviembre,Nueva Zelanda,1,5,,6,-74.140516,4.697157
28504,2014,Noviembre,Nueva Zelanda,0,1,,1,-75.42726,6.170465
28505,2014,Noviembre,Pakistán,0,3,,3,-74.140516,4.697157
28506,2014,Noviembre,Panamá,1016,1071,,2087,-75.527794,10.406342
28507,2014,Noviembre,Panamá,1879,2115,,3994,-75.516486,10.446304
28508,2014,Noviembre,Panamá,176,432,,608,-74.77647900000001,10.886686
28509,2014,Noviembre,Panamá,0,6,,6,-74.765343,10.970933
28510,2014,Noviembre,Panamá,2,8,,10,-74.213989,11.247722999999999
28511,2014,Noviembre,Panamá,5,19,,24,-81.703935,12.574411099999999
28512,2014,Noviembre,Panamá,1043,832,,1875,-81.70216500000001,12.5862
28513,2014,Noviembre,Panamá,8,13,,21,-81.372937,13.338761300000002
28514,2014,Noviembre,Panamá,331,726,,1057,-76.532004,3.451668
28515,2014,Noviembre,Panamá,0,23,,23,-77.061029,3.8844260000000004
28516,2014,Noviembre,Panamá,2682,4857,,7539,-74.140516,4.697157
28517,2014,Noviembre,Panamá,55,127,,182,-75.736374,4.815189
28518,2014,Noviembre,Panamá,967,1694,,2661,-75.42726,6.170465
28519,2014,Noviembre,Panamá,2,2,,4,-77.762647,7.102626
28520,2014,Noviembre,Panamá,34,51,,85,-73.181317,7.1280470000000005
28521,2014,Noviembre,Panamá,90,129,,219,-72.508188,7.927233
28522,2014,Noviembre,Panamá,0,3,,3,-76.7333,8.06667
28523,2014,Noviembre,Panamá,80,117,,197,-77.35002,8.63337
28524,2014,Noviembre,Paraguay,6,5,,11,-75.516486,10.446304
28525,2014,Noviembre,Paraguay,4,0,,4,-74.77647900000001,10.886686
28526,2014,Noviembre,Paraguay,16,14,,30,-81.70216500000001,12.5862
28527,2014,Noviembre,Paraguay,7,20,,27,-76.532004,3.451668
28528,2014,Noviembre,Paraguay,58,51,,109,-74.140516,4.697157
28529,2014,Noviembre,Paraguay,19,30,,49,-75.42726,6.170465
28530,2014,Noviembre,Paraguay,2,1,,3,-73.181317,7.1280470000000005
28531,2014,Noviembre,Perú,57,112,,169,-69.941498,4.191162
28532,2014,Noviembre,Perú,7,6,,13,-69.94143100000001,4.214082
28533,2014,Noviembre,Perú,2,6,,8,-77.35600000000001,0.81488
28534,2014,Noviembre,Perú,5,8,,13,-75.516486,10.446304
28535,2014,Noviembre,Perú,3,16,,19,-74.77647900000001,10.886686
28536,2014,Noviembre,Perú,0,4,,4,-74.213989,11.247722999999999
28537,2014,Noviembre,Perú,103,76,,179,-81.70216500000001,12.5862
28538,2014,Noviembre,Perú,234,378,,612,-76.532004,3.451668
28539,2014,Noviembre,Perú,1,78,,79,-77.061029,3.8844260000000004
28540,2014,Noviembre,Perú,4906,7378,,12284,-74.140516,4.697157
28541,2014,Noviembre,Perú,0,3,,3,-75.736374,4.815189
28542,2014,Noviembre,Perú,288,542,,830,-75.42726,6.170465
28543,2014,Noviembre,Perú,3,3,,6,-73.181317,7.1280470000000005
28544,2014,Noviembre,Perú,5,5,,10,-72.508188,7.927233
28545,2014,Noviembre,Polonia,28,26,,54,-74.140516,4.697157
28546,2014,Noviembre,Portugal,0,2,,2,-75.527794,10.406342
28547,2014,Noviembre,Portugal,0,2,,2,-76.532004,3.451668
28548,2014,Noviembre,Portugal,327,617,,944,-74.140516,4.697157
28549,2014,Noviembre,Portugal,0,1,,1,-75.42726,6.170465
28550,2014,Noviembre,Puerto Rico/Territorio de Estados Unidos,0,1,,1,-75.527794,10.406342
28551,2014,Noviembre,Puerto Rico/Territorio de Estados Unidos,6,5,,11,-75.516486,10.446304
28552,2014,Noviembre,Puerto Rico/Territorio de Estados Unidos,1,37,,38,-74.77647900000001,10.886686
28553,2014,Noviembre,Puerto Rico/Territorio de Estados Unidos,0,1,,1,-81.70216500000001,12.5862
28554,2014,Noviembre,Puerto Rico/Territorio de Estados Unidos,28,34,,62,-76.532004,3.451668
28555,2014,Noviembre,Puerto Rico/Territorio de Estados Unidos,166,309,,475,-74.140516,4.697157
28556,2014,Noviembre,Puerto Rico/Territorio de Estados Unidos,16,17,,33,-75.736374,4.815189
28557,2014,Noviembre,Puerto Rico/Territorio de Estados Unidos,16,56,,72,-75.42726,6.170465
28558,2014,Noviembre,Puerto Rico/Territorio de Estados Unidos,0,3,,3,-73.181317,7.1280470000000005
28559,2014,Noviembre,Puerto Rico/Territorio de Estados Unidos,0,2,,2,-75.68164200000001,9.402597
28560,2014,Noviembre,Reino Unido de Gran Bretaña e Irlanda del Norte,0,1,,1,-75.527794,10.406342
28561,2014,Noviembre,Reino Unido de Gran Bretaña e Irlanda del Norte,0,2,,2,-75.516486,10.446304
28562,2014,Noviembre,Reino Unido de Gran Bretaña e Irlanda del Norte,0,1,,1,-74.77647900000001,10.886686
28563,2014,Noviembre,Reino Unido de Gran Bretaña e Irlanda del Norte,0,1,,1,-74.213989,11.247722999999999
28564,2014,Noviembre,Reino Unido de Gran Bretaña e Irlanda del Norte,37,56,,93,-76.532004,3.451668
28565,2014,Noviembre,Reino Unido de Gran Bretaña e Irlanda del Norte,411,759,,1170,-74.140516,4.697157
28566,2014,Noviembre,Reino Unido de Gran Bretaña e Irlanda del Norte,1,1,,2,-75.736374,4.815189
28567,2014,Noviembre,Reino Unido de Gran Bretaña e Irlanda del Norte,13,11,,24,-75.42726,6.170465
28568,2014,Noviembre,República CentroÁfricana,1,0,,1,-74.140516,4.697157
28569,2014,Noviembre,Federación de Rusia,1,0,,1,-76.532004,3.451668
28570,2014,Noviembre,Federación de Rusia,0,4,,4,-77.061029,3.8844260000000004
28571,2014,Noviembre,Federación de Rusia,24,36,,60,-74.140516,4.697157
28572,2014,Noviembre,Federación de Rusia,1,1,,2,-75.42726,6.170465
28573,2014,Noviembre,República Dominicana,0,3,,3,-75.527794,10.406342
28574,2014,Noviembre,República Dominicana,10,16,,26,-75.516486,10.446304
28575,2014,Noviembre,República Dominicana,6,27,,33,-74.77647900000001,10.886686
28576,2014,Noviembre,República Dominicana,0,2,,2,-74.765343,10.970933
28577,2014,Noviembre,República Dominicana,0,3,,3,-81.70216500000001,12.5862
28578,2014,Noviembre,República Dominicana,10,14,,24,-76.532004,3.451668
28579,2014,Noviembre,República Dominicana,440,696,,1136,-74.140516,4.697157
28580,2014,Noviembre,República Dominicana,4,3,,7,-75.736374,4.815189
28581,2014,Noviembre,República Dominicana,40,56,,96,-75.42726,6.170465
28582,2014,Noviembre,República Dominicana,0,4,,4,-73.181317,7.1280470000000005
28583,2014,Noviembre,República Dominicana,0,2,,2,-72.508188,7.927233
28584,2014,Noviembre,Reunión,0,1,,1,-74.140516,4.697157
28585,2014,Noviembre,Rumania,0,1,,1,-75.516486,10.446304
28586,2014,Noviembre,Rumania,4,11,,15,-74.140516,4.697157
28587,2014,Noviembre,Rumania,0,1,,1,-75.42726,6.170465
28588,2014,Noviembre,San Cristóbal y Nevis,0,1,,1,-74.140516,4.697157
28589,2014,Noviembre,Santa Lucia,2,4,,6,-74.140516,4.697157
28590,2014,Noviembre,Serbia,1,1,,2,-74.140516,4.697157
28591,2014,Noviembre,Singapur,1,4,,5,-74.140516,4.697157
28592,2014,Noviembre,Sri Lanka,0,1,,1,-76.532004,3.451668
28593,2014,Noviembre,Sudáfrica,4,17,,21,-74.140516,4.697157
28594,2014,Noviembre,Sudáfrica,0,1,,1,-75.42726,6.170465
28595,2014,Noviembre,Suecia,1,0,,1,-75.516486,10.446304
28596,2014,Noviembre,Suecia,0,5,,5,-76.532004,3.451668
28597,2014,Noviembre,Suecia,18,27,,45,-74.140516,4.697157
28598,2014,Noviembre,Suecia,2,2,,4,-75.42726,6.170465
28599,2014,Noviembre,Suiza,1,0,,1,-75.516486,10.446304
28600,2014,Noviembre,Suiza,1,0,,1,-74.77647900000001,10.886686
28601,2014,Noviembre,Suiza,2,5,,7,-76.532004,3.451668
28602,2014,Noviembre,Suiza,40,99,,139,-74.140516,4.697157
28603,2014,Noviembre,Suiza,4,8,,12,-75.42726,6.170465
28604,2014,Noviembre,Surinam,0,1,,1,-75.527794,10.406342
28605,2014,Noviembre,Surinam,0,1,,1,-76.532004,3.451668
28606,2014,Noviembre,Surinam,2,3,,5,-74.140516,4.697157
28607,2014,Noviembre,Surinam,0,2,,2,-75.42726,6.170465
28608,2014,Noviembre,Taiwán,0,5,,5,-74.140516,4.697157
28609,2014,Noviembre,Taiwán,1,0,,1,-75.42726,6.170465
28610,2014,Noviembre,Tailandia,0,1,,1,-74.140516,4.697157
28611,2014,Noviembre,Trinidad y Tobago,0,4,,4,-76.532004,3.451668
28612,2014,Noviembre,Trinidad y Tobago,5,9,,14,-74.140516,4.697157
28613,2014,Noviembre,Trinidad y Tobago,0,1,,1,-75.736374,4.815189
28614,2014,Noviembre,Trinidad y Tobago,0,4,,4,-75.42726,6.170465
28615,2014,Noviembre,Trinidad y Tobago,4,6,,10,-73.181317,7.1280470000000005
28616,2014,Noviembre,Trinidad y Tobago,1,2,,3,-72.508188,7.927233
28617,2014,Noviembre,Turquía,10,15,,25,-74.140516,4.697157
28618,2014,Noviembre,Turquía,1,5,,6,-75.42726,6.170465
28619,2014,Noviembre,Turquía,0,7,,7,-72.508188,7.927233
28620,2014,Noviembre,Ucrania,0,2,,2,-74.140516,4.697157
28621,2014,Noviembre,Uruguay,0,1,,1,-77.35600000000001,0.81488
28622,2014,Noviembre,Uruguay,0,1,,1,-75.527794,10.406342
28623,2014,Noviembre,Uruguay,15,14,,29,-75.516486,10.446304
28624,2014,Noviembre,Uruguay,2,1,,3,-74.77647900000001,10.886686
28625,2014,Noviembre,Uruguay,12,6,,18,-81.70216500000001,12.5862
28626,2014,Noviembre,Uruguay,14,18,,32,-76.532004,3.451668
28627,2014,Noviembre,Uruguay,36,73,,109,-74.140516,4.697157
28628,2014,Noviembre,Uruguay,0,1,,1,-75.736374,4.815189
28629,2014,Noviembre,Uruguay,28,48,,76,-75.42726,6.170465
28630,2014,Noviembre,Venezuela,0,12,,12,-75.527794,10.406342
28631,2014,Noviembre,Venezuela,19,78,,97,-75.516486,10.446304
28632,2014,Noviembre,Venezuela,10,55,,65,-74.77647900000001,10.886686
28633,2014,Noviembre,Venezuela,0,1,,1,-74.765343,10.970933
28634,2014,Noviembre,Venezuela,1185,1999,,3184,-72.129595,11.360028999999999
28635,2014,Noviembre,Venezuela,0,2,,2,-81.70216500000001,12.5862
28636,2014,Noviembre,Venezuela,12,33,,45,-76.532004,3.451668
28637,2014,Noviembre,Venezuela,3854,4413,,8267,-74.140516,4.697157
28638,2014,Noviembre,Venezuela,1,3,,4,-75.736374,4.815189
28639,2014,Noviembre,Venezuela,37,115,,152,-75.42726,6.170465
28640,2014,Noviembre,Venezuela,383,611,,994,-67.48402800000001,6.185536
28641,2014,Noviembre,Venezuela,83,143,,226,-70.74025300000001,7.088728999999999
28642,2014,Noviembre,Venezuela,2893,3899,,6792,-72.453013,7.819
28643,2014,Noviembre,Venezuela,241,327,,568,-72.508188,7.927233
28644,2014,Noviembre,Vietnam,0,1,,1,-74.77647900000001,10.886686
28645,2014,Noviembre,Vietnam,0,1,,1,-74.140516,4.697157
28646,2014,Noviembre,Islas Vírgenes Británicas/Territorio Británico de Ultramar,2,1,,3,-74.140516,4.697157
28647,2014,Noviembre,Islas Vírgenes Estadounidenses/Territorio de Estados Unidos,0,1,,1,-74.140516,4.697157
28648,2014,Noviembre,Desconocido,0,2,,2,-76.532004,3.451668
28649,2014,Noviembre,Desconocido,1,33,,34,-74.140516,4.697157
28650,2014,Diciembre,Afganistán,0,1,,1,-74.140516,4.697157
28651,2014,Diciembre,Albania,0,1,,1,-74.140516,4.697157
28652,2014,Diciembre,Alemania,0,3,,3,-75.516486,10.446304
28653,2014,Diciembre,Alemania,2,4,,6,-74.77647900000001,10.886686
28654,2014,Diciembre,Alemania,18,23,,41,-76.532004,3.451668
28655,2014,Diciembre,Alemania,1410,2340,,3750,-74.140516,4.697157
28656,2014,Diciembre,Alemania,22,20,,42,-75.42726,6.170465
28657,2014,Diciembre,Alemania,2,1,,3,-73.181317,7.1280470000000005
28658,2014,Diciembre,Alemania,0,1,,1,-72.508188,7.927233
28659,2014,Diciembre,Angola,0,1,,1,-75.527794,10.406342
28660,2014,Diciembre,Angola,1,0,,1,-74.140516,4.697157
28661,2014,Diciembre,Antigua y Barbuda,0,1,,1,-75.516486,10.446304
28662,2014,Diciembre,Antigua y Barbuda,0,1,,1,-75.42726,6.170465
28663,2014,Diciembre,Antigua y Barbuda,0,1,,1,-72.508188,7.927233
28664,2014,Diciembre,Países Bajos,10,5,,15,-75.527794,10.406342
28665,2014,Diciembre,Países Bajos,1,1,,2,-75.516486,10.446304
28666,2014,Diciembre,Países Bajos,4,5,,9,-74.77647900000001,10.886686
28667,2014,Diciembre,Países Bajos,5,18,,23,-76.532004,3.451668
28668,2014,Diciembre,Países Bajos,89,146,,235,-74.140516,4.697157
28669,2014,Diciembre,Países Bajos,1,4,,5,-75.736374,4.815189
28670,2014,Diciembre,Países Bajos,44,81,,125,-75.42726,6.170465
28671,2014,Diciembre,Países Bajos,0,4,,4,-73.181317,7.1280470000000005
28672,2014,Diciembre,Arabia Saudita,3,3,,6,-74.140516,4.697157
28673,2014,Diciembre,Argelia,1,0,,1,-76.532004,3.451668
28674,2014,Diciembre,Argelia,2,0,,2,-74.140516,4.697157
28675,2014,Diciembre,Argentina,4,3,,7,-77.35600000000001,0.81488
28676,2014,Diciembre,Argentina,47,37,,84,-75.516486,10.446304
28677,2014,Diciembre,Argentina,15,14,,29,-74.77647900000001,10.886686
28678,2014,Diciembre,Argentina,60,52,,112,-81.70216500000001,12.5862
28679,2014,Diciembre,Argentina,52,81,,133,-76.532004,3.451668
28680,2014,Diciembre,Argentina,1944,2692,,4636,-74.140516,4.697157
28681,2014,Diciembre,Argentina,136,508,,644,-75.42726,6.170465
28682,2014,Diciembre,Argentina,0,1,,1,-73.181317,7.1280470000000005
28683,2014,Diciembre,Argentina,1,3,,4,-72.508188,7.927233
28684,2014,Diciembre,Aruba,27,56,,83,-75.527794,10.406342
28685,2014,Diciembre,Aruba,11,6,,17,-75.516486,10.446304
28686,2014,Diciembre,Aruba,7,10,,17,-74.77647900000001,10.886686
28687,2014,Diciembre,Aruba,0,1,,1,-74.765343,10.970933
28688,2014,Diciembre,Aruba,7,21,,28,-74.213989,11.247722999999999
28689,2014,Diciembre,Aruba,5,2,,7,-76.532004,3.451668
28690,2014,Diciembre,Aruba,402,616,,1018,-74.140516,4.697157
28691,2014,Diciembre,Aruba,0,1,,1,-75.736374,4.815189
28692,2014,Diciembre,Aruba,7,19,,26,-75.42726,6.170465
28693,2014,Diciembre,Aruba,6,1,,7,-73.181317,7.1280470000000005
28694,2014,Diciembre,Aruba,3,2,,5,-72.508188,7.927233
28695,2014,Diciembre,Australia,0,2,,2,-75.516486,10.446304
28696,2014,Diciembre,Australia,0,5,,5,-74.77647900000001,10.886686
28697,2014,Diciembre,Australia,11,18,,29,-76.532004,3.451668
28698,2014,Diciembre,Australia,57,76,,133,-74.140516,4.697157
28699,2014,Diciembre,Australia,0,1,,1,-75.736374,4.815189
28700,2014,Diciembre,Australia,11,25,,36,-75.42726,6.170465
28701,2014,Diciembre,Australia,0,3,,3,-73.181317,7.1280470000000005
28702,2014,Diciembre,Austria,0,1,,1,-75.516486,10.446304
28703,2014,Diciembre,Austria,2,0,,2,-76.532004,3.451668
28704,2014,Diciembre,Austria,19,33,,52,-74.140516,4.697157
28705,2014,Diciembre,Austria,0,1,,1,-75.42726,6.170465
28706,2014,Diciembre,Azerbaiyán,0,1,,1,-74.140516,4.697157
28707,2014,Diciembre,Bahamas,0,9,,9,-75.527794,10.406342
28708,2014,Diciembre,Bahamas,0,1,,1,-75.516486,10.446304
28709,2014,Diciembre,Bahréin,1,1,,2,-75.516486,10.446304
28710,2014,Diciembre,Bahréin,0,1,,1,-72.129595,11.360028999999999
28711,2014,Diciembre,Bahréin,0,2,,2,-75.42726,6.170465
28712,2014,Diciembre,Barbados,0,1,,1,-74.140516,4.697157
28713,2014,Diciembre,Barbados,0,1,,1,-75.736374,4.815189
28714,2014,Diciembre,República de Belarús,1,1,,2,-72.129595,11.360028999999999
28715,2014,Diciembre,República de Belarús,0,1,,1,-74.140516,4.697157
28716,2014,Diciembre,Bélgica,0,1,,1,-74.77647900000001,10.886686
28717,2014,Diciembre,Bélgica,0,2,,2,-74.213989,11.247722999999999
28718,2014,Diciembre,Bélgica,5,6,,11,-76.532004,3.451668
28719,2014,Diciembre,Bélgica,28,51,,79,-74.140516,4.697157
28720,2014,Diciembre,Bélgica,1,6,,7,-75.42726,6.170465
28721,2014,Diciembre,Bélgica,0,1,,1,-73.181317,7.1280470000000005
28722,2014,Diciembre,Belice,0,1,,1,-76.532004,3.451668
28723,2014,Diciembre,Belice,1,1,,2,-74.140516,4.697157
28724,2014,Diciembre,Belice,0,1,,1,-75.42726,6.170465
28725,2014,Diciembre,Benín,1,0,,1,-81.70216500000001,12.5862
28726,2014,Diciembre,Benín,1,0,,1,-74.140516,4.697157
28727,2014,Diciembre,Bermudas/Territorio Británico de Ultramar,0,1,,1,-75.42726,6.170465
28728,2014,Diciembre,Bolivia,2,2,,4,-77.35600000000001,0.81488
28729,2014,Diciembre,Bolivia,13,6,,19,-75.516486,10.446304
28730,2014,Diciembre,Bolivia,4,3,,7,-74.77647900000001,10.886686
28731,2014,Diciembre,Bolivia,3,1,,4,-81.70216500000001,12.5862
28732,2014,Diciembre,Bolivia,9,13,,22,-76.532004,3.451668
28733,2014,Diciembre,Bolivia,479,548,,1027,-74.140516,4.697157
28734,2014,Diciembre,Bolivia,13,27,,40,-75.42726,6.170465
28735,2014,Diciembre,Bolivia,0,1,,1,-73.181317,7.1280470000000005
28736,2014,Diciembre,Bolivia,0,1,,1,-72.508188,7.927233
28737,2014,Diciembre,Bosnia y Herzegovina,0,1,,1,-74.140516,4.697157
28738,2014,Diciembre,Brasil,144,137,,281,-69.941498,4.191162
28739,2014,Diciembre,Brasil,6,9,,15,-69.94143100000001,4.214082
28740,2014,Diciembre,Brasil,0,2,,2,-77.35600000000001,0.81488
28741,2014,Diciembre,Brasil,0,5,,5,-75.527794,10.406342
28742,2014,Diciembre,Brasil,49,32,,81,-75.516486,10.446304
28743,2014,Diciembre,Brasil,18,30,,48,-74.77647900000001,10.886686
28744,2014,Diciembre,Brasil,187,138,,325,-81.70216500000001,12.5862
28745,2014,Diciembre,Brasil,46,62,,108,-76.532004,3.451668
28746,2014,Diciembre,Brasil,3585,4642,,8227,-74.140516,4.697157
28747,2014,Diciembre,Brasil,2,7,,9,-75.736374,4.815189
28748,2014,Diciembre,Brasil,93,141,,234,-75.42726,6.170465
28749,2014,Diciembre,Brasil,5,4,,9,-73.181317,7.1280470000000005
28750,2014,Diciembre,Brasil,3,20,,23,-72.508188,7.927233
28751,2014,Diciembre,Bulgaria,1,5,,6,-74.140516,4.697157
28752,2014,Diciembre,Islas Caimán/Territorio Británico de Ultramar,6,7,,13,-75.527794,10.406342
28753,2014,Diciembre,Islas Caimán/Territorio Británico de Ultramar,0,1,,1,-74.77647900000001,10.886686
28754,2014,Diciembre,Islas Caimán/Territorio Británico de Ultramar,1,1,,2,-81.703935,12.574411099999999
28755,2014,Diciembre,Islas Caimán/Territorio Británico de Ultramar,2,6,,8,-81.70216500000001,12.5862
28756,2014,Diciembre,Islas Caimán/Territorio Británico de Ultramar,0,1,,1,-76.532004,3.451668
28757,2014,Diciembre,Islas Caimán/Territorio Británico de Ultramar,0,5,,5,-74.140516,4.697157
28758,2014,Diciembre,Canadá,0,3,,3,-75.527794,10.406342
28759,2014,Diciembre,Canadá,198,213,,411,-75.516486,10.446304
28760,2014,Diciembre,Canadá,14,34,,48,-74.77647900000001,10.886686
28761,2014,Diciembre,Canadá,170,167,,337,-81.70216500000001,12.5862
28762,2014,Diciembre,Canadá,101,99,,200,-76.532004,3.451668
28763,2014,Diciembre,Canadá,3,4,,7,-75.76635300000001,4.45285
28764,2014,Diciembre,Canadá,787,1103,,1890,-74.140516,4.697157
28765,2014,Diciembre,Canadá,20,29,,49,-75.736374,4.815189
28766,2014,Diciembre,Canadá,168,273,,441,-75.42726,6.170465
28767,2014,Diciembre,Canadá,15,25,,40,-73.181317,7.1280470000000005
28768,2014,Diciembre,Canadá,8,15,,23,-72.508188,7.927233
28769,2014,Diciembre,España,2,1,,3,-75.516486,10.446304
28770,2014,Diciembre,España,0,2,,2,-74.77647900000001,10.886686
28771,2014,Diciembre,España,2,3,,5,-81.70216500000001,12.5862
28772,2014,Diciembre,España,230,360,,590,-76.532004,3.451668
28773,2014,Diciembre,España,2840,5170,,8010,-74.140516,4.697157
28774,2014,Diciembre,España,1,3,,4,-75.736374,4.815189
28775,2014,Diciembre,España,156,354,,510,-75.42726,6.170465
28776,2014,Diciembre,España,0,1,,1,-73.181317,7.1280470000000005
28777,2014,Diciembre,España,2,1,,3,-72.508188,7.927233
28778,2014,Diciembre,España,1,0,,1,-75.42726,6.170465
28779,2014,Diciembre,República de Corea,15,25,,40,-74.140516,4.697157
28780,2014,Diciembre,República de Corea,0,1,,1,-75.736374,4.815189
28781,2014,Diciembre,República de Corea,0,1,,1,-75.42726,6.170465
28782,2014,Diciembre,República de Corea,0,1,,1,-72.508188,7.927233
28783,2014,Diciembre,Costa de Marfil,0,1,,1,-76.532004,3.451668
28784,2014,Diciembre,Costa de Marfil,1,6,,7,-74.140516,4.697157
28785,2014,Diciembre,Costa Rica,1,3,,4,-75.527794,10.406342
28786,2014,Diciembre,Costa Rica,6,6,,12,-75.516486,10.446304
28787,2014,Diciembre,Costa Rica,21,17,,38,-74.77647900000001,10.886686
28788,2014,Diciembre,Costa Rica,0,3,,3,-74.232675,11.117206
28789,2014,Diciembre,Costa Rica,462,340,,802,-81.70216500000001,12.5862
28790,2014,Diciembre,Costa Rica,40,32,,72,-76.532004,3.451668
28791,2014,Diciembre,Costa Rica,815,1125,,1940,-74.140516,4.697157
28792,2014,Diciembre,Costa Rica,4,26,,30,-75.736374,4.815189
28793,2014,Diciembre,Costa Rica,106,117,,223,-75.42726,6.170465
28794,2014,Diciembre,Costa Rica,5,10,,15,-73.181317,7.1280470000000005
28795,2014,Diciembre,Costa Rica,11,2,,13,-72.508188,7.927233
28796,2014,Diciembre,Croacia,0,1,,1,-75.527794,10.406342
28797,2014,Diciembre,Croacia,0,1,,1,-76.532004,3.451668
28798,2014,Diciembre,Croacia,1,1,,2,-74.140516,4.697157
28799,2014,Diciembre,Cuba,3,4,,7,-75.516486,10.446304
28800,2014,Diciembre,Cuba,5,10,,15,-74.77647900000001,10.886686
28801,2014,Diciembre,Cuba,7,6,,13,-76.532004,3.451668
28802,2014,Diciembre,Cuba,290,456,,746,-74.140516,4.697157
28803,2014,Diciembre,Cuba,0,1,,1,-75.736374,4.815189
28804,2014,Diciembre,Cuba,16,11,,27,-75.42726,6.170465
28805,2014,Diciembre,Cuba,2,0,,2,-73.181317,7.1280470000000005
28806,2014,Diciembre,Cuba,1,2,,3,-72.508188,7.927233
28807,2014,Diciembre,Curazao,0,3,,3,-75.527794,10.406342
28808,2014,Diciembre,Curazao,59,107,,166,-74.77647900000001,10.886686
28809,2014,Diciembre,Curazao,13,15,,28,-74.213989,11.247722999999999
28810,2014,Diciembre,Curazao,1,4,,5,-76.532004,3.451668
28811,2014,Diciembre,Curazao,330,532,,862,-74.140516,4.697157
28812,2014,Diciembre,Curazao,193,306,,499,-75.42726,6.170465
28813,2014,Diciembre,Curazao,1,1,,2,-73.181317,7.1280470000000005
28814,2014,Diciembre,República Checa,1,1,,2,-81.70216500000001,12.5862
28815,2014,Diciembre,República Checa,0,4,,4,-74.140516,4.697157
28816,2014,Diciembre,Chile,6,7,,13,-77.35600000000001,0.81488
28817,2014,Diciembre,Chile,5,2,,7,-75.516486,10.446304
28818,2014,Diciembre,Chile,5,10,,15,-74.77647900000001,10.886686
28819,2014,Diciembre,Chile,22,30,,52,-81.70216500000001,12.5862
28820,2014,Diciembre,Chile,38,71,,109,-76.532004,3.451668
28821,2014,Diciembre,Chile,0,2,,2,-77.061029,3.8844260000000004
28822,2014,Diciembre,Chile,3373,4454,,7827,-74.140516,4.697157
28823,2014,Diciembre,Chile,1,3,,4,-75.736374,4.815189
28824,2014,Diciembre,Chile,32,76,,108,-75.42726,6.170465
28825,2014,Diciembre,Chile,0,2,,2,-73.181317,7.1280470000000005
28826,2014,Diciembre,Chile,1,2,,3,-72.508188,7.927233
28827,2014,Diciembre,China,0,2,,2,-74.77647900000001,10.886686
28828,2014,Diciembre,China,0,4,,4,-74.765343,10.970933
28829,2014,Diciembre,China,1,3,,4,-76.532004,3.451668
28830,2014,Diciembre,China,0,1,,1,-77.061029,3.8844260000000004
28831,2014,Diciembre,China,33,88,,121,-74.140516,4.697157
28832,2014,Diciembre,Dinamarca,0,2,,2,-76.532004,3.451668
28833,2014,Diciembre,Dinamarca,12,24,,36,-74.140516,4.697157
28834,2014,Diciembre,Dinamarca,0,1,,1,-75.42726,6.170465
28835,2014,Diciembre,Dinamarca,2,1,,3,-73.181317,7.1280470000000005
28836,2014,Diciembre,Dominica,0,1,,1,-74.140516,4.697157
28837,2014,Diciembre,Ecuador,74,164,,238,-76.876446,0.33002
28838,2014,Diciembre,Ecuador,1,1,,2,-77.84700600000001,0.8124359999999999
28839,2014,Diciembre,Ecuador,3208,5077,,8285,-77.35600000000001,0.81488
28840,2014,Diciembre,Ecuador,13,47,,60,-78.802679,18.00143
28841,2014,Diciembre,Ecuador,0,1,,1,-75.527794,10.406342
28842,2014,Diciembre,Ecuador,0,5,,5,-75.516486,10.446304
28843,2014,Diciembre,Ecuador,0,2,,2,-81.70216500000001,12.5862
28844,2014,Diciembre,Ecuador,522,719,,1241,-76.532004,3.451668
28845,2014,Diciembre,Ecuador,3245,4586,,7831,-74.140516,4.697157
28846,2014,Diciembre,Ecuador,1,2,,3,-75.736374,4.815189
28847,2014,Diciembre,Ecuador,403,486,,889,-75.42726,6.170465
28848,2014,Diciembre,Ecuador,5,1,,6,-73.181317,7.1280470000000005
28849,2014,Diciembre,Ecuador,9,17,,26,-72.508188,7.927233
28850,2014,Diciembre,Egipto,0,1,,1,-74.213989,11.247722999999999
28851,2014,Diciembre,Egipto,0,4,,4,-74.140516,4.697157
28852,2014,Diciembre,El Salvador,1,2,,3,-74.77647900000001,10.886686
28853,2014,Diciembre,El Salvador,1,2,,3,-81.70216500000001,12.5862
28854,2014,Diciembre,El Salvador,121,193,,314,-76.532004,3.451668
28855,2014,Diciembre,El Salvador,768,1100,,1868,-74.140516,4.697157
28856,2014,Diciembre,El Salvador,1,1,,2,-75.736374,4.815189
28857,2014,Diciembre,El Salvador,110,197,,307,-75.42726,6.170465
28858,2014,Diciembre,El Salvador,1,1,,2,-73.181317,7.1280470000000005
28859,2014,Diciembre,El Salvador,1,1,,2,-72.508188,7.927233
28860,2014,Diciembre,Emiratos Árabes,3,0,,3,-81.70216500000001,12.5862
28861,2014,Diciembre,Emiratos Árabes,0,7,,7,-74.140516,4.697157
28862,2014,Diciembre,Emiratos Árabes,0,2,,2,-75.42726,6.170465
28863,2014,Diciembre,Eslovaquia,1,4,,5,-74.140516,4.697157
28864,2014,Diciembre,Eslovaquia,2,0,,2,-73.181317,7.1280470000000005
28865,2014,Diciembre,Eslovenia,2,2,,4,-74.140516,4.697157
28866,2014,Diciembre,Eslovenia,1,0,,1,-75.42726,6.170465
28867,2014,Diciembre,Estados Unidos de América,0,1,,1,-78.802679,18.00143
28868,2014,Diciembre,Estados Unidos de América,0,23,,23,-75.527794,10.406342
28869,2014,Diciembre,Estados Unidos de América,2759,4050,,6809,-75.516486,10.446304
28870,2014,Diciembre,Estados Unidos de América,383,690,,1073,-74.77647900000001,10.886686
28871,2014,Diciembre,Estados Unidos de América,0,8,,8,-74.765343,10.970933
28872,2014,Diciembre,Estados Unidos de América,2,29,,31,-74.213989,11.247722999999999
28873,2014,Diciembre,Estados Unidos de América,22,37,,59,-81.70216500000001,12.5862
28874,2014,Diciembre,Estados Unidos de América,1635,2391,,4026,-76.532004,3.451668
28875,2014,Diciembre,Estados Unidos de América,0,5,,5,-77.061029,3.8844260000000004
28876,2014,Diciembre,Estados Unidos de América,114,184,,298,-75.76635300000001,4.45285
28877,2014,Diciembre,Estados Unidos de América,11542,18813,,30355,-74.140516,4.697157
28878,2014,Diciembre,Estados Unidos de América,228,341,,569,-75.736374,4.815189
28879,2014,Diciembre,Estados Unidos de América,2886,5145,,8031,-75.42726,6.170465
28880,2014,Diciembre,Estados Unidos de América,52,100,,152,-73.181317,7.1280470000000005
28881,2014,Diciembre,Estados Unidos de América,95,107,,202,-72.508188,7.927233
28882,2014,Diciembre,Estonia,3,2,,5,-74.140516,4.697157
28883,2014,Diciembre,Islas Fiji,1,1,,2,-74.140516,4.697157
28884,2014,Diciembre,Filipinas,0,1,,1,-75.516486,10.446304
28885,2014,Diciembre,Filipinas,0,7,,7,-74.77647900000001,10.886686
28886,2014,Diciembre,Filipinas,1,0,,1,-76.532004,3.451668
28887,2014,Diciembre,Filipinas,2,10,,12,-74.140516,4.697157
28888,2014,Diciembre,Filipinas,0,2,,2,-75.68164200000001,9.402597
28889,2014,Diciembre,Finlandia,1,2,,3,-76.532004,3.451668
28890,2014,Diciembre,Finlandia,14,9,,23,-74.140516,4.697157
28891,2014,Diciembre,Finlandia,0,1,,1,-75.42726,6.170465
28892,2014,Diciembre,Francia,2,3,,5,-74.77647900000001,10.886686
28893,2014,Diciembre,Francia,1,0,,1,-81.70216500000001,12.5862
28894,2014,Diciembre,Francia,17,23,,40,-76.532004,3.451668
28895,2014,Diciembre,Francia,1402,2369,,3771,-74.140516,4.697157
28896,2014,Diciembre,Francia,0,2,,2,-75.736374,4.815189
28897,2014,Diciembre,Francia,11,34,,45,-75.42726,6.170465
28898,2014,Diciembre,Francia,0,1,,1,-73.181317,7.1280470000000005
28899,2014,Diciembre,Francia,4,3,,7,-72.508188,7.927233
28900,2014,Diciembre,Georgia,1,0,,1,-74.140516,4.697157
28901,2014,Diciembre,Georgia,0,1,,1,-75.68164200000001,9.402597
28902,2014,Diciembre,Ghana,0,2,,2,-74.140516,4.697157
28903,2014,Diciembre,Grecia,0,1,,1,-75.516486,10.446304
28904,2014,Diciembre,Grecia,5,8,,13,-74.140516,4.697157
28905,2014,Diciembre,Guatemala,2,1,,3,-75.516486,10.446304
28906,2014,Diciembre,Guatemala,3,3,,6,-74.77647900000001,10.886686
28907,2014,Diciembre,Guatemala,0,1,,1,-74.765343,10.970933
28908,2014,Diciembre,Guatemala,2,3,,5,-81.70216500000001,12.5862
28909,2014,Diciembre,Guatemala,15,39,,54,-76.532004,3.451668
28910,2014,Diciembre,Guatemala,0,2,,2,-77.061029,3.8844260000000004
28911,2014,Diciembre,Guatemala,283,406,,689,-74.140516,4.697157
28912,2014,Diciembre,Guatemala,0,1,,1,-75.736374,4.815189
28913,2014,Diciembre,Guatemala,28,57,,85,-75.42726,6.170465
28914,2014,Diciembre,Guatemala,3,3,,6,-73.181317,7.1280470000000005
28915,2014,Diciembre,Guatemala,8,10,,18,-72.508188,7.927233
28916,2014,Diciembre,Guyana,0,1,,1,-74.77647900000001,10.886686
28917,2014,Diciembre,Guyana,1,0,,1,-76.532004,3.451668
28918,2014,Diciembre,Guyana,0,1,,1,-74.140516,4.697157
28919,2014,Diciembre,Guyana,1,1,,2,-75.42726,6.170465
28920,2014,Diciembre,Guinea Ecuatorial,0,1,,1,-74.140516,4.697157
28921,2014,Diciembre,Guadalupe/Territorio Francés,1,2,,3,-74.140516,4.697157
28922,2014,Diciembre,Guayana Francesa/Departamento de Ultramar Francés,0,1,,1,-76.532004,3.451668
28923,2014,Diciembre,Guayana Francesa/Departamento de Ultramar Francés,0,1,,1,-74.140516,4.697157
28924,2014,Diciembre,Haití,0,12,,12,-75.516486,10.446304
28925,2014,Diciembre,Haití,1,1,,2,-74.77647900000001,10.886686
28926,2014,Diciembre,Haití,2,3,,5,-74.140516,4.697157
28927,2014,Diciembre,Haití,1,0,,1,-75.736374,4.815189
28928,2014,Diciembre,Haití,2,0,,2,-75.42726,6.170465
28929,2014,Diciembre,Honduras,1,2,,3,-75.516486,10.446304
28930,2014,Diciembre,Honduras,3,4,,7,-74.77647900000001,10.886686
28931,2014,Diciembre,Honduras,7,9,,16,-81.372937,13.338761300000002
28932,2014,Diciembre,Honduras,17,14,,31,-76.532004,3.451668
28933,2014,Diciembre,Honduras,32,42,,74,-74.140516,4.697157
28934,2014,Diciembre,Honduras,1,0,,1,-75.736374,4.815189
28935,2014,Diciembre,Honduras,25,21,,46,-75.42726,6.170465
28936,2014,Diciembre,Honduras,1,0,,1,-73.181317,7.1280470000000005
28937,2014,Diciembre,Honduras,4,4,,8,-72.508188,7.927233
28938,2014,Diciembre,Hong Kong,0,2,,2,-74.140516,4.697157
28939,2014,Diciembre,Hong Kong,0,1,,1,-72.508188,7.927233
28940,2014,Diciembre,Hungría,2,1,,3,-74.77647900000001,10.886686
28941,2014,Diciembre,Hungría,2,5,,7,-74.140516,4.697157
28942,2014,Diciembre,Hungría,1,1,,2,-75.42726,6.170465
28943,2014,Diciembre,India,0,1,,1,-75.516486,10.446304
28944,2014,Diciembre,India,0,1,,1,-74.77647900000001,10.886686
28945,2014,Diciembre,India,3,13,,16,-74.140516,4.697157
28946,2014,Diciembre,India,0,1,,1,-75.42726,6.170465
28947,2014,Diciembre,Indonesia,0,1,,1,-78.802679,18.00143
28948,2014,Diciembre,Indonesia,0,1,,1,-76.532004,3.451668
28949,2014,Diciembre,Indonesia,0,5,,5,-74.140516,4.697157
28950,2014,Diciembre,Iraq,0,2,,2,-74.140516,4.697157
28951,2014,Diciembre,Irán,1,2,,3,-74.140516,4.697157
28952,2014,Diciembre,República de Irlanda,1,1,,2,-76.532004,3.451668
28953,2014,Diciembre,República de Irlanda,7,17,,24,-74.140516,4.697157
28954,2014,Diciembre,República de Irlanda,1,1,,2,-75.42726,6.170465
28955,2014,Diciembre,Islandia,0,2,,2,-74.140516,4.697157
28956,2014,Diciembre,Israel,0,2,,2,-74.77647900000001,10.886686
28957,2014,Diciembre,Israel,0,4,,4,-74.213989,11.247722999999999
28958,2014,Diciembre,Israel,10,57,,67,-74.140516,4.697157
28959,2014,Diciembre,Israel,1,4,,5,-75.42726,6.170465
28960,2014,Diciembre,Italia,0,1,,1,-75.516486,10.446304
28961,2014,Diciembre,Italia,1,1,,2,-74.77647900000001,10.886686
28962,2014,Diciembre,Italia,79,75,,154,-81.70216500000001,12.5862
28963,2014,Diciembre,Italia,14,18,,32,-76.532004,3.451668
28964,2014,Diciembre,Italia,106,294,,400,-74.140516,4.697157
28965,2014,Diciembre,Italia,1,2,,3,-75.736374,4.815189
28966,2014,Diciembre,Italia,10,25,,35,-75.42726,6.170465
28967,2014,Diciembre,Italia,0,1,,1,-73.181317,7.1280470000000005
28968,2014,Diciembre,Italia,4,2,,6,-72.508188,7.927233
28969,2014,Diciembre,Jamaica,0,1,,1,-75.527794,10.406342
28970,2014,Diciembre,Jamaica,0,6,,6,-75.516486,10.446304
28971,2014,Diciembre,Jamaica,2,1,,3,-76.532004,3.451668
28972,2014,Diciembre,Jamaica,1,5,,6,-74.140516,4.697157
28973,2014,Diciembre,Jamaica,2,1,,3,-75.42726,6.170465
28974,2014,Diciembre,Jamaica,1,27,,28,-72.508188,7.927233
28975,2014,Diciembre,Japón,1,0,,1,-74.77647900000001,10.886686
28976,2014,Diciembre,Japón,5,6,,11,-76.532004,3.451668
28977,2014,Diciembre,Japón,13,26,,39,-74.140516,4.697157
28978,2014,Diciembre,Japón,1,4,,5,-75.42726,6.170465
28979,2014,Diciembre,Kazajistán,0,1,,1,-74.140516,4.697157
28980,2014,Diciembre,Kenia,1,0,,1,-74.140516,4.697157
28981,2014,Diciembre,Kirguistán,0,4,,4,-74.140516,4.697157
28982,2014,Diciembre,República Democrática Popular  Lao,0,1,,1,-74.140516,4.697157
28983,2014,Diciembre,Letonia,0,1,,1,-74.140516,4.697157
28984,2014,Diciembre,Lituania,0,2,,2,-74.140516,4.697157
28985,2014,Diciembre,Líbano,2,0,,2,-74.77647900000001,10.886686
28986,2014,Diciembre,Líbano,0,1,,1,-76.532004,3.451668
28987,2014,Diciembre,Líbano,1,9,,10,-74.140516,4.697157
28988,2014,Diciembre,Liechtenstein,1,1,,2,-75.42726,6.170465
28989,2014,Diciembre,Luxemburgo,2,1,,3,-74.140516,4.697157
28990,2014,Diciembre,Luxemburgo,1,1,,2,-75.42726,6.170465
28991,2014,Diciembre,Macao,0,1,,1,-74.140516,4.697157
28992,2014,Diciembre,Malasia,1,7,,8,-74.140516,4.697157
28993,2014,Diciembre,Malasia,0,1,,1,-75.42726,6.170465
28994,2014,Diciembre,Malta,0,1,,1,-74.140516,4.697157
28995,2014,Diciembre,Marruecos,9,8,,17,-75.516486,10.446304
28996,2014,Diciembre,Marruecos,1,3,,4,-74.140516,4.697157
28997,2014,Diciembre,Martinica/Departamento de Ultramar Francés,0,1,,1,-76.532004,3.451668
28998,2014,Diciembre,México,0,3,,3,-75.527794,10.406342
28999,2014,Diciembre,México,18,29,,47,-75.516486,10.446304
29000,2014,Diciembre,México,11,41,,52,-74.77647900000001,10.886686
29001,2014,Diciembre,México,0,2,,2,-74.765343,10.970933
29002,2014,Diciembre,México,6,7,,13,-81.70216500000001,12.5862
29003,2014,Diciembre,México,61,120,,181,-76.532004,3.451668
29004,2014,Diciembre,México,0,2,,2,-77.061029,3.8844260000000004
29005,2014,Diciembre,México,4041,6333,,10374,-74.140516,4.697157
29006,2014,Diciembre,México,11,15,,26,-75.736374,4.815189
29007,2014,Diciembre,México,109,243,,352,-75.42726,6.170465
29008,2014,Diciembre,México,17,19,,36,-73.181317,7.1280470000000005
29009,2014,Diciembre,México,23,25,,48,-72.508188,7.927233
29010,2014,Diciembre,Mozambique,0,1,,1,-74.140516,4.697157
29011,2014,Diciembre,Nepal,1,0,,1,-74.140516,4.697157
29012,2014,Diciembre,Nicaragua,1,9,,10,-75.516486,10.446304
29013,2014,Diciembre,Nicaragua,0,1,,1,-74.77647900000001,10.886686
29014,2014,Diciembre,Nicaragua,1,8,,9,-81.703935,12.574411099999999
29015,2014,Diciembre,Nicaragua,1,4,,5,-81.70216500000001,12.5862
29016,2014,Diciembre,Nicaragua,2,2,,4,-81.372937,13.338761300000002
29017,2014,Diciembre,Nicaragua,0,5,,5,-76.532004,3.451668
29018,2014,Diciembre,Nicaragua,0,4,,4,-77.061029,3.8844260000000004
29019,2014,Diciembre,Nicaragua,17,18,,35,-74.140516,4.697157
29020,2014,Diciembre,Nicaragua,1,0,,1,-75.736374,4.815189
29021,2014,Diciembre,Nicaragua,2,7,,9,-75.42726,6.170465
29022,2014,Diciembre,Nicaragua,0,1,,1,-72.508188,7.927233
29023,2014,Diciembre,Noruega,1,0,,1,-75.516486,10.446304
29024,2014,Diciembre,Noruega,0,1,,1,-74.77647900000001,10.886686
29025,2014,Diciembre,Noruega,3,3,,6,-76.532004,3.451668
29026,2014,Diciembre,Noruega,21,14,,35,-74.140516,4.697157
29027,2014,Diciembre,Noruega,4,7,,11,-75.42726,6.170465
29028,2014,Diciembre,Nueva Zelanda,0,2,,2,-76.532004,3.451668
29029,2014,Diciembre,Nueva Zelanda,6,6,,12,-74.140516,4.697157
29030,2014,Diciembre,Nueva Zelanda,0,2,,2,-75.42726,6.170465
29031,2014,Diciembre,Omán,0,1,,1,-74.140516,4.697157
29032,2014,Diciembre,Panamá,918,1294,,2212,-75.527794,10.406342
29033,2014,Diciembre,Panamá,2093,2370,,4463,-75.516486,10.446304
29034,2014,Diciembre,Panamá,262,487,,749,-74.77647900000001,10.886686
29035,2014,Diciembre,Panamá,0,2,,2,-74.765343,10.970933
29036,2014,Diciembre,Panamá,2,3,,5,-74.213989,11.247722999999999
29037,2014,Diciembre,Panamá,1,10,,11,-81.703935,12.574411099999999
29038,2014,Diciembre,Panamá,1172,1021,,2193,-81.70216500000001,12.5862
29039,2014,Diciembre,Panamá,5,8,,13,-81.372937,13.338761300000002
29040,2014,Diciembre,Panamá,516,1000,,1516,-76.532004,3.451668
29041,2014,Diciembre,Panamá,2,46,,48,-77.061029,3.8844260000000004
29042,2014,Diciembre,Panamá,2778,4753,,7531,-74.140516,4.697157
29043,2014,Diciembre,Panamá,74,160,,234,-75.736374,4.815189
29044,2014,Diciembre,Panamá,949,1716,,2665,-75.42726,6.170465
29045,2014,Diciembre,Panamá,0,1,,1,-77.401154,6.222551999999999
29046,2014,Diciembre,Panamá,10,7,,17,-77.762647,7.102626
29047,2014,Diciembre,Panamá,43,76,,119,-73.181317,7.1280470000000005
29048,2014,Diciembre,Panamá,267,310,,577,-72.508188,7.927233
29049,2014,Diciembre,Panamá,0,4,,4,-76.7333,8.06667
29050,2014,Diciembre,Panamá,65,122,,187,-77.35002,8.63337
29051,2014,Diciembre,Paraguay,0,1,,1,-77.35600000000001,0.81488
29052,2014,Diciembre,Paraguay,1,1,,2,-75.516486,10.446304
29053,2014,Diciembre,Paraguay,2,1,,3,-74.77647900000001,10.886686
29054,2014,Diciembre,Paraguay,11,6,,17,-81.70216500000001,12.5862
29055,2014,Diciembre,Paraguay,6,0,,6,-76.532004,3.451668
29056,2014,Diciembre,Paraguay,25,19,,44,-74.140516,4.697157
29057,2014,Diciembre,Paraguay,1,0,,1,-75.736374,4.815189
29058,2014,Diciembre,Paraguay,7,39,,46,-75.42726,6.170465
29059,2014,Diciembre,Paraguay,0,1,,1,-73.181317,7.1280470000000005
29060,2014,Diciembre,Perú,64,83,,147,-69.941498,4.191162
29061,2014,Diciembre,Perú,10,10,,20,-69.94143100000001,4.214082
29062,2014,Diciembre,Perú,7,22,,29,-77.35600000000001,0.81488
29063,2014,Diciembre,Perú,6,5,,11,-75.516486,10.446304
29064,2014,Diciembre,Perú,2,6,,8,-74.77647900000001,10.886686
29065,2014,Diciembre,Perú,123,95,,218,-81.70216500000001,12.5862
29066,2014,Diciembre,Perú,268,375,,643,-76.532004,3.451668
29067,2014,Diciembre,Perú,4563,6120,,10683,-74.140516,4.697157
29068,2014,Diciembre,Perú,4,5,,9,-75.736374,4.815189
29069,2014,Diciembre,Perú,260,414,,674,-75.42726,6.170465
29070,2014,Diciembre,Perú,1,0,,1,-73.181317,7.1280470000000005
29071,2014,Diciembre,Perú,5,7,,12,-72.508188,7.927233
29072,2014,Diciembre,Polonia,0,2,,2,-74.77647900000001,10.886686
29073,2014,Diciembre,Polonia,15,10,,25,-74.140516,4.697157
29074,2014,Diciembre,Portugal,0,3,,3,-74.765343,10.970933
29075,2014,Diciembre,Portugal,1,5,,6,-76.532004,3.451668
29076,2014,Diciembre,Portugal,404,680,,1084,-74.140516,4.697157
29077,2014,Diciembre,Portugal,0,1,,1,-75.736374,4.815189
29078,2014,Diciembre,Portugal,4,1,,5,-75.42726,6.170465
29079,2014,Diciembre,Puerto Rico/Territorio de Estados Unidos,2,1,,3,-75.516486,10.446304
29080,2014,Diciembre,Puerto Rico/Territorio de Estados Unidos,12,30,,42,-74.77647900000001,10.886686
29081,2014,Diciembre,Puerto Rico/Territorio de Estados Unidos,19,82,,101,-76.532004,3.451668
29082,2014,Diciembre,Puerto Rico/Territorio de Estados Unidos,328,403,,731,-74.140516,4.697157
29083,2014,Diciembre,Puerto Rico/Territorio de Estados Unidos,8,9,,17,-75.736374,4.815189
29084,2014,Diciembre,Puerto Rico/Territorio de Estados Unidos,47,106,,153,-75.42726,6.170465
29085,2014,Diciembre,Puerto Rico/Territorio de Estados Unidos,4,8,,12,-73.181317,7.1280470000000005
29086,2014,Diciembre,Puerto Rico/Territorio de Estados Unidos,4,5,,9,-72.508188,7.927233
29087,2014,Diciembre,Qatar,0,1,,1,-73.181317,7.1280470000000005
29088,2014,Diciembre,Reino Unido de Gran Bretaña e Irlanda del Norte,0,2,,2,-75.516486,10.446304
29089,2014,Diciembre,Reino Unido de Gran Bretaña e Irlanda del Norte,1,6,,7,-74.77647900000001,10.886686
29090,2014,Diciembre,Reino Unido de Gran Bretaña e Irlanda del Norte,14,33,,47,-76.532004,3.451668
29091,2014,Diciembre,Reino Unido de Gran Bretaña e Irlanda del Norte,573,1006,,1579,-74.140516,4.697157
29092,2014,Diciembre,Reino Unido de Gran Bretaña e Irlanda del Norte,0,1,,1,-75.736374,4.815189
29093,2014,Diciembre,Reino Unido de Gran Bretaña e Irlanda del Norte,15,25,,40,-75.42726,6.170465
29094,2014,Diciembre,Reino Unido de Gran Bretaña e Irlanda del Norte,1,1,,2,-73.181317,7.1280470000000005
29095,2014,Diciembre,Reino Unido de Gran Bretaña e Irlanda del Norte,0,1,,1,-72.508188,7.927233
29096,2014,Diciembre,Federación de Rusia,0,1,,1,-74.765343,10.970933
29097,2014,Diciembre,Federación de Rusia,19,24,,43,-74.140516,4.697157
29098,2014,Diciembre,Federación de Rusia,0,1,,1,-75.736374,4.815189
29099,2014,Diciembre,República Dominicana,0,5,,5,-75.527794,10.406342
29100,2014,Diciembre,República Dominicana,5,12,,17,-75.516486,10.446304
29101,2014,Diciembre,República Dominicana,12,25,,37,-74.77647900000001,10.886686
29102,2014,Diciembre,República Dominicana,0,5,,5,-74.765343,10.970933
29103,2014,Diciembre,República Dominicana,0,3,,3,-81.70216500000001,12.5862
29104,2014,Diciembre,República Dominicana,9,38,,47,-76.532004,3.451668
29105,2014,Diciembre,República Dominicana,325,576,,901,-74.140516,4.697157
29106,2014,Diciembre,República Dominicana,5,6,,11,-75.736374,4.815189
29107,2014,Diciembre,República Dominicana,20,43,,63,-75.42726,6.170465
29108,2014,Diciembre,República Dominicana,1,7,,8,-73.181317,7.1280470000000005
29109,2014,Diciembre,República Dominicana,1,6,,7,-72.508188,7.927233
29110,2014,Diciembre,República Democrática Popular de Corea,1,0,,1,-74.140516,4.697157
29111,2014,Diciembre,Rumania,0,1,,1,-75.516486,10.446304
29112,2014,Diciembre,Rumania,2,0,,2,-74.140516,4.697157
29113,2014,Diciembre,San  Vicente y las Granadinas,0,1,,1,-75.42726,6.170465
29114,2014,Diciembre,Santa Lucia,1,0,,1,-74.140516,4.697157
29115,2014,Diciembre,Senegal,1,2,,3,-75.42726,6.170465
29116,2014,Diciembre,Singapur,0,4,,4,-74.140516,4.697157
29117,2014,Diciembre,Sri Lanka,0,2,,2,-74.140516,4.697157
29118,2014,Diciembre,Sudáfrica,3,5,,8,-74.140516,4.697157
29119,2014,Diciembre,Sudáfrica,0,1,,1,-75.42726,6.170465
29120,2014,Diciembre,Suecia,2,1,,3,-74.77647900000001,10.886686
29121,2014,Diciembre,Suecia,8,16,,24,-76.532004,3.451668
29122,2014,Diciembre,Suecia,57,78,,135,-74.140516,4.697157
29123,2014,Diciembre,Suecia,1,0,,1,-75.736374,4.815189
29124,2014,Diciembre,Suecia,5,8,,13,-75.42726,6.170465
29125,2014,Diciembre,Suecia,4,1,,5,-73.181317,7.1280470000000005
29126,2014,Diciembre,Suiza,1,1,,2,-75.516486,10.446304
29127,2014,Diciembre,Suiza,2,0,,2,-74.77647900000001,10.886686
29128,2014,Diciembre,Suiza,0,1,,1,-81.70216500000001,12.5862
29129,2014,Diciembre,Suiza,11,18,,29,-76.532004,3.451668
29130,2014,Diciembre,Suiza,113,180,,293,-74.140516,4.697157
29131,2014,Diciembre,Suiza,0,1,,1,-75.736374,4.815189
29132,2014,Diciembre,Suiza,12,20,,32,-75.42726,6.170465
29133,2014,Diciembre,Suiza,0,1,,1,-73.181317,7.1280470000000005
29134,2014,Diciembre,Suiza,0,2,,2,-72.508188,7.927233
29135,2014,Diciembre,Surinam,0,36,,36,-75.527794,10.406342
29136,2014,Diciembre,Surinam,0,2,,2,-74.140516,4.697157
29137,2014,Diciembre,Taiwán,0,2,,2,-75.527794,10.406342
29138,2014,Diciembre,Taiwán,0,1,,1,-74.140516,4.697157
29139,2014,Diciembre,Taiwán,0,1,,1,-75.736374,4.815189
29140,2014,Diciembre,Tailandia,1,2,,3,-74.140516,4.697157
29141,2014,Diciembre,Trinidad y Tobago,1,3,,4,-75.516486,10.446304
29142,2014,Diciembre,Trinidad y Tobago,2,1,,3,-74.77647900000001,10.886686
29143,2014,Diciembre,Trinidad y Tobago,0,17,,17,-74.213989,11.247722999999999
29144,2014,Diciembre,Trinidad y Tobago,2,2,,4,-76.532004,3.451668
29145,2014,Diciembre,Trinidad y Tobago,8,9,,17,-74.140516,4.697157
29146,2014,Diciembre,Trinidad y Tobago,0,1,,1,-75.736374,4.815189
29147,2014,Diciembre,Trinidad y Tobago,2,6,,8,-75.42726,6.170465
29148,2014,Diciembre,Trinidad y Tobago,1,3,,4,-73.181317,7.1280470000000005
29149,2014,Diciembre,Trinidad y Tobago,0,3,,3,-72.508188,7.927233
29150,2014,Diciembre,Túnez,1,0,,1,-74.140516,4.697157
29151,2014,Diciembre,Turquía,1,2,,3,-75.516486,10.446304
29152,2014,Diciembre,Turquía,2,8,,10,-74.140516,4.697157
29153,2014,Diciembre,Ucrania,2,0,,2,-74.140516,4.697157
29154,2014,Diciembre,Uruguay,5,3,,8,-75.516486,10.446304
29155,2014,Diciembre,Uruguay,1,2,,3,-74.77647900000001,10.886686
29156,2014,Diciembre,Uruguay,6,7,,13,-81.70216500000001,12.5862
29157,2014,Diciembre,Uruguay,6,27,,33,-76.532004,3.451668
29158,2014,Diciembre,Uruguay,34,56,,90,-74.140516,4.697157
29159,2014,Diciembre,Uruguay,35,28,,63,-75.42726,6.170465
29160,2014,Diciembre,Uruguay,0,1,,1,-73.181317,7.1280470000000005
29161,2014,Diciembre,Uruguay,0,2,,2,-72.508188,7.927233
29162,2014,Diciembre,Venezuela,8,22,,30,-75.516486,10.446304
29163,2014,Diciembre,Venezuela,15,56,,71,-74.77647900000001,10.886686
29164,2014,Diciembre,Venezuela,0,3,,3,-74.765343,10.970933
29165,2014,Diciembre,Venezuela,0,6,,6,-74.232675,11.117206
29166,2014,Diciembre,Venezuela,3505,4402,,7907,-72.129595,11.360028999999999
29167,2014,Diciembre,Venezuela,4,1,,5,-81.70216500000001,12.5862
29168,2014,Diciembre,Venezuela,10,16,,26,-76.532004,3.451668
29169,2014,Diciembre,Venezuela,7,7,,14,-67.927521,3.866713
29170,2014,Diciembre,Venezuela,4523,4553,,9076,-74.140516,4.697157
29171,2014,Diciembre,Venezuela,0,1,,1,-75.736374,4.815189
29172,2014,Diciembre,Venezuela,64,74,,138,-75.42726,6.170465
29173,2014,Diciembre,Venezuela,404,650,,1054,-67.48402800000001,6.185536
29174,2014,Diciembre,Venezuela,206,311,,517,-70.74025300000001,7.088728999999999
29175,2014,Diciembre,Venezuela,3,13,,16,-73.181317,7.1280470000000005
29176,2014,Diciembre,Venezuela,6268,7293,,13561,-72.453013,7.819
29177,2014,Diciembre,Venezuela,669,627,,1296,-72.508188,7.927233
29178,2014,Diciembre,Vietnam,0,5,,5,-75.527794,10.406342
29179,2014,Diciembre,Vietnam,1,0,,1,-75.42726,6.170465
29180,2014,Diciembre,Vietnam,0,1,,1,-72.508188,7.927233
29181,2014,Diciembre,Islas Vírgenes Británicas/Territorio Británico de Ultramar,0,1,,1,-74.213989,11.247722999999999
29182,2014,Diciembre,República Árabe de Yemen,1,0,,1,-74.140516,4.697157
29183,2014,Diciembre,Zambia,0,1,,1,-74.77647900000001,10.886686
29184,2014,Diciembre,Desconocido,14,2,,16,-76.532004,3.451668
29185,2014,Diciembre,Desconocido,2,95,,97,-74.140516,4.697157
29186,2014,Diciembre,Desconocido,1,24,,25,-74.140516,4.697157
29187,2015,Enero,Alemania,2,1,,3,-74.77647900000001,10.886686
29188,2015,Enero,Alemania,19,12,,31,-76.532004,3.451668
29189,2015,Enero,Alemania,1480,2497,,3977,-74.140516,4.697157
29190,2015,Enero,Alemania,0,1,,1,-75.736374,4.815189
29191,2015,Enero,Alemania,15,19,,34,-75.42726,6.170465
29192,2015,Enero,Andorra,2,2,,4,-74.140516,4.697157
29193,2015,Enero,Países Bajos,39,29,,68,-75.527794,10.406342
29194,2015,Enero,Países Bajos,2,0,,2,-74.77647900000001,10.886686
29195,2015,Enero,Países Bajos,0,1,,1,-74.765343,10.970933
29196,2015,Enero,Países Bajos,14,22,,36,-74.213989,11.247722999999999
29197,2015,Enero,Países Bajos,6,16,,22,-76.532004,3.451668
29198,2015,Enero,Países Bajos,66,108,,174,-74.140516,4.697157
29199,2015,Enero,Países Bajos,0,1,,1,-75.736374,4.815189
29200,2015,Enero,Países Bajos,24,43,,67,-75.42726,6.170465
29201,2015,Enero,Países Bajos,2,0,,2,-73.181317,7.1280470000000005
29202,2015,Enero,Arabia Saudita,0,1,,1,-74.140516,4.697157
29203,2015,Enero,Argelia,4,2,,6,-74.140516,4.697157
29204,2015,Enero,Argentina,3,6,,9,-77.35600000000001,0.81488
29205,2015,Enero,Argentina,68,44,,112,-75.516486,10.446304
29206,2015,Enero,Argentina,14,21,,35,-74.77647900000001,10.886686
29207,2015,Enero,Argentina,94,75,,169,-81.70216500000001,12.5862
29208,2015,Enero,Argentina,98,110,,208,-76.532004,3.451668
29209,2015,Enero,Argentina,3421,3654,,7075,-74.140516,4.697157
29210,2015,Enero,Argentina,0,1,,1,-75.736374,4.815189
29211,2015,Enero,Argentina,155,167,,322,-75.42726,6.170465
29212,2015,Enero,Argentina,1,0,,1,-73.181317,7.1280470000000005
29213,2015,Enero,Argentina,0,1,,1,-72.508188,7.927233
29214,2015,Enero,República de Armenia,1,0,,1,-74.140516,4.697157
29215,2015,Enero,Aruba,72,80,,152,-75.527794,10.406342
29216,2015,Enero,Aruba,0,1,,1,-75.516486,10.446304
29217,2015,Enero,Aruba,1,3,,4,-74.77647900000001,10.886686
29218,2015,Enero,Aruba,0,2,,2,-74.765343,10.970933
29219,2015,Enero,Aruba,24,22,,46,-74.213989,11.247722999999999
29220,2015,Enero,Aruba,1,1,,2,-76.532004,3.451668
29221,2015,Enero,Aruba,386,440,,826,-74.140516,4.697157
29222,2015,Enero,Aruba,1,3,,4,-75.736374,4.815189
29223,2015,Enero,Aruba,3,7,,10,-75.42726,6.170465
29224,2015,Enero,Aruba,8,7,,15,-73.181317,7.1280470000000005
29225,2015,Enero,Aruba,0,2,,2,-72.508188,7.927233
29226,2015,Enero,Aruba,0,5,,5,-75.68164200000001,9.402597
29227,2015,Enero,Australia,2,2,,4,-75.516486,10.446304
29228,2015,Enero,Australia,0,4,,4,-74.77647900000001,10.886686
29229,2015,Enero,Australia,8,9,,17,-76.532004,3.451668
29230,2015,Enero,Australia,21,46,,67,-74.140516,4.697157
29231,2015,Enero,Australia,1,1,,2,-75.736374,4.815189
29232,2015,Enero,Australia,14,15,,29,-75.42726,6.170465
29233,2015,Enero,Austria,22,40,,62,-74.140516,4.697157
29234,2015,Enero,Austria,1,1,,2,-75.42726,6.170465
29235,2015,Enero,Austria,0,1,,1,-73.181317,7.1280470000000005
29236,2015,Enero,Azerbaiyán,1,1,,2,-76.532004,3.451668
29237,2015,Enero,Azerbaiyán,1,0,,1,-74.140516,4.697157
29238,2015,Enero,Bahamas,0,4,,4,-75.516486,10.446304
29239,2015,Enero,Bahamas,0,5,,5,-77.061029,3.8844260000000004
29240,2015,Enero,Bahamas,1,2,,3,-74.140516,4.697157
29241,2015,Enero,Bahamas,1,0,,1,-75.736374,4.815189
29242,2015,Enero,Bahréin,0,1,,1,-72.129595,11.360028999999999
29243,2015,Enero,Bangladesh,0,1,,1,-74.140516,4.697157
29244,2015,Enero,Barbados,0,1,,1,-76.532004,3.451668
29245,2015,Enero,Barbados,0,3,,3,-74.140516,4.697157
29246,2015,Enero,Barbados,0,1,,1,-75.736374,4.815189
29247,2015,Enero,Barbados,0,1,,1,-72.508188,7.927233
29248,2015,Enero,República de Belarús,0,1,,1,-72.129595,11.360028999999999
29249,2015,Enero,Bélgica,0,1,,1,-75.516486,10.446304
29250,2015,Enero,Bélgica,0,1,,1,-74.77647900000001,10.886686
29251,2015,Enero,Bélgica,1,7,,8,-76.532004,3.451668
29252,2015,Enero,Bélgica,21,46,,67,-74.140516,4.697157
29253,2015,Enero,Bélgica,0,6,,6,-75.42726,6.170465
29254,2015,Enero,Belice,0,1,,1,-75.516486,10.446304
29255,2015,Enero,Belice,2,0,,2,-74.140516,4.697157
29256,2015,Enero,Belice,0,2,,2,-75.42726,6.170465
29257,2015,Enero,Benín,1,1,,2,-74.140516,4.697157
29258,2015,Enero,Bermudas/Territorio Británico de Ultramar,0,2,,2,-76.532004,3.451668
29259,2015,Enero,Bermudas/Territorio Británico de Ultramar,0,1,,1,-75.42726,6.170465
29260,2015,Enero,Bolivia,1,0,,1,-77.35600000000001,0.81488
29261,2015,Enero,Bolivia,1,6,,7,-75.516486,10.446304
29262,2015,Enero,Bolivia,2,2,,4,-81.70216500000001,12.5862
29263,2015,Enero,Bolivia,19,14,,33,-76.532004,3.451668
29264,2015,Enero,Bolivia,605,669,,1274,-74.140516,4.697157
29265,2015,Enero,Bolivia,0,1,,1,-75.736374,4.815189
29266,2015,Enero,Bolivia,28,32,,60,-75.42726,6.170465
29267,2015,Enero,Bosnia y Herzegovina,0,1,,1,-75.42726,6.170465
29268,2015,Enero,Brasil,184,215,,399,-69.941498,4.191162
29269,2015,Enero,Brasil,13,31,,44,-69.94143100000001,4.214082
29270,2015,Enero,Brasil,1,2,,3,-77.35600000000001,0.81488
29271,2015,Enero,Brasil,3,14,,17,-75.527794,10.406342
29272,2015,Enero,Brasil,105,78,,183,-75.516486,10.446304
29273,2015,Enero,Brasil,10,9,,19,-74.77647900000001,10.886686
29274,2015,Enero,Brasil,96,67,,163,-81.70216500000001,12.5862
29275,2015,Enero,Brasil,55,72,,127,-76.532004,3.451668
29276,2015,Enero,Brasil,4007,5060,,9067,-74.140516,4.697157
29277,2015,Enero,Brasil,1,4,,5,-75.736374,4.815189
29278,2015,Enero,Brasil,105,172,,277,-75.42726,6.170465
29279,2015,Enero,Brasil,2,6,,8,-73.181317,7.1280470000000005
29280,2015,Enero,Brasil,0,3,,3,-72.508188,7.927233
29281,2015,Enero,Bulgaria,0,4,,4,-74.140516,4.697157
29282,2015,Enero,Bután,0,1,,1,-74.140516,4.697157
29283,2015,Enero,Islas Caimán/Territorio Británico de Ultramar,1,3,,4,-81.703935,12.574411099999999
29284,2015,Enero,Islas Caimán/Territorio Británico de Ultramar,2,3,,5,-81.70216500000001,12.5862
29285,2015,Enero,Islas Caimán/Territorio Británico de Ultramar,0,3,,3,-74.140516,4.697157
29286,2015,Enero,Canadá,726,702,,1428,-75.516486,10.446304
29287,2015,Enero,Canadá,21,24,,45,-74.77647900000001,10.886686
29288,2015,Enero,Canadá,324,316,,640,-81.70216500000001,12.5862
29289,2015,Enero,Canadá,26,33,,59,-76.532004,3.451668
29290,2015,Enero,Canadá,1,0,,1,-75.76635300000001,4.45285
29291,2015,Enero,Canadá,655,985,,1640,-74.140516,4.697157
29292,2015,Enero,Canadá,1,4,,5,-75.736374,4.815189
29293,2015,Enero,Canadá,72,128,,200,-75.42726,6.170465
29294,2015,Enero,Canadá,1,4,,5,-73.181317,7.1280470000000005
29295,2015,Enero,Canadá,4,5,,9,-72.508188,7.927233
29296,2015,Enero,España,0,8,,8,-75.527794,10.406342
29297,2015,Enero,España,0,1,,1,-75.516486,10.446304
29298,2015,Enero,España,0,2,,2,-74.77647900000001,10.886686
29299,2015,Enero,España,0,1,,1,-74.213989,11.247722999999999
29300,2015,Enero,España,1,0,,1,-81.70216500000001,12.5862
29301,2015,Enero,España,243,422,,665,-76.532004,3.451668
29302,2015,Enero,España,3162,5964,,9126,-74.140516,4.697157
29303,2015,Enero,España,1,3,,4,-75.736374,4.815189
29304,2015,Enero,España,151,353,,504,-75.42726,6.170465
29305,2015,Enero,República de Corea,0,1,,1,-76.532004,3.451668
29306,2015,Enero,República de Corea,0,2,,2,-77.061029,3.8844260000000004
29307,2015,Enero,República de Corea,18,25,,43,-74.140516,4.697157
29308,2015,Enero,República de Corea,0,1,,1,-75.736374,4.815189
29309,2015,Enero,República de Corea,2,1,,3,-75.42726,6.170465
29310,2015,Enero,República de Corea,0,1,,1,-72.508188,7.927233
29311,2015,Enero,Costa de Marfil,0,1,,1,-74.765343,10.970933
29312,2015,Enero,Costa de Marfil,3,0,,3,-74.140516,4.697157
29313,2015,Enero,Costa de Marfil,0,1,,1,-75.42726,6.170465
29314,2015,Enero,Costa Rica,3,5,,8,-75.527794,10.406342
29315,2015,Enero,Costa Rica,16,14,,30,-75.516486,10.446304
29316,2015,Enero,Costa Rica,5,8,,13,-74.77647900000001,10.886686
29317,2015,Enero,Costa Rica,412,320,,732,-81.70216500000001,12.5862
29318,2015,Enero,Costa Rica,12,31,,43,-76.532004,3.451668
29319,2015,Enero,Costa Rica,0,2,,2,-77.061029,3.8844260000000004
29320,2015,Enero,Costa Rica,579,899,,1478,-74.140516,4.697157
29321,2015,Enero,Costa Rica,6,9,,15,-75.736374,4.815189
29322,2015,Enero,Costa Rica,63,99,,162,-75.42726,6.170465
29323,2015,Enero,Costa Rica,2,6,,8,-73.181317,7.1280470000000005
29324,2015,Enero,Costa Rica,4,11,,15,-72.508188,7.927233
29325,2015,Enero,Croacia,0,2,,2,-76.532004,3.451668
29326,2015,Enero,Croacia,0,2,,2,-74.140516,4.697157
29327,2015,Enero,Cuba,3,3,,6,-75.516486,10.446304
29328,2015,Enero,Cuba,9,10,,19,-74.77647900000001,10.886686
29329,2015,Enero,Cuba,1,0,,1,-81.70216500000001,12.5862
29330,2015,Enero,Cuba,1,1,,2,-81.372937,13.338761300000002
29331,2015,Enero,Cuba,15,24,,39,-76.532004,3.451668
29332,2015,Enero,Cuba,248,353,,601,-74.140516,4.697157
29333,2015,Enero,Cuba,4,5,,9,-75.736374,4.815189
29334,2015,Enero,Cuba,13,18,,31,-75.42726,6.170465
29335,2015,Enero,Cuba,2,2,,4,-73.181317,7.1280470000000005
29336,2015,Enero,Cuba,2,12,,14,-72.508188,7.927233
29337,2015,Enero,Curazao,4,6,,10,-75.527794,10.406342
29338,2015,Enero,Curazao,52,85,,137,-74.77647900000001,10.886686
29339,2015,Enero,Curazao,2,6,,8,-74.213989,11.247722999999999
29340,2015,Enero,Curazao,1,2,,3,-76.532004,3.451668
29341,2015,Enero,Curazao,326,418,,744,-74.140516,4.697157
29342,2015,Enero,Curazao,122,176,,298,-75.42726,6.170465
29343,2015,Enero,República Checa,13,17,,30,-74.140516,4.697157
29344,2015,Enero,Chile,1,0,,1,-77.35600000000001,0.81488
29345,2015,Enero,Chile,11,12,,23,-75.516486,10.446304
29346,2015,Enero,Chile,5,9,,14,-74.77647900000001,10.886686
29347,2015,Enero,Chile,26,23,,49,-81.70216500000001,12.5862
29348,2015,Enero,Chile,45,58,,103,-76.532004,3.451668
29349,2015,Enero,Chile,4156,4842,,8998,-74.140516,4.697157
29350,2015,Enero,Chile,0,2,,2,-75.736374,4.815189
29351,2015,Enero,Chile,36,91,,127,-75.42726,6.170465
29352,2015,Enero,Chile,2,3,,5,-73.181317,7.1280470000000005
29353,2015,Enero,Chile,0,1,,1,-72.508188,7.927233
29354,2015,Enero,China,1,3,,4,-76.532004,3.451668
29355,2015,Enero,China,41,111,,152,-74.140516,4.697157
29356,2015,Enero,China,1,0,,1,-73.181317,7.1280470000000005
29357,2015,Enero,Dinamarca,1,2,,3,-76.532004,3.451668
29358,2015,Enero,Dinamarca,19,18,,37,-74.140516,4.697157
29359,2015,Enero,Dinamarca,1,3,,4,-75.42726,6.170465
29360,2015,Enero,Ecuador,53,183,,236,-76.876446,0.33002
29361,2015,Enero,Ecuador,2996,4608,,7604,-77.35600000000001,0.81488
29362,2015,Enero,Ecuador,8,20,,28,-78.802679,18.00143
29363,2015,Enero,Ecuador,0,1,,1,-75.527794,10.406342
29364,2015,Enero,Ecuador,0,3,,3,-75.516486,10.446304
29365,2015,Enero,Ecuador,1,5,,6,-74.77647900000001,10.886686
29366,2015,Enero,Ecuador,1,0,,1,-81.70216500000001,12.5862
29367,2015,Enero,Ecuador,340,506,,846,-76.532004,3.451668
29368,2015,Enero,Ecuador,0,2,,2,-77.061029,3.8844260000000004
29369,2015,Enero,Ecuador,2686,4158,,6844,-74.140516,4.697157
29370,2015,Enero,Ecuador,2,6,,8,-75.736374,4.815189
29371,2015,Enero,Ecuador,357,483,,840,-75.42726,6.170465
29372,2015,Enero,Ecuador,2,3,,5,-73.181317,7.1280470000000005
29373,2015,Enero,Ecuador,7,2,,9,-72.508188,7.927233
29374,2015,Enero,Egipto,0,1,,1,-76.532004,3.451668
29375,2015,Enero,Egipto,2,8,,10,-74.140516,4.697157
29376,2015,Enero,El Salvador,1,0,,1,-74.77647900000001,10.886686
29377,2015,Enero,El Salvador,116,178,,294,-76.532004,3.451668
29378,2015,Enero,El Salvador,622,990,,1612,-74.140516,4.697157
29379,2015,Enero,El Salvador,1,0,,1,-75.736374,4.815189
29380,2015,Enero,El Salvador,110,214,,324,-75.42726,6.170465
29381,2015,Enero,El Salvador,5,2,,7,-72.508188,7.927233
29382,2015,Enero,Emiratos Árabes,3,4,,7,-74.140516,4.697157
29383,2015,Enero,Eslovaquia,0,1,,1,-76.532004,3.451668
29384,2015,Enero,Eslovaquia,3,3,,6,-74.140516,4.697157
29385,2015,Enero,Eslovaquia,1,0,,1,-75.42726,6.170465
29386,2015,Enero,Eslovenia,0,2,,2,-76.532004,3.451668
29387,2015,Enero,Eslovenia,2,5,,7,-74.140516,4.697157
29388,2015,Enero,Estados Unidos de América,1,24,,25,-75.527794,10.406342
29389,2015,Enero,Estados Unidos de América,2085,3106,,5191,-75.516486,10.446304
29390,2015,Enero,Estados Unidos de América,191,366,,557,-74.77647900000001,10.886686
29391,2015,Enero,Estados Unidos de América,0,2,,2,-74.765343,10.970933
29392,2015,Enero,Estados Unidos de América,0,1,,1,-74.232675,11.117206
29393,2015,Enero,Estados Unidos de América,3,9,,12,-74.213989,11.247722999999999
29394,2015,Enero,Estados Unidos de América,4,6,,10,-81.70216500000001,12.5862
29395,2015,Enero,Estados Unidos de América,586,1055,,1641,-76.532004,3.451668
29396,2015,Enero,Estados Unidos de América,0,4,,4,-77.061029,3.8844260000000004
29397,2015,Enero,Estados Unidos de América,71,109,,180,-75.76635300000001,4.45285
29398,2015,Enero,Estados Unidos de América,7525,13075,,20600,-74.140516,4.697157
29399,2015,Enero,Estados Unidos de América,97,165,,262,-75.736374,4.815189
29400,2015,Enero,Estados Unidos de América,1267,3075,,4342,-75.42726,6.170465
29401,2015,Enero,Estados Unidos de América,28,29,,57,-73.181317,7.1280470000000005
29402,2015,Enero,Estados Unidos de América,97,86,,183,-72.508188,7.927233
29403,2015,Enero,Estados Unidos de América,0,2,,2,-76.7333,8.06667
29404,2015,Enero,Estados Unidos de América,0,4,,4,-75.68164200000001,9.402597
29405,2015,Enero,Estonia,1,0,,1,-74.140516,4.697157
29406,2015,Enero,Etiopia,0,1,,1,-74.140516,4.697157
29407,2015,Enero,Filipinas,0,7,,7,-75.516486,10.446304
29408,2015,Enero,Filipinas,0,1,,1,-74.77647900000001,10.886686
29409,2015,Enero,Filipinas,2,5,,7,-76.532004,3.451668
29410,2015,Enero,Filipinas,0,8,,8,-74.140516,4.697157
29411,2015,Enero,Finlandia,0,1,,1,-76.532004,3.451668
29412,2015,Enero,Finlandia,5,7,,12,-74.140516,4.697157
29413,2015,Enero,Finlandia,3,1,,4,-75.42726,6.170465
29414,2015,Enero,Francia,1,2,,3,-75.516486,10.446304
29415,2015,Enero,Francia,0,5,,5,-74.77647900000001,10.886686
29416,2015,Enero,Francia,13,21,,34,-76.532004,3.451668
29417,2015,Enero,Francia,1295,2235,,3530,-74.140516,4.697157
29418,2015,Enero,Francia,1,4,,5,-75.736374,4.815189
29419,2015,Enero,Francia,5,19,,24,-75.42726,6.170465
29420,2015,Enero,Francia,0,1,,1,-73.181317,7.1280470000000005
29421,2015,Enero,Georgia,1,0,,1,-74.140516,4.697157
29422,2015,Enero,Ghana,0,2,,2,-74.140516,4.697157
29423,2015,Enero,Granada,0,1,,1,-75.527794,10.406342
29424,2015,Enero,Granada,1,1,,2,-74.77647900000001,10.886686
29425,2015,Enero,Grecia,0,9,,9,-74.140516,4.697157
29426,2015,Enero,Guatemala,5,23,,28,-75.516486,10.446304
29427,2015,Enero,Guatemala,2,9,,11,-74.77647900000001,10.886686
29428,2015,Enero,Guatemala,3,2,,5,-81.70216500000001,12.5862
29429,2015,Enero,Guatemala,9,11,,20,-76.532004,3.451668
29430,2015,Enero,Guatemala,181,375,,556,-74.140516,4.697157
29431,2015,Enero,Guatemala,3,5,,8,-75.736374,4.815189
29432,2015,Enero,Guatemala,30,79,,109,-75.42726,6.170465
29433,2015,Enero,Guatemala,0,1,,1,-73.181317,7.1280470000000005
29434,2015,Enero,Guatemala,5,9,,14,-72.508188,7.927233
29435,2015,Enero,Guyana,4,1,,5,-74.140516,4.697157
29436,2015,Enero,Guinea Ecuatorial,0,6,,6,-74.77647900000001,10.886686
29437,2015,Enero,Guadalupe/Territorio Francés,1,2,,3,-74.140516,4.697157
29438,2015,Enero,Guadalupe/Territorio Francés,2,2,,4,-75.42726,6.170465
29439,2015,Enero,Guayana Francesa/Departamento de Ultramar Francés,2,1,,3,-74.140516,4.697157
29440,2015,Enero,Guayana Francesa/Departamento de Ultramar Francés,0,1,,1,-75.42726,6.170465
29441,2015,Enero,Haití,0,12,,12,-75.527794,10.406342
29442,2015,Enero,Haití,0,26,,26,-75.516486,10.446304
29443,2015,Enero,Haití,1,5,,6,-74.140516,4.697157
29444,2015,Enero,Haití,1,0,,1,-75.736374,4.815189
29445,2015,Enero,Haití,0,2,,2,-75.42726,6.170465
29446,2015,Enero,Honduras,0,1,,1,-75.527794,10.406342
29447,2015,Enero,Honduras,4,5,,9,-75.516486,10.446304
29448,2015,Enero,Honduras,3,10,,13,-81.372937,13.338761300000002
29449,2015,Enero,Honduras,6,16,,22,-76.532004,3.451668
29450,2015,Enero,Honduras,24,51,,75,-74.140516,4.697157
29451,2015,Enero,Honduras,1,2,,3,-75.736374,4.815189
29452,2015,Enero,Honduras,23,35,,58,-75.42726,6.170465
29453,2015,Enero,Honduras,2,0,,2,-73.181317,7.1280470000000005
29454,2015,Enero,Honduras,7,3,,10,-72.508188,7.927233
29455,2015,Enero,Hong Kong,3,4,,7,-74.140516,4.697157
29456,2015,Enero,Hungría,0,1,,1,-76.532004,3.451668
29457,2015,Enero,Hungría,2,3,,5,-74.140516,4.697157
29458,2015,Enero,India,0,1,,1,-75.516486,10.446304
29459,2015,Enero,India,0,8,,8,-76.532004,3.451668
29460,2015,Enero,India,4,25,,29,-74.140516,4.697157
29461,2015,Enero,India,0,6,,6,-75.42726,6.170465
29462,2015,Enero,Indonesia,0,1,,1,-75.516486,10.446304
29463,2015,Enero,Indonesia,1,2,,3,-74.140516,4.697157
29464,2015,Enero,Indonesia,0,1,,1,-75.42726,6.170465
29465,2015,Enero,Iraq,0,9,,9,-74.140516,4.697157
29466,2015,Enero,Irán,0,2,,2,-74.140516,4.697157
29467,2015,Enero,República de Irlanda,1,4,,5,-76.532004,3.451668
29468,2015,Enero,República de Irlanda,5,15,,20,-74.140516,4.697157
29469,2015,Enero,República de Irlanda,1,2,,3,-75.42726,6.170465
29470,2015,Enero,República de Irlanda,2,1,,3,-74.140516,4.697157
29471,2015,Enero,Israel,0,2,,2,-74.77647900000001,10.886686
29472,2015,Enero,Israel,1,7,,8,-76.532004,3.451668
29473,2015,Enero,Israel,17,66,,83,-74.140516,4.697157
29474,2015,Enero,Israel,0,7,,7,-75.42726,6.170465
29475,2015,Enero,Italia,1,7,,8,-75.516486,10.446304
29476,2015,Enero,Italia,1,1,,2,-74.77647900000001,10.886686
29477,2015,Enero,Italia,158,154,,312,-81.70216500000001,12.5862
29478,2015,Enero,Italia,11,31,,42,-76.532004,3.451668
29479,2015,Enero,Italia,111,341,,452,-74.140516,4.697157
29480,2015,Enero,Italia,3,2,,5,-75.736374,4.815189
29481,2015,Enero,Italia,12,35,,47,-75.42726,6.170465
29482,2015,Enero,Italia,0,1,,1,-73.181317,7.1280470000000005
29483,2015,Enero,Jamaica,2,3,,5,-75.527794,10.406342
29484,2015,Enero,Jamaica,0,3,,3,-75.516486,10.446304
29485,2015,Enero,Jamaica,0,1,,1,-74.77647900000001,10.886686
29486,2015,Enero,Jamaica,0,1,,1,-74.213989,11.247722999999999
29487,2015,Enero,Jamaica,2,1,,3,-76.532004,3.451668
29488,2015,Enero,Jamaica,1,5,,6,-74.140516,4.697157
29489,2015,Enero,Jamaica,0,2,,2,-75.42726,6.170465
29490,2015,Enero,Jamaica,2,0,,2,-73.181317,7.1280470000000005
29491,2015,Enero,Islas Salomón,1,0,,1,-74.140516,4.697157
29492,2015,Enero,Japón,1,10,,11,-76.532004,3.451668
29493,2015,Enero,Japón,12,33,,45,-74.140516,4.697157
29494,2015,Enero,Japón,1,1,,2,-75.736374,4.815189
29495,2015,Enero,Japón,0,5,,5,-75.42726,6.170465
29496,2015,Enero,Kazajistán,0,2,,2,-74.140516,4.697157
29497,2015,Enero,Kenia,2,1,,3,-74.140516,4.697157
29498,2015,Enero,Lituania,1,1,,2,-74.140516,4.697157
29499,2015,Enero,Líbano,5,5,,10,-74.140516,4.697157
29500,2015,Enero,Liberia,0,1,,1,-74.140516,4.697157
29501,2015,Enero,Luxemburgo,3,2,,5,-74.140516,4.697157
29502,2015,Enero,Malasia,1,1,,2,-76.532004,3.451668
29503,2015,Enero,Malasia,2,1,,3,-74.140516,4.697157
29504,2015,Enero,Malta,0,1,,1,-74.140516,4.697157
29505,2015,Enero,Marruecos,1,4,,5,-74.140516,4.697157
29506,2015,Enero,México,0,1,,1,-75.527794,10.406342
29507,2015,Enero,México,7,9,,16,-75.516486,10.446304
29508,2015,Enero,México,10,32,,42,-74.77647900000001,10.886686
29509,2015,Enero,México,1,3,,4,-81.70216500000001,12.5862
29510,2015,Enero,México,42,90,,132,-76.532004,3.451668
29511,2015,Enero,México,3412,5932,,9344,-74.140516,4.697157
29512,2015,Enero,México,6,6,,12,-75.736374,4.815189
29513,2015,Enero,México,97,280,,377,-75.42726,6.170465
29514,2015,Enero,México,8,18,,26,-73.181317,7.1280470000000005
29515,2015,Enero,México,28,26,,54,-72.508188,7.927233
29516,2015,Enero,Mónaco,1,0,,1,-74.140516,4.697157
29517,2015,Enero,Nauru,0,2,,2,-74.140516,4.697157
29518,2015,Enero,Nepal,0,1,,1,-76.532004,3.451668
29519,2015,Enero,Nicaragua,2,1,,3,-75.516486,10.446304
29520,2015,Enero,Nicaragua,1,1,,2,-74.77647900000001,10.886686
29521,2015,Enero,Nicaragua,4,6,,10,-76.532004,3.451668
29522,2015,Enero,Nicaragua,15,24,,39,-74.140516,4.697157
29523,2015,Enero,Nicaragua,0,1,,1,-75.736374,4.815189
29524,2015,Enero,Nicaragua,3,9,,12,-75.42726,6.170465
29525,2015,Enero,Nicaragua,1,0,,1,-73.181317,7.1280470000000005
29526,2015,Enero,Nicaragua,2,0,,2,-72.508188,7.927233
29527,2015,Enero,Noruega,0,1,,1,-76.532004,3.451668
29528,2015,Enero,Noruega,12,25,,37,-74.140516,4.697157
29529,2015,Enero,Noruega,0,1,,1,-75.736374,4.815189
29530,2015,Enero,Noruega,0,4,,4,-75.42726,6.170465
29531,2015,Enero,Noruega,1,0,,1,-72.508188,7.927233
29532,2015,Enero,Nueva Zelanda,2,7,,9,-76.532004,3.451668
29533,2015,Enero,Nueva Zelanda,3,4,,7,-74.140516,4.697157
29534,2015,Enero,Nueva Zelanda,0,1,,1,-75.736374,4.815189
29535,2015,Enero,Papúa Nueva Guinea,1,0,,1,-75.516486,10.446304
29536,2015,Enero,Pakistán,0,2,,2,-75.42726,6.170465
29537,2015,Enero,Panamá,0,3,,3,-69.941498,4.191162
29538,2015,Enero,Panamá,1178,1496,,2674,-75.527794,10.406342
29539,2015,Enero,Panamá,1980,2423,,4403,-75.516486,10.446304
29540,2015,Enero,Panamá,194,412,,606,-74.77647900000001,10.886686
29541,2015,Enero,Panamá,0,5,,5,-74.765343,10.970933
29542,2015,Enero,Panamá,1,2,,3,-74.232675,11.117206
29543,2015,Enero,Panamá,15,13,,28,-74.213989,11.247722999999999
29544,2015,Enero,Panamá,4,10,,14,-81.703935,12.574411099999999
29545,2015,Enero,Panamá,1359,1074,,2433,-81.70216500000001,12.5862
29546,2015,Enero,Panamá,1,1,,2,-81.372937,13.338761300000002
29547,2015,Enero,Panamá,342,608,,950,-76.532004,3.451668
29548,2015,Enero,Panamá,0,32,,32,-77.061029,3.8844260000000004
29549,2015,Enero,Panamá,2784,4394,,7178,-74.140516,4.697157
29550,2015,Enero,Panamá,57,116,,173,-75.736374,4.815189
29551,2015,Enero,Panamá,737,1417,,2154,-75.42726,6.170465
29552,2015,Enero,Panamá,2,0,,2,-77.401154,6.222551999999999
29553,2015,Enero,Panamá,0,2,,2,-77.762647,7.102626
29554,2015,Enero,Panamá,42,70,,112,-73.181317,7.1280470000000005
29555,2015,Enero,Panamá,196,216,,412,-72.508188,7.927233
29556,2015,Enero,Panamá,76,121,,197,-77.35002,8.63337
29557,2015,Enero,Panamá,0,1,,1,-75.68164200000001,9.402597
29558,2015,Enero,Paraguay,1,0,,1,-75.516486,10.446304
29559,2015,Enero,Paraguay,1,0,,1,-74.77647900000001,10.886686
29560,2015,Enero,Paraguay,33,20,,53,-81.70216500000001,12.5862
29561,2015,Enero,Paraguay,6,7,,13,-76.532004,3.451668
29562,2015,Enero,Paraguay,37,41,,78,-74.140516,4.697157
29563,2015,Enero,Paraguay,9,17,,26,-75.42726,6.170465
29564,2015,Enero,Perú,88,111,,199,-69.941498,4.191162
29565,2015,Enero,Perú,13,18,,31,-69.94143100000001,4.214082
29566,2015,Enero,Perú,14,15,,29,-77.35600000000001,0.81488
29567,2015,Enero,Perú,5,2,,7,-75.516486,10.446304
29568,2015,Enero,Perú,2,8,,10,-74.77647900000001,10.886686
29569,2015,Enero,Perú,54,35,,89,-81.70216500000001,12.5862
29570,2015,Enero,Perú,360,426,,786,-76.532004,3.451668
29571,2015,Enero,Perú,0,2,,2,-77.061029,3.8844260000000004
29572,2015,Enero,Perú,5668,7001,,12669,-74.140516,4.697157
29573,2015,Enero,Perú,348,518,,866,-75.42726,6.170465
29574,2015,Enero,Perú,3,3,,6,-73.181317,7.1280470000000005
29575,2015,Enero,Perú,8,2,,10,-72.508188,7.927233
29576,2015,Enero,Palestina,1,0,,1,-74.140516,4.697157
29577,2015,Enero,Polonia,1,1,,2,-76.532004,3.451668
29578,2015,Enero,Polonia,17,30,,47,-74.140516,4.697157
29579,2015,Enero,Polonia,1,1,,2,-75.42726,6.170465
29580,2015,Enero,Portugal,0,2,,2,-76.532004,3.451668
29581,2015,Enero,Portugal,372,738,,1110,-74.140516,4.697157
29582,2015,Enero,Portugal,2,0,,2,-75.42726,6.170465
29583,2015,Enero,Polinesia Francesa/Colectividad de Ultramar Francesa,1,0,,1,-74.140516,4.697157
29584,2015,Enero,Puerto Rico/Territorio de Estados Unidos,1,4,,5,-75.516486,10.446304
29585,2015,Enero,Puerto Rico/Territorio de Estados Unidos,6,56,,62,-74.77647900000001,10.886686
29586,2015,Enero,Puerto Rico/Territorio de Estados Unidos,12,27,,39,-76.532004,3.451668
29587,2015,Enero,Puerto Rico/Territorio de Estados Unidos,129,265,,394,-74.140516,4.697157
29588,2015,Enero,Puerto Rico/Territorio de Estados Unidos,7,13,,20,-75.736374,4.815189
29589,2015,Enero,Puerto Rico/Territorio de Estados Unidos,33,69,,102,-75.42726,6.170465
29590,2015,Enero,Puerto Rico/Territorio de Estados Unidos,2,2,,4,-73.181317,7.1280470000000005
29591,2015,Enero,Puerto Rico/Territorio de Estados Unidos,2,4,,6,-72.508188,7.927233
29592,2015,Enero,Qatar,0,1,,1,-74.140516,4.697157
29593,2015,Enero,Reino Unido de Gran Bretaña e Irlanda del Norte,1,0,,1,-74.77647900000001,10.886686
29594,2015,Enero,Reino Unido de Gran Bretaña e Irlanda del Norte,3,9,,12,-76.532004,3.451668
29595,2015,Enero,Reino Unido de Gran Bretaña e Irlanda del Norte,440,743,,1183,-74.140516,4.697157
29596,2015,Enero,Reino Unido de Gran Bretaña e Irlanda del Norte,0,1,,1,-75.736374,4.815189
29597,2015,Enero,Reino Unido de Gran Bretaña e Irlanda del Norte,7,15,,22,-75.42726,6.170465
29598,2015,Enero,República CentroÁfricana,0,1,,1,-74.140516,4.697157
29599,2015,Enero,Federación de Rusia,3,5,,8,-76.532004,3.451668
29600,2015,Enero,Federación de Rusia,61,81,,142,-74.140516,4.697157
29601,2015,Enero,Federación de Rusia,2,5,,7,-75.42726,6.170465
29602,2015,Enero,República Dominicana,0,3,,3,-75.527794,10.406342
29603,2015,Enero,República Dominicana,11,19,,30,-75.516486,10.446304
29604,2015,Enero,República Dominicana,1,9,,10,-74.77647900000001,10.886686
29605,2015,Enero,República Dominicana,0,1,,1,-74.765343,10.970933
29606,2015,Enero,República Dominicana,1,3,,4,-74.232675,11.117206
29607,2015,Enero,República Dominicana,20,29,,49,-76.532004,3.451668
29608,2015,Enero,República Dominicana,336,541,,877,-74.140516,4.697157
29609,2015,Enero,República Dominicana,3,3,,6,-75.736374,4.815189
29610,2015,Enero,República Dominicana,34,56,,90,-75.42726,6.170465
29611,2015,Enero,República Dominicana,0,4,,4,-73.181317,7.1280470000000005
29612,2015,Enero,República Dominicana,2,4,,6,-72.508188,7.927233
29613,2015,Enero,República Democrática Popular de Corea,0,1,,1,-76.532004,3.451668
29614,2015,Enero,Rumania,5,6,,11,-74.140516,4.697157
29615,2015,Enero,San Marino,1,0,,1,-72.508188,7.927233
29616,2015,Enero,Singapur,3,5,,8,-74.140516,4.697157
29617,2015,Enero,Sri Lanka,1,1,,2,-74.140516,4.697157
29618,2015,Enero,Sudáfrica,0,1,,1,-77.061029,3.8844260000000004
29619,2015,Enero,Sudáfrica,7,7,,14,-74.140516,4.697157
29620,2015,Enero,Suecia,1,5,,6,-76.532004,3.451668
29621,2015,Enero,Suecia,33,48,,81,-74.140516,4.697157
29622,2015,Enero,Suecia,3,11,,14,-75.42726,6.170465
29623,2015,Enero,Suiza,1,3,,4,-75.516486,10.446304
29624,2015,Enero,Suiza,5,23,,28,-76.532004,3.451668
29625,2015,Enero,Suiza,78,110,,188,-74.140516,4.697157
29626,2015,Enero,Suiza,10,14,,24,-75.42726,6.170465
29627,2015,Enero,Surinam,0,2,,2,-74.140516,4.697157
29628,2015,Enero,Surinam,4,9,,13,-75.42726,6.170465
29629,2015,Enero,Taiwán,1,0,,1,-76.532004,3.451668
29630,2015,Enero,Taiwán,1,1,,2,-74.140516,4.697157
29631,2015,Enero,Taiwán,0,2,,2,-75.42726,6.170465
29632,2015,Enero,Togo,0,1,,1,-74.140516,4.697157
29633,2015,Enero,Trinidad y Tobago,0,94,,94,-75.527794,10.406342
29634,2015,Enero,Trinidad y Tobago,0,2,,2,-75.516486,10.446304
29635,2015,Enero,Trinidad y Tobago,0,5,,5,-74.765343,10.970933
29636,2015,Enero,Trinidad y Tobago,3,12,,15,-76.532004,3.451668
29637,2015,Enero,Trinidad y Tobago,3,10,,13,-74.140516,4.697157
29638,2015,Enero,Trinidad y Tobago,0,1,,1,-75.736374,4.815189
29639,2015,Enero,Trinidad y Tobago,0,4,,4,-75.42726,6.170465
29640,2015,Enero,Trinidad y Tobago,1,1,,2,-73.181317,7.1280470000000005
29641,2015,Enero,Trinidad y Tobago,0,2,,2,-72.508188,7.927233
29642,2015,Enero,Turquía,0,2,,2,-76.532004,3.451668
29643,2015,Enero,Turquía,8,17,,25,-74.140516,4.697157
29644,2015,Enero,Turquía,3,10,,13,-75.42726,6.170465
29645,2015,Enero,Ucrania,3,3,,6,-76.532004,3.451668
29646,2015,Enero,Ucrania,1,10,,11,-74.140516,4.697157
29647,2015,Enero,Uruguay,16,14,,30,-75.516486,10.446304
29648,2015,Enero,Uruguay,3,3,,6,-74.77647900000001,10.886686
29649,2015,Enero,Uruguay,25,18,,43,-81.70216500000001,12.5862
29650,2015,Enero,Uruguay,13,16,,29,-76.532004,3.451668
29651,2015,Enero,Uruguay,55,62,,117,-74.140516,4.697157
29652,2015,Enero,Uruguay,1,2,,3,-75.736374,4.815189
29653,2015,Enero,Uruguay,22,26,,48,-75.42726,6.170465
29654,2015,Enero,Venezuela,0,19,,19,-75.527794,10.406342
29655,2015,Enero,Venezuela,5,19,,24,-75.516486,10.446304
29656,2015,Enero,Venezuela,9,45,,54,-74.77647900000001,10.886686
29657,2015,Enero,Venezuela,0,4,,4,-74.765343,10.970933
29658,2015,Enero,Venezuela,1843,2794,,4637,-72.129595,11.360028999999999
29659,2015,Enero,Venezuela,9,34,,43,-76.532004,3.451668
29660,2015,Enero,Venezuela,8,8,,16,-67.927521,3.866713
29661,2015,Enero,Venezuela,3405,3945,,7350,-74.140516,4.697157
29662,2015,Enero,Venezuela,8,4,,12,-75.736374,4.815189
29663,2015,Enero,Venezuela,45,87,,132,-75.42726,6.170465
29664,2015,Enero,Venezuela,384,571,,955,-67.48402800000001,6.185536
29665,2015,Enero,Venezuela,93,189,,282,-70.74025300000001,7.088728999999999
29666,2015,Enero,Venezuela,2,3,,5,-73.181317,7.1280470000000005
29667,2015,Enero,Venezuela,3709,4861,,8570,-72.453013,7.819
29668,2015,Enero,Venezuela,296,286,,582,-72.508188,7.927233
29669,2015,Enero,Vietnam,0,1,,1,-74.140516,4.697157
29670,2015,Enero,Islas Vírgenes Británicas/Territorio Británico de Ultramar,0,2,,2,-74.140516,4.697157
29671,2015,Enero,Islas Vírgenes Estadounidenses/Territorio de Estados Unidos,1,6,,7,-75.516486,10.446304
29672,2015,Enero,Desconocido,10,12,,22,-81.372937,13.338761300000002
29673,2015,Enero,Desconocido,0,2,,2,-76.532004,3.451668
29674,2015,Enero,Desconocido,1,27,,28,-74.140516,4.697157
29675,2015,Febrero,Albania,0,1,,1,-74.140516,4.697157
29676,2015,Febrero,Alemania,0,1,,1,-75.516486,10.446304
29677,2015,Febrero,Alemania,0,1,,1,-74.77647900000001,10.886686
29678,2015,Febrero,Alemania,1,2,,3,-81.70216500000001,12.5862
29679,2015,Febrero,Alemania,8,16,,24,-76.532004,3.451668
29680,2015,Febrero,Alemania,1434,2242,,3676,-74.140516,4.697157
29681,2015,Febrero,Alemania,0,1,,1,-75.736374,4.815189
29682,2015,Febrero,Alemania,10,17,,27,-75.42726,6.170465
29683,2015,Febrero,Países Bajos,1,2,,3,-75.516486,10.446304
29684,2015,Febrero,Países Bajos,9,16,,25,-74.77647900000001,10.886686
29685,2015,Febrero,Países Bajos,5,12,,17,-74.213989,11.247722999999999
29686,2015,Febrero,Países Bajos,3,10,,13,-76.532004,3.451668
29687,2015,Febrero,Países Bajos,83,141,,224,-74.140516,4.697157
29688,2015,Febrero,Países Bajos,1,2,,3,-75.736374,4.815189
29689,2015,Febrero,Países Bajos,68,78,,146,-75.42726,6.170465
29690,2015,Febrero,Países Bajos,3,1,,4,-73.181317,7.1280470000000005
29691,2015,Febrero,Argelia,2,2,,4,-74.140516,4.697157
29692,2015,Febrero,Argelia,0,8,,8,-76.7333,8.06667
29693,2015,Febrero,Argentina,81,60,,141,-75.516486,10.446304
29694,2015,Febrero,Argentina,5,4,,9,-74.77647900000001,10.886686
29695,2015,Febrero,Argentina,129,102,,231,-81.70216500000001,12.5862
29696,2015,Febrero,Argentina,80,84,,164,-76.532004,3.451668
29697,2015,Febrero,Argentina,2631,3057,,5688,-74.140516,4.697157
29698,2015,Febrero,Argentina,1,1,,2,-75.736374,4.815189
29699,2015,Febrero,Argentina,100,145,,245,-75.42726,6.170465
29700,2015,Febrero,Aruba,75,58,,133,-75.527794,10.406342
29701,2015,Febrero,Aruba,2,6,,8,-74.77647900000001,10.886686
29702,2015,Febrero,Aruba,0,2,,2,-74.765343,10.970933
29703,2015,Febrero,Aruba,0,1,,1,-74.232675,11.117206
29704,2015,Febrero,Aruba,12,18,,30,-74.213989,11.247722999999999
29705,2015,Febrero,Aruba,3,7,,10,-76.532004,3.451668
29706,2015,Febrero,Aruba,433,494,,927,-74.140516,4.697157
29707,2015,Febrero,Aruba,6,18,,24,-75.42726,6.170465
29708,2015,Febrero,Aruba,9,4,,13,-73.181317,7.1280470000000005
29709,2015,Febrero,Aruba,1,0,,1,-72.508188,7.927233
29710,2015,Febrero,Australia,3,3,,6,-75.516486,10.446304
29711,2015,Febrero,Australia,2,2,,4,-74.77647900000001,10.886686
29712,2015,Febrero,Australia,1,2,,3,-76.532004,3.451668
29713,2015,Febrero,Australia,11,36,,47,-74.140516,4.697157
29714,2015,Febrero,Australia,14,14,,28,-75.42726,6.170465
29715,2015,Febrero,Austria,0,1,,1,-76.532004,3.451668
29716,2015,Febrero,Austria,34,33,,67,-74.140516,4.697157
29717,2015,Febrero,Austria,1,2,,3,-75.42726,6.170465
29718,2015,Febrero,Bahamas,0,1,,1,-75.527794,10.406342
29719,2015,Febrero,Bahamas,1,3,,4,-75.516486,10.446304
29720,2015,Febrero,Bahamas,2,3,,5,-74.140516,4.697157
29721,2015,Febrero,Bahamas,0,2,,2,-75.42726,6.170465
29722,2015,Febrero,Bahréin,1,1,,2,-75.527794,10.406342
29723,2015,Febrero,Bahréin,1,1,,2,-74.140516,4.697157
29724,2015,Febrero,Barbados,0,1,,1,-76.532004,3.451668
29725,2015,Febrero,Barbados,0,2,,2,-74.140516,4.697157
29726,2015,Febrero,República de Belarús,3,1,,4,-74.140516,4.697157
29727,2015,Febrero,República de Belarús,0,1,,1,-72.453013,7.819
29728,2015,Febrero,Bélgica,0,3,,3,-75.527794,10.406342
29729,2015,Febrero,Bélgica,1,4,,5,-76.532004,3.451668
29730,2015,Febrero,Bélgica,23,35,,58,-74.140516,4.697157
29731,2015,Febrero,Bélgica,3,3,,6,-75.42726,6.170465
29732,2015,Febrero,Belice,1,1,,2,-75.516486,10.446304
29733,2015,Febrero,Belice,0,5,,5,-74.140516,4.697157
29734,2015,Febrero,Bermudas/Territorio Británico de Ultramar,0,2,,2,-76.532004,3.451668
29735,2015,Febrero,Bermudas/Territorio Británico de Ultramar,1,4,,5,-74.140516,4.697157
29736,2015,Febrero,Bolivia,0,1,,1,-75.516486,10.446304
29737,2015,Febrero,Bolivia,0,1,,1,-74.77647900000001,10.886686
29738,2015,Febrero,Bolivia,4,3,,7,-81.70216500000001,12.5862
29739,2015,Febrero,Bolivia,8,13,,21,-76.532004,3.451668
29740,2015,Febrero,Bolivia,299,466,,765,-74.140516,4.697157
29741,2015,Febrero,Bolivia,5,11,,16,-75.42726,6.170465
29742,2015,Febrero,Bolivia,1,3,,4,-73.181317,7.1280470000000005
29743,2015,Febrero,Brasil,99,129,,228,-69.941498,4.191162
29744,2015,Febrero,Brasil,9,22,,31,-69.94143100000001,4.214082
29745,2015,Febrero,Brasil,0,3,,3,-75.527794,10.406342
29746,2015,Febrero,Brasil,81,49,,130,-75.516486,10.446304
29747,2015,Febrero,Brasil,6,5,,11,-74.77647900000001,10.886686
29748,2015,Febrero,Brasil,155,123,,278,-81.70216500000001,12.5862
29749,2015,Febrero,Brasil,26,56,,82,-76.532004,3.451668
29750,2015,Febrero,Brasil,3712,5185,,8897,-74.140516,4.697157
29751,2015,Febrero,Brasil,4,7,,11,-75.736374,4.815189
29752,2015,Febrero,Brasil,199,217,,416,-75.42726,6.170465
29753,2015,Febrero,Brasil,0,1,,1,-73.181317,7.1280470000000005
29754,2015,Febrero,Brasil,1,3,,4,-72.508188,7.927233
29755,2015,Febrero,Brunei Darussalam,1,0,,1,-74.140516,4.697157
29756,2015,Febrero,Bulgaria,2,5,,7,-74.140516,4.697157
29757,2015,Febrero,Islas Caimán/Territorio Británico de Ultramar,2,11,,13,-75.527794,10.406342
29758,2015,Febrero,Islas Caimán/Territorio Británico de Ultramar,1,3,,4,-75.516486,10.446304
29759,2015,Febrero,Islas Caimán/Territorio Británico de Ultramar,1,2,,3,-81.703935,12.574411099999999
29760,2015,Febrero,Islas Caimán/Territorio Británico de Ultramar,0,12,,12,-74.140516,4.697157
29761,2015,Febrero,Camerún,1,1,,2,-74.140516,4.697157
29762,2015,Febrero,Canadá,0,1,,1,-75.527794,10.406342
29763,2015,Febrero,Canadá,694,643,,1337,-75.516486,10.446304
29764,2015,Febrero,Canadá,12,17,,29,-74.77647900000001,10.886686
29765,2015,Febrero,Canadá,360,323,,683,-81.70216500000001,12.5862
29766,2015,Febrero,Canadá,23,35,,58,-76.532004,3.451668
29767,2015,Febrero,Canadá,0,1,,1,-75.76635300000001,4.45285
29768,2015,Febrero,Canadá,614,924,,1538,-74.140516,4.697157
29769,2015,Febrero,Canadá,3,5,,8,-75.736374,4.815189
29770,2015,Febrero,Canadá,48,96,,144,-75.42726,6.170465
29771,2015,Febrero,Canadá,4,7,,11,-73.181317,7.1280470000000005
29772,2015,Febrero,Canadá,3,3,,6,-72.508188,7.927233
29773,2015,Febrero,Chad,0,1,,1,-74.140516,4.697157
29774,2015,Febrero,España,0,1,,1,-75.527794,10.406342
29775,2015,Febrero,España,1,2,,3,-75.516486,10.446304
29776,2015,Febrero,España,1,2,,3,-74.77647900000001,10.886686
29777,2015,Febrero,España,0,1,,1,-74.213989,11.247722999999999
29778,2015,Febrero,España,0,3,,3,-81.70216500000001,12.5862
29779,2015,Febrero,España,142,242,,384,-76.532004,3.451668
29780,2015,Febrero,España,2395,5274,,7669,-74.140516,4.697157
29781,2015,Febrero,España,1,1,,2,-75.736374,4.815189
29782,2015,Febrero,España,109,265,,374,-75.42726,6.170465
29783,2015,Febrero,República de Corea,14,11,,25,-74.140516,4.697157
29784,2015,Febrero,República de Corea,0,1,,1,-75.736374,4.815189
29785,2015,Febrero,República de Corea,5,4,,9,-75.42726,6.170465
29786,2015,Febrero,Costa de Marfil,1,2,,3,-74.140516,4.697157
29787,2015,Febrero,Costa Rica,1,3,,4,-75.527794,10.406342
29788,2015,Febrero,Costa Rica,2,2,,4,-75.516486,10.446304
29789,2015,Febrero,Costa Rica,4,4,,8,-74.77647900000001,10.886686
29790,2015,Febrero,Costa Rica,0,10,,10,-81.703935,12.574411099999999
29791,2015,Febrero,Costa Rica,42,45,,87,-81.70216500000001,12.5862
29792,2015,Febrero,Costa Rica,17,32,,49,-76.532004,3.451668
29793,2015,Febrero,Costa Rica,624,1076,,1700,-74.140516,4.697157
29794,2015,Febrero,Costa Rica,3,9,,12,-75.736374,4.815189
29795,2015,Febrero,Costa Rica,32,61,,93,-75.42726,6.170465
29796,2015,Febrero,Costa Rica,3,1,,4,-73.181317,7.1280470000000005
29797,2015,Febrero,Costa Rica,0,3,,3,-72.508188,7.927233
29798,2015,Febrero,Croacia,0,2,,2,-74.140516,4.697157
29799,2015,Febrero,Cuba,3,10,,13,-75.516486,10.446304
29800,2015,Febrero,Cuba,3,9,,12,-74.77647900000001,10.886686
29801,2015,Febrero,Cuba,4,3,,7,-76.532004,3.451668
29802,2015,Febrero,Cuba,269,392,,661,-74.140516,4.697157
29803,2015,Febrero,Cuba,10,16,,26,-75.42726,6.170465
29804,2015,Febrero,Cuba,0,2,,2,-73.181317,7.1280470000000005
29805,2015,Febrero,Cuba,1,3,,4,-72.508188,7.927233
29806,2015,Febrero,Curazao,23,66,,89,-74.77647900000001,10.886686
29807,2015,Febrero,Curazao,3,13,,16,-74.213989,11.247722999999999
29808,2015,Febrero,Curazao,259,337,,596,-74.140516,4.697157
29809,2015,Febrero,Curazao,98,150,,248,-75.42726,6.170465
29810,2015,Febrero,Curazao,0,1,,1,-72.508188,7.927233
29811,2015,Febrero,República Checa,0,1,,1,-76.532004,3.451668
29812,2015,Febrero,República Checa,7,8,,15,-74.140516,4.697157
29813,2015,Febrero,Chile,24,23,,47,-75.516486,10.446304
29814,2015,Febrero,Chile,3,4,,7,-74.77647900000001,10.886686
29815,2015,Febrero,Chile,69,73,,142,-81.70216500000001,12.5862
29816,2015,Febrero,Chile,64,88,,152,-76.532004,3.451668
29817,2015,Febrero,Chile,4834,5411,,10245,-74.140516,4.697157
29818,2015,Febrero,Chile,0,2,,2,-75.736374,4.815189
29819,2015,Febrero,Chile,81,84,,165,-75.42726,6.170465
29820,2015,Febrero,Chile,1,3,,4,-73.181317,7.1280470000000005
29821,2015,Febrero,China,26,52,,78,-74.140516,4.697157
29822,2015,Febrero,China,0,2,,2,-75.42726,6.170465
29823,2015,Febrero,Chipre,1,0,,1,-74.140516,4.697157
29824,2015,Febrero,Dinamarca,0,1,,1,-74.77647900000001,10.886686
29825,2015,Febrero,Dinamarca,2,0,,2,-76.532004,3.451668
29826,2015,Febrero,Dinamarca,17,15,,32,-74.140516,4.697157
29827,2015,Febrero,Dinamarca,0,1,,1,-75.736374,4.815189
29828,2015,Febrero,Dinamarca,1,1,,2,-75.42726,6.170465
29829,2015,Febrero,Ecuador,40,140,,180,-76.876446,0.33002
29830,2015,Febrero,Ecuador,2835,3846,,6681,-77.35600000000001,0.81488
29831,2015,Febrero,Ecuador,20,31,,51,-78.802679,18.00143
29832,2015,Febrero,Ecuador,0,1,,1,-75.516486,10.446304
29833,2015,Febrero,Ecuador,1,3,,4,-81.70216500000001,12.5862
29834,2015,Febrero,Ecuador,567,668,,1235,-76.532004,3.451668
29835,2015,Febrero,Ecuador,2479,4135,,6614,-74.140516,4.697157
29836,2015,Febrero,Ecuador,0,1,,1,-75.736374,4.815189
29837,2015,Febrero,Ecuador,510,678,,1188,-75.42726,6.170465
29838,2015,Febrero,Ecuador,0,5,,5,-73.181317,7.1280470000000005
29839,2015,Febrero,Ecuador,1,0,,1,-72.508188,7.927233
29840,2015,Febrero,Egipto,2,5,,7,-74.140516,4.697157
29841,2015,Febrero,El Salvador,2,3,,5,-75.516486,10.446304
29842,2015,Febrero,El Salvador,0,1,,1,-74.77647900000001,10.886686
29843,2015,Febrero,El Salvador,76,140,,216,-76.532004,3.451668
29844,2015,Febrero,El Salvador,606,1028,,1634,-74.140516,4.697157
29845,2015,Febrero,El Salvador,1,0,,1,-75.736374,4.815189
29846,2015,Febrero,El Salvador,101,148,,249,-75.42726,6.170465
29847,2015,Febrero,El Salvador,2,0,,2,-72.508188,7.927233
29848,2015,Febrero,Emiratos Árabes,1,3,,4,-74.140516,4.697157
29849,2015,Febrero,Emiratos Árabes,0,1,,1,-75.42726,6.170465
29850,2015,Febrero,Eslovaquia,7,4,,11,-74.140516,4.697157
29851,2015,Febrero,Eslovaquia,1,0,,1,-75.42726,6.170465
29852,2015,Febrero,Eslovenia,1,4,,5,-74.140516,4.697157
29853,2015,Febrero,Estados Unidos de América,1,11,,12,-75.527794,10.406342
29854,2015,Febrero,Estados Unidos de América,2412,3379,,5791,-75.516486,10.446304
29855,2015,Febrero,Estados Unidos de América,314,504,,818,-74.77647900000001,10.886686
29856,2015,Febrero,Estados Unidos de América,0,3,,3,-74.765343,10.970933
29857,2015,Febrero,Estados Unidos de América,0,17,,17,-74.213989,11.247722999999999
29858,2015,Febrero,Estados Unidos de América,13,20,,33,-81.70216500000001,12.5862
29859,2015,Febrero,Estados Unidos de América,673,1119,,1792,-76.532004,3.451668
29860,2015,Febrero,Estados Unidos de América,95,115,,210,-75.76635300000001,4.45285
29861,2015,Febrero,Estados Unidos de América,7756,14094,,21850,-74.140516,4.697157
29862,2015,Febrero,Estados Unidos de América,104,152,,256,-75.736374,4.815189
29863,2015,Febrero,Estados Unidos de América,1489,3496,,4985,-75.42726,6.170465
29864,2015,Febrero,Estados Unidos de América,11,17,,28,-73.181317,7.1280470000000005
29865,2015,Febrero,Estados Unidos de América,31,32,,63,-72.508188,7.927233
29866,2015,Febrero,Estados Unidos de América,0,1,,1,-75.68164200000001,9.402597
29867,2015,Febrero,Estonia,6,6,,12,-74.140516,4.697157
29868,2015,Febrero,Filipinas,0,4,,4,-74.77647900000001,10.886686
29869,2015,Febrero,Filipinas,1,12,,13,-76.532004,3.451668
29870,2015,Febrero,Filipinas,2,6,,8,-74.140516,4.697157
29871,2015,Febrero,Finlandia,0,1,,1,-76.532004,3.451668
29872,2015,Febrero,Finlandia,9,13,,22,-74.140516,4.697157
29873,2015,Febrero,Finlandia,0,1,,1,-75.42726,6.170465
29874,2015,Febrero,Francia,0,1,,1,-75.516486,10.446304
29875,2015,Febrero,Francia,1,2,,3,-74.77647900000001,10.886686
29876,2015,Febrero,Francia,7,17,,24,-76.532004,3.451668
29877,2015,Febrero,Francia,1251,2031,,3282,-74.140516,4.697157
29878,2015,Febrero,Francia,2,3,,5,-75.736374,4.815189
29879,2015,Febrero,Francia,6,20,,26,-75.42726,6.170465
29880,2015,Febrero,Francia,1,0,,1,-73.181317,7.1280470000000005
29881,2015,Febrero,Ghana,0,4,,4,-74.140516,4.697157
29882,2015,Febrero,Granada,1,1,,2,-74.213989,11.247722999999999
29883,2015,Febrero,Grecia,0,1,,1,-75.516486,10.446304
29884,2015,Febrero,Grecia,6,5,,11,-74.140516,4.697157
29885,2015,Febrero,Grecia,0,1,,1,-75.42726,6.170465
29886,2015,Febrero,Guatemala,60,72,,132,-75.516486,10.446304
29887,2015,Febrero,Guatemala,0,6,,6,-74.77647900000001,10.886686
29888,2015,Febrero,Guatemala,0,2,,2,-81.703935,12.574411099999999
29889,2015,Febrero,Guatemala,3,2,,5,-81.70216500000001,12.5862
29890,2015,Febrero,Guatemala,10,22,,32,-76.532004,3.451668
29891,2015,Febrero,Guatemala,242,537,,779,-74.140516,4.697157
29892,2015,Febrero,Guatemala,2,2,,4,-75.736374,4.815189
29893,2015,Febrero,Guatemala,25,49,,74,-75.42726,6.170465
29894,2015,Febrero,Guatemala,0,4,,4,-73.181317,7.1280470000000005
29895,2015,Febrero,Guatemala,1,4,,5,-72.508188,7.927233
29896,2015,Febrero,Guyana,0,1,,1,-74.77647900000001,10.886686
29897,2015,Febrero,Guyana,0,1,,1,-77.061029,3.8844260000000004
29898,2015,Febrero,Guyana,1,0,,1,-74.140516,4.697157
29899,2015,Febrero,Guyana,2,0,,2,-75.42726,6.170465
29900,2015,Febrero,Guinea,0,2,,2,-74.140516,4.697157
29901,2015,Febrero,Guinea Ecuatorial,0,4,,4,-74.140516,4.697157
29902,2015,Febrero,Guadalupe/Territorio Francés,1,1,,2,-75.42726,6.170465
29903,2015,Febrero,Haití,3,12,,15,-74.140516,4.697157
29904,2015,Febrero,Honduras,3,6,,9,-75.527794,10.406342
29905,2015,Febrero,Honduras,1,2,,3,-75.516486,10.446304
29906,2015,Febrero,Honduras,1,4,,5,-74.77647900000001,10.886686
29907,2015,Febrero,Honduras,2,7,,9,-76.532004,3.451668
29908,2015,Febrero,Honduras,51,72,,123,-74.140516,4.697157
29909,2015,Febrero,Honduras,17,42,,59,-75.42726,6.170465
29910,2015,Febrero,Honduras,1,1,,2,-72.508188,7.927233
29911,2015,Febrero,Hong Kong,1,0,,1,-74.140516,4.697157
29912,2015,Febrero,Hong Kong,1,1,,2,-75.42726,6.170465
29913,2015,Febrero,Hungría,2,5,,7,-74.140516,4.697157
29914,2015,Febrero,India,0,2,,2,-76.532004,3.451668
29915,2015,Febrero,India,6,30,,36,-74.140516,4.697157
29916,2015,Febrero,India,0,1,,1,-75.736374,4.815189
29917,2015,Febrero,India,0,2,,2,-75.42726,6.170465
29918,2015,Febrero,Indonesia,6,10,,16,-74.140516,4.697157
29919,2015,Febrero,Iraq,0,1,,1,-74.140516,4.697157
29920,2015,Febrero,Irán,1,1,,2,-74.140516,4.697157
29921,2015,Febrero,República de Irlanda,0,1,,1,-74.77647900000001,10.886686
29922,2015,Febrero,República de Irlanda,0,2,,2,-76.532004,3.451668
29923,2015,Febrero,República de Irlanda,5,17,,22,-74.140516,4.697157
29924,2015,Febrero,Israel,0,1,,1,-75.516486,10.446304
29925,2015,Febrero,Israel,0,1,,1,-76.532004,3.451668
29926,2015,Febrero,Israel,15,58,,73,-74.140516,4.697157
29927,2015,Febrero,Israel,1,3,,4,-75.42726,6.170465
29928,2015,Febrero,Italia,1,3,,4,-74.77647900000001,10.886686
29929,2015,Febrero,Italia,187,177,,364,-81.70216500000001,12.5862
29930,2015,Febrero,Italia,8,24,,32,-76.532004,3.451668
29931,2015,Febrero,Italia,123,315,,438,-74.140516,4.697157
29932,2015,Febrero,Italia,2,12,,14,-75.42726,6.170465
29933,2015,Febrero,Italia,0,2,,2,-73.181317,7.1280470000000005
29934,2015,Febrero,Jamaica,0,6,,6,-75.527794,10.406342
29935,2015,Febrero,Jamaica,2,3,,5,-75.516486,10.446304
29936,2015,Febrero,Jamaica,4,9,,13,-74.77647900000001,10.886686
29937,2015,Febrero,Jamaica,0,1,,1,-74.232675,11.117206
29938,2015,Febrero,Jamaica,1,0,,1,-81.372937,13.338761300000002
29939,2015,Febrero,Jamaica,0,2,,2,-76.532004,3.451668
29940,2015,Febrero,Jamaica,3,10,,13,-74.140516,4.697157
29941,2015,Febrero,Jamaica,0,6,,6,-75.42726,6.170465
29942,2015,Febrero,Japón,0,2,,2,-74.77647900000001,10.886686
29943,2015,Febrero,Japón,0,3,,3,-76.532004,3.451668
29944,2015,Febrero,Japón,8,20,,28,-74.140516,4.697157
29945,2015,Febrero,Japón,2,6,,8,-75.42726,6.170465
29946,2015,Febrero,Kazajistán,1,0,,1,-74.140516,4.697157
29947,2015,Febrero,Kazajistán,0,2,,2,-75.42726,6.170465
29948,2015,Febrero,Kenia,0,1,,1,-74.140516,4.697157
29949,2015,Febrero,Kenia,1,0,,1,-75.42726,6.170465
29950,2015,Febrero,Letonia,1,0,,1,-74.140516,4.697157
29951,2015,Febrero,Lituania,1,3,,4,-74.140516,4.697157
29952,2015,Febrero,Líbano,1,0,,1,-74.77647900000001,10.886686
29953,2015,Febrero,Líbano,4,6,,10,-74.140516,4.697157
29954,2015,Febrero,Liberia,1,0,,1,-74.140516,4.697157
29955,2015,Febrero,Luxemburgo,0,1,,1,-76.532004,3.451668
29956,2015,Febrero,Luxemburgo,2,1,,3,-74.140516,4.697157
29957,2015,Febrero,Macedonia,0,1,,1,-74.140516,4.697157
29958,2015,Febrero,Malasia,1,0,,1,-74.140516,4.697157
29959,2015,Febrero,Malta,1,0,,1,-74.140516,4.697157
29960,2015,Febrero,Martinica/Departamento de Ultramar Francés,1,1,,2,-74.213989,11.247722999999999
29961,2015,Febrero,Martinica/Departamento de Ultramar Francés,2,1,,3,-76.532004,3.451668
29962,2015,Febrero,México,0,1,,1,-75.527794,10.406342
29963,2015,Febrero,México,13,11,,24,-75.516486,10.446304
29964,2015,Febrero,México,9,50,,59,-74.77647900000001,10.886686
29965,2015,Febrero,México,0,1,,1,-74.765343,10.970933
29966,2015,Febrero,México,0,1,,1,-74.213989,11.247722999999999
29967,2015,Febrero,México,0,4,,4,-81.703935,12.574411099999999
29968,2015,Febrero,México,2,2,,4,-81.70216500000001,12.5862
29969,2015,Febrero,México,3,3,,6,-81.372937,13.338761300000002
29970,2015,Febrero,México,27,68,,95,-76.532004,3.451668
29971,2015,Febrero,México,3251,6379,,9630,-74.140516,4.697157
29972,2015,Febrero,México,4,9,,13,-75.736374,4.815189
29973,2015,Febrero,México,195,365,,560,-75.42726,6.170465
29974,2015,Febrero,México,0,5,,5,-73.181317,7.1280470000000005
29975,2015,Febrero,México,9,5,,14,-72.508188,7.927233
29976,2015,Febrero,Mónaco,0,1,,1,-74.140516,4.697157
29977,2015,Febrero,Nicaragua,1,3,,4,-75.516486,10.446304
29978,2015,Febrero,Nicaragua,1,7,,8,-81.703935,12.574411099999999
29979,2015,Febrero,Nicaragua,4,6,,10,-76.532004,3.451668
29980,2015,Febrero,Nicaragua,33,37,,70,-74.140516,4.697157
29981,2015,Febrero,Nicaragua,1,3,,4,-75.736374,4.815189
29982,2015,Febrero,Nicaragua,5,14,,19,-75.42726,6.170465
29983,2015,Febrero,Nigeria,0,10,,10,-74.140516,4.697157
29984,2015,Febrero,Noruega,1,2,,3,-74.77647900000001,10.886686
29985,2015,Febrero,Noruega,0,5,,5,-74.765343,10.970933
29986,2015,Febrero,Noruega,1,1,,2,-76.532004,3.451668
29987,2015,Febrero,Noruega,15,29,,44,-74.140516,4.697157
29988,2015,Febrero,Noruega,1,5,,6,-75.42726,6.170465
29989,2015,Febrero,Nueva Zelanda,1,1,,2,-75.516486,10.446304
29990,2015,Febrero,Nueva Zelanda,0,4,,4,-74.140516,4.697157
29991,2015,Febrero,Nueva Zelanda,0,1,,1,-75.42726,6.170465
29992,2015,Febrero,Panamá,1549,1558,,3107,-75.527794,10.406342
29993,2015,Febrero,Panamá,2175,2411,,4586,-75.516486,10.446304
29994,2015,Febrero,Panamá,234,534,,768,-74.77647900000001,10.886686
29995,2015,Febrero,Panamá,0,2,,2,-74.213989,11.247722999999999
29996,2015,Febrero,Panamá,5,12,,17,-81.703935,12.574411099999999
29997,2015,Febrero,Panamá,1180,984,,2164,-81.70216500000001,12.5862
29998,2015,Febrero,Panamá,26,23,,49,-81.372937,13.338761300000002
29999,2015,Febrero,Panamá,295,503,,798,-76.532004,3.451668
30000,2015,Febrero,Panamá,0,27,,27,-77.061029,3.8844260000000004
30001,2015,Febrero,Panamá,3229,5243,,8472,-74.140516,4.697157
30002,2015,Febrero,Panamá,75,150,,225,-75.736374,4.815189
30003,2015,Febrero,Panamá,1137,1778,,2915,-75.42726,6.170465
30004,2015,Febrero,Panamá,0,3,,3,-77.401154,6.222551999999999
30005,2015,Febrero,Panamá,4,0,,4,-77.762647,7.102626
30006,2015,Febrero,Panamá,32,54,,86,-73.181317,7.1280470000000005
30007,2015,Febrero,Panamá,89,117,,206,-72.508188,7.927233
30008,2015,Febrero,Panamá,0,1,,1,-76.7333,8.06667
30009,2015,Febrero,Panamá,88,83,,171,-77.35002,8.63337
30010,2015,Febrero,Paraguay,3,1,,4,-75.516486,10.446304
30011,2015,Febrero,Paraguay,0,1,,1,-74.77647900000001,10.886686
30012,2015,Febrero,Paraguay,59,44,,103,-81.70216500000001,12.5862
30013,2015,Febrero,Paraguay,3,3,,6,-76.532004,3.451668
30014,2015,Febrero,Paraguay,43,74,,117,-74.140516,4.697157
30015,2015,Febrero,Paraguay,1,0,,1,-75.736374,4.815189
30016,2015,Febrero,Paraguay,55,46,,101,-75.42726,6.170465
30017,2015,Febrero,Perú,82,109,,191,-69.941498,4.191162
30018,2015,Febrero,Perú,6,8,,14,-69.94143100000001,4.214082
30019,2015,Febrero,Perú,0,1,,1,-77.35600000000001,0.81488
30020,2015,Febrero,Perú,24,81,,105,-75.516486,10.446304
30021,2015,Febrero,Perú,2,5,,7,-74.77647900000001,10.886686
30022,2015,Febrero,Perú,197,131,,328,-81.70216500000001,12.5862
30023,2015,Febrero,Perú,314,416,,730,-76.532004,3.451668
30024,2015,Febrero,Perú,6467,7791,,14258,-74.140516,4.697157
30025,2015,Febrero,Perú,1,2,,3,-75.736374,4.815189
30026,2015,Febrero,Perú,512,636,,1148,-75.42726,6.170465
30027,2015,Febrero,Perú,2,2,,4,-73.181317,7.1280470000000005
30028,2015,Febrero,Perú,10,9,,19,-72.508188,7.927233
30029,2015,Febrero,Polonia,0,1,,1,-76.532004,3.451668
30030,2015,Febrero,Polonia,24,35,,59,-74.140516,4.697157
30031,2015,Febrero,Polonia,0,1,,1,-75.42726,6.170465
30032,2015,Febrero,Portugal,1,0,,1,-81.70216500000001,12.5862
30033,2015,Febrero,Portugal,265,410,,675,-74.140516,4.697157
30034,2015,Febrero,Portugal,0,3,,3,-75.42726,6.170465
30035,2015,Febrero,Puerto Rico/Territorio de Estados Unidos,0,2,,2,-75.527794,10.406342
30036,2015,Febrero,Puerto Rico/Territorio de Estados Unidos,2,2,,4,-75.516486,10.446304
30037,2015,Febrero,Puerto Rico/Territorio de Estados Unidos,16,79,,95,-74.77647900000001,10.886686
30038,2015,Febrero,Puerto Rico/Territorio de Estados Unidos,12,21,,33,-76.532004,3.451668
30039,2015,Febrero,Puerto Rico/Territorio de Estados Unidos,194,359,,553,-74.140516,4.697157
30040,2015,Febrero,Puerto Rico/Territorio de Estados Unidos,1,3,,4,-75.736374,4.815189
30041,2015,Febrero,Puerto Rico/Territorio de Estados Unidos,17,51,,68,-75.42726,6.170465
30042,2015,Febrero,Puerto Rico/Territorio de Estados Unidos,0,2,,2,-73.181317,7.1280470000000005
30043,2015,Febrero,Puerto Rico/Territorio de Estados Unidos,0,2,,2,-72.508188,7.927233
30044,2015,Febrero,Qatar,0,1,,1,-74.140516,4.697157
30045,2015,Febrero,Reino Unido de Gran Bretaña e Irlanda del Norte,1,2,,3,-75.516486,10.446304
30046,2015,Febrero,Reino Unido de Gran Bretaña e Irlanda del Norte,1,1,,2,-74.77647900000001,10.886686
30047,2015,Febrero,Reino Unido de Gran Bretaña e Irlanda del Norte,0,4,,4,-74.213989,11.247722999999999
30048,2015,Febrero,Reino Unido de Gran Bretaña e Irlanda del Norte,26,80,,106,-76.532004,3.451668
30049,2015,Febrero,Reino Unido de Gran Bretaña e Irlanda del Norte,444,762,,1206,-74.140516,4.697157
30050,2015,Febrero,Reino Unido de Gran Bretaña e Irlanda del Norte,7,12,,19,-75.42726,6.170465
30051,2015,Febrero,Federación de Rusia,0,1,,1,-74.77647900000001,10.886686
30052,2015,Febrero,Federación de Rusia,22,19,,41,-74.140516,4.697157
30053,2015,Febrero,Federación de Rusia,1,0,,1,-75.42726,6.170465
30054,2015,Febrero,República Dominicana,0,1,,1,-75.527794,10.406342
30055,2015,Febrero,República Dominicana,3,8,,11,-75.516486,10.446304
30056,2015,Febrero,República Dominicana,5,21,,26,-74.77647900000001,10.886686
30057,2015,Febrero,República Dominicana,0,2,,2,-74.765343,10.970933
30058,2015,Febrero,República Dominicana,0,1,,1,-74.232675,11.117206
30059,2015,Febrero,República Dominicana,12,33,,45,-76.532004,3.451668
30060,2015,Febrero,República Dominicana,413,664,,1077,-74.140516,4.697157
30061,2015,Febrero,República Dominicana,3,4,,7,-75.736374,4.815189
30062,2015,Febrero,República Dominicana,31,53,,84,-75.42726,6.170465
30063,2015,Febrero,República Dominicana,1,0,,1,-73.181317,7.1280470000000005
30064,2015,Febrero,República Dominicana,1,5,,6,-72.508188,7.927233
30065,2015,Febrero,República Democrática Popular de Corea,0,3,,3,-75.42726,6.170465
30066,2015,Febrero,Rumania,0,1,,1,-75.516486,10.446304
30067,2015,Febrero,Rumania,5,12,,17,-74.140516,4.697157
30068,2015,Febrero,Rwanda,0,1,,1,-74.140516,4.697157
30069,2015,Febrero,San  Vicente y las Granadinas,1,0,,1,-74.140516,4.697157
30070,2015,Febrero,Santa Lucia,1,1,,2,-74.140516,4.697157
30071,2015,Febrero,Senegal,1,0,,1,-74.140516,4.697157
30072,2015,Febrero,Singapur,2,0,,2,-74.140516,4.697157
30073,2015,Febrero,Singapur,1,1,,2,-75.42726,6.170465
30074,2015,Febrero,Sri Lanka,0,1,,1,-74.140516,4.697157
30075,2015,Febrero,Sudáfrica,4,5,,9,-74.140516,4.697157
30076,2015,Febrero,Suecia,0,1,,1,-75.516486,10.446304
30077,2015,Febrero,Suecia,0,1,,1,-74.77647900000001,10.886686
30078,2015,Febrero,Suecia,3,3,,6,-76.532004,3.451668
30079,2015,Febrero,Suecia,36,37,,73,-74.140516,4.697157
30080,2015,Febrero,Suecia,1,4,,5,-75.42726,6.170465
30081,2015,Febrero,Suecia,0,1,,1,-72.508188,7.927233
30082,2015,Febrero,Suiza,1,0,,1,-75.516486,10.446304
30083,2015,Febrero,Suiza,2,0,,2,-74.77647900000001,10.886686
30084,2015,Febrero,Suiza,7,16,,23,-76.532004,3.451668
30085,2015,Febrero,Suiza,71,112,,183,-74.140516,4.697157
30086,2015,Febrero,Suiza,7,12,,19,-75.42726,6.170465
30087,2015,Febrero,Suiza,1,5,,6,-73.181317,7.1280470000000005
30088,2015,Febrero,Surinam,2,1,,3,-74.140516,4.697157
30089,2015,Febrero,Surinam,3,2,,5,-75.42726,6.170465
30090,2015,Febrero,Taiwán,0,2,,2,-75.527794,10.406342
30091,2015,Febrero,Taiwán,4,4,,8,-74.140516,4.697157
30092,2015,Febrero,Taiwán,2,0,,2,-75.42726,6.170465
30093,2015,Febrero,Tailandia,1,1,,2,-74.140516,4.697157
30094,2015,Febrero,Tailandia,0,1,,1,-75.42726,6.170465
30095,2015,Febrero,Trinidad y Tobago,1,4,,5,-75.527794,10.406342
30096,2015,Febrero,Trinidad y Tobago,0,1,,1,-75.516486,10.446304
30097,2015,Febrero,Trinidad y Tobago,1,0,,1,-74.77647900000001,10.886686
30098,2015,Febrero,Trinidad y Tobago,0,6,,6,-76.532004,3.451668
30099,2015,Febrero,Trinidad y Tobago,6,12,,18,-74.140516,4.697157
30100,2015,Febrero,Trinidad y Tobago,0,1,,1,-75.736374,4.815189
30101,2015,Febrero,Trinidad y Tobago,2,4,,6,-75.42726,6.170465
30102,2015,Febrero,Túnez,0,1,,1,-74.140516,4.697157
30103,2015,Febrero,Turquía,0,2,,2,-75.516486,10.446304
30104,2015,Febrero,Turquía,0,2,,2,-76.532004,3.451668
30105,2015,Febrero,Turquía,26,112,,138,-74.140516,4.697157
30106,2015,Febrero,Turquía,0,1,,1,-75.42726,6.170465
30107,2015,Febrero,Ucrania,0,1,,1,-74.140516,4.697157
30108,2015,Febrero,Uruguay,24,12,,36,-75.516486,10.446304
30109,2015,Febrero,Uruguay,39,33,,72,-81.70216500000001,12.5862
30110,2015,Febrero,Uruguay,10,17,,27,-76.532004,3.451668
30111,2015,Febrero,Uruguay,30,60,,90,-74.140516,4.697157
30112,2015,Febrero,Uruguay,16,26,,42,-75.42726,6.170465
30113,2015,Febrero,Uruguay,0,4,,4,-73.181317,7.1280470000000005
30114,2015,Febrero,Venezuela,0,22,,22,-75.527794,10.406342
30115,2015,Febrero,Venezuela,20,32,,52,-75.516486,10.446304
30116,2015,Febrero,Venezuela,13,71,,84,-74.77647900000001,10.886686
30117,2015,Febrero,Venezuela,0,4,,4,-74.765343,10.970933
30118,2015,Febrero,Venezuela,2256,3048,,5304,-72.129595,11.360028999999999
30119,2015,Febrero,Venezuela,9,22,,31,-76.532004,3.451668
30120,2015,Febrero,Venezuela,5,22,,27,-67.927521,3.866713
30121,2015,Febrero,Venezuela,2942,3699,,6641,-74.140516,4.697157
30122,2015,Febrero,Venezuela,0,1,,1,-75.736374,4.815189
30123,2015,Febrero,Venezuela,26,67,,93,-75.42726,6.170465
30124,2015,Febrero,Venezuela,305,511,,816,-67.48402800000001,6.185536
30125,2015,Febrero,Venezuela,70,118,,188,-70.74025300000001,7.088728999999999
30126,2015,Febrero,Venezuela,1,5,,6,-73.181317,7.1280470000000005
30127,2015,Febrero,Venezuela,2825,3574,,6399,-72.453013,7.819
30128,2015,Febrero,Venezuela,252,282,,534,-72.508188,7.927233
30129,2015,Febrero,Vietnam,0,1,,1,-74.140516,4.697157
30130,2015,Febrero,Desconocido,0,6,,6,-77.84700600000001,0.8124359999999999
30131,2015,Febrero,Desconocido,1,0,,1,-81.70216500000001,12.5862
30132,2015,Febrero,Desconocido,10,19,,29,-81.372937,13.338761300000002
30133,2015,Febrero,Desconocido,1,36,,37,-74.140516,4.697157
30134,2015,Febrero,Desconocido,0,1,,1,-75.42726,6.170465
30135,2015,Febrero,Desconocido,3,2,,5,-67.48402800000001,6.185536
30136,2015,Febrero,Desconocido,0,1,,1,-76.7333,8.06667
30137,2015,Febrero,Desconocido,0,5,,5,-75.68164200000001,9.402597
30138,2015,Marzo,Afganistán,1,0,,1,-74.140516,4.697157
30139,2015,Marzo,Afganistán,0,1,,1,-75.42726,6.170465
30140,2015,Marzo,Alemania,5,2,,7,-74.77647900000001,10.886686
30141,2015,Marzo,Alemania,0,1,,1,-81.70216500000001,12.5862
30142,2015,Marzo,Alemania,17,27,,44,-76.532004,3.451668
30143,2015,Marzo,Alemania,1444,2506,,3950,-74.140516,4.697157
30144,2015,Marzo,Alemania,1,1,,2,-75.736374,4.815189
30145,2015,Marzo,Alemania,15,20,,35,-75.42726,6.170465
30146,2015,Marzo,Andorra,1,0,,1,-74.140516,4.697157
30147,2015,Marzo,Antigua y Barbuda,0,3,,3,-75.527794,10.406342
30148,2015,Marzo,Antigua y Barbuda,1,0,,1,-74.77647900000001,10.886686
30149,2015,Marzo,Antigua y Barbuda,0,3,,3,-74.140516,4.697157
30150,2015,Marzo,Países Bajos,1,3,,4,-75.527794,10.406342
30151,2015,Marzo,Países Bajos,38,38,,76,-74.77647900000001,10.886686
30152,2015,Marzo,Países Bajos,1,18,,19,-74.213989,11.247722999999999
30153,2015,Marzo,Países Bajos,26,56,,82,-76.532004,3.451668
30154,2015,Marzo,Países Bajos,298,428,,726,-74.140516,4.697157
30155,2015,Marzo,Países Bajos,165,235,,400,-75.42726,6.170465
30156,2015,Marzo,Países Bajos,3,3,,6,-73.181317,7.1280470000000005
30157,2015,Marzo,Arabia Saudita,0,3,,3,-74.140516,4.697157
30158,2015,Marzo,Arabia Saudita,0,1,,1,-75.736374,4.815189
30159,2015,Marzo,Argelia,3,2,,5,-74.140516,4.697157
30160,2015,Marzo,Argentina,13,12,,25,-77.35600000000001,0.81488
30161,2015,Marzo,Argentina,107,73,,180,-75.516486,10.446304
30162,2015,Marzo,Argentina,1,13,,14,-74.77647900000001,10.886686
30163,2015,Marzo,Argentina,0,3,,3,-74.765343,10.970933
30164,2015,Marzo,Argentina,157,122,,279,-81.70216500000001,12.5862
30165,2015,Marzo,Argentina,85,111,,196,-76.532004,3.451668
30166,2015,Marzo,Argentina,2813,3577,,6390,-74.140516,4.697157
30167,2015,Marzo,Argentina,88,193,,281,-75.42726,6.170465
30168,2015,Marzo,Aruba,75,75,,150,-75.527794,10.406342
30169,2015,Marzo,Aruba,24,33,,57,-74.77647900000001,10.886686
30170,2015,Marzo,Aruba,0,1,,1,-74.765343,10.970933
30171,2015,Marzo,Aruba,9,9,,18,-74.213989,11.247722999999999
30172,2015,Marzo,Aruba,2,6,,8,-76.532004,3.451668
30173,2015,Marzo,Aruba,473,589,,1062,-74.140516,4.697157
30174,2015,Marzo,Aruba,9,6,,15,-75.42726,6.170465
30175,2015,Marzo,Aruba,8,3,,11,-73.181317,7.1280470000000005
30176,2015,Marzo,Australia,0,1,,1,-75.516486,10.446304
30177,2015,Marzo,Australia,0,3,,3,-74.77647900000001,10.886686
30178,2015,Marzo,Australia,2,0,,2,-81.70216500000001,12.5862
30179,2015,Marzo,Australia,5,5,,10,-76.532004,3.451668
30180,2015,Marzo,Australia,27,39,,66,-74.140516,4.697157
30181,2015,Marzo,Australia,0,12,,12,-75.42726,6.170465
30182,2015,Marzo,Australia,0,1,,1,-73.181317,7.1280470000000005
30183,2015,Marzo,Austria,0,1,,1,-74.77647900000001,10.886686
30184,2015,Marzo,Austria,0,2,,2,-76.532004,3.451668
30185,2015,Marzo,Austria,8,24,,32,-74.140516,4.697157
30186,2015,Marzo,Austria,0,1,,1,-75.42726,6.170465
30187,2015,Marzo,Bahamas,1,2,,3,-75.527794,10.406342
30188,2015,Marzo,Bahamas,0,3,,3,-74.765343,10.970933
30189,2015,Marzo,Bahamas,0,1,,1,-74.140516,4.697157
30190,2015,Marzo,Bahamas,0,2,,2,-75.42726,6.170465
30191,2015,Marzo,Bahréin,0,1,,1,-75.516486,10.446304
30192,2015,Marzo,Barbados,0,2,,2,-75.527794,10.406342
30193,2015,Marzo,Barbados,0,2,,2,-76.532004,3.451668
30194,2015,Marzo,Barbados,0,2,,2,-74.140516,4.697157
30195,2015,Marzo,República de Belarús,0,1,,1,-74.140516,4.697157
30196,2015,Marzo,República de Belarús,0,1,,1,-72.453013,7.819
30197,2015,Marzo,Bélgica,1,1,,2,-74.77647900000001,10.886686
30198,2015,Marzo,Bélgica,2,2,,4,-76.532004,3.451668
30199,2015,Marzo,Bélgica,22,34,,56,-74.140516,4.697157
30200,2015,Marzo,Bélgica,4,6,,10,-75.42726,6.170465
30201,2015,Marzo,Belice,1,3,,4,-74.140516,4.697157
30202,2015,Marzo,Benín,2,0,,2,-74.140516,4.697157
30203,2015,Marzo,Bermudas/Territorio Británico de Ultramar,0,1,,1,-74.140516,4.697157
30204,2015,Marzo,Bolivia,1,0,,1,-77.35600000000001,0.81488
30205,2015,Marzo,Bolivia,0,3,,3,-74.232675,11.117206
30206,2015,Marzo,Bolivia,1,1,,2,-81.70216500000001,12.5862
30207,2015,Marzo,Bolivia,9,7,,16,-76.532004,3.451668
30208,2015,Marzo,Bolivia,340,442,,782,-74.140516,4.697157
30209,2015,Marzo,Bolivia,13,34,,47,-75.42726,6.170465
30210,2015,Marzo,Botsuana,0,2,,2,-74.140516,4.697157
30211,2015,Marzo,Brasil,104,138,,242,-69.941498,4.191162
30212,2015,Marzo,Brasil,15,19,,34,-69.94143100000001,4.214082
30213,2015,Marzo,Brasil,0,2,,2,-77.35600000000001,0.81488
30214,2015,Marzo,Brasil,0,7,,7,-75.527794,10.406342
30215,2015,Marzo,Brasil,54,47,,101,-75.516486,10.446304
30216,2015,Marzo,Brasil,1,4,,5,-74.77647900000001,10.886686
30217,2015,Marzo,Brasil,143,100,,243,-81.70216500000001,12.5862
30218,2015,Marzo,Brasil,39,73,,112,-76.532004,3.451668
30219,2015,Marzo,Brasil,0,4,,4,-67.927521,3.866713
30220,2015,Marzo,Brasil,3250,5314,,8564,-74.140516,4.697157
30221,2015,Marzo,Brasil,3,2,,5,-75.736374,4.815189
30222,2015,Marzo,Brasil,92,180,,272,-75.42726,6.170465
30223,2015,Marzo,Brasil,3,1,,4,-73.181317,7.1280470000000005
30224,2015,Marzo,Brasil,4,3,,7,-72.508188,7.927233
30225,2015,Marzo,Bulgaria,0,1,,1,-74.765343,10.970933
30226,2015,Marzo,Bulgaria,3,4,,7,-74.140516,4.697157
30227,2015,Marzo,Burundi,0,2,,2,-74.140516,4.697157
30228,2015,Marzo,Cabo Verde,1,0,,1,-74.140516,4.697157
30229,2015,Marzo,Islas Caimán/Territorio Británico de Ultramar,4,3,,7,-75.527794,10.406342
30230,2015,Marzo,Islas Caimán/Territorio Británico de Ultramar,1,0,,1,-74.77647900000001,10.886686
30231,2015,Marzo,Islas Caimán/Territorio Británico de Ultramar,0,5,,5,-74.140516,4.697157
30232,2015,Marzo,Camerún,0,1,,1,-74.140516,4.697157
30233,2015,Marzo,Camerún,0,1,,1,-75.42726,6.170465
30234,2015,Marzo,Canadá,298,321,,619,-75.516486,10.446304
30235,2015,Marzo,Canadá,10,10,,20,-74.77647900000001,10.886686
30236,2015,Marzo,Canadá,424,380,,804,-81.70216500000001,12.5862
30237,2015,Marzo,Canadá,25,45,,70,-76.532004,3.451668
30238,2015,Marzo,Canadá,589,907,,1496,-74.140516,4.697157
30239,2015,Marzo,Canadá,5,10,,15,-75.736374,4.815189
30240,2015,Marzo,Canadá,54,93,,147,-75.42726,6.170465
30241,2015,Marzo,Canadá,1,3,,4,-73.181317,7.1280470000000005
30242,2015,Marzo,Canadá,4,2,,6,-72.508188,7.927233
30243,2015,Marzo,España,0,1,,1,-75.516486,10.446304
30244,2015,Marzo,España,2,4,,6,-74.77647900000001,10.886686
30245,2015,Marzo,España,0,4,,4,-74.765343,10.970933
30246,2015,Marzo,España,0,6,,6,-74.213989,11.247722999999999
30247,2015,Marzo,España,1,1,,2,-81.70216500000001,12.5862
30248,2015,Marzo,España,156,277,,433,-76.532004,3.451668
30249,2015,Marzo,España,2599,5310,,7909,-74.140516,4.697157
30250,2015,Marzo,España,4,3,,7,-75.736374,4.815189
30251,2015,Marzo,España,105,264,,369,-75.42726,6.170465
30252,2015,Marzo,España,1,1,,2,-72.508188,7.927233
30253,2015,Marzo,República de Corea,1,0,,1,-76.532004,3.451668
30254,2015,Marzo,República de Corea,8,28,,36,-74.140516,4.697157
30255,2015,Marzo,República de Corea,1,2,,3,-75.42726,6.170465
30256,2015,Marzo,República de Corea,0,1,,1,-72.508188,7.927233
30257,2015,Marzo,Costa de Marfil,2,3,,5,-74.140516,4.697157
30258,2015,Marzo,Costa Rica,1,2,,3,-75.527794,10.406342
30259,2015,Marzo,Costa Rica,5,11,,16,-75.516486,10.446304
30260,2015,Marzo,Costa Rica,11,7,,18,-74.77647900000001,10.886686
30261,2015,Marzo,Costa Rica,4,3,,7,-81.70216500000001,12.5862
30262,2015,Marzo,Costa Rica,22,41,,63,-76.532004,3.451668
30263,2015,Marzo,Costa Rica,0,2,,2,-77.061029,3.8844260000000004
30264,2015,Marzo,Costa Rica,857,1290,,2147,-74.140516,4.697157
30265,2015,Marzo,Costa Rica,7,4,,11,-75.736374,4.815189
30266,2015,Marzo,Costa Rica,45,79,,124,-75.42726,6.170465
30267,2015,Marzo,Costa Rica,5,3,,8,-73.181317,7.1280470000000005
30268,2015,Marzo,Costa Rica,0,2,,2,-72.508188,7.927233
30269,2015,Marzo,Croacia,2,4,,6,-74.140516,4.697157
30270,2015,Marzo,Cuba,1,4,,5,-75.516486,10.446304
30271,2015,Marzo,Cuba,7,9,,16,-74.77647900000001,10.886686
30272,2015,Marzo,Cuba,1,1,,2,-81.70216500000001,12.5862
30273,2015,Marzo,Cuba,6,9,,15,-76.532004,3.451668
30274,2015,Marzo,Cuba,257,400,,657,-74.140516,4.697157
30275,2015,Marzo,Cuba,2,3,,5,-75.736374,4.815189
30276,2015,Marzo,Cuba,15,14,,29,-75.42726,6.170465
30277,2015,Marzo,Cuba,1,1,,2,-73.181317,7.1280470000000005
30278,2015,Marzo,Cuba,0,1,,1,-72.508188,7.927233
30279,2015,Marzo,República Checa,1,5,,6,-74.140516,4.697157
30280,2015,Marzo,República Checa,0,1,,1,-75.42726,6.170465
30281,2015,Marzo,Chile,2,10,,12,-77.35600000000001,0.81488
30282,2015,Marzo,Chile,10,10,,20,-75.516486,10.446304
30283,2015,Marzo,Chile,0,3,,3,-74.77647900000001,10.886686
30284,2015,Marzo,Chile,51,42,,93,-81.70216500000001,12.5862
30285,2015,Marzo,Chile,13,51,,64,-76.532004,3.451668
30286,2015,Marzo,Chile,4122,5642,,9764,-74.140516,4.697157
30287,2015,Marzo,Chile,0,1,,1,-75.736374,4.815189
30288,2015,Marzo,Chile,15,61,,76,-75.42726,6.170465
30289,2015,Marzo,Chile,0,1,,1,-73.181317,7.1280470000000005
30290,2015,Marzo,Chile,1,2,,3,-72.508188,7.927233
30291,2015,Marzo,China,39,132,,171,-74.140516,4.697157
30292,2015,Marzo,China,4,2,,6,-75.42726,6.170465
30293,2015,Marzo,China,0,1,,1,-72.508188,7.927233
30294,2015,Marzo,Dinamarca,18,24,,42,-74.140516,4.697157
30295,2015,Marzo,Dinamarca,1,0,,1,-75.42726,6.170465
30296,2015,Marzo,Ecuador,40,201,,241,-76.876446,0.33002
30297,2015,Marzo,Ecuador,2905,4727,,7632,-77.35600000000001,0.81488
30298,2015,Marzo,Ecuador,18,24,,42,-78.802679,18.00143
30299,2015,Marzo,Ecuador,0,4,,4,-74.77647900000001,10.886686
30300,2015,Marzo,Ecuador,516,630,,1146,-76.532004,3.451668
30301,2015,Marzo,Ecuador,2708,4593,,7301,-74.140516,4.697157
30302,2015,Marzo,Ecuador,0,1,,1,-75.736374,4.815189
30303,2015,Marzo,Ecuador,492,708,,1200,-75.42726,6.170465
30304,2015,Marzo,Ecuador,1,2,,3,-73.181317,7.1280470000000005
30305,2015,Marzo,Ecuador,3,4,,7,-72.508188,7.927233
30306,2015,Marzo,Egipto,1,6,,7,-74.140516,4.697157
30307,2015,Marzo,El Salvador,4,4,,8,-75.516486,10.446304
30308,2015,Marzo,El Salvador,1,1,,2,-74.77647900000001,10.886686
30309,2015,Marzo,El Salvador,1,4,,5,-81.70216500000001,12.5862
30310,2015,Marzo,El Salvador,83,152,,235,-76.532004,3.451668
30311,2015,Marzo,El Salvador,693,1086,,1779,-74.140516,4.697157
30312,2015,Marzo,El Salvador,114,239,,353,-75.42726,6.170465
30313,2015,Marzo,Emiratos Árabes,2,4,,6,-74.140516,4.697157
30314,2015,Marzo,Emiratos Árabes,0,1,,1,-75.42726,6.170465
30315,2015,Marzo,Eslovaquia,3,3,,6,-74.140516,4.697157
30316,2015,Marzo,Eslovenia,2,2,,4,-74.140516,4.697157
30317,2015,Marzo,Estados Unidos de América,0,1,,1,-78.802679,18.00143
30318,2015,Marzo,Estados Unidos de América,0,30,,30,-75.527794,10.406342
30319,2015,Marzo,Estados Unidos de América,2790,3959,,6749,-75.516486,10.446304
30320,2015,Marzo,Estados Unidos de América,237,458,,695,-74.77647900000001,10.886686
30321,2015,Marzo,Estados Unidos de América,0,17,,17,-74.765343,10.970933
30322,2015,Marzo,Estados Unidos de América,0,2,,2,-74.232675,11.117206
30323,2015,Marzo,Estados Unidos de América,2,37,,39,-74.213989,11.247722999999999
30324,2015,Marzo,Estados Unidos de América,9,10,,19,-81.70216500000001,12.5862
30325,2015,Marzo,Estados Unidos de América,888,1294,,2182,-76.532004,3.451668
30326,2015,Marzo,Estados Unidos de América,0,6,,6,-77.061029,3.8844260000000004
30327,2015,Marzo,Estados Unidos de América,114,164,,278,-75.76635300000001,4.45285
30328,2015,Marzo,Estados Unidos de América,8330,15316,,23646,-74.140516,4.697157
30329,2015,Marzo,Estados Unidos de América,103,118,,221,-75.736374,4.815189
30330,2015,Marzo,Estados Unidos de América,1670,3702,,5372,-75.42726,6.170465
30331,2015,Marzo,Estados Unidos de América,10,27,,37,-73.181317,7.1280470000000005
30332,2015,Marzo,Estados Unidos de América,47,38,,85,-72.508188,7.927233
30333,2015,Marzo,Estados Unidos de América,0,3,,3,-76.7333,8.06667
30334,2015,Marzo,Estonia,1,1,,2,-74.140516,4.697157
30335,2015,Marzo,Filipinas,0,2,,2,-75.516486,10.446304
30336,2015,Marzo,Filipinas,1,0,,1,-74.77647900000001,10.886686
30337,2015,Marzo,Filipinas,0,5,,5,-76.532004,3.451668
30338,2015,Marzo,Filipinas,0,1,,1,-77.061029,3.8844260000000004
30339,2015,Marzo,Filipinas,1,21,,22,-74.140516,4.697157
30340,2015,Marzo,Filipinas,1,0,,1,-75.42726,6.170465
30341,2015,Marzo,Finlandia,2,1,,3,-76.532004,3.451668
30342,2015,Marzo,Finlandia,3,13,,16,-74.140516,4.697157
30343,2015,Marzo,Francia,0,2,,2,-75.516486,10.446304
30344,2015,Marzo,Francia,0,1,,1,-74.77647900000001,10.886686
30345,2015,Marzo,Francia,5,24,,29,-76.532004,3.451668
30346,2015,Marzo,Francia,1087,2104,,3191,-74.140516,4.697157
30347,2015,Marzo,Francia,0,1,,1,-75.736374,4.815189
30348,2015,Marzo,Francia,11,21,,32,-75.42726,6.170465
30349,2015,Marzo,Georgia,0,4,,4,-74.140516,4.697157
30350,2015,Marzo,Gibraltar/Territorio Británico de Ultramar,1,1,,2,-77.35600000000001,0.81488
30351,2015,Marzo,Grecia,3,5,,8,-74.140516,4.697157
30352,2015,Marzo,Guatemala,10,16,,26,-75.516486,10.446304
30353,2015,Marzo,Guatemala,0,3,,3,-74.77647900000001,10.886686
30354,2015,Marzo,Guatemala,2,1,,3,-81.70216500000001,12.5862
30355,2015,Marzo,Guatemala,3,4,,7,-81.372937,13.338761300000002
30356,2015,Marzo,Guatemala,19,48,,67,-76.532004,3.451668
30357,2015,Marzo,Guatemala,301,564,,865,-74.140516,4.697157
30358,2015,Marzo,Guatemala,4,6,,10,-75.736374,4.815189
30359,2015,Marzo,Guatemala,31,71,,102,-75.42726,6.170465
30360,2015,Marzo,Guatemala,0,1,,1,-73.181317,7.1280470000000005
30361,2015,Marzo,Guatemala,3,7,,10,-72.508188,7.927233
30362,2015,Marzo,Guyana,1,0,,1,-74.140516,4.697157
30363,2015,Marzo,Guinea Ecuatorial,0,3,,3,-74.140516,4.697157
30364,2015,Marzo,Guadalupe/Territorio Francés,3,6,,9,-74.140516,4.697157
30365,2015,Marzo,Guayana Francesa/Departamento de Ultramar Francés,0,1,,1,-74.140516,4.697157
30366,2015,Marzo,Haití,0,2,,2,-75.516486,10.446304
30367,2015,Marzo,Haití,2,7,,9,-74.140516,4.697157
30368,2015,Marzo,Haití,0,1,,1,-75.42726,6.170465
30369,2015,Marzo,Honduras,1,3,,4,-75.527794,10.406342
30370,2015,Marzo,Honduras,2,8,,10,-75.516486,10.446304
30371,2015,Marzo,Honduras,4,2,,6,-74.77647900000001,10.886686
30372,2015,Marzo,Honduras,2,0,,2,-81.70216500000001,12.5862
30373,2015,Marzo,Honduras,8,9,,17,-81.372937,13.338761300000002
30374,2015,Marzo,Honduras,1,9,,10,-76.532004,3.451668
30375,2015,Marzo,Honduras,57,73,,130,-74.140516,4.697157
30376,2015,Marzo,Honduras,4,3,,7,-75.736374,4.815189
30377,2015,Marzo,Honduras,35,41,,76,-75.42726,6.170465
30378,2015,Marzo,Honduras,2,3,,5,-72.508188,7.927233
30379,2015,Marzo,Hong Kong,3,3,,6,-74.140516,4.697157
30380,2015,Marzo,Hungría,1,2,,3,-74.140516,4.697157
30381,2015,Marzo,India,0,1,,1,-75.516486,10.446304
30382,2015,Marzo,India,0,3,,3,-74.77647900000001,10.886686
30383,2015,Marzo,India,6,40,,46,-74.140516,4.697157
30384,2015,Marzo,India,0,2,,2,-75.42726,6.170465
30385,2015,Marzo,Indonesia,0,1,,1,-76.532004,3.451668
30386,2015,Marzo,Indonesia,2,0,,2,-74.140516,4.697157
30387,2015,Marzo,Iraq,0,1,,1,-74.140516,4.697157
30388,2015,Marzo,Irán,0,2,,2,-74.140516,4.697157
30389,2015,Marzo,República de Irlanda,0,2,,2,-75.516486,10.446304
30390,2015,Marzo,República de Irlanda,1,1,,2,-81.70216500000001,12.5862
30391,2015,Marzo,República de Irlanda,0,1,,1,-76.532004,3.451668
30392,2015,Marzo,República de Irlanda,8,11,,19,-74.140516,4.697157
30393,2015,Marzo,República de Irlanda,0,2,,2,-75.42726,6.170465
30394,2015,Marzo,Isla de Man,1,4,,5,-74.140516,4.697157
30395,2015,Marzo,Israel,2,2,,4,-76.532004,3.451668
30396,2015,Marzo,Israel,23,67,,90,-74.140516,4.697157
30397,2015,Marzo,Israel,1,1,,2,-75.42726,6.170465
30398,2015,Marzo,Israel,0,1,,1,-72.508188,7.927233
30399,2015,Marzo,Italia,49,104,,153,-75.516486,10.446304
30400,2015,Marzo,Italia,213,191,,404,-81.70216500000001,12.5862
30401,2015,Marzo,Italia,4,23,,27,-76.532004,3.451668
30402,2015,Marzo,Italia,86,237,,323,-74.140516,4.697157
30403,2015,Marzo,Italia,5,19,,24,-75.42726,6.170465
30404,2015,Marzo,Jamaica,1,1,,2,-75.527794,10.406342
30405,2015,Marzo,Jamaica,0,2,,2,-75.516486,10.446304
30406,2015,Marzo,Jamaica,0,3,,3,-74.77647900000001,10.886686
30407,2015,Marzo,Jamaica,0,4,,4,-81.703935,12.574411099999999
30408,2015,Marzo,Jamaica,1,1,,2,-76.532004,3.451668
30409,2015,Marzo,Jamaica,2,4,,6,-74.140516,4.697157
30410,2015,Marzo,Jamaica,0,10,,10,-75.42726,6.170465
30411,2015,Marzo,Japón,0,2,,2,-76.532004,3.451668
30412,2015,Marzo,Japón,12,36,,48,-74.140516,4.697157
30413,2015,Marzo,Japón,1,2,,3,-75.42726,6.170465
30414,2015,Marzo,Jordania,0,2,,2,-74.140516,4.697157
30415,2015,Marzo,Kenia,0,4,,4,-74.140516,4.697157
30416,2015,Marzo,Kirguistán,0,3,,3,-74.140516,4.697157
30417,2015,Marzo,Lesoto,0,1,,1,-74.140516,4.697157
30418,2015,Marzo,Letonia,0,1,,1,-74.140516,4.697157
30419,2015,Marzo,Lituania,1,0,,1,-74.140516,4.697157
30420,2015,Marzo,Líbano,1,0,,1,-76.532004,3.451668
30421,2015,Marzo,Líbano,1,7,,8,-74.140516,4.697157
30422,2015,Marzo,Liechtenstein,0,1,,1,-74.140516,4.697157
30423,2015,Marzo,Luxemburgo,2,0,,2,-74.140516,4.697157
30424,2015,Marzo,Macedonia,0,1,,1,-74.140516,4.697157
30425,2015,Marzo,Malasia,0,1,,1,-75.516486,10.446304
30426,2015,Marzo,Malasia,0,3,,3,-74.140516,4.697157
30427,2015,Marzo,Malí,0,1,,1,-74.140516,4.697157
30428,2015,Marzo,Malta,0,1,,1,-74.140516,4.697157
30429,2015,Marzo,Marruecos,1,0,,1,-74.140516,4.697157
30430,2015,Marzo,Marruecos,0,1,,1,-75.42726,6.170465
30431,2015,Marzo,Martinica/Departamento de Ultramar Francés,1,2,,3,-74.213989,11.247722999999999
30432,2015,Marzo,Martinica/Departamento de Ultramar Francés,1,0,,1,-74.140516,4.697157
30433,2015,Marzo,México,0,4,,4,-75.527794,10.406342
30434,2015,Marzo,México,16,38,,54,-75.516486,10.446304
30435,2015,Marzo,México,8,16,,24,-74.77647900000001,10.886686
30436,2015,Marzo,México,1,4,,5,-81.703935,12.574411099999999
30437,2015,Marzo,México,2,3,,5,-81.70216500000001,12.5862
30438,2015,Marzo,México,39,104,,143,-76.532004,3.451668
30439,2015,Marzo,México,4404,7802,,12206,-74.140516,4.697157
30440,2015,Marzo,México,11,9,,20,-75.736374,4.815189
30441,2015,Marzo,México,357,877,,1234,-75.42726,6.170465
30442,2015,Marzo,México,3,11,,14,-73.181317,7.1280470000000005
30443,2015,Marzo,México,16,17,,33,-72.508188,7.927233
30444,2015,Marzo,Mónaco,0,1,,1,-74.140516,4.697157
30445,2015,Marzo,Mongolia,0,1,,1,-74.140516,4.697157
30446,2015,Marzo,Nicaragua,2,2,,4,-75.516486,10.446304
30447,2015,Marzo,Nicaragua,1,1,,2,-74.77647900000001,10.886686
30448,2015,Marzo,Nicaragua,6,15,,21,-81.703935,12.574411099999999
30449,2015,Marzo,Nicaragua,0,1,,1,-81.70216500000001,12.5862
30450,2015,Marzo,Nicaragua,1,7,,8,-81.372937,13.338761300000002
30451,2015,Marzo,Nicaragua,5,4,,9,-76.532004,3.451668
30452,2015,Marzo,Nicaragua,21,22,,43,-74.140516,4.697157
30453,2015,Marzo,Nicaragua,0,4,,4,-75.736374,4.815189
30454,2015,Marzo,Nicaragua,4,16,,20,-75.42726,6.170465
30455,2015,Marzo,Nigeria,0,1,,1,-74.140516,4.697157
30456,2015,Marzo,Noruega,1,0,,1,-75.516486,10.446304
30457,2015,Marzo,Noruega,0,1,,1,-74.77647900000001,10.886686
30458,2015,Marzo,Noruega,2,5,,7,-76.532004,3.451668
30459,2015,Marzo,Noruega,27,24,,51,-74.140516,4.697157
30460,2015,Marzo,Noruega,1,2,,3,-72.508188,7.927233
30461,2015,Marzo,Nueva Zelanda,0,1,,1,-76.532004,3.451668
30462,2015,Marzo,Nueva Zelanda,0,3,,3,-74.140516,4.697157
30463,2015,Marzo,Nueva Zelanda,1,2,,3,-75.42726,6.170465
30464,2015,Marzo,Pakistán,0,2,,2,-74.140516,4.697157
30465,2015,Marzo,Panamá,1093,1170,,2263,-75.527794,10.406342
30466,2015,Marzo,Panamá,2159,2644,,4803,-75.516486,10.446304
30467,2015,Marzo,Panamá,143,367,,510,-74.77647900000001,10.886686
30468,2015,Marzo,Panamá,0,6,,6,-74.765343,10.970933
30469,2015,Marzo,Panamá,0,1,,1,-74.213989,11.247722999999999
30470,2015,Marzo,Panamá,8,24,,32,-81.703935,12.574411099999999
30471,2015,Marzo,Panamá,1033,866,,1899,-81.70216500000001,12.5862
30472,2015,Marzo,Panamá,5,7,,12,-81.372937,13.338761300000002
30473,2015,Marzo,Panamá,279,533,,812,-76.532004,3.451668
30474,2015,Marzo,Panamá,1,10,,11,-77.061029,3.8844260000000004
30475,2015,Marzo,Panamá,2678,4937,,7615,-74.140516,4.697157
30476,2015,Marzo,Panamá,66,112,,178,-75.736374,4.815189
30477,2015,Marzo,Panamá,660,1453,,2113,-75.42726,6.170465
30478,2015,Marzo,Panamá,1,7,,8,-77.401154,6.222551999999999
30479,2015,Marzo,Panamá,2,1,,3,-77.762647,7.102626
30480,2015,Marzo,Panamá,30,31,,61,-73.181317,7.1280470000000005
30481,2015,Marzo,Panamá,115,120,,235,-72.508188,7.927233
30482,2015,Marzo,Panamá,0,4,,4,-76.7333,8.06667
30483,2015,Marzo,Panamá,90,100,,190,-77.35002,8.63337
30484,2015,Marzo,Paraguay,10,9,,19,-75.516486,10.446304
30485,2015,Marzo,Paraguay,2,1,,3,-74.77647900000001,10.886686
30486,2015,Marzo,Paraguay,39,25,,64,-81.70216500000001,12.5862
30487,2015,Marzo,Paraguay,3,5,,8,-76.532004,3.451668
30488,2015,Marzo,Paraguay,41,53,,94,-74.140516,4.697157
30489,2015,Marzo,Paraguay,10,9,,19,-75.42726,6.170465
30490,2015,Marzo,Perú,108,186,,294,-69.941498,4.191162
30491,2015,Marzo,Perú,14,19,,33,-69.94143100000001,4.214082
30492,2015,Marzo,Perú,17,26,,43,-77.35600000000001,0.81488
30493,2015,Marzo,Perú,0,30,,30,-75.527794,10.406342
30494,2015,Marzo,Perú,16,10,,26,-75.516486,10.446304
30495,2015,Marzo,Perú,1,5,,6,-74.77647900000001,10.886686
30496,2015,Marzo,Perú,108,77,,185,-81.70216500000001,12.5862
30497,2015,Marzo,Perú,225,392,,617,-76.532004,3.451668
30498,2015,Marzo,Perú,0,4,,4,-77.061029,3.8844260000000004
30499,2015,Marzo,Perú,5565,7724,,13289,-74.140516,4.697157
30500,2015,Marzo,Perú,0,1,,1,-75.736374,4.815189
30501,2015,Marzo,Perú,297,646,,943,-75.42726,6.170465
30502,2015,Marzo,Perú,1,4,,5,-72.508188,7.927233
30503,2015,Marzo,Polonia,0,1,,1,-75.516486,10.446304
30504,2015,Marzo,Polonia,2,0,,2,-76.532004,3.451668
30505,2015,Marzo,Polonia,16,13,,29,-74.140516,4.697157
30506,2015,Marzo,Polonia,0,1,,1,-75.42726,6.170465
30507,2015,Marzo,Portugal,1,2,,3,-76.532004,3.451668
30508,2015,Marzo,Portugal,250,441,,691,-74.140516,4.697157
30509,2015,Marzo,Portugal,0,1,,1,-75.42726,6.170465
30510,2015,Marzo,Puerto Rico/Territorio de Estados Unidos,1,1,,2,-75.516486,10.446304
30511,2015,Marzo,Puerto Rico/Territorio de Estados Unidos,13,54,,67,-74.77647900000001,10.886686
30512,2015,Marzo,Puerto Rico/Territorio de Estados Unidos,0,1,,1,-74.765343,10.970933
30513,2015,Marzo,Puerto Rico/Territorio de Estados Unidos,27,36,,63,-76.532004,3.451668
30514,2015,Marzo,Puerto Rico/Territorio de Estados Unidos,231,392,,623,-74.140516,4.697157
30515,2015,Marzo,Puerto Rico/Territorio de Estados Unidos,1,5,,6,-75.736374,4.815189
30516,2015,Marzo,Puerto Rico/Territorio de Estados Unidos,24,77,,101,-75.42726,6.170465
30517,2015,Marzo,Puerto Rico/Territorio de Estados Unidos,1,3,,4,-73.181317,7.1280470000000005
30518,2015,Marzo,Puerto Rico/Territorio de Estados Unidos,2,1,,3,-72.508188,7.927233
30519,2015,Marzo,Reino Unido de Gran Bretaña e Irlanda del Norte,0,3,,3,-75.516486,10.446304
30520,2015,Marzo,Reino Unido de Gran Bretaña e Irlanda del Norte,0,1,,1,-74.77647900000001,10.886686
30521,2015,Marzo,Reino Unido de Gran Bretaña e Irlanda del Norte,2,8,,10,-76.532004,3.451668
30522,2015,Marzo,Reino Unido de Gran Bretaña e Irlanda del Norte,465,828,,1293,-74.140516,4.697157
30523,2015,Marzo,Reino Unido de Gran Bretaña e Irlanda del Norte,1,1,,2,-75.736374,4.815189
30524,2015,Marzo,Reino Unido de Gran Bretaña e Irlanda del Norte,5,9,,14,-75.42726,6.170465
30525,2015,Marzo,Federación de Rusia,0,1,,1,-75.516486,10.446304
30526,2015,Marzo,Federación de Rusia,0,1,,1,-76.532004,3.451668
30527,2015,Marzo,Federación de Rusia,30,55,,85,-74.140516,4.697157
30528,2015,Marzo,República Dominicana,0,4,,4,-75.527794,10.406342
30529,2015,Marzo,República Dominicana,1,7,,8,-75.516486,10.446304
30530,2015,Marzo,República Dominicana,6,20,,26,-74.77647900000001,10.886686
30531,2015,Marzo,República Dominicana,0,1,,1,-74.765343,10.970933
30532,2015,Marzo,República Dominicana,2,2,,4,-81.70216500000001,12.5862
30533,2015,Marzo,República Dominicana,18,33,,51,-76.532004,3.451668
30534,2015,Marzo,República Dominicana,367,607,,974,-74.140516,4.697157
30535,2015,Marzo,República Dominicana,3,7,,10,-75.736374,4.815189
30536,2015,Marzo,República Dominicana,22,55,,77,-75.42726,6.170465
30537,2015,Marzo,República Dominicana,1,0,,1,-73.181317,7.1280470000000005
30538,2015,Marzo,República Dominicana,1,3,,4,-72.508188,7.927233
30539,2015,Marzo,Reunión,1,1,,2,-74.140516,4.697157
30540,2015,Marzo,Rumania,4,7,,11,-74.140516,4.697157
30541,2015,Marzo,San Pedro y Miquelón/territorio de Ultramar de La Unión Europea,0,1,,1,-74.140516,4.697157
30542,2015,Marzo,San  Vicente y las Granadinas,7,8,,15,-75.527794,10.406342
30543,2015,Marzo,Santa Lucia,0,1,,1,-74.140516,4.697157
30544,2015,Marzo,Serbia,0,1,,1,-74.140516,4.697157
30545,2015,Marzo,Singapur,1,4,,5,-74.140516,4.697157
30546,2015,Marzo,Singapur,0,1,,1,-75.42726,6.170465
30547,2015,Marzo,Sri Lanka,0,1,,1,-74.140516,4.697157
30548,2015,Marzo,Sudáfrica,4,5,,9,-74.140516,4.697157
30549,2015,Marzo,Suecia,1,0,,1,-75.516486,10.446304
30550,2015,Marzo,Suecia,0,2,,2,-74.77647900000001,10.886686
30551,2015,Marzo,Suecia,2,0,,2,-76.532004,3.451668
30552,2015,Marzo,Suecia,21,40,,61,-74.140516,4.697157
30553,2015,Marzo,Suecia,3,5,,8,-75.42726,6.170465
30554,2015,Marzo,Suiza,0,1,,1,-75.516486,10.446304
30555,2015,Marzo,Suiza,1,8,,9,-74.77647900000001,10.886686
30556,2015,Marzo,Suiza,0,1,,1,-81.70216500000001,12.5862
30557,2015,Marzo,Suiza,2,10,,12,-76.532004,3.451668
30558,2015,Marzo,Suiza,53,115,,168,-74.140516,4.697157
30559,2015,Marzo,Suiza,3,15,,18,-75.42726,6.170465
30560,2015,Marzo,Surinam,2,3,,5,-74.140516,4.697157
30561,2015,Marzo,Surinam,1,2,,3,-75.42726,6.170465
30562,2015,Marzo,Taiwán,2,4,,6,-74.140516,4.697157
30563,2015,Marzo,Taiwán,0,1,,1,-75.42726,6.170465
30564,2015,Marzo,Tailandia,2,3,,5,-74.140516,4.697157
30565,2015,Marzo,Tanzania,0,1,,1,-76.532004,3.451668
30566,2015,Marzo,Tanzania,0,2,,2,-74.140516,4.697157
30567,2015,Marzo,Trinidad y Tobago,1,0,,1,-75.527794,10.406342
30568,2015,Marzo,Trinidad y Tobago,0,1,,1,-75.516486,10.446304
30569,2015,Marzo,Trinidad y Tobago,0,1,,1,-74.765343,10.970933
30570,2015,Marzo,Trinidad y Tobago,4,7,,11,-76.532004,3.451668
30571,2015,Marzo,Trinidad y Tobago,7,17,,24,-74.140516,4.697157
30572,2015,Marzo,Trinidad y Tobago,0,1,,1,-75.42726,6.170465
30573,2015,Marzo,Trinidad y Tobago,1,2,,3,-73.181317,7.1280470000000005
30574,2015,Marzo,Túnez,0,2,,2,-74.140516,4.697157
30575,2015,Marzo,Turkmenistán,0,1,,1,-75.42726,6.170465
30576,2015,Marzo,Turquía,2,1,,3,-76.532004,3.451668
30577,2015,Marzo,Turquía,12,7,,19,-74.140516,4.697157
30578,2015,Marzo,Turquía,2,3,,5,-75.42726,6.170465
30579,2015,Marzo,Ucrania,5,8,,13,-74.140516,4.697157
30580,2015,Marzo,Uganda,1,0,,1,-74.140516,4.697157
30581,2015,Marzo,Uruguay,10,11,,21,-75.516486,10.446304
30582,2015,Marzo,Uruguay,0,1,,1,-74.77647900000001,10.886686
30583,2015,Marzo,Uruguay,41,31,,72,-81.70216500000001,12.5862
30584,2015,Marzo,Uruguay,4,16,,20,-76.532004,3.451668
30585,2015,Marzo,Uruguay,50,60,,110,-74.140516,4.697157
30586,2015,Marzo,Uruguay,16,26,,42,-75.42726,6.170465
30587,2015,Marzo,Uruguay,0,1,,1,-73.181317,7.1280470000000005
30588,2015,Marzo,Uruguay,2,1,,3,-72.508188,7.927233
30589,2015,Marzo,Venezuela,1,28,,29,-75.527794,10.406342
30590,2015,Marzo,Venezuela,57,104,,161,-75.516486,10.446304
30591,2015,Marzo,Venezuela,7,68,,75,-74.77647900000001,10.886686
30592,2015,Marzo,Venezuela,0,7,,7,-74.765343,10.970933
30593,2015,Marzo,Venezuela,2142,2691,,4833,-72.129595,11.360028999999999
30594,2015,Marzo,Venezuela,7,14,,21,-76.532004,3.451668
30595,2015,Marzo,Venezuela,11,12,,23,-67.927521,3.866713
30596,2015,Marzo,Venezuela,0,1,,1,-77.061029,3.8844260000000004
30597,2015,Marzo,Venezuela,3645,4259,,7904,-74.140516,4.697157
30598,2015,Marzo,Venezuela,5,6,,11,-75.736374,4.815189
30599,2015,Marzo,Venezuela,31,83,,114,-75.42726,6.170465
30600,2015,Marzo,Venezuela,124,228,,352,-67.48402800000001,6.185536
30601,2015,Marzo,Venezuela,142,227,,369,-70.74025300000001,7.088728999999999
30602,2015,Marzo,Venezuela,4,7,,11,-73.181317,7.1280470000000005
30603,2015,Marzo,Venezuela,3270,4232,,7502,-72.453013,7.819
30604,2015,Marzo,Venezuela,265,326,,591,-72.508188,7.927233
30605,2015,Marzo,Vietnam,0,1,,1,-74.140516,4.697157
30606,2015,Marzo,Islas Vírgenes Británicas/Territorio Británico de Ultramar,0,1,,1,-75.527794,10.406342
30607,2015,Marzo,Islas Vírgenes Británicas/Territorio Británico de Ultramar,0,1,,1,-75.516486,10.446304
30608,2015,Marzo,Islas Vírgenes Británicas/Territorio Británico de Ultramar,0,3,,3,-74.140516,4.697157
30609,2015,Marzo,Islas Vírgenes Estadounidenses/Territorio de Estados Unidos,0,2,,2,-74.140516,4.697157
30610,2015,Marzo,Desconocido,0,2,,2,-77.84700600000001,0.8124359999999999
30611,2015,Marzo,Desconocido,2,5,,7,-81.372937,13.338761300000002
30612,2015,Marzo,Desconocido,0,1,,1,-76.532004,3.451668
30613,2015,Marzo,Desconocido,2,40,,42,-74.140516,4.697157
30614,2015,Marzo,Desconocido,0,2,,2,-75.42726,6.170465
30615,2015,Marzo,Desconocido,14,39,,53,-67.48402800000001,6.185536
30616,2015,Marzo,Desconocido,0,5,,5,-75.68164200000001,9.402597
30617,2015,Abril,Albania,1,0,,1,-74.140516,4.697157
30618,2015,Abril,Alemania,1,1,,2,-74.77647900000001,10.886686
30619,2015,Abril,Alemania,0,1,,1,-81.70216500000001,12.5862
30620,2015,Abril,Alemania,34,47,,81,-76.532004,3.451668
30621,2015,Abril,Alemania,1044,1978,,3022,-74.140516,4.697157
30622,2015,Abril,Alemania,2,4,,6,-75.736374,4.815189
30623,2015,Abril,Alemania,11,10,,21,-75.42726,6.170465
30624,2015,Abril,Andorra,1,0,,1,-74.140516,4.697157
30625,2015,Abril,Antigua y Barbuda,5,6,,11,-75.527794,10.406342
30626,2015,Abril,Antigua y Barbuda,1,2,,3,-75.516486,10.446304
30627,2015,Abril,Antigua y Barbuda,3,2,,5,-74.213989,11.247722999999999
30628,2015,Abril,Antigua y Barbuda,1,3,,4,-74.140516,4.697157
30629,2015,Abril,Antigua y Barbuda,0,1,,1,-75.42726,6.170465
30630,2015,Abril,Países Bajos,38,55,,93,-74.77647900000001,10.886686
30631,2015,Abril,Países Bajos,0,3,,3,-74.232675,11.117206
30632,2015,Abril,Países Bajos,2,2,,4,-74.213989,11.247722999999999
30633,2015,Abril,Países Bajos,0,9,,9,-81.70216500000001,12.5862
30634,2015,Abril,Países Bajos,109,181,,290,-76.532004,3.451668
30635,2015,Abril,Países Bajos,749,1192,,1941,-74.140516,4.697157
30636,2015,Abril,Países Bajos,0,1,,1,-75.736374,4.815189
30637,2015,Abril,Países Bajos,247,282,,529,-75.42726,6.170465
30638,2015,Abril,Países Bajos,3,1,,4,-73.181317,7.1280470000000005
30639,2015,Abril,Arabia Saudita,0,3,,3,-74.140516,4.697157
30640,2015,Abril,Arabia Saudita,0,2,,2,-75.42726,6.170465
30641,2015,Abril,Argelia,0,2,,2,-74.140516,4.697157
30642,2015,Abril,Argentina,5,8,,13,-77.35600000000001,0.81488
30643,2015,Abril,Argentina,147,93,,240,-75.516486,10.446304
30644,2015,Abril,Argentina,3,3,,6,-74.77647900000001,10.886686
30645,2015,Abril,Argentina,96,63,,159,-81.70216500000001,12.5862
30646,2015,Abril,Argentina,64,84,,148,-76.532004,3.451668
30647,2015,Abril,Argentina,2026,2739,,4765,-74.140516,4.697157
30648,2015,Abril,Argentina,0,1,,1,-75.736374,4.815189
30649,2015,Abril,Argentina,60,113,,173,-75.42726,6.170465
30650,2015,Abril,Argentina,1,0,,1,-73.181317,7.1280470000000005
30651,2015,Abril,Aruba,35,25,,60,-75.527794,10.406342
30652,2015,Abril,Aruba,12,29,,41,-74.77647900000001,10.886686
30653,2015,Abril,Aruba,0,2,,2,-74.765343,10.970933
30654,2015,Abril,Aruba,6,8,,14,-74.213989,11.247722999999999
30655,2015,Abril,Aruba,8,2,,10,-76.532004,3.451668
30656,2015,Abril,Aruba,575,737,,1312,-74.140516,4.697157
30657,2015,Abril,Aruba,1,1,,2,-75.736374,4.815189
30658,2015,Abril,Aruba,121,93,,214,-75.42726,6.170465
30659,2015,Abril,Aruba,13,14,,27,-73.181317,7.1280470000000005
30660,2015,Abril,Aruba,1,0,,1,-72.508188,7.927233
30661,2015,Abril,Australia,0,1,,1,-75.516486,10.446304
30662,2015,Abril,Australia,0,3,,3,-76.532004,3.451668
30663,2015,Abril,Australia,11,21,,32,-74.140516,4.697157
30664,2015,Abril,Australia,2,0,,2,-75.736374,4.815189
30665,2015,Abril,Australia,2,10,,12,-75.42726,6.170465
30666,2015,Abril,Australia,1,0,,1,-72.508188,7.927233
30667,2015,Abril,Austria,0,1,,1,-75.516486,10.446304
30668,2015,Abril,Austria,0,1,,1,-76.532004,3.451668
30669,2015,Abril,Austria,10,28,,38,-74.140516,4.697157
30670,2015,Abril,Austria,0,1,,1,-75.42726,6.170465
30671,2015,Abril,Bahamas,2,5,,7,-75.527794,10.406342
30672,2015,Abril,Bahamas,1,0,,1,-75.516486,10.446304
30673,2015,Abril,Bahamas,1,3,,4,-75.42726,6.170465
30674,2015,Abril,Bahréin,0,1,,1,-72.453013,7.819
30675,2015,Abril,Barbados,0,1,,1,-76.532004,3.451668
30676,2015,Abril,Barbados,0,7,,7,-74.140516,4.697157
30677,2015,Abril,Barbados,1,0,,1,-73.181317,7.1280470000000005
30678,2015,Abril,República de Belarús,1,1,,2,-74.140516,4.697157
30679,2015,Abril,República de Belarús,0,1,,1,-72.453013,7.819
30680,2015,Abril,Bélgica,1,3,,4,-76.532004,3.451668
30681,2015,Abril,Bélgica,19,24,,43,-74.140516,4.697157
30682,2015,Abril,Bélgica,1,6,,7,-75.42726,6.170465
30683,2015,Abril,Belice,2,3,,5,-74.140516,4.697157
30684,2015,Abril,Belice,0,1,,1,-75.42726,6.170465
30685,2015,Abril,Bermudas/Territorio Británico de Ultramar,0,2,,2,-75.516486,10.446304
30686,2015,Abril,Bolivia,12,20,,32,-76.532004,3.451668
30687,2015,Abril,Bolivia,341,508,,849,-74.140516,4.697157
30688,2015,Abril,Bolivia,0,1,,1,-75.736374,4.815189
30689,2015,Abril,Bolivia,21,30,,51,-75.42726,6.170465
30690,2015,Abril,Brasil,105,126,,231,-69.941498,4.191162
30691,2015,Abril,Brasil,10,20,,30,-69.94143100000001,4.214082
30692,2015,Abril,Brasil,1,1,,2,-77.35600000000001,0.81488
30693,2015,Abril,Brasil,0,3,,3,-75.527794,10.406342
30694,2015,Abril,Brasil,76,61,,137,-75.516486,10.446304
30695,2015,Abril,Brasil,5,3,,8,-74.77647900000001,10.886686
30696,2015,Abril,Brasil,94,71,,165,-81.70216500000001,12.5862
30697,2015,Abril,Brasil,39,72,,111,-76.532004,3.451668
30698,2015,Abril,Brasil,3561,5119,,8680,-74.140516,4.697157
30699,2015,Abril,Brasil,1,5,,6,-75.736374,4.815189
30700,2015,Abril,Brasil,139,160,,299,-75.42726,6.170465
30701,2015,Abril,Brasil,0,1,,1,-73.181317,7.1280470000000005
30702,2015,Abril,Brasil,7,2,,9,-72.508188,7.927233
30703,2015,Abril,Bulgaria,0,1,,1,-76.532004,3.451668
30704,2015,Abril,Bulgaria,3,7,,10,-74.140516,4.697157
30705,2015,Abril,Islas Caimán/Territorio Británico de Ultramar,0,1,,1,-81.372937,13.338761300000002
30706,2015,Abril,Islas Caimán/Territorio Británico de Ultramar,0,1,,1,-75.42726,6.170465
30707,2015,Abril,Camerún,1,0,,1,-74.140516,4.697157
30708,2015,Abril,Canadá,6,8,,14,-75.516486,10.446304
30709,2015,Abril,Canadá,1,4,,5,-74.77647900000001,10.886686
30710,2015,Abril,Canadá,3,2,,5,-81.70216500000001,12.5862
30711,2015,Abril,Canadá,19,54,,73,-76.532004,3.451668
30712,2015,Abril,Canadá,472,750,,1222,-74.140516,4.697157
30713,2015,Abril,Canadá,5,8,,13,-75.736374,4.815189
30714,2015,Abril,Canadá,33,96,,129,-75.42726,6.170465
30715,2015,Abril,Canadá,1,4,,5,-73.181317,7.1280470000000005
30716,2015,Abril,Canadá,6,6,,12,-72.508188,7.927233
30717,2015,Abril,España,2,1,,3,-75.516486,10.446304
30718,2015,Abril,España,1,1,,2,-74.77647900000001,10.886686
30719,2015,Abril,España,151,278,,429,-76.532004,3.451668
30720,2015,Abril,España,2328,4804,,7132,-74.140516,4.697157
30721,2015,Abril,España,1,2,,3,-75.736374,4.815189
30722,2015,Abril,España,93,230,,323,-75.42726,6.170465
30723,2015,Abril,España,2,0,,2,-73.181317,7.1280470000000005
30724,2015,Abril,España,1,14,,15,-72.508188,7.927233
30725,2015,Abril,República de Corea,0,1,,1,-76.532004,3.451668
30726,2015,Abril,República de Corea,54,176,,230,-74.140516,4.697157
30727,2015,Abril,República de Corea,0,2,,2,-75.42726,6.170465
30728,2015,Abril,Costa de Marfil,0,1,,1,-75.516486,10.446304
30729,2015,Abril,Costa de Marfil,1,6,,7,-74.140516,4.697157
30730,2015,Abril,Costa Rica,14,16,,30,-75.527794,10.406342
30731,2015,Abril,Costa Rica,6,12,,18,-75.516486,10.446304
30732,2015,Abril,Costa Rica,1,12,,13,-74.77647900000001,10.886686
30733,2015,Abril,Costa Rica,0,1,,1,-74.213989,11.247722999999999
30734,2015,Abril,Costa Rica,2,3,,5,-81.703935,12.574411099999999
30735,2015,Abril,Costa Rica,1,1,,2,-81.70216500000001,12.5862
30736,2015,Abril,Costa Rica,31,53,,84,-76.532004,3.451668
30737,2015,Abril,Costa Rica,714,1259,,1973,-74.140516,4.697157
30738,2015,Abril,Costa Rica,2,5,,7,-75.736374,4.815189
30739,2015,Abril,Costa Rica,59,110,,169,-75.42726,6.170465
30740,2015,Abril,Costa Rica,1,0,,1,-73.181317,7.1280470000000005
30741,2015,Abril,Costa Rica,4,1,,5,-72.508188,7.927233
30742,2015,Abril,Croacia,0,1,,1,-74.140516,4.697157
30743,2015,Abril,Cuba,3,1,,4,-75.516486,10.446304
30744,2015,Abril,Cuba,1,5,,6,-74.77647900000001,10.886686
30745,2015,Abril,Cuba,9,13,,22,-76.532004,3.451668
30746,2015,Abril,Cuba,415,538,,953,-74.140516,4.697157
30747,2015,Abril,Cuba,1,0,,1,-75.736374,4.815189
30748,2015,Abril,Cuba,18,13,,31,-75.42726,6.170465
30749,2015,Abril,Cuba,6,5,,11,-72.508188,7.927233
30750,2015,Abril,República Checa,1,0,,1,-76.532004,3.451668
30751,2015,Abril,República Checa,5,7,,12,-74.140516,4.697157
30752,2015,Abril,Chile,1,6,,7,-77.35600000000001,0.81488
30753,2015,Abril,Chile,9,8,,17,-75.516486,10.446304
30754,2015,Abril,Chile,5,4,,9,-81.70216500000001,12.5862
30755,2015,Abril,Chile,20,29,,49,-76.532004,3.451668
30756,2015,Abril,Chile,3881,5180,,9061,-74.140516,4.697157
30757,2015,Abril,Chile,12,36,,48,-75.42726,6.170465
30758,2015,Abril,Chile,0,3,,3,-73.181317,7.1280470000000005
30759,2015,Abril,China,1,3,,4,-76.532004,3.451668
30760,2015,Abril,China,28,102,,130,-74.140516,4.697157
30761,2015,Abril,China,1,2,,3,-75.42726,6.170465
30762,2015,Abril,Dinamarca,0,2,,2,-76.532004,3.451668
30763,2015,Abril,Dinamarca,10,5,,15,-74.140516,4.697157
30764,2015,Abril,Dinamarca,1,2,,3,-75.42726,6.170465
30765,2015,Abril,Dinamarca,0,1,,1,-72.508188,7.927233
30766,2015,Abril,Ecuador,52,164,,216,-76.876446,0.33002
30767,2015,Abril,Ecuador,1,13,,14,-77.84700600000001,0.8124359999999999
30768,2015,Abril,Ecuador,2835,4273,,7108,-77.35600000000001,0.81488
30769,2015,Abril,Ecuador,35,38,,73,-78.802679,18.00143
30770,2015,Abril,Ecuador,2,4,,6,-75.516486,10.446304
30771,2015,Abril,Ecuador,2,3,,5,-74.77647900000001,10.886686
30772,2015,Abril,Ecuador,3,3,,6,-81.70216500000001,12.5862
30773,2015,Abril,Ecuador,432,461,,893,-76.532004,3.451668
30774,2015,Abril,Ecuador,0,1,,1,-77.061029,3.8844260000000004
30775,2015,Abril,Ecuador,3504,5049,,8553,-74.140516,4.697157
30776,2015,Abril,Ecuador,1,3,,4,-75.736374,4.815189
30777,2015,Abril,Ecuador,3,17,,20,-75.42726,6.170465
30778,2015,Abril,Ecuador,5,5,,10,-73.181317,7.1280470000000005
30779,2015,Abril,Ecuador,4,15,,19,-72.508188,7.927233
30780,2015,Abril,Egipto,0,5,,5,-74.140516,4.697157
30781,2015,Abril,El Salvador,1,2,,3,-75.516486,10.446304
30782,2015,Abril,El Salvador,3,7,,10,-74.77647900000001,10.886686
30783,2015,Abril,El Salvador,6,4,,10,-81.70216500000001,12.5862
30784,2015,Abril,El Salvador,77,120,,197,-76.532004,3.451668
30785,2015,Abril,El Salvador,751,1160,,1911,-74.140516,4.697157
30786,2015,Abril,El Salvador,0,1,,1,-75.736374,4.815189
30787,2015,Abril,El Salvador,118,181,,299,-75.42726,6.170465
30788,2015,Abril,Emiratos Árabes,3,4,,7,-74.140516,4.697157
30789,2015,Abril,Eritrea,1,0,,1,-76.532004,3.451668
30790,2015,Abril,Eritrea,0,1,,1,-74.140516,4.697157
30791,2015,Abril,Eslovaquia,1,1,,2,-74.140516,4.697157
30792,2015,Abril,Eslovenia,0,3,,3,-74.140516,4.697157
30793,2015,Abril,Eslovenia,0,1,,1,-75.42726,6.170465
30794,2015,Abril,Estados Unidos de América,9,55,,64,-75.527794,10.406342
30795,2015,Abril,Estados Unidos de América,2012,3039,,5051,-75.516486,10.446304
30796,2015,Abril,Estados Unidos de América,238,437,,675,-74.77647900000001,10.886686
30797,2015,Abril,Estados Unidos de América,0,3,,3,-74.765343,10.970933
30798,2015,Abril,Estados Unidos de América,1,3,,4,-74.232675,11.117206
30799,2015,Abril,Estados Unidos de América,1,24,,25,-74.213989,11.247722999999999
30800,2015,Abril,Estados Unidos de América,0,3,,3,-81.703935,12.574411099999999
30801,2015,Abril,Estados Unidos de América,11,16,,27,-81.70216500000001,12.5862
30802,2015,Abril,Estados Unidos de América,785,1121,,1906,-76.532004,3.451668
30803,2015,Abril,Estados Unidos de América,0,1,,1,-77.061029,3.8844260000000004
30804,2015,Abril,Estados Unidos de América,88,121,,209,-75.76635300000001,4.45285
30805,2015,Abril,Estados Unidos de América,6504,12593,,19097,-74.140516,4.697157
30806,2015,Abril,Estados Unidos de América,99,134,,233,-75.736374,4.815189
30807,2015,Abril,Estados Unidos de América,1434,3459,,4893,-75.42726,6.170465
30808,2015,Abril,Estados Unidos de América,12,32,,44,-73.181317,7.1280470000000005
30809,2015,Abril,Estados Unidos de América,53,56,,109,-72.508188,7.927233
30810,2015,Abril,Estados Unidos de América,0,1,,1,-76.7333,8.06667
30811,2015,Abril,Estados Unidos de América,0,2,,2,-75.68164200000001,9.402597
30812,2015,Abril,Estonia,0,4,,4,-74.140516,4.697157
30813,2015,Abril,Etiopia,1,1,,2,-74.140516,4.697157
30814,2015,Abril,Filipinas,0,3,,3,-74.77647900000001,10.886686
30815,2015,Abril,Filipinas,0,1,,1,-76.532004,3.451668
30816,2015,Abril,Filipinas,2,9,,11,-74.140516,4.697157
30817,2015,Abril,Filipinas,0,1,,1,-75.42726,6.170465
30818,2015,Abril,Finlandia,0,1,,1,-76.532004,3.451668
30819,2015,Abril,Finlandia,2,4,,6,-74.140516,4.697157
30820,2015,Abril,Finlandia,0,1,,1,-75.42726,6.170465
30821,2015,Abril,Francia,1,2,,3,-74.77647900000001,10.886686
30822,2015,Abril,Francia,8,19,,27,-76.532004,3.451668
30823,2015,Abril,Francia,952,1845,,2797,-74.140516,4.697157
30824,2015,Abril,Francia,1,1,,2,-75.736374,4.815189
30825,2015,Abril,Francia,10,16,,26,-75.42726,6.170465
30826,2015,Abril,Gibraltar/Territorio Británico de Ultramar,1,0,,1,-77.35600000000001,0.81488
30827,2015,Abril,Granada,0,5,,5,-75.527794,10.406342
30828,2015,Abril,Granada,1,0,,1,-74.140516,4.697157
30829,2015,Abril,Grecia,3,10,,13,-74.140516,4.697157
30830,2015,Abril,Guatemala,8,10,,18,-75.516486,10.446304
30831,2015,Abril,Guatemala,3,11,,14,-74.77647900000001,10.886686
30832,2015,Abril,Guatemala,3,0,,3,-81.70216500000001,12.5862
30833,2015,Abril,Guatemala,26,55,,81,-76.532004,3.451668
30834,2015,Abril,Guatemala,225,512,,737,-74.140516,4.697157
30835,2015,Abril,Guatemala,1,3,,4,-75.736374,4.815189
30836,2015,Abril,Guatemala,29,91,,120,-75.42726,6.170465
30837,2015,Abril,Guatemala,0,2,,2,-73.181317,7.1280470000000005
30838,2015,Abril,Guatemala,1,0,,1,-72.508188,7.927233
30839,2015,Abril,Guyana,0,2,,2,-76.532004,3.451668
30840,2015,Abril,Guyana,1,1,,2,-74.140516,4.697157
30841,2015,Abril,Guyana,1,0,,1,-75.42726,6.170465
30842,2015,Abril,Guyana,1,0,,1,-72.508188,7.927233
30843,2015,Abril,Guadalupe/Territorio Francés,1,3,,4,-74.140516,4.697157
30844,2015,Abril,Guadalupe/Territorio Francés,0,1,,1,-75.42726,6.170465
30845,2015,Abril,Guayana Francesa/Departamento de Ultramar Francés,3,1,,4,-76.532004,3.451668
30846,2015,Abril,Guayana Francesa/Departamento de Ultramar Francés,0,1,,1,-74.140516,4.697157
30847,2015,Abril,Haití,0,2,,2,-76.532004,3.451668
30848,2015,Abril,Haití,0,24,,24,-74.140516,4.697157
30849,2015,Abril,Haití,0,2,,2,-75.42726,6.170465
30850,2015,Abril,Honduras,0,1,,1,-75.516486,10.446304
30851,2015,Abril,Honduras,0,1,,1,-74.77647900000001,10.886686
30852,2015,Abril,Honduras,0,2,,2,-81.703935,12.574411099999999
30853,2015,Abril,Honduras,0,1,,1,-81.70216500000001,12.5862
30854,2015,Abril,Honduras,1,1,,2,-81.372937,13.338761300000002
30855,2015,Abril,Honduras,7,20,,27,-76.532004,3.451668
30856,2015,Abril,Honduras,39,63,,102,-74.140516,4.697157
30857,2015,Abril,Honduras,1,2,,3,-75.736374,4.815189
30858,2015,Abril,Honduras,41,47,,88,-75.42726,6.170465
30859,2015,Abril,Honduras,1,0,,1,-73.181317,7.1280470000000005
30860,2015,Abril,Honduras,0,1,,1,-72.508188,7.927233
30861,2015,Abril,Hong Kong,1,4,,5,-74.140516,4.697157
30862,2015,Abril,Hong Kong,0,1,,1,-75.42726,6.170465
30863,2015,Abril,Hungría,1,3,,4,-74.140516,4.697157
30864,2015,Abril,India,0,1,,1,-74.77647900000001,10.886686
30865,2015,Abril,India,1,9,,10,-76.532004,3.451668
30866,2015,Abril,India,5,28,,33,-74.140516,4.697157
30867,2015,Abril,India,0,1,,1,-75.42726,6.170465
30868,2015,Abril,Indonesia,0,1,,1,-74.140516,4.697157
30869,2015,Abril,Iraq,0,1,,1,-76.532004,3.451668
30870,2015,Abril,Irán,0,1,,1,-74.140516,4.697157
30871,2015,Abril,República de Irlanda,1,2,,3,-76.532004,3.451668
30872,2015,Abril,República de Irlanda,3,5,,8,-74.140516,4.697157
30873,2015,Abril,República de Irlanda,0,1,,1,-75.42726,6.170465
30874,2015,Abril,Islandia,1,1,,2,-74.140516,4.697157
30875,2015,Abril,Israel,2,7,,9,-76.532004,3.451668
30876,2015,Abril,Israel,15,83,,98,-74.140516,4.697157
30877,2015,Abril,Israel,0,3,,3,-75.42726,6.170465
30878,2015,Abril,Italia,0,2,,2,-74.77647900000001,10.886686
30879,2015,Abril,Italia,40,36,,76,-81.70216500000001,12.5862
30880,2015,Abril,Italia,12,22,,34,-76.532004,3.451668
30881,2015,Abril,Italia,49,187,,236,-74.140516,4.697157
30882,2015,Abril,Italia,0,1,,1,-75.736374,4.815189
30883,2015,Abril,Italia,7,23,,30,-75.42726,6.170465
30884,2015,Abril,Jamaica,1,5,,6,-75.527794,10.406342
30885,2015,Abril,Jamaica,1,0,,1,-74.77647900000001,10.886686
30886,2015,Abril,Jamaica,0,1,,1,-74.765343,10.970933
30887,2015,Abril,Jamaica,0,3,,3,-74.232675,11.117206
30888,2015,Abril,Jamaica,7,6,,13,-81.372937,13.338761300000002
30889,2015,Abril,Jamaica,0,4,,4,-74.140516,4.697157
30890,2015,Abril,Jamaica,1,4,,5,-75.42726,6.170465
30891,2015,Abril,Japón,0,3,,3,-76.532004,3.451668
30892,2015,Abril,Japón,6,20,,26,-74.140516,4.697157
30893,2015,Abril,Japón,0,1,,1,-75.736374,4.815189
30894,2015,Abril,Japón,0,1,,1,-75.42726,6.170465
30895,2015,Abril,Kazajistán,0,1,,1,-74.140516,4.697157
30896,2015,Abril,Kenia,2,0,,2,-76.532004,3.451668
30897,2015,Abril,Kenia,0,11,,11,-74.140516,4.697157
30898,2015,Abril,Letonia,1,0,,1,-74.140516,4.697157
30899,2015,Abril,Lituania,1,0,,1,-74.140516,4.697157
30900,2015,Abril,Líbano,2,4,,6,-74.140516,4.697157
30901,2015,Abril,Liechtenstein,2,2,,4,-74.140516,4.697157
30902,2015,Abril,Luxemburgo,2,6,,8,-74.140516,4.697157
30903,2015,Abril,Luxemburgo,2,2,,4,-75.42726,6.170465
30904,2015,Abril,Macedonia,0,1,,1,-74.140516,4.697157
30905,2015,Abril,Malasia,2,11,,13,-74.140516,4.697157
30906,2015,Abril,Malta,0,1,,1,-75.42726,6.170465
30907,2015,Abril,Marruecos,0,2,,2,-74.765343,10.970933
30908,2015,Abril,Marruecos,1,2,,3,-74.140516,4.697157
30909,2015,Abril,Marruecos,1,0,,1,-75.42726,6.170465
30910,2015,Abril,Martinica/Departamento de Ultramar Francés,0,2,,2,-75.527794,10.406342
30911,2015,Abril,México,0,6,,6,-75.527794,10.406342
30912,2015,Abril,México,113,52,,165,-75.516486,10.446304
30913,2015,Abril,México,7,16,,23,-74.77647900000001,10.886686
30914,2015,Abril,México,0,1,,1,-81.703935,12.574411099999999
30915,2015,Abril,México,1,4,,5,-81.70216500000001,12.5862
30916,2015,Abril,México,42,131,,173,-76.532004,3.451668
30917,2015,Abril,México,4322,7855,,12177,-74.140516,4.697157
30918,2015,Abril,México,13,16,,29,-75.736374,4.815189
30919,2015,Abril,México,278,712,,990,-75.42726,6.170465
30920,2015,Abril,México,1,6,,7,-73.181317,7.1280470000000005
30921,2015,Abril,México,13,21,,34,-72.508188,7.927233
30922,2015,Abril,Mónaco,1,0,,1,-74.140516,4.697157
30923,2015,Abril,Montenegro,0,2,,2,-74.140516,4.697157
30924,2015,Abril,Namibia,0,1,,1,-74.140516,4.697157
30925,2015,Abril,Nicaragua,1,2,,3,-75.516486,10.446304
30926,2015,Abril,Nicaragua,0,1,,1,-74.77647900000001,10.886686
30927,2015,Abril,Nicaragua,1,1,,2,-81.70216500000001,12.5862
30928,2015,Abril,Nicaragua,1,1,,2,-81.372937,13.338761300000002
30929,2015,Abril,Nicaragua,5,10,,15,-76.532004,3.451668
30930,2015,Abril,Nicaragua,22,37,,59,-74.140516,4.697157
30931,2015,Abril,Nicaragua,1,2,,3,-75.736374,4.815189
30932,2015,Abril,Nicaragua,3,16,,19,-75.42726,6.170465
30933,2015,Abril,Nicaragua,1,0,,1,-73.181317,7.1280470000000005
30934,2015,Abril,Noruega,5,11,,16,-74.140516,4.697157
30935,2015,Abril,Noruega,2,0,,2,-75.42726,6.170465
30936,2015,Abril,Nueva Caledonia/Territorio francés,0,2,,2,-74.140516,4.697157
30937,2015,Abril,Nueva Zelanda,0,1,,1,-81.70216500000001,12.5862
30938,2015,Abril,Nueva Zelanda,5,7,,12,-74.140516,4.697157
30939,2015,Abril,Panamá,947,902,,1849,-75.527794,10.406342
30940,2015,Abril,Panamá,0,3,,3,-73.247863,10.433608999999999
30941,2015,Abril,Panamá,1830,1881,,3711,-75.516486,10.446304
30942,2015,Abril,Panamá,139,321,,460,-74.77647900000001,10.886686
30943,2015,Abril,Panamá,0,2,,2,-74.765343,10.970933
30944,2015,Abril,Panamá,2,6,,8,-74.213989,11.247722999999999
30945,2015,Abril,Panamá,3,6,,9,-81.703935,12.574411099999999
30946,2015,Abril,Panamá,1164,921,,2085,-81.70216500000001,12.5862
30947,2015,Abril,Panamá,16,16,,32,-81.372937,13.338761300000002
30948,2015,Abril,Panamá,233,413,,646,-76.532004,3.451668
30949,2015,Abril,Panamá,0,10,,10,-77.061029,3.8844260000000004
30950,2015,Abril,Panamá,2993,4885,,7878,-74.140516,4.697157
30951,2015,Abril,Panamá,40,111,,151,-75.736374,4.815189
30952,2015,Abril,Panamá,819,1487,,2306,-75.42726,6.170465
30953,2015,Abril,Panamá,0,1,,1,-77.401154,6.222551999999999
30954,2015,Abril,Panamá,1,4,,5,-77.762647,7.102626
30955,2015,Abril,Panamá,13,39,,52,-73.181317,7.1280470000000005
30956,2015,Abril,Panamá,150,174,,324,-72.508188,7.927233
30957,2015,Abril,Panamá,67,73,,140,-77.35002,8.63337
30958,2015,Abril,Paraguay,1,0,,1,-77.35600000000001,0.81488
30959,2015,Abril,Paraguay,12,8,,20,-75.516486,10.446304
30960,2015,Abril,Paraguay,19,13,,32,-81.70216500000001,12.5862
30961,2015,Abril,Paraguay,8,6,,14,-76.532004,3.451668
30962,2015,Abril,Paraguay,51,59,,110,-74.140516,4.697157
30963,2015,Abril,Paraguay,6,22,,28,-75.42726,6.170465
30964,2015,Abril,Perú,151,238,,389,-69.941498,4.191162
30965,2015,Abril,Perú,4,10,,14,-69.94143100000001,4.214082
30966,2015,Abril,Perú,12,22,,34,-77.35600000000001,0.81488
30967,2015,Abril,Perú,18,12,,30,-75.516486,10.446304
30968,2015,Abril,Perú,1,1,,2,-74.77647900000001,10.886686
30969,2015,Abril,Perú,0,1,,1,-74.213989,11.247722999999999
30970,2015,Abril,Perú,53,41,,94,-81.70216500000001,12.5862
30971,2015,Abril,Perú,322,424,,746,-76.532004,3.451668
30972,2015,Abril,Perú,5229,7485,,12714,-74.140516,4.697157
30973,2015,Abril,Perú,329,537,,866,-75.42726,6.170465
30974,2015,Abril,Perú,2,4,,6,-72.508188,7.927233
30975,2015,Abril,Polonia,2,2,,4,-76.532004,3.451668
30976,2015,Abril,Polonia,10,12,,22,-74.140516,4.697157
30977,2015,Abril,Portugal,0,1,,1,-76.532004,3.451668
30978,2015,Abril,Portugal,221,356,,577,-74.140516,4.697157
30979,2015,Abril,Portugal,0,1,,1,-75.42726,6.170465
30980,2015,Abril,Puerto Rico/Territorio de Estados Unidos,1,7,,8,-75.516486,10.446304
30981,2015,Abril,Puerto Rico/Territorio de Estados Unidos,0,25,,25,-74.77647900000001,10.886686
30982,2015,Abril,Puerto Rico/Territorio de Estados Unidos,18,33,,51,-76.532004,3.451668
30983,2015,Abril,Puerto Rico/Territorio de Estados Unidos,254,329,,583,-74.140516,4.697157
30984,2015,Abril,Puerto Rico/Territorio de Estados Unidos,0,2,,2,-75.736374,4.815189
30985,2015,Abril,Puerto Rico/Territorio de Estados Unidos,35,75,,110,-75.42726,6.170465
30986,2015,Abril,Puerto Rico/Territorio de Estados Unidos,2,2,,4,-73.181317,7.1280470000000005
30987,2015,Abril,Qatar,0,1,,1,-74.140516,4.697157
30988,2015,Abril,Reino Unido de Gran Bretaña e Irlanda del Norte,0,1,,1,-75.516486,10.446304
30989,2015,Abril,Reino Unido de Gran Bretaña e Irlanda del Norte,8,14,,22,-76.532004,3.451668
30990,2015,Abril,Reino Unido de Gran Bretaña e Irlanda del Norte,295,557,,852,-74.140516,4.697157
30991,2015,Abril,Reino Unido de Gran Bretaña e Irlanda del Norte,3,15,,18,-75.42726,6.170465
30992,2015,Abril,Reino Unido de Gran Bretaña e Irlanda del Norte,0,1,,1,-73.181317,7.1280470000000005
30993,2015,Abril,República CentroÁfricana,0,3,,3,-75.527794,10.406342
30994,2015,Abril,República CentroÁfricana,1,1,,2,-74.140516,4.697157
30995,2015,Abril,Federación de Rusia,0,2,,2,-76.532004,3.451668
30996,2015,Abril,Federación de Rusia,13,24,,37,-74.140516,4.697157
30997,2015,Abril,Federación de Rusia,3,1,,4,-75.42726,6.170465
30998,2015,Abril,República Dominicana,0,1,,1,-75.527794,10.406342
30999,2015,Abril,República Dominicana,3,5,,8,-75.516486,10.446304
31000,2015,Abril,República Dominicana,6,15,,21,-74.77647900000001,10.886686
31001,2015,Abril,República Dominicana,0,1,,1,-74.765343,10.970933
31002,2015,Abril,República Dominicana,0,1,,1,-74.232675,11.117206
31003,2015,Abril,República Dominicana,0,3,,3,-81.70216500000001,12.5862
31004,2015,Abril,República Dominicana,24,20,,44,-76.532004,3.451668
31005,2015,Abril,República Dominicana,353,551,,904,-74.140516,4.697157
31006,2015,Abril,República Dominicana,2,2,,4,-75.736374,4.815189
31007,2015,Abril,República Dominicana,32,34,,66,-75.42726,6.170465
31008,2015,Abril,República Dominicana,0,2,,2,-73.181317,7.1280470000000005
31009,2015,Abril,República Dominicana,1,3,,4,-72.508188,7.927233
31010,2015,Abril,República Democrática Popular de Corea,0,1,,1,-76.532004,3.451668
31011,2015,Abril,Rumania,0,1,,1,-76.532004,3.451668
31012,2015,Abril,Rumania,2,8,,10,-74.140516,4.697157
31013,2015,Abril,Rumania,0,1,,1,-75.42726,6.170465
31014,2015,Abril,San Marino,1,3,,4,-74.213989,11.247722999999999
31015,2015,Abril,San Marino,0,1,,1,-74.140516,4.697157
31016,2015,Abril,Santa Lucia,0,1,,1,-81.70216500000001,12.5862
31017,2015,Abril,Santa Lucia,1,1,,2,-74.140516,4.697157
31018,2015,Abril,Santa Sede/Ciudad del Vaticano,0,1,,1,-74.140516,4.697157
31019,2015,Abril,Singapur,0,1,,1,-76.532004,3.451668
31020,2015,Abril,Singapur,0,2,,2,-74.140516,4.697157
31021,2015,Abril,República Árabe Siria,1,0,,1,-74.140516,4.697157
31022,2015,Abril,Sri Lanka,1,0,,1,-74.140516,4.697157
31023,2015,Abril,Sudáfrica,5,8,,13,-74.140516,4.697157
31024,2015,Abril,Sudáfrica,0,1,,1,-75.42726,6.170465
31025,2015,Abril,Suecia,2,5,,7,-76.532004,3.451668
31026,2015,Abril,Suecia,17,17,,34,-74.140516,4.697157
31027,2015,Abril,Suecia,1,4,,5,-75.42726,6.170465
31028,2015,Abril,Suiza,1,1,,2,-75.516486,10.446304
31029,2015,Abril,Suiza,0,1,,1,-81.70216500000001,12.5862
31030,2015,Abril,Suiza,10,13,,23,-76.532004,3.451668
31031,2015,Abril,Suiza,51,66,,117,-74.140516,4.697157
31032,2015,Abril,Suiza,3,6,,9,-75.42726,6.170465
31033,2015,Abril,Surinam,1,0,,1,-76.532004,3.451668
31034,2015,Abril,Surinam,1,1,,2,-74.140516,4.697157
31035,2015,Abril,Surinam,2,2,,4,-75.42726,6.170465
31036,2015,Abril,Taiwán,1,1,,2,-74.140516,4.697157
31037,2015,Abril,Taiwán,2,6,,8,-75.42726,6.170465
31038,2015,Abril,Trinidad y Tobago,0,1,,1,-74.77647900000001,10.886686
31039,2015,Abril,Trinidad y Tobago,2,24,,26,-74.213989,11.247722999999999
31040,2015,Abril,Trinidad y Tobago,5,5,,10,-76.532004,3.451668
31041,2015,Abril,Trinidad y Tobago,5,14,,19,-74.140516,4.697157
31042,2015,Abril,Trinidad y Tobago,0,4,,4,-75.42726,6.170465
31043,2015,Abril,Trinidad y Tobago,0,1,,1,-73.181317,7.1280470000000005
31044,2015,Abril,Trinidad y Tobago,0,1,,1,-72.508188,7.927233
31045,2015,Abril,Túnez,0,1,,1,-74.140516,4.697157
31046,2015,Abril,Turquía,0,1,,1,-76.532004,3.451668
31047,2015,Abril,Turquía,2,15,,17,-74.140516,4.697157
31048,2015,Abril,Turquía,0,2,,2,-75.42726,6.170465
31049,2015,Abril,Ucrania,2,1,,3,-74.140516,4.697157
31050,2015,Abril,Uruguay,1,1,,2,-77.35600000000001,0.81488
31051,2015,Abril,Uruguay,20,15,,35,-75.516486,10.446304
31052,2015,Abril,Uruguay,2,4,,6,-74.77647900000001,10.886686
31053,2015,Abril,Uruguay,12,9,,21,-81.70216500000001,12.5862
31054,2015,Abril,Uruguay,13,15,,28,-76.532004,3.451668
31055,2015,Abril,Uruguay,44,70,,114,-74.140516,4.697157
31056,2015,Abril,Uruguay,1,0,,1,-75.736374,4.815189
31057,2015,Abril,Uruguay,15,25,,40,-75.42726,6.170465
31058,2015,Abril,Uruguay,0,1,,1,-73.181317,7.1280470000000005
31059,2015,Abril,Uruguay,1,1,,2,-72.508188,7.927233
31060,2015,Abril,Venezuela,0,9,,9,-75.527794,10.406342
31061,2015,Abril,Venezuela,4,13,,17,-73.247863,10.433608999999999
31062,2015,Abril,Venezuela,8,28,,36,-75.516486,10.446304
31063,2015,Abril,Venezuela,5,65,,70,-74.77647900000001,10.886686
31064,2015,Abril,Venezuela,0,5,,5,-74.213989,11.247722999999999
31065,2015,Abril,Venezuela,1775,2840,,4615,-72.129595,11.360028999999999
31066,2015,Abril,Venezuela,9,18,,27,-76.532004,3.451668
31067,2015,Abril,Venezuela,9,10,,19,-67.927521,3.866713
31068,2015,Abril,Venezuela,3686,4295,,7981,-74.140516,4.697157
31069,2015,Abril,Venezuela,0,1,,1,-75.736374,4.815189
31070,2015,Abril,Venezuela,52,100,,152,-75.42726,6.170465
31071,2015,Abril,Venezuela,149,264,,413,-67.48402800000001,6.185536
31072,2015,Abril,Venezuela,65,122,,187,-70.74025300000001,7.088728999999999
31073,2015,Abril,Venezuela,2,3,,5,-73.181317,7.1280470000000005
31074,2015,Abril,Venezuela,2712,3840,,6552,-72.453013,7.819
31075,2015,Abril,Venezuela,193,234,,427,-72.508188,7.927233
31076,2015,Abril,Islas Vírgenes Estadounidenses/Territorio de Estados Unidos,0,1,,1,-74.77647900000001,10.886686
31077,2015,Abril,República Árabe de Yemen,1,1,,2,-74.140516,4.697157
31078,2015,Abril,Islas Turcas y Caicos/Territorio Británico de Ultramar,0,2,,2,-74.140516,4.697157
31079,2015,Abril,Desconocido,0,1,,1,-77.84700600000001,0.8124359999999999
31080,2015,Abril,Desconocido,2,45,,47,-74.140516,4.697157
31081,2015,Abril,Desconocido,13,36,,49,-67.48402800000001,6.185536
31082,2015,Abril,Desconocido,1,8,,9,-75.68164200000001,9.402597
31083,2015,Mayo,Afganistán,0,2,,2,-74.140516,4.697157
31084,2015,Mayo,Alemania,1,1,,2,-74.77647900000001,10.886686
31085,2015,Mayo,Alemania,31,36,,67,-76.532004,3.451668
31086,2015,Mayo,Alemania,1032,1931,,2963,-74.140516,4.697157
31087,2015,Mayo,Alemania,2,1,,3,-75.736374,4.815189
31088,2015,Mayo,Alemania,4,8,,12,-75.42726,6.170465
31089,2015,Mayo,Alemania,1,0,,1,-72.508188,7.927233
31090,2015,Mayo,Antigua y Barbuda,2,2,,4,-75.516486,10.446304
31091,2015,Mayo,Antigua y Barbuda,0,2,,2,-74.140516,4.697157
31092,2015,Mayo,Países Bajos,0,1,,1,-75.527794,10.406342
31093,2015,Mayo,Países Bajos,0,1,,1,-75.516486,10.446304
31094,2015,Mayo,Países Bajos,49,49,,98,-74.77647900000001,10.886686
31095,2015,Mayo,Países Bajos,2,4,,6,-74.213989,11.247722999999999
31096,2015,Mayo,Países Bajos,70,155,,225,-76.532004,3.451668
31097,2015,Mayo,Países Bajos,621,955,,1576,-74.140516,4.697157
31098,2015,Mayo,Países Bajos,0,1,,1,-75.736374,4.815189
31099,2015,Mayo,Países Bajos,238,270,,508,-75.42726,6.170465
31100,2015,Mayo,Países Bajos,8,1,,9,-73.181317,7.1280470000000005
31101,2015,Mayo,Países Bajos,3,1,,4,-72.508188,7.927233
31102,2015,Mayo,Arabia Saudita,1,1,,2,-74.140516,4.697157
31103,2015,Mayo,Argelia,1,0,,1,-76.532004,3.451668
31104,2015,Mayo,Argelia,0,5,,5,-74.140516,4.697157
31105,2015,Mayo,Argentina,1,7,,8,-77.35600000000001,0.81488
31106,2015,Mayo,Argentina,109,57,,166,-75.516486,10.446304
31107,2015,Mayo,Argentina,6,5,,11,-74.77647900000001,10.886686
31108,2015,Mayo,Argentina,39,31,,70,-81.70216500000001,12.5862
31109,2015,Mayo,Argentina,48,87,,135,-76.532004,3.451668
31110,2015,Mayo,Argentina,2159,3090,,5249,-74.140516,4.697157
31111,2015,Mayo,Argentina,1,1,,2,-75.736374,4.815189
31112,2015,Mayo,Argentina,71,123,,194,-75.42726,6.170465
31113,2015,Mayo,Argentina,0,1,,1,-73.181317,7.1280470000000005
31114,2015,Mayo,Argentina,2,5,,7,-72.508188,7.927233
31115,2015,Mayo,Aruba,12,14,,26,-75.527794,10.406342
31116,2015,Mayo,Aruba,11,7,,18,-74.77647900000001,10.886686
31117,2015,Mayo,Aruba,9,22,,31,-74.213989,11.247722999999999
31118,2015,Mayo,Aruba,10,3,,13,-76.532004,3.451668
31119,2015,Mayo,Aruba,599,750,,1349,-74.140516,4.697157
31120,2015,Mayo,Aruba,6,7,,13,-75.42726,6.170465
31121,2015,Mayo,Aruba,5,7,,12,-73.181317,7.1280470000000005
31122,2015,Mayo,Aruba,1,1,,2,-72.508188,7.927233
31123,2015,Mayo,Australia,0,1,,1,-75.516486,10.446304
31124,2015,Mayo,Australia,2,2,,4,-74.77647900000001,10.886686
31125,2015,Mayo,Australia,0,1,,1,-81.70216500000001,12.5862
31126,2015,Mayo,Australia,5,7,,12,-76.532004,3.451668
31127,2015,Mayo,Australia,17,28,,45,-74.140516,4.697157
31128,2015,Mayo,Australia,0,2,,2,-75.736374,4.815189
31129,2015,Mayo,Australia,5,17,,22,-75.42726,6.170465
31130,2015,Mayo,Austria,0,2,,2,-75.516486,10.446304
31131,2015,Mayo,Austria,1,1,,2,-74.77647900000001,10.886686
31132,2015,Mayo,Austria,1,2,,3,-76.532004,3.451668
31133,2015,Mayo,Austria,16,24,,40,-74.140516,4.697157
31134,2015,Mayo,Austria,2,0,,2,-75.42726,6.170465
31135,2015,Mayo,Bahamas,0,3,,3,-75.516486,10.446304
31136,2015,Mayo,Bahamas,0,1,,1,-74.213989,11.247722999999999
31137,2015,Mayo,Bahamas,0,1,,1,-74.140516,4.697157
31138,2015,Mayo,Bahréin,1,3,,4,-74.140516,4.697157
31139,2015,Mayo,Bahréin,0,1,,1,-72.453013,7.819
31140,2015,Mayo,Barbados,0,2,,2,-74.765343,10.970933
31141,2015,Mayo,Barbados,1,0,,1,-75.42726,6.170465
31142,2015,Mayo,República de Belarús,0,1,,1,-72.129595,11.360028999999999
31143,2015,Mayo,República de Belarús,0,3,,3,-74.140516,4.697157
31144,2015,Mayo,República de Belarús,1,0,,1,-72.453013,7.819
31145,2015,Mayo,Bélgica,3,4,,7,-76.532004,3.451668
31146,2015,Mayo,Bélgica,12,33,,45,-74.140516,4.697157
31147,2015,Mayo,Bélgica,1,4,,5,-75.42726,6.170465
31148,2015,Mayo,Belice,0,1,,1,-75.516486,10.446304
31149,2015,Mayo,Belice,1,4,,5,-74.140516,4.697157
31150,2015,Mayo,Bermudas/Territorio Británico de Ultramar,0,1,,1,-74.140516,4.697157
31151,2015,Mayo,Bermudas/Territorio Británico de Ultramar,0,1,,1,-75.42726,6.170465
31152,2015,Mayo,Bolivia,2,2,,4,-77.35600000000001,0.81488
31153,2015,Mayo,Bolivia,5,3,,8,-75.516486,10.446304
31154,2015,Mayo,Bolivia,14,18,,32,-76.532004,3.451668
31155,2015,Mayo,Bolivia,329,538,,867,-74.140516,4.697157
31156,2015,Mayo,Bolivia,25,18,,43,-75.42726,6.170465
31157,2015,Mayo,Brasil,94,227,,321,-69.941498,4.191162
31158,2015,Mayo,Brasil,8,10,,18,-69.94143100000001,4.214082
31159,2015,Mayo,Brasil,0,1,,1,-77.35600000000001,0.81488
31160,2015,Mayo,Brasil,27,28,,55,-75.516486,10.446304
31161,2015,Mayo,Brasil,5,7,,12,-74.77647900000001,10.886686
31162,2015,Mayo,Brasil,17,12,,29,-81.70216500000001,12.5862
31163,2015,Mayo,Brasil,36,67,,103,-76.532004,3.451668
31164,2015,Mayo,Brasil,3432,5697,,9129,-74.140516,4.697157
31165,2015,Mayo,Brasil,1,5,,6,-75.736374,4.815189
31166,2015,Mayo,Brasil,90,166,,256,-75.42726,6.170465
31167,2015,Mayo,Brasil,0,3,,3,-73.181317,7.1280470000000005
31168,2015,Mayo,Brasil,3,2,,5,-72.508188,7.927233
31169,2015,Mayo,Bulgaria,3,5,,8,-74.140516,4.697157
31170,2015,Mayo,Bulgaria,1,2,,3,-75.42726,6.170465
31171,2015,Mayo,Islas Caimán/Territorio Británico de Ultramar,0,1,,1,-74.765343,10.970933
31172,2015,Mayo,Islas Caimán/Territorio Británico de Ultramar,4,5,,9,-81.372937,13.338761300000002
31173,2015,Mayo,Islas Caimán/Territorio Británico de Ultramar,1,0,,1,-76.532004,3.451668
31174,2015,Mayo,Islas Caimán/Territorio Británico de Ultramar,0,3,,3,-74.140516,4.697157
31175,2015,Mayo,Antártida,0,1,,1,-74.213989,11.247722999999999
31176,2015,Mayo,Canadá,5,11,,16,-75.516486,10.446304
31177,2015,Mayo,Canadá,2,8,,10,-74.77647900000001,10.886686
31178,2015,Mayo,Canadá,0,1,,1,-74.765343,10.970933
31179,2015,Mayo,Canadá,36,45,,81,-76.532004,3.451668
31180,2015,Mayo,Canadá,452,749,,1201,-74.140516,4.697157
31181,2015,Mayo,Canadá,7,5,,12,-75.736374,4.815189
31182,2015,Mayo,Canadá,41,86,,127,-75.42726,6.170465
31183,2015,Mayo,Canadá,0,2,,2,-73.181317,7.1280470000000005
31184,2015,Mayo,Canadá,0,1,,1,-72.508188,7.927233
31185,2015,Mayo,España,0,1,,1,-75.516486,10.446304
31186,2015,Mayo,España,0,1,,1,-74.77647900000001,10.886686
31187,2015,Mayo,España,147,258,,405,-76.532004,3.451668
31188,2015,Mayo,España,2394,4966,,7360,-74.140516,4.697157
31189,2015,Mayo,España,3,3,,6,-75.736374,4.815189
31190,2015,Mayo,España,93,227,,320,-75.42726,6.170465
31191,2015,Mayo,España,1,1,,2,-72.508188,7.927233
31192,2015,Mayo,República de Corea,1,2,,3,-76.532004,3.451668
31193,2015,Mayo,República de Corea,4,14,,18,-74.140516,4.697157
31194,2015,Mayo,República de Corea,2,3,,5,-75.42726,6.170465
31195,2015,Mayo,República de Corea,0,1,,1,-72.508188,7.927233
31196,2015,Mayo,Costa de Marfil,2,1,,3,-74.140516,4.697157
31197,2015,Mayo,Costa Rica,0,3,,3,-75.527794,10.406342
31198,2015,Mayo,Costa Rica,3,7,,10,-75.516486,10.446304
31199,2015,Mayo,Costa Rica,1,3,,4,-74.77647900000001,10.886686
31200,2015,Mayo,Costa Rica,0,1,,1,-74.765343,10.970933
31201,2015,Mayo,Costa Rica,3,1,,4,-81.70216500000001,12.5862
31202,2015,Mayo,Costa Rica,25,41,,66,-76.532004,3.451668
31203,2015,Mayo,Costa Rica,777,1323,,2100,-74.140516,4.697157
31204,2015,Mayo,Costa Rica,4,4,,8,-75.736374,4.815189
31205,2015,Mayo,Costa Rica,83,135,,218,-75.42726,6.170465
31206,2015,Mayo,Costa Rica,1,0,,1,-73.181317,7.1280470000000005
31207,2015,Mayo,Costa Rica,5,5,,10,-72.508188,7.927233
31208,2015,Mayo,Croacia,0,1,,1,-75.516486,10.446304
31209,2015,Mayo,Croacia,0,4,,4,-74.140516,4.697157
31210,2015,Mayo,Cuba,1,1,,2,-75.527794,10.406342
31211,2015,Mayo,Cuba,6,8,,14,-74.77647900000001,10.886686
31212,2015,Mayo,Cuba,11,10,,21,-76.532004,3.451668
31213,2015,Mayo,Cuba,420,546,,966,-74.140516,4.697157
31214,2015,Mayo,Cuba,9,18,,27,-75.42726,6.170465
31215,2015,Mayo,Cuba,3,1,,4,-73.181317,7.1280470000000005
31216,2015,Mayo,Cuba,4,17,,21,-72.508188,7.927233
31217,2015,Mayo,República Checa,3,9,,12,-74.140516,4.697157
31218,2015,Mayo,Chile,1,0,,1,-77.35600000000001,0.81488
31219,2015,Mayo,Chile,5,4,,9,-75.516486,10.446304
31220,2015,Mayo,Chile,1,0,,1,-74.77647900000001,10.886686
31221,2015,Mayo,Chile,0,1,,1,-74.765343,10.970933
31222,2015,Mayo,Chile,18,34,,52,-76.532004,3.451668
31223,2015,Mayo,Chile,4622,5795,,10417,-74.140516,4.697157
31224,2015,Mayo,Chile,2,1,,3,-75.736374,4.815189
31225,2015,Mayo,Chile,13,62,,75,-75.42726,6.170465
31226,2015,Mayo,Chile,0,1,,1,-73.181317,7.1280470000000005
31227,2015,Mayo,China,0,1,,1,-74.77647900000001,10.886686
31228,2015,Mayo,China,2,0,,2,-76.532004,3.451668
31229,2015,Mayo,China,44,142,,186,-74.140516,4.697157
31230,2015,Mayo,China,3,3,,6,-75.42726,6.170465
31231,2015,Mayo,Dinamarca,0,1,,1,-75.516486,10.446304
31232,2015,Mayo,Dinamarca,3,0,,3,-74.77647900000001,10.886686
31233,2015,Mayo,Dinamarca,2,1,,3,-76.532004,3.451668
31234,2015,Mayo,Dinamarca,9,16,,25,-74.140516,4.697157
31235,2015,Mayo,Dinamarca,3,0,,3,-75.42726,6.170465
31236,2015,Mayo,Dominica,0,1,,1,-74.140516,4.697157
31237,2015,Mayo,Ecuador,46,152,,198,-76.876446,0.33002
31238,2015,Mayo,Ecuador,2,11,,13,-77.84700600000001,0.8124359999999999
31239,2015,Mayo,Ecuador,2334,4071,,6405,-77.35600000000001,0.81488
31240,2015,Mayo,Ecuador,11,97,,108,-78.802679,18.00143
31241,2015,Mayo,Ecuador,0,1,,1,-75.516486,10.446304
31242,2015,Mayo,Ecuador,2,6,,8,-74.77647900000001,10.886686
31243,2015,Mayo,Ecuador,295,405,,700,-76.532004,3.451668
31244,2015,Mayo,Ecuador,0,6,,6,-77.061029,3.8844260000000004
31245,2015,Mayo,Ecuador,3027,5018,,8045,-74.140516,4.697157
31246,2015,Mayo,Ecuador,0,1,,1,-75.736374,4.815189
31247,2015,Mayo,Ecuador,17,25,,42,-75.42726,6.170465
31248,2015,Mayo,Ecuador,3,2,,5,-73.181317,7.1280470000000005
31249,2015,Mayo,Ecuador,10,10,,20,-72.508188,7.927233
31250,2015,Mayo,Egipto,1,0,,1,-75.516486,10.446304
31251,2015,Mayo,Egipto,1,8,,9,-74.140516,4.697157
31252,2015,Mayo,Egipto,0,1,,1,-72.508188,7.927233
31253,2015,Mayo,El Salvador,0,3,,3,-74.77647900000001,10.886686
31254,2015,Mayo,El Salvador,0,2,,2,-81.70216500000001,12.5862
31255,2015,Mayo,El Salvador,91,150,,241,-76.532004,3.451668
31256,2015,Mayo,El Salvador,787,1212,,1999,-74.140516,4.697157
31257,2015,Mayo,El Salvador,1,1,,2,-75.736374,4.815189
31258,2015,Mayo,El Salvador,100,180,,280,-75.42726,6.170465
31259,2015,Mayo,El Salvador,3,1,,4,-73.181317,7.1280470000000005
31260,2015,Mayo,El Salvador,1,0,,1,-72.508188,7.927233
31261,2015,Mayo,Emiratos Árabes,0,4,,4,-74.140516,4.697157
31262,2015,Mayo,Eslovaquia,1,1,,2,-74.140516,4.697157
31263,2015,Mayo,Eslovenia,0,2,,2,-76.532004,3.451668
31264,2015,Mayo,Eslovenia,0,1,,1,-74.140516,4.697157
31265,2015,Mayo,Estados Unidos de América,1,29,,30,-75.527794,10.406342
31266,2015,Mayo,Estados Unidos de América,2,3,,5,-73.247863,10.433608999999999
31267,2015,Mayo,Estados Unidos de América,2041,3319,,5360,-75.516486,10.446304
31268,2015,Mayo,Estados Unidos de América,316,549,,865,-74.77647900000001,10.886686
31269,2015,Mayo,Estados Unidos de América,0,6,,6,-74.765343,10.970933
31270,2015,Mayo,Estados Unidos de América,1,2,,3,-74.232675,11.117206
31271,2015,Mayo,Estados Unidos de América,0,11,,11,-74.213989,11.247722999999999
31272,2015,Mayo,Estados Unidos de América,2,7,,9,-81.70216500000001,12.5862
31273,2015,Mayo,Estados Unidos de América,957,1333,,2290,-76.532004,3.451668
31274,2015,Mayo,Estados Unidos de América,90,163,,253,-75.76635300000001,4.45285
31275,2015,Mayo,Estados Unidos de América,7381,13949,,21330,-74.140516,4.697157
31276,2015,Mayo,Estados Unidos de América,150,166,,316,-75.736374,4.815189
31277,2015,Mayo,Estados Unidos de América,1670,3846,,5516,-75.42726,6.170465
31278,2015,Mayo,Estados Unidos de América,24,35,,59,-73.181317,7.1280470000000005
31279,2015,Mayo,Estados Unidos de América,57,64,,121,-72.508188,7.927233
31280,2015,Mayo,Estados Unidos de América,0,1,,1,-76.7333,8.06667
31281,2015,Mayo,Estonia,0,3,,3,-74.140516,4.697157
31282,2015,Mayo,Filipinas,0,5,,5,-75.527794,10.406342
31283,2015,Mayo,Filipinas,0,5,,5,-75.516486,10.446304
31284,2015,Mayo,Filipinas,0,4,,4,-74.77647900000001,10.886686
31285,2015,Mayo,Filipinas,0,3,,3,-76.532004,3.451668
31286,2015,Mayo,Filipinas,1,14,,15,-74.140516,4.697157
31287,2015,Mayo,Filipinas,1,0,,1,-75.42726,6.170465
31288,2015,Mayo,Finlandia,3,5,,8,-74.140516,4.697157
31289,2015,Mayo,Finlandia,1,2,,3,-75.42726,6.170465
31290,2015,Mayo,Francia,0,1,,1,-75.527794,10.406342
31291,2015,Mayo,Francia,0,1,,1,-74.77647900000001,10.886686
31292,2015,Mayo,Francia,24,31,,55,-76.532004,3.451668
31293,2015,Mayo,Francia,913,1861,,2774,-74.140516,4.697157
31294,2015,Mayo,Francia,8,7,,15,-75.42726,6.170465
31295,2015,Mayo,Grecia,3,6,,9,-74.140516,4.697157
31296,2015,Mayo,Groenlandia,0,1,,1,-76.532004,3.451668
31297,2015,Mayo,Guatemala,7,5,,12,-75.516486,10.446304
31298,2015,Mayo,Guatemala,1,4,,5,-74.77647900000001,10.886686
31299,2015,Mayo,Guatemala,0,1,,1,-74.765343,10.970933
31300,2015,Mayo,Guatemala,2,3,,5,-81.70216500000001,12.5862
31301,2015,Mayo,Guatemala,29,71,,100,-76.532004,3.451668
31302,2015,Mayo,Guatemala,258,547,,805,-74.140516,4.697157
31303,2015,Mayo,Guatemala,0,6,,6,-75.736374,4.815189
31304,2015,Mayo,Guatemala,33,75,,108,-75.42726,6.170465
31305,2015,Mayo,Guatemala,1,6,,7,-73.181317,7.1280470000000005
31306,2015,Mayo,Guatemala,5,4,,9,-72.508188,7.927233
31307,2015,Mayo,Guyana,2,1,,3,-76.532004,3.451668
31308,2015,Mayo,Guyana,0,1,,1,-74.140516,4.697157
31309,2015,Mayo,Guyana,1,1,,2,-75.42726,6.170465
31310,2015,Mayo,Guadalupe/Territorio Francés,1,0,,1,-76.532004,3.451668
31311,2015,Mayo,Guadalupe/Territorio Francés,1,2,,3,-74.140516,4.697157
31312,2015,Mayo,Guayana Francesa/Departamento de Ultramar Francés,0,1,,1,-74.765343,10.970933
31313,2015,Mayo,Guayana Francesa/Departamento de Ultramar Francés,0,1,,1,-74.140516,4.697157
31314,2015,Mayo,Guayana Francesa/Departamento de Ultramar Francés,1,0,,1,-75.42726,6.170465
31315,2015,Mayo,Haití,0,9,,9,-74.77647900000001,10.886686
31316,2015,Mayo,Haití,1,0,,1,-74.140516,4.697157
31317,2015,Mayo,Haití,3,1,,4,-75.42726,6.170465
31318,2015,Mayo,Honduras,0,3,,3,-75.527794,10.406342
31319,2015,Mayo,Honduras,4,3,,7,-75.516486,10.446304
31320,2015,Mayo,Honduras,4,4,,8,-81.372937,13.338761300000002
31321,2015,Mayo,Honduras,8,17,,25,-76.532004,3.451668
31322,2015,Mayo,Honduras,42,52,,94,-74.140516,4.697157
31323,2015,Mayo,Honduras,1,3,,4,-75.736374,4.815189
31324,2015,Mayo,Honduras,31,32,,63,-75.42726,6.170465
31325,2015,Mayo,Honduras,1,0,,1,-73.181317,7.1280470000000005
31326,2015,Mayo,Honduras,1,3,,4,-72.508188,7.927233
31327,2015,Mayo,Hong Kong,2,3,,5,-74.140516,4.697157
31328,2015,Mayo,Hong Kong,1,2,,3,-75.42726,6.170465
31329,2015,Mayo,Hungría,1,2,,3,-74.140516,4.697157
31330,2015,Mayo,Hungría,1,0,,1,-75.42726,6.170465
31331,2015,Mayo,India,0,1,,1,-75.527794,10.406342
31332,2015,Mayo,India,0,1,,1,-74.77647900000001,10.886686
31333,2015,Mayo,India,0,4,,4,-76.532004,3.451668
31334,2015,Mayo,India,6,31,,37,-74.140516,4.697157
31335,2015,Mayo,India,3,3,,6,-75.42726,6.170465
31336,2015,Mayo,Indonesia,3,3,,6,-74.140516,4.697157
31337,2015,Mayo,República de Irlanda,1,0,,1,-75.516486,10.446304
31338,2015,Mayo,República de Irlanda,0,1,,1,-74.77647900000001,10.886686
31339,2015,Mayo,República de Irlanda,0,1,,1,-76.532004,3.451668
31340,2015,Mayo,República de Irlanda,1,7,,8,-74.140516,4.697157
31341,2015,Mayo,Islandia,1,0,,1,-74.140516,4.697157
31342,2015,Mayo,Israel,1,0,,1,-74.77647900000001,10.886686
31343,2015,Mayo,Israel,6,10,,16,-76.532004,3.451668
31344,2015,Mayo,Israel,8,74,,82,-74.140516,4.697157
31345,2015,Mayo,Israel,6,4,,10,-75.42726,6.170465
31346,2015,Mayo,Israel,3,1,,4,-73.181317,7.1280470000000005
31347,2015,Mayo,Italia,1,2,,3,-75.516486,10.446304
31348,2015,Mayo,Italia,0,2,,2,-74.77647900000001,10.886686
31349,2015,Mayo,Italia,4,21,,25,-76.532004,3.451668
31350,2015,Mayo,Italia,59,201,,260,-74.140516,4.697157
31351,2015,Mayo,Italia,9,16,,25,-75.42726,6.170465
31352,2015,Mayo,Italia,0,1,,1,-72.508188,7.927233
31353,2015,Mayo,Jamaica,0,10,,10,-75.527794,10.406342
31354,2015,Mayo,Jamaica,0,2,,2,-75.516486,10.446304
31355,2015,Mayo,Jamaica,0,2,,2,-74.77647900000001,10.886686
31356,2015,Mayo,Jamaica,0,1,,1,-74.765343,10.970933
31357,2015,Mayo,Jamaica,1,1,,2,-76.532004,3.451668
31358,2015,Mayo,Jamaica,3,8,,11,-74.140516,4.697157
31359,2015,Mayo,Jamaica,1,1,,2,-75.42726,6.170465
31360,2015,Mayo,Jamaica,0,1,,1,-73.181317,7.1280470000000005
31361,2015,Mayo,Japón,0,1,,1,-76.532004,3.451668
31362,2015,Mayo,Japón,6,8,,14,-74.140516,4.697157
31363,2015,Mayo,Japón,0,2,,2,-75.42726,6.170465
31364,2015,Mayo,Japón,0,1,,1,-73.181317,7.1280470000000005
31365,2015,Mayo,Jordania,2,0,,2,-74.140516,4.697157
31366,2015,Mayo,Kazajistán,3,0,,3,-74.140516,4.697157
31367,2015,Mayo,Kuwait,0,1,,1,-74.140516,4.697157
31368,2015,Mayo,Letonia,0,2,,2,-74.140516,4.697157
31369,2015,Mayo,Lituania,1,1,,2,-74.140516,4.697157
31370,2015,Mayo,Líbano,5,2,,7,-74.140516,4.697157
31371,2015,Mayo,Luxemburgo,1,1,,2,-74.140516,4.697157
31372,2015,Mayo,Malasia,0,3,,3,-74.140516,4.697157
31373,2015,Mayo,Malasia,0,1,,1,-75.42726,6.170465
31374,2015,Mayo,Marruecos,0,1,,1,-74.140516,4.697157
31375,2015,Mayo,Martinica/Departamento de Ultramar Francés,1,0,,1,-74.77647900000001,10.886686
31376,2015,Mayo,México,2,11,,13,-75.527794,10.406342
31377,2015,Mayo,México,9,18,,27,-75.516486,10.446304
31378,2015,Mayo,México,11,26,,37,-74.77647900000001,10.886686
31379,2015,Mayo,México,0,9,,9,-81.70216500000001,12.5862
31380,2015,Mayo,México,84,142,,226,-76.532004,3.451668
31381,2015,Mayo,México,4608,7973,,12581,-74.140516,4.697157
31382,2015,Mayo,México,4,21,,25,-75.736374,4.815189
31383,2015,Mayo,México,367,828,,1195,-75.42726,6.170465
31384,2015,Mayo,México,3,12,,15,-73.181317,7.1280470000000005
31385,2015,Mayo,México,22,33,,55,-72.508188,7.927233
31386,2015,Mayo,Mongolia,0,1,,1,-74.140516,4.697157
31387,2015,Mayo,Montenegro,0,1,,1,-75.516486,10.446304
31388,2015,Mayo,Montenegro,1,0,,1,-74.140516,4.697157
31389,2015,Mayo,Nicaragua,1,1,,2,-75.516486,10.446304
31390,2015,Mayo,Nicaragua,0,1,,1,-74.77647900000001,10.886686
31391,2015,Mayo,Nicaragua,1,3,,4,-81.70216500000001,12.5862
31392,2015,Mayo,Nicaragua,22,36,,58,-76.532004,3.451668
31393,2015,Mayo,Nicaragua,24,35,,59,-74.140516,4.697157
31394,2015,Mayo,Nicaragua,0,4,,4,-75.736374,4.815189
31395,2015,Mayo,Nicaragua,6,21,,27,-75.42726,6.170465
31396,2015,Mayo,Nicaragua,0,1,,1,-72.508188,7.927233
31397,2015,Mayo,Nigeria,0,1,,1,-75.736374,4.815189
31398,2015,Mayo,Noruega,1,1,,2,-76.532004,3.451668
31399,2015,Mayo,Noruega,5,12,,17,-74.140516,4.697157
31400,2015,Mayo,Noruega,0,1,,1,-75.42726,6.170465
31401,2015,Mayo,Nueva Zelanda,0,1,,1,-76.532004,3.451668
31402,2015,Mayo,Nueva Zelanda,2,4,,6,-74.140516,4.697157
31403,2015,Mayo,Nueva Zelanda,0,1,,1,-75.736374,4.815189
31404,2015,Mayo,Nueva Zelanda,0,3,,3,-75.42726,6.170465
31405,2015,Mayo,Omán,1,0,,1,-74.140516,4.697157
31406,2015,Mayo,Papúa Nueva Guinea,1,0,,1,-75.516486,10.446304
31407,2015,Mayo,Panamá,816,753,,1569,-75.527794,10.406342
31408,2015,Mayo,Panamá,1605,1951,,3556,-75.516486,10.446304
31409,2015,Mayo,Panamá,140,309,,449,-74.77647900000001,10.886686
31410,2015,Mayo,Panamá,0,16,,16,-74.765343,10.970933
31411,2015,Mayo,Panamá,0,15,,15,-74.213989,11.247722999999999
31412,2015,Mayo,Panamá,1,10,,11,-81.703935,12.574411099999999
31413,2015,Mayo,Panamá,1133,784,,1917,-81.70216500000001,12.5862
31414,2015,Mayo,Panamá,6,6,,12,-81.372937,13.338761300000002
31415,2015,Mayo,Panamá,305,596,,901,-76.532004,3.451668
31416,2015,Mayo,Panamá,0,26,,26,-77.061029,3.8844260000000004
31417,2015,Mayo,Panamá,3247,5411,,8658,-74.140516,4.697157
31418,2015,Mayo,Panamá,27,109,,136,-75.736374,4.815189
31419,2015,Mayo,Panamá,979,1659,,2638,-75.42726,6.170465
31420,2015,Mayo,Panamá,2,2,,4,-77.401154,6.222551999999999
31421,2015,Mayo,Panamá,1,2,,3,-77.762647,7.102626
31422,2015,Mayo,Panamá,31,43,,74,-73.181317,7.1280470000000005
31423,2015,Mayo,Panamá,104,172,,276,-72.508188,7.927233
31424,2015,Mayo,Panamá,106,105,,211,-77.35002,8.63337
31425,2015,Mayo,Paraguay,4,7,,11,-75.516486,10.446304
31426,2015,Mayo,Paraguay,1,0,,1,-74.77647900000001,10.886686
31427,2015,Mayo,Paraguay,12,1,,13,-81.70216500000001,12.5862
31428,2015,Mayo,Paraguay,10,11,,21,-76.532004,3.451668
31429,2015,Mayo,Paraguay,56,57,,113,-74.140516,4.697157
31430,2015,Mayo,Paraguay,21,27,,48,-75.42726,6.170465
31431,2015,Mayo,Perú,136,210,,346,-69.941498,4.191162
31432,2015,Mayo,Perú,13,16,,29,-69.94143100000001,4.214082
31433,2015,Mayo,Perú,16,24,,40,-77.35600000000001,0.81488
31434,2015,Mayo,Perú,6,5,,11,-75.516486,10.446304
31435,2015,Mayo,Perú,0,3,,3,-74.77647900000001,10.886686
31436,2015,Mayo,Perú,0,1,,1,-74.213989,11.247722999999999
31437,2015,Mayo,Perú,25,18,,43,-81.70216500000001,12.5862
31438,2015,Mayo,Perú,307,422,,729,-76.532004,3.451668
31439,2015,Mayo,Perú,5442,7388,,12830,-74.140516,4.697157
31440,2015,Mayo,Perú,1,2,,3,-75.736374,4.815189
31441,2015,Mayo,Perú,402,631,,1033,-75.42726,6.170465
31442,2015,Mayo,Perú,3,0,,3,-73.181317,7.1280470000000005
31443,2015,Mayo,Perú,5,5,,10,-72.508188,7.927233
31444,2015,Mayo,Polonia,0,1,,1,-75.516486,10.446304
31445,2015,Mayo,Polonia,5,5,,10,-76.532004,3.451668
31446,2015,Mayo,Polonia,13,19,,32,-74.140516,4.697157
31447,2015,Mayo,Polonia,1,1,,2,-75.42726,6.170465
31448,2015,Mayo,Portugal,1,3,,4,-76.532004,3.451668
31449,2015,Mayo,Portugal,164,323,,487,-74.140516,4.697157
31450,2015,Mayo,Portugal,0,1,,1,-72.508188,7.927233
31451,2015,Mayo,Puerto Rico/Territorio de Estados Unidos,1,2,,3,-75.516486,10.446304
31452,2015,Mayo,Puerto Rico/Territorio de Estados Unidos,4,40,,44,-74.77647900000001,10.886686
31453,2015,Mayo,Puerto Rico/Territorio de Estados Unidos,17,31,,48,-76.532004,3.451668
31454,2015,Mayo,Puerto Rico/Territorio de Estados Unidos,271,354,,625,-74.140516,4.697157
31455,2015,Mayo,Puerto Rico/Territorio de Estados Unidos,2,4,,6,-75.736374,4.815189
31456,2015,Mayo,Puerto Rico/Territorio de Estados Unidos,51,97,,148,-75.42726,6.170465
31457,2015,Mayo,Puerto Rico/Territorio de Estados Unidos,0,1,,1,-73.181317,7.1280470000000005
31458,2015,Mayo,Puerto Rico/Territorio de Estados Unidos,0,3,,3,-72.508188,7.927233
31459,2015,Mayo,Reino Unido de Gran Bretaña e Irlanda del Norte,0,1,,1,-75.516486,10.446304
31460,2015,Mayo,Reino Unido de Gran Bretaña e Irlanda del Norte,0,1,,1,-74.765343,10.970933
31461,2015,Mayo,Reino Unido de Gran Bretaña e Irlanda del Norte,8,88,,96,-76.532004,3.451668
31462,2015,Mayo,Reino Unido de Gran Bretaña e Irlanda del Norte,291,617,,908,-74.140516,4.697157
31463,2015,Mayo,Reino Unido de Gran Bretaña e Irlanda del Norte,0,1,,1,-75.736374,4.815189
31464,2015,Mayo,Reino Unido de Gran Bretaña e Irlanda del Norte,8,8,,16,-75.42726,6.170465
31465,2015,Mayo,República CentroÁfricana,0,1,,1,-74.140516,4.697157
31466,2015,Mayo,Federación de Rusia,0,1,,1,-74.77647900000001,10.886686
31467,2015,Mayo,Federación de Rusia,2,1,,3,-76.532004,3.451668
31468,2015,Mayo,Federación de Rusia,16,28,,44,-74.140516,4.697157
31469,2015,Mayo,Federación de Rusia,1,1,,2,-75.42726,6.170465
31470,2015,Mayo,República Dominicana,4,9,,13,-75.527794,10.406342
31471,2015,Mayo,República Dominicana,3,5,,8,-73.247863,10.433608999999999
31472,2015,Mayo,República Dominicana,1,3,,4,-75.516486,10.446304
31473,2015,Mayo,República Dominicana,14,10,,24,-74.77647900000001,10.886686
31474,2015,Mayo,República Dominicana,0,3,,3,-74.765343,10.970933
31475,2015,Mayo,República Dominicana,15,15,,30,-76.532004,3.451668
31476,2015,Mayo,República Dominicana,476,737,,1213,-74.140516,4.697157
31477,2015,Mayo,República Dominicana,3,6,,9,-75.736374,4.815189
31478,2015,Mayo,República Dominicana,39,71,,110,-75.42726,6.170465
31479,2015,Mayo,República Dominicana,1,0,,1,-73.181317,7.1280470000000005
31480,2015,Mayo,República Dominicana,2,7,,9,-72.508188,7.927233
31481,2015,Mayo,República Democrática Popular de Corea,1,0,,1,-74.140516,4.697157
31482,2015,Mayo,Rumania,0,1,,1,-76.532004,3.451668
31483,2015,Mayo,Rumania,3,7,,10,-74.140516,4.697157
31484,2015,Mayo,Rumania,1,0,,1,-75.42726,6.170465
31485,2015,Mayo,San Cristóbal y Nevis,0,1,,1,-76.532004,3.451668
31486,2015,Mayo,San  Vicente y las Granadinas,0,1,,1,-74.140516,4.697157
31487,2015,Mayo,San  Vicente y las Granadinas,1,5,,6,-72.508188,7.927233
31488,2015,Mayo,Santa Lucia,3,8,,11,-74.140516,4.697157
31489,2015,Mayo,Serbia,0,2,,2,-74.140516,4.697157
31490,2015,Mayo,Singapur,1,3,,4,-74.140516,4.697157
31491,2015,Mayo,República Árabe Siria,1,0,,1,-74.140516,4.697157
31492,2015,Mayo,Sudáfrica,2,5,,7,-74.140516,4.697157
31493,2015,Mayo,Suecia,1,7,,8,-76.532004,3.451668
31494,2015,Mayo,Suecia,6,19,,25,-74.140516,4.697157
31495,2015,Mayo,Suecia,1,1,,2,-75.42726,6.170465
31496,2015,Mayo,Suiza,3,0,,3,-75.516486,10.446304
31497,2015,Mayo,Suiza,12,13,,25,-76.532004,3.451668
31498,2015,Mayo,Suiza,31,66,,97,-74.140516,4.697157
31499,2015,Mayo,Suiza,2,2,,4,-75.42726,6.170465
31500,2015,Mayo,Surinam,1,1,,2,-74.77647900000001,10.886686
31501,2015,Mayo,Surinam,0,1,,1,-76.532004,3.451668
31502,2015,Mayo,Surinam,0,1,,1,-74.140516,4.697157
31503,2015,Mayo,Surinam,5,11,,16,-75.42726,6.170465
31504,2015,Mayo,Taiwán,0,1,,1,-76.532004,3.451668
31505,2015,Mayo,Taiwán,5,5,,10,-74.140516,4.697157
31506,2015,Mayo,Taiwán,0,1,,1,-75.736374,4.815189
31507,2015,Mayo,Taiwán,2,3,,5,-75.42726,6.170465
31508,2015,Mayo,Tailandia,0,1,,1,-76.532004,3.451668
31509,2015,Mayo,Tailandia,1,3,,4,-74.140516,4.697157
31510,2015,Mayo,Trinidad y Tobago,0,6,,6,-75.527794,10.406342
31511,2015,Mayo,Trinidad y Tobago,0,7,,7,-74.765343,10.970933
31512,2015,Mayo,Trinidad y Tobago,1,4,,5,-76.532004,3.451668
31513,2015,Mayo,Trinidad y Tobago,1,14,,15,-74.140516,4.697157
31514,2015,Mayo,Trinidad y Tobago,0,2,,2,-75.736374,4.815189
31515,2015,Mayo,Trinidad y Tobago,19,9,,28,-75.42726,6.170465
31516,2015,Mayo,Trinidad y Tobago,1,0,,1,-73.181317,7.1280470000000005
31517,2015,Mayo,Trinidad y Tobago,0,2,,2,-72.508188,7.927233
31518,2015,Mayo,Túnez,0,1,,1,-74.140516,4.697157
31519,2015,Mayo,Turquía,0,1,,1,-76.532004,3.451668
31520,2015,Mayo,Turquía,1,9,,10,-74.140516,4.697157
31521,2015,Mayo,Turquía,2,1,,3,-75.42726,6.170465
31522,2015,Mayo,Ucrania,2,1,,3,-74.140516,4.697157
31523,2015,Mayo,Ucrania,1,0,,1,-75.42726,6.170465
31524,2015,Mayo,Uruguay,12,9,,21,-75.516486,10.446304
31525,2015,Mayo,Uruguay,1,1,,2,-74.77647900000001,10.886686
31526,2015,Mayo,Uruguay,2,1,,3,-81.70216500000001,12.5862
31527,2015,Mayo,Uruguay,7,31,,38,-76.532004,3.451668
31528,2015,Mayo,Uruguay,48,75,,123,-74.140516,4.697157
31529,2015,Mayo,Uruguay,18,37,,55,-75.42726,6.170465
31530,2015,Mayo,Venezuela,0,12,,12,-75.527794,10.406342
31531,2015,Mayo,Venezuela,0,7,,7,-73.247863,10.433608999999999
31532,2015,Mayo,Venezuela,7,41,,48,-75.516486,10.446304
31533,2015,Mayo,Venezuela,19,79,,98,-74.77647900000001,10.886686
31534,2015,Mayo,Venezuela,0,1,,1,-74.765343,10.970933
31535,2015,Mayo,Venezuela,1770,2658,,4428,-72.129595,11.360028999999999
31536,2015,Mayo,Venezuela,28,58,,86,-76.532004,3.451668
31537,2015,Mayo,Venezuela,11,14,,25,-67.927521,3.866713
31538,2015,Mayo,Venezuela,3172,3929,,7101,-74.140516,4.697157
31539,2015,Mayo,Venezuela,0,4,,4,-75.736374,4.815189
31540,2015,Mayo,Venezuela,59,81,,140,-75.42726,6.170465
31541,2015,Mayo,Venezuela,199,462,,661,-67.48402800000001,6.185536
31542,2015,Mayo,Venezuela,53,106,,159,-70.74025300000001,7.088728999999999
31543,2015,Mayo,Venezuela,2,6,,8,-73.181317,7.1280470000000005
31544,2015,Mayo,Venezuela,3047,3986,,7033,-72.453013,7.819
31545,2015,Mayo,Venezuela,229,282,,511,-72.508188,7.927233
31546,2015,Mayo,Vietnam,0,1,,1,-74.140516,4.697157
31547,2015,Mayo,Islas Vírgenes Británicas/Territorio Británico de Ultramar,1,3,,4,-74.77647900000001,10.886686
31548,2015,Mayo,Islas Vírgenes Estadounidenses/Territorio de Estados Unidos,5,6,,11,-74.77647900000001,10.886686
31549,2015,Mayo,Islas Vírgenes Estadounidenses/Territorio de Estados Unidos,2,1,,3,-76.532004,3.451668
31550,2015,Mayo,Zambia,1,0,,1,-76.532004,3.451668
31551,2015,Mayo,Zambia,3,1,,4,-74.140516,4.697157
31552,2015,Mayo,Desconocido,0,7,,7,-81.703935,12.574411099999999
31553,2015,Mayo,Desconocido,5,0,,5,-76.532004,3.451668
31554,2015,Mayo,Desconocido,0,40,,40,-74.140516,4.697157
31555,2015,Mayo,Desconocido,0,29,,29,-75.68164200000001,9.402597
31556,2015,Junio,Albania,0,2,,2,-76.532004,3.451668
31557,2015,Junio,Albania,0,1,,1,-74.140516,4.697157
31558,2015,Junio,Alemania,1,0,,1,-75.516486,10.446304
31559,2015,Junio,Alemania,4,3,,7,-74.77647900000001,10.886686
31560,2015,Junio,Alemania,23,31,,54,-76.532004,3.451668
31561,2015,Junio,Alemania,0,1,,1,-77.061029,3.8844260000000004
31562,2015,Junio,Alemania,1176,2069,,3245,-74.140516,4.697157
31563,2015,Junio,Alemania,1,0,,1,-75.736374,4.815189
31564,2015,Junio,Alemania,8,21,,29,-75.42726,6.170465
31565,2015,Junio,Alemania,0,1,,1,-73.181317,7.1280470000000005
31566,2015,Junio,Antigua y Barbuda,0,1,,1,-75.527794,10.406342
31567,2015,Junio,Antigua y Barbuda,1,4,,5,-74.140516,4.697157
31568,2015,Junio,Países Bajos,1,1,,2,-75.527794,10.406342
31569,2015,Junio,Países Bajos,1,0,,1,-75.516486,10.446304
31570,2015,Junio,Países Bajos,35,50,,85,-74.77647900000001,10.886686
31571,2015,Junio,Países Bajos,51,123,,174,-76.532004,3.451668
31572,2015,Junio,Países Bajos,0,1,,1,-77.061029,3.8844260000000004
31573,2015,Junio,Países Bajos,616,886,,1502,-74.140516,4.697157
31574,2015,Junio,Países Bajos,189,213,,402,-75.42726,6.170465
31575,2015,Junio,Países Bajos,2,3,,5,-73.181317,7.1280470000000005
31576,2015,Junio,Arabia Saudita,0,4,,4,-74.140516,4.697157
31577,2015,Junio,Arabia Saudita,0,2,,2,-75.42726,6.170465
31578,2015,Junio,Argelia,0,1,,1,-76.532004,3.451668
31579,2015,Junio,Argelia,2,1,,3,-74.140516,4.697157
31580,2015,Junio,Argentina,6,14,,20,-77.35600000000001,0.81488
31581,2015,Junio,Argentina,47,19,,66,-75.516486,10.446304
31582,2015,Junio,Argentina,3,7,,10,-74.77647900000001,10.886686
31583,2015,Junio,Argentina,201,130,,331,-81.70216500000001,12.5862
31584,2015,Junio,Argentina,48,88,,136,-76.532004,3.451668
31585,2015,Junio,Argentina,1580,2543,,4123,-74.140516,4.697157
31586,2015,Junio,Argentina,78,170,,248,-75.42726,6.170465
31587,2015,Junio,República de Armenia,1,1,,2,-74.140516,4.697157
31588,2015,Junio,Aruba,21,17,,38,-75.527794,10.406342
31589,2015,Junio,Aruba,13,18,,31,-74.77647900000001,10.886686
31590,2015,Junio,Aruba,1,10,,11,-74.213989,11.247722999999999
31591,2015,Junio,Aruba,3,4,,7,-76.532004,3.451668
31592,2015,Junio,Aruba,484,680,,1164,-74.140516,4.697157
31593,2015,Junio,Aruba,0,2,,2,-75.736374,4.815189
31594,2015,Junio,Aruba,25,23,,48,-75.42726,6.170465
31595,2015,Junio,Aruba,5,6,,11,-73.181317,7.1280470000000005
31596,2015,Junio,Aruba,0,3,,3,-72.508188,7.927233
31597,2015,Junio,Australia,0,2,,2,-75.516486,10.446304
31598,2015,Junio,Australia,0,2,,2,-74.77647900000001,10.886686
31599,2015,Junio,Australia,4,7,,11,-76.532004,3.451668
31600,2015,Junio,Australia,27,37,,64,-74.140516,4.697157
31601,2015,Junio,Australia,7,18,,25,-75.42726,6.170465
31602,2015,Junio,Australia,1,1,,2,-73.181317,7.1280470000000005
31603,2015,Junio,Austria,4,2,,6,-76.532004,3.451668
31604,2015,Junio,Austria,9,9,,18,-74.140516,4.697157
31605,2015,Junio,Austria,0,1,,1,-75.42726,6.170465
31606,2015,Junio,Azerbaiyán,0,1,,1,-74.140516,4.697157
31607,2015,Junio,Bahamas,0,2,,2,-75.516486,10.446304
31608,2015,Junio,Bahamas,1,1,,2,-76.532004,3.451668
31609,2015,Junio,Bahamas,1,2,,3,-74.140516,4.697157
31610,2015,Junio,Bahamas,4,3,,7,-75.42726,6.170465
31611,2015,Junio,Barbados,0,2,,2,-76.532004,3.451668
31612,2015,Junio,República de Belarús,0,3,,3,-74.140516,4.697157
31613,2015,Junio,República de Belarús,1,0,,1,-72.508188,7.927233
31614,2015,Junio,Bélgica,0,2,,2,-75.516486,10.446304
31615,2015,Junio,Bélgica,7,7,,14,-76.532004,3.451668
31616,2015,Junio,Bélgica,39,51,,90,-74.140516,4.697157
31617,2015,Junio,Bélgica,2,10,,12,-75.42726,6.170465
31618,2015,Junio,Belice,0,1,,1,-76.532004,3.451668
31619,2015,Junio,Belice,2,7,,9,-74.140516,4.697157
31620,2015,Junio,Benín,0,1,,1,-74.140516,4.697157
31621,2015,Junio,Bolivia,8,2,,10,-75.516486,10.446304
31622,2015,Junio,Bolivia,10,0,,10,-74.77647900000001,10.886686
31623,2015,Junio,Bolivia,10,5,,15,-81.70216500000001,12.5862
31624,2015,Junio,Bolivia,25,25,,50,-76.532004,3.451668
31625,2015,Junio,Bolivia,456,518,,974,-74.140516,4.697157
31626,2015,Junio,Bolivia,21,26,,47,-75.42726,6.170465
31627,2015,Junio,Botsuana,1,1,,2,-75.42726,6.170465
31628,2015,Junio,Brasil,117,154,,271,-69.941498,4.191162
31629,2015,Junio,Brasil,5,2,,7,-69.94143100000001,4.214082
31630,2015,Junio,Brasil,1,2,,3,-77.35600000000001,0.81488
31631,2015,Junio,Brasil,0,4,,4,-75.527794,10.406342
31632,2015,Junio,Brasil,25,26,,51,-75.516486,10.446304
31633,2015,Junio,Brasil,3,2,,5,-74.77647900000001,10.886686
31634,2015,Junio,Brasil,97,79,,176,-81.70216500000001,12.5862
31635,2015,Junio,Brasil,34,49,,83,-76.532004,3.451668
31636,2015,Junio,Brasil,0,1,,1,-67.927521,3.866713
31637,2015,Junio,Brasil,3070,4890,,7960,-74.140516,4.697157
31638,2015,Junio,Brasil,107,162,,269,-75.42726,6.170465
31639,2015,Junio,Brasil,0,5,,5,-73.181317,7.1280470000000005
31640,2015,Junio,Brasil,3,2,,5,-72.508188,7.927233
31641,2015,Junio,Bulgaria,4,5,,9,-74.140516,4.697157
31642,2015,Junio,Bulgaria,3,2,,5,-72.508188,7.927233
31643,2015,Junio,Islas Caimán/Territorio Británico de Ultramar,0,3,,3,-74.77647900000001,10.886686
31644,2015,Junio,Islas Caimán/Territorio Británico de Ultramar,0,1,,1,-81.70216500000001,12.5862
31645,2015,Junio,Islas Caimán/Territorio Británico de Ultramar,2,2,,4,-81.372937,13.338761300000002
31646,2015,Junio,Islas Caimán/Territorio Británico de Ultramar,0,10,,10,-74.140516,4.697157
31647,2015,Junio,Islas Caimán/Territorio Británico de Ultramar,0,2,,2,-75.42726,6.170465
31648,2015,Junio,Camerún,0,2,,2,-74.140516,4.697157
31649,2015,Junio,Canadá,5,23,,28,-75.516486,10.446304
31650,2015,Junio,Canadá,13,10,,23,-74.77647900000001,10.886686
31651,2015,Junio,Canadá,0,1,,1,-74.765343,10.970933
31652,2015,Junio,Canadá,0,1,,1,-81.70216500000001,12.5862
31653,2015,Junio,Canadá,27,49,,76,-76.532004,3.451668
31654,2015,Junio,Canadá,569,873,,1442,-74.140516,4.697157
31655,2015,Junio,Canadá,1,7,,8,-75.736374,4.815189
31656,2015,Junio,Canadá,75,124,,199,-75.42726,6.170465
31657,2015,Junio,Canadá,8,13,,21,-73.181317,7.1280470000000005
31658,2015,Junio,Canadá,2,5,,7,-72.508188,7.927233
31659,2015,Junio,España,0,2,,2,-75.527794,10.406342
31660,2015,Junio,España,25,151,,176,-74.77647900000001,10.886686
31661,2015,Junio,España,0,2,,2,-74.213989,11.247722999999999
31662,2015,Junio,España,250,322,,572,-76.532004,3.451668
31663,2015,Junio,España,2743,5155,,7898,-74.140516,4.697157
31664,2015,Junio,España,15,19,,34,-75.736374,4.815189
31665,2015,Junio,España,132,279,,411,-75.42726,6.170465
31666,2015,Junio,España,8,2,,10,-73.181317,7.1280470000000005
31667,2015,Junio,España,4,10,,14,-72.508188,7.927233
31668,2015,Junio,República de Corea,1,1,,2,-76.532004,3.451668
31669,2015,Junio,República de Corea,4,20,,24,-74.140516,4.697157
31670,2015,Junio,República de Corea,0,4,,4,-75.42726,6.170465
31671,2015,Junio,República de Corea,0,3,,3,-72.508188,7.927233
31672,2015,Junio,Islas Malvinas,0,1,,1,-74.140516,4.697157
31673,2015,Junio,Costa de Marfil,2,2,,4,-74.140516,4.697157
31674,2015,Junio,Costa Rica,0,4,,4,-75.527794,10.406342
31675,2015,Junio,Costa Rica,7,11,,18,-75.516486,10.446304
31676,2015,Junio,Costa Rica,8,8,,16,-74.77647900000001,10.886686
31677,2015,Junio,Costa Rica,0,1,,1,-74.213989,11.247722999999999
31678,2015,Junio,Costa Rica,8,5,,13,-81.70216500000001,12.5862
31679,2015,Junio,Costa Rica,44,52,,96,-76.532004,3.451668
31680,2015,Junio,Costa Rica,789,1389,,2178,-74.140516,4.697157
31681,2015,Junio,Costa Rica,1,4,,5,-75.736374,4.815189
31682,2015,Junio,Costa Rica,52,83,,135,-75.42726,6.170465
31683,2015,Junio,Costa Rica,0,1,,1,-73.181317,7.1280470000000005
31684,2015,Junio,Costa Rica,4,2,,6,-72.508188,7.927233
31685,2015,Junio,Croacia,1,6,,7,-74.140516,4.697157
31686,2015,Junio,Cuba,1,1,,2,-75.516486,10.446304
31687,2015,Junio,Cuba,5,4,,9,-74.77647900000001,10.886686
31688,2015,Junio,Cuba,27,35,,62,-76.532004,3.451668
31689,2015,Junio,Cuba,499,658,,1157,-74.140516,4.697157
31690,2015,Junio,Cuba,1,0,,1,-75.736374,4.815189
31691,2015,Junio,Cuba,10,15,,25,-75.42726,6.170465
31692,2015,Junio,Cuba,2,2,,4,-73.181317,7.1280470000000005
31693,2015,Junio,Cuba,5,1,,6,-72.508188,7.927233
31694,2015,Junio,República Checa,1,0,,1,-75.516486,10.446304
31695,2015,Junio,República Checa,0,1,,1,-76.532004,3.451668
31696,2015,Junio,República Checa,9,5,,14,-74.140516,4.697157
31697,2015,Junio,República Checa,2,2,,4,-75.42726,6.170465
31698,2015,Junio,Chile,6,6,,12,-77.35600000000001,0.81488
31699,2015,Junio,Chile,4,5,,9,-75.516486,10.446304
31700,2015,Junio,Chile,3,1,,4,-74.77647900000001,10.886686
31701,2015,Junio,Chile,0,6,,6,-74.765343,10.970933
31702,2015,Junio,Chile,52,46,,98,-81.70216500000001,12.5862
31703,2015,Junio,Chile,21,35,,56,-76.532004,3.451668
31704,2015,Junio,Chile,2718,4232,,6950,-74.140516,4.697157
31705,2015,Junio,Chile,0,3,,3,-75.736374,4.815189
31706,2015,Junio,Chile,17,57,,74,-75.42726,6.170465
31707,2015,Junio,Chile,0,1,,1,-73.181317,7.1280470000000005
31708,2015,Junio,Chile,4,3,,7,-72.508188,7.927233
31709,2015,Junio,China,3,1,,4,-76.532004,3.451668
31710,2015,Junio,China,38,99,,137,-74.140516,4.697157
31711,2015,Junio,Chipre,0,3,,3,-74.140516,4.697157
31712,2015,Junio,Dinamarca,2,1,,3,-76.532004,3.451668
31713,2015,Junio,Dinamarca,7,13,,20,-74.140516,4.697157
31714,2015,Junio,Dinamarca,0,1,,1,-75.42726,6.170465
31715,2015,Junio,Dominica,0,1,,1,-74.140516,4.697157
31716,2015,Junio,Dominica,0,2,,2,-72.508188,7.927233
31717,2015,Junio,Ecuador,67,160,,227,-76.876446,0.33002
31718,2015,Junio,Ecuador,1,5,,6,-77.84700600000001,0.8124359999999999
31719,2015,Junio,Ecuador,2237,3691,,5928,-77.35600000000001,0.81488
31720,2015,Junio,Ecuador,27,125,,152,-78.802679,18.00143
31721,2015,Junio,Ecuador,73,65,,138,-75.516486,10.446304
31722,2015,Junio,Ecuador,4,6,,10,-74.77647900000001,10.886686
31723,2015,Junio,Ecuador,237,347,,584,-76.532004,3.451668
31724,2015,Junio,Ecuador,0,1,,1,-77.061029,3.8844260000000004
31725,2015,Junio,Ecuador,2610,4312,,6922,-74.140516,4.697157
31726,2015,Junio,Ecuador,0,5,,5,-75.736374,4.815189
31727,2015,Junio,Ecuador,3,13,,16,-75.42726,6.170465
31728,2015,Junio,Ecuador,1,2,,3,-73.181317,7.1280470000000005
31729,2015,Junio,Ecuador,2,5,,7,-72.508188,7.927233
31730,2015,Junio,Egipto,1,0,,1,-74.140516,4.697157
31731,2015,Junio,El Salvador,0,2,,2,-74.77647900000001,10.886686
31732,2015,Junio,El Salvador,8,6,,14,-81.70216500000001,12.5862
31733,2015,Junio,El Salvador,118,175,,293,-76.532004,3.451668
31734,2015,Junio,El Salvador,802,1306,,2108,-74.140516,4.697157
31735,2015,Junio,El Salvador,115,199,,314,-75.42726,6.170465
31736,2015,Junio,El Salvador,1,2,,3,-72.508188,7.927233
31737,2015,Junio,Emiratos Árabes,3,9,,12,-74.140516,4.697157
31738,2015,Junio,Emiratos Árabes,1,0,,1,-75.42726,6.170465
31739,2015,Junio,Eslovaquia,1,1,,2,-74.140516,4.697157
31740,2015,Junio,Eslovenia,0,1,,1,-76.532004,3.451668
31741,2015,Junio,Eslovenia,4,3,,7,-74.140516,4.697157
31742,2015,Junio,Estados Unidos de América,0,29,,29,-75.527794,10.406342
31743,2015,Junio,Estados Unidos de América,2515,3521,,6036,-75.516486,10.446304
31744,2015,Junio,Estados Unidos de América,795,1192,,1987,-74.77647900000001,10.886686
31745,2015,Junio,Estados Unidos de América,2,126,,128,-74.765343,10.970933
31746,2015,Junio,Estados Unidos de América,1,3,,4,-74.232675,11.117206
31747,2015,Junio,Estados Unidos de América,1,8,,9,-74.213989,11.247722999999999
31748,2015,Junio,Estados Unidos de América,26,29,,55,-81.70216500000001,12.5862
31749,2015,Junio,Estados Unidos de América,1932,2277,,4209,-76.532004,3.451668
31750,2015,Junio,Estados Unidos de América,200,236,,436,-75.76635300000001,4.45285
31751,2015,Junio,Estados Unidos de América,9925,15882,,25807,-74.140516,4.697157
31752,2015,Junio,Estados Unidos de América,299,316,,615,-75.736374,4.815189
31753,2015,Junio,Estados Unidos de América,3062,4809,,7871,-75.42726,6.170465
31754,2015,Junio,Estados Unidos de América,81,99,,180,-73.181317,7.1280470000000005
31755,2015,Junio,Estados Unidos de América,87,69,,156,-72.508188,7.927233
31756,2015,Junio,Estados Unidos de América,0,1,,1,-76.7333,8.06667
31757,2015,Junio,Estados Unidos de América,0,1,,1,-75.68164200000001,9.402597
31758,2015,Junio,Estonia,2,2,,4,-74.140516,4.697157
31759,2015,Junio,Etiopia,1,0,,1,-76.532004,3.451668
31760,2015,Junio,Etiopia,1,1,,2,-75.42726,6.170465
31761,2015,Junio,Filipinas,0,3,,3,-75.516486,10.446304
31762,2015,Junio,Filipinas,0,4,,4,-74.77647900000001,10.886686
31763,2015,Junio,Filipinas,0,5,,5,-76.532004,3.451668
31764,2015,Junio,Filipinas,3,17,,20,-74.140516,4.697157
31765,2015,Junio,Filipinas,0,1,,1,-75.42726,6.170465
31766,2015,Junio,Finlandia,1,1,,2,-75.516486,10.446304
31767,2015,Junio,Finlandia,3,5,,8,-74.140516,4.697157
31768,2015,Junio,Finlandia,1,2,,3,-75.42726,6.170465
31769,2015,Junio,Francia,0,1,,1,-75.527794,10.406342
31770,2015,Junio,Francia,0,1,,1,-75.516486,10.446304
31771,2015,Junio,Francia,12,19,,31,-76.532004,3.451668
31772,2015,Junio,Francia,1165,2041,,3206,-74.140516,4.697157
31773,2015,Junio,Francia,2,2,,4,-75.736374,4.815189
31774,2015,Junio,Francia,6,14,,20,-75.42726,6.170465
31775,2015,Junio,Francia,0,1,,1,-73.181317,7.1280470000000005
31776,2015,Junio,Francia,0,1,,1,-72.508188,7.927233
31777,2015,Junio,Gabón,0,1,,1,-74.140516,4.697157
31778,2015,Junio,Georgia,0,2,,2,-74.140516,4.697157
31779,2015,Junio,Ghana,0,1,,1,-74.140516,4.697157
31780,2015,Junio,Ghana,1,0,,1,-75.736374,4.815189
31781,2015,Junio,Gibraltar/Territorio Británico de Ultramar,0,8,,8,-74.213989,11.247722999999999
31782,2015,Junio,Granada,0,1,,1,-74.140516,4.697157
31783,2015,Junio,Grecia,0,1,,1,-76.532004,3.451668
31784,2015,Junio,Grecia,0,1,,1,-77.061029,3.8844260000000004
31785,2015,Junio,Grecia,0,5,,5,-74.140516,4.697157
31786,2015,Junio,Guatemala,6,8,,14,-75.516486,10.446304
31787,2015,Junio,Guatemala,2,6,,8,-74.77647900000001,10.886686
31788,2015,Junio,Guatemala,7,13,,20,-81.70216500000001,12.5862
31789,2015,Junio,Guatemala,1,2,,3,-81.372937,13.338761300000002
31790,2015,Junio,Guatemala,19,41,,60,-76.532004,3.451668
31791,2015,Junio,Guatemala,294,520,,814,-74.140516,4.697157
31792,2015,Junio,Guatemala,2,9,,11,-75.736374,4.815189
31793,2015,Junio,Guatemala,25,63,,88,-75.42726,6.170465
31794,2015,Junio,Guatemala,1,3,,4,-73.181317,7.1280470000000005
31795,2015,Junio,Guatemala,8,11,,19,-72.508188,7.927233
31796,2015,Junio,Guyana,0,1,,1,-75.527794,10.406342
31797,2015,Junio,Guadalupe/Territorio Francés,0,1,,1,-75.516486,10.446304
31798,2015,Junio,Guadalupe/Territorio Francés,0,4,,4,-74.140516,4.697157
31799,2015,Junio,Guayana Francesa/Departamento de Ultramar Francés,0,1,,1,-75.527794,10.406342
31800,2015,Junio,Haití,0,7,,7,-74.77647900000001,10.886686
31801,2015,Junio,Haití,0,15,,15,-74.140516,4.697157
31802,2015,Junio,Haití,1,1,,2,-75.42726,6.170465
31803,2015,Junio,Haití,0,1,,1,-72.508188,7.927233
31804,2015,Junio,Honduras,5,4,,9,-75.516486,10.446304
31805,2015,Junio,Honduras,0,3,,3,-74.77647900000001,10.886686
31806,2015,Junio,Honduras,0,3,,3,-81.703935,12.574411099999999
31807,2015,Junio,Honduras,1,1,,2,-81.70216500000001,12.5862
31808,2015,Junio,Honduras,1,1,,2,-81.372937,13.338761300000002
31809,2015,Junio,Honduras,14,13,,27,-76.532004,3.451668
31810,2015,Junio,Honduras,41,82,,123,-74.140516,4.697157
31811,2015,Junio,Honduras,1,1,,2,-75.736374,4.815189
31812,2015,Junio,Honduras,14,21,,35,-75.42726,6.170465
31813,2015,Junio,Honduras,1,1,,2,-73.181317,7.1280470000000005
31814,2015,Junio,Honduras,3,3,,6,-72.508188,7.927233
31815,2015,Junio,Hong Kong,4,4,,8,-74.140516,4.697157
31816,2015,Junio,Hong Kong,0,2,,2,-75.42726,6.170465
31817,2015,Junio,Hungría,6,8,,14,-74.140516,4.697157
31818,2015,Junio,India,0,1,,1,-74.77647900000001,10.886686
31819,2015,Junio,India,0,6,,6,-76.532004,3.451668
31820,2015,Junio,India,6,28,,34,-74.140516,4.697157
31821,2015,Junio,India,4,3,,7,-75.42726,6.170465
31822,2015,Junio,India,0,1,,1,-72.508188,7.927233
31823,2015,Junio,Indonesia,0,5,,5,-74.140516,4.697157
31824,2015,Junio,Indonesia,1,3,,4,-75.42726,6.170465
31825,2015,Junio,República de Irlanda,5,13,,18,-74.140516,4.697157
31826,2015,Junio,República de Irlanda,3,0,,3,-75.42726,6.170465
31827,2015,Junio,Islandia,1,1,,2,-74.140516,4.697157
31828,2015,Junio,Israel,0,1,,1,-75.516486,10.446304
31829,2015,Junio,Israel,0,1,,1,-74.77647900000001,10.886686
31830,2015,Junio,Israel,0,1,,1,-76.532004,3.451668
31831,2015,Junio,Israel,10,50,,60,-74.140516,4.697157
31832,2015,Junio,Italia,1,0,,1,-75.516486,10.446304
31833,2015,Junio,Italia,1,3,,4,-74.77647900000001,10.886686
31834,2015,Junio,Italia,22,41,,63,-76.532004,3.451668
31835,2015,Junio,Italia,108,290,,398,-74.140516,4.697157
31836,2015,Junio,Italia,0,1,,1,-75.736374,4.815189
31837,2015,Junio,Italia,7,18,,25,-75.42726,6.170465
31838,2015,Junio,Italia,0,3,,3,-72.508188,7.927233
31839,2015,Junio,Jamaica,5,11,,16,-75.527794,10.406342
31840,2015,Junio,Jamaica,3,10,,13,-81.70216500000001,12.5862
31841,2015,Junio,Jamaica,1,3,,4,-76.532004,3.451668
31842,2015,Junio,Jamaica,9,14,,23,-74.140516,4.697157
31843,2015,Junio,Jamaica,0,2,,2,-75.42726,6.170465
31844,2015,Junio,Jamaica,1,0,,1,-73.181317,7.1280470000000005
31845,2015,Junio,Japón,0,7,,7,-75.527794,10.406342
31846,2015,Junio,Japón,0,3,,3,-75.516486,10.446304
31847,2015,Junio,Japón,0,2,,2,-74.765343,10.970933
31848,2015,Junio,Japón,2,3,,5,-76.532004,3.451668
31849,2015,Junio,Japón,2,18,,20,-74.140516,4.697157
31850,2015,Junio,Japón,2,7,,9,-75.42726,6.170465
31851,2015,Junio,Jordania,1,0,,1,-74.140516,4.697157
31852,2015,Junio,Kazajistán,0,1,,1,-74.140516,4.697157
31853,2015,Junio,Kenia,1,6,,7,-76.532004,3.451668
31854,2015,Junio,Kenia,1,4,,5,-74.140516,4.697157
31855,2015,Junio,Kenia,1,1,,2,-75.42726,6.170465
31856,2015,Junio,Kuwait,0,1,,1,-74.140516,4.697157
31857,2015,Junio,Letonia,3,5,,8,-74.140516,4.697157
31858,2015,Junio,Lituania,4,4,,8,-74.140516,4.697157
31859,2015,Junio,Líbano,5,7,,12,-74.140516,4.697157
31860,2015,Junio,Luxemburgo,0,1,,1,-76.532004,3.451668
31861,2015,Junio,Malasia,3,6,,9,-74.140516,4.697157
31862,2015,Junio,Malawi,0,1,,1,-76.532004,3.451668
31863,2015,Junio,Malí,0,1,,1,-74.140516,4.697157
31864,2015,Junio,Marruecos,2,1,,3,-74.140516,4.697157
31865,2015,Junio,Martinica/Departamento de Ultramar Francés,0,1,,1,-74.140516,4.697157
31866,2015,Junio,México,0,6,,6,-75.527794,10.406342
31867,2015,Junio,México,7,17,,24,-75.516486,10.446304
31868,2015,Junio,México,16,30,,46,-74.77647900000001,10.886686
31869,2015,Junio,México,0,1,,1,-74.765343,10.970933
31870,2015,Junio,México,6,7,,13,-81.70216500000001,12.5862
31871,2015,Junio,México,56,107,,163,-76.532004,3.451668
31872,2015,Junio,México,4794,8162,,12956,-74.140516,4.697157
31873,2015,Junio,México,7,12,,19,-75.736374,4.815189
31874,2015,Junio,México,507,1115,,1622,-75.42726,6.170465
31875,2015,Junio,México,10,7,,17,-73.181317,7.1280470000000005
31876,2015,Junio,México,22,16,,38,-72.508188,7.927233
31877,2015,Junio,Mónaco,0,1,,1,-74.140516,4.697157
31878,2015,Junio,Mongolia,0,2,,2,-74.140516,4.697157
31879,2015,Junio,Montenegro,0,1,,1,-75.42726,6.170465
31880,2015,Junio,Mozambique,0,2,,2,-76.532004,3.451668
31881,2015,Junio,Mozambique,0,1,,1,-74.140516,4.697157
31882,2015,Junio,Nauru,2,0,,2,-75.42726,6.170465
31883,2015,Junio,Nepal,0,5,,5,-74.140516,4.697157
31884,2015,Junio,Nicaragua,2,8,,10,-75.527794,10.406342
31885,2015,Junio,Nicaragua,2,4,,6,-75.516486,10.446304
31886,2015,Junio,Nicaragua,1,1,,2,-74.77647900000001,10.886686
31887,2015,Junio,Nicaragua,2,6,,8,-81.703935,12.574411099999999
31888,2015,Junio,Nicaragua,8,4,,12,-81.70216500000001,12.5862
31889,2015,Junio,Nicaragua,10,12,,22,-76.532004,3.451668
31890,2015,Junio,Nicaragua,31,24,,55,-74.140516,4.697157
31891,2015,Junio,Nicaragua,1,5,,6,-75.736374,4.815189
31892,2015,Junio,Nicaragua,1,4,,5,-75.42726,6.170465
31893,2015,Junio,Nicaragua,1,0,,1,-73.181317,7.1280470000000005
31894,2015,Junio,Nicaragua,2,3,,5,-72.508188,7.927233
31895,2015,Junio,Nigeria,1,3,,4,-74.140516,4.697157
31896,2015,Junio,Noruega,0,5,,5,-74.77647900000001,10.886686
31897,2015,Junio,Noruega,7,9,,16,-76.532004,3.451668
31898,2015,Junio,Noruega,24,36,,60,-74.140516,4.697157
31899,2015,Junio,Noruega,0,1,,1,-75.42726,6.170465
31900,2015,Junio,Noruega,2,1,,3,-73.181317,7.1280470000000005
31901,2015,Junio,Nueva Caledonia/Territorio francés,1,0,,1,-74.140516,4.697157
31902,2015,Junio,Nueva Zelanda,1,1,,2,-75.516486,10.446304
31903,2015,Junio,Nueva Zelanda,0,1,,1,-76.532004,3.451668
31904,2015,Junio,Nueva Zelanda,2,2,,4,-74.140516,4.697157
31905,2015,Junio,Nueva Zelanda,1,0,,1,-72.508188,7.927233
31906,2015,Junio,Omán,1,0,,1,-74.140516,4.697157
31907,2015,Junio,Omán,0,1,,1,-75.42726,6.170465
31908,2015,Junio,Pakistán,0,1,,1,-76.532004,3.451668
31909,2015,Junio,Pakistán,0,1,,1,-74.140516,4.697157
31910,2015,Junio,Panamá,181,263,,444,-75.527794,10.406342
31911,2015,Junio,Panamá,1608,1911,,3519,-75.516486,10.446304
31912,2015,Junio,Panamá,233,457,,690,-74.77647900000001,10.886686
31913,2015,Junio,Panamá,0,21,,21,-74.765343,10.970933
31914,2015,Junio,Panamá,0,6,,6,-74.213989,11.247722999999999
31915,2015,Junio,Panamá,0,1,,1,-81.703935,12.574411099999999
31916,2015,Junio,Panamá,385,289,,674,-81.70216500000001,12.5862
31917,2015,Junio,Panamá,2,7,,9,-81.372937,13.338761300000002
31918,2015,Junio,Panamá,335,462,,797,-76.532004,3.451668
31919,2015,Junio,Panamá,0,38,,38,-77.061029,3.8844260000000004
31920,2015,Junio,Panamá,3047,4975,,8022,-74.140516,4.697157
31921,2015,Junio,Panamá,32,80,,112,-75.736374,4.815189
31922,2015,Junio,Panamá,872,1535,,2407,-75.42726,6.170465
31923,2015,Junio,Panamá,1,1,,2,-77.762647,7.102626
31924,2015,Junio,Panamá,14,33,,47,-73.181317,7.1280470000000005
31925,2015,Junio,Panamá,114,133,,247,-72.508188,7.927233
31926,2015,Junio,Panamá,1,0,,1,-76.7333,8.06667
31927,2015,Junio,Panamá,75,88,,163,-77.35002,8.63337
31928,2015,Junio,Paraguay,10,6,,16,-75.516486,10.446304
31929,2015,Junio,Paraguay,2,0,,2,-74.77647900000001,10.886686
31930,2015,Junio,Paraguay,100,58,,158,-81.70216500000001,12.5862
31931,2015,Junio,Paraguay,12,17,,29,-76.532004,3.451668
31932,2015,Junio,Paraguay,71,63,,134,-74.140516,4.697157
31933,2015,Junio,Paraguay,1,1,,2,-75.736374,4.815189
31934,2015,Junio,Paraguay,12,53,,65,-75.42726,6.170465
31935,2015,Junio,Perú,141,222,,363,-69.941498,4.191162
31936,2015,Junio,Perú,1,2,,3,-69.94143100000001,4.214082
31937,2015,Junio,Perú,8,34,,42,-77.35600000000001,0.81488
31938,2015,Junio,Perú,0,4,,4,-75.527794,10.406342
31939,2015,Junio,Perú,15,8,,23,-75.516486,10.446304
31940,2015,Junio,Perú,1,8,,9,-74.77647900000001,10.886686
31941,2015,Junio,Perú,120,85,,205,-81.70216500000001,12.5862
31942,2015,Junio,Perú,206,308,,514,-76.532004,3.451668
31943,2015,Junio,Perú,0,1,,1,-77.061029,3.8844260000000004
31944,2015,Junio,Perú,4683,6810,,11493,-74.140516,4.697157
31945,2015,Junio,Perú,1,2,,3,-75.736374,4.815189
31946,2015,Junio,Perú,244,401,,645,-75.42726,6.170465
31947,2015,Junio,Perú,2,1,,3,-73.181317,7.1280470000000005
31948,2015,Junio,Perú,2,5,,7,-72.508188,7.927233
31949,2015,Junio,Polonia,0,3,,3,-74.77647900000001,10.886686
31950,2015,Junio,Polonia,8,10,,18,-74.140516,4.697157
31951,2015,Junio,Polonia,0,1,,1,-75.42726,6.170465
31952,2015,Junio,Portugal,1,1,,2,-76.532004,3.451668
31953,2015,Junio,Portugal,321,558,,879,-74.140516,4.697157
31954,2015,Junio,Portugal,1,1,,2,-75.42726,6.170465
31955,2015,Junio,Portugal,1,0,,1,-72.508188,7.927233
31956,2015,Junio,Puerto Rico/Territorio de Estados Unidos,0,2,,2,-75.516486,10.446304
31957,2015,Junio,Puerto Rico/Territorio de Estados Unidos,3,35,,38,-74.77647900000001,10.886686
31958,2015,Junio,Puerto Rico/Territorio de Estados Unidos,1,2,,3,-81.70216500000001,12.5862
31959,2015,Junio,Puerto Rico/Territorio de Estados Unidos,32,37,,69,-76.532004,3.451668
31960,2015,Junio,Puerto Rico/Territorio de Estados Unidos,354,419,,773,-74.140516,4.697157
31961,2015,Junio,Puerto Rico/Territorio de Estados Unidos,4,7,,11,-75.736374,4.815189
31962,2015,Junio,Puerto Rico/Territorio de Estados Unidos,36,79,,115,-75.42726,6.170465
31963,2015,Junio,Puerto Rico/Territorio de Estados Unidos,3,4,,7,-73.181317,7.1280470000000005
31964,2015,Junio,Puerto Rico/Territorio de Estados Unidos,0,2,,2,-72.508188,7.927233
31965,2015,Junio,Qatar,1,2,,3,-74.140516,4.697157
31966,2015,Junio,Qatar,2,2,,4,-75.42726,6.170465
31967,2015,Junio,Reino Unido de Gran Bretaña e Irlanda del Norte,1,4,,5,-75.516486,10.446304
31968,2015,Junio,Reino Unido de Gran Bretaña e Irlanda del Norte,0,1,,1,-74.77647900000001,10.886686
31969,2015,Junio,Reino Unido de Gran Bretaña e Irlanda del Norte,3,0,,3,-81.70216500000001,12.5862
31970,2015,Junio,Reino Unido de Gran Bretaña e Irlanda del Norte,14,16,,30,-76.532004,3.451668
31971,2015,Junio,Reino Unido de Gran Bretaña e Irlanda del Norte,0,1,,1,-77.061029,3.8844260000000004
31972,2015,Junio,Reino Unido de Gran Bretaña e Irlanda del Norte,371,647,,1018,-74.140516,4.697157
31973,2015,Junio,Reino Unido de Gran Bretaña e Irlanda del Norte,2,0,,2,-75.736374,4.815189
31974,2015,Junio,Reino Unido de Gran Bretaña e Irlanda del Norte,4,14,,18,-75.42726,6.170465
31975,2015,Junio,República CentroÁfricana,1,1,,2,-74.140516,4.697157
31976,2015,Junio,Federación de Rusia,0,6,,6,-74.213989,11.247722999999999
31977,2015,Junio,Federación de Rusia,1,3,,4,-76.532004,3.451668
31978,2015,Junio,Federación de Rusia,12,21,,33,-74.140516,4.697157
31979,2015,Junio,República Dominicana,2,6,,8,-75.516486,10.446304
31980,2015,Junio,República Dominicana,6,13,,19,-74.77647900000001,10.886686
31981,2015,Junio,República Dominicana,22,32,,54,-76.532004,3.451668
31982,2015,Junio,República Dominicana,520,739,,1259,-74.140516,4.697157
31983,2015,Junio,República Dominicana,0,3,,3,-75.736374,4.815189
31984,2015,Junio,República Dominicana,33,49,,82,-75.42726,6.170465
31985,2015,Junio,República Dominicana,0,3,,3,-73.181317,7.1280470000000005
31986,2015,Junio,República Dominicana,5,6,,11,-72.508188,7.927233
31987,2015,Junio,Rumania,0,3,,3,-74.140516,4.697157
31988,2015,Junio,Rwanda,0,1,,1,-76.532004,3.451668
31989,2015,Junio,San Cristóbal y Nevis,1,15,,16,-75.516486,10.446304
31990,2015,Junio,San Cristóbal y Nevis,0,1,,1,-75.42726,6.170465
31991,2015,Junio,Santa Lucia,1,1,,2,-73.181317,7.1280470000000005
31992,2015,Junio,Santo Tomé y Príncipe,1,0,,1,-74.140516,4.697157
31993,2015,Junio,Senegal,0,2,,2,-74.140516,4.697157
31994,2015,Junio,Serbia,1,1,,2,-74.140516,4.697157
31995,2015,Junio,Seychelles,0,2,,2,-74.140516,4.697157
31996,2015,Junio,Singapur,0,1,,1,-76.532004,3.451668
31997,2015,Junio,Singapur,4,6,,10,-74.140516,4.697157
31998,2015,Junio,Sudáfrica,4,9,,13,-74.140516,4.697157
31999,2015,Junio,Sudáfrica,0,1,,1,-75.42726,6.170465
32000,2015,Junio,Suecia,2,0,,2,-75.516486,10.446304
32001,2015,Junio,Suecia,1,0,,1,-74.77647900000001,10.886686
32002,2015,Junio,Suecia,18,9,,27,-76.532004,3.451668
32003,2015,Junio,Suecia,34,45,,79,-74.140516,4.697157
32004,2015,Junio,Suecia,2,8,,10,-75.42726,6.170465
32005,2015,Junio,Suecia,0,1,,1,-73.181317,7.1280470000000005
32006,2015,Junio,Suiza,1,0,,1,-74.77647900000001,10.886686
32007,2015,Junio,Suiza,17,30,,47,-76.532004,3.451668
32008,2015,Junio,Suiza,60,90,,150,-74.140516,4.697157
32009,2015,Junio,Suiza,0,1,,1,-75.736374,4.815189
32010,2015,Junio,Suiza,5,16,,21,-75.42726,6.170465
32011,2015,Junio,Surinam,3,1,,4,-74.140516,4.697157
32012,2015,Junio,Taiwán,0,3,,3,-76.532004,3.451668
32013,2015,Junio,Taiwán,1,1,,2,-74.140516,4.697157
32014,2015,Junio,Tailandia,2,3,,5,-74.140516,4.697157
32015,2015,Junio,Tanzania,0,2,,2,-74.140516,4.697157
32016,2015,Junio,Togo,0,1,,1,-75.42726,6.170465
32017,2015,Junio,Trinidad y Tobago,0,1,,1,-75.527794,10.406342
32018,2015,Junio,Trinidad y Tobago,0,1,,1,-75.516486,10.446304
32019,2015,Junio,Trinidad y Tobago,0,7,,7,-74.765343,10.970933
32020,2015,Junio,Trinidad y Tobago,4,6,,10,-76.532004,3.451668
32021,2015,Junio,Trinidad y Tobago,6,15,,21,-74.140516,4.697157
32022,2015,Junio,Trinidad y Tobago,0,1,,1,-75.736374,4.815189
32023,2015,Junio,Trinidad y Tobago,3,12,,15,-75.42726,6.170465
32024,2015,Junio,Trinidad y Tobago,1,1,,2,-73.181317,7.1280470000000005
32025,2015,Junio,Trinidad y Tobago,0,5,,5,-72.508188,7.927233
32026,2015,Junio,Túnez,1,1,,2,-74.140516,4.697157
32027,2015,Junio,Turquía,0,1,,1,-76.532004,3.451668
32028,2015,Junio,Turquía,4,6,,10,-74.140516,4.697157
32029,2015,Junio,Turquía,2,2,,4,-75.42726,6.170465
32030,2015,Junio,Turquía,0,1,,1,-73.181317,7.1280470000000005
32031,2015,Junio,Ucrania,3,1,,4,-74.140516,4.697157
32032,2015,Junio,Uganda,1,0,,1,-76.532004,3.451668
32033,2015,Junio,Uganda,0,1,,1,-74.140516,4.697157
32034,2015,Junio,Uruguay,18,4,,22,-75.516486,10.446304
32035,2015,Junio,Uruguay,3,2,,5,-74.77647900000001,10.886686
32036,2015,Junio,Uruguay,28,22,,50,-81.70216500000001,12.5862
32037,2015,Junio,Uruguay,13,22,,35,-76.532004,3.451668
32038,2015,Junio,Uruguay,69,89,,158,-74.140516,4.697157
32039,2015,Junio,Uruguay,0,1,,1,-75.736374,4.815189
32040,2015,Junio,Uruguay,42,68,,110,-75.42726,6.170465
32041,2015,Junio,Uzbekistán,1,0,,1,-74.140516,4.697157
32042,2015,Junio,Venezuela,0,26,,26,-75.527794,10.406342
32043,2015,Junio,Venezuela,9,30,,39,-75.516486,10.446304
32044,2015,Junio,Venezuela,15,75,,90,-74.77647900000001,10.886686
32045,2015,Junio,Venezuela,0,1,,1,-74.765343,10.970933
32046,2015,Junio,Venezuela,0,4,,4,-74.232675,11.117206
32047,2015,Junio,Venezuela,0,1,,1,-74.213989,11.247722999999999
32048,2015,Junio,Venezuela,1820,2608,,4428,-72.129595,11.360028999999999
32049,2015,Junio,Venezuela,0,2,,2,-81.70216500000001,12.5862
32050,2015,Junio,Venezuela,14,29,,43,-76.532004,3.451668
32051,2015,Junio,Venezuela,13,9,,22,-67.927521,3.866713
32052,2015,Junio,Venezuela,3018,3716,,6734,-74.140516,4.697157
32053,2015,Junio,Venezuela,1,4,,5,-75.736374,4.815189
32054,2015,Junio,Venezuela,42,79,,121,-75.42726,6.170465
32055,2015,Junio,Venezuela,214,397,,611,-67.48402800000001,6.185536
32056,2015,Junio,Venezuela,130,200,,330,-70.74025300000001,7.088728999999999
32057,2015,Junio,Venezuela,1,2,,3,-73.181317,7.1280470000000005
32058,2015,Junio,Venezuela,3055,3996,,7051,-72.453013,7.819
32059,2015,Junio,Venezuela,201,217,,418,-72.508188,7.927233
32060,2015,Junio,Vietnam,1,2,,3,-74.140516,4.697157
32061,2015,Junio,Vietnam,1,0,,1,-75.42726,6.170465
32062,2015,Junio,Islas Vírgenes Británicas/Territorio Británico de Ultramar,0,4,,4,-74.213989,11.247722999999999
32063,2015,Junio,Islas Vírgenes Británicas/Territorio Británico de Ultramar,1,7,,8,-74.140516,4.697157
32064,2015,Junio,República Árabe de Yemen,1,1,,2,-74.140516,4.697157
32065,2015,Junio,Desconocido,2,1,,3,-81.703935,12.574411099999999
32066,2015,Junio,Desconocido,3,37,,40,-74.140516,4.697157
32067,2015,Junio,Desconocido,1,2,,3,-70.74025300000001,7.088728999999999
32068,2015,Junio,Desconocido,0,4,,4,-75.68164200000001,9.402597
32069,2015,Julio,Alemania,5,5,,10,-74.77647900000001,10.886686
32070,2015,Julio,Alemania,3,1,,4,-81.70216500000001,12.5862
32071,2015,Julio,Alemania,99,73,,172,-76.532004,3.451668
32072,2015,Julio,Alemania,1801,2485,,4286,-74.140516,4.697157
32073,2015,Julio,Alemania,0,1,,1,-75.736374,4.815189
32074,2015,Julio,Alemania,37,41,,78,-75.42726,6.170465
32075,2015,Julio,Alemania,0,1,,1,-73.181317,7.1280470000000005
32076,2015,Julio,Angola,0,1,,1,-74.140516,4.697157
32077,2015,Julio,Antigua y Barbuda,1,2,,3,-76.532004,3.451668
32078,2015,Julio,Antigua y Barbuda,3,2,,5,-74.140516,4.697157
32079,2015,Julio,Antigua y Barbuda,1,1,,2,-75.42726,6.170465
32080,2015,Julio,Países Bajos,0,2,,2,-75.527794,10.406342
32081,2015,Julio,Países Bajos,1,3,,4,-75.516486,10.446304
32082,2015,Julio,Países Bajos,80,96,,176,-74.77647900000001,10.886686
32083,2015,Julio,Países Bajos,150,260,,410,-76.532004,3.451668
32084,2015,Julio,Países Bajos,893,1146,,2039,-74.140516,4.697157
32085,2015,Julio,Países Bajos,2,6,,8,-75.736374,4.815189
32086,2015,Julio,Países Bajos,397,436,,833,-75.42726,6.170465
32087,2015,Julio,Países Bajos,3,5,,8,-73.181317,7.1280470000000005
32088,2015,Julio,Países Bajos,2,1,,3,-72.508188,7.927233
32089,2015,Julio,Arabia Saudita,0,1,,1,-76.532004,3.451668
32090,2015,Julio,Arabia Saudita,1,6,,7,-74.140516,4.697157
32091,2015,Julio,Arabia Saudita,0,1,,1,-75.42726,6.170465
32092,2015,Julio,Argelia,1,4,,5,-74.140516,4.697157
32093,2015,Julio,Argentina,5,11,,16,-77.35600000000001,0.81488
32094,2015,Julio,Argentina,49,34,,83,-75.516486,10.446304
32095,2015,Julio,Argentina,6,23,,29,-74.77647900000001,10.886686
32096,2015,Julio,Argentina,168,124,,292,-81.70216500000001,12.5862
32097,2015,Julio,Argentina,82,81,,163,-76.532004,3.451668
32098,2015,Julio,Argentina,2437,3107,,5544,-74.140516,4.697157
32099,2015,Julio,Argentina,4,0,,4,-75.736374,4.815189
32100,2015,Julio,Argentina,104,138,,242,-75.42726,6.170465
32101,2015,Julio,Argentina,0,2,,2,-73.181317,7.1280470000000005
32102,2015,Julio,República de Armenia,0,1,,1,-76.532004,3.451668
32103,2015,Julio,Aruba,0,4,,4,-75.527794,10.406342
32104,2015,Julio,Aruba,17,15,,32,-74.77647900000001,10.886686
32105,2015,Julio,Aruba,1,1,,2,-74.765343,10.970933
32106,2015,Julio,Aruba,1,5,,6,-74.213989,11.247722999999999
32107,2015,Julio,Aruba,8,9,,17,-76.532004,3.451668
32108,2015,Julio,Aruba,886,929,,1815,-74.140516,4.697157
32109,2015,Julio,Aruba,5,7,,12,-75.736374,4.815189
32110,2015,Julio,Aruba,99,126,,225,-75.42726,6.170465
32111,2015,Julio,Aruba,2,6,,8,-73.181317,7.1280470000000005
32112,2015,Julio,Aruba,0,1,,1,-72.508188,7.927233
32113,2015,Julio,Australia,1,2,,3,-75.516486,10.446304
32114,2015,Julio,Australia,0,1,,1,-74.77647900000001,10.886686
32115,2015,Julio,Australia,22,30,,52,-76.532004,3.451668
32116,2015,Julio,Australia,17,39,,56,-74.140516,4.697157
32117,2015,Julio,Australia,9,14,,23,-75.42726,6.170465
32118,2015,Julio,Australia,0,1,,1,-73.181317,7.1280470000000005
32119,2015,Julio,Austria,9,17,,26,-76.532004,3.451668
32120,2015,Julio,Austria,26,24,,50,-74.140516,4.697157
32121,2015,Julio,Austria,2,2,,4,-75.736374,4.815189
32122,2015,Julio,Austria,3,5,,8,-75.42726,6.170465
32123,2015,Julio,Azerbaiyán,1,2,,3,-74.140516,4.697157
32124,2015,Julio,Bahamas,1,5,,6,-74.77647900000001,10.886686
32125,2015,Julio,Bahamas,2,6,,8,-76.532004,3.451668
32126,2015,Julio,Bahamas,1,0,,1,-74.140516,4.697157
32127,2015,Julio,Bahamas,1,5,,6,-75.42726,6.170465
32128,2015,Julio,Bahréin,0,1,,1,-75.527794,10.406342
32129,2015,Julio,Bahréin,1,0,,1,-75.516486,10.446304
32130,2015,Julio,Bahréin,1,0,,1,-76.532004,3.451668
32131,2015,Julio,Bahréin,0,1,,1,-74.140516,4.697157
32132,2015,Julio,Bahréin,1,2,,3,-75.42726,6.170465
32133,2015,Julio,Barbados,3,0,,3,-76.532004,3.451668
32134,2015,Julio,Barbados,0,6,,6,-74.140516,4.697157
32135,2015,Julio,Barbados,1,0,,1,-75.42726,6.170465
32136,2015,Julio,República de Belarús,1,1,,2,-72.129595,11.360028999999999
32137,2015,Julio,República de Belarús,1,3,,4,-74.140516,4.697157
32138,2015,Julio,República de Belarús,0,1,,1,-75.42726,6.170465
32139,2015,Julio,República de Belarús,1,2,,3,-72.508188,7.927233
32140,2015,Julio,Bélgica,0,1,,1,-74.77647900000001,10.886686
32141,2015,Julio,Bélgica,10,13,,23,-76.532004,3.451668
32142,2015,Julio,Bélgica,59,70,,129,-74.140516,4.697157
32143,2015,Julio,Bélgica,0,1,,1,-75.736374,4.815189
32144,2015,Julio,Bélgica,12,20,,32,-75.42726,6.170465
32145,2015,Julio,Belice,7,9,,16,-74.140516,4.697157
32146,2015,Julio,Belice,0,4,,4,-73.181317,7.1280470000000005
32147,2015,Julio,Belice,0,1,,1,-72.508188,7.927233
32148,2015,Julio,Benín,0,1,,1,-74.140516,4.697157
32149,2015,Julio,Bolivia,0,1,,1,-77.35600000000001,0.81488
32150,2015,Julio,Bolivia,2,0,,2,-75.516486,10.446304
32151,2015,Julio,Bolivia,0,1,,1,-74.77647900000001,10.886686
32152,2015,Julio,Bolivia,10,10,,20,-81.70216500000001,12.5862
32153,2015,Julio,Bolivia,34,27,,61,-76.532004,3.451668
32154,2015,Julio,Bolivia,450,551,,1001,-74.140516,4.697157
32155,2015,Julio,Bolivia,2,2,,4,-75.736374,4.815189
32156,2015,Julio,Bolivia,22,21,,43,-75.42726,6.170465
32157,2015,Julio,Bolivia,0,1,,1,-73.181317,7.1280470000000005
32158,2015,Julio,Bolivia,0,1,,1,-72.508188,7.927233
32159,2015,Julio,Brasil,151,172,,323,-69.941498,4.191162
32160,2015,Julio,Brasil,0,6,,6,-69.94143100000001,4.214082
32161,2015,Julio,Brasil,1,0,,1,-77.35600000000001,0.81488
32162,2015,Julio,Brasil,0,8,,8,-75.527794,10.406342
32163,2015,Julio,Brasil,37,24,,61,-75.516486,10.446304
32164,2015,Julio,Brasil,7,9,,16,-74.77647900000001,10.886686
32165,2015,Julio,Brasil,204,135,,339,-81.70216500000001,12.5862
32166,2015,Julio,Brasil,57,103,,160,-76.532004,3.451668
32167,2015,Julio,Brasil,4034,5379,,9413,-74.140516,4.697157
32168,2015,Julio,Brasil,1,2,,3,-75.736374,4.815189
32169,2015,Julio,Brasil,82,129,,211,-75.42726,6.170465
32170,2015,Julio,Brasil,1,4,,5,-73.181317,7.1280470000000005
32171,2015,Julio,Brasil,5,0,,5,-72.508188,7.927233
32172,2015,Julio,Bulgaria,1,1,,2,-74.140516,4.697157
32173,2015,Julio,Burundi,0,1,,1,-74.140516,4.697157
32174,2015,Julio,Cabo Verde,1,1,,2,-74.140516,4.697157
32175,2015,Julio,Islas Caimán/Territorio Británico de Ultramar,4,5,,9,-81.70216500000001,12.5862
32176,2015,Julio,Islas Caimán/Territorio Británico de Ultramar,4,4,,8,-81.372937,13.338761300000002
32177,2015,Julio,Islas Caimán/Territorio Británico de Ultramar,1,2,,3,-76.532004,3.451668
32178,2015,Julio,Islas Caimán/Territorio Británico de Ultramar,0,6,,6,-74.140516,4.697157
32179,2015,Julio,Islas Caimán/Territorio Británico de Ultramar,0,1,,1,-75.42726,6.170465
32180,2015,Julio,Camboya,1,0,,1,-74.140516,4.697157
32181,2015,Julio,Canadá,0,3,,3,-75.527794,10.406342
32182,2015,Julio,Canadá,5,10,,15,-75.516486,10.446304
32183,2015,Julio,Canadá,11,16,,27,-74.77647900000001,10.886686
32184,2015,Julio,Canadá,1,1,,2,-81.70216500000001,12.5862
32185,2015,Julio,Canadá,70,78,,148,-76.532004,3.451668
32186,2015,Julio,Canadá,668,885,,1553,-74.140516,4.697157
32187,2015,Julio,Canadá,9,5,,14,-75.736374,4.815189
32188,2015,Julio,Canadá,82,131,,213,-75.42726,6.170465
32189,2015,Julio,Canadá,6,10,,16,-73.181317,7.1280470000000005
32190,2015,Julio,Canadá,8,7,,15,-72.508188,7.927233
32191,2015,Julio,España,3,4,,7,-75.516486,10.446304
32192,2015,Julio,España,4,13,,17,-74.77647900000001,10.886686
32193,2015,Julio,España,0,1,,1,-74.765343,10.970933
32194,2015,Julio,España,2,1,,3,-81.70216500000001,12.5862
32195,2015,Julio,España,590,970,,1560,-76.532004,3.451668
32196,2015,Julio,España,3079,5045,,8124,-74.140516,4.697157
32197,2015,Julio,España,5,9,,14,-75.736374,4.815189
32198,2015,Julio,España,382,670,,1052,-75.42726,6.170465
32199,2015,Julio,España,3,7,,10,-73.181317,7.1280470000000005
32200,2015,Julio,España,2,2,,4,-72.508188,7.927233
32201,2015,Julio,República Del Congo,0,1,,1,-74.140516,4.697157
32202,2015,Julio,República de Corea,2,13,,15,-76.532004,3.451668
32203,2015,Julio,República de Corea,8,16,,24,-74.140516,4.697157
32204,2015,Julio,República de Corea,3,6,,9,-75.42726,6.170465
32205,2015,Julio,República de Corea,0,2,,2,-72.508188,7.927233
32206,2015,Julio,Costa de Marfil,0,2,,2,-76.532004,3.451668
32207,2015,Julio,Costa de Marfil,0,5,,5,-74.140516,4.697157
32208,2015,Julio,Costa Rica,3,7,,10,-75.527794,10.406342
32209,2015,Julio,Costa Rica,4,7,,11,-75.516486,10.446304
32210,2015,Julio,Costa Rica,8,9,,17,-74.77647900000001,10.886686
32211,2015,Julio,Costa Rica,0,6,,6,-74.765343,10.970933
32212,2015,Julio,Costa Rica,0,10,,10,-81.703935,12.574411099999999
32213,2015,Julio,Costa Rica,130,121,,251,-81.70216500000001,12.5862
32214,2015,Julio,Costa Rica,15,27,,42,-76.532004,3.451668
32215,2015,Julio,Costa Rica,942,1497,,2439,-74.140516,4.697157
32216,2015,Julio,Costa Rica,2,3,,5,-75.736374,4.815189
32217,2015,Julio,Costa Rica,99,98,,197,-75.42726,6.170465
32218,2015,Julio,Costa Rica,1,1,,2,-73.181317,7.1280470000000005
32219,2015,Julio,Costa Rica,1,3,,4,-72.508188,7.927233
32220,2015,Julio,Costa Rica,0,1,,1,-76.7333,8.06667
32221,2015,Julio,Croacia,0,1,,1,-76.532004,3.451668
32222,2015,Julio,Croacia,2,5,,7,-74.140516,4.697157
32223,2015,Julio,Cuba,0,2,,2,-75.527794,10.406342
32224,2015,Julio,Cuba,1,1,,2,-75.516486,10.446304
32225,2015,Julio,Cuba,5,7,,12,-74.77647900000001,10.886686
32226,2015,Julio,Cuba,7,9,,16,-81.70216500000001,12.5862
32227,2015,Julio,Cuba,15,28,,43,-76.532004,3.451668
32228,2015,Julio,Cuba,265,378,,643,-74.140516,4.697157
32229,2015,Julio,Cuba,0,7,,7,-75.736374,4.815189
32230,2015,Julio,Cuba,22,32,,54,-75.42726,6.170465
32231,2015,Julio,Cuba,5,1,,6,-73.181317,7.1280470000000005
32232,2015,Julio,Cuba,1,2,,3,-72.508188,7.927233
32233,2015,Julio,República Checa,0,1,,1,-76.532004,3.451668
32234,2015,Julio,República Checa,8,9,,17,-74.140516,4.697157
32235,2015,Julio,República Checa,2,1,,3,-75.42726,6.170465
32236,2015,Julio,República Checa,0,1,,1,-72.508188,7.927233
32237,2015,Julio,Chile,2,2,,4,-77.35600000000001,0.81488
32238,2015,Julio,Chile,15,13,,28,-75.516486,10.446304
32239,2015,Julio,Chile,2,5,,7,-74.77647900000001,10.886686
32240,2015,Julio,Chile,82,71,,153,-81.70216500000001,12.5862
32241,2015,Julio,Chile,30,58,,88,-76.532004,3.451668
32242,2015,Julio,Chile,3956,4864,,8820,-74.140516,4.697157
32243,2015,Julio,Chile,5,3,,8,-75.736374,4.815189
32244,2015,Julio,Chile,26,115,,141,-75.42726,6.170465
32245,2015,Julio,Chile,4,2,,6,-73.181317,7.1280470000000005
32246,2015,Julio,Chile,1,1,,2,-72.508188,7.927233
32247,2015,Julio,China,1,13,,14,-76.532004,3.451668
32248,2015,Julio,China,43,122,,165,-74.140516,4.697157
32249,2015,Julio,China,1,0,,1,-75.736374,4.815189
32250,2015,Julio,China,2,2,,4,-75.42726,6.170465
32251,2015,Julio,Chipre,0,2,,2,-76.532004,3.451668
32252,2015,Julio,Chipre,1,0,,1,-74.140516,4.697157
32253,2015,Julio,Chipre,1,0,,1,-75.42726,6.170465
32254,2015,Julio,Dinamarca,1,0,,1,-75.516486,10.446304
32255,2015,Julio,Dinamarca,11,16,,27,-76.532004,3.451668
32256,2015,Julio,Dinamarca,22,20,,42,-74.140516,4.697157
32257,2015,Julio,Dinamarca,2,1,,3,-75.736374,4.815189
32258,2015,Julio,Dinamarca,1,1,,2,-73.181317,7.1280470000000005
32259,2015,Julio,Dominica,2,2,,4,-74.140516,4.697157
32260,2015,Julio,Ecuador,62,194,,256,-76.876446,0.33002
32261,2015,Julio,Ecuador,2,2,,4,-77.84700600000001,0.8124359999999999
32262,2015,Julio,Ecuador,3392,4637,,8029,-77.35600000000001,0.81488
32263,2015,Julio,Ecuador,18,264,,282,-78.802679,18.00143
32264,2015,Julio,Ecuador,0,14,,14,-75.527794,10.406342
32265,2015,Julio,Ecuador,242,148,,390,-75.516486,10.446304
32266,2015,Julio,Ecuador,6,7,,13,-74.77647900000001,10.886686
32267,2015,Julio,Ecuador,0,1,,1,-74.213989,11.247722999999999
32268,2015,Julio,Ecuador,5,4,,9,-81.70216500000001,12.5862
32269,2015,Julio,Ecuador,400,474,,874,-76.532004,3.451668
32270,2015,Julio,Ecuador,3489,5024,,8513,-74.140516,4.697157
32271,2015,Julio,Ecuador,4,7,,11,-75.736374,4.815189
32272,2015,Julio,Ecuador,35,35,,70,-75.42726,6.170465
32273,2015,Julio,Ecuador,4,8,,12,-72.508188,7.927233
32274,2015,Julio,Egipto,7,4,,11,-74.140516,4.697157
32275,2015,Julio,Egipto,1,0,,1,-75.42726,6.170465
32276,2015,Julio,El Salvador,1,0,,1,-74.77647900000001,10.886686
32277,2015,Julio,El Salvador,45,48,,93,-81.70216500000001,12.5862
32278,2015,Julio,El Salvador,121,156,,277,-76.532004,3.451668
32279,2015,Julio,El Salvador,921,1376,,2297,-74.140516,4.697157
32280,2015,Julio,El Salvador,0,1,,1,-75.736374,4.815189
32281,2015,Julio,El Salvador,141,256,,397,-75.42726,6.170465
32282,2015,Julio,El Salvador,0,2,,2,-72.508188,7.927233
32283,2015,Julio,Emiratos Árabes,1,1,,2,-76.532004,3.451668
32284,2015,Julio,Emiratos Árabes,8,19,,27,-74.140516,4.697157
32285,2015,Julio,Emiratos Árabes,0,1,,1,-75.42726,6.170465
32286,2015,Julio,Eslovaquia,0,2,,2,-74.140516,4.697157
32287,2015,Julio,Eslovaquia,1,1,,2,-75.42726,6.170465
32288,2015,Julio,Eslovenia,1,1,,2,-76.532004,3.451668
32289,2015,Julio,Eslovenia,2,5,,7,-74.140516,4.697157
32290,2015,Julio,Estados Unidos de América,1,34,,35,-75.527794,10.406342
32291,2015,Julio,Estados Unidos de América,2957,4029,,6986,-75.516486,10.446304
32292,2015,Julio,Estados Unidos de América,810,1140,,1950,-74.77647900000001,10.886686
32293,2015,Julio,Estados Unidos de América,0,3,,3,-74.765343,10.970933
32294,2015,Julio,Estados Unidos de América,0,28,,28,-74.213989,11.247722999999999
32295,2015,Julio,Estados Unidos de América,32,52,,84,-81.70216500000001,12.5862
32296,2015,Julio,Estados Unidos de América,1708,2178,,3886,-76.532004,3.451668
32297,2015,Julio,Estados Unidos de América,0,1,,1,-77.061029,3.8844260000000004
32298,2015,Julio,Estados Unidos de América,146,217,,363,-75.76635300000001,4.45285
32299,2015,Julio,Estados Unidos de América,11496,17508,,29004,-74.140516,4.697157
32300,2015,Julio,Estados Unidos de América,300,392,,692,-75.736374,4.815189
32301,2015,Julio,Estados Unidos de América,3266,5544,,8810,-75.42726,6.170465
32302,2015,Julio,Estados Unidos de América,90,110,,200,-73.181317,7.1280470000000005
32303,2015,Julio,Estados Unidos de América,83,64,,147,-72.508188,7.927233
32304,2015,Julio,Estados Unidos de América,0,2,,2,-75.68164200000001,9.402597
32305,2015,Julio,Estonia,1,1,,2,-74.140516,4.697157
32306,2015,Julio,Etiopia,5,8,,13,-74.140516,4.697157
32307,2015,Julio,Filipinas,0,4,,4,-75.516486,10.446304
32308,2015,Julio,Filipinas,0,3,,3,-74.77647900000001,10.886686
32309,2015,Julio,Filipinas,2,3,,5,-74.140516,4.697157
32310,2015,Julio,Filipinas,0,1,,1,-75.42726,6.170465
32311,2015,Julio,Finlandia,14,3,,17,-76.532004,3.451668
32312,2015,Julio,Finlandia,2,8,,10,-74.140516,4.697157
32313,2015,Julio,Finlandia,2,1,,3,-75.42726,6.170465
32314,2015,Julio,Francia,3,5,,8,-74.77647900000001,10.886686
32315,2015,Julio,Francia,92,136,,228,-76.532004,3.451668
32316,2015,Julio,Francia,1612,2526,,4138,-74.140516,4.697157
32317,2015,Julio,Francia,2,6,,8,-75.736374,4.815189
32318,2015,Julio,Francia,46,69,,115,-75.42726,6.170465
32319,2015,Julio,Francia,5,8,,13,-73.181317,7.1280470000000005
32320,2015,Julio,Georgia,1,0,,1,-76.532004,3.451668
32321,2015,Julio,Georgia,0,1,,1,-74.140516,4.697157
32322,2015,Julio,Ghana,0,3,,3,-74.140516,4.697157
32323,2015,Julio,Gibraltar/Territorio Británico de Ultramar,2,1,,3,-77.35600000000001,0.81488
32324,2015,Julio,Granada,1,0,,1,-76.532004,3.451668
32325,2015,Julio,Granada,0,1,,1,-74.140516,4.697157
32326,2015,Julio,Grecia,9,6,,15,-74.140516,4.697157
32327,2015,Julio,Grecia,3,2,,5,-72.508188,7.927233
32328,2015,Julio,Guatemala,8,11,,19,-75.516486,10.446304
32329,2015,Julio,Guatemala,6,11,,17,-74.77647900000001,10.886686
32330,2015,Julio,Guatemala,42,49,,91,-81.70216500000001,12.5862
32331,2015,Julio,Guatemala,27,56,,83,-76.532004,3.451668
32332,2015,Julio,Guatemala,281,589,,870,-74.140516,4.697157
32333,2015,Julio,Guatemala,1,5,,6,-75.736374,4.815189
32334,2015,Julio,Guatemala,47,65,,112,-75.42726,6.170465
32335,2015,Julio,Guatemala,1,4,,5,-73.181317,7.1280470000000005
32336,2015,Julio,Guatemala,2,1,,3,-72.508188,7.927233
32337,2015,Julio,Guyana,0,1,,1,-74.140516,4.697157
32338,2015,Julio,Guinea Bissau,0,2,,2,-76.532004,3.451668
32339,2015,Julio,Guadalupe/Territorio Francés,1,5,,6,-74.140516,4.697157
32340,2015,Julio,Guadalupe/Territorio Francés,1,1,,2,-75.42726,6.170465
32341,2015,Julio,Guayana Francesa/Departamento de Ultramar Francés,2,2,,4,-75.42726,6.170465
32342,2015,Julio,Haití,1,1,,2,-75.527794,10.406342
32343,2015,Julio,Haití,0,5,,5,-75.516486,10.446304
32344,2015,Julio,Haití,0,1,,1,-74.77647900000001,10.886686
32345,2015,Julio,Haití,2,4,,6,-74.140516,4.697157
32346,2015,Julio,Haití,0,1,,1,-75.736374,4.815189
32347,2015,Julio,Haití,0,1,,1,-75.42726,6.170465
32348,2015,Julio,Haití,0,1,,1,-72.508188,7.927233
32349,2015,Julio,Honduras,0,1,,1,-75.516486,10.446304
32350,2015,Julio,Honduras,6,5,,11,-74.77647900000001,10.886686
32351,2015,Julio,Honduras,0,59,,59,-81.703935,12.574411099999999
32352,2015,Julio,Honduras,0,3,,3,-81.70216500000001,12.5862
32353,2015,Julio,Honduras,12,14,,26,-76.532004,3.451668
32354,2015,Julio,Honduras,61,69,,130,-74.140516,4.697157
32355,2015,Julio,Honduras,22,31,,53,-75.42726,6.170465
32356,2015,Julio,Honduras,0,2,,2,-72.508188,7.927233
32357,2015,Julio,Hong Kong,7,6,,13,-74.140516,4.697157
32358,2015,Julio,Hong Kong,0,1,,1,-75.42726,6.170465
32359,2015,Julio,Hungría,0,1,,1,-76.532004,3.451668
32360,2015,Julio,Hungría,11,4,,15,-74.140516,4.697157
32361,2015,Julio,Hungría,0,2,,2,-75.42726,6.170465
32362,2015,Julio,India,0,2,,2,-74.77647900000001,10.886686
32363,2015,Julio,India,0,9,,9,-76.532004,3.451668
32364,2015,Julio,India,1,31,,32,-74.140516,4.697157
32365,2015,Julio,India,0,1,,1,-75.736374,4.815189
32366,2015,Julio,India,1,1,,2,-75.42726,6.170465
32367,2015,Julio,Indonesia,4,11,,15,-74.140516,4.697157
32368,2015,Julio,Iraq,0,1,,1,-74.140516,4.697157
32369,2015,Julio,Irán,2,0,,2,-74.140516,4.697157
32370,2015,Julio,República de Irlanda,0,1,,1,-75.516486,10.446304
32371,2015,Julio,República de Irlanda,3,2,,5,-76.532004,3.451668
32372,2015,Julio,República de Irlanda,12,8,,20,-74.140516,4.697157
32373,2015,Julio,República de Irlanda,0,3,,3,-75.42726,6.170465
32374,2015,Julio,Islandia,0,2,,2,-75.42726,6.170465
32375,2015,Julio,Israel,0,1,,1,-75.516486,10.446304
32376,2015,Julio,Israel,3,2,,5,-74.77647900000001,10.886686
32377,2015,Julio,Israel,0,3,,3,-76.532004,3.451668
32378,2015,Julio,Israel,21,68,,89,-74.140516,4.697157
32379,2015,Julio,Israel,0,3,,3,-75.42726,6.170465
32380,2015,Julio,Italia,3,6,,9,-74.77647900000001,10.886686
32381,2015,Julio,Italia,40,93,,133,-76.532004,3.451668
32382,2015,Julio,Italia,126,242,,368,-74.140516,4.697157
32383,2015,Julio,Italia,1,1,,2,-75.736374,4.815189
32384,2015,Julio,Italia,16,34,,50,-75.42726,6.170465
32385,2015,Julio,Italia,1,1,,2,-73.181317,7.1280470000000005
32386,2015,Julio,Jamaica,2,6,,8,-75.527794,10.406342
32387,2015,Julio,Jamaica,1,3,,4,-75.516486,10.446304
32388,2015,Julio,Jamaica,0,6,,6,-74.77647900000001,10.886686
32389,2015,Julio,Jamaica,0,1,,1,-74.765343,10.970933
32390,2015,Julio,Jamaica,0,4,,4,-81.703935,12.574411099999999
32391,2015,Julio,Jamaica,16,18,,34,-76.532004,3.451668
32392,2015,Julio,Jamaica,8,9,,17,-74.140516,4.697157
32393,2015,Julio,Jamaica,0,3,,3,-75.42726,6.170465
32394,2015,Julio,Japón,0,1,,1,-74.77647900000001,10.886686
32395,2015,Julio,Japón,8,14,,22,-76.532004,3.451668
32396,2015,Julio,Japón,13,26,,39,-74.140516,4.697157
32397,2015,Julio,Japón,0,4,,4,-75.42726,6.170465
32398,2015,Julio,Japón,0,1,,1,-72.508188,7.927233
32399,2015,Julio,Jordania,2,1,,3,-74.140516,4.697157
32400,2015,Julio,Kazajistán,3,0,,3,-76.532004,3.451668
32401,2015,Julio,Kenia,1,0,,1,-74.77647900000001,10.886686
32402,2015,Julio,Kenia,12,21,,33,-76.532004,3.451668
32403,2015,Julio,Kenia,0,5,,5,-74.140516,4.697157
32404,2015,Julio,Kiribati,0,1,,1,-74.140516,4.697157
32405,2015,Julio,Kuwait,0,2,,2,-76.532004,3.451668
32406,2015,Julio,Lesoto,1,1,,2,-74.140516,4.697157
32407,2015,Julio,Letonia,5,2,,7,-76.532004,3.451668
32408,2015,Julio,Letonia,3,2,,5,-74.140516,4.697157
32409,2015,Julio,Lituania,0,2,,2,-74.140516,4.697157
32410,2015,Julio,Líbano,5,4,,9,-74.140516,4.697157
32411,2015,Julio,Luxemburgo,1,0,,1,-76.532004,3.451668
32412,2015,Julio,Luxemburgo,2,3,,5,-74.140516,4.697157
32413,2015,Julio,Macedonia,0,1,,1,-74.140516,4.697157
32414,2015,Julio,Malasia,1,2,,3,-74.140516,4.697157
32415,2015,Julio,Malta,1,0,,1,-74.140516,4.697157
32416,2015,Julio,Marruecos,0,1,,1,-76.532004,3.451668
32417,2015,Julio,Marruecos,0,1,,1,-74.140516,4.697157
32418,2015,Julio,Marruecos,0,2,,2,-75.42726,6.170465
32419,2015,Julio,Martinica/Departamento de Ultramar Francés,0,1,,1,-73.181317,7.1280470000000005
32420,2015,Julio,México,0,4,,4,-75.527794,10.406342
32421,2015,Julio,México,24,28,,52,-75.516486,10.446304
32422,2015,Julio,México,36,45,,81,-74.77647900000001,10.886686
32423,2015,Julio,México,0,6,,6,-74.765343,10.970933
32424,2015,Julio,México,0,1,,1,-74.213989,11.247722999999999
32425,2015,Julio,México,0,3,,3,-81.703935,12.574411099999999
32426,2015,Julio,México,13,9,,22,-81.70216500000001,12.5862
32427,2015,Julio,México,66,101,,167,-76.532004,3.451668
32428,2015,Julio,México,5683,8700,,14383,-74.140516,4.697157
32429,2015,Julio,México,8,13,,21,-75.736374,4.815189
32430,2015,Julio,México,848,1673,,2521,-75.42726,6.170465
32431,2015,Julio,México,18,15,,33,-73.181317,7.1280470000000005
32432,2015,Julio,México,22,18,,40,-72.508188,7.927233
32433,2015,Julio,República de Moldavia,0,1,,1,-76.532004,3.451668
32434,2015,Julio,Nauru,0,1,,1,-74.140516,4.697157
32435,2015,Julio,Namibia,1,1,,2,-74.140516,4.697157
32436,2015,Julio,Nepal,1,0,,1,-74.140516,4.697157
32437,2015,Julio,Nicaragua,0,3,,3,-74.77647900000001,10.886686
32438,2015,Julio,Nicaragua,3,7,,10,-81.70216500000001,12.5862
32439,2015,Julio,Nicaragua,10,27,,37,-76.532004,3.451668
32440,2015,Julio,Nicaragua,21,37,,58,-74.140516,4.697157
32441,2015,Julio,Nicaragua,4,6,,10,-75.736374,4.815189
32442,2015,Julio,Nicaragua,4,7,,11,-75.42726,6.170465
32443,2015,Julio,Nicaragua,3,3,,6,-72.508188,7.927233
32444,2015,Julio,Nigeria,0,1,,1,-76.532004,3.451668
32445,2015,Julio,Nigeria,0,3,,3,-74.140516,4.697157
32446,2015,Julio,Nigeria,0,1,,1,-75.42726,6.170465
32447,2015,Julio,Noruega,19,14,,33,-76.532004,3.451668
32448,2015,Julio,Noruega,38,23,,61,-74.140516,4.697157
32449,2015,Julio,Noruega,3,5,,8,-75.42726,6.170465
32450,2015,Julio,Nueva Zelanda,3,2,,5,-76.532004,3.451668
32451,2015,Julio,Nueva Zelanda,2,4,,6,-74.140516,4.697157
32452,2015,Julio,Nueva Zelanda,2,1,,3,-75.42726,6.170465
32453,2015,Julio,Omán,0,1,,1,-76.532004,3.451668
32454,2015,Julio,Omán,0,1,,1,-74.140516,4.697157
32455,2015,Julio,Panamá,144,256,,400,-75.527794,10.406342
32456,2015,Julio,Panamá,1721,1994,,3715,-75.516486,10.446304
32457,2015,Julio,Panamá,252,489,,741,-74.77647900000001,10.886686
32458,2015,Julio,Panamá,0,20,,20,-74.765343,10.970933
32459,2015,Julio,Panamá,0,1,,1,-81.703935,12.574411099999999
32460,2015,Julio,Panamá,70,110,,180,-81.70216500000001,12.5862
32461,2015,Julio,Panamá,233,418,,651,-76.532004,3.451668
32462,2015,Julio,Panamá,2,24,,26,-77.061029,3.8844260000000004
32463,2015,Julio,Panamá,3639,5502,,9141,-74.140516,4.697157
32464,2015,Julio,Panamá,50,92,,142,-75.736374,4.815189
32465,2015,Julio,Panamá,1293,2028,,3321,-75.42726,6.170465
32466,2015,Julio,Panamá,1,1,,2,-77.401154,6.222551999999999
32467,2015,Julio,Panamá,0,3,,3,-77.762647,7.102626
32468,2015,Julio,Panamá,18,49,,67,-73.181317,7.1280470000000005
32469,2015,Julio,Panamá,120,149,,269,-72.508188,7.927233
32470,2015,Julio,Panamá,119,133,,252,-77.35002,8.63337
32471,2015,Julio,Paraguay,4,3,,7,-75.516486,10.446304
32472,2015,Julio,Paraguay,39,28,,67,-81.70216500000001,12.5862
32473,2015,Julio,Paraguay,4,8,,12,-76.532004,3.451668
32474,2015,Julio,Paraguay,28,31,,59,-74.140516,4.697157
32475,2015,Julio,Paraguay,11,7,,18,-75.42726,6.170465
32476,2015,Julio,Perú,197,323,,520,-69.941498,4.191162
32477,2015,Julio,Perú,1,1,,2,-69.94143100000001,4.214082
32478,2015,Julio,Perú,7,23,,30,-77.35600000000001,0.81488
32479,2015,Julio,Perú,0,13,,13,-78.802679,18.00143
32480,2015,Julio,Perú,24,14,,38,-75.516486,10.446304
32481,2015,Julio,Perú,0,1,,1,-74.77647900000001,10.886686
32482,2015,Julio,Perú,177,165,,342,-81.70216500000001,12.5862
32483,2015,Julio,Perú,307,400,,707,-76.532004,3.451668
32484,2015,Julio,Perú,6744,8406,,15150,-74.140516,4.697157
32485,2015,Julio,Perú,4,1,,5,-75.736374,4.815189
32486,2015,Julio,Perú,396,573,,969,-75.42726,6.170465
32487,2015,Julio,Perú,3,2,,5,-72.508188,7.927233
32488,2015,Julio,Polonia,7,6,,13,-76.532004,3.451668
32489,2015,Julio,Polonia,10,16,,26,-74.140516,4.697157
32490,2015,Julio,Polonia,0,1,,1,-75.736374,4.815189
32491,2015,Julio,Polonia,1,0,,1,-75.42726,6.170465
32492,2015,Julio,Portugal,3,7,,10,-76.532004,3.451668
32493,2015,Julio,Portugal,474,683,,1157,-74.140516,4.697157
32494,2015,Julio,Portugal,1,5,,6,-75.42726,6.170465
32495,2015,Julio,Portugal,1,0,,1,-73.181317,7.1280470000000005
32496,2015,Julio,Puerto Rico/Territorio de Estados Unidos,0,1,,1,-75.527794,10.406342
32497,2015,Julio,Puerto Rico/Territorio de Estados Unidos,3,5,,8,-75.516486,10.446304
32498,2015,Julio,Puerto Rico/Territorio de Estados Unidos,2,22,,24,-74.77647900000001,10.886686
32499,2015,Julio,Puerto Rico/Territorio de Estados Unidos,7,2,,9,-81.70216500000001,12.5862
32500,2015,Julio,Puerto Rico/Territorio de Estados Unidos,24,62,,86,-76.532004,3.451668
32501,2015,Julio,Puerto Rico/Territorio de Estados Unidos,416,508,,924,-74.140516,4.697157
32502,2015,Julio,Puerto Rico/Territorio de Estados Unidos,15,18,,33,-75.736374,4.815189
32503,2015,Julio,Puerto Rico/Territorio de Estados Unidos,43,105,,148,-75.42726,6.170465
32504,2015,Julio,Puerto Rico/Territorio de Estados Unidos,4,7,,11,-73.181317,7.1280470000000005
32505,2015,Julio,Puerto Rico/Territorio de Estados Unidos,9,12,,21,-72.508188,7.927233
32506,2015,Julio,Qatar,0,2,,2,-76.532004,3.451668
32507,2015,Julio,Qatar,0,2,,2,-74.140516,4.697157
32508,2015,Julio,Qatar,1,1,,2,-75.42726,6.170465
32509,2015,Julio,Reino Unido de Gran Bretaña e Irlanda del Norte,3,2,,5,-75.516486,10.446304
32510,2015,Julio,Reino Unido de Gran Bretaña e Irlanda del Norte,1,0,,1,-74.77647900000001,10.886686
32511,2015,Julio,Reino Unido de Gran Bretaña e Irlanda del Norte,29,33,,62,-76.532004,3.451668
32512,2015,Julio,Reino Unido de Gran Bretaña e Irlanda del Norte,844,1197,,2041,-74.140516,4.697157
32513,2015,Julio,Reino Unido de Gran Bretaña e Irlanda del Norte,0,1,,1,-75.736374,4.815189
32514,2015,Julio,Reino Unido de Gran Bretaña e Irlanda del Norte,10,20,,30,-75.42726,6.170465
32515,2015,Julio,Reino Unido de Gran Bretaña e Irlanda del Norte,4,5,,9,-73.181317,7.1280470000000005
32516,2015,Julio,Reino Unido de Gran Bretaña e Irlanda del Norte,1,1,,2,-72.508188,7.927233
32517,2015,Julio,República CentroÁfricana,1,0,,1,-74.140516,4.697157
32518,2015,Julio,Federación de Rusia,2,1,,3,-76.532004,3.451668
32519,2015,Julio,Federación de Rusia,26,42,,68,-74.140516,4.697157
32520,2015,Julio,Federación de Rusia,0,2,,2,-75.736374,4.815189
32521,2015,Julio,Federación de Rusia,1,0,,1,-75.42726,6.170465
32522,2015,Julio,República Dominicana,0,6,,6,-75.527794,10.406342
32523,2015,Julio,República Dominicana,4,3,,7,-75.516486,10.446304
32524,2015,Julio,República Dominicana,5,11,,16,-74.77647900000001,10.886686
32525,2015,Julio,República Dominicana,0,5,,5,-74.765343,10.970933
32526,2015,Julio,República Dominicana,0,1,,1,-74.232675,11.117206
32527,2015,Julio,República Dominicana,0,1,,1,-74.213989,11.247722999999999
32528,2015,Julio,República Dominicana,2,1,,3,-81.70216500000001,12.5862
32529,2015,Julio,República Dominicana,18,39,,57,-76.532004,3.451668
32530,2015,Julio,República Dominicana,480,734,,1214,-74.140516,4.697157
32531,2015,Julio,República Dominicana,3,6,,9,-75.736374,4.815189
32532,2015,Julio,República Dominicana,45,55,,100,-75.42726,6.170465
32533,2015,Julio,República Dominicana,5,17,,22,-73.181317,7.1280470000000005
32534,2015,Julio,República Dominicana,1,3,,4,-72.508188,7.927233
32535,2015,Julio,Reunión,2,1,,3,-74.140516,4.697157
32536,2015,Julio,Rumania,2,5,,7,-76.532004,3.451668
32537,2015,Julio,Rumania,4,6,,10,-74.140516,4.697157
32538,2015,Julio,Rumania,0,1,,1,-75.42726,6.170465
32539,2015,Julio,San Cristóbal y Nevis,3,2,,5,-76.532004,3.451668
32540,2015,Julio,San Cristóbal y Nevis,0,1,,1,-74.140516,4.697157
32541,2015,Julio,San Marino,1,1,,2,-74.140516,4.697157
32542,2015,Julio,San  Vicente y las Granadinas,2,0,,2,-76.532004,3.451668
32543,2015,Julio,San  Vicente y las Granadinas,2,0,,2,-75.42726,6.170465
32544,2015,Julio,Santa Lucia,1,1,,2,-76.532004,3.451668
32545,2015,Julio,Santa Lucia,1,3,,4,-74.140516,4.697157
32546,2015,Julio,Santo Tomé y Príncipe,0,1,,1,-74.140516,4.697157
32547,2015,Julio,Santo Tomé y Príncipe,2,0,,2,-75.736374,4.815189
32548,2015,Julio,Senegal,1,1,,2,-76.532004,3.451668
32549,2015,Julio,Senegal,2,0,,2,-74.140516,4.697157
32550,2015,Julio,Serbia,3,6,,9,-74.140516,4.697157
32551,2015,Julio,Singapur,1,3,,4,-76.532004,3.451668
32552,2015,Julio,Singapur,1,6,,7,-74.140516,4.697157
32553,2015,Julio,Sri Lanka,1,1,,2,-76.532004,3.451668
32554,2015,Julio,Sudáfrica,3,2,,5,-76.532004,3.451668
32555,2015,Julio,Sudáfrica,8,11,,19,-74.140516,4.697157
32556,2015,Julio,Sudán,1,0,,1,-74.140516,4.697157
32557,2015,Julio,Suecia,1,2,,3,-74.77647900000001,10.886686
32558,2015,Julio,Suecia,15,28,,43,-76.532004,3.451668
32559,2015,Julio,Suecia,23,28,,51,-74.140516,4.697157
32560,2015,Julio,Suecia,3,6,,9,-75.42726,6.170465
32561,2015,Julio,Suiza,0,1,,1,-74.77647900000001,10.886686
32562,2015,Julio,Suiza,33,69,,102,-76.532004,3.451668
32563,2015,Julio,Suiza,179,180,,359,-74.140516,4.697157
32564,2015,Julio,Suiza,3,2,,5,-75.736374,4.815189
32565,2015,Julio,Suiza,15,25,,40,-75.42726,6.170465
32566,2015,Julio,Suiza,1,0,,1,-73.181317,7.1280470000000005
32567,2015,Julio,Surinam,1,1,,2,-74.140516,4.697157
32568,2015,Julio,Taiwán,2,5,,7,-74.140516,4.697157
32569,2015,Julio,Taiwán,0,2,,2,-75.42726,6.170465
32570,2015,Julio,Taiwán,2,0,,2,-72.508188,7.927233
32571,2015,Julio,Tailandia,1,0,,1,-76.532004,3.451668
32572,2015,Julio,Tailandia,0,1,,1,-74.140516,4.697157
32573,2015,Julio,Togo,0,1,,1,-74.140516,4.697157
32574,2015,Julio,Trinidad y Tobago,1,9,,10,-75.527794,10.406342
32575,2015,Julio,Trinidad y Tobago,0,1,,1,-75.516486,10.446304
32576,2015,Julio,Trinidad y Tobago,0,1,,1,-74.765343,10.970933
32577,2015,Julio,Trinidad y Tobago,13,12,,25,-76.532004,3.451668
32578,2015,Julio,Trinidad y Tobago,11,13,,24,-74.140516,4.697157
32579,2015,Julio,Trinidad y Tobago,2,1,,3,-75.736374,4.815189
32580,2015,Julio,Trinidad y Tobago,9,8,,17,-75.42726,6.170465
32581,2015,Julio,Trinidad y Tobago,1,3,,4,-73.181317,7.1280470000000005
32582,2015,Julio,Trinidad y Tobago,0,1,,1,-72.508188,7.927233
32583,2015,Julio,Túnez,0,3,,3,-74.140516,4.697157
32584,2015,Julio,Turquía,6,14,,20,-76.532004,3.451668
32585,2015,Julio,Turquía,7,15,,22,-74.140516,4.697157
32586,2015,Julio,Turquía,0,2,,2,-75.42726,6.170465
32587,2015,Julio,Ucrania,0,1,,1,-74.77647900000001,10.886686
32588,2015,Julio,Ucrania,1,1,,2,-76.532004,3.451668
32589,2015,Julio,Ucrania,7,6,,13,-74.140516,4.697157
32590,2015,Julio,Ucrania,1,0,,1,-73.181317,7.1280470000000005
32591,2015,Julio,Uganda,2,2,,4,-76.532004,3.451668
32592,2015,Julio,Uganda,0,1,,1,-75.42726,6.170465
32593,2015,Julio,Uruguay,2,0,,2,-77.35600000000001,0.81488
32594,2015,Julio,Uruguay,16,13,,29,-75.516486,10.446304
32595,2015,Julio,Uruguay,0,3,,3,-74.77647900000001,10.886686
32596,2015,Julio,Uruguay,41,36,,77,-81.70216500000001,12.5862
32597,2015,Julio,Uruguay,5,21,,26,-76.532004,3.451668
32598,2015,Julio,Uruguay,68,80,,148,-74.140516,4.697157
32599,2015,Julio,Uruguay,15,20,,35,-75.42726,6.170465
32600,2015,Julio,Uruguay,1,1,,2,-73.181317,7.1280470000000005
32601,2015,Julio,Uzbekistán,1,2,,3,-76.532004,3.451668
32602,2015,Julio,Venezuela,0,7,,7,-75.527794,10.406342
32603,2015,Julio,Venezuela,431,374,,805,-75.516486,10.446304
32604,2015,Julio,Venezuela,22,95,,117,-74.77647900000001,10.886686
32605,2015,Julio,Venezuela,0,6,,6,-74.765343,10.970933
32606,2015,Julio,Venezuela,0,5,,5,-74.232675,11.117206
32607,2015,Julio,Venezuela,2696,3355,,6051,-72.129595,11.360028999999999
32608,2015,Julio,Venezuela,2,0,,2,-81.70216500000001,12.5862
32609,2015,Julio,Venezuela,14,20,,34,-76.532004,3.451668
32610,2015,Julio,Venezuela,37,65,,102,-67.927521,3.866713
32611,2015,Julio,Venezuela,3920,4566,,8486,-74.140516,4.697157
32612,2015,Julio,Venezuela,7,8,,15,-75.736374,4.815189
32613,2015,Julio,Venezuela,856,898,,1754,-75.42726,6.170465
32614,2015,Julio,Venezuela,389,646,,1035,-67.48402800000001,6.185536
32615,2015,Julio,Venezuela,70,115,,185,-70.74025300000001,7.088728999999999
32616,2015,Julio,Venezuela,1,1,,2,-73.181317,7.1280470000000005
32617,2015,Julio,Venezuela,4365,4980,,9345,-72.453013,7.819
32618,2015,Julio,Venezuela,342,315,,657,-72.508188,7.927233
32619,2015,Julio,Vietnam,1,1,,2,-74.140516,4.697157
32620,2015,Julio,Islas Vírgenes Británicas/Territorio Británico de Ultramar,0,1,,1,-74.140516,4.697157
32621,2015,Julio,Zambia,0,2,,2,-76.532004,3.451668
32622,2015,Julio,Zimbabue,1,1,,2,-74.140516,4.697157
32623,2015,Julio,Anguila/Territorio Británico de Ultramar,0,3,,3,-75.516486,10.446304
32624,2015,Julio,Anguila/Territorio Británico de Ultramar,1,0,,1,-76.532004,3.451668
32625,2015,Julio,Desconocido,8,11,,19,-75.527794,10.406342
32626,2015,Julio,Desconocido,0,1,,1,-76.532004,3.451668
32627,2015,Julio,Desconocido,5,46,,51,-74.140516,4.697157
32628,2015,Julio,Desconocido,0,1,,1,-75.42726,6.170465
32629,2015,Julio,Desconocido,0,12,,12,-75.68164200000001,9.402597
32630,2015,Agosto,Afganistán,0,4,,4,-74.140516,4.697157
32631,2015,Agosto,Alemania,1,0,,1,-77.35600000000001,0.81488
32632,2015,Agosto,Alemania,0,1,,1,-75.516486,10.446304
32633,2015,Agosto,Alemania,4,3,,7,-74.77647900000001,10.886686
32634,2015,Agosto,Alemania,60,76,,136,-76.532004,3.451668
32635,2015,Agosto,Alemania,1857,2506,,4363,-74.140516,4.697157
32636,2015,Agosto,Alemania,0,1,,1,-75.736374,4.815189
32637,2015,Agosto,Alemania,35,31,,66,-75.42726,6.170465
32638,2015,Agosto,Alemania,0,1,,1,-73.181317,7.1280470000000005
32639,2015,Agosto,Andorra,1,0,,1,-74.77647900000001,10.886686
32640,2015,Agosto,Angola,0,1,,1,-74.140516,4.697157
32641,2015,Agosto,Antigua y Barbuda,0,1,,1,-75.527794,10.406342
32642,2015,Agosto,Antigua y Barbuda,0,9,,9,-75.516486,10.446304
32643,2015,Agosto,Antigua y Barbuda,0,3,,3,-74.140516,4.697157
32644,2015,Agosto,Países Bajos,2,3,,5,-75.527794,10.406342
32645,2015,Agosto,Países Bajos,0,1,,1,-75.516486,10.446304
32646,2015,Agosto,Países Bajos,50,65,,115,-74.77647900000001,10.886686
32647,2015,Agosto,Países Bajos,0,29,,29,-74.765343,10.970933
32648,2015,Agosto,Países Bajos,8,8,,16,-74.213989,11.247722999999999
32649,2015,Agosto,Países Bajos,68,112,,180,-76.532004,3.451668
32650,2015,Agosto,Países Bajos,740,1077,,1817,-74.140516,4.697157
32651,2015,Agosto,Países Bajos,147,213,,360,-75.42726,6.170465
32652,2015,Agosto,Países Bajos,3,2,,5,-73.181317,7.1280470000000005
32653,2015,Agosto,Arabia Saudita,0,1,,1,-74.140516,4.697157
32654,2015,Agosto,Arabia Saudita,0,1,,1,-75.42726,6.170465
32655,2015,Agosto,Argelia,0,1,,1,-74.140516,4.697157
32656,2015,Agosto,Argelia,0,1,,1,-75.42726,6.170465
32657,2015,Agosto,Argentina,8,9,,17,-77.35600000000001,0.81488
32658,2015,Agosto,Argentina,49,35,,84,-75.516486,10.446304
32659,2015,Agosto,Argentina,2,13,,15,-74.77647900000001,10.886686
32660,2015,Agosto,Argentina,267,178,,445,-81.70216500000001,12.5862
32661,2015,Agosto,Argentina,57,94,,151,-76.532004,3.451668
32662,2015,Agosto,Argentina,0,8,,8,-77.061029,3.8844260000000004
32663,2015,Agosto,Argentina,2039,2946,,4985,-74.140516,4.697157
32664,2015,Agosto,Argentina,5,3,,8,-75.736374,4.815189
32665,2015,Agosto,Argentina,101,176,,277,-75.42726,6.170465
32666,2015,Agosto,Argentina,2,2,,4,-73.181317,7.1280470000000005
32667,2015,Agosto,Argentina,0,1,,1,-72.508188,7.927233
32668,2015,Agosto,República de Armenia,1,0,,1,-74.140516,4.697157
32669,2015,Agosto,Aruba,0,14,,14,-75.527794,10.406342
32670,2015,Agosto,Aruba,0,1,,1,-75.516486,10.446304
32671,2015,Agosto,Aruba,1,3,,4,-74.77647900000001,10.886686
32672,2015,Agosto,Aruba,0,6,,6,-74.765343,10.970933
32673,2015,Agosto,Aruba,10,13,,23,-74.213989,11.247722999999999
32674,2015,Agosto,Aruba,5,2,,7,-76.532004,3.451668
32675,2015,Agosto,Aruba,633,760,,1393,-74.140516,4.697157
32676,2015,Agosto,Aruba,0,1,,1,-75.736374,4.815189
32677,2015,Agosto,Aruba,72,100,,172,-75.42726,6.170465
32678,2015,Agosto,Aruba,7,7,,14,-73.181317,7.1280470000000005
32679,2015,Agosto,Australia,2,0,,2,-74.77647900000001,10.886686
32680,2015,Agosto,Australia,2,3,,5,-76.532004,3.451668
32681,2015,Agosto,Australia,15,40,,55,-74.140516,4.697157
32682,2015,Agosto,Australia,1,0,,1,-75.736374,4.815189
32683,2015,Agosto,Australia,5,12,,17,-75.42726,6.170465
32684,2015,Agosto,Australia,0,1,,1,-73.181317,7.1280470000000005
32685,2015,Agosto,Austria,1,0,,1,-75.516486,10.446304
32686,2015,Agosto,Austria,1,0,,1,-74.77647900000001,10.886686
32687,2015,Agosto,Austria,4,0,,4,-76.532004,3.451668
32688,2015,Agosto,Austria,24,27,,51,-74.140516,4.697157
32689,2015,Agosto,Austria,3,1,,4,-75.42726,6.170465
32690,2015,Agosto,Bahamas,0,1,,1,-75.527794,10.406342
32691,2015,Agosto,Bahamas,1,1,,2,-74.77647900000001,10.886686
32692,2015,Agosto,Bahamas,0,1,,1,-75.42726,6.170465
32693,2015,Agosto,Bahréin,2,1,,3,-74.140516,4.697157
32694,2015,Agosto,Bahréin,0,1,,1,-75.42726,6.170465
32695,2015,Agosto,Barbados,0,1,,1,-75.516486,10.446304
32696,2015,Agosto,Barbados,1,0,,1,-74.140516,4.697157
32697,2015,Agosto,Barbados,1,0,,1,-75.42726,6.170465
32698,2015,Agosto,República de Belarús,1,0,,1,-74.140516,4.697157
32699,2015,Agosto,Bélgica,6,5,,11,-76.532004,3.451668
32700,2015,Agosto,Bélgica,36,42,,78,-74.140516,4.697157
32701,2015,Agosto,Bélgica,0,1,,1,-75.736374,4.815189
32702,2015,Agosto,Bélgica,2,3,,5,-75.42726,6.170465
32703,2015,Agosto,Belice,0,2,,2,-74.77647900000001,10.886686
32704,2015,Agosto,Belice,2,9,,11,-74.140516,4.697157
32705,2015,Agosto,Benín,0,4,,4,-74.140516,4.697157
32706,2015,Agosto,Bermudas/Territorio Británico de Ultramar,3,0,,3,-75.42726,6.170465
32707,2015,Agosto,Bolivia,3,1,,4,-75.516486,10.446304
32708,2015,Agosto,Bolivia,1,1,,2,-74.77647900000001,10.886686
32709,2015,Agosto,Bolivia,6,3,,9,-81.70216500000001,12.5862
32710,2015,Agosto,Bolivia,12,22,,34,-76.532004,3.451668
32711,2015,Agosto,Bolivia,382,523,,905,-74.140516,4.697157
32712,2015,Agosto,Bolivia,39,30,,69,-75.42726,6.170465
32713,2015,Agosto,Bolivia,1,3,,4,-73.181317,7.1280470000000005
32714,2015,Agosto,Botsuana,1,0,,1,-74.140516,4.697157
32715,2015,Agosto,Brasil,120,146,,266,-69.941498,4.191162
32716,2015,Agosto,Brasil,3,8,,11,-69.94143100000001,4.214082
32717,2015,Agosto,Brasil,1,1,,2,-77.35600000000001,0.81488
32718,2015,Agosto,Brasil,1,1,,2,-75.527794,10.406342
32719,2015,Agosto,Brasil,38,33,,71,-75.516486,10.446304
32720,2015,Agosto,Brasil,2,5,,7,-74.77647900000001,10.886686
32721,2015,Agosto,Brasil,109,77,,186,-81.70216500000001,12.5862
32722,2015,Agosto,Brasil,30,79,,109,-76.532004,3.451668
32723,2015,Agosto,Brasil,3177,5331,,8508,-74.140516,4.697157
32724,2015,Agosto,Brasil,3,5,,8,-75.736374,4.815189
32725,2015,Agosto,Brasil,51,134,,185,-75.42726,6.170465
32726,2015,Agosto,Brasil,2,9,,11,-73.181317,7.1280470000000005
32727,2015,Agosto,Brasil,0,2,,2,-72.508188,7.927233
32728,2015,Agosto,Brunei Darussalam,0,1,,1,-74.140516,4.697157
32729,2015,Agosto,Bulgaria,2,1,,3,-74.140516,4.697157
32730,2015,Agosto,Islas Caimán/Territorio Británico de Ultramar,0,1,,1,-75.527794,10.406342
32731,2015,Agosto,Islas Caimán/Territorio Británico de Ultramar,0,2,,2,-74.77647900000001,10.886686
32732,2015,Agosto,Islas Caimán/Territorio Británico de Ultramar,1,1,,2,-81.70216500000001,12.5862
32733,2015,Agosto,Islas Caimán/Territorio Británico de Ultramar,0,10,,10,-74.140516,4.697157
32734,2015,Agosto,Camboya,1,2,,3,-74.140516,4.697157
32735,2015,Agosto,Canadá,0,1,,1,-75.527794,10.406342
32736,2015,Agosto,Canadá,0,1,,1,-75.516486,10.446304
32737,2015,Agosto,Canadá,5,8,,13,-74.77647900000001,10.886686
32738,2015,Agosto,Canadá,0,2,,2,-74.213989,11.247722999999999
32739,2015,Agosto,Canadá,0,2,,2,-81.70216500000001,12.5862
32740,2015,Agosto,Canadá,47,43,,90,-76.532004,3.451668
32741,2015,Agosto,Canadá,641,901,,1542,-74.140516,4.697157
32742,2015,Agosto,Canadá,11,8,,19,-75.736374,4.815189
32743,2015,Agosto,Canadá,63,130,,193,-75.42726,6.170465
32744,2015,Agosto,Canadá,1,2,,3,-73.181317,7.1280470000000005
32745,2015,Agosto,Canadá,4,5,,9,-72.508188,7.927233
32746,2015,Agosto,España,2,2,,4,-75.527794,10.406342
32747,2015,Agosto,España,0,1,,1,-75.516486,10.446304
32748,2015,Agosto,España,0,3,,3,-74.77647900000001,10.886686
32749,2015,Agosto,España,549,825,,1374,-76.532004,3.451668
32750,2015,Agosto,España,3757,5652,,9409,-74.140516,4.697157
32751,2015,Agosto,España,4,11,,15,-75.736374,4.815189
32752,2015,Agosto,España,422,622,,1044,-75.42726,6.170465
32753,2015,Agosto,España,7,8,,15,-73.181317,7.1280470000000005
32754,2015,Agosto,España,1,4,,5,-72.508188,7.927233
32755,2015,Agosto,República Democrática del Congo,0,1,,1,-74.140516,4.697157
32756,2015,Agosto,República de Corea,0,1,,1,-75.527794,10.406342
32757,2015,Agosto,República de Corea,1,1,,2,-76.532004,3.451668
32758,2015,Agosto,República de Corea,12,22,,34,-74.140516,4.697157
32759,2015,Agosto,República de Corea,0,1,,1,-75.736374,4.815189
32760,2015,Agosto,República de Corea,2,4,,6,-75.42726,6.170465
32761,2015,Agosto,República de Corea,0,5,,5,-72.508188,7.927233
32762,2015,Agosto,Costa de Marfil,3,3,,6,-74.140516,4.697157
32763,2015,Agosto,Costa de Marfil,1,0,,1,-75.42726,6.170465
32764,2015,Agosto,Costa Rica,2,7,,9,-75.516486,10.446304
32765,2015,Agosto,Costa Rica,8,4,,12,-74.77647900000001,10.886686
32766,2015,Agosto,Costa Rica,0,3,,3,-74.232675,11.117206
32767,2015,Agosto,Costa Rica,0,8,,8,-81.703935,12.574411099999999
32768,2015,Agosto,Costa Rica,94,104,,198,-81.70216500000001,12.5862
32769,2015,Agosto,Costa Rica,25,48,,73,-76.532004,3.451668
32770,2015,Agosto,Costa Rica,846,1352,,2198,-74.140516,4.697157
32771,2015,Agosto,Costa Rica,3,7,,10,-75.736374,4.815189
32772,2015,Agosto,Costa Rica,71,121,,192,-75.42726,6.170465
32773,2015,Agosto,Costa Rica,0,2,,2,-73.181317,7.1280470000000005
32774,2015,Agosto,Costa Rica,5,4,,9,-72.508188,7.927233
32775,2015,Agosto,Croacia,2,6,,8,-74.140516,4.697157
32776,2015,Agosto,Cuba,0,2,,2,-75.516486,10.446304
32777,2015,Agosto,Cuba,1,3,,4,-74.77647900000001,10.886686
32778,2015,Agosto,Cuba,1,3,,4,-81.70216500000001,12.5862
32779,2015,Agosto,Cuba,17,21,,38,-76.532004,3.451668
32780,2015,Agosto,Cuba,295,486,,781,-74.140516,4.697157
32781,2015,Agosto,Cuba,2,3,,5,-75.736374,4.815189
32782,2015,Agosto,Cuba,34,48,,82,-75.42726,6.170465
32783,2015,Agosto,Cuba,1,2,,3,-73.181317,7.1280470000000005
32784,2015,Agosto,Cuba,2,2,,4,-72.508188,7.927233
32785,2015,Agosto,Curazao,0,4,,4,-74.140516,4.697157
32786,2015,Agosto,Curazao,0,1,,1,-75.42726,6.170465
32787,2015,Agosto,República Checa,2,5,,7,-74.140516,4.697157
32788,2015,Agosto,República Checa,0,1,,1,-75.42726,6.170465
32789,2015,Agosto,Chile,6,3,,9,-77.35600000000001,0.81488
32790,2015,Agosto,Chile,6,4,,10,-75.516486,10.446304
32791,2015,Agosto,Chile,0,6,,6,-74.77647900000001,10.886686
32792,2015,Agosto,Chile,28,19,,47,-81.70216500000001,12.5862
32793,2015,Agosto,Chile,36,70,,106,-76.532004,3.451668
32794,2015,Agosto,Chile,4278,5499,,9777,-74.140516,4.697157
32795,2015,Agosto,Chile,3,2,,5,-75.736374,4.815189
32796,2015,Agosto,Chile,27,74,,101,-75.42726,6.170465
32797,2015,Agosto,Chile,1,3,,4,-73.181317,7.1280470000000005
32798,2015,Agosto,China,0,1,,1,-75.516486,10.446304
32799,2015,Agosto,China,0,1,,1,-76.532004,3.451668
32800,2015,Agosto,China,39,85,,124,-74.140516,4.697157
32801,2015,Agosto,China,0,2,,2,-75.42726,6.170465
32802,2015,Agosto,Chipre,0,1,,1,-74.140516,4.697157
32803,2015,Agosto,Dinamarca,0,1,,1,-74.77647900000001,10.886686
32804,2015,Agosto,Dinamarca,4,2,,6,-76.532004,3.451668
32805,2015,Agosto,Dinamarca,5,8,,13,-74.140516,4.697157
32806,2015,Agosto,Dinamarca,3,2,,5,-75.42726,6.170465
32807,2015,Agosto,Dominica,0,1,,1,-75.527794,10.406342
32808,2015,Agosto,Dominica,0,1,,1,-75.516486,10.446304
32809,2015,Agosto,Dominica,0,3,,3,-74.140516,4.697157
32810,2015,Agosto,Ecuador,93,230,,323,-76.876446,0.33002
32811,2015,Agosto,Ecuador,5,14,,19,-77.84700600000001,0.8124359999999999
32812,2015,Agosto,Ecuador,4081,5460,,9541,-77.35600000000001,0.81488
32813,2015,Agosto,Ecuador,25,240,,265,-78.802679,18.00143
32814,2015,Agosto,Ecuador,385,322,,707,-75.516486,10.446304
32815,2015,Agosto,Ecuador,3,5,,8,-74.77647900000001,10.886686
32816,2015,Agosto,Ecuador,0,4,,4,-74.232675,11.117206
32817,2015,Agosto,Ecuador,8,10,,18,-81.70216500000001,12.5862
32818,2015,Agosto,Ecuador,479,599,,1078,-76.532004,3.451668
32819,2015,Agosto,Ecuador,0,5,,5,-77.061029,3.8844260000000004
32820,2015,Agosto,Ecuador,3756,4887,,8643,-74.140516,4.697157
32821,2015,Agosto,Ecuador,1,2,,3,-75.736374,4.815189
32822,2015,Agosto,Ecuador,13,38,,51,-75.42726,6.170465
32823,2015,Agosto,Ecuador,1,0,,1,-72.508188,7.927233
32824,2015,Agosto,Egipto,0,5,,5,-74.140516,4.697157
32825,2015,Agosto,El Salvador,1,0,,1,-74.77647900000001,10.886686
32826,2015,Agosto,El Salvador,113,77,,190,-81.70216500000001,12.5862
32827,2015,Agosto,El Salvador,102,163,,265,-76.532004,3.451668
32828,2015,Agosto,El Salvador,997,1400,,2397,-74.140516,4.697157
32829,2015,Agosto,El Salvador,168,268,,436,-75.42726,6.170465
32830,2015,Agosto,Emiratos Árabes,5,2,,7,-74.140516,4.697157
32831,2015,Agosto,Eritrea,0,1,,1,-74.140516,4.697157
32832,2015,Agosto,Eslovaquia,1,1,,2,-74.140516,4.697157
32833,2015,Agosto,Estados Unidos de América,0,34,,34,-75.527794,10.406342
32834,2015,Agosto,Estados Unidos de América,2920,4061,,6981,-75.516486,10.446304
32835,2015,Agosto,Estados Unidos de América,632,1107,,1739,-74.77647900000001,10.886686
32836,2015,Agosto,Estados Unidos de América,0,3,,3,-74.765343,10.970933
32837,2015,Agosto,Estados Unidos de América,0,6,,6,-74.213989,11.247722999999999
32838,2015,Agosto,Estados Unidos de América,10,20,,30,-81.70216500000001,12.5862
32839,2015,Agosto,Estados Unidos de América,1195,1532,,2727,-76.532004,3.451668
32840,2015,Agosto,Estados Unidos de América,97,154,,251,-75.76635300000001,4.45285
32841,2015,Agosto,Estados Unidos de América,9719,16443,,26162,-74.140516,4.697157
32842,2015,Agosto,Estados Unidos de América,185,225,,410,-75.736374,4.815189
32843,2015,Agosto,Estados Unidos de América,2704,5103,,7807,-75.42726,6.170465
32844,2015,Agosto,Estados Unidos de América,31,54,,85,-73.181317,7.1280470000000005
32845,2015,Agosto,Estados Unidos de América,58,71,,129,-72.508188,7.927233
32846,2015,Agosto,Estados Unidos de América,0,1,,1,-76.7333,8.06667
32847,2015,Agosto,Estonia,1,0,,1,-75.42726,6.170465
32848,2015,Agosto,Etiopia,1,0,,1,-74.140516,4.697157
32849,2015,Agosto,Islas Fiji,0,1,,1,-75.42726,6.170465
32850,2015,Agosto,Filipinas,0,5,,5,-75.516486,10.446304
32851,2015,Agosto,Filipinas,0,1,,1,-74.77647900000001,10.886686
32852,2015,Agosto,Filipinas,0,3,,3,-76.532004,3.451668
32853,2015,Agosto,Filipinas,2,15,,17,-74.140516,4.697157
32854,2015,Agosto,Finlandia,1,0,,1,-76.532004,3.451668
32855,2015,Agosto,Finlandia,1,2,,3,-74.140516,4.697157
32856,2015,Agosto,Francia,1,6,,7,-75.527794,10.406342
32857,2015,Agosto,Francia,1,0,,1,-74.77647900000001,10.886686
32858,2015,Agosto,Francia,0,3,,3,-81.70216500000001,12.5862
32859,2015,Agosto,Francia,43,53,,96,-76.532004,3.451668
32860,2015,Agosto,Francia,1583,2601,,4184,-74.140516,4.697157
32861,2015,Agosto,Francia,0,1,,1,-75.736374,4.815189
32862,2015,Agosto,Francia,18,31,,49,-75.42726,6.170465
32863,2015,Agosto,Francia,1,2,,3,-73.181317,7.1280470000000005
32864,2015,Agosto,Francia,0,1,,1,-76.7333,8.06667
32865,2015,Agosto,Ghana,0,4,,4,-74.140516,4.697157
32866,2015,Agosto,Grecia,0,1,,1,-76.532004,3.451668
32867,2015,Agosto,Grecia,5,7,,12,-74.140516,4.697157
32868,2015,Agosto,Grecia,2,2,,4,-75.42726,6.170465
32869,2015,Agosto,Grecia,0,4,,4,-76.7333,8.06667
32870,2015,Agosto,Guatemala,2,4,,6,-75.516486,10.446304
32871,2015,Agosto,Guatemala,1,3,,4,-74.77647900000001,10.886686
32872,2015,Agosto,Guatemala,21,28,,49,-81.70216500000001,12.5862
32873,2015,Agosto,Guatemala,23,70,,93,-76.532004,3.451668
32874,2015,Agosto,Guatemala,285,572,,857,-74.140516,4.697157
32875,2015,Agosto,Guatemala,7,5,,12,-75.736374,4.815189
32876,2015,Agosto,Guatemala,37,73,,110,-75.42726,6.170465
32877,2015,Agosto,Guatemala,6,2,,8,-73.181317,7.1280470000000005
32878,2015,Agosto,Guatemala,6,4,,10,-72.508188,7.927233
32879,2015,Agosto,Guyana,0,1,,1,-75.516486,10.446304
32880,2015,Agosto,Guyana,0,1,,1,-74.140516,4.697157
32881,2015,Agosto,Guadalupe/Territorio Francés,1,0,,1,-74.77647900000001,10.886686
32882,2015,Agosto,Guadalupe/Territorio Francés,2,4,,6,-74.140516,4.697157
32883,2015,Agosto,Guadalupe/Territorio Francés,1,0,,1,-72.508188,7.927233
32884,2015,Agosto,Guayana Francesa/Departamento de Ultramar Francés,1,1,,2,-74.140516,4.697157
32885,2015,Agosto,Haití,0,1,,1,-76.532004,3.451668
32886,2015,Agosto,Haití,2,14,,16,-74.140516,4.697157
32887,2015,Agosto,Haití,1,0,,1,-75.42726,6.170465
32888,2015,Agosto,Honduras,0,1,,1,-75.527794,10.406342
32889,2015,Agosto,Honduras,1,1,,2,-75.516486,10.446304
32890,2015,Agosto,Honduras,0,2,,2,-74.77647900000001,10.886686
32891,2015,Agosto,Honduras,0,14,,14,-81.703935,12.574411099999999
32892,2015,Agosto,Honduras,1,0,,1,-81.70216500000001,12.5862
32893,2015,Agosto,Honduras,1,2,,3,-81.372937,13.338761300000002
32894,2015,Agosto,Honduras,13,20,,33,-76.532004,3.451668
32895,2015,Agosto,Honduras,56,80,,136,-74.140516,4.697157
32896,2015,Agosto,Honduras,2,0,,2,-75.736374,4.815189
32897,2015,Agosto,Honduras,15,48,,63,-75.42726,6.170465
32898,2015,Agosto,Honduras,3,0,,3,-73.181317,7.1280470000000005
32899,2015,Agosto,Honduras,0,3,,3,-72.508188,7.927233
32900,2015,Agosto,Hong Kong,0,1,,1,-74.77647900000001,10.886686
32901,2015,Agosto,Hong Kong,1,0,,1,-76.532004,3.451668
32902,2015,Agosto,Hong Kong,2,4,,6,-74.140516,4.697157
32903,2015,Agosto,Hong Kong,1,1,,2,-75.42726,6.170465
32904,2015,Agosto,Hungría,1,6,,7,-74.140516,4.697157
32905,2015,Agosto,Hungría,1,0,,1,-75.42726,6.170465
32906,2015,Agosto,India,0,1,,1,-74.77647900000001,10.886686
32907,2015,Agosto,India,0,14,,14,-76.532004,3.451668
32908,2015,Agosto,India,9,39,,48,-74.140516,4.697157
32909,2015,Agosto,India,2,22,,24,-75.42726,6.170465
32910,2015,Agosto,Indonesia,3,5,,8,-74.140516,4.697157
32911,2015,Agosto,Iraq,1,0,,1,-74.140516,4.697157
32912,2015,Agosto,Irán,1,2,,3,-74.140516,4.697157
32913,2015,Agosto,República de Irlanda,0,3,,3,-76.532004,3.451668
32914,2015,Agosto,República de Irlanda,8,19,,27,-74.140516,4.697157
32915,2015,Agosto,República de Irlanda,2,7,,9,-75.42726,6.170465
32916,2015,Agosto,Israel,2,0,,2,-75.516486,10.446304
32917,2015,Agosto,Israel,2,2,,4,-76.532004,3.451668
32918,2015,Agosto,Israel,20,71,,91,-74.140516,4.697157
32919,2015,Agosto,Israel,2,5,,7,-75.42726,6.170465
32920,2015,Agosto,Israel,2,2,,4,-73.181317,7.1280470000000005
32921,2015,Agosto,Italia,1,2,,3,-75.516486,10.446304
32922,2015,Agosto,Italia,0,3,,3,-74.77647900000001,10.886686
32923,2015,Agosto,Italia,2,6,,8,-81.70216500000001,12.5862
32924,2015,Agosto,Italia,25,78,,103,-76.532004,3.451668
32925,2015,Agosto,Italia,158,333,,491,-74.140516,4.697157
32926,2015,Agosto,Italia,1,1,,2,-75.736374,4.815189
32927,2015,Agosto,Italia,23,51,,74,-75.42726,6.170465
32928,2015,Agosto,Italia,0,1,,1,-73.181317,7.1280470000000005
32929,2015,Agosto,Italia,1,0,,1,-72.508188,7.927233
32930,2015,Agosto,Jamaica,1,7,,8,-75.527794,10.406342
32931,2015,Agosto,Jamaica,0,1,,1,-75.516486,10.446304
32932,2015,Agosto,Jamaica,0,7,,7,-74.77647900000001,10.886686
32933,2015,Agosto,Jamaica,2,7,,9,-81.70216500000001,12.5862
32934,2015,Agosto,Jamaica,0,5,,5,-76.532004,3.451668
32935,2015,Agosto,Jamaica,1,7,,8,-74.140516,4.697157
32936,2015,Agosto,Jamaica,2,1,,3,-75.42726,6.170465
32937,2015,Agosto,Japón,0,1,,1,-74.77647900000001,10.886686
32938,2015,Agosto,Japón,2,1,,3,-76.532004,3.451668
32939,2015,Agosto,Japón,16,25,,41,-74.140516,4.697157
32940,2015,Agosto,Japón,1,3,,4,-75.42726,6.170465
32941,2015,Agosto,Kazajistán,1,1,,2,-76.532004,3.451668
32942,2015,Agosto,Kazajistán,1,1,,2,-74.140516,4.697157
32943,2015,Agosto,Kenia,0,3,,3,-74.140516,4.697157
32944,2015,Agosto,Letonia,1,2,,3,-74.140516,4.697157
32945,2015,Agosto,Lituania,0,1,,1,-76.532004,3.451668
32946,2015,Agosto,Lituania,2,3,,5,-75.42726,6.170465
32947,2015,Agosto,Líbano,0,1,,1,-76.532004,3.451668
32948,2015,Agosto,Líbano,7,12,,19,-74.140516,4.697157
32949,2015,Agosto,Luxemburgo,1,2,,3,-74.140516,4.697157
32950,2015,Agosto,Malasia,2,6,,8,-74.140516,4.697157
32951,2015,Agosto,Malawi,2,2,,4,-76.532004,3.451668
32952,2015,Agosto,Malta,2,2,,4,-74.140516,4.697157
32953,2015,Agosto,Marruecos,0,2,,2,-74.140516,4.697157
32954,2015,Agosto,Marruecos,0,1,,1,-75.42726,6.170465
32955,2015,Agosto,Martinica/Departamento de Ultramar Francés,0,2,,2,-75.527794,10.406342
32956,2015,Agosto,Martinica/Departamento de Ultramar Francés,1,0,,1,-76.532004,3.451668
32957,2015,Agosto,México,0,6,,6,-75.527794,10.406342
32958,2015,Agosto,México,14,20,,34,-75.516486,10.446304
32959,2015,Agosto,México,12,39,,51,-74.77647900000001,10.886686
32960,2015,Agosto,México,0,6,,6,-74.765343,10.970933
32961,2015,Agosto,México,0,1,,1,-74.213989,11.247722999999999
32962,2015,Agosto,México,4,7,,11,-81.70216500000001,12.5862
32963,2015,Agosto,México,57,110,,167,-76.532004,3.451668
32964,2015,Agosto,México,4631,8241,,12872,-74.140516,4.697157
32965,2015,Agosto,México,13,19,,32,-75.736374,4.815189
32966,2015,Agosto,México,750,1599,,2349,-75.42726,6.170465
32967,2015,Agosto,México,10,30,,40,-73.181317,7.1280470000000005
32968,2015,Agosto,México,23,37,,60,-72.508188,7.927233
32969,2015,Agosto,Mónaco,0,1,,1,-74.140516,4.697157
32970,2015,Agosto,Myanmar,0,1,,1,-74.140516,4.697157
32971,2015,Agosto,Nepal,0,1,,1,-74.140516,4.697157
32972,2015,Agosto,Nicaragua,1,0,,1,-74.77647900000001,10.886686
32973,2015,Agosto,Nicaragua,1,2,,3,-81.70216500000001,12.5862
32974,2015,Agosto,Nicaragua,8,42,,50,-76.532004,3.451668
32975,2015,Agosto,Nicaragua,19,25,,44,-74.140516,4.697157
32976,2015,Agosto,Nicaragua,2,7,,9,-75.736374,4.815189
32977,2015,Agosto,Nicaragua,9,11,,20,-75.42726,6.170465
32978,2015,Agosto,Nigeria,0,1,,1,-76.532004,3.451668
32979,2015,Agosto,Nigeria,0,1,,1,-74.140516,4.697157
32980,2015,Agosto,Noruega,0,1,,1,-74.77647900000001,10.886686
32981,2015,Agosto,Noruega,2,1,,3,-76.532004,3.451668
32982,2015,Agosto,Noruega,5,19,,24,-74.140516,4.697157
32983,2015,Agosto,Noruega,1,0,,1,-75.736374,4.815189
32984,2015,Agosto,Noruega,1,4,,5,-75.42726,6.170465
32985,2015,Agosto,Nueva Zelanda,0,1,,1,-75.516486,10.446304
32986,2015,Agosto,Nueva Zelanda,3,6,,9,-74.140516,4.697157
32987,2015,Agosto,Nueva Zelanda,1,2,,3,-75.42726,6.170465
32988,2015,Agosto,Omán,0,1,,1,-74.140516,4.697157
32989,2015,Agosto,Papúa Nueva Guinea,0,1,,1,-76.532004,3.451668
32990,2015,Agosto,Panamá,143,256,,399,-75.527794,10.406342
32991,2015,Agosto,Panamá,1526,1975,,3501,-75.516486,10.446304
32992,2015,Agosto,Panamá,196,436,,632,-74.77647900000001,10.886686
32993,2015,Agosto,Panamá,0,4,,4,-74.765343,10.970933
32994,2015,Agosto,Panamá,1,9,,10,-81.703935,12.574411099999999
32995,2015,Agosto,Panamá,150,108,,258,-81.70216500000001,12.5862
32996,2015,Agosto,Panamá,239,472,,711,-76.532004,3.451668
32997,2015,Agosto,Panamá,0,10,,10,-77.061029,3.8844260000000004
32998,2015,Agosto,Panamá,3601,5644,,9245,-74.140516,4.697157
32999,2015,Agosto,Panamá,48,89,,137,-75.736374,4.815189
33000,2015,Agosto,Panamá,1462,2252,,3714,-75.42726,6.170465
33001,2015,Agosto,Panamá,1,1,,2,-77.401154,6.222551999999999
33002,2015,Agosto,Panamá,6,6,,12,-77.762647,7.102626
33003,2015,Agosto,Panamá,21,29,,50,-73.181317,7.1280470000000005
33004,2015,Agosto,Panamá,77,102,,179,-72.508188,7.927233
33005,2015,Agosto,Panamá,91,137,,228,-77.35002,8.63337
33006,2015,Agosto,Paraguay,0,1,,1,-77.35600000000001,0.81488
33007,2015,Agosto,Paraguay,4,0,,4,-75.516486,10.446304
33008,2015,Agosto,Paraguay,0,1,,1,-74.77647900000001,10.886686
33009,2015,Agosto,Paraguay,28,11,,39,-81.70216500000001,12.5862
33010,2015,Agosto,Paraguay,9,6,,15,-76.532004,3.451668
33011,2015,Agosto,Paraguay,49,67,,116,-74.140516,4.697157
33012,2015,Agosto,Paraguay,23,18,,41,-75.42726,6.170465
33013,2015,Agosto,Perú,181,245,,426,-69.941498,4.191162
33014,2015,Agosto,Perú,1,2,,3,-69.94143100000001,4.214082
33015,2015,Agosto,Perú,7,37,,44,-77.35600000000001,0.81488
33016,2015,Agosto,Perú,11,7,,18,-75.516486,10.446304
33017,2015,Agosto,Perú,5,1,,6,-74.77647900000001,10.886686
33018,2015,Agosto,Perú,86,63,,149,-81.70216500000001,12.5862
33019,2015,Agosto,Perú,346,491,,837,-76.532004,3.451668
33020,2015,Agosto,Perú,6189,8364,,14553,-74.140516,4.697157
33021,2015,Agosto,Perú,481,746,,1227,-75.42726,6.170465
33022,2015,Agosto,Perú,2,3,,5,-72.508188,7.927233
33023,2015,Agosto,Polonia,10,10,,20,-74.140516,4.697157
33024,2015,Agosto,Polonia,3,2,,5,-75.42726,6.170465
33025,2015,Agosto,Polonia,0,1,,1,-73.181317,7.1280470000000005
33026,2015,Agosto,Portugal,4,4,,8,-76.532004,3.451668
33027,2015,Agosto,Portugal,440,621,,1061,-74.140516,4.697157
33028,2015,Agosto,Portugal,0,1,,1,-75.42726,6.170465
33029,2015,Agosto,Polinesia Francesa/Colectividad de Ultramar Francesa,0,1,,1,-74.140516,4.697157
33030,2015,Agosto,Puerto Rico/Territorio de Estados Unidos,0,1,,1,-75.527794,10.406342
33031,2015,Agosto,Puerto Rico/Territorio de Estados Unidos,8,8,,16,-75.516486,10.446304
33032,2015,Agosto,Puerto Rico/Territorio de Estados Unidos,5,17,,22,-74.77647900000001,10.886686
33033,2015,Agosto,Puerto Rico/Territorio de Estados Unidos,34,42,,76,-76.532004,3.451668
33034,2015,Agosto,Puerto Rico/Territorio de Estados Unidos,216,380,,596,-74.140516,4.697157
33035,2015,Agosto,Puerto Rico/Territorio de Estados Unidos,5,7,,12,-75.736374,4.815189
33036,2015,Agosto,Puerto Rico/Territorio de Estados Unidos,47,165,,212,-75.42726,6.170465
33037,2015,Agosto,Puerto Rico/Territorio de Estados Unidos,2,1,,3,-73.181317,7.1280470000000005
33038,2015,Agosto,Puerto Rico/Territorio de Estados Unidos,2,1,,3,-72.508188,7.927233
33039,2015,Agosto,Reino Unido de Gran Bretaña e Irlanda del Norte,0,5,,5,-75.527794,10.406342
33040,2015,Agosto,Reino Unido de Gran Bretaña e Irlanda del Norte,1,2,,3,-75.516486,10.446304
33041,2015,Agosto,Reino Unido de Gran Bretaña e Irlanda del Norte,0,2,,2,-74.213989,11.247722999999999
33042,2015,Agosto,Reino Unido de Gran Bretaña e Irlanda del Norte,9,20,,29,-76.532004,3.451668
33043,2015,Agosto,Reino Unido de Gran Bretaña e Irlanda del Norte,666,1091,,1757,-74.140516,4.697157
33044,2015,Agosto,Reino Unido de Gran Bretaña e Irlanda del Norte,0,1,,1,-75.736374,4.815189
33045,2015,Agosto,Reino Unido de Gran Bretaña e Irlanda del Norte,14,17,,31,-75.42726,6.170465
33046,2015,Agosto,Reino Unido de Gran Bretaña e Irlanda del Norte,0,1,,1,-72.508188,7.927233
33047,2015,Agosto,Federación de Rusia,0,1,,1,-74.77647900000001,10.886686
33048,2015,Agosto,Federación de Rusia,2,1,,3,-76.532004,3.451668
33049,2015,Agosto,Federación de Rusia,24,28,,52,-74.140516,4.697157
33050,2015,Agosto,Federación de Rusia,1,3,,4,-75.42726,6.170465
33051,2015,Agosto,Federación de Rusia,1,1,,2,-73.181317,7.1280470000000005
33052,2015,Agosto,República Dominicana,2,5,,7,-75.527794,10.406342
33053,2015,Agosto,República Dominicana,5,7,,12,-75.516486,10.446304
33054,2015,Agosto,República Dominicana,6,9,,15,-74.77647900000001,10.886686
33055,2015,Agosto,República Dominicana,3,2,,5,-81.70216500000001,12.5862
33056,2015,Agosto,República Dominicana,36,40,,76,-76.532004,3.451668
33057,2015,Agosto,República Dominicana,582,776,,1358,-74.140516,4.697157
33058,2015,Agosto,República Dominicana,3,6,,9,-75.736374,4.815189
33059,2015,Agosto,República Dominicana,43,113,,156,-75.42726,6.170465
33060,2015,Agosto,República Dominicana,3,10,,13,-73.181317,7.1280470000000005
33061,2015,Agosto,República Dominicana,4,7,,11,-72.508188,7.927233
33062,2015,Agosto,República Democrática Popular de Corea,0,2,,2,-74.140516,4.697157
33063,2015,Agosto,Rumania,1,0,,1,-76.532004,3.451668
33064,2015,Agosto,Rumania,4,7,,11,-74.140516,4.697157
33065,2015,Agosto,Rumania,0,1,,1,-75.42726,6.170465
33066,2015,Agosto,San Marino,0,1,,1,-74.140516,4.697157
33067,2015,Agosto,San  Vicente y las Granadinas,0,1,,1,-75.516486,10.446304
33068,2015,Agosto,San  Vicente y las Granadinas,0,1,,1,-74.140516,4.697157
33069,2015,Agosto,Santa Lucia,0,4,,4,-75.516486,10.446304
33070,2015,Agosto,Santa Lucia,1,0,,1,-76.532004,3.451668
33071,2015,Agosto,Senegal,0,1,,1,-74.140516,4.697157
33072,2015,Agosto,Serbia,0,3,,3,-74.140516,4.697157
33073,2015,Agosto,Serbia,1,0,,1,-75.42726,6.170465
33074,2015,Agosto,Singapur,0,1,,1,-76.532004,3.451668
33075,2015,Agosto,Singapur,0,2,,2,-74.140516,4.697157
33076,2015,Agosto,Singapur,0,1,,1,-75.42726,6.170465
33077,2015,Agosto,Sudáfrica,11,8,,19,-74.140516,4.697157
33078,2015,Agosto,Sudáfrica,0,1,,1,-73.181317,7.1280470000000005
33079,2015,Agosto,Suecia,9,2,,11,-76.532004,3.451668
33080,2015,Agosto,Suecia,8,10,,18,-74.140516,4.697157
33081,2015,Agosto,Suecia,4,5,,9,-75.42726,6.170465
33082,2015,Agosto,Suiza,12,14,,26,-76.532004,3.451668
33083,2015,Agosto,Suiza,57,74,,131,-74.140516,4.697157
33084,2015,Agosto,Suiza,1,0,,1,-75.736374,4.815189
33085,2015,Agosto,Suiza,8,17,,25,-75.42726,6.170465
33086,2015,Agosto,Surinam,0,2,,2,-74.77647900000001,10.886686
33087,2015,Agosto,Surinam,3,4,,7,-74.140516,4.697157
33088,2015,Agosto,Surinam,1,3,,4,-75.42726,6.170465
33089,2015,Agosto,Taiwán,3,2,,5,-74.140516,4.697157
33090,2015,Agosto,Tailandia,1,0,,1,-76.532004,3.451668
33091,2015,Agosto,Tailandia,6,2,,8,-74.140516,4.697157
33092,2015,Agosto,Tailandia,0,1,,1,-75.42726,6.170465
33093,2015,Agosto,Tanzania,0,1,,1,-74.140516,4.697157
33094,2015,Agosto,Trinidad y Tobago,1,0,,1,-74.77647900000001,10.886686
33095,2015,Agosto,Trinidad y Tobago,0,16,,16,-74.213989,11.247722999999999
33096,2015,Agosto,Trinidad y Tobago,7,8,,15,-76.532004,3.451668
33097,2015,Agosto,Trinidad y Tobago,6,19,,25,-74.140516,4.697157
33098,2015,Agosto,Trinidad y Tobago,9,15,,24,-75.42726,6.170465
33099,2015,Agosto,Trinidad y Tobago,1,0,,1,-73.181317,7.1280470000000005
33100,2015,Agosto,Trinidad y Tobago,3,2,,5,-72.508188,7.927233
33101,2015,Agosto,Túnez,1,1,,2,-75.42726,6.170465
33102,2015,Agosto,Turkmenistán,0,1,,1,-74.140516,4.697157
33103,2015,Agosto,Turquía,7,15,,22,-74.140516,4.697157
33104,2015,Agosto,Ucrania,1,0,,1,-76.532004,3.451668
33105,2015,Agosto,Ucrania,0,1,,1,-74.140516,4.697157
33106,2015,Agosto,Uganda,0,3,,3,-76.532004,3.451668
33107,2015,Agosto,Uganda,4,3,,7,-74.140516,4.697157
33108,2015,Agosto,Uruguay,0,1,,1,-77.35600000000001,0.81488
33109,2015,Agosto,Uruguay,18,17,,35,-75.516486,10.446304
33110,2015,Agosto,Uruguay,2,1,,3,-74.77647900000001,10.886686
33111,2015,Agosto,Uruguay,29,29,,58,-81.70216500000001,12.5862
33112,2015,Agosto,Uruguay,11,16,,27,-76.532004,3.451668
33113,2015,Agosto,Uruguay,47,89,,136,-74.140516,4.697157
33114,2015,Agosto,Uruguay,27,31,,58,-75.42726,6.170465
33115,2015,Agosto,Venezuela,0,9,,9,-75.527794,10.406342
33116,2015,Agosto,Venezuela,521,433,,954,-75.516486,10.446304
33117,2015,Agosto,Venezuela,5,37,,42,-74.77647900000001,10.886686
33118,2015,Agosto,Venezuela,0,6,,6,-74.765343,10.970933
33119,2015,Agosto,Venezuela,4183,4807,,8990,-72.129595,11.360028999999999
33120,2015,Agosto,Venezuela,18,40,,58,-76.532004,3.451668
33121,2015,Agosto,Venezuela,52,78,,130,-67.927521,3.866713
33122,2015,Agosto,Venezuela,4536,4731,,9267,-74.140516,4.697157
33123,2015,Agosto,Venezuela,1,1,,2,-75.736374,4.815189
33124,2015,Agosto,Venezuela,2585,2404,,4989,-75.42726,6.170465
33125,2015,Agosto,Venezuela,359,641,,1000,-67.48402800000001,6.185536
33126,2015,Agosto,Venezuela,323,401,,724,-70.74025300000001,7.088728999999999
33127,2015,Agosto,Venezuela,12,10,,22,-73.181317,7.1280470000000005
33128,2015,Agosto,Venezuela,4242,4548,,8790,-72.453013,7.819
33129,2015,Agosto,Venezuela,368,327,,695,-72.508188,7.927233
33131,2015,Agosto,Vietnam,0,1,,1,-74.140516,4.697157
33132,2015,Agosto,Islas Vírgenes Estadounidenses/Territorio de Estados Unidos,0,1,,1,-74.140516,4.697157
33133,2015,Agosto,Zimbabue,0,1,,1,-74.140516,4.697157
33134,2015,Agosto,Desconocido,0,6,,6,-74.140516,4.697157
33135,2015,Agosto,Desconocido,0,12,,12,-75.68164200000001,9.402597
33136,2015,Septiembre,Afganistán,1,1,,2,-74.140516,4.697157
33137,2015,Septiembre,Afganistán,0,2,,2,-75.42726,6.170465
33138,2015,Septiembre,Alemania,1,0,,1,-81.70216500000001,12.5862
33139,2015,Septiembre,Alemania,73,60,,133,-76.532004,3.451668
33140,2015,Septiembre,Alemania,0,1,,1,-77.061029,3.8844260000000004
33141,2015,Septiembre,Alemania,1188,2054,,3242,-74.140516,4.697157
33142,2015,Septiembre,Alemania,1,1,,2,-75.736374,4.815189
33143,2015,Septiembre,Alemania,11,27,,38,-75.42726,6.170465
33144,2015,Septiembre,Antigua y Barbuda,1,2,,3,-74.77647900000001,10.886686
33145,2015,Septiembre,Antigua y Barbuda,0,3,,3,-74.140516,4.697157
33146,2015,Septiembre,Antigua y Barbuda,0,1,,1,-75.42726,6.170465
33147,2015,Septiembre,Países Bajos,1,3,,4,-75.527794,10.406342
33148,2015,Septiembre,Países Bajos,68,69,,137,-74.77647900000001,10.886686
33149,2015,Septiembre,Países Bajos,3,6,,9,-74.213989,11.247722999999999
33150,2015,Septiembre,Países Bajos,103,148,,251,-76.532004,3.451668
33151,2015,Septiembre,Países Bajos,710,1104,,1814,-74.140516,4.697157
33152,2015,Septiembre,Países Bajos,0,2,,2,-75.736374,4.815189
33153,2015,Septiembre,Países Bajos,199,280,,479,-75.42726,6.170465
33154,2015,Septiembre,Arabia Saudita,1,1,,2,-74.140516,4.697157
33155,2015,Septiembre,Arabia Saudita,0,2,,2,-75.42726,6.170465
33156,2015,Septiembre,Argelia,1,4,,5,-74.140516,4.697157
33157,2015,Septiembre,Argentina,3,15,,18,-77.35600000000001,0.81488
33158,2015,Septiembre,Argentina,67,42,,109,-75.516486,10.446304
33159,2015,Septiembre,Argentina,5,2,,7,-74.77647900000001,10.886686
33160,2015,Septiembre,Argentina,233,150,,383,-81.70216500000001,12.5862
33161,2015,Septiembre,Argentina,86,108,,194,-76.532004,3.451668
33162,2015,Septiembre,Argentina,1890,2562,,4452,-74.140516,4.697157
33163,2015,Septiembre,Argentina,0,3,,3,-75.736374,4.815189
33164,2015,Septiembre,Argentina,89,173,,262,-75.42726,6.170465
33165,2015,Septiembre,Argentina,1,0,,1,-73.181317,7.1280470000000005
33166,2015,Septiembre,Argentina,0,1,,1,-72.508188,7.927233
33167,2015,Septiembre,República de Armenia,1,0,,1,-74.140516,4.697157
33168,2015,Septiembre,Aruba,148,149,,297,-75.527794,10.406342
33169,2015,Septiembre,Aruba,0,2,,2,-75.516486,10.446304
33170,2015,Septiembre,Aruba,2,6,,8,-74.77647900000001,10.886686
33171,2015,Septiembre,Aruba,6,8,,14,-74.213989,11.247722999999999
33172,2015,Septiembre,Aruba,5,3,,8,-76.532004,3.451668
33173,2015,Septiembre,Aruba,549,694,,1243,-74.140516,4.697157
33174,2015,Septiembre,Aruba,40,70,,110,-75.42726,6.170465
33175,2015,Septiembre,Aruba,51,58,,109,-73.181317,7.1280470000000005
33176,2015,Septiembre,Australia,2,3,,5,-75.516486,10.446304
33177,2015,Septiembre,Australia,1,2,,3,-74.77647900000001,10.886686
33178,2015,Septiembre,Australia,6,6,,12,-76.532004,3.451668
33179,2015,Septiembre,Australia,19,18,,37,-74.140516,4.697157
33180,2015,Septiembre,Australia,2,0,,2,-75.736374,4.815189
33181,2015,Septiembre,Australia,10,13,,23,-75.42726,6.170465
33182,2015,Septiembre,Austria,1,1,,2,-76.532004,3.451668
33183,2015,Septiembre,Austria,8,24,,32,-74.140516,4.697157
33184,2015,Septiembre,Austria,3,2,,5,-75.42726,6.170465
33185,2015,Septiembre,Azerbaiyán,2,1,,3,-74.140516,4.697157
33186,2015,Septiembre,Azerbaiyán,0,1,,1,-75.42726,6.170465
33187,2015,Septiembre,Bahamas,0,2,,2,-75.527794,10.406342
33188,2015,Septiembre,Bahamas,0,1,,1,-76.532004,3.451668
33189,2015,Septiembre,Bahamas,2,12,,14,-74.140516,4.697157
33190,2015,Septiembre,Bahamas,0,1,,1,-75.42726,6.170465
33191,2015,Septiembre,Bahréin,1,1,,2,-74.140516,4.697157
33192,2015,Septiembre,Bahréin,1,1,,2,-75.42726,6.170465
33193,2015,Septiembre,Barbados,0,2,,2,-74.140516,4.697157
33194,2015,Septiembre,República de Belarús,1,0,,1,-74.140516,4.697157
33195,2015,Septiembre,Bélgica,1,2,,3,-74.77647900000001,10.886686
33196,2015,Septiembre,Bélgica,1,8,,9,-76.532004,3.451668
33197,2015,Septiembre,Bélgica,17,25,,42,-74.140516,4.697157
33198,2015,Septiembre,Bélgica,2,8,,10,-75.42726,6.170465
33199,2015,Septiembre,Bélgica,0,1,,1,-73.181317,7.1280470000000005
33200,2015,Septiembre,Belice,0,3,,3,-76.532004,3.451668
33201,2015,Septiembre,Belice,1,2,,3,-74.140516,4.697157
33202,2015,Septiembre,Benín,1,3,,4,-74.140516,4.697157
33203,2015,Septiembre,Bermudas/Territorio Británico de Ultramar,0,1,,1,-75.42726,6.170465
33204,2015,Septiembre,Bolivia,0,2,,2,-77.35600000000001,0.81488
33205,2015,Septiembre,Bolivia,1,3,,4,-75.516486,10.446304
33206,2015,Septiembre,Bolivia,1,0,,1,-74.77647900000001,10.886686
33207,2015,Septiembre,Bolivia,6,4,,10,-81.70216500000001,12.5862
33208,2015,Septiembre,Bolivia,20,34,,54,-76.532004,3.451668
33209,2015,Septiembre,Bolivia,359,522,,881,-74.140516,4.697157
33210,2015,Septiembre,Bolivia,44,30,,74,-75.42726,6.170465
33211,2015,Septiembre,Brasil,111,162,,273,-69.941498,4.191162
33212,2015,Septiembre,Brasil,4,5,,9,-69.94143100000001,4.214082
33213,2015,Septiembre,Brasil,0,10,,10,-75.527794,10.406342
33214,2015,Septiembre,Brasil,30,32,,62,-75.516486,10.446304
33215,2015,Septiembre,Brasil,0,7,,7,-74.77647900000001,10.886686
33216,2015,Septiembre,Brasil,0,1,,1,-74.213989,11.247722999999999
33217,2015,Septiembre,Brasil,134,75,,209,-81.70216500000001,12.5862
33218,2015,Septiembre,Brasil,64,74,,138,-76.532004,3.451668
33219,2015,Septiembre,Brasil,4118,5834,,9952,-74.140516,4.697157
33220,2015,Septiembre,Brasil,3,6,,9,-75.736374,4.815189
33221,2015,Septiembre,Brasil,99,149,,248,-75.42726,6.170465
33222,2015,Septiembre,Brasil,0,2,,2,-73.181317,7.1280470000000005
33223,2015,Septiembre,Brasil,2,0,,2,-72.508188,7.927233
33224,2015,Septiembre,Brunei Darussalam,0,1,,1,-74.140516,4.697157
33225,2015,Septiembre,Bulgaria,1,1,,2,-74.140516,4.697157
33226,2015,Septiembre,Burkina Faso,0,1,,1,-75.42726,6.170465
33227,2015,Septiembre,Bután,1,0,,1,-74.140516,4.697157
33228,2015,Septiembre,Islas Caimán/Territorio Británico de Ultramar,1,2,,3,-75.527794,10.406342
33229,2015,Septiembre,Islas Caimán/Territorio Británico de Ultramar,0,7,,7,-81.703935,12.574411099999999
33230,2015,Septiembre,Islas Caimán/Territorio Británico de Ultramar,0,1,,1,-81.70216500000001,12.5862
33231,2015,Septiembre,Islas Caimán/Territorio Británico de Ultramar,0,7,,7,-74.140516,4.697157
33232,2015,Septiembre,Canadá,7,11,,18,-75.516486,10.446304
33233,2015,Septiembre,Canadá,1,9,,10,-74.77647900000001,10.886686
33234,2015,Septiembre,Canadá,0,3,,3,-81.70216500000001,12.5862
33235,2015,Septiembre,Canadá,22,44,,66,-76.532004,3.451668
33236,2015,Septiembre,Canadá,388,639,,1027,-74.140516,4.697157
33237,2015,Septiembre,Canadá,3,5,,8,-75.736374,4.815189
33238,2015,Septiembre,Canadá,54,111,,165,-75.42726,6.170465
33239,2015,Septiembre,Canadá,1,7,,8,-73.181317,7.1280470000000005
33240,2015,Septiembre,Canadá,2,1,,3,-72.508188,7.927233
33241,2015,Septiembre,Chad,0,1,,1,-74.140516,4.697157
33242,2015,Septiembre,España,3,6,,9,-75.516486,10.446304
33243,2015,Septiembre,España,2,9,,11,-74.77647900000001,10.886686
33244,2015,Septiembre,España,425,640,,1065,-76.532004,3.451668
33245,2015,Septiembre,España,3022,5494,,8516,-74.140516,4.697157
33246,2015,Septiembre,España,1,3,,4,-75.736374,4.815189
33247,2015,Septiembre,España,326,515,,841,-75.42726,6.170465
33248,2015,Septiembre,España,2,1,,3,-73.181317,7.1280470000000005
33249,2015,Septiembre,España,2,5,,7,-72.508188,7.927233
33250,2015,Septiembre,España,0,3,,3,-76.7333,8.06667
33251,2015,Septiembre,República Del Congo,0,2,,2,-74.140516,4.697157
33252,2015,Septiembre,República de Corea,0,1,,1,-75.527794,10.406342
33253,2015,Septiembre,República de Corea,0,1,,1,-76.532004,3.451668
33254,2015,Septiembre,República de Corea,5,14,,19,-74.140516,4.697157
33255,2015,Septiembre,República de Corea,2,4,,6,-75.42726,6.170465
33256,2015,Septiembre,Costa de Marfil,0,3,,3,-76.532004,3.451668
33257,2015,Septiembre,Costa de Marfil,0,6,,6,-74.140516,4.697157
33258,2015,Septiembre,Costa de Marfil,1,0,,1,-75.42726,6.170465
33259,2015,Septiembre,Costa Rica,2,4,,6,-75.527794,10.406342
33260,2015,Septiembre,Costa Rica,5,7,,12,-75.516486,10.446304
33261,2015,Septiembre,Costa Rica,1,7,,8,-74.77647900000001,10.886686
33262,2015,Septiembre,Costa Rica,0,2,,2,-74.765343,10.970933
33263,2015,Septiembre,Costa Rica,0,24,,24,-81.703935,12.574411099999999
33264,2015,Septiembre,Costa Rica,79,69,,148,-81.70216500000001,12.5862
33265,2015,Septiembre,Costa Rica,32,66,,98,-76.532004,3.451668
33266,2015,Septiembre,Costa Rica,773,1363,,2136,-74.140516,4.697157
33267,2015,Septiembre,Costa Rica,2,7,,9,-75.736374,4.815189
33268,2015,Septiembre,Costa Rica,78,116,,194,-75.42726,6.170465
33269,2015,Septiembre,Costa Rica,0,9,,9,-73.181317,7.1280470000000005
33270,2015,Septiembre,Costa Rica,1,3,,4,-72.508188,7.927233
33271,2015,Septiembre,Croacia,0,1,,1,-74.77647900000001,10.886686
33272,2015,Septiembre,Croacia,0,1,,1,-76.532004,3.451668
33273,2015,Septiembre,Croacia,1,1,,2,-74.140516,4.697157
33274,2015,Septiembre,Cuba,0,7,,7,-75.527794,10.406342
33275,2015,Septiembre,Cuba,0,2,,2,-75.516486,10.446304
33276,2015,Septiembre,Cuba,2,5,,7,-74.77647900000001,10.886686
33277,2015,Septiembre,Cuba,0,2,,2,-81.70216500000001,12.5862
33278,2015,Septiembre,Cuba,10,32,,42,-76.532004,3.451668
33279,2015,Septiembre,Cuba,362,541,,903,-74.140516,4.697157
33280,2015,Septiembre,Cuba,1,2,,3,-75.736374,4.815189
33281,2015,Septiembre,Cuba,29,32,,61,-75.42726,6.170465
33282,2015,Septiembre,Cuba,1,4,,5,-73.181317,7.1280470000000005
33283,2015,Septiembre,Curazao,0,1,,1,-75.42726,6.170465
33284,2015,Septiembre,República Checa,3,2,,5,-74.140516,4.697157
33285,2015,Septiembre,República Checa,0,1,,1,-75.42726,6.170465
33286,2015,Septiembre,Chile,4,4,,8,-77.35600000000001,0.81488
33287,2015,Septiembre,Chile,1,2,,3,-75.516486,10.446304
33288,2015,Septiembre,Chile,7,0,,7,-74.77647900000001,10.886686
33289,2015,Septiembre,Chile,34,17,,51,-81.70216500000001,12.5862
33290,2015,Septiembre,Chile,31,59,,90,-76.532004,3.451668
33291,2015,Septiembre,Chile,3676,4846,,8522,-74.140516,4.697157
33292,2015,Septiembre,Chile,0,4,,4,-75.736374,4.815189
33293,2015,Septiembre,Chile,26,74,,100,-75.42726,6.170465
33294,2015,Septiembre,Chile,0,1,,1,-73.181317,7.1280470000000005
33295,2015,Septiembre,Chile,0,1,,1,-72.508188,7.927233
33296,2015,Septiembre,China,0,1,,1,-75.516486,10.446304
33297,2015,Septiembre,China,0,2,,2,-76.532004,3.451668
33298,2015,Septiembre,China,20,78,,98,-74.140516,4.697157
33299,2015,Septiembre,China,2,1,,3,-75.42726,6.170465
33300,2015,Septiembre,Dinamarca,0,1,,1,-76.532004,3.451668
33301,2015,Septiembre,Dinamarca,9,17,,26,-74.140516,4.697157
33302,2015,Septiembre,Dinamarca,0,1,,1,-75.736374,4.815189
33303,2015,Septiembre,Dinamarca,1,2,,3,-75.42726,6.170465
33304,2015,Septiembre,Ecuador,81,178,,259,-76.876446,0.33002
33305,2015,Septiembre,Ecuador,3,8,,11,-77.84700600000001,0.8124359999999999
33306,2015,Septiembre,Ecuador,2484,4048,,6532,-77.35600000000001,0.81488
33307,2015,Septiembre,Ecuador,32,156,,188,-78.802679,18.00143
33308,2015,Septiembre,Ecuador,147,135,,282,-75.516486,10.446304
33309,2015,Septiembre,Ecuador,1,1,,2,-74.77647900000001,10.886686
33310,2015,Septiembre,Ecuador,7,7,,14,-81.70216500000001,12.5862
33311,2015,Septiembre,Ecuador,453,573,,1026,-76.532004,3.451668
33312,2015,Septiembre,Ecuador,3400,5306,,8706,-74.140516,4.697157
33313,2015,Septiembre,Ecuador,1,1,,2,-75.736374,4.815189
33314,2015,Septiembre,Ecuador,48,71,,119,-75.42726,6.170465
33315,2015,Septiembre,Ecuador,1,2,,3,-73.181317,7.1280470000000005
33316,2015,Septiembre,Ecuador,15,13,,28,-72.508188,7.927233
33317,2015,Septiembre,Egipto,0,1,,1,-76.532004,3.451668
33318,2015,Septiembre,Egipto,2,7,,9,-74.140516,4.697157
33319,2015,Septiembre,Egipto,0,1,,1,-75.42726,6.170465
33320,2015,Septiembre,El Salvador,29,25,,54,-81.70216500000001,12.5862
33321,2015,Septiembre,El Salvador,97,138,,235,-76.532004,3.451668
33322,2015,Septiembre,El Salvador,895,1439,,2334,-74.140516,4.697157
33323,2015,Septiembre,El Salvador,0,1,,1,-75.736374,4.815189
33324,2015,Septiembre,El Salvador,102,172,,274,-75.42726,6.170465
33325,2015,Septiembre,El Salvador,2,0,,2,-72.508188,7.927233
33326,2015,Septiembre,Emiratos Árabes,1,3,,4,-74.140516,4.697157
33327,2015,Septiembre,Emiratos Árabes,0,3,,3,-75.42726,6.170465
33328,2015,Septiembre,Eslovaquia,4,0,,4,-74.140516,4.697157
33329,2015,Septiembre,Eslovaquia,1,0,,1,-75.42726,6.170465
33330,2015,Septiembre,Eslovenia,3,1,,4,-76.532004,3.451668
33331,2015,Septiembre,Eslovenia,2,1,,3,-74.140516,4.697157
33332,2015,Septiembre,Eslovenia,0,1,,1,-75.42726,6.170465
33333,2015,Septiembre,Estados Unidos de América,0,41,,41,-75.527794,10.406342
33334,2015,Septiembre,Estados Unidos de América,1938,3141,,5079,-75.516486,10.446304
33335,2015,Septiembre,Estados Unidos de América,509,997,,1506,-74.77647900000001,10.886686
33336,2015,Septiembre,Estados Unidos de América,0,8,,8,-74.765343,10.970933
33337,2015,Septiembre,Estados Unidos de América,0,6,,6,-74.213989,11.247722999999999
33338,2015,Septiembre,Estados Unidos de América,8,29,,37,-81.70216500000001,12.5862
33339,2015,Septiembre,Estados Unidos de América,759,1178,,1937,-76.532004,3.451668
33340,2015,Septiembre,Estados Unidos de América,66,121,,187,-75.76635300000001,4.45285
33341,2015,Septiembre,Estados Unidos de América,6936,13508,,20444,-74.140516,4.697157
33342,2015,Septiembre,Estados Unidos de América,78,126,,204,-75.736374,4.815189
33343,2015,Septiembre,Estados Unidos de América,1716,4313,,6029,-75.42726,6.170465
33344,2015,Septiembre,Estados Unidos de América,20,52,,72,-73.181317,7.1280470000000005
33345,2015,Septiembre,Estados Unidos de América,85,63,,148,-72.508188,7.927233
33346,2015,Septiembre,Estados Unidos de América,0,1,,1,-76.7333,8.06667
33347,2015,Septiembre,Etiopia,0,1,,1,-74.140516,4.697157
33348,2015,Septiembre,Filipinas,0,3,,3,-75.516486,10.446304
33349,2015,Septiembre,Filipinas,0,1,,1,-74.77647900000001,10.886686
33350,2015,Septiembre,Filipinas,1,2,,3,-74.140516,4.697157
33351,2015,Septiembre,Finlandia,1,0,,1,-76.532004,3.451668
33352,2015,Septiembre,Finlandia,2,10,,12,-74.140516,4.697157
33353,2015,Septiembre,Finlandia,1,2,,3,-75.42726,6.170465
33354,2015,Septiembre,Francia,2,2,,4,-74.77647900000001,10.886686
33355,2015,Septiembre,Francia,0,1,,1,-81.70216500000001,12.5862
33356,2015,Septiembre,Francia,23,35,,58,-76.532004,3.451668
33357,2015,Septiembre,Francia,985,2072,,3057,-74.140516,4.697157
33358,2015,Septiembre,Francia,0,2,,2,-75.736374,4.815189
33359,2015,Septiembre,Francia,10,28,,38,-75.42726,6.170465
33360,2015,Septiembre,Francia,1,0,,1,-72.508188,7.927233
33361,2015,Septiembre,Gambia,0,1,,1,-75.42726,6.170465
33362,2015,Septiembre,Ghana,0,2,,2,-74.140516,4.697157
33363,2015,Septiembre,Ghana,1,3,,4,-75.42726,6.170465
33364,2015,Septiembre,Grecia,0,1,,1,-76.532004,3.451668
33365,2015,Septiembre,Grecia,2,3,,5,-74.140516,4.697157
33366,2015,Septiembre,Guatemala,1,5,,6,-75.527794,10.406342
33367,2015,Septiembre,Guatemala,7,7,,14,-75.516486,10.446304
33368,2015,Septiembre,Guatemala,1,2,,3,-74.77647900000001,10.886686
33369,2015,Septiembre,Guatemala,0,4,,4,-81.703935,12.574411099999999
33370,2015,Septiembre,Guatemala,25,32,,57,-81.70216500000001,12.5862
33371,2015,Septiembre,Guatemala,23,46,,69,-76.532004,3.451668
33372,2015,Septiembre,Guatemala,275,576,,851,-74.140516,4.697157
33373,2015,Septiembre,Guatemala,1,6,,7,-75.736374,4.815189
33374,2015,Septiembre,Guatemala,26,124,,150,-75.42726,6.170465
33375,2015,Septiembre,Guatemala,2,1,,3,-73.181317,7.1280470000000005
33376,2015,Septiembre,Guatemala,7,1,,8,-72.508188,7.927233
33377,2015,Septiembre,Guyana,1,0,,1,-76.532004,3.451668
33378,2015,Septiembre,Guyana,0,3,,3,-74.140516,4.697157
33379,2015,Septiembre,Guyana,0,1,,1,-75.42726,6.170465
33380,2015,Septiembre,Guyana,0,3,,3,-72.508188,7.927233
33381,2015,Septiembre,Guadalupe/Territorio Francés,0,1,,1,-74.140516,4.697157
33382,2015,Septiembre,Guayana Francesa/Departamento de Ultramar Francés,0,1,,1,-75.527794,10.406342
33383,2015,Septiembre,Guayana Francesa/Departamento de Ultramar Francés,0,1,,1,-74.77647900000001,10.886686
33384,2015,Septiembre,Guayana Francesa/Departamento de Ultramar Francés,0,1,,1,-76.532004,3.451668
33385,2015,Septiembre,Haití,0,1,,1,-76.532004,3.451668
33386,2015,Septiembre,Haití,4,12,,16,-74.140516,4.697157
33387,2015,Septiembre,Haití,1,2,,3,-75.42726,6.170465
33388,2015,Septiembre,Honduras,1,7,,8,-75.516486,10.446304
33389,2015,Septiembre,Honduras,3,7,,10,-74.77647900000001,10.886686
33390,2015,Septiembre,Honduras,0,6,,6,-81.703935,12.574411099999999
33391,2015,Septiembre,Honduras,2,9,,11,-81.70216500000001,12.5862
33392,2015,Septiembre,Honduras,17,32,,49,-76.532004,3.451668
33393,2015,Septiembre,Honduras,52,90,,142,-74.140516,4.697157
33394,2015,Septiembre,Honduras,59,59,,118,-75.42726,6.170465
33395,2015,Septiembre,Honduras,0,1,,1,-72.508188,7.927233
33396,2015,Septiembre,Hong Kong,2,1,,3,-76.532004,3.451668
33397,2015,Septiembre,Hong Kong,2,4,,6,-74.140516,4.697157
33398,2015,Septiembre,Hong Kong,0,1,,1,-75.42726,6.170465
33399,2015,Septiembre,Hungría,2,7,,9,-74.140516,4.697157
33400,2015,Septiembre,India,0,4,,4,-74.77647900000001,10.886686
33401,2015,Septiembre,India,0,2,,2,-74.765343,10.970933
33402,2015,Septiembre,India,4,10,,14,-76.532004,3.451668
33403,2015,Septiembre,India,3,37,,40,-74.140516,4.697157
33404,2015,Septiembre,India,3,8,,11,-75.42726,6.170465
33405,2015,Septiembre,Indonesia,0,1,,1,-76.532004,3.451668
33406,2015,Septiembre,Indonesia,1,1,,2,-74.140516,4.697157
33407,2015,Septiembre,Indonesia,0,2,,2,-75.42726,6.170465
33408,2015,Septiembre,Irán,0,1,,1,-74.140516,4.697157
33409,2015,Septiembre,República de Irlanda,0,1,,1,-75.516486,10.446304
33410,2015,Septiembre,República de Irlanda,0,4,,4,-76.532004,3.451668
33411,2015,Septiembre,República de Irlanda,2,13,,15,-74.140516,4.697157
33412,2015,Septiembre,República de Irlanda,1,3,,4,-75.42726,6.170465
33413,2015,Septiembre,Israel,1,1,,2,-76.532004,3.451668
33414,2015,Septiembre,Israel,17,59,,76,-74.140516,4.697157
33415,2015,Septiembre,Israel,1,0,,1,-75.736374,4.815189
33416,2015,Septiembre,Israel,2,3,,5,-75.42726,6.170465
33417,2015,Septiembre,Italia,176,95,,271,-76.532004,3.451668
33418,2015,Septiembre,Italia,74,227,,301,-74.140516,4.697157
33419,2015,Septiembre,Italia,10,32,,42,-75.42726,6.170465
33420,2015,Septiembre,Italia,0,1,,1,-73.181317,7.1280470000000005
33421,2015,Septiembre,Jamaica,0,2,,2,-75.527794,10.406342
33422,2015,Septiembre,Jamaica,0,1,,1,-75.516486,10.446304
33423,2015,Septiembre,Jamaica,0,5,,5,-74.77647900000001,10.886686
33424,2015,Septiembre,Jamaica,2,6,,8,-81.70216500000001,12.5862
33425,2015,Septiembre,Jamaica,1,1,,2,-76.532004,3.451668
33426,2015,Septiembre,Jamaica,3,8,,11,-74.140516,4.697157
33427,2015,Septiembre,Jamaica,7,5,,12,-75.42726,6.170465
33428,2015,Septiembre,Jamaica,0,3,,3,-72.508188,7.927233
33429,2015,Septiembre,Japón,3,1,,4,-75.516486,10.446304
33430,2015,Septiembre,Japón,0,1,,1,-74.77647900000001,10.886686
33431,2015,Septiembre,Japón,12,5,,17,-76.532004,3.451668
33432,2015,Septiembre,Japón,13,18,,31,-74.140516,4.697157
33433,2015,Septiembre,Japón,0,1,,1,-75.736374,4.815189
33434,2015,Septiembre,Japón,1,9,,10,-75.42726,6.170465
33435,2015,Septiembre,Jordania,4,4,,8,-74.140516,4.697157
33436,2015,Septiembre,Kazajistán,1,0,,1,-75.516486,10.446304
33437,2015,Septiembre,Kenia,1,3,,4,-74.140516,4.697157
33438,2015,Septiembre,Kenia,3,3,,6,-75.42726,6.170465
33439,2015,Septiembre,Letonia,1,0,,1,-74.140516,4.697157
33440,2015,Septiembre,Lituania,1,0,,1,-74.140516,4.697157
33441,2015,Septiembre,Lituania,3,1,,4,-75.42726,6.170465
33442,2015,Septiembre,Líbano,11,12,,23,-74.140516,4.697157
33443,2015,Septiembre,Luxemburgo,1,0,,1,-74.140516,4.697157
33444,2015,Septiembre,Madagascar,0,1,,1,-74.77647900000001,10.886686
33445,2015,Septiembre,Madagascar,0,1,,1,-74.140516,4.697157
33446,2015,Septiembre,Malasia,1,10,,11,-74.140516,4.697157
33447,2015,Septiembre,Malasia,0,3,,3,-75.42726,6.170465
33448,2015,Septiembre,Malta,2,3,,5,-74.140516,4.697157
33449,2015,Septiembre,Marruecos,3,6,,9,-74.140516,4.697157
33450,2015,Septiembre,Marruecos,1,3,,4,-75.42726,6.170465
33451,2015,Septiembre,México,0,12,,12,-75.527794,10.406342
33452,2015,Septiembre,México,6,19,,25,-75.516486,10.446304
33453,2015,Septiembre,México,8,18,,26,-74.77647900000001,10.886686
33454,2015,Septiembre,México,9,8,,17,-81.70216500000001,12.5862
33455,2015,Septiembre,México,66,134,,200,-76.532004,3.451668
33456,2015,Septiembre,México,4303,7669,,11972,-74.140516,4.697157
33457,2015,Septiembre,México,10,19,,29,-75.736374,4.815189
33458,2015,Septiembre,México,576,1411,,1987,-75.42726,6.170465
33459,2015,Septiembre,México,4,15,,19,-73.181317,7.1280470000000005
33460,2015,Septiembre,México,16,13,,29,-72.508188,7.927233
33461,2015,Septiembre,Mónaco,1,0,,1,-74.140516,4.697157
33462,2015,Septiembre,Mónaco,1,0,,1,-75.42726,6.170465
33463,2015,Septiembre,Mongolia,1,0,,1,-74.140516,4.697157
33464,2015,Septiembre,Mozambique,0,3,,3,-74.140516,4.697157
33465,2015,Septiembre,Nicaragua,0,1,,1,-75.527794,10.406342
33466,2015,Septiembre,Nicaragua,2,2,,4,-75.516486,10.446304
33467,2015,Septiembre,Nicaragua,1,2,,3,-74.77647900000001,10.886686
33468,2015,Septiembre,Nicaragua,1,1,,2,-81.703935,12.574411099999999
33469,2015,Septiembre,Nicaragua,2,1,,3,-81.70216500000001,12.5862
33470,2015,Septiembre,Nicaragua,14,25,,39,-76.532004,3.451668
33471,2015,Septiembre,Nicaragua,23,47,,70,-74.140516,4.697157
33472,2015,Septiembre,Nicaragua,0,6,,6,-75.736374,4.815189
33473,2015,Septiembre,Nicaragua,10,16,,26,-75.42726,6.170465
33474,2015,Septiembre,Nicaragua,0,1,,1,-73.181317,7.1280470000000005
33475,2015,Septiembre,Nicaragua,2,1,,3,-72.508188,7.927233
33476,2015,Septiembre,Nigeria,0,2,,2,-75.42726,6.170465
33477,2015,Septiembre,Noruega,2,4,,6,-76.532004,3.451668
33478,2015,Septiembre,Noruega,11,11,,22,-74.140516,4.697157
33479,2015,Septiembre,Noruega,1,0,,1,-75.736374,4.815189
33480,2015,Septiembre,Noruega,2,1,,3,-75.42726,6.170465
33481,2015,Septiembre,Nueva Caledonia/Territorio francés,1,0,,1,-76.532004,3.451668
33482,2015,Septiembre,Nueva Zelanda,0,1,,1,-76.532004,3.451668
33483,2015,Septiembre,Nueva Zelanda,2,3,,5,-74.140516,4.697157
33484,2015,Septiembre,Nueva Zelanda,0,1,,1,-75.42726,6.170465
33485,2015,Septiembre,Omán,0,1,,1,-74.140516,4.697157
33486,2015,Septiembre,Panamá,516,475,,991,-75.527794,10.406342
33487,2015,Septiembre,Panamá,1772,2143,,3915,-75.516486,10.446304
33488,2015,Septiembre,Panamá,165,433,,598,-74.77647900000001,10.886686
33489,2015,Septiembre,Panamá,1,12,,13,-74.765343,10.970933
33490,2015,Septiembre,Panamá,1,3,,4,-74.213989,11.247722999999999
33491,2015,Septiembre,Panamá,311,222,,533,-81.70216500000001,12.5862
33492,2015,Septiembre,Panamá,281,483,,764,-76.532004,3.451668
33493,2015,Septiembre,Panamá,0,12,,12,-77.061029,3.8844260000000004
33494,2015,Septiembre,Panamá,3488,5315,,8803,-74.140516,4.697157
33495,2015,Septiembre,Panamá,39,108,,147,-75.736374,4.815189
33496,2015,Septiembre,Panamá,1328,1990,,3318,-75.42726,6.170465
33497,2015,Septiembre,Panamá,2,1,,3,-77.401154,6.222551999999999
33498,2015,Septiembre,Panamá,1,0,,1,-77.762647,7.102626
33499,2015,Septiembre,Panamá,20,53,,73,-73.181317,7.1280470000000005
33500,2015,Septiembre,Panamá,107,90,,197,-72.508188,7.927233
33501,2015,Septiembre,Panamá,0,10,,10,-76.7333,8.06667
33502,2015,Septiembre,Panamá,77,88,,165,-77.35002,8.63337
33503,2015,Septiembre,Paraguay,2,2,,4,-75.516486,10.446304
33504,2015,Septiembre,Paraguay,1,0,,1,-74.77647900000001,10.886686
33505,2015,Septiembre,Paraguay,38,23,,61,-81.70216500000001,12.5862
33506,2015,Septiembre,Paraguay,26,55,,81,-76.532004,3.451668
33507,2015,Septiembre,Paraguay,51,66,,117,-74.140516,4.697157
33508,2015,Septiembre,Paraguay,29,63,,92,-75.42726,6.170465
33509,2015,Septiembre,Paraguay,3,5,,8,-73.181317,7.1280470000000005
33510,2015,Septiembre,Paraguay,1,2,,3,-72.508188,7.927233
33511,2015,Septiembre,Perú,87,174,,261,-69.941498,4.191162
33512,2015,Septiembre,Perú,1,0,,1,-69.94143100000001,4.214082
33513,2015,Septiembre,Perú,7,25,,32,-77.35600000000001,0.81488
33514,2015,Septiembre,Perú,0,1,,1,-78.802679,18.00143
33515,2015,Septiembre,Perú,0,1,,1,-75.527794,10.406342
33516,2015,Septiembre,Perú,7,0,,7,-75.516486,10.446304
33517,2015,Septiembre,Perú,0,11,,11,-74.77647900000001,10.886686
33518,2015,Septiembre,Perú,134,82,,216,-81.70216500000001,12.5862
33519,2015,Septiembre,Perú,314,471,,785,-76.532004,3.451668
33520,2015,Septiembre,Perú,5683,7804,,13487,-74.140516,4.697157
33521,2015,Septiembre,Perú,1,1,,2,-75.736374,4.815189
33522,2015,Septiembre,Perú,386,699,,1085,-75.42726,6.170465
33523,2015,Septiembre,Perú,1,2,,3,-73.181317,7.1280470000000005
33524,2015,Septiembre,Perú,2,4,,6,-72.508188,7.927233
33525,2015,Septiembre,Palestina,0,1,,1,-74.140516,4.697157
33526,2015,Septiembre,Polonia,0,3,,3,-76.532004,3.451668
33527,2015,Septiembre,Polonia,10,17,,27,-74.140516,4.697157
33528,2015,Septiembre,Polonia,0,2,,2,-75.736374,4.815189
33529,2015,Septiembre,Polonia,0,1,,1,-75.42726,6.170465
33530,2015,Septiembre,Portugal,1,8,,9,-75.516486,10.446304
33531,2015,Septiembre,Portugal,4,5,,9,-76.532004,3.451668
33532,2015,Septiembre,Portugal,267,436,,703,-74.140516,4.697157
33533,2015,Septiembre,Portugal,2,4,,6,-75.42726,6.170465
33534,2015,Septiembre,Puerto Rico/Territorio de Estados Unidos,3,3,,6,-75.516486,10.446304
33535,2015,Septiembre,Puerto Rico/Territorio de Estados Unidos,8,29,,37,-74.77647900000001,10.886686
33536,2015,Septiembre,Puerto Rico/Territorio de Estados Unidos,1,1,,2,-81.70216500000001,12.5862
33537,2015,Septiembre,Puerto Rico/Territorio de Estados Unidos,14,37,,51,-76.532004,3.451668
33538,2015,Septiembre,Puerto Rico/Territorio de Estados Unidos,208,373,,581,-74.140516,4.697157
33539,2015,Septiembre,Puerto Rico/Territorio de Estados Unidos,2,4,,6,-75.736374,4.815189
33540,2015,Septiembre,Puerto Rico/Territorio de Estados Unidos,61,93,,154,-75.42726,6.170465
33541,2015,Septiembre,Puerto Rico/Territorio de Estados Unidos,3,17,,20,-73.181317,7.1280470000000005
33542,2015,Septiembre,Puerto Rico/Territorio de Estados Unidos,1,1,,2,-72.508188,7.927233
33543,2015,Septiembre,Qatar,1,5,,6,-74.140516,4.697157
33544,2015,Septiembre,Reino Unido de Gran Bretaña e Irlanda del Norte,1,1,,2,-75.516486,10.446304
33545,2015,Septiembre,Reino Unido de Gran Bretaña e Irlanda del Norte,1,1,,2,-74.77647900000001,10.886686
33546,2015,Septiembre,Reino Unido de Gran Bretaña e Irlanda del Norte,0,1,,1,-74.213989,11.247722999999999
33547,2015,Septiembre,Reino Unido de Gran Bretaña e Irlanda del Norte,12,18,,30,-76.532004,3.451668
33548,2015,Septiembre,Reino Unido de Gran Bretaña e Irlanda del Norte,449,935,,1384,-74.140516,4.697157
33549,2015,Septiembre,Reino Unido de Gran Bretaña e Irlanda del Norte,9,16,,25,-75.42726,6.170465
33550,2015,Septiembre,Reino Unido de Gran Bretaña e Irlanda del Norte,0,1,,1,-73.181317,7.1280470000000005
33551,2015,Septiembre,Reino Unido de Gran Bretaña e Irlanda del Norte,0,1,,1,-72.508188,7.927233
33552,2015,Septiembre,Federación de Rusia,0,2,,2,-76.532004,3.451668
33553,2015,Septiembre,Federación de Rusia,25,37,,62,-74.140516,4.697157
33554,2015,Septiembre,República Dominicana,0,22,,22,-75.527794,10.406342
33555,2015,Septiembre,República Dominicana,6,7,,13,-75.516486,10.446304
33556,2015,Septiembre,República Dominicana,1,10,,11,-74.77647900000001,10.886686
33557,2015,Septiembre,República Dominicana,0,1,,1,-74.213989,11.247722999999999
33558,2015,Septiembre,República Dominicana,28,45,,73,-76.532004,3.451668
33559,2015,Septiembre,República Dominicana,587,938,,1525,-74.140516,4.697157
33560,2015,Septiembre,República Dominicana,3,0,,3,-75.736374,4.815189
33561,2015,Septiembre,República Dominicana,46,95,,141,-75.42726,6.170465
33562,2015,Septiembre,República Dominicana,5,8,,13,-73.181317,7.1280470000000005
33563,2015,Septiembre,República Dominicana,1,2,,3,-72.508188,7.927233
33564,2015,Septiembre,República Democrática Popular de Corea,0,1,,1,-74.765343,10.970933
33565,2015,Septiembre,República Democrática Popular de Corea,0,1,,1,-74.140516,4.697157
33566,2015,Septiembre,Rumania,0,1,,1,-74.765343,10.970933
33567,2015,Septiembre,Rumania,0,1,,1,-76.532004,3.451668
33568,2015,Septiembre,Rumania,2,5,,7,-74.140516,4.697157
33569,2015,Septiembre,Rumania,3,1,,4,-75.42726,6.170465
33570,2015,Septiembre,San Marino,0,1,,1,-74.140516,4.697157
33571,2015,Septiembre,San  Vicente y las Granadinas,0,1,,1,-75.516486,10.446304
33572,2015,Septiembre,San  Vicente y las Granadinas,0,1,,1,-74.140516,4.697157
33573,2015,Septiembre,San  Vicente y las Granadinas,0,1,,1,-75.42726,6.170465
33574,2015,Septiembre,Santa Lucia,0,1,,1,-74.140516,4.697157
33575,2015,Septiembre,Santa Lucia,0,1,,1,-75.42726,6.170465
33576,2015,Septiembre,Santo Tomé y Príncipe,0,1,,1,-74.140516,4.697157
33577,2015,Septiembre,Senegal,1,0,,1,-74.140516,4.697157
33578,2015,Septiembre,Senegal,0,2,,2,-75.42726,6.170465
33579,2015,Septiembre,Seychelles,1,0,,1,-74.140516,4.697157
33580,2015,Septiembre,Singapur,2,2,,4,-74.140516,4.697157
33581,2015,Septiembre,Sudáfrica,3,9,,12,-74.140516,4.697157
33582,2015,Septiembre,Sudáfrica,0,2,,2,-75.42726,6.170465
33583,2015,Septiembre,Sudán,0,2,,2,-76.532004,3.451668
33584,2015,Septiembre,Sudán,0,1,,1,-74.140516,4.697157
33585,2015,Septiembre,Suecia,1,6,,7,-76.532004,3.451668
33586,2015,Septiembre,Suecia,17,25,,42,-74.140516,4.697157
33587,2015,Septiembre,Suecia,3,4,,7,-75.42726,6.170465
33588,2015,Septiembre,Suiza,12,25,,37,-76.532004,3.451668
33589,2015,Septiembre,Suiza,39,78,,117,-74.140516,4.697157
33590,2015,Septiembre,Suiza,14,23,,37,-75.42726,6.170465
33591,2015,Septiembre,Surinam,0,5,,5,-74.140516,4.697157
33592,2015,Septiembre,Surinam,2,4,,6,-75.42726,6.170465
33593,2015,Septiembre,Taiwán,1,0,,1,-75.516486,10.446304
33594,2015,Septiembre,Taiwán,7,7,,14,-76.532004,3.451668
33595,2015,Septiembre,Taiwán,3,5,,8,-74.140516,4.697157
33596,2015,Septiembre,Tailandia,0,3,,3,-74.140516,4.697157
33597,2015,Septiembre,Tanzania,0,1,,1,-75.42726,6.170465
33598,2015,Septiembre,República Democrática de Timor Oriental,0,1,,1,-75.42726,6.170465
33599,2015,Septiembre,Trinidad y Tobago,0,6,,6,-75.527794,10.406342
33600,2015,Septiembre,Trinidad y Tobago,0,1,,1,-75.516486,10.446304
33601,2015,Septiembre,Trinidad y Tobago,0,1,,1,-74.765343,10.970933
33602,2015,Septiembre,Trinidad y Tobago,1,4,,5,-76.532004,3.451668
33603,2015,Septiembre,Trinidad y Tobago,2,7,,9,-74.140516,4.697157
33604,2015,Septiembre,Trinidad y Tobago,0,3,,3,-75.736374,4.815189
33605,2015,Septiembre,Trinidad y Tobago,1,6,,7,-75.42726,6.170465
33606,2015,Septiembre,Túnez,1,2,,3,-74.140516,4.697157
33607,2015,Septiembre,Turquía,0,1,,1,-76.532004,3.451668
33608,2015,Septiembre,Turquía,1,14,,15,-74.140516,4.697157
33609,2015,Septiembre,Turquía,0,2,,2,-75.42726,6.170465
33610,2015,Septiembre,Ucrania,0,1,,1,-76.532004,3.451668
33611,2015,Septiembre,Ucrania,2,3,,5,-74.140516,4.697157
33612,2015,Septiembre,Ucrania,0,1,,1,-75.42726,6.170465
33613,2015,Septiembre,Uganda,0,2,,2,-75.42726,6.170465
33614,2015,Septiembre,Uruguay,0,1,,1,-77.35600000000001,0.81488
33615,2015,Septiembre,Uruguay,8,6,,14,-75.516486,10.446304
33616,2015,Septiembre,Uruguay,2,1,,3,-74.77647900000001,10.886686
33617,2015,Septiembre,Uruguay,23,13,,36,-81.70216500000001,12.5862
33618,2015,Septiembre,Uruguay,21,29,,50,-76.532004,3.451668
33619,2015,Septiembre,Uruguay,68,101,,169,-74.140516,4.697157
33620,2015,Septiembre,Uruguay,22,42,,64,-75.42726,6.170465
33621,2015,Septiembre,Uzbekistán,1,1,,2,-74.140516,4.697157
33622,2015,Septiembre,Venezuela,0,9,,9,-75.527794,10.406342
33623,2015,Septiembre,Venezuela,436,397,,833,-75.516486,10.446304
33624,2015,Septiembre,Venezuela,15,53,,68,-74.77647900000001,10.886686
33625,2015,Septiembre,Venezuela,0,2,,2,-74.765343,10.970933
33626,2015,Septiembre,Venezuela,970,1250,,2220,-72.129595,11.360028999999999
33627,2015,Septiembre,Venezuela,1,0,,1,-81.70216500000001,12.5862
33628,2015,Septiembre,Venezuela,12,10,,22,-76.532004,3.451668
33629,2015,Septiembre,Venezuela,34,44,,78,-67.927521,3.866713
33630,2015,Septiembre,Venezuela,4122,4564,,8686,-74.140516,4.697157
33631,2015,Septiembre,Venezuela,0,2,,2,-75.736374,4.815189
33632,2015,Septiembre,Venezuela,2561,2271,,4832,-75.42726,6.170465
33633,2015,Septiembre,Venezuela,205,424,,629,-67.48402800000001,6.185536
33634,2015,Septiembre,Venezuela,191,278,,469,-70.74025300000001,7.088728999999999
33635,2015,Septiembre,Venezuela,3,2,,5,-73.181317,7.1280470000000005
33636,2015,Septiembre,Venezuela,1457,1804,,3261,-72.453013,7.819
33637,2015,Septiembre,Venezuela,61,89,,150,-72.508188,7.927233
33638,2015,Septiembre,Islas Vírgenes Británicas/Territorio Británico de Ultramar,1,0,,1,-75.42726,6.170465
33639,2015,Septiembre,Islas Vírgenes Estadounidenses/Territorio de Estados Unidos,0,1,,1,-75.42726,6.170465
33640,2015,Septiembre,Zambia,4,0,,4,-74.140516,4.697157
33641,2015,Septiembre,Zambia,1,0,,1,-75.42726,6.170465
33642,2015,Septiembre,Zimbabue,0,1,,1,-74.140516,4.697157
33643,2015,Septiembre,Zimbabue,0,1,,1,-75.42726,6.170465
33644,2015,Septiembre,Desconocido,0,24,,24,-75.68164200000001,9.402597
33645,2015,Octubre,Afganistán,0,4,,4,-74.140516,4.697157
33646,2015,Octubre,Albania,0,1,,1,-76.532004,3.451668
33647,2015,Octubre,Albania,0,2,,2,-74.140516,4.697157
33648,2015,Octubre,Alemania,1,1,,2,-75.516486,10.446304
33649,2015,Octubre,Alemania,3,4,,7,-74.77647900000001,10.886686
33650,2015,Octubre,Alemania,1,0,,1,-81.70216500000001,12.5862
33651,2015,Octubre,Alemania,38,35,,73,-76.532004,3.451668
33652,2015,Octubre,Alemania,1346,2323,,3669,-74.140516,4.697157
33653,2015,Octubre,Alemania,0,1,,1,-75.736374,4.815189
33654,2015,Octubre,Alemania,39,44,,83,-75.42726,6.170465
33655,2015,Octubre,Alemania,0,2,,2,-73.181317,7.1280470000000005
33656,2015,Octubre,Andorra,0,1,,1,-76.532004,3.451668
33657,2015,Octubre,Andorra,0,1,,1,-74.140516,4.697157
33658,2015,Octubre,Antigua y Barbuda,0,2,,2,-75.527794,10.406342
33659,2015,Octubre,Antigua y Barbuda,0,4,,4,-74.140516,4.697157
33660,2015,Octubre,Países Bajos,0,1,,1,-78.802679,18.00143
33661,2015,Octubre,Países Bajos,1,5,,6,-75.527794,10.406342
33662,2015,Octubre,Países Bajos,0,1,,1,-75.516486,10.446304
33663,2015,Octubre,Países Bajos,91,106,,197,-74.77647900000001,10.886686
33664,2015,Octubre,Países Bajos,1,1,,2,-74.765343,10.970933
33665,2015,Octubre,Países Bajos,3,1,,4,-74.213989,11.247722999999999
33666,2015,Octubre,Países Bajos,116,225,,341,-76.532004,3.451668
33667,2015,Octubre,Países Bajos,872,1315,,2187,-74.140516,4.697157
33668,2015,Octubre,Países Bajos,1,2,,3,-75.736374,4.815189
33669,2015,Octubre,Países Bajos,239,321,,560,-75.42726,6.170465
33670,2015,Octubre,Países Bajos,1,0,,1,-72.508188,7.927233
33671,2015,Octubre,Arabia Saudita,2,0,,2,-74.140516,4.697157
33672,2015,Octubre,Arabia Saudita,0,1,,1,-72.508188,7.927233
33673,2015,Octubre,Argelia,1,0,,1,-81.70216500000001,12.5862
33674,2015,Octubre,Argelia,1,0,,1,-76.532004,3.451668
33675,2015,Octubre,Argelia,3,5,,8,-74.140516,4.697157
33676,2015,Octubre,Argelia,0,1,,1,-75.42726,6.170465
33677,2015,Octubre,Argelia,0,4,,4,-76.7333,8.06667
33678,2015,Octubre,Argentina,9,15,,24,-77.35600000000001,0.81488
33679,2015,Octubre,Argentina,52,32,,84,-75.516486,10.446304
33680,2015,Octubre,Argentina,0,3,,3,-74.77647900000001,10.886686
33681,2015,Octubre,Argentina,250,191,,441,-81.70216500000001,12.5862
33682,2015,Octubre,Argentina,46,151,,197,-76.532004,3.451668
33683,2015,Octubre,Argentina,1647,2644,,4291,-74.140516,4.697157
33684,2015,Octubre,Argentina,1,4,,5,-75.736374,4.815189
33685,2015,Octubre,Argentina,71,128,,199,-75.42726,6.170465
33686,2015,Octubre,Argentina,1,2,,3,-73.181317,7.1280470000000005
33687,2015,Octubre,Aruba,4,11,,15,-75.527794,10.406342
33688,2015,Octubre,Aruba,2,2,,4,-75.516486,10.446304
33689,2015,Octubre,Aruba,4,6,,10,-74.77647900000001,10.886686
33690,2015,Octubre,Aruba,1,31,,32,-74.765343,10.970933
33691,2015,Octubre,Aruba,17,25,,42,-74.213989,11.247722999999999
33692,2015,Octubre,Aruba,9,18,,27,-76.532004,3.451668
33693,2015,Octubre,Aruba,585,663,,1248,-74.140516,4.697157
33694,2015,Octubre,Aruba,4,5,,9,-75.736374,4.815189
33695,2015,Octubre,Aruba,91,102,,193,-75.42726,6.170465
33696,2015,Octubre,Aruba,8,3,,11,-73.181317,7.1280470000000005
33697,2015,Octubre,Aruba,0,1,,1,-72.508188,7.927233
33698,2015,Octubre,Australia,0,1,,1,-74.77647900000001,10.886686
33699,2015,Octubre,Australia,0,1,,1,-81.70216500000001,12.5862
33700,2015,Octubre,Australia,8,4,,12,-76.532004,3.451668
33701,2015,Octubre,Australia,17,37,,54,-74.140516,4.697157
33702,2015,Octubre,Australia,1,0,,1,-75.736374,4.815189
33703,2015,Octubre,Australia,4,22,,26,-75.42726,6.170465
33704,2015,Octubre,Australia,2,1,,3,-73.181317,7.1280470000000005
33705,2015,Octubre,Austria,2,1,,3,-76.532004,3.451668
33706,2015,Octubre,Austria,7,16,,23,-74.140516,4.697157
33707,2015,Octubre,Austria,1,3,,4,-75.42726,6.170465
33708,2015,Octubre,Azerbaiyán,0,2,,2,-76.532004,3.451668
33709,2015,Octubre,Azerbaiyán,1,2,,3,-74.140516,4.697157
33710,2015,Octubre,Bahamas,0,1,,1,-76.532004,3.451668
33711,2015,Octubre,Bahamas,0,1,,1,-74.140516,4.697157
33712,2015,Octubre,Bahamas,0,2,,2,-75.42726,6.170465
33713,2015,Octubre,Bahréin,1,1,,2,-74.140516,4.697157
33714,2015,Octubre,Barbados,0,9,,9,-75.516486,10.446304
33715,2015,Octubre,Barbados,2,1,,3,-74.140516,4.697157
33716,2015,Octubre,Barbados,0,1,,1,-75.42726,6.170465
33717,2015,Octubre,República de Belarús,4,0,,4,-74.140516,4.697157
33718,2015,Octubre,Bélgica,0,4,,4,-75.527794,10.406342
33719,2015,Octubre,Bélgica,4,11,,15,-76.532004,3.451668
33720,2015,Octubre,Bélgica,25,48,,73,-74.140516,4.697157
33721,2015,Octubre,Bélgica,3,9,,12,-75.42726,6.170465
33722,2015,Octubre,Belice,0,1,,1,-74.140516,4.697157
33723,2015,Octubre,Belice,0,2,,2,-75.42726,6.170465
33724,2015,Octubre,Benín,0,1,,1,-76.532004,3.451668
33725,2015,Octubre,Benín,1,0,,1,-74.140516,4.697157
33726,2015,Octubre,Bermudas/Territorio Británico de Ultramar,3,6,,9,-76.532004,3.451668
33727,2015,Octubre,Bolivia,1,0,,1,-77.35600000000001,0.81488
33728,2015,Octubre,Bolivia,1,1,,2,-75.516486,10.446304
33729,2015,Octubre,Bolivia,1,2,,3,-74.77647900000001,10.886686
33730,2015,Octubre,Bolivia,18,13,,31,-81.70216500000001,12.5862
33731,2015,Octubre,Bolivia,20,26,,46,-76.532004,3.451668
33732,2015,Octubre,Bolivia,407,597,,1004,-74.140516,4.697157
33733,2015,Octubre,Bolivia,1,3,,4,-75.736374,4.815189
33734,2015,Octubre,Bolivia,43,36,,79,-75.42726,6.170465
33735,2015,Octubre,Bolivia,1,1,,2,-73.181317,7.1280470000000005
33736,2015,Octubre,Brasil,126,161,,287,-69.941498,4.191162
33737,2015,Octubre,Brasil,2,12,,14,-69.94143100000001,4.214082
33738,2015,Octubre,Brasil,1,1,,2,-77.35600000000001,0.81488
33739,2015,Octubre,Brasil,0,4,,4,-75.527794,10.406342
33740,2015,Octubre,Brasil,43,30,,73,-75.516486,10.446304
33741,2015,Octubre,Brasil,1,4,,5,-74.77647900000001,10.886686
33742,2015,Octubre,Brasil,192,156,,348,-81.70216500000001,12.5862
33743,2015,Octubre,Brasil,40,71,,111,-76.532004,3.451668
33744,2015,Octubre,Brasil,0,3,,3,-67.927521,3.866713
33745,2015,Octubre,Brasil,3890,5470,,9360,-74.140516,4.697157
33746,2015,Octubre,Brasil,1,31,,32,-75.736374,4.815189
33747,2015,Octubre,Brasil,92,143,,235,-75.42726,6.170465
33748,2015,Octubre,Brasil,0,4,,4,-73.181317,7.1280470000000005
33749,2015,Octubre,Brasil,1,0,,1,-72.508188,7.927233
33750,2015,Octubre,Bulgaria,0,1,,1,-75.516486,10.446304
33751,2015,Octubre,Bulgaria,2,2,,4,-74.140516,4.697157
33752,2015,Octubre,Bulgaria,0,1,,1,-75.42726,6.170465
33753,2015,Octubre,Cabo Verde,1,0,,1,-74.140516,4.697157
33754,2015,Octubre,Islas Caimán/Territorio Británico de Ultramar,1,1,,2,-74.213989,11.247722999999999
33755,2015,Octubre,Islas Caimán/Territorio Británico de Ultramar,1,1,,2,-81.372937,13.338761300000002
33756,2015,Octubre,Islas Caimán/Territorio Británico de Ultramar,2,6,,8,-74.140516,4.697157
33757,2015,Octubre,Camerún,0,1,,1,-74.77647900000001,10.886686
33758,2015,Octubre,Canadá,0,8,,8,-75.527794,10.406342
33759,2015,Octubre,Canadá,17,19,,36,-75.516486,10.446304
33760,2015,Octubre,Canadá,6,8,,14,-74.77647900000001,10.886686
33761,2015,Octubre,Canadá,0,2,,2,-74.765343,10.970933
33762,2015,Octubre,Canadá,0,1,,1,-81.70216500000001,12.5862
33763,2015,Octubre,Canadá,29,46,,75,-76.532004,3.451668
33764,2015,Octubre,Canadá,499,787,,1286,-74.140516,4.697157
33765,2015,Octubre,Canadá,3,6,,9,-75.736374,4.815189
33766,2015,Octubre,Canadá,52,100,,152,-75.42726,6.170465
33767,2015,Octubre,Canadá,4,4,,8,-73.181317,7.1280470000000005
33768,2015,Octubre,Canadá,1,1,,2,-72.508188,7.927233
33769,2015,Octubre,Chad,0,1,,1,-74.140516,4.697157
33770,2015,Octubre,España,1,6,,7,-75.527794,10.406342
33771,2015,Octubre,España,2,5,,7,-74.77647900000001,10.886686
33772,2015,Octubre,España,0,1,,1,-74.213989,11.247722999999999
33773,2015,Octubre,España,457,718,,1175,-76.532004,3.451668
33774,2015,Octubre,España,2647,5017,,7664,-74.140516,4.697157
33775,2015,Octubre,España,5,2,,7,-75.736374,4.815189
33776,2015,Octubre,España,266,526,,792,-75.42726,6.170465
33777,2015,Octubre,España,1,0,,1,-73.181317,7.1280470000000005
33778,2015,Octubre,España,0,1,,1,-72.508188,7.927233
33779,2015,Octubre,República de Corea,0,2,,2,-75.527794,10.406342
33780,2015,Octubre,República de Corea,0,1,,1,-75.516486,10.446304
33781,2015,Octubre,República de Corea,4,6,,10,-76.532004,3.451668
33782,2015,Octubre,República de Corea,12,32,,44,-74.140516,4.697157
33783,2015,Octubre,República de Corea,2,2,,4,-75.42726,6.170465
33784,2015,Octubre,República de Corea,0,2,,2,-72.508188,7.927233
33785,2015,Octubre,Costa de Marfil,3,2,,5,-74.140516,4.697157
33786,2015,Octubre,Costa Rica,13,17,,30,-75.527794,10.406342
33787,2015,Octubre,Costa Rica,5,12,,17,-75.516486,10.446304
33788,2015,Octubre,Costa Rica,4,7,,11,-74.77647900000001,10.886686
33789,2015,Octubre,Costa Rica,0,1,,1,-74.213989,11.247722999999999
33790,2015,Octubre,Costa Rica,59,57,,116,-81.70216500000001,12.5862
33791,2015,Octubre,Costa Rica,35,49,,84,-76.532004,3.451668
33792,2015,Octubre,Costa Rica,1006,1487,,2493,-74.140516,4.697157
33793,2015,Octubre,Costa Rica,2,2,,4,-75.736374,4.815189
33794,2015,Octubre,Costa Rica,63,89,,152,-75.42726,6.170465
33795,2015,Octubre,Costa Rica,4,0,,4,-73.181317,7.1280470000000005
33796,2015,Octubre,Costa Rica,0,1,,1,-72.508188,7.927233
33797,2015,Octubre,Costa Rica,0,4,,4,-76.7333,8.06667
33798,2015,Octubre,Croacia,0,1,,1,-76.532004,3.451668
33799,2015,Octubre,Croacia,0,1,,1,-74.140516,4.697157
33800,2015,Octubre,Cuba,0,4,,4,-75.527794,10.406342
33801,2015,Octubre,Cuba,1,4,,5,-75.516486,10.446304
33802,2015,Octubre,Cuba,7,20,,27,-74.77647900000001,10.886686
33803,2015,Octubre,Cuba,1,0,,1,-81.70216500000001,12.5862
33804,2015,Octubre,Cuba,14,21,,35,-76.532004,3.451668
33805,2015,Octubre,Cuba,341,491,,832,-74.140516,4.697157
33806,2015,Octubre,Cuba,1,3,,4,-75.736374,4.815189
33807,2015,Octubre,Cuba,11,30,,41,-75.42726,6.170465
33808,2015,Octubre,Cuba,2,2,,4,-73.181317,7.1280470000000005
33809,2015,Octubre,Cuba,0,2,,2,-72.508188,7.927233
33810,2015,Octubre,Curazao,1,0,,1,-74.140516,4.697157
33811,2015,Octubre,República Checa,0,2,,2,-76.532004,3.451668
33812,2015,Octubre,República Checa,7,15,,22,-74.140516,4.697157
33813,2015,Octubre,República Checa,0,1,,1,-72.508188,7.927233
33814,2015,Octubre,Chile,1,1,,2,-77.35600000000001,0.81488
33815,2015,Octubre,Chile,0,1,,1,-75.516486,10.446304
33816,2015,Octubre,Chile,0,3,,3,-74.77647900000001,10.886686
33817,2015,Octubre,Chile,21,11,,32,-81.70216500000001,12.5862
33818,2015,Octubre,Chile,50,165,,215,-76.532004,3.451668
33819,2015,Octubre,Chile,4043,5126,,9169,-74.140516,4.697157
33820,2015,Octubre,Chile,1,1,,2,-75.736374,4.815189
33821,2015,Octubre,Chile,28,62,,90,-75.42726,6.170465
33822,2015,Octubre,Chile,1,2,,3,-73.181317,7.1280470000000005
33823,2015,Octubre,Chile,0,2,,2,-72.508188,7.927233
33824,2015,Octubre,China,1,2,,3,-76.532004,3.451668
33825,2015,Octubre,China,30,74,,104,-74.140516,4.697157
33826,2015,Octubre,China,0,1,,1,-75.736374,4.815189
33827,2015,Octubre,China,3,4,,7,-75.42726,6.170465
33828,2015,Octubre,Chipre,1,1,,2,-74.140516,4.697157
33829,2015,Octubre,Dinamarca,2,7,,9,-76.532004,3.451668
33830,2015,Octubre,Dinamarca,14,20,,34,-74.140516,4.697157
33831,2015,Octubre,Dinamarca,0,1,,1,-75.42726,6.170465
33832,2015,Octubre,Ecuador,65,185,,250,-76.876446,0.33002
33833,2015,Octubre,Ecuador,3,9,,12,-77.84700600000001,0.8124359999999999
33834,2015,Octubre,Ecuador,3327,4583,,7910,-77.35600000000001,0.81488
33835,2015,Octubre,Ecuador,34,290,,324,-78.802679,18.00143
33836,2015,Octubre,Ecuador,0,1,,1,-75.527794,10.406342
33837,2015,Octubre,Ecuador,1,5,,6,-74.77647900000001,10.886686
33838,2015,Octubre,Ecuador,12,11,,23,-81.70216500000001,12.5862
33839,2015,Octubre,Ecuador,510,596,,1106,-76.532004,3.451668
33840,2015,Octubre,Ecuador,3872,5345,,9217,-74.140516,4.697157
33841,2015,Octubre,Ecuador,1,3,,4,-75.736374,4.815189
33842,2015,Octubre,Ecuador,39,48,,87,-75.42726,6.170465
33843,2015,Octubre,Ecuador,4,1,,5,-73.181317,7.1280470000000005
33844,2015,Octubre,Ecuador,0,3,,3,-72.508188,7.927233
33845,2015,Octubre,Egipto,0,1,,1,-74.140516,4.697157
33846,2015,Octubre,El Salvador,1,1,,2,-75.516486,10.446304
33847,2015,Octubre,El Salvador,1,3,,4,-74.77647900000001,10.886686
33848,2015,Octubre,El Salvador,19,12,,31,-81.70216500000001,12.5862
33849,2015,Octubre,El Salvador,83,154,,237,-76.532004,3.451668
33850,2015,Octubre,El Salvador,1018,1435,,2453,-74.140516,4.697157
33851,2015,Octubre,El Salvador,0,2,,2,-75.736374,4.815189
33852,2015,Octubre,El Salvador,157,236,,393,-75.42726,6.170465
33853,2015,Octubre,Emiratos Árabes,3,3,,6,-74.140516,4.697157
33854,2015,Octubre,Eslovaquia,0,3,,3,-76.532004,3.451668
33855,2015,Octubre,Eslovaquia,2,3,,5,-74.140516,4.697157
33856,2015,Octubre,Eslovenia,3,5,,8,-74.140516,4.697157
33857,2015,Octubre,Estados Unidos de América,8,34,,42,-75.527794,10.406342
33858,2015,Octubre,Estados Unidos de América,1830,2937,,4767,-75.516486,10.446304
33859,2015,Octubre,Estados Unidos de América,449,911,,1360,-74.77647900000001,10.886686
33860,2015,Octubre,Estados Unidos de América,0,12,,12,-74.765343,10.970933
33861,2015,Octubre,Estados Unidos de América,0,3,,3,-74.232675,11.117206
33862,2015,Octubre,Estados Unidos de América,0,25,,25,-74.213989,11.247722999999999
33863,2015,Octubre,Estados Unidos de América,7,15,,22,-81.70216500000001,12.5862
33864,2015,Octubre,Estados Unidos de América,802,1231,,2033,-76.532004,3.451668
33865,2015,Octubre,Estados Unidos de América,84,129,,213,-75.76635300000001,4.45285
33866,2015,Octubre,Estados Unidos de América,7241,14181,,21422,-74.140516,4.697157
33867,2015,Octubre,Estados Unidos de América,79,150,,229,-75.736374,4.815189
33868,2015,Octubre,Estados Unidos de América,1638,4067,,5705,-75.42726,6.170465
33869,2015,Octubre,Estados Unidos de América,13,43,,56,-73.181317,7.1280470000000005
33870,2015,Octubre,Estados Unidos de América,44,27,,71,-72.508188,7.927233
33871,2015,Octubre,Estados Unidos de América,0,1,,1,-75.68164200000001,9.402597
33872,2015,Octubre,Estonia,1,3,,4,-74.140516,4.697157
33873,2015,Octubre,Filipinas,0,1,,1,-75.516486,10.446304
33874,2015,Octubre,Filipinas,0,2,,2,-74.77647900000001,10.886686
33875,2015,Octubre,Filipinas,3,12,,15,-74.140516,4.697157
33876,2015,Octubre,Finlandia,2,4,,6,-76.532004,3.451668
33877,2015,Octubre,Finlandia,4,5,,9,-74.140516,4.697157
33878,2015,Octubre,Finlandia,1,3,,4,-75.42726,6.170465
33879,2015,Octubre,Francia,0,1,,1,-75.516486,10.446304
33880,2015,Octubre,Francia,2,2,,4,-74.77647900000001,10.886686
33881,2015,Octubre,Francia,18,51,,69,-76.532004,3.451668
33882,2015,Octubre,Francia,1257,2217,,3474,-74.140516,4.697157
33883,2015,Octubre,Francia,1,3,,4,-75.736374,4.815189
33884,2015,Octubre,Francia,15,33,,48,-75.42726,6.170465
33885,2015,Octubre,Francia,3,6,,9,-73.181317,7.1280470000000005
33886,2015,Octubre,Georgia,0,1,,1,-74.140516,4.697157
33887,2015,Octubre,Ghana,0,1,,1,-74.140516,4.697157
33888,2015,Octubre,Gibraltar/Territorio Británico de Ultramar,0,1,,1,-77.35600000000001,0.81488
33889,2015,Octubre,Gibraltar/Territorio Británico de Ultramar,0,1,,1,-76.7333,8.06667
33890,2015,Octubre,Grecia,1,0,,1,-76.532004,3.451668
33891,2015,Octubre,Grecia,2,14,,16,-74.140516,4.697157
33892,2015,Octubre,Guatemala,1,5,,6,-75.516486,10.446304
33893,2015,Octubre,Guatemala,0,3,,3,-74.77647900000001,10.886686
33894,2015,Octubre,Guatemala,0,1,,1,-74.765343,10.970933
33895,2015,Octubre,Guatemala,30,43,,73,-81.70216500000001,12.5862
33896,2015,Octubre,Guatemala,36,61,,97,-76.532004,3.451668
33897,2015,Octubre,Guatemala,335,633,,968,-74.140516,4.697157
33898,2015,Octubre,Guatemala,3,7,,10,-75.736374,4.815189
33899,2015,Octubre,Guatemala,40,86,,126,-75.42726,6.170465
33900,2015,Octubre,Guatemala,0,7,,7,-73.181317,7.1280470000000005
33901,2015,Octubre,Guatemala,2,1,,3,-72.508188,7.927233
33902,2015,Octubre,Guyana,1,1,,2,-76.532004,3.451668
33903,2015,Octubre,Guyana,1,1,,2,-74.140516,4.697157
33904,2015,Octubre,Guyana,1,0,,1,-75.42726,6.170465
33905,2015,Octubre,Guinea Ecuatorial,1,0,,1,-74.140516,4.697157
33906,2015,Octubre,Guadalupe/Territorio Francés,1,1,,2,-75.527794,10.406342
33907,2015,Octubre,Guadalupe/Territorio Francés,0,1,,1,-76.532004,3.451668
33908,2015,Octubre,Guadalupe/Territorio Francés,1,2,,3,-74.140516,4.697157
33909,2015,Octubre,Haití,4,2,,6,-75.516486,10.446304
33910,2015,Octubre,Haití,0,1,,1,-74.77647900000001,10.886686
33911,2015,Octubre,Haití,0,7,,7,-74.765343,10.970933
33912,2015,Octubre,Haití,1,17,,18,-74.140516,4.697157
33913,2015,Octubre,Haití,1,0,,1,-75.736374,4.815189
33914,2015,Octubre,Haití,0,2,,2,-72.508188,7.927233
33915,2015,Octubre,Honduras,1,19,,20,-75.527794,10.406342
33916,2015,Octubre,Honduras,7,0,,7,-75.516486,10.446304
33917,2015,Octubre,Honduras,3,3,,6,-74.77647900000001,10.886686
33918,2015,Octubre,Honduras,2,3,,5,-81.703935,12.574411099999999
33919,2015,Octubre,Honduras,0,3,,3,-81.70216500000001,12.5862
33920,2015,Octubre,Honduras,34,60,,94,-76.532004,3.451668
33921,2015,Octubre,Honduras,85,68,,153,-74.140516,4.697157
33922,2015,Octubre,Honduras,16,47,,63,-75.42726,6.170465
33923,2015,Octubre,Honduras,0,1,,1,-73.181317,7.1280470000000005
33924,2015,Octubre,Hong Kong,7,3,,10,-76.532004,3.451668
33925,2015,Octubre,Hong Kong,3,0,,3,-74.140516,4.697157
33926,2015,Octubre,Hungría,0,1,,1,-76.532004,3.451668
33927,2015,Octubre,Hungría,4,5,,9,-74.140516,4.697157
33928,2015,Octubre,India,1,1,,2,-74.77647900000001,10.886686
33929,2015,Octubre,India,0,1,,1,-76.532004,3.451668
33930,2015,Octubre,India,3,31,,34,-74.140516,4.697157
33931,2015,Octubre,India,0,1,,1,-75.736374,4.815189
33932,2015,Octubre,India,2,2,,4,-75.42726,6.170465
33933,2015,Octubre,India,0,1,,1,-73.181317,7.1280470000000005
33934,2015,Octubre,Indonesia,1,0,,1,-74.140516,4.697157
33935,2015,Octubre,Iraq,0,1,,1,-74.140516,4.697157
33936,2015,Octubre,Irán,0,1,,1,-76.532004,3.451668
33937,2015,Octubre,Irán,0,1,,1,-74.140516,4.697157
33938,2015,Octubre,República de Irlanda,2,4,,6,-76.532004,3.451668
33939,2015,Octubre,República de Irlanda,8,6,,14,-74.140516,4.697157
33940,2015,Octubre,República de Irlanda,1,3,,4,-75.42726,6.170465
33941,2015,Octubre,República de Irlanda,2,0,,2,-72.508188,7.927233
33942,2015,Octubre,Islandia,1,0,,1,-74.140516,4.697157
33943,2015,Octubre,Israel,0,1,,1,-75.516486,10.446304
33944,2015,Octubre,Israel,0,1,,1,-81.70216500000001,12.5862
33945,2015,Octubre,Israel,2,7,,9,-76.532004,3.451668
33946,2015,Octubre,Israel,15,63,,78,-74.140516,4.697157
33947,2015,Octubre,Israel,0,6,,6,-75.42726,6.170465
33948,2015,Octubre,Italia,21,61,,82,-76.532004,3.451668
33949,2015,Octubre,Italia,96,193,,289,-74.140516,4.697157
33950,2015,Octubre,Italia,11,37,,48,-75.42726,6.170465
33951,2015,Octubre,Jamaica,0,2,,2,-75.516486,10.446304
33952,2015,Octubre,Jamaica,0,2,,2,-74.232675,11.117206
33953,2015,Octubre,Jamaica,2,2,,4,-81.70216500000001,12.5862
33954,2015,Octubre,Jamaica,2,1,,3,-76.532004,3.451668
33955,2015,Octubre,Jamaica,3,6,,9,-74.140516,4.697157
33956,2015,Octubre,Jamaica,0,2,,2,-75.42726,6.170465
33957,2015,Octubre,Japón,0,1,,1,-74.77647900000001,10.886686
33958,2015,Octubre,Japón,8,10,,18,-76.532004,3.451668
33959,2015,Octubre,Japón,4,16,,20,-74.140516,4.697157
33960,2015,Octubre,Japón,1,2,,3,-75.42726,6.170465
33961,2015,Octubre,Kazajistán,0,3,,3,-76.532004,3.451668
33962,2015,Octubre,Kazajistán,1,0,,1,-75.42726,6.170465
33963,2015,Octubre,Kenia,1,1,,2,-74.140516,4.697157
33964,2015,Octubre,Kirguistán,0,1,,1,-74.140516,4.697157
33965,2015,Octubre,Kuwait,0,1,,1,-75.736374,4.815189
33966,2015,Octubre,Letonia,2,1,,3,-74.140516,4.697157
33967,2015,Octubre,Lituania,2,1,,3,-74.140516,4.697157
33968,2015,Octubre,Líbano,5,9,,14,-74.140516,4.697157
33969,2015,Octubre,Libia,0,1,,1,-74.140516,4.697157
33970,2015,Octubre,Luxemburgo,1,1,,2,-74.140516,4.697157
33971,2015,Octubre,Madagascar,0,1,,1,-74.77647900000001,10.886686
33972,2015,Octubre,Malasia,2,0,,2,-76.532004,3.451668
33973,2015,Octubre,Malasia,1,4,,5,-74.140516,4.697157
33974,2015,Octubre,Malasia,0,1,,1,-75.42726,6.170465
33975,2015,Octubre,Malta,0,1,,1,-74.140516,4.697157
33976,2015,Octubre,Malta,0,1,,1,-75.42726,6.170465
33977,2015,Octubre,Marruecos,4,1,,5,-74.140516,4.697157
33978,2015,Octubre,México,0,8,,8,-75.527794,10.406342
33979,2015,Octubre,México,8,9,,17,-75.516486,10.446304
33980,2015,Octubre,México,8,31,,39,-74.77647900000001,10.886686
33981,2015,Octubre,México,0,6,,6,-74.765343,10.970933
33982,2015,Octubre,México,9,5,,14,-81.70216500000001,12.5862
33983,2015,Octubre,México,51,108,,159,-76.532004,3.451668
33984,2015,Octubre,México,4227,7321,,11548,-74.140516,4.697157
33985,2015,Octubre,México,6,12,,18,-75.736374,4.815189
33986,2015,Octubre,México,526,1180,,1706,-75.42726,6.170465
33987,2015,Octubre,México,9,22,,31,-73.181317,7.1280470000000005
33988,2015,Octubre,México,4,8,,12,-72.508188,7.927233
33989,2015,Octubre,Mónaco,0,3,,3,-74.140516,4.697157
33990,2015,Octubre,Nepal,0,2,,2,-74.140516,4.697157
33991,2015,Octubre,Nicaragua,0,3,,3,-75.516486,10.446304
33992,2015,Octubre,Nicaragua,1,3,,4,-74.77647900000001,10.886686
33993,2015,Octubre,Nicaragua,2,0,,2,-81.70216500000001,12.5862
33994,2015,Octubre,Nicaragua,14,7,,21,-76.532004,3.451668
33995,2015,Octubre,Nicaragua,16,29,,45,-74.140516,4.697157
33996,2015,Octubre,Nicaragua,3,6,,9,-75.736374,4.815189
33997,2015,Octubre,Nicaragua,4,11,,15,-75.42726,6.170465
33998,2015,Octubre,Nicaragua,1,0,,1,-73.181317,7.1280470000000005
33999,2015,Octubre,Nicaragua,1,0,,1,-72.508188,7.927233
34000,2015,Octubre,Noruega,3,3,,6,-76.532004,3.451668
34001,2015,Octubre,Noruega,14,18,,32,-74.140516,4.697157
34002,2015,Octubre,Noruega,1,1,,2,-75.42726,6.170465
34003,2015,Octubre,Nueva Zelanda,2,1,,3,-76.532004,3.451668
34004,2015,Octubre,Nueva Zelanda,5,1,,6,-74.140516,4.697157
34005,2015,Octubre,Nueva Zelanda,0,1,,1,-75.42726,6.170465
34006,2015,Octubre,Pakistán,0,1,,1,-76.532004,3.451668
34007,2015,Octubre,Panamá,0,13,,13,-78.802679,18.00143
34008,2015,Octubre,Panamá,1253,918,,2171,-75.527794,10.406342
34009,2015,Octubre,Panamá,2252,2532,,4784,-75.516486,10.446304
34010,2015,Octubre,Panamá,243,575,,818,-74.77647900000001,10.886686
34011,2015,Octubre,Panamá,1,29,,30,-74.765343,10.970933
34012,2015,Octubre,Panamá,3,3,,6,-74.213989,11.247722999999999
34013,2015,Octubre,Panamá,6,12,,18,-81.703935,12.574411099999999
34014,2015,Octubre,Panamá,411,356,,767,-81.70216500000001,12.5862
34015,2015,Octubre,Panamá,4,5,,9,-81.372937,13.338761300000002
34016,2015,Octubre,Panamá,290,506,,796,-76.532004,3.451668
34017,2015,Octubre,Panamá,0,13,,13,-77.061029,3.8844260000000004
34018,2015,Octubre,Panamá,4032,5986,,10018,-74.140516,4.697157
34019,2015,Octubre,Panamá,51,113,,164,-75.736374,4.815189
34020,2015,Octubre,Panamá,1621,2471,,4092,-75.42726,6.170465
34021,2015,Octubre,Panamá,0,3,,3,-77.401154,6.222551999999999
34022,2015,Octubre,Panamá,3,8,,11,-77.762647,7.102626
34023,2015,Octubre,Panamá,48,83,,131,-73.181317,7.1280470000000005
34024,2015,Octubre,Panamá,38,47,,85,-72.508188,7.927233
34025,2015,Octubre,Panamá,1,3,,4,-76.7333,8.06667
34026,2015,Octubre,Panamá,84,103,,187,-77.35002,8.63337
34027,2015,Octubre,Panamá,10,15,,25,-75.68164200000001,9.402597
34028,2015,Octubre,Paraguay,4,3,,7,-75.516486,10.446304
34029,2015,Octubre,Paraguay,0,1,,1,-74.77647900000001,10.886686
34030,2015,Octubre,Paraguay,59,25,,84,-81.70216500000001,12.5862
34031,2015,Octubre,Paraguay,11,13,,24,-76.532004,3.451668
34032,2015,Octubre,Paraguay,80,71,,151,-74.140516,4.697157
34033,2015,Octubre,Paraguay,7,15,,22,-75.42726,6.170465
34034,2015,Octubre,Paraguay,1,0,,1,-73.181317,7.1280470000000005
34035,2015,Octubre,Paraguay,1,1,,2,-72.508188,7.927233
34036,2015,Octubre,Perú,55,95,,150,-69.941498,4.191162
34037,2015,Octubre,Perú,2,5,,7,-69.94143100000001,4.214082
34038,2015,Octubre,Perú,7,26,,33,-77.35600000000001,0.81488
34039,2015,Octubre,Perú,0,1,,1,-75.527794,10.406342
34040,2015,Octubre,Perú,9,11,,20,-75.516486,10.446304
34041,2015,Octubre,Perú,13,142,,155,-74.77647900000001,10.886686
34042,2015,Octubre,Perú,195,127,,322,-81.70216500000001,12.5862
34043,2015,Octubre,Perú,325,451,,776,-76.532004,3.451668
34044,2015,Octubre,Perú,6813,8930,,15743,-74.140516,4.697157
34045,2015,Octubre,Perú,1,0,,1,-75.736374,4.815189
34046,2015,Octubre,Perú,425,779,,1204,-75.42726,6.170465
34047,2015,Octubre,Perú,1,2,,3,-73.181317,7.1280470000000005
34048,2015,Octubre,Perú,1,1,,2,-72.508188,7.927233
34049,2015,Octubre,Polonia,2,4,,6,-76.532004,3.451668
34050,2015,Octubre,Polonia,10,26,,36,-74.140516,4.697157
34051,2015,Octubre,Polonia,1,16,,17,-75.42726,6.170465
34052,2015,Octubre,Portugal,1,0,,1,-74.77647900000001,10.886686
34053,2015,Octubre,Portugal,0,2,,2,-74.765343,10.970933
34054,2015,Octubre,Portugal,2,9,,11,-76.532004,3.451668
34055,2015,Octubre,Portugal,363,591,,954,-74.140516,4.697157
34056,2015,Octubre,Portugal,5,7,,12,-75.42726,6.170465
34057,2015,Octubre,Polinesia Francesa/Colectividad de Ultramar Francesa,0,1,,1,-74.140516,4.697157
34058,2015,Octubre,Puerto Rico/Territorio de Estados Unidos,6,20,,26,-74.77647900000001,10.886686
34059,2015,Octubre,Puerto Rico/Territorio de Estados Unidos,3,2,,5,-81.70216500000001,12.5862
34060,2015,Octubre,Puerto Rico/Territorio de Estados Unidos,18,57,,75,-76.532004,3.451668
34061,2015,Octubre,Puerto Rico/Territorio de Estados Unidos,211,342,,553,-74.140516,4.697157
34062,2015,Octubre,Puerto Rico/Territorio de Estados Unidos,3,12,,15,-75.736374,4.815189
34063,2015,Octubre,Puerto Rico/Territorio de Estados Unidos,35,63,,98,-75.42726,6.170465
34064,2015,Octubre,Puerto Rico/Territorio de Estados Unidos,1,4,,5,-73.181317,7.1280470000000005
34065,2015,Octubre,Puerto Rico/Territorio de Estados Unidos,1,0,,1,-72.508188,7.927233
34066,2015,Octubre,Qatar,0,1,,1,-74.140516,4.697157
34067,2015,Octubre,Reino Unido de Gran Bretaña e Irlanda del Norte,0,1,,1,-74.77647900000001,10.886686
34068,2015,Octubre,Reino Unido de Gran Bretaña e Irlanda del Norte,10,26,,36,-76.532004,3.451668
34069,2015,Octubre,Reino Unido de Gran Bretaña e Irlanda del Norte,587,980,,1567,-74.140516,4.697157
34070,2015,Octubre,Reino Unido de Gran Bretaña e Irlanda del Norte,9,24,,33,-75.42726,6.170465
34071,2015,Octubre,República CentroÁfricana,1,0,,1,-74.140516,4.697157
34072,2015,Octubre,Federación de Rusia,10,19,,29,-76.532004,3.451668
34073,2015,Octubre,Federación de Rusia,17,27,,44,-74.140516,4.697157
34074,2015,Octubre,Federación de Rusia,1,1,,2,-75.42726,6.170465
34075,2015,Octubre,República Dominicana,27,36,,63,-75.527794,10.406342
34076,2015,Octubre,República Dominicana,2,7,,9,-75.516486,10.446304
34077,2015,Octubre,República Dominicana,6,30,,36,-74.77647900000001,10.886686
34078,2015,Octubre,República Dominicana,0,2,,2,-74.765343,10.970933
34079,2015,Octubre,República Dominicana,0,1,,1,-81.70216500000001,12.5862
34080,2015,Octubre,República Dominicana,19,24,,43,-76.532004,3.451668
34081,2015,Octubre,República Dominicana,605,788,,1393,-74.140516,4.697157
34082,2015,Octubre,República Dominicana,3,4,,7,-75.736374,4.815189
34083,2015,Octubre,República Dominicana,14,34,,48,-75.42726,6.170465
34084,2015,Octubre,República Dominicana,2,1,,3,-73.181317,7.1280470000000005
34085,2015,Octubre,República Dominicana,0,1,,1,-72.508188,7.927233
34086,2015,Octubre,Rumania,0,1,,1,-75.516486,10.446304
34087,2015,Octubre,Rumania,0,1,,1,-74.77647900000001,10.886686
34088,2015,Octubre,Rumania,1,1,,2,-76.532004,3.451668
34089,2015,Octubre,Rumania,3,8,,11,-74.140516,4.697157
34090,2015,Octubre,San  Vicente y las Granadinas,0,1,,1,-75.516486,10.446304
34091,2015,Octubre,San  Vicente y las Granadinas,0,1,,1,-74.765343,10.970933
34092,2015,Octubre,San  Vicente y las Granadinas,1,1,,2,-75.42726,6.170465
34093,2015,Octubre,Santa Lucia,1,1,,2,-74.140516,4.697157
34094,2015,Octubre,Senegal,0,1,,1,-74.140516,4.697157
34095,2015,Octubre,Singapur,3,0,,3,-76.532004,3.451668
34096,2015,Octubre,Singapur,2,2,,4,-74.140516,4.697157
34097,2015,Octubre,Sri Lanka,0,1,,1,-75.42726,6.170465
34098,2015,Octubre,Sudáfrica,6,7,,13,-74.140516,4.697157
34099,2015,Octubre,Suecia,1,0,,1,-74.77647900000001,10.886686
34100,2015,Octubre,Suecia,9,6,,15,-76.532004,3.451668
34101,2015,Octubre,Suecia,19,30,,49,-74.140516,4.697157
34102,2015,Octubre,Suecia,2,2,,4,-75.42726,6.170465
34103,2015,Octubre,Suiza,3,0,,3,-74.77647900000001,10.886686
34104,2015,Octubre,Suiza,14,28,,42,-76.532004,3.451668
34105,2015,Octubre,Suiza,63,92,,155,-74.140516,4.697157
34106,2015,Octubre,Suiza,5,15,,20,-75.42726,6.170465
34107,2015,Octubre,Suiza,1,3,,4,-73.181317,7.1280470000000005
34108,2015,Octubre,Suiza,3,0,,3,-72.508188,7.927233
34109,2015,Octubre,Surinam,3,4,,7,-75.42726,6.170465
34110,2015,Octubre,Taiwán,2,5,,7,-76.532004,3.451668
34111,2015,Octubre,Taiwán,1,5,,6,-74.140516,4.697157
34112,2015,Octubre,Taiwán,0,2,,2,-75.42726,6.170465
34113,2015,Octubre,República de Tayikistán,1,0,,1,-74.140516,4.697157
34114,2015,Octubre,Tailandia,1,0,,1,-76.532004,3.451668
34115,2015,Octubre,Tailandia,2,3,,5,-74.140516,4.697157
34116,2015,Octubre,Tanzania,1,1,,2,-74.140516,4.697157
34117,2015,Octubre,Trinidad y Tobago,0,4,,4,-75.527794,10.406342
34118,2015,Octubre,Trinidad y Tobago,1,5,,6,-75.516486,10.446304
34119,2015,Octubre,Trinidad y Tobago,0,1,,1,-74.77647900000001,10.886686
34120,2015,Octubre,Trinidad y Tobago,4,11,,15,-76.532004,3.451668
34121,2015,Octubre,Trinidad y Tobago,4,4,,8,-74.140516,4.697157
34122,2015,Octubre,Trinidad y Tobago,0,5,,5,-75.42726,6.170465
34123,2015,Octubre,Trinidad y Tobago,0,1,,1,-73.181317,7.1280470000000005
34124,2015,Octubre,Turquía,2,5,,7,-76.532004,3.451668
34125,2015,Octubre,Turquía,3,12,,15,-74.140516,4.697157
34126,2015,Octubre,Ucrania,4,5,,9,-76.532004,3.451668
34127,2015,Octubre,Ucrania,4,2,,6,-74.140516,4.697157
34128,2015,Octubre,Ucrania,1,0,,1,-75.42726,6.170465
34129,2015,Octubre,Uruguay,6,4,,10,-75.516486,10.446304
34130,2015,Octubre,Uruguay,0,1,,1,-74.77647900000001,10.886686
34131,2015,Octubre,Uruguay,14,9,,23,-81.70216500000001,12.5862
34132,2015,Octubre,Uruguay,14,16,,30,-76.532004,3.451668
34133,2015,Octubre,Uruguay,57,87,,144,-74.140516,4.697157
34134,2015,Octubre,Uruguay,0,1,,1,-75.736374,4.815189
34135,2015,Octubre,Uruguay,40,33,,73,-75.42726,6.170465
34136,2015,Octubre,Venezuela,0,21,,21,-75.527794,10.406342
34137,2015,Octubre,Venezuela,443,376,,819,-75.516486,10.446304
34138,2015,Octubre,Venezuela,20,63,,83,-74.77647900000001,10.886686
34139,2015,Octubre,Venezuela,2,20,,22,-74.232675,11.117206
34140,2015,Octubre,Venezuela,206,288,,494,-72.129595,11.360028999999999
34141,2015,Octubre,Venezuela,18,33,,51,-76.532004,3.451668
34142,2015,Octubre,Venezuela,34,55,,89,-67.927521,3.866713
34143,2015,Octubre,Venezuela,4433,4837,,9270,-74.140516,4.697157
34144,2015,Octubre,Venezuela,0,2,,2,-75.736374,4.815189
34145,2015,Octubre,Venezuela,2400,2107,,4507,-75.42726,6.170465
34146,2015,Octubre,Venezuela,27,50,,77,-67.48402800000001,6.185536
34147,2015,Octubre,Venezuela,46,96,,142,-70.74025300000001,7.088728999999999
34148,2015,Octubre,Venezuela,6,10,,16,-73.181317,7.1280470000000005
34149,2015,Octubre,Venezuela,1793,2282,,4075,-72.453013,7.819
34150,2015,Octubre,Venezuela,78,95,,173,-72.508188,7.927233
34151,2015,Octubre,Islas Vírgenes Británicas/Territorio Británico de Ultramar,0,1,,1,-75.527794,10.406342
34152,2015,Octubre,Islas Vírgenes Estadounidenses/Territorio de Estados Unidos,0,1,,1,-75.527794,10.406342
34153,2015,Octubre,Desconocido,0,10,,10,-77.061029,3.8844260000000004
34154,2015,Octubre,Desconocido,0,8,,8,-75.68164200000001,9.402597
34155,2015,Noviembre,Afganistán,0,2,,2,-74.140516,4.697157
34156,2015,Noviembre,Alemania,5,3,,8,-75.516486,10.446304
34157,2015,Noviembre,Alemania,1,1,,2,-74.77647900000001,10.886686
34158,2015,Noviembre,Alemania,1,0,,1,-81.70216500000001,12.5862
34159,2015,Noviembre,Alemania,22,38,,60,-76.532004,3.451668
34160,2015,Noviembre,Alemania,1157,2187,,3344,-74.140516,4.697157
34161,2015,Noviembre,Alemania,0,1,,1,-75.736374,4.815189
34162,2015,Noviembre,Alemania,12,36,,48,-75.42726,6.170465
34163,2015,Noviembre,Alemania,1,0,,1,-73.181317,7.1280470000000005
34164,2015,Noviembre,Andorra,0,1,,1,-75.42726,6.170465
34165,2015,Noviembre,Angola,1,0,,1,-76.532004,3.451668
34166,2015,Noviembre,Antigua y Barbuda,0,1,,1,-75.527794,10.406342
34167,2015,Noviembre,Antigua y Barbuda,1,3,,4,-74.140516,4.697157
34168,2015,Noviembre,Países Bajos,21,32,,53,-75.527794,10.406342
34169,2015,Noviembre,Países Bajos,0,3,,3,-75.516486,10.446304
34170,2015,Noviembre,Países Bajos,57,80,,137,-74.77647900000001,10.886686
34171,2015,Noviembre,Países Bajos,4,6,,10,-74.213989,11.247722999999999
34172,2015,Noviembre,Países Bajos,70,162,,232,-76.532004,3.451668
34173,2015,Noviembre,Países Bajos,771,1215,,1986,-74.140516,4.697157
34174,2015,Noviembre,Países Bajos,1,2,,3,-75.736374,4.815189
34175,2015,Noviembre,Países Bajos,200,288,,488,-75.42726,6.170465
34176,2015,Noviembre,Países Bajos,1,1,,2,-73.181317,7.1280470000000005
34177,2015,Noviembre,Arabia Saudita,1,0,,1,-74.140516,4.697157
34178,2015,Noviembre,Argelia,3,5,,8,-74.140516,4.697157
34179,2015,Noviembre,Argelia,1,2,,3,-75.42726,6.170465
34180,2015,Noviembre,Argentina,2,4,,6,-77.35600000000001,0.81488
34181,2015,Noviembre,Argentina,0,1,,1,-78.802679,18.00143
34182,2015,Noviembre,Argentina,0,2,,2,-75.527794,10.406342
34183,2015,Noviembre,Argentina,69,37,,106,-75.516486,10.446304
34184,2015,Noviembre,Argentina,6,78,,84,-74.77647900000001,10.886686
34185,2015,Noviembre,Argentina,330,213,,543,-81.70216500000001,12.5862
34186,2015,Noviembre,Argentina,48,70,,118,-76.532004,3.451668
34187,2015,Noviembre,Argentina,0,1,,1,-77.061029,3.8844260000000004
34188,2015,Noviembre,Argentina,1745,2796,,4541,-74.140516,4.697157
34189,2015,Noviembre,Argentina,0,2,,2,-75.736374,4.815189
34190,2015,Noviembre,Argentina,139,208,,347,-75.42726,6.170465
34191,2015,Noviembre,Argentina,1,3,,4,-73.181317,7.1280470000000005
34192,2015,Noviembre,Argentina,0,2,,2,-72.508188,7.927233
34193,2015,Noviembre,Aruba,11,24,,35,-75.527794,10.406342
34194,2015,Noviembre,Aruba,0,3,,3,-75.516486,10.446304
34195,2015,Noviembre,Aruba,2,4,,6,-74.77647900000001,10.886686
34196,2015,Noviembre,Aruba,13,22,,35,-74.213989,11.247722999999999
34197,2015,Noviembre,Aruba,9,8,,17,-76.532004,3.451668
34198,2015,Noviembre,Aruba,541,644,,1185,-74.140516,4.697157
34199,2015,Noviembre,Aruba,63,93,,156,-75.42726,6.170465
34200,2015,Noviembre,Aruba,11,14,,25,-73.181317,7.1280470000000005
34201,2015,Noviembre,Aruba,1,3,,4,-72.508188,7.927233
34202,2015,Noviembre,Australia,2,3,,5,-75.516486,10.446304
34203,2015,Noviembre,Australia,2,0,,2,-74.77647900000001,10.886686
34204,2015,Noviembre,Australia,7,10,,17,-76.532004,3.451668
34205,2015,Noviembre,Australia,43,62,,105,-74.140516,4.697157
34206,2015,Noviembre,Australia,2,5,,7,-75.736374,4.815189
34207,2015,Noviembre,Australia,7,22,,29,-75.42726,6.170465
34208,2015,Noviembre,Australia,0,1,,1,-73.181317,7.1280470000000005
34209,2015,Noviembre,Austria,1,3,,4,-76.532004,3.451668
34210,2015,Noviembre,Austria,19,41,,60,-74.140516,4.697157
34211,2015,Noviembre,Austria,0,2,,2,-75.42726,6.170465
34212,2015,Noviembre,Bahamas,2,3,,5,-75.516486,10.446304
34213,2015,Noviembre,Bahamas,1,0,,1,-81.70216500000001,12.5862
34214,2015,Noviembre,Bahamas,1,0,,1,-76.532004,3.451668
34215,2015,Noviembre,Bahamas,1,3,,4,-74.140516,4.697157
34216,2015,Noviembre,Bahamas,0,1,,1,-75.42726,6.170465
34217,2015,Noviembre,Bahréin,0,1,,1,-75.516486,10.446304
34218,2015,Noviembre,Bahréin,0,1,,1,-76.532004,3.451668
34219,2015,Noviembre,Bahréin,0,2,,2,-75.42726,6.170465
34220,2015,Noviembre,Barbados,4,4,,8,-74.140516,4.697157
34221,2015,Noviembre,Barbados,0,1,,1,-75.42726,6.170465
34222,2015,Noviembre,República de Belarús,1,0,,1,-74.140516,4.697157
34223,2015,Noviembre,Bélgica,1,0,,1,-75.516486,10.446304
34224,2015,Noviembre,Bélgica,0,2,,2,-74.77647900000001,10.886686
34225,2015,Noviembre,Bélgica,3,8,,11,-76.532004,3.451668
34226,2015,Noviembre,Bélgica,35,60,,95,-74.140516,4.697157
34227,2015,Noviembre,Bélgica,1,7,,8,-75.42726,6.170465
34228,2015,Noviembre,Belice,0,1,,1,-76.532004,3.451668
34229,2015,Noviembre,Belice,7,4,,11,-74.140516,4.697157
34230,2015,Noviembre,Belice,0,1,,1,-75.42726,6.170465
34231,2015,Noviembre,Benín,0,1,,1,-76.532004,3.451668
34232,2015,Noviembre,Benín,2,2,,4,-74.140516,4.697157
34233,2015,Noviembre,Bermudas/Territorio Británico de Ultramar,0,1,,1,-74.140516,4.697157
34234,2015,Noviembre,Bolivia,2,1,,3,-77.35600000000001,0.81488
34235,2015,Noviembre,Bolivia,6,2,,8,-75.516486,10.446304
34236,2015,Noviembre,Bolivia,0,2,,2,-74.77647900000001,10.886686
34237,2015,Noviembre,Bolivia,29,12,,41,-81.70216500000001,12.5862
34238,2015,Noviembre,Bolivia,34,41,,75,-76.532004,3.451668
34239,2015,Noviembre,Bolivia,378,557,,935,-74.140516,4.697157
34240,2015,Noviembre,Bolivia,1,1,,2,-75.736374,4.815189
34241,2015,Noviembre,Bolivia,37,30,,67,-75.42726,6.170465
34242,2015,Noviembre,Bolivia,1,0,,1,-73.181317,7.1280470000000005
34243,2015,Noviembre,Brasil,122,137,,259,-69.941498,4.191162
34244,2015,Noviembre,Brasil,8,17,,25,-69.94143100000001,4.214082
34245,2015,Noviembre,Brasil,1,1,,2,-77.35600000000001,0.81488
34246,2015,Noviembre,Brasil,24,27,,51,-75.516486,10.446304
34247,2015,Noviembre,Brasil,1,4,,5,-74.77647900000001,10.886686
34248,2015,Noviembre,Brasil,254,207,,461,-81.70216500000001,12.5862
34249,2015,Noviembre,Brasil,41,95,,136,-76.532004,3.451668
34250,2015,Noviembre,Brasil,0,4,,4,-67.927521,3.866713
34251,2015,Noviembre,Brasil,3378,5521,,8899,-74.140516,4.697157
34252,2015,Noviembre,Brasil,2,27,,29,-75.736374,4.815189
34253,2015,Noviembre,Brasil,106,239,,345,-75.42726,6.170465
34254,2015,Noviembre,Brasil,3,4,,7,-73.181317,7.1280470000000005
34255,2015,Noviembre,Brunei Darussalam,0,1,,1,-74.140516,4.697157
34256,2015,Noviembre,Bulgaria,2,0,,2,-74.140516,4.697157
34257,2015,Noviembre,Cabo Verde,0,3,,3,-74.765343,10.970933
34258,2015,Noviembre,Islas Caimán/Territorio Británico de Ultramar,4,5,,9,-75.527794,10.406342
34259,2015,Noviembre,Islas Caimán/Territorio Británico de Ultramar,1,5,,6,-81.70216500000001,12.5862
34260,2015,Noviembre,Islas Caimán/Territorio Británico de Ultramar,0,3,,3,-74.140516,4.697157
34261,2015,Noviembre,Camboya,0,1,,1,-74.140516,4.697157
34262,2015,Noviembre,Camerún,0,1,,1,-76.532004,3.451668
34263,2015,Noviembre,Canadá,0,1,,1,-75.527794,10.406342
34264,2015,Noviembre,Canadá,10,19,,29,-75.516486,10.446304
34265,2015,Noviembre,Canadá,5,6,,11,-74.77647900000001,10.886686
34266,2015,Noviembre,Canadá,1,1,,2,-81.70216500000001,12.5862
34267,2015,Noviembre,Canadá,24,55,,79,-76.532004,3.451668
34268,2015,Noviembre,Canadá,602,986,,1588,-74.140516,4.697157
34269,2015,Noviembre,Canadá,4,7,,11,-75.736374,4.815189
34270,2015,Noviembre,Canadá,68,146,,214,-75.42726,6.170465
34271,2015,Noviembre,Canadá,4,6,,10,-73.181317,7.1280470000000005
34272,2015,Noviembre,Canadá,0,4,,4,-72.508188,7.927233
34273,2015,Noviembre,España,2,27,,29,-75.527794,10.406342
34274,2015,Noviembre,España,1,1,,2,-75.516486,10.446304
34275,2015,Noviembre,España,3,7,,10,-74.77647900000001,10.886686
34276,2015,Noviembre,España,0,2,,2,-74.765343,10.970933
34277,2015,Noviembre,España,0,1,,1,-74.213989,11.247722999999999
34278,2015,Noviembre,España,0,1,,1,-81.70216500000001,12.5862
34279,2015,Noviembre,España,503,706,,1209,-76.532004,3.451668
34280,2015,Noviembre,España,2879,5980,,8859,-74.140516,4.697157
34281,2015,Noviembre,España,10,28,,38,-75.736374,4.815189
34282,2015,Noviembre,España,256,509,,765,-75.42726,6.170465
34283,2015,Noviembre,España,3,7,,10,-73.181317,7.1280470000000005
34284,2015,Noviembre,España,1,2,,3,-72.508188,7.927233
34285,2015,Noviembre,República Del Congo,0,1,,1,-74.140516,4.697157
34286,2015,Noviembre,República Democrática del Congo,0,1,,1,-74.140516,4.697157
34287,2015,Noviembre,República de Corea,0,2,,2,-75.527794,10.406342
34288,2015,Noviembre,República de Corea,16,31,,47,-74.140516,4.697157
34289,2015,Noviembre,República de Corea,0,4,,4,-75.42726,6.170465
34290,2015,Noviembre,Costa de Marfil,5,6,,11,-74.140516,4.697157
34291,2015,Noviembre,Costa de Marfil,0,1,,1,-75.42726,6.170465
34292,2015,Noviembre,Costa Rica,0,4,,4,-75.527794,10.406342
34293,2015,Noviembre,Costa Rica,3,2,,5,-75.516486,10.446304
34294,2015,Noviembre,Costa Rica,9,8,,17,-74.77647900000001,10.886686
34295,2015,Noviembre,Costa Rica,69,67,,136,-81.70216500000001,12.5862
34296,2015,Noviembre,Costa Rica,24,56,,80,-76.532004,3.451668
34297,2015,Noviembre,Costa Rica,970,1624,,2594,-74.140516,4.697157
34298,2015,Noviembre,Costa Rica,2,2,,4,-75.736374,4.815189
34299,2015,Noviembre,Costa Rica,91,126,,217,-75.42726,6.170465
34300,2015,Noviembre,Costa Rica,3,0,,3,-73.181317,7.1280470000000005
34301,2015,Noviembre,Costa Rica,1,1,,2,-72.508188,7.927233
34302,2015,Noviembre,Croacia,0,4,,4,-76.532004,3.451668
34303,2015,Noviembre,Croacia,0,7,,7,-74.140516,4.697157
34304,2015,Noviembre,Cuba,131,130,,261,-75.516486,10.446304
34305,2015,Noviembre,Cuba,5,9,,14,-74.77647900000001,10.886686
34306,2015,Noviembre,Cuba,2,1,,3,-81.70216500000001,12.5862
34307,2015,Noviembre,Cuba,15,12,,27,-76.532004,3.451668
34308,2015,Noviembre,Cuba,378,668,,1046,-74.140516,4.697157
34309,2015,Noviembre,Cuba,2,2,,4,-75.736374,4.815189
34310,2015,Noviembre,Cuba,39,41,,80,-75.42726,6.170465
34311,2015,Noviembre,Cuba,4,2,,6,-73.181317,7.1280470000000005
34312,2015,Noviembre,Cuba,0,1,,1,-72.508188,7.927233
34313,2015,Noviembre,Curazao,0,1,,1,-75.42726,6.170465
34314,2015,Noviembre,República Checa,0,1,,1,-81.70216500000001,12.5862
34315,2015,Noviembre,República Checa,2,4,,6,-76.532004,3.451668
34316,2015,Noviembre,República Checa,14,23,,37,-74.140516,4.697157
34317,2015,Noviembre,República Checa,0,2,,2,-72.508188,7.927233
34318,2015,Noviembre,Chile,2,5,,7,-77.35600000000001,0.81488
34319,2015,Noviembre,Chile,6,9,,15,-75.516486,10.446304
34320,2015,Noviembre,Chile,6,13,,19,-74.77647900000001,10.886686
34321,2015,Noviembre,Chile,11,10,,21,-81.70216500000001,12.5862
34322,2015,Noviembre,Chile,17,45,,62,-76.532004,3.451668
34323,2015,Noviembre,Chile,3789,5641,,9430,-74.140516,4.697157
34324,2015,Noviembre,Chile,1,1,,2,-75.736374,4.815189
34325,2015,Noviembre,Chile,25,80,,105,-75.42726,6.170465
34326,2015,Noviembre,Chile,0,1,,1,-72.508188,7.927233
34327,2015,Noviembre,China,0,3,,3,-76.532004,3.451668
34328,2015,Noviembre,China,17,52,,69,-74.140516,4.697157
34329,2015,Noviembre,China,3,6,,9,-75.42726,6.170465
34330,2015,Noviembre,Chipre,0,2,,2,-74.140516,4.697157
34331,2015,Noviembre,Dinamarca,1,0,,1,-74.77647900000001,10.886686
34332,2015,Noviembre,Dinamarca,4,5,,9,-76.532004,3.451668
34333,2015,Noviembre,Dinamarca,14,25,,39,-74.140516,4.697157
34334,2015,Noviembre,Dinamarca,1,3,,4,-75.42726,6.170465
34335,2015,Noviembre,Dominica,2,0,,2,-74.140516,4.697157
34336,2015,Noviembre,Dominica,0,1,,1,-75.42726,6.170465
34337,2015,Noviembre,Ecuador,85,203,,288,-76.876446,0.33002
34338,2015,Noviembre,Ecuador,0,3,,3,-77.84700600000001,0.8124359999999999
34339,2015,Noviembre,Ecuador,2480,3984,,6464,-77.35600000000001,0.81488
34340,2015,Noviembre,Ecuador,24,106,,130,-78.802679,18.00143
34341,2015,Noviembre,Ecuador,1,1,,2,-75.516486,10.446304
34342,2015,Noviembre,Ecuador,5,12,,17,-74.77647900000001,10.886686
34343,2015,Noviembre,Ecuador,13,8,,21,-81.70216500000001,12.5862
34344,2015,Noviembre,Ecuador,455,476,,931,-76.532004,3.451668
34345,2015,Noviembre,Ecuador,3245,5082,,8327,-74.140516,4.697157
34346,2015,Noviembre,Ecuador,0,2,,2,-75.736374,4.815189
34347,2015,Noviembre,Ecuador,14,31,,45,-75.42726,6.170465
34348,2015,Noviembre,Ecuador,1,1,,2,-73.181317,7.1280470000000005
34349,2015,Noviembre,Ecuador,0,1,,1,-72.508188,7.927233
34350,2015,Noviembre,Egipto,0,3,,3,-74.140516,4.697157
34351,2015,Noviembre,Egipto,0,1,,1,-75.42726,6.170465
34352,2015,Noviembre,El Salvador,5,1,,6,-75.516486,10.446304
34353,2015,Noviembre,El Salvador,31,33,,64,-81.70216500000001,12.5862
34354,2015,Noviembre,El Salvador,121,196,,317,-76.532004,3.451668
34355,2015,Noviembre,El Salvador,1008,1585,,2593,-74.140516,4.697157
34356,2015,Noviembre,El Salvador,181,294,,475,-75.42726,6.170465
34357,2015,Noviembre,Emiratos Árabes,0,1,,1,-76.532004,3.451668
34358,2015,Noviembre,Emiratos Árabes,1,4,,5,-74.140516,4.697157
34359,2015,Noviembre,Emiratos Árabes,1,2,,3,-75.42726,6.170465
34360,2015,Noviembre,Eritrea,0,1,,1,-74.140516,4.697157
34361,2015,Noviembre,Eslovaquia,4,3,,7,-74.140516,4.697157
34362,2015,Noviembre,Eslovenia,1,1,,2,-74.140516,4.697157
34363,2015,Noviembre,Eslovenia,0,1,,1,-75.736374,4.815189
34364,2015,Noviembre,Eslovenia,3,0,,3,-75.42726,6.170465
34365,2015,Noviembre,Estados Unidos de América,3,51,,54,-75.527794,10.406342
34366,2015,Noviembre,Estados Unidos de América,2305,3641,,5946,-75.516486,10.446304
34367,2015,Noviembre,Estados Unidos de América,572,1004,,1576,-74.77647900000001,10.886686
34368,2015,Noviembre,Estados Unidos de América,0,2,,2,-74.765343,10.970933
34369,2015,Noviembre,Estados Unidos de América,0,1,,1,-74.232675,11.117206
34370,2015,Noviembre,Estados Unidos de América,0,28,,28,-74.213989,11.247722999999999
34371,2015,Noviembre,Estados Unidos de América,19,41,,60,-81.70216500000001,12.5862
34372,2015,Noviembre,Estados Unidos de América,848,1355,,2203,-76.532004,3.451668
34373,2015,Noviembre,Estados Unidos de América,80,129,,209,-75.76635300000001,4.45285
34374,2015,Noviembre,Estados Unidos de América,8180,16037,,24217,-74.140516,4.697157
34375,2015,Noviembre,Estados Unidos de América,89,124,,213,-75.736374,4.815189
34376,2015,Noviembre,Estados Unidos de América,1956,4866,,6822,-75.42726,6.170465
34377,2015,Noviembre,Estados Unidos de América,19,42,,61,-73.181317,7.1280470000000005
34378,2015,Noviembre,Estados Unidos de América,32,30,,62,-72.508188,7.927233
34379,2015,Noviembre,Estonia,0,14,,14,-75.527794,10.406342
34380,2015,Noviembre,Estonia,1,4,,5,-74.140516,4.697157
34381,2015,Noviembre,Etiopia,0,2,,2,-74.140516,4.697157
34382,2015,Noviembre,Filipinas,0,2,,2,-75.516486,10.446304
34383,2015,Noviembre,Filipinas,0,2,,2,-74.77647900000001,10.886686
34384,2015,Noviembre,Filipinas,1,8,,9,-76.532004,3.451668
34385,2015,Noviembre,Filipinas,4,20,,24,-74.140516,4.697157
34386,2015,Noviembre,Filipinas,0,1,,1,-75.42726,6.170465
34387,2015,Noviembre,Finlandia,1,1,,2,-76.532004,3.451668
34388,2015,Noviembre,Finlandia,7,10,,17,-74.140516,4.697157
34389,2015,Noviembre,Finlandia,0,1,,1,-75.736374,4.815189
34390,2015,Noviembre,Francia,1,0,,1,-75.516486,10.446304
34391,2015,Noviembre,Francia,0,3,,3,-74.77647900000001,10.886686
34392,2015,Noviembre,Francia,0,3,,3,-74.213989,11.247722999999999
34393,2015,Noviembre,Francia,20,36,,56,-76.532004,3.451668
34394,2015,Noviembre,Francia,1232,2508,,3740,-74.140516,4.697157
34395,2015,Noviembre,Francia,10,17,,27,-75.42726,6.170465
34396,2015,Noviembre,Georgia,0,1,,1,-74.140516,4.697157
34397,2015,Noviembre,Granada,0,1,,1,-74.140516,4.697157
34398,2015,Noviembre,Grecia,0,1,,1,-76.532004,3.451668
34399,2015,Noviembre,Grecia,0,8,,8,-74.140516,4.697157
34400,2015,Noviembre,Grecia,0,1,,1,-75.42726,6.170465
34401,2015,Noviembre,Guatemala,4,6,,10,-75.516486,10.446304
34402,2015,Noviembre,Guatemala,4,11,,15,-74.77647900000001,10.886686
34403,2015,Noviembre,Guatemala,31,36,,67,-81.70216500000001,12.5862
34404,2015,Noviembre,Guatemala,2,2,,4,-81.372937,13.338761300000002
34405,2015,Noviembre,Guatemala,16,53,,69,-76.532004,3.451668
34406,2015,Noviembre,Guatemala,428,771,,1199,-74.140516,4.697157
34407,2015,Noviembre,Guatemala,2,13,,15,-75.736374,4.815189
34408,2015,Noviembre,Guatemala,60,100,,160,-75.42726,6.170465
34409,2015,Noviembre,Guatemala,1,2,,3,-73.181317,7.1280470000000005
34410,2015,Noviembre,Guatemala,3,1,,4,-72.508188,7.927233
34411,2015,Noviembre,Guyana,0,1,,1,-75.527794,10.406342
34412,2015,Noviembre,Guyana,0,3,,3,-74.77647900000001,10.886686
34413,2015,Noviembre,Guyana,0,2,,2,-74.140516,4.697157
34414,2015,Noviembre,Guadalupe/Territorio Francés,0,5,,5,-75.527794,10.406342
34415,2015,Noviembre,Guadalupe/Territorio Francés,1,1,,2,-76.532004,3.451668
34416,2015,Noviembre,Guadalupe/Territorio Francés,1,6,,7,-74.140516,4.697157
34417,2015,Noviembre,Guadalupe/Territorio Francés,0,2,,2,-75.42726,6.170465
34418,2015,Noviembre,Haití,0,4,,4,-75.527794,10.406342
34419,2015,Noviembre,Haití,0,1,,1,-74.765343,10.970933
34420,2015,Noviembre,Haití,2,2,,4,-74.140516,4.697157
34421,2015,Noviembre,Haití,0,1,,1,-75.736374,4.815189
34422,2015,Noviembre,Haití,1,3,,4,-75.42726,6.170465
34423,2015,Noviembre,Haití,0,1,,1,-72.508188,7.927233
34424,2015,Noviembre,Honduras,1,1,,2,-75.516486,10.446304
34425,2015,Noviembre,Honduras,0,6,,6,-74.77647900000001,10.886686
34426,2015,Noviembre,Honduras,0,9,,9,-81.703935,12.574411099999999
34427,2015,Noviembre,Honduras,3,2,,5,-81.70216500000001,12.5862
34428,2015,Noviembre,Honduras,2,2,,4,-81.372937,13.338761300000002
34429,2015,Noviembre,Honduras,12,22,,34,-76.532004,3.451668
34430,2015,Noviembre,Honduras,76,102,,178,-74.140516,4.697157
34431,2015,Noviembre,Honduras,1,2,,3,-75.736374,4.815189
34432,2015,Noviembre,Honduras,30,33,,63,-75.42726,6.170465
34433,2015,Noviembre,Honduras,0,5,,5,-73.181317,7.1280470000000005
34434,2015,Noviembre,Hong Kong,1,2,,3,-74.140516,4.697157
34435,2015,Noviembre,Hong Kong,0,1,,1,-75.42726,6.170465
34436,2015,Noviembre,Hungría,5,6,,11,-74.140516,4.697157
34437,2015,Noviembre,India,0,1,,1,-74.213989,11.247722999999999
34438,2015,Noviembre,India,0,1,,1,-76.532004,3.451668
34439,2015,Noviembre,India,4,34,,38,-74.140516,4.697157
34440,2015,Noviembre,India,0,1,,1,-75.736374,4.815189
34441,2015,Noviembre,India,1,6,,7,-75.42726,6.170465
34442,2015,Noviembre,India,0,2,,2,-72.508188,7.927233
34443,2015,Noviembre,Indonesia,1,3,,4,-74.140516,4.697157
34444,2015,Noviembre,Iraq,0,1,,1,-74.140516,4.697157
34445,2015,Noviembre,Irán,0,3,,3,-74.140516,4.697157
34446,2015,Noviembre,Irán,1,0,,1,-75.42726,6.170465
34447,2015,Noviembre,República de Irlanda,0,1,,1,-74.77647900000001,10.886686
34448,2015,Noviembre,República de Irlanda,6,16,,22,-74.140516,4.697157
34449,2015,Noviembre,República de Irlanda,1,4,,5,-75.42726,6.170465
34450,2015,Noviembre,Islandia,1,0,,1,-76.532004,3.451668
34451,2015,Noviembre,Israel,0,2,,2,-75.516486,10.446304
34452,2015,Noviembre,Israel,1,1,,2,-74.77647900000001,10.886686
34453,2015,Noviembre,Israel,0,1,,1,-81.70216500000001,12.5862
34454,2015,Noviembre,Israel,6,5,,11,-76.532004,3.451668
34455,2015,Noviembre,Israel,7,67,,74,-74.140516,4.697157
34456,2015,Noviembre,Israel,0,1,,1,-75.42726,6.170465
34457,2015,Noviembre,Italia,0,3,,3,-75.516486,10.446304
34458,2015,Noviembre,Italia,0,2,,2,-74.77647900000001,10.886686
34459,2015,Noviembre,Italia,0,1,,1,-81.70216500000001,12.5862
34460,2015,Noviembre,Italia,19,59,,78,-76.532004,3.451668
34461,2015,Noviembre,Italia,97,345,,442,-74.140516,4.697157
34462,2015,Noviembre,Italia,1,2,,3,-75.736374,4.815189
34463,2015,Noviembre,Italia,17,42,,59,-75.42726,6.170465
34464,2015,Noviembre,Italia,1,0,,1,-73.181317,7.1280470000000005
34465,2015,Noviembre,Jamaica,0,11,,11,-75.527794,10.406342
34466,2015,Noviembre,Jamaica,0,1,,1,-74.77647900000001,10.886686
34467,2015,Noviembre,Jamaica,1,7,,8,-81.70216500000001,12.5862
34468,2015,Noviembre,Jamaica,0,4,,4,-81.372937,13.338761300000002
34469,2015,Noviembre,Jamaica,2,2,,4,-76.532004,3.451668
34470,2015,Noviembre,Jamaica,2,6,,8,-74.140516,4.697157
34471,2015,Noviembre,Jamaica,2,7,,9,-75.42726,6.170465
34472,2015,Noviembre,Jamaica,1,0,,1,-73.181317,7.1280470000000005
34473,2015,Noviembre,Japón,0,6,,6,-76.532004,3.451668
34474,2015,Noviembre,Japón,13,38,,51,-74.140516,4.697157
34475,2015,Noviembre,Japón,1,4,,5,-75.42726,6.170465
34476,2015,Noviembre,Japón,1,0,,1,-72.508188,7.927233
34477,2015,Noviembre,Kazajistán,0,1,,1,-74.140516,4.697157
34478,2015,Noviembre,Kenia,2,3,,5,-74.140516,4.697157
34479,2015,Noviembre,Kirguistán,0,1,,1,-74.140516,4.697157
34480,2015,Noviembre,República Democrática Popular  Lao,0,1,,1,-76.532004,3.451668
34481,2015,Noviembre,República Democrática Popular  Lao,0,1,,1,-74.140516,4.697157
34482,2015,Noviembre,Lituania,6,5,,11,-74.140516,4.697157
34483,2015,Noviembre,Líbano,2,2,,4,-74.140516,4.697157
34484,2015,Noviembre,Líbano,0,2,,2,-75.736374,4.815189
34485,2015,Noviembre,Luxemburgo,1,1,,2,-74.140516,4.697157
34486,2015,Noviembre,Luxemburgo,0,1,,1,-75.42726,6.170465
34487,2015,Noviembre,Madagascar,1,1,,2,-74.140516,4.697157
34488,2015,Noviembre,Malasia,0,2,,2,-74.140516,4.697157
34489,2015,Noviembre,Malasia,1,0,,1,-75.42726,6.170465
34490,2015,Noviembre,Malta,0,1,,1,-75.42726,6.170465
34491,2015,Noviembre,Marruecos,0,1,,1,-74.765343,10.970933
34492,2015,Noviembre,Marruecos,0,2,,2,-74.140516,4.697157
34493,2015,Noviembre,Marruecos,1,4,,5,-75.42726,6.170465
34494,2015,Noviembre,Martinica/Departamento de Ultramar Francés,1,1,,2,-74.213989,11.247722999999999
34495,2015,Noviembre,México,7,21,,28,-75.527794,10.406342
34496,2015,Noviembre,México,8,27,,35,-75.516486,10.446304
34497,2015,Noviembre,México,11,26,,37,-74.77647900000001,10.886686
34498,2015,Noviembre,México,7,9,,16,-81.70216500000001,12.5862
34499,2015,Noviembre,México,74,186,,260,-76.532004,3.451668
34500,2015,Noviembre,México,4204,8085,,12289,-74.140516,4.697157
34501,2015,Noviembre,México,5,15,,20,-75.736374,4.815189
34502,2015,Noviembre,México,547,1334,,1881,-75.42726,6.170465
34503,2015,Noviembre,México,7,5,,12,-73.181317,7.1280470000000005
34504,2015,Noviembre,México,2,4,,6,-72.508188,7.927233
34505,2015,Noviembre,Mónaco,0,1,,1,-74.140516,4.697157
34506,2015,Noviembre,Nicaragua,1,0,,1,-75.516486,10.446304
34507,2015,Noviembre,Nicaragua,0,2,,2,-74.77647900000001,10.886686
34508,2015,Noviembre,Nicaragua,3,0,,3,-81.70216500000001,12.5862
34509,2015,Noviembre,Nicaragua,5,9,,14,-76.532004,3.451668
34510,2015,Noviembre,Nicaragua,29,32,,61,-74.140516,4.697157
34511,2015,Noviembre,Nicaragua,1,2,,3,-75.736374,4.815189
34512,2015,Noviembre,Nicaragua,12,29,,41,-75.42726,6.170465
34513,2015,Noviembre,Nicaragua,2,0,,2,-73.181317,7.1280470000000005
34514,2015,Noviembre,Nigeria,0,1,,1,-75.736374,4.815189
34515,2015,Noviembre,Noruega,0,1,,1,-75.516486,10.446304
34516,2015,Noviembre,Noruega,4,3,,7,-74.77647900000001,10.886686
34517,2015,Noviembre,Noruega,0,1,,1,-81.70216500000001,12.5862
34518,2015,Noviembre,Noruega,3,3,,6,-76.532004,3.451668
34519,2015,Noviembre,Noruega,22,29,,51,-74.140516,4.697157
34520,2015,Noviembre,Nueva Zelanda,1,0,,1,-76.532004,3.451668
34521,2015,Noviembre,Nueva Zelanda,4,3,,7,-74.140516,4.697157
34522,2015,Noviembre,Nueva Zelanda,1,3,,4,-75.42726,6.170465
34523,2015,Noviembre,Omán,0,1,,1,-75.42726,6.170465
34524,2015,Noviembre,Pakistán,0,1,,1,-74.140516,4.697157
34525,2015,Noviembre,Panamá,0,1,,1,-78.802679,18.00143
34526,2015,Noviembre,Panamá,1037,862,,1899,-75.527794,10.406342
34527,2015,Noviembre,Panamá,2475,2632,,5107,-75.516486,10.446304
34528,2015,Noviembre,Panamá,239,542,,781,-74.77647900000001,10.886686
34529,2015,Noviembre,Panamá,0,28,,28,-74.765343,10.970933
34530,2015,Noviembre,Panamá,1,3,,4,-74.213989,11.247722999999999
34531,2015,Noviembre,Panamá,11,22,,33,-81.703935,12.574411099999999
34532,2015,Noviembre,Panamá,281,243,,524,-81.70216500000001,12.5862
34533,2015,Noviembre,Panamá,10,8,,18,-81.372937,13.338761300000002
34534,2015,Noviembre,Panamá,234,460,,694,-76.532004,3.451668
34535,2015,Noviembre,Panamá,0,102,,102,-77.061029,3.8844260000000004
34536,2015,Noviembre,Panamá,4291,6513,,10804,-74.140516,4.697157
34537,2015,Noviembre,Panamá,46,98,,144,-75.736374,4.815189
34538,2015,Noviembre,Panamá,1867,2628,,4495,-75.42726,6.170465
34539,2015,Noviembre,Panamá,1,0,,1,-77.401154,6.222551999999999
34540,2015,Noviembre,Panamá,0,1,,1,-77.762647,7.102626
34541,2015,Noviembre,Panamá,23,48,,71,-73.181317,7.1280470000000005
34542,2015,Noviembre,Panamá,44,71,,115,-72.508188,7.927233
34543,2015,Noviembre,Panamá,92,115,,207,-77.35002,8.63337
34544,2015,Noviembre,Paraguay,3,1,,4,-75.516486,10.446304
34545,2015,Noviembre,Paraguay,2,2,,4,-74.77647900000001,10.886686
34546,2015,Noviembre,Paraguay,60,37,,97,-81.70216500000001,12.5862
34547,2015,Noviembre,Paraguay,15,45,,60,-76.532004,3.451668
34548,2015,Noviembre,Paraguay,71,95,,166,-74.140516,4.697157
34549,2015,Noviembre,Paraguay,21,39,,60,-75.42726,6.170465
34550,2015,Noviembre,Paraguay,0,1,,1,-73.181317,7.1280470000000005
34551,2015,Noviembre,Perú,67,114,,181,-69.941498,4.191162
34552,2015,Noviembre,Perú,4,10,,14,-69.94143100000001,4.214082
34553,2015,Noviembre,Perú,7,14,,21,-77.35600000000001,0.81488
34554,2015,Noviembre,Perú,0,1,,1,-78.802679,18.00143
34555,2015,Noviembre,Perú,0,3,,3,-75.527794,10.406342
34556,2015,Noviembre,Perú,8,9,,17,-75.516486,10.446304
34557,2015,Noviembre,Perú,1,5,,6,-74.77647900000001,10.886686
34558,2015,Noviembre,Perú,0,1,,1,-74.213989,11.247722999999999
34559,2015,Noviembre,Perú,99,68,,167,-81.70216500000001,12.5862
34560,2015,Noviembre,Perú,221,414,,635,-76.532004,3.451668
34561,2015,Noviembre,Perú,5467,8512,,13979,-74.140516,4.697157
34562,2015,Noviembre,Perú,6,6,,12,-75.736374,4.815189
34563,2015,Noviembre,Perú,329,594,,923,-75.42726,6.170465
34564,2015,Noviembre,Perú,0,1,,1,-73.181317,7.1280470000000005
34565,2015,Noviembre,Perú,0,2,,2,-72.508188,7.927233
34566,2015,Noviembre,Polonia,0,4,,4,-76.532004,3.451668
34567,2015,Noviembre,Polonia,27,30,,57,-74.140516,4.697157
34568,2015,Noviembre,Portugal,20,27,,47,-75.516486,10.446304
34569,2015,Noviembre,Portugal,0,1,,1,-74.77647900000001,10.886686
34570,2015,Noviembre,Portugal,0,6,,6,-76.532004,3.451668
34571,2015,Noviembre,Portugal,422,648,,1070,-74.140516,4.697157
34572,2015,Noviembre,Portugal,1,5,,6,-75.42726,6.170465
34573,2015,Noviembre,Portugal,1,0,,1,-72.508188,7.927233
34574,2015,Noviembre,Puerto Rico/Territorio de Estados Unidos,3,1,,4,-75.516486,10.446304
34575,2015,Noviembre,Puerto Rico/Territorio de Estados Unidos,6,50,,56,-74.77647900000001,10.886686
34576,2015,Noviembre,Puerto Rico/Territorio de Estados Unidos,20,33,,53,-76.532004,3.451668
34577,2015,Noviembre,Puerto Rico/Territorio de Estados Unidos,308,405,,713,-74.140516,4.697157
34578,2015,Noviembre,Puerto Rico/Territorio de Estados Unidos,35,90,,125,-75.42726,6.170465
34579,2015,Noviembre,Puerto Rico/Territorio de Estados Unidos,2,4,,6,-73.181317,7.1280470000000005
34580,2015,Noviembre,Puerto Rico/Territorio de Estados Unidos,1,2,,3,-72.508188,7.927233
34581,2015,Noviembre,Qatar,1,0,,1,-74.140516,4.697157
34582,2015,Noviembre,Reino Unido de Gran Bretaña e Irlanda del Norte,0,8,,8,-75.527794,10.406342
34583,2015,Noviembre,Reino Unido de Gran Bretaña e Irlanda del Norte,7,20,,27,-76.532004,3.451668
34584,2015,Noviembre,Reino Unido de Gran Bretaña e Irlanda del Norte,572,1115,,1687,-74.140516,4.697157
34585,2015,Noviembre,Reino Unido de Gran Bretaña e Irlanda del Norte,8,27,,35,-75.42726,6.170465
34586,2015,Noviembre,Federación de Rusia,1,2,,3,-75.516486,10.446304
34587,2015,Noviembre,Federación de Rusia,0,1,,1,-74.77647900000001,10.886686
34588,2015,Noviembre,Federación de Rusia,2,1,,3,-81.70216500000001,12.5862
34589,2015,Noviembre,Federación de Rusia,0,1,,1,-76.532004,3.451668
34590,2015,Noviembre,Federación de Rusia,24,49,,73,-74.140516,4.697157
34591,2015,Noviembre,Federación de Rusia,0,2,,2,-75.42726,6.170465
34592,2015,Noviembre,República Dominicana,3,9,,12,-75.527794,10.406342
34593,2015,Noviembre,República Dominicana,3,2,,5,-75.516486,10.446304
34594,2015,Noviembre,República Dominicana,2,14,,16,-74.77647900000001,10.886686
34595,2015,Noviembre,República Dominicana,1,3,,4,-81.70216500000001,12.5862
34596,2015,Noviembre,República Dominicana,22,33,,55,-76.532004,3.451668
34597,2015,Noviembre,República Dominicana,745,1169,,1914,-74.140516,4.697157
34598,2015,Noviembre,República Dominicana,1,0,,1,-75.736374,4.815189
34599,2015,Noviembre,República Dominicana,38,59,,97,-75.42726,6.170465
34600,2015,Noviembre,República Dominicana,2,3,,5,-73.181317,7.1280470000000005
34601,2015,Noviembre,República Dominicana,0,1,,1,-72.508188,7.927233
34602,2015,Noviembre,Reunión,0,1,,1,-74.140516,4.697157
34603,2015,Noviembre,Rumania,0,1,,1,-76.532004,3.451668
34604,2015,Noviembre,Rumania,3,8,,11,-74.140516,4.697157
34605,2015,Noviembre,San  Vicente y las Granadinas,1,0,,1,-76.532004,3.451668
34606,2015,Noviembre,Santa Lucia,1,0,,1,-76.532004,3.451668
34607,2015,Noviembre,Santo Tomé y Príncipe,0,1,,1,-75.527794,10.406342
34608,2015,Noviembre,Senegal,0,2,,2,-74.140516,4.697157
34609,2015,Noviembre,Serbia,0,1,,1,-75.516486,10.446304
34610,2015,Noviembre,Serbia,1,0,,1,-74.140516,4.697157
34611,2015,Noviembre,Singapur,1,3,,4,-74.140516,4.697157
34612,2015,Noviembre,Singapur,1,1,,2,-75.42726,6.170465
34613,2015,Noviembre,Sri Lanka,1,0,,1,-76.532004,3.451668
34614,2015,Noviembre,Sri Lanka,0,1,,1,-74.140516,4.697157
34615,2015,Noviembre,Sudáfrica,4,11,,15,-74.140516,4.697157
34616,2015,Noviembre,Sudáfrica,0,1,,1,-75.42726,6.170465
34617,2015,Noviembre,Suecia,0,1,,1,-74.77647900000001,10.886686
34618,2015,Noviembre,Suecia,8,13,,21,-76.532004,3.451668
34619,2015,Noviembre,Suecia,26,50,,76,-74.140516,4.697157
34620,2015,Noviembre,Suecia,1,1,,2,-75.736374,4.815189
34621,2015,Noviembre,Suecia,3,6,,9,-75.42726,6.170465
34622,2015,Noviembre,Suiza,0,1,,1,-75.516486,10.446304
34623,2015,Noviembre,Suiza,2,1,,3,-74.77647900000001,10.886686
34624,2015,Noviembre,Suiza,9,21,,30,-76.532004,3.451668
34625,2015,Noviembre,Suiza,77,110,,187,-74.140516,4.697157
34626,2015,Noviembre,Suiza,10,19,,29,-75.42726,6.170465
34627,2015,Noviembre,Surinam,0,2,,2,-74.140516,4.697157
34628,2015,Noviembre,Surinam,8,5,,13,-75.42726,6.170465
34629,2015,Noviembre,Taiwán,0,1,,1,-76.532004,3.451668
34630,2015,Noviembre,Taiwán,1,6,,7,-74.140516,4.697157
34631,2015,Noviembre,Tailandia,3,1,,4,-74.140516,4.697157
34632,2015,Noviembre,Trinidad y Tobago,1,5,,6,-75.527794,10.406342
34633,2015,Noviembre,Trinidad y Tobago,1,0,,1,-74.77647900000001,10.886686
34634,2015,Noviembre,Trinidad y Tobago,1,1,,2,-81.70216500000001,12.5862
34635,2015,Noviembre,Trinidad y Tobago,4,9,,13,-76.532004,3.451668
34636,2015,Noviembre,Trinidad y Tobago,7,19,,26,-74.140516,4.697157
34637,2015,Noviembre,Trinidad y Tobago,1,8,,9,-75.42726,6.170465
34638,2015,Noviembre,Turquía,3,15,,18,-74.140516,4.697157
34639,2015,Noviembre,Turquía,0,4,,4,-75.42726,6.170465
34640,2015,Noviembre,Ucrania,2,3,,5,-74.140516,4.697157
34641,2015,Noviembre,Uganda,0,1,,1,-74.140516,4.697157
34642,2015,Noviembre,Uruguay,6,3,,9,-75.516486,10.446304
34643,2015,Noviembre,Uruguay,1,3,,4,-74.77647900000001,10.886686
34644,2015,Noviembre,Uruguay,24,16,,40,-81.70216500000001,12.5862
34645,2015,Noviembre,Uruguay,16,34,,50,-76.532004,3.451668
34646,2015,Noviembre,Uruguay,49,90,,139,-74.140516,4.697157
34647,2015,Noviembre,Uruguay,0,1,,1,-75.736374,4.815189
34648,2015,Noviembre,Uruguay,26,40,,66,-75.42726,6.170465
34649,2015,Noviembre,Uruguay,0,1,,1,-73.181317,7.1280470000000005
34650,2015,Noviembre,Uruguay,1,0,,1,-72.508188,7.927233
34651,2015,Noviembre,Venezuela,0,22,,22,-75.527794,10.406342
34652,2015,Noviembre,Venezuela,545,431,,976,-75.516486,10.446304
34653,2015,Noviembre,Venezuela,14,45,,59,-74.77647900000001,10.886686
34654,2015,Noviembre,Venezuela,0,4,,4,-74.765343,10.970933
34655,2015,Noviembre,Venezuela,6,7,,13,-74.232675,11.117206
34656,2015,Noviembre,Venezuela,188,291,,479,-72.129595,11.360028999999999
34657,2015,Noviembre,Venezuela,2,0,,2,-81.70216500000001,12.5862
34658,2015,Noviembre,Venezuela,12,16,,28,-76.532004,3.451668
34659,2015,Noviembre,Venezuela,36,59,,95,-67.927521,3.866713
34660,2015,Noviembre,Venezuela,4208,4760,,8968,-74.140516,4.697157
34661,2015,Noviembre,Venezuela,4,4,,8,-75.736374,4.815189
34662,2015,Noviembre,Venezuela,1892,1810,,3702,-75.42726,6.170465
34663,2015,Noviembre,Venezuela,59,101,,160,-67.48402800000001,6.185536
34664,2015,Noviembre,Venezuela,40,63,,103,-70.74025300000001,7.088728999999999
34665,2015,Noviembre,Venezuela,7,6,,13,-73.181317,7.1280470000000005
34666,2015,Noviembre,Venezuela,2521,3080,,5601,-72.453013,7.819
34667,2015,Noviembre,Venezuela,115,132,,247,-72.508188,7.927233
34668,2015,Noviembre,Vietnam,0,1,,1,-74.140516,4.697157
34669,2015,Noviembre,Islas Vírgenes Británicas/Territorio Británico de Ultramar,2,8,,10,-74.140516,4.697157
34670,2015,Noviembre,Islas Vírgenes Estadounidenses/Territorio de Estados Unidos,0,10,,10,-74.140516,4.697157
34671,2015,Noviembre,República Árabe de Yemen,0,1,,1,-74.140516,4.697157
34672,2015,Noviembre,Anguila/Territorio Británico de Ultramar,1,0,,1,-76.532004,3.451668
34673,2015,Noviembre,Islas Turcas y Caicos/Territorio Británico de Ultramar,0,2,,2,-75.516486,10.446304
34674,2015,Noviembre,Desconocido,4,7,,11,-73.181317,7.1280470000000005
34675,2015,Noviembre,Desconocido,1,28,,29,-75.68164200000001,9.402597
34676,2015,Diciembre,Afganistán,0,1,,1,-76.532004,3.451668
34677,2015,Diciembre,Afganistán,0,1,,1,-74.140516,4.697157
34678,2015,Diciembre,Albania,1,2,,3,-74.140516,4.697157
34679,2015,Diciembre,Alemania,1,1,,2,-77.35600000000001,0.81488
34680,2015,Diciembre,Alemania,0,1,,1,-75.516486,10.446304
34681,2015,Diciembre,Alemania,2,10,,12,-74.77647900000001,10.886686
34682,2015,Diciembre,Alemania,4,2,,6,-81.70216500000001,12.5862
34683,2015,Diciembre,Alemania,80,111,,191,-76.532004,3.451668
34684,2015,Diciembre,Alemania,1457,2388,,3845,-74.140516,4.697157
34685,2015,Diciembre,Alemania,1,1,,2,-75.736374,4.815189
34686,2015,Diciembre,Alemania,23,41,,64,-75.42726,6.170465
34687,2015,Diciembre,Alemania,5,4,,9,-73.181317,7.1280470000000005
34688,2015,Diciembre,Angola,0,2,,2,-74.140516,4.697157
34689,2015,Diciembre,Angola,0,1,,1,-75.42726,6.170465
34690,2015,Diciembre,Antigua y Barbuda,0,4,,4,-75.527794,10.406342
34691,2015,Diciembre,Antigua y Barbuda,1,1,,2,-74.77647900000001,10.886686
34692,2015,Diciembre,Antigua y Barbuda,0,3,,3,-74.140516,4.697157
34693,2015,Diciembre,Países Bajos,2,12,,14,-75.527794,10.406342
34694,2015,Diciembre,Países Bajos,39,78,,117,-74.77647900000001,10.886686
34695,2015,Diciembre,Países Bajos,0,2,,2,-74.232675,11.117206
34696,2015,Diciembre,Países Bajos,3,6,,9,-74.213989,11.247722999999999
34697,2015,Diciembre,Países Bajos,119,249,,368,-76.532004,3.451668
34698,2015,Diciembre,Países Bajos,813,1198,,2011,-74.140516,4.697157
34699,2015,Diciembre,Países Bajos,2,5,,7,-75.736374,4.815189
34700,2015,Diciembre,Países Bajos,276,367,,643,-75.42726,6.170465
34701,2015,Diciembre,Países Bajos,1,7,,8,-73.181317,7.1280470000000005
34702,2015,Diciembre,Países Bajos,1,2,,3,-72.508188,7.927233
34703,2015,Diciembre,Arabia Saudita,1,1,,2,-74.140516,4.697157
34704,2015,Diciembre,Argelia,0,1,,1,-76.532004,3.451668
34705,2015,Diciembre,Argelia,3,4,,7,-74.140516,4.697157
34706,2015,Diciembre,Argelia,1,0,,1,-75.42726,6.170465
34707,2015,Diciembre,Argentina,10,8,,18,-77.35600000000001,0.81488
34708,2015,Diciembre,Argentina,36,30,,66,-75.516486,10.446304
34709,2015,Diciembre,Argentina,4,6,,10,-74.77647900000001,10.886686
34710,2015,Diciembre,Argentina,243,207,,450,-81.70216500000001,12.5862
34711,2015,Diciembre,Argentina,96,194,,290,-76.532004,3.451668
34712,2015,Diciembre,Argentina,2195,2925,,5120,-74.140516,4.697157
34713,2015,Diciembre,Argentina,2,4,,6,-75.736374,4.815189
34714,2015,Diciembre,Argentina,98,155,,253,-75.42726,6.170465
34715,2015,Diciembre,Argentina,2,3,,5,-73.181317,7.1280470000000005
34716,2015,Diciembre,Argentina,1,0,,1,-72.508188,7.927233
34717,2015,Diciembre,Aruba,10,20,,30,-75.527794,10.406342
34718,2015,Diciembre,Aruba,1,2,,3,-75.516486,10.446304
34719,2015,Diciembre,Aruba,13,6,,19,-74.77647900000001,10.886686
34720,2015,Diciembre,Aruba,12,16,,28,-74.213989,11.247722999999999
34721,2015,Diciembre,Aruba,4,5,,9,-76.532004,3.451668
34722,2015,Diciembre,Aruba,677,877,,1554,-74.140516,4.697157
34723,2015,Diciembre,Aruba,0,2,,2,-75.736374,4.815189
34724,2015,Diciembre,Aruba,71,103,,174,-75.42726,6.170465
34725,2015,Diciembre,Aruba,7,2,,9,-73.181317,7.1280470000000005
34726,2015,Diciembre,Aruba,0,3,,3,-72.508188,7.927233
34727,2015,Diciembre,Australia,3,1,,4,-75.516486,10.446304
34728,2015,Diciembre,Australia,1,4,,5,-74.77647900000001,10.886686
34729,2015,Diciembre,Australia,1,0,,1,-81.70216500000001,12.5862
34730,2015,Diciembre,Australia,11,14,,25,-76.532004,3.451668
34731,2015,Diciembre,Australia,0,1,,1,-75.76635300000001,4.45285
34732,2015,Diciembre,Australia,77,125,,202,-74.140516,4.697157
34733,2015,Diciembre,Australia,1,4,,5,-75.736374,4.815189
34734,2015,Diciembre,Australia,27,39,,66,-75.42726,6.170465
34735,2015,Diciembre,Australia,1,1,,2,-73.181317,7.1280470000000005
34736,2015,Diciembre,Australia,1,1,,2,-72.508188,7.927233
34737,2015,Diciembre,Austria,1,1,,2,-75.516486,10.446304
34738,2015,Diciembre,Austria,1,2,,3,-74.77647900000001,10.886686
34739,2015,Diciembre,Austria,0,1,,1,-81.70216500000001,12.5862
34740,2015,Diciembre,Austria,8,9,,17,-76.532004,3.451668
34741,2015,Diciembre,Austria,25,44,,69,-74.140516,4.697157
34742,2015,Diciembre,Austria,1,2,,3,-75.42726,6.170465
34743,2015,Diciembre,Azerbaiyán,1,1,,2,-74.140516,4.697157
34744,2015,Diciembre,Bahamas,1,7,,8,-75.527794,10.406342
34745,2015,Diciembre,Bahamas,0,2,,2,-75.516486,10.446304
34746,2015,Diciembre,Bahamas,1,1,,2,-74.213989,11.247722999999999
34747,2015,Diciembre,Bahamas,1,5,,6,-76.532004,3.451668
34748,2015,Diciembre,Bahamas,0,2,,2,-74.140516,4.697157
34749,2015,Diciembre,Bahréin,0,1,,1,-76.532004,3.451668
34750,2015,Diciembre,Bahréin,1,0,,1,-74.140516,4.697157
34751,2015,Diciembre,Barbados,16,26,,42,-74.140516,4.697157
34752,2015,Diciembre,República de Belarús,1,0,,1,-75.42726,6.170465
34753,2015,Diciembre,Bélgica,0,2,,2,-75.527794,10.406342
34754,2015,Diciembre,Bélgica,1,2,,3,-74.77647900000001,10.886686
34755,2015,Diciembre,Bélgica,0,1,,1,-81.70216500000001,12.5862
34756,2015,Diciembre,Bélgica,6,16,,22,-76.532004,3.451668
34757,2015,Diciembre,Bélgica,51,79,,130,-74.140516,4.697157
34758,2015,Diciembre,Bélgica,0,1,,1,-75.736374,4.815189
34759,2015,Diciembre,Bélgica,3,9,,12,-75.42726,6.170465
34760,2015,Diciembre,Belice,1,0,,1,-76.532004,3.451668
34761,2015,Diciembre,Belice,1,3,,4,-74.140516,4.697157
34762,2015,Diciembre,Belice,0,2,,2,-75.42726,6.170465
34763,2015,Diciembre,Benín,0,2,,2,-74.140516,4.697157
34764,2015,Diciembre,Bolivia,8,3,,11,-77.35600000000001,0.81488
34765,2015,Diciembre,Bolivia,11,10,,21,-75.516486,10.446304
34766,2015,Diciembre,Bolivia,2,0,,2,-74.77647900000001,10.886686
34767,2015,Diciembre,Bolivia,16,17,,33,-81.70216500000001,12.5862
34768,2015,Diciembre,Bolivia,44,38,,82,-76.532004,3.451668
34769,2015,Diciembre,Bolivia,576,592,,1168,-74.140516,4.697157
34770,2015,Diciembre,Bolivia,38,37,,75,-75.42726,6.170465
34771,2015,Diciembre,Bolivia,0,2,,2,-73.181317,7.1280470000000005
34772,2015,Diciembre,Bolivia,0,1,,1,-72.508188,7.927233
34773,2015,Diciembre,Bosnia y Herzegovina,0,1,,1,-74.140516,4.697157
34774,2015,Diciembre,Botsuana,0,1,,1,-74.140516,4.697157
34775,2015,Diciembre,Brasil,130,154,,284,-69.941498,4.191162
34776,2015,Diciembre,Brasil,5,5,,10,-69.94143100000001,4.214082
34777,2015,Diciembre,Brasil,2,3,,5,-77.35600000000001,0.81488
34778,2015,Diciembre,Brasil,85,77,,162,-75.516486,10.446304
34779,2015,Diciembre,Brasil,18,7,,25,-74.77647900000001,10.886686
34780,2015,Diciembre,Brasil,521,430,,951,-81.70216500000001,12.5862
34781,2015,Diciembre,Brasil,49,71,,120,-76.532004,3.451668
34782,2015,Diciembre,Brasil,1,3,,4,-67.927521,3.866713
34783,2015,Diciembre,Brasil,4090,4904,,8994,-74.140516,4.697157
34784,2015,Diciembre,Brasil,11,8,,19,-75.736374,4.815189
34785,2015,Diciembre,Brasil,147,182,,329,-75.42726,6.170465
34786,2015,Diciembre,Brasil,4,4,,8,-73.181317,7.1280470000000005
34787,2015,Diciembre,Brasil,3,1,,4,-72.508188,7.927233
34788,2015,Diciembre,Bulgaria,1,1,,2,-76.532004,3.451668
34789,2015,Diciembre,Bulgaria,3,3,,6,-74.140516,4.697157
34790,2015,Diciembre,Bulgaria,0,1,,1,-75.42726,6.170465
34791,2015,Diciembre,Cabo Verde,0,1,,1,-75.527794,10.406342
34792,2015,Diciembre,Cabo Verde,1,0,,1,-74.140516,4.697157
34793,2015,Diciembre,Islas Caimán/Territorio Británico de Ultramar,1,5,,6,-75.527794,10.406342
34794,2015,Diciembre,Islas Caimán/Territorio Británico de Ultramar,0,3,,3,-81.703935,12.574411099999999
34795,2015,Diciembre,Islas Caimán/Territorio Británico de Ultramar,0,2,,2,-81.70216500000001,12.5862
34796,2015,Diciembre,Islas Caimán/Territorio Británico de Ultramar,1,1,,2,-76.532004,3.451668
34797,2015,Diciembre,Islas Caimán/Territorio Británico de Ultramar,0,2,,2,-74.140516,4.697157
34798,2015,Diciembre,Canadá,1,1,,2,-75.527794,10.406342
34799,2015,Diciembre,Canadá,139,149,,288,-75.516486,10.446304
34800,2015,Diciembre,Canadá,19,19,,38,-74.77647900000001,10.886686
34801,2015,Diciembre,Canadá,162,166,,328,-81.70216500000001,12.5862
34802,2015,Diciembre,Canadá,106,131,,237,-76.532004,3.451668
34803,2015,Diciembre,Canadá,1,2,,3,-75.76635300000001,4.45285
34804,2015,Diciembre,Canadá,732,1011,,1743,-74.140516,4.697157
34805,2015,Diciembre,Canadá,18,17,,35,-75.736374,4.815189
34806,2015,Diciembre,Canadá,156,285,,441,-75.42726,6.170465
34807,2015,Diciembre,Canadá,20,28,,48,-73.181317,7.1280470000000005
34808,2015,Diciembre,Canadá,9,8,,17,-72.508188,7.927233
34809,2015,Diciembre,España,0,5,,5,-75.527794,10.406342
34810,2015,Diciembre,España,9,29,,38,-75.516486,10.446304
34811,2015,Diciembre,España,1,2,,3,-74.77647900000001,10.886686
34812,2015,Diciembre,España,0,6,,6,-74.765343,10.970933
34813,2015,Diciembre,España,0,11,,11,-74.213989,11.247722999999999
34814,2015,Diciembre,España,535,953,,1488,-76.532004,3.451668
34815,2015,Diciembre,España,3114,5416,,8530,-74.140516,4.697157
34816,2015,Diciembre,España,8,15,,23,-75.736374,4.815189
34817,2015,Diciembre,España,338,587,,925,-75.42726,6.170465
34818,2015,Diciembre,España,5,9,,14,-73.181317,7.1280470000000005
34819,2015,Diciembre,España,7,11,,18,-72.508188,7.927233
34820,2015,Diciembre,República de Corea,1,0,,1,-75.516486,10.446304
34821,2015,Diciembre,República de Corea,0,1,,1,-81.70216500000001,12.5862
34822,2015,Diciembre,República de Corea,1,0,,1,-76.532004,3.451668
34823,2015,Diciembre,República de Corea,14,19,,33,-74.140516,4.697157
34824,2015,Diciembre,República de Corea,1,4,,5,-75.42726,6.170465
34825,2015,Diciembre,República de Corea,0,2,,2,-72.508188,7.927233
34826,2015,Diciembre,Costa de Marfil,6,2,,8,-74.140516,4.697157
34827,2015,Diciembre,Costa de Marfil,2,2,,4,-75.42726,6.170465
34828,2015,Diciembre,Costa Rica,2,7,,9,-75.527794,10.406342
34829,2015,Diciembre,Costa Rica,18,19,,37,-75.516486,10.446304
34830,2015,Diciembre,Costa Rica,15,14,,29,-74.77647900000001,10.886686
34831,2015,Diciembre,Costa Rica,0,1,,1,-74.213989,11.247722999999999
34832,2015,Diciembre,Costa Rica,0,12,,12,-81.703935,12.574411099999999
34833,2015,Diciembre,Costa Rica,154,124,,278,-81.70216500000001,12.5862
34834,2015,Diciembre,Costa Rica,82,91,,173,-76.532004,3.451668
34835,2015,Diciembre,Costa Rica,1244,1575,,2819,-74.140516,4.697157
34836,2015,Diciembre,Costa Rica,24,16,,40,-75.736374,4.815189
34837,2015,Diciembre,Costa Rica,215,242,,457,-75.42726,6.170465
34838,2015,Diciembre,Costa Rica,15,9,,24,-73.181317,7.1280470000000005
34839,2015,Diciembre,Costa Rica,3,2,,5,-72.508188,7.927233
34840,2015,Diciembre,Croacia,0,5,,5,-76.532004,3.451668
34841,2015,Diciembre,Croacia,0,1,,1,-74.140516,4.697157
34842,2015,Diciembre,Croacia,0,1,,1,-75.42726,6.170465
34843,2015,Diciembre,Cuba,0,6,,6,-75.527794,10.406342
34844,2015,Diciembre,Cuba,3,2,,5,-75.516486,10.446304
34845,2015,Diciembre,Cuba,5,2,,7,-74.77647900000001,10.886686
34846,2015,Diciembre,Cuba,0,2,,2,-81.70216500000001,12.5862
34847,2015,Diciembre,Cuba,11,9,,20,-76.532004,3.451668
34848,2015,Diciembre,Cuba,461,670,,1131,-74.140516,4.697157
34849,2015,Diciembre,Cuba,2,0,,2,-75.736374,4.815189
34850,2015,Diciembre,Cuba,15,15,,30,-75.42726,6.170465
34851,2015,Diciembre,Cuba,4,2,,6,-73.181317,7.1280470000000005
34852,2015,Diciembre,Cuba,2,2,,4,-72.508188,7.927233
34853,2015,Diciembre,Curazao,1,2,,3,-74.140516,4.697157
34854,2015,Diciembre,Curazao,0,1,,1,-75.42726,6.170465
34855,2015,Diciembre,República Checa,2,10,,12,-74.140516,4.697157
34856,2015,Diciembre,República Checa,2,0,,2,-75.42726,6.170465
34857,2015,Diciembre,República Checa,0,1,,1,-72.508188,7.927233
34858,2015,Diciembre,Chile,2,3,,5,-77.35600000000001,0.81488
34859,2015,Diciembre,Chile,5,7,,12,-75.516486,10.446304
34860,2015,Diciembre,Chile,26,21,,47,-81.70216500000001,12.5862
34861,2015,Diciembre,Chile,44,60,,104,-76.532004,3.451668
34862,2015,Diciembre,Chile,3636,4902,,8538,-74.140516,4.697157
34863,2015,Diciembre,Chile,2,7,,9,-75.736374,4.815189
34864,2015,Diciembre,Chile,44,76,,120,-75.42726,6.170465
34865,2015,Diciembre,Chile,1,3,,4,-73.181317,7.1280470000000005
34866,2015,Diciembre,Chile,1,4,,5,-72.508188,7.927233
34867,2015,Diciembre,China,2,3,,5,-76.532004,3.451668
34868,2015,Diciembre,China,30,59,,89,-74.140516,4.697157
34869,2015,Diciembre,China,1,7,,8,-75.42726,6.170465
34870,2015,Diciembre,Dinamarca,0,1,,1,-77.35600000000001,0.81488
34871,2015,Diciembre,Dinamarca,1,0,,1,-81.70216500000001,12.5862
34872,2015,Diciembre,Dinamarca,2,6,,8,-76.532004,3.451668
34873,2015,Diciembre,Dinamarca,15,30,,45,-74.140516,4.697157
34874,2015,Diciembre,Dinamarca,3,3,,6,-75.42726,6.170465
34875,2015,Diciembre,Dinamarca,3,3,,6,-72.508188,7.927233
34876,2015,Diciembre,Dominica,11,19,,30,-74.140516,4.697157
34877,2015,Diciembre,Ecuador,171,320,,491,-76.876446,0.33002
34878,2015,Diciembre,Ecuador,0,1,,1,-77.84700600000001,0.8124359999999999
34879,2015,Diciembre,Ecuador,4308,6411,,10719,-77.35600000000001,0.81488
34880,2015,Diciembre,Ecuador,35,66,,101,-78.802679,18.00143
34881,2015,Diciembre,Ecuador,0,13,,13,-75.527794,10.406342
34882,2015,Diciembre,Ecuador,6,9,,15,-75.516486,10.446304
34883,2015,Diciembre,Ecuador,3,2,,5,-74.77647900000001,10.886686
34884,2015,Diciembre,Ecuador,4,3,,7,-81.70216500000001,12.5862
34885,2015,Diciembre,Ecuador,486,553,,1039,-76.532004,3.451668
34886,2015,Diciembre,Ecuador,3551,4624,,8175,-74.140516,4.697157
34887,2015,Diciembre,Ecuador,41,36,,77,-75.42726,6.170465
34888,2015,Diciembre,Ecuador,6,0,,6,-73.181317,7.1280470000000005
34889,2015,Diciembre,Ecuador,2,7,,9,-72.508188,7.927233
34890,2015,Diciembre,Egipto,0,3,,3,-74.140516,4.697157
34891,2015,Diciembre,Egipto,0,1,,1,-75.42726,6.170465
34892,2015,Diciembre,El Salvador,3,10,,13,-75.516486,10.446304
34893,2015,Diciembre,El Salvador,14,11,,25,-81.70216500000001,12.5862
34894,2015,Diciembre,El Salvador,134,205,,339,-76.532004,3.451668
34895,2015,Diciembre,El Salvador,1098,1407,,2505,-74.140516,4.697157
34896,2015,Diciembre,El Salvador,1,1,,2,-75.736374,4.815189
34897,2015,Diciembre,El Salvador,182,257,,439,-75.42726,6.170465
34898,2015,Diciembre,El Salvador,0,1,,1,-72.508188,7.927233
34899,2015,Diciembre,Emiratos Árabes,2,5,,7,-74.140516,4.697157
34900,2015,Diciembre,Emiratos Árabes,0,1,,1,-75.42726,6.170465
34901,2015,Diciembre,Eritrea,0,1,,1,-74.140516,4.697157
34902,2015,Diciembre,Eslovaquia,7,6,,13,-74.140516,4.697157
34903,2015,Diciembre,Eslovenia,6,5,,11,-74.140516,4.697157
34904,2015,Diciembre,Estados Unidos de América,17,67,,84,-75.527794,10.406342
34905,2015,Diciembre,Estados Unidos de América,3740,5162,,8902,-75.516486,10.446304
34906,2015,Diciembre,Estados Unidos de América,865,1432,,2297,-74.77647900000001,10.886686
34907,2015,Diciembre,Estados Unidos de América,0,11,,11,-74.765343,10.970933
34908,2015,Diciembre,Estados Unidos de América,0,20,,20,-74.213989,11.247722999999999
34909,2015,Diciembre,Estados Unidos de América,54,54,,108,-81.70216500000001,12.5862
34910,2015,Diciembre,Estados Unidos de América,1886,2847,,4733,-76.532004,3.451668
34911,2015,Diciembre,Estados Unidos de América,127,223,,350,-75.76635300000001,4.45285
34912,2015,Diciembre,Estados Unidos de América,13028,20467,,33495,-74.140516,4.697157
34913,2015,Diciembre,Estados Unidos de América,273,425,,698,-75.736374,4.815189
34914,2015,Diciembre,Estados Unidos de América,3943,7065,,11008,-75.42726,6.170465
34915,2015,Diciembre,Estados Unidos de América,73,119,,192,-73.181317,7.1280470000000005
34916,2015,Diciembre,Estados Unidos de América,44,70,,114,-72.508188,7.927233
34917,2015,Diciembre,Estados Unidos de América,0,12,,12,-75.68164200000001,9.402597
34918,2015,Diciembre,Estonia,0,2,,2,-74.140516,4.697157
34919,2015,Diciembre,Etiopia,0,2,,2,-74.140516,4.697157
34920,2015,Diciembre,Filipinas,0,1,,1,-75.516486,10.446304
34921,2015,Diciembre,Filipinas,1,4,,5,-76.532004,3.451668
34922,2015,Diciembre,Filipinas,1,16,,17,-74.140516,4.697157
34923,2015,Diciembre,Finlandia,2,6,,8,-76.532004,3.451668
34924,2015,Diciembre,Finlandia,13,13,,26,-74.140516,4.697157
34925,2015,Diciembre,Finlandia,2,1,,3,-75.42726,6.170465
34926,2015,Diciembre,Finlandia,0,1,,1,-73.181317,7.1280470000000005
34927,2015,Diciembre,Francia,0,4,,4,-75.527794,10.406342
34928,2015,Diciembre,Francia,1,2,,3,-75.516486,10.446304
34929,2015,Diciembre,Francia,6,3,,9,-74.77647900000001,10.886686
34930,2015,Diciembre,Francia,2,2,,4,-81.70216500000001,12.5862
34931,2015,Diciembre,Francia,43,82,,125,-76.532004,3.451668
34932,2015,Diciembre,Francia,1447,2377,,3824,-74.140516,4.697157
34933,2015,Diciembre,Francia,4,4,,8,-75.736374,4.815189
34934,2015,Diciembre,Francia,40,63,,103,-75.42726,6.170465
34935,2015,Diciembre,Francia,4,3,,7,-73.181317,7.1280470000000005
34936,2015,Diciembre,Francia,0,1,,1,-72.508188,7.927233
34937,2015,Diciembre,Georgia,2,0,,2,-74.140516,4.697157
34938,2015,Diciembre,Ghana,0,1,,1,-74.140516,4.697157
34939,2015,Diciembre,Gibraltar/Territorio Británico de Ultramar,0,2,,2,-77.35600000000001,0.81488
34940,2015,Diciembre,Granada,2,2,,4,-75.42726,6.170465
34941,2015,Diciembre,Granada,1,1,,2,-72.508188,7.927233
34942,2015,Diciembre,Grecia,2,0,,2,-76.532004,3.451668
34943,2015,Diciembre,Grecia,2,11,,13,-74.140516,4.697157
34944,2015,Diciembre,Grecia,0,2,,2,-75.42726,6.170465
34945,2015,Diciembre,Guatemala,11,6,,17,-75.516486,10.446304
34946,2015,Diciembre,Guatemala,3,8,,11,-74.77647900000001,10.886686
34947,2015,Diciembre,Guatemala,74,49,,123,-81.70216500000001,12.5862
34948,2015,Diciembre,Guatemala,42,46,,88,-76.532004,3.451668
34949,2015,Diciembre,Guatemala,431,591,,1022,-74.140516,4.697157
34950,2015,Diciembre,Guatemala,3,8,,11,-75.736374,4.815189
34951,2015,Diciembre,Guatemala,72,106,,178,-75.42726,6.170465
34952,2015,Diciembre,Guatemala,7,7,,14,-73.181317,7.1280470000000005
34953,2015,Diciembre,Guatemala,13,7,,20,-72.508188,7.927233
34954,2015,Diciembre,Guyana,0,1,,1,-76.532004,3.451668
34955,2015,Diciembre,Guyana,1,3,,4,-74.140516,4.697157
34956,2015,Diciembre,Guyana,0,2,,2,-75.42726,6.170465
34957,2015,Diciembre,Guadalupe/Territorio Francés,1,0,,1,-76.532004,3.451668
34958,2015,Diciembre,Guadalupe/Territorio Francés,2,2,,4,-74.140516,4.697157
34959,2015,Diciembre,Guayana Francesa/Departamento de Ultramar Francés,0,1,,1,-74.140516,4.697157
34960,2015,Diciembre,Haití,1,0,,1,-74.77647900000001,10.886686
34961,2015,Diciembre,Haití,0,2,,2,-74.140516,4.697157
34962,2015,Diciembre,Haití,1,2,,3,-75.42726,6.170465
34963,2015,Diciembre,Honduras,0,2,,2,-75.527794,10.406342
34964,2015,Diciembre,Honduras,73,54,,127,-75.516486,10.446304
34965,2015,Diciembre,Honduras,0,2,,2,-74.77647900000001,10.886686
34966,2015,Diciembre,Honduras,0,4,,4,-81.703935,12.574411099999999
34967,2015,Diciembre,Honduras,6,9,,15,-81.372937,13.338761300000002
34968,2015,Diciembre,Honduras,20,24,,44,-76.532004,3.451668
34969,2015,Diciembre,Honduras,49,48,,97,-74.140516,4.697157
34970,2015,Diciembre,Honduras,0,1,,1,-75.736374,4.815189
34971,2015,Diciembre,Honduras,40,32,,72,-75.42726,6.170465
34972,2015,Diciembre,Honduras,0,1,,1,-73.181317,7.1280470000000005
34973,2015,Diciembre,Honduras,1,1,,2,-72.508188,7.927233
34974,2015,Diciembre,Hong Kong,1,0,,1,-76.532004,3.451668
34975,2015,Diciembre,Hong Kong,3,6,,9,-74.140516,4.697157
34976,2015,Diciembre,Hong Kong,1,1,,2,-75.42726,6.170465
34977,2015,Diciembre,Hungría,5,5,,10,-74.140516,4.697157
34978,2015,Diciembre,India,0,2,,2,-75.516486,10.446304
34979,2015,Diciembre,India,0,1,,1,-74.77647900000001,10.886686
34980,2015,Diciembre,India,0,1,,1,-76.532004,3.451668
34981,2015,Diciembre,India,4,21,,25,-74.140516,4.697157
34982,2015,Diciembre,India,1,0,,1,-75.736374,4.815189
34983,2015,Diciembre,India,2,7,,9,-75.42726,6.170465
34984,2015,Diciembre,Indonesia,0,2,,2,-76.532004,3.451668
34985,2015,Diciembre,Indonesia,4,4,,8,-74.140516,4.697157
34986,2015,Diciembre,Indonesia,1,0,,1,-75.42726,6.170465
34987,2015,Diciembre,República de Irlanda,0,1,,1,-76.532004,3.451668
34988,2015,Diciembre,República de Irlanda,9,19,,28,-74.140516,4.697157
34989,2015,Diciembre,Islandia,0,1,,1,-74.140516,4.697157
34990,2015,Diciembre,Israel,1,2,,3,-81.70216500000001,12.5862
34991,2015,Diciembre,Israel,6,10,,16,-76.532004,3.451668
34992,2015,Diciembre,Israel,33,51,,84,-74.140516,4.697157
34993,2015,Diciembre,Israel,0,4,,4,-75.42726,6.170465
34994,2015,Diciembre,Italia,1,10,,11,-75.516486,10.446304
34995,2015,Diciembre,Italia,1,2,,3,-74.77647900000001,10.886686
34996,2015,Diciembre,Italia,60,50,,110,-81.70216500000001,12.5862
34997,2015,Diciembre,Italia,46,109,,155,-76.532004,3.451668
34998,2015,Diciembre,Italia,169,319,,488,-74.140516,4.697157
34999,2015,Diciembre,Italia,1,4,,5,-75.736374,4.815189
35000,2015,Diciembre,Italia,27,45,,72,-75.42726,6.170465
35001,2015,Diciembre,Italia,2,4,,6,-73.181317,7.1280470000000005
35002,2015,Diciembre,Jamaica,3,12,,15,-75.527794,10.406342
35003,2015,Diciembre,Jamaica,1,4,,5,-75.516486,10.446304
35004,2015,Diciembre,Jamaica,0,2,,2,-74.77647900000001,10.886686
35005,2015,Diciembre,Jamaica,0,2,,2,-81.70216500000001,12.5862
35006,2015,Diciembre,Jamaica,1,7,,8,-76.532004,3.451668
35007,2015,Diciembre,Jamaica,3,3,,6,-74.140516,4.697157
35008,2015,Diciembre,Jamaica,1,0,,1,-75.42726,6.170465
35009,2015,Diciembre,Japón,1,1,,2,-74.77647900000001,10.886686
35010,2015,Diciembre,Japón,6,3,,9,-76.532004,3.451668
35011,2015,Diciembre,Japón,12,26,,38,-74.140516,4.697157
35012,2015,Diciembre,Japón,0,1,,1,-75.736374,4.815189
35013,2015,Diciembre,Japón,1,9,,10,-75.42726,6.170465
35014,2015,Diciembre,Japón,0,1,,1,-72.508188,7.927233
35015,2015,Diciembre,Jordania,0,3,,3,-74.140516,4.697157
35016,2015,Diciembre,Kenia,1,4,,5,-74.140516,4.697157
35017,2015,Diciembre,Lesoto,1,0,,1,-74.140516,4.697157
35018,2015,Diciembre,Letonia,1,6,,7,-74.140516,4.697157
35019,2015,Diciembre,Lituania,3,6,,9,-74.140516,4.697157
35020,2015,Diciembre,Líbano,4,3,,7,-74.140516,4.697157
35021,2015,Diciembre,Liechtenstein,0,3,,3,-74.140516,4.697157
35022,2015,Diciembre,Luxemburgo,2,5,,7,-74.140516,4.697157
35023,2015,Diciembre,Luxemburgo,2,0,,2,-75.736374,4.815189
35024,2015,Diciembre,Malasia,0,2,,2,-74.140516,4.697157
35025,2015,Diciembre,Malasia,0,1,,1,-75.42726,6.170465
35026,2015,Diciembre,Malí,0,1,,1,-74.140516,4.697157
35027,2015,Diciembre,Malta,0,1,,1,-74.140516,4.697157
35028,2015,Diciembre,Marruecos,0,1,,1,-74.140516,4.697157
35029,2015,Diciembre,Marruecos,1,0,,1,-75.42726,6.170465
35030,2015,Diciembre,Martinica/Departamento de Ultramar Francés,0,2,,2,-75.527794,10.406342
35031,2015,Diciembre,México,0,11,,11,-75.527794,10.406342
35032,2015,Diciembre,México,31,34,,65,-75.516486,10.446304
35033,2015,Diciembre,México,23,40,,63,-74.77647900000001,10.886686
35034,2015,Diciembre,México,0,1,,1,-74.765343,10.970933
35035,2015,Diciembre,México,0,3,,3,-81.703935,12.574411099999999
35036,2015,Diciembre,México,13,22,,35,-81.70216500000001,12.5862
35037,2015,Diciembre,México,49,121,,170,-76.532004,3.451668
35038,2015,Diciembre,México,5128,7606,,12734,-74.140516,4.697157
35039,2015,Diciembre,México,14,19,,33,-75.736374,4.815189
35040,2015,Diciembre,México,650,1151,,1801,-75.42726,6.170465
35041,2015,Diciembre,México,17,28,,45,-73.181317,7.1280470000000005
35042,2015,Diciembre,México,18,17,,35,-72.508188,7.927233
35043,2015,Diciembre,Myanmar,1,3,,4,-74.140516,4.697157
35044,2015,Diciembre,Nicaragua,3,12,,15,-75.516486,10.446304
35045,2015,Diciembre,Nicaragua,4,6,,10,-74.77647900000001,10.886686
35046,2015,Diciembre,Nicaragua,2,2,,4,-81.70216500000001,12.5862
35047,2015,Diciembre,Nicaragua,4,7,,11,-76.532004,3.451668
35048,2015,Diciembre,Nicaragua,34,22,,56,-74.140516,4.697157
35049,2015,Diciembre,Nicaragua,2,5,,7,-75.736374,4.815189
35050,2015,Diciembre,Nicaragua,3,9,,12,-75.42726,6.170465
35051,2015,Diciembre,Nicaragua,2,1,,3,-72.508188,7.927233
35052,2015,Diciembre,Nicaragua,0,1,,1,-77.35002,8.63337
35053,2015,Diciembre,Noruega,0,1,,1,-75.516486,10.446304
35054,2015,Diciembre,Noruega,0,1,,1,-74.77647900000001,10.886686
35055,2015,Diciembre,Noruega,0,2,,2,-81.70216500000001,12.5862
35056,2015,Diciembre,Noruega,10,5,,15,-76.532004,3.451668
35057,2015,Diciembre,Noruega,42,38,,80,-74.140516,4.697157
35058,2015,Diciembre,Noruega,2,3,,5,-75.42726,6.170465
35059,2015,Diciembre,Nueva Zelanda,1,3,,4,-76.532004,3.451668
35060,2015,Diciembre,Nueva Zelanda,4,7,,11,-74.140516,4.697157
35061,2015,Diciembre,Nueva Zelanda,0,3,,3,-75.42726,6.170465
35062,2015,Diciembre,Papúa Nueva Guinea,1,0,,1,-76.532004,3.451668
35063,2015,Diciembre,Pakistán,0,2,,2,-74.140516,4.697157
35064,2015,Diciembre,Panamá,0,2,,2,-78.802679,18.00143
35065,2015,Diciembre,Panamá,811,789,,1600,-75.527794,10.406342
35066,2015,Diciembre,Panamá,2933,3061,,5994,-75.516486,10.446304
35067,2015,Diciembre,Panamá,400,699,,1099,-74.77647900000001,10.886686
35068,2015,Diciembre,Panamá,0,24,,24,-74.765343,10.970933
35069,2015,Diciembre,Panamá,5,16,,21,-81.703935,12.574411099999999
35070,2015,Diciembre,Panamá,241,234,,475,-81.70216500000001,12.5862
35071,2015,Diciembre,Panamá,11,9,,20,-81.372937,13.338761300000002
35072,2015,Diciembre,Panamá,323,619,,942,-76.532004,3.451668
35073,2015,Diciembre,Panamá,0,44,,44,-77.061029,3.8844260000000004
35074,2015,Diciembre,Panamá,100,160,,260,-75.76635300000001,4.45285
35075,2015,Diciembre,Panamá,4087,5833,,9920,-74.140516,4.697157
35076,2015,Diciembre,Panamá,86,128,,214,-75.736374,4.815189
35077,2015,Diciembre,Panamá,1686,2620,,4306,-75.42726,6.170465
35078,2015,Diciembre,Panamá,1,1,,2,-77.401154,6.222551999999999
35079,2015,Diciembre,Panamá,4,10,,14,-77.762647,7.102626
35080,2015,Diciembre,Panamá,32,56,,88,-73.181317,7.1280470000000005
35081,2015,Diciembre,Panamá,114,140,,254,-72.508188,7.927233
35082,2015,Diciembre,Panamá,106,162,,268,-77.35002,8.63337
35083,2015,Diciembre,Paraguay,1,5,,6,-74.77647900000001,10.886686
35084,2015,Diciembre,Paraguay,34,27,,61,-81.70216500000001,12.5862
35085,2015,Diciembre,Paraguay,9,11,,20,-76.532004,3.451668
35086,2015,Diciembre,Paraguay,63,66,,129,-74.140516,4.697157
35087,2015,Diciembre,Paraguay,11,11,,22,-75.42726,6.170465
35088,2015,Diciembre,Perú,119,138,,257,-69.941498,4.191162
35089,2015,Diciembre,Perú,8,6,,14,-69.94143100000001,4.214082
35090,2015,Diciembre,Perú,8,20,,28,-77.35600000000001,0.81488
35091,2015,Diciembre,Perú,0,4,,4,-75.527794,10.406342
35092,2015,Diciembre,Perú,7,4,,11,-75.516486,10.446304
35093,2015,Diciembre,Perú,3,5,,8,-74.77647900000001,10.886686
35094,2015,Diciembre,Perú,83,58,,141,-81.70216500000001,12.5862
35095,2015,Diciembre,Perú,269,347,,616,-76.532004,3.451668
35096,2015,Diciembre,Perú,5663,7317,,12980,-74.140516,4.697157
35097,2015,Diciembre,Perú,5,1,,6,-75.736374,4.815189
35098,2015,Diciembre,Perú,280,561,,841,-75.42726,6.170465
35099,2015,Diciembre,Perú,4,6,,10,-73.181317,7.1280470000000005
35100,2015,Diciembre,Perú,9,5,,14,-72.508188,7.927233
35101,2015,Diciembre,Polonia,0,1,,1,-74.77647900000001,10.886686
35102,2015,Diciembre,Polonia,0,2,,2,-81.70216500000001,12.5862
35103,2015,Diciembre,Polonia,0,1,,1,-76.532004,3.451668
35104,2015,Diciembre,Polonia,20,13,,33,-74.140516,4.697157
35105,2015,Diciembre,Polonia,0,1,,1,-75.42726,6.170465
35106,2015,Diciembre,Portugal,0,1,,1,-74.213989,11.247722999999999
35107,2015,Diciembre,Portugal,2,2,,4,-76.532004,3.451668
35108,2015,Diciembre,Portugal,386,560,,946,-74.140516,4.697157
35109,2015,Diciembre,Portugal,0,3,,3,-75.42726,6.170465
35110,2015,Diciembre,Polinesia Francesa/Colectividad de Ultramar Francesa,0,1,,1,-74.140516,4.697157
35111,2015,Diciembre,Puerto Rico/Territorio de Estados Unidos,1,3,,4,-75.516486,10.446304
35112,2015,Diciembre,Puerto Rico/Territorio de Estados Unidos,17,48,,65,-74.77647900000001,10.886686
35113,2015,Diciembre,Puerto Rico/Territorio de Estados Unidos,1,1,,2,-74.765343,10.970933
35114,2015,Diciembre,Puerto Rico/Territorio de Estados Unidos,2,10,,12,-81.70216500000001,12.5862
35115,2015,Diciembre,Puerto Rico/Territorio de Estados Unidos,41,120,,161,-76.532004,3.451668
35116,2015,Diciembre,Puerto Rico/Territorio de Estados Unidos,405,483,,888,-74.140516,4.697157
35117,2015,Diciembre,Puerto Rico/Territorio de Estados Unidos,19,13,,32,-75.736374,4.815189
35118,2015,Diciembre,Puerto Rico/Territorio de Estados Unidos,55,108,,163,-75.42726,6.170465
35119,2015,Diciembre,Puerto Rico/Territorio de Estados Unidos,3,10,,13,-73.181317,7.1280470000000005
35120,2015,Diciembre,Puerto Rico/Territorio de Estados Unidos,4,3,,7,-72.508188,7.927233
35121,2015,Diciembre,Qatar,0,1,,1,-74.140516,4.697157
35122,2015,Diciembre,Reino Unido de Gran Bretaña e Irlanda del Norte,2,0,,2,-75.516486,10.446304
35123,2015,Diciembre,Reino Unido de Gran Bretaña e Irlanda del Norte,2,7,,9,-74.77647900000001,10.886686
35124,2015,Diciembre,Reino Unido de Gran Bretaña e Irlanda del Norte,0,1,,1,-81.70216500000001,12.5862
35125,2015,Diciembre,Reino Unido de Gran Bretaña e Irlanda del Norte,31,59,,90,-76.532004,3.451668
35126,2015,Diciembre,Reino Unido de Gran Bretaña e Irlanda del Norte,1128,1782,,2910,-74.140516,4.697157
35127,2015,Diciembre,Reino Unido de Gran Bretaña e Irlanda del Norte,2,2,,4,-75.736374,4.815189
35128,2015,Diciembre,Reino Unido de Gran Bretaña e Irlanda del Norte,25,43,,68,-75.42726,6.170465
35129,2015,Diciembre,Reino Unido de Gran Bretaña e Irlanda del Norte,0,1,,1,-72.508188,7.927233
35130,2015,Diciembre,República CentroÁfricana,0,2,,2,-76.532004,3.451668
35131,2015,Diciembre,República CentroÁfricana,0,1,,1,-74.140516,4.697157
35132,2015,Diciembre,Federación de Rusia,0,1,,1,-74.77647900000001,10.886686
35133,2015,Diciembre,Federación de Rusia,1,0,,1,-76.532004,3.451668
35134,2015,Diciembre,Federación de Rusia,18,24,,42,-74.140516,4.697157
35135,2015,Diciembre,Federación de Rusia,0,1,,1,-75.42726,6.170465
35136,2015,Diciembre,República Dominicana,2,16,,18,-75.527794,10.406342
35137,2015,Diciembre,República Dominicana,2,1,,3,-75.516486,10.446304
35138,2015,Diciembre,República Dominicana,4,15,,19,-74.77647900000001,10.886686
35139,2015,Diciembre,República Dominicana,0,1,,1,-74.765343,10.970933
35140,2015,Diciembre,República Dominicana,1,3,,4,-81.70216500000001,12.5862
35141,2015,Diciembre,República Dominicana,12,72,,84,-76.532004,3.451668
35142,2015,Diciembre,República Dominicana,579,940,,1519,-74.140516,4.697157
35143,2015,Diciembre,República Dominicana,4,13,,17,-75.736374,4.815189
35144,2015,Diciembre,República Dominicana,35,41,,76,-75.42726,6.170465
35145,2015,Diciembre,República Dominicana,2,3,,5,-73.181317,7.1280470000000005
35146,2015,Diciembre,República Dominicana,2,2,,4,-72.508188,7.927233
35147,2015,Diciembre,Reunión,1,2,,3,-74.140516,4.697157
35148,2015,Diciembre,República Democrática Popular de Corea,0,1,,1,-74.140516,4.697157
35149,2015,Diciembre,Rumania,1,0,,1,-76.532004,3.451668
35150,2015,Diciembre,Rumania,4,8,,12,-74.140516,4.697157
35151,2015,Diciembre,San Cristóbal y Nevis,0,1,,1,-75.527794,10.406342
35152,2015,Diciembre,San Cristóbal y Nevis,1,2,,3,-74.140516,4.697157
35153,2015,Diciembre,San  Vicente y las Granadinas,0,4,,4,-75.527794,10.406342
35154,2015,Diciembre,San  Vicente y las Granadinas,1,3,,4,-74.213989,11.247722999999999
35155,2015,Diciembre,Santa Elena/Territorio Británico de Ultramar,0,1,,1,-74.140516,4.697157
35156,2015,Diciembre,Santa Lucia,0,1,,1,-74.213989,11.247722999999999
35157,2015,Diciembre,Santa Lucia,0,1,,1,-76.532004,3.451668
35158,2015,Diciembre,Serbia,2,0,,2,-74.140516,4.697157
35159,2015,Diciembre,Singapur,0,1,,1,-76.532004,3.451668
35160,2015,Diciembre,Singapur,7,5,,12,-74.140516,4.697157
35161,2015,Diciembre,Singapur,0,1,,1,-75.736374,4.815189
35162,2015,Diciembre,Singapur,0,1,,1,-75.42726,6.170465
35163,2015,Diciembre,Sri Lanka,1,0,,1,-74.140516,4.697157
35164,2015,Diciembre,Sudáfrica,1,2,,3,-76.532004,3.451668
35165,2015,Diciembre,Sudáfrica,3,5,,8,-74.140516,4.697157
35166,2015,Diciembre,Suecia,0,2,,2,-75.516486,10.446304
35167,2015,Diciembre,Suecia,5,2,,7,-74.77647900000001,10.886686
35168,2015,Diciembre,Suecia,27,34,,61,-76.532004,3.451668
35169,2015,Diciembre,Suecia,87,111,,198,-74.140516,4.697157
35170,2015,Diciembre,Suecia,1,2,,3,-75.736374,4.815189
35171,2015,Diciembre,Suecia,5,15,,20,-75.42726,6.170465
35172,2015,Diciembre,Suiza,2,1,,3,-75.516486,10.446304
35173,2015,Diciembre,Suiza,1,0,,1,-81.70216500000001,12.5862
35174,2015,Diciembre,Suiza,45,61,,106,-76.532004,3.451668
35175,2015,Diciembre,Suiza,123,202,,325,-74.140516,4.697157
35176,2015,Diciembre,Suiza,2,2,,4,-75.736374,4.815189
35177,2015,Diciembre,Suiza,10,34,,44,-75.42726,6.170465
35178,2015,Diciembre,Suiza,1,4,,5,-73.181317,7.1280470000000005
35179,2015,Diciembre,Suiza,1,0,,1,-72.508188,7.927233
35180,2015,Diciembre,Surinam,1,0,,1,-74.140516,4.697157
35181,2015,Diciembre,Surinam,1,4,,5,-75.42726,6.170465
35182,2015,Diciembre,Taiwán,1,5,,6,-74.140516,4.697157
35183,2015,Diciembre,Taiwán,2,0,,2,-75.42726,6.170465
35184,2015,Diciembre,Tailandia,2,2,,4,-74.140516,4.697157
35185,2015,Diciembre,Togo,0,1,,1,-74.140516,4.697157
35186,2015,Diciembre,Trinidad y Tobago,0,1,,1,-75.516486,10.446304
35187,2015,Diciembre,Trinidad y Tobago,8,8,,16,-76.532004,3.451668
35188,2015,Diciembre,Trinidad y Tobago,2,13,,15,-74.140516,4.697157
35189,2015,Diciembre,Trinidad y Tobago,1,4,,5,-75.736374,4.815189
35190,2015,Diciembre,Trinidad y Tobago,1,5,,6,-75.42726,6.170465
35191,2015,Diciembre,Trinidad y Tobago,1,4,,5,-73.181317,7.1280470000000005
35192,2015,Diciembre,Trinidad y Tobago,4,3,,7,-72.508188,7.927233
35193,2015,Diciembre,Túnez,0,1,,1,-74.140516,4.697157
35194,2015,Diciembre,Turquía,0,1,,1,-76.532004,3.451668
35195,2015,Diciembre,Turquía,4,14,,18,-74.140516,4.697157
35196,2015,Diciembre,Turquía,0,4,,4,-75.42726,6.170465
35197,2015,Diciembre,Ucrania,1,1,,2,-74.77647900000001,10.886686
35198,2015,Diciembre,Ucrania,0,2,,2,-76.532004,3.451668
35199,2015,Diciembre,Ucrania,4,1,,5,-74.140516,4.697157
35200,2015,Diciembre,Uruguay,3,0,,3,-75.516486,10.446304
35201,2015,Diciembre,Uruguay,1,2,,3,-74.77647900000001,10.886686
35202,2015,Diciembre,Uruguay,15,18,,33,-81.70216500000001,12.5862
35203,2015,Diciembre,Uruguay,14,22,,36,-76.532004,3.451668
35204,2015,Diciembre,Uruguay,41,63,,104,-74.140516,4.697157
35205,2015,Diciembre,Uruguay,21,33,,54,-75.42726,6.170465
35206,2015,Diciembre,Uruguay,0,1,,1,-73.181317,7.1280470000000005
35207,2015,Diciembre,Venezuela,0,20,,20,-75.527794,10.406342
35208,2015,Diciembre,Venezuela,529,406,,935,-75.516486,10.446304
35209,2015,Diciembre,Venezuela,27,48,,75,-74.77647900000001,10.886686
35210,2015,Diciembre,Venezuela,0,6,,6,-74.232675,11.117206
35211,2015,Diciembre,Venezuela,225,330,,555,-72.129595,11.360028999999999
35212,2015,Diciembre,Venezuela,3,5,,8,-81.70216500000001,12.5862
35213,2015,Diciembre,Venezuela,24,43,,67,-76.532004,3.451668
35214,2015,Diciembre,Venezuela,47,48,,95,-67.927521,3.866713
35215,2015,Diciembre,Venezuela,4543,4387,,8930,-74.140516,4.697157
35216,2015,Diciembre,Venezuela,1,4,,5,-75.736374,4.815189
35217,2015,Diciembre,Venezuela,1985,1641,,3626,-75.42726,6.170465
35218,2015,Diciembre,Venezuela,49,76,,125,-67.48402800000001,6.185536
35219,2015,Diciembre,Venezuela,61,145,,206,-70.74025300000001,7.088728999999999
35220,2015,Diciembre,Venezuela,20,18,,38,-73.181317,7.1280470000000005
35221,2015,Diciembre,Venezuela,3048,3439,,6487,-72.453013,7.819
35222,2015,Diciembre,Venezuela,178,221,,399,-72.508188,7.927233
35223,2015,Diciembre,Islas Vírgenes Británicas/Territorio Británico de Ultramar,5,3,,8,-81.372937,13.338761300000002
35224,2015,Diciembre,Islas Vírgenes Británicas/Territorio Británico de Ultramar,4,9,,13,-74.140516,4.697157
35225,2015,Diciembre,República Árabe de Yemen,0,1,,1,-74.140516,4.697157
35226,2015,Diciembre,Desconocido,0,8,,8,-75.68164200000001,9.402597
35227,2015,Diciembre,Desconocido,199,1220,,1419,-74.140516,4.697157
35228,2016,Enero,Afganistán,2,0,,2,-74.140516,4.697157
35229,2016,Enero,Alemania,3,2,,5,-74.77647900000001,10.886686
35230,2016,Enero,Alemania,1,0,,1,-81.70216500000001,12.5862
35231,2016,Enero,Alemania,31,52,,83,-76.532004,3.451668
35232,2016,Enero,Alemania,1360,2188,,3548,-74.140516,4.697157
35233,2016,Enero,Alemania,0,2,,2,-75.736374,4.815189
35234,2016,Enero,Alemania,42,52,,94,-75.42726,6.170465
35235,2016,Enero,Angola,0,1,,1,-74.140516,4.697157
35236,2016,Enero,Antigua y Barbuda,0,1,,1,-75.527794,10.406342
35237,2016,Enero,Antigua y Barbuda,0,4,,4,-74.140516,4.697157
35238,2016,Enero,Países Bajos,30,30,,60,-75.527794,10.406342
35239,2016,Enero,Países Bajos,3,10,,13,-75.516486,10.446304
35240,2016,Enero,Países Bajos,49,54,,103,-74.77647900000001,10.886686
35241,2016,Enero,Países Bajos,10,15,,25,-74.213989,11.247722999999999
35242,2016,Enero,Países Bajos,87,185,,272,-76.532004,3.451668
35243,2016,Enero,Países Bajos,926,1356,,2282,-74.140516,4.697157
35244,2016,Enero,Países Bajos,1,0,,1,-75.736374,4.815189
35245,2016,Enero,Países Bajos,163,234,,397,-75.42726,6.170465
35246,2016,Enero,Países Bajos,9,4,,13,-73.181317,7.1280470000000005
35247,2016,Enero,Arabia Saudita,0,1,,1,-74.140516,4.697157
35248,2016,Enero,Argelia,0,2,,2,-76.532004,3.451668
35249,2016,Enero,Argelia,3,3,,6,-74.140516,4.697157
35250,2016,Enero,Argentina,1,6,,7,-77.35600000000001,0.81488
35251,2016,Enero,Argentina,32,21,,53,-75.516486,10.446304
35252,2016,Enero,Argentina,10,11,,21,-74.77647900000001,10.886686
35253,2016,Enero,Argentina,281,193,,474,-81.70216500000001,12.5862
35254,2016,Enero,Argentina,61,69,,130,-76.532004,3.451668
35255,2016,Enero,Argentina,3959,4056,,8015,-74.140516,4.697157
35256,2016,Enero,Argentina,5,3,,8,-75.736374,4.815189
35257,2016,Enero,Argentina,133,121,,254,-75.42726,6.170465
35258,2016,Enero,Argentina,0,3,,3,-73.181317,7.1280470000000005
35259,2016,Enero,Aruba,157,145,,302,-75.527794,10.406342
35260,2016,Enero,Aruba,4,7,,11,-75.516486,10.446304
35261,2016,Enero,Aruba,9,4,,13,-74.77647900000001,10.886686
35262,2016,Enero,Aruba,40,65,,105,-74.213989,11.247722999999999
35263,2016,Enero,Aruba,13,13,,26,-76.532004,3.451668
35264,2016,Enero,Aruba,564,726,,1290,-74.140516,4.697157
35265,2016,Enero,Aruba,30,44,,74,-75.42726,6.170465
35266,2016,Enero,Aruba,10,6,,16,-73.181317,7.1280470000000005
35267,2016,Enero,Australia,1,1,,2,-74.77647900000001,10.886686
35268,2016,Enero,Australia,1,1,,2,-81.70216500000001,12.5862
35269,2016,Enero,Australia,5,11,,16,-76.532004,3.451668
35270,2016,Enero,Australia,38,34,,72,-74.140516,4.697157
35271,2016,Enero,Australia,0,1,,1,-75.736374,4.815189
35272,2016,Enero,Australia,18,26,,44,-75.42726,6.170465
35273,2016,Enero,Australia,0,1,,1,-73.181317,7.1280470000000005
35274,2016,Enero,Austria,3,5,,8,-76.532004,3.451668
35275,2016,Enero,Austria,27,39,,66,-74.140516,4.697157
35276,2016,Enero,Austria,4,3,,7,-75.42726,6.170465
35277,2016,Enero,Austria,0,2,,2,-73.181317,7.1280470000000005
35278,2016,Enero,Austria,1,1,,2,-72.508188,7.927233
35279,2016,Enero,Bahamas,1,1,,2,-74.213989,11.247722999999999
35280,2016,Enero,Bahamas,2,1,,3,-74.140516,4.697157
35281,2016,Enero,Bahamas,4,1,,5,-75.42726,6.170465
35282,2016,Enero,Bahréin,0,1,,1,-75.516486,10.446304
35283,2016,Enero,Bahréin,1,0,,1,-74.140516,4.697157
35284,2016,Enero,Bahréin,1,0,,1,-72.453013,7.819
35285,2016,Enero,Barbados,36,52,,88,-74.140516,4.697157
35286,2016,Enero,República de Belarús,2,2,,4,-74.140516,4.697157
35287,2016,Enero,República de Belarús,1,1,,2,-72.453013,7.819
35288,2016,Enero,Bélgica,0,1,,1,-74.77647900000001,10.886686
35289,2016,Enero,Bélgica,3,10,,13,-76.532004,3.451668
35290,2016,Enero,Bélgica,33,45,,78,-74.140516,4.697157
35291,2016,Enero,Bélgica,1,2,,3,-75.736374,4.815189
35292,2016,Enero,Bélgica,6,14,,20,-75.42726,6.170465
35293,2016,Enero,Belice,3,3,,6,-74.140516,4.697157
35294,2016,Enero,Belice,0,2,,2,-75.42726,6.170465
35295,2016,Enero,Benín,0,2,,2,-75.42726,6.170465
35296,2016,Enero,Bolivia,3,2,,5,-75.516486,10.446304
35297,2016,Enero,Bolivia,5,2,,7,-74.77647900000001,10.886686
35298,2016,Enero,Bolivia,21,20,,41,-81.70216500000001,12.5862
35299,2016,Enero,Bolivia,30,30,,60,-76.532004,3.451668
35300,2016,Enero,Bolivia,565,600,,1165,-74.140516,4.697157
35301,2016,Enero,Bolivia,4,0,,4,-75.736374,4.815189
35302,2016,Enero,Bolivia,41,53,,94,-75.42726,6.170465
35303,2016,Enero,Bolivia,1,1,,2,-72.508188,7.927233
35304,2016,Enero,Bosnia y Herzegovina,1,0,,1,-74.140516,4.697157
35305,2016,Enero,Brasil,111,165,,276,-69.941498,4.191162
35306,2016,Enero,Brasil,0,19,,19,-69.94143100000001,4.214082
35307,2016,Enero,Brasil,0,6,,6,-75.527794,10.406342
35308,2016,Enero,Brasil,35,28,,63,-75.516486,10.446304
35309,2016,Enero,Brasil,13,11,,24,-74.77647900000001,10.886686
35310,2016,Enero,Brasil,516,395,,911,-81.70216500000001,12.5862
35311,2016,Enero,Brasil,115,140,,255,-76.532004,3.451668
35312,2016,Enero,Brasil,0,4,,4,-77.061029,3.8844260000000004
35313,2016,Enero,Brasil,5306,6111,,11417,-74.140516,4.697157
35314,2016,Enero,Brasil,4,6,,10,-75.736374,4.815189
35315,2016,Enero,Brasil,212,246,,458,-75.42726,6.170465
35316,2016,Enero,Brasil,5,6,,11,-73.181317,7.1280470000000005
35317,2016,Enero,Brasil,5,4,,9,-72.508188,7.927233
35318,2016,Enero,Bulgaria,5,3,,8,-74.140516,4.697157
35319,2016,Enero,Bulgaria,0,1,,1,-75.42726,6.170465
35320,2016,Enero,Bulgaria,1,1,,2,-73.181317,7.1280470000000005
35321,2016,Enero,Burkina Faso,0,1,,1,-74.140516,4.697157
35322,2016,Enero,Cabo Verde,1,0,,1,-74.140516,4.697157
35323,2016,Enero,Islas Caimán/Territorio Británico de Ultramar,2,6,,8,-75.527794,10.406342
35324,2016,Enero,Islas Caimán/Territorio Británico de Ultramar,1,1,,2,-81.372937,13.338761300000002
35325,2016,Enero,Islas Caimán/Territorio Británico de Ultramar,0,3,,3,-74.140516,4.697157
35326,2016,Enero,Canadá,0,1,,1,-75.527794,10.406342
35327,2016,Enero,Canadá,386,358,,744,-75.516486,10.446304
35328,2016,Enero,Canadá,9,19,,28,-74.77647900000001,10.886686
35329,2016,Enero,Canadá,348,329,,677,-81.70216500000001,12.5862
35330,2016,Enero,Canadá,44,52,,96,-76.532004,3.451668
35331,2016,Enero,Canadá,0,2,,2,-75.76635300000001,4.45285
35332,2016,Enero,Canadá,617,901,,1518,-74.140516,4.697157
35333,2016,Enero,Canadá,8,22,,30,-75.736374,4.815189
35334,2016,Enero,Canadá,111,184,,295,-75.42726,6.170465
35335,2016,Enero,Canadá,5,9,,14,-73.181317,7.1280470000000005
35336,2016,Enero,Canadá,1,2,,3,-72.508188,7.927233
35337,2016,Enero,Chad,1,0,,1,-74.140516,4.697157
35338,2016,Enero,España,2,5,,7,-74.77647900000001,10.886686
35339,2016,Enero,España,2,2,,4,-81.70216500000001,12.5862
35340,2016,Enero,España,531,815,,1346,-76.532004,3.451668
35341,2016,Enero,España,3473,5948,,9421,-74.140516,4.697157
35342,2016,Enero,España,2,2,,4,-75.736374,4.815189
35343,2016,Enero,España,357,674,,1031,-75.42726,6.170465
35344,2016,Enero,España,3,3,,6,-73.181317,7.1280470000000005
35345,2016,Enero,España,1,0,,1,-72.508188,7.927233
35346,2016,Enero,República de Corea,0,1,,1,-75.527794,10.406342
35347,2016,Enero,República de Corea,0,1,,1,-74.77647900000001,10.886686
35348,2016,Enero,República de Corea,0,4,,4,-77.061029,3.8844260000000004
35349,2016,Enero,República de Corea,25,46,,71,-74.140516,4.697157
35350,2016,Enero,República de Corea,4,6,,10,-75.42726,6.170465
35351,2016,Enero,Costa de Marfil,0,1,,1,-75.527794,10.406342
35352,2016,Enero,Costa de Marfil,0,1,,1,-76.532004,3.451668
35353,2016,Enero,Costa de Marfil,4,4,,8,-74.140516,4.697157
35354,2016,Enero,Costa de Marfil,0,1,,1,-75.42726,6.170465
35355,2016,Enero,Costa Rica,129,107,,236,-75.527794,10.406342
35356,2016,Enero,Costa Rica,2,7,,9,-75.516486,10.446304
35357,2016,Enero,Costa Rica,9,15,,24,-74.77647900000001,10.886686
35358,2016,Enero,Costa Rica,5,20,,25,-81.703935,12.574411099999999
35359,2016,Enero,Costa Rica,237,168,,405,-81.70216500000001,12.5862
35360,2016,Enero,Costa Rica,41,45,,86,-76.532004,3.451668
35361,2016,Enero,Costa Rica,932,1234,,2166,-74.140516,4.697157
35362,2016,Enero,Costa Rica,14,12,,26,-75.736374,4.815189
35363,2016,Enero,Costa Rica,111,153,,264,-75.42726,6.170465
35364,2016,Enero,Costa Rica,5,5,,10,-73.181317,7.1280470000000005
35365,2016,Enero,Costa Rica,2,7,,9,-72.508188,7.927233
35366,2016,Enero,Croacia,0,2,,2,-76.532004,3.451668
35367,2016,Enero,Croacia,2,2,,4,-74.140516,4.697157
35368,2016,Enero,Cuba,0,3,,3,-75.516486,10.446304
35369,2016,Enero,Cuba,6,6,,12,-74.77647900000001,10.886686
35370,2016,Enero,Cuba,3,0,,3,-81.70216500000001,12.5862
35371,2016,Enero,Cuba,7,18,,25,-76.532004,3.451668
35372,2016,Enero,Cuba,429,600,,1029,-74.140516,4.697157
35373,2016,Enero,Cuba,1,4,,5,-75.736374,4.815189
35374,2016,Enero,Cuba,20,41,,61,-75.42726,6.170465
35375,2016,Enero,Cuba,1,3,,4,-73.181317,7.1280470000000005
35376,2016,Enero,Cuba,1,3,,4,-72.508188,7.927233
35377,2016,Enero,Curazao,1,0,,1,-74.140516,4.697157
35378,2016,Enero,República Checa,1,2,,3,-76.532004,3.451668
35379,2016,Enero,República Checa,10,10,,20,-74.140516,4.697157
35380,2016,Enero,Chile,7,10,,17,-75.516486,10.446304
35381,2016,Enero,Chile,2,5,,7,-74.77647900000001,10.886686
35382,2016,Enero,Chile,253,179,,432,-81.70216500000001,12.5862
35383,2016,Enero,Chile,73,101,,174,-76.532004,3.451668
35384,2016,Enero,Chile,4501,5258,,9759,-74.140516,4.697157
35385,2016,Enero,Chile,0,6,,6,-75.736374,4.815189
35386,2016,Enero,Chile,50,71,,121,-75.42726,6.170465
35387,2016,Enero,Chile,1,3,,4,-73.181317,7.1280470000000005
35388,2016,Enero,Chile,2,2,,4,-72.508188,7.927233
35389,2016,Enero,China,2,1,,3,-76.532004,3.451668
35390,2016,Enero,China,33,71,,104,-74.140516,4.697157
35391,2016,Enero,China,1,7,,8,-75.42726,6.170465
35392,2016,Enero,China,0,1,,1,-73.181317,7.1280470000000005
35393,2016,Enero,Dinamarca,7,6,,13,-76.532004,3.451668
35394,2016,Enero,Dinamarca,27,37,,64,-74.140516,4.697157
35395,2016,Enero,Dinamarca,3,3,,6,-75.42726,6.170465
35396,2016,Enero,Dinamarca,0,3,,3,-73.181317,7.1280470000000005
35397,2016,Enero,Dominica,10,8,,18,-74.140516,4.697157
35398,2016,Enero,Ecuador,90,228,,318,-76.876446,0.33002
35399,2016,Enero,Ecuador,2,1,,3,-77.84700600000001,0.8124359999999999
35400,2016,Enero,Ecuador,3244,5088,,8332,-77.35600000000001,0.81488
35401,2016,Enero,Ecuador,39,54,,93,-78.802679,18.00143
35402,2016,Enero,Ecuador,1,2,,3,-75.527794,10.406342
35403,2016,Enero,Ecuador,4,9,,13,-75.516486,10.446304
35404,2016,Enero,Ecuador,5,4,,9,-74.77647900000001,10.886686
35405,2016,Enero,Ecuador,2,3,,5,-81.70216500000001,12.5862
35406,2016,Enero,Ecuador,322,411,,733,-76.532004,3.451668
35407,2016,Enero,Ecuador,3085,4513,,7598,-74.140516,4.697157
35408,2016,Enero,Ecuador,55,80,,135,-75.42726,6.170465
35409,2016,Enero,Ecuador,1,3,,4,-73.181317,7.1280470000000005
35410,2016,Enero,Ecuador,6,9,,15,-72.508188,7.927233
35411,2016,Enero,Egipto,2,6,,8,-74.140516,4.697157
35412,2016,Enero,Egipto,0,1,,1,-73.181317,7.1280470000000005
35413,2016,Enero,El Salvador,1,1,,2,-74.77647900000001,10.886686
35414,2016,Enero,El Salvador,3,4,,7,-81.70216500000001,12.5862
35415,2016,Enero,El Salvador,131,186,,317,-76.532004,3.451668
35416,2016,Enero,El Salvador,790,1136,,1926,-74.140516,4.697157
35417,2016,Enero,El Salvador,160,242,,402,-75.42726,6.170465
35418,2016,Enero,El Salvador,1,1,,2,-73.181317,7.1280470000000005
35419,2016,Enero,El Salvador,2,2,,4,-72.508188,7.927233
35420,2016,Enero,Emiratos Árabes,1,0,,1,-76.532004,3.451668
35421,2016,Enero,Emiratos Árabes,2,7,,9,-74.140516,4.697157
35422,2016,Enero,Eslovaquia,0,1,,1,-76.532004,3.451668
35423,2016,Enero,Eslovaquia,3,3,,6,-74.140516,4.697157
35424,2016,Enero,Eslovenia,4,4,,8,-74.140516,4.697157
35425,2016,Enero,Eslovenia,1,0,,1,-75.42726,6.170465
35426,2016,Enero,Estados Unidos de América,1,36,,37,-75.527794,10.406342
35427,2016,Enero,Estados Unidos de América,3401,4777,,8178,-75.516486,10.446304
35428,2016,Enero,Estados Unidos de América,577,989,,1566,-74.77647900000001,10.886686
35429,2016,Enero,Estados Unidos de América,0,2,,2,-74.765343,10.970933
35430,2016,Enero,Estados Unidos de América,0,7,,7,-74.213989,11.247722999999999
35431,2016,Enero,Estados Unidos de América,14,16,,30,-81.70216500000001,12.5862
35432,2016,Enero,Estados Unidos de América,854,1279,,2133,-76.532004,3.451668
35433,2016,Enero,Estados Unidos de América,98,148,,246,-75.76635300000001,4.45285
35434,2016,Enero,Estados Unidos de América,8431,14652,,23083,-74.140516,4.697157
35435,2016,Enero,Estados Unidos de América,130,188,,318,-75.736374,4.815189
35436,2016,Enero,Estados Unidos de América,2349,5384,,7733,-75.42726,6.170465
35437,2016,Enero,Estados Unidos de América,39,70,,109,-73.181317,7.1280470000000005
35438,2016,Enero,Estados Unidos de América,46,52,,98,-72.508188,7.927233
35439,2016,Enero,Estados Unidos de América,0,18,,18,-75.68164200000001,9.402597
35440,2016,Enero,Estonia,2,5,,7,-74.140516,4.697157
35441,2016,Enero,Filipinas,0,1,,1,-74.77647900000001,10.886686
35442,2016,Enero,Filipinas,2,10,,12,-76.532004,3.451668
35443,2016,Enero,Filipinas,4,6,,10,-74.140516,4.697157
35444,2016,Enero,Filipinas,2,3,,5,-75.736374,4.815189
35445,2016,Enero,Filipinas,0,1,,1,-75.42726,6.170465
35446,2016,Enero,Finlandia,0,3,,3,-74.77647900000001,10.886686
35447,2016,Enero,Finlandia,1,1,,2,-76.532004,3.451668
35448,2016,Enero,Finlandia,5,16,,21,-74.140516,4.697157
35449,2016,Enero,Finlandia,1,1,,2,-75.42726,6.170465
35450,2016,Enero,Francia,0,6,,6,-75.527794,10.406342
35451,2016,Enero,Francia,0,1,,1,-75.516486,10.446304
35452,2016,Enero,Francia,4,1,,5,-74.77647900000001,10.886686
35453,2016,Enero,Francia,40,48,,88,-76.532004,3.451668
35454,2016,Enero,Francia,1579,2277,,3856,-74.140516,4.697157
35455,2016,Enero,Francia,1,6,,7,-75.736374,4.815189
35456,2016,Enero,Francia,39,54,,93,-75.42726,6.170465
35457,2016,Enero,Francia,1,0,,1,-73.181317,7.1280470000000005
35458,2016,Enero,Gibraltar/Territorio Británico de Ultramar,1,0,,1,-77.35600000000001,0.81488
35459,2016,Enero,Grecia,2,3,,5,-76.532004,3.451668
35460,2016,Enero,Grecia,2,7,,9,-74.140516,4.697157
35461,2016,Enero,Grecia,0,1,,1,-72.508188,7.927233
35462,2016,Enero,Guatemala,0,2,,2,-75.527794,10.406342
35463,2016,Enero,Guatemala,3,5,,8,-75.516486,10.446304
35464,2016,Enero,Guatemala,2,7,,9,-74.77647900000001,10.886686
35465,2016,Enero,Guatemala,6,3,,9,-81.70216500000001,12.5862
35466,2016,Enero,Guatemala,1,1,,2,-81.372937,13.338761300000002
35467,2016,Enero,Guatemala,19,46,,65,-76.532004,3.451668
35468,2016,Enero,Guatemala,264,423,,687,-74.140516,4.697157
35469,2016,Enero,Guatemala,3,4,,7,-75.736374,4.815189
35470,2016,Enero,Guatemala,57,129,,186,-75.42726,6.170465
35471,2016,Enero,Guatemala,5,6,,11,-73.181317,7.1280470000000005
35472,2016,Enero,Guatemala,2,1,,3,-72.508188,7.927233
35473,2016,Enero,Guyana,0,6,,6,-75.527794,10.406342
35474,2016,Enero,Guyana,1,0,,1,-74.77647900000001,10.886686
35475,2016,Enero,Guyana,2,1,,3,-76.532004,3.451668
35476,2016,Enero,Guyana,1,3,,4,-74.140516,4.697157
35477,2016,Enero,Guinea,1,0,,1,-77.35600000000001,0.81488
35478,2016,Enero,Guinea Ecuatorial,0,1,,1,-74.140516,4.697157
35479,2016,Enero,Guadalupe/Territorio Francés,3,4,,7,-74.140516,4.697157
35480,2016,Enero,Guadalupe/Territorio Francés,0,1,,1,-75.42726,6.170465
35481,2016,Enero,Guayana Francesa/Departamento de Ultramar Francés,0,1,,1,-74.140516,4.697157
35482,2016,Enero,Guayana Francesa/Departamento de Ultramar Francés,0,1,,1,-75.42726,6.170465
35483,2016,Enero,Haití,0,3,,3,-75.527794,10.406342
35484,2016,Enero,Haití,3,7,,10,-74.140516,4.697157
35485,2016,Enero,Haití,1,1,,2,-75.42726,6.170465
35486,2016,Enero,Honduras,3,6,,9,-75.516486,10.446304
35487,2016,Enero,Honduras,1,1,,2,-74.77647900000001,10.886686
35488,2016,Enero,Honduras,0,2,,2,-74.213989,11.247722999999999
35489,2016,Enero,Honduras,6,3,,9,-81.703935,12.574411099999999
35490,2016,Enero,Honduras,7,10,,17,-81.372937,13.338761300000002
35491,2016,Enero,Honduras,13,18,,31,-76.532004,3.451668
35492,2016,Enero,Honduras,39,51,,90,-74.140516,4.697157
35493,2016,Enero,Honduras,2,1,,3,-75.736374,4.815189
35494,2016,Enero,Honduras,41,61,,102,-75.42726,6.170465
35495,2016,Enero,Honduras,1,0,,1,-73.181317,7.1280470000000005
35496,2016,Enero,Honduras,1,0,,1,-72.508188,7.927233
35497,2016,Enero,Hong Kong,3,7,,10,-74.140516,4.697157
35498,2016,Enero,Hong Kong,0,1,,1,-75.42726,6.170465
35499,2016,Enero,Hungría,1,0,,1,-76.532004,3.451668
35500,2016,Enero,Hungría,3,3,,6,-74.140516,4.697157
35501,2016,Enero,India,2,6,,8,-76.532004,3.451668
35502,2016,Enero,India,4,32,,36,-74.140516,4.697157
35503,2016,Enero,India,2,22,,24,-75.42726,6.170465
35504,2016,Enero,India,0,2,,2,-72.508188,7.927233
35505,2016,Enero,Indonesia,1,1,,2,-74.140516,4.697157
35506,2016,Enero,Irán,0,1,,1,-76.532004,3.451668
35507,2016,Enero,Irán,2,1,,3,-74.140516,4.697157
35508,2016,Enero,República de Irlanda,0,1,,1,-75.516486,10.446304
35509,2016,Enero,República de Irlanda,2,1,,3,-74.77647900000001,10.886686
35510,2016,Enero,República de Irlanda,1,2,,3,-76.532004,3.451668
35511,2016,Enero,República de Irlanda,12,10,,22,-74.140516,4.697157
35512,2016,Enero,República de Irlanda,0,1,,1,-75.42726,6.170465
35513,2016,Enero,Islandia,1,0,,1,-74.140516,4.697157
35514,2016,Enero,Israel,2,9,,11,-76.532004,3.451668
35515,2016,Enero,Israel,8,74,,82,-74.140516,4.697157
35516,2016,Enero,Israel,0,7,,7,-75.42726,6.170465
35517,2016,Enero,Italia,2,1,,3,-74.77647900000001,10.886686
35518,2016,Enero,Italia,161,154,,315,-81.70216500000001,12.5862
35519,2016,Enero,Italia,36,81,,117,-76.532004,3.451668
35520,2016,Enero,Italia,134,333,,467,-74.140516,4.697157
35521,2016,Enero,Italia,1,1,,2,-75.736374,4.815189
35522,2016,Enero,Italia,19,67,,86,-75.42726,6.170465
35523,2016,Enero,Italia,0,1,,1,-73.181317,7.1280470000000005
35524,2016,Enero,Italia,1,0,,1,-72.508188,7.927233
35525,2016,Enero,Jamaica,1,5,,6,-75.527794,10.406342
35526,2016,Enero,Jamaica,0,1,,1,-74.77647900000001,10.886686
35527,2016,Enero,Jamaica,1,2,,3,-76.532004,3.451668
35528,2016,Enero,Jamaica,7,7,,14,-74.140516,4.697157
35529,2016,Enero,Jamaica,1,0,,1,-75.736374,4.815189
35530,2016,Enero,Jamaica,0,2,,2,-75.42726,6.170465
35531,2016,Enero,Jamaica,0,1,,1,-76.7333,8.06667
35532,2016,Enero,Japón,0,3,,3,-76.532004,3.451668
35533,2016,Enero,Japón,8,28,,36,-74.140516,4.697157
35534,2016,Enero,Japón,2,11,,13,-75.42726,6.170465
35535,2016,Enero,Jordania,2,1,,3,-74.140516,4.697157
35536,2016,Enero,Jordania,0,1,,1,-73.181317,7.1280470000000005
35537,2016,Enero,Kazajistán,1,2,,3,-76.532004,3.451668
35538,2016,Enero,Kazajistán,1,1,,2,-74.140516,4.697157
35539,2016,Enero,Kenia,0,1,,1,-76.532004,3.451668
35540,2016,Enero,Kenia,0,2,,2,-74.140516,4.697157
35541,2016,Enero,Letonia,0,3,,3,-74.140516,4.697157
35542,2016,Enero,Lituania,0,1,,1,-76.532004,3.451668
35543,2016,Enero,Lituania,5,2,,7,-74.140516,4.697157
35544,2016,Enero,Líbano,2,4,,6,-74.140516,4.697157
35545,2016,Enero,Luxemburgo,3,3,,6,-74.140516,4.697157
35546,2016,Enero,Macedonia,1,0,,1,-76.532004,3.451668
35547,2016,Enero,Madagascar,0,1,,1,-74.140516,4.697157
35548,2016,Enero,Malasia,1,2,,3,-74.140516,4.697157
35549,2016,Enero,Malasia,1,0,,1,-75.42726,6.170465
35550,2016,Enero,Malasia,0,1,,1,-72.508188,7.927233
35551,2016,Enero,Malí,0,2,,2,-74.140516,4.697157
35552,2016,Enero,Malta,1,2,,3,-74.140516,4.697157
35553,2016,Enero,Marruecos,0,4,,4,-74.140516,4.697157
35554,2016,Enero,Marruecos,0,1,,1,-75.42726,6.170465
35555,2016,Enero,México,13,37,,50,-75.516486,10.446304
35556,2016,Enero,México,21,14,,35,-74.77647900000001,10.886686
35557,2016,Enero,México,0,6,,6,-81.703935,12.574411099999999
35558,2016,Enero,México,7,7,,14,-81.70216500000001,12.5862
35559,2016,Enero,México,49,103,,152,-76.532004,3.451668
35560,2016,Enero,México,4462,7069,,11531,-74.140516,4.697157
35561,2016,Enero,México,7,24,,31,-75.736374,4.815189
35562,2016,Enero,México,453,1065,,1518,-75.42726,6.170465
35563,2016,Enero,México,19,23,,42,-73.181317,7.1280470000000005
35564,2016,Enero,México,20,16,,36,-72.508188,7.927233
35565,2016,Enero,Nicaragua,0,8,,8,-75.516486,10.446304
35566,2016,Enero,Nicaragua,1,3,,4,-74.77647900000001,10.886686
35567,2016,Enero,Nicaragua,0,2,,2,-81.70216500000001,12.5862
35568,2016,Enero,Nicaragua,9,4,,13,-76.532004,3.451668
35569,2016,Enero,Nicaragua,29,57,,86,-74.140516,4.697157
35570,2016,Enero,Nicaragua,3,5,,8,-75.736374,4.815189
35571,2016,Enero,Nicaragua,5,7,,12,-75.42726,6.170465
35572,2016,Enero,Nicaragua,3,0,,3,-73.181317,7.1280470000000005
35573,2016,Enero,Nicaragua,2,1,,3,-72.508188,7.927233
35574,2016,Enero,Nigeria,0,7,,7,-74.140516,4.697157
35575,2016,Enero,Níger,0,1,,1,-74.140516,4.697157
35576,2016,Enero,Noruega,0,1,,1,-74.77647900000001,10.886686
35577,2016,Enero,Noruega,2,4,,6,-76.532004,3.451668
35578,2016,Enero,Noruega,12,24,,36,-74.140516,4.697157
35579,2016,Enero,Noruega,6,6,,12,-75.42726,6.170465
35580,2016,Enero,Noruega,0,1,,1,-72.508188,7.927233
35581,2016,Enero,Nueva Zelanda,0,1,,1,-74.77647900000001,10.886686
35582,2016,Enero,Nueva Zelanda,1,2,,3,-76.532004,3.451668
35583,2016,Enero,Nueva Zelanda,5,4,,9,-74.140516,4.697157
35584,2016,Enero,Nueva Zelanda,1,3,,4,-75.42726,6.170465
35585,2016,Enero,Pakistán,0,1,,1,-75.42726,6.170465
35586,2016,Enero,Panamá,1549,1297,,2846,-75.527794,10.406342
35587,2016,Enero,Panamá,2880,3177,,6057,-75.516486,10.446304
35588,2016,Enero,Panamá,298,553,,851,-74.77647900000001,10.886686
35589,2016,Enero,Panamá,1,43,,44,-74.765343,10.970933
35590,2016,Enero,Panamá,1,4,,5,-74.213989,11.247722999999999
35591,2016,Enero,Panamá,4,11,,15,-81.703935,12.574411099999999
35592,2016,Enero,Panamá,306,297,,603,-81.70216500000001,12.5862
35593,2016,Enero,Panamá,30,27,,57,-81.372937,13.338761300000002
35594,2016,Enero,Panamá,305,502,,807,-76.532004,3.451668
35595,2016,Enero,Panamá,0,22,,22,-77.061029,3.8844260000000004
35596,2016,Enero,Panamá,115,170,,285,-75.76635300000001,4.45285
35597,2016,Enero,Panamá,3920,5518,,9438,-74.140516,4.697157
35598,2016,Enero,Panamá,63,107,,170,-75.736374,4.815189
35599,2016,Enero,Panamá,1670,2493,,4163,-75.42726,6.170465
35600,2016,Enero,Panamá,3,3,,6,-77.762647,7.102626
35601,2016,Enero,Panamá,23,36,,59,-73.181317,7.1280470000000005
35602,2016,Enero,Panamá,64,80,,144,-72.508188,7.927233
35603,2016,Enero,Panamá,0,4,,4,-76.7333,8.06667
35604,2016,Enero,Panamá,160,245,,405,-77.35002,8.63337
35605,2016,Enero,Paraguay,1,0,,1,-77.35600000000001,0.81488
35606,2016,Enero,Paraguay,2,1,,3,-75.516486,10.446304
35607,2016,Enero,Paraguay,1,6,,7,-74.77647900000001,10.886686
35608,2016,Enero,Paraguay,106,70,,176,-81.70216500000001,12.5862
35609,2016,Enero,Paraguay,6,5,,11,-76.532004,3.451668
35610,2016,Enero,Paraguay,71,70,,141,-74.140516,4.697157
35611,2016,Enero,Paraguay,2,1,,3,-75.736374,4.815189
35612,2016,Enero,Paraguay,12,13,,25,-75.42726,6.170465
35613,2016,Enero,Paraguay,0,1,,1,-72.508188,7.927233
35614,2016,Enero,Perú,97,126,,223,-69.941498,4.191162
35615,2016,Enero,Perú,1,1,,2,-69.94143100000001,4.214082
35616,2016,Enero,Perú,0,10,,10,-77.35600000000001,0.81488
35617,2016,Enero,Perú,0,3,,3,-78.802679,18.00143
35618,2016,Enero,Perú,0,3,,3,-75.527794,10.406342
35619,2016,Enero,Perú,10,10,,20,-75.516486,10.446304
35620,2016,Enero,Perú,9,15,,24,-74.77647900000001,10.886686
35621,2016,Enero,Perú,0,1,,1,-74.213989,11.247722999999999
35622,2016,Enero,Perú,169,117,,286,-81.70216500000001,12.5862
35623,2016,Enero,Perú,299,400,,699,-76.532004,3.451668
35624,2016,Enero,Perú,0,1,,1,-77.061029,3.8844260000000004
35625,2016,Enero,Perú,6499,7883,,14382,-74.140516,4.697157
35626,2016,Enero,Perú,4,3,,7,-75.736374,4.815189
35627,2016,Enero,Perú,377,643,,1020,-75.42726,6.170465
35628,2016,Enero,Perú,2,5,,7,-73.181317,7.1280470000000005
35629,2016,Enero,Perú,6,0,,6,-72.508188,7.927233
35630,2016,Enero,Polonia,6,13,,19,-76.532004,3.451668
35631,2016,Enero,Polonia,11,23,,34,-74.140516,4.697157
35632,2016,Enero,Polonia,2,1,,3,-75.42726,6.170465
35633,2016,Enero,Portugal,2,1,,3,-76.532004,3.451668
35634,2016,Enero,Portugal,475,740,,1215,-74.140516,4.697157
35635,2016,Enero,Portugal,3,7,,10,-75.42726,6.170465
35636,2016,Enero,Polinesia Francesa/Colectividad de Ultramar Francesa,0,1,,1,-74.140516,4.697157
35637,2016,Enero,Polinesia Francesa/Colectividad de Ultramar Francesa,2,0,,2,-75.42726,6.170465
35638,2016,Enero,Puerto Rico/Territorio de Estados Unidos,0,8,,8,-75.516486,10.446304
35639,2016,Enero,Puerto Rico/Territorio de Estados Unidos,11,41,,52,-74.77647900000001,10.886686
35640,2016,Enero,Puerto Rico/Territorio de Estados Unidos,0,3,,3,-74.213989,11.247722999999999
35641,2016,Enero,Puerto Rico/Territorio de Estados Unidos,1,1,,2,-81.372937,13.338761300000002
35642,2016,Enero,Puerto Rico/Territorio de Estados Unidos,15,33,,48,-76.532004,3.451668
35643,2016,Enero,Puerto Rico/Territorio de Estados Unidos,150,251,,401,-74.140516,4.697157
35644,2016,Enero,Puerto Rico/Territorio de Estados Unidos,5,38,,43,-75.736374,4.815189
35645,2016,Enero,Puerto Rico/Territorio de Estados Unidos,19,59,,78,-75.42726,6.170465
35646,2016,Enero,Puerto Rico/Territorio de Estados Unidos,2,5,,7,-73.181317,7.1280470000000005
35647,2016,Enero,Puerto Rico/Territorio de Estados Unidos,1,2,,3,-72.508188,7.927233
35648,2016,Enero,Reino Unido de Gran Bretaña e Irlanda del Norte,283,249,,532,-75.516486,10.446304
35649,2016,Enero,Reino Unido de Gran Bretaña e Irlanda del Norte,33,60,,93,-74.77647900000001,10.886686
35650,2016,Enero,Reino Unido de Gran Bretaña e Irlanda del Norte,19,30,,49,-76.532004,3.451668
35651,2016,Enero,Reino Unido de Gran Bretaña e Irlanda del Norte,982,1579,,2561,-74.140516,4.697157
35652,2016,Enero,Reino Unido de Gran Bretaña e Irlanda del Norte,9,28,,37,-75.42726,6.170465
35653,2016,Enero,República CentroÁfricana,1,0,,1,-74.140516,4.697157
35654,2016,Enero,Federación de Rusia,2,1,,3,-76.532004,3.451668
35655,2016,Enero,Federación de Rusia,56,70,,126,-74.140516,4.697157
35656,2016,Enero,Federación de Rusia,2,1,,3,-75.42726,6.170465
35657,2016,Enero,República Dominicana,2,4,,6,-75.527794,10.406342
35658,2016,Enero,República Dominicana,1,6,,7,-75.516486,10.446304
35659,2016,Enero,República Dominicana,4,6,,10,-74.77647900000001,10.886686
35660,2016,Enero,República Dominicana,0,2,,2,-74.232675,11.117206
35661,2016,Enero,República Dominicana,2,3,,5,-81.70216500000001,12.5862
35662,2016,Enero,República Dominicana,22,30,,52,-76.532004,3.451668
35663,2016,Enero,República Dominicana,626,898,,1524,-74.140516,4.697157
35664,2016,Enero,República Dominicana,5,7,,12,-75.736374,4.815189
35665,2016,Enero,República Dominicana,38,62,,100,-75.42726,6.170465
35666,2016,Enero,República Dominicana,6,31,,37,-73.181317,7.1280470000000005
35667,2016,Enero,República Dominicana,1,1,,2,-72.508188,7.927233
35668,2016,Enero,Reunión,2,1,,3,-74.140516,4.697157
35669,2016,Enero,Rumania,9,19,,28,-74.140516,4.697157
35670,2016,Enero,San Marino,1,2,,3,-74.140516,4.697157
35671,2016,Enero,San  Vicente y las Granadinas,0,1,,1,-75.516486,10.446304
35672,2016,Enero,Santa Lucia,1,2,,3,-74.765343,10.970933
35673,2016,Enero,Santa Lucia,30,45,,75,-74.213989,11.247722999999999
35674,2016,Enero,Santa Lucia,0,1,,1,-74.140516,4.697157
35675,2016,Enero,Santa Lucia,1,0,,1,-72.508188,7.927233
35676,2016,Enero,Santa Sede/Ciudad del Vaticano,0,1,,1,-76.532004,3.451668
35677,2016,Enero,Santo Tomé y Príncipe,1,0,,1,-74.140516,4.697157
35678,2016,Enero,Serbia,1,1,,2,-74.140516,4.697157
35679,2016,Enero,Seychelles,0,3,,3,-74.213989,11.247722999999999
35680,2016,Enero,Singapur,1,2,,3,-74.140516,4.697157
35681,2016,Enero,Singapur,0,1,,1,-75.42726,6.170465
35682,2016,Enero,Sudáfrica,0,2,,2,-74.765343,10.970933
35683,2016,Enero,Sudáfrica,4,10,,14,-74.140516,4.697157
35684,2016,Enero,Sudáfrica,0,1,,1,-75.42726,6.170465
35685,2016,Enero,Suecia,0,1,,1,-74.77647900000001,10.886686
35686,2016,Enero,Suecia,8,14,,22,-76.532004,3.451668
35687,2016,Enero,Suecia,25,45,,70,-74.140516,4.697157
35688,2016,Enero,Suecia,7,7,,14,-75.42726,6.170465
35689,2016,Enero,Suecia,0,1,,1,-73.181317,7.1280470000000005
35690,2016,Enero,Suiza,0,1,,1,-75.516486,10.446304
35691,2016,Enero,Suiza,2,0,,2,-74.77647900000001,10.886686
35692,2016,Enero,Suiza,1,1,,2,-81.70216500000001,12.5862
35693,2016,Enero,Suiza,18,36,,54,-76.532004,3.451668
35694,2016,Enero,Suiza,83,126,,209,-74.140516,4.697157
35695,2016,Enero,Suiza,1,2,,3,-75.736374,4.815189
35696,2016,Enero,Suiza,12,23,,35,-75.42726,6.170465
35697,2016,Enero,Surinam,0,1,,1,-74.77647900000001,10.886686
35698,2016,Enero,Surinam,3,5,,8,-74.140516,4.697157
35699,2016,Enero,Surinam,2,1,,3,-75.42726,6.170465
35700,2016,Enero,Taiwán,1,0,,1,-76.532004,3.451668
35701,2016,Enero,Taiwán,4,7,,11,-74.140516,4.697157
35702,2016,Enero,Taiwán,1,5,,6,-75.42726,6.170465
35703,2016,Enero,Tailandia,2,2,,4,-74.140516,4.697157
35704,2016,Enero,Trinidad y Tobago,0,8,,8,-75.527794,10.406342
35705,2016,Enero,Trinidad y Tobago,1,1,,2,-74.77647900000001,10.886686
35706,2016,Enero,Trinidad y Tobago,2,11,,13,-76.532004,3.451668
35707,2016,Enero,Trinidad y Tobago,3,14,,17,-74.140516,4.697157
35708,2016,Enero,Trinidad y Tobago,0,2,,2,-75.736374,4.815189
35709,2016,Enero,Trinidad y Tobago,0,9,,9,-75.42726,6.170465
35710,2016,Enero,Trinidad y Tobago,0,1,,1,-72.508188,7.927233
35711,2016,Enero,Turkmenistán,0,1,,1,-76.532004,3.451668
35712,2016,Enero,Turquía,0,3,,3,-76.532004,3.451668
35713,2016,Enero,Turquía,5,14,,19,-74.140516,4.697157
35714,2016,Enero,Turquía,0,5,,5,-75.42726,6.170465
35715,2016,Enero,Ucrania,1,6,,7,-74.140516,4.697157
35716,2016,Enero,Ucrania,1,0,,1,-75.42726,6.170465
35717,2016,Enero,Uruguay,1,0,,1,-77.35600000000001,0.81488
35718,2016,Enero,Uruguay,2,0,,2,-75.516486,10.446304
35719,2016,Enero,Uruguay,2,4,,6,-74.77647900000001,10.886686
35720,2016,Enero,Uruguay,37,14,,51,-81.70216500000001,12.5862
35721,2016,Enero,Uruguay,23,24,,47,-76.532004,3.451668
35722,2016,Enero,Uruguay,69,119,,188,-74.140516,4.697157
35723,2016,Enero,Uruguay,0,1,,1,-75.736374,4.815189
35724,2016,Enero,Uruguay,35,43,,78,-75.42726,6.170465
35725,2016,Enero,Uruguay,5,0,,5,-72.508188,7.927233
35726,2016,Enero,Venezuela,0,42,,42,-75.527794,10.406342
35727,2016,Enero,Venezuela,61,88,,149,-75.516486,10.446304
35728,2016,Enero,Venezuela,14,47,,61,-74.77647900000001,10.886686
35729,2016,Enero,Venezuela,1,5,,6,-74.232675,11.117206
35730,2016,Enero,Venezuela,244,414,,658,-72.129595,11.360028999999999
35731,2016,Enero,Venezuela,1,2,,3,-81.70216500000001,12.5862
35732,2016,Enero,Venezuela,22,46,,68,-76.532004,3.451668
35733,2016,Enero,Venezuela,36,47,,83,-67.927521,3.866713
35734,2016,Enero,Venezuela,3445,3845,,7290,-74.140516,4.697157
35735,2016,Enero,Venezuela,5,9,,14,-75.736374,4.815189
35736,2016,Enero,Venezuela,719,716,,1435,-75.42726,6.170465
35737,2016,Enero,Venezuela,32,81,,113,-67.48402800000001,6.185536
35738,2016,Enero,Venezuela,43,80,,123,-70.74025300000001,7.088728999999999
35739,2016,Enero,Venezuela,12,15,,27,-73.181317,7.1280470000000005
35740,2016,Enero,Venezuela,2721,3401,,6122,-72.453013,7.819
35741,2016,Enero,Venezuela,159,225,,384,-72.508188,7.927233
35742,2016,Enero,Vietnam,0,1,,1,-74.140516,4.697157
35743,2016,Enero,Islas Vírgenes Estadounidenses/Territorio de Estados Unidos,0,5,,5,-75.527794,10.406342
35744,2016,Enero,Islas Turcas y Caicos/Territorio Británico de Ultramar,3,1,,4,-74.213989,11.247722999999999
35745,2016,Enero,Desconocido,0,1,,1,-74.140516,4.697157
35746,2016,Febrero,Afganistán,1,2,,3,-74.140516,4.697157
35747,2016,Febrero,Alemania,0,2,,2,-75.516486,10.446304
35748,2016,Febrero,Alemania,2,3,,5,-74.77647900000001,10.886686
35749,2016,Febrero,Alemania,55,69,,124,-76.532004,3.451668
35750,2016,Febrero,Alemania,1463,2295,,3758,-74.140516,4.697157
35751,2016,Febrero,Alemania,0,1,,1,-75.736374,4.815189
35752,2016,Febrero,Alemania,23,40,,63,-75.42726,6.170465
35753,2016,Febrero,Alemania,0,1,,1,-73.181317,7.1280470000000005
35754,2016,Febrero,Andorra,0,1,,1,-76.532004,3.451668
35755,2016,Febrero,Andorra,0,1,,1,-74.140516,4.697157
35756,2016,Febrero,Antigua y Barbuda,0,6,,6,-75.527794,10.406342
35757,2016,Febrero,Antigua y Barbuda,1,5,,6,-75.516486,10.446304
35758,2016,Febrero,Antigua y Barbuda,1,1,,2,-74.140516,4.697157
35759,2016,Febrero,Países Bajos,57,117,,174,-75.527794,10.406342
35760,2016,Febrero,Países Bajos,3,6,,9,-75.516486,10.446304
35761,2016,Febrero,Países Bajos,55,91,,146,-74.77647900000001,10.886686
35762,2016,Febrero,Países Bajos,3,10,,13,-74.213989,11.247722999999999
35763,2016,Febrero,Países Bajos,57,136,,193,-76.532004,3.451668
35764,2016,Febrero,Países Bajos,914,1252,,2166,-74.140516,4.697157
35765,2016,Febrero,Países Bajos,1,6,,7,-75.736374,4.815189
35766,2016,Febrero,Países Bajos,176,226,,402,-75.42726,6.170465
35767,2016,Febrero,Países Bajos,0,2,,2,-73.181317,7.1280470000000005
35768,2016,Febrero,Arabia Saudita,0,1,,1,-74.140516,4.697157
35769,2016,Febrero,Argelia,0,1,,1,-76.532004,3.451668
35770,2016,Febrero,Argelia,0,1,,1,-74.140516,4.697157
35771,2016,Febrero,Argentina,11,20,,31,-77.35600000000001,0.81488
35772,2016,Febrero,Argentina,31,21,,52,-75.516486,10.446304
35773,2016,Febrero,Argentina,13,11,,24,-74.77647900000001,10.886686
35774,2016,Febrero,Argentina,312,238,,550,-81.70216500000001,12.5862
35775,2016,Febrero,Argentina,86,137,,223,-76.532004,3.451668
35776,2016,Febrero,Argentina,2779,3361,,6140,-74.140516,4.697157
35777,2016,Febrero,Argentina,1,3,,4,-75.736374,4.815189
35778,2016,Febrero,Argentina,86,121,,207,-75.42726,6.170465
35779,2016,Febrero,Argentina,1,1,,2,-73.181317,7.1280470000000005
35780,2016,Febrero,Argentina,2,1,,3,-72.508188,7.927233
35781,2016,Febrero,República de Armenia,0,1,,1,-74.140516,4.697157
35782,2016,Febrero,Aruba,5,6,,11,-75.527794,10.406342
35783,2016,Febrero,Aruba,0,2,,2,-75.516486,10.446304
35784,2016,Febrero,Aruba,1,5,,6,-74.77647900000001,10.886686
35785,2016,Febrero,Aruba,10,12,,22,-74.213989,11.247722999999999
35786,2016,Febrero,Aruba,6,12,,18,-76.532004,3.451668
35787,2016,Febrero,Aruba,563,740,,1303,-74.140516,4.697157
35788,2016,Febrero,Aruba,5,2,,7,-75.736374,4.815189
35789,2016,Febrero,Aruba,18,14,,32,-75.42726,6.170465
35790,2016,Febrero,Aruba,7,7,,14,-73.181317,7.1280470000000005
35791,2016,Febrero,Australia,1,1,,2,-75.516486,10.446304
35792,2016,Febrero,Australia,0,1,,1,-74.77647900000001,10.886686
35793,2016,Febrero,Australia,0,1,,1,-81.70216500000001,12.5862
35794,2016,Febrero,Australia,4,11,,15,-76.532004,3.451668
35795,2016,Febrero,Australia,22,36,,58,-74.140516,4.697157
35796,2016,Febrero,Australia,1,0,,1,-75.736374,4.815189
35797,2016,Febrero,Australia,14,23,,37,-75.42726,6.170465
35798,2016,Febrero,Austria,2,0,,2,-74.77647900000001,10.886686
35799,2016,Febrero,Austria,3,4,,7,-76.532004,3.451668
35800,2016,Febrero,Austria,34,56,,90,-74.140516,4.697157
35801,2016,Febrero,Austria,1,5,,6,-75.42726,6.170465
35802,2016,Febrero,Bahamas,0,2,,2,-76.532004,3.451668
35803,2016,Febrero,Bahamas,2,11,,13,-74.140516,4.697157
35804,2016,Febrero,Bahamas,1,1,,2,-75.42726,6.170465
35805,2016,Febrero,Bahréin,2,1,,3,-74.140516,4.697157
35806,2016,Febrero,Bahréin,0,1,,1,-75.42726,6.170465
35807,2016,Febrero,Barbados,0,2,,2,-75.516486,10.446304
35808,2016,Febrero,Barbados,1,4,,5,-74.77647900000001,10.886686
35809,2016,Febrero,Barbados,0,1,,1,-76.532004,3.451668
35810,2016,Febrero,Barbados,33,38,,71,-74.140516,4.697157
35811,2016,Febrero,República de Belarús,5,16,,21,-74.140516,4.697157
35812,2016,Febrero,Bélgica,0,1,,1,-74.213989,11.247722999999999
35813,2016,Febrero,Bélgica,1,0,,1,-81.70216500000001,12.5862
35814,2016,Febrero,Bélgica,5,12,,17,-76.532004,3.451668
35815,2016,Febrero,Bélgica,31,60,,91,-74.140516,4.697157
35816,2016,Febrero,Bélgica,9,6,,15,-75.42726,6.170465
35817,2016,Febrero,Belice,0,1,,1,-74.77647900000001,10.886686
35818,2016,Febrero,Belice,1,1,,2,-81.70216500000001,12.5862
35819,2016,Febrero,Belice,1,3,,4,-74.140516,4.697157
35820,2016,Febrero,Belice,0,1,,1,-75.42726,6.170465
35821,2016,Febrero,Benín,1,0,,1,-74.140516,4.697157
35822,2016,Febrero,Benín,0,1,,1,-75.42726,6.170465
35823,2016,Febrero,Bolivia,1,0,,1,-77.35600000000001,0.81488
35824,2016,Febrero,Bolivia,2,2,,4,-75.516486,10.446304
35825,2016,Febrero,Bolivia,1,0,,1,-74.77647900000001,10.886686
35826,2016,Febrero,Bolivia,24,26,,50,-81.70216500000001,12.5862
35827,2016,Febrero,Bolivia,35,28,,63,-76.532004,3.451668
35828,2016,Febrero,Bolivia,419,505,,924,-74.140516,4.697157
35829,2016,Febrero,Bolivia,2,5,,7,-75.736374,4.815189
35830,2016,Febrero,Bolivia,39,45,,84,-75.42726,6.170465
35831,2016,Febrero,Bosnia y Herzegovina,1,0,,1,-74.140516,4.697157
35832,2016,Febrero,Botsuana,0,1,,1,-74.140516,4.697157
35833,2016,Febrero,Brasil,123,158,,281,-69.941498,4.191162
35834,2016,Febrero,Brasil,2,10,,12,-69.94143100000001,4.214082
35835,2016,Febrero,Brasil,1,1,,2,-77.35600000000001,0.81488
35836,2016,Febrero,Brasil,0,2,,2,-75.527794,10.406342
35837,2016,Febrero,Brasil,43,29,,72,-75.516486,10.446304
35838,2016,Febrero,Brasil,12,15,,27,-74.77647900000001,10.886686
35839,2016,Febrero,Brasil,0,6,,6,-74.765343,10.970933
35840,2016,Febrero,Brasil,418,342,,760,-81.70216500000001,12.5862
35841,2016,Febrero,Brasil,126,151,,277,-76.532004,3.451668
35842,2016,Febrero,Brasil,0,1,,1,-67.927521,3.866713
35843,2016,Febrero,Brasil,5429,6632,,12061,-74.140516,4.697157
35844,2016,Febrero,Brasil,1,4,,5,-75.736374,4.815189
35845,2016,Febrero,Brasil,189,246,,435,-75.42726,6.170465
35846,2016,Febrero,Brasil,0,2,,2,-73.181317,7.1280470000000005
35847,2016,Febrero,Brasil,0,1,,1,-72.508188,7.927233
35848,2016,Febrero,Bulgaria,2,3,,5,-74.140516,4.697157
35849,2016,Febrero,Islas Caimán/Territorio Británico de Ultramar,2,1,,3,-75.527794,10.406342
35850,2016,Febrero,Islas Caimán/Territorio Británico de Ultramar,1,0,,1,-76.532004,3.451668
35851,2016,Febrero,Islas Caimán/Territorio Británico de Ultramar,0,12,,12,-74.140516,4.697157
35852,2016,Febrero,Islas Caimán/Territorio Británico de Ultramar,0,1,,1,-75.42726,6.170465
35853,2016,Febrero,Canadá,321,323,,644,-75.516486,10.446304
35854,2016,Febrero,Canadá,4,10,,14,-74.77647900000001,10.886686
35855,2016,Febrero,Canadá,327,304,,631,-81.70216500000001,12.5862
35856,2016,Febrero,Canadá,36,44,,80,-76.532004,3.451668
35857,2016,Febrero,Canadá,674,1066,,1740,-74.140516,4.697157
35858,2016,Febrero,Canadá,0,2,,2,-75.736374,4.815189
35859,2016,Febrero,Canadá,91,138,,229,-75.42726,6.170465
35860,2016,Febrero,Canadá,3,2,,5,-72.508188,7.927233
35861,2016,Febrero,España,1,1,,2,-75.527794,10.406342
35862,2016,Febrero,España,4,5,,9,-75.516486,10.446304
35863,2016,Febrero,España,1,2,,3,-74.77647900000001,10.886686
35864,2016,Febrero,España,348,586,,934,-76.532004,3.451668
35865,2016,Febrero,España,2800,5126,,7926,-74.140516,4.697157
35866,2016,Febrero,España,4,5,,9,-75.736374,4.815189
35867,2016,Febrero,España,201,354,,555,-75.42726,6.170465
35868,2016,Febrero,España,0,1,,1,-73.181317,7.1280470000000005
35869,2016,Febrero,España,0,1,,1,-76.7333,8.06667
35870,2016,Febrero,España,0,1,,1,-75.68164200000001,9.402597
35871,2016,Febrero,República de Corea,1,0,,1,-76.532004,3.451668
35872,2016,Febrero,República de Corea,11,13,,24,-74.140516,4.697157
35873,2016,Febrero,República de Corea,3,3,,6,-75.42726,6.170465
35874,2016,Febrero,República de Corea,0,1,,1,-73.181317,7.1280470000000005
35875,2016,Febrero,República de Corea,0,1,,1,-72.508188,7.927233
35876,2016,Febrero,Costa de Marfil,1,0,,1,-75.527794,10.406342
35877,2016,Febrero,Costa de Marfil,4,4,,8,-74.140516,4.697157
35878,2016,Febrero,Costa Rica,2,10,,12,-75.527794,10.406342
35879,2016,Febrero,Costa Rica,0,1,,1,-75.516486,10.446304
35880,2016,Febrero,Costa Rica,6,14,,20,-74.77647900000001,10.886686
35881,2016,Febrero,Costa Rica,0,5,,5,-81.703935,12.574411099999999
35882,2016,Febrero,Costa Rica,112,99,,211,-81.70216500000001,12.5862
35883,2016,Febrero,Costa Rica,19,40,,59,-76.532004,3.451668
35884,2016,Febrero,Costa Rica,778,1326,,2104,-74.140516,4.697157
35885,2016,Febrero,Costa Rica,2,11,,13,-75.736374,4.815189
35886,2016,Febrero,Costa Rica,57,92,,149,-75.42726,6.170465
35887,2016,Febrero,Costa Rica,0,1,,1,-73.181317,7.1280470000000005
35888,2016,Febrero,Costa Rica,0,2,,2,-72.508188,7.927233
35889,2016,Febrero,Croacia,0,8,,8,-74.213989,11.247722999999999
35890,2016,Febrero,Croacia,4,2,,6,-74.140516,4.697157
35891,2016,Febrero,Croacia,2,1,,3,-75.42726,6.170465
35892,2016,Febrero,Cuba,0,7,,7,-75.527794,10.406342
35893,2016,Febrero,Cuba,92,70,,162,-75.516486,10.446304
35894,2016,Febrero,Cuba,2,5,,7,-74.77647900000001,10.886686
35895,2016,Febrero,Cuba,1,0,,1,-81.70216500000001,12.5862
35896,2016,Febrero,Cuba,5,8,,13,-76.532004,3.451668
35897,2016,Febrero,Cuba,288,375,,663,-74.140516,4.697157
35898,2016,Febrero,Cuba,0,1,,1,-75.736374,4.815189
35899,2016,Febrero,Cuba,14,23,,37,-75.42726,6.170465
35900,2016,Febrero,Cuba,0,2,,2,-73.181317,7.1280470000000005
35901,2016,Febrero,Cuba,1,1,,2,-72.508188,7.927233
35902,2016,Febrero,Curazao,1,2,,3,-74.140516,4.697157
35903,2016,Febrero,República Checa,5,17,,22,-74.140516,4.697157
35904,2016,Febrero,República Checa,1,0,,1,-75.42726,6.170465
35905,2016,Febrero,Chile,24,23,,47,-77.35600000000001,0.81488
35906,2016,Febrero,Chile,29,19,,48,-75.516486,10.446304
35907,2016,Febrero,Chile,141,93,,234,-81.70216500000001,12.5862
35908,2016,Febrero,Chile,85,91,,176,-76.532004,3.451668
35909,2016,Febrero,Chile,4785,5246,,10031,-74.140516,4.697157
35910,2016,Febrero,Chile,4,5,,9,-75.736374,4.815189
35911,2016,Febrero,Chile,63,67,,130,-75.42726,6.170465
35912,2016,Febrero,Chile,1,2,,3,-73.181317,7.1280470000000005
35913,2016,Febrero,Chile,1,1,,2,-72.508188,7.927233
35914,2016,Febrero,China,7,5,,12,-74.77647900000001,10.886686
35915,2016,Febrero,China,1,3,,4,-76.532004,3.451668
35916,2016,Febrero,China,26,56,,82,-74.140516,4.697157
35917,2016,Febrero,China,0,1,,1,-75.42726,6.170465
35918,2016,Febrero,Chipre,0,1,,1,-74.140516,4.697157
35919,2016,Febrero,Dinamarca,1,2,,3,-76.532004,3.451668
35920,2016,Febrero,Dinamarca,25,38,,63,-74.140516,4.697157
35921,2016,Febrero,Dinamarca,0,1,,1,-75.736374,4.815189
35922,2016,Febrero,Dinamarca,1,2,,3,-75.42726,6.170465
35923,2016,Febrero,Dominica,0,1,,1,-75.516486,10.446304
35924,2016,Febrero,Dominica,0,2,,2,-74.140516,4.697157
35925,2016,Febrero,Ecuador,0,2,,2,-74.78366,0.18595699999999998
35926,2016,Febrero,Ecuador,92,209,,301,-76.876446,0.33002
35927,2016,Febrero,Ecuador,0,1,,1,-77.84700600000001,0.8124359999999999
35928,2016,Febrero,Ecuador,3409,4965,,8374,-77.35600000000001,0.81488
35929,2016,Febrero,Ecuador,22,32,,54,-78.802679,18.00143
35930,2016,Febrero,Ecuador,0,1,,1,-75.527794,10.406342
35931,2016,Febrero,Ecuador,4,3,,7,-75.516486,10.446304
35932,2016,Febrero,Ecuador,1,3,,4,-74.77647900000001,10.886686
35933,2016,Febrero,Ecuador,12,9,,21,-81.70216500000001,12.5862
35934,2016,Febrero,Ecuador,412,438,,850,-76.532004,3.451668
35935,2016,Febrero,Ecuador,3351,4933,,8284,-74.140516,4.697157
35936,2016,Febrero,Ecuador,2,2,,4,-75.736374,4.815189
35937,2016,Febrero,Ecuador,62,88,,150,-75.42726,6.170465
35938,2016,Febrero,Egipto,0,3,,3,-74.140516,4.697157
35939,2016,Febrero,El Salvador,1,1,,2,-74.77647900000001,10.886686
35940,2016,Febrero,El Salvador,11,9,,20,-81.70216500000001,12.5862
35941,2016,Febrero,El Salvador,89,132,,221,-76.532004,3.451668
35942,2016,Febrero,El Salvador,811,1209,,2020,-74.140516,4.697157
35943,2016,Febrero,El Salvador,0,1,,1,-75.736374,4.815189
35944,2016,Febrero,El Salvador,141,242,,383,-75.42726,6.170465
35945,2016,Febrero,Emiratos Árabes,1,5,,6,-74.140516,4.697157
35946,2016,Febrero,Eritrea,1,1,,2,-74.140516,4.697157
35947,2016,Febrero,Eslovaquia,0,2,,2,-76.532004,3.451668
35948,2016,Febrero,Eslovaquia,1,3,,4,-74.140516,4.697157
35949,2016,Febrero,Eslovenia,0,2,,2,-76.532004,3.451668
35950,2016,Febrero,Eslovenia,5,4,,9,-74.140516,4.697157
35951,2016,Febrero,Eslovenia,1,0,,1,-75.42726,6.170465
35952,2016,Febrero,Estados Unidos de América,2,29,,31,-75.527794,10.406342
35953,2016,Febrero,Estados Unidos de América,3786,4969,,8755,-75.516486,10.446304
35954,2016,Febrero,Estados Unidos de América,702,1173,,1875,-74.77647900000001,10.886686
35955,2016,Febrero,Estados Unidos de América,0,11,,11,-74.765343,10.970933
35956,2016,Febrero,Estados Unidos de América,2,2,,4,-74.232675,11.117206
35957,2016,Febrero,Estados Unidos de América,0,22,,22,-74.213989,11.247722999999999
35958,2016,Febrero,Estados Unidos de América,6,20,,26,-81.70216500000001,12.5862
35959,2016,Febrero,Estados Unidos de América,817,1323,,2140,-76.532004,3.451668
35960,2016,Febrero,Estados Unidos de América,0,1,,1,-77.061029,3.8844260000000004
35961,2016,Febrero,Estados Unidos de América,98,137,,235,-75.76635300000001,4.45285
35962,2016,Febrero,Estados Unidos de América,8604,15542,,24146,-74.140516,4.697157
35963,2016,Febrero,Estados Unidos de América,132,170,,302,-75.736374,4.815189
35964,2016,Febrero,Estados Unidos de América,2431,5998,,8429,-75.42726,6.170465
35965,2016,Febrero,Estados Unidos de América,12,17,,29,-73.181317,7.1280470000000005
35966,2016,Febrero,Estados Unidos de América,15,17,,32,-72.508188,7.927233
35967,2016,Febrero,Estados Unidos de América,0,29,,29,-75.68164200000001,9.402597
35968,2016,Febrero,Estonia,0,1,,1,-74.140516,4.697157
35969,2016,Febrero,Filipinas,2,3,,5,-75.516486,10.446304
35970,2016,Febrero,Filipinas,0,3,,3,-74.77647900000001,10.886686
35971,2016,Febrero,Filipinas,0,4,,4,-76.532004,3.451668
35972,2016,Febrero,Filipinas,4,10,,14,-74.140516,4.697157
35973,2016,Febrero,Filipinas,0,1,,1,-75.736374,4.815189
35974,2016,Febrero,Finlandia,8,6,,14,-74.140516,4.697157
35975,2016,Febrero,Finlandia,1,0,,1,-75.42726,6.170465
35976,2016,Febrero,Francia,1,2,,3,-75.516486,10.446304
35977,2016,Febrero,Francia,4,5,,9,-74.77647900000001,10.886686
35978,2016,Febrero,Francia,9,9,,18,-81.70216500000001,12.5862
35979,2016,Febrero,Francia,35,61,,96,-76.532004,3.451668
35980,2016,Febrero,Francia,1544,2438,,3982,-74.140516,4.697157
35981,2016,Febrero,Francia,4,4,,8,-75.736374,4.815189
35982,2016,Febrero,Francia,25,37,,62,-75.42726,6.170465
35983,2016,Febrero,Georgia,0,2,,2,-74.140516,4.697157
35984,2016,Febrero,Ghana,1,1,,2,-74.140516,4.697157
35985,2016,Febrero,Grecia,2,3,,5,-76.532004,3.451668
35986,2016,Febrero,Grecia,4,16,,20,-74.140516,4.697157
35987,2016,Febrero,Guatemala,3,6,,9,-75.516486,10.446304
35988,2016,Febrero,Guatemala,1,4,,5,-74.77647900000001,10.886686
35989,2016,Febrero,Guatemala,3,5,,8,-81.70216500000001,12.5862
35990,2016,Febrero,Guatemala,12,31,,43,-76.532004,3.451668
35991,2016,Febrero,Guatemala,285,569,,854,-74.140516,4.697157
35992,2016,Febrero,Guatemala,15,19,,34,-75.736374,4.815189
35993,2016,Febrero,Guatemala,41,73,,114,-75.42726,6.170465
35994,2016,Febrero,Guatemala,2,6,,8,-73.181317,7.1280470000000005
35995,2016,Febrero,Guatemala,4,1,,5,-72.508188,7.927233
35996,2016,Febrero,Guyana,0,1,,1,-75.42726,6.170465
35997,2016,Febrero,Guadalupe/Territorio Francés,1,0,,1,-75.516486,10.446304
35998,2016,Febrero,Guadalupe/Territorio Francés,1,1,,2,-74.213989,11.247722999999999
35999,2016,Febrero,Guadalupe/Territorio Francés,2,5,,7,-74.140516,4.697157
36000,2016,Febrero,Guadalupe/Territorio Francés,1,0,,1,-75.736374,4.815189
36001,2016,Febrero,Guayana Francesa/Departamento de Ultramar Francés,1,0,,1,-73.181317,7.1280470000000005
36002,2016,Febrero,Haití,0,14,,14,-75.527794,10.406342
36003,2016,Febrero,Haití,0,1,,1,-76.532004,3.451668
36004,2016,Febrero,Haití,3,2,,5,-74.140516,4.697157
36005,2016,Febrero,Haití,0,1,,1,-75.42726,6.170465
36006,2016,Febrero,Honduras,0,1,,1,-75.516486,10.446304
36007,2016,Febrero,Honduras,1,1,,2,-74.77647900000001,10.886686
36008,2016,Febrero,Honduras,0,9,,9,-81.703935,12.574411099999999
36009,2016,Febrero,Honduras,0,1,,1,-81.70216500000001,12.5862
36010,2016,Febrero,Honduras,4,7,,11,-81.372937,13.338761300000002
36011,2016,Febrero,Honduras,8,10,,18,-76.532004,3.451668
36012,2016,Febrero,Honduras,45,56,,101,-74.140516,4.697157
36013,2016,Febrero,Honduras,1,3,,4,-75.736374,4.815189
36014,2016,Febrero,Honduras,15,34,,49,-75.42726,6.170465
36015,2016,Febrero,Hong Kong,3,14,,17,-74.140516,4.697157
36016,2016,Febrero,Hong Kong,1,1,,2,-75.42726,6.170465
36017,2016,Febrero,Hungría,0,1,,1,-76.532004,3.451668
36018,2016,Febrero,Hungría,9,5,,14,-74.140516,4.697157
36019,2016,Febrero,India,0,1,,1,-75.516486,10.446304
36020,2016,Febrero,India,0,1,,1,-74.77647900000001,10.886686
36021,2016,Febrero,India,0,5,,5,-76.532004,3.451668
36022,2016,Febrero,India,6,23,,29,-74.140516,4.697157
36023,2016,Febrero,India,0,1,,1,-75.736374,4.815189
36024,2016,Febrero,India,1,4,,5,-75.42726,6.170465
36025,2016,Febrero,Indonesia,1,6,,7,-74.140516,4.697157
36026,2016,Febrero,República de Irlanda,1,1,,2,-81.70216500000001,12.5862
36027,2016,Febrero,República de Irlanda,1,2,,3,-76.532004,3.451668
36028,2016,Febrero,República de Irlanda,10,14,,24,-74.140516,4.697157
36029,2016,Febrero,República de Irlanda,0,1,,1,-75.42726,6.170465
36030,2016,Febrero,Isla de Man,0,1,,1,-75.42726,6.170465
36031,2016,Febrero,Israel,0,1,,1,-74.77647900000001,10.886686
36032,2016,Febrero,Israel,2,1,,3,-76.532004,3.451668
36033,2016,Febrero,Israel,7,47,,54,-74.140516,4.697157
36034,2016,Febrero,Israel,0,6,,6,-75.42726,6.170465
36035,2016,Febrero,Italia,1,2,,3,-75.516486,10.446304
36036,2016,Febrero,Italia,148,137,,285,-81.70216500000001,12.5862
36037,2016,Febrero,Italia,21,55,,76,-76.532004,3.451668
36038,2016,Febrero,Italia,122,259,,381,-74.140516,4.697157
36039,2016,Febrero,Italia,12,38,,50,-75.42726,6.170465
36040,2016,Febrero,Jamaica,3,10,,13,-75.527794,10.406342
36041,2016,Febrero,Jamaica,8,6,,14,-75.516486,10.446304
36042,2016,Febrero,Jamaica,3,8,,11,-76.532004,3.451668
36043,2016,Febrero,Jamaica,2,7,,9,-74.140516,4.697157
36044,2016,Febrero,Jamaica,1,0,,1,-75.736374,4.815189
36045,2016,Febrero,Jamaica,3,3,,6,-75.42726,6.170465
36046,2016,Febrero,Japón,1,5,,6,-76.532004,3.451668
36047,2016,Febrero,Japón,8,28,,36,-74.140516,4.697157
36048,2016,Febrero,Japón,1,4,,5,-75.42726,6.170465
36049,2016,Febrero,Japón,0,1,,1,-73.181317,7.1280470000000005
36050,2016,Febrero,Jordania,0,1,,1,-74.140516,4.697157
36051,2016,Febrero,Kenia,0,2,,2,-74.140516,4.697157
36052,2016,Febrero,Letonia,2,3,,5,-74.140516,4.697157
36053,2016,Febrero,Lituania,2,3,,5,-74.140516,4.697157
36054,2016,Febrero,Líbano,2,0,,2,-74.77647900000001,10.886686
36055,2016,Febrero,Líbano,4,0,,4,-74.140516,4.697157
36056,2016,Febrero,Luxemburgo,5,1,,6,-74.140516,4.697157
36057,2016,Febrero,Luxemburgo,0,2,,2,-75.42726,6.170465
36058,2016,Febrero,Malasia,6,2,,8,-74.140516,4.697157
36059,2016,Febrero,Malí,0,1,,1,-74.140516,4.697157
36060,2016,Febrero,Malta,1,2,,3,-74.140516,4.697157
36061,2016,Febrero,Marruecos,0,4,,4,-74.765343,10.970933
36062,2016,Febrero,Marruecos,3,0,,3,-76.532004,3.451668
36063,2016,Febrero,Martinica/Departamento de Ultramar Francés,1,1,,2,-75.527794,10.406342
36064,2016,Febrero,Martinica/Departamento de Ultramar Francés,1,1,,2,-81.372937,13.338761300000002
36065,2016,Febrero,México,2,5,,7,-75.527794,10.406342
36066,2016,Febrero,México,5,5,,10,-75.516486,10.446304
36067,2016,Febrero,México,8,27,,35,-74.77647900000001,10.886686
36068,2016,Febrero,México,0,2,,2,-74.765343,10.970933
36069,2016,Febrero,México,1,6,,7,-81.70216500000001,12.5862
36070,2016,Febrero,México,39,131,,170,-76.532004,3.451668
36071,2016,Febrero,México,3885,7170,,11055,-74.140516,4.697157
36072,2016,Febrero,México,2,11,,13,-75.736374,4.815189
36073,2016,Febrero,México,278,844,,1122,-75.42726,6.170465
36074,2016,Febrero,México,3,6,,9,-73.181317,7.1280470000000005
36075,2016,Febrero,México,9,9,,18,-72.508188,7.927233
36076,2016,Febrero,Mónaco,0,1,,1,-74.140516,4.697157
36077,2016,Febrero,Mozambique,0,1,,1,-74.140516,4.697157
36078,2016,Febrero,Nicaragua,0,1,,1,-75.516486,10.446304
36079,2016,Febrero,Nicaragua,3,8,,11,-74.77647900000001,10.886686
36080,2016,Febrero,Nicaragua,0,1,,1,-81.70216500000001,12.5862
36081,2016,Febrero,Nicaragua,8,3,,11,-76.532004,3.451668
36082,2016,Febrero,Nicaragua,35,33,,68,-74.140516,4.697157
36083,2016,Febrero,Nicaragua,2,8,,10,-75.736374,4.815189
36084,2016,Febrero,Nicaragua,11,14,,25,-75.42726,6.170465
36085,2016,Febrero,Nicaragua,0,2,,2,-73.181317,7.1280470000000005
36086,2016,Febrero,Nicaragua,3,0,,3,-72.508188,7.927233
36087,2016,Febrero,Nigeria,0,1,,1,-74.140516,4.697157
36088,2016,Febrero,Níger,1,0,,1,-74.140516,4.697157
36089,2016,Febrero,Noruega,0,1,,1,-75.516486,10.446304
36090,2016,Febrero,Noruega,1,1,,2,-81.70216500000001,12.5862
36091,2016,Febrero,Noruega,3,4,,7,-76.532004,3.451668
36092,2016,Febrero,Noruega,17,25,,42,-74.140516,4.697157
36093,2016,Febrero,Noruega,1,0,,1,-75.736374,4.815189
36094,2016,Febrero,Nueva Zelanda,1,2,,3,-74.140516,4.697157
36095,2016,Febrero,Nueva Zelanda,0,1,,1,-75.42726,6.170465
36096,2016,Febrero,Papúa Nueva Guinea,0,1,,1,-74.140516,4.697157
36097,2016,Febrero,Pakistán,0,1,,1,-74.140516,4.697157
36098,2016,Febrero,Panamá,2084,1640,,3724,-75.527794,10.406342
36099,2016,Febrero,Panamá,3511,3365,,6876,-75.516486,10.446304
36100,2016,Febrero,Panamá,302,570,,872,-74.77647900000001,10.886686
36101,2016,Febrero,Panamá,2,10,,12,-74.765343,10.970933
36102,2016,Febrero,Panamá,1,1,,2,-74.213989,11.247722999999999
36103,2016,Febrero,Panamá,13,26,,39,-81.703935,12.574411099999999
36104,2016,Febrero,Panamá,428,370,,798,-81.70216500000001,12.5862
36105,2016,Febrero,Panamá,3,3,,6,-81.372937,13.338761300000002
36106,2016,Febrero,Panamá,318,468,,786,-76.532004,3.451668
36107,2016,Febrero,Panamá,0,12,,12,-77.061029,3.8844260000000004
36108,2016,Febrero,Panamá,102,143,,245,-75.76635300000001,4.45285
36109,2016,Febrero,Panamá,4807,6344,,11151,-74.140516,4.697157
36110,2016,Febrero,Panamá,48,76,,124,-75.736374,4.815189
36111,2016,Febrero,Panamá,2534,2968,,5502,-75.42726,6.170465
36112,2016,Febrero,Panamá,1,1,,2,-77.401154,6.222551999999999
36113,2016,Febrero,Panamá,0,2,,2,-77.762647,7.102626
36114,2016,Febrero,Panamá,12,19,,31,-73.181317,7.1280470000000005
36115,2016,Febrero,Panamá,46,47,,93,-72.508188,7.927233
36116,2016,Febrero,Panamá,122,163,,285,-77.35002,8.63337
36117,2016,Febrero,Paraguay,1,0,,1,-77.35600000000001,0.81488
36118,2016,Febrero,Paraguay,2,4,,6,-75.516486,10.446304
36119,2016,Febrero,Paraguay,0,5,,5,-74.77647900000001,10.886686
36120,2016,Febrero,Paraguay,84,53,,137,-81.70216500000001,12.5862
36121,2016,Febrero,Paraguay,10,6,,16,-76.532004,3.451668
36122,2016,Febrero,Paraguay,57,71,,128,-74.140516,4.697157
36123,2016,Febrero,Paraguay,2,0,,2,-75.736374,4.815189
36124,2016,Febrero,Paraguay,22,24,,46,-75.42726,6.170465
36125,2016,Febrero,Paraguay,0,1,,1,-72.508188,7.927233
36126,2016,Febrero,Perú,119,197,,316,-69.941498,4.191162
36127,2016,Febrero,Perú,2,7,,9,-69.94143100000001,4.214082
36128,2016,Febrero,Perú,1,0,,1,-74.78366,0.18595699999999998
36129,2016,Febrero,Perú,11,38,,49,-77.35600000000001,0.81488
36130,2016,Febrero,Perú,0,2,,2,-75.527794,10.406342
36131,2016,Febrero,Perú,19,11,,30,-75.516486,10.446304
36132,2016,Febrero,Perú,3,8,,11,-74.77647900000001,10.886686
36133,2016,Febrero,Perú,262,223,,485,-81.70216500000001,12.5862
36134,2016,Febrero,Perú,309,411,,720,-76.532004,3.451668
36135,2016,Febrero,Perú,0,1,,1,-77.061029,3.8844260000000004
36136,2016,Febrero,Perú,6380,8194,,14574,-74.140516,4.697157
36137,2016,Febrero,Perú,1,2,,3,-75.736374,4.815189
36138,2016,Febrero,Perú,471,740,,1211,-75.42726,6.170465
36139,2016,Febrero,Perú,2,1,,3,-73.181317,7.1280470000000005
36140,2016,Febrero,Polonia,1,1,,2,-75.516486,10.446304
36141,2016,Febrero,Polonia,3,0,,3,-76.532004,3.451668
36142,2016,Febrero,Polonia,35,52,,87,-74.140516,4.697157
36143,2016,Febrero,Polonia,1,2,,3,-75.42726,6.170465
36144,2016,Febrero,Portugal,1,9,,10,-76.532004,3.451668
36145,2016,Febrero,Portugal,372,586,,958,-74.140516,4.697157
36146,2016,Febrero,Portugal,0,1,,1,-75.736374,4.815189
36147,2016,Febrero,Portugal,0,1,,1,-75.42726,6.170465
36148,2016,Febrero,Polinesia Francesa/Colectividad de Ultramar Francesa,0,1,,1,-74.140516,4.697157
36149,2016,Febrero,Puerto Rico/Territorio de Estados Unidos,0,2,,2,-75.527794,10.406342
36150,2016,Febrero,Puerto Rico/Territorio de Estados Unidos,1,1,,2,-75.516486,10.446304
36151,2016,Febrero,Puerto Rico/Territorio de Estados Unidos,11,43,,54,-74.77647900000001,10.886686
36152,2016,Febrero,Puerto Rico/Territorio de Estados Unidos,2,0,,2,-81.70216500000001,12.5862
36153,2016,Febrero,Puerto Rico/Territorio de Estados Unidos,22,26,,48,-76.532004,3.451668
36154,2016,Febrero,Puerto Rico/Territorio de Estados Unidos,200,304,,504,-74.140516,4.697157
36155,2016,Febrero,Puerto Rico/Territorio de Estados Unidos,1,2,,3,-75.736374,4.815189
36156,2016,Febrero,Puerto Rico/Territorio de Estados Unidos,22,74,,96,-75.42726,6.170465
36157,2016,Febrero,Puerto Rico/Territorio de Estados Unidos,1,2,,3,-73.181317,7.1280470000000005
36158,2016,Febrero,Puerto Rico/Territorio de Estados Unidos,0,2,,2,-72.508188,7.927233
36159,2016,Febrero,Qatar,2,2,,4,-76.532004,3.451668
36160,2016,Febrero,Qatar,1,0,,1,-74.140516,4.697157
36161,2016,Febrero,Reino Unido de Gran Bretaña e Irlanda del Norte,0,3,,3,-75.516486,10.446304
36162,2016,Febrero,Reino Unido de Gran Bretaña e Irlanda del Norte,0,3,,3,-74.77647900000001,10.886686
36163,2016,Febrero,Reino Unido de Gran Bretaña e Irlanda del Norte,23,44,,67,-76.532004,3.451668
36164,2016,Febrero,Reino Unido de Gran Bretaña e Irlanda del Norte,790,1263,,2053,-74.140516,4.697157
36165,2016,Febrero,Reino Unido de Gran Bretaña e Irlanda del Norte,6,25,,31,-75.42726,6.170465
36166,2016,Febrero,Reino Unido de Gran Bretaña e Irlanda del Norte,0,1,,1,-73.181317,7.1280470000000005
36167,2016,Febrero,Federación de Rusia,1,1,,2,-75.516486,10.446304
36168,2016,Febrero,Federación de Rusia,1,0,,1,-81.70216500000001,12.5862
36169,2016,Febrero,Federación de Rusia,2,4,,6,-76.532004,3.451668
36170,2016,Febrero,Federación de Rusia,18,27,,45,-74.140516,4.697157
36171,2016,Febrero,Federación de Rusia,1,0,,1,-75.42726,6.170465
36172,2016,Febrero,Federación de Rusia,0,1,,1,-72.508188,7.927233
36173,2016,Febrero,República Dominicana,2,59,,61,-75.527794,10.406342
36174,2016,Febrero,República Dominicana,3,7,,10,-75.516486,10.446304
36175,2016,Febrero,República Dominicana,7,28,,35,-74.77647900000001,10.886686
36176,2016,Febrero,República Dominicana,24,48,,72,-76.532004,3.451668
36177,2016,Febrero,República Dominicana,585,852,,1437,-74.140516,4.697157
36178,2016,Febrero,República Dominicana,8,10,,18,-75.736374,4.815189
36179,2016,Febrero,República Dominicana,28,51,,79,-75.42726,6.170465
36180,2016,Febrero,República Dominicana,1,0,,1,-73.181317,7.1280470000000005
36181,2016,Febrero,República Dominicana,2,2,,4,-72.508188,7.927233
36182,2016,Febrero,Rumania,0,12,,12,-74.140516,4.697157
36183,2016,Febrero,Rumania,0,1,,1,-75.42726,6.170465
36184,2016,Febrero,San Marino,1,1,,2,-81.70216500000001,12.5862
36185,2016,Febrero,San  Vicente y las Granadinas,1,0,,1,-74.140516,4.697157
36186,2016,Febrero,Santa Lucia,0,2,,2,-74.140516,4.697157
36187,2016,Febrero,Serbia,0,1,,1,-76.532004,3.451668
36188,2016,Febrero,Serbia,0,2,,2,-74.140516,4.697157
36189,2016,Febrero,Singapur,2,5,,7,-74.140516,4.697157
36190,2016,Febrero,República Árabe Siria,0,1,,1,-74.140516,4.697157
36191,2016,Febrero,Sudáfrica,5,16,,21,-74.140516,4.697157
36192,2016,Febrero,Suecia,4,4,,8,-76.532004,3.451668
36193,2016,Febrero,Suecia,31,45,,76,-74.140516,4.697157
36194,2016,Febrero,Suecia,2,4,,6,-75.42726,6.170465
36195,2016,Febrero,Suiza,19,32,,51,-76.532004,3.451668
36196,2016,Febrero,Suiza,74,107,,181,-74.140516,4.697157
36197,2016,Febrero,Suiza,15,25,,40,-75.42726,6.170465
36198,2016,Febrero,Surinam,2,3,,5,-74.140516,4.697157
36199,2016,Febrero,Surinam,0,10,,10,-75.42726,6.170465
36200,2016,Febrero,Taiwán,3,3,,6,-74.140516,4.697157
36201,2016,Febrero,Taiwán,1,0,,1,-75.42726,6.170465
36202,2016,Febrero,Tailandia,5,1,,6,-74.140516,4.697157
36203,2016,Febrero,Togo,1,1,,2,-74.140516,4.697157
36204,2016,Febrero,Trinidad y Tobago,1,35,,36,-75.527794,10.406342
36205,2016,Febrero,Trinidad y Tobago,0,1,,1,-74.77647900000001,10.886686
36206,2016,Febrero,Trinidad y Tobago,0,1,,1,-74.765343,10.970933
36207,2016,Febrero,Trinidad y Tobago,4,9,,13,-76.532004,3.451668
36208,2016,Febrero,Trinidad y Tobago,1,13,,14,-74.140516,4.697157
36209,2016,Febrero,Trinidad y Tobago,1,3,,4,-75.736374,4.815189
36210,2016,Febrero,Trinidad y Tobago,0,3,,3,-75.42726,6.170465
36211,2016,Febrero,Trinidad y Tobago,2,0,,2,-73.181317,7.1280470000000005
36212,2016,Febrero,Túnez,0,1,,1,-74.140516,4.697157
36213,2016,Febrero,Turquía,1,0,,1,-76.532004,3.451668
36214,2016,Febrero,Turquía,6,13,,19,-74.140516,4.697157
36215,2016,Febrero,Turquía,1,1,,2,-75.42726,6.170465
36216,2016,Febrero,Ucrania,0,1,,1,-76.532004,3.451668
36217,2016,Febrero,Ucrania,1,3,,4,-74.140516,4.697157
36218,2016,Febrero,Uganda,3,0,,3,-74.140516,4.697157
36219,2016,Febrero,Uruguay,0,2,,2,-77.35600000000001,0.81488
36220,2016,Febrero,Uruguay,5,7,,12,-75.516486,10.446304
36221,2016,Febrero,Uruguay,28,16,,44,-81.70216500000001,12.5862
36222,2016,Febrero,Uruguay,7,26,,33,-76.532004,3.451668
36223,2016,Febrero,Uruguay,61,81,,142,-74.140516,4.697157
36224,2016,Febrero,Uruguay,19,41,,60,-75.42726,6.170465
36225,2016,Febrero,Uzbekistán,0,1,,1,-74.140516,4.697157
36226,2016,Febrero,Venezuela,0,7,,7,-75.527794,10.406342
36227,2016,Febrero,Venezuela,4,17,,21,-75.516486,10.446304
36228,2016,Febrero,Venezuela,16,65,,81,-74.77647900000001,10.886686
36229,2016,Febrero,Venezuela,0,1,,1,-74.765343,10.970933
36230,2016,Febrero,Venezuela,3,4,,7,-74.213989,11.247722999999999
36231,2016,Febrero,Venezuela,279,456,,735,-72.129595,11.360028999999999
36232,2016,Febrero,Venezuela,1,3,,4,-81.70216500000001,12.5862
36233,2016,Febrero,Venezuela,14,28,,42,-76.532004,3.451668
36234,2016,Febrero,Venezuela,48,53,,101,-67.927521,3.866713
36235,2016,Febrero,Venezuela,2975,3669,,6644,-74.140516,4.697157
36236,2016,Febrero,Venezuela,0,1,,1,-75.736374,4.815189
36237,2016,Febrero,Venezuela,541,599,,1140,-75.42726,6.170465
36238,2016,Febrero,Venezuela,64,101,,165,-67.48402800000001,6.185536
36239,2016,Febrero,Venezuela,36,45,,81,-70.74025300000001,7.088728999999999
36240,2016,Febrero,Venezuela,1,1,,2,-73.181317,7.1280470000000005
36241,2016,Febrero,Venezuela,1865,2498,,4363,-72.453013,7.819
36242,2016,Febrero,Venezuela,148,187,,335,-72.508188,7.927233
36243,2016,Febrero,Vietnam,0,1,,1,-76.532004,3.451668
36244,2016,Febrero,Islas Vírgenes Británicas/Territorio Británico de Ultramar,7,31,,38,-75.527794,10.406342
36245,2016,Febrero,Islas Vírgenes Británicas/Territorio Británico de Ultramar,1,1,,2,-74.140516,4.697157
36246,2016,Febrero,Islas Vírgenes Estadounidenses/Territorio de Estados Unidos,0,1,,1,-75.527794,10.406342
36247,2016,Febrero,Islas Vírgenes Estadounidenses/Territorio de Estados Unidos,0,1,,1,-75.42726,6.170465
36248,2016,Marzo,Afganistán,1,3,,4,-74.140516,4.697157
36249,2016,Marzo,Albania,1,0,,1,-76.532004,3.451668
36250,2016,Marzo,Albania,0,2,,2,-74.140516,4.697157
36251,2016,Marzo,Alemania,0,2,,2,-75.527794,10.406342
36252,2016,Marzo,Alemania,1,1,,2,-75.516486,10.446304
36253,2016,Marzo,Alemania,6,3,,9,-74.77647900000001,10.886686
36254,2016,Marzo,Alemania,4,2,,6,-81.70216500000001,12.5862
36255,2016,Marzo,Alemania,45,74,,119,-76.532004,3.451668
36256,2016,Marzo,Alemania,1479,2351,,3830,-74.140516,4.697157
36257,2016,Marzo,Alemania,2,2,,4,-75.736374,4.815189
36258,2016,Marzo,Alemania,23,33,,56,-75.42726,6.170465
36259,2016,Marzo,Alemania,0,1,,1,-73.181317,7.1280470000000005
36260,2016,Marzo,Alemania,1,0,,1,-72.508188,7.927233
36261,2016,Marzo,Antigua y Barbuda,0,1,,1,-75.527794,10.406342
36262,2016,Marzo,Antigua y Barbuda,1,3,,4,-74.140516,4.697157
36263,2016,Marzo,Países Bajos,5,12,,17,-75.527794,10.406342
36264,2016,Marzo,Países Bajos,3,3,,6,-75.516486,10.446304
36265,2016,Marzo,Países Bajos,60,71,,131,-74.77647900000001,10.886686
36266,2016,Marzo,Países Bajos,2,1,,3,-74.765343,10.970933
36267,2016,Marzo,Países Bajos,4,1,,5,-74.213989,11.247722999999999
36268,2016,Marzo,Países Bajos,0,1,,1,-81.70216500000001,12.5862
36269,2016,Marzo,Países Bajos,86,157,,243,-76.532004,3.451668
36270,2016,Marzo,Países Bajos,866,1253,,2119,-74.140516,4.697157
36271,2016,Marzo,Países Bajos,3,2,,5,-75.736374,4.815189
36272,2016,Marzo,Países Bajos,207,226,,433,-75.42726,6.170465
36273,2016,Marzo,Países Bajos,0,1,,1,-73.181317,7.1280470000000005
36274,2016,Marzo,Arabia Saudita,0,2,,2,-74.140516,4.697157
36275,2016,Marzo,Arabia Saudita,0,1,,1,-75.42726,6.170465
36276,2016,Marzo,Argelia,3,4,,7,-74.140516,4.697157
36277,2016,Marzo,Argentina,5,22,,27,-77.35600000000001,0.81488
36278,2016,Marzo,Argentina,51,37,,88,-75.516486,10.446304
36279,2016,Marzo,Argentina,12,12,,24,-74.77647900000001,10.886686
36280,2016,Marzo,Argentina,293,200,,493,-81.70216500000001,12.5862
36281,2016,Marzo,Argentina,87,217,,304,-76.532004,3.451668
36282,2016,Marzo,Argentina,2485,3123,,5608,-74.140516,4.697157
36283,2016,Marzo,Argentina,0,2,,2,-75.736374,4.815189
36284,2016,Marzo,Argentina,73,138,,211,-75.42726,6.170465
36285,2016,Marzo,Argentina,0,4,,4,-73.181317,7.1280470000000005
36286,2016,Marzo,Argentina,2,1,,3,-72.508188,7.927233
36287,2016,Marzo,Aruba,14,34,,48,-75.527794,10.406342
36288,2016,Marzo,Aruba,4,12,,16,-74.77647900000001,10.886686
36289,2016,Marzo,Aruba,2,10,,12,-74.213989,11.247722999999999
36290,2016,Marzo,Aruba,7,11,,18,-76.532004,3.451668
36291,2016,Marzo,Aruba,724,790,,1514,-74.140516,4.697157
36292,2016,Marzo,Aruba,74,69,,143,-75.42726,6.170465
36293,2016,Marzo,Aruba,9,5,,14,-73.181317,7.1280470000000005
36294,2016,Marzo,Australia,0,2,,2,-75.516486,10.446304
36295,2016,Marzo,Australia,0,4,,4,-76.532004,3.451668
36296,2016,Marzo,Australia,16,37,,53,-74.140516,4.697157
36297,2016,Marzo,Australia,1,1,,2,-75.736374,4.815189
36298,2016,Marzo,Australia,6,20,,26,-75.42726,6.170465
36299,2016,Marzo,Austria,1,2,,3,-76.532004,3.451668
36300,2016,Marzo,Austria,16,39,,55,-74.140516,4.697157
36301,2016,Marzo,Austria,5,9,,14,-75.42726,6.170465
36302,2016,Marzo,Azerbaiyán,1,2,,3,-74.140516,4.697157
36303,2016,Marzo,Bahamas,0,1,,1,-75.527794,10.406342
36304,2016,Marzo,Bahamas,1,1,,2,-76.532004,3.451668
36305,2016,Marzo,Bahamas,2,4,,6,-74.140516,4.697157
36306,2016,Marzo,Bahamas,1,0,,1,-75.42726,6.170465
36307,2016,Marzo,Bahréin,2,0,,2,-75.516486,10.446304
36308,2016,Marzo,Bahréin,0,1,,1,-74.140516,4.697157
36309,2016,Marzo,Bangladesh,0,1,,1,-74.140516,4.697157
36310,2016,Marzo,Barbados,0,1,,1,-76.532004,3.451668
36311,2016,Marzo,Barbados,42,57,,99,-74.140516,4.697157
36312,2016,Marzo,Barbados,1,0,,1,-75.42726,6.170465
36313,2016,Marzo,República de Belarús,0,1,,1,-74.140516,4.697157
36314,2016,Marzo,República de Belarús,1,0,,1,-75.42726,6.170465
36315,2016,Marzo,República de Belarús,0,1,,1,-72.453013,7.819
36316,2016,Marzo,Bélgica,1,0,,1,-75.516486,10.446304
36317,2016,Marzo,Bélgica,8,11,,19,-76.532004,3.451668
36318,2016,Marzo,Bélgica,24,36,,60,-74.140516,4.697157
36319,2016,Marzo,Bélgica,10,15,,25,-75.42726,6.170465
36320,2016,Marzo,Belice,9,13,,22,-75.516486,10.446304
36321,2016,Marzo,Belice,3,2,,5,-74.140516,4.697157
36322,2016,Marzo,Belice,1,1,,2,-75.42726,6.170465
36323,2016,Marzo,Benín,1,0,,1,-76.532004,3.451668
36324,2016,Marzo,Bolivia,2,0,,2,-77.35600000000001,0.81488
36325,2016,Marzo,Bolivia,0,9,,9,-74.77647900000001,10.886686
36326,2016,Marzo,Bolivia,12,9,,21,-81.70216500000001,12.5862
36327,2016,Marzo,Bolivia,29,33,,62,-76.532004,3.451668
36328,2016,Marzo,Bolivia,443,552,,995,-74.140516,4.697157
36329,2016,Marzo,Bolivia,0,4,,4,-75.736374,4.815189
36330,2016,Marzo,Bolivia,45,40,,85,-75.42726,6.170465
36331,2016,Marzo,Bolivia,1,1,,2,-73.181317,7.1280470000000005
36332,2016,Marzo,Bosnia y Herzegovina,1,1,,2,-74.140516,4.697157
36333,2016,Marzo,Brasil,118,159,,277,-69.941498,4.191162
36334,2016,Marzo,Brasil,5,8,,13,-69.94143100000001,4.214082
36335,2016,Marzo,Brasil,4,3,,7,-77.35600000000001,0.81488
36336,2016,Marzo,Brasil,91,45,,136,-75.516486,10.446304
36337,2016,Marzo,Brasil,0,7,,7,-74.77647900000001,10.886686
36338,2016,Marzo,Brasil,365,305,,670,-81.70216500000001,12.5862
36339,2016,Marzo,Brasil,74,94,,168,-76.532004,3.451668
36340,2016,Marzo,Brasil,0,1,,1,-67.927521,3.866713
36341,2016,Marzo,Brasil,4582,5766,,10348,-74.140516,4.697157
36342,2016,Marzo,Brasil,1,3,,4,-75.736374,4.815189
36343,2016,Marzo,Brasil,144,176,,320,-75.42726,6.170465
36344,2016,Marzo,Bulgaria,1,0,,1,-76.532004,3.451668
36345,2016,Marzo,Bulgaria,1,1,,2,-74.140516,4.697157
36346,2016,Marzo,Bulgaria,4,2,,6,-75.42726,6.170465
36347,2016,Marzo,Cabo Verde,0,1,,1,-74.140516,4.697157
36348,2016,Marzo,Islas Caimán/Territorio Británico de Ultramar,0,8,,8,-75.516486,10.446304
36349,2016,Marzo,Islas Caimán/Territorio Británico de Ultramar,0,3,,3,-74.77647900000001,10.886686
36350,2016,Marzo,Islas Caimán/Territorio Británico de Ultramar,1,5,,6,-81.372937,13.338761300000002
36351,2016,Marzo,Islas Caimán/Territorio Británico de Ultramar,1,15,,16,-74.140516,4.697157
36352,2016,Marzo,Islas Caimán/Territorio Británico de Ultramar,0,5,,5,-75.42726,6.170465
36353,2016,Marzo,Camerún,1,0,,1,-74.140516,4.697157
36354,2016,Marzo,Canadá,225,207,,432,-75.516486,10.446304
36355,2016,Marzo,Canadá,5,11,,16,-74.77647900000001,10.886686
36356,2016,Marzo,Canadá,429,359,,788,-81.70216500000001,12.5862
36357,2016,Marzo,Canadá,26,36,,62,-76.532004,3.451668
36358,2016,Marzo,Canadá,579,901,,1480,-74.140516,4.697157
36359,2016,Marzo,Canadá,4,2,,6,-75.736374,4.815189
36360,2016,Marzo,Canadá,81,135,,216,-75.42726,6.170465
36361,2016,Marzo,Canadá,0,2,,2,-73.181317,7.1280470000000005
36362,2016,Marzo,Canadá,2,2,,4,-72.508188,7.927233
36363,2016,Marzo,España,0,1,,1,-75.516486,10.446304
36364,2016,Marzo,España,4,2,,6,-74.77647900000001,10.886686
36365,2016,Marzo,España,0,2,,2,-74.765343,10.970933
36366,2016,Marzo,España,405,639,,1044,-76.532004,3.451668
36367,2016,Marzo,España,2610,4817,,7427,-74.140516,4.697157
36368,2016,Marzo,España,2,2,,4,-75.736374,4.815189
36369,2016,Marzo,España,280,502,,782,-75.42726,6.170465
36370,2016,Marzo,España,0,5,,5,-73.181317,7.1280470000000005
36371,2016,Marzo,España,0,1,,1,-72.508188,7.927233
36372,2016,Marzo,República Del Congo,0,1,,1,-74.140516,4.697157
36373,2016,Marzo,República de Corea,1,0,,1,-75.516486,10.446304
36374,2016,Marzo,República de Corea,2,0,,2,-76.532004,3.451668
36375,2016,Marzo,República de Corea,3,14,,17,-74.140516,4.697157
36376,2016,Marzo,República de Corea,0,6,,6,-75.42726,6.170465
36377,2016,Marzo,Costa de Marfil,0,1,,1,-76.532004,3.451668
36378,2016,Marzo,Costa de Marfil,1,6,,7,-74.140516,4.697157
36379,2016,Marzo,Costa Rica,4,4,,8,-75.527794,10.406342
36380,2016,Marzo,Costa Rica,9,11,,20,-75.516486,10.446304
36381,2016,Marzo,Costa Rica,10,22,,32,-74.77647900000001,10.886686
36382,2016,Marzo,Costa Rica,0,1,,1,-74.213989,11.247722999999999
36383,2016,Marzo,Costa Rica,134,109,,243,-81.70216500000001,12.5862
36384,2016,Marzo,Costa Rica,1,2,,3,-81.372937,13.338761300000002
36385,2016,Marzo,Costa Rica,25,33,,58,-76.532004,3.451668
36386,2016,Marzo,Costa Rica,971,1505,,2476,-74.140516,4.697157
36387,2016,Marzo,Costa Rica,6,9,,15,-75.736374,4.815189
36388,2016,Marzo,Costa Rica,80,109,,189,-75.42726,6.170465
36389,2016,Marzo,Costa Rica,0,5,,5,-72.508188,7.927233
36390,2016,Marzo,Croacia,2,2,,4,-75.516486,10.446304
36391,2016,Marzo,Croacia,2,1,,3,-74.140516,4.697157
36392,2016,Marzo,Croacia,0,1,,1,-75.42726,6.170465
36393,2016,Marzo,Cuba,0,1,,1,-75.527794,10.406342
36394,2016,Marzo,Cuba,1,3,,4,-75.516486,10.446304
36395,2016,Marzo,Cuba,4,6,,10,-74.77647900000001,10.886686
36396,2016,Marzo,Cuba,0,1,,1,-74.765343,10.970933
36397,2016,Marzo,Cuba,1,0,,1,-81.70216500000001,12.5862
36398,2016,Marzo,Cuba,11,12,,23,-76.532004,3.451668
36399,2016,Marzo,Cuba,319,533,,852,-74.140516,4.697157
36400,2016,Marzo,Cuba,1,1,,2,-75.736374,4.815189
36401,2016,Marzo,Cuba,11,18,,29,-75.42726,6.170465
36402,2016,Marzo,Cuba,3,2,,5,-73.181317,7.1280470000000005
36403,2016,Marzo,Cuba,1,2,,3,-72.508188,7.927233
36404,2016,Marzo,Curazao,0,1,,1,-74.140516,4.697157
36405,2016,Marzo,República Checa,1,0,,1,-76.532004,3.451668
36406,2016,Marzo,República Checa,9,11,,20,-74.140516,4.697157
36407,2016,Marzo,República Checa,1,0,,1,-75.42726,6.170465
36408,2016,Marzo,República Checa,0,2,,2,-72.508188,7.927233
36409,2016,Marzo,Chile,4,7,,11,-77.35600000000001,0.81488
36410,2016,Marzo,Chile,15,11,,26,-75.516486,10.446304
36411,2016,Marzo,Chile,1,5,,6,-74.77647900000001,10.886686
36412,2016,Marzo,Chile,41,31,,72,-81.70216500000001,12.5862
36413,2016,Marzo,Chile,36,51,,87,-76.532004,3.451668
36414,2016,Marzo,Chile,4022,5352,,9374,-74.140516,4.697157
36415,2016,Marzo,Chile,6,5,,11,-75.736374,4.815189
36416,2016,Marzo,Chile,30,48,,78,-75.42726,6.170465
36417,2016,Marzo,Chile,3,2,,5,-72.508188,7.927233
36418,2016,Marzo,China,0,1,,1,-76.532004,3.451668
36419,2016,Marzo,China,24,79,,103,-74.140516,4.697157
36420,2016,Marzo,China,1,2,,3,-75.42726,6.170465
36421,2016,Marzo,Dinamarca,2,3,,5,-76.532004,3.451668
36422,2016,Marzo,Dinamarca,21,29,,50,-74.140516,4.697157
36423,2016,Marzo,Dinamarca,2,1,,3,-75.42726,6.170465
36424,2016,Marzo,Dominica,2,0,,2,-74.140516,4.697157
36425,2016,Marzo,Dominica,0,1,,1,-75.42726,6.170465
36426,2016,Marzo,Ecuador,98,241,,339,-76.876446,0.33002
36427,2016,Marzo,Ecuador,4085,5715,,9800,-77.35600000000001,0.81488
36428,2016,Marzo,Ecuador,49,66,,115,-78.802679,18.00143
36429,2016,Marzo,Ecuador,0,1,,1,-75.527794,10.406342
36430,2016,Marzo,Ecuador,99,231,,330,-75.516486,10.446304
36431,2016,Marzo,Ecuador,47,191,,238,-74.77647900000001,10.886686
36432,2016,Marzo,Ecuador,1,2,,3,-81.70216500000001,12.5862
36433,2016,Marzo,Ecuador,406,456,,862,-76.532004,3.451668
36434,2016,Marzo,Ecuador,0,2,,2,-77.061029,3.8844260000000004
36435,2016,Marzo,Ecuador,3818,5762,,9580,-74.140516,4.697157
36436,2016,Marzo,Ecuador,3,2,,5,-75.736374,4.815189
36437,2016,Marzo,Ecuador,28,44,,72,-75.42726,6.170465
36438,2016,Marzo,Ecuador,5,3,,8,-73.181317,7.1280470000000005
36439,2016,Marzo,Ecuador,1,3,,4,-72.508188,7.927233
36441,2016,Marzo,Egipto,0,3,,3,-74.140516,4.697157
36442,2016,Marzo,Egipto,0,2,,2,-75.42726,6.170465
36443,2016,Marzo,El Salvador,33,21,,54,-75.516486,10.446304
36444,2016,Marzo,El Salvador,0,1,,1,-74.77647900000001,10.886686
36445,2016,Marzo,El Salvador,26,29,,55,-81.70216500000001,12.5862
36446,2016,Marzo,El Salvador,132,179,,311,-76.532004,3.451668
36447,2016,Marzo,El Salvador,1111,1508,,2619,-74.140516,4.697157
36448,2016,Marzo,El Salvador,0,1,,1,-75.736374,4.815189
36449,2016,Marzo,El Salvador,183,252,,435,-75.42726,6.170465
36450,2016,Marzo,Emiratos Árabes,2,2,,4,-74.140516,4.697157
36451,2016,Marzo,Emiratos Árabes,0,1,,1,-75.42726,6.170465
36452,2016,Marzo,Eritrea,0,1,,1,-74.140516,4.697157
36453,2016,Marzo,Eslovaquia,4,6,,10,-74.140516,4.697157
36454,2016,Marzo,Eslovenia,0,3,,3,-74.140516,4.697157
36455,2016,Marzo,Eslovenia,0,1,,1,-75.42726,6.170465
36456,2016,Marzo,Estados Unidos de América,1,40,,41,-75.527794,10.406342
36457,2016,Marzo,Estados Unidos de América,3854,5200,,9054,-75.516486,10.446304
36458,2016,Marzo,Estados Unidos de América,699,1092,,1791,-74.77647900000001,10.886686
36459,2016,Marzo,Estados Unidos de América,0,6,,6,-74.765343,10.970933
36460,2016,Marzo,Estados Unidos de América,0,4,,4,-74.232675,11.117206
36461,2016,Marzo,Estados Unidos de América,1,17,,18,-74.213989,11.247722999999999
36462,2016,Marzo,Estados Unidos de América,21,25,,46,-81.70216500000001,12.5862
36463,2016,Marzo,Estados Unidos de América,1084,1379,,2463,-76.532004,3.451668
36464,2016,Marzo,Estados Unidos de América,0,6,,6,-77.061029,3.8844260000000004
36465,2016,Marzo,Estados Unidos de América,115,216,,331,-75.76635300000001,4.45285
36466,2016,Marzo,Estados Unidos de América,9730,16052,,25782,-74.140516,4.697157
36467,2016,Marzo,Estados Unidos de América,136,190,,326,-75.736374,4.815189
36468,2016,Marzo,Estados Unidos de América,2870,6066,,8936,-75.42726,6.170465
36469,2016,Marzo,Estados Unidos de América,21,38,,59,-73.181317,7.1280470000000005
36470,2016,Marzo,Estados Unidos de América,15,28,,43,-72.508188,7.927233
36471,2016,Marzo,Estados Unidos de América,1,21,,22,-75.68164200000001,9.402597
36472,2016,Marzo,Estonia,0,1,,1,-74.140516,4.697157
36473,2016,Marzo,Estonia,1,0,,1,-75.42726,6.170465
36474,2016,Marzo,Etiopia,0,1,,1,-74.140516,4.697157
36475,2016,Marzo,Filipinas,0,2,,2,-74.77647900000001,10.886686
36476,2016,Marzo,Filipinas,1,6,,7,-76.532004,3.451668
36477,2016,Marzo,Filipinas,0,1,,1,-77.061029,3.8844260000000004
36478,2016,Marzo,Filipinas,2,11,,13,-74.140516,4.697157
36479,2016,Marzo,Filipinas,1,0,,1,-75.42726,6.170465
36480,2016,Marzo,Finlandia,0,2,,2,-74.77647900000001,10.886686
36481,2016,Marzo,Finlandia,0,1,,1,-76.532004,3.451668
36482,2016,Marzo,Finlandia,9,15,,24,-74.140516,4.697157
36483,2016,Marzo,Finlandia,0,3,,3,-75.42726,6.170465
36484,2016,Marzo,Francia,0,3,,3,-75.527794,10.406342
36485,2016,Marzo,Francia,1,1,,2,-75.516486,10.446304
36486,2016,Marzo,Francia,1,1,,2,-74.77647900000001,10.886686
36487,2016,Marzo,Francia,14,28,,42,-76.532004,3.451668
36488,2016,Marzo,Francia,1425,2256,,3681,-74.140516,4.697157
36489,2016,Marzo,Francia,17,28,,45,-75.42726,6.170465
36490,2016,Marzo,Francia,0,1,,1,-73.181317,7.1280470000000005
36491,2016,Marzo,Ghana,0,3,,3,-74.140516,4.697157
36492,2016,Marzo,Gibraltar/Territorio Británico de Ultramar,3,5,,8,-77.35600000000001,0.81488
36493,2016,Marzo,Gibraltar/Territorio Británico de Ultramar,0,4,,4,-75.527794,10.406342
36494,2016,Marzo,Grecia,0,1,,1,-76.532004,3.451668
36495,2016,Marzo,Grecia,3,7,,10,-74.140516,4.697157
36496,2016,Marzo,Guatemala,2,8,,10,-75.527794,10.406342
36497,2016,Marzo,Guatemala,6,6,,12,-75.516486,10.446304
36498,2016,Marzo,Guatemala,17,6,,23,-74.77647900000001,10.886686
36499,2016,Marzo,Guatemala,30,40,,70,-81.70216500000001,12.5862
36500,2016,Marzo,Guatemala,19,37,,56,-76.532004,3.451668
36501,2016,Marzo,Guatemala,425,615,,1040,-74.140516,4.697157
36502,2016,Marzo,Guatemala,6,4,,10,-75.736374,4.815189
36503,2016,Marzo,Guatemala,56,83,,139,-75.42726,6.170465
36504,2016,Marzo,Guatemala,3,0,,3,-73.181317,7.1280470000000005
36505,2016,Marzo,Guatemala,3,0,,3,-72.508188,7.927233
36506,2016,Marzo,Guyana,1,6,,7,-75.527794,10.406342
36507,2016,Marzo,Guyana,0,3,,3,-74.140516,4.697157
36508,2016,Marzo,Guyana,0,1,,1,-75.42726,6.170465
36509,2016,Marzo,Guinea,0,1,,1,-74.140516,4.697157
36510,2016,Marzo,Guadalupe/Territorio Francés,2,3,,5,-75.516486,10.446304
36511,2016,Marzo,Guadalupe/Territorio Francés,2,3,,5,-74.140516,4.697157
36512,2016,Marzo,Guayana Francesa/Departamento de Ultramar Francés,0,8,,8,-75.527794,10.406342
36513,2016,Marzo,Haití,3,7,,10,-75.527794,10.406342
36514,2016,Marzo,Haití,3,4,,7,-74.140516,4.697157
36515,2016,Marzo,Honduras,0,1,,1,-75.527794,10.406342
36516,2016,Marzo,Honduras,28,29,,57,-75.516486,10.446304
36517,2016,Marzo,Honduras,1,0,,1,-81.70216500000001,12.5862
36518,2016,Marzo,Honduras,5,7,,12,-81.372937,13.338761300000002
36519,2016,Marzo,Honduras,25,19,,44,-76.532004,3.451668
36520,2016,Marzo,Honduras,43,58,,101,-74.140516,4.697157
36521,2016,Marzo,Honduras,0,1,,1,-75.736374,4.815189
36522,2016,Marzo,Honduras,47,40,,87,-75.42726,6.170465
36523,2016,Marzo,Honduras,0,2,,2,-72.508188,7.927233
36524,2016,Marzo,Hong Kong,1,3,,4,-74.140516,4.697157
36525,2016,Marzo,Hungría,0,1,,1,-76.532004,3.451668
36526,2016,Marzo,Hungría,5,5,,10,-74.140516,4.697157
36527,2016,Marzo,Hungría,0,1,,1,-75.42726,6.170465
36528,2016,Marzo,India,0,1,,1,-74.77647900000001,10.886686
36529,2016,Marzo,India,0,3,,3,-76.532004,3.451668
36530,2016,Marzo,India,9,21,,30,-74.140516,4.697157
36531,2016,Marzo,India,1,7,,8,-75.42726,6.170465
36532,2016,Marzo,Indonesia,1,1,,2,-76.532004,3.451668
36533,2016,Marzo,Indonesia,3,5,,8,-74.140516,4.697157
36534,2016,Marzo,Indonesia,0,1,,1,-75.42726,6.170465
36535,2016,Marzo,Irán,0,2,,2,-74.140516,4.697157
36536,2016,Marzo,Irán,0,1,,1,-75.42726,6.170465
36537,2016,Marzo,República de Irlanda,0,2,,2,-76.532004,3.451668
36538,2016,Marzo,República de Irlanda,15,20,,35,-74.140516,4.697157
36539,2016,Marzo,República de Irlanda,2,2,,4,-75.42726,6.170465
36540,2016,Marzo,Islandia,0,1,,1,-74.140516,4.697157
36541,2016,Marzo,Israel,0,1,,1,-74.77647900000001,10.886686
36542,2016,Marzo,Israel,3,0,,3,-81.70216500000001,12.5862
36543,2016,Marzo,Israel,2,1,,3,-76.532004,3.451668
36544,2016,Marzo,Israel,18,56,,74,-74.140516,4.697157
36545,2016,Marzo,Israel,2,1,,3,-75.42726,6.170465
36546,2016,Marzo,Italia,1,1,,2,-75.516486,10.446304
36547,2016,Marzo,Italia,1,3,,4,-74.77647900000001,10.886686
36548,2016,Marzo,Italia,135,95,,230,-81.70216500000001,12.5862
36549,2016,Marzo,Italia,10,39,,49,-76.532004,3.451668
36550,2016,Marzo,Italia,80,217,,297,-74.140516,4.697157
36551,2016,Marzo,Italia,0,2,,2,-75.736374,4.815189
36552,2016,Marzo,Italia,9,22,,31,-75.42726,6.170465
36553,2016,Marzo,Italia,1,1,,2,-73.181317,7.1280470000000005
36554,2016,Marzo,Italia,0,1,,1,-72.508188,7.927233
36555,2016,Marzo,Jamaica,3,8,,11,-75.527794,10.406342
36556,2016,Marzo,Jamaica,0,1,,1,-74.77647900000001,10.886686
36557,2016,Marzo,Jamaica,0,2,,2,-74.765343,10.970933
36558,2016,Marzo,Jamaica,2,1,,3,-76.532004,3.451668
36559,2016,Marzo,Jamaica,3,3,,6,-74.140516,4.697157
36560,2016,Marzo,Jamaica,0,1,,1,-75.736374,4.815189
36561,2016,Marzo,Japón,2,3,,5,-76.532004,3.451668
36562,2016,Marzo,Japón,13,14,,27,-74.140516,4.697157
36563,2016,Marzo,Japón,0,1,,1,-75.736374,4.815189
36564,2016,Marzo,Japón,2,5,,7,-75.42726,6.170465
36565,2016,Marzo,Jordania,1,3,,4,-74.140516,4.697157
36566,2016,Marzo,Kenia,0,1,,1,-74.140516,4.697157
36567,2016,Marzo,Kenia,0,1,,1,-75.42726,6.170465
36568,2016,Marzo,Lituania,0,1,,1,-76.532004,3.451668
36569,2016,Marzo,Lituania,5,5,,10,-74.140516,4.697157
36570,2016,Marzo,Líbano,2,4,,6,-74.140516,4.697157
36571,2016,Marzo,Luxemburgo,0,6,,6,-74.140516,4.697157
36572,2016,Marzo,Luxemburgo,2,2,,4,-75.42726,6.170465
36573,2016,Marzo,Macao,0,1,,1,-74.140516,4.697157
36574,2016,Marzo,Madagascar,1,0,,1,-74.140516,4.697157
36575,2016,Marzo,Malasia,1,3,,4,-74.140516,4.697157
36576,2016,Marzo,Malta,0,2,,2,-74.140516,4.697157
36577,2016,Marzo,Marruecos,0,1,,1,-76.532004,3.451668
36578,2016,Marzo,Marruecos,0,1,,1,-74.140516,4.697157
36579,2016,Marzo,Marruecos,1,2,,3,-75.42726,6.170465
36580,2016,Marzo,Mauricio,0,1,,1,-75.527794,10.406342
36581,2016,Marzo,Mauricio,0,3,,3,-74.140516,4.697157
36582,2016,Marzo,Martinica/Departamento de Ultramar Francés,2,3,,5,-75.527794,10.406342
36583,2016,Marzo,Martinica/Departamento de Ultramar Francés,0,3,,3,-75.516486,10.446304
36584,2016,Marzo,México,0,8,,8,-75.527794,10.406342
36585,2016,Marzo,México,11,30,,41,-75.516486,10.446304
36586,2016,Marzo,México,16,25,,41,-74.77647900000001,10.886686
36587,2016,Marzo,México,0,1,,1,-74.765343,10.970933
36588,2016,Marzo,México,4,8,,12,-81.70216500000001,12.5862
36589,2016,Marzo,México,72,127,,199,-76.532004,3.451668
36590,2016,Marzo,México,0,1,,1,-77.061029,3.8844260000000004
36591,2016,Marzo,México,5186,8424,,13610,-74.140516,4.697157
36592,2016,Marzo,México,12,14,,26,-75.736374,4.815189
36593,2016,Marzo,México,573,1088,,1661,-75.42726,6.170465
36594,2016,Marzo,México,0,9,,9,-73.181317,7.1280470000000005
36595,2016,Marzo,México,14,4,,18,-72.508188,7.927233
36596,2016,Marzo,Mongolia,0,1,,1,-74.140516,4.697157
36597,2016,Marzo,Montenegro,0,2,,2,-74.140516,4.697157
36598,2016,Marzo,Nicaragua,3,2,,5,-75.516486,10.446304
36599,2016,Marzo,Nicaragua,1,0,,1,-74.77647900000001,10.886686
36600,2016,Marzo,Nicaragua,0,3,,3,-81.70216500000001,12.5862
36601,2016,Marzo,Nicaragua,6,10,,16,-76.532004,3.451668
36602,2016,Marzo,Nicaragua,35,31,,66,-74.140516,4.697157
36603,2016,Marzo,Nicaragua,6,3,,9,-75.736374,4.815189
36604,2016,Marzo,Nicaragua,22,12,,34,-75.42726,6.170465
36605,2016,Marzo,Nicaragua,1,0,,1,-73.181317,7.1280470000000005
36606,2016,Marzo,Nigeria,0,1,,1,-74.140516,4.697157
36607,2016,Marzo,Noruega,1,2,,3,-74.77647900000001,10.886686
36608,2016,Marzo,Noruega,2,5,,7,-76.532004,3.451668
36609,2016,Marzo,Noruega,22,22,,44,-74.140516,4.697157
36610,2016,Marzo,Noruega,0,6,,6,-75.42726,6.170465
36611,2016,Marzo,Nueva Zelanda,2,6,,8,-74.140516,4.697157
36612,2016,Marzo,Nueva Zelanda,0,2,,2,-75.42726,6.170465
36613,2016,Marzo,Pakistán,0,1,,1,-74.140516,4.697157
36614,2016,Marzo,Pakistán,0,1,,1,-75.42726,6.170465
36615,2016,Marzo,Panamá,1593,1298,,2891,-75.527794,10.406342
36616,2016,Marzo,Panamá,3550,3376,,6926,-75.516486,10.446304
36617,2016,Marzo,Panamá,273,473,,746,-74.77647900000001,10.886686
36618,2016,Marzo,Panamá,0,10,,10,-74.765343,10.970933
36619,2016,Marzo,Panamá,26,38,,64,-81.703935,12.574411099999999
36620,2016,Marzo,Panamá,382,320,,702,-81.70216500000001,12.5862
36621,2016,Marzo,Panamá,3,12,,15,-81.372937,13.338761300000002
36622,2016,Marzo,Panamá,215,327,,542,-76.532004,3.451668
36623,2016,Marzo,Panamá,0,6,,6,-77.061029,3.8844260000000004
36624,2016,Marzo,Panamá,95,163,,258,-75.76635300000001,4.45285
36625,2016,Marzo,Panamá,4614,6347,,10961,-74.140516,4.697157
36626,2016,Marzo,Panamá,31,68,,99,-75.736374,4.815189
36627,2016,Marzo,Panamá,1860,2677,,4537,-75.42726,6.170465
36628,2016,Marzo,Panamá,0,3,,3,-77.401154,6.222551999999999
36629,2016,Marzo,Panamá,15,36,,51,-73.181317,7.1280470000000005
36630,2016,Marzo,Panamá,38,58,,96,-72.508188,7.927233
36631,2016,Marzo,Panamá,0,3,,3,-76.7333,8.06667
36632,2016,Marzo,Panamá,144,154,,298,-77.35002,8.63337
36633,2016,Marzo,Panamá,0,3,,3,-75.68164200000001,9.402597
36634,2016,Marzo,Paraguay,4,4,,8,-75.516486,10.446304
36635,2016,Marzo,Paraguay,0,2,,2,-74.77647900000001,10.886686
36636,2016,Marzo,Paraguay,69,56,,125,-81.70216500000001,12.5862
36637,2016,Marzo,Paraguay,7,10,,17,-76.532004,3.451668
36638,2016,Marzo,Paraguay,77,73,,150,-74.140516,4.697157
36639,2016,Marzo,Paraguay,2,1,,3,-75.736374,4.815189
36640,2016,Marzo,Paraguay,11,15,,26,-75.42726,6.170465
36641,2016,Marzo,Paraguay,1,1,,2,-72.508188,7.927233
36642,2016,Marzo,Perú,99,174,,273,-69.941498,4.191162
36643,2016,Marzo,Perú,0,3,,3,-74.78366,0.18595699999999998
36644,2016,Marzo,Perú,15,32,,47,-77.35600000000001,0.81488
36645,2016,Marzo,Perú,0,4,,4,-75.527794,10.406342
36646,2016,Marzo,Perú,21,13,,34,-75.516486,10.446304
36647,2016,Marzo,Perú,172,117,,289,-81.70216500000001,12.5862
36648,2016,Marzo,Perú,312,436,,748,-76.532004,3.451668
36649,2016,Marzo,Perú,6135,8252,,14387,-74.140516,4.697157
36650,2016,Marzo,Perú,2,1,,3,-75.736374,4.815189
36651,2016,Marzo,Perú,495,759,,1254,-75.42726,6.170465
36652,2016,Marzo,Perú,0,1,,1,-73.181317,7.1280470000000005
36653,2016,Marzo,Perú,1,1,,2,-72.508188,7.927233
36654,2016,Marzo,Polonia,0,1,,1,-74.77647900000001,10.886686
36655,2016,Marzo,Polonia,15,24,,39,-74.140516,4.697157
36656,2016,Marzo,Polonia,3,0,,3,-75.42726,6.170465
36657,2016,Marzo,Portugal,0,2,,2,-74.765343,10.970933
36658,2016,Marzo,Portugal,5,11,,16,-76.532004,3.451668
36659,2016,Marzo,Portugal,163,272,,435,-74.140516,4.697157
36660,2016,Marzo,Portugal,7,4,,11,-75.42726,6.170465
36661,2016,Marzo,Puerto Rico/Territorio de Estados Unidos,1,9,,10,-75.527794,10.406342
36662,2016,Marzo,Puerto Rico/Territorio de Estados Unidos,2,4,,6,-75.516486,10.446304
36663,2016,Marzo,Puerto Rico/Territorio de Estados Unidos,5,53,,58,-74.77647900000001,10.886686
36664,2016,Marzo,Puerto Rico/Territorio de Estados Unidos,0,1,,1,-74.765343,10.970933
36665,2016,Marzo,Puerto Rico/Territorio de Estados Unidos,0,5,,5,-74.213989,11.247722999999999
36666,2016,Marzo,Puerto Rico/Territorio de Estados Unidos,2,0,,2,-81.70216500000001,12.5862
36667,2016,Marzo,Puerto Rico/Territorio de Estados Unidos,31,48,,79,-76.532004,3.451668
36668,2016,Marzo,Puerto Rico/Territorio de Estados Unidos,257,384,,641,-74.140516,4.697157
36669,2016,Marzo,Puerto Rico/Territorio de Estados Unidos,2,4,,6,-75.736374,4.815189
36670,2016,Marzo,Puerto Rico/Territorio de Estados Unidos,25,63,,88,-75.42726,6.170465
36671,2016,Marzo,Puerto Rico/Territorio de Estados Unidos,0,1,,1,-72.508188,7.927233
36672,2016,Marzo,Qatar,1,0,,1,-74.140516,4.697157
36673,2016,Marzo,Reino Unido de Gran Bretaña e Irlanda del Norte,0,3,,3,-75.527794,10.406342
36674,2016,Marzo,Reino Unido de Gran Bretaña e Irlanda del Norte,136,128,,264,-75.516486,10.446304
36675,2016,Marzo,Reino Unido de Gran Bretaña e Irlanda del Norte,1,0,,1,-81.70216500000001,12.5862
36676,2016,Marzo,Reino Unido de Gran Bretaña e Irlanda del Norte,17,20,,37,-76.532004,3.451668
36677,2016,Marzo,Reino Unido de Gran Bretaña e Irlanda del Norte,832,1283,,2115,-74.140516,4.697157
36678,2016,Marzo,Reino Unido de Gran Bretaña e Irlanda del Norte,7,23,,30,-75.42726,6.170465
36679,2016,Marzo,Reino Unido de Gran Bretaña e Irlanda del Norte,1,0,,1,-72.508188,7.927233
36680,2016,Marzo,República CentroÁfricana,0,1,,1,-76.532004,3.451668
36681,2016,Marzo,República CentroÁfricana,0,1,,1,-74.140516,4.697157
36682,2016,Marzo,República CentroÁfricana,1,0,,1,-75.42726,6.170465
36683,2016,Marzo,Federación de Rusia,1,0,,1,-75.516486,10.446304
36684,2016,Marzo,Federación de Rusia,1,2,,3,-76.532004,3.451668
36685,2016,Marzo,Federación de Rusia,15,26,,41,-74.140516,4.697157
36686,2016,Marzo,Federación de Rusia,0,1,,1,-75.42726,6.170465
36687,2016,Marzo,República Dominicana,0,1,,1,-75.527794,10.406342
36688,2016,Marzo,República Dominicana,1,1,,2,-75.516486,10.446304
36689,2016,Marzo,República Dominicana,7,15,,22,-74.77647900000001,10.886686
36690,2016,Marzo,República Dominicana,0,1,,1,-74.765343,10.970933
36691,2016,Marzo,República Dominicana,27,45,,72,-76.532004,3.451668
36692,2016,Marzo,República Dominicana,764,962,,1726,-74.140516,4.697157
36693,2016,Marzo,República Dominicana,3,2,,5,-75.736374,4.815189
36694,2016,Marzo,República Dominicana,96,86,,182,-75.42726,6.170465
36695,2016,Marzo,República Dominicana,1,4,,5,-72.508188,7.927233
36696,2016,Marzo,Reunión,1,0,,1,-74.140516,4.697157
36697,2016,Marzo,Rumania,4,6,,10,-74.140516,4.697157
36698,2016,Marzo,Rumania,0,1,,1,-75.42726,6.170465
36699,2016,Marzo,San Cristóbal y Nevis,0,2,,2,-74.140516,4.697157
36700,2016,Marzo,San  Vicente y las Granadinas,0,1,,1,-75.527794,10.406342
36701,2016,Marzo,San  Vicente y las Granadinas,1,0,,1,-81.70216500000001,12.5862
36702,2016,Marzo,Santa Sede/Ciudad del Vaticano,0,1,,1,-74.140516,4.697157
36703,2016,Marzo,Santo Tomé y Príncipe,0,1,,1,-74.140516,4.697157
36704,2016,Marzo,Serbia,2,0,,2,-74.140516,4.697157
36705,2016,Marzo,Sierra Leona,0,1,,1,-74.140516,4.697157
36706,2016,Marzo,Singapur,3,4,,7,-74.140516,4.697157
36707,2016,Marzo,Singapur,0,1,,1,-75.42726,6.170465
36708,2016,Marzo,Sri Lanka,0,1,,1,-74.140516,4.697157
36709,2016,Marzo,Sudáfrica,2,8,,10,-74.140516,4.697157
36710,2016,Marzo,Sudáfrica,3,1,,4,-75.42726,6.170465
36711,2016,Marzo,Sudán,0,1,,1,-75.42726,6.170465
36712,2016,Marzo,Suecia,1,1,,2,-74.77647900000001,10.886686
36713,2016,Marzo,Suecia,0,1,,1,-81.70216500000001,12.5862
36714,2016,Marzo,Suecia,6,6,,12,-76.532004,3.451668
36715,2016,Marzo,Suecia,20,34,,54,-74.140516,4.697157
36716,2016,Marzo,Suecia,2,5,,7,-75.42726,6.170465
36717,2016,Marzo,Suiza,2,1,,3,-75.516486,10.446304
36718,2016,Marzo,Suiza,1,2,,3,-81.70216500000001,12.5862
36719,2016,Marzo,Suiza,11,19,,30,-76.532004,3.451668
36720,2016,Marzo,Suiza,66,91,,157,-74.140516,4.697157
36721,2016,Marzo,Suiza,1,2,,3,-75.736374,4.815189
36722,2016,Marzo,Suiza,9,11,,20,-75.42726,6.170465
36723,2016,Marzo,Surinam,1,4,,5,-74.140516,4.697157
36724,2016,Marzo,Surinam,8,7,,15,-75.42726,6.170465
36725,2016,Marzo,Taiwán,0,2,,2,-74.140516,4.697157
36726,2016,Marzo,Taiwán,0,1,,1,-75.42726,6.170465
36727,2016,Marzo,Tailandia,2,1,,3,-74.140516,4.697157
36728,2016,Marzo,Tailandia,1,0,,1,-75.42726,6.170465
36729,2016,Marzo,Trinidad y Tobago,2,73,,75,-75.527794,10.406342
36730,2016,Marzo,Trinidad y Tobago,1,1,,2,-75.516486,10.446304
36731,2016,Marzo,Trinidad y Tobago,1,0,,1,-74.77647900000001,10.886686
36732,2016,Marzo,Trinidad y Tobago,3,6,,9,-76.532004,3.451668
36733,2016,Marzo,Trinidad y Tobago,0,12,,12,-74.140516,4.697157
36734,2016,Marzo,Trinidad y Tobago,10,9,,19,-75.42726,6.170465
36735,2016,Marzo,Turkmenistán,1,1,,2,-76.532004,3.451668
36736,2016,Marzo,Turquía,0,3,,3,-74.765343,10.970933
36737,2016,Marzo,Turquía,0,1,,1,-74.213989,11.247722999999999
36738,2016,Marzo,Turquía,9,18,,27,-74.140516,4.697157
36739,2016,Marzo,Turquía,2,0,,2,-75.42726,6.170465
36740,2016,Marzo,Ucrania,0,1,,1,-74.77647900000001,10.886686
36741,2016,Marzo,Ucrania,2,2,,4,-74.140516,4.697157
36742,2016,Marzo,Uganda,0,2,,2,-74.140516,4.697157
36743,2016,Marzo,Uruguay,1,0,,1,-77.35600000000001,0.81488
36744,2016,Marzo,Uruguay,1,5,,6,-75.516486,10.446304
36745,2016,Marzo,Uruguay,1,4,,5,-74.77647900000001,10.886686
36746,2016,Marzo,Uruguay,0,11,,11,-74.765343,10.970933
36747,2016,Marzo,Uruguay,39,33,,72,-81.70216500000001,12.5862
36748,2016,Marzo,Uruguay,9,31,,40,-76.532004,3.451668
36749,2016,Marzo,Uruguay,72,91,,163,-74.140516,4.697157
36750,2016,Marzo,Uruguay,1,0,,1,-75.736374,4.815189
36751,2016,Marzo,Uruguay,44,123,,167,-75.42726,6.170465
36752,2016,Marzo,Vanuatu,1,0,,1,-74.140516,4.697157
36753,2016,Marzo,Venezuela,2,9,,11,-75.527794,10.406342
36754,2016,Marzo,Venezuela,3,6,,9,-75.516486,10.446304
36755,2016,Marzo,Venezuela,16,42,,58,-74.77647900000001,10.886686
36756,2016,Marzo,Venezuela,0,10,,10,-74.232675,11.117206
36757,2016,Marzo,Venezuela,424,602,,1026,-72.129595,11.360028999999999
36758,2016,Marzo,Venezuela,0,1,,1,-81.70216500000001,12.5862
36759,2016,Marzo,Venezuela,11,18,,29,-76.532004,3.451668
36760,2016,Marzo,Venezuela,53,72,,125,-67.927521,3.866713
36761,2016,Marzo,Venezuela,3610,4205,,7815,-74.140516,4.697157
36762,2016,Marzo,Venezuela,3,5,,8,-75.736374,4.815189
36763,2016,Marzo,Venezuela,831,812,,1643,-75.42726,6.170465
36764,2016,Marzo,Venezuela,81,134,,215,-67.48402800000001,6.185536
36765,2016,Marzo,Venezuela,63,93,,156,-70.74025300000001,7.088728999999999
36766,2016,Marzo,Venezuela,2,11,,13,-73.181317,7.1280470000000005
36767,2016,Marzo,Venezuela,1656,2095,,3751,-72.453013,7.819
36768,2016,Marzo,Venezuela,107,146,,253,-72.508188,7.927233
36769,2016,Marzo,Vietnam,1,0,,1,-74.140516,4.697157
36770,2016,Abril,Afganistán,0,1,,1,-74.140516,4.697157
36771,2016,Abril,Alemania,1,0,,1,-75.516486,10.446304
36772,2016,Abril,Alemania,3,3,,6,-74.77647900000001,10.886686
36773,2016,Abril,Alemania,25,33,,58,-76.532004,3.451668
36774,2016,Abril,Alemania,892,1625,,2517,-74.140516,4.697157
36775,2016,Abril,Alemania,2,2,,4,-75.736374,4.815189
36776,2016,Abril,Alemania,20,35,,55,-75.42726,6.170465
36777,2016,Abril,Alemania,1,0,,1,-73.181317,7.1280470000000005
36778,2016,Abril,Andorra,0,1,,1,-74.140516,4.697157
36779,2016,Abril,Antigua y Barbuda,0,3,,3,-75.527794,10.406342
36780,2016,Abril,Antigua y Barbuda,1,4,,5,-74.140516,4.697157
36781,2016,Abril,Antigua y Barbuda,1,0,,1,-75.42726,6.170465
36782,2016,Abril,Países Bajos,6,24,,30,-75.527794,10.406342
36783,2016,Abril,Países Bajos,2,4,,6,-75.516486,10.446304
36784,2016,Abril,Países Bajos,76,84,,160,-74.77647900000001,10.886686
36785,2016,Abril,Países Bajos,1,4,,5,-74.213989,11.247722999999999
36786,2016,Abril,Países Bajos,78,123,,201,-76.532004,3.451668
36787,2016,Abril,Países Bajos,819,1189,,2008,-74.140516,4.697157
36788,2016,Abril,Países Bajos,2,1,,3,-75.736374,4.815189
36789,2016,Abril,Países Bajos,248,281,,529,-75.42726,6.170465
36790,2016,Abril,Países Bajos,3,3,,6,-73.181317,7.1280470000000005
36791,2016,Abril,Países Bajos,0,1,,1,-72.508188,7.927233
36792,2016,Abril,Países Bajos,0,1,,1,-76.7333,8.06667
36793,2016,Abril,Arabia Saudita,0,2,,2,-76.532004,3.451668
36794,2016,Abril,Argelia,1,2,,3,-74.140516,4.697157
36795,2016,Abril,Argelia,0,1,,1,-75.42726,6.170465
36796,2016,Abril,Argentina,15,19,,34,-77.35600000000001,0.81488
36797,2016,Abril,Argentina,36,16,,52,-75.516486,10.446304
36798,2016,Abril,Argentina,8,14,,22,-74.77647900000001,10.886686
36799,2016,Abril,Argentina,168,105,,273,-81.70216500000001,12.5862
36800,2016,Abril,Argentina,39,70,,109,-76.532004,3.451668
36801,2016,Abril,Argentina,2074,2920,,4994,-74.140516,4.697157
36802,2016,Abril,Argentina,1,1,,2,-75.736374,4.815189
36803,2016,Abril,Argentina,53,136,,189,-75.42726,6.170465
36804,2016,Abril,Argentina,4,1,,5,-73.181317,7.1280470000000005
36805,2016,Abril,República de Armenia,1,0,,1,-74.140516,4.697157
36806,2016,Abril,Aruba,19,36,,55,-75.527794,10.406342
36807,2016,Abril,Aruba,1,3,,4,-75.516486,10.446304
36808,2016,Abril,Aruba,10,20,,30,-74.77647900000001,10.886686
36809,2016,Abril,Aruba,0,2,,2,-74.765343,10.970933
36810,2016,Abril,Aruba,1,2,,3,-74.213989,11.247722999999999
36811,2016,Abril,Aruba,4,7,,11,-76.532004,3.451668
36812,2016,Abril,Aruba,563,698,,1261,-74.140516,4.697157
36813,2016,Abril,Aruba,0,1,,1,-75.736374,4.815189
36814,2016,Abril,Aruba,89,115,,204,-75.42726,6.170465
36815,2016,Abril,Aruba,10,16,,26,-73.181317,7.1280470000000005
36816,2016,Abril,Australia,2,3,,5,-75.516486,10.446304
36817,2016,Abril,Australia,0,1,,1,-74.77647900000001,10.886686
36818,2016,Abril,Australia,6,1,,7,-76.532004,3.451668
36819,2016,Abril,Australia,21,27,,48,-74.140516,4.697157
36820,2016,Abril,Australia,0,1,,1,-75.736374,4.815189
36821,2016,Abril,Australia,9,12,,21,-75.42726,6.170465
36822,2016,Abril,Austria,0,1,,1,-74.77647900000001,10.886686
36823,2016,Abril,Austria,0,1,,1,-81.70216500000001,12.5862
36824,2016,Abril,Austria,5,21,,26,-74.140516,4.697157
36825,2016,Abril,Azerbaiyán,1,0,,1,-74.140516,4.697157
36826,2016,Abril,Bahamas,1,1,,2,-75.527794,10.406342
36827,2016,Abril,Bahamas,0,1,,1,-74.77647900000001,10.886686
36828,2016,Abril,Bahamas,0,1,,1,-74.140516,4.697157
36829,2016,Abril,Bahamas,0,4,,4,-75.42726,6.170465
36830,2016,Abril,Bahréin,1,0,,1,-75.516486,10.446304
36831,2016,Abril,Bahréin,0,1,,1,-74.140516,4.697157
36832,2016,Abril,Bangladesh,0,1,,1,-76.532004,3.451668
36833,2016,Abril,Barbados,0,8,,8,-75.516486,10.446304
36834,2016,Abril,Barbados,32,38,,70,-74.140516,4.697157
36835,2016,Abril,República de Belarús,2,5,,7,-74.140516,4.697157
36836,2016,Abril,Bélgica,0,1,,1,-74.77647900000001,10.886686
36837,2016,Abril,Bélgica,2,6,,8,-76.532004,3.451668
36838,2016,Abril,Bélgica,14,25,,39,-74.140516,4.697157
36839,2016,Abril,Bélgica,3,2,,5,-75.42726,6.170465
36840,2016,Abril,Belice,0,2,,2,-76.532004,3.451668
36841,2016,Abril,Belice,1,7,,8,-74.140516,4.697157
36842,2016,Abril,Benín,0,1,,1,-76.532004,3.451668
36843,2016,Abril,Benín,0,2,,2,-74.140516,4.697157
36844,2016,Abril,Bermudas/Territorio Británico de Ultramar,0,1,,1,-75.42726,6.170465
36845,2016,Abril,Bolivia,0,1,,1,-77.35600000000001,0.81488
36846,2016,Abril,Bolivia,2,2,,4,-75.516486,10.446304
36847,2016,Abril,Bolivia,14,9,,23,-74.77647900000001,10.886686
36848,2016,Abril,Bolivia,30,26,,56,-81.70216500000001,12.5862
36849,2016,Abril,Bolivia,27,45,,72,-76.532004,3.451668
36850,2016,Abril,Bolivia,375,505,,880,-74.140516,4.697157
36851,2016,Abril,Bolivia,1,0,,1,-75.736374,4.815189
36852,2016,Abril,Bolivia,43,57,,100,-75.42726,6.170465
36853,2016,Abril,Botsuana,0,1,,1,-74.140516,4.697157
36854,2016,Abril,Brasil,107,151,,258,-69.941498,4.191162
36855,2016,Abril,Brasil,0,8,,8,-69.94143100000001,4.214082
36856,2016,Abril,Brasil,2,3,,5,-77.35600000000001,0.81488
36857,2016,Abril,Brasil,0,8,,8,-75.527794,10.406342
36858,2016,Abril,Brasil,46,36,,82,-75.516486,10.446304
36859,2016,Abril,Brasil,1,12,,13,-74.77647900000001,10.886686
36860,2016,Abril,Brasil,0,2,,2,-74.765343,10.970933
36861,2016,Abril,Brasil,337,274,,611,-81.70216500000001,12.5862
36862,2016,Abril,Brasil,100,115,,215,-76.532004,3.451668
36863,2016,Abril,Brasil,5270,6557,,11827,-74.140516,4.697157
36864,2016,Abril,Brasil,2,3,,5,-75.736374,4.815189
36865,2016,Abril,Brasil,108,207,,315,-75.42726,6.170465
36866,2016,Abril,Brasil,0,2,,2,-73.181317,7.1280470000000005
36867,2016,Abril,Bulgaria,0,1,,1,-74.140516,4.697157
36868,2016,Abril,Burundi,0,1,,1,-74.140516,4.697157
36869,2016,Abril,Cabo Verde,0,1,,1,-74.140516,4.697157
36870,2016,Abril,Islas Caimán/Territorio Británico de Ultramar,3,1,,4,-75.527794,10.406342
36871,2016,Abril,Islas Caimán/Territorio Británico de Ultramar,1,0,,1,-81.70216500000001,12.5862
36872,2016,Abril,Islas Caimán/Territorio Británico de Ultramar,3,4,,7,-81.372937,13.338761300000002
36873,2016,Abril,Islas Caimán/Territorio Británico de Ultramar,1,2,,3,-74.140516,4.697157
36874,2016,Abril,Islas Caimán/Territorio Británico de Ultramar,0,1,,1,-75.42726,6.170465
36875,2016,Abril,Canadá,0,4,,4,-75.527794,10.406342
36876,2016,Abril,Canadá,3,2,,5,-75.516486,10.446304
36877,2016,Abril,Canadá,4,5,,9,-74.77647900000001,10.886686
36878,2016,Abril,Canadá,1,0,,1,-81.70216500000001,12.5862
36879,2016,Abril,Canadá,30,49,,79,-76.532004,3.451668
36880,2016,Abril,Canadá,394,671,,1065,-74.140516,4.697157
36881,2016,Abril,Canadá,0,3,,3,-75.736374,4.815189
36882,2016,Abril,Canadá,65,121,,186,-75.42726,6.170465
36883,2016,Abril,Canadá,2,4,,6,-73.181317,7.1280470000000005
36884,2016,Abril,Canadá,1,1,,2,-72.508188,7.927233
36885,2016,Abril,Canadá,0,2,,2,-75.68164200000001,9.402597
36886,2016,Abril,España,0,8,,8,-75.527794,10.406342
36887,2016,Abril,España,1,4,,5,-74.77647900000001,10.886686
36888,2016,Abril,España,0,1,,1,-81.70216500000001,12.5862
36889,2016,Abril,España,311,507,,818,-76.532004,3.451668
36890,2016,Abril,España,2152,4416,,6568,-74.140516,4.697157
36891,2016,Abril,España,4,5,,9,-75.736374,4.815189
36892,2016,Abril,España,157,367,,524,-75.42726,6.170465
36893,2016,Abril,España,0,1,,1,-73.181317,7.1280470000000005
36894,2016,Abril,República de Corea,0,8,,8,-75.527794,10.406342
36895,2016,Abril,República de Corea,1,1,,2,-76.532004,3.451668
36896,2016,Abril,República de Corea,6,14,,20,-74.140516,4.697157
36897,2016,Abril,República de Corea,1,3,,4,-75.42726,6.170465
36898,2016,Abril,República de Corea,0,3,,3,-72.508188,7.927233
36899,2016,Abril,Costa de Marfil,2,1,,3,-76.532004,3.451668
36900,2016,Abril,Costa de Marfil,2,6,,8,-74.140516,4.697157
36901,2016,Abril,Costa Rica,0,4,,4,-75.527794,10.406342
36902,2016,Abril,Costa Rica,2,7,,9,-75.516486,10.446304
36903,2016,Abril,Costa Rica,4,14,,18,-74.77647900000001,10.886686
36904,2016,Abril,Costa Rica,0,6,,6,-74.765343,10.970933
36905,2016,Abril,Costa Rica,0,3,,3,-74.232675,11.117206
36906,2016,Abril,Costa Rica,153,111,,264,-81.70216500000001,12.5862
36907,2016,Abril,Costa Rica,34,27,,61,-76.532004,3.451668
36908,2016,Abril,Costa Rica,786,1272,,2058,-74.140516,4.697157
36909,2016,Abril,Costa Rica,7,16,,23,-75.736374,4.815189
36910,2016,Abril,Costa Rica,79,123,,202,-75.42726,6.170465
36911,2016,Abril,Costa Rica,1,2,,3,-73.181317,7.1280470000000005
36912,2016,Abril,Costa Rica,0,4,,4,-72.508188,7.927233
36913,2016,Abril,Costa Rica,0,1,,1,-77.35002,8.63337
36914,2016,Abril,Croacia,0,6,,6,-74.140516,4.697157
36915,2016,Abril,Croacia,0,2,,2,-75.42726,6.170465
36916,2016,Abril,Cuba,0,4,,4,-75.527794,10.406342
36917,2016,Abril,Cuba,9,97,,106,-75.516486,10.446304
36918,2016,Abril,Cuba,4,3,,7,-74.77647900000001,10.886686
36919,2016,Abril,Cuba,1,2,,3,-81.70216500000001,12.5862
36920,2016,Abril,Cuba,0,3,,3,-81.372937,13.338761300000002
36921,2016,Abril,Cuba,11,13,,24,-76.532004,3.451668
36922,2016,Abril,Cuba,244,414,,658,-74.140516,4.697157
36923,2016,Abril,Cuba,2,1,,3,-75.736374,4.815189
36924,2016,Abril,Cuba,18,18,,36,-75.42726,6.170465
36925,2016,Abril,Cuba,2,1,,3,-73.181317,7.1280470000000005
36926,2016,Abril,Cuba,0,1,,1,-72.508188,7.927233
36927,2016,Abril,Curazao,2,0,,2,-74.140516,4.697157
36928,2016,Abril,República Checa,2,4,,6,-74.140516,4.697157
36929,2016,Abril,Chile,4,9,,13,-77.35600000000001,0.81488
36930,2016,Abril,Chile,9,2,,11,-75.516486,10.446304
36931,2016,Abril,Chile,1,4,,5,-74.77647900000001,10.886686
36932,2016,Abril,Chile,22,17,,39,-81.70216500000001,12.5862
36933,2016,Abril,Chile,30,43,,73,-76.532004,3.451668
36934,2016,Abril,Chile,4037,5367,,9404,-74.140516,4.697157
36935,2016,Abril,Chile,2,5,,7,-75.736374,4.815189
36936,2016,Abril,Chile,31,50,,81,-75.42726,6.170465
36937,2016,Abril,Chile,1,1,,2,-72.508188,7.927233
36938,2016,Abril,China,2,0,,2,-76.532004,3.451668
36939,2016,Abril,China,28,77,,105,-74.140516,4.697157
36940,2016,Abril,China,4,5,,9,-75.42726,6.170465
36941,2016,Abril,Dinamarca,0,1,,1,-74.77647900000001,10.886686
36942,2016,Abril,Dinamarca,3,3,,6,-76.532004,3.451668
36943,2016,Abril,Dinamarca,14,16,,30,-74.140516,4.697157
36944,2016,Abril,Dinamarca,2,1,,3,-75.42726,6.170465
36945,2016,Abril,Dominica,1,3,,4,-74.140516,4.697157
36946,2016,Abril,Ecuador,0,1,,1,-74.78366,0.18595699999999998
36947,2016,Abril,Ecuador,105,188,,293,-76.876446,0.33002
36948,2016,Abril,Ecuador,2,1,,3,-77.84700600000001,0.8124359999999999
36949,2016,Abril,Ecuador,3613,4894,,8507,-77.35600000000001,0.81488
36950,2016,Abril,Ecuador,45,38,,83,-78.802679,18.00143
36951,2016,Abril,Ecuador,0,5,,5,-75.527794,10.406342
36952,2016,Abril,Ecuador,3,2,,5,-75.516486,10.446304
36953,2016,Abril,Ecuador,1,1,,2,-74.77647900000001,10.886686
36954,2016,Abril,Ecuador,14,11,,25,-81.70216500000001,12.5862
36955,2016,Abril,Ecuador,416,501,,917,-76.532004,3.451668
36956,2016,Abril,Ecuador,3038,4369,,7407,-74.140516,4.697157
36957,2016,Abril,Ecuador,8,5,,13,-75.736374,4.815189
36958,2016,Abril,Ecuador,21,43,,64,-75.42726,6.170465
36959,2016,Abril,Ecuador,0,1,,1,-73.181317,7.1280470000000005
36960,2016,Abril,Ecuador,1,0,,1,-72.508188,7.927233
36961,2016,Abril,Egipto,2,7,,9,-74.140516,4.697157
36962,2016,Abril,El Salvador,3,3,,6,-75.516486,10.446304
36963,2016,Abril,El Salvador,2,0,,2,-74.77647900000001,10.886686
36964,2016,Abril,El Salvador,11,8,,19,-81.70216500000001,12.5862
36965,2016,Abril,El Salvador,97,160,,257,-76.532004,3.451668
36966,2016,Abril,El Salvador,958,1427,,2385,-74.140516,4.697157
36967,2016,Abril,El Salvador,1,0,,1,-75.736374,4.815189
36968,2016,Abril,El Salvador,153,224,,377,-75.42726,6.170465
36969,2016,Abril,Emiratos Árabes,0,1,,1,-76.532004,3.451668
36970,2016,Abril,Emiratos Árabes,2,2,,4,-74.140516,4.697157
36971,2016,Abril,Eslovaquia,1,0,,1,-75.516486,10.446304
36972,2016,Abril,Eslovaquia,0,4,,4,-74.140516,4.697157
36973,2016,Abril,Eslovenia,0,2,,2,-74.140516,4.697157
36974,2016,Abril,Estados Unidos de América,7,65,,72,-75.527794,10.406342
36975,2016,Abril,Estados Unidos de América,3199,4563,,7762,-75.516486,10.446304
36976,2016,Abril,Estados Unidos de América,425,879,,1304,-74.77647900000001,10.886686
36977,2016,Abril,Estados Unidos de América,0,15,,15,-74.765343,10.970933
36978,2016,Abril,Estados Unidos de América,0,6,,6,-74.213989,11.247722999999999
36979,2016,Abril,Estados Unidos de América,10,26,,36,-81.70216500000001,12.5862
36980,2016,Abril,Estados Unidos de América,891,1244,,2135,-76.532004,3.451668
36981,2016,Abril,Estados Unidos de América,114,168,,282,-75.76635300000001,4.45285
36982,2016,Abril,Estados Unidos de América,7157,13664,,20821,-74.140516,4.697157
36983,2016,Abril,Estados Unidos de América,125,155,,280,-75.736374,4.815189
36984,2016,Abril,Estados Unidos de América,2180,5515,,7695,-75.42726,6.170465
36985,2016,Abril,Estados Unidos de América,14,25,,39,-73.181317,7.1280470000000005
36986,2016,Abril,Estados Unidos de América,15,22,,37,-72.508188,7.927233
36987,2016,Abril,Estados Unidos de América,0,7,,7,-75.68164200000001,9.402597
36988,2016,Abril,Etiopia,1,0,,1,-76.532004,3.451668
36989,2016,Abril,Etiopia,1,1,,2,-74.140516,4.697157
36990,2016,Abril,Islas Fiji,0,1,,1,-74.140516,4.697157
36991,2016,Abril,Filipinas,0,3,,3,-75.516486,10.446304
36992,2016,Abril,Filipinas,0,10,,10,-74.77647900000001,10.886686
36993,2016,Abril,Filipinas,1,16,,17,-74.140516,4.697157
36994,2016,Abril,Finlandia,0,3,,3,-76.532004,3.451668
36995,2016,Abril,Finlandia,4,7,,11,-74.140516,4.697157
36996,2016,Abril,Finlandia,1,1,,2,-75.42726,6.170465
36997,2016,Abril,Francia,0,1,,1,-78.802679,18.00143
36998,2016,Abril,Francia,0,1,,1,-75.527794,10.406342
36999,2016,Abril,Francia,2,1,,3,-75.516486,10.446304
37000,2016,Abril,Francia,2,3,,5,-74.77647900000001,10.886686
37001,2016,Abril,Francia,24,46,,70,-76.532004,3.451668
37002,2016,Abril,Francia,1132,1911,,3043,-74.140516,4.697157
37003,2016,Abril,Francia,1,3,,4,-75.736374,4.815189
37004,2016,Abril,Francia,22,31,,53,-75.42726,6.170465
37005,2016,Abril,Francia,0,1,,1,-72.508188,7.927233
37006,2016,Abril,Gabón,0,1,,1,-74.140516,4.697157
37007,2016,Abril,Ghana,1,1,,2,-74.140516,4.697157
37008,2016,Abril,Gibraltar/Territorio Británico de Ultramar,1,1,,2,-77.35600000000001,0.81488
37009,2016,Abril,Granada,0,1,,1,-75.736374,4.815189
37010,2016,Abril,Grecia,0,1,,1,-76.532004,3.451668
37011,2016,Abril,Grecia,0,4,,4,-74.140516,4.697157
37012,2016,Abril,Grecia,1,0,,1,-75.42726,6.170465
37013,2016,Abril,Guatemala,4,1,,5,-75.516486,10.446304
37014,2016,Abril,Guatemala,5,5,,10,-74.77647900000001,10.886686
37015,2016,Abril,Guatemala,24,20,,44,-81.70216500000001,12.5862
37016,2016,Abril,Guatemala,20,37,,57,-76.532004,3.451668
37017,2016,Abril,Guatemala,294,599,,893,-74.140516,4.697157
37018,2016,Abril,Guatemala,3,7,,10,-75.736374,4.815189
37019,2016,Abril,Guatemala,43,79,,122,-75.42726,6.170465
37020,2016,Abril,Guatemala,2,4,,6,-73.181317,7.1280470000000005
37021,2016,Abril,Guatemala,1,0,,1,-72.508188,7.927233
37022,2016,Abril,Guyana,2,0,,2,-75.736374,4.815189
37023,2016,Abril,Guadalupe/Territorio Francés,0,1,,1,-75.516486,10.446304
37024,2016,Abril,Guadalupe/Territorio Francés,1,0,,1,-76.532004,3.451668
37025,2016,Abril,Guadalupe/Territorio Francés,1,3,,4,-74.140516,4.697157
37026,2016,Abril,Guadalupe/Territorio Francés,1,0,,1,-75.42726,6.170465
37027,2016,Abril,Haití,0,3,,3,-75.516486,10.446304
37028,2016,Abril,Haití,1,2,,3,-74.140516,4.697157
37029,2016,Abril,Haití,2,0,,2,-73.181317,7.1280470000000005
37030,2016,Abril,Honduras,1,12,,13,-75.527794,10.406342
37031,2016,Abril,Honduras,2,0,,2,-75.516486,10.446304
37032,2016,Abril,Honduras,0,2,,2,-74.77647900000001,10.886686
37033,2016,Abril,Honduras,0,3,,3,-74.213989,11.247722999999999
37034,2016,Abril,Honduras,1,2,,3,-81.703935,12.574411099999999
37035,2016,Abril,Honduras,3,0,,3,-81.70216500000001,12.5862
37036,2016,Abril,Honduras,3,3,,6,-81.372937,13.338761300000002
37037,2016,Abril,Honduras,22,22,,44,-76.532004,3.451668
37038,2016,Abril,Honduras,58,69,,127,-74.140516,4.697157
37039,2016,Abril,Honduras,57,71,,128,-75.42726,6.170465
37040,2016,Abril,Honduras,0,3,,3,-73.181317,7.1280470000000005
37041,2016,Abril,Hong Kong,1,2,,3,-74.140516,4.697157
37042,2016,Abril,Hungría,2,6,,8,-74.140516,4.697157
37043,2016,Abril,Hungría,0,1,,1,-75.736374,4.815189
37044,2016,Abril,India,0,3,,3,-74.77647900000001,10.886686
37045,2016,Abril,India,0,1,,1,-76.532004,3.451668
37046,2016,Abril,India,3,20,,23,-74.140516,4.697157
37047,2016,Abril,India,4,13,,17,-75.42726,6.170465
37048,2016,Abril,Indonesia,1,1,,2,-74.140516,4.697157
37049,2016,Abril,República de Irlanda,1,0,,1,-76.532004,3.451668
37050,2016,Abril,República de Irlanda,6,14,,20,-74.140516,4.697157
37051,2016,Abril,República de Irlanda,0,1,,1,-75.42726,6.170465
37052,2016,Abril,Islandia,0,1,,1,-74.140516,4.697157
37053,2016,Abril,Israel,1,3,,4,-75.516486,10.446304
37054,2016,Abril,Israel,2,0,,2,-74.77647900000001,10.886686
37055,2016,Abril,Israel,1,1,,2,-81.70216500000001,12.5862
37056,2016,Abril,Israel,1,4,,5,-76.532004,3.451668
37057,2016,Abril,Israel,29,96,,125,-74.140516,4.697157
37058,2016,Abril,Israel,5,10,,15,-75.42726,6.170465
37059,2016,Abril,Italia,0,3,,3,-75.516486,10.446304
37060,2016,Abril,Italia,1,0,,1,-74.77647900000001,10.886686
37061,2016,Abril,Italia,7,5,,12,-81.70216500000001,12.5862
37062,2016,Abril,Italia,17,37,,54,-76.532004,3.451668
37063,2016,Abril,Italia,54,155,,209,-74.140516,4.697157
37064,2016,Abril,Italia,9,35,,44,-75.42726,6.170465
37065,2016,Abril,Italia,0,1,,1,-72.508188,7.927233
37066,2016,Abril,Jamaica,1,4,,5,-75.527794,10.406342
37067,2016,Abril,Jamaica,0,4,,4,-74.765343,10.970933
37068,2016,Abril,Jamaica,0,3,,3,-81.372937,13.338761300000002
37069,2016,Abril,Jamaica,0,1,,1,-76.532004,3.451668
37070,2016,Abril,Jamaica,0,1,,1,-74.140516,4.697157
37071,2016,Abril,Jamaica,0,3,,3,-75.42726,6.170465
37072,2016,Abril,Japón,0,2,,2,-76.532004,3.451668
37073,2016,Abril,Japón,11,18,,29,-74.140516,4.697157
37074,2016,Abril,Japón,2,7,,9,-75.42726,6.170465
37075,2016,Abril,Japón,0,1,,1,-73.181317,7.1280470000000005
37076,2016,Abril,Jordania,1,0,,1,-74.140516,4.697157
37077,2016,Abril,Kenia,4,6,,10,-74.140516,4.697157
37078,2016,Abril,Letonia,0,1,,1,-74.140516,4.697157
37079,2016,Abril,Lituania,0,1,,1,-74.140516,4.697157
37080,2016,Abril,Líbano,1,4,,5,-74.140516,4.697157
37081,2016,Abril,Líbano,0,1,,1,-75.42726,6.170465
37082,2016,Abril,Luxemburgo,1,0,,1,-76.532004,3.451668
37083,2016,Abril,Luxemburgo,0,1,,1,-74.140516,4.697157
37084,2016,Abril,Malasia,0,2,,2,-74.140516,4.697157
37085,2016,Abril,Malasia,0,1,,1,-75.42726,6.170465
37086,2016,Abril,Malta,0,1,,1,-74.140516,4.697157
37087,2016,Abril,Marruecos,0,1,,1,-74.140516,4.697157
37088,2016,Abril,Mauritania,0,1,,1,-74.140516,4.697157
37089,2016,Abril,Martinica/Departamento de Ultramar Francés,1,1,,2,-75.516486,10.446304
37090,2016,Abril,México,0,5,,5,-75.527794,10.406342
37091,2016,Abril,México,158,108,,266,-75.516486,10.446304
37092,2016,Abril,México,10,31,,41,-74.77647900000001,10.886686
37093,2016,Abril,México,4,5,,9,-81.70216500000001,12.5862
37094,2016,Abril,México,67,128,,195,-76.532004,3.451668
37095,2016,Abril,México,0,1,,1,-75.76635300000001,4.45285
37096,2016,Abril,México,3894,7398,,11292,-74.140516,4.697157
37097,2016,Abril,México,7,13,,20,-75.736374,4.815189
37098,2016,Abril,México,352,916,,1268,-75.42726,6.170465
37099,2016,Abril,México,3,10,,13,-73.181317,7.1280470000000005
37100,2016,Abril,México,8,7,,15,-72.508188,7.927233
37101,2016,Abril,Mónaco,2,0,,2,-74.140516,4.697157
37102,2016,Abril,Nauru,0,1,,1,-74.140516,4.697157
37103,2016,Abril,Nepal,0,1,,1,-74.140516,4.697157
37104,2016,Abril,Nicaragua,2,2,,4,-75.516486,10.446304
37105,2016,Abril,Nicaragua,14,16,,30,-81.703935,12.574411099999999
37106,2016,Abril,Nicaragua,5,13,,18,-76.532004,3.451668
37107,2016,Abril,Nicaragua,18,34,,52,-74.140516,4.697157
37108,2016,Abril,Nicaragua,1,1,,2,-75.736374,4.815189
37109,2016,Abril,Nicaragua,7,22,,29,-75.42726,6.170465
37110,2016,Abril,Nicaragua,0,1,,1,-73.181317,7.1280470000000005
37111,2016,Abril,Nigeria,0,1,,1,-74.77647900000001,10.886686
37112,2016,Abril,Nigeria,1,0,,1,-74.140516,4.697157
37113,2016,Abril,Noruega,2,11,,13,-74.140516,4.697157
37114,2016,Abril,Noruega,0,2,,2,-75.736374,4.815189
37115,2016,Abril,Noruega,0,2,,2,-75.42726,6.170465
37116,2016,Abril,Nueva Zelanda,1,2,,3,-74.140516,4.697157
37117,2016,Abril,Nueva Zelanda,0,2,,2,-75.42726,6.170465
37118,2016,Abril,Pakistán,0,1,,1,-74.140516,4.697157
37119,2016,Abril,Panamá,1847,1372,,3219,-75.527794,10.406342
37120,2016,Abril,Panamá,1,3,,4,-73.247863,10.433608999999999
37121,2016,Abril,Panamá,3026,3443,,6469,-75.516486,10.446304
37122,2016,Abril,Panamá,180,486,,666,-74.77647900000001,10.886686
37123,2016,Abril,Panamá,0,26,,26,-74.765343,10.970933
37124,2016,Abril,Panamá,0,1,,1,-74.213989,11.247722999999999
37125,2016,Abril,Panamá,8,13,,21,-81.703935,12.574411099999999
37126,2016,Abril,Panamá,383,296,,679,-81.70216500000001,12.5862
37127,2016,Abril,Panamá,8,11,,19,-81.372937,13.338761300000002
37128,2016,Abril,Panamá,275,408,,683,-76.532004,3.451668
37129,2016,Abril,Panamá,0,5,,5,-77.061029,3.8844260000000004
37130,2016,Abril,Panamá,85,137,,222,-75.76635300000001,4.45285
37131,2016,Abril,Panamá,4747,6421,,11168,-74.140516,4.697157
37132,2016,Abril,Panamá,56,75,,131,-75.736374,4.815189
37133,2016,Abril,Panamá,1907,2546,,4453,-75.42726,6.170465
37134,2016,Abril,Panamá,0,1,,1,-77.401154,6.222551999999999
37135,2016,Abril,Panamá,1,0,,1,-77.762647,7.102626
37136,2016,Abril,Panamá,14,33,,47,-73.181317,7.1280470000000005
37137,2016,Abril,Panamá,32,49,,81,-72.508188,7.927233
37138,2016,Abril,Panamá,0,1,,1,-76.7333,8.06667
37139,2016,Abril,Panamá,127,149,,276,-77.35002,8.63337
37140,2016,Abril,Panamá,0,15,,15,-75.68164200000001,9.402597
37141,2016,Abril,Paraguay,6,1,,7,-75.516486,10.446304
37142,2016,Abril,Paraguay,0,1,,1,-74.77647900000001,10.886686
37143,2016,Abril,Paraguay,43,20,,63,-81.70216500000001,12.5862
37144,2016,Abril,Paraguay,6,15,,21,-76.532004,3.451668
37145,2016,Abril,Paraguay,48,54,,102,-74.140516,4.697157
37146,2016,Abril,Paraguay,1,0,,1,-75.736374,4.815189
37147,2016,Abril,Paraguay,26,26,,52,-75.42726,6.170465
37148,2016,Abril,Paraguay,1,2,,3,-72.508188,7.927233
37149,2016,Abril,Perú,98,157,,255,-69.941498,4.191162
37150,2016,Abril,Perú,1,0,,1,-74.78366,0.18595699999999998
37151,2016,Abril,Perú,7,30,,37,-77.35600000000001,0.81488
37152,2016,Abril,Perú,0,2,,2,-75.527794,10.406342
37153,2016,Abril,Perú,18,9,,27,-75.516486,10.446304
37154,2016,Abril,Perú,3,2,,5,-74.77647900000001,10.886686
37155,2016,Abril,Perú,104,79,,183,-81.70216500000001,12.5862
37156,2016,Abril,Perú,277,427,,704,-76.532004,3.451668
37157,2016,Abril,Perú,5237,7643,,12880,-74.140516,4.697157
37158,2016,Abril,Perú,1,4,,5,-75.736374,4.815189
37159,2016,Abril,Perú,351,757,,1108,-75.42726,6.170465
37160,2016,Abril,Palestina,0,1,,1,-74.140516,4.697157
37161,2016,Abril,Polonia,10,17,,27,-74.140516,4.697157
37162,2016,Abril,Polonia,0,1,,1,-75.42726,6.170465
37163,2016,Abril,Portugal,2,13,,15,-76.532004,3.451668
37164,2016,Abril,Portugal,17,52,,69,-74.140516,4.697157
37165,2016,Abril,Portugal,0,1,,1,-75.736374,4.815189
37166,2016,Abril,Portugal,0,5,,5,-75.42726,6.170465
37167,2016,Abril,Puerto Rico/Territorio de Estados Unidos,1,4,,5,-73.247863,10.433608999999999
37168,2016,Abril,Puerto Rico/Territorio de Estados Unidos,0,2,,2,-75.516486,10.446304
37169,2016,Abril,Puerto Rico/Territorio de Estados Unidos,8,41,,49,-74.77647900000001,10.886686
37170,2016,Abril,Puerto Rico/Territorio de Estados Unidos,1,3,,4,-81.70216500000001,12.5862
37171,2016,Abril,Puerto Rico/Territorio de Estados Unidos,33,34,,67,-76.532004,3.451668
37172,2016,Abril,Puerto Rico/Territorio de Estados Unidos,173,299,,472,-74.140516,4.697157
37173,2016,Abril,Puerto Rico/Territorio de Estados Unidos,3,4,,7,-75.736374,4.815189
37174,2016,Abril,Puerto Rico/Territorio de Estados Unidos,44,67,,111,-75.42726,6.170465
37175,2016,Abril,Puerto Rico/Territorio de Estados Unidos,1,3,,4,-73.181317,7.1280470000000005
37176,2016,Abril,Qatar,0,2,,2,-74.140516,4.697157
37177,2016,Abril,Reino Unido de Gran Bretaña e Irlanda del Norte,0,2,,2,-75.516486,10.446304
37178,2016,Abril,Reino Unido de Gran Bretaña e Irlanda del Norte,1,4,,5,-74.77647900000001,10.886686
37179,2016,Abril,Reino Unido de Gran Bretaña e Irlanda del Norte,10,25,,35,-76.532004,3.451668
37180,2016,Abril,Reino Unido de Gran Bretaña e Irlanda del Norte,484,856,,1340,-74.140516,4.697157
37181,2016,Abril,Reino Unido de Gran Bretaña e Irlanda del Norte,15,26,,41,-75.42726,6.170465
37182,2016,Abril,Federación de Rusia,0,1,,1,-74.213989,11.247722999999999
37183,2016,Abril,Federación de Rusia,1,1,,2,-76.532004,3.451668
37184,2016,Abril,Federación de Rusia,5,13,,18,-74.140516,4.697157
37185,2016,Abril,Federación de Rusia,2,2,,4,-75.42726,6.170465
37186,2016,Abril,República Dominicana,0,16,,16,-75.527794,10.406342
37187,2016,Abril,República Dominicana,5,5,,10,-75.516486,10.446304
37188,2016,Abril,República Dominicana,3,16,,19,-74.77647900000001,10.886686
37189,2016,Abril,República Dominicana,0,2,,2,-74.213989,11.247722999999999
37190,2016,Abril,República Dominicana,0,2,,2,-81.70216500000001,12.5862
37191,2016,Abril,República Dominicana,20,30,,50,-76.532004,3.451668
37192,2016,Abril,República Dominicana,453,659,,1112,-74.140516,4.697157
37193,2016,Abril,República Dominicana,6,5,,11,-75.736374,4.815189
37194,2016,Abril,República Dominicana,22,28,,50,-75.42726,6.170465
37195,2016,Abril,República Dominicana,1,0,,1,-73.181317,7.1280470000000005
37196,2016,Abril,República Dominicana,1,0,,1,-72.508188,7.927233
37197,2016,Abril,República Democrática Popular de Corea,0,1,,1,-75.527794,10.406342
37198,2016,Abril,Rumania,4,11,,15,-74.140516,4.697157
37199,2016,Abril,San Cristóbal y Nevis,0,1,,1,-75.42726,6.170465
37200,2016,Abril,Santa Elena/Territorio Británico de Ultramar,0,1,,1,-74.140516,4.697157
37201,2016,Abril,Santa Lucia,1,3,,4,-74.213989,11.247722999999999
37202,2016,Abril,Serbia,0,3,,3,-74.140516,4.697157
37203,2016,Abril,Sierra Leona,1,2,,3,-74.140516,4.697157
37204,2016,Abril,Singapur,0,1,,1,-75.527794,10.406342
37205,2016,Abril,Singapur,0,3,,3,-74.140516,4.697157
37206,2016,Abril,Sudáfrica,3,5,,8,-74.140516,4.697157
37207,2016,Abril,Sudáfrica,1,0,,1,-75.42726,6.170465
37208,2016,Abril,Suecia,2,5,,7,-76.532004,3.451668
37209,2016,Abril,Suecia,16,30,,46,-74.140516,4.697157
37210,2016,Abril,Suecia,3,1,,4,-75.42726,6.170465
37211,2016,Abril,Suiza,0,2,,2,-75.516486,10.446304
37212,2016,Abril,Suiza,1,1,,2,-81.70216500000001,12.5862
37213,2016,Abril,Suiza,10,21,,31,-76.532004,3.451668
37214,2016,Abril,Suiza,56,63,,119,-74.140516,4.697157
37215,2016,Abril,Suiza,1,2,,3,-75.736374,4.815189
37216,2016,Abril,Suiza,5,17,,22,-75.42726,6.170465
37217,2016,Abril,Suiza,0,1,,1,-73.181317,7.1280470000000005
37218,2016,Abril,Surinam,3,0,,3,-74.77647900000001,10.886686
37219,2016,Abril,Surinam,0,1,,1,-74.140516,4.697157
37220,2016,Abril,Surinam,0,2,,2,-75.42726,6.170465
37221,2016,Abril,Taiwán,0,4,,4,-76.532004,3.451668
37222,2016,Abril,Taiwán,0,3,,3,-74.140516,4.697157
37223,2016,Abril,República de Tayikistán,0,1,,1,-74.140516,4.697157
37224,2016,Abril,Tailandia,1,0,,1,-76.532004,3.451668
37225,2016,Abril,Tailandia,2,3,,5,-74.140516,4.697157
37226,2016,Abril,Territorio Británico del Océano Índico/Territorios Británicos de Ultramar,1,0,,1,-74.140516,4.697157
37227,2016,Abril,Trinidad y Tobago,0,12,,12,-75.527794,10.406342
37228,2016,Abril,Trinidad y Tobago,0,1,,1,-75.516486,10.446304
37229,2016,Abril,Trinidad y Tobago,0,1,,1,-81.70216500000001,12.5862
37230,2016,Abril,Trinidad y Tobago,2,1,,3,-76.532004,3.451668
37231,2016,Abril,Trinidad y Tobago,4,9,,13,-74.140516,4.697157
37232,2016,Abril,Trinidad y Tobago,0,2,,2,-75.736374,4.815189
37233,2016,Abril,Trinidad y Tobago,0,1,,1,-75.42726,6.170465
37234,2016,Abril,Trinidad y Tobago,1,0,,1,-73.181317,7.1280470000000005
37235,2016,Abril,Túnez,0,2,,2,-74.140516,4.697157
37236,2016,Abril,Turquía,0,1,,1,-74.213989,11.247722999999999
37237,2016,Abril,Turquía,0,1,,1,-76.532004,3.451668
37238,2016,Abril,Turquía,4,14,,18,-74.140516,4.697157
37239,2016,Abril,Turquía,0,1,,1,-75.42726,6.170465
37240,2016,Abril,Ucrania,0,1,,1,-76.532004,3.451668
37241,2016,Abril,Ucrania,2,1,,3,-74.140516,4.697157
37242,2016,Abril,Uganda,0,1,,1,-76.532004,3.451668
37243,2016,Abril,Uganda,2,0,,2,-74.140516,4.697157
37244,2016,Abril,Uruguay,0,2,,2,-77.35600000000001,0.81488
37245,2016,Abril,Uruguay,4,2,,6,-75.516486,10.446304
37246,2016,Abril,Uruguay,0,1,,1,-74.77647900000001,10.886686
37247,2016,Abril,Uruguay,24,21,,45,-81.70216500000001,12.5862
37248,2016,Abril,Uruguay,6,19,,25,-76.532004,3.451668
37249,2016,Abril,Uruguay,79,81,,160,-74.140516,4.697157
37250,2016,Abril,Uruguay,23,22,,45,-75.42726,6.170465
37251,2016,Abril,Uruguay,0,1,,1,-73.181317,7.1280470000000005
37252,2016,Abril,Vanuatu,0,1,,1,-74.140516,4.697157
37253,2016,Abril,Venezuela,0,9,,9,-75.527794,10.406342
37254,2016,Abril,Venezuela,6,4,,10,-73.247863,10.433608999999999
37255,2016,Abril,Venezuela,3,21,,24,-75.516486,10.446304
37256,2016,Abril,Venezuela,11,61,,72,-74.77647900000001,10.886686
37257,2016,Abril,Venezuela,0,1,,1,-74.765343,10.970933
37258,2016,Abril,Venezuela,0,5,,5,-74.232675,11.117206
37259,2016,Abril,Venezuela,0,3,,3,-74.213989,11.247722999999999
37260,2016,Abril,Venezuela,402,643,,1045,-72.129595,11.360028999999999
37261,2016,Abril,Venezuela,1,4,,5,-81.70216500000001,12.5862
37262,2016,Abril,Venezuela,15,20,,35,-76.532004,3.451668
37263,2016,Abril,Venezuela,35,26,,61,-67.927521,3.866713
37264,2016,Abril,Venezuela,3024,3553,,6577,-74.140516,4.697157
37265,2016,Abril,Venezuela,2,5,,7,-75.736374,4.815189
37266,2016,Abril,Venezuela,507,586,,1093,-75.42726,6.170465
37267,2016,Abril,Venezuela,40,53,,93,-67.48402800000001,6.185536
37268,2016,Abril,Venezuela,51,47,,98,-70.74025300000001,7.088728999999999
37269,2016,Abril,Venezuela,3,3,,6,-73.181317,7.1280470000000005
37270,2016,Abril,Venezuela,1308,1935,,3243,-72.453013,7.819
37271,2016,Abril,Venezuela,90,126,,216,-72.508188,7.927233
37273,2016,Abril,Vietnam,1,1,,2,-74.140516,4.697157
37274,2016,Abril,Islas Vírgenes Británicas/Territorio Británico de Ultramar,1,1,,2,-74.140516,4.697157
37275,2016,Abril,Islas Vírgenes Estadounidenses/Territorio de Estados Unidos,0,16,,16,-75.527794,10.406342
37276,2016,Abril,Anguila/Territorio Británico de Ultramar,1,0,,1,-76.532004,3.451668
37277,2016,Mayo,Afganistán,0,1,,1,-74.140516,4.697157
37278,2016,Mayo,Albania,0,1,,1,-74.140516,4.697157
37279,2016,Mayo,Alemania,3,1,,4,-74.77647900000001,10.886686
37280,2016,Mayo,Alemania,0,1,,1,-81.70216500000001,12.5862
37281,2016,Mayo,Alemania,22,39,,61,-76.532004,3.451668
37282,2016,Mayo,Alemania,847,1747,,2594,-74.140516,4.697157
37283,2016,Mayo,Alemania,1,2,,3,-75.736374,4.815189
37284,2016,Mayo,Alemania,20,29,,49,-75.42726,6.170465
37285,2016,Mayo,Alemania,1,0,,1,-73.181317,7.1280470000000005
37286,2016,Mayo,Andorra,2,2,,4,-74.140516,4.697157
37287,2016,Mayo,Angola,1,1,,2,-76.532004,3.451668
37288,2016,Mayo,Angola,0,2,,2,-74.140516,4.697157
37289,2016,Mayo,Antigua y Barbuda,0,1,,1,-75.527794,10.406342
37290,2016,Mayo,Antigua y Barbuda,0,2,,2,-74.140516,4.697157
37291,2016,Mayo,Antigua y Barbuda,0,1,,1,-75.42726,6.170465
37292,2016,Mayo,Antigua y Barbuda,0,1,,1,-75.68164200000001,9.402597
37293,2016,Mayo,Países Bajos,2,13,,15,-75.527794,10.406342
37294,2016,Mayo,Países Bajos,0,1,,1,-75.516486,10.446304
37295,2016,Mayo,Países Bajos,44,62,,106,-74.77647900000001,10.886686
37296,2016,Mayo,Países Bajos,0,11,,11,-74.213989,11.247722999999999
37297,2016,Mayo,Países Bajos,61,147,,208,-76.532004,3.451668
37298,2016,Mayo,Países Bajos,630,1059,,1689,-74.140516,4.697157
37299,2016,Mayo,Países Bajos,0,1,,1,-75.736374,4.815189
37300,2016,Mayo,Países Bajos,220,289,,509,-75.42726,6.170465
37301,2016,Mayo,Países Bajos,7,1,,8,-73.181317,7.1280470000000005
37302,2016,Mayo,Países Bajos,0,2,,2,-75.68164200000001,9.402597
37303,2016,Mayo,Arabia Saudita,2,3,,5,-74.140516,4.697157
37304,2016,Mayo,Arabia Saudita,1,0,,1,-75.42726,6.170465
37305,2016,Mayo,Argelia,0,3,,3,-74.140516,4.697157
37306,2016,Mayo,Argentina,13,20,,33,-77.35600000000001,0.81488
37307,2016,Mayo,Argentina,1,5,,6,-75.527794,10.406342
37308,2016,Mayo,Argentina,38,18,,56,-75.516486,10.446304
37309,2016,Mayo,Argentina,4,5,,9,-74.77647900000001,10.886686
37310,2016,Mayo,Argentina,111,90,,201,-81.70216500000001,12.5862
37311,2016,Mayo,Argentina,34,51,,85,-76.532004,3.451668
37312,2016,Mayo,Argentina,1931,2836,,4767,-74.140516,4.697157
37313,2016,Mayo,Argentina,3,2,,5,-75.736374,4.815189
37314,2016,Mayo,Argentina,76,319,,395,-75.42726,6.170465
37315,2016,Mayo,Argentina,1,1,,2,-73.181317,7.1280470000000005
37316,2016,Mayo,Argentina,1,2,,3,-72.508188,7.927233
37317,2016,Mayo,Aruba,3,5,,8,-75.527794,10.406342
37318,2016,Mayo,Aruba,0,2,,2,-75.516486,10.446304
37319,2016,Mayo,Aruba,0,1,,1,-74.77647900000001,10.886686
37320,2016,Mayo,Aruba,0,8,,8,-74.213989,11.247722999999999
37321,2016,Mayo,Aruba,8,5,,13,-76.532004,3.451668
37322,2016,Mayo,Aruba,600,719,,1319,-74.140516,4.697157
37323,2016,Mayo,Aruba,1,2,,3,-75.736374,4.815189
37324,2016,Mayo,Aruba,106,97,,203,-75.42726,6.170465
37325,2016,Mayo,Aruba,10,11,,21,-73.181317,7.1280470000000005
37326,2016,Mayo,Australia,2,2,,4,-75.516486,10.446304
37327,2016,Mayo,Australia,0,1,,1,-74.77647900000001,10.886686
37328,2016,Mayo,Australia,3,2,,5,-76.532004,3.451668
37329,2016,Mayo,Australia,28,40,,68,-74.140516,4.697157
37330,2016,Mayo,Australia,0,1,,1,-75.736374,4.815189
37331,2016,Mayo,Australia,29,54,,83,-75.42726,6.170465
37332,2016,Mayo,Australia,3,2,,5,-73.181317,7.1280470000000005
37333,2016,Mayo,Austria,0,2,,2,-81.70216500000001,12.5862
37334,2016,Mayo,Austria,0,2,,2,-76.532004,3.451668
37335,2016,Mayo,Austria,12,13,,25,-74.140516,4.697157
37336,2016,Mayo,Austria,0,5,,5,-75.42726,6.170465
37337,2016,Mayo,Azerbaiyán,0,1,,1,-74.140516,4.697157
37338,2016,Mayo,Bahamas,0,3,,3,-75.527794,10.406342
37339,2016,Mayo,Bahamas,1,1,,2,-74.140516,4.697157
37340,2016,Mayo,Bahamas,1,0,,1,-75.42726,6.170465
37341,2016,Mayo,Bahréin,0,1,,1,-75.516486,10.446304
37342,2016,Mayo,Bahréin,1,0,,1,-74.140516,4.697157
37343,2016,Mayo,Bangladesh,0,1,,1,-74.140516,4.697157
37344,2016,Mayo,Barbados,34,45,,79,-74.140516,4.697157
37345,2016,Mayo,República de Belarús,1,2,,3,-74.140516,4.697157
37346,2016,Mayo,República de Belarús,1,1,,2,-72.453013,7.819
37347,2016,Mayo,Bélgica,0,1,,1,-75.527794,10.406342
37348,2016,Mayo,Bélgica,1,1,,2,-74.77647900000001,10.886686
37349,2016,Mayo,Bélgica,4,11,,15,-76.532004,3.451668
37350,2016,Mayo,Bélgica,9,28,,37,-74.140516,4.697157
37351,2016,Mayo,Bélgica,9,11,,20,-75.42726,6.170465
37352,2016,Mayo,Belice,2,3,,5,-74.140516,4.697157
37353,2016,Mayo,Belice,3,0,,3,-75.42726,6.170465
37354,2016,Mayo,Bermudas/Territorio Británico de Ultramar,0,1,,1,-75.42726,6.170465
37355,2016,Mayo,Bolivia,1,0,,1,-77.35600000000001,0.81488
37356,2016,Mayo,Bolivia,6,5,,11,-75.516486,10.446304
37357,2016,Mayo,Bolivia,0,2,,2,-74.77647900000001,10.886686
37358,2016,Mayo,Bolivia,29,21,,50,-81.70216500000001,12.5862
37359,2016,Mayo,Bolivia,16,39,,55,-76.532004,3.451668
37360,2016,Mayo,Bolivia,386,499,,885,-74.140516,4.697157
37361,2016,Mayo,Bolivia,1,2,,3,-75.736374,4.815189
37362,2016,Mayo,Bolivia,64,81,,145,-75.42726,6.170465
37363,2016,Mayo,Bolivia,0,1,,1,-73.181317,7.1280470000000005
37364,2016,Mayo,Bolivia,2,2,,4,-72.508188,7.927233
37365,2016,Mayo,Bosnia y Herzegovina,0,1,,1,-74.140516,4.697157
37366,2016,Mayo,Botsuana,1,0,,1,-74.140516,4.697157
37367,2016,Mayo,Brasil,110,146,,256,-69.941498,4.191162
37368,2016,Mayo,Brasil,1,5,,6,-77.35600000000001,0.81488
37369,2016,Mayo,Brasil,0,3,,3,-75.527794,10.406342
37370,2016,Mayo,Brasil,66,50,,116,-75.516486,10.446304
37371,2016,Mayo,Brasil,4,9,,13,-74.77647900000001,10.886686
37372,2016,Mayo,Brasil,0,3,,3,-74.213989,11.247722999999999
37373,2016,Mayo,Brasil,241,182,,423,-81.70216500000001,12.5862
37374,2016,Mayo,Brasil,74,119,,193,-76.532004,3.451668
37375,2016,Mayo,Brasil,0,3,,3,-67.927521,3.866713
37376,2016,Mayo,Brasil,4539,6090,,10629,-74.140516,4.697157
37377,2016,Mayo,Brasil,2,10,,12,-75.736374,4.815189
37378,2016,Mayo,Brasil,118,229,,347,-75.42726,6.170465
37379,2016,Mayo,Brasil,0,3,,3,-73.181317,7.1280470000000005
37380,2016,Mayo,Brasil,1,4,,5,-72.508188,7.927233
37381,2016,Mayo,Brunei Darussalam,0,1,,1,-74.140516,4.697157
37382,2016,Mayo,Bulgaria,1,4,,5,-74.140516,4.697157
37383,2016,Mayo,Bulgaria,0,1,,1,-75.42726,6.170465
37384,2016,Mayo,Burundi,1,0,,1,-74.140516,4.697157
37385,2016,Mayo,Islas Caimán/Territorio Británico de Ultramar,1,2,,3,-75.527794,10.406342
37386,2016,Mayo,Islas Caimán/Territorio Británico de Ultramar,0,4,,4,-74.77647900000001,10.886686
37387,2016,Mayo,Islas Caimán/Territorio Británico de Ultramar,0,1,,1,-81.70216500000001,12.5862
37388,2016,Mayo,Islas Caimán/Territorio Británico de Ultramar,5,5,,10,-81.372937,13.338761300000002
37389,2016,Mayo,Islas Caimán/Territorio Británico de Ultramar,0,1,,1,-76.532004,3.451668
37390,2016,Mayo,Islas Caimán/Territorio Británico de Ultramar,0,1,,1,-74.140516,4.697157
37391,2016,Mayo,Islas Caimán/Territorio Británico de Ultramar,0,1,,1,-75.42726,6.170465
37392,2016,Mayo,Camerún,0,1,,1,-76.532004,3.451668
37393,2016,Mayo,Camerún,0,1,,1,-74.140516,4.697157
37394,2016,Mayo,Canadá,0,1,,1,-75.527794,10.406342
37395,2016,Mayo,Canadá,12,9,,21,-75.516486,10.446304
37396,2016,Mayo,Canadá,5,6,,11,-74.77647900000001,10.886686
37397,2016,Mayo,Canadá,0,1,,1,-81.70216500000001,12.5862
37398,2016,Mayo,Canadá,32,25,,57,-76.532004,3.451668
37399,2016,Mayo,Canadá,571,844,,1415,-74.140516,4.697157
37400,2016,Mayo,Canadá,4,3,,7,-75.736374,4.815189
37401,2016,Mayo,Canadá,61,182,,243,-75.42726,6.170465
37402,2016,Mayo,Canadá,2,3,,5,-73.181317,7.1280470000000005
37403,2016,Mayo,Canadá,2,3,,5,-72.508188,7.927233
37404,2016,Mayo,Chad,0,1,,1,-74.140516,4.697157
37405,2016,Mayo,España,0,2,,2,-75.527794,10.406342
37406,2016,Mayo,España,0,9,,9,-75.516486,10.446304
37407,2016,Mayo,España,3,3,,6,-74.77647900000001,10.886686
37408,2016,Mayo,España,295,497,,792,-76.532004,3.451668
37409,2016,Mayo,España,1863,4250,,6113,-74.140516,4.697157
37410,2016,Mayo,España,7,4,,11,-75.736374,4.815189
37411,2016,Mayo,España,147,333,,480,-75.42726,6.170465
37412,2016,Mayo,España,1,0,,1,-72.508188,7.927233
37413,2016,Mayo,República de Corea,0,2,,2,-75.527794,10.406342
37414,2016,Mayo,República de Corea,1,0,,1,-74.77647900000001,10.886686
37415,2016,Mayo,República de Corea,0,1,,1,-76.532004,3.451668
37416,2016,Mayo,República de Corea,0,2,,2,-77.061029,3.8844260000000004
37417,2016,Mayo,República de Corea,3,17,,20,-74.140516,4.697157
37418,2016,Mayo,República de Corea,2,7,,9,-75.42726,6.170465
37419,2016,Mayo,Costa de Marfil,0,4,,4,-74.140516,4.697157
37420,2016,Mayo,Costa Rica,4,6,,10,-75.516486,10.446304
37421,2016,Mayo,Costa Rica,15,18,,33,-74.77647900000001,10.886686
37422,2016,Mayo,Costa Rica,0,3,,3,-74.232675,11.117206
37423,2016,Mayo,Costa Rica,0,9,,9,-81.703935,12.574411099999999
37424,2016,Mayo,Costa Rica,99,89,,188,-81.70216500000001,12.5862
37425,2016,Mayo,Costa Rica,23,31,,54,-76.532004,3.451668
37426,2016,Mayo,Costa Rica,0,1,,1,-77.061029,3.8844260000000004
37427,2016,Mayo,Costa Rica,828,1359,,2187,-74.140516,4.697157
37428,2016,Mayo,Costa Rica,5,1,,6,-75.736374,4.815189
37429,2016,Mayo,Costa Rica,63,114,,177,-75.42726,6.170465
37430,2016,Mayo,Costa Rica,1,1,,2,-73.181317,7.1280470000000005
37431,2016,Mayo,Costa Rica,0,1,,1,-72.508188,7.927233
37432,2016,Mayo,Croacia,1,4,,5,-74.140516,4.697157
37433,2016,Mayo,Croacia,0,1,,1,-75.42726,6.170465
37434,2016,Mayo,Cuba,0,1,,1,-75.527794,10.406342
37435,2016,Mayo,Cuba,1,0,,1,-75.516486,10.446304
37436,2016,Mayo,Cuba,2,6,,8,-74.77647900000001,10.886686
37437,2016,Mayo,Cuba,0,1,,1,-74.213989,11.247722999999999
37438,2016,Mayo,Cuba,22,12,,34,-76.532004,3.451668
37439,2016,Mayo,Cuba,286,501,,787,-74.140516,4.697157
37440,2016,Mayo,Cuba,0,3,,3,-75.736374,4.815189
37441,2016,Mayo,Cuba,20,36,,56,-75.42726,6.170465
37442,2016,Mayo,Cuba,2,3,,5,-73.181317,7.1280470000000005
37443,2016,Mayo,Cuba,0,5,,5,-72.508188,7.927233
37444,2016,Mayo,Curazao,0,2,,2,-74.140516,4.697157
37445,2016,Mayo,República Checa,8,8,,16,-74.140516,4.697157
37446,2016,Mayo,Chile,9,10,,19,-77.35600000000001,0.81488
37447,2016,Mayo,Chile,5,0,,5,-75.516486,10.446304
37448,2016,Mayo,Chile,2,4,,6,-74.77647900000001,10.886686
37449,2016,Mayo,Chile,20,15,,35,-81.70216500000001,12.5862
37450,2016,Mayo,Chile,33,48,,81,-76.532004,3.451668
37451,2016,Mayo,Chile,4208,5696,,9904,-74.140516,4.697157
37452,2016,Mayo,Chile,1,1,,2,-75.736374,4.815189
37453,2016,Mayo,Chile,24,47,,71,-75.42726,6.170465
37454,2016,Mayo,Chile,1,2,,3,-72.508188,7.927233
37455,2016,Mayo,China,2,2,,4,-76.532004,3.451668
37456,2016,Mayo,China,31,59,,90,-74.140516,4.697157
37457,2016,Mayo,China,3,11,,14,-75.42726,6.170465
37458,2016,Mayo,Chipre,1,0,,1,-74.140516,4.697157
37459,2016,Mayo,Dinamarca,0,3,,3,-76.532004,3.451668
37460,2016,Mayo,Dinamarca,7,7,,14,-74.140516,4.697157
37461,2016,Mayo,Dinamarca,2,3,,5,-75.42726,6.170465
37462,2016,Mayo,Dinamarca,1,2,,3,-73.181317,7.1280470000000005
37463,2016,Mayo,Dominica,0,3,,3,-74.140516,4.697157
37464,2016,Mayo,Dominica,0,1,,1,-75.42726,6.170465
37465,2016,Mayo,Ecuador,0,2,,2,-74.78366,0.18595699999999998
37466,2016,Mayo,Ecuador,124,272,,396,-76.876446,0.33002
37467,2016,Mayo,Ecuador,2733,4610,,7343,-77.35600000000001,0.81488
37468,2016,Mayo,Ecuador,19,37,,56,-78.802679,18.00143
37469,2016,Mayo,Ecuador,0,1,,1,-75.527794,10.406342
37470,2016,Mayo,Ecuador,5,6,,11,-75.516486,10.446304
37471,2016,Mayo,Ecuador,2,2,,4,-74.77647900000001,10.886686
37472,2016,Mayo,Ecuador,6,5,,11,-81.70216500000001,12.5862
37473,2016,Mayo,Ecuador,320,430,,750,-76.532004,3.451668
37474,2016,Mayo,Ecuador,2,2,,4,-77.061029,3.8844260000000004
37475,2016,Mayo,Ecuador,2541,4069,,6610,-74.140516,4.697157
37476,2016,Mayo,Ecuador,1,0,,1,-75.736374,4.815189
37477,2016,Mayo,Ecuador,35,44,,79,-75.42726,6.170465
37478,2016,Mayo,Ecuador,1,0,,1,-73.181317,7.1280470000000005
37479,2016,Mayo,Ecuador,0,1,,1,-72.508188,7.927233
37480,2016,Mayo,Egipto,0,1,,1,-75.516486,10.446304
37481,2016,Mayo,Egipto,1,2,,3,-74.140516,4.697157
37482,2016,Mayo,El Salvador,1,0,,1,-75.516486,10.446304
37483,2016,Mayo,El Salvador,1,2,,3,-74.77647900000001,10.886686
37484,2016,Mayo,El Salvador,17,18,,35,-81.70216500000001,12.5862
37485,2016,Mayo,El Salvador,97,163,,260,-76.532004,3.451668
37486,2016,Mayo,El Salvador,800,1276,,2076,-74.140516,4.697157
37487,2016,Mayo,El Salvador,160,288,,448,-75.42726,6.170465
37488,2016,Mayo,El Salvador,0,1,,1,-73.181317,7.1280470000000005
37489,2016,Mayo,Emiratos Árabes,0,1,,1,-76.532004,3.451668
37490,2016,Mayo,Emiratos Árabes,1,7,,8,-74.140516,4.697157
37491,2016,Mayo,Emiratos Árabes,0,1,,1,-75.42726,6.170465
37492,2016,Mayo,Emiratos Árabes,0,1,,1,-73.181317,7.1280470000000005
37493,2016,Mayo,Eritrea,1,0,,1,-74.140516,4.697157
37494,2016,Mayo,Eslovaquia,0,1,,1,-76.532004,3.451668
37495,2016,Mayo,Eslovaquia,2,2,,4,-74.140516,4.697157
37496,2016,Mayo,Eslovaquia,1,0,,1,-75.42726,6.170465
37497,2016,Mayo,Eslovenia,0,4,,4,-74.140516,4.697157
37498,2016,Mayo,Estados Unidos de América,1,71,,72,-75.527794,10.406342
37499,2016,Mayo,Estados Unidos de América,2778,3993,,6771,-75.516486,10.446304
37500,2016,Mayo,Estados Unidos de América,577,1034,,1611,-74.77647900000001,10.886686
37501,2016,Mayo,Estados Unidos de América,1,10,,11,-74.765343,10.970933
37502,2016,Mayo,Estados Unidos de América,0,3,,3,-74.232675,11.117206
37503,2016,Mayo,Estados Unidos de América,0,15,,15,-74.213989,11.247722999999999
37504,2016,Mayo,Estados Unidos de América,11,13,,24,-81.70216500000001,12.5862
37505,2016,Mayo,Estados Unidos de América,947,1335,,2282,-76.532004,3.451668
37506,2016,Mayo,Estados Unidos de América,0,4,,4,-77.061029,3.8844260000000004
37507,2016,Mayo,Estados Unidos de América,144,209,,353,-75.76635300000001,4.45285
37508,2016,Mayo,Estados Unidos de América,8002,14405,,22407,-74.140516,4.697157
37509,2016,Mayo,Estados Unidos de América,116,178,,294,-75.736374,4.815189
37510,2016,Mayo,Estados Unidos de América,2489,5712,,8201,-75.42726,6.170465
37511,2016,Mayo,Estados Unidos de América,24,39,,63,-73.181317,7.1280470000000005
37512,2016,Mayo,Estados Unidos de América,29,27,,56,-72.508188,7.927233
37513,2016,Mayo,Estados Unidos de América,0,20,,20,-75.68164200000001,9.402597
37514,2016,Mayo,Estonia,1,0,,1,-74.140516,4.697157
37515,2016,Mayo,Etiopia,0,1,,1,-74.140516,4.697157
37516,2016,Mayo,Filipinas,0,3,,3,-75.516486,10.446304
37517,2016,Mayo,Filipinas,0,6,,6,-76.532004,3.451668
37518,2016,Mayo,Filipinas,4,12,,16,-74.140516,4.697157
37519,2016,Mayo,Filipinas,1,0,,1,-75.42726,6.170465
37520,2016,Mayo,Finlandia,0,1,,1,-76.532004,3.451668
37521,2016,Mayo,Finlandia,10,3,,13,-74.140516,4.697157
37522,2016,Mayo,Finlandia,0,3,,3,-75.42726,6.170465
37523,2016,Mayo,Francia,0,1,,1,-75.516486,10.446304
37524,2016,Mayo,Francia,1,1,,2,-74.77647900000001,10.886686
37525,2016,Mayo,Francia,18,33,,51,-76.532004,3.451668
37526,2016,Mayo,Francia,887,1636,,2523,-74.140516,4.697157
37527,2016,Mayo,Francia,2,3,,5,-75.736374,4.815189
37528,2016,Mayo,Francia,40,94,,134,-75.42726,6.170465
37529,2016,Mayo,Georgia,0,1,,1,-74.140516,4.697157
37530,2016,Mayo,Ghana,0,1,,1,-74.140516,4.697157
37531,2016,Mayo,Grecia,0,1,,1,-74.77647900000001,10.886686
37532,2016,Mayo,Grecia,0,4,,4,-74.213989,11.247722999999999
37533,2016,Mayo,Grecia,0,2,,2,-76.532004,3.451668
37534,2016,Mayo,Grecia,4,6,,10,-74.140516,4.697157
37535,2016,Mayo,Grecia,0,1,,1,-75.42726,6.170465
37536,2016,Mayo,Guatemala,5,5,,10,-75.516486,10.446304
37537,2016,Mayo,Guatemala,2,3,,5,-74.77647900000001,10.886686
37538,2016,Mayo,Guatemala,18,28,,46,-81.70216500000001,12.5862
37539,2016,Mayo,Guatemala,14,37,,51,-76.532004,3.451668
37540,2016,Mayo,Guatemala,305,595,,900,-74.140516,4.697157
37541,2016,Mayo,Guatemala,2,9,,11,-75.736374,4.815189
37542,2016,Mayo,Guatemala,58,149,,207,-75.42726,6.170465
37543,2016,Mayo,Guatemala,2,2,,4,-73.181317,7.1280470000000005
37544,2016,Mayo,Guatemala,6,8,,14,-72.508188,7.927233
37545,2016,Mayo,Guyana,1,1,,2,-75.527794,10.406342
37546,2016,Mayo,Guyana,1,1,,2,-74.77647900000001,10.886686
37547,2016,Mayo,Guyana,1,4,,5,-76.532004,3.451668
37548,2016,Mayo,Guyana,1,0,,1,-74.140516,4.697157
37549,2016,Mayo,Guyana,2,1,,3,-75.42726,6.170465
37550,2016,Mayo,Guadalupe/Territorio Francés,0,4,,4,-74.140516,4.697157
37551,2016,Mayo,Guadalupe/Territorio Francés,0,2,,2,-75.42726,6.170465
37552,2016,Mayo,Guayana Francesa/Departamento de Ultramar Francés,0,1,,1,-75.527794,10.406342
37553,2016,Mayo,Guayana Francesa/Departamento de Ultramar Francés,1,0,,1,-76.532004,3.451668
37554,2016,Mayo,Guayana Francesa/Departamento de Ultramar Francés,1,1,,2,-74.140516,4.697157
37555,2016,Mayo,Haití,0,2,,2,-75.527794,10.406342
37556,2016,Mayo,Haití,2,1,,3,-74.140516,4.697157
37557,2016,Mayo,Honduras,0,2,,2,-75.516486,10.446304
37558,2016,Mayo,Honduras,2,4,,6,-74.77647900000001,10.886686
37559,2016,Mayo,Honduras,0,1,,1,-74.765343,10.970933
37560,2016,Mayo,Honduras,0,2,,2,-81.703935,12.574411099999999
37561,2016,Mayo,Honduras,0,3,,3,-81.70216500000001,12.5862
37562,2016,Mayo,Honduras,0,4,,4,-81.372937,13.338761300000002
37563,2016,Mayo,Honduras,20,42,,62,-76.532004,3.451668
37564,2016,Mayo,Honduras,61,62,,123,-74.140516,4.697157
37565,2016,Mayo,Honduras,2,1,,3,-75.736374,4.815189
37566,2016,Mayo,Honduras,33,49,,82,-75.42726,6.170465
37567,2016,Mayo,Honduras,0,1,,1,-72.508188,7.927233
37568,2016,Mayo,Hong Kong,2,4,,6,-74.140516,4.697157
37569,2016,Mayo,Hong Kong,1,0,,1,-75.42726,6.170465
37570,2016,Mayo,Hungría,2,5,,7,-74.140516,4.697157
37571,2016,Mayo,Hungría,0,1,,1,-75.42726,6.170465
37572,2016,Mayo,India,0,4,,4,-74.213989,11.247722999999999
37573,2016,Mayo,India,0,1,,1,-81.70216500000001,12.5862
37574,2016,Mayo,India,0,6,,6,-76.532004,3.451668
37575,2016,Mayo,India,5,36,,41,-74.140516,4.697157
37576,2016,Mayo,India,1,1,,2,-75.736374,4.815189
37577,2016,Mayo,India,11,19,,30,-75.42726,6.170465
37578,2016,Mayo,Indonesia,1,0,,1,-76.532004,3.451668
37579,2016,Mayo,Indonesia,0,1,,1,-74.140516,4.697157
37580,2016,Mayo,Indonesia,0,1,,1,-75.42726,6.170465
37581,2016,Mayo,República de Irlanda,0,1,,1,-75.516486,10.446304
37582,2016,Mayo,República de Irlanda,0,1,,1,-76.532004,3.451668
37583,2016,Mayo,República de Irlanda,10,14,,24,-74.140516,4.697157
37584,2016,Mayo,República de Irlanda,3,9,,12,-75.42726,6.170465
37585,2016,Mayo,Islandia,0,1,,1,-74.140516,4.697157
37586,2016,Mayo,Israel,0,1,,1,-75.516486,10.446304
37587,2016,Mayo,Israel,5,1,,6,-81.70216500000001,12.5862
37588,2016,Mayo,Israel,0,7,,7,-76.532004,3.451668
37589,2016,Mayo,Israel,20,84,,104,-74.140516,4.697157
37590,2016,Mayo,Israel,2,10,,12,-75.42726,6.170465
37591,2016,Mayo,Italia,1,3,,4,-75.516486,10.446304
37592,2016,Mayo,Italia,1,0,,1,-74.77647900000001,10.886686
37593,2016,Mayo,Italia,0,1,,1,-81.70216500000001,12.5862
37594,2016,Mayo,Italia,6,25,,31,-76.532004,3.451668
37595,2016,Mayo,Italia,0,1,,1,-75.76635300000001,4.45285
37596,2016,Mayo,Italia,60,145,,205,-74.140516,4.697157
37597,2016,Mayo,Italia,1,1,,2,-75.736374,4.815189
37598,2016,Mayo,Italia,18,61,,79,-75.42726,6.170465
37599,2016,Mayo,Italia,1,1,,2,-73.181317,7.1280470000000005
37600,2016,Mayo,Jamaica,3,12,,15,-75.527794,10.406342
37601,2016,Mayo,Jamaica,0,10,,10,-75.516486,10.446304
37602,2016,Mayo,Jamaica,0,3,,3,-74.77647900000001,10.886686
37603,2016,Mayo,Jamaica,1,2,,3,-74.213989,11.247722999999999
37604,2016,Mayo,Jamaica,0,1,,1,-81.70216500000001,12.5862
37605,2016,Mayo,Jamaica,5,8,,13,-81.372937,13.338761300000002
37606,2016,Mayo,Jamaica,0,2,,2,-76.532004,3.451668
37607,2016,Mayo,Jamaica,1,5,,6,-74.140516,4.697157
37608,2016,Mayo,Jamaica,0,4,,4,-75.42726,6.170465
37609,2016,Mayo,Japón,1,1,,2,-81.70216500000001,12.5862
37610,2016,Mayo,Japón,1,1,,2,-76.532004,3.451668
37611,2016,Mayo,Japón,4,21,,25,-74.140516,4.697157
37612,2016,Mayo,Japón,16,21,,37,-75.42726,6.170465
37613,2016,Mayo,Jordania,1,1,,2,-74.140516,4.697157
37614,2016,Mayo,Kazajistán,1,1,,2,-74.140516,4.697157
37615,2016,Mayo,Kenia,2,0,,2,-74.140516,4.697157
37616,2016,Mayo,Kenia,0,1,,1,-75.42726,6.170465
37617,2016,Mayo,Letonia,1,0,,1,-76.532004,3.451668
37618,2016,Mayo,Letonia,0,4,,4,-74.140516,4.697157
37619,2016,Mayo,Letonia,2,6,,8,-75.42726,6.170465
37620,2016,Mayo,Lituania,0,1,,1,-76.532004,3.451668
37621,2016,Mayo,Lituania,1,3,,4,-74.140516,4.697157
37622,2016,Mayo,Líbano,2,8,,10,-74.140516,4.697157
37623,2016,Mayo,Liechtenstein,1,0,,1,-74.140516,4.697157
37624,2016,Mayo,Luxemburgo,1,2,,3,-74.140516,4.697157
37625,2016,Mayo,Malasia,0,1,,1,-74.140516,4.697157
37626,2016,Mayo,Malta,2,1,,3,-75.42726,6.170465
37627,2016,Mayo,Martinica/Departamento de Ultramar Francés,0,2,,2,-75.527794,10.406342
37628,2016,Mayo,México,2,8,,10,-75.527794,10.406342
37629,2016,Mayo,México,6,25,,31,-75.516486,10.446304
37630,2016,Mayo,México,11,29,,40,-74.77647900000001,10.886686
37631,2016,Mayo,México,12,8,,20,-81.70216500000001,12.5862
37632,2016,Mayo,México,70,175,,245,-76.532004,3.451668
37633,2016,Mayo,México,4395,8094,,12489,-74.140516,4.697157
37634,2016,Mayo,México,14,29,,43,-75.736374,4.815189
37635,2016,Mayo,México,431,987,,1418,-75.42726,6.170465
37636,2016,Mayo,México,6,6,,12,-73.181317,7.1280470000000005
37637,2016,Mayo,México,13,8,,21,-72.508188,7.927233
37638,2016,Mayo,Mónaco,1,1,,2,-74.140516,4.697157
37639,2016,Mayo,Mozambique,1,0,,1,-74.140516,4.697157
37640,2016,Mayo,Nicaragua,1,2,,3,-74.77647900000001,10.886686
37641,2016,Mayo,Nicaragua,2,1,,3,-81.70216500000001,12.5862
37642,2016,Mayo,Nicaragua,0,3,,3,-76.532004,3.451668
37643,2016,Mayo,Nicaragua,16,39,,55,-74.140516,4.697157
37644,2016,Mayo,Nicaragua,2,6,,8,-75.736374,4.815189
37645,2016,Mayo,Nicaragua,5,16,,21,-75.42726,6.170465
37646,2016,Mayo,Nicaragua,0,1,,1,-72.508188,7.927233
37647,2016,Mayo,Nigeria,1,0,,1,-74.140516,4.697157
37648,2016,Mayo,Noruega,0,12,,12,-75.527794,10.406342
37649,2016,Mayo,Noruega,2,5,,7,-76.532004,3.451668
37650,2016,Mayo,Noruega,3,13,,16,-74.140516,4.697157
37651,2016,Mayo,Noruega,2,4,,6,-75.42726,6.170465
37652,2016,Mayo,Noruega,2,2,,4,-73.181317,7.1280470000000005
37653,2016,Mayo,Nueva Zelanda,0,2,,2,-76.532004,3.451668
37654,2016,Mayo,Nueva Zelanda,5,11,,16,-74.140516,4.697157
37655,2016,Mayo,Nueva Zelanda,4,9,,13,-75.42726,6.170465
37656,2016,Mayo,Pakistán,0,1,,1,-76.532004,3.451668
37657,2016,Mayo,Pakistán,0,1,,1,-74.140516,4.697157
37658,2016,Mayo,Panamá,1550,1159,,2709,-75.527794,10.406342
37659,2016,Mayo,Panamá,2589,2939,,5528,-75.516486,10.446304
37660,2016,Mayo,Panamá,198,425,,623,-74.77647900000001,10.886686
37661,2016,Mayo,Panamá,0,12,,12,-74.765343,10.970933
37662,2016,Mayo,Panamá,0,1,,1,-74.232675,11.117206
37663,2016,Mayo,Panamá,0,2,,2,-74.213989,11.247722999999999
37664,2016,Mayo,Panamá,4,10,,14,-81.703935,12.574411099999999
37665,2016,Mayo,Panamá,315,269,,584,-81.70216500000001,12.5862
37666,2016,Mayo,Panamá,5,5,,10,-81.372937,13.338761300000002
37667,2016,Mayo,Panamá,239,411,,650,-76.532004,3.451668
37668,2016,Mayo,Panamá,0,10,,10,-77.061029,3.8844260000000004
37669,2016,Mayo,Panamá,88,136,,224,-75.76635300000001,4.45285
37670,2016,Mayo,Panamá,3510,5421,,8931,-74.140516,4.697157
37671,2016,Mayo,Panamá,30,70,,100,-75.736374,4.815189
37672,2016,Mayo,Panamá,1569,2508,,4077,-75.42726,6.170465
37673,2016,Mayo,Panamá,0,3,,3,-77.401154,6.222551999999999
37674,2016,Mayo,Panamá,1,1,,2,-77.762647,7.102626
37675,2016,Mayo,Panamá,13,15,,28,-73.181317,7.1280470000000005
37676,2016,Mayo,Panamá,29,55,,84,-72.508188,7.927233
37677,2016,Mayo,Panamá,101,126,,227,-77.35002,8.63337
37678,2016,Mayo,Panamá,0,2,,2,-75.68164200000001,9.402597
37679,2016,Mayo,Paraguay,3,5,,8,-75.516486,10.446304
37680,2016,Mayo,Paraguay,1,4,,5,-74.77647900000001,10.886686
37681,2016,Mayo,Paraguay,48,41,,89,-81.70216500000001,12.5862
37682,2016,Mayo,Paraguay,5,5,,10,-76.532004,3.451668
37683,2016,Mayo,Paraguay,40,40,,80,-74.140516,4.697157
37684,2016,Mayo,Paraguay,1,1,,2,-75.736374,4.815189
37685,2016,Mayo,Paraguay,7,29,,36,-75.42726,6.170465
37686,2016,Mayo,Paraguay,2,1,,3,-72.508188,7.927233
37687,2016,Mayo,Perú,146,207,,353,-69.941498,4.191162
37688,2016,Mayo,Perú,0,3,,3,-74.78366,0.18595699999999998
37689,2016,Mayo,Perú,17,36,,53,-77.35600000000001,0.81488
37690,2016,Mayo,Perú,1,7,,8,-75.527794,10.406342
37691,2016,Mayo,Perú,18,12,,30,-75.516486,10.446304
37692,2016,Mayo,Perú,3,3,,6,-74.77647900000001,10.886686
37693,2016,Mayo,Perú,185,113,,298,-81.70216500000001,12.5862
37694,2016,Mayo,Perú,292,507,,799,-76.532004,3.451668
37695,2016,Mayo,Perú,5348,7543,,12891,-74.140516,4.697157
37696,2016,Mayo,Perú,2,1,,3,-75.736374,4.815189
37697,2016,Mayo,Perú,423,838,,1261,-75.42726,6.170465
37698,2016,Mayo,Perú,0,1,,1,-72.508188,7.927233
37699,2016,Mayo,Polonia,0,2,,2,-74.77647900000001,10.886686
37700,2016,Mayo,Polonia,1,1,,2,-76.532004,3.451668
37701,2016,Mayo,Polonia,5,14,,19,-74.140516,4.697157
37702,2016,Mayo,Polonia,2,2,,4,-75.42726,6.170465
37703,2016,Mayo,Portugal,0,1,,1,-75.527794,10.406342
37704,2016,Mayo,Portugal,2,5,,7,-76.532004,3.451668
37705,2016,Mayo,Portugal,17,31,,48,-74.140516,4.697157
37706,2016,Mayo,Portugal,3,6,,9,-75.42726,6.170465
37707,2016,Mayo,Portugal,0,1,,1,-73.181317,7.1280470000000005
37708,2016,Mayo,Puerto Rico/Territorio de Estados Unidos,0,2,,2,-75.527794,10.406342
37709,2016,Mayo,Puerto Rico/Territorio de Estados Unidos,1,4,,5,-75.516486,10.446304
37710,2016,Mayo,Puerto Rico/Territorio de Estados Unidos,8,42,,50,-74.77647900000001,10.886686
37711,2016,Mayo,Puerto Rico/Territorio de Estados Unidos,1,1,,2,-81.70216500000001,12.5862
37712,2016,Mayo,Puerto Rico/Territorio de Estados Unidos,39,70,,109,-76.532004,3.451668
37713,2016,Mayo,Puerto Rico/Territorio de Estados Unidos,271,352,,623,-74.140516,4.697157
37714,2016,Mayo,Puerto Rico/Territorio de Estados Unidos,2,3,,5,-75.736374,4.815189
37715,2016,Mayo,Puerto Rico/Territorio de Estados Unidos,36,70,,106,-75.42726,6.170465
37716,2016,Mayo,Puerto Rico/Territorio de Estados Unidos,1,2,,3,-73.181317,7.1280470000000005
37717,2016,Mayo,Puerto Rico/Territorio de Estados Unidos,0,1,,1,-72.508188,7.927233
37718,2016,Mayo,Reino Unido de Gran Bretaña e Irlanda del Norte,2,0,,2,-75.516486,10.446304
37719,2016,Mayo,Reino Unido de Gran Bretaña e Irlanda del Norte,11,13,,24,-76.532004,3.451668
37720,2016,Mayo,Reino Unido de Gran Bretaña e Irlanda del Norte,481,930,,1411,-74.140516,4.697157
37721,2016,Mayo,Reino Unido de Gran Bretaña e Irlanda del Norte,3,0,,3,-75.736374,4.815189
37722,2016,Mayo,Reino Unido de Gran Bretaña e Irlanda del Norte,40,86,,126,-75.42726,6.170465
37723,2016,Mayo,República CentroÁfricana,0,1,,1,-74.140516,4.697157
37724,2016,Mayo,Federación de Rusia,0,1,,1,-74.77647900000001,10.886686
37725,2016,Mayo,Federación de Rusia,0,1,,1,-81.70216500000001,12.5862
37726,2016,Mayo,Federación de Rusia,0,1,,1,-76.532004,3.451668
37727,2016,Mayo,Federación de Rusia,13,25,,38,-74.140516,4.697157
37728,2016,Mayo,Federación de Rusia,3,1,,4,-75.42726,6.170465
37729,2016,Mayo,República Dominicana,0,6,,6,-75.527794,10.406342
37730,2016,Mayo,República Dominicana,3,6,,9,-75.516486,10.446304
37731,2016,Mayo,República Dominicana,8,24,,32,-74.77647900000001,10.886686
37732,2016,Mayo,República Dominicana,1,0,,1,-74.213989,11.247722999999999
37733,2016,Mayo,República Dominicana,4,4,,8,-81.70216500000001,12.5862
37734,2016,Mayo,República Dominicana,8,31,,39,-76.532004,3.451668
37735,2016,Mayo,República Dominicana,521,720,,1241,-74.140516,4.697157
37736,2016,Mayo,República Dominicana,6,9,,15,-75.736374,4.815189
37737,2016,Mayo,República Dominicana,35,53,,88,-75.42726,6.170465
37738,2016,Mayo,República Dominicana,0,2,,2,-73.181317,7.1280470000000005
37739,2016,Mayo,República Dominicana,1,5,,6,-72.508188,7.927233
37740,2016,Mayo,Rumania,3,7,,10,-74.140516,4.697157
37741,2016,Mayo,San Cristóbal y Nevis,0,1,,1,-74.140516,4.697157
37742,2016,Mayo,San Cristóbal y Nevis,0,2,,2,-75.42726,6.170465
37743,2016,Mayo,San  Vicente y las Granadinas,0,1,,1,-76.532004,3.451668
37744,2016,Mayo,Serbia,0,1,,1,-75.42726,6.170465
37745,2016,Mayo,Sierra Leona,0,1,,1,-76.532004,3.451668
37746,2016,Mayo,Singapur,0,1,,1,-74.140516,4.697157
37747,2016,Mayo,Singapur,1,1,,2,-75.42726,6.170465
37748,2016,Mayo,Sudáfrica,1,7,,8,-74.140516,4.697157
37749,2016,Mayo,Sudáfrica,0,5,,5,-75.42726,6.170465
37750,2016,Mayo,Suecia,1,0,,1,-75.516486,10.446304
37751,2016,Mayo,Suecia,5,2,,7,-76.532004,3.451668
37752,2016,Mayo,Suecia,12,15,,27,-74.140516,4.697157
37753,2016,Mayo,Suecia,2,5,,7,-75.42726,6.170465
37754,2016,Mayo,Suiza,0,1,,1,-75.516486,10.446304
37755,2016,Mayo,Suiza,0,2,,2,-74.77647900000001,10.886686
37756,2016,Mayo,Suiza,7,12,,19,-76.532004,3.451668
37757,2016,Mayo,Suiza,29,65,,94,-74.140516,4.697157
37758,2016,Mayo,Suiza,13,11,,24,-75.42726,6.170465
37759,2016,Mayo,Suiza,3,1,,4,-72.508188,7.927233
37760,2016,Mayo,Surinam,1,1,,2,-74.140516,4.697157
37761,2016,Mayo,Surinam,0,7,,7,-75.42726,6.170465
37762,2016,Mayo,Taiwán,0,4,,4,-74.140516,4.697157
37763,2016,Mayo,Taiwán,2,3,,5,-75.42726,6.170465
37764,2016,Mayo,Tailandia,0,1,,1,-76.532004,3.451668
37765,2016,Mayo,Tailandia,4,1,,5,-74.140516,4.697157
37766,2016,Mayo,Trinidad y Tobago,0,3,,3,-74.77647900000001,10.886686
37767,2016,Mayo,Trinidad y Tobago,1,5,,6,-76.532004,3.451668
37768,2016,Mayo,Trinidad y Tobago,2,8,,10,-74.140516,4.697157
37769,2016,Mayo,Trinidad y Tobago,0,1,,1,-75.736374,4.815189
37770,2016,Mayo,Trinidad y Tobago,0,16,,16,-75.42726,6.170465
37771,2016,Mayo,Túnez,0,1,,1,-74.140516,4.697157
37772,2016,Mayo,Turkmenistán,2,5,,7,-74.140516,4.697157
37773,2016,Mayo,Turquía,298,489,,787,-74.140516,4.697157
37774,2016,Mayo,Ucrania,2,1,,3,-74.140516,4.697157
37775,2016,Mayo,Uruguay,4,5,,9,-75.516486,10.446304
37776,2016,Mayo,Uruguay,0,2,,2,-74.77647900000001,10.886686
37777,2016,Mayo,Uruguay,20,11,,31,-81.70216500000001,12.5862
37778,2016,Mayo,Uruguay,12,14,,26,-76.532004,3.451668
37779,2016,Mayo,Uruguay,67,83,,150,-74.140516,4.697157
37780,2016,Mayo,Uruguay,27,54,,81,-75.42726,6.170465
37781,2016,Mayo,Venezuela,0,14,,14,-75.527794,10.406342
37782,2016,Mayo,Venezuela,1,3,,4,-75.516486,10.446304
37783,2016,Mayo,Venezuela,12,44,,56,-74.77647900000001,10.886686
37784,2016,Mayo,Venezuela,0,2,,2,-74.765343,10.970933
37785,2016,Mayo,Venezuela,1,10,,11,-74.232675,11.117206
37786,2016,Mayo,Venezuela,0,7,,7,-74.213989,11.247722999999999
37787,2016,Mayo,Venezuela,418,677,,1095,-72.129595,11.360028999999999
37788,2016,Mayo,Venezuela,1,1,,2,-81.70216500000001,12.5862
37789,2016,Mayo,Venezuela,8,22,,30,-76.532004,3.451668
37790,2016,Mayo,Venezuela,32,39,,71,-67.927521,3.866713
37791,2016,Mayo,Venezuela,3120,4011,,7131,-74.140516,4.697157
37792,2016,Mayo,Venezuela,0,6,,6,-75.736374,4.815189
37793,2016,Mayo,Venezuela,492,588,,1080,-75.42726,6.170465
37794,2016,Mayo,Venezuela,47,54,,101,-67.48402800000001,6.185536
37795,2016,Mayo,Venezuela,60,71,,131,-70.74025300000001,7.088728999999999
37796,2016,Mayo,Venezuela,3,2,,5,-73.181317,7.1280470000000005
37797,2016,Mayo,Venezuela,1513,2147,,3660,-72.453013,7.819
37798,2016,Mayo,Venezuela,136,172,,308,-72.508188,7.927233
37799,2016,Mayo,Islas Vírgenes Británicas/Territorio Británico de Ultramar,0,1,,1,-75.527794,10.406342
37800,2016,Mayo,Islas Vírgenes Británicas/Territorio Británico de Ultramar,0,1,,1,-74.140516,4.697157
37801,2016,Mayo,Zimbabue,0,1,,1,-74.140516,4.697157
37802,2016,Mayo,Zimbabue,3,2,,5,-75.42726,6.170465
37803,2016,Mayo,Islas Turcas y Caicos/Territorio Británico de Ultramar,2,4,,6,-74.140516,4.697157
37804,2016,Mayo,Desconocido,0,1,,1,-69.941498,4.191162
37805,2016,Mayo,Desconocido,0,1,,1,-76.532004,3.451668
37806,2016,Junio,Afganistán,1,0,,1,-74.140516,4.697157
37807,2016,Junio,Afganistán,0,1,,1,-75.42726,6.170465
37808,2016,Junio,Alemania,1,1,,2,-75.516486,10.446304
37809,2016,Junio,Alemania,4,3,,7,-74.77647900000001,10.886686
37810,2016,Junio,Alemania,37,36,,73,-76.532004,3.451668
37811,2016,Junio,Alemania,1024,1805,,2829,-74.140516,4.697157
37812,2016,Junio,Alemania,1,2,,3,-75.736374,4.815189
37813,2016,Junio,Alemania,19,27,,46,-75.42726,6.170465
37814,2016,Junio,Antigua y Barbuda,1,2,,3,-74.140516,4.697157
37815,2016,Junio,Antigua y Barbuda,0,1,,1,-75.42726,6.170465
37816,2016,Junio,Países Bajos,0,3,,3,-75.527794,10.406342
37817,2016,Junio,Países Bajos,2,6,,8,-75.516486,10.446304
37818,2016,Junio,Países Bajos,34,64,,98,-74.77647900000001,10.886686
37819,2016,Junio,Países Bajos,1,1,,2,-74.213989,11.247722999999999
37820,2016,Junio,Países Bajos,74,111,,185,-76.532004,3.451668
37821,2016,Junio,Países Bajos,619,963,,1582,-74.140516,4.697157
37822,2016,Junio,Países Bajos,0,3,,3,-75.736374,4.815189
37823,2016,Junio,Países Bajos,142,205,,347,-75.42726,6.170465
37824,2016,Junio,Países Bajos,0,1,,1,-73.181317,7.1280470000000005
37825,2016,Junio,Países Bajos,0,1,,1,-72.508188,7.927233
37826,2016,Junio,Arabia Saudita,0,1,,1,-76.532004,3.451668
37827,2016,Junio,Arabia Saudita,0,2,,2,-74.140516,4.697157
37828,2016,Junio,Arabia Saudita,0,1,,1,-75.42726,6.170465
37829,2016,Junio,Argelia,4,4,,8,-74.140516,4.697157
37830,2016,Junio,Argentina,4,14,,18,-77.35600000000001,0.81488
37831,2016,Junio,Argentina,1,14,,15,-75.527794,10.406342
37832,2016,Junio,Argentina,21,15,,36,-75.516486,10.446304
37833,2016,Junio,Argentina,2,8,,10,-74.77647900000001,10.886686
37834,2016,Junio,Argentina,94,61,,155,-81.70216500000001,12.5862
37835,2016,Junio,Argentina,35,78,,113,-76.532004,3.451668
37836,2016,Junio,Argentina,2036,2988,,5024,-74.140516,4.697157
37837,2016,Junio,Argentina,3,9,,12,-75.736374,4.815189
37838,2016,Junio,Argentina,35,116,,151,-75.42726,6.170465
37839,2016,Junio,Argentina,1,2,,3,-73.181317,7.1280470000000005
37840,2016,Junio,Argentina,1,1,,2,-72.508188,7.927233
37841,2016,Junio,República de Armenia,1,0,,1,-74.140516,4.697157
37842,2016,Junio,Aruba,1,8,,9,-75.527794,10.406342
37843,2016,Junio,Aruba,4,6,,10,-74.77647900000001,10.886686
37844,2016,Junio,Aruba,3,16,,19,-74.213989,11.247722999999999
37845,2016,Junio,Aruba,7,9,,16,-76.532004,3.451668
37846,2016,Junio,Aruba,564,681,,1245,-74.140516,4.697157
37847,2016,Junio,Aruba,0,2,,2,-75.736374,4.815189
37848,2016,Junio,Aruba,52,93,,145,-75.42726,6.170465
37849,2016,Junio,Aruba,21,10,,31,-73.181317,7.1280470000000005
37850,2016,Junio,Aruba,0,1,,1,-75.68164200000001,9.402597
37851,2016,Junio,Australia,13,7,,20,-76.532004,3.451668
37852,2016,Junio,Australia,39,62,,101,-74.140516,4.697157
37853,2016,Junio,Australia,8,15,,23,-75.42726,6.170465
37854,2016,Junio,Australia,1,2,,3,-73.181317,7.1280470000000005
37855,2016,Junio,Austria,0,1,,1,-76.532004,3.451668
37856,2016,Junio,Austria,10,24,,34,-74.140516,4.697157
37857,2016,Junio,Austria,3,2,,5,-75.42726,6.170465
37858,2016,Junio,Azerbaiyán,1,2,,3,-74.140516,4.697157
37859,2016,Junio,Bahamas,0,1,,1,-74.77647900000001,10.886686
37860,2016,Junio,Bahamas,2,1,,3,-74.140516,4.697157
37861,2016,Junio,Bahamas,1,3,,4,-75.42726,6.170465
37862,2016,Junio,Bahamas,0,5,,5,-75.68164200000001,9.402597
37863,2016,Junio,Barbados,27,44,,71,-74.140516,4.697157
37864,2016,Junio,República de Belarús,2,1,,3,-74.140516,4.697157
37865,2016,Junio,Bélgica,16,10,,26,-76.532004,3.451668
37866,2016,Junio,Bélgica,40,50,,90,-74.140516,4.697157
37867,2016,Junio,Bélgica,1,2,,3,-75.736374,4.815189
37868,2016,Junio,Bélgica,23,35,,58,-75.42726,6.170465
37869,2016,Junio,Belice,2,0,,2,-81.70216500000001,12.5862
37870,2016,Junio,Belice,1,0,,1,-76.532004,3.451668
37871,2016,Junio,Belice,1,4,,5,-74.140516,4.697157
37872,2016,Junio,Belice,0,2,,2,-75.42726,6.170465
37873,2016,Junio,Benín,1,0,,1,-75.42726,6.170465
37874,2016,Junio,Bermudas/Territorio Británico de Ultramar,0,2,,2,-75.527794,10.406342
37875,2016,Junio,Bermudas/Territorio Británico de Ultramar,0,1,,1,-74.140516,4.697157
37876,2016,Junio,Bolivia,6,7,,13,-75.516486,10.446304
37877,2016,Junio,Bolivia,0,1,,1,-74.77647900000001,10.886686
37878,2016,Junio,Bolivia,31,26,,57,-81.70216500000001,12.5862
37879,2016,Junio,Bolivia,20,28,,48,-76.532004,3.451668
37880,2016,Junio,Bolivia,412,581,,993,-74.140516,4.697157
37881,2016,Junio,Bolivia,3,2,,5,-75.736374,4.815189
37882,2016,Junio,Bolivia,47,51,,98,-75.42726,6.170465
37883,2016,Junio,Bolivia,0,4,,4,-73.181317,7.1280470000000005
37884,2016,Junio,Brasil,134,149,,283,-69.941498,4.191162
37885,2016,Junio,Brasil,6,2,,8,-69.94143100000001,4.214082
37886,2016,Junio,Brasil,0,1,,1,-77.35600000000001,0.81488
37887,2016,Junio,Brasil,0,29,,29,-75.527794,10.406342
37888,2016,Junio,Brasil,17,14,,31,-75.516486,10.446304
37889,2016,Junio,Brasil,4,8,,12,-74.77647900000001,10.886686
37890,2016,Junio,Brasil,181,118,,299,-81.70216500000001,12.5862
37891,2016,Junio,Brasil,39,81,,120,-76.532004,3.451668
37892,2016,Junio,Brasil,0,2,,2,-67.927521,3.866713
37893,2016,Junio,Brasil,4067,5920,,9987,-74.140516,4.697157
37894,2016,Junio,Brasil,3,1,,4,-75.736374,4.815189
37895,2016,Junio,Brasil,54,119,,173,-75.42726,6.170465
37896,2016,Junio,Brasil,1,1,,2,-73.181317,7.1280470000000005
37897,2016,Junio,Bulgaria,2,1,,3,-74.140516,4.697157
37898,2016,Junio,Bulgaria,0,2,,2,-75.42726,6.170465
37899,2016,Junio,Cabo Verde,0,16,,16,-75.527794,10.406342
37900,2016,Junio,Islas Caimán/Territorio Británico de Ultramar,0,1,,1,-74.77647900000001,10.886686
37901,2016,Junio,Islas Caimán/Territorio Británico de Ultramar,1,1,,2,-81.703935,12.574411099999999
37902,2016,Junio,Islas Caimán/Territorio Británico de Ultramar,0,1,,1,-81.70216500000001,12.5862
37903,2016,Junio,Islas Caimán/Territorio Británico de Ultramar,2,3,,5,-81.372937,13.338761300000002
37904,2016,Junio,Islas Caimán/Territorio Británico de Ultramar,0,3,,3,-74.140516,4.697157
37905,2016,Junio,Camboya,0,1,,1,-74.140516,4.697157
37906,2016,Junio,Canadá,5,6,,11,-75.516486,10.446304
37907,2016,Junio,Canadá,3,5,,8,-74.77647900000001,10.886686
37908,2016,Junio,Canadá,39,48,,87,-76.532004,3.451668
37909,2016,Junio,Canadá,0,1,,1,-75.76635300000001,4.45285
37910,2016,Junio,Canadá,554,906,,1460,-74.140516,4.697157
37911,2016,Junio,Canadá,9,8,,17,-75.736374,4.815189
37912,2016,Junio,Canadá,53,96,,149,-75.42726,6.170465
37913,2016,Junio,Canadá,2,6,,8,-73.181317,7.1280470000000005
37914,2016,Junio,Canadá,4,2,,6,-72.508188,7.927233
37915,2016,Junio,España,0,8,,8,-75.527794,10.406342
37916,2016,Junio,España,2,1,,3,-75.516486,10.446304
37917,2016,Junio,España,11,8,,19,-74.77647900000001,10.886686
37918,2016,Junio,España,540,741,,1281,-76.532004,3.451668
37919,2016,Junio,España,2482,4457,,6939,-74.140516,4.697157
37920,2016,Junio,España,6,9,,15,-75.736374,4.815189
37921,2016,Junio,España,273,441,,714,-75.42726,6.170465
37922,2016,Junio,España,4,3,,7,-73.181317,7.1280470000000005
37923,2016,Junio,República de Corea,0,3,,3,-74.213989,11.247722999999999
37924,2016,Junio,República de Corea,1,2,,3,-76.532004,3.451668
37925,2016,Junio,República de Corea,13,25,,38,-74.140516,4.697157
37926,2016,Junio,República de Corea,2,4,,6,-75.42726,6.170465
37927,2016,Junio,Costa de Marfil,1,1,,2,-74.140516,4.697157
37928,2016,Junio,Costa de Marfil,0,1,,1,-72.508188,7.927233
37929,2016,Junio,Costa Rica,1,5,,6,-75.527794,10.406342
37930,2016,Junio,Costa Rica,1,1,,2,-75.516486,10.446304
37931,2016,Junio,Costa Rica,9,9,,18,-74.77647900000001,10.886686
37932,2016,Junio,Costa Rica,0,9,,9,-81.703935,12.574411099999999
37933,2016,Junio,Costa Rica,102,88,,190,-81.70216500000001,12.5862
37934,2016,Junio,Costa Rica,29,26,,55,-76.532004,3.451668
37935,2016,Junio,Costa Rica,953,1385,,2338,-74.140516,4.697157
37936,2016,Junio,Costa Rica,5,0,,5,-75.736374,4.815189
37937,2016,Junio,Costa Rica,72,137,,209,-75.42726,6.170465
37938,2016,Junio,Costa Rica,1,3,,4,-73.181317,7.1280470000000005
37939,2016,Junio,Costa Rica,1,1,,2,-72.508188,7.927233
37940,2016,Junio,Croacia,1,2,,3,-74.140516,4.697157
37941,2016,Junio,Croacia,0,1,,1,-75.42726,6.170465
37942,2016,Junio,Cuba,0,2,,2,-75.527794,10.406342
37943,2016,Junio,Cuba,1,4,,5,-75.516486,10.446304
37944,2016,Junio,Cuba,6,4,,10,-74.77647900000001,10.886686
37945,2016,Junio,Cuba,0,1,,1,-74.765343,10.970933
37946,2016,Junio,Cuba,0,1,,1,-81.70216500000001,12.5862
37947,2016,Junio,Cuba,0,2,,2,-81.372937,13.338761300000002
37948,2016,Junio,Cuba,12,16,,28,-76.532004,3.451668
37949,2016,Junio,Cuba,223,409,,632,-74.140516,4.697157
37950,2016,Junio,Cuba,4,3,,7,-75.736374,4.815189
37951,2016,Junio,Cuba,8,21,,29,-75.42726,6.170465
37952,2016,Junio,Cuba,1,1,,2,-73.181317,7.1280470000000005
37953,2016,Junio,Cuba,1,1,,2,-72.508188,7.927233
37954,2016,Junio,Curazao,0,3,,3,-74.140516,4.697157
37955,2016,Junio,República Checa,3,7,,10,-74.140516,4.697157
37956,2016,Junio,República Checa,0,1,,1,-75.42726,6.170465
37957,2016,Junio,Chile,3,9,,12,-77.35600000000001,0.81488
37958,2016,Junio,Chile,0,3,,3,-75.527794,10.406342
37959,2016,Junio,Chile,12,4,,16,-75.516486,10.446304
37960,2016,Junio,Chile,1,3,,4,-74.77647900000001,10.886686
37961,2016,Junio,Chile,53,30,,83,-81.70216500000001,12.5862
37962,2016,Junio,Chile,17,48,,65,-76.532004,3.451668
37963,2016,Junio,Chile,4276,5953,,10229,-74.140516,4.697157
37964,2016,Junio,Chile,2,1,,3,-75.736374,4.815189
37965,2016,Junio,Chile,27,43,,70,-75.42726,6.170465
37966,2016,Junio,Chile,2,2,,4,-73.181317,7.1280470000000005
37967,2016,Junio,Chile,0,2,,2,-72.508188,7.927233
37968,2016,Junio,China,2,2,,4,-76.532004,3.451668
37969,2016,Junio,China,40,79,,119,-74.140516,4.697157
37970,2016,Junio,China,0,1,,1,-75.736374,4.815189
37971,2016,Junio,China,3,5,,8,-75.42726,6.170465
37972,2016,Junio,Chipre,0,1,,1,-74.140516,4.697157
37973,2016,Junio,Dinamarca,0,3,,3,-76.532004,3.451668
37974,2016,Junio,Dinamarca,18,15,,33,-74.140516,4.697157
37975,2016,Junio,Dinamarca,1,0,,1,-72.508188,7.927233
37976,2016,Junio,Ecuador,2,6,,8,-74.78366,0.18595699999999998
37977,2016,Junio,Ecuador,95,275,,370,-76.876446,0.33002
37978,2016,Junio,Ecuador,2680,4309,,6989,-77.35600000000001,0.81488
37979,2016,Junio,Ecuador,35,101,,136,-78.802679,18.00143
37980,2016,Junio,Ecuador,0,6,,6,-75.527794,10.406342
37981,2016,Junio,Ecuador,3,13,,16,-75.516486,10.446304
37982,2016,Junio,Ecuador,0,4,,4,-74.77647900000001,10.886686
37983,2016,Junio,Ecuador,0,2,,2,-74.213989,11.247722999999999
37984,2016,Junio,Ecuador,29,28,,57,-81.70216500000001,12.5862
37985,2016,Junio,Ecuador,244,389,,633,-76.532004,3.451668
37986,2016,Junio,Ecuador,0,1,,1,-77.061029,3.8844260000000004
37987,2016,Junio,Ecuador,2703,4228,,6931,-74.140516,4.697157
37988,2016,Junio,Ecuador,0,1,,1,-75.736374,4.815189
37989,2016,Junio,Ecuador,23,42,,65,-75.42726,6.170465
37990,2016,Junio,Ecuador,1,2,,3,-73.181317,7.1280470000000005
37991,2016,Junio,Ecuador,5,2,,7,-72.508188,7.927233
37992,2016,Junio,Egipto,3,3,,6,-74.140516,4.697157
37993,2016,Junio,El Salvador,2,15,,17,-75.516486,10.446304
37994,2016,Junio,El Salvador,1,5,,6,-74.77647900000001,10.886686
37995,2016,Junio,El Salvador,37,29,,66,-81.70216500000001,12.5862
37996,2016,Junio,El Salvador,131,194,,325,-76.532004,3.451668
37997,2016,Junio,El Salvador,824,1324,,2148,-74.140516,4.697157
37998,2016,Junio,El Salvador,0,1,,1,-75.736374,4.815189
37999,2016,Junio,El Salvador,170,227,,397,-75.42726,6.170465
38000,2016,Junio,Emiratos Árabes,2,1,,3,-76.532004,3.451668
38001,2016,Junio,Emiratos Árabes,8,6,,14,-74.140516,4.697157
38002,2016,Junio,Eslovaquia,3,4,,7,-74.140516,4.697157
38003,2016,Junio,Eslovenia,1,2,,3,-74.140516,4.697157
38004,2016,Junio,Eslovenia,1,1,,2,-75.42726,6.170465
38005,2016,Junio,Estados Unidos de América,0,28,,28,-75.527794,10.406342
38006,2016,Junio,Estados Unidos de América,3511,4741,,8252,-75.516486,10.446304
38007,2016,Junio,Estados Unidos de América,848,1278,,2126,-74.77647900000001,10.886686
38008,2016,Junio,Estados Unidos de América,0,2,,2,-74.765343,10.970933
38009,2016,Junio,Estados Unidos de América,0,18,,18,-74.213989,11.247722999999999
38010,2016,Junio,Estados Unidos de América,0,1,,1,-81.703935,12.574411099999999
38011,2016,Junio,Estados Unidos de América,53,42,,95,-81.70216500000001,12.5862
38012,2016,Junio,Estados Unidos de América,1818,2276,,4094,-76.532004,3.451668
38013,2016,Junio,Estados Unidos de América,0,3,,3,-77.061029,3.8844260000000004
38014,2016,Junio,Estados Unidos de América,307,347,,654,-75.76635300000001,4.45285
38015,2016,Junio,Estados Unidos de América,11116,16464,,27580,-74.140516,4.697157
38016,2016,Junio,Estados Unidos de América,255,325,,580,-75.736374,4.815189
38017,2016,Junio,Estados Unidos de América,3719,6541,,10260,-75.42726,6.170465
38018,2016,Junio,Estados Unidos de América,40,57,,97,-73.181317,7.1280470000000005
38019,2016,Junio,Estados Unidos de América,41,27,,68,-72.508188,7.927233
38020,2016,Junio,Estados Unidos de América,0,17,,17,-75.68164200000001,9.402597
38021,2016,Junio,Estonia,0,2,,2,-74.140516,4.697157
38022,2016,Junio,Etiopia,0,1,,1,-74.140516,4.697157
38023,2016,Junio,Filipinas,0,1,,1,-75.516486,10.446304
38024,2016,Junio,Filipinas,0,2,,2,-74.77647900000001,10.886686
38025,2016,Junio,Filipinas,0,13,,13,-77.061029,3.8844260000000004
38026,2016,Junio,Filipinas,2,19,,21,-74.140516,4.697157
38027,2016,Junio,Filipinas,0,2,,2,-75.42726,6.170465
38028,2016,Junio,Finlandia,9,13,,22,-74.140516,4.697157
38029,2016,Junio,Finlandia,0,1,,1,-75.42726,6.170465
38030,2016,Junio,Francia,1,1,,2,-75.516486,10.446304
38031,2016,Junio,Francia,1,6,,7,-74.77647900000001,10.886686
38032,2016,Junio,Francia,29,44,,73,-76.532004,3.451668
38033,2016,Junio,Francia,988,1738,,2726,-74.140516,4.697157
38034,2016,Junio,Francia,18,50,,68,-75.42726,6.170465
38035,2016,Junio,Francia,0,1,,1,-73.181317,7.1280470000000005
38036,2016,Junio,Ghana,0,1,,1,-74.140516,4.697157
38037,2016,Junio,Gibraltar/Territorio Británico de Ultramar,2,0,,2,-77.35600000000001,0.81488
38038,2016,Junio,Gibraltar/Territorio Británico de Ultramar,0,8,,8,-74.213989,11.247722999999999
38039,2016,Junio,Granada,0,2,,2,-75.527794,10.406342
38040,2016,Junio,Granada,4,8,,12,-74.213989,11.247722999999999
38041,2016,Junio,Grecia,0,2,,2,-76.532004,3.451668
38042,2016,Junio,Grecia,7,8,,15,-74.140516,4.697157
38043,2016,Junio,Grecia,0,1,,1,-75.736374,4.815189
38044,2016,Junio,Grecia,1,0,,1,-75.42726,6.170465
38045,2016,Junio,Guatemala,5,11,,16,-75.516486,10.446304
38046,2016,Junio,Guatemala,35,51,,86,-74.77647900000001,10.886686
38047,2016,Junio,Guatemala,16,16,,32,-81.70216500000001,12.5862
38048,2016,Junio,Guatemala,33,53,,86,-76.532004,3.451668
38049,2016,Junio,Guatemala,0,1,,1,-77.061029,3.8844260000000004
38050,2016,Junio,Guatemala,356,561,,917,-74.140516,4.697157
38051,2016,Junio,Guatemala,3,4,,7,-75.736374,4.815189
38052,2016,Junio,Guatemala,57,130,,187,-75.42726,6.170465
38053,2016,Junio,Guatemala,1,2,,3,-73.181317,7.1280470000000005
38054,2016,Junio,Guatemala,1,1,,2,-72.508188,7.927233
38055,2016,Junio,Guyana,0,1,,1,-76.532004,3.451668
38056,2016,Junio,Guadalupe/Territorio Francés,1,1,,2,-74.140516,4.697157
38057,2016,Junio,Guayana Francesa/Departamento de Ultramar Francés,1,0,,1,-74.140516,4.697157
38058,2016,Junio,Haití,1,0,,1,-76.532004,3.451668
38059,2016,Junio,Haití,0,3,,3,-74.140516,4.697157
38060,2016,Junio,Haití,0,3,,3,-75.42726,6.170465
38061,2016,Junio,Haití,0,1,,1,-73.181317,7.1280470000000005
38062,2016,Junio,Honduras,3,2,,5,-75.516486,10.446304
38063,2016,Junio,Honduras,6,0,,6,-74.77647900000001,10.886686
38064,2016,Junio,Honduras,0,15,,15,-81.703935,12.574411099999999
38065,2016,Junio,Honduras,1,4,,5,-81.70216500000001,12.5862
38066,2016,Junio,Honduras,5,7,,12,-81.372937,13.338761300000002
38067,2016,Junio,Honduras,21,20,,41,-76.532004,3.451668
38068,2016,Junio,Honduras,43,75,,118,-74.140516,4.697157
38069,2016,Junio,Honduras,3,2,,5,-75.736374,4.815189
38070,2016,Junio,Honduras,22,47,,69,-75.42726,6.170465
38071,2016,Junio,Honduras,0,1,,1,-73.181317,7.1280470000000005
38072,2016,Junio,Honduras,2,2,,4,-72.508188,7.927233
38073,2016,Junio,Hong Kong,2,6,,8,-74.140516,4.697157
38074,2016,Junio,Hungría,0,8,,8,-74.140516,4.697157
38075,2016,Junio,Hungría,1,0,,1,-75.42726,6.170465
38076,2016,Junio,India,0,1,,1,-75.516486,10.446304
38077,2016,Junio,India,0,2,,2,-76.532004,3.451668
38078,2016,Junio,India,9,26,,35,-74.140516,4.697157
38079,2016,Junio,India,8,8,,16,-75.42726,6.170465
38080,2016,Junio,Indonesia,0,1,,1,-74.213989,11.247722999999999
38081,2016,Junio,Indonesia,1,3,,4,-74.140516,4.697157
38082,2016,Junio,República de Irlanda,1,4,,5,-76.532004,3.451668
38083,2016,Junio,República de Irlanda,11,18,,29,-74.140516,4.697157
38084,2016,Junio,República de Irlanda,0,3,,3,-75.42726,6.170465
38085,2016,Junio,Islandia,2,1,,3,-76.532004,3.451668
38086,2016,Junio,Islandia,3,2,,5,-74.140516,4.697157
38087,2016,Junio,Israel,0,1,,1,-74.77647900000001,10.886686
38088,2016,Junio,Israel,4,3,,7,-76.532004,3.451668
38089,2016,Junio,Israel,14,49,,63,-74.140516,4.697157
38090,2016,Junio,Israel,0,1,,1,-75.42726,6.170465
38091,2016,Junio,Italia,3,2,,5,-75.516486,10.446304
38092,2016,Junio,Italia,0,1,,1,-74.213989,11.247722999999999
38093,2016,Junio,Italia,2,1,,3,-81.70216500000001,12.5862
38094,2016,Junio,Italia,28,46,,74,-76.532004,3.451668
38095,2016,Junio,Italia,109,246,,355,-74.140516,4.697157
38096,2016,Junio,Italia,1,3,,4,-75.736374,4.815189
38097,2016,Junio,Italia,23,42,,65,-75.42726,6.170465
38098,2016,Junio,Italia,0,1,,1,-73.181317,7.1280470000000005
38099,2016,Junio,Italia,1,2,,3,-72.508188,7.927233
38100,2016,Junio,Jamaica,0,6,,6,-75.527794,10.406342
38101,2016,Junio,Jamaica,0,4,,4,-75.516486,10.446304
38102,2016,Junio,Jamaica,1,5,,6,-81.70216500000001,12.5862
38103,2016,Junio,Jamaica,1,1,,2,-81.372937,13.338761300000002
38104,2016,Junio,Jamaica,0,1,,1,-76.532004,3.451668
38105,2016,Junio,Jamaica,2,9,,11,-74.140516,4.697157
38106,2016,Junio,Jamaica,1,2,,3,-75.42726,6.170465
38107,2016,Junio,Japón,0,1,,1,-76.532004,3.451668
38108,2016,Junio,Japón,5,20,,25,-74.140516,4.697157
38109,2016,Junio,Japón,1,3,,4,-75.42726,6.170465
38110,2016,Junio,Jordania,2,1,,3,-74.140516,4.697157
38111,2016,Junio,Kazajistán,4,1,,5,-74.140516,4.697157
38112,2016,Junio,Kenia,0,7,,7,-74.140516,4.697157
38113,2016,Junio,Kenia,0,1,,1,-75.42726,6.170465
38114,2016,Junio,Kuwait,1,1,,2,-74.140516,4.697157
38115,2016,Junio,Letonia,1,1,,2,-74.140516,4.697157
38116,2016,Junio,Líbano,4,2,,6,-74.140516,4.697157
38117,2016,Junio,Liechtenstein,1,0,,1,-74.140516,4.697157
38118,2016,Junio,Luxemburgo,2,2,,4,-74.140516,4.697157
38119,2016,Junio,Malasia,2,1,,3,-74.140516,4.697157
38120,2016,Junio,Malta,3,5,,8,-74.140516,4.697157
38121,2016,Junio,Marruecos,1,2,,3,-74.140516,4.697157
38122,2016,Junio,Marruecos,0,1,,1,-75.42726,6.170465
38123,2016,Junio,Martinica/Departamento de Ultramar Francés,0,2,,2,-75.527794,10.406342
38124,2016,Junio,México,0,6,,6,-75.527794,10.406342
38125,2016,Junio,México,22,29,,51,-75.516486,10.446304
38126,2016,Junio,México,23,36,,59,-74.77647900000001,10.886686
38127,2016,Junio,México,2,5,,7,-74.232675,11.117206
38128,2016,Junio,México,0,1,,1,-74.213989,11.247722999999999
38129,2016,Junio,México,5,10,,15,-81.70216500000001,12.5862
38130,2016,Junio,México,96,187,,283,-76.532004,3.451668
38131,2016,Junio,México,4805,8102,,12907,-74.140516,4.697157
38132,2016,Junio,México,24,23,,47,-75.736374,4.815189
38133,2016,Junio,México,545,1206,,1751,-75.42726,6.170465
38134,2016,Junio,México,6,11,,17,-73.181317,7.1280470000000005
38135,2016,Junio,México,7,20,,27,-72.508188,7.927233
38136,2016,Junio,Mónaco,0,2,,2,-74.140516,4.697157
38137,2016,Junio,Nepal,0,1,,1,-74.140516,4.697157
38138,2016,Junio,Nicaragua,1,1,,2,-75.516486,10.446304
38139,2016,Junio,Nicaragua,0,1,,1,-74.77647900000001,10.886686
38140,2016,Junio,Nicaragua,1,2,,3,-81.70216500000001,12.5862
38141,2016,Junio,Nicaragua,4,14,,18,-76.532004,3.451668
38142,2016,Junio,Nicaragua,35,45,,80,-74.140516,4.697157
38143,2016,Junio,Nicaragua,5,3,,8,-75.736374,4.815189
38144,2016,Junio,Nicaragua,27,20,,47,-75.42726,6.170465
38145,2016,Junio,Nigeria,1,3,,4,-75.527794,10.406342
38146,2016,Junio,Nigeria,1,2,,3,-76.532004,3.451668
38147,2016,Junio,Noruega,2,0,,2,-75.516486,10.446304
38148,2016,Junio,Noruega,2,3,,5,-74.77647900000001,10.886686
38149,2016,Junio,Noruega,11,12,,23,-76.532004,3.451668
38150,2016,Junio,Noruega,41,48,,89,-74.140516,4.697157
38151,2016,Junio,Noruega,1,1,,2,-75.42726,6.170465
38152,2016,Junio,Nueva Zelanda,1,0,,1,-75.516486,10.446304
38153,2016,Junio,Nueva Zelanda,2,6,,8,-74.140516,4.697157
38154,2016,Junio,Nueva Zelanda,3,3,,6,-75.42726,6.170465
38155,2016,Junio,Panamá,150,236,,386,-75.527794,10.406342
38156,2016,Junio,Panamá,2791,3297,,6088,-75.516486,10.446304
38157,2016,Junio,Panamá,275,554,,829,-74.77647900000001,10.886686
38158,2016,Junio,Panamá,1,22,,23,-74.765343,10.970933
38159,2016,Junio,Panamá,0,8,,8,-74.213989,11.247722999999999
38160,2016,Junio,Panamá,4,40,,44,-81.703935,12.574411099999999
38161,2016,Junio,Panamá,583,419,,1002,-81.70216500000001,12.5862
38162,2016,Junio,Panamá,2,8,,10,-81.372937,13.338761300000002
38163,2016,Junio,Panamá,375,581,,956,-76.532004,3.451668
38164,2016,Junio,Panamá,1,11,,12,-77.061029,3.8844260000000004
38165,2016,Junio,Panamá,32,42,,74,-75.76635300000001,4.45285
38166,2016,Junio,Panamá,4188,5773,,9961,-74.140516,4.697157
38167,2016,Junio,Panamá,24,51,,75,-75.736374,4.815189
38168,2016,Junio,Panamá,2033,2636,,4669,-75.42726,6.170465
38169,2016,Junio,Panamá,5,17,,22,-77.762647,7.102626
38170,2016,Junio,Panamá,17,37,,54,-73.181317,7.1280470000000005
38171,2016,Junio,Panamá,49,45,,94,-72.508188,7.927233
38172,2016,Junio,Panamá,0,10,,10,-76.7333,8.06667
38173,2016,Junio,Panamá,127,144,,271,-77.35002,8.63337
38174,2016,Junio,Panamá,2,5,,7,-75.68164200000001,9.402597
38175,2016,Junio,Paraguay,1,2,,3,-75.516486,10.446304
38176,2016,Junio,Paraguay,2,7,,9,-74.77647900000001,10.886686
38177,2016,Junio,Paraguay,70,32,,102,-81.70216500000001,12.5862
38178,2016,Junio,Paraguay,12,17,,29,-76.532004,3.451668
38179,2016,Junio,Paraguay,63,76,,139,-74.140516,4.697157
38180,2016,Junio,Paraguay,2,3,,5,-75.736374,4.815189
38181,2016,Junio,Paraguay,5,18,,23,-75.42726,6.170465
38182,2016,Junio,Perú,142,198,,340,-69.941498,4.191162
38183,2016,Junio,Perú,1,0,,1,-69.94143100000001,4.214082
38184,2016,Junio,Perú,1,1,,2,-74.78366,0.18595699999999998
38185,2016,Junio,Perú,27,59,,86,-77.35600000000001,0.81488
38186,2016,Junio,Perú,0,3,,3,-75.527794,10.406342
38187,2016,Junio,Perú,4,7,,11,-75.516486,10.446304
38188,2016,Junio,Perú,2,10,,12,-74.77647900000001,10.886686
38189,2016,Junio,Perú,85,73,,158,-81.70216500000001,12.5862
38190,2016,Junio,Perú,291,477,,768,-76.532004,3.451668
38191,2016,Junio,Perú,0,1,,1,-77.061029,3.8844260000000004
38192,2016,Junio,Perú,5701,8065,,13766,-74.140516,4.697157
38193,2016,Junio,Perú,2,2,,4,-75.736374,4.815189
38194,2016,Junio,Perú,807,1141,,1948,-75.42726,6.170465
38195,2016,Junio,Perú,0,2,,2,-73.181317,7.1280470000000005
38196,2016,Junio,Perú,1,0,,1,-72.508188,7.927233
38197,2016,Junio,Polonia,2,0,,2,-74.77647900000001,10.886686
38198,2016,Junio,Polonia,0,2,,2,-76.532004,3.451668
38199,2016,Junio,Polonia,15,23,,38,-74.140516,4.697157
38200,2016,Junio,Polonia,2,1,,3,-75.42726,6.170465
38201,2016,Junio,Portugal,0,9,,9,-75.527794,10.406342
38202,2016,Junio,Portugal,0,1,,1,-74.77647900000001,10.886686
38203,2016,Junio,Portugal,1,5,,6,-76.532004,3.451668
38204,2016,Junio,Portugal,16,47,,63,-74.140516,4.697157
38205,2016,Junio,Portugal,0,5,,5,-75.42726,6.170465
38206,2016,Junio,Polinesia Francesa/Colectividad de Ultramar Francesa,0,1,,1,-74.140516,4.697157
38207,2016,Junio,Puerto Rico/Territorio de Estados Unidos,1,5,,6,-75.516486,10.446304
38208,2016,Junio,Puerto Rico/Territorio de Estados Unidos,10,47,,57,-74.77647900000001,10.886686
38209,2016,Junio,Puerto Rico/Territorio de Estados Unidos,3,1,,4,-81.70216500000001,12.5862
38210,2016,Junio,Puerto Rico/Territorio de Estados Unidos,49,56,,105,-76.532004,3.451668
38211,2016,Junio,Puerto Rico/Territorio de Estados Unidos,510,579,,1089,-74.140516,4.697157
38212,2016,Junio,Puerto Rico/Territorio de Estados Unidos,2,9,,11,-75.736374,4.815189
38213,2016,Junio,Puerto Rico/Territorio de Estados Unidos,26,75,,101,-75.42726,6.170465
38214,2016,Junio,Puerto Rico/Territorio de Estados Unidos,2,6,,8,-73.181317,7.1280470000000005
38215,2016,Junio,Puerto Rico/Territorio de Estados Unidos,9,1,,10,-72.508188,7.927233
38216,2016,Junio,Reino Unido de Gran Bretaña e Irlanda del Norte,3,0,,3,-75.516486,10.446304
38217,2016,Junio,Reino Unido de Gran Bretaña e Irlanda del Norte,1,2,,3,-74.77647900000001,10.886686
38218,2016,Junio,Reino Unido de Gran Bretaña e Irlanda del Norte,0,1,,1,-74.213989,11.247722999999999
38219,2016,Junio,Reino Unido de Gran Bretaña e Irlanda del Norte,8,12,,20,-76.532004,3.451668
38220,2016,Junio,Reino Unido de Gran Bretaña e Irlanda del Norte,564,983,,1547,-74.140516,4.697157
38221,2016,Junio,Reino Unido de Gran Bretaña e Irlanda del Norte,4,5,,9,-75.736374,4.815189
38222,2016,Junio,Reino Unido de Gran Bretaña e Irlanda del Norte,17,24,,41,-75.42726,6.170465
38223,2016,Junio,Reino Unido de Gran Bretaña e Irlanda del Norte,1,1,,2,-73.181317,7.1280470000000005
38224,2016,Junio,Federación de Rusia,1,0,,1,-75.516486,10.446304
38225,2016,Junio,Federación de Rusia,0,2,,2,-76.532004,3.451668
38226,2016,Junio,Federación de Rusia,0,2,,2,-77.061029,3.8844260000000004
38227,2016,Junio,Federación de Rusia,12,24,,36,-74.140516,4.697157
38228,2016,Junio,Federación de Rusia,1,1,,2,-75.42726,6.170465
38229,2016,Junio,Federación de Rusia,1,0,,1,-72.508188,7.927233
38230,2016,Junio,República Dominicana,1,11,,12,-75.527794,10.406342
38231,2016,Junio,República Dominicana,3,11,,14,-75.516486,10.446304
38232,2016,Junio,República Dominicana,6,11,,17,-74.77647900000001,10.886686
38233,2016,Junio,República Dominicana,1,3,,4,-74.765343,10.970933
38234,2016,Junio,República Dominicana,3,4,,7,-81.70216500000001,12.5862
38235,2016,Junio,República Dominicana,18,36,,54,-76.532004,3.451668
38236,2016,Junio,República Dominicana,473,706,,1179,-74.140516,4.697157
38237,2016,Junio,República Dominicana,2,4,,6,-75.736374,4.815189
38238,2016,Junio,República Dominicana,40,80,,120,-75.42726,6.170465
38239,2016,Junio,República Dominicana,5,6,,11,-73.181317,7.1280470000000005
38240,2016,Junio,República Dominicana,4,4,,8,-72.508188,7.927233
38241,2016,Junio,República Democrática Popular de Corea,0,1,,1,-76.532004,3.451668
38242,2016,Junio,Rumania,0,1,,1,-76.532004,3.451668
38243,2016,Junio,Rumania,1,8,,9,-74.140516,4.697157
38244,2016,Junio,Rwanda,0,1,,1,-74.140516,4.697157
38245,2016,Junio,San Cristóbal y Nevis,0,1,,1,-74.140516,4.697157
38246,2016,Junio,Santa Lucia,0,1,,1,-76.532004,3.451668
38247,2016,Junio,Senegal,1,1,,2,-74.140516,4.697157
38248,2016,Junio,Singapur,3,5,,8,-74.140516,4.697157
38249,2016,Junio,Sudáfrica,0,1,,1,-74.77647900000001,10.886686
38250,2016,Junio,Sudáfrica,0,2,,2,-76.532004,3.451668
38251,2016,Junio,Sudáfrica,6,19,,25,-74.140516,4.697157
38252,2016,Junio,Sudáfrica,0,2,,2,-75.736374,4.815189
38253,2016,Junio,Suecia,5,4,,9,-74.77647900000001,10.886686
38254,2016,Junio,Suecia,18,15,,33,-76.532004,3.451668
38255,2016,Junio,Suecia,55,54,,109,-74.140516,4.697157
38256,2016,Junio,Suecia,2,3,,5,-75.736374,4.815189
38257,2016,Junio,Suecia,6,10,,16,-75.42726,6.170465
38258,2016,Junio,Suiza,0,1,,1,-75.516486,10.446304
38259,2016,Junio,Suiza,0,1,,1,-74.77647900000001,10.886686
38260,2016,Junio,Suiza,0,1,,1,-81.70216500000001,12.5862
38261,2016,Junio,Suiza,18,24,,42,-76.532004,3.451668
38262,2016,Junio,Suiza,56,77,,133,-74.140516,4.697157
38263,2016,Junio,Suiza,12,22,,34,-75.42726,6.170465
38264,2016,Junio,Suiza,1,0,,1,-73.181317,7.1280470000000005
38265,2016,Junio,Surinam,0,1,,1,-75.527794,10.406342
38266,2016,Junio,Surinam,0,1,,1,-74.140516,4.697157
38267,2016,Junio,Surinam,2,7,,9,-75.42726,6.170465
38268,2016,Junio,Taiwán,4,1,,5,-74.140516,4.697157
38269,2016,Junio,Tailandia,4,2,,6,-74.140516,4.697157
38270,2016,Junio,Trinidad y Tobago,0,13,,13,-75.527794,10.406342
38271,2016,Junio,Trinidad y Tobago,0,1,,1,-74.77647900000001,10.886686
38272,2016,Junio,Trinidad y Tobago,0,1,,1,-74.213989,11.247722999999999
38273,2016,Junio,Trinidad y Tobago,4,2,,6,-76.532004,3.451668
38274,2016,Junio,Trinidad y Tobago,4,11,,15,-74.140516,4.697157
38275,2016,Junio,Trinidad y Tobago,1,3,,4,-75.42726,6.170465
38276,2016,Junio,Trinidad y Tobago,0,1,,1,-73.181317,7.1280470000000005
38277,2016,Junio,Trinidad y Tobago,0,1,,1,-72.508188,7.927233
38278,2016,Junio,Trinidad y Tobago,0,2,,2,-75.68164200000001,9.402597
38279,2016,Junio,Túnez,0,2,,2,-74.140516,4.697157
38280,2016,Junio,Turkmenistán,3,6,,9,-74.140516,4.697157
38281,2016,Junio,Turquía,312,490,,802,-74.140516,4.697157
38282,2016,Junio,Turquía,2,2,,4,-75.42726,6.170465
38283,2016,Junio,Ucrania,0,1,,1,-74.140516,4.697157
38284,2016,Junio,Ucrania,0,1,,1,-75.42726,6.170465
38285,2016,Junio,Uruguay,0,1,,1,-77.35600000000001,0.81488
38286,2016,Junio,Uruguay,3,3,,6,-75.516486,10.446304
38287,2016,Junio,Uruguay,17,15,,32,-81.70216500000001,12.5862
38288,2016,Junio,Uruguay,7,19,,26,-76.532004,3.451668
38289,2016,Junio,Uruguay,89,116,,205,-74.140516,4.697157
38290,2016,Junio,Uruguay,3,2,,5,-75.736374,4.815189
38291,2016,Junio,Uruguay,27,39,,66,-75.42726,6.170465
38292,2016,Junio,Uruguay,1,2,,3,-73.181317,7.1280470000000005
38293,2016,Junio,Venezuela,0,27,,27,-75.527794,10.406342
38294,2016,Junio,Venezuela,9,22,,31,-75.516486,10.446304
38295,2016,Junio,Venezuela,32,40,,72,-74.77647900000001,10.886686
38296,2016,Junio,Venezuela,0,1,,1,-74.213989,11.247722999999999
38297,2016,Junio,Venezuela,670,942,,1612,-72.129595,11.360028999999999
38298,2016,Junio,Venezuela,4,4,,8,-81.70216500000001,12.5862
38299,2016,Junio,Venezuela,8,28,,36,-76.532004,3.451668
38300,2016,Junio,Venezuela,24,38,,62,-67.927521,3.866713
38301,2016,Junio,Venezuela,3351,4195,,7546,-74.140516,4.697157
38302,2016,Junio,Venezuela,1,4,,5,-75.736374,4.815189
38303,2016,Junio,Venezuela,659,733,,1392,-75.42726,6.170465
38304,2016,Junio,Venezuela,27,46,,73,-67.48402800000001,6.185536
38305,2016,Junio,Venezuela,78,84,,162,-70.74025300000001,7.088728999999999
38306,2016,Junio,Venezuela,2,4,,6,-73.181317,7.1280470000000005
38307,2016,Junio,Venezuela,1466,2036,,3502,-72.453013,7.819
38308,2016,Junio,Venezuela,161,165,,326,-72.508188,7.927233
38309,2016,Junio,Vietnam,0,2,,2,-75.42726,6.170465
38310,2016,Junio,Islas Vírgenes Británicas/Territorio Británico de Ultramar,2,2,,4,-74.140516,4.697157
38311,2016,Junio,Desconocido,0,1,,1,-69.941498,4.191162
38312,2016,Julio,Afganistán,0,1,,1,-74.77647900000001,10.886686
38313,2016,Julio,Afganistán,0,1,,1,-74.140516,4.697157
38314,2016,Julio,Albania,1,0,,1,-74.140516,4.697157
38315,2016,Julio,Alemania,1,0,,1,-75.516486,10.446304
38316,2016,Julio,Alemania,5,7,,12,-74.77647900000001,10.886686
38317,2016,Julio,Alemania,0,2,,2,-74.213989,11.247722999999999
38318,2016,Julio,Alemania,1,2,,3,-81.70216500000001,12.5862
38319,2016,Julio,Alemania,62,54,,116,-76.532004,3.451668
38320,2016,Julio,Alemania,1587,2101,,3688,-74.140516,4.697157
38321,2016,Julio,Alemania,5,5,,10,-75.736374,4.815189
38322,2016,Julio,Alemania,68,65,,133,-75.42726,6.170465
38323,2016,Julio,Alemania,1,2,,3,-73.181317,7.1280470000000005
38324,2016,Julio,Andorra,1,0,,1,-74.140516,4.697157
38325,2016,Julio,Antigua y Barbuda,0,1,,1,-75.527794,10.406342
38326,2016,Julio,Antigua y Barbuda,0,1,,1,-74.140516,4.697157
38327,2016,Julio,Antigua y Barbuda,1,0,,1,-75.42726,6.170465
38328,2016,Julio,Países Bajos,3,16,,19,-75.527794,10.406342
38329,2016,Julio,Países Bajos,1,4,,5,-75.516486,10.446304
38330,2016,Julio,Países Bajos,202,204,,406,-74.77647900000001,10.886686
38331,2016,Julio,Países Bajos,0,4,,4,-74.213989,11.247722999999999
38332,2016,Julio,Países Bajos,116,164,,280,-76.532004,3.451668
38333,2016,Julio,Países Bajos,979,1339,,2318,-74.140516,4.697157
38334,2016,Julio,Países Bajos,10,7,,17,-75.736374,4.815189
38335,2016,Julio,Países Bajos,370,392,,762,-75.42726,6.170465
38336,2016,Julio,Países Bajos,4,3,,7,-73.181317,7.1280470000000005
38337,2016,Julio,Países Bajos,1,0,,1,-72.508188,7.927233
38338,2016,Julio,Arabia Saudita,5,6,,11,-74.140516,4.697157
38339,2016,Julio,Arabia Saudita,0,1,,1,-75.736374,4.815189
38340,2016,Julio,Arabia Saudita,0,1,,1,-75.42726,6.170465
38341,2016,Julio,Argelia,1,0,,1,-76.532004,3.451668
38342,2016,Julio,Argelia,1,4,,5,-74.140516,4.697157
38343,2016,Julio,Argentina,8,9,,17,-77.35600000000001,0.81488
38344,2016,Julio,Argentina,0,4,,4,-75.527794,10.406342
38345,2016,Julio,Argentina,37,29,,66,-75.516486,10.446304
38346,2016,Julio,Argentina,8,10,,18,-74.77647900000001,10.886686
38347,2016,Julio,Argentina,289,207,,496,-81.70216500000001,12.5862
38348,2016,Julio,Argentina,68,67,,135,-76.532004,3.451668
38349,2016,Julio,Argentina,0,9,,9,-77.061029,3.8844260000000004
38350,2016,Julio,Argentina,2648,3319,,5967,-74.140516,4.697157
38351,2016,Julio,Argentina,1,0,,1,-75.736374,4.815189
38352,2016,Julio,Argentina,76,134,,210,-75.42726,6.170465
38353,2016,Julio,Argentina,2,2,,4,-73.181317,7.1280470000000005
38354,2016,Julio,Aruba,3,9,,12,-75.527794,10.406342
38355,2016,Julio,Aruba,2,4,,6,-75.516486,10.446304
38356,2016,Julio,Aruba,17,25,,42,-74.77647900000001,10.886686
38357,2016,Julio,Aruba,2,8,,10,-74.213989,11.247722999999999
38358,2016,Julio,Aruba,26,38,,64,-76.532004,3.451668
38359,2016,Julio,Aruba,977,991,,1968,-74.140516,4.697157
38360,2016,Julio,Aruba,6,2,,8,-75.736374,4.815189
38361,2016,Julio,Aruba,173,189,,362,-75.42726,6.170465
38362,2016,Julio,Aruba,12,9,,21,-73.181317,7.1280470000000005
38363,2016,Julio,Aruba,0,1,,1,-72.508188,7.927233
38364,2016,Julio,Australia,0,1,,1,-74.77647900000001,10.886686
38365,2016,Julio,Australia,5,7,,12,-76.532004,3.451668
38366,2016,Julio,Australia,44,53,,97,-74.140516,4.697157
38367,2016,Julio,Australia,9,17,,26,-75.42726,6.170465
38368,2016,Julio,Australia,1,0,,1,-73.181317,7.1280470000000005
38369,2016,Julio,Austria,0,2,,2,-81.70216500000001,12.5862
38370,2016,Julio,Austria,6,3,,9,-76.532004,3.451668
38371,2016,Julio,Austria,39,46,,85,-74.140516,4.697157
38372,2016,Julio,Austria,7,9,,16,-75.42726,6.170465
38373,2016,Julio,Bahamas,0,1,,1,-75.527794,10.406342
38374,2016,Julio,Bahamas,0,1,,1,-76.532004,3.451668
38375,2016,Julio,Bahamas,3,4,,7,-74.140516,4.697157
38376,2016,Julio,Bahamas,0,1,,1,-75.736374,4.815189
38377,2016,Julio,Bahamas,9,2,,11,-75.42726,6.170465
38378,2016,Julio,Bahamas,1,0,,1,-72.508188,7.927233
38379,2016,Julio,Bahamas,0,2,,2,-75.68164200000001,9.402597
38380,2016,Julio,Bahréin,1,1,,2,-75.516486,10.446304
38381,2016,Julio,Bahréin,1,1,,2,-74.140516,4.697157
38382,2016,Julio,Bangladesh,0,1,,1,-74.140516,4.697157
38383,2016,Julio,Barbados,1,1,,2,-76.532004,3.451668
38384,2016,Julio,Barbados,40,49,,89,-74.140516,4.697157
38385,2016,Julio,Barbados,1,0,,1,-75.42726,6.170465
38386,2016,Julio,Barbados,0,1,,1,-73.181317,7.1280470000000005
38387,2016,Julio,República de Belarús,0,1,,1,-72.129595,11.360028999999999
38388,2016,Julio,República de Belarús,0,5,,5,-74.140516,4.697157
38389,2016,Julio,Bélgica,1,1,,2,-75.516486,10.446304
38390,2016,Julio,Bélgica,2,0,,2,-74.77647900000001,10.886686
38391,2016,Julio,Bélgica,8,10,,18,-76.532004,3.451668
38392,2016,Julio,Bélgica,67,71,,138,-74.140516,4.697157
38393,2016,Julio,Bélgica,23,33,,56,-75.42726,6.170465
38394,2016,Julio,Belice,1,0,,1,-76.532004,3.451668
38395,2016,Julio,Belice,1,3,,4,-74.140516,4.697157
38396,2016,Julio,Bermudas/Territorio Británico de Ultramar,0,9,,9,-75.527794,10.406342
38397,2016,Julio,Bolivia,2,2,,4,-77.35600000000001,0.81488
38398,2016,Julio,Bolivia,1,2,,3,-75.516486,10.446304
38399,2016,Julio,Bolivia,32,21,,53,-81.70216500000001,12.5862
38400,2016,Julio,Bolivia,25,25,,50,-76.532004,3.451668
38401,2016,Julio,Bolivia,615,654,,1269,-74.140516,4.697157
38402,2016,Julio,Bolivia,49,52,,101,-75.42726,6.170465
38403,2016,Julio,Bolivia,4,0,,4,-73.181317,7.1280470000000005
38404,2016,Julio,Botsuana,1,0,,1,-74.140516,4.697157
38405,2016,Julio,Brasil,164,203,,367,-69.941498,4.191162
38406,2016,Julio,Brasil,1,3,,4,-69.94143100000001,4.214082
38407,2016,Julio,Brasil,1,4,,5,-77.35600000000001,0.81488
38408,2016,Julio,Brasil,0,8,,8,-75.527794,10.406342
38409,2016,Julio,Brasil,49,37,,86,-75.516486,10.446304
38410,2016,Julio,Brasil,13,12,,25,-74.77647900000001,10.886686
38411,2016,Julio,Brasil,496,372,,868,-81.70216500000001,12.5862
38412,2016,Julio,Brasil,84,88,,172,-76.532004,3.451668
38413,2016,Julio,Brasil,4639,5714,,10353,-74.140516,4.697157
38414,2016,Julio,Brasil,1,8,,9,-75.736374,4.815189
38415,2016,Julio,Brasil,108,274,,382,-75.42726,6.170465
38416,2016,Julio,Brasil,0,2,,2,-73.181317,7.1280470000000005
38417,2016,Julio,Brasil,0,4,,4,-72.508188,7.927233
38418,2016,Julio,Bulgaria,1,1,,2,-74.140516,4.697157
38419,2016,Julio,Bulgaria,1,0,,1,-75.42726,6.170465
38420,2016,Julio,Bulgaria,0,1,,1,-72.508188,7.927233
38421,2016,Julio,Burkina Faso,0,4,,4,-75.42726,6.170465
38422,2016,Julio,Cabo Verde,0,1,,1,-74.140516,4.697157
38423,2016,Julio,Islas Caimán/Territorio Británico de Ultramar,0,2,,2,-81.70216500000001,12.5862
38424,2016,Julio,Islas Caimán/Territorio Británico de Ultramar,2,2,,4,-74.140516,4.697157
38425,2016,Julio,Canadá,37,12,,49,-75.516486,10.446304
38426,2016,Julio,Canadá,6,5,,11,-74.77647900000001,10.886686
38427,2016,Julio,Canadá,1,1,,2,-81.70216500000001,12.5862
38428,2016,Julio,Canadá,55,56,,111,-76.532004,3.451668
38429,2016,Julio,Canadá,698,925,,1623,-74.140516,4.697157
38430,2016,Julio,Canadá,9,8,,17,-75.736374,4.815189
38431,2016,Julio,Canadá,126,218,,344,-75.42726,6.170465
38432,2016,Julio,Canadá,12,9,,21,-73.181317,7.1280470000000005
38433,2016,Julio,Canadá,1,0,,1,-72.508188,7.927233
38434,2016,Julio,España,1,7,,8,-75.527794,10.406342
38435,2016,Julio,España,6,6,,12,-75.516486,10.446304
38436,2016,Julio,España,6,8,,14,-74.77647900000001,10.886686
38437,2016,Julio,España,2,3,,5,-81.70216500000001,12.5862
38438,2016,Julio,España,530,761,,1291,-76.532004,3.451668
38439,2016,Julio,España,3876,5843,,9719,-74.140516,4.697157
38440,2016,Julio,España,5,6,,11,-75.736374,4.815189
38441,2016,Julio,España,304,490,,794,-75.42726,6.170465
38442,2016,Julio,España,1,2,,3,-73.181317,7.1280470000000005
38443,2016,Julio,España,2,5,,7,-72.508188,7.927233
38444,2016,Julio,República de Corea,0,2,,2,-75.527794,10.406342
38445,2016,Julio,República de Corea,1,0,,1,-76.532004,3.451668
38446,2016,Julio,República de Corea,16,19,,35,-74.140516,4.697157
38447,2016,Julio,República de Corea,0,1,,1,-75.42726,6.170465
38448,2016,Julio,Costa de Marfil,2,4,,6,-74.140516,4.697157
38449,2016,Julio,Costa Rica,0,9,,9,-75.527794,10.406342
38450,2016,Julio,Costa Rica,6,7,,13,-75.516486,10.446304
38451,2016,Julio,Costa Rica,8,22,,30,-74.77647900000001,10.886686
38452,2016,Julio,Costa Rica,0,1,,1,-74.213989,11.247722999999999
38453,2016,Julio,Costa Rica,0,3,,3,-81.703935,12.574411099999999
38454,2016,Julio,Costa Rica,232,185,,417,-81.70216500000001,12.5862
38455,2016,Julio,Costa Rica,26,18,,44,-76.532004,3.451668
38456,2016,Julio,Costa Rica,1121,1540,,2661,-74.140516,4.697157
38457,2016,Julio,Costa Rica,14,19,,33,-75.736374,4.815189
38458,2016,Julio,Costa Rica,136,168,,304,-75.42726,6.170465
38459,2016,Julio,Costa Rica,3,0,,3,-73.181317,7.1280470000000005
38460,2016,Julio,Costa Rica,0,1,,1,-72.508188,7.927233
38461,2016,Julio,Croacia,0,1,,1,-74.77647900000001,10.886686
38462,2016,Julio,Croacia,0,1,,1,-76.532004,3.451668
38463,2016,Julio,Croacia,0,1,,1,-74.140516,4.697157
38464,2016,Julio,Cuba,0,1,,1,-75.516486,10.446304
38465,2016,Julio,Cuba,4,16,,20,-74.77647900000001,10.886686
38466,2016,Julio,Cuba,0,1,,1,-74.213989,11.247722999999999
38467,2016,Julio,Cuba,4,3,,7,-81.703935,12.574411099999999
38468,2016,Julio,Cuba,2,0,,2,-81.70216500000001,12.5862
38469,2016,Julio,Cuba,18,36,,54,-76.532004,3.451668
38470,2016,Julio,Cuba,369,563,,932,-74.140516,4.697157
38471,2016,Julio,Cuba,4,5,,9,-75.736374,4.815189
38472,2016,Julio,Cuba,30,37,,67,-75.42726,6.170465
38473,2016,Julio,Cuba,2,1,,3,-73.181317,7.1280470000000005
38474,2016,Julio,Cuba,0,3,,3,-72.508188,7.927233
38475,2016,Julio,República Checa,1,3,,4,-76.532004,3.451668
38476,2016,Julio,República Checa,4,9,,13,-74.140516,4.697157
38477,2016,Julio,República Checa,0,1,,1,-72.508188,7.927233
38478,2016,Julio,Chile,2,6,,8,-77.35600000000001,0.81488
38479,2016,Julio,Chile,0,1,,1,-75.527794,10.406342
38480,2016,Julio,Chile,14,9,,23,-75.516486,10.446304
38481,2016,Julio,Chile,3,7,,10,-74.77647900000001,10.886686
38482,2016,Julio,Chile,156,120,,276,-81.70216500000001,12.5862
38483,2016,Julio,Chile,66,62,,128,-76.532004,3.451668
38484,2016,Julio,Chile,5047,5889,,10936,-74.140516,4.697157
38485,2016,Julio,Chile,3,3,,6,-75.736374,4.815189
38486,2016,Julio,Chile,49,60,,109,-75.42726,6.170465
38487,2016,Julio,Chile,0,2,,2,-73.181317,7.1280470000000005
38488,2016,Julio,China,1,1,,2,-74.77647900000001,10.886686
38489,2016,Julio,China,0,1,,1,-76.532004,3.451668
38490,2016,Julio,China,34,75,,109,-74.140516,4.697157
38491,2016,Julio,China,3,6,,9,-75.42726,6.170465
38492,2016,Julio,China,1,0,,1,-73.181317,7.1280470000000005
38493,2016,Julio,Dinamarca,1,0,,1,-75.516486,10.446304
38494,2016,Julio,Dinamarca,1,2,,3,-74.77647900000001,10.886686
38495,2016,Julio,Dinamarca,1,0,,1,-81.70216500000001,12.5862
38496,2016,Julio,Dinamarca,1,0,,1,-76.532004,3.451668
38497,2016,Julio,Dinamarca,27,28,,55,-74.140516,4.697157
38498,2016,Julio,Dinamarca,6,3,,9,-75.736374,4.815189
38499,2016,Julio,Dinamarca,2,1,,3,-75.42726,6.170465
38500,2016,Julio,Dominica,0,1,,1,-74.140516,4.697157
38501,2016,Julio,Ecuador,0,3,,3,-74.78366,0.18595699999999998
38502,2016,Julio,Ecuador,160,342,,502,-76.876446,0.33002
38503,2016,Julio,Ecuador,1,1,,2,-77.84700600000001,0.8124359999999999
38504,2016,Julio,Ecuador,4502,5644,,10146,-77.35600000000001,0.81488
38505,2016,Julio,Ecuador,52,159,,211,-78.802679,18.00143
38506,2016,Julio,Ecuador,0,1,,1,-78.75132099999999,18.124979999999997
38507,2016,Julio,Ecuador,187,168,,355,-75.516486,10.446304
38508,2016,Julio,Ecuador,1,0,,1,-74.77647900000001,10.886686
38509,2016,Julio,Ecuador,0,2,,2,-74.765343,10.970933
38510,2016,Julio,Ecuador,9,5,,14,-81.70216500000001,12.5862
38511,2016,Julio,Ecuador,432,503,,935,-76.532004,3.451668
38512,2016,Julio,Ecuador,0,2,,2,-77.061029,3.8844260000000004
38513,2016,Julio,Ecuador,3570,4901,,8471,-74.140516,4.697157
38514,2016,Julio,Ecuador,3,12,,15,-75.736374,4.815189
38515,2016,Julio,Ecuador,86,261,,347,-75.42726,6.170465
38516,2016,Julio,Ecuador,0,1,,1,-73.181317,7.1280470000000005
38517,2016,Julio,Ecuador,0,2,,2,-72.508188,7.927233
38518,2016,Julio,Egipto,0,7,,7,-74.140516,4.697157
38519,2016,Julio,Egipto,1,0,,1,-75.42726,6.170465
38520,2016,Julio,El Salvador,3,1,,4,-75.516486,10.446304
38521,2016,Julio,El Salvador,1,2,,3,-74.77647900000001,10.886686
38522,2016,Julio,El Salvador,21,17,,38,-81.70216500000001,12.5862
38523,2016,Julio,El Salvador,115,192,,307,-76.532004,3.451668
38524,2016,Julio,El Salvador,1058,1531,,2589,-74.140516,4.697157
38525,2016,Julio,El Salvador,205,308,,513,-75.42726,6.170465
38526,2016,Julio,El Salvador,0,1,,1,-73.181317,7.1280470000000005
38527,2016,Julio,Emiratos Árabes,8,24,,32,-74.140516,4.697157
38528,2016,Julio,Emiratos Árabes,3,3,,6,-75.42726,6.170465
38529,2016,Julio,Eritrea,1,1,,2,-74.140516,4.697157
38530,2016,Julio,Eslovaquia,1,2,,3,-74.140516,4.697157
38531,2016,Julio,Eslovenia,1,7,,8,-74.140516,4.697157
38532,2016,Julio,Eslovenia,1,1,,2,-75.42726,6.170465
38533,2016,Julio,Estados Unidos de América,0,16,,16,-75.527794,10.406342
38534,2016,Julio,Estados Unidos de América,4019,5026,,9045,-75.516486,10.446304
38535,2016,Julio,Estados Unidos de América,847,1210,,2057,-74.77647900000001,10.886686
38536,2016,Julio,Estados Unidos de América,0,1,,1,-74.765343,10.970933
38537,2016,Julio,Estados Unidos de América,0,1,,1,-74.232675,11.117206
38538,2016,Julio,Estados Unidos de América,0,7,,7,-74.213989,11.247722999999999
38539,2016,Julio,Estados Unidos de América,79,91,,170,-81.70216500000001,12.5862
38540,2016,Julio,Estados Unidos de América,1729,2030,,3759,-76.532004,3.451668
38541,2016,Julio,Estados Unidos de América,263,361,,624,-75.76635300000001,4.45285
38542,2016,Julio,Estados Unidos de América,10665,15956,,26621,-74.140516,4.697157
38543,2016,Julio,Estados Unidos de América,291,301,,592,-75.736374,4.815189
38544,2016,Julio,Estados Unidos de América,3903,6768,,10671,-75.42726,6.170465
38545,2016,Julio,Estados Unidos de América,35,60,,95,-73.181317,7.1280470000000005
38546,2016,Julio,Estados Unidos de América,57,56,,113,-72.508188,7.927233
38547,2016,Julio,Estados Unidos de América,0,2,,2,-76.7333,8.06667
38548,2016,Julio,Estados Unidos de América,1,22,,23,-75.68164200000001,9.402597
38549,2016,Julio,Estonia,1,2,,3,-74.140516,4.697157
38550,2016,Julio,Etiopia,2,1,,3,-74.140516,4.697157
38551,2016,Julio,Filipinas,0,2,,2,-75.516486,10.446304
38552,2016,Julio,Filipinas,0,1,,1,-74.77647900000001,10.886686
38553,2016,Julio,Filipinas,0,1,,1,-81.70216500000001,12.5862
38554,2016,Julio,Filipinas,0,1,,1,-76.532004,3.451668
38555,2016,Julio,Filipinas,3,10,,13,-74.140516,4.697157
38556,2016,Julio,Filipinas,0,1,,1,-75.42726,6.170465
38557,2016,Julio,Finlandia,7,3,,10,-74.140516,4.697157
38558,2016,Julio,Francia,0,3,,3,-75.527794,10.406342
38559,2016,Julio,Francia,1,2,,3,-75.516486,10.446304
38560,2016,Julio,Francia,0,5,,5,-74.77647900000001,10.886686
38561,2016,Julio,Francia,1,0,,1,-81.70216500000001,12.5862
38562,2016,Julio,Francia,68,92,,160,-76.532004,3.451668
38563,2016,Julio,Francia,1,0,,1,-77.061029,3.8844260000000004
38564,2016,Julio,Francia,1546,2244,,3790,-74.140516,4.697157
38565,2016,Julio,Francia,3,11,,14,-75.736374,4.815189
38566,2016,Julio,Francia,78,102,,180,-75.42726,6.170465
38567,2016,Julio,Francia,1,0,,1,-73.181317,7.1280470000000005
38568,2016,Julio,Georgia,1,0,,1,-74.140516,4.697157
38569,2016,Julio,Ghana,1,0,,1,-74.140516,4.697157
38570,2016,Julio,Grecia,1,1,,2,-76.532004,3.451668
38571,2016,Julio,Grecia,5,4,,9,-74.140516,4.697157
38572,2016,Julio,Grecia,0,1,,1,-75.42726,6.170465
38573,2016,Julio,Guatemala,7,4,,11,-75.516486,10.446304
38574,2016,Julio,Guatemala,0,3,,3,-74.77647900000001,10.886686
38575,2016,Julio,Guatemala,25,16,,41,-81.70216500000001,12.5862
38576,2016,Julio,Guatemala,8,31,,39,-76.532004,3.451668
38577,2016,Julio,Guatemala,336,609,,945,-74.140516,4.697157
38578,2016,Julio,Guatemala,5,13,,18,-75.736374,4.815189
38579,2016,Julio,Guatemala,81,140,,221,-75.42726,6.170465
38580,2016,Julio,Guatemala,4,2,,6,-73.181317,7.1280470000000005
38581,2016,Julio,Guatemala,3,2,,5,-72.508188,7.927233
38582,2016,Julio,Guyana,1,4,,5,-74.140516,4.697157
38583,2016,Julio,Guadalupe/Territorio Francés,0,2,,2,-76.532004,3.451668
38584,2016,Julio,Guadalupe/Territorio Francés,3,7,,10,-74.140516,4.697157
38585,2016,Julio,Guadalupe/Territorio Francés,0,1,,1,-75.736374,4.815189
38586,2016,Julio,Guayana Francesa/Departamento de Ultramar Francés,0,1,,1,-74.140516,4.697157
38587,2016,Julio,Haití,3,2,,5,-74.140516,4.697157
38588,2016,Julio,Haití,1,0,,1,-75.42726,6.170465
38589,2016,Julio,Honduras,5,3,,8,-75.516486,10.446304
38590,2016,Julio,Honduras,2,2,,4,-74.77647900000001,10.886686
38591,2016,Julio,Honduras,3,24,,27,-81.703935,12.574411099999999
38592,2016,Julio,Honduras,11,17,,28,-76.532004,3.451668
38593,2016,Julio,Honduras,81,125,,206,-74.140516,4.697157
38594,2016,Julio,Honduras,1,0,,1,-75.736374,4.815189
38595,2016,Julio,Honduras,58,61,,119,-75.42726,6.170465
38596,2016,Julio,Honduras,1,0,,1,-73.181317,7.1280470000000005
38597,2016,Julio,Honduras,0,1,,1,-72.508188,7.927233
38598,2016,Julio,Honduras,0,1,,1,-77.35002,8.63337
38599,2016,Julio,Hong Kong,2,6,,8,-74.140516,4.697157
38600,2016,Julio,Hong Kong,1,2,,3,-75.42726,6.170465
38601,2016,Julio,Hungría,6,7,,13,-74.140516,4.697157
38602,2016,Julio,India,0,1,,1,-74.77647900000001,10.886686
38603,2016,Julio,India,1,2,,3,-76.532004,3.451668
38604,2016,Julio,India,3,38,,41,-74.140516,4.697157
38605,2016,Julio,India,2,11,,13,-75.42726,6.170465
38606,2016,Julio,Indonesia,2,5,,7,-74.140516,4.697157
38607,2016,Julio,Irán,1,0,,1,-74.140516,4.697157
38608,2016,Julio,República de Irlanda,1,1,,2,-76.532004,3.451668
38609,2016,Julio,República de Irlanda,9,18,,27,-74.140516,4.697157
38610,2016,Julio,República de Irlanda,1,1,,2,-75.736374,4.815189
38611,2016,Julio,República de Irlanda,3,5,,8,-75.42726,6.170465
38612,2016,Julio,Israel,2,0,,2,-75.516486,10.446304
38613,2016,Julio,Israel,1,2,,3,-76.532004,3.451668
38614,2016,Julio,Israel,17,61,,78,-74.140516,4.697157
38615,2016,Julio,Israel,3,6,,9,-75.42726,6.170465
38616,2016,Julio,Italia,0,1,,1,-75.516486,10.446304
38617,2016,Julio,Italia,1,1,,2,-74.77647900000001,10.886686
38618,2016,Julio,Italia,30,38,,68,-76.532004,3.451668
38619,2016,Julio,Italia,137,236,,373,-74.140516,4.697157
38620,2016,Julio,Italia,0,2,,2,-75.736374,4.815189
38621,2016,Julio,Italia,14,33,,47,-75.42726,6.170465
38622,2016,Julio,Italia,0,1,,1,-73.181317,7.1280470000000005
38623,2016,Julio,Italia,0,2,,2,-72.508188,7.927233
38624,2016,Julio,Jamaica,2,5,,7,-75.527794,10.406342
38625,2016,Julio,Jamaica,0,1,,1,-75.516486,10.446304
38626,2016,Julio,Jamaica,1,9,,10,-74.77647900000001,10.886686
38627,2016,Julio,Jamaica,0,2,,2,-74.765343,10.970933
38628,2016,Julio,Jamaica,2,2,,4,-81.70216500000001,12.5862
38629,2016,Julio,Jamaica,2,3,,5,-81.372937,13.338761300000002
38630,2016,Julio,Jamaica,6,1,,7,-76.532004,3.451668
38631,2016,Julio,Jamaica,6,6,,12,-74.140516,4.697157
38632,2016,Julio,Jamaica,2,5,,7,-75.42726,6.170465
38633,2016,Julio,Jamaica,0,1,,1,-72.508188,7.927233
38634,2016,Julio,Japón,0,1,,1,-74.77647900000001,10.886686
38635,2016,Julio,Japón,1,1,,2,-76.532004,3.451668
38636,2016,Julio,Japón,16,22,,38,-74.140516,4.697157
38637,2016,Julio,Japón,8,18,,26,-75.42726,6.170465
38638,2016,Julio,Jordania,1,0,,1,-74.140516,4.697157
38639,2016,Julio,Kazajistán,1,0,,1,-74.140516,4.697157
38640,2016,Julio,Kenia,1,2,,3,-76.532004,3.451668
38641,2016,Julio,Kenia,4,7,,11,-74.140516,4.697157
38642,2016,Julio,Letonia,1,0,,1,-74.140516,4.697157
38643,2016,Julio,Lituania,1,1,,2,-76.532004,3.451668
38644,2016,Julio,Lituania,2,5,,7,-74.140516,4.697157
38645,2016,Julio,Líbano,5,7,,12,-74.140516,4.697157
38646,2016,Julio,Luxemburgo,0,1,,1,-76.532004,3.451668
38647,2016,Julio,Luxemburgo,2,0,,2,-74.140516,4.697157
38648,2016,Julio,Luxemburgo,1,0,,1,-75.42726,6.170465
38649,2016,Julio,Malasia,2,5,,7,-74.140516,4.697157
38650,2016,Julio,Maldivas,0,1,,1,-74.140516,4.697157
38651,2016,Julio,Malta,3,3,,6,-74.140516,4.697157
38652,2016,Julio,Marruecos,0,1,,1,-74.765343,10.970933
38653,2016,Julio,Marruecos,2,2,,4,-74.140516,4.697157
38654,2016,Julio,Mauricio,1,0,,1,-75.42726,6.170465
38655,2016,Julio,Mauritania,1,0,,1,-74.140516,4.697157
38656,2016,Julio,Martinica/Departamento de Ultramar Francés,0,2,,2,-74.140516,4.697157
38657,2016,Julio,Martinica/Departamento de Ultramar Francés,1,0,,1,-75.736374,4.815189
38658,2016,Julio,México,1,11,,12,-75.527794,10.406342
38659,2016,Julio,México,27,35,,62,-75.516486,10.446304
38660,2016,Julio,México,38,36,,74,-74.77647900000001,10.886686
38661,2016,Julio,México,0,1,,1,-74.213989,11.247722999999999
38662,2016,Julio,México,20,27,,47,-81.70216500000001,12.5862
38663,2016,Julio,México,71,179,,250,-76.532004,3.451668
38664,2016,Julio,México,5943,8354,,14297,-74.140516,4.697157
38665,2016,Julio,México,64,50,,114,-75.736374,4.815189
38666,2016,Julio,México,886,1608,,2494,-75.42726,6.170465
38667,2016,Julio,México,25,33,,58,-73.181317,7.1280470000000005
38668,2016,Julio,México,15,11,,26,-72.508188,7.927233
38669,2016,Julio,Nicaragua,0,1,,1,-75.527794,10.406342
38670,2016,Julio,Nicaragua,1,1,,2,-75.516486,10.446304
38671,2016,Julio,Nicaragua,0,2,,2,-74.77647900000001,10.886686
38672,2016,Julio,Nicaragua,2,4,,6,-81.703935,12.574411099999999
38673,2016,Julio,Nicaragua,2,0,,2,-81.70216500000001,12.5862
38674,2016,Julio,Nicaragua,2,3,,5,-76.532004,3.451668
38675,2016,Julio,Nicaragua,34,57,,91,-74.140516,4.697157
38676,2016,Julio,Nicaragua,1,1,,2,-75.736374,4.815189
38677,2016,Julio,Nicaragua,7,19,,26,-75.42726,6.170465
38678,2016,Julio,Nicaragua,1,2,,3,-73.181317,7.1280470000000005
38679,2016,Julio,Nicaragua,0,1,,1,-72.508188,7.927233
38680,2016,Julio,Noruega,1,0,,1,-74.77647900000001,10.886686
38681,2016,Julio,Noruega,1,2,,3,-76.532004,3.451668
38682,2016,Julio,Noruega,17,21,,38,-74.140516,4.697157
38683,2016,Julio,Noruega,7,7,,14,-75.42726,6.170465
38684,2016,Julio,Nueva Zelanda,10,7,,17,-74.140516,4.697157
38685,2016,Julio,Nueva Zelanda,3,6,,9,-75.42726,6.170465
38686,2016,Julio,Panamá,160,240,,400,-75.527794,10.406342
38687,2016,Julio,Panamá,3309,3621,,6930,-75.516486,10.446304
38688,2016,Julio,Panamá,363,620,,983,-74.77647900000001,10.886686
38689,2016,Julio,Panamá,1,26,,27,-74.765343,10.970933
38690,2016,Julio,Panamá,1,3,,4,-74.213989,11.247722999999999
38691,2016,Julio,Panamá,2,4,,6,-81.703935,12.574411099999999
38692,2016,Julio,Panamá,159,158,,317,-81.70216500000001,12.5862
38693,2016,Julio,Panamá,340,516,,856,-76.532004,3.451668
38694,2016,Julio,Panamá,2,6,,8,-77.061029,3.8844260000000004
38695,2016,Julio,Panamá,22,48,,70,-75.76635300000001,4.45285
38696,2016,Julio,Panamá,4460,6142,,10602,-74.140516,4.697157
38697,2016,Julio,Panamá,116,135,,251,-75.736374,4.815189
38698,2016,Julio,Panamá,2252,2900,,5152,-75.42726,6.170465
38699,2016,Julio,Panamá,2,2,,4,-77.762647,7.102626
38700,2016,Julio,Panamá,21,39,,60,-73.181317,7.1280470000000005
38701,2016,Julio,Panamá,34,52,,86,-72.508188,7.927233
38702,2016,Julio,Panamá,125,129,,254,-77.35002,8.63337
38703,2016,Julio,Paraguay,4,5,,9,-75.516486,10.446304
38704,2016,Julio,Paraguay,0,2,,2,-74.77647900000001,10.886686
38705,2016,Julio,Paraguay,66,52,,118,-81.70216500000001,12.5862
38706,2016,Julio,Paraguay,16,9,,25,-76.532004,3.451668
38707,2016,Julio,Paraguay,48,55,,103,-74.140516,4.697157
38708,2016,Julio,Paraguay,0,6,,6,-75.736374,4.815189
38709,2016,Julio,Paraguay,13,35,,48,-75.42726,6.170465
38710,2016,Julio,Paraguay,4,4,,8,-72.508188,7.927233
38711,2016,Julio,Perú,210,294,,504,-69.941498,4.191162
38712,2016,Julio,Perú,0,2,,2,-74.78366,0.18595699999999998
38713,2016,Julio,Perú,135,94,,229,-77.35600000000001,0.81488
38714,2016,Julio,Perú,0,28,,28,-75.527794,10.406342
38715,2016,Julio,Perú,25,17,,42,-75.516486,10.446304
38716,2016,Julio,Perú,3,2,,5,-74.77647900000001,10.886686
38717,2016,Julio,Perú,116,80,,196,-81.70216500000001,12.5862
38718,2016,Julio,Perú,437,548,,985,-76.532004,3.451668
38719,2016,Julio,Perú,0,16,,16,-77.061029,3.8844260000000004
38720,2016,Julio,Perú,6675,8213,,14888,-74.140516,4.697157
38721,2016,Julio,Perú,0,2,,2,-75.736374,4.815189
38722,2016,Julio,Perú,572,769,,1341,-75.42726,6.170465
38723,2016,Julio,Perú,2,3,,5,-73.181317,7.1280470000000005
38724,2016,Julio,Perú,1,2,,3,-72.508188,7.927233
38725,2016,Julio,Palestina,1,0,,1,-74.140516,4.697157
38726,2016,Julio,Polonia,0,1,,1,-76.532004,3.451668
38727,2016,Julio,Polonia,23,31,,54,-74.140516,4.697157
38728,2016,Julio,Polonia,0,4,,4,-75.42726,6.170465
38729,2016,Julio,Portugal,1,5,,6,-76.532004,3.451668
38730,2016,Julio,Portugal,17,48,,65,-74.140516,4.697157
38731,2016,Julio,Portugal,3,18,,21,-75.42726,6.170465
38732,2016,Julio,Polinesia Francesa/Colectividad de Ultramar Francesa,2,0,,2,-74.140516,4.697157
38733,2016,Julio,Puerto Rico/Territorio de Estados Unidos,6,6,,12,-75.516486,10.446304
38734,2016,Julio,Puerto Rico/Territorio de Estados Unidos,8,42,,50,-74.77647900000001,10.886686
38735,2016,Julio,Puerto Rico/Territorio de Estados Unidos,1,0,,1,-81.70216500000001,12.5862
38736,2016,Julio,Puerto Rico/Territorio de Estados Unidos,25,44,,69,-76.532004,3.451668
38737,2016,Julio,Puerto Rico/Territorio de Estados Unidos,695,677,,1372,-74.140516,4.697157
38738,2016,Julio,Puerto Rico/Territorio de Estados Unidos,4,19,,23,-75.736374,4.815189
38739,2016,Julio,Puerto Rico/Territorio de Estados Unidos,117,166,,283,-75.42726,6.170465
38740,2016,Julio,Puerto Rico/Territorio de Estados Unidos,2,6,,8,-73.181317,7.1280470000000005
38741,2016,Julio,Puerto Rico/Territorio de Estados Unidos,8,7,,15,-72.508188,7.927233
38742,2016,Julio,Qatar,5,32,,37,-74.140516,4.697157
38743,2016,Julio,Reino Unido de Gran Bretaña e Irlanda del Norte,0,2,,2,-75.516486,10.446304
38744,2016,Julio,Reino Unido de Gran Bretaña e Irlanda del Norte,0,1,,1,-74.77647900000001,10.886686
38745,2016,Julio,Reino Unido de Gran Bretaña e Irlanda del Norte,0,2,,2,-74.213989,11.247722999999999
38746,2016,Julio,Reino Unido de Gran Bretaña e Irlanda del Norte,69,72,,141,-76.532004,3.451668
38747,2016,Julio,Reino Unido de Gran Bretaña e Irlanda del Norte,807,1142,,1949,-74.140516,4.697157
38748,2016,Julio,Reino Unido de Gran Bretaña e Irlanda del Norte,0,1,,1,-75.736374,4.815189
38749,2016,Julio,Reino Unido de Gran Bretaña e Irlanda del Norte,64,66,,130,-75.42726,6.170465
38750,2016,Julio,República CentroÁfricana,2,1,,3,-74.140516,4.697157
38751,2016,Julio,Federación de Rusia,4,3,,7,-76.532004,3.451668
38752,2016,Julio,Federación de Rusia,13,19,,32,-74.140516,4.697157
38753,2016,Julio,Federación de Rusia,0,2,,2,-75.736374,4.815189
38754,2016,Julio,Federación de Rusia,1,0,,1,-73.181317,7.1280470000000005
38755,2016,Julio,República Dominicana,0,12,,12,-75.527794,10.406342
38756,2016,Julio,República Dominicana,3,5,,8,-75.516486,10.446304
38757,2016,Julio,República Dominicana,17,23,,40,-74.77647900000001,10.886686
38758,2016,Julio,República Dominicana,3,10,,13,-81.70216500000001,12.5862
38759,2016,Julio,República Dominicana,17,24,,41,-76.532004,3.451668
38760,2016,Julio,República Dominicana,714,962,,1676,-74.140516,4.697157
38761,2016,Julio,República Dominicana,3,15,,18,-75.736374,4.815189
38762,2016,Julio,República Dominicana,86,88,,174,-75.42726,6.170465
38763,2016,Julio,República Dominicana,4,4,,8,-73.181317,7.1280470000000005
38764,2016,Julio,República Dominicana,4,5,,9,-72.508188,7.927233
38765,2016,Julio,Rumania,0,1,,1,-75.516486,10.446304
38766,2016,Julio,Rumania,1,0,,1,-76.532004,3.451668
38767,2016,Julio,Rumania,5,10,,15,-74.140516,4.697157
38768,2016,Julio,Rumania,0,1,,1,-75.42726,6.170465
38769,2016,Julio,Rwanda,1,0,,1,-74.140516,4.697157
38770,2016,Julio,San Cristóbal y Nevis,2,0,,2,-74.140516,4.697157
38771,2016,Julio,Santa Lucia,1,1,,2,-76.532004,3.451668
38772,2016,Julio,Santa Sede/Ciudad del Vaticano,0,1,,1,-74.140516,4.697157
38773,2016,Julio,Senegal,1,1,,2,-74.140516,4.697157
38774,2016,Julio,Serbia,2,1,,3,-74.140516,4.697157
38775,2016,Julio,Singapur,5,4,,9,-74.140516,4.697157
38776,2016,Julio,Singapur,0,1,,1,-75.42726,6.170465
38777,2016,Julio,Sri Lanka,0,1,,1,-74.140516,4.697157
38778,2016,Julio,Sudáfrica,0,2,,2,-76.532004,3.451668
38779,2016,Julio,Sudáfrica,4,7,,11,-74.140516,4.697157
38780,2016,Julio,Sudáfrica,1,0,,1,-75.42726,6.170465
38781,2016,Julio,Suecia,0,1,,1,-75.516486,10.446304
38782,2016,Julio,Suecia,0,1,,1,-74.77647900000001,10.886686
38783,2016,Julio,Suecia,3,6,,9,-76.532004,3.451668
38784,2016,Julio,Suecia,9,26,,35,-74.140516,4.697157
38785,2016,Julio,Suecia,1,0,,1,-75.736374,4.815189
38786,2016,Julio,Suecia,8,11,,19,-75.42726,6.170465
38787,2016,Julio,Suecia,0,3,,3,-73.181317,7.1280470000000005
38788,2016,Julio,Suiza,1,2,,3,-74.77647900000001,10.886686
38789,2016,Julio,Suiza,2,2,,4,-81.70216500000001,12.5862
38790,2016,Julio,Suiza,32,44,,76,-76.532004,3.451668
38791,2016,Julio,Suiza,175,203,,378,-74.140516,4.697157
38792,2016,Julio,Suiza,0,1,,1,-75.736374,4.815189
38793,2016,Julio,Suiza,36,51,,87,-75.42726,6.170465
38794,2016,Julio,Surinam,0,15,,15,-75.527794,10.406342
38795,2016,Julio,Surinam,0,1,,1,-74.77647900000001,10.886686
38796,2016,Julio,Surinam,1,2,,3,-74.140516,4.697157
38797,2016,Julio,Surinam,1,1,,2,-75.42726,6.170465
38798,2016,Julio,Tailandia,4,2,,6,-74.140516,4.697157
38799,2016,Julio,Tailandia,1,2,,3,-75.42726,6.170465
38800,2016,Julio,Trinidad y Tobago,0,7,,7,-75.527794,10.406342
38801,2016,Julio,Trinidad y Tobago,0,1,,1,-74.77647900000001,10.886686
38802,2016,Julio,Trinidad y Tobago,3,8,,11,-76.532004,3.451668
38803,2016,Julio,Trinidad y Tobago,13,5,,18,-74.140516,4.697157
38804,2016,Julio,Trinidad y Tobago,1,0,,1,-75.736374,4.815189
38805,2016,Julio,Trinidad y Tobago,1,10,,11,-75.42726,6.170465
38806,2016,Julio,Trinidad y Tobago,3,4,,7,-73.181317,7.1280470000000005
38807,2016,Julio,Trinidad y Tobago,1,0,,1,-72.508188,7.927233
38808,2016,Julio,Túnez,2,2,,4,-74.140516,4.697157
38809,2016,Julio,Turkmenistán,6,3,,9,-74.140516,4.697157
38810,2016,Julio,Turquía,0,8,,8,-74.765343,10.970933
38811,2016,Julio,Turquía,1,0,,1,-76.532004,3.451668
38812,2016,Julio,Turquía,452,594,,1046,-74.140516,4.697157
38813,2016,Julio,Turquía,0,1,,1,-75.42726,6.170465
38814,2016,Julio,Ucrania,0,1,,1,-74.77647900000001,10.886686
38815,2016,Julio,Ucrania,1,0,,1,-75.42726,6.170465
38816,2016,Julio,Uruguay,1,6,,7,-75.516486,10.446304
38817,2016,Julio,Uruguay,0,3,,3,-74.77647900000001,10.886686
38818,2016,Julio,Uruguay,20,12,,32,-81.70216500000001,12.5862
38819,2016,Julio,Uruguay,6,10,,16,-76.532004,3.451668
38820,2016,Julio,Uruguay,63,107,,170,-74.140516,4.697157
38821,2016,Julio,Uruguay,3,0,,3,-75.736374,4.815189
38822,2016,Julio,Uruguay,44,38,,82,-75.42726,6.170465
38823,2016,Julio,Vanuatu,0,1,,1,-74.140516,4.697157
38824,2016,Julio,Venezuela,0,1,,1,-75.527794,10.406342
38825,2016,Julio,Venezuela,29,40,,69,-75.516486,10.446304
38826,2016,Julio,Venezuela,18,51,,69,-74.77647900000001,10.886686
38827,2016,Julio,Venezuela,1,10,,11,-74.232675,11.117206
38828,2016,Julio,Venezuela,0,1,,1,-74.213989,11.247722999999999
38829,2016,Julio,Venezuela,2209,2843,,5052,-72.129595,11.360028999999999
38830,2016,Julio,Venezuela,2,4,,6,-81.70216500000001,12.5862
38831,2016,Julio,Venezuela,8,25,,33,-76.532004,3.451668
38832,2016,Julio,Venezuela,9,23,,32,-67.927521,3.866713
38833,2016,Julio,Venezuela,4487,4615,,9102,-74.140516,4.697157
38834,2016,Julio,Venezuela,1,3,,4,-75.736374,4.815189
38835,2016,Julio,Venezuela,963,959,,1922,-75.42726,6.170465
38836,2016,Julio,Venezuela,31,43,,74,-67.48402800000001,6.185536
38837,2016,Julio,Venezuela,44,45,,89,-70.74025300000001,7.088728999999999
38838,2016,Julio,Venezuela,5,3,,8,-73.181317,7.1280470000000005
38839,2016,Julio,Venezuela,2517,3113,,5630,-72.453013,7.819
38840,2016,Julio,Venezuela,263,288,,551,-72.508188,7.927233
38841,2016,Julio,Venezuela,18,22,,40,-72.409396,8.36068
38842,2016,Julio,Vietnam,0,3,,3,-74.140516,4.697157
38843,2016,Julio,Vietnam,0,1,,1,-75.42726,6.170465
38844,2016,Julio,Islas Vírgenes Británicas/Territorio Británico de Ultramar,2,0,,2,-74.140516,4.697157
38845,2016,Julio,Islas Vírgenes Británicas/Territorio Británico de Ultramar,0,1,,1,-75.42726,6.170465
38846,2016,Julio,República Árabe de Yemen,0,1,,1,-74.140516,4.697157
38847,2016,Julio,Zimbabue,0,1,,1,-74.140516,4.697157
38848,2016,Agosto,Afganistán,0,1,,1,-75.42726,6.170465
38849,2016,Agosto,Albania,1,0,,1,-76.532004,3.451668
38850,2016,Agosto,Albania,2,1,,3,-74.140516,4.697157
38851,2016,Agosto,Albania,0,1,,1,-75.42726,6.170465
38852,2016,Agosto,Alemania,0,3,,3,-75.527794,10.406342
38853,2016,Agosto,Alemania,2,2,,4,-75.516486,10.446304
38854,2016,Agosto,Alemania,7,10,,17,-74.77647900000001,10.886686
38855,2016,Agosto,Alemania,0,1,,1,-74.213989,11.247722999999999
38856,2016,Agosto,Alemania,31,39,,70,-76.532004,3.451668
38857,2016,Agosto,Alemania,1631,2188,,3819,-74.140516,4.697157
38858,2016,Agosto,Alemania,0,6,,6,-75.736374,4.815189
38859,2016,Agosto,Alemania,49,60,,109,-75.42726,6.170465
38860,2016,Agosto,Alemania,0,1,,1,-73.181317,7.1280470000000005
38861,2016,Agosto,Andorra,0,1,,1,-76.532004,3.451668
38862,2016,Agosto,Andorra,0,1,,1,-75.42726,6.170465
38863,2016,Agosto,Angola,0,1,,1,-74.140516,4.697157
38864,2016,Agosto,Antigua y Barbuda,0,1,,1,-75.527794,10.406342
38865,2016,Agosto,Antigua y Barbuda,0,3,,3,-74.140516,4.697157
38866,2016,Agosto,Antigua y Barbuda,0,1,,1,-75.42726,6.170465
38867,2016,Agosto,Países Bajos,0,8,,8,-75.527794,10.406342
38868,2016,Agosto,Países Bajos,2,4,,6,-75.516486,10.446304
38869,2016,Agosto,Países Bajos,80,108,,188,-74.77647900000001,10.886686
38870,2016,Agosto,Países Bajos,2,4,,6,-74.213989,11.247722999999999
38871,2016,Agosto,Países Bajos,83,148,,231,-76.532004,3.451668
38872,2016,Agosto,Países Bajos,734,988,,1722,-74.140516,4.697157
38873,2016,Agosto,Países Bajos,1,3,,4,-75.736374,4.815189
38874,2016,Agosto,Países Bajos,235,282,,517,-75.42726,6.170465
38875,2016,Agosto,Países Bajos,1,2,,3,-73.181317,7.1280470000000005
38876,2016,Agosto,Arabia Saudita,0,2,,2,-74.140516,4.697157
38877,2016,Agosto,Argelia,0,1,,1,-76.532004,3.451668
38878,2016,Agosto,Argelia,7,3,,10,-74.140516,4.697157
38879,2016,Agosto,Argelia,0,1,,1,-75.42726,6.170465
38880,2016,Agosto,Argentina,13,7,,20,-77.35600000000001,0.81488
38881,2016,Agosto,Argentina,0,1,,1,-75.527794,10.406342
38882,2016,Agosto,Argentina,35,22,,57,-75.516486,10.446304
38883,2016,Agosto,Argentina,9,10,,19,-74.77647900000001,10.886686
38884,2016,Agosto,Argentina,194,131,,325,-81.70216500000001,12.5862
38885,2016,Agosto,Argentina,73,76,,149,-76.532004,3.451668
38886,2016,Agosto,Argentina,2603,3989,,6592,-74.140516,4.697157
38887,2016,Agosto,Argentina,0,4,,4,-75.736374,4.815189
38888,2016,Agosto,Argentina,72,147,,219,-75.42726,6.170465
38889,2016,Agosto,Argentina,2,1,,3,-73.181317,7.1280470000000005
38890,2016,Agosto,República de Armenia,1,0,,1,-74.140516,4.697157
38891,2016,Agosto,Aruba,1,17,,18,-75.527794,10.406342
38892,2016,Agosto,Aruba,4,6,,10,-74.77647900000001,10.886686
38893,2016,Agosto,Aruba,3,7,,10,-74.213989,11.247722999999999
38894,2016,Agosto,Aruba,11,12,,23,-76.532004,3.451668
38895,2016,Agosto,Aruba,651,785,,1436,-74.140516,4.697157
38896,2016,Agosto,Aruba,0,1,,1,-75.736374,4.815189
38897,2016,Agosto,Aruba,113,126,,239,-75.42726,6.170465
38898,2016,Agosto,Aruba,9,4,,13,-73.181317,7.1280470000000005
38899,2016,Agosto,Aruba,0,1,,1,-72.508188,7.927233
38900,2016,Agosto,Australia,1,1,,2,-75.516486,10.446304
38901,2016,Agosto,Australia,0,1,,1,-74.77647900000001,10.886686
38902,2016,Agosto,Australia,0,2,,2,-81.70216500000001,12.5862
38903,2016,Agosto,Australia,0,1,,1,-76.532004,3.451668
38904,2016,Agosto,Australia,35,59,,94,-74.140516,4.697157
38905,2016,Agosto,Australia,0,1,,1,-75.736374,4.815189
38906,2016,Agosto,Australia,10,18,,28,-75.42726,6.170465
38907,2016,Agosto,Austria,2,1,,3,-76.532004,3.451668
38908,2016,Agosto,Austria,22,42,,64,-74.140516,4.697157
38909,2016,Agosto,Austria,1,2,,3,-75.42726,6.170465
38910,2016,Agosto,Azerbaiyán,0,2,,2,-74.140516,4.697157
38911,2016,Agosto,Bahamas,2,9,,11,-75.527794,10.406342
38912,2016,Agosto,Bahamas,0,2,,2,-74.213989,11.247722999999999
38913,2016,Agosto,Bahamas,1,0,,1,-76.532004,3.451668
38914,2016,Agosto,Bahamas,3,6,,9,-74.140516,4.697157
38915,2016,Agosto,Bahamas,4,5,,9,-75.42726,6.170465
38916,2016,Agosto,Bahréin,1,0,,1,-75.516486,10.446304
38917,2016,Agosto,Bangladesh,0,1,,1,-74.140516,4.697157
38918,2016,Agosto,Barbados,42,53,,95,-74.140516,4.697157
38919,2016,Agosto,República de Belarús,3,1,,4,-74.140516,4.697157
38920,2016,Agosto,República de Belarús,1,0,,1,-72.453013,7.819
38921,2016,Agosto,República de Belarús,1,0,,1,-72.409396,8.36068
38922,2016,Agosto,Bélgica,1,0,,1,-75.516486,10.446304
38923,2016,Agosto,Bélgica,5,8,,13,-76.532004,3.451668
38924,2016,Agosto,Bélgica,33,36,,69,-74.140516,4.697157
38925,2016,Agosto,Bélgica,7,11,,18,-75.42726,6.170465
38926,2016,Agosto,Belice,5,4,,9,-74.140516,4.697157
38927,2016,Agosto,Benín,1,3,,4,-74.140516,4.697157
38928,2016,Agosto,Bermudas/Territorio Británico de Ultramar,0,1,,1,-74.140516,4.697157
38929,2016,Agosto,Bolivia,0,1,,1,-77.35600000000001,0.81488
38930,2016,Agosto,Bolivia,4,3,,7,-75.516486,10.446304
38931,2016,Agosto,Bolivia,19,7,,26,-81.70216500000001,12.5862
38932,2016,Agosto,Bolivia,12,22,,34,-76.532004,3.451668
38933,2016,Agosto,Bolivia,432,541,,973,-74.140516,4.697157
38934,2016,Agosto,Bolivia,1,1,,2,-75.736374,4.815189
38935,2016,Agosto,Bolivia,28,42,,70,-75.42726,6.170465
38936,2016,Agosto,Bolivia,0,1,,1,-73.181317,7.1280470000000005
38937,2016,Agosto,Brasil,129,178,,307,-69.941498,4.191162
38938,2016,Agosto,Brasil,0,8,,8,-75.527794,10.406342
38939,2016,Agosto,Brasil,55,43,,98,-75.516486,10.446304
38940,2016,Agosto,Brasil,7,10,,17,-74.77647900000001,10.886686
38941,2016,Agosto,Brasil,439,306,,745,-81.70216500000001,12.5862
38942,2016,Agosto,Brasil,24,62,,86,-76.532004,3.451668
38943,2016,Agosto,Brasil,0,6,,6,-67.927521,3.866713
38944,2016,Agosto,Brasil,4295,5875,,10170,-74.140516,4.697157
38945,2016,Agosto,Brasil,2,5,,7,-75.736374,4.815189
38946,2016,Agosto,Brasil,82,128,,210,-75.42726,6.170465
38947,2016,Agosto,Brasil,0,1,,1,-73.181317,7.1280470000000005
38948,2016,Agosto,Brasil,0,1,,1,-72.508188,7.927233
38949,2016,Agosto,Bulgaria,1,3,,4,-74.140516,4.697157
38950,2016,Agosto,Islas Caimán/Territorio Británico de Ultramar,9,9,,18,-81.70216500000001,12.5862
38951,2016,Agosto,Islas Caimán/Territorio Británico de Ultramar,1,2,,3,-81.372937,13.338761300000002
38952,2016,Agosto,Camboya,1,0,,1,-74.140516,4.697157
38953,2016,Agosto,Camerún,1,1,,2,-70.74025300000001,7.088728999999999
38954,2016,Agosto,Canadá,13,20,,33,-75.516486,10.446304
38955,2016,Agosto,Canadá,3,9,,12,-74.77647900000001,10.886686
38956,2016,Agosto,Canadá,0,1,,1,-74.765343,10.970933
38957,2016,Agosto,Canadá,0,2,,2,-81.70216500000001,12.5862
38958,2016,Agosto,Canadá,35,62,,97,-76.532004,3.451668
38959,2016,Agosto,Canadá,628,913,,1541,-74.140516,4.697157
38960,2016,Agosto,Canadá,8,16,,24,-75.736374,4.815189
38961,2016,Agosto,Canadá,74,143,,217,-75.42726,6.170465
38962,2016,Agosto,Canadá,4,5,,9,-73.181317,7.1280470000000005
38963,2016,Agosto,Canadá,1,0,,1,-72.508188,7.927233
38964,2016,Agosto,Chad,1,2,,3,-74.140516,4.697157
38965,2016,Agosto,España,0,1,,1,-75.527794,10.406342
38966,2016,Agosto,España,1,2,,3,-75.516486,10.446304
38967,2016,Agosto,España,4,24,,28,-74.77647900000001,10.886686
38968,2016,Agosto,España,3,4,,7,-81.70216500000001,12.5862
38969,2016,Agosto,España,501,735,,1236,-76.532004,3.451668
38970,2016,Agosto,España,4331,6282,,10613,-74.140516,4.697157
38971,2016,Agosto,España,5,8,,13,-75.736374,4.815189
38972,2016,Agosto,España,322,502,,824,-75.42726,6.170465
38973,2016,Agosto,España,1,4,,5,-73.181317,7.1280470000000005
38974,2016,Agosto,España,0,1,,1,-72.508188,7.927233
38975,2016,Agosto,República Del Congo,1,0,,1,-74.140516,4.697157
38976,2016,Agosto,República de Corea,9,23,,32,-74.140516,4.697157
38977,2016,Agosto,República de Corea,1,5,,6,-75.42726,6.170465
38978,2016,Agosto,Islas Malvinas,0,2,,2,-76.532004,3.451668
38979,2016,Agosto,Costa de Marfil,0,1,,1,-75.516486,10.446304
38980,2016,Agosto,Costa de Marfil,0,1,,1,-76.532004,3.451668
38981,2016,Agosto,Costa de Marfil,2,2,,4,-74.140516,4.697157
38982,2016,Agosto,Costa Rica,0,3,,3,-75.527794,10.406342
38983,2016,Agosto,Costa Rica,12,18,,30,-75.516486,10.446304
38984,2016,Agosto,Costa Rica,9,10,,19,-74.77647900000001,10.886686
38985,2016,Agosto,Costa Rica,0,1,,1,-74.765343,10.970933
38986,2016,Agosto,Costa Rica,0,1,,1,-74.213989,11.247722999999999
38987,2016,Agosto,Costa Rica,98,69,,167,-81.70216500000001,12.5862
38988,2016,Agosto,Costa Rica,19,37,,56,-76.532004,3.451668
38989,2016,Agosto,Costa Rica,1059,1621,,2680,-74.140516,4.697157
38990,2016,Agosto,Costa Rica,7,11,,18,-75.736374,4.815189
38991,2016,Agosto,Costa Rica,96,166,,262,-75.42726,6.170465
38992,2016,Agosto,Costa Rica,6,4,,10,-73.181317,7.1280470000000005
38993,2016,Agosto,Croacia,1,3,,4,-76.532004,3.451668
38994,2016,Agosto,Croacia,1,4,,5,-74.140516,4.697157
38995,2016,Agosto,Croacia,0,1,,1,-75.42726,6.170465
38996,2016,Agosto,Cuba,2,4,,6,-75.516486,10.446304
38997,2016,Agosto,Cuba,1,10,,11,-74.77647900000001,10.886686
38998,2016,Agosto,Cuba,2,2,,4,-81.70216500000001,12.5862
38999,2016,Agosto,Cuba,12,16,,28,-76.532004,3.451668
39000,2016,Agosto,Cuba,301,498,,799,-74.140516,4.697157
39001,2016,Agosto,Cuba,3,5,,8,-75.736374,4.815189
39002,2016,Agosto,Cuba,11,49,,60,-75.42726,6.170465
39003,2016,Agosto,Cuba,1,1,,2,-73.181317,7.1280470000000005
39004,2016,Agosto,Cuba,1,0,,1,-72.508188,7.927233
39005,2016,Agosto,Curazao,1,2,,3,-74.140516,4.697157
39006,2016,Agosto,Curazao,0,2,,2,-75.42726,6.170465
39007,2016,Agosto,República Checa,0,1,,1,-76.532004,3.451668
39008,2016,Agosto,República Checa,3,6,,9,-74.140516,4.697157
39009,2016,Agosto,República Checa,1,0,,1,-75.42726,6.170465
39010,2016,Agosto,Chile,3,6,,9,-77.35600000000001,0.81488
39011,2016,Agosto,Chile,18,8,,26,-75.516486,10.446304
39012,2016,Agosto,Chile,0,1,,1,-74.77647900000001,10.886686
39013,2016,Agosto,Chile,100,59,,159,-81.70216500000001,12.5862
39014,2016,Agosto,Chile,40,41,,81,-76.532004,3.451668
39015,2016,Agosto,Chile,5561,6806,,12367,-74.140516,4.697157
39016,2016,Agosto,Chile,3,9,,12,-75.736374,4.815189
39017,2016,Agosto,Chile,21,49,,70,-75.42726,6.170465
39018,2016,Agosto,Chile,0,1,,1,-73.181317,7.1280470000000005
39019,2016,Agosto,Chile,0,4,,4,-72.508188,7.927233
39020,2016,Agosto,China,5,7,,12,-76.532004,3.451668
39021,2016,Agosto,China,49,87,,136,-74.140516,4.697157
39022,2016,Agosto,China,1,7,,8,-75.42726,6.170465
39023,2016,Agosto,Dinamarca,1,0,,1,-75.516486,10.446304
39024,2016,Agosto,Dinamarca,1,3,,4,-76.532004,3.451668
39025,2016,Agosto,Dinamarca,9,10,,19,-74.140516,4.697157
39026,2016,Agosto,Dinamarca,3,2,,5,-75.42726,6.170465
39027,2016,Agosto,Dinamarca,0,1,,1,-73.181317,7.1280470000000005
39028,2016,Agosto,Dominica,0,1,,1,-74.140516,4.697157
39029,2016,Agosto,Ecuador,0,3,,3,-74.78366,0.18595699999999998
39030,2016,Agosto,Ecuador,178,318,,496,-76.876446,0.33002
39031,2016,Agosto,Ecuador,21,32,,53,-77.84700600000001,0.8124359999999999
39032,2016,Agosto,Ecuador,5454,6733,,12187,-77.35600000000001,0.81488
39033,2016,Agosto,Ecuador,31,152,,183,-78.802679,18.00143
39034,2016,Agosto,Ecuador,0,2,,2,-75.527794,10.406342
39035,2016,Agosto,Ecuador,499,347,,846,-75.516486,10.446304
39036,2016,Agosto,Ecuador,2,1,,3,-74.77647900000001,10.886686
39037,2016,Agosto,Ecuador,0,3,,3,-74.765343,10.970933
39038,2016,Agosto,Ecuador,19,15,,34,-81.70216500000001,12.5862
39039,2016,Agosto,Ecuador,517,581,,1098,-76.532004,3.451668
39040,2016,Agosto,Ecuador,1,1,,2,-77.061029,3.8844260000000004
39041,2016,Agosto,Ecuador,4209,5417,,9626,-74.140516,4.697157
39042,2016,Agosto,Ecuador,0,2,,2,-75.736374,4.815189
39043,2016,Agosto,Ecuador,18,61,,79,-75.42726,6.170465
39044,2016,Agosto,Ecuador,2,0,,2,-73.181317,7.1280470000000005
39045,2016,Agosto,Ecuador,1,1,,2,-72.508188,7.927233
39046,2016,Agosto,Egipto,1,11,,12,-74.140516,4.697157
39047,2016,Agosto,El Salvador,10,21,,31,-75.516486,10.446304
39048,2016,Agosto,El Salvador,31,29,,60,-81.70216500000001,12.5862
39049,2016,Agosto,El Salvador,121,168,,289,-76.532004,3.451668
39050,2016,Agosto,El Salvador,1104,1539,,2643,-74.140516,4.697157
39051,2016,Agosto,El Salvador,174,274,,448,-75.42726,6.170465
39052,2016,Agosto,El Salvador,0,1,,1,-72.508188,7.927233
39053,2016,Agosto,Emiratos Árabes,2,5,,7,-74.140516,4.697157
39054,2016,Agosto,Emiratos Árabes,0,1,,1,-75.42726,6.170465
39055,2016,Agosto,Emiratos Árabes,0,1,,1,-73.181317,7.1280470000000005
39056,2016,Agosto,Eslovaquia,2,1,,3,-74.140516,4.697157
39057,2016,Agosto,Eslovaquia,0,1,,1,-75.42726,6.170465
39058,2016,Agosto,Estados Unidos de América,1,23,,24,-75.527794,10.406342
39059,2016,Agosto,Estados Unidos de América,3681,4950,,8631,-75.516486,10.446304
39060,2016,Agosto,Estados Unidos de América,520,907,,1427,-74.77647900000001,10.886686
39061,2016,Agosto,Estados Unidos de América,0,4,,4,-74.765343,10.970933
39062,2016,Agosto,Estados Unidos de América,0,3,,3,-74.232675,11.117206
39063,2016,Agosto,Estados Unidos de América,1,8,,9,-74.213989,11.247722999999999
39064,2016,Agosto,Estados Unidos de América,22,29,,51,-81.70216500000001,12.5862
39065,2016,Agosto,Estados Unidos de América,1234,1627,,2861,-76.532004,3.451668
39066,2016,Agosto,Estados Unidos de América,193,253,,446,-75.76635300000001,4.45285
39067,2016,Agosto,Estados Unidos de América,9028,15232,,24260,-74.140516,4.697157
39068,2016,Agosto,Estados Unidos de América,192,234,,426,-75.736374,4.815189
39069,2016,Agosto,Estados Unidos de América,2975,6299,,9274,-75.42726,6.170465
39070,2016,Agosto,Estados Unidos de América,26,38,,64,-73.181317,7.1280470000000005
39071,2016,Agosto,Estados Unidos de América,33,36,,69,-72.508188,7.927233
39072,2016,Agosto,Estados Unidos de América,0,36,,36,-75.68164200000001,9.402597
39073,2016,Agosto,Estonia,1,0,,1,-74.140516,4.697157
39074,2016,Agosto,Etiopia,0,1,,1,-74.140516,4.697157
39075,2016,Agosto,Filipinas,0,3,,3,-75.516486,10.446304
39076,2016,Agosto,Filipinas,0,6,,6,-74.77647900000001,10.886686
39077,2016,Agosto,Filipinas,0,2,,2,-76.532004,3.451668
39078,2016,Agosto,Filipinas,4,11,,15,-74.140516,4.697157
39079,2016,Agosto,Filipinas,1,0,,1,-75.42726,6.170465
39080,2016,Agosto,Finlandia,3,7,,10,-74.140516,4.697157
39081,2016,Agosto,Finlandia,1,1,,2,-75.42726,6.170465
39082,2016,Agosto,Francia,1,3,,4,-75.516486,10.446304
39083,2016,Agosto,Francia,2,3,,5,-74.77647900000001,10.886686
39084,2016,Agosto,Francia,42,56,,98,-76.532004,3.451668
39085,2016,Agosto,Francia,1524,2317,,3841,-74.140516,4.697157
39086,2016,Agosto,Francia,10,13,,23,-75.736374,4.815189
39087,2016,Agosto,Francia,37,51,,88,-75.42726,6.170465
39088,2016,Agosto,Francia,0,1,,1,-73.181317,7.1280470000000005
39089,2016,Agosto,Grecia,2,5,,7,-74.140516,4.697157
39090,2016,Agosto,Grecia,0,2,,2,-75.42726,6.170465
39091,2016,Agosto,Grecia,0,1,,1,-72.508188,7.927233
39092,2016,Agosto,Guatemala,0,1,,1,-75.527794,10.406342
39093,2016,Agosto,Guatemala,18,13,,31,-75.516486,10.446304
39094,2016,Agosto,Guatemala,0,7,,7,-74.77647900000001,10.886686
39095,2016,Agosto,Guatemala,18,26,,44,-81.70216500000001,12.5862
39096,2016,Agosto,Guatemala,14,57,,71,-76.532004,3.451668
39097,2016,Agosto,Guatemala,409,689,,1098,-74.140516,4.697157
39098,2016,Agosto,Guatemala,2,3,,5,-75.736374,4.815189
39099,2016,Agosto,Guatemala,62,170,,232,-75.42726,6.170465
39100,2016,Agosto,Guatemala,7,3,,10,-73.181317,7.1280470000000005
39101,2016,Agosto,Guatemala,3,0,,3,-72.508188,7.927233
39102,2016,Agosto,Guyana,0,1,,1,-74.213989,11.247722999999999
39103,2016,Agosto,Guyana,0,1,,1,-76.532004,3.451668
39104,2016,Agosto,Guyana,1,3,,4,-74.140516,4.697157
39105,2016,Agosto,Guyana,1,0,,1,-75.42726,6.170465
39106,2016,Agosto,Guyana,1,0,,1,-73.181317,7.1280470000000005
39107,2016,Agosto,Guinea Ecuatorial,1,0,,1,-76.532004,3.451668
39108,2016,Agosto,Guadalupe/Territorio Francés,1,0,,1,-74.140516,4.697157
39109,2016,Agosto,Guadalupe/Territorio Francés,0,1,,1,-75.42726,6.170465
39110,2016,Agosto,Guadalupe/Territorio Francés,1,0,,1,-73.181317,7.1280470000000005
39111,2016,Agosto,Guayana Francesa/Departamento de Ultramar Francés,1,1,,2,-74.140516,4.697157
39112,2016,Agosto,Haití,0,1,,1,-75.527794,10.406342
39113,2016,Agosto,Haití,1,1,,2,-75.42726,6.170465
39114,2016,Agosto,Honduras,1,1,,2,-75.516486,10.446304
39115,2016,Agosto,Honduras,3,2,,5,-74.77647900000001,10.886686
39116,2016,Agosto,Honduras,0,37,,37,-81.703935,12.574411099999999
39117,2016,Agosto,Honduras,1,2,,3,-81.70216500000001,12.5862
39118,2016,Agosto,Honduras,7,11,,18,-76.532004,3.451668
39119,2016,Agosto,Honduras,62,111,,173,-74.140516,4.697157
39120,2016,Agosto,Honduras,1,2,,3,-75.736374,4.815189
39121,2016,Agosto,Honduras,44,53,,97,-75.42726,6.170465
39122,2016,Agosto,Honduras,1,0,,1,-73.181317,7.1280470000000005
39123,2016,Agosto,Honduras,0,1,,1,-72.508188,7.927233
39124,2016,Agosto,Hong Kong,2,8,,10,-74.140516,4.697157
39125,2016,Agosto,Hong Kong,0,1,,1,-75.42726,6.170465
39126,2016,Agosto,Hungría,5,3,,8,-74.140516,4.697157
39127,2016,Agosto,India,0,1,,1,-76.532004,3.451668
39128,2016,Agosto,India,5,45,,50,-74.140516,4.697157
39129,2016,Agosto,India,0,7,,7,-75.42726,6.170465
39130,2016,Agosto,India,1,2,,3,-73.181317,7.1280470000000005
39131,2016,Agosto,Indonesia,0,1,,1,-74.77647900000001,10.886686
39132,2016,Agosto,Indonesia,2,3,,5,-74.140516,4.697157
39133,2016,Agosto,Irán,0,3,,3,-74.140516,4.697157
39134,2016,Agosto,República de Irlanda,0,1,,1,-75.516486,10.446304
39135,2016,Agosto,República de Irlanda,3,12,,15,-74.140516,4.697157
39136,2016,Agosto,República de Irlanda,0,4,,4,-75.42726,6.170465
39137,2016,Agosto,Israel,0,2,,2,-75.516486,10.446304
39138,2016,Agosto,Israel,0,3,,3,-81.70216500000001,12.5862
39139,2016,Agosto,Israel,7,3,,10,-76.532004,3.451668
39140,2016,Agosto,Israel,34,79,,113,-74.140516,4.697157
39141,2016,Agosto,Israel,3,11,,14,-75.42726,6.170465
39142,2016,Agosto,Italia,2,2,,4,-75.516486,10.446304
39143,2016,Agosto,Italia,0,1,,1,-74.77647900000001,10.886686
39144,2016,Agosto,Italia,3,3,,6,-81.70216500000001,12.5862
39145,2016,Agosto,Italia,21,36,,57,-76.532004,3.451668
39146,2016,Agosto,Italia,201,341,,542,-74.140516,4.697157
39147,2016,Agosto,Italia,2,3,,5,-75.736374,4.815189
39148,2016,Agosto,Italia,22,46,,68,-75.42726,6.170465
39149,2016,Agosto,Italia,1,0,,1,-72.508188,7.927233
39150,2016,Agosto,Jamaica,2,9,,11,-75.527794,10.406342
39151,2016,Agosto,Jamaica,0,2,,2,-75.516486,10.446304
39152,2016,Agosto,Jamaica,0,1,,1,-74.77647900000001,10.886686
39153,2016,Agosto,Jamaica,0,3,,3,-74.765343,10.970933
39154,2016,Agosto,Jamaica,0,7,,7,-74.213989,11.247722999999999
39155,2016,Agosto,Jamaica,0,2,,2,-81.703935,12.574411099999999
39156,2016,Agosto,Jamaica,1,0,,1,-81.70216500000001,12.5862
39157,2016,Agosto,Jamaica,1,0,,1,-76.532004,3.451668
39158,2016,Agosto,Jamaica,4,7,,11,-74.140516,4.697157
39159,2016,Agosto,Jamaica,8,6,,14,-75.42726,6.170465
39160,2016,Agosto,Japón,1,2,,3,-76.532004,3.451668
39161,2016,Agosto,Japón,11,27,,38,-74.140516,4.697157
39162,2016,Agosto,Japón,1,4,,5,-75.42726,6.170465
39163,2016,Agosto,Jordania,0,1,,1,-74.140516,4.697157
39164,2016,Agosto,Kenia,2,3,,5,-76.532004,3.451668
39165,2016,Agosto,Kenia,0,1,,1,-74.140516,4.697157
39166,2016,Agosto,Kenia,0,1,,1,-75.42726,6.170465
39167,2016,Agosto,Kuwait,0,1,,1,-74.140516,4.697157
39168,2016,Agosto,Letonia,0,1,,1,-74.140516,4.697157
39169,2016,Agosto,Lituania,3,4,,7,-74.140516,4.697157
39170,2016,Agosto,Líbano,5,6,,11,-74.140516,4.697157
39171,2016,Agosto,Luxemburgo,0,2,,2,-76.532004,3.451668
39172,2016,Agosto,Luxemburgo,4,6,,10,-74.140516,4.697157
39173,2016,Agosto,Luxemburgo,0,1,,1,-75.42726,6.170465
39174,2016,Agosto,Malasia,0,7,,7,-74.140516,4.697157
39175,2016,Agosto,Marruecos,4,4,,8,-74.140516,4.697157
39176,2016,Agosto,Marruecos,0,1,,1,-75.42726,6.170465
39177,2016,Agosto,Islas Marshall,0,1,,1,-74.140516,4.697157
39178,2016,Agosto,Mauricio,0,1,,1,-75.42726,6.170465
39179,2016,Agosto,Martinica/Departamento de Ultramar Francés,0,2,,2,-75.527794,10.406342
39180,2016,Agosto,Martinica/Departamento de Ultramar Francés,1,2,,3,-76.532004,3.451668
39181,2016,Agosto,Martinica/Departamento de Ultramar Francés,0,1,,1,-74.140516,4.697157
39182,2016,Agosto,México,1,1,,2,-75.527794,10.406342
39183,2016,Agosto,México,37,62,,99,-75.516486,10.446304
39184,2016,Agosto,México,9,22,,31,-74.77647900000001,10.886686
39185,2016,Agosto,México,0,1,,1,-74.213989,11.247722999999999
39186,2016,Agosto,México,3,6,,9,-81.70216500000001,12.5862
39187,2016,Agosto,México,41,161,,202,-76.532004,3.451668
39188,2016,Agosto,México,4985,8196,,13181,-74.140516,4.697157
39189,2016,Agosto,México,10,14,,24,-75.736374,4.815189
39190,2016,Agosto,México,580,1390,,1970,-75.42726,6.170465
39191,2016,Agosto,México,4,14,,18,-73.181317,7.1280470000000005
39192,2016,Agosto,México,5,7,,12,-72.508188,7.927233
39193,2016,Agosto,República de Moldavia,1,0,,1,-74.140516,4.697157
39194,2016,Agosto,Mozambique,2,0,,2,-74.140516,4.697157
39195,2016,Agosto,Nicaragua,4,2,,6,-75.516486,10.446304
39196,2016,Agosto,Nicaragua,1,1,,2,-74.77647900000001,10.886686
39197,2016,Agosto,Nicaragua,13,20,,33,-81.703935,12.574411099999999
39198,2016,Agosto,Nicaragua,6,11,,17,-76.532004,3.451668
39199,2016,Agosto,Nicaragua,38,55,,93,-74.140516,4.697157
39200,2016,Agosto,Nicaragua,0,6,,6,-75.736374,4.815189
39201,2016,Agosto,Nicaragua,8,8,,16,-75.42726,6.170465
39202,2016,Agosto,Nicaragua,0,4,,4,-73.181317,7.1280470000000005
39203,2016,Agosto,Nigeria,0,1,,1,-76.532004,3.451668
39204,2016,Agosto,Nigeria,0,1,,1,-74.140516,4.697157
39205,2016,Agosto,Níger,1,0,,1,-74.140516,4.697157
39206,2016,Agosto,Noruega,0,2,,2,-74.77647900000001,10.886686
39207,2016,Agosto,Noruega,2,3,,5,-76.532004,3.451668
39208,2016,Agosto,Noruega,15,22,,37,-74.140516,4.697157
39209,2016,Agosto,Noruega,1,0,,1,-75.736374,4.815189
39210,2016,Agosto,Noruega,0,1,,1,-75.42726,6.170465
39211,2016,Agosto,Noruega,0,1,,1,-73.181317,7.1280470000000005
39212,2016,Agosto,Nueva Caledonia/Territorio francés,0,1,,1,-75.42726,6.170465
39213,2016,Agosto,Nueva Zelanda,3,7,,10,-74.140516,4.697157
39214,2016,Agosto,Nueva Zelanda,3,7,,10,-75.42726,6.170465
39215,2016,Agosto,Panamá,166,274,,440,-75.527794,10.406342
39216,2016,Agosto,Panamá,3048,3602,,6650,-75.516486,10.446304
39217,2016,Agosto,Panamá,314,582,,896,-74.77647900000001,10.886686
39218,2016,Agosto,Panamá,0,76,,76,-74.765343,10.970933
39219,2016,Agosto,Panamá,1,0,,1,-74.213989,11.247722999999999
39220,2016,Agosto,Panamá,1,2,,3,-81.703935,12.574411099999999
39221,2016,Agosto,Panamá,229,220,,449,-81.70216500000001,12.5862
39222,2016,Agosto,Panamá,352,558,,910,-76.532004,3.451668
39223,2016,Agosto,Panamá,0,15,,15,-77.061029,3.8844260000000004
39224,2016,Agosto,Panamá,35,38,,73,-75.76635300000001,4.45285
39225,2016,Agosto,Panamá,4920,6744,,11664,-74.140516,4.697157
39226,2016,Agosto,Panamá,48,111,,159,-75.736374,4.815189
39227,2016,Agosto,Panamá,2390,3371,,5761,-75.42726,6.170465
39228,2016,Agosto,Panamá,7,15,,22,-77.762647,7.102626
39229,2016,Agosto,Panamá,22,31,,53,-73.181317,7.1280470000000005
39230,2016,Agosto,Panamá,26,41,,67,-72.508188,7.927233
39231,2016,Agosto,Panamá,0,1,,1,-76.7333,8.06667
39232,2016,Agosto,Panamá,99,120,,219,-77.35002,8.63337
39233,2016,Agosto,Paraguay,8,9,,17,-75.516486,10.446304
39234,2016,Agosto,Paraguay,0,14,,14,-74.77647900000001,10.886686
39235,2016,Agosto,Paraguay,64,36,,100,-81.70216500000001,12.5862
39236,2016,Agosto,Paraguay,20,11,,31,-76.532004,3.451668
39237,2016,Agosto,Paraguay,34,46,,80,-74.140516,4.697157
39238,2016,Agosto,Paraguay,0,1,,1,-75.736374,4.815189
39239,2016,Agosto,Paraguay,12,43,,55,-75.42726,6.170465
39240,2016,Agosto,Paraguay,1,0,,1,-73.181317,7.1280470000000005
39241,2016,Agosto,Paraguay,2,1,,3,-72.508188,7.927233
39242,2016,Agosto,Perú,88,167,,255,-69.941498,4.191162
39243,2016,Agosto,Perú,10,22,,32,-77.35600000000001,0.81488
39244,2016,Agosto,Perú,10,12,,22,-75.516486,10.446304
39245,2016,Agosto,Perú,177,107,,284,-81.70216500000001,12.5862
39246,2016,Agosto,Perú,312,475,,787,-76.532004,3.451668
39247,2016,Agosto,Perú,6447,8179,,14626,-74.140516,4.697157
39248,2016,Agosto,Perú,0,1,,1,-75.736374,4.815189
39249,2016,Agosto,Perú,540,910,,1450,-75.42726,6.170465
39250,2016,Agosto,Perú,2,1,,3,-73.181317,7.1280470000000005
39251,2016,Agosto,Perú,0,3,,3,-72.508188,7.927233
39252,2016,Agosto,Polonia,0,2,,2,-76.532004,3.451668
39253,2016,Agosto,Polonia,16,21,,37,-74.140516,4.697157
39254,2016,Agosto,Polonia,1,0,,1,-75.42726,6.170465
39255,2016,Agosto,Portugal,0,1,,1,-74.77647900000001,10.886686
39256,2016,Agosto,Portugal,1,1,,2,-81.70216500000001,12.5862
39257,2016,Agosto,Portugal,1,6,,7,-76.532004,3.451668
39258,2016,Agosto,Portugal,45,73,,118,-74.140516,4.697157
39259,2016,Agosto,Portugal,3,7,,10,-75.42726,6.170465
39260,2016,Agosto,Puerto Rico/Territorio de Estados Unidos,0,3,,3,-75.527794,10.406342
39261,2016,Agosto,Puerto Rico/Territorio de Estados Unidos,1,3,,4,-75.516486,10.446304
39262,2016,Agosto,Puerto Rico/Territorio de Estados Unidos,7,38,,45,-74.77647900000001,10.886686
39263,2016,Agosto,Puerto Rico/Territorio de Estados Unidos,3,6,,9,-81.70216500000001,12.5862
39264,2016,Agosto,Puerto Rico/Territorio de Estados Unidos,20,54,,74,-76.532004,3.451668
39265,2016,Agosto,Puerto Rico/Territorio de Estados Unidos,345,523,,868,-74.140516,4.697157
39266,2016,Agosto,Puerto Rico/Territorio de Estados Unidos,4,10,,14,-75.736374,4.815189
39267,2016,Agosto,Puerto Rico/Territorio de Estados Unidos,42,169,,211,-75.42726,6.170465
39268,2016,Agosto,Puerto Rico/Territorio de Estados Unidos,0,4,,4,-73.181317,7.1280470000000005
39269,2016,Agosto,Qatar,1,1,,2,-74.140516,4.697157
39270,2016,Agosto,Reino Unido de Gran Bretaña e Irlanda del Norte,4,1,,5,-75.516486,10.446304
39271,2016,Agosto,Reino Unido de Gran Bretaña e Irlanda del Norte,0,1,,1,-74.77647900000001,10.886686
39272,2016,Agosto,Reino Unido de Gran Bretaña e Irlanda del Norte,1,1,,2,-81.70216500000001,12.5862
39273,2016,Agosto,Reino Unido de Gran Bretaña e Irlanda del Norte,17,23,,40,-76.532004,3.451668
39274,2016,Agosto,Reino Unido de Gran Bretaña e Irlanda del Norte,637,964,,1601,-74.140516,4.697157
39275,2016,Agosto,Reino Unido de Gran Bretaña e Irlanda del Norte,0,1,,1,-75.736374,4.815189
39276,2016,Agosto,Reino Unido de Gran Bretaña e Irlanda del Norte,32,39,,71,-75.42726,6.170465
39277,2016,Agosto,República CentroÁfricana,2,2,,4,-74.140516,4.697157
39278,2016,Agosto,Federación de Rusia,1,0,,1,-76.532004,3.451668
39279,2016,Agosto,Federación de Rusia,18,23,,41,-74.140516,4.697157
39280,2016,Agosto,Federación de Rusia,1,0,,1,-75.42726,6.170465
39281,2016,Agosto,República Dominicana,1,3,,4,-75.527794,10.406342
39282,2016,Agosto,República Dominicana,7,10,,17,-75.516486,10.446304
39283,2016,Agosto,República Dominicana,9,22,,31,-74.77647900000001,10.886686
39284,2016,Agosto,República Dominicana,0,1,,1,-74.765343,10.970933
39285,2016,Agosto,República Dominicana,1,1,,2,-81.70216500000001,12.5862
39286,2016,Agosto,República Dominicana,26,48,,74,-76.532004,3.451668
39287,2016,Agosto,República Dominicana,794,951,,1745,-74.140516,4.697157
39288,2016,Agosto,República Dominicana,7,17,,24,-75.736374,4.815189
39289,2016,Agosto,República Dominicana,72,170,,242,-75.42726,6.170465
39290,2016,Agosto,República Dominicana,0,6,,6,-73.181317,7.1280470000000005
39291,2016,Agosto,República Dominicana,4,6,,10,-72.508188,7.927233
39292,2016,Agosto,Reunión,0,1,,1,-74.140516,4.697157
39293,2016,Agosto,Rumania,2,1,,3,-76.532004,3.451668
39294,2016,Agosto,Rumania,2,1,,3,-74.140516,4.697157
39295,2016,Agosto,Rumania,1,1,,2,-75.42726,6.170465
39296,2016,Agosto,San Cristóbal y Nevis,0,1,,1,-74.140516,4.697157
39297,2016,Agosto,San Cristóbal y Nevis,1,0,,1,-75.42726,6.170465
39298,2016,Agosto,Senegal,3,0,,3,-74.140516,4.697157
39299,2016,Agosto,Serbia,0,1,,1,-74.140516,4.697157
39300,2016,Agosto,Serbia,1,1,,2,-75.42726,6.170465
39301,2016,Agosto,Singapur,2,7,,9,-74.140516,4.697157
39302,2016,Agosto,Singapur,1,1,,2,-75.42726,6.170465
39303,2016,Agosto,Sudáfrica,7,6,,13,-74.140516,4.697157
39304,2016,Agosto,Suecia,0,1,,1,-74.77647900000001,10.886686
39305,2016,Agosto,Suecia,3,5,,8,-76.532004,3.451668
39306,2016,Agosto,Suecia,14,20,,34,-74.140516,4.697157
39307,2016,Agosto,Suecia,0,1,,1,-75.736374,4.815189
39308,2016,Agosto,Suecia,3,3,,6,-75.42726,6.170465
39309,2016,Agosto,Suiza,1,1,,2,-75.516486,10.446304
39310,2016,Agosto,Suiza,0,1,,1,-74.77647900000001,10.886686
39311,2016,Agosto,Suiza,1,0,,1,-81.70216500000001,12.5862
39312,2016,Agosto,Suiza,13,14,,27,-76.532004,3.451668
39313,2016,Agosto,Suiza,61,75,,136,-74.140516,4.697157
39314,2016,Agosto,Suiza,10,13,,23,-75.42726,6.170465
39315,2016,Agosto,Surinam,1,8,,9,-74.140516,4.697157
39316,2016,Agosto,Surinam,12,6,,18,-75.42726,6.170465
39317,2016,Agosto,Taiwán,0,1,,1,-75.516486,10.446304
39318,2016,Agosto,Taiwán,0,1,,1,-76.532004,3.451668
39319,2016,Agosto,Taiwán,1,2,,3,-74.140516,4.697157
39320,2016,Agosto,Tailandia,0,1,,1,-76.532004,3.451668
39321,2016,Agosto,Tailandia,1,6,,7,-74.140516,4.697157
39322,2016,Agosto,Tanzania,2,2,,4,-75.736374,4.815189
39323,2016,Agosto,Trinidad y Tobago,0,1,,1,-75.527794,10.406342
39324,2016,Agosto,Trinidad y Tobago,1,0,,1,-74.77647900000001,10.886686
39325,2016,Agosto,Trinidad y Tobago,5,5,,10,-76.532004,3.451668
39326,2016,Agosto,Trinidad y Tobago,8,15,,23,-74.140516,4.697157
39327,2016,Agosto,Trinidad y Tobago,3,16,,19,-75.42726,6.170465
39328,2016,Agosto,Trinidad y Tobago,0,2,,2,-73.181317,7.1280470000000005
39329,2016,Agosto,Trinidad y Tobago,3,2,,5,-72.508188,7.927233
39330,2016,Agosto,Túnez,2,0,,2,-74.140516,4.697157
39331,2016,Agosto,Turkmenistán,5,7,,12,-74.140516,4.697157
39332,2016,Agosto,Turquía,359,475,,834,-74.140516,4.697157
39333,2016,Agosto,Turquía,1,1,,2,-75.42726,6.170465
39334,2016,Agosto,Ucrania,3,4,,7,-74.140516,4.697157
39335,2016,Agosto,Ucrania,0,1,,1,-75.42726,6.170465
39336,2016,Agosto,Uruguay,0,1,,1,-77.35600000000001,0.81488
39337,2016,Agosto,Uruguay,7,3,,10,-75.516486,10.446304
39338,2016,Agosto,Uruguay,33,25,,58,-81.70216500000001,12.5862
39339,2016,Agosto,Uruguay,9,21,,30,-76.532004,3.451668
39340,2016,Agosto,Uruguay,97,130,,227,-74.140516,4.697157
39341,2016,Agosto,Uruguay,1,1,,2,-75.736374,4.815189
39342,2016,Agosto,Uruguay,40,51,,91,-75.42726,6.170465
39343,2016,Agosto,Uruguay,0,1,,1,-73.181317,7.1280470000000005
39344,2016,Agosto,Uruguay,0,2,,2,-72.508188,7.927233
39345,2016,Agosto,Vanuatu,1,0,,1,-72.129595,11.360028999999999
39346,2016,Agosto,Venezuela,0,11,,11,-75.527794,10.406342
39347,2016,Agosto,Venezuela,5,6,,11,-75.516486,10.446304
39348,2016,Agosto,Venezuela,46,156,,202,-74.77647900000001,10.886686
39349,2016,Agosto,Venezuela,8298,8635,,16933,-72.129595,11.360028999999999
39350,2016,Agosto,Venezuela,0,1,,1,-81.70216500000001,12.5862
39351,2016,Agosto,Venezuela,27,23,,50,-76.532004,3.451668
39352,2016,Agosto,Venezuela,14,15,,29,-67.927521,3.866713
39353,2016,Agosto,Venezuela,4337,4693,,9030,-74.140516,4.697157
39354,2016,Agosto,Venezuela,6,11,,17,-75.736374,4.815189
39355,2016,Agosto,Venezuela,828,912,,1740,-75.42726,6.170465
39356,2016,Agosto,Venezuela,1342,1695,,3037,-67.48402800000001,6.185536
39357,2016,Agosto,Venezuela,5234,4834,,10068,-70.74025300000001,7.088728999999999
39358,2016,Agosto,Venezuela,10,8,,18,-73.181317,7.1280470000000005
39359,2016,Agosto,Venezuela,6171,7462,,13633,-72.453013,7.819
39360,2016,Agosto,Venezuela,0,2,,2,-72.508188,7.927233
39361,2016,Agosto,Venezuela,436,444,,880,-72.409396,8.36068
39362,2016,Septiembre,Albania,0,1,,1,-74.140516,4.697157
39363,2016,Septiembre,Alemania,0,1,,1,-75.527794,10.406342
39364,2016,Septiembre,Alemania,1,3,,4,-75.516486,10.446304
39365,2016,Septiembre,Alemania,2,4,,6,-74.77647900000001,10.886686
39366,2016,Septiembre,Alemania,3,0,,3,-81.70216500000001,12.5862
39367,2016,Septiembre,Alemania,61,52,,113,-76.532004,3.451668
39368,2016,Septiembre,Alemania,1198,2133,,3331,-74.140516,4.697157
39369,2016,Septiembre,Alemania,0,5,,5,-75.736374,4.815189
39370,2016,Septiembre,Alemania,16,34,,50,-75.42726,6.170465
39371,2016,Septiembre,Alemania,0,1,,1,-73.181317,7.1280470000000005
39372,2016,Septiembre,Alemania,0,1,,1,-76.7333,8.06667
39373,2016,Septiembre,Andorra,0,2,,2,-74.140516,4.697157
39374,2016,Septiembre,Angola,0,1,,1,-76.532004,3.451668
39375,2016,Septiembre,Angola,2,0,,2,-74.140516,4.697157
39376,2016,Septiembre,Angola,2,2,,4,-74.140516,4.697157
39377,2016,Septiembre,Angola,1,0,,1,-75.42726,6.170465
39378,2016,Septiembre,Países Bajos,1,1,,2,-75.516486,10.446304
39379,2016,Septiembre,Países Bajos,62,120,,182,-74.77647900000001,10.886686
39380,2016,Septiembre,Países Bajos,2,10,,12,-74.213989,11.247722999999999
39381,2016,Septiembre,Países Bajos,66,131,,197,-76.532004,3.451668
39382,2016,Septiembre,Países Bajos,682,990,,1672,-74.140516,4.697157
39383,2016,Septiembre,Países Bajos,0,3,,3,-75.736374,4.815189
39384,2016,Septiembre,Países Bajos,156,220,,376,-75.42726,6.170465
39385,2016,Septiembre,Países Bajos,4,1,,5,-73.181317,7.1280470000000005
39386,2016,Septiembre,Países Bajos,0,1,,1,-76.7333,8.06667
39387,2016,Septiembre,Arabia Saudita,1,0,,1,-76.532004,3.451668
39388,2016,Septiembre,Arabia Saudita,0,2,,2,-74.140516,4.697157
39389,2016,Septiembre,Arabia Saudita,1,1,,2,-75.42726,6.170465
39390,2016,Septiembre,Argelia,4,5,,9,-74.140516,4.697157
39391,2016,Septiembre,Argentina,7,4,,11,-77.35600000000001,0.81488
39392,2016,Septiembre,Argentina,0,1,,1,-75.527794,10.406342
39393,2016,Septiembre,Argentina,37,36,,73,-75.516486,10.446304
39394,2016,Septiembre,Argentina,2,7,,9,-74.77647900000001,10.886686
39395,2016,Septiembre,Argentina,132,99,,231,-81.70216500000001,12.5862
39396,2016,Septiembre,Argentina,54,93,,147,-76.532004,3.451668
39397,2016,Septiembre,Argentina,2226,3050,,5276,-74.140516,4.697157
39398,2016,Septiembre,Argentina,4,4,,8,-75.736374,4.815189
39399,2016,Septiembre,Argentina,75,163,,238,-75.42726,6.170465
39400,2016,Septiembre,Argentina,1,1,,2,-73.181317,7.1280470000000005
39401,2016,Septiembre,República de Armenia,0,1,,1,-74.140516,4.697157
39402,2016,Septiembre,Aruba,62,78,,140,-75.527794,10.406342
39403,2016,Septiembre,Aruba,10,10,,20,-74.77647900000001,10.886686
39404,2016,Septiembre,Aruba,5,10,,15,-74.213989,11.247722999999999
39405,2016,Septiembre,Aruba,3,8,,11,-76.532004,3.451668
39406,2016,Septiembre,Aruba,635,704,,1339,-74.140516,4.697157
39407,2016,Septiembre,Aruba,0,2,,2,-75.736374,4.815189
39408,2016,Septiembre,Aruba,87,82,,169,-75.42726,6.170465
39409,2016,Septiembre,Aruba,10,10,,20,-73.181317,7.1280470000000005
39410,2016,Septiembre,Australia,1,1,,2,-75.516486,10.446304
39411,2016,Septiembre,Australia,1,0,,1,-81.70216500000001,12.5862
39412,2016,Septiembre,Australia,2,4,,6,-76.532004,3.451668
39413,2016,Septiembre,Australia,37,37,,74,-74.140516,4.697157
39414,2016,Septiembre,Australia,12,11,,23,-75.42726,6.170465
39415,2016,Septiembre,Australia,2,1,,3,-73.181317,7.1280470000000005
39416,2016,Septiembre,Austria,1,0,,1,-81.70216500000001,12.5862
39417,2016,Septiembre,Austria,0,1,,1,-76.532004,3.451668
39418,2016,Septiembre,Austria,9,17,,26,-74.140516,4.697157
39419,2016,Septiembre,Austria,2,2,,4,-75.42726,6.170465
39420,2016,Septiembre,Azerbaiyán,0,1,,1,-75.42726,6.170465
39421,2016,Septiembre,Bahamas,0,4,,4,-75.516486,10.446304
39422,2016,Septiembre,Bahamas,0,2,,2,-74.77647900000001,10.886686
39423,2016,Septiembre,Bahamas,2,1,,3,-76.532004,3.451668
39424,2016,Septiembre,Bahamas,3,3,,6,-74.140516,4.697157
39425,2016,Septiembre,Bahamas,2,3,,5,-75.42726,6.170465
39426,2016,Septiembre,Bahréin,0,2,,2,-75.516486,10.446304
39427,2016,Septiembre,Bahréin,2,1,,3,-74.140516,4.697157
39428,2016,Septiembre,Barbados,10,17,,27,-74.140516,4.697157
39429,2016,Septiembre,República de Belarús,2,0,,2,-74.140516,4.697157
39430,2016,Septiembre,República de Belarús,1,0,,1,-72.453013,7.819
39431,2016,Septiembre,Bélgica,3,9,,12,-76.532004,3.451668
39432,2016,Septiembre,Bélgica,27,54,,81,-74.140516,4.697157
39433,2016,Septiembre,Bélgica,5,11,,16,-75.42726,6.170465
39434,2016,Septiembre,Belice,1,3,,4,-74.140516,4.697157
39435,2016,Septiembre,Benín,0,1,,1,-74.140516,4.697157
39436,2016,Septiembre,Bermudas/Territorio Británico de Ultramar,1,0,,1,-74.140516,4.697157
39437,2016,Septiembre,Bolivia,11,13,,24,-75.516486,10.446304
39438,2016,Septiembre,Bolivia,1,7,,8,-74.77647900000001,10.886686
39439,2016,Septiembre,Bolivia,13,17,,30,-81.70216500000001,12.5862
39440,2016,Septiembre,Bolivia,31,25,,56,-76.532004,3.451668
39441,2016,Septiembre,Bolivia,467,631,,1098,-74.140516,4.697157
39442,2016,Septiembre,Bolivia,0,1,,1,-75.736374,4.815189
39443,2016,Septiembre,Bolivia,37,73,,110,-75.42726,6.170465
39444,2016,Septiembre,Bosnia y Herzegovina,0,2,,2,-74.140516,4.697157
39445,2016,Septiembre,Brasil,190,200,,390,-69.941498,4.191162
39446,2016,Septiembre,Brasil,0,1,,1,-77.35600000000001,0.81488
39447,2016,Septiembre,Brasil,0,2,,2,-75.527794,10.406342
39448,2016,Septiembre,Brasil,98,64,,162,-75.516486,10.446304
39449,2016,Septiembre,Brasil,16,24,,40,-74.77647900000001,10.886686
39450,2016,Septiembre,Brasil,368,271,,639,-81.70216500000001,12.5862
39451,2016,Septiembre,Brasil,102,115,,217,-76.532004,3.451668
39452,2016,Septiembre,Brasil,1,1,,2,-67.927521,3.866713
39453,2016,Septiembre,Brasil,5006,6291,,11297,-74.140516,4.697157
39454,2016,Septiembre,Brasil,3,1,,4,-75.736374,4.815189
39455,2016,Septiembre,Brasil,72,174,,246,-75.42726,6.170465
39456,2016,Septiembre,Brasil,1,1,,2,-72.508188,7.927233
39457,2016,Septiembre,Brunei Darussalam,0,1,,1,-74.140516,4.697157
39458,2016,Septiembre,Bulgaria,0,1,,1,-76.532004,3.451668
39459,2016,Septiembre,Bulgaria,1,3,,4,-74.140516,4.697157
39460,2016,Septiembre,Bulgaria,0,1,,1,-75.42726,6.170465
39461,2016,Septiembre,Islas Caimán/Territorio Británico de Ultramar,0,2,,2,-81.703935,12.574411099999999
39462,2016,Septiembre,Islas Caimán/Territorio Británico de Ultramar,1,2,,3,-81.70216500000001,12.5862
39463,2016,Septiembre,Canadá,11,18,,29,-75.516486,10.446304
39464,2016,Septiembre,Canadá,1,6,,7,-74.77647900000001,10.886686
39465,2016,Septiembre,Canadá,1,3,,4,-81.70216500000001,12.5862
39466,2016,Septiembre,Canadá,25,34,,59,-76.532004,3.451668
39467,2016,Septiembre,Canadá,490,856,,1346,-74.140516,4.697157
39468,2016,Septiembre,Canadá,1,3,,4,-75.736374,4.815189
39469,2016,Septiembre,Canadá,46,85,,131,-75.42726,6.170465
39470,2016,Septiembre,Canadá,1,2,,3,-73.181317,7.1280470000000005
39471,2016,Septiembre,Canadá,0,1,,1,-72.508188,7.927233
39472,2016,Septiembre,España,0,2,,2,-75.527794,10.406342
39473,2016,Septiembre,España,10,35,,45,-75.516486,10.446304
39474,2016,Septiembre,España,1,2,,3,-74.77647900000001,10.886686
39475,2016,Septiembre,España,327,597,,924,-76.532004,3.451668
39476,2016,Septiembre,España,3353,5791,,9144,-74.140516,4.697157
39477,2016,Septiembre,España,6,8,,14,-75.736374,4.815189
39478,2016,Septiembre,España,242,481,,723,-75.42726,6.170465
39479,2016,Septiembre,España,0,1,,1,-73.181317,7.1280470000000005
39480,2016,Septiembre,República Democrática del Congo,1,1,,2,-74.140516,4.697157
39481,2016,Septiembre,República de Corea,9,24,,33,-74.140516,4.697157
39482,2016,Septiembre,República de Corea,1,3,,4,-75.42726,6.170465
39483,2016,Septiembre,Costa de Marfil,1,1,,2,-76.532004,3.451668
39484,2016,Septiembre,Costa de Marfil,6,3,,9,-74.140516,4.697157
39485,2016,Septiembre,Costa Rica,2,19,,21,-75.527794,10.406342
39486,2016,Septiembre,Costa Rica,11,12,,23,-75.516486,10.446304
39487,2016,Septiembre,Costa Rica,4,8,,12,-74.77647900000001,10.886686
39488,2016,Septiembre,Costa Rica,1,5,,6,-81.703935,12.574411099999999
39489,2016,Septiembre,Costa Rica,118,76,,194,-81.70216500000001,12.5862
39490,2016,Septiembre,Costa Rica,1,9,,10,-81.372937,13.338761300000002
39491,2016,Septiembre,Costa Rica,19,33,,52,-76.532004,3.451668
39492,2016,Septiembre,Costa Rica,936,1445,,2381,-74.140516,4.697157
39493,2016,Septiembre,Costa Rica,4,2,,6,-75.736374,4.815189
39494,2016,Septiembre,Costa Rica,68,115,,183,-75.42726,6.170465
39495,2016,Septiembre,Costa Rica,2,8,,10,-73.181317,7.1280470000000005
39496,2016,Septiembre,Costa Rica,0,4,,4,-76.7333,8.06667
39497,2016,Septiembre,Croacia,2,6,,8,-74.140516,4.697157
39498,2016,Septiembre,Cuba,39,144,,183,-75.516486,10.446304
39499,2016,Septiembre,Cuba,14,10,,24,-74.77647900000001,10.886686
39500,2016,Septiembre,Cuba,1,3,,4,-81.70216500000001,12.5862
39501,2016,Septiembre,Cuba,15,20,,35,-76.532004,3.451668
39502,2016,Septiembre,Cuba,250,450,,700,-74.140516,4.697157
39503,2016,Septiembre,Cuba,4,6,,10,-75.736374,4.815189
39504,2016,Septiembre,Cuba,19,28,,47,-75.42726,6.170465
39505,2016,Septiembre,Cuba,1,3,,4,-73.181317,7.1280470000000005
39506,2016,Septiembre,Cuba,0,1,,1,-72.508188,7.927233
39507,2016,Septiembre,Curazao,1,1,,2,-74.140516,4.697157
39508,2016,Septiembre,República Checa,0,1,,1,-76.532004,3.451668
39509,2016,Septiembre,República Checa,10,9,,19,-74.140516,4.697157
39510,2016,Septiembre,Chile,1,6,,7,-77.35600000000001,0.81488
39511,2016,Septiembre,Chile,0,3,,3,-75.527794,10.406342
39512,2016,Septiembre,Chile,18,37,,55,-75.516486,10.446304
39513,2016,Septiembre,Chile,2,2,,4,-74.77647900000001,10.886686
39514,2016,Septiembre,Chile,45,43,,88,-81.70216500000001,12.5862
39515,2016,Septiembre,Chile,34,44,,78,-76.532004,3.451668
39516,2016,Septiembre,Chile,0,2,,2,-77.061029,3.8844260000000004
39517,2016,Septiembre,Chile,4743,5869,,10612,-74.140516,4.697157
39518,2016,Septiembre,Chile,2,1,,3,-75.736374,4.815189
39519,2016,Septiembre,Chile,22,47,,69,-75.42726,6.170465
39520,2016,Septiembre,Chile,3,1,,4,-73.181317,7.1280470000000005
39521,2016,Septiembre,China,3,5,,8,-76.532004,3.451668
39522,2016,Septiembre,China,30,91,,121,-74.140516,4.697157
39523,2016,Septiembre,China,2,10,,12,-75.42726,6.170465
39524,2016,Septiembre,Dinamarca,1,2,,3,-76.532004,3.451668
39525,2016,Septiembre,Dinamarca,10,22,,32,-74.140516,4.697157
39526,2016,Septiembre,Dinamarca,1,5,,6,-75.42726,6.170465
39527,2016,Septiembre,Dominica,1,0,,1,-76.532004,3.451668
39528,2016,Septiembre,Dominica,0,1,,1,-75.42726,6.170465
39529,2016,Septiembre,Ecuador,0,3,,3,-74.78366,0.18595699999999998
39530,2016,Septiembre,Ecuador,77,216,,293,-76.876446,0.33002
39531,2016,Septiembre,Ecuador,2,2,,4,-77.84700600000001,0.8124359999999999
39532,2016,Septiembre,Ecuador,2846,4344,,7190,-77.35600000000001,0.81488
39533,2016,Septiembre,Ecuador,45,131,,176,-78.802679,18.00143
39534,2016,Septiembre,Ecuador,0,1,,1,-75.527794,10.406342
39535,2016,Septiembre,Ecuador,64,59,,123,-75.516486,10.446304
39536,2016,Septiembre,Ecuador,3,16,,19,-74.77647900000001,10.886686
39537,2016,Septiembre,Ecuador,8,10,,18,-81.70216500000001,12.5862
39538,2016,Septiembre,Ecuador,390,513,,903,-76.532004,3.451668
39539,2016,Septiembre,Ecuador,3111,4618,,7729,-74.140516,4.697157
39540,2016,Septiembre,Ecuador,32,68,,100,-75.42726,6.170465
39541,2016,Septiembre,Ecuador,2,2,,4,-73.181317,7.1280470000000005
39542,2016,Septiembre,Egipto,0,2,,2,-76.532004,3.451668
39543,2016,Septiembre,Egipto,1,8,,9,-74.140516,4.697157
39544,2016,Septiembre,Egipto,0,8,,8,-75.42726,6.170465
39545,2016,Septiembre,El Salvador,6,7,,13,-75.516486,10.446304
39546,2016,Septiembre,El Salvador,15,15,,30,-81.70216500000001,12.5862
39547,2016,Septiembre,El Salvador,115,177,,292,-76.532004,3.451668
39548,2016,Septiembre,El Salvador,1005,1512,,2517,-74.140516,4.697157
39549,2016,Septiembre,El Salvador,0,1,,1,-75.736374,4.815189
39550,2016,Septiembre,El Salvador,149,258,,407,-75.42726,6.170465
39551,2016,Septiembre,El Salvador,0,1,,1,-73.181317,7.1280470000000005
39552,2016,Septiembre,Emiratos Árabes,3,4,,7,-74.140516,4.697157
39553,2016,Septiembre,Eritrea,1,0,,1,-74.140516,4.697157
39554,2016,Septiembre,Eslovaquia,1,1,,2,-74.140516,4.697157
39555,2016,Septiembre,Eslovenia,3,2,,5,-74.140516,4.697157
39556,2016,Septiembre,Eslovenia,0,1,,1,-75.42726,6.170465
39557,2016,Septiembre,Estados Unidos de América,2,45,,47,-75.527794,10.406342
39558,2016,Septiembre,Estados Unidos de América,2509,4099,,6608,-75.516486,10.446304
39559,2016,Septiembre,Estados Unidos de América,337,736,,1073,-74.77647900000001,10.886686
39560,2016,Septiembre,Estados Unidos de América,0,12,,12,-74.765343,10.970933
39561,2016,Septiembre,Estados Unidos de América,0,14,,14,-74.213989,11.247722999999999
39562,2016,Septiembre,Estados Unidos de América,7,20,,27,-81.70216500000001,12.5862
39563,2016,Septiembre,Estados Unidos de América,693,1208,,1901,-76.532004,3.451668
39564,2016,Septiembre,Estados Unidos de América,0,14,,14,-77.061029,3.8844260000000004
39565,2016,Septiembre,Estados Unidos de América,153,197,,350,-75.76635300000001,4.45285
39566,2016,Septiembre,Estados Unidos de América,7052,13740,,20792,-74.140516,4.697157
39567,2016,Septiembre,Estados Unidos de América,52,94,,146,-75.736374,4.815189
39568,2016,Septiembre,Estados Unidos de América,1652,4471,,6123,-75.42726,6.170465
39569,2016,Septiembre,Estados Unidos de América,9,30,,39,-73.181317,7.1280470000000005
39570,2016,Septiembre,Estados Unidos de América,43,44,,87,-72.508188,7.927233
39571,2016,Septiembre,Estados Unidos de América,0,1,,1,-76.7333,8.06667
39572,2016,Septiembre,Estados Unidos de América,0,12,,12,-75.68164200000001,9.402597
39573,2016,Septiembre,Estonia,4,1,,5,-74.140516,4.697157
39574,2016,Septiembre,Filipinas,0,3,,3,-74.77647900000001,10.886686
39575,2016,Septiembre,Filipinas,0,15,,15,-76.532004,3.451668
39576,2016,Septiembre,Filipinas,2,6,,8,-74.140516,4.697157
39577,2016,Septiembre,Filipinas,1,1,,2,-75.42726,6.170465
39578,2016,Septiembre,Finlandia,3,4,,7,-74.140516,4.697157
39579,2016,Septiembre,Francia,1,0,,1,-75.527794,10.406342
39580,2016,Septiembre,Francia,0,2,,2,-75.516486,10.446304
39581,2016,Septiembre,Francia,24,38,,62,-76.532004,3.451668
39582,2016,Septiembre,Francia,0,1,,1,-77.061029,3.8844260000000004
39583,2016,Septiembre,Francia,1088,1929,,3017,-74.140516,4.697157
39584,2016,Septiembre,Francia,1,0,,1,-75.736374,4.815189
39585,2016,Septiembre,Francia,15,43,,58,-75.42726,6.170465
39586,2016,Septiembre,Septiembre,1,1,,2,-74.140516,4.697157
39587,2016,Septiembre,Granada,0,2,,2,-75.527794,10.406342
39588,2016,Septiembre,Granada,1,0,,1,-76.532004,3.451668
39589,2016,Septiembre,Grecia,0,1,,1,-74.77647900000001,10.886686
39590,2016,Septiembre,Grecia,1,6,,7,-74.140516,4.697157
39591,2016,Septiembre,Grecia,0,2,,2,-75.42726,6.170465
39592,2016,Septiembre,Guatemala,17,25,,42,-75.516486,10.446304
39593,2016,Septiembre,Guatemala,4,4,,8,-74.77647900000001,10.886686
39594,2016,Septiembre,Guatemala,0,1,,1,-74.765343,10.970933
39595,2016,Septiembre,Guatemala,14,19,,33,-81.70216500000001,12.5862
39596,2016,Septiembre,Guatemala,31,113,,144,-76.532004,3.451668
39597,2016,Septiembre,Guatemala,0,2,,2,-77.061029,3.8844260000000004
39598,2016,Septiembre,Guatemala,419,649,,1068,-74.140516,4.697157
39599,2016,Septiembre,Guatemala,0,3,,3,-75.736374,4.815189
39600,2016,Septiembre,Guatemala,37,120,,157,-75.42726,6.170465
39601,2016,Septiembre,Guatemala,2,0,,2,-72.508188,7.927233
39602,2016,Septiembre,Guyana,0,1,,1,-75.527794,10.406342
39603,2016,Septiembre,Guyana,1,3,,4,-76.532004,3.451668
39604,2016,Septiembre,Guyana,1,3,,4,-74.140516,4.697157
39605,2016,Septiembre,Guyana,0,1,,1,-75.42726,6.170465
39606,2016,Septiembre,Guyana,0,1,,1,-73.181317,7.1280470000000005
39607,2016,Septiembre,Guadalupe/Territorio Francés,0,1,,1,-74.140516,4.697157
39608,2016,Septiembre,Haití,0,1,,1,-75.527794,10.406342
39609,2016,Septiembre,Haití,1,4,,5,-74.140516,4.697157
39610,2016,Septiembre,Haití,0,3,,3,-75.42726,6.170465
39611,2016,Septiembre,Haití,0,1,,1,-73.181317,7.1280470000000005
39612,2016,Septiembre,Honduras,2,8,,10,-75.516486,10.446304
39613,2016,Septiembre,Honduras,2,1,,3,-74.77647900000001,10.886686
39614,2016,Septiembre,Honduras,0,1,,1,-81.703935,12.574411099999999
39615,2016,Septiembre,Honduras,1,2,,3,-81.372937,13.338761300000002
39616,2016,Septiembre,Honduras,15,17,,32,-76.532004,3.451668
39617,2016,Septiembre,Honduras,98,115,,213,-74.140516,4.697157
39618,2016,Septiembre,Honduras,0,3,,3,-75.736374,4.815189
39619,2016,Septiembre,Honduras,26,28,,54,-75.42726,6.170465
39620,2016,Septiembre,Hong Kong,4,5,,9,-74.140516,4.697157
39621,2016,Septiembre,Hungría,0,3,,3,-74.140516,4.697157
39622,2016,Septiembre,India,0,2,,2,-75.516486,10.446304
39623,2016,Septiembre,India,0,1,,1,-74.77647900000001,10.886686
39624,2016,Septiembre,India,0,2,,2,-76.532004,3.451668
39625,2016,Septiembre,India,7,36,,43,-74.140516,4.697157
39626,2016,Septiembre,India,0,2,,2,-75.736374,4.815189
39627,2016,Septiembre,India,2,6,,8,-75.42726,6.170465
39628,2016,Septiembre,India,0,1,,1,-73.181317,7.1280470000000005
39629,2016,Septiembre,Indonesia,1,4,,5,-74.140516,4.697157
39630,2016,Septiembre,Indonesia,0,1,,1,-75.42726,6.170465
39631,2016,Septiembre,Irán,1,10,,11,-74.140516,4.697157
39632,2016,Septiembre,República de Irlanda,0,1,,1,-75.516486,10.446304
39633,2016,Septiembre,República de Irlanda,4,1,,5,-76.532004,3.451668
39634,2016,Septiembre,República de Irlanda,13,14,,27,-74.140516,4.697157
39635,2016,Septiembre,República de Irlanda,0,3,,3,-75.42726,6.170465
39636,2016,Septiembre,Islandia,2,0,,2,-74.140516,4.697157
39637,2016,Septiembre,Israel,1,1,,2,-76.532004,3.451668
39638,2016,Septiembre,Israel,28,63,,91,-74.140516,4.697157
39639,2016,Septiembre,Israel,0,4,,4,-75.42726,6.170465
39640,2016,Septiembre,Italia,0,1,,1,-75.516486,10.446304
39641,2016,Septiembre,Italia,1,0,,1,-81.70216500000001,12.5862
39642,2016,Septiembre,Italia,16,69,,85,-76.532004,3.451668
39643,2016,Septiembre,Italia,69,223,,292,-74.140516,4.697157
39644,2016,Septiembre,Italia,11,32,,43,-75.42726,6.170465
39645,2016,Septiembre,Jamaica,3,27,,30,-75.527794,10.406342
39646,2016,Septiembre,Jamaica,1,5,,6,-75.516486,10.446304
39647,2016,Septiembre,Jamaica,0,1,,1,-74.77647900000001,10.886686
39648,2016,Septiembre,Jamaica,3,12,,15,-81.70216500000001,12.5862
39649,2016,Septiembre,Jamaica,4,1,,5,-76.532004,3.451668
39650,2016,Septiembre,Jamaica,2,13,,15,-74.140516,4.697157
39651,2016,Septiembre,Jamaica,1,2,,3,-75.42726,6.170465
39652,2016,Septiembre,Jamaica,1,1,,2,-73.181317,7.1280470000000005
39653,2016,Septiembre,Japón,1,9,,10,-76.532004,3.451668
39654,2016,Septiembre,Japón,9,24,,33,-74.140516,4.697157
39655,2016,Septiembre,Japón,0,4,,4,-75.42726,6.170465
39656,2016,Septiembre,Kazajistán,0,6,,6,-74.140516,4.697157
39657,2016,Septiembre,Kenia,0,2,,2,-75.42726,6.170465
39658,2016,Septiembre,Kuwait,0,1,,1,-76.532004,3.451668
39659,2016,Septiembre,Letonia,1,0,,1,-76.532004,3.451668
39660,2016,Septiembre,Letonia,0,2,,2,-74.140516,4.697157
39661,2016,Septiembre,Lituania,1,2,,3,-74.140516,4.697157
39662,2016,Septiembre,Líbano,5,12,,17,-74.140516,4.697157
39663,2016,Septiembre,Liberia,0,1,,1,-74.140516,4.697157
39664,2016,Septiembre,Libia,0,1,,1,-74.140516,4.697157
39665,2016,Septiembre,Luxemburgo,2,4,,6,-74.140516,4.697157
39666,2016,Septiembre,Luxemburgo,0,1,,1,-75.42726,6.170465
39667,2016,Septiembre,Malasia,1,3,,4,-75.516486,10.446304
39668,2016,Septiembre,Malasia,1,3,,4,-74.140516,4.697157
39669,2016,Septiembre,Malasia,0,1,,1,-75.42726,6.170465
39670,2016,Septiembre,Malta,0,1,,1,-74.140516,4.697157
39671,2016,Septiembre,Marruecos,0,16,,16,-74.140516,4.697157
39672,2016,Septiembre,Marruecos,0,1,,1,-75.42726,6.170465
39673,2016,Septiembre,Mauricio,0,1,,1,-74.140516,4.697157
39674,2016,Septiembre,Martinica/Departamento de Ultramar Francés,0,1,,1,-74.140516,4.697157
39675,2016,Septiembre,México,3,24,,27,-75.527794,10.406342
39676,2016,Septiembre,México,56,114,,170,-75.516486,10.446304
39677,2016,Septiembre,México,8,14,,22,-74.77647900000001,10.886686
39678,2016,Septiembre,México,9,8,,17,-81.70216500000001,12.5862
39679,2016,Septiembre,México,64,129,,193,-76.532004,3.451668
39680,2016,Septiembre,México,5371,9057,,14428,-74.140516,4.697157
39681,2016,Septiembre,México,7,12,,19,-75.736374,4.815189
39682,2016,Septiembre,México,481,1140,,1621,-75.42726,6.170465
39683,2016,Septiembre,México,6,20,,26,-73.181317,7.1280470000000005
39684,2016,Septiembre,México,8,5,,13,-72.508188,7.927233
39685,2016,Septiembre,República de Moldavia,1,0,,1,-74.140516,4.697157
39686,2016,Septiembre,Mozambique,0,12,,12,-74.140516,4.697157
39687,2016,Septiembre,Nauru,0,1,,1,-75.42726,6.170465
39688,2016,Septiembre,Nicaragua,0,4,,4,-75.516486,10.446304
39689,2016,Septiembre,Nicaragua,4,1,,5,-74.77647900000001,10.886686
39690,2016,Septiembre,Nicaragua,0,12,,12,-81.703935,12.574411099999999
39691,2016,Septiembre,Nicaragua,1,1,,2,-81.70216500000001,12.5862
39692,2016,Septiembre,Nicaragua,7,9,,16,-76.532004,3.451668
39693,2016,Septiembre,Nicaragua,35,33,,68,-74.140516,4.697157
39694,2016,Septiembre,Nicaragua,0,9,,9,-75.736374,4.815189
39695,2016,Septiembre,Nicaragua,7,19,,26,-75.42726,6.170465
39696,2016,Septiembre,Nicaragua,0,5,,5,-73.181317,7.1280470000000005
39697,2016,Septiembre,Noruega,0,1,,1,-74.77647900000001,10.886686
39698,2016,Septiembre,Noruega,0,1,,1,-76.532004,3.451668
39699,2016,Septiembre,Noruega,12,8,,20,-74.140516,4.697157
39700,2016,Septiembre,Noruega,2,0,,2,-75.42726,6.170465
39701,2016,Septiembre,Nueva Zelanda,0,1,,1,-76.532004,3.451668
39702,2016,Septiembre,Nueva Zelanda,6,6,,12,-74.140516,4.697157
39703,2016,Septiembre,Nueva Zelanda,0,1,,1,-73.181317,7.1280470000000005
39704,2016,Septiembre,Papúa Nueva Guinea,1,0,,1,-74.140516,4.697157
39705,2016,Septiembre,Panamá,109,214,,323,-75.527794,10.406342
39706,2016,Septiembre,Panamá,3032,3500,,6532,-75.516486,10.446304
39707,2016,Septiembre,Panamá,189,508,,697,-74.77647900000001,10.886686
39708,2016,Septiembre,Panamá,0,9,,9,-74.765343,10.970933
39709,2016,Septiembre,Panamá,0,1,,1,-81.703935,12.574411099999999
39710,2016,Septiembre,Panamá,117,119,,236,-81.70216500000001,12.5862
39711,2016,Septiembre,Panamá,472,661,,1133,-76.532004,3.451668
39712,2016,Septiembre,Panamá,0,12,,12,-77.061029,3.8844260000000004
39713,2016,Septiembre,Panamá,64,79,,143,-75.76635300000001,4.45285
39714,2016,Septiembre,Panamá,5016,6649,,11665,-74.140516,4.697157
39715,2016,Septiembre,Panamá,46,87,,133,-75.736374,4.815189
39716,2016,Septiembre,Panamá,2355,2934,,5289,-75.42726,6.170465
39717,2016,Septiembre,Panamá,0,2,,2,-77.762647,7.102626
39718,2016,Septiembre,Panamá,22,38,,60,-73.181317,7.1280470000000005
39719,2016,Septiembre,Panamá,51,36,,87,-72.508188,7.927233
39720,2016,Septiembre,Panamá,69,86,,155,-77.35002,8.63337
39721,2016,Septiembre,Paraguay,14,14,,28,-75.516486,10.446304
39722,2016,Septiembre,Paraguay,2,1,,3,-74.77647900000001,10.886686
39723,2016,Septiembre,Paraguay,72,46,,118,-81.70216500000001,12.5862
39724,2016,Septiembre,Paraguay,13,34,,47,-76.532004,3.451668
39725,2016,Septiembre,Paraguay,67,79,,146,-74.140516,4.697157
39726,2016,Septiembre,Paraguay,24,59,,83,-75.42726,6.170465
39727,2016,Septiembre,Paraguay,0,2,,2,-72.508188,7.927233
39728,2016,Septiembre,Perú,67,121,,188,-69.941498,4.191162
39729,2016,Septiembre,Perú,0,1,,1,-74.78366,0.18595699999999998
39730,2016,Septiembre,Perú,4,13,,17,-77.35600000000001,0.81488
39731,2016,Septiembre,Perú,0,2,,2,-75.527794,10.406342
39732,2016,Septiembre,Perú,15,27,,42,-75.516486,10.446304
39733,2016,Septiembre,Perú,0,3,,3,-74.77647900000001,10.886686
39734,2016,Septiembre,Perú,0,1,,1,-74.765343,10.970933
39735,2016,Septiembre,Perú,0,1,,1,-74.213989,11.247722999999999
39736,2016,Septiembre,Perú,91,64,,155,-81.70216500000001,12.5862
39737,2016,Septiembre,Perú,303,470,,773,-76.532004,3.451668
39738,2016,Septiembre,Perú,5864,7614,,13478,-74.140516,4.697157
39739,2016,Septiembre,Perú,7,6,,13,-75.736374,4.815189
39740,2016,Septiembre,Perú,501,785,,1286,-75.42726,6.170465
39741,2016,Septiembre,Perú,0,3,,3,-73.181317,7.1280470000000005
39742,2016,Septiembre,Perú,0,2,,2,-72.508188,7.927233
39743,2016,Septiembre,Palestina,1,0,,1,-74.140516,4.697157
39744,2016,Septiembre,Polonia,3,2,,5,-76.532004,3.451668
39745,2016,Septiembre,Polonia,8,17,,25,-74.140516,4.697157
39746,2016,Septiembre,Polonia,1,4,,5,-75.42726,6.170465
39747,2016,Septiembre,Portugal,1,7,,8,-75.516486,10.446304
39748,2016,Septiembre,Portugal,0,1,,1,-74.77647900000001,10.886686
39749,2016,Septiembre,Portugal,1,25,,26,-76.532004,3.451668
39750,2016,Septiembre,Portugal,25,64,,89,-74.140516,4.697157
39751,2016,Septiembre,Portugal,1,9,,10,-75.42726,6.170465
39752,2016,Septiembre,Puerto Rico/Territorio de Estados Unidos,0,2,,2,-75.527794,10.406342
39753,2016,Septiembre,Puerto Rico/Territorio de Estados Unidos,2,9,,11,-75.516486,10.446304
39754,2016,Septiembre,Puerto Rico/Territorio de Estados Unidos,1,43,,44,-74.77647900000001,10.886686
39755,2016,Septiembre,Puerto Rico/Territorio de Estados Unidos,24,29,,53,-76.532004,3.451668
39756,2016,Septiembre,Puerto Rico/Territorio de Estados Unidos,296,367,,663,-74.140516,4.697157
39757,2016,Septiembre,Puerto Rico/Territorio de Estados Unidos,3,5,,8,-75.736374,4.815189
39758,2016,Septiembre,Puerto Rico/Territorio de Estados Unidos,43,98,,141,-75.42726,6.170465
39759,2016,Septiembre,Puerto Rico/Territorio de Estados Unidos,1,2,,3,-73.181317,7.1280470000000005
39760,2016,Septiembre,Puerto Rico/Territorio de Estados Unidos,0,1,,1,-72.508188,7.927233
39761,2016,Septiembre,Qatar,2,0,,2,-74.140516,4.697157
39762,2016,Septiembre,Reino Unido de Gran Bretaña e Irlanda del Norte,0,1,,1,-81.70216500000001,12.5862
39763,2016,Septiembre,Reino Unido de Gran Bretaña e Irlanda del Norte,5,13,,18,-76.532004,3.451668
39764,2016,Septiembre,Reino Unido de Gran Bretaña e Irlanda del Norte,554,978,,1532,-74.140516,4.697157
39765,2016,Septiembre,Reino Unido de Gran Bretaña e Irlanda del Norte,7,25,,32,-75.42726,6.170465
39766,2016,Septiembre,Reino Unido de Gran Bretaña e Irlanda del Norte,2,2,,4,-73.181317,7.1280470000000005
39767,2016,Septiembre,República CentroÁfricana,0,1,,1,-74.140516,4.697157
39768,2016,Septiembre,Federación de Rusia,0,1,,1,-76.532004,3.451668
39769,2016,Septiembre,Federación de Rusia,22,33,,55,-74.140516,4.697157
39770,2016,Septiembre,Federación de Rusia,0,1,,1,-75.736374,4.815189
39771,2016,Septiembre,Federación de Rusia,2,6,,8,-75.42726,6.170465
39772,2016,Septiembre,Federación de Rusia,0,2,,2,-76.7333,8.06667
39773,2016,Septiembre,República Dominicana,0,8,,8,-75.527794,10.406342
39774,2016,Septiembre,República Dominicana,14,47,,61,-75.516486,10.446304
39775,2016,Septiembre,República Dominicana,17,30,,47,-74.77647900000001,10.886686
39776,2016,Septiembre,República Dominicana,0,1,,1,-74.765343,10.970933
39777,2016,Septiembre,República Dominicana,0,1,,1,-74.232675,11.117206
39778,2016,Septiembre,República Dominicana,18,25,,43,-76.532004,3.451668
39779,2016,Septiembre,República Dominicana,656,905,,1561,-74.140516,4.697157
39780,2016,Septiembre,República Dominicana,5,6,,11,-75.736374,4.815189
39781,2016,Septiembre,República Dominicana,59,82,,141,-75.42726,6.170465
39782,2016,Septiembre,República Dominicana,3,3,,6,-73.181317,7.1280470000000005
39783,2016,Septiembre,República Dominicana,2,3,,5,-72.508188,7.927233
39784,2016,Septiembre,Reunión,0,1,,1,-74.140516,4.697157
39785,2016,Septiembre,República Democrática Popular de Corea,1,0,,1,-74.140516,4.697157
39786,2016,Septiembre,Rumania,2,3,,5,-75.516486,10.446304
39787,2016,Septiembre,Rumania,3,5,,8,-76.532004,3.451668
39788,2016,Septiembre,Rumania,6,9,,15,-74.140516,4.697157
39789,2016,Septiembre,Rumania,0,2,,2,-75.42726,6.170465
39790,2016,Septiembre,Rwanda,0,2,,2,-74.140516,4.697157
39791,2016,Septiembre,San Cristóbal y Nevis,0,1,,1,-74.140516,4.697157
39792,2016,Septiembre,San Cristóbal y Nevis,1,0,,1,-75.42726,6.170465
39793,2016,Septiembre,Santa Lucia,2,2,,4,-74.140516,4.697157
39794,2016,Septiembre,Santa Sede/Ciudad del Vaticano,1,0,,1,-74.140516,4.697157
39795,2016,Septiembre,Serbia,0,2,,2,-74.140516,4.697157
39796,2016,Septiembre,Singapur,1,2,,3,-74.140516,4.697157
39797,2016,Septiembre,Singapur,1,0,,1,-75.42726,6.170465
39798,2016,Septiembre,Sudáfrica,2,6,,8,-74.140516,4.697157
39799,2016,Septiembre,Sudáfrica,1,1,,2,-75.42726,6.170465
39800,2016,Septiembre,Suecia,1,0,,1,-75.516486,10.446304
39801,2016,Septiembre,Suecia,0,1,,1,-74.77647900000001,10.886686
39802,2016,Septiembre,Suecia,1,5,,6,-76.532004,3.451668
39803,2016,Septiembre,Suecia,22,32,,54,-74.140516,4.697157
39804,2016,Septiembre,Suecia,2,5,,7,-75.42726,6.170465
39805,2016,Septiembre,Suiza,0,1,,1,-75.516486,10.446304
39806,2016,Septiembre,Suiza,0,1,,1,-74.77647900000001,10.886686
39807,2016,Septiembre,Suiza,10,13,,23,-76.532004,3.451668
39808,2016,Septiembre,Suiza,50,70,,120,-74.140516,4.697157
39809,2016,Septiembre,Suiza,0,1,,1,-75.736374,4.815189
39810,2016,Septiembre,Suiza,6,13,,19,-75.42726,6.170465
39811,2016,Septiembre,Suiza,0,1,,1,-73.181317,7.1280470000000005
39812,2016,Septiembre,Surinam,2,3,,5,-76.532004,3.451668
39813,2016,Septiembre,Surinam,6,3,,9,-74.140516,4.697157
39814,2016,Septiembre,Surinam,4,3,,7,-75.42726,6.170465
39815,2016,Septiembre,Taiwán,1,1,,2,-76.532004,3.451668
39816,2016,Septiembre,Taiwán,2,6,,8,-74.140516,4.697157
39817,2016,Septiembre,Tailandia,8,19,,27,-74.140516,4.697157
39818,2016,Septiembre,Tailandia,0,1,,1,-75.42726,6.170465
39819,2016,Septiembre,Tanzania,3,0,,3,-74.140516,4.697157
39820,2016,Septiembre,Togo,0,1,,1,-74.140516,4.697157
39821,2016,Septiembre,Trinidad y Tobago,3,0,,3,-75.516486,10.446304
39822,2016,Septiembre,Trinidad y Tobago,1,0,,1,-81.70216500000001,12.5862
39823,2016,Septiembre,Trinidad y Tobago,1,1,,2,-76.532004,3.451668
39824,2016,Septiembre,Trinidad y Tobago,8,12,,20,-74.140516,4.697157
39825,2016,Septiembre,Trinidad y Tobago,3,5,,8,-75.42726,6.170465
39826,2016,Septiembre,Trinidad y Tobago,0,1,,1,-73.181317,7.1280470000000005
39827,2016,Septiembre,Trinidad y Tobago,0,4,,4,-72.508188,7.927233
39828,2016,Septiembre,Túnez,1,1,,2,-74.140516,4.697157
39829,2016,Septiembre,Turkmenistán,0,5,,5,-74.140516,4.697157
39830,2016,Septiembre,Turquía,0,1,,1,-74.213989,11.247722999999999
39831,2016,Septiembre,Turquía,0,2,,2,-76.532004,3.451668
39832,2016,Septiembre,Turquía,342,581,,923,-74.140516,4.697157
39833,2016,Septiembre,Turquía,0,3,,3,-75.42726,6.170465
39834,2016,Septiembre,Ucrania,1,4,,5,-74.140516,4.697157
39835,2016,Septiembre,Uruguay,12,12,,24,-75.516486,10.446304
39836,2016,Septiembre,Uruguay,2,13,,15,-74.77647900000001,10.886686
39837,2016,Septiembre,Uruguay,29,20,,49,-81.70216500000001,12.5862
39838,2016,Septiembre,Uruguay,18,24,,42,-76.532004,3.451668
39839,2016,Septiembre,Uruguay,82,119,,201,-74.140516,4.697157
39840,2016,Septiembre,Uruguay,1,1,,2,-75.736374,4.815189
39841,2016,Septiembre,Uruguay,42,59,,101,-75.42726,6.170465
39842,2016,Septiembre,Venezuela,0,2,,2,-75.527794,10.406342
39843,2016,Septiembre,Venezuela,15,114,,129,-75.516486,10.446304
39844,2016,Septiembre,Venezuela,11,98,,109,-74.77647900000001,10.886686
39845,2016,Septiembre,Venezuela,0,1,,1,-74.232675,11.117206
39846,2016,Septiembre,Venezuela,0,1,,1,-74.213989,11.247722999999999
39847,2016,Septiembre,Venezuela,4588,5586,,10174,-72.129595,11.360028999999999
39848,2016,Septiembre,Venezuela,3,3,,6,-81.70216500000001,12.5862
39849,2016,Septiembre,Venezuela,9,31,,40,-76.532004,3.451668
39850,2016,Septiembre,Venezuela,23,21,,44,-67.927521,3.866713
39851,2016,Septiembre,Venezuela,3273,3718,,6991,-74.140516,4.697157
39852,2016,Septiembre,Venezuela,3,2,,5,-75.736374,4.815189
39853,2016,Septiembre,Venezuela,492,564,,1056,-75.42726,6.170465
39854,2016,Septiembre,Venezuela,1864,2356,,4220,-67.48402800000001,6.185536
39855,2016,Septiembre,Venezuela,5522,5453,,10975,-70.74025300000001,7.088728999999999
39856,2016,Septiembre,Venezuela,2,2,,4,-73.181317,7.1280470000000005
39857,2016,Septiembre,Venezuela,6120,8063,,14183,-72.453013,7.819
39858,2016,Septiembre,Venezuela,1,7,,8,-72.508188,7.927233
39859,2016,Septiembre,Venezuela,125,137,,262,-72.409396,8.36068
39860,2016,Septiembre,Vietnam,0,1,,1,-74.140516,4.697157
39861,2016,Septiembre,Islas Vírgenes Estadounidenses/Territorio de Estados Unidos,0,2,,2,-75.516486,10.446304
39862,2016,Septiembre,Anguila/Territorio Británico de Ultramar,0,1,,1,-76.532004,3.451668
39863,2016,Septiembre,Desconocido,0,1,,1,-69.941498,4.191162
39864,2016,Septiembre,Desconocido,0,1,,1,-75.76635300000001,4.45285
39865,2016,Septiembre,Desconocido,0,1,,1,-74.140516,4.697157
39866,2016,Octubre,Albania,1,1,,2,-74.140516,4.697157
39867,2016,Octubre,Alemania,1,0,,1,-75.516486,10.446304
39868,2016,Octubre,Alemania,2,0,,2,-74.77647900000001,10.886686
39869,2016,Octubre,Alemania,0,2,,2,-74.213989,11.247722999999999
39870,2016,Octubre,Alemania,1,0,,1,-81.70216500000001,12.5862
39871,2016,Octubre,Alemania,23,37,,60,-76.532004,3.451668
39872,2016,Octubre,Alemania,1359,2385,,3744,-74.140516,4.697157
39873,2016,Octubre,Alemania,4,1,,5,-75.736374,4.815189
39874,2016,Octubre,Alemania,19,34,,53,-75.42726,6.170465
39875,2016,Octubre,Andorra,1,0,,1,-74.140516,4.697157
39876,2016,Octubre,Angola,0,6,,6,-75.68164200000001,9.402597
39877,2016,Octubre,Antigua y Barbuda,0,4,,4,-74.140516,4.697157
39878,2016,Octubre,Países Bajos,5,14,,19,-75.527794,10.406342
39879,2016,Octubre,Países Bajos,0,1,,1,-75.516486,10.446304
39880,2016,Octubre,Países Bajos,50,90,,140,-74.77647900000001,10.886686
39881,2016,Octubre,Países Bajos,1,3,,4,-74.765343,10.970933
39882,2016,Octubre,Países Bajos,3,6,,9,-74.213989,11.247722999999999
39883,2016,Octubre,Países Bajos,82,120,,202,-76.532004,3.451668
39884,2016,Octubre,Países Bajos,767,1092,,1859,-74.140516,4.697157
39885,2016,Octubre,Países Bajos,3,2,,5,-75.736374,4.815189
39886,2016,Octubre,Países Bajos,229,245,,474,-75.42726,6.170465
39887,2016,Octubre,Países Bajos,2,1,,3,-73.181317,7.1280470000000005
39888,2016,Octubre,Arabia Saudita,1,1,,2,-74.140516,4.697157
39889,2016,Octubre,Argelia,0,4,,4,-74.140516,4.697157
39890,2016,Octubre,Argentina,2,17,,19,-77.35600000000001,0.81488
39891,2016,Octubre,Argentina,0,8,,8,-75.527794,10.406342
39892,2016,Octubre,Argentina,59,41,,100,-75.516486,10.446304
39893,2016,Octubre,Argentina,1,7,,8,-74.77647900000001,10.886686
39894,2016,Octubre,Argentina,195,118,,313,-81.70216500000001,12.5862
39895,2016,Octubre,Argentina,75,84,,159,-76.532004,3.451668
39896,2016,Octubre,Argentina,2266,3097,,5363,-74.140516,4.697157
39897,2016,Octubre,Argentina,2,3,,5,-75.736374,4.815189
39898,2016,Octubre,Argentina,94,179,,273,-75.42726,6.170465
39899,2016,Octubre,Argentina,0,2,,2,-73.181317,7.1280470000000005
39900,2016,Octubre,República de Armenia,1,1,,2,-74.140516,4.697157
39901,2016,Octubre,Aruba,9,10,,19,-75.527794,10.406342
39902,2016,Octubre,Aruba,5,7,,12,-74.77647900000001,10.886686
39903,2016,Octubre,Aruba,10,16,,26,-74.213989,11.247722999999999
39904,2016,Octubre,Aruba,3,2,,5,-76.532004,3.451668
39905,2016,Octubre,Aruba,683,777,,1460,-74.140516,4.697157
39906,2016,Octubre,Aruba,81,109,,190,-75.42726,6.170465
39907,2016,Octubre,Aruba,13,8,,21,-73.181317,7.1280470000000005
39908,2016,Octubre,Australia,1,1,,2,-75.516486,10.446304
39909,2016,Octubre,Australia,0,1,,1,-74.77647900000001,10.886686
39910,2016,Octubre,Australia,3,6,,9,-76.532004,3.451668
39911,2016,Octubre,Australia,36,52,,88,-74.140516,4.697157
39912,2016,Octubre,Australia,3,1,,4,-75.736374,4.815189
39913,2016,Octubre,Australia,10,12,,22,-75.42726,6.170465
39914,2016,Octubre,Austria,4,5,,9,-76.532004,3.451668
39915,2016,Octubre,Austria,23,30,,53,-74.140516,4.697157
39916,2016,Octubre,Austria,0,4,,4,-75.42726,6.170465
39917,2016,Octubre,Austria,0,1,,1,-73.181317,7.1280470000000005
39918,2016,Octubre,Azerbaiyán,0,1,,1,-74.140516,4.697157
39919,2016,Octubre,Bahamas,2,6,,8,-75.527794,10.406342
39920,2016,Octubre,Bahamas,1,0,,1,-74.140516,4.697157
39921,2016,Octubre,Bahréin,1,1,,2,-75.516486,10.446304
39922,2016,Octubre,Bahréin,0,1,,1,-72.129595,11.360028999999999
39923,2016,Octubre,Bahréin,0,1,,1,-74.140516,4.697157
39924,2016,Octubre,Barbados,0,1,,1,-76.532004,3.451668
39925,2016,Octubre,Barbados,37,38,,75,-74.140516,4.697157
39926,2016,Octubre,Barbados,0,1,,1,-75.42726,6.170465
39927,2016,Octubre,República de Belarús,1,9,,10,-74.140516,4.697157
39928,2016,Octubre,República de Belarús,0,1,,1,-72.453013,7.819
39929,2016,Octubre,Bélgica,0,5,,5,-75.527794,10.406342
39930,2016,Octubre,Bélgica,4,8,,12,-76.532004,3.451668
39931,2016,Octubre,Bélgica,34,61,,95,-74.140516,4.697157
39932,2016,Octubre,Bélgica,0,1,,1,-75.736374,4.815189
39933,2016,Octubre,Bélgica,2,7,,9,-75.42726,6.170465
39934,2016,Octubre,Belice,0,5,,5,-75.527794,10.406342
39935,2016,Octubre,Belice,1,5,,6,-74.140516,4.697157
39936,2016,Octubre,Belice,0,1,,1,-75.42726,6.170465
39937,2016,Octubre,Benín,2,2,,4,-74.140516,4.697157
39938,2016,Octubre,Bolivia,2,0,,2,-77.35600000000001,0.81488
39939,2016,Octubre,Bolivia,8,5,,13,-75.516486,10.446304
39940,2016,Octubre,Bolivia,2,55,,57,-74.77647900000001,10.886686
39941,2016,Octubre,Bolivia,9,20,,29,-81.70216500000001,12.5862
39942,2016,Octubre,Bolivia,16,17,,33,-76.532004,3.451668
39943,2016,Octubre,Bolivia,511,623,,1134,-74.140516,4.697157
39944,2016,Octubre,Bolivia,55,46,,101,-75.42726,6.170465
39945,2016,Octubre,Botsuana,0,1,,1,-74.140516,4.697157
39946,2016,Octubre,Brasil,195,201,,396,-69.941498,4.191162
39947,2016,Octubre,Brasil,0,1,,1,-77.35600000000001,0.81488
39948,2016,Octubre,Brasil,0,1,,1,-75.527794,10.406342
39949,2016,Octubre,Brasil,105,95,,200,-75.516486,10.446304
39950,2016,Octubre,Brasil,5,42,,47,-74.77647900000001,10.886686
39951,2016,Octubre,Brasil,387,269,,656,-81.70216500000001,12.5862
39952,2016,Octubre,Brasil,92,101,,193,-76.532004,3.451668
39953,2016,Octubre,Brasil,2,6,,8,-67.927521,3.866713
39954,2016,Octubre,Brasil,5012,6151,,11163,-74.140516,4.697157
39955,2016,Octubre,Brasil,0,5,,5,-75.736374,4.815189
39956,2016,Octubre,Brasil,63,137,,200,-75.42726,6.170465
39957,2016,Octubre,Brasil,2,2,,4,-73.181317,7.1280470000000005
39958,2016,Octubre,Bulgaria,0,1,,1,-75.516486,10.446304
39959,2016,Octubre,Bulgaria,2,0,,2,-74.77647900000001,10.886686
39960,2016,Octubre,Bulgaria,0,5,,5,-74.140516,4.697157
39961,2016,Octubre,Cabo Verde,1,0,,1,-74.140516,4.697157
39962,2016,Octubre,Islas Caimán/Territorio Británico de Ultramar,0,6,,6,-75.527794,10.406342
39963,2016,Octubre,Islas Caimán/Territorio Británico de Ultramar,1,3,,4,-75.516486,10.446304
39964,2016,Octubre,Islas Caimán/Territorio Británico de Ultramar,0,2,,2,-74.77647900000001,10.886686
39965,2016,Octubre,Islas Caimán/Territorio Británico de Ultramar,1,5,,6,-81.703935,12.574411099999999
39966,2016,Octubre,Islas Caimán/Territorio Británico de Ultramar,0,5,,5,-81.70216500000001,12.5862
39967,2016,Octubre,Islas Caimán/Territorio Británico de Ultramar,1,0,,1,-74.140516,4.697157
39968,2016,Octubre,Canadá,17,16,,33,-75.516486,10.446304
39969,2016,Octubre,Canadá,2,5,,7,-74.77647900000001,10.886686
39970,2016,Octubre,Canadá,0,1,,1,-74.213989,11.247722999999999
39971,2016,Octubre,Canadá,2,2,,4,-81.70216500000001,12.5862
39972,2016,Octubre,Canadá,24,34,,58,-76.532004,3.451668
39973,2016,Octubre,Canadá,559,994,,1553,-74.140516,4.697157
39974,2016,Octubre,Canadá,1,3,,4,-75.736374,4.815189
39975,2016,Octubre,Canadá,59,130,,189,-75.42726,6.170465
39976,2016,Octubre,Canadá,3,4,,7,-73.181317,7.1280470000000005
39977,2016,Octubre,España,8,32,,40,-75.516486,10.446304
39978,2016,Octubre,España,2,2,,4,-74.77647900000001,10.886686
39979,2016,Octubre,España,0,4,,4,-74.765343,10.970933
39980,2016,Octubre,España,448,718,,1166,-76.532004,3.451668
39981,2016,Octubre,España,3646,6236,,9882,-74.140516,4.697157
39982,2016,Octubre,España,0,3,,3,-75.736374,4.815189
39983,2016,Octubre,España,219,472,,691,-75.42726,6.170465
39984,2016,Octubre,España,0,1,,1,-73.181317,7.1280470000000005
39985,2016,Octubre,España,0,3,,3,-76.7333,8.06667
39986,2016,Octubre,República Del Congo,0,2,,2,-74.140516,4.697157
39987,2016,Octubre,República Democrática del Congo,0,1,,1,-74.140516,4.697157
39988,2016,Octubre,República de Corea,0,3,,3,-74.77647900000001,10.886686
39989,2016,Octubre,República de Corea,2,0,,2,-81.70216500000001,12.5862
39990,2016,Octubre,República de Corea,0,1,,1,-76.532004,3.451668
39991,2016,Octubre,República de Corea,9,19,,28,-74.140516,4.697157
39992,2016,Octubre,República de Corea,4,7,,11,-75.736374,4.815189
39993,2016,Octubre,República de Corea,1,6,,7,-75.42726,6.170465
39994,2016,Octubre,Costa de Marfil,0,1,,1,-75.516486,10.446304
39995,2016,Octubre,Costa de Marfil,8,6,,14,-74.140516,4.697157
39996,2016,Octubre,Costa Rica,22,52,,74,-75.527794,10.406342
39997,2016,Octubre,Costa Rica,10,15,,25,-75.516486,10.446304
39998,2016,Octubre,Costa Rica,1,13,,14,-74.77647900000001,10.886686
39999,2016,Octubre,Costa Rica,0,9,,9,-81.703935,12.574411099999999
40000,2016,Octubre,Costa Rica,104,82,,186,-81.70216500000001,12.5862
40001,2016,Octubre,Costa Rica,0,8,,8,-81.372937,13.338761300000002
40002,2016,Octubre,Costa Rica,16,34,,50,-76.532004,3.451668
40003,2016,Octubre,Costa Rica,1016,1448,,2464,-74.140516,4.697157
40004,2016,Octubre,Costa Rica,6,20,,26,-75.736374,4.815189
40005,2016,Octubre,Costa Rica,89,145,,234,-75.42726,6.170465
40006,2016,Octubre,Costa Rica,5,2,,7,-73.181317,7.1280470000000005
40007,2016,Octubre,Croacia,0,1,,1,-74.77647900000001,10.886686
40008,2016,Octubre,Croacia,0,1,,1,-76.532004,3.451668
40009,2016,Octubre,Croacia,2,4,,6,-74.140516,4.697157
40010,2016,Octubre,Cuba,47,50,,97,-75.516486,10.446304
40011,2016,Octubre,Cuba,11,10,,21,-74.77647900000001,10.886686
40012,2016,Octubre,Cuba,22,23,,45,-76.532004,3.451668
40013,2016,Octubre,Cuba,315,545,,860,-74.140516,4.697157
40014,2016,Octubre,Cuba,2,1,,3,-75.736374,4.815189
40015,2016,Octubre,Cuba,18,26,,44,-75.42726,6.170465
40016,2016,Octubre,Cuba,6,6,,12,-73.181317,7.1280470000000005
40017,2016,Octubre,Curazao,3,2,,5,-74.140516,4.697157
40018,2016,Octubre,República Checa,1,0,,1,-76.532004,3.451668
40019,2016,Octubre,República Checa,8,6,,14,-74.140516,4.697157
40020,2016,Octubre,República Checa,1,0,,1,-75.42726,6.170465
40021,2016,Octubre,Chile,1,2,,3,-77.35600000000001,0.81488
40022,2016,Octubre,Chile,25,38,,63,-75.516486,10.446304
40023,2016,Octubre,Chile,20,9,,29,-74.77647900000001,10.886686
40024,2016,Octubre,Chile,38,29,,67,-81.70216500000001,12.5862
40025,2016,Octubre,Chile,111,224,,335,-76.532004,3.451668
40026,2016,Octubre,Chile,5680,6457,,12137,-74.140516,4.697157
40027,2016,Octubre,Chile,1,2,,3,-75.736374,4.815189
40028,2016,Octubre,Chile,24,53,,77,-75.42726,6.170465
40029,2016,Octubre,Chile,1,1,,2,-73.181317,7.1280470000000005
40030,2016,Octubre,China,1,0,,1,-74.77647900000001,10.886686
40031,2016,Octubre,China,0,3,,3,-76.532004,3.451668
40032,2016,Octubre,China,42,89,,131,-74.140516,4.697157
40033,2016,Octubre,China,1,0,,1,-75.736374,4.815189
40034,2016,Octubre,China,1,2,,3,-75.42726,6.170465
40035,2016,Octubre,China,0,1,,1,-73.181317,7.1280470000000005
40036,2016,Octubre,Chipre,0,1,,1,-74.140516,4.697157
40037,2016,Octubre,Dinamarca,2,0,,2,-75.516486,10.446304
40038,2016,Octubre,Dinamarca,13,21,,34,-74.140516,4.697157
40039,2016,Octubre,Dinamarca,2,0,,2,-75.42726,6.170465
40040,2016,Octubre,Dominica,0,1,,1,-76.532004,3.451668
40041,2016,Octubre,Ecuador,0,2,,2,-74.78366,0.18595699999999998
40042,2016,Octubre,Ecuador,112,268,,380,-76.876446,0.33002
40043,2016,Octubre,Ecuador,8,4,,12,-77.84700600000001,0.8124359999999999
40044,2016,Octubre,Ecuador,3452,5046,,8498,-77.35600000000001,0.81488
40045,2016,Octubre,Ecuador,53,119,,172,-78.802679,18.00143
40046,2016,Octubre,Ecuador,0,1,,1,-75.527794,10.406342
40047,2016,Octubre,Ecuador,7,16,,23,-75.516486,10.446304
40048,2016,Octubre,Ecuador,4,4,,8,-74.77647900000001,10.886686
40049,2016,Octubre,Ecuador,4,2,,6,-81.70216500000001,12.5862
40050,2016,Octubre,Ecuador,450,485,,935,-76.532004,3.451668
40051,2016,Octubre,Ecuador,0,2,,2,-77.061029,3.8844260000000004
40052,2016,Octubre,Ecuador,3358,5120,,8478,-74.140516,4.697157
40053,2016,Octubre,Ecuador,8,9,,17,-75.736374,4.815189
40054,2016,Octubre,Ecuador,49,71,,120,-75.42726,6.170465
40055,2016,Octubre,Ecuador,3,2,,5,-73.181317,7.1280470000000005
40056,2016,Octubre,Egipto,1,4,,5,-74.140516,4.697157
40057,2016,Octubre,El Salvador,11,10,,21,-75.516486,10.446304
40058,2016,Octubre,El Salvador,2,3,,5,-74.77647900000001,10.886686
40059,2016,Octubre,El Salvador,21,28,,49,-81.70216500000001,12.5862
40060,2016,Octubre,El Salvador,107,162,,269,-76.532004,3.451668
40061,2016,Octubre,El Salvador,1033,1519,,2552,-74.140516,4.697157
40062,2016,Octubre,El Salvador,0,3,,3,-75.736374,4.815189
40063,2016,Octubre,El Salvador,159,277,,436,-75.42726,6.170465
40064,2016,Octubre,Emiratos Árabes,2,10,,12,-74.140516,4.697157
40065,2016,Octubre,Eritrea,1,0,,1,-74.140516,4.697157
40066,2016,Octubre,Eslovaquia,4,6,,10,-74.140516,4.697157
40067,2016,Octubre,Eslovenia,0,1,,1,-74.77647900000001,10.886686
40068,2016,Octubre,Eslovenia,0,1,,1,-76.532004,3.451668
40069,2016,Octubre,Eslovenia,3,1,,4,-74.140516,4.697157
40070,2016,Octubre,Eslovenia,0,2,,2,-75.42726,6.170465
40071,2016,Octubre,Estados Unidos de América,5,33,,38,-75.527794,10.406342
40072,2016,Octubre,Estados Unidos de América,1972,3106,,5078,-75.516486,10.446304
40073,2016,Octubre,Estados Unidos de América,330,754,,1084,-74.77647900000001,10.886686
40074,2016,Octubre,Estados Unidos de América,0,2,,2,-74.765343,10.970933
40075,2016,Octubre,Estados Unidos de América,0,1,,1,-74.232675,11.117206
40076,2016,Octubre,Estados Unidos de América,2,24,,26,-74.213989,11.247722999999999
40077,2016,Octubre,Estados Unidos de América,7,18,,25,-81.70216500000001,12.5862
40078,2016,Octubre,Estados Unidos de América,681,1137,,1818,-76.532004,3.451668
40079,2016,Octubre,Estados Unidos de América,0,1,,1,-77.061029,3.8844260000000004
40080,2016,Octubre,Estados Unidos de América,78,158,,236,-75.76635300000001,4.45285
40081,2016,Octubre,Estados Unidos de América,7397,13616,,21013,-74.140516,4.697157
40082,2016,Octubre,Estados Unidos de América,72,139,,211,-75.736374,4.815189
40083,2016,Octubre,Estados Unidos de América,1305,3825,,5130,-75.42726,6.170465
40084,2016,Octubre,Estados Unidos de América,16,37,,53,-73.181317,7.1280470000000005
40085,2016,Octubre,Estados Unidos de América,4,3,,7,-72.508188,7.927233
40086,2016,Octubre,Estados Unidos de América,0,11,,11,-75.68164200000001,9.402597
40087,2016,Octubre,Estonia,4,4,,8,-74.140516,4.697157
40088,2016,Octubre,Etiopia,0,1,,1,-74.140516,4.697157
40089,2016,Octubre,Islas Fiji,1,0,,1,-74.140516,4.697157
40090,2016,Octubre,Filipinas,0,3,,3,-74.77647900000001,10.886686
40091,2016,Octubre,Filipinas,0,1,,1,-76.532004,3.451668
40092,2016,Octubre,Filipinas,4,20,,24,-74.140516,4.697157
40093,2016,Octubre,Finlandia,2,0,,2,-76.532004,3.451668
40094,2016,Octubre,Finlandia,3,8,,11,-74.140516,4.697157
40095,2016,Octubre,Francia,0,1,,1,-75.527794,10.406342
40096,2016,Octubre,Francia,2,0,,2,-75.516486,10.446304
40097,2016,Octubre,Francia,2,2,,4,-74.77647900000001,10.886686
40098,2016,Octubre,Francia,25,58,,83,-76.532004,3.451668
40099,2016,Octubre,Francia,1317,2087,,3404,-74.140516,4.697157
40100,2016,Octubre,Francia,35,58,,93,-75.42726,6.170465
40101,2016,Octubre,Francia,1,1,,2,-73.181317,7.1280470000000005
40102,2016,Octubre,Georgia,0,1,,1,-76.532004,3.451668
40103,2016,Octubre,Ghana,0,2,,2,-76.532004,3.451668
40104,2016,Octubre,Ghana,0,1,,1,-74.140516,4.697157
40105,2016,Octubre,Granada,0,2,,2,-74.213989,11.247722999999999
40106,2016,Octubre,Granada,1,0,,1,-74.140516,4.697157
40107,2016,Octubre,Grecia,0,1,,1,-76.532004,3.451668
40108,2016,Octubre,Grecia,9,7,,16,-74.140516,4.697157
40109,2016,Octubre,Guatemala,29,31,,60,-75.516486,10.446304
40110,2016,Octubre,Guatemala,2,7,,9,-74.77647900000001,10.886686
40111,2016,Octubre,Guatemala,10,12,,22,-81.70216500000001,12.5862
40112,2016,Octubre,Guatemala,22,46,,68,-76.532004,3.451668
40113,2016,Octubre,Guatemala,398,643,,1041,-74.140516,4.697157
40114,2016,Octubre,Guatemala,3,3,,6,-75.736374,4.815189
40115,2016,Octubre,Guatemala,70,157,,227,-75.42726,6.170465
40116,2016,Octubre,Guatemala,2,10,,12,-73.181317,7.1280470000000005
40117,2016,Octubre,Guyana,1,1,,2,-76.532004,3.451668
40118,2016,Octubre,Guyana,1,2,,3,-74.140516,4.697157
40119,2016,Octubre,Guinea Ecuatorial,0,1,,1,-74.140516,4.697157
40120,2016,Octubre,Guadalupe/Territorio Francés,1,0,,1,-76.532004,3.451668
40121,2016,Octubre,Guadalupe/Territorio Francés,1,2,,3,-74.140516,4.697157
40122,2016,Octubre,Guadalupe/Territorio Francés,0,1,,1,-75.736374,4.815189
40123,2016,Octubre,Guadalupe/Territorio Francés,0,1,,1,-75.42726,6.170465
40124,2016,Octubre,Guayana Francesa/Departamento de Ultramar Francés,3,1,,4,-74.140516,4.697157
40125,2016,Octubre,Haití,0,1,,1,-75.516486,10.446304
40126,2016,Octubre,Haití,0,1,,1,-74.77647900000001,10.886686
40127,2016,Octubre,Haití,4,2,,6,-74.140516,4.697157
40128,2016,Octubre,Haití,0,8,,8,-75.42726,6.170465
40129,2016,Octubre,Honduras,7,26,,33,-75.516486,10.446304
40130,2016,Octubre,Honduras,4,8,,12,-74.77647900000001,10.886686
40131,2016,Octubre,Honduras,0,4,,4,-81.703935,12.574411099999999
40132,2016,Octubre,Honduras,62,51,,113,-81.70216500000001,12.5862
40133,2016,Octubre,Honduras,17,48,,65,-76.532004,3.451668
40134,2016,Octubre,Honduras,132,138,,270,-74.140516,4.697157
40135,2016,Octubre,Honduras,1,4,,5,-75.736374,4.815189
40136,2016,Octubre,Honduras,58,85,,143,-75.42726,6.170465
40137,2016,Octubre,Honduras,1,0,,1,-73.181317,7.1280470000000005
40138,2016,Octubre,Hong Kong,1,0,,1,-74.140516,4.697157
40139,2016,Octubre,Hungría,5,6,,11,-74.140516,4.697157
40140,2016,Octubre,Hungría,0,1,,1,-75.42726,6.170465
40141,2016,Octubre,India,0,3,,3,-74.77647900000001,10.886686
40142,2016,Octubre,India,1,2,,3,-76.532004,3.451668
40143,2016,Octubre,India,6,23,,29,-74.140516,4.697157
40144,2016,Octubre,India,1,8,,9,-75.42726,6.170465
40145,2016,Octubre,Indonesia,0,2,,2,-74.140516,4.697157
40146,2016,Octubre,Irán,0,4,,4,-74.140516,4.697157
40147,2016,Octubre,República de Irlanda,1,1,,2,-76.532004,3.451668
40148,2016,Octubre,República de Irlanda,16,12,,28,-74.140516,4.697157
40149,2016,Octubre,República de Irlanda,2,3,,5,-75.42726,6.170465
40150,2016,Octubre,Islandia,0,1,,1,-74.140516,4.697157
40151,2016,Octubre,Israel,1,0,,1,-74.77647900000001,10.886686
40152,2016,Octubre,Israel,0,6,,6,-76.532004,3.451668
40153,2016,Octubre,Israel,18,48,,66,-74.140516,4.697157
40154,2016,Octubre,Israel,3,5,,8,-75.42726,6.170465
40155,2016,Octubre,Italia,0,2,,2,-75.516486,10.446304
40156,2016,Octubre,Italia,0,2,,2,-74.77647900000001,10.886686
40157,2016,Octubre,Italia,20,29,,49,-76.532004,3.451668
40158,2016,Octubre,Italia,91,238,,329,-74.140516,4.697157
40159,2016,Octubre,Italia,11,41,,52,-75.42726,6.170465
40160,2016,Octubre,Italia,0,1,,1,-73.181317,7.1280470000000005
40161,2016,Octubre,Jamaica,1,6,,7,-75.527794,10.406342
40162,2016,Octubre,Jamaica,1,3,,4,-74.77647900000001,10.886686
40163,2016,Octubre,Jamaica,0,1,,1,-81.70216500000001,12.5862
40164,2016,Octubre,Jamaica,1,2,,3,-81.372937,13.338761300000002
40165,2016,Octubre,Jamaica,4,4,,8,-76.532004,3.451668
40166,2016,Octubre,Jamaica,12,7,,19,-74.140516,4.697157
40167,2016,Octubre,Jamaica,0,7,,7,-75.42726,6.170465
40168,2016,Octubre,Jamaica,2,1,,3,-73.181317,7.1280470000000005
40169,2016,Octubre,Japón,1,0,,1,-75.516486,10.446304
40170,2016,Octubre,Japón,1,1,,2,-76.532004,3.451668
40171,2016,Octubre,Japón,3,30,,33,-74.140516,4.697157
40172,2016,Octubre,Japón,2,7,,9,-75.42726,6.170465
40173,2016,Octubre,Jordania,1,0,,1,-74.140516,4.697157
40174,2016,Octubre,Kazajistán,1,1,,2,-74.140516,4.697157
40175,2016,Octubre,Kenia,1,3,,4,-76.532004,3.451668
40176,2016,Octubre,Kenia,2,2,,4,-74.140516,4.697157
40177,2016,Octubre,Kuwait,0,1,,1,-76.532004,3.451668
40178,2016,Octubre,República de Kosovo,0,1,,1,-74.140516,4.697157
40179,2016,Octubre,Lesoto,0,1,,1,-74.140516,4.697157
40180,2016,Octubre,Lituania,6,4,,10,-74.140516,4.697157
40181,2016,Octubre,Líbano,0,1,,1,-74.77647900000001,10.886686
40182,2016,Octubre,Líbano,5,10,,15,-74.140516,4.697157
40183,2016,Octubre,Luxemburgo,0,1,,1,-74.140516,4.697157
40184,2016,Octubre,Malasia,0,1,,1,-76.532004,3.451668
40185,2016,Octubre,Malasia,2,5,,7,-74.140516,4.697157
40186,2016,Octubre,Malta,1,0,,1,-76.532004,3.451668
40187,2016,Octubre,Malta,1,0,,1,-75.42726,6.170465
40188,2016,Octubre,Marruecos,0,1,,1,-75.527794,10.406342
40189,2016,Octubre,Marruecos,4,1,,5,-74.140516,4.697157
40190,2016,Octubre,Mauricio,0,1,,1,-74.140516,4.697157
40191,2016,Octubre,Mauritania,1,0,,1,-74.140516,4.697157
40192,2016,Octubre,México,1,1,,2,-75.527794,10.406342
40193,2016,Octubre,México,19,48,,67,-75.516486,10.446304
40194,2016,Octubre,México,9,31,,40,-74.77647900000001,10.886686
40195,2016,Octubre,México,0,4,,4,-81.703935,12.574411099999999
40196,2016,Octubre,México,2,6,,8,-81.70216500000001,12.5862
40197,2016,Octubre,México,56,172,,228,-76.532004,3.451668
40198,2016,Octubre,México,0,2,,2,-77.061029,3.8844260000000004
40199,2016,Octubre,México,1,1,,2,-75.76635300000001,4.45285
40200,2016,Octubre,México,4807,8189,,12996,-74.140516,4.697157
40201,2016,Octubre,México,5,11,,16,-75.736374,4.815189
40202,2016,Octubre,México,439,1063,,1502,-75.42726,6.170465
40203,2016,Octubre,México,10,16,,26,-73.181317,7.1280470000000005
40204,2016,Octubre,México,1,1,,2,-72.508188,7.927233
40205,2016,Octubre,Mónaco,1,0,,1,-74.140516,4.697157
40206,2016,Octubre,Nepal,0,1,,1,-74.140516,4.697157
40207,2016,Octubre,Nicaragua,2,6,,8,-75.516486,10.446304
40208,2016,Octubre,Nicaragua,0,8,,8,-81.703935,12.574411099999999
40209,2016,Octubre,Nicaragua,0,1,,1,-81.70216500000001,12.5862
40210,2016,Octubre,Nicaragua,6,5,,11,-76.532004,3.451668
40211,2016,Octubre,Nicaragua,34,44,,78,-74.140516,4.697157
40212,2016,Octubre,Nicaragua,3,10,,13,-75.736374,4.815189
40213,2016,Octubre,Nicaragua,8,15,,23,-75.42726,6.170465
40214,2016,Octubre,Nicaragua,1,0,,1,-73.181317,7.1280470000000005
40215,2016,Octubre,Nigeria,2,1,,3,-74.140516,4.697157
40216,2016,Octubre,Noruega,0,1,,1,-74.77647900000001,10.886686
40217,2016,Octubre,Noruega,2,4,,6,-76.532004,3.451668
40218,2016,Octubre,Noruega,17,17,,34,-74.140516,4.697157
40219,2016,Octubre,Noruega,1,2,,3,-75.42726,6.170465
40220,2016,Octubre,Nueva Zelanda,2,4,,6,-74.140516,4.697157
40221,2016,Octubre,Nueva Zelanda,0,1,,1,-75.736374,4.815189
40222,2016,Octubre,Nueva Zelanda,2,6,,8,-75.42726,6.170465
40223,2016,Octubre,Pakistán,0,2,,2,-74.140516,4.697157
40224,2016,Octubre,Panamá,1351,998,,2349,-75.527794,10.406342
40225,2016,Octubre,Panamá,3356,3511,,6867,-75.516486,10.446304
40226,2016,Octubre,Panamá,267,588,,855,-74.77647900000001,10.886686
40227,2016,Octubre,Panamá,0,12,,12,-74.765343,10.970933
40228,2016,Octubre,Panamá,7,5,,12,-81.703935,12.574411099999999
40229,2016,Octubre,Panamá,511,379,,890,-81.70216500000001,12.5862
40230,2016,Octubre,Panamá,2,1,,3,-81.372937,13.338761300000002
40231,2016,Octubre,Panamá,360,605,,965,-76.532004,3.451668
40232,2016,Octubre,Panamá,0,23,,23,-77.061029,3.8844260000000004
40233,2016,Octubre,Panamá,55,73,,128,-75.76635300000001,4.45285
40234,2016,Octubre,Panamá,4274,6101,,10375,-74.140516,4.697157
40235,2016,Octubre,Panamá,39,96,,135,-75.736374,4.815189
40236,2016,Octubre,Panamá,1909,2699,,4608,-75.42726,6.170465
40237,2016,Octubre,Panamá,3,1,,4,-77.401154,6.222551999999999
40238,2016,Octubre,Panamá,1,3,,4,-77.762647,7.102626
40239,2016,Octubre,Panamá,20,38,,58,-73.181317,7.1280470000000005
40240,2016,Octubre,Panamá,30,32,,62,-72.508188,7.927233
40241,2016,Octubre,Panamá,0,6,,6,-76.7333,8.06667
40242,2016,Octubre,Panamá,52,57,,109,-77.35002,8.63337
40243,2016,Octubre,Panamá,0,1,,1,-75.68164200000001,9.402597
40244,2016,Octubre,Paraguay,9,10,,19,-75.516486,10.446304
40245,2016,Octubre,Paraguay,1,9,,10,-74.77647900000001,10.886686
40246,2016,Octubre,Paraguay,53,27,,80,-81.70216500000001,12.5862
40247,2016,Octubre,Paraguay,3,4,,7,-76.532004,3.451668
40248,2016,Octubre,Paraguay,70,69,,139,-74.140516,4.697157
40249,2016,Octubre,Paraguay,1,2,,3,-75.736374,4.815189
40250,2016,Octubre,Paraguay,48,126,,174,-75.42726,6.170465
40251,2016,Octubre,Paraguay,0,3,,3,-73.181317,7.1280470000000005
40252,2016,Octubre,Perú,75,133,,208,-69.941498,4.191162
40253,2016,Octubre,Perú,6,4,,10,-74.78366,0.18595699999999998
40254,2016,Octubre,Perú,1,9,,10,-77.35600000000001,0.81488
40255,2016,Octubre,Perú,1,16,,17,-75.527794,10.406342
40256,2016,Octubre,Perú,18,42,,60,-75.516486,10.446304
40257,2016,Octubre,Perú,8,12,,20,-74.77647900000001,10.886686
40258,2016,Octubre,Perú,0,1,,1,-74.765343,10.970933
40259,2016,Octubre,Perú,165,120,,285,-81.70216500000001,12.5862
40260,2016,Octubre,Perú,338,506,,844,-76.532004,3.451668
40261,2016,Octubre,Perú,6908,9090,,15998,-74.140516,4.697157
40262,2016,Octubre,Perú,6,2,,8,-75.736374,4.815189
40263,2016,Octubre,Perú,462,760,,1222,-75.42726,6.170465
40264,2016,Octubre,Perú,2,2,,4,-73.181317,7.1280470000000005
40265,2016,Octubre,Polonia,1,1,,2,-76.532004,3.451668
40266,2016,Octubre,Polonia,23,25,,48,-74.140516,4.697157
40267,2016,Octubre,Polonia,0,3,,3,-75.42726,6.170465
40268,2016,Octubre,Portugal,0,7,,7,-75.516486,10.446304
40269,2016,Octubre,Portugal,0,2,,2,-74.77647900000001,10.886686
40270,2016,Octubre,Portugal,1,6,,7,-76.532004,3.451668
40271,2016,Octubre,Portugal,25,95,,120,-74.140516,4.697157
40272,2016,Octubre,Portugal,4,3,,7,-75.42726,6.170465
40273,2016,Octubre,Portugal,0,1,,1,-73.181317,7.1280470000000005
40274,2016,Octubre,Polinesia Francesa/Colectividad de Ultramar Francesa,1,0,,1,-81.70216500000001,12.5862
40275,2016,Octubre,Puerto Rico/Territorio de Estados Unidos,8,9,,17,-75.516486,10.446304
40276,2016,Octubre,Puerto Rico/Territorio de Estados Unidos,4,23,,27,-74.77647900000001,10.886686
40277,2016,Octubre,Puerto Rico/Territorio de Estados Unidos,0,2,,2,-81.70216500000001,12.5862
40278,2016,Octubre,Puerto Rico/Territorio de Estados Unidos,23,43,,66,-76.532004,3.451668
40279,2016,Octubre,Puerto Rico/Territorio de Estados Unidos,340,413,,753,-74.140516,4.697157
40280,2016,Octubre,Puerto Rico/Territorio de Estados Unidos,9,11,,20,-75.736374,4.815189
40281,2016,Octubre,Puerto Rico/Territorio de Estados Unidos,66,149,,215,-75.42726,6.170465
40282,2016,Octubre,Puerto Rico/Territorio de Estados Unidos,1,1,,2,-73.181317,7.1280470000000005
40283,2016,Octubre,Reino Unido de Gran Bretaña e Irlanda del Norte,0,1,,1,-75.516486,10.446304
40284,2016,Octubre,Reino Unido de Gran Bretaña e Irlanda del Norte,0,1,,1,-74.77647900000001,10.886686
40285,2016,Octubre,Reino Unido de Gran Bretaña e Irlanda del Norte,13,27,,40,-76.532004,3.451668
40286,2016,Octubre,Reino Unido de Gran Bretaña e Irlanda del Norte,788,1308,,2096,-74.140516,4.697157
40287,2016,Octubre,Reino Unido de Gran Bretaña e Irlanda del Norte,1,1,,2,-75.736374,4.815189
40288,2016,Octubre,Reino Unido de Gran Bretaña e Irlanda del Norte,7,25,,32,-75.42726,6.170465
40289,2016,Octubre,Reino Unido de Gran Bretaña e Irlanda del Norte,0,1,,1,-73.181317,7.1280470000000005
40290,2016,Octubre,Reino Unido de Gran Bretaña e Irlanda del Norte,0,2,,2,-76.7333,8.06667
40291,2016,Octubre,República CentroÁfricana,1,1,,2,-74.140516,4.697157
40292,2016,Octubre,Federación de Rusia,0,11,,11,-75.527794,10.406342
40293,2016,Octubre,Federación de Rusia,1,2,,3,-76.532004,3.451668
40294,2016,Octubre,Federación de Rusia,35,51,,86,-74.140516,4.697157
40295,2016,Octubre,Federación de Rusia,0,6,,6,-75.42726,6.170465
40296,2016,Octubre,Federación de Rusia,0,4,,4,-76.7333,8.06667
40297,2016,Octubre,República Dominicana,1,14,,15,-75.527794,10.406342
40298,2016,Octubre,República Dominicana,19,75,,94,-75.516486,10.446304
40299,2016,Octubre,República Dominicana,4,45,,49,-74.77647900000001,10.886686
40300,2016,Octubre,República Dominicana,39,51,,90,-76.532004,3.451668
40301,2016,Octubre,República Dominicana,718,951,,1669,-74.140516,4.697157
40302,2016,Octubre,República Dominicana,8,20,,28,-75.736374,4.815189
40303,2016,Octubre,República Dominicana,31,85,,116,-75.42726,6.170465
40304,2016,Octubre,República Dominicana,2,7,,9,-73.181317,7.1280470000000005
40305,2016,Octubre,Rumania,1,2,,3,-76.532004,3.451668
40306,2016,Octubre,Rumania,5,13,,18,-74.140516,4.697157
40307,2016,Octubre,Rumania,0,2,,2,-75.42726,6.170465
40308,2016,Octubre,Rwanda,0,1,,1,-74.140516,4.697157
40309,2016,Octubre,San  Vicente y las Granadinas,0,1,,1,-74.140516,4.697157
40310,2016,Octubre,Senegal,3,0,,3,-75.42726,6.170465
40311,2016,Octubre,Serbia,0,1,,1,-76.532004,3.451668
40312,2016,Octubre,Serbia,1,1,,2,-74.140516,4.697157
40313,2016,Octubre,Serbia,1,0,,1,-75.42726,6.170465
40314,2016,Octubre,Sierra Leona,0,2,,2,-74.140516,4.697157
40315,2016,Octubre,Singapur,0,3,,3,-74.140516,4.697157
40316,2016,Octubre,Singapur,0,1,,1,-75.42726,6.170465
40317,2016,Octubre,Singapur,0,1,,1,-73.181317,7.1280470000000005
40318,2016,Octubre,República Árabe Siria,1,0,,1,-74.140516,4.697157
40319,2016,Octubre,Sudáfrica,8,16,,24,-74.140516,4.697157
40320,2016,Octubre,Sudáfrica,1,1,,2,-75.42726,6.170465
40321,2016,Octubre,Suecia,0,1,,1,-75.516486,10.446304
40322,2016,Octubre,Suecia,0,1,,1,-76.532004,3.451668
40323,2016,Octubre,Suecia,25,38,,63,-74.140516,4.697157
40324,2016,Octubre,Suecia,0,1,,1,-75.736374,4.815189
40325,2016,Octubre,Suecia,1,4,,5,-75.42726,6.170465
40326,2016,Octubre,Suecia,1,0,,1,-73.181317,7.1280470000000005
40327,2016,Octubre,Suiza,3,1,,4,-75.516486,10.446304
40328,2016,Octubre,Suiza,0,1,,1,-81.70216500000001,12.5862
40329,2016,Octubre,Suiza,17,26,,43,-76.532004,3.451668
40330,2016,Octubre,Suiza,70,104,,174,-74.140516,4.697157
40331,2016,Octubre,Suiza,6,20,,26,-75.42726,6.170465
40332,2016,Octubre,Surinam,0,1,,1,-75.527794,10.406342
40333,2016,Octubre,Surinam,5,4,,9,-74.140516,4.697157
40334,2016,Octubre,Surinam,2,5,,7,-75.42726,6.170465
40335,2016,Octubre,Taiwán,1,0,,1,-76.532004,3.451668
40336,2016,Octubre,Taiwán,3,3,,6,-74.140516,4.697157
40337,2016,Octubre,Taiwán,2,2,,4,-75.42726,6.170465
40338,2016,Octubre,Tailandia,1,5,,6,-74.140516,4.697157
40339,2016,Octubre,Trinidad y Tobago,1,1,,2,-75.527794,10.406342
40340,2016,Octubre,Trinidad y Tobago,4,42,,46,-74.765343,10.970933
40341,2016,Octubre,Trinidad y Tobago,1,3,,4,-76.532004,3.451668
40342,2016,Octubre,Trinidad y Tobago,4,14,,18,-74.140516,4.697157
40343,2016,Octubre,Trinidad y Tobago,0,3,,3,-75.42726,6.170465
40344,2016,Octubre,Túnez,0,2,,2,-74.140516,4.697157
40345,2016,Octubre,Turkmenistán,2,8,,10,-74.140516,4.697157
40346,2016,Octubre,Turquía,0,5,,5,-74.765343,10.970933
40347,2016,Octubre,Turquía,367,586,,953,-74.140516,4.697157
40348,2016,Octubre,Turquía,1,2,,3,-75.42726,6.170465
40349,2016,Octubre,Turquía,0,1,,1,-76.7333,8.06667
40350,2016,Octubre,Ucrania,5,2,,7,-74.140516,4.697157
40351,2016,Octubre,Ucrania,1,0,,1,-75.42726,6.170465
40352,2016,Octubre,Uganda,1,0,,1,-76.532004,3.451668
40353,2016,Octubre,Uruguay,1,1,,2,-77.35600000000001,0.81488
40354,2016,Octubre,Uruguay,6,4,,10,-75.516486,10.446304
40355,2016,Octubre,Uruguay,8,69,,77,-74.77647900000001,10.886686
40356,2016,Octubre,Uruguay,33,19,,52,-81.70216500000001,12.5862
40357,2016,Octubre,Uruguay,7,17,,24,-76.532004,3.451668
40358,2016,Octubre,Uruguay,87,141,,228,-74.140516,4.697157
40359,2016,Octubre,Uruguay,1,0,,1,-75.736374,4.815189
40360,2016,Octubre,Uruguay,42,62,,104,-75.42726,6.170465
40361,2016,Octubre,Uruguay,1,0,,1,-73.181317,7.1280470000000005
40362,2016,Octubre,Venezuela,0,5,,5,-75.527794,10.406342
40363,2016,Octubre,Venezuela,32,78,,110,-75.516486,10.446304
40364,2016,Octubre,Venezuela,19,59,,78,-74.77647900000001,10.886686
40365,2016,Octubre,Venezuela,0,7,,7,-74.765343,10.970933
40366,2016,Octubre,Venezuela,0,1,,1,-74.213989,11.247722999999999
40367,2016,Octubre,Venezuela,4332,5126,,9458,-72.129595,11.360028999999999
40368,2016,Octubre,Venezuela,0,2,,2,-81.70216500000001,12.5862
40369,2016,Octubre,Venezuela,14,32,,46,-76.532004,3.451668
40370,2016,Octubre,Venezuela,17,17,,34,-67.927521,3.866713
40371,2016,Octubre,Venezuela,0,1,,1,-77.061029,3.8844260000000004
40372,2016,Octubre,Venezuela,3437,3950,,7387,-74.140516,4.697157
40373,2016,Octubre,Venezuela,6,8,,14,-75.736374,4.815189
40374,2016,Octubre,Venezuela,577,621,,1198,-75.42726,6.170465
40375,2016,Octubre,Venezuela,1382,1840,,3222,-67.48402800000001,6.185536
40376,2016,Octubre,Venezuela,87,112,,199,-70.74025300000001,7.088728999999999
40377,2016,Octubre,Venezuela,2,1,,3,-73.181317,7.1280470000000005
40378,2016,Octubre,Venezuela,6722,8714,,15436,-72.453013,7.819
40379,2016,Octubre,Venezuela,67,84,,151,-72.409396,8.36068
40380,2016,Octubre,Vietnam,0,1,,1,-76.532004,3.451668
40381,2016,Octubre,Vietnam,0,5,,5,-74.140516,4.697157
40382,2016,Octubre,Zambia,0,1,,1,-74.140516,4.697157
40383,2016,Octubre,Islas Turcas y Caicos/Territorio Británico de Ultramar,0,11,,11,-75.516486,10.446304
40384,2016,Octubre,Desconocido,1,0,,1,-72.129595,11.360028999999999
40385,2016,Noviembre,Afganistán,0,1,,1,-76.532004,3.451668
40386,2016,Noviembre,Afganistán,0,2,,2,-75.42726,6.170465
40387,2016,Noviembre,Albania,0,1,,1,-74.140516,4.697157
40388,2016,Noviembre,Alemania,1,0,,1,-77.35600000000001,0.81488
40389,2016,Noviembre,Alemania,0,1,,1,-75.516486,10.446304
40390,2016,Noviembre,Alemania,1,2,,3,-74.77647900000001,10.886686
40391,2016,Noviembre,Alemania,33,42,,75,-76.532004,3.451668
40392,2016,Noviembre,Alemania,1079,1911,,2990,-74.140516,4.697157
40393,2016,Noviembre,Alemania,0,2,,2,-75.736374,4.815189
40394,2016,Noviembre,Alemania,25,31,,56,-75.42726,6.170465
40395,2016,Noviembre,Alemania,0,1,,1,-73.181317,7.1280470000000005
40396,2016,Noviembre,Angola,0,1,,1,-74.140516,4.697157
40397,2016,Noviembre,Antigua y Barbuda,0,2,,2,-75.527794,10.406342
40398,2016,Noviembre,Antigua y Barbuda,3,0,,3,-76.532004,3.451668
40399,2016,Noviembre,Antigua y Barbuda,1,5,,6,-74.140516,4.697157
40400,2016,Noviembre,Países Bajos,9,19,,28,-75.527794,10.406342
40401,2016,Noviembre,Países Bajos,2,8,,10,-75.516486,10.446304
40402,2016,Noviembre,Países Bajos,40,64,,104,-74.77647900000001,10.886686
40403,2016,Noviembre,Países Bajos,7,11,,18,-74.213989,11.247722999999999
40404,2016,Noviembre,Países Bajos,79,163,,242,-76.532004,3.451668
40405,2016,Noviembre,Países Bajos,778,1148,,1926,-74.140516,4.697157
40406,2016,Noviembre,Países Bajos,0,3,,3,-75.736374,4.815189
40407,2016,Noviembre,Países Bajos,229,292,,521,-75.42726,6.170465
40408,2016,Noviembre,Países Bajos,5,2,,7,-73.181317,7.1280470000000005
40409,2016,Noviembre,Argelia,1,10,,11,-74.140516,4.697157
40410,2016,Noviembre,Argelia,0,2,,2,-75.42726,6.170465
40411,2016,Noviembre,Argentina,2,7,,9,-77.35600000000001,0.81488
40412,2016,Noviembre,Argentina,0,32,,32,-75.527794,10.406342
40413,2016,Noviembre,Argentina,26,14,,40,-75.516486,10.446304
40414,2016,Noviembre,Argentina,3,8,,11,-74.77647900000001,10.886686
40415,2016,Noviembre,Argentina,161,89,,250,-81.70216500000001,12.5862
40416,2016,Noviembre,Argentina,39,105,,144,-76.532004,3.451668
40417,2016,Noviembre,Argentina,2612,3562,,6174,-74.140516,4.697157
40418,2016,Noviembre,Argentina,0,1,,1,-75.736374,4.815189
40419,2016,Noviembre,Argentina,75,169,,244,-75.42726,6.170465
40420,2016,Noviembre,Argentina,2,2,,4,-73.181317,7.1280470000000005
40421,2016,Noviembre,República de Armenia,0,1,,1,-74.140516,4.697157
40422,2016,Noviembre,Aruba,4,13,,17,-75.527794,10.406342
40423,2016,Noviembre,Aruba,2,4,,6,-75.516486,10.446304
40424,2016,Noviembre,Aruba,2,2,,4,-74.77647900000001,10.886686
40425,2016,Noviembre,Aruba,0,1,,1,-74.232675,11.117206
40426,2016,Noviembre,Aruba,17,23,,40,-74.213989,11.247722999999999
40427,2016,Noviembre,Aruba,5,12,,17,-76.532004,3.451668
40428,2016,Noviembre,Aruba,626,736,,1362,-74.140516,4.697157
40429,2016,Noviembre,Aruba,1,2,,3,-75.736374,4.815189
40430,2016,Noviembre,Aruba,38,50,,88,-75.42726,6.170465
40431,2016,Noviembre,Aruba,13,9,,22,-73.181317,7.1280470000000005
40432,2016,Noviembre,Australia,2,1,,3,-74.77647900000001,10.886686
40433,2016,Noviembre,Australia,5,5,,10,-76.532004,3.451668
40434,2016,Noviembre,Australia,39,78,,117,-74.140516,4.697157
40435,2016,Noviembre,Australia,10,17,,27,-75.42726,6.170465
40436,2016,Noviembre,Australia,1,2,,3,-73.181317,7.1280470000000005
40437,2016,Noviembre,Austria,1,0,,1,-76.532004,3.451668
40438,2016,Noviembre,Austria,10,42,,52,-74.140516,4.697157
40439,2016,Noviembre,Austria,3,2,,5,-75.42726,6.170465
40440,2016,Noviembre,Azerbaiyán,1,1,,2,-74.140516,4.697157
40441,2016,Noviembre,Bahamas,2,3,,5,-75.527794,10.406342
40442,2016,Noviembre,Bahamas,1,1,,2,-76.532004,3.451668
40443,2016,Noviembre,Bahamas,0,1,,1,-74.140516,4.697157
40444,2016,Noviembre,Bahamas,0,2,,2,-75.736374,4.815189
40445,2016,Noviembre,Bahréin,0,1,,1,-74.140516,4.697157
40446,2016,Noviembre,Barbados,1,0,,1,-74.77647900000001,10.886686
40447,2016,Noviembre,Barbados,43,53,,96,-74.140516,4.697157
40448,2016,Noviembre,República de Belarús,0,2,,2,-74.140516,4.697157
40449,2016,Noviembre,República de Belarús,2,0,,2,-72.453013,7.819
40450,2016,Noviembre,Bélgica,0,2,,2,-76.532004,3.451668
40451,2016,Noviembre,Bélgica,53,63,,116,-74.140516,4.697157
40452,2016,Noviembre,Bélgica,3,11,,14,-75.42726,6.170465
40453,2016,Noviembre,Belice,2,6,,8,-74.140516,4.697157
40454,2016,Noviembre,Belice,1,0,,1,-75.42726,6.170465
40455,2016,Noviembre,Benín,0,2,,2,-74.140516,4.697157
40456,2016,Noviembre,Benín,1,0,,1,-75.42726,6.170465
40457,2016,Noviembre,Bolivia,2,2,,4,-75.516486,10.446304
40458,2016,Noviembre,Bolivia,0,1,,1,-74.77647900000001,10.886686
40459,2016,Noviembre,Bolivia,17,13,,30,-81.70216500000001,12.5862
40460,2016,Noviembre,Bolivia,17,28,,45,-76.532004,3.451668
40461,2016,Noviembre,Bolivia,456,578,,1034,-74.140516,4.697157
40462,2016,Noviembre,Bolivia,4,3,,7,-75.736374,4.815189
40463,2016,Noviembre,Bolivia,40,62,,102,-75.42726,6.170465
40464,2016,Noviembre,Bolivia,0,2,,2,-73.181317,7.1280470000000005
40465,2016,Noviembre,Brasil,197,217,,414,-69.941498,4.191162
40466,2016,Noviembre,Brasil,0,6,,6,-75.527794,10.406342
40467,2016,Noviembre,Brasil,47,30,,77,-75.516486,10.446304
40468,2016,Noviembre,Brasil,2,5,,7,-74.77647900000001,10.886686
40469,2016,Noviembre,Brasil,429,309,,738,-81.70216500000001,12.5862
40470,2016,Noviembre,Brasil,41,90,,131,-76.532004,3.451668
40471,2016,Noviembre,Brasil,0,5,,5,-67.927521,3.866713
40472,2016,Noviembre,Brasil,4530,6424,,10954,-74.140516,4.697157
40473,2016,Noviembre,Brasil,1,0,,1,-75.736374,4.815189
40474,2016,Noviembre,Brasil,98,296,,394,-75.42726,6.170465
40475,2016,Noviembre,Bulgaria,1,2,,3,-74.140516,4.697157
40476,2016,Noviembre,Bután,0,1,,1,-74.140516,4.697157
40477,2016,Noviembre,Cabo Verde,0,2,,2,-74.140516,4.697157
40478,2016,Noviembre,Islas Caimán/Territorio Británico de Ultramar,0,1,,1,-75.516486,10.446304
40479,2016,Noviembre,Islas Caimán/Territorio Británico de Ultramar,0,3,,3,-74.77647900000001,10.886686
40480,2016,Noviembre,Islas Caimán/Territorio Británico de Ultramar,0,2,,2,-81.70216500000001,12.5862
40481,2016,Noviembre,Islas Caimán/Territorio Británico de Ultramar,1,2,,3,-74.140516,4.697157
40482,2016,Noviembre,Camerún,0,1,,1,-74.140516,4.697157
40483,2016,Noviembre,Canadá,0,1,,1,-75.527794,10.406342
40484,2016,Noviembre,Canadá,5,25,,30,-75.516486,10.446304
40485,2016,Noviembre,Canadá,1,16,,17,-74.77647900000001,10.886686
40486,2016,Noviembre,Canadá,2,1,,3,-81.70216500000001,12.5862
40487,2016,Noviembre,Canadá,21,44,,65,-76.532004,3.451668
40488,2016,Noviembre,Canadá,660,1119,,1779,-74.140516,4.697157
40489,2016,Noviembre,Canadá,5,7,,12,-75.736374,4.815189
40490,2016,Noviembre,Canadá,89,185,,274,-75.42726,6.170465
40491,2016,Noviembre,Canadá,1,1,,2,-73.181317,7.1280470000000005
40492,2016,Noviembre,España,0,1,,1,-75.527794,10.406342
40493,2016,Noviembre,España,1,3,,4,-74.77647900000001,10.886686
40494,2016,Noviembre,España,0,2,,2,-74.213989,11.247722999999999
40495,2016,Noviembre,España,570,804,,1374,-76.532004,3.451668
40496,2016,Noviembre,España,3961,7015,,10976,-74.140516,4.697157
40497,2016,Noviembre,España,6,7,,13,-75.736374,4.815189
40498,2016,Noviembre,España,252,623,,875,-75.42726,6.170465
40499,2016,Noviembre,República Del Congo,0,3,,3,-74.140516,4.697157
40500,2016,Noviembre,Comoras,0,1,,1,-74.140516,4.697157
40501,2016,Noviembre,República de Corea,0,1,,1,-75.516486,10.446304
40502,2016,Noviembre,República de Corea,0,2,,2,-74.77647900000001,10.886686
40503,2016,Noviembre,República de Corea,0,1,,1,-77.061029,3.8844260000000004
40504,2016,Noviembre,República de Corea,9,17,,26,-74.140516,4.697157
40505,2016,Noviembre,República de Corea,0,5,,5,-75.42726,6.170465
40506,2016,Noviembre,Costa de Marfil,0,1,,1,-76.532004,3.451668
40507,2016,Noviembre,Costa de Marfil,5,5,,10,-74.140516,4.697157
40508,2016,Noviembre,Costa Rica,1,7,,8,-75.527794,10.406342
40509,2016,Noviembre,Costa Rica,8,2,,10,-75.516486,10.446304
40510,2016,Noviembre,Costa Rica,9,6,,15,-74.77647900000001,10.886686
40511,2016,Noviembre,Costa Rica,0,1,,1,-74.232675,11.117206
40512,2016,Noviembre,Costa Rica,0,1,,1,-81.703935,12.574411099999999
40513,2016,Noviembre,Costa Rica,197,161,,358,-81.70216500000001,12.5862
40514,2016,Noviembre,Costa Rica,18,25,,43,-76.532004,3.451668
40515,2016,Noviembre,Costa Rica,1040,1541,,2581,-74.140516,4.697157
40516,2016,Noviembre,Costa Rica,4,5,,9,-75.736374,4.815189
40517,2016,Noviembre,Costa Rica,57,129,,186,-75.42726,6.170465
40518,2016,Noviembre,Costa Rica,5,2,,7,-73.181317,7.1280470000000005
40519,2016,Noviembre,Croacia,1,3,,4,-74.140516,4.697157
40520,2016,Noviembre,Cuba,0,1,,1,-75.527794,10.406342
40521,2016,Noviembre,Cuba,2,3,,5,-75.516486,10.446304
40522,2016,Noviembre,Cuba,2,6,,8,-74.77647900000001,10.886686
40523,2016,Noviembre,Cuba,0,1,,1,-74.213989,11.247722999999999
40524,2016,Noviembre,Cuba,0,5,,5,-81.703935,12.574411099999999
40525,2016,Noviembre,Cuba,1,2,,3,-81.372937,13.338761300000002
40526,2016,Noviembre,Cuba,12,10,,22,-76.532004,3.451668
40527,2016,Noviembre,Cuba,313,560,,873,-74.140516,4.697157
40528,2016,Noviembre,Cuba,4,1,,5,-75.736374,4.815189
40529,2016,Noviembre,Cuba,21,27,,48,-75.42726,6.170465
40530,2016,Noviembre,Cuba,4,2,,6,-73.181317,7.1280470000000005
40531,2016,Noviembre,Curazao,1,4,,5,-74.140516,4.697157
40532,2016,Noviembre,Curazao,0,1,,1,-75.42726,6.170465
40533,2016,Noviembre,Curazao,0,1,,1,-81.70216500000001,12.5862
40534,2016,Noviembre,Curazao,0,1,,1,-76.532004,3.451668
40535,2016,Noviembre,Curazao,6,5,,11,-74.140516,4.697157
40536,2016,Noviembre,Curazao,0,3,,3,-75.42726,6.170465
40537,2016,Noviembre,Chile,4,15,,19,-75.516486,10.446304
40538,2016,Noviembre,Chile,33,266,,299,-74.77647900000001,10.886686
40539,2016,Noviembre,Chile,39,25,,64,-81.70216500000001,12.5862
40540,2016,Noviembre,Chile,30,54,,84,-76.532004,3.451668
40541,2016,Noviembre,Chile,4930,6822,,11752,-74.140516,4.697157
40542,2016,Noviembre,Chile,3,1,,4,-75.736374,4.815189
40543,2016,Noviembre,Chile,20,51,,71,-75.42726,6.170465
40544,2016,Noviembre,China,2,0,,2,-74.77647900000001,10.886686
40545,2016,Noviembre,China,0,1,,1,-76.532004,3.451668
40546,2016,Noviembre,China,47,114,,161,-74.140516,4.697157
40547,2016,Noviembre,China,0,2,,2,-75.42726,6.170465
40548,2016,Noviembre,Dinamarca,2,5,,7,-76.532004,3.451668
40549,2016,Noviembre,Dinamarca,8,25,,33,-74.140516,4.697157
40550,2016,Noviembre,Dinamarca,1,4,,5,-75.42726,6.170465
40551,2016,Noviembre,Dominica,0,4,,4,-75.516486,10.446304
40552,2016,Noviembre,Dominica,0,1,,1,-74.140516,4.697157
40553,2016,Noviembre,Ecuador,1,0,,1,-74.78366,0.18595699999999998
40554,2016,Noviembre,Ecuador,155,366,,521,-76.876446,0.33002
40555,2016,Noviembre,Ecuador,1,3,,4,-77.84700600000001,0.8124359999999999
40556,2016,Noviembre,Ecuador,4018,5523,,9541,-77.35600000000001,0.81488
40557,2016,Noviembre,Ecuador,36,64,,100,-78.802679,18.00143
40558,2016,Noviembre,Ecuador,72,55,,127,-75.516486,10.446304
40559,2016,Noviembre,Ecuador,0,1,,1,-74.77647900000001,10.886686
40560,2016,Noviembre,Ecuador,1,1,,2,-81.70216500000001,12.5862
40561,2016,Noviembre,Ecuador,442,552,,994,-76.532004,3.451668
40562,2016,Noviembre,Ecuador,0,1,,1,-77.061029,3.8844260000000004
40563,2016,Noviembre,Ecuador,3192,4730,,7922,-74.140516,4.697157
40564,2016,Noviembre,Ecuador,2,4,,6,-75.736374,4.815189
40565,2016,Noviembre,Ecuador,31,66,,97,-75.42726,6.170465
40566,2016,Noviembre,Egipto,0,2,,2,-74.140516,4.697157
40567,2016,Noviembre,El Salvador,2,2,,4,-75.516486,10.446304
40568,2016,Noviembre,El Salvador,4,0,,4,-74.77647900000001,10.886686
40569,2016,Noviembre,El Salvador,30,21,,51,-81.70216500000001,12.5862
40570,2016,Noviembre,El Salvador,109,181,,290,-76.532004,3.451668
40571,2016,Noviembre,El Salvador,1186,1584,,2770,-74.140516,4.697157
40572,2016,Noviembre,El Salvador,1,2,,3,-75.736374,4.815189
40573,2016,Noviembre,El Salvador,207,330,,537,-75.42726,6.170465
40574,2016,Noviembre,El Salvador,0,8,,8,-73.181317,7.1280470000000005
40575,2016,Noviembre,Emiratos Árabes,4,8,,12,-74.140516,4.697157
40576,2016,Noviembre,Emiratos Árabes,1,3,,4,-75.42726,6.170465
40577,2016,Noviembre,Eslovaquia,0,2,,2,-76.532004,3.451668
40578,2016,Noviembre,Eslovaquia,1,4,,5,-74.140516,4.697157
40579,2016,Noviembre,Eslovenia,0,1,,1,-76.532004,3.451668
40580,2016,Noviembre,Eslovenia,3,3,,6,-74.140516,4.697157
40581,2016,Noviembre,Estados Unidos de América,9,49,,58,-75.527794,10.406342
40582,2016,Noviembre,Estados Unidos de América,2359,3823,,6182,-75.516486,10.446304
40583,2016,Noviembre,Estados Unidos de América,541,1040,,1581,-74.77647900000001,10.886686
40584,2016,Noviembre,Estados Unidos de América,0,3,,3,-74.765343,10.970933
40585,2016,Noviembre,Estados Unidos de América,0,19,,19,-74.213989,11.247722999999999
40586,2016,Noviembre,Estados Unidos de América,0,4,,4,-81.703935,12.574411099999999
40587,2016,Noviembre,Estados Unidos de América,20,20,,40,-81.70216500000001,12.5862
40588,2016,Noviembre,Estados Unidos de América,795,1276,,2071,-76.532004,3.451668
40589,2016,Noviembre,Estados Unidos de América,0,5,,5,-77.061029,3.8844260000000004
40590,2016,Noviembre,Estados Unidos de América,99,138,,237,-75.76635300000001,4.45285
40591,2016,Noviembre,Estados Unidos de América,8326,14704,,23030,-74.140516,4.697157
40592,2016,Noviembre,Estados Unidos de América,70,139,,209,-75.736374,4.815189
40593,2016,Noviembre,Estados Unidos de América,1666,4273,,5939,-75.42726,6.170465
40594,2016,Noviembre,Estados Unidos de América,23,39,,62,-73.181317,7.1280470000000005
40595,2016,Noviembre,Estados Unidos de América,0,6,,6,-72.508188,7.927233
40596,2016,Noviembre,Estados Unidos de América,0,1,,1,-76.7333,8.06667
40597,2016,Noviembre,Estados Unidos de América,0,20,,20,-75.68164200000001,9.402597
40598,2016,Noviembre,Estonia,3,0,,3,-74.140516,4.697157
40599,2016,Noviembre,Filipinas,0,2,,2,-75.516486,10.446304
40600,2016,Noviembre,Filipinas,0,3,,3,-74.77647900000001,10.886686
40601,2016,Noviembre,Filipinas,0,5,,5,-76.532004,3.451668
40602,2016,Noviembre,Filipinas,4,8,,12,-74.140516,4.697157
40603,2016,Noviembre,Finlandia,5,10,,15,-74.140516,4.697157
40604,2016,Noviembre,Francia,4,3,,7,-75.516486,10.446304
40605,2016,Noviembre,Francia,1,4,,5,-74.77647900000001,10.886686
40606,2016,Noviembre,Francia,0,1,,1,-74.213989,11.247722999999999
40607,2016,Noviembre,Francia,19,34,,53,-76.532004,3.451668
40608,2016,Noviembre,Francia,1195,2147,,3342,-74.140516,4.697157
40609,2016,Noviembre,Francia,10,36,,46,-75.42726,6.170465
40610,2016,Noviembre,Georgia,1,0,,1,-74.140516,4.697157
40611,2016,Noviembre,Ghana,1,0,,1,-76.532004,3.451668
40612,2016,Noviembre,Ghana,1,1,,2,-74.140516,4.697157
40613,2016,Noviembre,Gibraltar/Territorio Británico de Ultramar,1,2,,3,-77.35600000000001,0.81488
40614,2016,Noviembre,Gibraltar/Territorio Británico de Ultramar,0,1,,1,-76.532004,3.451668
40615,2016,Noviembre,Grecia,1,0,,1,-75.516486,10.446304
40616,2016,Noviembre,Grecia,4,11,,15,-74.140516,4.697157
40617,2016,Noviembre,Grecia,0,3,,3,-75.42726,6.170465
40618,2016,Noviembre,Groenlandia,1,0,,1,-74.140516,4.697157
40619,2016,Noviembre,Guatemala,0,1,,1,-75.527794,10.406342
40620,2016,Noviembre,Guatemala,7,10,,17,-75.516486,10.446304
40621,2016,Noviembre,Guatemala,5,5,,10,-74.77647900000001,10.886686
40622,2016,Noviembre,Guatemala,11,7,,18,-81.70216500000001,12.5862
40623,2016,Noviembre,Guatemala,3,3,,6,-81.372937,13.338761300000002
40624,2016,Noviembre,Guatemala,33,44,,77,-76.532004,3.451668
40625,2016,Noviembre,Guatemala,530,788,,1318,-74.140516,4.697157
40626,2016,Noviembre,Guatemala,3,11,,14,-75.736374,4.815189
40627,2016,Noviembre,Guatemala,34,72,,106,-75.42726,6.170465
40628,2016,Noviembre,Guatemala,3,1,,4,-73.181317,7.1280470000000005
40629,2016,Noviembre,Guyana,0,1,,1,-75.527794,10.406342
40630,2016,Noviembre,Guyana,1,2,,3,-74.140516,4.697157
40631,2016,Noviembre,Guyana,0,2,,2,-75.42726,6.170465
40632,2016,Noviembre,Guadalupe/Territorio Francés,0,1,,1,-76.532004,3.451668
40633,2016,Noviembre,Guadalupe/Territorio Francés,1,2,,3,-74.140516,4.697157
40634,2016,Noviembre,Guadalupe/Territorio Francés,0,1,,1,-75.42726,6.170465
40635,2016,Noviembre,Haití,6,2,,8,-74.140516,4.697157
40636,2016,Noviembre,Honduras,0,1,,1,-75.516486,10.446304
40637,2016,Noviembre,Honduras,3,1,,4,-74.77647900000001,10.886686
40638,2016,Noviembre,Honduras,11,18,,29,-76.532004,3.451668
40639,2016,Noviembre,Honduras,90,110,,200,-74.140516,4.697157
40640,2016,Noviembre,Honduras,6,2,,8,-75.736374,4.815189
40641,2016,Noviembre,Honduras,36,54,,90,-75.42726,6.170465
40642,2016,Noviembre,Honduras,0,1,,1,-73.181317,7.1280470000000005
40643,2016,Noviembre,Hong Kong,0,1,,1,-74.140516,4.697157
40644,2016,Noviembre,Hungría,2,10,,12,-74.140516,4.697157
40645,2016,Noviembre,Hungría,0,2,,2,-75.42726,6.170465
40646,2016,Noviembre,India,0,2,,2,-75.516486,10.446304
40647,2016,Noviembre,India,0,3,,3,-74.77647900000001,10.886686
40648,2016,Noviembre,India,0,2,,2,-76.532004,3.451668
40649,2016,Noviembre,India,6,38,,44,-74.140516,4.697157
40650,2016,Noviembre,India,0,1,,1,-75.736374,4.815189
40651,2016,Noviembre,India,0,6,,6,-75.42726,6.170465
40652,2016,Noviembre,Indonesia,0,1,,1,-74.77647900000001,10.886686
40653,2016,Noviembre,Indonesia,2,0,,2,-76.532004,3.451668
40654,2016,Noviembre,Indonesia,2,3,,5,-74.140516,4.697157
40655,2016,Noviembre,Iraq,0,1,,1,-74.140516,4.697157
40656,2016,Noviembre,Irán,0,2,,2,-74.140516,4.697157
40657,2016,Noviembre,República de Irlanda,0,1,,1,-76.532004,3.451668
40658,2016,Noviembre,República de Irlanda,5,15,,20,-74.140516,4.697157
40659,2016,Noviembre,República de Irlanda,0,3,,3,-75.42726,6.170465
40660,2016,Noviembre,República de Irlanda,0,1,,1,-73.181317,7.1280470000000005
40661,2016,Noviembre,Islandia,1,1,,2,-74.140516,4.697157
40662,2016,Noviembre,Israel,0,1,,1,-74.77647900000001,10.886686
40663,2016,Noviembre,Israel,1,4,,5,-76.532004,3.451668
40664,2016,Noviembre,Israel,27,61,,88,-74.140516,4.697157
40665,2016,Noviembre,Israel,0,7,,7,-75.42726,6.170465
40666,2016,Noviembre,Italia,3,2,,5,-74.77647900000001,10.886686
40667,2016,Noviembre,Italia,19,51,,70,-76.532004,3.451668
40668,2016,Noviembre,Italia,127,317,,444,-74.140516,4.697157
40669,2016,Noviembre,Italia,1,0,,1,-75.736374,4.815189
40670,2016,Noviembre,Italia,23,47,,70,-75.42726,6.170465
40671,2016,Noviembre,Jamaica,2,10,,12,-75.527794,10.406342
40672,2016,Noviembre,Jamaica,0,2,,2,-75.516486,10.446304
40673,2016,Noviembre,Jamaica,0,5,,5,-74.77647900000001,10.886686
40674,2016,Noviembre,Jamaica,0,1,,1,-76.532004,3.451668
40675,2016,Noviembre,Jamaica,5,13,,18,-74.140516,4.697157
40676,2016,Noviembre,Jamaica,0,3,,3,-75.42726,6.170465
40677,2016,Noviembre,Japón,1,0,,1,-74.77647900000001,10.886686
40678,2016,Noviembre,Japón,2,0,,2,-76.532004,3.451668
40679,2016,Noviembre,Japón,9,20,,29,-74.140516,4.697157
40680,2016,Noviembre,Japón,7,3,,10,-75.42726,6.170465
40681,2016,Noviembre,Jordania,0,2,,2,-74.140516,4.697157
40682,2016,Noviembre,Kenia,1,1,,2,-76.532004,3.451668
40683,2016,Noviembre,Kenia,5,2,,7,-74.140516,4.697157
40684,2016,Noviembre,Kuwait,0,1,,1,-75.42726,6.170465
40685,2016,Noviembre,Lesoto,0,1,,1,-75.42726,6.170465
40686,2016,Noviembre,Letonia,5,3,,8,-74.140516,4.697157
40687,2016,Noviembre,Lituania,5,2,,7,-74.140516,4.697157
40688,2016,Noviembre,Líbano,5,6,,11,-74.140516,4.697157
40689,2016,Noviembre,Liechtenstein,0,1,,1,-75.42726,6.170465
40690,2016,Noviembre,Luxemburgo,1,3,,4,-74.140516,4.697157
40691,2016,Noviembre,Malasia,0,4,,4,-74.140516,4.697157
40692,2016,Noviembre,Malasia,2,2,,4,-75.42726,6.170465
40693,2016,Noviembre,Malí,0,2,,2,-74.140516,4.697157
40694,2016,Noviembre,Malta,1,2,,3,-74.140516,4.697157
40695,2016,Noviembre,Marruecos,1,0,,1,-74.140516,4.697157
40696,2016,Noviembre,Marruecos,0,1,,1,-75.42726,6.170465
40697,2016,Noviembre,Martinica/Departamento de Ultramar Francés,1,1,,2,-75.527794,10.406342
40698,2016,Noviembre,México,0,2,,2,-75.527794,10.406342
40699,2016,Noviembre,México,10,36,,46,-75.516486,10.446304
40700,2016,Noviembre,México,13,33,,46,-74.77647900000001,10.886686
40701,2016,Noviembre,México,2,7,,9,-81.70216500000001,12.5862
40702,2016,Noviembre,México,75,189,,264,-76.532004,3.451668
40703,2016,Noviembre,México,4855,8681,,13536,-74.140516,4.697157
40704,2016,Noviembre,México,7,17,,24,-75.736374,4.815189
40705,2016,Noviembre,México,423,1109,,1532,-75.42726,6.170465
40706,2016,Noviembre,México,4,12,,16,-73.181317,7.1280470000000005
40707,2016,Noviembre,Mónaco,1,2,,3,-74.140516,4.697157
40708,2016,Noviembre,Mozambique,0,1,,1,-74.140516,4.697157
40709,2016,Noviembre,Myanmar,0,1,,1,-74.77647900000001,10.886686
40710,2016,Noviembre,Myanmar,1,0,,1,-74.140516,4.697157
40711,2016,Noviembre,Nauru,0,1,,1,-74.140516,4.697157
40712,2016,Noviembre,Nepal,0,1,,1,-74.140516,4.697157
40713,2016,Noviembre,Nicaragua,0,1,,1,-75.527794,10.406342
40714,2016,Noviembre,Nicaragua,1,1,,2,-75.516486,10.446304
40715,2016,Noviembre,Nicaragua,0,1,,1,-74.77647900000001,10.886686
40716,2016,Noviembre,Nicaragua,7,16,,23,-76.532004,3.451668
40717,2016,Noviembre,Nicaragua,0,2,,2,-77.061029,3.8844260000000004
40718,2016,Noviembre,Nicaragua,44,33,,77,-74.140516,4.697157
40719,2016,Noviembre,Nicaragua,3,2,,5,-75.736374,4.815189
40720,2016,Noviembre,Nicaragua,10,6,,16,-75.42726,6.170465
40721,2016,Noviembre,Nicaragua,1,1,,2,-73.181317,7.1280470000000005
40722,2016,Noviembre,Nigeria,0,1,,1,-74.140516,4.697157
40723,2016,Noviembre,Nigeria,0,1,,1,-75.42726,6.170465
40724,2016,Noviembre,Noruega,0,1,,1,-74.77647900000001,10.886686
40725,2016,Noviembre,Noruega,3,5,,8,-76.532004,3.451668
40726,2016,Noviembre,Noruega,23,35,,58,-74.140516,4.697157
40727,2016,Noviembre,Noruega,2,2,,4,-75.42726,6.170465
40728,2016,Noviembre,Nueva Zelanda,0,1,,1,-76.532004,3.451668
40729,2016,Noviembre,Nueva Zelanda,4,2,,6,-74.140516,4.697157
40730,2016,Noviembre,Nueva Zelanda,2,7,,9,-75.42726,6.170465
40731,2016,Noviembre,Panamá,723,663,,1386,-75.527794,10.406342
40732,2016,Noviembre,Panamá,3147,3557,,6704,-75.516486,10.446304
40733,2016,Noviembre,Panamá,241,575,,816,-74.77647900000001,10.886686
40734,2016,Noviembre,Panamá,0,80,,80,-74.765343,10.970933
40735,2016,Noviembre,Panamá,2,2,,4,-74.213989,11.247722999999999
40736,2016,Noviembre,Panamá,5,7,,12,-81.703935,12.574411099999999
40737,2016,Noviembre,Panamá,532,399,,931,-81.70216500000001,12.5862
40738,2016,Noviembre,Panamá,2,2,,4,-81.372937,13.338761300000002
40739,2016,Noviembre,Panamá,403,644,,1047,-76.532004,3.451668
40740,2016,Noviembre,Panamá,0,17,,17,-77.061029,3.8844260000000004
40741,2016,Noviembre,Panamá,63,67,,130,-75.76635300000001,4.45285
40742,2016,Noviembre,Panamá,5151,6778,,11929,-74.140516,4.697157
40743,2016,Noviembre,Panamá,68,126,,194,-75.736374,4.815189
40744,2016,Noviembre,Panamá,3029,3613,,6642,-75.42726,6.170465
40745,2016,Noviembre,Panamá,0,4,,4,-77.762647,7.102626
40746,2016,Noviembre,Panamá,8,10,,18,-73.181317,7.1280470000000005
40747,2016,Noviembre,Panamá,0,3,,3,-72.508188,7.927233
40748,2016,Noviembre,Panamá,98,114,,212,-77.35002,8.63337
40749,2016,Noviembre,Paraguay,4,2,,6,-75.516486,10.446304
40750,2016,Noviembre,Paraguay,2,5,,7,-74.77647900000001,10.886686
40751,2016,Noviembre,Paraguay,22,17,,39,-81.70216500000001,12.5862
40752,2016,Noviembre,Paraguay,3,3,,6,-76.532004,3.451668
40753,2016,Noviembre,Paraguay,66,75,,141,-74.140516,4.697157
40754,2016,Noviembre,Paraguay,2,1,,3,-75.736374,4.815189
40755,2016,Noviembre,Paraguay,39,98,,137,-75.42726,6.170465
40756,2016,Noviembre,Perú,135,162,,297,-69.941498,4.191162
40757,2016,Noviembre,Perú,0,10,,10,-77.35600000000001,0.81488
40758,2016,Noviembre,Perú,0,5,,5,-75.527794,10.406342
40759,2016,Noviembre,Perú,10,6,,16,-75.516486,10.446304
40760,2016,Noviembre,Perú,2,4,,6,-74.77647900000001,10.886686
40761,2016,Noviembre,Perú,134,86,,220,-81.70216500000001,12.5862
40762,2016,Noviembre,Perú,284,462,,746,-76.532004,3.451668
40763,2016,Noviembre,Perú,0,2,,2,-77.061029,3.8844260000000004
40764,2016,Noviembre,Perú,6279,8399,,14678,-74.140516,4.697157
40765,2016,Noviembre,Perú,0,3,,3,-75.736374,4.815189
40766,2016,Noviembre,Perú,453,757,,1210,-75.42726,6.170465
40767,2016,Noviembre,Polonia,27,32,,59,-74.140516,4.697157
40768,2016,Noviembre,Polonia,0,3,,3,-75.42726,6.170465
40769,2016,Noviembre,Portugal,1,0,,1,-74.77647900000001,10.886686
40770,2016,Noviembre,Portugal,1,0,,1,-81.70216500000001,12.5862
40771,2016,Noviembre,Portugal,0,4,,4,-76.532004,3.451668
40772,2016,Noviembre,Portugal,32,68,,100,-74.140516,4.697157
40773,2016,Noviembre,Portugal,2,8,,10,-75.42726,6.170465
40774,2016,Noviembre,Puerto Rico/Territorio de Estados Unidos,0,5,,5,-75.516486,10.446304
40775,2016,Noviembre,Puerto Rico/Territorio de Estados Unidos,6,46,,52,-74.77647900000001,10.886686
40776,2016,Noviembre,Puerto Rico/Territorio de Estados Unidos,0,3,,3,-81.70216500000001,12.5862
40777,2016,Noviembre,Puerto Rico/Territorio de Estados Unidos,24,28,,52,-76.532004,3.451668
40778,2016,Noviembre,Puerto Rico/Territorio de Estados Unidos,465,573,,1038,-74.140516,4.697157
40779,2016,Noviembre,Puerto Rico/Territorio de Estados Unidos,1,7,,8,-75.736374,4.815189
40780,2016,Noviembre,Puerto Rico/Territorio de Estados Unidos,43,92,,135,-75.42726,6.170465
40781,2016,Noviembre,Puerto Rico/Territorio de Estados Unidos,4,6,,10,-73.181317,7.1280470000000005
40782,2016,Noviembre,Reino Unido de Gran Bretaña e Irlanda del Norte,0,1,,1,-75.516486,10.446304
40783,2016,Noviembre,Reino Unido de Gran Bretaña e Irlanda del Norte,1,3,,4,-74.77647900000001,10.886686
40784,2016,Noviembre,Reino Unido de Gran Bretaña e Irlanda del Norte,4,9,,13,-76.532004,3.451668
40785,2016,Noviembre,Reino Unido de Gran Bretaña e Irlanda del Norte,698,1416,,2114,-74.140516,4.697157
40786,2016,Noviembre,Reino Unido de Gran Bretaña e Irlanda del Norte,0,1,,1,-75.736374,4.815189
40787,2016,Noviembre,Reino Unido de Gran Bretaña e Irlanda del Norte,24,36,,60,-75.42726,6.170465
40788,2016,Noviembre,Federación de Rusia,3,0,,3,-76.532004,3.451668
40789,2016,Noviembre,Federación de Rusia,25,38,,63,-74.140516,4.697157
40790,2016,Noviembre,Federación de Rusia,1,1,,2,-75.42726,6.170465
40791,2016,Noviembre,República Dominicana,1,11,,12,-75.527794,10.406342
40792,2016,Noviembre,República Dominicana,6,12,,18,-75.516486,10.446304
40793,2016,Noviembre,República Dominicana,11,23,,34,-74.77647900000001,10.886686
40794,2016,Noviembre,República Dominicana,1,1,,2,-81.70216500000001,12.5862
40795,2016,Noviembre,República Dominicana,12,32,,44,-76.532004,3.451668
40796,2016,Noviembre,República Dominicana,881,1127,,2008,-74.140516,4.697157
40797,2016,Noviembre,República Dominicana,4,5,,9,-75.736374,4.815189
40798,2016,Noviembre,República Dominicana,41,79,,120,-75.42726,6.170465
40799,2016,Noviembre,República Dominicana,5,9,,14,-73.181317,7.1280470000000005
40800,2016,Noviembre,Rumania,4,8,,12,-74.140516,4.697157
40801,2016,Noviembre,Rumania,2,0,,2,-75.42726,6.170465
40802,2016,Noviembre,Rwanda,1,0,,1,-74.140516,4.697157
40803,2016,Noviembre,San Cristóbal y Nevis,1,0,,1,-76.532004,3.451668
40804,2016,Noviembre,Santa Lucia,0,1,,1,-76.532004,3.451668
40805,2016,Noviembre,Santa Lucia,0,1,,1,-74.140516,4.697157
40806,2016,Noviembre,Senegal,0,1,,1,-74.140516,4.697157
40807,2016,Noviembre,Singapur,0,1,,1,-76.532004,3.451668
40808,2016,Noviembre,Singapur,4,4,,8,-74.140516,4.697157
40809,2016,Noviembre,Sri Lanka,0,1,,1,-74.140516,4.697157
40810,2016,Noviembre,Sudáfrica,2,7,,9,-74.140516,4.697157
40811,2016,Noviembre,Suecia,6,8,,14,-76.532004,3.451668
40812,2016,Noviembre,Suecia,20,27,,47,-74.140516,4.697157
40813,2016,Noviembre,Suecia,8,6,,14,-75.42726,6.170465
40814,2016,Noviembre,Suiza,0,1,,1,-75.516486,10.446304
40815,2016,Noviembre,Suiza,0,1,,1,-74.77647900000001,10.886686
40816,2016,Noviembre,Suiza,5,10,,15,-76.532004,3.451668
40817,2016,Noviembre,Suiza,71,99,,170,-74.140516,4.697157
40818,2016,Noviembre,Suiza,12,25,,37,-75.42726,6.170465
40819,2016,Noviembre,Suiza,1,0,,1,-73.181317,7.1280470000000005
40820,2016,Noviembre,Surinam,0,2,,2,-75.42726,6.170465
40821,2016,Noviembre,Taiwán,0,2,,2,-74.140516,4.697157
40822,2016,Noviembre,Taiwán,0,2,,2,-75.42726,6.170465
40823,2016,Noviembre,Tailandia,7,5,,12,-74.140516,4.697157
40824,2016,Noviembre,Trinidad y Tobago,0,127,,127,-75.527794,10.406342
40825,2016,Noviembre,Trinidad y Tobago,0,1,,1,-75.516486,10.446304
40826,2016,Noviembre,Trinidad y Tobago,0,1,,1,-74.77647900000001,10.886686
40827,2016,Noviembre,Trinidad y Tobago,0,1,,1,-81.70216500000001,12.5862
40828,2016,Noviembre,Trinidad y Tobago,2,1,,3,-76.532004,3.451668
40829,2016,Noviembre,Trinidad y Tobago,6,8,,14,-74.140516,4.697157
40830,2016,Noviembre,Trinidad y Tobago,1,1,,2,-75.736374,4.815189
40831,2016,Noviembre,Trinidad y Tobago,1,10,,11,-75.42726,6.170465
40832,2016,Noviembre,Trinidad y Tobago,2,2,,4,-73.181317,7.1280470000000005
40833,2016,Noviembre,Túnez,0,1,,1,-74.140516,4.697157
40834,2016,Noviembre,Turkmenistán,6,11,,17,-74.140516,4.697157
40835,2016,Noviembre,Turquía,0,1,,1,-76.532004,3.451668
40836,2016,Noviembre,Turquía,317,615,,932,-74.140516,4.697157
40837,2016,Noviembre,Turquía,0,1,,1,-75.42726,6.170465
40838,2016,Noviembre,Ucrania,0,1,,1,-74.77647900000001,10.886686
40839,2016,Noviembre,Ucrania,1,4,,5,-74.140516,4.697157
40840,2016,Noviembre,Ucrania,0,2,,2,-75.42726,6.170465
40841,2016,Noviembre,Uganda,1,0,,1,-76.532004,3.451668
40842,2016,Noviembre,Uganda,0,1,,1,-74.140516,4.697157
40843,2016,Noviembre,Uruguay,2,0,,2,-75.516486,10.446304
40844,2016,Noviembre,Uruguay,3,2,,5,-74.77647900000001,10.886686
40845,2016,Noviembre,Uruguay,18,12,,30,-81.70216500000001,12.5862
40846,2016,Noviembre,Uruguay,9,16,,25,-76.532004,3.451668
40847,2016,Noviembre,Uruguay,106,128,,234,-74.140516,4.697157
40848,2016,Noviembre,Uruguay,0,3,,3,-75.736374,4.815189
40849,2016,Noviembre,Uruguay,24,49,,73,-75.42726,6.170465
40850,2016,Noviembre,Venezuela,0,4,,4,-75.527794,10.406342
40851,2016,Noviembre,Venezuela,7,17,,24,-75.516486,10.446304
40852,2016,Noviembre,Venezuela,31,65,,96,-74.77647900000001,10.886686
40853,2016,Noviembre,Venezuela,0,11,,11,-74.232675,11.117206
40854,2016,Noviembre,Venezuela,4334,5075,,9409,-72.129595,11.360028999999999
40855,2016,Noviembre,Venezuela,2,0,,2,-81.70216500000001,12.5862
40856,2016,Noviembre,Venezuela,9,54,,63,-76.532004,3.451668
40857,2016,Noviembre,Venezuela,44,36,,80,-67.927521,3.866713
40858,2016,Noviembre,Venezuela,3419,4073,,7492,-74.140516,4.697157
40859,2016,Noviembre,Venezuela,3,3,,6,-75.736374,4.815189
40860,2016,Noviembre,Venezuela,563,570,,1133,-75.42726,6.170465
40861,2016,Noviembre,Venezuela,785,1024,,1809,-67.48402800000001,6.185536
40862,2016,Noviembre,Venezuela,117,161,,278,-70.74025300000001,7.088728999999999
40863,2016,Noviembre,Venezuela,2,7,,9,-73.181317,7.1280470000000005
40864,2016,Noviembre,Venezuela,6800,8672,,15472,-72.453013,7.819
40865,2016,Noviembre,Venezuela,75,75,,150,-72.409396,8.36068
40866,2016,Noviembre,Vietnam,4,5,,9,-74.140516,4.697157
40867,2016,Noviembre,Islas Vírgenes Estadounidenses/Territorio de Estados Unidos,1,7,,8,-75.527794,10.406342
40868,2016,Noviembre,Zambia,0,1,,1,-76.532004,3.451668
40869,2016,Noviembre,Zimbabue,1,0,,1,-76.532004,3.451668
40870,2016,Noviembre,Zimbabue,1,0,,1,-74.140516,4.697157
40871,2016,Diciembre,Afganistán,1,1,,2,-74.140516,4.697157
40872,2016,Diciembre,Albania,1,0,,1,-74.140516,4.697157
40873,2016,Diciembre,Alemania,1,1,,2,-77.35600000000001,0.81488
40874,2016,Diciembre,Alemania,1,0,,1,-75.516486,10.446304
40875,2016,Diciembre,Alemania,7,19,,26,-74.77647900000001,10.886686
40876,2016,Diciembre,Alemania,0,2,,2,-74.765343,10.970933
40877,2016,Diciembre,Alemania,3,1,,4,-81.70216500000001,12.5862
40878,2016,Diciembre,Alemania,39,71,,110,-76.532004,3.451668
40879,2016,Diciembre,Alemania,1492,2354,,3846,-74.140516,4.697157
40880,2016,Diciembre,Alemania,1,2,,3,-75.736374,4.815189
40881,2016,Diciembre,Alemania,30,49,,79,-75.42726,6.170465
40882,2016,Diciembre,Antigua y Barbuda,0,2,,2,-75.42726,6.170465
40883,2016,Diciembre,Países Bajos,6,27,,33,-75.527794,10.406342
40884,2016,Diciembre,Países Bajos,0,4,,4,-75.516486,10.446304
40885,2016,Diciembre,Países Bajos,97,150,,247,-74.77647900000001,10.886686
40886,2016,Diciembre,Países Bajos,1,1,,2,-74.765343,10.970933
40887,2016,Diciembre,Países Bajos,1,2,,3,-74.213989,11.247722999999999
40888,2016,Diciembre,Países Bajos,126,267,,393,-76.532004,3.451668
40889,2016,Diciembre,Países Bajos,814,1274,,2088,-74.140516,4.697157
40890,2016,Diciembre,Países Bajos,1,6,,7,-75.736374,4.815189
40891,2016,Diciembre,Países Bajos,187,304,,491,-75.42726,6.170465
40892,2016,Diciembre,Países Bajos,0,4,,4,-73.181317,7.1280470000000005
40893,2016,Diciembre,Arabia Saudita,1,0,,1,-76.532004,3.451668
40894,2016,Diciembre,Arabia Saudita,1,5,,6,-74.140516,4.697157
40895,2016,Diciembre,Argelia,4,6,,10,-74.140516,4.697157
40896,2016,Diciembre,Argelia,0,1,,1,-75.42726,6.170465
40897,2016,Diciembre,Argentina,3,5,,8,-77.35600000000001,0.81488
40898,2016,Diciembre,Argentina,21,27,,48,-75.516486,10.446304
40899,2016,Diciembre,Argentina,9,20,,29,-74.77647900000001,10.886686
40900,2016,Diciembre,Argentina,103,92,,195,-81.70216500000001,12.5862
40901,2016,Diciembre,Argentina,61,58,,119,-76.532004,3.451668
40902,2016,Diciembre,Argentina,3389,4334,,7723,-74.140516,4.697157
40903,2016,Diciembre,Argentina,2,2,,4,-75.736374,4.815189
40904,2016,Diciembre,Argentina,182,276,,458,-75.42726,6.170465
40905,2016,Diciembre,República de Armenia,1,0,,1,-74.140516,4.697157
40906,2016,Diciembre,Aruba,21,35,,56,-75.527794,10.406342
40907,2016,Diciembre,Aruba,23,30,,53,-75.516486,10.446304
40908,2016,Diciembre,Aruba,5,15,,20,-74.77647900000001,10.886686
40909,2016,Diciembre,Aruba,19,30,,49,-74.213989,11.247722999999999
40910,2016,Diciembre,Aruba,6,3,,9,-76.532004,3.451668
40911,2016,Diciembre,Aruba,662,868,,1530,-74.140516,4.697157
40912,2016,Diciembre,Aruba,0,1,,1,-75.736374,4.815189
40913,2016,Diciembre,Aruba,81,102,,183,-75.42726,6.170465
40914,2016,Diciembre,Aruba,8,13,,21,-73.181317,7.1280470000000005
40915,2016,Diciembre,Australia,3,2,,5,-75.516486,10.446304
40916,2016,Diciembre,Australia,3,4,,7,-74.77647900000001,10.886686
40917,2016,Diciembre,Australia,6,19,,25,-76.532004,3.451668
40918,2016,Diciembre,Australia,69,95,,164,-74.140516,4.697157
40919,2016,Diciembre,Australia,0,1,,1,-75.736374,4.815189
40920,2016,Diciembre,Australia,22,39,,61,-75.42726,6.170465
40921,2016,Diciembre,Australia,0,1,,1,-73.181317,7.1280470000000005
40922,2016,Diciembre,Austria,1,1,,2,-74.77647900000001,10.886686
40923,2016,Diciembre,Austria,3,7,,10,-76.532004,3.451668
40924,2016,Diciembre,Austria,27,45,,72,-74.140516,4.697157
40925,2016,Diciembre,Austria,4,1,,5,-75.42726,6.170465
40926,2016,Diciembre,Bahamas,1,5,,6,-75.527794,10.406342
40927,2016,Diciembre,Bahamas,1,2,,3,-75.516486,10.446304
40928,2016,Diciembre,Bahamas,3,8,,11,-74.77647900000001,10.886686
40929,2016,Diciembre,Bahamas,0,2,,2,-74.213989,11.247722999999999
40930,2016,Diciembre,Bahamas,3,3,,6,-76.532004,3.451668
40931,2016,Diciembre,Bahamas,1,3,,4,-74.140516,4.697157
40932,2016,Diciembre,Bahamas,1,4,,5,-75.42726,6.170465
40933,2016,Diciembre,Bahréin,1,1,,2,-75.516486,10.446304
40934,2016,Diciembre,Bahréin,0,1,,1,-76.532004,3.451668
40935,2016,Diciembre,Bahréin,1,1,,2,-74.140516,4.697157
40936,2016,Diciembre,Bahréin,0,2,,2,-75.42726,6.170465
40937,2016,Diciembre,Barbados,73,82,,155,-74.140516,4.697157
40938,2016,Diciembre,República de Belarús,2,4,,6,-74.140516,4.697157
40939,2016,Diciembre,República de Belarús,0,1,,1,-75.42726,6.170465
40940,2016,Diciembre,República de Belarús,0,1,,1,-72.453013,7.819
40941,2016,Diciembre,Bélgica,0,1,,1,-75.516486,10.446304
40942,2016,Diciembre,Bélgica,2,3,,5,-74.77647900000001,10.886686
40943,2016,Diciembre,Bélgica,9,12,,21,-76.532004,3.451668
40944,2016,Diciembre,Bélgica,56,84,,140,-74.140516,4.697157
40945,2016,Diciembre,Bélgica,10,25,,35,-75.42726,6.170465
40946,2016,Diciembre,Belice,1,1,,2,-81.372937,13.338761300000002
40947,2016,Diciembre,Belice,0,1,,1,-76.532004,3.451668
40948,2016,Diciembre,Belice,0,1,,1,-74.140516,4.697157
40949,2016,Diciembre,Belice,0,3,,3,-75.42726,6.170465
40950,2016,Diciembre,Bermudas/Territorio Británico de Ultramar,1,0,,1,-74.140516,4.697157
40951,2016,Diciembre,Bolivia,2,3,,5,-69.941498,4.191162
40952,2016,Diciembre,Bolivia,1,0,,1,-77.35600000000001,0.81488
40953,2016,Diciembre,Bolivia,4,4,,8,-75.516486,10.446304
40954,2016,Diciembre,Bolivia,25,16,,41,-81.70216500000001,12.5862
40955,2016,Diciembre,Bolivia,7,12,,19,-76.532004,3.451668
40956,2016,Diciembre,Bolivia,717,708,,1425,-74.140516,4.697157
40957,2016,Diciembre,Bolivia,3,1,,4,-75.736374,4.815189
40958,2016,Diciembre,Bolivia,73,97,,170,-75.42726,6.170465
40959,2016,Diciembre,Bolivia,2,0,,2,-73.181317,7.1280470000000005
40960,2016,Diciembre,Brasil,274,256,,530,-69.941498,4.191162
40961,2016,Diciembre,Brasil,0,1,,1,-75.527794,10.406342
40962,2016,Diciembre,Brasil,21,12,,33,-75.516486,10.446304
40963,2016,Diciembre,Brasil,3,3,,6,-74.77647900000001,10.886686
40964,2016,Diciembre,Brasil,479,374,,853,-81.70216500000001,12.5862
40965,2016,Diciembre,Brasil,33,54,,87,-76.532004,3.451668
40966,2016,Diciembre,Brasil,2,3,,5,-67.927521,3.866713
40967,2016,Diciembre,Brasil,4941,5769,,10710,-74.140516,4.697157
40968,2016,Diciembre,Brasil,2,2,,4,-75.736374,4.815189
40969,2016,Diciembre,Brasil,62,117,,179,-75.42726,6.170465
40970,2016,Diciembre,Brasil,1,0,,1,-73.181317,7.1280470000000005
40971,2016,Diciembre,Bulgaria,1,1,,2,-74.140516,4.697157
40972,2016,Diciembre,Islas Caimán/Territorio Británico de Ultramar,2,3,,5,-75.527794,10.406342
40973,2016,Diciembre,Islas Caimán/Territorio Británico de Ultramar,5,33,,38,-81.70216500000001,12.5862
40974,2016,Diciembre,Camerún,5,2,,7,-74.140516,4.697157
40975,2016,Diciembre,Canadá,0,2,,2,-75.527794,10.406342
40976,2016,Diciembre,Canadá,244,271,,515,-75.516486,10.446304
40977,2016,Diciembre,Canadá,22,29,,51,-74.77647900000001,10.886686
40978,2016,Diciembre,Canadá,149,143,,292,-81.70216500000001,12.5862
40979,2016,Diciembre,Canadá,96,101,,197,-76.532004,3.451668
40980,2016,Diciembre,Canadá,861,1211,,2072,-74.140516,4.697157
40981,2016,Diciembre,Canadá,13,28,,41,-75.736374,4.815189
40982,2016,Diciembre,Canadá,183,296,,479,-75.42726,6.170465
40983,2016,Diciembre,Canadá,6,16,,22,-73.181317,7.1280470000000005
40984,2016,Diciembre,España,3,3,,6,-75.527794,10.406342
40985,2016,Diciembre,España,1,4,,5,-75.516486,10.446304
40986,2016,Diciembre,España,1,6,,7,-74.77647900000001,10.886686
40987,2016,Diciembre,España,711,1099,,1810,-76.532004,3.451668
40988,2016,Diciembre,España,4509,7253,,11762,-74.140516,4.697157
40989,2016,Diciembre,España,1,4,,5,-75.736374,4.815189
40990,2016,Diciembre,España,384,794,,1178,-75.42726,6.170465
40991,2016,Diciembre,República Del Congo,1,0,,1,-74.140516,4.697157
40992,2016,Diciembre,Comoras,0,1,,1,-74.140516,4.697157
40993,2016,Diciembre,República de Corea,0,3,,3,-76.532004,3.451668
40994,2016,Diciembre,República de Corea,10,9,,19,-74.140516,4.697157
40995,2016,Diciembre,República de Corea,0,4,,4,-75.42726,6.170465
40996,2016,Diciembre,Costa de Marfil,1,0,,1,-76.532004,3.451668
40997,2016,Diciembre,Costa de Marfil,5,10,,15,-74.140516,4.697157
40998,2016,Diciembre,Costa de Marfil,0,1,,1,-75.42726,6.170465
40999,2016,Diciembre,Costa Rica,11,28,,39,-75.527794,10.406342
41000,2016,Diciembre,Costa Rica,3,6,,9,-75.516486,10.446304
41001,2016,Diciembre,Costa Rica,23,21,,44,-74.77647900000001,10.886686
41002,2016,Diciembre,Costa Rica,0,2,,2,-81.703935,12.574411099999999
41003,2016,Diciembre,Costa Rica,166,140,,306,-81.70216500000001,12.5862
41004,2016,Diciembre,Costa Rica,52,59,,111,-76.532004,3.451668
41005,2016,Diciembre,Costa Rica,1358,1586,,2944,-74.140516,4.697157
41006,2016,Diciembre,Costa Rica,12,18,,30,-75.736374,4.815189
41007,2016,Diciembre,Costa Rica,146,186,,332,-75.42726,6.170465
41008,2016,Diciembre,Costa Rica,8,2,,10,-73.181317,7.1280470000000005
41009,2016,Diciembre,Croacia,0,1,,1,-74.77647900000001,10.886686
41010,2016,Diciembre,Croacia,0,3,,3,-76.532004,3.451668
41011,2016,Diciembre,Croacia,3,6,,9,-74.140516,4.697157
41012,2016,Diciembre,Cuba,0,3,,3,-75.527794,10.406342
41013,2016,Diciembre,Cuba,2,5,,7,-75.516486,10.446304
41014,2016,Diciembre,Cuba,5,6,,11,-74.77647900000001,10.886686
41015,2016,Diciembre,Cuba,20,39,,59,-76.532004,3.451668
41016,2016,Diciembre,Cuba,371,712,,1083,-74.140516,4.697157
41017,2016,Diciembre,Cuba,1,2,,3,-75.736374,4.815189
41018,2016,Diciembre,Cuba,14,12,,26,-75.42726,6.170465
41019,2016,Diciembre,Cuba,5,2,,7,-73.181317,7.1280470000000005
41020,2016,Diciembre,Curazao,2,3,,5,-74.140516,4.697157
41021,2016,Diciembre,Curazao,0,1,,1,-75.42726,6.170465
41022,2016,Diciembre,República Checa,1,0,,1,-76.532004,3.451668
41023,2016,Diciembre,República Checa,16,19,,35,-74.140516,4.697157
41024,2016,Diciembre,Chile,2,5,,7,-77.35600000000001,0.81488
41025,2016,Diciembre,Chile,0,4,,4,-75.527794,10.406342
41026,2016,Diciembre,Chile,6,6,,12,-75.516486,10.446304
41027,2016,Diciembre,Chile,4,6,,10,-74.77647900000001,10.886686
41028,2016,Diciembre,Chile,106,78,,184,-81.70216500000001,12.5862
41029,2016,Diciembre,Chile,57,88,,145,-76.532004,3.451668
41030,2016,Diciembre,Chile,4450,5686,,10136,-74.140516,4.697157
41031,2016,Diciembre,Chile,2,3,,5,-75.736374,4.815189
41032,2016,Diciembre,Chile,38,68,,106,-75.42726,6.170465
41033,2016,Diciembre,Chile,1,1,,2,-73.181317,7.1280470000000005
41034,2016,Diciembre,China,0,8,,8,-76.532004,3.451668
41035,2016,Diciembre,China,22,59,,81,-74.140516,4.697157
41036,2016,Diciembre,China,6,4,,10,-75.42726,6.170465
41037,2016,Diciembre,Dinamarca,3,5,,8,-76.532004,3.451668
41038,2016,Diciembre,Dinamarca,22,40,,62,-74.140516,4.697157
41039,2016,Diciembre,Dinamarca,1,2,,3,-75.42726,6.170465
41040,2016,Diciembre,Dinamarca,0,1,,1,-73.181317,7.1280470000000005
41041,2016,Diciembre,Dominica,0,1,,1,-74.140516,4.697157
41042,2016,Diciembre,Ecuador,151,363,,514,-76.876446,0.33002
41043,2016,Diciembre,Ecuador,1,2,,3,-77.84700600000001,0.8124359999999999
41044,2016,Diciembre,Ecuador,4737,6955,,11692,-77.35600000000001,0.81488
41045,2016,Diciembre,Ecuador,62,68,,130,-78.802679,18.00143
41046,2016,Diciembre,Ecuador,0,2,,2,-75.527794,10.406342
41047,2016,Diciembre,Ecuador,1,2,,3,-75.516486,10.446304
41048,2016,Diciembre,Ecuador,2,1,,3,-74.77647900000001,10.886686
41049,2016,Diciembre,Ecuador,9,5,,14,-81.70216500000001,12.5862
41050,2016,Diciembre,Ecuador,489,508,,997,-76.532004,3.451668
41051,2016,Diciembre,Ecuador,3235,4135,,7370,-74.140516,4.697157
41052,2016,Diciembre,Ecuador,1,1,,2,-75.736374,4.815189
41053,2016,Diciembre,Ecuador,22,32,,54,-75.42726,6.170465
41054,2016,Diciembre,Ecuador,3,1,,4,-73.181317,7.1280470000000005
41055,2016,Diciembre,Egipto,6,15,,21,-74.140516,4.697157
41056,2016,Diciembre,El Salvador,7,10,,17,-75.516486,10.446304
41057,2016,Diciembre,El Salvador,2,1,,3,-74.77647900000001,10.886686
41058,2016,Diciembre,El Salvador,13,18,,31,-81.70216500000001,12.5862
41059,2016,Diciembre,El Salvador,134,211,,345,-76.532004,3.451668
41060,2016,Diciembre,El Salvador,1081,1372,,2453,-74.140516,4.697157
41061,2016,Diciembre,El Salvador,2,1,,3,-75.736374,4.815189
41062,2016,Diciembre,El Salvador,194,287,,481,-75.42726,6.170465
41063,2016,Diciembre,El Salvador,0,1,,1,-73.181317,7.1280470000000005
41064,2016,Diciembre,Emiratos Árabes,0,1,,1,-75.516486,10.446304
41065,2016,Diciembre,Emiratos Árabes,8,9,,17,-74.140516,4.697157
41066,2016,Diciembre,Eslovaquia,2,3,,5,-74.140516,4.697157
41067,2016,Diciembre,Eslovenia,2,5,,7,-74.140516,4.697157
41068,2016,Diciembre,Eslovenia,0,1,,1,-75.42726,6.170465
41069,2016,Diciembre,Estados Unidos de América,10,66,,76,-75.527794,10.406342
41070,2016,Diciembre,Estados Unidos de América,3384,4699,,8083,-75.516486,10.446304
41071,2016,Diciembre,Estados Unidos de América,853,1422,,2275,-74.77647900000001,10.886686
41072,2016,Diciembre,Estados Unidos de América,0,6,,6,-74.765343,10.970933
41073,2016,Diciembre,Estados Unidos de América,0,1,,1,-74.232675,11.117206
41074,2016,Diciembre,Estados Unidos de América,0,14,,14,-74.213989,11.247722999999999
41075,2016,Diciembre,Estados Unidos de América,48,52,,100,-81.70216500000001,12.5862
41076,2016,Diciembre,Estados Unidos de América,1831,2715,,4546,-76.532004,3.451668
41077,2016,Diciembre,Estados Unidos de América,150,194,,344,-75.76635300000001,4.45285
41078,2016,Diciembre,Estados Unidos de América,10566,17230,,27796,-74.140516,4.697157
41079,2016,Diciembre,Estados Unidos de América,239,338,,577,-75.736374,4.815189
41080,2016,Diciembre,Estados Unidos de América,3307,6213,,9520,-75.42726,6.170465
41081,2016,Diciembre,Estados Unidos de América,63,85,,148,-73.181317,7.1280470000000005
41082,2016,Diciembre,Estados Unidos de América,0,29,,29,-75.68164200000001,9.402597
41083,2016,Diciembre,Estonia,3,0,,3,-74.140516,4.697157
41084,2016,Diciembre,Estonia,0,2,,2,-75.42726,6.170465
41085,2016,Diciembre,Etiopia,0,1,,1,-74.140516,4.697157
41086,2016,Diciembre,Filipinas,0,1,,1,-75.516486,10.446304
41087,2016,Diciembre,Filipinas,0,6,,6,-74.77647900000001,10.886686
41088,2016,Diciembre,Filipinas,0,3,,3,-76.532004,3.451668
41089,2016,Diciembre,Filipinas,0,7,,7,-77.061029,3.8844260000000004
41090,2016,Diciembre,Filipinas,3,7,,10,-74.140516,4.697157
41091,2016,Diciembre,Filipinas,0,1,,1,-73.181317,7.1280470000000005
41092,2016,Diciembre,Finlandia,0,3,,3,-76.532004,3.451668
41093,2016,Diciembre,Finlandia,13,16,,29,-74.140516,4.697157
41094,2016,Diciembre,Finlandia,0,2,,2,-75.42726,6.170465
41095,2016,Diciembre,Francia,1,3,,4,-75.527794,10.406342
41096,2016,Diciembre,Francia,3,3,,6,-75.516486,10.446304
41097,2016,Diciembre,Francia,3,4,,7,-74.77647900000001,10.886686
41098,2016,Diciembre,Francia,1,0,,1,-81.70216500000001,12.5862
41099,2016,Diciembre,Francia,61,102,,163,-76.532004,3.451668
41100,2016,Diciembre,Francia,1505,2540,,4045,-74.140516,4.697157
41101,2016,Diciembre,Francia,1,3,,4,-75.736374,4.815189
41102,2016,Diciembre,Francia,26,62,,88,-75.42726,6.170465
41103,2016,Diciembre,Gabón,0,1,,1,-74.140516,4.697157
41104,2016,Diciembre,Georgia,0,1,,1,-74.140516,4.697157
41105,2016,Diciembre,Ghana,0,1,,1,-76.532004,3.451668
41106,2016,Diciembre,Ghana,0,1,,1,-74.140516,4.697157
41107,2016,Diciembre,Gibraltar/Territorio Británico de Ultramar,1,1,,2,-77.35600000000001,0.81488
41108,2016,Diciembre,Grecia,0,1,,1,-76.532004,3.451668
41109,2016,Diciembre,Grecia,8,15,,23,-74.140516,4.697157
41110,2016,Diciembre,Grecia,1,1,,2,-75.42726,6.170465
41111,2016,Diciembre,Groenlandia,0,2,,2,-74.140516,4.697157
41112,2016,Diciembre,Guatemala,1,2,,3,-75.527794,10.406342
41113,2016,Diciembre,Guatemala,3,2,,5,-75.516486,10.446304
41114,2016,Diciembre,Guatemala,6,5,,11,-74.77647900000001,10.886686
41115,2016,Diciembre,Guatemala,92,83,,175,-81.70216500000001,12.5862
41116,2016,Diciembre,Guatemala,31,35,,66,-76.532004,3.451668
41117,2016,Diciembre,Guatemala,0,6,,6,-77.061029,3.8844260000000004
41118,2016,Diciembre,Guatemala,429,563,,992,-74.140516,4.697157
41119,2016,Diciembre,Guatemala,7,2,,9,-75.736374,4.815189
41120,2016,Diciembre,Guatemala,80,133,,213,-75.42726,6.170465
41121,2016,Diciembre,Guatemala,1,1,,2,-73.181317,7.1280470000000005
41122,2016,Diciembre,Guyana,4,3,,7,-74.140516,4.697157
41123,2016,Diciembre,Guyana,0,1,,1,-76.7333,8.06667
41124,2016,Diciembre,Guinea Ecuatorial,0,1,,1,-74.140516,4.697157
41125,2016,Diciembre,Guadalupe/Territorio Francés,1,2,,3,-74.140516,4.697157
41126,2016,Diciembre,Guadalupe/Territorio Francés,1,0,,1,-75.42726,6.170465
41127,2016,Diciembre,Haití,0,2,,2,-76.532004,3.451668
41128,2016,Diciembre,Haití,1,2,,3,-74.140516,4.697157
41129,2016,Diciembre,Haití,0,1,,1,-75.736374,4.815189
41130,2016,Diciembre,Haití,1,1,,2,-75.42726,6.170465
41131,2016,Diciembre,Haití,0,1,,1,-73.181317,7.1280470000000005
41132,2016,Diciembre,Honduras,1,1,,2,-75.516486,10.446304
41133,2016,Diciembre,Honduras,2,2,,4,-81.70216500000001,12.5862
41134,2016,Diciembre,Honduras,3,3,,6,-81.372937,13.338761300000002
41135,2016,Diciembre,Honduras,30,42,,72,-76.532004,3.451668
41136,2016,Diciembre,Honduras,61,73,,134,-74.140516,4.697157
41137,2016,Diciembre,Honduras,1,1,,2,-75.736374,4.815189
41138,2016,Diciembre,Honduras,49,45,,94,-75.42726,6.170465
41139,2016,Diciembre,Honduras,1,1,,2,-73.181317,7.1280470000000005
41140,2016,Diciembre,Hong Kong,1,5,,6,-74.140516,4.697157
41141,2016,Diciembre,Hong Kong,1,0,,1,-75.42726,6.170465
41142,2016,Diciembre,Hungría,9,3,,12,-74.140516,4.697157
41143,2016,Diciembre,Hungría,0,1,,1,-75.42726,6.170465
41144,2016,Diciembre,India,0,2,,2,-75.516486,10.446304
41145,2016,Diciembre,India,0,2,,2,-74.213989,11.247722999999999
41146,2016,Diciembre,India,1,1,,2,-76.532004,3.451668
41147,2016,Diciembre,India,5,26,,31,-74.140516,4.697157
41148,2016,Diciembre,India,0,4,,4,-75.736374,4.815189
41149,2016,Diciembre,India,5,3,,8,-75.42726,6.170465
41150,2016,Diciembre,Indonesia,0,1,,1,-74.77647900000001,10.886686
41151,2016,Diciembre,Indonesia,0,4,,4,-74.140516,4.697157
41152,2016,Diciembre,Irán,0,1,,1,-76.532004,3.451668
41153,2016,Diciembre,República de Irlanda,1,5,,6,-76.532004,3.451668
41154,2016,Diciembre,República de Irlanda,11,14,,25,-74.140516,4.697157
41155,2016,Diciembre,República de Irlanda,2,2,,4,-75.42726,6.170465
41156,2016,Diciembre,República de Irlanda,0,1,,1,-73.181317,7.1280470000000005
41157,2016,Diciembre,Islandia,1,2,,3,-74.140516,4.697157
41158,2016,Diciembre,Islandia,0,1,,1,-75.42726,6.170465
41159,2016,Diciembre,Israel,0,1,,1,-74.77647900000001,10.886686
41160,2016,Diciembre,Israel,4,1,,5,-76.532004,3.451668
41161,2016,Diciembre,Israel,24,46,,70,-74.140516,4.697157
41162,2016,Diciembre,Israel,2,4,,6,-75.42726,6.170465
41163,2016,Diciembre,Italia,0,2,,2,-75.516486,10.446304
41164,2016,Diciembre,Italia,3,0,,3,-74.77647900000001,10.886686
41165,2016,Diciembre,Italia,0,1,,1,-81.70216500000001,12.5862
41166,2016,Diciembre,Italia,23,74,,97,-76.532004,3.451668
41167,2016,Diciembre,Italia,217,446,,663,-74.140516,4.697157
41168,2016,Diciembre,Italia,1,3,,4,-75.736374,4.815189
41169,2016,Diciembre,Italia,32,54,,86,-75.42726,6.170465
41170,2016,Diciembre,Italia,1,1,,2,-73.181317,7.1280470000000005
41171,2016,Diciembre,Jamaica,1,19,,20,-75.527794,10.406342
41172,2016,Diciembre,Jamaica,1,40,,41,-75.516486,10.446304
41173,2016,Diciembre,Jamaica,0,2,,2,-74.77647900000001,10.886686
41174,2016,Diciembre,Jamaica,0,2,,2,-81.70216500000001,12.5862
41175,2016,Diciembre,Jamaica,0,4,,4,-76.532004,3.451668
41176,2016,Diciembre,Jamaica,3,10,,13,-74.140516,4.697157
41177,2016,Diciembre,Jamaica,1,3,,4,-75.42726,6.170465
41178,2016,Diciembre,Japón,1,0,,1,-74.77647900000001,10.886686
41179,2016,Diciembre,Japón,6,10,,16,-76.532004,3.451668
41180,2016,Diciembre,Japón,22,31,,53,-74.140516,4.697157
41181,2016,Diciembre,Japón,5,5,,10,-75.42726,6.170465
41182,2016,Diciembre,Jordania,1,2,,3,-74.140516,4.697157
41183,2016,Diciembre,Kenia,2,0,,2,-74.140516,4.697157
41184,2016,Diciembre,Kuwait,0,1,,1,-76.532004,3.451668
41185,2016,Diciembre,Letonia,0,1,,1,-75.516486,10.446304
41186,2016,Diciembre,Letonia,2,0,,2,-74.140516,4.697157
41187,2016,Diciembre,Lituania,3,2,,5,-74.140516,4.697157
41188,2016,Diciembre,Líbano,5,7,,12,-74.140516,4.697157
41189,2016,Diciembre,Luxemburgo,1,2,,3,-76.532004,3.451668
41190,2016,Diciembre,Luxemburgo,0,3,,3,-74.140516,4.697157
41191,2016,Diciembre,Madagascar,1,0,,1,-74.140516,4.697157
41192,2016,Diciembre,Malasia,0,2,,2,-74.140516,4.697157
41193,2016,Diciembre,Malasia,0,2,,2,-75.42726,6.170465
41194,2016,Diciembre,Malta,2,4,,6,-74.140516,4.697157
41195,2016,Diciembre,Malta,0,1,,1,-75.42726,6.170465
41196,2016,Diciembre,Marruecos,3,4,,7,-74.140516,4.697157
41197,2016,Diciembre,Martinica/Departamento de Ultramar Francés,0,1,,1,-73.181317,7.1280470000000005
41198,2016,Diciembre,México,0,6,,6,-75.527794,10.406342
41199,2016,Diciembre,México,16,18,,34,-75.516486,10.446304
41200,2016,Diciembre,México,16,38,,54,-74.77647900000001,10.886686
41201,2016,Diciembre,México,0,2,,2,-81.70216500000001,12.5862
41202,2016,Diciembre,México,82,141,,223,-76.532004,3.451668
41203,2016,Diciembre,México,0,2,,2,-77.061029,3.8844260000000004
41204,2016,Diciembre,México,5630,8033,,13663,-74.140516,4.697157
41205,2016,Diciembre,México,23,37,,60,-75.736374,4.815189
41206,2016,Diciembre,México,523,1090,,1613,-75.42726,6.170465
41207,2016,Diciembre,México,13,29,,42,-73.181317,7.1280470000000005
41208,2016,Diciembre,Mónaco,0,1,,1,-76.532004,3.451668
41209,2016,Diciembre,Mónaco,1,0,,1,-74.140516,4.697157
41210,2016,Diciembre,Myanmar,1,0,,1,-74.140516,4.697157
41211,2016,Diciembre,Namibia,1,1,,2,-74.140516,4.697157
41212,2016,Diciembre,Nicaragua,2,3,,5,-75.516486,10.446304
41213,2016,Diciembre,Nicaragua,2,0,,2,-74.77647900000001,10.886686
41214,2016,Diciembre,Nicaragua,1,2,,3,-81.70216500000001,12.5862
41215,2016,Diciembre,Nicaragua,9,10,,19,-76.532004,3.451668
41216,2016,Diciembre,Nicaragua,33,28,,61,-74.140516,4.697157
41217,2016,Diciembre,Nicaragua,1,1,,2,-75.736374,4.815189
41218,2016,Diciembre,Nicaragua,6,19,,25,-75.42726,6.170465
41219,2016,Diciembre,Nicaragua,0,3,,3,-73.181317,7.1280470000000005
41220,2016,Diciembre,Nigeria,1,0,,1,-76.532004,3.451668
41221,2016,Diciembre,Noruega,9,14,,23,-76.532004,3.451668
41222,2016,Diciembre,Noruega,25,35,,60,-74.140516,4.697157
41223,2016,Diciembre,Noruega,4,6,,10,-75.42726,6.170465
41224,2016,Diciembre,Nueva Zelanda,9,10,,19,-74.140516,4.697157
41225,2016,Diciembre,Nueva Zelanda,0,2,,2,-75.42726,6.170465
41226,2016,Diciembre,Omán,0,1,,1,-74.140516,4.697157
41227,2016,Diciembre,Papúa Nueva Guinea,0,1,,1,-74.140516,4.697157
41228,2016,Diciembre,Pakistán,0,1,,1,-76.532004,3.451668
41229,2016,Diciembre,Panamá,374,481,,855,-75.527794,10.406342
41230,2016,Diciembre,Panamá,3255,3739,,6994,-75.516486,10.446304
41231,2016,Diciembre,Panamá,340,681,,1021,-74.77647900000001,10.886686
41232,2016,Diciembre,Panamá,2,25,,27,-74.765343,10.970933
41233,2016,Diciembre,Panamá,0,4,,4,-74.232675,11.117206
41234,2016,Diciembre,Panamá,0,1,,1,-74.213989,11.247722999999999
41235,2016,Diciembre,Panamá,2,12,,14,-81.703935,12.574411099999999
41236,2016,Diciembre,Panamá,237,249,,486,-81.70216500000001,12.5862
41237,2016,Diciembre,Panamá,4,7,,11,-81.372937,13.338761300000002
41238,2016,Diciembre,Panamá,457,736,,1193,-76.532004,3.451668
41239,2016,Diciembre,Panamá,0,12,,12,-77.061029,3.8844260000000004
41240,2016,Diciembre,Panamá,50,77,,127,-75.76635300000001,4.45285
41241,2016,Diciembre,Panamá,4166,5893,,10059,-74.140516,4.697157
41242,2016,Diciembre,Panamá,91,149,,240,-75.736374,4.815189
41243,2016,Diciembre,Panamá,2373,3345,,5718,-75.42726,6.170465
41244,2016,Diciembre,Panamá,3,2,,5,-77.401154,6.222551999999999
41245,2016,Diciembre,Panamá,6,13,,19,-77.762647,7.102626
41246,2016,Diciembre,Panamá,18,34,,52,-73.181317,7.1280470000000005
41247,2016,Diciembre,Panamá,1,0,,1,-76.7333,8.06667
41248,2016,Diciembre,Panamá,126,165,,291,-77.35002,8.63337
41249,2016,Diciembre,Paraguay,0,3,,3,-74.77647900000001,10.886686
41250,2016,Diciembre,Paraguay,24,27,,51,-81.70216500000001,12.5862
41251,2016,Diciembre,Paraguay,7,5,,12,-76.532004,3.451668
41252,2016,Diciembre,Paraguay,83,62,,145,-74.140516,4.697157
41253,2016,Diciembre,Paraguay,70,89,,159,-75.42726,6.170465
41254,2016,Diciembre,Paraguay,0,1,,1,-73.181317,7.1280470000000005
41255,2016,Diciembre,Perú,126,174,,300,-69.941498,4.191162
41256,2016,Diciembre,Perú,3,1,,4,-74.78366,0.18595699999999998
41257,2016,Diciembre,Perú,4,4,,8,-77.35600000000001,0.81488
41258,2016,Diciembre,Perú,9,9,,18,-75.516486,10.446304
41259,2016,Diciembre,Perú,2,2,,4,-74.77647900000001,10.886686
41260,2016,Diciembre,Perú,71,52,,123,-81.70216500000001,12.5862
41261,2016,Diciembre,Perú,257,358,,615,-76.532004,3.451668
41262,2016,Diciembre,Perú,5573,7244,,12817,-74.140516,4.697157
41263,2016,Diciembre,Perú,0,4,,4,-75.736374,4.815189
41264,2016,Diciembre,Perú,473,726,,1199,-75.42726,6.170465
41265,2016,Diciembre,Perú,1,0,,1,-73.181317,7.1280470000000005
41266,2016,Diciembre,Palestina,0,2,,2,-74.140516,4.697157
41267,2016,Diciembre,Polonia,0,2,,2,-75.516486,10.446304
41268,2016,Diciembre,Polonia,0,3,,3,-74.77647900000001,10.886686
41269,2016,Diciembre,Polonia,22,22,,44,-74.140516,4.697157
41270,2016,Diciembre,Portugal,4,7,,11,-76.532004,3.451668
41271,2016,Diciembre,Portugal,22,60,,82,-74.140516,4.697157
41272,2016,Diciembre,Portugal,5,3,,8,-75.42726,6.170465
41273,2016,Diciembre,Puerto Rico/Territorio de Estados Unidos,1,2,,3,-75.527794,10.406342
41274,2016,Diciembre,Puerto Rico/Territorio de Estados Unidos,1,3,,4,-75.516486,10.446304
41275,2016,Diciembre,Puerto Rico/Territorio de Estados Unidos,10,63,,73,-74.77647900000001,10.886686
41276,2016,Diciembre,Puerto Rico/Territorio de Estados Unidos,0,9,,9,-81.70216500000001,12.5862
41277,2016,Diciembre,Puerto Rico/Territorio de Estados Unidos,25,100,,125,-76.532004,3.451668
41278,2016,Diciembre,Puerto Rico/Territorio de Estados Unidos,540,687,,1227,-74.140516,4.697157
41279,2016,Diciembre,Puerto Rico/Territorio de Estados Unidos,13,22,,35,-75.736374,4.815189
41280,2016,Diciembre,Puerto Rico/Territorio de Estados Unidos,51,137,,188,-75.42726,6.170465
41281,2016,Diciembre,Puerto Rico/Territorio de Estados Unidos,2,11,,13,-73.181317,7.1280470000000005
41282,2016,Diciembre,Qatar,1,1,,2,-76.532004,3.451668
41283,2016,Diciembre,Qatar,1,2,,3,-74.140516,4.697157
41284,2016,Diciembre,Reino Unido de Gran Bretaña e Irlanda del Norte,0,1,,1,-75.516486,10.446304
41285,2016,Diciembre,Reino Unido de Gran Bretaña e Irlanda del Norte,0,1,,1,-74.77647900000001,10.886686
41286,2016,Diciembre,Reino Unido de Gran Bretaña e Irlanda del Norte,34,39,,73,-76.532004,3.451668
41287,2016,Diciembre,Reino Unido de Gran Bretaña e Irlanda del Norte,1028,1744,,2772,-74.140516,4.697157
41288,2016,Diciembre,Reino Unido de Gran Bretaña e Irlanda del Norte,40,71,,111,-75.42726,6.170465
41289,2016,Diciembre,Reino Unido de Gran Bretaña e Irlanda del Norte,0,1,,1,-73.181317,7.1280470000000005
41290,2016,Diciembre,República CentroÁfricana,0,2,,2,-76.532004,3.451668
41291,2016,Diciembre,República CentroÁfricana,1,0,,1,-74.140516,4.697157
41292,2016,Diciembre,Federación de Rusia,0,9,,9,-75.527794,10.406342
41293,2016,Diciembre,Federación de Rusia,1,0,,1,-75.516486,10.446304
41294,2016,Diciembre,Federación de Rusia,1,1,,2,-74.77647900000001,10.886686
41295,2016,Diciembre,Federación de Rusia,2,1,,3,-76.532004,3.451668
41296,2016,Diciembre,Federación de Rusia,27,21,,48,-74.140516,4.697157
41297,2016,Diciembre,Federación de Rusia,1,10,,11,-75.42726,6.170465
41298,2016,Diciembre,República Dominicana,0,11,,11,-75.527794,10.406342
41299,2016,Diciembre,República Dominicana,0,6,,6,-75.516486,10.446304
41300,2016,Diciembre,República Dominicana,1,13,,14,-74.77647900000001,10.886686
41301,2016,Diciembre,República Dominicana,0,2,,2,-81.70216500000001,12.5862
41302,2016,Diciembre,República Dominicana,8,20,,28,-76.532004,3.451668
41303,2016,Diciembre,República Dominicana,858,1021,,1879,-74.140516,4.697157
41304,2016,Diciembre,República Dominicana,5,8,,13,-75.736374,4.815189
41305,2016,Diciembre,República Dominicana,29,42,,71,-75.42726,6.170465
41306,2016,Diciembre,República Dominicana,5,7,,12,-73.181317,7.1280470000000005
41307,2016,Diciembre,Reunión,1,0,,1,-74.140516,4.697157
41308,2016,Diciembre,República Democrática Popular de Corea,1,0,,1,-75.42726,6.170465
41309,2016,Diciembre,Rumania,1,0,,1,-76.532004,3.451668
41310,2016,Diciembre,Rumania,3,10,,13,-74.140516,4.697157
41311,2016,Diciembre,Sahara Occidental/Desierto Sahara,1,0,,1,-75.516486,10.446304
41312,2016,Diciembre,San  Vicente y las Granadinas,2,3,,5,-74.140516,4.697157
41313,2016,Diciembre,Santa Lucia,0,1,,1,-74.140516,4.697157
41314,2016,Diciembre,Santa Lucia,1,0,,1,-75.42726,6.170465
41315,2016,Diciembre,Santa Sede/Ciudad del Vaticano,1,0,,1,-76.532004,3.451668
41316,2016,Diciembre,Serbia,2,5,,7,-74.140516,4.697157
41317,2016,Diciembre,Singapur,0,3,,3,-74.213989,11.247722999999999
41318,2016,Diciembre,Singapur,1,1,,2,-76.532004,3.451668
41319,2016,Diciembre,Singapur,0,7,,7,-74.140516,4.697157
41320,2016,Diciembre,Sri Lanka,1,0,,1,-74.140516,4.697157
41321,2016,Diciembre,Sudáfrica,7,5,,12,-74.140516,4.697157
41322,2016,Diciembre,Sudáfrica,1,2,,3,-75.42726,6.170465
41323,2016,Diciembre,Suecia,0,2,,2,-75.516486,10.446304
41324,2016,Diciembre,Suecia,2,2,,4,-74.77647900000001,10.886686
41325,2016,Diciembre,Suecia,21,21,,42,-76.532004,3.451668
41326,2016,Diciembre,Suecia,91,79,,170,-74.140516,4.697157
41327,2016,Diciembre,Suecia,8,12,,20,-75.42726,6.170465
41328,2016,Diciembre,Suiza,0,3,,3,-74.77647900000001,10.886686
41329,2016,Diciembre,Suiza,26,75,,101,-76.532004,3.451668
41330,2016,Diciembre,Suiza,139,261,,400,-74.140516,4.697157
41331,2016,Diciembre,Suiza,0,1,,1,-75.736374,4.815189
41332,2016,Diciembre,Suiza,12,42,,54,-75.42726,6.170465
41333,2016,Diciembre,Suiza,0,1,,1,-73.181317,7.1280470000000005
41334,2016,Diciembre,Surinam,0,1,,1,-75.527794,10.406342
41335,2016,Diciembre,Surinam,60,73,,133,-74.77647900000001,10.886686
41336,2016,Diciembre,Surinam,8,7,,15,-74.140516,4.697157
41337,2016,Diciembre,Surinam,6,7,,13,-75.42726,6.170465
41338,2016,Diciembre,Taiwán,1,0,,1,-76.532004,3.451668
41339,2016,Diciembre,Taiwán,0,2,,2,-74.140516,4.697157
41340,2016,Diciembre,Taiwán,1,3,,4,-75.42726,6.170465
41341,2016,Diciembre,República de Tayikistán,0,1,,1,-74.140516,4.697157
41342,2016,Diciembre,Tailandia,0,1,,1,-76.532004,3.451668
41343,2016,Diciembre,Tailandia,1,2,,3,-74.140516,4.697157
41344,2016,Diciembre,Tailandia,1,0,,1,-75.42726,6.170465
41345,2016,Diciembre,Trinidad y Tobago,0,1,,1,-75.527794,10.406342
41346,2016,Diciembre,Trinidad y Tobago,0,23,,23,-74.765343,10.970933
41347,2016,Diciembre,Trinidad y Tobago,1,7,,8,-76.532004,3.451668
41348,2016,Diciembre,Trinidad y Tobago,6,25,,31,-74.140516,4.697157
41349,2016,Diciembre,Trinidad y Tobago,0,2,,2,-75.736374,4.815189
41350,2016,Diciembre,Trinidad y Tobago,2,17,,19,-75.42726,6.170465
41351,2016,Diciembre,Trinidad y Tobago,1,1,,2,-73.181317,7.1280470000000005
41352,2016,Diciembre,Turkmenistán,2,5,,7,-74.140516,4.697157
41353,2016,Diciembre,Turquía,350,602,,952,-74.140516,4.697157
41354,2016,Diciembre,Ucrania,2,1,,3,-74.140516,4.697157
41355,2016,Diciembre,Uruguay,0,1,,1,-75.516486,10.446304
41356,2016,Diciembre,Uruguay,3,1,,4,-74.77647900000001,10.886686
41357,2016,Diciembre,Uruguay,24,19,,43,-81.70216500000001,12.5862
41358,2016,Diciembre,Uruguay,12,27,,39,-76.532004,3.451668
41359,2016,Diciembre,Uruguay,139,162,,301,-74.140516,4.697157
41360,2016,Diciembre,Uruguay,1,1,,2,-75.736374,4.815189
41361,2016,Diciembre,Uruguay,29,52,,81,-75.42726,6.170465
41362,2016,Diciembre,Uruguay,2,1,,3,-73.181317,7.1280470000000005
41363,2016,Diciembre,Venezuela,0,18,,18,-75.527794,10.406342
41364,2016,Diciembre,Venezuela,18,37,,55,-75.516486,10.446304
41365,2016,Diciembre,Venezuela,20,42,,62,-74.77647900000001,10.886686
41366,2016,Diciembre,Venezuela,0,1,,1,-74.765343,10.970933
41367,2016,Diciembre,Venezuela,1,4,,5,-74.232675,11.117206
41368,2016,Diciembre,Venezuela,3834,3982,,7816,-72.129595,11.360028999999999
41369,2016,Diciembre,Venezuela,9,9,,18,-81.70216500000001,12.5862
41370,2016,Diciembre,Venezuela,14,28,,42,-76.532004,3.451668
41371,2016,Diciembre,Venezuela,40,38,,78,-67.927521,3.866713
41372,2016,Diciembre,Venezuela,4172,4077,,8249,-74.140516,4.697157
41373,2016,Diciembre,Venezuela,4,7,,11,-75.736374,4.815189
41374,2016,Diciembre,Venezuela,705,703,,1408,-75.42726,6.170465
41375,2016,Diciembre,Venezuela,415,580,,995,-67.48402800000001,6.185536
41376,2016,Diciembre,Venezuela,118,165,,283,-70.74025300000001,7.088728999999999
41377,2016,Diciembre,Venezuela,5,9,,14,-73.181317,7.1280470000000005
41378,2016,Diciembre,Venezuela,8818,8976,,17794,-72.453013,7.819
41379,2016,Diciembre,Venezuela,1,1,,2,-72.508188,7.927233
41380,2016,Diciembre,Venezuela,155,163,,318,-72.409396,8.36068
41381,2016,Diciembre,Vietnam,0,3,,3,-76.532004,3.451668
41382,2016,Diciembre,República Árabe de Yemen,1,0,,1,-74.140516,4.697157
41383,2016,Diciembre,Desconocido,267,958,,1225,-74.140516,4.697157
41384,2017,Enero,Afganistán,1,0,,1,-75.516486,10.446304
41385,2017,Enero,Afganistán,1,0,,1,-74.140516,4.697157
41386,2017,Enero,Albania,1,1,,2,-74.140516,4.697157
41387,2017,Enero,Alemania,0,1,,1,-77.35600000000001,0.81488
41388,2017,Enero,Alemania,0,1,,1,-75.527794,10.406342
41389,2017,Enero,Alemania,2,2,,4,-75.516486,10.446304
41390,2017,Enero,Alemania,7,9,,16,-74.77647900000001,10.886686
41391,2017,Enero,Alemania,0,2,,2,-81.70216500000001,12.5862
41392,2017,Enero,Alemania,28,46,,74,-76.532004,3.451668
41393,2017,Enero,Alemania,1298,1964,,3262,-74.140516,4.697157
41394,2017,Enero,Alemania,1,5,,6,-75.736374,4.815189
41395,2017,Enero,Alemania,41,62,,103,-75.42726,6.170465
41396,2017,Enero,Alemania,1,1,,2,-73.181317,7.1280470000000005
41397,2017,Enero,Antigua y Barbuda,0,2,,2,-75.527794,10.406342
41398,2017,Enero,Antigua y Barbuda,0,3,,3,-74.140516,4.697157
41399,2017,Enero,Países Bajos,16,30,,46,-75.527794,10.406342
41400,2017,Enero,Países Bajos,1,5,,6,-75.516486,10.446304
41401,2017,Enero,Países Bajos,76,106,,182,-74.77647900000001,10.886686
41402,2017,Enero,Países Bajos,31,60,,91,-74.213989,11.247722999999999
41403,2017,Enero,Países Bajos,106,193,,299,-76.532004,3.451668
41404,2017,Enero,Países Bajos,1,0,,1,-75.76635300000001,4.45285
41405,2017,Enero,Países Bajos,944,1280,,2224,-74.140516,4.697157
41406,2017,Enero,Países Bajos,1,5,,6,-75.736374,4.815189
41407,2017,Enero,Países Bajos,166,248,,414,-75.42726,6.170465
41408,2017,Enero,Arabia Saudita,0,1,,1,-74.140516,4.697157
41409,2017,Enero,Argelia,4,5,,9,-74.140516,4.697157
41410,2017,Enero,Argelia,0,1,,1,-75.42726,6.170465
41411,2017,Enero,Argentina,1,6,,7,-69.941498,4.191162
41412,2017,Enero,Argentina,9,15,,24,-77.35600000000001,0.81488
41413,2017,Enero,Argentina,59,54,,113,-75.516486,10.446304
41414,2017,Enero,Argentina,7,10,,17,-74.77647900000001,10.886686
41415,2017,Enero,Argentina,380,276,,656,-81.70216500000001,12.5862
41416,2017,Enero,Argentina,68,59,,127,-76.532004,3.451668
41417,2017,Enero,Argentina,5509,5558,,11067,-74.140516,4.697157
41418,2017,Enero,Argentina,2,5,,7,-75.736374,4.815189
41419,2017,Enero,Argentina,94,119,,213,-75.42726,6.170465
41420,2017,Enero,Argentina,0,1,,1,-73.181317,7.1280470000000005
41421,2017,Enero,República de Armenia,1,0,,1,-74.140516,4.697157
41422,2017,Enero,Aruba,12,27,,39,-75.527794,10.406342
41423,2017,Enero,Aruba,3,1,,4,-75.516486,10.446304
41424,2017,Enero,Aruba,2,1,,3,-74.765343,10.970933
41425,2017,Enero,Aruba,12,12,,24,-74.213989,11.247722999999999
41426,2017,Enero,Aruba,6,2,,8,-76.532004,3.451668
41427,2017,Enero,Aruba,715,756,,1471,-74.140516,4.697157
41428,2017,Enero,Aruba,38,55,,93,-75.42726,6.170465
41429,2017,Enero,Aruba,10,13,,23,-73.181317,7.1280470000000005
41430,2017,Enero,Australia,1,1,,2,-75.516486,10.446304
41431,2017,Enero,Australia,3,2,,5,-74.77647900000001,10.886686
41432,2017,Enero,Australia,1,0,,1,-81.70216500000001,12.5862
41433,2017,Enero,Australia,1,2,,3,-76.532004,3.451668
41434,2017,Enero,Australia,40,41,,81,-74.140516,4.697157
41435,2017,Enero,Australia,8,30,,38,-75.42726,6.170465
41436,2017,Enero,Austria,0,3,,3,-76.532004,3.451668
41437,2017,Enero,Austria,22,37,,59,-74.140516,4.697157
41438,2017,Enero,Austria,5,9,,14,-75.42726,6.170465
41439,2017,Enero,Azerbaiyán,1,1,,2,-74.140516,4.697157
41440,2017,Enero,Bahamas,2,11,,13,-75.527794,10.406342
41441,2017,Enero,Bahamas,1,2,,3,-75.516486,10.446304
41442,2017,Enero,Bahamas,0,1,,1,-74.140516,4.697157
41443,2017,Enero,Bahamas,1,0,,1,-75.736374,4.815189
41444,2017,Enero,Bahamas,2,3,,5,-75.42726,6.170465
41445,2017,Enero,Bahréin,1,0,,1,-75.516486,10.446304
41446,2017,Enero,Bahréin,0,2,,2,-74.140516,4.697157
41447,2017,Enero,Barbados,41,63,,104,-74.140516,4.697157
41448,2017,Enero,República de Belarús,1,0,,1,-76.532004,3.451668
41449,2017,Enero,República de Belarús,5,3,,8,-74.140516,4.697157
41450,2017,Enero,República de Belarús,2,1,,3,-72.453013,7.819
41451,2017,Enero,Bélgica,4,9,,13,-76.532004,3.451668
41452,2017,Enero,Bélgica,42,65,,107,-74.140516,4.697157
41453,2017,Enero,Bélgica,6,9,,15,-75.42726,6.170465
41454,2017,Enero,Bélgica,0,1,,1,-73.181317,7.1280470000000005
41455,2017,Enero,Bélgica,0,1,,1,-72.453013,7.819
41456,2017,Enero,Belice,1,1,,2,-74.140516,4.697157
41457,2017,Enero,Belice,0,5,,5,-75.42726,6.170465
41458,2017,Enero,Benín,1,1,,2,-74.140516,4.697157
41459,2017,Enero,Bolivia,0,1,,1,-77.35600000000001,0.81488
41460,2017,Enero,Bolivia,1,4,,5,-75.516486,10.446304
41461,2017,Enero,Bolivia,47,32,,79,-81.70216500000001,12.5862
41462,2017,Enero,Bolivia,23,28,,51,-76.532004,3.451668
41463,2017,Enero,Bolivia,500,529,,1029,-74.140516,4.697157
41464,2017,Enero,Bolivia,1,0,,1,-75.736374,4.815189
41465,2017,Enero,Bolivia,31,29,,60,-75.42726,6.170465
41466,2017,Enero,Brasil,276,292,,568,-69.941498,4.191162
41467,2017,Enero,Brasil,1,2,,3,-77.35600000000001,0.81488
41468,2017,Enero,Brasil,0,5,,5,-75.527794,10.406342
41469,2017,Enero,Brasil,53,19,,72,-75.516486,10.446304
41470,2017,Enero,Brasil,2,5,,7,-74.77647900000001,10.886686
41471,2017,Enero,Brasil,391,307,,698,-81.70216500000001,12.5862
41472,2017,Enero,Brasil,96,116,,212,-76.532004,3.451668
41473,2017,Enero,Brasil,0,1,,1,-67.927521,3.866713
41474,2017,Enero,Brasil,5105,6086,,11191,-74.140516,4.697157
41475,2017,Enero,Brasil,3,1,,4,-75.736374,4.815189
41476,2017,Enero,Brasil,157,205,,362,-75.42726,6.170465
41477,2017,Enero,Brasil,0,1,,1,-73.181317,7.1280470000000005
41478,2017,Enero,Bulgaria,1,1,,2,-74.140516,4.697157
41479,2017,Enero,Cabo Verde,1,0,,1,-74.140516,4.697157
41480,2017,Enero,Islas Caimán/Territorio Británico de Ultramar,4,5,,9,-75.527794,10.406342
41481,2017,Enero,Islas Caimán/Territorio Británico de Ultramar,1,0,,1,-74.77647900000001,10.886686
41482,2017,Enero,Islas Caimán/Territorio Británico de Ultramar,1,7,,8,-81.70216500000001,12.5862
41483,2017,Enero,Islas Caimán/Territorio Británico de Ultramar,0,3,,3,-74.140516,4.697157
41484,2017,Enero,Canadá,539,563,,1102,-75.516486,10.446304
41485,2017,Enero,Canadá,6,7,,13,-74.77647900000001,10.886686
41486,2017,Enero,Canadá,332,292,,624,-81.70216500000001,12.5862
41487,2017,Enero,Canadá,38,59,,97,-76.532004,3.451668
41488,2017,Enero,Canadá,799,1092,,1891,-74.140516,4.697157
41489,2017,Enero,Canadá,4,8,,12,-75.736374,4.815189
41490,2017,Enero,Canadá,113,205,,318,-75.42726,6.170465
41491,2017,Enero,Canadá,4,10,,14,-73.181317,7.1280470000000005
41492,2017,Enero,Chad,0,1,,1,-74.140516,4.697157
41493,2017,Enero,España,0,8,,8,-75.527794,10.406342
41494,2017,Enero,España,1,6,,7,-75.516486,10.446304
41495,2017,Enero,España,4,8,,12,-74.77647900000001,10.886686
41496,2017,Enero,España,0,3,,3,-74.765343,10.970933
41497,2017,Enero,España,581,832,,1413,-76.532004,3.451668
41498,2017,Enero,España,0,1,,1,-77.061029,3.8844260000000004
41499,2017,Enero,España,4315,7147,,11462,-74.140516,4.697157
41500,2017,Enero,España,3,9,,12,-75.736374,4.815189
41501,2017,Enero,España,348,696,,1044,-75.42726,6.170465
41502,2017,Enero,España,1,0,,1,-73.181317,7.1280470000000005
41503,2017,Enero,República de Corea,3,0,,3,-75.516486,10.446304
41504,2017,Enero,República de Corea,15,18,,33,-74.140516,4.697157
41505,2017,Enero,República de Corea,0,1,,1,-75.736374,4.815189
41506,2017,Enero,República de Corea,8,8,,16,-75.42726,6.170465
41507,2017,Enero,Costa de Marfil,0,2,,2,-76.532004,3.451668
41508,2017,Enero,Costa de Marfil,5,3,,8,-74.140516,4.697157
41509,2017,Enero,Costa Rica,4,13,,17,-75.527794,10.406342
41510,2017,Enero,Costa Rica,8,8,,16,-75.516486,10.446304
41511,2017,Enero,Costa Rica,8,15,,23,-74.77647900000001,10.886686
41512,2017,Enero,Costa Rica,0,3,,3,-74.232675,11.117206
41513,2017,Enero,Costa Rica,0,1,,1,-81.703935,12.574411099999999
41514,2017,Enero,Costa Rica,242,177,,419,-81.70216500000001,12.5862
41515,2017,Enero,Costa Rica,19,54,,73,-76.532004,3.451668
41516,2017,Enero,Costa Rica,1227,1495,,2722,-74.140516,4.697157
41517,2017,Enero,Costa Rica,8,11,,19,-75.736374,4.815189
41518,2017,Enero,Costa Rica,100,147,,247,-75.42726,6.170465
41519,2017,Enero,Costa Rica,4,4,,8,-73.181317,7.1280470000000005
41520,2017,Enero,Croacia,0,2,,2,-76.532004,3.451668
41521,2017,Enero,Croacia,2,2,,4,-74.140516,4.697157
41522,2017,Enero,Croacia,0,1,,1,-75.42726,6.170465
41523,2017,Enero,Cuba,1,3,,4,-75.527794,10.406342
41524,2017,Enero,Cuba,0,1,,1,-75.516486,10.446304
41525,2017,Enero,Cuba,8,9,,17,-74.77647900000001,10.886686
41526,2017,Enero,Cuba,1,3,,4,-81.372937,13.338761300000002
41527,2017,Enero,Cuba,13,28,,41,-76.532004,3.451668
41528,2017,Enero,Cuba,428,777,,1205,-74.140516,4.697157
41529,2017,Enero,Cuba,2,3,,5,-75.736374,4.815189
41530,2017,Enero,Cuba,19,21,,40,-75.42726,6.170465
41531,2017,Enero,Cuba,1,6,,7,-73.181317,7.1280470000000005
41532,2017,Enero,Curazao,0,1,,1,-75.516486,10.446304
41533,2017,Enero,Curazao,0,10,,10,-74.140516,4.697157
41534,2017,Enero,República Checa,2,2,,4,-75.516486,10.446304
41535,2017,Enero,República Checa,0,1,,1,-76.532004,3.451668
41536,2017,Enero,República Checa,11,11,,22,-74.140516,4.697157
41537,2017,Enero,República Checa,0,1,,1,-75.42726,6.170465
41538,2017,Enero,Chile,5,6,,11,-77.35600000000001,0.81488
41539,2017,Enero,Chile,2,0,,2,-78.802679,18.00143
41540,2017,Enero,Chile,18,16,,34,-75.516486,10.446304
41541,2017,Enero,Chile,12,13,,25,-74.77647900000001,10.886686
41542,2017,Enero,Chile,1,1,,2,-74.232675,11.117206
41543,2017,Enero,Chile,102,67,,169,-81.70216500000001,12.5862
41544,2017,Enero,Chile,51,57,,108,-76.532004,3.451668
41545,2017,Enero,Chile,5323,5897,,11220,-74.140516,4.697157
41546,2017,Enero,Chile,1,5,,6,-75.736374,4.815189
41547,2017,Enero,Chile,46,50,,96,-75.42726,6.170465
41548,2017,Enero,Chile,1,1,,2,-73.181317,7.1280470000000005
41549,2017,Enero,China,0,1,,1,-75.527794,10.406342
41550,2017,Enero,China,2,1,,3,-76.532004,3.451668
41551,2017,Enero,China,0,1,,1,-77.061029,3.8844260000000004
41552,2017,Enero,China,31,67,,98,-74.140516,4.697157
41553,2017,Enero,China,5,4,,9,-75.42726,6.170465
41554,2017,Enero,Dinamarca,3,2,,5,-74.77647900000001,10.886686
41555,2017,Enero,Dinamarca,0,2,,2,-76.532004,3.451668
41556,2017,Enero,Dinamarca,21,39,,60,-74.140516,4.697157
41557,2017,Enero,Dinamarca,6,5,,11,-75.42726,6.170465
41558,2017,Enero,Dominica,0,1,,1,-74.140516,4.697157
41559,2017,Enero,Dominica,0,1,,1,-75.42726,6.170465
41560,2017,Enero,Ecuador,91,305,,396,-76.876446,0.33002
41561,2017,Enero,Ecuador,3,1,,4,-77.84700600000001,0.8124359999999999
41562,2017,Enero,Ecuador,3698,5501,,9199,-77.35600000000001,0.81488
41563,2017,Enero,Ecuador,26,55,,81,-78.802679,18.00143
41564,2017,Enero,Ecuador,0,2,,2,-75.527794,10.406342
41565,2017,Enero,Ecuador,0,1,,1,-75.516486,10.446304
41566,2017,Enero,Ecuador,0,7,,7,-74.77647900000001,10.886686
41567,2017,Enero,Ecuador,1,0,,1,-81.70216500000001,12.5862
41568,2017,Enero,Ecuador,285,386,,671,-76.532004,3.451668
41569,2017,Enero,Ecuador,3018,4380,,7398,-74.140516,4.697157
41570,2017,Enero,Ecuador,0,2,,2,-75.736374,4.815189
41571,2017,Enero,Ecuador,52,86,,138,-75.42726,6.170465
41572,2017,Enero,Ecuador,1,2,,3,-73.181317,7.1280470000000005
41573,2017,Enero,Ecuador,0,1,,1,-72.453013,7.819
41574,2017,Enero,Egipto,1,0,,1,-74.77647900000001,10.886686
41575,2017,Enero,Egipto,0,2,,2,-74.140516,4.697157
41576,2017,Enero,El Salvador,3,10,,13,-75.516486,10.446304
41577,2017,Enero,El Salvador,2,2,,4,-74.77647900000001,10.886686
41578,2017,Enero,El Salvador,8,3,,11,-81.70216500000001,12.5862
41579,2017,Enero,El Salvador,126,173,,299,-76.532004,3.451668
41580,2017,Enero,El Salvador,982,1269,,2251,-74.140516,4.697157
41581,2017,Enero,El Salvador,0,1,,1,-75.736374,4.815189
41582,2017,Enero,El Salvador,138,227,,365,-75.42726,6.170465
41583,2017,Enero,El Salvador,1,0,,1,-73.181317,7.1280470000000005
41584,2017,Enero,Emiratos Árabes,1,1,,2,-75.516486,10.446304
41585,2017,Enero,Emiratos Árabes,1,0,,1,-76.532004,3.451668
41586,2017,Enero,Emiratos Árabes,1,2,,3,-74.140516,4.697157
41587,2017,Enero,Eslovaquia,0,4,,4,-76.532004,3.451668
41588,2017,Enero,Eslovaquia,13,9,,22,-74.140516,4.697157
41589,2017,Enero,Eslovaquia,2,0,,2,-75.42726,6.170465
41590,2017,Enero,Eslovenia,1,3,,4,-74.140516,4.697157
41591,2017,Enero,Eslovenia,0,1,,1,-75.42726,6.170465
41592,2017,Enero,Estados Unidos de América,6,29,,35,-75.527794,10.406342
41593,2017,Enero,Estados Unidos de América,2727,4016,,6743,-75.516486,10.446304
41594,2017,Enero,Estados Unidos de América,446,721,,1167,-74.77647900000001,10.886686
41595,2017,Enero,Estados Unidos de América,0,9,,9,-74.765343,10.970933
41596,2017,Enero,Estados Unidos de América,1,19,,20,-74.213989,11.247722999999999
41597,2017,Enero,Estados Unidos de América,22,30,,52,-81.70216500000001,12.5862
41598,2017,Enero,Estados Unidos de América,837,1271,,2108,-76.532004,3.451668
41599,2017,Enero,Estados Unidos de América,0,3,,3,-77.061029,3.8844260000000004
41600,2017,Enero,Estados Unidos de América,66,107,,173,-75.76635300000001,4.45285
41601,2017,Enero,Estados Unidos de América,7848,12908,,20756,-74.140516,4.697157
41602,2017,Enero,Estados Unidos de América,104,172,,276,-75.736374,4.815189
41603,2017,Enero,Estados Unidos de América,1692,4135,,5827,-75.42726,6.170465
41604,2017,Enero,Estados Unidos de América,23,42,,65,-73.181317,7.1280470000000005
41605,2017,Enero,Estados Unidos de América,0,6,,6,-75.68164200000001,9.402597
41606,2017,Enero,Estonia,1,2,,3,-74.140516,4.697157
41607,2017,Enero,Etiopia,0,1,,1,-74.140516,4.697157
41608,2017,Enero,Filipinas,0,1,,1,-75.516486,10.446304
41609,2017,Enero,Filipinas,0,3,,3,-74.77647900000001,10.886686
41610,2017,Enero,Filipinas,0,5,,5,-76.532004,3.451668
41611,2017,Enero,Filipinas,0,2,,2,-74.140516,4.697157
41612,2017,Enero,Filipinas,1,1,,2,-75.42726,6.170465
41613,2017,Enero,Finlandia,0,1,,1,-76.532004,3.451668
41614,2017,Enero,Finlandia,9,15,,24,-74.140516,4.697157
41615,2017,Enero,Finlandia,0,1,,1,-75.736374,4.815189
41616,2017,Enero,Francia,1,4,,5,-75.516486,10.446304
41617,2017,Enero,Francia,3,6,,9,-74.77647900000001,10.886686
41618,2017,Enero,Francia,0,1,,1,-74.213989,11.247722999999999
41619,2017,Enero,Francia,37,76,,113,-76.532004,3.451668
41620,2017,Enero,Francia,1558,2511,,4069,-74.140516,4.697157
41621,2017,Enero,Francia,1,3,,4,-75.736374,4.815189
41622,2017,Enero,Francia,39,74,,113,-75.42726,6.170465
41623,2017,Enero,Georgia,0,1,,1,-74.140516,4.697157
41624,2017,Enero,Gibraltar/Territorio Británico de Ultramar,9,3,,12,-77.35600000000001,0.81488
41625,2017,Enero,Gibraltar/Territorio Británico de Ultramar,0,3,,3,-74.213989,11.247722999999999
41626,2017,Enero,Granada,0,1,,1,-74.213989,11.247722999999999
41627,2017,Enero,Granada,1,1,,2,-74.140516,4.697157
41628,2017,Enero,Grecia,0,1,,1,-76.532004,3.451668
41629,2017,Enero,Grecia,4,10,,14,-74.140516,4.697157
41630,2017,Enero,Grecia,0,1,,1,-73.181317,7.1280470000000005
41631,2017,Enero,Guatemala,8,9,,17,-75.516486,10.446304
41632,2017,Enero,Guatemala,6,9,,15,-74.77647900000001,10.886686
41633,2017,Enero,Guatemala,2,3,,5,-74.232675,11.117206
41634,2017,Enero,Guatemala,6,9,,15,-81.70216500000001,12.5862
41635,2017,Enero,Guatemala,1,1,,2,-81.372937,13.338761300000002
41636,2017,Enero,Guatemala,30,49,,79,-76.532004,3.451668
41637,2017,Enero,Guatemala,266,523,,789,-74.140516,4.697157
41638,2017,Enero,Guatemala,0,4,,4,-75.736374,4.815189
41639,2017,Enero,Guatemala,45,92,,137,-75.42726,6.170465
41640,2017,Enero,Guatemala,3,0,,3,-73.181317,7.1280470000000005
41641,2017,Enero,Guyana,2,0,,2,-76.532004,3.451668
41642,2017,Enero,Guyana,0,1,,1,-74.140516,4.697157
41643,2017,Enero,Guyana,0,1,,1,-75.42726,6.170465
41644,2017,Enero,Guadalupe/Territorio Francés,2,5,,7,-74.140516,4.697157
41645,2017,Enero,Guayana Francesa/Departamento de Ultramar Francés,0,1,,1,-75.42726,6.170465
41646,2017,Enero,Haití,0,1,,1,-76.532004,3.451668
41647,2017,Enero,Haití,2,3,,5,-74.140516,4.697157
41648,2017,Enero,Haití,1,0,,1,-73.181317,7.1280470000000005
41649,2017,Enero,Honduras,0,1,,1,-75.527794,10.406342
41650,2017,Enero,Honduras,1,2,,3,-75.516486,10.446304
41651,2017,Enero,Honduras,1,2,,3,-74.77647900000001,10.886686
41652,2017,Enero,Honduras,1,0,,1,-74.232675,11.117206
41653,2017,Enero,Honduras,8,16,,24,-81.372937,13.338761300000002
41654,2017,Enero,Honduras,8,16,,24,-76.532004,3.451668
41655,2017,Enero,Honduras,46,73,,119,-74.140516,4.697157
41656,2017,Enero,Honduras,1,4,,5,-75.736374,4.815189
41657,2017,Enero,Honduras,31,61,,92,-75.42726,6.170465
41658,2017,Enero,Honduras,1,0,,1,-73.181317,7.1280470000000005
41659,2017,Enero,Hong Kong,3,4,,7,-74.140516,4.697157
41660,2017,Enero,Hungría,1,0,,1,-76.532004,3.451668
41661,2017,Enero,Hungría,5,7,,12,-74.140516,4.697157
41662,2017,Enero,Hungría,0,1,,1,-75.42726,6.170465
41663,2017,Enero,India,0,1,,1,-74.77647900000001,10.886686
41664,2017,Enero,India,2,3,,5,-76.532004,3.451668
41665,2017,Enero,India,5,39,,44,-74.140516,4.697157
41666,2017,Enero,India,1,20,,21,-75.42726,6.170465
41667,2017,Enero,Indonesia,0,1,,1,-76.532004,3.451668
41668,2017,Enero,Indonesia,5,3,,8,-74.140516,4.697157
41669,2017,Enero,Iraq,0,2,,2,-74.140516,4.697157
41670,2017,Enero,Irán,1,0,,1,-74.140516,4.697157
41671,2017,Enero,República de Irlanda,0,1,,1,-74.77647900000001,10.886686
41672,2017,Enero,República de Irlanda,1,1,,2,-76.532004,3.451668
41673,2017,Enero,República de Irlanda,10,15,,25,-74.140516,4.697157
41674,2017,Enero,República de Irlanda,4,4,,8,-75.42726,6.170465
41675,2017,Enero,República de Irlanda,0,1,,1,-73.181317,7.1280470000000005
41676,2017,Enero,Islandia,0,2,,2,-74.140516,4.697157
41677,2017,Enero,Islandia,0,1,,1,-75.42726,6.170465
41678,2017,Enero,Israel,2,2,,4,-75.516486,10.446304
41679,2017,Enero,Israel,0,4,,4,-76.532004,3.451668
41680,2017,Enero,Israel,14,53,,67,-74.140516,4.697157
41681,2017,Enero,Israel,3,9,,12,-75.42726,6.170465
41682,2017,Enero,Italia,2,3,,5,-75.516486,10.446304
41683,2017,Enero,Italia,0,7,,7,-74.77647900000001,10.886686
41684,2017,Enero,Italia,1,1,,2,-81.70216500000001,12.5862
41685,2017,Enero,Italia,11,44,,55,-76.532004,3.451668
41686,2017,Enero,Italia,168,392,,560,-74.140516,4.697157
41687,2017,Enero,Italia,0,8,,8,-75.736374,4.815189
41688,2017,Enero,Italia,29,76,,105,-75.42726,6.170465
41689,2017,Enero,Italia,0,1,,1,-73.181317,7.1280470000000005
41690,2017,Enero,Jamaica,35,34,,69,-75.527794,10.406342
41691,2017,Enero,Jamaica,1,1,,2,-74.77647900000001,10.886686
41692,2017,Enero,Jamaica,1,2,,3,-81.703935,12.574411099999999
41693,2017,Enero,Jamaica,1,1,,2,-81.70216500000001,12.5862
41694,2017,Enero,Jamaica,0,3,,3,-81.372937,13.338761300000002
41695,2017,Enero,Jamaica,5,4,,9,-76.532004,3.451668
41696,2017,Enero,Jamaica,3,10,,13,-74.140516,4.697157
41697,2017,Enero,Jamaica,1,3,,4,-75.42726,6.170465
41698,2017,Enero,Japón,1,1,,2,-76.532004,3.451668
41699,2017,Enero,Japón,12,29,,41,-74.140516,4.697157
41700,2017,Enero,Japón,1,9,,10,-75.42726,6.170465
41701,2017,Enero,Kenia,1,1,,2,-74.140516,4.697157
41702,2017,Enero,Kiribati,0,1,,1,-75.516486,10.446304
41703,2017,Enero,Kuwait,0,1,,1,-74.140516,4.697157
41704,2017,Enero,Letonia,2,2,,4,-74.140516,4.697157
41705,2017,Enero,Lituania,5,4,,9,-74.140516,4.697157
41706,2017,Enero,Lituania,1,0,,1,-75.42726,6.170465
41707,2017,Enero,Líbano,3,4,,7,-74.140516,4.697157
41708,2017,Enero,Liechtenstein,0,1,,1,-74.140516,4.697157
41709,2017,Enero,Luxemburgo,2,2,,4,-74.140516,4.697157
41710,2017,Enero,Luxemburgo,0,1,,1,-75.42726,6.170465
41711,2017,Enero,Malasia,1,0,,1,-74.140516,4.697157
41712,2017,Enero,Malta,0,1,,1,-74.140516,4.697157
41713,2017,Enero,Marruecos,0,2,,2,-75.527794,10.406342
41714,2017,Enero,Marruecos,0,1,,1,-74.140516,4.697157
41715,2017,Enero,Marruecos,2,4,,6,-75.42726,6.170465
41716,2017,Enero,Mauricio,0,1,,1,-74.140516,4.697157
41717,2017,Enero,Martinica/Departamento de Ultramar Francés,0,5,,5,-74.213989,11.247722999999999
41718,2017,Enero,Martinica/Departamento de Ultramar Francés,0,2,,2,-74.140516,4.697157
41719,2017,Enero,México,0,5,,5,-75.527794,10.406342
41720,2017,Enero,México,6,12,,18,-75.516486,10.446304
41721,2017,Enero,México,18,30,,48,-74.77647900000001,10.886686
41722,2017,Enero,México,0,1,,1,-74.765343,10.970933
41723,2017,Enero,México,0,1,,1,-74.213989,11.247722999999999
41724,2017,Enero,México,1,0,,1,-81.703935,12.574411099999999
41725,2017,Enero,México,1,1,,2,-81.70216500000001,12.5862
41726,2017,Enero,México,56,169,,225,-76.532004,3.451668
41727,2017,Enero,México,4853,7477,,12330,-74.140516,4.697157
41728,2017,Enero,México,6,19,,25,-75.736374,4.815189
41729,2017,Enero,México,446,1069,,1515,-75.42726,6.170465
41730,2017,Enero,México,5,8,,13,-73.181317,7.1280470000000005
41731,2017,Enero,México,0,1,,1,-72.453013,7.819
41732,2017,Enero,Mónaco,0,1,,1,-75.42726,6.170465
41733,2017,Enero,Nicaragua,2,0,,2,-75.516486,10.446304
41734,2017,Enero,Nicaragua,1,1,,2,-74.77647900000001,10.886686
41735,2017,Enero,Nicaragua,1,1,,2,-81.70216500000001,12.5862
41736,2017,Enero,Nicaragua,21,27,,48,-76.532004,3.451668
41737,2017,Enero,Nicaragua,35,47,,82,-74.140516,4.697157
41738,2017,Enero,Nicaragua,9,15,,24,-75.736374,4.815189
41739,2017,Enero,Nicaragua,11,24,,35,-75.42726,6.170465
41740,2017,Enero,Nicaragua,1,1,,2,-73.181317,7.1280470000000005
41741,2017,Enero,Nigeria,1,1,,2,-74.140516,4.697157
41742,2017,Enero,Noruega,1,2,,3,-74.77647900000001,10.886686
41743,2017,Enero,Noruega,1,4,,5,-76.532004,3.451668
41744,2017,Enero,Noruega,11,20,,31,-74.140516,4.697157
41745,2017,Enero,Noruega,2,4,,6,-75.42726,6.170465
41746,2017,Enero,Nueva Zelanda,2,2,,4,-74.140516,4.697157
41747,2017,Enero,Nueva Zelanda,2,3,,5,-75.42726,6.170465
41748,2017,Enero,Nueva Zelanda,0,2,,2,-73.181317,7.1280470000000005
41749,2017,Enero,Papúa Nueva Guinea,2,3,,5,-75.516486,10.446304
41750,2017,Enero,Pakistán,0,1,,1,-75.42726,6.170465
41751,2017,Enero,Panamá,901,821,,1722,-75.527794,10.406342
41752,2017,Enero,Panamá,3949,4242,,8191,-75.516486,10.446304
41753,2017,Enero,Panamá,328,602,,930,-74.77647900000001,10.886686
41754,2017,Enero,Panamá,0,10,,10,-74.765343,10.970933
41755,2017,Enero,Panamá,0,1,,1,-74.232675,11.117206
41756,2017,Enero,Panamá,7,16,,23,-81.703935,12.574411099999999
41757,2017,Enero,Panamá,739,597,,1336,-81.70216500000001,12.5862
41758,2017,Enero,Panamá,10,11,,21,-81.372937,13.338761300000002
41759,2017,Enero,Panamá,415,554,,969,-76.532004,3.451668
41760,2017,Enero,Panamá,0,54,,54,-77.061029,3.8844260000000004
41761,2017,Enero,Panamá,46,85,,131,-75.76635300000001,4.45285
41762,2017,Enero,Panamá,4027,5713,,9740,-74.140516,4.697157
41763,2017,Enero,Panamá,68,113,,181,-75.736374,4.815189
41764,2017,Enero,Panamá,2474,3065,,5539,-75.42726,6.170465
41765,2017,Enero,Panamá,3,4,,7,-77.401154,6.222551999999999
41766,2017,Enero,Panamá,4,9,,13,-77.762647,7.102626
41767,2017,Enero,Panamá,13,26,,39,-73.181317,7.1280470000000005
41768,2017,Enero,Panamá,114,143,,257,-77.35002,8.63337
41769,2017,Enero,Panamá,9,2,,11,-75.68164200000001,9.402597
41770,2017,Enero,Paraguay,6,3,,9,-75.516486,10.446304
41771,2017,Enero,Paraguay,4,2,,6,-74.77647900000001,10.886686
41772,2017,Enero,Paraguay,113,65,,178,-81.70216500000001,12.5862
41773,2017,Enero,Paraguay,4,6,,10,-76.532004,3.451668
41774,2017,Enero,Paraguay,77,94,,171,-74.140516,4.697157
41775,2017,Enero,Paraguay,2,1,,3,-75.736374,4.815189
41776,2017,Enero,Paraguay,10,17,,27,-75.42726,6.170465
41777,2017,Enero,Perú,126,200,,326,-69.941498,4.191162
41778,2017,Enero,Perú,8,22,,30,-77.35600000000001,0.81488
41779,2017,Enero,Perú,1310,952,,2262,-75.516486,10.446304
41780,2017,Enero,Perú,14,13,,27,-74.77647900000001,10.886686
41781,2017,Enero,Perú,246,166,,412,-81.70216500000001,12.5862
41782,2017,Enero,Perú,372,477,,849,-76.532004,3.451668
41783,2017,Enero,Perú,0,3,,3,-77.061029,3.8844260000000004
41784,2017,Enero,Perú,5768,7080,,12848,-74.140516,4.697157
41785,2017,Enero,Perú,3,5,,8,-75.736374,4.815189
41786,2017,Enero,Perú,532,844,,1376,-75.42726,6.170465
41787,2017,Enero,Perú,2,7,,9,-73.181317,7.1280470000000005
41788,2017,Enero,Polonia,1,1,,2,-75.516486,10.446304
41789,2017,Enero,Polonia,3,6,,9,-76.532004,3.451668
41790,2017,Enero,Polonia,19,21,,40,-74.140516,4.697157
41791,2017,Enero,Polonia,0,4,,4,-75.736374,4.815189
41792,2017,Enero,Polonia,1,6,,7,-75.42726,6.170465
41793,2017,Enero,Portugal,0,1,,1,-74.77647900000001,10.886686
41794,2017,Enero,Portugal,3,8,,11,-76.532004,3.451668
41795,2017,Enero,Portugal,36,85,,121,-74.140516,4.697157
41796,2017,Enero,Portugal,1,13,,14,-75.42726,6.170465
41797,2017,Enero,Puerto Rico/Territorio de Estados Unidos,0,2,,2,-75.527794,10.406342
41798,2017,Enero,Puerto Rico/Territorio de Estados Unidos,2,8,,10,-75.516486,10.446304
41799,2017,Enero,Puerto Rico/Territorio de Estados Unidos,3,43,,46,-74.77647900000001,10.886686
41800,2017,Enero,Puerto Rico/Territorio de Estados Unidos,16,37,,53,-76.532004,3.451668
41801,2017,Enero,Puerto Rico/Territorio de Estados Unidos,306,409,,715,-74.140516,4.697157
41802,2017,Enero,Puerto Rico/Territorio de Estados Unidos,2,5,,7,-75.736374,4.815189
41803,2017,Enero,Puerto Rico/Territorio de Estados Unidos,54,81,,135,-75.42726,6.170465
41804,2017,Enero,Puerto Rico/Territorio de Estados Unidos,1,2,,3,-73.181317,7.1280470000000005
41805,2017,Enero,Reino Unido de Gran Bretaña e Irlanda del Norte,2,1,,3,-75.516486,10.446304
41806,2017,Enero,Reino Unido de Gran Bretaña e Irlanda del Norte,0,1,,1,-74.77647900000001,10.886686
41807,2017,Enero,Reino Unido de Gran Bretaña e Irlanda del Norte,0,1,,1,-74.765343,10.970933
41808,2017,Enero,Reino Unido de Gran Bretaña e Irlanda del Norte,1,4,,5,-74.232675,11.117206
41809,2017,Enero,Reino Unido de Gran Bretaña e Irlanda del Norte,10,24,,34,-76.532004,3.451668
41810,2017,Enero,Reino Unido de Gran Bretaña e Irlanda del Norte,1012,1587,,2599,-74.140516,4.697157
41811,2017,Enero,Reino Unido de Gran Bretaña e Irlanda del Norte,15,42,,57,-75.42726,6.170465
41812,2017,Enero,Reino Unido de Gran Bretaña e Irlanda del Norte,1,0,,1,-73.181317,7.1280470000000005
41813,2017,Enero,República CentroÁfricana,1,0,,1,-74.140516,4.697157
41814,2017,Enero,Federación de Rusia,1,1,,2,-74.77647900000001,10.886686
41815,2017,Enero,Federación de Rusia,3,8,,11,-76.532004,3.451668
41816,2017,Enero,Federación de Rusia,29,59,,88,-74.140516,4.697157
41817,2017,Enero,Federación de Rusia,2,0,,2,-75.42726,6.170465
41818,2017,Enero,República Dominicana,1,3,,4,-69.941498,4.191162
41819,2017,Enero,República Dominicana,1,4,,5,-75.527794,10.406342
41820,2017,Enero,República Dominicana,5,21,,26,-75.516486,10.446304
41821,2017,Enero,República Dominicana,7,20,,27,-74.77647900000001,10.886686
41822,2017,Enero,República Dominicana,0,1,,1,-74.765343,10.970933
41823,2017,Enero,República Dominicana,0,2,,2,-74.213989,11.247722999999999
41824,2017,Enero,República Dominicana,0,1,,1,-81.70216500000001,12.5862
41825,2017,Enero,República Dominicana,18,25,,43,-76.532004,3.451668
41826,2017,Enero,República Dominicana,713,981,,1694,-74.140516,4.697157
41827,2017,Enero,República Dominicana,3,25,,28,-75.736374,4.815189
41828,2017,Enero,República Dominicana,58,89,,147,-75.42726,6.170465
41829,2017,Enero,República Dominicana,4,8,,12,-73.181317,7.1280470000000005
41830,2017,Enero,Reunión,1,1,,2,-74.140516,4.697157
41831,2017,Enero,Rumania,9,10,,19,-74.140516,4.697157
41832,2017,Enero,Rumania,1,0,,1,-75.42726,6.170465
41833,2017,Enero,San Cristóbal y Nevis,0,1,,1,-74.140516,4.697157
41834,2017,Enero,Santa Lucia,1,1,,2,-76.532004,3.451668
41835,2017,Enero,Santa Lucia,1,2,,3,-74.140516,4.697157
41836,2017,Enero,Serbia,0,2,,2,-76.532004,3.451668
41837,2017,Enero,Serbia,0,4,,4,-75.42726,6.170465
41838,2017,Enero,Singapur,0,2,,2,-76.532004,3.451668
41839,2017,Enero,Singapur,1,1,,2,-74.140516,4.697157
41840,2017,Enero,Singapur,1,0,,1,-75.42726,6.170465
41841,2017,Enero,Sri Lanka,0,1,,1,-74.140516,4.697157
41842,2017,Enero,Sudáfrica,4,5,,9,-74.140516,4.697157
41843,2017,Enero,Sudáfrica,1,2,,3,-75.42726,6.170465
41844,2017,Enero,Suecia,0,5,,5,-74.77647900000001,10.886686
41845,2017,Enero,Suecia,3,13,,16,-76.532004,3.451668
41846,2017,Enero,Suecia,55,60,,115,-74.140516,4.697157
41847,2017,Enero,Suecia,0,2,,2,-75.736374,4.815189
41848,2017,Enero,Suecia,4,14,,18,-75.42726,6.170465
41849,2017,Enero,Suiza,1,1,,2,-75.527794,10.406342
41850,2017,Enero,Suiza,0,2,,2,-75.516486,10.446304
41851,2017,Enero,Suiza,1,0,,1,-74.77647900000001,10.886686
41852,2017,Enero,Suiza,4,2,,6,-81.70216500000001,12.5862
41853,2017,Enero,Suiza,16,30,,46,-76.532004,3.451668
41854,2017,Enero,Suiza,99,134,,233,-74.140516,4.697157
41855,2017,Enero,Suiza,19,27,,46,-75.42726,6.170465
41856,2017,Enero,Surinam,1,3,,4,-74.140516,4.697157
41857,2017,Enero,Surinam,0,2,,2,-75.42726,6.170465
41858,2017,Enero,Taiwán,0,1,,1,-74.77647900000001,10.886686
41859,2017,Enero,Taiwán,5,1,,6,-74.140516,4.697157
41860,2017,Enero,Taiwán,3,3,,6,-75.42726,6.170465
41861,2017,Enero,Tailandia,1,2,,3,-74.140516,4.697157
41862,2017,Enero,Tailandia,0,1,,1,-75.42726,6.170465
41863,2017,Enero,Trinidad y Tobago,0,5,,5,-75.527794,10.406342
41864,2017,Enero,Trinidad y Tobago,1,3,,4,-74.77647900000001,10.886686
41865,2017,Enero,Trinidad y Tobago,5,41,,46,-76.532004,3.451668
41866,2017,Enero,Trinidad y Tobago,5,8,,13,-74.140516,4.697157
41867,2017,Enero,Trinidad y Tobago,0,5,,5,-75.42726,6.170465
41868,2017,Enero,Túnez,1,1,,2,-74.140516,4.697157
41869,2017,Enero,Turkmenistán,4,9,,13,-74.140516,4.697157
41870,2017,Enero,Turkmenistán,0,1,,1,-72.453013,7.819
41871,2017,Enero,Turquía,1,1,,2,-74.77647900000001,10.886686
41872,2017,Enero,Turquía,0,3,,3,-74.765343,10.970933
41873,2017,Enero,Turquía,0,3,,3,-76.532004,3.451668
41874,2017,Enero,Turquía,0,1,,1,-77.061029,3.8844260000000004
41875,2017,Enero,Turquía,278,399,,677,-74.140516,4.697157
41876,2017,Enero,Turquía,0,6,,6,-75.42726,6.170465
41877,2017,Enero,Ucrania,0,1,,1,-74.77647900000001,10.886686
41878,2017,Enero,Ucrania,1,1,,2,-76.532004,3.451668
41879,2017,Enero,Ucrania,1,10,,11,-74.140516,4.697157
41880,2017,Enero,Ucrania,1,0,,1,-75.42726,6.170465
41881,2017,Enero,Uganda,0,2,,2,-74.140516,4.697157
41882,2017,Enero,Uruguay,1,5,,6,-69.941498,4.191162
41883,2017,Enero,Uruguay,4,1,,5,-75.516486,10.446304
41884,2017,Enero,Uruguay,6,3,,9,-74.77647900000001,10.886686
41885,2017,Enero,Uruguay,31,20,,51,-81.70216500000001,12.5862
41886,2017,Enero,Uruguay,15,30,,45,-76.532004,3.451668
41887,2017,Enero,Uruguay,122,142,,264,-74.140516,4.697157
41888,2017,Enero,Uruguay,3,5,,8,-75.736374,4.815189
41889,2017,Enero,Uruguay,43,37,,80,-75.42726,6.170465
41890,2017,Enero,Venezuela,16,31,,47,-75.516486,10.446304
41891,2017,Enero,Venezuela,19,74,,93,-74.77647900000001,10.886686
41892,2017,Enero,Venezuela,4116,5697,,9813,-72.129595,11.360028999999999
41893,2017,Enero,Venezuela,8,30,,38,-76.532004,3.451668
41894,2017,Enero,Venezuela,49,39,,88,-67.927521,3.866713
41895,2017,Enero,Venezuela,3162,3400,,6562,-74.140516,4.697157
41896,2017,Enero,Venezuela,3,8,,11,-75.736374,4.815189
41897,2017,Enero,Venezuela,418,515,,933,-75.42726,6.170465
41898,2017,Enero,Venezuela,403,553,,956,-67.48402800000001,6.185536
41899,2017,Enero,Venezuela,113,137,,250,-70.74025300000001,7.088728999999999
41900,2017,Enero,Venezuela,6,8,,14,-73.181317,7.1280470000000005
41901,2017,Enero,Venezuela,8660,12338,,20998,-72.453013,7.819
41902,2017,Enero,Venezuela,0,2,,2,-72.508188,7.927233
41903,2017,Enero,Venezuela,244,301,,545,-72.409396,8.36068
41904,2017,Enero,Vietnam,1,1,,2,-74.140516,4.697157
41905,2017,Enero,Vietnam,0,1,,1,-72.453013,7.819
41906,2017,Enero,Islas Vírgenes Británicas/Territorio Británico de Ultramar,1,1,,2,-74.140516,4.697157
41907,2017,Enero,Islas Vírgenes Británicas/Territorio Británico de Ultramar,1,1,,2,-75.42726,6.170465
41908,2017,Enero,Zimbabue,0,1,,1,-74.140516,4.697157
41909,2017,Febrero,Afganistán,0,1,,1,-75.516486,10.446304
41910,2017,Febrero,Alemania,6,6,,12,-74.77647900000001,10.886686
41911,2017,Febrero,Alemania,0,1,,1,-74.213989,11.247722999999999
41912,2017,Febrero,Alemania,1,2,,3,-81.70216500000001,12.5862
41913,2017,Febrero,Alemania,48,83,,131,-76.532004,3.451668
41914,2017,Febrero,Alemania,1624,2283,,3907,-74.140516,4.697157
41915,2017,Febrero,Alemania,1,1,,2,-75.736374,4.815189
41916,2017,Febrero,Alemania,34,61,,95,-75.42726,6.170465
41917,2017,Febrero,Alemania,0,1,,1,-73.181317,7.1280470000000005
41918,2017,Febrero,Antigua y Barbuda,2,5,,7,-75.527794,10.406342
41919,2017,Febrero,Antigua y Barbuda,0,1,,1,-76.532004,3.451668
41920,2017,Febrero,Antigua y Barbuda,1,0,,1,-74.140516,4.697157
41921,2017,Febrero,Antigua y Barbuda,0,1,,1,-75.42726,6.170465
41922,2017,Febrero,Países Bajos,23,41,,64,-75.527794,10.406342
41923,2017,Febrero,Países Bajos,3,3,,6,-75.516486,10.446304
41924,2017,Febrero,Países Bajos,11,23,,34,-74.77647900000001,10.886686
41925,2017,Febrero,Países Bajos,12,20,,32,-74.213989,11.247722999999999
41926,2017,Febrero,Países Bajos,105,166,,271,-76.532004,3.451668
41927,2017,Febrero,Países Bajos,1045,1420,,2465,-74.140516,4.697157
41928,2017,Febrero,Países Bajos,2,5,,7,-75.736374,4.815189
41929,2017,Febrero,Países Bajos,59,85,,144,-75.42726,6.170465
41930,2017,Febrero,Países Bajos,7,8,,15,-73.181317,7.1280470000000005
41931,2017,Febrero,Argelia,1,0,,1,-76.532004,3.451668
41932,2017,Febrero,Argelia,2,6,,8,-74.140516,4.697157
41933,2017,Febrero,Argentina,7,9,,16,-77.35600000000001,0.81488
41934,2017,Febrero,Argentina,18,98,,116,-75.516486,10.446304
41935,2017,Febrero,Argentina,6,10,,16,-74.77647900000001,10.886686
41936,2017,Febrero,Argentina,284,240,,524,-81.70216500000001,12.5862
41937,2017,Febrero,Argentina,50,63,,113,-76.532004,3.451668
41938,2017,Febrero,Argentina,4315,4925,,9240,-74.140516,4.697157
41939,2017,Febrero,Argentina,3,5,,8,-75.736374,4.815189
41940,2017,Febrero,Argentina,93,104,,197,-75.42726,6.170465
41941,2017,Febrero,Argentina,2,1,,3,-73.181317,7.1280470000000005
41942,2017,Febrero,República de Armenia,1,1,,2,-74.140516,4.697157
41943,2017,Febrero,Aruba,6,18,,24,-75.527794,10.406342
41944,2017,Febrero,Aruba,5,1,,6,-74.77647900000001,10.886686
41945,2017,Febrero,Aruba,27,35,,62,-74.213989,11.247722999999999
41946,2017,Febrero,Aruba,11,10,,21,-76.532004,3.451668
41947,2017,Febrero,Aruba,713,923,,1636,-74.140516,4.697157
41948,2017,Febrero,Aruba,0,1,,1,-75.736374,4.815189
41949,2017,Febrero,Aruba,10,12,,22,-75.42726,6.170465
41950,2017,Febrero,Aruba,12,10,,22,-73.181317,7.1280470000000005
41951,2017,Febrero,Australia,0,1,,1,-74.77647900000001,10.886686
41952,2017,Febrero,Australia,3,6,,9,-76.532004,3.451668
41953,2017,Febrero,Australia,37,57,,94,-74.140516,4.697157
41954,2017,Febrero,Australia,8,14,,22,-75.42726,6.170465
41955,2017,Febrero,Austria,0,1,,1,-74.77647900000001,10.886686
41956,2017,Febrero,Austria,3,4,,7,-76.532004,3.451668
41957,2017,Febrero,Austria,37,63,,100,-74.140516,4.697157
41958,2017,Febrero,Austria,3,2,,5,-75.42726,6.170465
41959,2017,Febrero,Azerbaiyán,0,1,,1,-76.532004,3.451668
41960,2017,Febrero,Azerbaiyán,1,4,,5,-74.140516,4.697157
41961,2017,Febrero,Bahamas,0,1,,1,-76.532004,3.451668
41962,2017,Febrero,Bahamas,1,6,,7,-74.140516,4.697157
41963,2017,Febrero,Bahamas,0,2,,2,-75.42726,6.170465
41964,2017,Febrero,Bahamas,1,1,,2,-73.181317,7.1280470000000005
41965,2017,Febrero,Bahréin,0,1,,1,-75.516486,10.446304
41966,2017,Febrero,Bahréin,1,0,,1,-76.532004,3.451668
41967,2017,Febrero,Barbados,33,53,,86,-74.140516,4.697157
41968,2017,Febrero,República de Belarús,1,0,,1,-72.129595,11.360028999999999
41969,2017,Febrero,República de Belarús,1,4,,5,-76.532004,3.451668
41970,2017,Febrero,República de Belarús,0,1,,1,-74.140516,4.697157
41971,2017,Febrero,Bélgica,1,0,,1,-74.77647900000001,10.886686
41972,2017,Febrero,Bélgica,0,2,,2,-74.213989,11.247722999999999
41973,2017,Febrero,Bélgica,15,13,,28,-76.532004,3.451668
41974,2017,Febrero,Bélgica,55,72,,127,-74.140516,4.697157
41975,2017,Febrero,Bélgica,12,16,,28,-75.42726,6.170465
41976,2017,Febrero,Belice,0,1,,1,-74.232675,11.117206
41977,2017,Febrero,Belice,1,2,,3,-81.703935,12.574411099999999
41978,2017,Febrero,Belice,1,2,,3,-76.532004,3.451668
41979,2017,Febrero,Belice,2,5,,7,-74.140516,4.697157
41980,2017,Febrero,Belice,0,3,,3,-75.42726,6.170465
41981,2017,Febrero,Benín,1,1,,2,-75.516486,10.446304
41982,2017,Febrero,Benín,0,1,,1,-76.532004,3.451668
41983,2017,Febrero,Bermudas/Territorio Británico de Ultramar,0,1,,1,-74.140516,4.697157
41984,2017,Febrero,Bolivia,3,1,,4,-77.35600000000001,0.81488
41985,2017,Febrero,Bolivia,2,1,,3,-75.516486,10.446304
41986,2017,Febrero,Bolivia,4,5,,9,-74.77647900000001,10.886686
41987,2017,Febrero,Bolivia,31,18,,49,-81.70216500000001,12.5862
41988,2017,Febrero,Bolivia,26,19,,45,-76.532004,3.451668
41989,2017,Febrero,Bolivia,408,518,,926,-74.140516,4.697157
41990,2017,Febrero,Bolivia,0,2,,2,-75.736374,4.815189
41991,2017,Febrero,Bolivia,24,28,,52,-75.42726,6.170465
41992,2017,Febrero,Bosnia y Herzegovina,1,0,,1,-76.532004,3.451668
41993,2017,Febrero,Brasil,263,257,,520,-69.941498,4.191162
41994,2017,Febrero,Brasil,1,1,,2,-69.94143100000001,4.214082
41995,2017,Febrero,Brasil,2,1,,3,-77.35600000000001,0.81488
41996,2017,Febrero,Brasil,0,2,,2,-75.527794,10.406342
41997,2017,Febrero,Brasil,15,5,,20,-75.516486,10.446304
41998,2017,Febrero,Brasil,3,3,,6,-74.77647900000001,10.886686
41999,2017,Febrero,Brasil,0,1,,1,-74.765343,10.970933
42000,2017,Febrero,Brasil,478,384,,862,-81.70216500000001,12.5862
42001,2017,Febrero,Brasil,129,143,,272,-76.532004,3.451668
42002,2017,Febrero,Brasil,0,1,,1,-67.927521,3.866713
42003,2017,Febrero,Brasil,4739,5882,,10621,-74.140516,4.697157
42004,2017,Febrero,Brasil,5,3,,8,-75.736374,4.815189
42005,2017,Febrero,Brasil,139,160,,299,-75.42726,6.170465
42006,2017,Febrero,Brasil,1,3,,4,-73.181317,7.1280470000000005
42007,2017,Febrero,Bulgaria,1,2,,3,-74.140516,4.697157
42008,2017,Febrero,Burundi,0,1,,1,-74.140516,4.697157
42009,2017,Febrero,Islas Caimán/Territorio Británico de Ultramar,2,2,,4,-75.527794,10.406342
42010,2017,Febrero,Islas Caimán/Territorio Británico de Ultramar,2,2,,4,-81.372937,13.338761300000002
42011,2017,Febrero,Islas Caimán/Territorio Británico de Ultramar,2,7,,9,-74.140516,4.697157
42012,2017,Febrero,Camboya,1,1,,2,-74.140516,4.697157
42013,2017,Febrero,Camerún,0,1,,1,-74.140516,4.697157
42014,2017,Febrero,Canadá,560,595,,1155,-75.516486,10.446304
42015,2017,Febrero,Canadá,7,10,,17,-74.77647900000001,10.886686
42016,2017,Febrero,Canadá,316,285,,601,-81.70216500000001,12.5862
42017,2017,Febrero,Canadá,47,59,,106,-76.532004,3.451668
42018,2017,Febrero,Canadá,792,1197,,1989,-74.140516,4.697157
42019,2017,Febrero,Canadá,1,6,,7,-75.736374,4.815189
42020,2017,Febrero,Canadá,102,192,,294,-75.42726,6.170465
42021,2017,Febrero,Canadá,3,4,,7,-73.181317,7.1280470000000005
42022,2017,Febrero,España,2,3,,5,-74.77647900000001,10.886686
42023,2017,Febrero,España,0,8,,8,-74.765343,10.970933
42024,2017,Febrero,España,398,658,,1056,-76.532004,3.451668
42025,2017,Febrero,España,3729,6316,,10045,-74.140516,4.697157
42026,2017,Febrero,España,2,5,,7,-75.736374,4.815189
42027,2017,Febrero,España,273,542,,815,-75.42726,6.170465
42028,2017,Febrero,España,0,1,,1,-73.181317,7.1280470000000005
42029,2017,Febrero,República Del Congo,0,2,,2,-74.140516,4.697157
42030,2017,Febrero,República de Corea,1,2,,3,-76.532004,3.451668
42031,2017,Febrero,República de Corea,20,16,,36,-74.140516,4.697157
42032,2017,Febrero,República de Corea,1,0,,1,-75.736374,4.815189
42033,2017,Febrero,República de Corea,0,6,,6,-75.42726,6.170465
42034,2017,Febrero,Costa de Marfil,2,1,,3,-76.532004,3.451668
42035,2017,Febrero,Costa de Marfil,4,8,,12,-74.140516,4.697157
42036,2017,Febrero,Costa Rica,3,9,,12,-75.527794,10.406342
42037,2017,Febrero,Costa Rica,2,2,,4,-75.516486,10.446304
42038,2017,Febrero,Costa Rica,3,6,,9,-74.77647900000001,10.886686
42039,2017,Febrero,Costa Rica,0,3,,3,-74.765343,10.970933
42040,2017,Febrero,Costa Rica,307,268,,575,-81.70216500000001,12.5862
42041,2017,Febrero,Costa Rica,0,2,,2,-81.372937,13.338761300000002
42042,2017,Febrero,Costa Rica,9,34,,43,-76.532004,3.451668
42043,2017,Febrero,Costa Rica,917,1321,,2238,-74.140516,4.697157
42044,2017,Febrero,Costa Rica,1,6,,7,-75.736374,4.815189
42045,2017,Febrero,Costa Rica,70,129,,199,-75.42726,6.170465
42046,2017,Febrero,Costa Rica,1,2,,3,-73.181317,7.1280470000000005
42047,2017,Febrero,Croacia,0,3,,3,-76.532004,3.451668
42048,2017,Febrero,Croacia,1,2,,3,-74.140516,4.697157
42049,2017,Febrero,Croacia,0,1,,1,-75.42726,6.170465
42050,2017,Febrero,Cuba,1,10,,11,-74.77647900000001,10.886686
42051,2017,Febrero,Cuba,0,2,,2,-81.703935,12.574411099999999
42052,2017,Febrero,Cuba,12,35,,47,-76.532004,3.451668
42053,2017,Febrero,Cuba,402,668,,1070,-74.140516,4.697157
42054,2017,Febrero,Cuba,17,16,,33,-75.42726,6.170465
42055,2017,Febrero,Cuba,1,2,,3,-73.181317,7.1280470000000005
42056,2017,Febrero,Curazao,2,7,,9,-74.140516,4.697157
42057,2017,Febrero,República Checa,0,3,,3,-76.532004,3.451668
42058,2017,Febrero,República Checa,15,22,,37,-74.140516,4.697157
42059,2017,Febrero,República Checa,3,3,,6,-75.42726,6.170465
42060,2017,Febrero,Chile,7,9,,16,-77.35600000000001,0.81488
42061,2017,Febrero,Chile,27,26,,53,-75.516486,10.446304
42062,2017,Febrero,Chile,8,11,,19,-74.77647900000001,10.886686
42063,2017,Febrero,Chile,182,151,,333,-81.70216500000001,12.5862
42064,2017,Febrero,Chile,39,80,,119,-76.532004,3.451668
42065,2017,Febrero,Chile,5526,6046,,11572,-74.140516,4.697157
42066,2017,Febrero,Chile,7,2,,9,-75.736374,4.815189
42067,2017,Febrero,Chile,29,57,,86,-75.42726,6.170465
42068,2017,Febrero,Chile,0,2,,2,-73.181317,7.1280470000000005
42069,2017,Febrero,China,2,5,,7,-76.532004,3.451668
42070,2017,Febrero,China,26,94,,120,-74.140516,4.697157
42071,2017,Febrero,China,1,3,,4,-75.42726,6.170465
42072,2017,Febrero,Dinamarca,4,3,,7,-76.532004,3.451668
42073,2017,Febrero,Dinamarca,17,39,,56,-74.140516,4.697157
42074,2017,Febrero,Dinamarca,4,2,,6,-75.42726,6.170465
42075,2017,Febrero,Dominica,0,2,,2,-76.532004,3.451668
42076,2017,Febrero,Dominica,1,1,,2,-74.140516,4.697157
42077,2017,Febrero,Ecuador,1,0,,1,-74.78366,0.18595699999999998
42078,2017,Febrero,Ecuador,123,296,,419,-76.876446,0.33002
42079,2017,Febrero,Ecuador,1,0,,1,-77.84700600000001,0.8124359999999999
42080,2017,Febrero,Ecuador,3415,4904,,8319,-77.35600000000001,0.81488
42081,2017,Febrero,Ecuador,28,54,,82,-78.802679,18.00143
42082,2017,Febrero,Ecuador,57,40,,97,-75.516486,10.446304
42083,2017,Febrero,Ecuador,2,3,,5,-74.77647900000001,10.886686
42084,2017,Febrero,Ecuador,3,2,,5,-81.70216500000001,12.5862
42085,2017,Febrero,Ecuador,374,351,,725,-76.532004,3.451668
42086,2017,Febrero,Ecuador,1,4,,5,-77.061029,3.8844260000000004
42087,2017,Febrero,Ecuador,3241,4449,,7690,-74.140516,4.697157
42088,2017,Febrero,Ecuador,30,69,,99,-75.42726,6.170465
42089,2017,Febrero,Ecuador,0,2,,2,-73.181317,7.1280470000000005
42090,2017,Febrero,Egipto,2,8,,10,-74.140516,4.697157
42091,2017,Febrero,El Salvador,0,4,,4,-75.516486,10.446304
42092,2017,Febrero,El Salvador,2,3,,5,-74.77647900000001,10.886686
42093,2017,Febrero,El Salvador,7,8,,15,-81.70216500000001,12.5862
42094,2017,Febrero,El Salvador,113,184,,297,-76.532004,3.451668
42095,2017,Febrero,El Salvador,1001,1414,,2415,-74.140516,4.697157
42096,2017,Febrero,El Salvador,0,1,,1,-75.736374,4.815189
42097,2017,Febrero,El Salvador,173,267,,440,-75.42726,6.170465
42098,2017,Febrero,Emiratos Árabes,0,2,,2,-74.77647900000001,10.886686
42099,2017,Febrero,Emiratos Árabes,2,2,,4,-74.140516,4.697157
42100,2017,Febrero,Emiratos Árabes,0,1,,1,-75.42726,6.170465
42101,2017,Febrero,Eritrea,0,1,,1,-75.42726,6.170465
42102,2017,Febrero,Eslovaquia,2,7,,9,-74.140516,4.697157
42103,2017,Febrero,Eslovenia,9,6,,15,-74.140516,4.697157
42104,2017,Febrero,Estados Unidos de América,0,57,,57,-75.527794,10.406342
42105,2017,Febrero,Estados Unidos de América,3508,4699,,8207,-75.516486,10.446304
42106,2017,Febrero,Estados Unidos de América,572,1023,,1595,-74.77647900000001,10.886686
42107,2017,Febrero,Estados Unidos de América,0,6,,6,-74.765343,10.970933
42108,2017,Febrero,Estados Unidos de América,0,20,,20,-74.213989,11.247722999999999
42109,2017,Febrero,Estados Unidos de América,11,19,,30,-81.70216500000001,12.5862
42110,2017,Febrero,Estados Unidos de América,932,1424,,2356,-76.532004,3.451668
42111,2017,Febrero,Estados Unidos de América,88,136,,224,-75.76635300000001,4.45285
42112,2017,Febrero,Estados Unidos de América,8740,14852,,23592,-74.140516,4.697157
42113,2017,Febrero,Estados Unidos de América,79,152,,231,-75.736374,4.815189
42114,2017,Febrero,Estados Unidos de América,1898,4982,,6880,-75.42726,6.170465
42115,2017,Febrero,Estados Unidos de América,24,39,,63,-73.181317,7.1280470000000005
42116,2017,Febrero,Estados Unidos de América,1,17,,18,-75.68164200000001,9.402597
42117,2017,Febrero,Estonia,9,22,,31,-74.140516,4.697157
42118,2017,Febrero,Estonia,0,1,,1,-75.42726,6.170465
42119,2017,Febrero,Filipinas,0,1,,1,-75.516486,10.446304
42120,2017,Febrero,Filipinas,0,1,,1,-74.77647900000001,10.886686
42121,2017,Febrero,Filipinas,1,9,,10,-76.532004,3.451668
42122,2017,Febrero,Filipinas,6,13,,19,-74.140516,4.697157
42123,2017,Febrero,Filipinas,0,3,,3,-75.42726,6.170465
42124,2017,Febrero,Finlandia,0,1,,1,-76.532004,3.451668
42125,2017,Febrero,Finlandia,13,10,,23,-74.140516,4.697157
42126,2017,Febrero,Finlandia,0,1,,1,-75.42726,6.170465
42127,2017,Febrero,Francia,2,1,,3,-75.527794,10.406342
42128,2017,Febrero,Francia,3,8,,11,-74.77647900000001,10.886686
42129,2017,Febrero,Francia,53,85,,138,-76.532004,3.451668
42130,2017,Febrero,Francia,1765,2727,,4492,-74.140516,4.697157
42131,2017,Febrero,Francia,1,2,,3,-75.736374,4.815189
42132,2017,Febrero,Francia,37,62,,99,-75.42726,6.170465
42133,2017,Febrero,Granada,0,1,,1,-81.70216500000001,12.5862
42134,2017,Febrero,Grecia,8,6,,14,-74.140516,4.697157
42135,2017,Febrero,Grecia,1,0,,1,-75.42726,6.170465
42136,2017,Febrero,Guatemala,4,6,,10,-75.516486,10.446304
42137,2017,Febrero,Guatemala,1,2,,3,-74.77647900000001,10.886686
42138,2017,Febrero,Guatemala,10,15,,25,-81.70216500000001,12.5862
42139,2017,Febrero,Guatemala,15,39,,54,-76.532004,3.451668
42140,2017,Febrero,Guatemala,317,576,,893,-74.140516,4.697157
42141,2017,Febrero,Guatemala,2,8,,10,-75.736374,4.815189
42142,2017,Febrero,Guatemala,59,120,,179,-75.42726,6.170465
42143,2017,Febrero,Guatemala,1,2,,3,-73.181317,7.1280470000000005
42144,2017,Febrero,Guyana,1,2,,3,-75.527794,10.406342
42145,2017,Febrero,Guyana,1,1,,2,-74.140516,4.697157
42146,2017,Febrero,Guyana,1,0,,1,-75.42726,6.170465
42147,2017,Febrero,Guinea Ecuatorial,1,0,,1,-76.532004,3.451668
42148,2017,Febrero,Guinea Ecuatorial,1,0,,1,-75.42726,6.170465
42149,2017,Febrero,Guadalupe/Territorio Francés,5,10,,15,-74.213989,11.247722999999999
42150,2017,Febrero,Guadalupe/Territorio Francés,0,1,,1,-74.140516,4.697157
42151,2017,Febrero,Guadalupe/Territorio Francés,0,1,,1,-75.42726,6.170465
42152,2017,Febrero,Guayana Francesa/Departamento de Ultramar Francés,1,1,,2,-76.532004,3.451668
42153,2017,Febrero,Haití,0,4,,4,-75.527794,10.406342
42154,2017,Febrero,Haití,0,1,,1,-74.77647900000001,10.886686
42155,2017,Febrero,Haití,0,7,,7,-74.765343,10.970933
42156,2017,Febrero,Haití,0,1,,1,-76.532004,3.451668
42157,2017,Febrero,Haití,2,2,,4,-74.140516,4.697157
42158,2017,Febrero,Haití,0,2,,2,-75.42726,6.170465
42159,2017,Febrero,Honduras,0,1,,1,-75.527794,10.406342
42160,2017,Febrero,Honduras,1,3,,4,-74.77647900000001,10.886686
42161,2017,Febrero,Honduras,0,1,,1,-74.765343,10.970933
42162,2017,Febrero,Honduras,1,1,,2,-81.372937,13.338761300000002
42163,2017,Febrero,Honduras,7,8,,15,-76.532004,3.451668
42164,2017,Febrero,Honduras,43,70,,113,-74.140516,4.697157
42165,2017,Febrero,Honduras,2,1,,3,-75.736374,4.815189
42166,2017,Febrero,Honduras,31,38,,69,-75.42726,6.170465
42167,2017,Febrero,Honduras,0,3,,3,-73.181317,7.1280470000000005
42168,2017,Febrero,Hong Kong,2,4,,6,-74.140516,4.697157
42169,2017,Febrero,Hungría,1,1,,2,-76.532004,3.451668
42170,2017,Febrero,Hungría,4,5,,9,-74.140516,4.697157
42171,2017,Febrero,India,0,2,,2,-75.516486,10.446304
42172,2017,Febrero,India,1,4,,5,-76.532004,3.451668
42173,2017,Febrero,India,6,26,,32,-74.140516,4.697157
42174,2017,Febrero,India,2,5,,7,-75.42726,6.170465
42175,2017,Febrero,Indonesia,0,3,,3,-76.532004,3.451668
42176,2017,Febrero,Indonesia,2,1,,3,-74.140516,4.697157
42177,2017,Febrero,Iraq,0,2,,2,-74.140516,4.697157
42178,2017,Febrero,República de Irlanda,0,1,,1,-76.532004,3.451668
42179,2017,Febrero,República de Irlanda,7,13,,20,-74.140516,4.697157
42180,2017,Febrero,República de Irlanda,0,3,,3,-75.42726,6.170465
42181,2017,Febrero,Isla de Man,1,0,,1,-74.140516,4.697157
42182,2017,Febrero,Israel,1,1,,2,-76.532004,3.451668
42183,2017,Febrero,Israel,17,66,,83,-74.140516,4.697157
42184,2017,Febrero,Israel,2,5,,7,-75.42726,6.170465
42185,2017,Febrero,Italia,0,1,,1,-74.77647900000001,10.886686
42186,2017,Febrero,Italia,0,1,,1,-81.70216500000001,12.5862
42187,2017,Febrero,Italia,29,70,,99,-76.532004,3.451668
42188,2017,Febrero,Italia,194,384,,578,-74.140516,4.697157
42189,2017,Febrero,Italia,0,6,,6,-75.736374,4.815189
42190,2017,Febrero,Italia,18,70,,88,-75.42726,6.170465
42191,2017,Febrero,Jamaica,0,3,,3,-75.527794,10.406342
42192,2017,Febrero,Jamaica,4,4,,8,-75.516486,10.446304
42193,2017,Febrero,Jamaica,0,5,,5,-74.77647900000001,10.886686
42194,2017,Febrero,Jamaica,1,2,,3,-74.213989,11.247722999999999
42195,2017,Febrero,Jamaica,2,5,,7,-81.372937,13.338761300000002
42196,2017,Febrero,Jamaica,3,2,,5,-76.532004,3.451668
42197,2017,Febrero,Jamaica,4,4,,8,-74.140516,4.697157
42198,2017,Febrero,Jamaica,0,1,,1,-75.736374,4.815189
42199,2017,Febrero,Jamaica,2,0,,2,-75.42726,6.170465
42200,2017,Febrero,Japón,4,10,,14,-76.532004,3.451668
42201,2017,Febrero,Japón,12,23,,35,-74.140516,4.697157
42202,2017,Febrero,Japón,1,6,,7,-75.42726,6.170465
42203,2017,Febrero,Jordania,1,0,,1,-74.140516,4.697157
42204,2017,Febrero,Kazajistán,1,1,,2,-74.140516,4.697157
42205,2017,Febrero,Kenia,0,1,,1,-76.532004,3.451668
42206,2017,Febrero,Kenia,3,2,,5,-74.140516,4.697157
42207,2017,Febrero,Kuwait,0,1,,1,-74.140516,4.697157
42208,2017,Febrero,Letonia,0,1,,1,-74.140516,4.697157
42209,2017,Febrero,Lituania,1,5,,6,-74.140516,4.697157
42210,2017,Febrero,Líbano,2,5,,7,-74.140516,4.697157
42211,2017,Febrero,Libia,2,0,,2,-74.140516,4.697157
42212,2017,Febrero,Liechtenstein,0,1,,1,-74.140516,4.697157
42213,2017,Febrero,Luxemburgo,0,1,,1,-76.532004,3.451668
42214,2017,Febrero,Luxemburgo,2,5,,7,-74.140516,4.697157
42215,2017,Febrero,Malasia,0,3,,3,-74.140516,4.697157
42216,2017,Febrero,Malta,1,4,,5,-74.140516,4.697157
42217,2017,Febrero,Malta,0,1,,1,-75.42726,6.170465
42218,2017,Febrero,Marruecos,1,1,,2,-74.140516,4.697157
42219,2017,Febrero,Martinica/Departamento de Ultramar Francés,3,2,,5,-74.213989,11.247722999999999
42220,2017,Febrero,México,0,4,,4,-75.527794,10.406342
42221,2017,Febrero,México,15,36,,51,-75.516486,10.446304
42222,2017,Febrero,México,9,21,,30,-74.77647900000001,10.886686
42223,2017,Febrero,México,0,4,,4,-74.765343,10.970933
42224,2017,Febrero,México,3,0,,3,-81.70216500000001,12.5862
42225,2017,Febrero,México,57,141,,198,-76.532004,3.451668
42226,2017,Febrero,México,4556,8024,,12580,-74.140516,4.697157
42227,2017,Febrero,México,5,13,,18,-75.736374,4.815189
42228,2017,Febrero,México,468,1171,,1639,-75.42726,6.170465
42229,2017,Febrero,México,0,9,,9,-73.181317,7.1280470000000005
42230,2017,Febrero,República de Moldavia,1,0,,1,-74.140516,4.697157
42231,2017,Febrero,Mónaco,1,1,,2,-74.140516,4.697157
42232,2017,Febrero,Nicaragua,0,14,,14,-75.527794,10.406342
42233,2017,Febrero,Nicaragua,0,1,,1,-75.516486,10.446304
42234,2017,Febrero,Nicaragua,0,2,,2,-74.77647900000001,10.886686
42235,2017,Febrero,Nicaragua,0,2,,2,-74.232675,11.117206
42236,2017,Febrero,Nicaragua,2,0,,2,-81.70216500000001,12.5862
42237,2017,Febrero,Nicaragua,3,8,,11,-76.532004,3.451668
42238,2017,Febrero,Nicaragua,0,1,,1,-77.061029,3.8844260000000004
42239,2017,Febrero,Nicaragua,26,35,,61,-74.140516,4.697157
42240,2017,Febrero,Nicaragua,3,1,,4,-75.736374,4.815189
42241,2017,Febrero,Nicaragua,13,18,,31,-75.42726,6.170465
42242,2017,Febrero,Nicaragua,1,0,,1,-73.181317,7.1280470000000005
42243,2017,Febrero,Nigeria,0,4,,4,-74.140516,4.697157
42244,2017,Febrero,Nigeria,0,2,,2,-75.42726,6.170465
42245,2017,Febrero,Noruega,0,1,,1,-75.516486,10.446304
42246,2017,Febrero,Noruega,0,1,,1,-74.77647900000001,10.886686
42247,2017,Febrero,Noruega,4,1,,5,-76.532004,3.451668
42248,2017,Febrero,Noruega,17,16,,33,-74.140516,4.697157
42249,2017,Febrero,Noruega,0,1,,1,-75.736374,4.815189
42250,2017,Febrero,Noruega,2,4,,6,-75.42726,6.170465
42251,2017,Febrero,Nueva Caledonia/Territorio francés,0,2,,2,-76.532004,3.451668
42252,2017,Febrero,Nueva Zelanda,6,4,,10,-76.532004,3.451668
42253,2017,Febrero,Nueva Zelanda,1,6,,7,-74.140516,4.697157
42254,2017,Febrero,Nueva Zelanda,2,4,,6,-75.42726,6.170465
42255,2017,Febrero,Panamá,1,1,,2,-78.802679,18.00143
42256,2017,Febrero,Panamá,1525,1272,,2797,-75.527794,10.406342
42257,2017,Febrero,Panamá,3911,4073,,7984,-75.516486,10.446304
42258,2017,Febrero,Panamá,445,770,,1215,-74.77647900000001,10.886686
42259,2017,Febrero,Panamá,0,9,,9,-74.765343,10.970933
42260,2017,Febrero,Panamá,1,2,,3,-74.213989,11.247722999999999
42261,2017,Febrero,Panamá,4,11,,15,-81.703935,12.574411099999999
42262,2017,Febrero,Panamá,651,593,,1244,-81.70216500000001,12.5862
42263,2017,Febrero,Panamá,4,4,,8,-81.372937,13.338761300000002
42264,2017,Febrero,Panamá,406,602,,1008,-76.532004,3.451668
42265,2017,Febrero,Panamá,0,46,,46,-77.061029,3.8844260000000004
42266,2017,Febrero,Panamá,58,73,,131,-75.76635300000001,4.45285
42267,2017,Febrero,Panamá,5262,6925,,12187,-74.140516,4.697157
42268,2017,Febrero,Panamá,62,126,,188,-75.736374,4.815189
42269,2017,Febrero,Panamá,3095,3545,,6640,-75.42726,6.170465
42270,2017,Febrero,Panamá,0,1,,1,-77.401154,6.222551999999999
42271,2017,Febrero,Panamá,3,1,,4,-77.762647,7.102626
42272,2017,Febrero,Panamá,13,17,,30,-73.181317,7.1280470000000005
42273,2017,Febrero,Panamá,112,150,,262,-77.35002,8.63337
42274,2017,Febrero,Paraguay,0,1,,1,-75.516486,10.446304
42275,2017,Febrero,Paraguay,0,2,,2,-74.77647900000001,10.886686
42276,2017,Febrero,Paraguay,64,42,,106,-81.70216500000001,12.5862
42277,2017,Febrero,Paraguay,9,46,,55,-76.532004,3.451668
42278,2017,Febrero,Paraguay,57,58,,115,-74.140516,4.697157
42279,2017,Febrero,Paraguay,1,0,,1,-75.736374,4.815189
42280,2017,Febrero,Paraguay,19,17,,36,-75.42726,6.170465
42281,2017,Febrero,Paraguay,2,2,,4,-73.181317,7.1280470000000005
42282,2017,Febrero,Perú,126,223,,349,-69.941498,4.191162
42283,2017,Febrero,Perú,5,7,,12,-69.94143100000001,4.214082
42284,2017,Febrero,Perú,1,0,,1,-74.78366,0.18595699999999998
42285,2017,Febrero,Perú,19,32,,51,-77.35600000000001,0.81488
42286,2017,Febrero,Perú,0,1,,1,-75.527794,10.406342
42287,2017,Febrero,Perú,1129,890,,2019,-75.516486,10.446304
42288,2017,Febrero,Perú,8,9,,17,-74.77647900000001,10.886686
42289,2017,Febrero,Perú,430,327,,757,-81.70216500000001,12.5862
42290,2017,Febrero,Perú,443,587,,1030,-76.532004,3.451668
42291,2017,Febrero,Perú,6257,7637,,13894,-74.140516,4.697157
42292,2017,Febrero,Perú,5,3,,8,-75.736374,4.815189
42293,2017,Febrero,Perú,624,834,,1458,-75.42726,6.170465
42294,2017,Febrero,Perú,3,4,,7,-73.181317,7.1280470000000005
42295,2017,Febrero,Perú,0,1,,1,-75.68164200000001,9.402597
42296,2017,Febrero,Palestina,0,1,,1,-74.140516,4.697157
42297,2017,Febrero,Polonia,3,5,,8,-76.532004,3.451668
42298,2017,Febrero,Polonia,9,23,,32,-74.140516,4.697157
42299,2017,Febrero,Polonia,4,1,,5,-75.42726,6.170465
42300,2017,Febrero,Portugal,0,5,,5,-76.532004,3.451668
42301,2017,Febrero,Portugal,27,49,,76,-74.140516,4.697157
42302,2017,Febrero,Portugal,2,5,,7,-75.42726,6.170465
42303,2017,Febrero,Puerto Rico/Territorio de Estados Unidos,0,3,,3,-75.527794,10.406342
42304,2017,Febrero,Puerto Rico/Territorio de Estados Unidos,1,3,,4,-75.516486,10.446304
42305,2017,Febrero,Puerto Rico/Territorio de Estados Unidos,8,30,,38,-74.77647900000001,10.886686
42306,2017,Febrero,Puerto Rico/Territorio de Estados Unidos,0,1,,1,-74.213989,11.247722999999999
42307,2017,Febrero,Puerto Rico/Territorio de Estados Unidos,1,0,,1,-81.70216500000001,12.5862
42308,2017,Febrero,Puerto Rico/Territorio de Estados Unidos,28,49,,77,-76.532004,3.451668
42309,2017,Febrero,Puerto Rico/Territorio de Estados Unidos,342,489,,831,-74.140516,4.697157
42310,2017,Febrero,Puerto Rico/Territorio de Estados Unidos,7,12,,19,-75.736374,4.815189
42311,2017,Febrero,Puerto Rico/Territorio de Estados Unidos,41,80,,121,-75.42726,6.170465
42312,2017,Febrero,Puerto Rico/Territorio de Estados Unidos,1,3,,4,-73.181317,7.1280470000000005
42313,2017,Febrero,Qatar,1,0,,1,-74.140516,4.697157
42314,2017,Febrero,Reino Unido de Gran Bretaña e Irlanda del Norte,0,1,,1,-74.77647900000001,10.886686
42315,2017,Febrero,Reino Unido de Gran Bretaña e Irlanda del Norte,4,14,,18,-76.532004,3.451668
42316,2017,Febrero,Reino Unido de Gran Bretaña e Irlanda del Norte,874,1391,,2265,-74.140516,4.697157
42317,2017,Febrero,Reino Unido de Gran Bretaña e Irlanda del Norte,23,42,,65,-75.42726,6.170465
42318,2017,Febrero,República CentroÁfricana,0,1,,1,-74.140516,4.697157
42319,2017,Febrero,Federación de Rusia,3,12,,15,-76.532004,3.451668
42320,2017,Febrero,Federación de Rusia,7,27,,34,-74.140516,4.697157
42321,2017,Febrero,Federación de Rusia,1,1,,2,-75.42726,6.170465
42322,2017,Febrero,República Dominicana,3,10,,13,-75.527794,10.406342
42323,2017,Febrero,República Dominicana,6,13,,19,-75.516486,10.446304
42324,2017,Febrero,República Dominicana,57,40,,97,-74.77647900000001,10.886686
42325,2017,Febrero,República Dominicana,1,2,,3,-74.232675,11.117206
42326,2017,Febrero,República Dominicana,11,31,,42,-76.532004,3.451668
42327,2017,Febrero,República Dominicana,680,1026,,1706,-74.140516,4.697157
42328,2017,Febrero,República Dominicana,5,6,,11,-75.736374,4.815189
42329,2017,Febrero,República Dominicana,32,70,,102,-75.42726,6.170465
42330,2017,Febrero,República Dominicana,3,4,,7,-73.181317,7.1280470000000005
42331,2017,Febrero,Reunión,0,1,,1,-74.140516,4.697157
42332,2017,Febrero,República Democrática Popular de Corea,0,2,,2,-74.140516,4.697157
42333,2017,Febrero,Rumania,0,1,,1,-76.532004,3.451668
42334,2017,Febrero,Rumania,3,10,,13,-74.140516,4.697157
42335,2017,Febrero,San Cristóbal y Nevis,0,1,,1,-74.140516,4.697157
42336,2017,Febrero,Santa Lucia,1,0,,1,-74.77647900000001,10.886686
42337,2017,Febrero,Santa Lucia,0,1,,1,-74.140516,4.697157
42338,2017,Febrero,Santa Sede/Ciudad del Vaticano,1,1,,2,-74.140516,4.697157
42339,2017,Febrero,Serbia,1,3,,4,-74.140516,4.697157
42340,2017,Febrero,Singapur,0,4,,4,-74.213989,11.247722999999999
42341,2017,Febrero,Singapur,0,4,,4,-74.140516,4.697157
42342,2017,Febrero,República Árabe Siria,0,1,,1,-74.140516,4.697157
42343,2017,Febrero,Sudáfrica,4,6,,10,-74.140516,4.697157
42344,2017,Febrero,Suecia,6,10,,16,-76.532004,3.451668
42345,2017,Febrero,Suecia,32,49,,81,-74.140516,4.697157
42346,2017,Febrero,Suecia,1,0,,1,-75.736374,4.815189
42347,2017,Febrero,Suecia,5,5,,10,-75.42726,6.170465
42348,2017,Febrero,Suecia,1,1,,2,-73.181317,7.1280470000000005
42349,2017,Febrero,Suiza,2,0,,2,-74.77647900000001,10.886686
42350,2017,Febrero,Suiza,9,21,,30,-76.532004,3.451668
42351,2017,Febrero,Suiza,106,140,,246,-74.140516,4.697157
42352,2017,Febrero,Suiza,30,52,,82,-75.42726,6.170465
42353,2017,Febrero,Surinam,6,1,,7,-74.140516,4.697157
42354,2017,Febrero,Surinam,0,1,,1,-75.42726,6.170465
42355,2017,Febrero,Taiwán,0,2,,2,-76.532004,3.451668
42356,2017,Febrero,Taiwán,0,4,,4,-74.140516,4.697157
42357,2017,Febrero,Taiwán,2,2,,4,-75.42726,6.170465
42358,2017,Febrero,Tailandia,0,4,,4,-74.140516,4.697157
42359,2017,Febrero,Tailandia,1,0,,1,-75.42726,6.170465
42360,2017,Febrero,Trinidad y Tobago,0,1,,1,-75.527794,10.406342
42361,2017,Febrero,Trinidad y Tobago,1,1,,2,-75.516486,10.446304
42362,2017,Febrero,Trinidad y Tobago,3,0,,3,-74.77647900000001,10.886686
42363,2017,Febrero,Trinidad y Tobago,1,7,,8,-76.532004,3.451668
42364,2017,Febrero,Trinidad y Tobago,10,5,,15,-74.140516,4.697157
42365,2017,Febrero,Trinidad y Tobago,6,20,,26,-75.42726,6.170465
42366,2017,Febrero,Trinidad y Tobago,2,3,,5,-73.181317,7.1280470000000005
42367,2017,Febrero,Túnez,1,3,,4,-74.140516,4.697157
42368,2017,Febrero,Túnez,0,1,,1,-72.453013,7.819
42369,2017,Febrero,Turkmenistán,2,3,,5,-74.140516,4.697157
42370,2017,Febrero,Turkmenistán,0,1,,1,-75.42726,6.170465
42371,2017,Febrero,Turquía,0,1,,1,-74.213989,11.247722999999999
42372,2017,Febrero,Turquía,1,1,,2,-76.532004,3.451668
42373,2017,Febrero,Turquía,226,369,,595,-74.140516,4.697157
42374,2017,Febrero,Turquía,1,3,,4,-75.42726,6.170465
42375,2017,Febrero,Ucrania,4,5,,9,-76.532004,3.451668
42376,2017,Febrero,Ucrania,0,2,,2,-74.140516,4.697157
42377,2017,Febrero,Uruguay,0,5,,5,-74.77647900000001,10.886686
42378,2017,Febrero,Uruguay,38,21,,59,-81.70216500000001,12.5862
42379,2017,Febrero,Uruguay,15,19,,34,-76.532004,3.451668
42380,2017,Febrero,Uruguay,77,116,,193,-74.140516,4.697157
42381,2017,Febrero,Uruguay,1,1,,2,-75.736374,4.815189
42382,2017,Febrero,Uruguay,45,37,,82,-75.42726,6.170465
42383,2017,Febrero,Uruguay,1,1,,2,-73.181317,7.1280470000000005
42384,2017,Febrero,Vanuatu,1,0,,1,-72.453013,7.819
42385,2017,Febrero,Venezuela,0,4,,4,-75.527794,10.406342
42386,2017,Febrero,Venezuela,5,11,,16,-75.516486,10.446304
42387,2017,Febrero,Venezuela,24,73,,97,-74.77647900000001,10.886686
42388,2017,Febrero,Venezuela,0,1,,1,-74.765343,10.970933
42389,2017,Febrero,Venezuela,11,8,,19,-74.232675,11.117206
42390,2017,Febrero,Venezuela,4617,5720,,10337,-72.129595,11.360028999999999
42391,2017,Febrero,Venezuela,1,0,,1,-81.70216500000001,12.5862
42392,2017,Febrero,Venezuela,9,20,,29,-76.532004,3.451668
42393,2017,Febrero,Venezuela,53,46,,99,-67.927521,3.866713
42394,2017,Febrero,Venezuela,2710,3151,,5861,-74.140516,4.697157
42395,2017,Febrero,Venezuela,3,3,,6,-75.736374,4.815189
42396,2017,Febrero,Venezuela,400,458,,858,-75.42726,6.170465
42397,2017,Febrero,Venezuela,517,710,,1227,-67.48402800000001,6.185536
42398,2017,Febrero,Venezuela,77,82,,159,-70.74025300000001,7.088728999999999
42399,2017,Febrero,Venezuela,2,1,,3,-73.181317,7.1280470000000005
42400,2017,Febrero,Venezuela,7026,9695,,16721,-72.453013,7.819
42401,2017,Febrero,Venezuela,1,10,,11,-72.508188,7.927233
42402,2017,Febrero,Venezuela,159,217,,376,-72.409396,8.36068
42403,2017,Febrero,Vietnam,0,2,,2,-74.140516,4.697157
42404,2017,Febrero,Islas Vírgenes Británicas/Territorio Británico de Ultramar,15,32,,47,-75.527794,10.406342
42405,2017,Febrero,Islas Vírgenes Británicas/Territorio Británico de Ultramar,1,4,,5,-74.140516,4.697157
42406,2017,Febrero,Islas Vírgenes Británicas/Territorio Británico de Ultramar,2,0,,2,-75.42726,6.170465
42407,2017,Febrero,Islas Vírgenes Estadounidenses/Territorio de Estados Unidos,0,1,,1,-75.527794,10.406342
42408,2017,Marzo,Albania,1,0,,1,-76.532004,3.451668
42409,2017,Marzo,Albania,1,1,,2,-74.140516,4.697157
42410,2017,Marzo,Alemania,3,5,,8,-75.516486,10.446304
42411,2017,Marzo,Alemania,5,2,,7,-74.77647900000001,10.886686
42412,2017,Marzo,Alemania,34,55,,89,-76.532004,3.451668
42413,2017,Marzo,Alemania,1533,2388,,3921,-74.140516,4.697157
42414,2017,Marzo,Alemania,0,3,,3,-75.736374,4.815189
42415,2017,Marzo,Alemania,36,72,,108,-75.42726,6.170465
42416,2017,Marzo,Alemania,3,0,,3,-73.181317,7.1280470000000005
42417,2017,Marzo,Andorra,0,1,,1,-74.140516,4.697157
42418,2017,Marzo,Angola,2,5,,7,-74.140516,4.697157
42419,2017,Marzo,Antigua y Barbuda,0,5,,5,-75.527794,10.406342
42420,2017,Marzo,Antigua y Barbuda,1,4,,5,-74.140516,4.697157
42421,2017,Marzo,Países Bajos,34,91,,125,-75.527794,10.406342
42422,2017,Marzo,Países Bajos,30,49,,79,-75.516486,10.446304
42423,2017,Marzo,Países Bajos,5,5,,10,-74.77647900000001,10.886686
42424,2017,Marzo,Países Bajos,0,5,,5,-74.213989,11.247722999999999
42425,2017,Marzo,Países Bajos,64,126,,190,-76.532004,3.451668
42426,2017,Marzo,Países Bajos,950,1254,,2204,-74.140516,4.697157
42427,2017,Marzo,Países Bajos,0,1,,1,-75.736374,4.815189
42428,2017,Marzo,Países Bajos,63,106,,169,-75.42726,6.170465
42429,2017,Marzo,Países Bajos,4,4,,8,-73.181317,7.1280470000000005
42430,2017,Marzo,Arabia Saudita,0,2,,2,-74.140516,4.697157
42431,2017,Marzo,Argelia,0,1,,1,-74.77647900000001,10.886686
42432,2017,Marzo,Argelia,4,4,,8,-74.140516,4.697157
42433,2017,Marzo,Argelia,1,0,,1,-75.42726,6.170465
42434,2017,Marzo,Argentina,2,15,,17,-77.35600000000001,0.81488
42435,2017,Marzo,Argentina,71,60,,131,-75.516486,10.446304
42436,2017,Marzo,Argentina,1,6,,7,-74.77647900000001,10.886686
42437,2017,Marzo,Argentina,296,251,,547,-81.70216500000001,12.5862
42438,2017,Marzo,Argentina,48,65,,113,-76.532004,3.451668
42439,2017,Marzo,Argentina,5119,5608,,10727,-74.140516,4.697157
42440,2017,Marzo,Argentina,0,2,,2,-75.736374,4.815189
42441,2017,Marzo,Argentina,50,99,,149,-75.42726,6.170465
42442,2017,Marzo,Argentina,0,1,,1,-73.181317,7.1280470000000005
42443,2017,Marzo,Aruba,8,15,,23,-75.527794,10.406342
42444,2017,Marzo,Aruba,3,4,,7,-75.516486,10.446304
42445,2017,Marzo,Aruba,1,2,,3,-74.77647900000001,10.886686
42446,2017,Marzo,Aruba,9,16,,25,-74.213989,11.247722999999999
42447,2017,Marzo,Aruba,8,11,,19,-76.532004,3.451668
42448,2017,Marzo,Aruba,876,963,,1839,-74.140516,4.697157
42449,2017,Marzo,Aruba,0,1,,1,-75.736374,4.815189
42450,2017,Marzo,Aruba,9,10,,19,-75.42726,6.170465
42451,2017,Marzo,Aruba,21,18,,39,-73.181317,7.1280470000000005
42452,2017,Marzo,Australia,2,1,,3,-75.516486,10.446304
42453,2017,Marzo,Australia,0,4,,4,-74.77647900000001,10.886686
42454,2017,Marzo,Australia,2,4,,6,-76.532004,3.451668
42455,2017,Marzo,Australia,35,45,,80,-74.140516,4.697157
42456,2017,Marzo,Australia,0,2,,2,-75.736374,4.815189
42457,2017,Marzo,Australia,10,22,,32,-75.42726,6.170465
42458,2017,Marzo,Austria,1,1,,2,-81.70216500000001,12.5862
42459,2017,Marzo,Austria,0,2,,2,-76.532004,3.451668
42460,2017,Marzo,Austria,18,35,,53,-74.140516,4.697157
42461,2017,Marzo,Austria,0,1,,1,-75.736374,4.815189
42462,2017,Marzo,Austria,3,6,,9,-75.42726,6.170465
42463,2017,Marzo,Bahamas,32,44,,76,-75.516486,10.446304
42464,2017,Marzo,Bahamas,1,0,,1,-76.532004,3.451668
42465,2017,Marzo,Bahamas,0,2,,2,-74.140516,4.697157
42466,2017,Marzo,Bahamas,1,2,,3,-75.42726,6.170465
42467,2017,Marzo,Bahréin,0,1,,1,-74.140516,4.697157
42468,2017,Marzo,Barbados,0,1,,1,-76.532004,3.451668
42469,2017,Marzo,Barbados,46,53,,99,-74.140516,4.697157
42470,2017,Marzo,República de Belarús,0,1,,1,-74.77647900000001,10.886686
42471,2017,Marzo,República de Belarús,0,1,,1,-74.140516,4.697157
42472,2017,Marzo,República de Belarús,1,0,,1,-72.453013,7.819
42473,2017,Marzo,República de Belarús,0,1,,1,-72.409396,8.36068
42474,2017,Marzo,Bélgica,1,3,,4,-74.77647900000001,10.886686
42475,2017,Marzo,Bélgica,4,17,,21,-76.532004,3.451668
42476,2017,Marzo,Bélgica,36,70,,106,-74.140516,4.697157
42477,2017,Marzo,Bélgica,11,18,,29,-75.42726,6.170465
42478,2017,Marzo,Bélgica,0,1,,1,-76.7333,8.06667
42479,2017,Marzo,Belice,1,2,,3,-81.372937,13.338761300000002
42480,2017,Marzo,Belice,3,7,,10,-74.140516,4.697157
42481,2017,Marzo,Belice,0,1,,1,-75.42726,6.170465
42482,2017,Marzo,Benín,1,0,,1,-75.516486,10.446304
42483,2017,Marzo,Bermudas/Territorio Británico de Ultramar,0,1,,1,-74.140516,4.697157
42484,2017,Marzo,Bolivia,0,3,,3,-69.941498,4.191162
42485,2017,Marzo,Bolivia,0,1,,1,-77.35600000000001,0.81488
42486,2017,Marzo,Bolivia,7,3,,10,-75.516486,10.446304
42487,2017,Marzo,Bolivia,3,74,,77,-74.77647900000001,10.886686
42488,2017,Marzo,Bolivia,19,16,,35,-81.70216500000001,12.5862
42489,2017,Marzo,Bolivia,11,24,,35,-76.532004,3.451668
42490,2017,Marzo,Bolivia,327,463,,790,-74.140516,4.697157
42491,2017,Marzo,Bolivia,0,1,,1,-75.736374,4.815189
42492,2017,Marzo,Bolivia,17,28,,45,-75.42726,6.170465
42493,2017,Marzo,Bolivia,2,0,,2,-73.181317,7.1280470000000005
42494,2017,Marzo,Brasil,176,237,,413,-69.941498,4.191162
42495,2017,Marzo,Brasil,2,5,,7,-69.94143100000001,4.214082
42496,2017,Marzo,Brasil,0,1,,1,-77.35600000000001,0.81488
42497,2017,Marzo,Brasil,0,4,,4,-75.527794,10.406342
42498,2017,Marzo,Brasil,30,27,,57,-75.516486,10.446304
42499,2017,Marzo,Brasil,5,4,,9,-74.77647900000001,10.886686
42500,2017,Marzo,Brasil,465,388,,853,-81.70216500000001,12.5862
42501,2017,Marzo,Brasil,88,85,,173,-76.532004,3.451668
42502,2017,Marzo,Brasil,0,4,,4,-67.927521,3.866713
42503,2017,Marzo,Brasil,4400,6205,,10605,-74.140516,4.697157
42504,2017,Marzo,Brasil,7,13,,20,-75.736374,4.815189
42505,2017,Marzo,Brasil,121,143,,264,-75.42726,6.170465
42506,2017,Marzo,Brasil,0,4,,4,-73.181317,7.1280470000000005
42507,2017,Marzo,Bulgaria,3,5,,8,-74.140516,4.697157
42508,2017,Marzo,Bulgaria,2,5,,7,-75.42726,6.170465
42509,2017,Marzo,Burundi,0,1,,1,-74.140516,4.697157
42510,2017,Marzo,Cabo Verde,0,1,,1,-76.876446,0.33002
42511,2017,Marzo,Islas Caimán/Territorio Británico de Ultramar,0,1,,1,-81.70216500000001,12.5862
42512,2017,Marzo,Islas Caimán/Territorio Británico de Ultramar,1,0,,1,-76.532004,3.451668
42513,2017,Marzo,Camboya,0,1,,1,-74.140516,4.697157
42514,2017,Marzo,Canadá,478,495,,973,-75.516486,10.446304
42515,2017,Marzo,Canadá,4,9,,13,-74.77647900000001,10.886686
42516,2017,Marzo,Canadá,370,353,,723,-81.70216500000001,12.5862
42517,2017,Marzo,Canadá,38,71,,109,-76.532004,3.451668
42518,2017,Marzo,Canadá,789,1173,,1962,-74.140516,4.697157
42519,2017,Marzo,Canadá,9,11,,20,-75.736374,4.815189
42520,2017,Marzo,Canadá,113,184,,297,-75.42726,6.170465
42521,2017,Marzo,Canadá,1,4,,5,-73.181317,7.1280470000000005
42522,2017,Marzo,España,0,11,,11,-75.527794,10.406342
42523,2017,Marzo,España,0,5,,5,-74.77647900000001,10.886686
42524,2017,Marzo,España,349,526,,875,-76.532004,3.451668
42525,2017,Marzo,España,3275,5995,,9270,-74.140516,4.697157
42526,2017,Marzo,España,3,6,,9,-75.736374,4.815189
42527,2017,Marzo,España,301,597,,898,-75.42726,6.170465
42528,2017,Marzo,República de Corea,1,0,,1,-76.532004,3.451668
42529,2017,Marzo,República de Corea,10,14,,24,-74.140516,4.697157
42530,2017,Marzo,República de Corea,0,5,,5,-75.42726,6.170465
42531,2017,Marzo,Costa de Marfil,7,2,,9,-74.140516,4.697157
42532,2017,Marzo,Costa Rica,2,8,,10,-75.527794,10.406342
42533,2017,Marzo,Costa Rica,0,3,,3,-75.516486,10.446304
42534,2017,Marzo,Costa Rica,6,14,,20,-74.77647900000001,10.886686
42535,2017,Marzo,Costa Rica,291,237,,528,-81.70216500000001,12.5862
42536,2017,Marzo,Costa Rica,0,1,,1,-81.372937,13.338761300000002
42537,2017,Marzo,Costa Rica,25,33,,58,-76.532004,3.451668
42538,2017,Marzo,Costa Rica,1096,1705,,2801,-74.140516,4.697157
42539,2017,Marzo,Costa Rica,4,8,,12,-75.736374,4.815189
42540,2017,Marzo,Costa Rica,80,133,,213,-75.42726,6.170465
42541,2017,Marzo,Costa Rica,1,4,,5,-73.181317,7.1280470000000005
42542,2017,Marzo,Croacia,2,6,,8,-76.532004,3.451668
42543,2017,Marzo,Croacia,3,7,,10,-74.140516,4.697157
42544,2017,Marzo,Croacia,0,1,,1,-75.42726,6.170465
42545,2017,Marzo,Cuba,0,3,,3,-75.516486,10.446304
42546,2017,Marzo,Cuba,0,1,,1,-74.77647900000001,10.886686
42547,2017,Marzo,Cuba,0,2,,2,-74.765343,10.970933
42548,2017,Marzo,Cuba,9,9,,18,-76.532004,3.451668
42549,2017,Marzo,Cuba,318,525,,843,-74.140516,4.697157
42550,2017,Marzo,Cuba,1,2,,3,-75.736374,4.815189
42551,2017,Marzo,Cuba,13,18,,31,-75.42726,6.170465
42552,2017,Marzo,Cuba,1,1,,2,-73.181317,7.1280470000000005
42553,2017,Marzo,Curazao,4,1,,5,-74.140516,4.697157
42554,2017,Marzo,República Checa,4,5,,9,-74.140516,4.697157
42555,2017,Marzo,República Checa,0,2,,2,-75.42726,6.170465
42556,2017,Marzo,Chile,1,3,,4,-77.35600000000001,0.81488
42557,2017,Marzo,Chile,12,11,,23,-75.516486,10.446304
42558,2017,Marzo,Chile,2,5,,7,-74.77647900000001,10.886686
42559,2017,Marzo,Chile,161,133,,294,-81.70216500000001,12.5862
42560,2017,Marzo,Chile,32,33,,65,-76.532004,3.451668
42561,2017,Marzo,Chile,4848,6180,,11028,-74.140516,4.697157
42562,2017,Marzo,Chile,2,5,,7,-75.736374,4.815189
42563,2017,Marzo,Chile,21,66,,87,-75.42726,6.170465
42564,2017,Marzo,Chile,0,2,,2,-73.181317,7.1280470000000005
42565,2017,Marzo,China,0,3,,3,-74.77647900000001,10.886686
42566,2017,Marzo,China,0,1,,1,-76.532004,3.451668
42567,2017,Marzo,China,0,5,,5,-77.061029,3.8844260000000004
42568,2017,Marzo,China,38,98,,136,-74.140516,4.697157
42569,2017,Marzo,China,0,6,,6,-75.42726,6.170465
42570,2017,Marzo,China,1,1,,2,-73.181317,7.1280470000000005
42571,2017,Marzo,Chipre,0,2,,2,-74.140516,4.697157
42572,2017,Marzo,Dinamarca,1,2,,3,-75.516486,10.446304
42573,2017,Marzo,Dinamarca,0,1,,1,-74.77647900000001,10.886686
42574,2017,Marzo,Dinamarca,0,4,,4,-76.532004,3.451668
42575,2017,Marzo,Dinamarca,20,30,,50,-74.140516,4.697157
42576,2017,Marzo,Dinamarca,3,1,,4,-75.42726,6.170465
42577,2017,Marzo,Ecuador,107,360,,467,-76.876446,0.33002
42578,2017,Marzo,Ecuador,0,1,,1,-77.84700600000001,0.8124359999999999
42579,2017,Marzo,Ecuador,3621,4774,,8395,-77.35600000000001,0.81488
42580,2017,Marzo,Ecuador,42,58,,100,-78.802679,18.00143
42581,2017,Marzo,Ecuador,0,1,,1,-75.527794,10.406342
42582,2017,Marzo,Ecuador,0,4,,4,-75.516486,10.446304
42583,2017,Marzo,Ecuador,4,6,,10,-74.77647900000001,10.886686
42584,2017,Marzo,Ecuador,11,2,,13,-81.70216500000001,12.5862
42585,2017,Marzo,Ecuador,511,559,,1070,-76.532004,3.451668
42586,2017,Marzo,Ecuador,0,8,,8,-77.061029,3.8844260000000004
42587,2017,Marzo,Ecuador,3485,5247,,8732,-74.140516,4.697157
42588,2017,Marzo,Ecuador,27,55,,82,-75.42726,6.170465
42589,2017,Marzo,Ecuador,0,1,,1,-73.181317,7.1280470000000005
42590,2017,Marzo,Egipto,1,3,,4,-74.140516,4.697157
42591,2017,Marzo,El Salvador,2,1,,3,-75.516486,10.446304
42592,2017,Marzo,El Salvador,4,7,,11,-74.77647900000001,10.886686
42593,2017,Marzo,El Salvador,0,6,,6,-81.70216500000001,12.5862
42594,2017,Marzo,El Salvador,129,183,,312,-76.532004,3.451668
42595,2017,Marzo,El Salvador,991,1500,,2491,-74.140516,4.697157
42596,2017,Marzo,El Salvador,0,1,,1,-75.736374,4.815189
42597,2017,Marzo,El Salvador,165,257,,422,-75.42726,6.170465
42598,2017,Marzo,Emiratos Árabes,1,0,,1,-76.532004,3.451668
42599,2017,Marzo,Emiratos Árabes,3,2,,5,-74.140516,4.697157
42600,2017,Marzo,Eritrea,0,1,,1,-74.140516,4.697157
42601,2017,Marzo,Eslovaquia,0,3,,3,-76.532004,3.451668
42602,2017,Marzo,Eslovaquia,4,4,,8,-74.140516,4.697157
42603,2017,Marzo,Eslovenia,4,3,,7,-74.140516,4.697157
42604,2017,Marzo,Eslovenia,0,3,,3,-75.42726,6.170465
42605,2017,Marzo,Estados Unidos de América,2,41,,43,-75.527794,10.406342
42606,2017,Marzo,Estados Unidos de América,3609,5173,,8782,-75.516486,10.446304
42607,2017,Marzo,Estados Unidos de América,523,765,,1288,-74.77647900000001,10.886686
42608,2017,Marzo,Estados Unidos de América,0,2,,2,-74.765343,10.970933
42609,2017,Marzo,Estados Unidos de América,0,2,,2,-74.232675,11.117206
42610,2017,Marzo,Estados Unidos de América,0,22,,22,-74.213989,11.247722999999999
42611,2017,Marzo,Estados Unidos de América,34,80,,114,-72.919186,11.52863
42612,2017,Marzo,Estados Unidos de América,21,32,,53,-81.70216500000001,12.5862
42613,2017,Marzo,Estados Unidos de América,1141,1366,,2507,-76.532004,3.451668
42614,2017,Marzo,Estados Unidos de América,1,19,,20,-77.061029,3.8844260000000004
42615,2017,Marzo,Estados Unidos de América,76,136,,212,-75.76635300000001,4.45285
42616,2017,Marzo,Estados Unidos de América,9225,15753,,24978,-74.140516,4.697157
42617,2017,Marzo,Estados Unidos de América,107,139,,246,-75.736374,4.815189
42618,2017,Marzo,Estados Unidos de América,2189,5638,,7827,-75.42726,6.170465
42619,2017,Marzo,Estados Unidos de América,25,33,,58,-73.181317,7.1280470000000005
42620,2017,Marzo,Estados Unidos de América,0,25,,25,-75.68164200000001,9.402597
42621,2017,Marzo,Estonia,1,1,,2,-74.140516,4.697157
42622,2017,Marzo,Etiopia,0,2,,2,-74.140516,4.697157
42623,2017,Marzo,Filipinas,0,1,,1,-75.516486,10.446304
42624,2017,Marzo,Filipinas,0,2,,2,-74.77647900000001,10.886686
42625,2017,Marzo,Filipinas,0,10,,10,-76.532004,3.451668
42626,2017,Marzo,Filipinas,1,2,,3,-74.140516,4.697157
42627,2017,Marzo,Filipinas,1,0,,1,-75.42726,6.170465
42628,2017,Marzo,Finlandia,6,8,,14,-74.140516,4.697157
42629,2017,Marzo,Finlandia,0,3,,3,-75.42726,6.170465
42630,2017,Marzo,Francia,1,2,,3,-75.516486,10.446304
42631,2017,Marzo,Francia,2,4,,6,-74.77647900000001,10.886686
42632,2017,Marzo,Francia,22,27,,49,-76.532004,3.451668
42633,2017,Marzo,Francia,1379,2311,,3690,-74.140516,4.697157
42634,2017,Marzo,Francia,0,1,,1,-75.736374,4.815189
42635,2017,Marzo,Francia,31,58,,89,-75.42726,6.170465
42636,2017,Marzo,Francia,0,2,,2,-73.181317,7.1280470000000005
42637,2017,Marzo,Ghana,1,2,,3,-74.140516,4.697157
42638,2017,Marzo,Granada,1,1,,2,-75.527794,10.406342
42639,2017,Marzo,Granada,0,1,,1,-74.140516,4.697157
42640,2017,Marzo,Granada,1,0,,1,-75.42726,6.170465
42641,2017,Marzo,Grecia,0,2,,2,-76.532004,3.451668
42642,2017,Marzo,Grecia,3,7,,10,-74.140516,4.697157
42643,2017,Marzo,Grecia,0,2,,2,-75.42726,6.170465
42644,2017,Marzo,Guatemala,1,6,,7,-75.516486,10.446304
42645,2017,Marzo,Guatemala,1,0,,1,-74.77647900000001,10.886686
42646,2017,Marzo,Guatemala,38,33,,71,-81.70216500000001,12.5862
42647,2017,Marzo,Guatemala,17,25,,42,-76.532004,3.451668
42648,2017,Marzo,Guatemala,347,651,,998,-74.140516,4.697157
42649,2017,Marzo,Guatemala,3,5,,8,-75.736374,4.815189
42650,2017,Marzo,Guatemala,34,122,,156,-75.42726,6.170465
42651,2017,Marzo,Guyana,1,0,,1,-76.532004,3.451668
42652,2017,Marzo,Guyana,3,1,,4,-74.140516,4.697157
42653,2017,Marzo,Guyana,0,2,,2,-75.736374,4.815189
42654,2017,Marzo,Guyana,1,2,,3,-75.42726,6.170465
42655,2017,Marzo,Guadalupe/Territorio Francés,0,1,,1,-74.140516,4.697157
42656,2017,Marzo,Guayana Francesa/Departamento de Ultramar Francés,2,1,,3,-75.42726,6.170465
42657,2017,Marzo,Haití,0,1,,1,-75.527794,10.406342
42658,2017,Marzo,Haití,1,0,,1,-76.532004,3.451668
42659,2017,Marzo,Haití,1,4,,5,-74.140516,4.697157
42660,2017,Marzo,Haití,1,0,,1,-73.181317,7.1280470000000005
42661,2017,Marzo,Honduras,1,0,,1,-75.516486,10.446304
42662,2017,Marzo,Honduras,1,3,,4,-74.77647900000001,10.886686
42663,2017,Marzo,Honduras,1,2,,3,-81.70216500000001,12.5862
42664,2017,Marzo,Honduras,4,5,,9,-81.372937,13.338761300000002
42665,2017,Marzo,Honduras,15,7,,22,-76.532004,3.451668
42666,2017,Marzo,Honduras,62,85,,147,-74.140516,4.697157
42667,2017,Marzo,Honduras,3,18,,21,-75.736374,4.815189
42668,2017,Marzo,Honduras,18,20,,38,-75.42726,6.170465
42669,2017,Marzo,Hong Kong,3,1,,4,-74.140516,4.697157
42670,2017,Marzo,Hong Kong,1,0,,1,-73.181317,7.1280470000000005
42671,2017,Marzo,Hungría,0,1,,1,-76.532004,3.451668
42672,2017,Marzo,Hungría,6,6,,12,-74.140516,4.697157
42673,2017,Marzo,Hungría,1,2,,3,-75.42726,6.170465
42674,2017,Marzo,India,0,2,,2,-74.77647900000001,10.886686
42675,2017,Marzo,India,1,5,,6,-76.532004,3.451668
42676,2017,Marzo,India,3,36,,39,-74.140516,4.697157
42677,2017,Marzo,India,3,6,,9,-75.42726,6.170465
42678,2017,Marzo,Indonesia,0,3,,3,-76.532004,3.451668
42679,2017,Marzo,Indonesia,0,2,,2,-74.140516,4.697157
42680,2017,Marzo,Iraq,0,1,,1,-74.140516,4.697157
42681,2017,Marzo,Irán,0,1,,1,-75.42726,6.170465
42682,2017,Marzo,República de Irlanda,0,3,,3,-76.532004,3.451668
42683,2017,Marzo,República de Irlanda,14,24,,38,-74.140516,4.697157
42684,2017,Marzo,República de Irlanda,4,10,,14,-75.42726,6.170465
42685,2017,Marzo,Islandia,0,2,,2,-74.140516,4.697157
42686,2017,Marzo,Isla de Man,0,1,,1,-75.516486,10.446304
42687,2017,Marzo,Israel,1,2,,3,-75.516486,10.446304
42688,2017,Marzo,Israel,1,0,,1,-74.77647900000001,10.886686
42689,2017,Marzo,Israel,2,0,,2,-81.70216500000001,12.5862
42690,2017,Marzo,Israel,4,5,,9,-76.532004,3.451668
42691,2017,Marzo,Israel,22,90,,112,-74.140516,4.697157
42692,2017,Marzo,Israel,2,6,,8,-75.42726,6.170465
42693,2017,Marzo,Islas Aland/Provincia de Finlandia,1,0,,1,-76.532004,3.451668
42694,2017,Marzo,Italia,0,3,,3,-75.516486,10.446304
42695,2017,Marzo,Italia,2,1,,3,-74.77647900000001,10.886686
42696,2017,Marzo,Italia,18,43,,61,-76.532004,3.451668
42697,2017,Marzo,Italia,114,264,,378,-74.140516,4.697157
42698,2017,Marzo,Italia,1,2,,3,-75.736374,4.815189
42699,2017,Marzo,Italia,13,36,,49,-75.42726,6.170465
42700,2017,Marzo,Jamaica,0,2,,2,-75.516486,10.446304
42701,2017,Marzo,Jamaica,3,2,,5,-76.532004,3.451668
42702,2017,Marzo,Jamaica,3,9,,12,-74.140516,4.697157
42703,2017,Marzo,Jamaica,0,2,,2,-75.42726,6.170465
42704,2017,Marzo,Japón,1,0,,1,-75.516486,10.446304
42705,2017,Marzo,Japón,0,2,,2,-74.77647900000001,10.886686
42706,2017,Marzo,Japón,1,3,,4,-76.532004,3.451668
42707,2017,Marzo,Japón,6,27,,33,-74.140516,4.697157
42708,2017,Marzo,Japón,3,2,,5,-75.42726,6.170465
42709,2017,Marzo,Jordania,0,1,,1,-76.532004,3.451668
42710,2017,Marzo,Jordania,1,0,,1,-74.140516,4.697157
42711,2017,Marzo,Kazajistán,1,1,,2,-75.42726,6.170465
42712,2017,Marzo,Kenia,0,1,,1,-74.140516,4.697157
42713,2017,Marzo,Kuwait,0,1,,1,-74.140516,4.697157
42714,2017,Marzo,Letonia,1,0,,1,-76.532004,3.451668
42715,2017,Marzo,Letonia,1,8,,9,-74.140516,4.697157
42716,2017,Marzo,Letonia,1,1,,2,-75.42726,6.170465
42717,2017,Marzo,Lituania,0,1,,1,-74.77647900000001,10.886686
42718,2017,Marzo,Lituania,0,3,,3,-74.765343,10.970933
42719,2017,Marzo,Lituania,5,3,,8,-74.140516,4.697157
42720,2017,Marzo,Líbano,1,5,,6,-74.140516,4.697157
42721,2017,Marzo,Liechtenstein,0,1,,1,-75.42726,6.170465
42722,2017,Marzo,Luxemburgo,2,4,,6,-74.140516,4.697157
42723,2017,Marzo,Malasia,1,4,,5,-74.140516,4.697157
42724,2017,Marzo,Malawi,1,1,,2,-74.140516,4.697157
42725,2017,Marzo,Maldivas,0,1,,1,-74.140516,4.697157
42726,2017,Marzo,Malta,1,0,,1,-74.140516,4.697157
42727,2017,Marzo,Marruecos,0,2,,2,-74.140516,4.697157
42728,2017,Marzo,Martinica/Departamento de Ultramar Francés,1,2,,3,-75.527794,10.406342
42729,2017,Marzo,Martinica/Departamento de Ultramar Francés,0,1,,1,-75.516486,10.446304
42730,2017,Marzo,México,1,14,,15,-75.527794,10.406342
42731,2017,Marzo,México,9,29,,38,-75.516486,10.446304
42732,2017,Marzo,México,12,38,,50,-74.77647900000001,10.886686
42733,2017,Marzo,México,65,136,,201,-76.532004,3.451668
42734,2017,Marzo,México,4867,8814,,13681,-74.140516,4.697157
42735,2017,Marzo,México,8,21,,29,-75.736374,4.815189
42736,2017,Marzo,México,472,1394,,1866,-75.42726,6.170465
42737,2017,Marzo,México,1,3,,4,-73.181317,7.1280470000000005
42738,2017,Marzo,Mónaco,0,1,,1,-76.532004,3.451668
42739,2017,Marzo,Mónaco,1,1,,2,-74.140516,4.697157
42740,2017,Marzo,Nicaragua,0,1,,1,-75.516486,10.446304
42741,2017,Marzo,Nicaragua,0,2,,2,-74.77647900000001,10.886686
42742,2017,Marzo,Nicaragua,0,1,,1,-74.765343,10.970933
42743,2017,Marzo,Nicaragua,1,2,,3,-81.70216500000001,12.5862
42744,2017,Marzo,Nicaragua,5,4,,9,-76.532004,3.451668
42745,2017,Marzo,Nicaragua,21,61,,82,-74.140516,4.697157
42746,2017,Marzo,Nicaragua,3,4,,7,-75.736374,4.815189
42747,2017,Marzo,Nicaragua,2,18,,20,-75.42726,6.170465
42748,2017,Marzo,Nicaragua,0,2,,2,-73.181317,7.1280470000000005
42749,2017,Marzo,Noruega,1,2,,3,-76.532004,3.451668
42750,2017,Marzo,Noruega,25,28,,53,-74.140516,4.697157
42751,2017,Marzo,Noruega,0,1,,1,-75.736374,4.815189
42752,2017,Marzo,Noruega,4,2,,6,-75.42726,6.170465
42753,2017,Marzo,Nueva Zelanda,1,0,,1,-76.532004,3.451668
42754,2017,Marzo,Nueva Zelanda,5,9,,14,-74.140516,4.697157
42755,2017,Marzo,Nueva Zelanda,0,1,,1,-75.42726,6.170465
42756,2017,Marzo,Omán,0,2,,2,-74.140516,4.697157
42757,2017,Marzo,Pakistán,0,3,,3,-74.140516,4.697157
42758,2017,Marzo,Pakistán,0,2,,2,-75.42726,6.170465
42759,2017,Marzo,Panamá,1397,1126,,2523,-75.527794,10.406342
42760,2017,Marzo,Panamá,3869,4347,,8216,-75.516486,10.446304
42761,2017,Marzo,Panamá,240,494,,734,-74.77647900000001,10.886686
42762,2017,Marzo,Panamá,0,16,,16,-74.765343,10.970933
42763,2017,Marzo,Panamá,0,1,,1,-74.213989,11.247722999999999
42764,2017,Marzo,Panamá,18,33,,51,-81.703935,12.574411099999999
42765,2017,Marzo,Panamá,206,192,,398,-81.70216500000001,12.5862
42766,2017,Marzo,Panamá,6,8,,14,-81.372937,13.338761300000002
42767,2017,Marzo,Panamá,290,455,,745,-76.532004,3.451668
42768,2017,Marzo,Panamá,0,55,,55,-77.061029,3.8844260000000004
42769,2017,Marzo,Panamá,31,55,,86,-75.76635300000001,4.45285
42770,2017,Marzo,Panamá,3932,6017,,9949,-74.140516,4.697157
42771,2017,Marzo,Panamá,39,78,,117,-75.736374,4.815189
42772,2017,Marzo,Panamá,1603,2604,,4207,-75.42726,6.170465
42773,2017,Marzo,Panamá,0,1,,1,-77.401154,6.222551999999999
42774,2017,Marzo,Panamá,4,10,,14,-77.762647,7.102626
42775,2017,Marzo,Panamá,11,18,,29,-73.181317,7.1280470000000005
42776,2017,Marzo,Panamá,165,155,,320,-77.35002,8.63337
42777,2017,Marzo,Panamá,6,6,,12,-75.68164200000001,9.402597
42778,2017,Marzo,Paraguay,1,0,,1,-77.35600000000001,0.81488
42779,2017,Marzo,Paraguay,3,0,,3,-74.77647900000001,10.886686
42780,2017,Marzo,Paraguay,73,62,,135,-81.70216500000001,12.5862
42781,2017,Marzo,Paraguay,10,5,,15,-76.532004,3.451668
42782,2017,Marzo,Paraguay,60,75,,135,-74.140516,4.697157
42783,2017,Marzo,Paraguay,3,4,,7,-75.736374,4.815189
42784,2017,Marzo,Paraguay,7,13,,20,-75.42726,6.170465
42785,2017,Marzo,Perú,116,192,,308,-69.941498,4.191162
42786,2017,Marzo,Perú,54,57,,111,-69.94143100000001,4.214082
42787,2017,Marzo,Perú,1,13,,14,-77.35600000000001,0.81488
42788,2017,Marzo,Perú,1190,878,,2068,-75.516486,10.446304
42789,2017,Marzo,Perú,5,14,,19,-74.77647900000001,10.886686
42790,2017,Marzo,Perú,236,179,,415,-81.70216500000001,12.5862
42791,2017,Marzo,Perú,380,510,,890,-76.532004,3.451668
42792,2017,Marzo,Perú,6392,8638,,15030,-74.140516,4.697157
42793,2017,Marzo,Perú,1,0,,1,-75.736374,4.815189
42794,2017,Marzo,Perú,591,955,,1546,-75.42726,6.170465
42795,2017,Marzo,Perú,1,4,,5,-73.181317,7.1280470000000005
42796,2017,Marzo,Polonia,0,1,,1,-75.516486,10.446304
42797,2017,Marzo,Polonia,15,22,,37,-74.140516,4.697157
42798,2017,Marzo,Polonia,2,1,,3,-75.42726,6.170465
42799,2017,Marzo,Portugal,3,8,,11,-76.532004,3.451668
42800,2017,Marzo,Portugal,31,90,,121,-74.140516,4.697157
42801,2017,Marzo,Portugal,0,3,,3,-75.42726,6.170465
42802,2017,Marzo,Puerto Rico/Territorio de Estados Unidos,1,1,,2,-75.516486,10.446304
42803,2017,Marzo,Puerto Rico/Territorio de Estados Unidos,7,45,,52,-74.77647900000001,10.886686
42804,2017,Marzo,Puerto Rico/Territorio de Estados Unidos,30,67,,97,-76.532004,3.451668
42805,2017,Marzo,Puerto Rico/Territorio de Estados Unidos,299,558,,857,-74.140516,4.697157
42806,2017,Marzo,Puerto Rico/Territorio de Estados Unidos,3,4,,7,-75.736374,4.815189
42807,2017,Marzo,Puerto Rico/Territorio de Estados Unidos,72,196,,268,-75.42726,6.170465
42808,2017,Marzo,Puerto Rico/Territorio de Estados Unidos,2,2,,4,-73.181317,7.1280470000000005
42809,2017,Marzo,Reino Unido de Gran Bretaña e Irlanda del Norte,1,1,,2,-75.516486,10.446304
42810,2017,Marzo,Reino Unido de Gran Bretaña e Irlanda del Norte,0,2,,2,-74.77647900000001,10.886686
42811,2017,Marzo,Reino Unido de Gran Bretaña e Irlanda del Norte,6,12,,18,-76.532004,3.451668
42812,2017,Marzo,Reino Unido de Gran Bretaña e Irlanda del Norte,780,1394,,2174,-74.140516,4.697157
42813,2017,Marzo,Reino Unido de Gran Bretaña e Irlanda del Norte,18,32,,50,-75.42726,6.170465
42814,2017,Marzo,Reino Unido de Gran Bretaña e Irlanda del Norte,4,1,,5,-73.181317,7.1280470000000005
42815,2017,Marzo,República CentroÁfricana,0,2,,2,-76.532004,3.451668
42816,2017,Marzo,República CentroÁfricana,1,1,,2,-74.140516,4.697157
42817,2017,Marzo,Federación de Rusia,0,5,,5,-75.527794,10.406342
42818,2017,Marzo,Federación de Rusia,1,0,,1,-75.516486,10.446304
42819,2017,Marzo,Federación de Rusia,2,4,,6,-76.532004,3.451668
42820,2017,Marzo,Federación de Rusia,0,2,,2,-77.061029,3.8844260000000004
42821,2017,Marzo,Federación de Rusia,19,21,,40,-74.140516,4.697157
42822,2017,Marzo,Federación de Rusia,2,1,,3,-75.42726,6.170465
42823,2017,Marzo,República Dominicana,0,17,,17,-75.527794,10.406342
42824,2017,Marzo,República Dominicana,3,2,,5,-75.516486,10.446304
42825,2017,Marzo,República Dominicana,7,23,,30,-74.77647900000001,10.886686
42826,2017,Marzo,República Dominicana,0,5,,5,-74.232675,11.117206
42827,2017,Marzo,República Dominicana,20,27,,47,-76.532004,3.451668
42828,2017,Marzo,República Dominicana,598,912,,1510,-74.140516,4.697157
42829,2017,Marzo,República Dominicana,14,26,,40,-75.736374,4.815189
42830,2017,Marzo,República Dominicana,28,55,,83,-75.42726,6.170465
42831,2017,Marzo,República Dominicana,2,4,,6,-73.181317,7.1280470000000005
42832,2017,Marzo,Reunión,0,2,,2,-74.140516,4.697157
42833,2017,Marzo,Rumania,5,14,,19,-74.140516,4.697157
42834,2017,Marzo,Rumania,1,4,,5,-75.42726,6.170465
42835,2017,Marzo,San Cristóbal y Nevis,0,1,,1,-75.42726,6.170465
42836,2017,Marzo,San Marino,0,2,,2,-75.527794,10.406342
42837,2017,Marzo,San  Vicente y las Granadinas,1,2,,3,-75.527794,10.406342
42838,2017,Marzo,San  Vicente y las Granadinas,1,1,,2,-74.140516,4.697157
42839,2017,Marzo,Santa Lucia,1,0,,1,-75.42726,6.170465
42840,2017,Marzo,Senegal,1,0,,1,-74.140516,4.697157
42841,2017,Marzo,Serbia,1,1,,2,-76.532004,3.451668
42842,2017,Marzo,Serbia,0,2,,2,-75.42726,6.170465
42843,2017,Marzo,Singapur,0,1,,1,-74.213989,11.247722999999999
42844,2017,Marzo,Singapur,0,3,,3,-74.140516,4.697157
42845,2017,Marzo,Singapur,0,1,,1,-75.42726,6.170465
42846,2017,Marzo,República Árabe Siria,1,0,,1,-74.140516,4.697157
42847,2017,Marzo,Somalia,0,3,,3,-74.140516,4.697157
42848,2017,Marzo,Sri Lanka,0,1,,1,-76.532004,3.451668
42849,2017,Marzo,Sri Lanka,0,1,,1,-74.140516,4.697157
42850,2017,Marzo,Sudáfrica,0,1,,1,-76.532004,3.451668
42851,2017,Marzo,Sudáfrica,6,6,,12,-74.140516,4.697157
42852,2017,Marzo,Sudáfrica,0,2,,2,-75.42726,6.170465
42853,2017,Marzo,Sudán,0,1,,1,-74.140516,4.697157
42854,2017,Marzo,Suecia,0,1,,1,-74.77647900000001,10.886686
42855,2017,Marzo,Suecia,1,3,,4,-76.532004,3.451668
42856,2017,Marzo,Suecia,35,59,,94,-74.140516,4.697157
42857,2017,Marzo,Suecia,2,1,,3,-75.736374,4.815189
42858,2017,Marzo,Suecia,1,4,,5,-75.42726,6.170465
42859,2017,Marzo,Suiza,1,0,,1,-75.516486,10.446304
42860,2017,Marzo,Suiza,1,1,,2,-81.70216500000001,12.5862
42861,2017,Marzo,Suiza,8,27,,35,-76.532004,3.451668
42862,2017,Marzo,Suiza,90,100,,190,-74.140516,4.697157
42863,2017,Marzo,Suiza,15,34,,49,-75.42726,6.170465
42864,2017,Marzo,Surinam,3,8,,11,-74.140516,4.697157
42865,2017,Marzo,Taiwán,0,2,,2,-74.77647900000001,10.886686
42866,2017,Marzo,Taiwán,1,0,,1,-76.532004,3.451668
42867,2017,Marzo,Taiwán,1,4,,5,-74.140516,4.697157
42868,2017,Marzo,Taiwán,1,1,,2,-75.42726,6.170465
42869,2017,Marzo,Tailandia,1,0,,1,-74.77647900000001,10.886686
42870,2017,Marzo,Tailandia,1,3,,4,-74.140516,4.697157
42871,2017,Marzo,República Democrática de Timor Oriental,0,1,,1,-74.140516,4.697157
42872,2017,Marzo,Trinidad y Tobago,0,4,,4,-75.527794,10.406342
42873,2017,Marzo,Trinidad y Tobago,0,1,,1,-74.77647900000001,10.886686
42874,2017,Marzo,Trinidad y Tobago,0,1,,1,-81.70216500000001,12.5862
42875,2017,Marzo,Trinidad y Tobago,0,8,,8,-76.532004,3.451668
42876,2017,Marzo,Trinidad y Tobago,4,15,,19,-74.140516,4.697157
42877,2017,Marzo,Trinidad y Tobago,0,1,,1,-75.736374,4.815189
42878,2017,Marzo,Trinidad y Tobago,1,3,,4,-75.42726,6.170465
42879,2017,Marzo,Trinidad y Tobago,0,1,,1,-73.181317,7.1280470000000005
42880,2017,Marzo,Túnez,0,2,,2,-74.140516,4.697157
42881,2017,Marzo,Turkmenistán,0,2,,2,-74.140516,4.697157
42882,2017,Marzo,Turquía,6,6,,12,-76.532004,3.451668
42883,2017,Marzo,Turquía,175,408,,583,-74.140516,4.697157
42884,2017,Marzo,Turquía,0,5,,5,-75.42726,6.170465
42885,2017,Marzo,Ucrania,0,2,,2,-76.532004,3.451668
42886,2017,Marzo,Ucrania,2,1,,3,-74.140516,4.697157
42887,2017,Marzo,Uganda,1,2,,3,-74.140516,4.697157
42888,2017,Marzo,Uruguay,6,4,,10,-75.516486,10.446304
42889,2017,Marzo,Uruguay,2,3,,5,-74.77647900000001,10.886686
42890,2017,Marzo,Uruguay,29,30,,59,-81.70216500000001,12.5862
42891,2017,Marzo,Uruguay,8,22,,30,-76.532004,3.451668
42892,2017,Marzo,Uruguay,79,115,,194,-74.140516,4.697157
42893,2017,Marzo,Uruguay,25,43,,68,-75.42726,6.170465
42894,2017,Marzo,Venezuela,14,50,,64,-75.516486,10.446304
42895,2017,Marzo,Venezuela,19,82,,101,-74.77647900000001,10.886686
42896,2017,Marzo,Venezuela,0,1,,1,-74.765343,10.970933
42897,2017,Marzo,Venezuela,0,1,,1,-74.213989,11.247722999999999
42898,2017,Marzo,Venezuela,4080,5005,,9085,-72.129595,11.360028999999999
42899,2017,Marzo,Venezuela,0,1,,1,-81.70216500000001,12.5862
42900,2017,Marzo,Venezuela,23,24,,47,-76.532004,3.451668
42901,2017,Marzo,Venezuela,167,179,,346,-67.927521,3.866713
42902,2017,Marzo,Venezuela,2535,3221,,5756,-74.140516,4.697157
42903,2017,Marzo,Venezuela,1,2,,3,-75.736374,4.815189
42904,2017,Marzo,Venezuela,391,475,,866,-75.42726,6.170465
42905,2017,Marzo,Venezuela,323,484,,807,-67.48402800000001,6.185536
42906,2017,Marzo,Venezuela,89,130,,219,-70.74025300000001,7.088728999999999
42907,2017,Marzo,Venezuela,4,8,,12,-73.181317,7.1280470000000005
42908,2017,Marzo,Venezuela,7200,9792,,16992,-72.453013,7.819
42909,2017,Marzo,Venezuela,0,5,,5,-72.508188,7.927233
42910,2017,Marzo,Venezuela,240,349,,589,-72.409396,8.36068
42911,2017,Marzo,Vietnam,4,3,,7,-74.140516,4.697157
42912,2017,Marzo,Islas Vírgenes Británicas/Territorio Británico de Ultramar,1,4,,5,-75.527794,10.406342
42913,2017,Marzo,Islas Vírgenes Británicas/Territorio Británico de Ultramar,0,9,,9,-75.516486,10.446304
42914,2017,Marzo,Islas Vírgenes Estadounidenses/Territorio de Estados Unidos,2,5,,7,-75.516486,10.446304
42915,2017,Marzo,Zimbabue,0,2,,2,-74.140516,4.697157
42916,2017,Abril,Albania,0,1,,1,-74.140516,4.697157
42917,2017,Abril,Albania,2,0,,2,-72.453013,7.819
42918,2017,Abril,Alemania,2,1,,3,-77.35600000000001,0.81488
42919,2017,Abril,Alemania,0,1,,1,-75.516486,10.446304
42920,2017,Abril,Alemania,3,6,,9,-74.77647900000001,10.886686
42921,2017,Abril,Alemania,0,2,,2,-74.213989,11.247722999999999
42922,2017,Abril,Alemania,17,12,,29,-76.532004,3.451668
42923,2017,Abril,Alemania,1352,1991,,3343,-74.140516,4.697157
42924,2017,Abril,Alemania,0,1,,1,-75.736374,4.815189
42925,2017,Abril,Alemania,31,46,,77,-75.42726,6.170465
42926,2017,Abril,Alemania,0,2,,2,-76.7333,8.06667
42927,2017,Abril,Andorra,2,2,,4,-74.140516,4.697157
42928,2017,Abril,Angola,0,1,,1,-75.42726,6.170465
42929,2017,Abril,Antigua y Barbuda,0,5,,5,-75.527794,10.406342
42930,2017,Abril,Antigua y Barbuda,2,4,,6,-74.140516,4.697157
42931,2017,Abril,Países Bajos,2,6,,8,-75.527794,10.406342
42932,2017,Abril,Países Bajos,179,315,,494,-75.516486,10.446304
42933,2017,Abril,Países Bajos,11,15,,26,-74.77647900000001,10.886686
42934,2017,Abril,Países Bajos,2,1,,3,-74.232675,11.117206
42935,2017,Abril,Países Bajos,4,5,,9,-74.213989,11.247722999999999
42936,2017,Abril,Países Bajos,21,24,,45,-76.532004,3.451668
42937,2017,Abril,Países Bajos,0,1,,1,-77.061029,3.8844260000000004
42938,2017,Abril,Países Bajos,1087,1417,,2504,-74.140516,4.697157
42939,2017,Abril,Países Bajos,0,4,,4,-75.736374,4.815189
42940,2017,Abril,Países Bajos,119,120,,239,-75.42726,6.170465
42941,2017,Abril,Países Bajos,3,7,,10,-73.181317,7.1280470000000005
42942,2017,Abril,Arabia Saudita,0,2,,2,-74.140516,4.697157
42943,2017,Abril,Argelia,1,0,,1,-75.516486,10.446304
42944,2017,Abril,Argelia,0,3,,3,-74.140516,4.697157
42945,2017,Abril,Argentina,3,13,,16,-77.35600000000001,0.81488
42946,2017,Abril,Argentina,123,83,,206,-75.516486,10.446304
42947,2017,Abril,Argentina,4,8,,12,-74.77647900000001,10.886686
42948,2017,Abril,Argentina,147,103,,250,-81.70216500000001,12.5862
42949,2017,Abril,Argentina,25,76,,101,-76.532004,3.451668
42950,2017,Abril,Argentina,4033,4535,,8568,-74.140516,4.697157
42951,2017,Abril,Argentina,0,2,,2,-75.736374,4.815189
42952,2017,Abril,Argentina,48,97,,145,-75.42726,6.170465
42953,2017,Abril,Argentina,0,1,,1,-73.181317,7.1280470000000005
42954,2017,Abril,Aruba,17,35,,52,-75.527794,10.406342
42955,2017,Abril,Aruba,0,2,,2,-75.516486,10.446304
42956,2017,Abril,Aruba,4,3,,7,-74.77647900000001,10.886686
42957,2017,Abril,Aruba,0,2,,2,-74.232675,11.117206
42958,2017,Abril,Aruba,3,13,,16,-74.213989,11.247722999999999
42959,2017,Abril,Aruba,16,13,,29,-76.532004,3.451668
42960,2017,Abril,Aruba,960,1059,,2019,-74.140516,4.697157
42961,2017,Abril,Aruba,59,57,,116,-75.736374,4.815189
42962,2017,Abril,Aruba,21,33,,54,-75.42726,6.170465
42963,2017,Abril,Aruba,6,3,,9,-73.181317,7.1280470000000005
42964,2017,Abril,Australia,1,1,,2,-75.516486,10.446304
42965,2017,Abril,Australia,6,4,,10,-76.532004,3.451668
42966,2017,Abril,Australia,29,54,,83,-74.140516,4.697157
42967,2017,Abril,Australia,0,1,,1,-75.736374,4.815189
42968,2017,Abril,Australia,11,24,,35,-75.42726,6.170465
42969,2017,Abril,Austria,2,0,,2,-76.532004,3.451668
42970,2017,Abril,Austria,17,26,,43,-74.140516,4.697157
42971,2017,Abril,Austria,2,2,,4,-75.42726,6.170465
42972,2017,Abril,Bahamas,0,2,,2,-75.527794,10.406342
42973,2017,Abril,Bahamas,2,3,,5,-75.516486,10.446304
42974,2017,Abril,Bahamas,0,1,,1,-76.532004,3.451668
42975,2017,Abril,Bahamas,2,2,,4,-74.140516,4.697157
42976,2017,Abril,Bahamas,2,6,,8,-75.42726,6.170465
42977,2017,Abril,Bahréin,3,4,,7,-75.516486,10.446304
42978,2017,Abril,Bahréin,1,0,,1,-74.140516,4.697157
42979,2017,Abril,Barbados,51,60,,111,-74.140516,4.697157
42980,2017,Abril,Barbados,0,1,,1,-75.736374,4.815189
42981,2017,Abril,República de Belarús,1,0,,1,-72.129595,11.360028999999999
42982,2017,Abril,República de Belarús,4,1,,5,-74.140516,4.697157
42983,2017,Abril,Bélgica,0,1,,1,-75.527794,10.406342
42984,2017,Abril,Bélgica,1,0,,1,-74.77647900000001,10.886686
42985,2017,Abril,Bélgica,1,9,,10,-76.532004,3.451668
42986,2017,Abril,Bélgica,27,63,,90,-74.140516,4.697157
42987,2017,Abril,Bélgica,0,2,,2,-75.736374,4.815189
42988,2017,Abril,Bélgica,6,10,,16,-75.42726,6.170465
42989,2017,Abril,Bélgica,1,1,,2,-73.181317,7.1280470000000005
42990,2017,Abril,Belice,2,0,,2,-76.532004,3.451668
42991,2017,Abril,Belice,1,3,,4,-74.140516,4.697157
42992,2017,Abril,Belice,1,1,,2,-75.42726,6.170465
42993,2017,Abril,Bermudas/Territorio Británico de Ultramar,0,1,,1,-74.140516,4.697157
42994,2017,Abril,Bolivia,2,1,,3,-77.35600000000001,0.81488
42995,2017,Abril,Bolivia,3,1,,4,-75.516486,10.446304
42996,2017,Abril,Bolivia,22,20,,42,-81.70216500000001,12.5862
42997,2017,Abril,Bolivia,26,20,,46,-76.532004,3.451668
42998,2017,Abril,Bolivia,379,524,,903,-74.140516,4.697157
42999,2017,Abril,Bolivia,2,0,,2,-75.736374,4.815189
43000,2017,Abril,Bolivia,17,19,,36,-75.42726,6.170465
43001,2017,Abril,Bosnia y Herzegovina,0,1,,1,-74.140516,4.697157
43002,2017,Abril,Brasil,145,161,,306,-69.941498,4.191162
43003,2017,Abril,Brasil,19,20,,39,-69.94143100000001,4.214082
43004,2017,Abril,Brasil,0,5,,5,-75.527794,10.406342
43005,2017,Abril,Brasil,27,16,,43,-75.516486,10.446304
43006,2017,Abril,Brasil,3,0,,3,-74.77647900000001,10.886686
43007,2017,Abril,Brasil,376,274,,650,-81.70216500000001,12.5862
43008,2017,Abril,Brasil,66,85,,151,-76.532004,3.451668
43009,2017,Abril,Brasil,1,2,,3,-67.927521,3.866713
43010,2017,Abril,Brasil,4733,6124,,10857,-74.140516,4.697157
43011,2017,Abril,Brasil,0,3,,3,-75.736374,4.815189
43012,2017,Abril,Brasil,71,141,,212,-75.42726,6.170465
43013,2017,Abril,Brasil,2,1,,3,-73.181317,7.1280470000000005
43014,2017,Abril,Bulgaria,3,3,,6,-74.140516,4.697157
43015,2017,Abril,Burkina Faso,0,2,,2,-74.140516,4.697157
43016,2017,Abril,Burkina Faso,0,1,,1,-75.42726,6.170465
43017,2017,Abril,Islas Caimán/Territorio Británico de Ultramar,6,14,,20,-81.70216500000001,12.5862
43018,2017,Abril,Islas Caimán/Territorio Británico de Ultramar,1,2,,3,-81.372937,13.338761300000002
43019,2017,Abril,Islas Caimán/Territorio Británico de Ultramar,0,1,,1,-75.42726,6.170465
43020,2017,Abril,Canadá,0,2,,2,-75.527794,10.406342
43021,2017,Abril,Canadá,24,40,,64,-75.516486,10.446304
43022,2017,Abril,Canadá,1,6,,7,-74.77647900000001,10.886686
43023,2017,Abril,Canadá,0,1,,1,-72.919186,11.52863
43024,2017,Abril,Canadá,0,1,,1,-81.70216500000001,12.5862
43025,2017,Abril,Canadá,27,39,,66,-76.532004,3.451668
43026,2017,Abril,Canadá,648,969,,1617,-74.140516,4.697157
43027,2017,Abril,Canadá,1,7,,8,-75.736374,4.815189
43028,2017,Abril,Canadá,84,211,,295,-75.42726,6.170465
43029,2017,Abril,Canadá,2,4,,6,-73.181317,7.1280470000000005
43030,2017,Abril,Chad,0,1,,1,-74.140516,4.697157
43031,2017,Abril,España,1,4,,5,-75.527794,10.406342
43032,2017,Abril,España,2,5,,7,-75.516486,10.446304
43033,2017,Abril,España,1,1,,2,-74.77647900000001,10.886686
43034,2017,Abril,España,422,562,,984,-76.532004,3.451668
43035,2017,Abril,España,3611,5619,,9230,-74.140516,4.697157
43036,2017,Abril,España,2,1,,3,-75.736374,4.815189
43037,2017,Abril,España,496,816,,1312,-75.42726,6.170465
43038,2017,Abril,España,1,2,,3,-73.181317,7.1280470000000005
43039,2017,Abril,República de Corea,0,4,,4,-77.061029,3.8844260000000004
43040,2017,Abril,República de Corea,10,19,,29,-74.140516,4.697157
43041,2017,Abril,República de Corea,0,3,,3,-75.42726,6.170465
43042,2017,Abril,Costa de Marfil,1,0,,1,-75.516486,10.446304
43043,2017,Abril,Costa de Marfil,0,2,,2,-76.532004,3.451668
43044,2017,Abril,Costa de Marfil,7,3,,10,-74.140516,4.697157
43045,2017,Abril,Costa de Marfil,0,1,,1,-75.42726,6.170465
43046,2017,Abril,Costa Rica,1,3,,4,-75.527794,10.406342
43047,2017,Abril,Costa Rica,191,127,,318,-75.516486,10.446304
43048,2017,Abril,Costa Rica,8,8,,16,-74.77647900000001,10.886686
43049,2017,Abril,Costa Rica,0,3,,3,-74.232675,11.117206
43050,2017,Abril,Costa Rica,319,248,,567,-81.70216500000001,12.5862
43051,2017,Abril,Costa Rica,34,46,,80,-76.532004,3.451668
43052,2017,Abril,Costa Rica,1553,1890,,3443,-74.140516,4.697157
43053,2017,Abril,Costa Rica,6,6,,12,-75.736374,4.815189
43054,2017,Abril,Costa Rica,75,135,,210,-75.42726,6.170465
43055,2017,Abril,Costa Rica,0,1,,1,-73.181317,7.1280470000000005
43056,2017,Abril,Costa Rica,0,1,,1,-76.7333,8.06667
43057,2017,Abril,Croacia,0,5,,5,-76.532004,3.451668
43058,2017,Abril,Croacia,0,5,,5,-74.140516,4.697157
43059,2017,Abril,Croacia,1,1,,2,-75.42726,6.170465
43060,2017,Abril,Cuba,0,1,,1,-75.516486,10.446304
43061,2017,Abril,Cuba,5,13,,18,-74.77647900000001,10.886686
43062,2017,Abril,Cuba,0,1,,1,-81.70216500000001,12.5862
43063,2017,Abril,Cuba,1,1,,2,-81.372937,13.338761300000002
43064,2017,Abril,Cuba,27,33,,60,-76.532004,3.451668
43065,2017,Abril,Cuba,388,555,,943,-74.140516,4.697157
43066,2017,Abril,Cuba,1,4,,5,-75.736374,4.815189
43067,2017,Abril,Cuba,22,24,,46,-75.42726,6.170465
43068,2017,Abril,Cuba,1,2,,3,-73.181317,7.1280470000000005
43069,2017,Abril,Curazao,0,3,,3,-74.140516,4.697157
43070,2017,Abril,República Checa,1,0,,1,-76.532004,3.451668
43071,2017,Abril,República Checa,3,7,,10,-74.140516,4.697157
43072,2017,Abril,Chile,4,5,,9,-77.35600000000001,0.81488
43073,2017,Abril,Chile,16,17,,33,-75.516486,10.446304
43074,2017,Abril,Chile,4,4,,8,-74.77647900000001,10.886686
43075,2017,Abril,Chile,130,115,,245,-81.70216500000001,12.5862
43076,2017,Abril,Chile,30,53,,83,-76.532004,3.451668
43077,2017,Abril,Chile,4658,5789,,10447,-74.140516,4.697157
43078,2017,Abril,Chile,3,5,,8,-75.736374,4.815189
43079,2017,Abril,Chile,19,45,,64,-75.42726,6.170465
43080,2017,Abril,Chile,1,1,,2,-73.181317,7.1280470000000005
43081,2017,Abril,China,2,3,,5,-76.532004,3.451668
43082,2017,Abril,China,18,91,,109,-74.140516,4.697157
43083,2017,Abril,China,0,4,,4,-75.42726,6.170465
43084,2017,Abril,Dinamarca,0,1,,1,-74.77647900000001,10.886686
43085,2017,Abril,Dinamarca,0,3,,3,-76.532004,3.451668
43086,2017,Abril,Dinamarca,10,15,,25,-74.140516,4.697157
43087,2017,Abril,Dinamarca,2,3,,5,-75.42726,6.170465
43088,2017,Abril,Dominica,0,1,,1,-76.532004,3.451668
43089,2017,Abril,Dominica,1,0,,1,-74.140516,4.697157
43090,2017,Abril,Ecuador,1,0,,1,-74.78366,0.18595699999999998
43091,2017,Abril,Ecuador,94,351,,445,-76.876446,0.33002
43092,2017,Abril,Ecuador,4120,5400,,9520,-77.35600000000001,0.81488
43093,2017,Abril,Ecuador,38,58,,96,-78.802679,18.00143
43094,2017,Abril,Ecuador,0,1,,1,-75.527794,10.406342
43095,2017,Abril,Ecuador,3,8,,11,-75.516486,10.446304
43096,2017,Abril,Ecuador,0,1,,1,-74.77647900000001,10.886686
43097,2017,Abril,Ecuador,10,6,,16,-81.70216500000001,12.5862
43098,2017,Abril,Ecuador,495,558,,1053,-76.532004,3.451668
43099,2017,Abril,Ecuador,3409,4602,,8011,-74.140516,4.697157
43100,2017,Abril,Ecuador,1,2,,3,-75.736374,4.815189
43101,2017,Abril,Ecuador,28,55,,83,-75.42726,6.170465
43102,2017,Abril,Ecuador,2,2,,4,-73.181317,7.1280470000000005
43103,2017,Abril,Egipto,0,3,,3,-74.140516,4.697157
43104,2017,Abril,El Salvador,1,2,,3,-75.516486,10.446304
43105,2017,Abril,El Salvador,0,1,,1,-74.77647900000001,10.886686
43106,2017,Abril,El Salvador,13,13,,26,-81.70216500000001,12.5862
43107,2017,Abril,El Salvador,112,178,,290,-76.532004,3.451668
43108,2017,Abril,El Salvador,1129,1495,,2624,-74.140516,4.697157
43109,2017,Abril,El Salvador,0,1,,1,-75.736374,4.815189
43110,2017,Abril,El Salvador,168,275,,443,-75.42726,6.170465
43111,2017,Abril,Emiratos Árabes,1,0,,1,-75.516486,10.446304
43112,2017,Abril,Emiratos Árabes,0,4,,4,-74.140516,4.697157
43113,2017,Abril,Eslovaquia,3,2,,5,-74.140516,4.697157
43114,2017,Abril,Eslovenia,0,1,,1,-76.532004,3.451668
43115,2017,Abril,Eslovenia,0,4,,4,-74.140516,4.697157
43116,2017,Abril,Estados Unidos de América,0,4,,4,-78.802679,18.00143
43117,2017,Abril,Estados Unidos de América,5,55,,60,-75.527794,10.406342
43118,2017,Abril,Estados Unidos de América,4,24,,28,-73.247863,10.433608999999999
43119,2017,Abril,Estados Unidos de América,2970,4194,,7164,-75.516486,10.446304
43120,2017,Abril,Estados Unidos de América,531,959,,1490,-74.77647900000001,10.886686
43121,2017,Abril,Estados Unidos de América,0,24,,24,-74.765343,10.970933
43122,2017,Abril,Estados Unidos de América,0,21,,21,-74.213989,11.247722999999999
43123,2017,Abril,Estados Unidos de América,3,87,,90,-72.919186,11.52863
43124,2017,Abril,Estados Unidos de América,8,15,,23,-81.70216500000001,12.5862
43125,2017,Abril,Estados Unidos de América,1164,1469,,2633,-76.532004,3.451668
43126,2017,Abril,Estados Unidos de América,0,4,,4,-77.061029,3.8844260000000004
43127,2017,Abril,Estados Unidos de América,73,127,,200,-75.76635300000001,4.45285
43128,2017,Abril,Estados Unidos de América,8325,14329,,22654,-74.140516,4.697157
43129,2017,Abril,Estados Unidos de América,83,167,,250,-75.736374,4.815189
43130,2017,Abril,Estados Unidos de América,2239,5211,,7450,-75.42726,6.170465
43131,2017,Abril,Estados Unidos de América,23,38,,61,-73.181317,7.1280470000000005
43132,2017,Abril,Estados Unidos de América,0,13,,13,-75.68164200000001,9.402597
43133,2017,Abril,Estonia,1,1,,2,-76.532004,3.451668
43134,2017,Abril,Etiopia,0,1,,1,-74.140516,4.697157
43135,2017,Abril,Filipinas,0,1,,1,-74.77647900000001,10.886686
43136,2017,Abril,Filipinas,0,8,,8,-76.532004,3.451668
43137,2017,Abril,Filipinas,4,20,,24,-74.140516,4.697157
43138,2017,Abril,Filipinas,0,2,,2,-75.42726,6.170465
43139,2017,Abril,Finlandia,1,0,,1,-74.77647900000001,10.886686
43140,2017,Abril,Finlandia,2,0,,2,-76.532004,3.451668
43141,2017,Abril,Finlandia,2,5,,7,-74.140516,4.697157
43142,2017,Abril,Finlandia,1,1,,2,-75.42726,6.170465
43143,2017,Abril,Francia,3,1,,4,-75.516486,10.446304
43144,2017,Abril,Francia,1,1,,2,-74.77647900000001,10.886686
43145,2017,Abril,Francia,20,31,,51,-76.532004,3.451668
43146,2017,Abril,Francia,1395,2216,,3611,-74.140516,4.697157
43147,2017,Abril,Francia,1,8,,9,-75.736374,4.815189
43148,2017,Abril,Francia,38,50,,88,-75.42726,6.170465
43149,2017,Abril,Georgia,0,4,,4,-74.140516,4.697157
43150,2017,Abril,Gibraltar/Territorio Británico de Ultramar,0,1,,1,-74.213989,11.247722999999999
43151,2017,Abril,Gibraltar/Territorio Británico de Ultramar,1,0,,1,-74.140516,4.697157
43152,2017,Abril,Grecia,0,1,,1,-76.532004,3.451668
43153,2017,Abril,Grecia,1,7,,8,-74.140516,4.697157
43154,2017,Abril,Grecia,0,1,,1,-75.42726,6.170465
43155,2017,Abril,Groenlandia,0,1,,1,-74.140516,4.697157
43156,2017,Abril,Guatemala,1,7,,8,-75.527794,10.406342
43157,2017,Abril,Guatemala,16,26,,42,-75.516486,10.446304
43158,2017,Abril,Guatemala,0,5,,5,-74.77647900000001,10.886686
43159,2017,Abril,Guatemala,45,35,,80,-81.70216500000001,12.5862
43160,2017,Abril,Guatemala,18,46,,64,-76.532004,3.451668
43161,2017,Abril,Guatemala,343,548,,891,-74.140516,4.697157
43162,2017,Abril,Guatemala,2,7,,9,-75.736374,4.815189
43163,2017,Abril,Guatemala,48,102,,150,-75.42726,6.170465
43164,2017,Abril,Guatemala,2,2,,4,-73.181317,7.1280470000000005
43165,2017,Abril,Guyana,2,2,,4,-76.532004,3.451668
43166,2017,Abril,Guyana,1,2,,3,-74.140516,4.697157
43167,2017,Abril,Guyana,1,0,,1,-75.42726,6.170465
43168,2017,Abril,Guadalupe/Territorio Francés,0,1,,1,-75.516486,10.446304
43169,2017,Abril,Guadalupe/Territorio Francés,1,4,,5,-74.140516,4.697157
43170,2017,Abril,Guayana Francesa/Departamento de Ultramar Francés,0,1,,1,-75.736374,4.815189
43171,2017,Abril,Haití,0,1,,1,-75.527794,10.406342
43172,2017,Abril,Haití,2,1,,3,-75.516486,10.446304
43173,2017,Abril,Haití,0,3,,3,-74.140516,4.697157
43174,2017,Abril,Haití,0,1,,1,-75.42726,6.170465
43175,2017,Abril,Honduras,0,1,,1,-75.527794,10.406342
43176,2017,Abril,Honduras,4,6,,10,-75.516486,10.446304
43177,2017,Abril,Honduras,2,0,,2,-74.77647900000001,10.886686
43178,2017,Abril,Honduras,0,1,,1,-74.213989,11.247722999999999
43179,2017,Abril,Honduras,3,2,,5,-81.70216500000001,12.5862
43180,2017,Abril,Honduras,3,5,,8,-81.372937,13.338761300000002
43181,2017,Abril,Honduras,16,20,,36,-76.532004,3.451668
43182,2017,Abril,Honduras,107,108,,215,-74.140516,4.697157
43183,2017,Abril,Honduras,1,3,,4,-75.736374,4.815189
43184,2017,Abril,Honduras,34,77,,111,-75.42726,6.170465
43185,2017,Abril,Honduras,2,0,,2,-73.181317,7.1280470000000005
43186,2017,Abril,Hong Kong,1,2,,3,-74.140516,4.697157
43187,2017,Abril,Hungría,2,3,,5,-74.140516,4.697157
43188,2017,Abril,Hungría,0,1,,1,-75.42726,6.170465
43189,2017,Abril,India,0,1,,1,-75.516486,10.446304
43190,2017,Abril,India,1,0,,1,-76.532004,3.451668
43191,2017,Abril,India,7,32,,39,-74.140516,4.697157
43192,2017,Abril,India,1,0,,1,-75.736374,4.815189
43193,2017,Abril,India,2,5,,7,-75.42726,6.170465
43194,2017,Abril,Indonesia,0,1,,1,-76.532004,3.451668
43195,2017,Abril,Indonesia,1,2,,3,-74.140516,4.697157
43196,2017,Abril,República de Irlanda,1,2,,3,-76.532004,3.451668
43197,2017,Abril,República de Irlanda,5,14,,19,-74.140516,4.697157
43198,2017,Abril,República de Irlanda,2,3,,5,-75.42726,6.170465
43199,2017,Abril,República de Irlanda,0,1,,1,-73.181317,7.1280470000000005
43200,2017,Abril,Islandia,2,1,,3,-74.140516,4.697157
43201,2017,Abril,Israel,1,0,,1,-76.532004,3.451668
43202,2017,Abril,Israel,32,111,,143,-74.140516,4.697157
43203,2017,Abril,Israel,4,11,,15,-75.42726,6.170465
43204,2017,Abril,Italia,73,78,,151,-75.516486,10.446304
43205,2017,Abril,Italia,0,2,,2,-74.77647900000001,10.886686
43206,2017,Abril,Italia,10,26,,36,-76.532004,3.451668
43207,2017,Abril,Italia,86,217,,303,-74.140516,4.697157
43208,2017,Abril,Italia,21,50,,71,-75.42726,6.170465
43209,2017,Abril,Jamaica,2,4,,6,-75.527794,10.406342
43210,2017,Abril,Jamaica,0,1,,1,-74.77647900000001,10.886686
43211,2017,Abril,Jamaica,0,30,,30,-74.765343,10.970933
43212,2017,Abril,Jamaica,1,2,,3,-81.372937,13.338761300000002
43213,2017,Abril,Jamaica,4,1,,5,-76.532004,3.451668
43214,2017,Abril,Jamaica,4,17,,21,-74.140516,4.697157
43215,2017,Abril,Jamaica,0,3,,3,-75.42726,6.170465
43216,2017,Abril,Japón,1,2,,3,-76.532004,3.451668
43217,2017,Abril,Japón,10,15,,25,-74.140516,4.697157
43218,2017,Abril,Japón,1,1,,2,-75.736374,4.815189
43219,2017,Abril,Japón,0,2,,2,-75.42726,6.170465
43220,2017,Abril,Jordania,3,2,,5,-74.140516,4.697157
43221,2017,Abril,Kazajistán,2,0,,2,-74.140516,4.697157
43222,2017,Abril,Kenia,1,3,,4,-74.140516,4.697157
43223,2017,Abril,Lesoto,0,1,,1,-76.532004,3.451668
43224,2017,Abril,Lesoto,0,1,,1,-74.140516,4.697157
43225,2017,Abril,Letonia,0,1,,1,-74.140516,4.697157
43226,2017,Abril,Lituania,1,0,,1,-75.516486,10.446304
43227,2017,Abril,Lituania,1,5,,6,-74.140516,4.697157
43228,2017,Abril,Líbano,5,4,,9,-74.140516,4.697157
43229,2017,Abril,Liechtenstein,1,1,,2,-74.140516,4.697157
43230,2017,Abril,Luxemburgo,1,0,,1,-74.140516,4.697157
43231,2017,Abril,Luxemburgo,0,2,,2,-75.42726,6.170465
43232,2017,Abril,Malasia,1,4,,5,-74.140516,4.697157
43233,2017,Abril,Malí,0,1,,1,-74.140516,4.697157
43234,2017,Abril,Malta,0,2,,2,-74.140516,4.697157
43235,2017,Abril,Marruecos,0,1,,1,-75.527794,10.406342
43236,2017,Abril,Marruecos,1,0,,1,-76.532004,3.451668
43237,2017,Abril,Mauricio,0,1,,1,-74.140516,4.697157
43238,2017,Abril,México,4,9,,13,-75.527794,10.406342
43239,2017,Abril,México,150,146,,296,-75.516486,10.446304
43240,2017,Abril,México,32,19,,51,-74.77647900000001,10.886686
43241,2017,Abril,México,0,1,,1,-74.765343,10.970933
43242,2017,Abril,México,0,3,,3,-81.70216500000001,12.5862
43243,2017,Abril,México,1,3,,4,-81.372937,13.338761300000002
43244,2017,Abril,México,100,193,,293,-76.532004,3.451668
43245,2017,Abril,México,5795,8455,,14250,-74.140516,4.697157
43246,2017,Abril,México,8,19,,27,-75.736374,4.815189
43247,2017,Abril,México,645,1454,,2099,-75.42726,6.170465
43248,2017,Abril,México,10,16,,26,-73.181317,7.1280470000000005
43249,2017,Abril,República de Moldavia,1,0,,1,-74.140516,4.697157
43250,2017,Abril,Mónaco,0,4,,4,-74.140516,4.697157
43251,2017,Abril,Montenegro,0,1,,1,-74.77647900000001,10.886686
43252,2017,Abril,Mozambique,0,1,,1,-76.532004,3.451668
43253,2017,Abril,Myanmar,0,1,,1,-76.532004,3.451668
43254,2017,Abril,Myanmar,1,1,,2,-74.140516,4.697157
43255,2017,Abril,Nauru,1,0,,1,-74.140516,4.697157
43256,2017,Abril,Nicaragua,3,5,,8,-75.516486,10.446304
43257,2017,Abril,Nicaragua,0,5,,5,-81.703935,12.574411099999999
43258,2017,Abril,Nicaragua,0,4,,4,-81.70216500000001,12.5862
43259,2017,Abril,Nicaragua,8,14,,22,-76.532004,3.451668
43260,2017,Abril,Nicaragua,23,42,,65,-74.140516,4.697157
43261,2017,Abril,Nicaragua,1,5,,6,-75.736374,4.815189
43262,2017,Abril,Nicaragua,12,16,,28,-75.42726,6.170465
43263,2017,Abril,Nicaragua,3,2,,5,-73.181317,7.1280470000000005
43264,2017,Abril,Noruega,0,16,,16,-74.765343,10.970933
43265,2017,Abril,Noruega,1,2,,3,-76.532004,3.451668
43266,2017,Abril,Noruega,14,17,,31,-74.140516,4.697157
43267,2017,Abril,Noruega,2,4,,6,-75.42726,6.170465
43268,2017,Abril,Nueva Zelanda,1,0,,1,-76.532004,3.451668
43269,2017,Abril,Nueva Zelanda,2,8,,10,-74.140516,4.697157
43270,2017,Abril,Omán,1,1,,2,-74.140516,4.697157
43271,2017,Abril,Panamá,1462,1038,,2500,-75.527794,10.406342
43272,2017,Abril,Panamá,3753,3886,,7639,-75.516486,10.446304
43273,2017,Abril,Panamá,360,596,,956,-74.77647900000001,10.886686
43274,2017,Abril,Panamá,0,34,,34,-74.765343,10.970933
43275,2017,Abril,Panamá,1,1,,2,-74.213989,11.247722999999999
43276,2017,Abril,Panamá,10,26,,36,-81.703935,12.574411099999999
43277,2017,Abril,Panamá,191,192,,383,-81.70216500000001,12.5862
43278,2017,Abril,Panamá,3,3,,6,-81.372937,13.338761300000002
43279,2017,Abril,Panamá,349,511,,860,-76.532004,3.451668
43280,2017,Abril,Panamá,0,25,,25,-77.061029,3.8844260000000004
43281,2017,Abril,Panamá,38,54,,92,-75.76635300000001,4.45285
43282,2017,Abril,Panamá,4427,5741,,10168,-74.140516,4.697157
43283,2017,Abril,Panamá,52,80,,132,-75.736374,4.815189
43284,2017,Abril,Panamá,2256,2741,,4997,-75.42726,6.170465
43285,2017,Abril,Panamá,2,1,,3,-77.401154,6.222551999999999
43286,2017,Abril,Panamá,5,6,,11,-77.762647,7.102626
43287,2017,Abril,Panamá,14,27,,41,-73.181317,7.1280470000000005
43288,2017,Abril,Panamá,133,131,,264,-77.35002,8.63337
43289,2017,Abril,Panamá,0,4,,4,-75.68164200000001,9.402597
43290,2017,Abril,Paraguay,2,2,,4,-75.516486,10.446304
43291,2017,Abril,Paraguay,0,2,,2,-74.77647900000001,10.886686
43292,2017,Abril,Paraguay,20,15,,35,-81.70216500000001,12.5862
43293,2017,Abril,Paraguay,5,26,,31,-76.532004,3.451668
43294,2017,Abril,Paraguay,91,108,,199,-74.140516,4.697157
43295,2017,Abril,Paraguay,1,0,,1,-75.736374,4.815189
43296,2017,Abril,Paraguay,12,12,,24,-75.42726,6.170465
43297,2017,Abril,Perú,36,70,,106,-69.941498,4.191162
43298,2017,Abril,Perú,145,184,,329,-69.94143100000001,4.214082
43299,2017,Abril,Perú,1,2,,3,-74.78366,0.18595699999999998
43300,2017,Abril,Perú,2,10,,12,-77.35600000000001,0.81488
43301,2017,Abril,Perú,1276,927,,2203,-75.516486,10.446304
43302,2017,Abril,Perú,5,3,,8,-74.77647900000001,10.886686
43303,2017,Abril,Perú,0,2,,2,-74.765343,10.970933
43304,2017,Abril,Perú,195,150,,345,-81.70216500000001,12.5862
43305,2017,Abril,Perú,304,339,,643,-76.532004,3.451668
43306,2017,Abril,Perú,0,43,,43,-77.061029,3.8844260000000004
43307,2017,Abril,Perú,6158,7981,,14139,-74.140516,4.697157
43308,2017,Abril,Perú,3,3,,6,-75.736374,4.815189
43309,2017,Abril,Perú,471,650,,1121,-75.42726,6.170465
43310,2017,Abril,Perú,0,2,,2,-73.181317,7.1280470000000005
43311,2017,Abril,Perú,1,0,,1,-72.453013,7.819
43312,2017,Abril,Palestina,1,0,,1,-74.140516,4.697157
43313,2017,Abril,Polonia,2,0,,2,-76.532004,3.451668
43314,2017,Abril,Polonia,11,28,,39,-74.140516,4.697157
43315,2017,Abril,Polonia,2,2,,4,-75.42726,6.170465
43316,2017,Abril,Portugal,2,5,,7,-76.532004,3.451668
43317,2017,Abril,Portugal,20,55,,75,-74.140516,4.697157
43318,2017,Abril,Portugal,8,9,,17,-75.42726,6.170465
43319,2017,Abril,Polinesia Francesa/Colectividad de Ultramar Francesa,1,0,,1,-74.140516,4.697157
43320,2017,Abril,Puerto Rico/Territorio de Estados Unidos,4,0,,4,-75.516486,10.446304
43321,2017,Abril,Puerto Rico/Territorio de Estados Unidos,4,31,,35,-74.77647900000001,10.886686
43322,2017,Abril,Puerto Rico/Territorio de Estados Unidos,2,1,,3,-74.213989,11.247722999999999
43323,2017,Abril,Puerto Rico/Territorio de Estados Unidos,0,2,,2,-81.70216500000001,12.5862
43324,2017,Abril,Puerto Rico/Territorio de Estados Unidos,16,38,,54,-76.532004,3.451668
43325,2017,Abril,Puerto Rico/Territorio de Estados Unidos,419,509,,928,-74.140516,4.697157
43326,2017,Abril,Puerto Rico/Territorio de Estados Unidos,2,5,,7,-75.736374,4.815189
43327,2017,Abril,Puerto Rico/Territorio de Estados Unidos,33,87,,120,-75.42726,6.170465
43328,2017,Abril,Puerto Rico/Territorio de Estados Unidos,0,1,,1,-73.181317,7.1280470000000005
43329,2017,Abril,Reino Unido de Gran Bretaña e Irlanda del Norte,2,0,,2,-75.516486,10.446304
43330,2017,Abril,Reino Unido de Gran Bretaña e Irlanda del Norte,0,3,,3,-74.77647900000001,10.886686
43331,2017,Abril,Reino Unido de Gran Bretaña e Irlanda del Norte,0,3,,3,-74.213989,11.247722999999999
43332,2017,Abril,Reino Unido de Gran Bretaña e Irlanda del Norte,9,13,,22,-76.532004,3.451668
43333,2017,Abril,Reino Unido de Gran Bretaña e Irlanda del Norte,812,1297,,2109,-74.140516,4.697157
43334,2017,Abril,Reino Unido de Gran Bretaña e Irlanda del Norte,28,49,,77,-75.42726,6.170465
43335,2017,Abril,República CentroÁfricana,1,0,,1,-74.140516,4.697157
43336,2017,Abril,Federación de Rusia,20,56,,76,-74.140516,4.697157
43337,2017,Abril,Federación de Rusia,3,1,,4,-75.42726,6.170465
43338,2017,Abril,República Dominicana,0,32,,32,-75.527794,10.406342
43339,2017,Abril,República Dominicana,1,4,,5,-73.247863,10.433608999999999
43340,2017,Abril,República Dominicana,6,15,,21,-75.516486,10.446304
43341,2017,Abril,República Dominicana,9,22,,31,-74.77647900000001,10.886686
43342,2017,Abril,República Dominicana,0,4,,4,-74.213989,11.247722999999999
43343,2017,Abril,República Dominicana,19,20,,39,-76.532004,3.451668
43344,2017,Abril,República Dominicana,1013,1163,,2176,-74.140516,4.697157
43345,2017,Abril,República Dominicana,16,15,,31,-75.736374,4.815189
43346,2017,Abril,República Dominicana,62,77,,139,-75.42726,6.170465
43347,2017,Abril,República Dominicana,2,4,,6,-73.181317,7.1280470000000005
43348,2017,Abril,Reunión,0,1,,1,-74.140516,4.697157
43349,2017,Abril,Rumania,2,1,,3,-76.532004,3.451668
43350,2017,Abril,Rumania,7,4,,11,-74.140516,4.697157
43351,2017,Abril,Rumania,1,1,,2,-75.42726,6.170465
43352,2017,Abril,San Marino,1,1,,2,-74.140516,4.697157
43353,2017,Abril,San  Vicente y las Granadinas,1,4,,5,-75.527794,10.406342
43354,2017,Abril,Senegal,0,1,,1,-74.140516,4.697157
43355,2017,Abril,Singapur,4,2,,6,-74.140516,4.697157
43356,2017,Abril,Singapur,1,0,,1,-75.42726,6.170465
43357,2017,Abril,Sudáfrica,0,1,,1,-76.532004,3.451668
43358,2017,Abril,Sudáfrica,8,6,,14,-74.140516,4.697157
43359,2017,Abril,Suecia,0,1,,1,-74.77647900000001,10.886686
43360,2017,Abril,Suecia,2,0,,2,-76.532004,3.451668
43361,2017,Abril,Suecia,27,32,,59,-74.140516,4.697157
43362,2017,Abril,Suecia,0,1,,1,-75.736374,4.815189
43363,2017,Abril,Suecia,2,6,,8,-75.42726,6.170465
43364,2017,Abril,Suiza,0,1,,1,-74.77647900000001,10.886686
43365,2017,Abril,Suiza,7,9,,16,-76.532004,3.451668
43366,2017,Abril,Suiza,97,125,,222,-74.140516,4.697157
43367,2017,Abril,Suiza,13,20,,33,-75.42726,6.170465
43368,2017,Abril,Suiza,0,1,,1,-73.181317,7.1280470000000005
43369,2017,Abril,Surinam,2,4,,6,-74.140516,4.697157
43370,2017,Abril,Surinam,0,1,,1,-75.42726,6.170465
43371,2017,Abril,Taiwán,1,4,,5,-74.140516,4.697157
43372,2017,Abril,Taiwán,0,1,,1,-75.42726,6.170465
43373,2017,Abril,Tailandia,3,0,,3,-74.140516,4.697157
43374,2017,Abril,Trinidad y Tobago,0,13,,13,-75.527794,10.406342
43375,2017,Abril,Trinidad y Tobago,1,5,,6,-75.516486,10.446304
43376,2017,Abril,Trinidad y Tobago,0,1,,1,-74.77647900000001,10.886686
43377,2017,Abril,Trinidad y Tobago,0,1,,1,-81.70216500000001,12.5862
43378,2017,Abril,Trinidad y Tobago,0,11,,11,-76.532004,3.451668
43379,2017,Abril,Trinidad y Tobago,1,4,,5,-74.140516,4.697157
43380,2017,Abril,Trinidad y Tobago,1,4,,5,-75.42726,6.170465
43381,2017,Abril,Trinidad y Tobago,0,1,,1,-73.181317,7.1280470000000005
43382,2017,Abril,Turkmenistán,2,2,,4,-74.140516,4.697157
43383,2017,Abril,Turquía,0,4,,4,-75.527794,10.406342
43384,2017,Abril,Turquía,201,363,,564,-74.140516,4.697157
43385,2017,Abril,Turquía,1,0,,1,-75.736374,4.815189
43386,2017,Abril,Turquía,0,1,,1,-75.42726,6.170465
43387,2017,Abril,Ucrania,0,5,,5,-74.77647900000001,10.886686
43388,2017,Abril,Ucrania,0,5,,5,-76.532004,3.451668
43389,2017,Abril,Ucrania,0,3,,3,-74.140516,4.697157
43390,2017,Abril,Uruguay,0,1,,1,-77.35600000000001,0.81488
43391,2017,Abril,Uruguay,13,4,,17,-75.516486,10.446304
43392,2017,Abril,Uruguay,1,0,,1,-74.77647900000001,10.886686
43393,2017,Abril,Uruguay,35,27,,62,-81.70216500000001,12.5862
43394,2017,Abril,Uruguay,23,33,,56,-76.532004,3.451668
43395,2017,Abril,Uruguay,100,148,,248,-74.140516,4.697157
43396,2017,Abril,Uruguay,1,1,,2,-75.736374,4.815189
43397,2017,Abril,Uruguay,23,25,,48,-75.42726,6.170465
43398,2017,Abril,Uruguay,0,1,,1,-73.181317,7.1280470000000005
43399,2017,Abril,Venezuela,0,4,,4,-75.527794,10.406342
43400,2017,Abril,Venezuela,6,16,,22,-73.247863,10.433608999999999
43401,2017,Abril,Venezuela,10,13,,23,-75.516486,10.446304
43402,2017,Abril,Venezuela,8,50,,58,-74.77647900000001,10.886686
43403,2017,Abril,Venezuela,0,6,,6,-74.765343,10.970933
43404,2017,Abril,Venezuela,5168,5629,,10797,-72.129595,11.360028999999999
43405,2017,Abril,Venezuela,1,1,,2,-81.70216500000001,12.5862
43406,2017,Abril,Venezuela,14,20,,34,-76.532004,3.451668
43407,2017,Abril,Venezuela,106,120,,226,-67.927521,3.866713
43408,2017,Abril,Venezuela,3498,3621,,7119,-74.140516,4.697157
43409,2017,Abril,Venezuela,1,3,,4,-75.736374,4.815189
43410,2017,Abril,Venezuela,548,561,,1109,-75.42726,6.170465
43411,2017,Abril,Venezuela,127,175,,302,-67.48402800000001,6.185536
43412,2017,Abril,Venezuela,113,119,,232,-70.74025300000001,7.088728999999999
43413,2017,Abril,Venezuela,11,11,,22,-73.181317,7.1280470000000005
43414,2017,Abril,Venezuela,7956,10225,,18181,-72.453013,7.819
43415,2017,Abril,Venezuela,3,7,,10,-72.508188,7.927233
43416,2017,Abril,Venezuela,255,269,,524,-72.409396,8.36068
43417,2017,Abril,Vietnam,0,1,,1,-74.140516,4.697157
43418,2017,Abril,Islas Vírgenes Británicas/Territorio Británico de Ultramar,0,3,,3,-74.213989,11.247722999999999
43419,2017,Abril,Islas Vírgenes Estadounidenses/Territorio de Estados Unidos,0,8,,8,-74.140516,4.697157
43420,2017,Mayo,Afganistán,0,1,,1,-74.140516,4.697157
43421,2017,Mayo,Albania,1,3,,4,-74.140516,4.697157
43422,2017,Mayo,Alemania,1,1,,2,-77.35600000000001,0.81488
43423,2017,Mayo,Alemania,3,1,,4,-75.516486,10.446304
43424,2017,Mayo,Alemania,3,2,,5,-74.77647900000001,10.886686
43425,2017,Mayo,Alemania,0,1,,1,-74.213989,11.247722999999999
43426,2017,Mayo,Alemania,15,13,,28,-76.532004,3.451668
43427,2017,Mayo,Alemania,978,1877,,2855,-74.140516,4.697157
43428,2017,Mayo,Alemania,3,3,,6,-75.736374,4.815189
43429,2017,Mayo,Alemania,17,27,,44,-75.42726,6.170465
43430,2017,Mayo,Angola,0,2,,2,-74.140516,4.697157
43431,2017,Mayo,Antigua y Barbuda,0,9,,9,-75.527794,10.406342
43432,2017,Mayo,Antigua y Barbuda,0,1,,1,-75.42726,6.170465
43433,2017,Mayo,Países Bajos,4,23,,27,-75.527794,10.406342
43434,2017,Mayo,Países Bajos,124,220,,344,-75.516486,10.446304
43435,2017,Mayo,Países Bajos,4,5,,9,-74.77647900000001,10.886686
43436,2017,Mayo,Países Bajos,0,1,,1,-74.213989,11.247722999999999
43437,2017,Mayo,Países Bajos,29,33,,62,-76.532004,3.451668
43438,2017,Mayo,Países Bajos,791,1162,,1953,-74.140516,4.697157
43439,2017,Mayo,Países Bajos,0,5,,5,-75.736374,4.815189
43440,2017,Mayo,Países Bajos,80,116,,196,-75.42726,6.170465
43441,2017,Mayo,Países Bajos,4,3,,7,-73.181317,7.1280470000000005
43442,2017,Mayo,Arabia Saudita,0,1,,1,-76.532004,3.451668
43443,2017,Mayo,Arabia Saudita,2,0,,2,-74.140516,4.697157
43444,2017,Mayo,Argelia,3,0,,3,-74.140516,4.697157
43445,2017,Mayo,Argentina,5,9,,14,-77.35600000000001,0.81488
43446,2017,Mayo,Argentina,119,87,,206,-75.516486,10.446304
43447,2017,Mayo,Argentina,9,4,,13,-74.77647900000001,10.886686
43448,2017,Mayo,Argentina,151,103,,254,-81.70216500000001,12.5862
43449,2017,Mayo,Argentina,12,26,,38,-76.532004,3.451668
43450,2017,Mayo,Argentina,3953,4623,,8576,-74.140516,4.697157
43451,2017,Mayo,Argentina,1,1,,2,-75.736374,4.815189
43452,2017,Mayo,Argentina,21,70,,91,-75.42726,6.170465
43453,2017,Mayo,Aruba,4,7,,11,-75.527794,10.406342
43454,2017,Mayo,Aruba,0,2,,2,-74.77647900000001,10.886686
43455,2017,Mayo,Aruba,18,39,,57,-74.213989,11.247722999999999
43456,2017,Mayo,Aruba,6,9,,15,-76.532004,3.451668
43457,2017,Mayo,Aruba,764,908,,1672,-74.140516,4.697157
43458,2017,Mayo,Aruba,0,2,,2,-75.736374,4.815189
43459,2017,Mayo,Aruba,7,13,,20,-75.42726,6.170465
43460,2017,Mayo,Aruba,22,11,,33,-73.181317,7.1280470000000005
43461,2017,Mayo,Australia,1,0,,1,-75.516486,10.446304
43462,2017,Mayo,Australia,2,0,,2,-74.77647900000001,10.886686
43463,2017,Mayo,Australia,0,1,,1,-81.70216500000001,12.5862
43464,2017,Mayo,Australia,0,3,,3,-76.532004,3.451668
43465,2017,Mayo,Australia,43,45,,88,-74.140516,4.697157
43466,2017,Mayo,Australia,9,15,,24,-75.42726,6.170465
43467,2017,Mayo,Australia,0,1,,1,-73.181317,7.1280470000000005
43468,2017,Mayo,Austria,1,0,,1,-76.532004,3.451668
43469,2017,Mayo,Austria,15,18,,33,-74.140516,4.697157
43470,2017,Mayo,Austria,1,1,,2,-75.42726,6.170465
43471,2017,Mayo,Azerbaiyán,0,2,,2,-74.140516,4.697157
43472,2017,Mayo,Bahamas,0,1,,1,-75.527794,10.406342
43473,2017,Mayo,Bahamas,0,4,,4,-76.532004,3.451668
43474,2017,Mayo,Bahamas,1,0,,1,-74.140516,4.697157
43475,2017,Mayo,Bahamas,0,1,,1,-75.736374,4.815189
43476,2017,Mayo,Bahamas,0,6,,6,-75.42726,6.170465
43477,2017,Mayo,Bahréin,0,2,,2,-75.516486,10.446304
43478,2017,Mayo,Bahréin,1,0,,1,-75.42726,6.170465
43479,2017,Mayo,Bangladesh,0,2,,2,-74.140516,4.697157
43480,2017,Mayo,Barbados,50,67,,117,-74.140516,4.697157
43481,2017,Mayo,República de Belarús,3,1,,4,-74.140516,4.697157
43482,2017,Mayo,Bélgica,0,2,,2,-74.213989,11.247722999999999
43483,2017,Mayo,Bélgica,2,7,,9,-76.532004,3.451668
43484,2017,Mayo,Bélgica,22,32,,54,-74.140516,4.697157
43485,2017,Mayo,Bélgica,0,1,,1,-75.736374,4.815189
43486,2017,Mayo,Bélgica,6,7,,13,-75.42726,6.170465
43487,2017,Mayo,Belice,1,1,,2,-75.516486,10.446304
43488,2017,Mayo,Belice,1,1,,2,-81.372937,13.338761300000002
43489,2017,Mayo,Belice,4,3,,7,-74.140516,4.697157
43490,2017,Mayo,Belice,0,1,,1,-75.42726,6.170465
43491,2017,Mayo,Benín,0,1,,1,-74.140516,4.697157
43492,2017,Mayo,Bermudas/Territorio Británico de Ultramar,2,0,,2,-75.42726,6.170465
43493,2017,Mayo,Bolivia,6,4,,10,-75.516486,10.446304
43494,2017,Mayo,Bolivia,1,1,,2,-74.77647900000001,10.886686
43495,2017,Mayo,Bolivia,90,27,,117,-81.70216500000001,12.5862
43496,2017,Mayo,Bolivia,13,15,,28,-76.532004,3.451668
43497,2017,Mayo,Bolivia,531,608,,1139,-74.140516,4.697157
43498,2017,Mayo,Bolivia,1,2,,3,-75.736374,4.815189
43499,2017,Mayo,Bolivia,26,28,,54,-75.42726,6.170465
43500,2017,Mayo,Bolivia,0,1,,1,-73.181317,7.1280470000000005
43501,2017,Mayo,Brasil,134,162,,296,-69.941498,4.191162
43502,2017,Mayo,Brasil,16,18,,34,-69.94143100000001,4.214082
43503,2017,Mayo,Brasil,1,1,,2,-77.35600000000001,0.81488
43504,2017,Mayo,Brasil,0,4,,4,-75.527794,10.406342
43505,2017,Mayo,Brasil,57,64,,121,-75.516486,10.446304
43506,2017,Mayo,Brasil,3,8,,11,-74.77647900000001,10.886686
43507,2017,Mayo,Brasil,0,1,,1,-74.213989,11.247722999999999
43508,2017,Mayo,Brasil,333,293,,626,-81.70216500000001,12.5862
43509,2017,Mayo,Brasil,19,46,,65,-76.532004,3.451668
43510,2017,Mayo,Brasil,4491,6146,,10637,-74.140516,4.697157
43511,2017,Mayo,Brasil,1,2,,3,-75.736374,4.815189
43512,2017,Mayo,Brasil,107,165,,272,-75.42726,6.170465
43513,2017,Mayo,Brasil,0,2,,2,-73.181317,7.1280470000000005
43514,2017,Mayo,Brunei Darussalam,1,0,,1,-74.140516,4.697157
43515,2017,Mayo,Bulgaria,1,0,,1,-74.140516,4.697157
43516,2017,Mayo,Bulgaria,0,2,,2,-75.42726,6.170465
43517,2017,Mayo,Islas Caimán/Territorio Británico de Ultramar,0,2,,2,-75.527794,10.406342
43518,2017,Mayo,Islas Caimán/Territorio Británico de Ultramar,0,3,,3,-74.77647900000001,10.886686
43519,2017,Mayo,Islas Caimán/Territorio Británico de Ultramar,0,4,,4,-81.703935,12.574411099999999
43520,2017,Mayo,Islas Caimán/Territorio Británico de Ultramar,1,2,,3,-81.70216500000001,12.5862
43521,2017,Mayo,Islas Caimán/Territorio Británico de Ultramar,1,1,,2,-81.372937,13.338761300000002
43522,2017,Mayo,Islas Caimán/Territorio Británico de Ultramar,0,1,,1,-76.532004,3.451668
43523,2017,Mayo,Islas Caimán/Territorio Británico de Ultramar,0,1,,1,-74.140516,4.697157
43524,2017,Mayo,Camerún,0,1,,1,-74.140516,4.697157
43525,2017,Mayo,Canadá,12,12,,24,-75.516486,10.446304
43526,2017,Mayo,Canadá,8,5,,13,-74.77647900000001,10.886686
43527,2017,Mayo,Canadá,0,5,,5,-74.765343,10.970933
43528,2017,Mayo,Canadá,37,33,,70,-76.532004,3.451668
43529,2017,Mayo,Canadá,0,9,,9,-77.061029,3.8844260000000004
43530,2017,Mayo,Canadá,636,984,,1620,-74.140516,4.697157
43531,2017,Mayo,Canadá,4,11,,15,-75.736374,4.815189
43532,2017,Mayo,Canadá,66,151,,217,-75.42726,6.170465
43533,2017,Mayo,Canadá,1,3,,4,-73.181317,7.1280470000000005
43534,2017,Mayo,España,0,3,,3,-75.527794,10.406342
43535,2017,Mayo,España,0,2,,2,-75.516486,10.446304
43536,2017,Mayo,España,1,5,,6,-74.77647900000001,10.886686
43537,2017,Mayo,España,0,2,,2,-74.213989,11.247722999999999
43538,2017,Mayo,España,3,2,,5,-81.70216500000001,12.5862
43539,2017,Mayo,España,229,375,,604,-76.532004,3.451668
43540,2017,Mayo,España,2610,5028,,7638,-74.140516,4.697157
43541,2017,Mayo,España,4,5,,9,-75.736374,4.815189
43542,2017,Mayo,España,316,581,,897,-75.42726,6.170465
43543,2017,Mayo,República Del Congo,1,0,,1,-74.140516,4.697157
43544,2017,Mayo,República Democrática del Congo,0,2,,2,-74.140516,4.697157
43545,2017,Mayo,República de Corea,0,2,,2,-76.532004,3.451668
43546,2017,Mayo,República de Corea,4,22,,26,-74.140516,4.697157
43547,2017,Mayo,República de Corea,1,5,,6,-75.42726,6.170465
43548,2017,Mayo,Costa de Marfil,2,6,,8,-74.140516,4.697157
43549,2017,Mayo,Costa Rica,14,9,,23,-75.516486,10.446304
43550,2017,Mayo,Costa Rica,6,11,,17,-74.77647900000001,10.886686
43551,2017,Mayo,Costa Rica,1,5,,6,-74.213989,11.247722999999999
43552,2017,Mayo,Costa Rica,279,212,,491,-81.70216500000001,12.5862
43553,2017,Mayo,Costa Rica,35,36,,71,-76.532004,3.451668
43554,2017,Mayo,Costa Rica,0,1,,1,-75.76635300000001,4.45285
43555,2017,Mayo,Costa Rica,1126,1599,,2725,-74.140516,4.697157
43556,2017,Mayo,Costa Rica,1,22,,23,-75.736374,4.815189
43557,2017,Mayo,Costa Rica,109,164,,273,-75.42726,6.170465
43558,2017,Mayo,Costa Rica,2,4,,6,-73.181317,7.1280470000000005
43559,2017,Mayo,Croacia,1,3,,4,-74.140516,4.697157
43560,2017,Mayo,Croacia,1,0,,1,-75.736374,4.815189
43561,2017,Mayo,Croacia,1,0,,1,-75.42726,6.170465
43562,2017,Mayo,Cuba,0,1,,1,-75.527794,10.406342
43563,2017,Mayo,Cuba,1,3,,4,-75.516486,10.446304
43564,2017,Mayo,Cuba,2,9,,11,-74.77647900000001,10.886686
43565,2017,Mayo,Cuba,1,4,,5,-81.703935,12.574411099999999
43566,2017,Mayo,Cuba,9,11,,20,-76.532004,3.451668
43567,2017,Mayo,Cuba,328,489,,817,-74.140516,4.697157
43568,2017,Mayo,Cuba,1,1,,2,-75.736374,4.815189
43569,2017,Mayo,Cuba,16,37,,53,-75.42726,6.170465
43570,2017,Mayo,Curazao,0,1,,1,-75.516486,10.446304
43571,2017,Mayo,Curazao,0,5,,5,-74.140516,4.697157
43572,2017,Mayo,República Checa,1,4,,5,-74.140516,4.697157
43573,2017,Mayo,República Checa,0,1,,1,-75.42726,6.170465
43574,2017,Mayo,Chile,2,4,,6,-77.35600000000001,0.81488
43575,2017,Mayo,Chile,19,11,,30,-75.516486,10.446304
43576,2017,Mayo,Chile,3,5,,8,-74.77647900000001,10.886686
43577,2017,Mayo,Chile,72,62,,134,-81.70216500000001,12.5862
43578,2017,Mayo,Chile,14,26,,40,-76.532004,3.451668
43579,2017,Mayo,Chile,4637,5994,,10631,-74.140516,4.697157
43580,2017,Mayo,Chile,0,2,,2,-75.736374,4.815189
43581,2017,Mayo,Chile,23,48,,71,-75.42726,6.170465
43582,2017,Mayo,China,1,6,,7,-76.532004,3.451668
43583,2017,Mayo,China,39,97,,136,-74.140516,4.697157
43584,2017,Mayo,China,8,18,,26,-75.42726,6.170465
43585,2017,Mayo,Dinamarca,0,1,,1,-76.532004,3.451668
43586,2017,Mayo,Dinamarca,3,13,,16,-74.140516,4.697157
43587,2017,Mayo,Dinamarca,2,1,,3,-75.42726,6.170465
43588,2017,Mayo,Dominica,1,1,,2,-76.532004,3.451668
43589,2017,Mayo,Dominica,0,1,,1,-75.42726,6.170465
43590,2017,Mayo,Ecuador,0,1,,1,-74.78366,0.18595699999999998
43591,2017,Mayo,Ecuador,151,474,,625,-76.876446,0.33002
43592,2017,Mayo,Ecuador,3392,5858,,9250,-77.35600000000001,0.81488
43593,2017,Mayo,Ecuador,34,54,,88,-78.802679,18.00143
43594,2017,Mayo,Ecuador,0,4,,4,-75.527794,10.406342
43595,2017,Mayo,Ecuador,66,73,,139,-75.516486,10.446304
43596,2017,Mayo,Ecuador,2,4,,6,-74.77647900000001,10.886686
43597,2017,Mayo,Ecuador,9,8,,17,-81.70216500000001,12.5862
43598,2017,Mayo,Ecuador,415,467,,882,-76.532004,3.451668
43599,2017,Mayo,Ecuador,0,7,,7,-77.061029,3.8844260000000004
43600,2017,Mayo,Ecuador,3361,4681,,8042,-74.140516,4.697157
43601,2017,Mayo,Ecuador,0,1,,1,-75.736374,4.815189
43602,2017,Mayo,Ecuador,54,174,,228,-75.42726,6.170465
43603,2017,Mayo,Egipto,1,3,,4,-74.140516,4.697157
43604,2017,Mayo,El Salvador,1,2,,3,-75.516486,10.446304
43605,2017,Mayo,El Salvador,0,1,,1,-74.77647900000001,10.886686
43606,2017,Mayo,El Salvador,13,6,,19,-81.70216500000001,12.5862
43607,2017,Mayo,El Salvador,110,166,,276,-76.532004,3.451668
43608,2017,Mayo,El Salvador,0,2,,2,-77.061029,3.8844260000000004
43609,2017,Mayo,El Salvador,1003,1489,,2492,-74.140516,4.697157
43610,2017,Mayo,El Salvador,0,1,,1,-75.736374,4.815189
43611,2017,Mayo,El Salvador,169,296,,465,-75.42726,6.170465
43612,2017,Mayo,Emiratos Árabes,1,3,,4,-74.140516,4.697157
43613,2017,Mayo,Eslovaquia,1,0,,1,-75.42726,6.170465
43614,2017,Mayo,Eslovenia,2,5,,7,-74.140516,4.697157
43615,2017,Mayo,Eslovenia,0,1,,1,-75.42726,6.170465
43616,2017,Mayo,Estados Unidos de América,1,20,,21,-75.527794,10.406342
43617,2017,Mayo,Estados Unidos de América,0,2,,2,-73.247863,10.433608999999999
43618,2017,Mayo,Estados Unidos de América,2689,3610,,6299,-75.516486,10.446304
43619,2017,Mayo,Estados Unidos de América,513,953,,1466,-74.77647900000001,10.886686
43620,2017,Mayo,Estados Unidos de América,0,1,,1,-74.765343,10.970933
43621,2017,Mayo,Estados Unidos de América,0,3,,3,-74.232675,11.117206
43622,2017,Mayo,Estados Unidos de América,0,14,,14,-74.213989,11.247722999999999
43623,2017,Mayo,Estados Unidos de América,23,20,,43,-81.70216500000001,12.5862
43624,2017,Mayo,Estados Unidos de América,1250,1597,,2847,-76.532004,3.451668
43625,2017,Mayo,Estados Unidos de América,0,2,,2,-77.061029,3.8844260000000004
43626,2017,Mayo,Estados Unidos de América,161,215,,376,-75.76635300000001,4.45285
43627,2017,Mayo,Estados Unidos de América,8799,15858,,24657,-74.140516,4.697157
43628,2017,Mayo,Estados Unidos de América,121,154,,275,-75.736374,4.815189
43629,2017,Mayo,Estados Unidos de América,2419,6078,,8497,-75.42726,6.170465
43630,2017,Mayo,Estados Unidos de América,27,40,,67,-73.181317,7.1280470000000005
43631,2017,Mayo,Estados Unidos de América,1,25,,26,-75.68164200000001,9.402597
43632,2017,Mayo,Estonia,1,0,,1,-74.140516,4.697157
43633,2017,Mayo,Estonia,1,0,,1,-75.42726,6.170465
43634,2017,Mayo,Filipinas,0,2,,2,-74.77647900000001,10.886686
43635,2017,Mayo,Filipinas,1,8,,9,-76.532004,3.451668
43636,2017,Mayo,Filipinas,0,2,,2,-77.061029,3.8844260000000004
43637,2017,Mayo,Filipinas,1,3,,4,-74.140516,4.697157
43638,2017,Mayo,Filipinas,0,2,,2,-75.736374,4.815189
43639,2017,Mayo,Filipinas,1,0,,1,-75.42726,6.170465
43640,2017,Mayo,Finlandia,5,7,,12,-74.140516,4.697157
43641,2017,Mayo,Finlandia,1,3,,4,-75.42726,6.170465
43642,2017,Mayo,Francia,1,0,,1,-75.516486,10.446304
43643,2017,Mayo,Francia,1,3,,4,-74.77647900000001,10.886686
43644,2017,Mayo,Francia,27,31,,58,-76.532004,3.451668
43645,2017,Mayo,Francia,2,0,,2,-75.76635300000001,4.45285
43646,2017,Mayo,Francia,1123,1897,,3020,-74.140516,4.697157
43647,2017,Mayo,Francia,23,36,,59,-75.42726,6.170465
43648,2017,Mayo,Francia,0,1,,1,-73.181317,7.1280470000000005
43649,2017,Mayo,Georgia,0,1,,1,-74.140516,4.697157
43650,2017,Mayo,Ghana,0,1,,1,-75.516486,10.446304
43651,2017,Mayo,Gibraltar/Territorio Británico de Ultramar,0,1,,1,-77.35600000000001,0.81488
43652,2017,Mayo,Gibraltar/Territorio Británico de Ultramar,0,1,,1,-74.140516,4.697157
43653,2017,Mayo,Granada,0,6,,6,-75.527794,10.406342
43654,2017,Mayo,Granada,0,1,,1,-76.532004,3.451668
43655,2017,Mayo,Grecia,0,1,,1,-76.532004,3.451668
43656,2017,Mayo,Grecia,1,1,,2,-74.140516,4.697157
43657,2017,Mayo,Guatemala,0,1,,1,-75.527794,10.406342
43658,2017,Mayo,Guatemala,7,11,,18,-75.516486,10.446304
43659,2017,Mayo,Guatemala,2,10,,12,-74.77647900000001,10.886686
43660,2017,Mayo,Guatemala,44,30,,74,-81.70216500000001,12.5862
43661,2017,Mayo,Guatemala,11,39,,50,-76.532004,3.451668
43662,2017,Mayo,Guatemala,366,585,,951,-74.140516,4.697157
43663,2017,Mayo,Guatemala,2,12,,14,-75.736374,4.815189
43664,2017,Mayo,Guatemala,58,107,,165,-75.42726,6.170465
43665,2017,Mayo,Guatemala,3,12,,15,-73.181317,7.1280470000000005
43666,2017,Mayo,Guyana,2,1,,3,-76.532004,3.451668
43667,2017,Mayo,Guyana,0,1,,1,-74.140516,4.697157
43668,2017,Mayo,Guyana,1,0,,1,-75.42726,6.170465
43669,2017,Mayo,Guinea Ecuatorial,0,1,,1,-74.140516,4.697157
43670,2017,Mayo,Guadalupe/Territorio Francés,0,1,,1,-74.213989,11.247722999999999
43671,2017,Mayo,Guadalupe/Territorio Francés,1,0,,1,-76.532004,3.451668
43672,2017,Mayo,Guadalupe/Territorio Francés,2,3,,5,-74.140516,4.697157
43673,2017,Mayo,Guadalupe/Territorio Francés,0,1,,1,-75.736374,4.815189
43674,2017,Mayo,Guayana Francesa/Departamento de Ultramar Francés,0,2,,2,-76.532004,3.451668
43675,2017,Mayo,Haití,0,1,,1,-75.516486,10.446304
43676,2017,Mayo,Haití,0,1,,1,-74.140516,4.697157
43677,2017,Mayo,Haití,3,3,,6,-75.42726,6.170465
43678,2017,Mayo,Honduras,1,2,,3,-75.516486,10.446304
43679,2017,Mayo,Honduras,1,2,,3,-74.77647900000001,10.886686
43680,2017,Mayo,Honduras,19,10,,29,-81.70216500000001,12.5862
43681,2017,Mayo,Honduras,6,9,,15,-81.372937,13.338761300000002
43682,2017,Mayo,Honduras,16,10,,26,-76.532004,3.451668
43683,2017,Mayo,Honduras,55,77,,132,-74.140516,4.697157
43684,2017,Mayo,Honduras,23,54,,77,-75.42726,6.170465
43685,2017,Mayo,Hong Kong,0,1,,1,-76.532004,3.451668
43686,2017,Mayo,Hong Kong,2,5,,7,-74.140516,4.697157
43687,2017,Mayo,Hungría,5,5,,10,-74.140516,4.697157
43688,2017,Mayo,India,0,4,,4,-74.77647900000001,10.886686
43689,2017,Mayo,India,0,2,,2,-76.532004,3.451668
43690,2017,Mayo,India,2,24,,26,-74.140516,4.697157
43691,2017,Mayo,India,1,5,,6,-75.42726,6.170465
43692,2017,Mayo,India,0,2,,2,-73.181317,7.1280470000000005
43693,2017,Mayo,Irán,1,1,,2,-74.140516,4.697157
43694,2017,Mayo,República de Irlanda,1,1,,2,-75.516486,10.446304
43695,2017,Mayo,República de Irlanda,2,2,,4,-76.532004,3.451668
43696,2017,Mayo,República de Irlanda,13,12,,25,-74.140516,4.697157
43697,2017,Mayo,República de Irlanda,3,3,,6,-75.42726,6.170465
43698,2017,Mayo,Islandia,2,3,,5,-74.140516,4.697157
43699,2017,Mayo,Islandia,1,1,,2,-75.736374,4.815189
43700,2017,Mayo,Israel,0,1,,1,-75.516486,10.446304
43701,2017,Mayo,Israel,0,1,,1,-74.77647900000001,10.886686
43702,2017,Mayo,Israel,1,2,,3,-76.532004,3.451668
43703,2017,Mayo,Israel,30,79,,109,-74.140516,4.697157
43704,2017,Mayo,Israel,2,5,,7,-75.42726,6.170465
43705,2017,Mayo,Italia,0,2,,2,-75.527794,10.406342
43706,2017,Mayo,Italia,1,6,,7,-74.77647900000001,10.886686
43707,2017,Mayo,Italia,11,30,,41,-76.532004,3.451668
43708,2017,Mayo,Italia,61,181,,242,-74.140516,4.697157
43709,2017,Mayo,Italia,2,2,,4,-75.736374,4.815189
43710,2017,Mayo,Italia,9,32,,41,-75.42726,6.170465
43711,2017,Mayo,Jamaica,4,11,,15,-75.527794,10.406342
43712,2017,Mayo,Jamaica,0,7,,7,-75.516486,10.446304
43713,2017,Mayo,Jamaica,0,1,,1,-74.765343,10.970933
43714,2017,Mayo,Jamaica,7,8,,15,-81.372937,13.338761300000002
43715,2017,Mayo,Jamaica,1,1,,2,-76.532004,3.451668
43716,2017,Mayo,Jamaica,5,5,,10,-74.140516,4.697157
43717,2017,Mayo,Jamaica,0,2,,2,-75.42726,6.170465
43718,2017,Mayo,Japón,0,1,,1,-74.77647900000001,10.886686
43719,2017,Mayo,Japón,0,1,,1,-76.532004,3.451668
43720,2017,Mayo,Japón,6,17,,23,-74.140516,4.697157
43721,2017,Mayo,Japón,0,1,,1,-75.736374,4.815189
43722,2017,Mayo,Japón,1,3,,4,-75.42726,6.170465
43723,2017,Mayo,Kazajistán,0,1,,1,-74.140516,4.697157
43724,2017,Mayo,Kenia,0,3,,3,-76.532004,3.451668
43725,2017,Mayo,Kenia,0,1,,1,-74.140516,4.697157
43726,2017,Mayo,República de Kosovo,1,0,,1,-74.140516,4.697157
43727,2017,Mayo,Letonia,0,1,,1,-74.140516,4.697157
43728,2017,Mayo,Lituania,0,2,,2,-74.140516,4.697157
43729,2017,Mayo,Líbano,3,6,,9,-74.140516,4.697157
43730,2017,Mayo,Liechtenstein,1,0,,1,-76.532004,3.451668
43731,2017,Mayo,Liechtenstein,0,2,,2,-74.140516,4.697157
43732,2017,Mayo,Luxemburgo,2,2,,4,-74.140516,4.697157
43733,2017,Mayo,Malasia,2,1,,3,-74.140516,4.697157
43734,2017,Mayo,Malta,0,2,,2,-74.140516,4.697157
43735,2017,Mayo,Marruecos,0,1,,1,-75.527794,10.406342
43736,2017,Mayo,Marruecos,0,2,,2,-74.140516,4.697157
43737,2017,Mayo,Martinica/Departamento de Ultramar Francés,1,2,,3,-74.213989,11.247722999999999
43738,2017,Mayo,México,1,23,,24,-75.527794,10.406342
43739,2017,Mayo,México,113,106,,219,-75.516486,10.446304
43740,2017,Mayo,México,14,27,,41,-74.77647900000001,10.886686
43741,2017,Mayo,México,0,13,,13,-74.213989,11.247722999999999
43742,2017,Mayo,México,61,153,,214,-76.532004,3.451668
43743,2017,Mayo,México,5233,8481,,13714,-74.140516,4.697157
43744,2017,Mayo,México,6,14,,20,-75.736374,4.815189
43745,2017,Mayo,México,525,1232,,1757,-75.42726,6.170465
43746,2017,Mayo,México,2,14,,16,-73.181317,7.1280470000000005
43747,2017,Mayo,República de Moldavia,1,0,,1,-74.140516,4.697157
43748,2017,Mayo,Mónaco,0,1,,1,-75.42726,6.170465
43749,2017,Mayo,Montenegro,0,1,,1,-74.140516,4.697157
43750,2017,Mayo,Nepal,0,1,,1,-75.736374,4.815189
43751,2017,Mayo,Nicaragua,0,2,,2,-75.516486,10.446304
43752,2017,Mayo,Nicaragua,0,2,,2,-74.77647900000001,10.886686
43753,2017,Mayo,Nicaragua,4,13,,17,-81.703935,12.574411099999999
43754,2017,Mayo,Nicaragua,0,2,,2,-81.70216500000001,12.5862
43755,2017,Mayo,Nicaragua,5,6,,11,-76.532004,3.451668
43756,2017,Mayo,Nicaragua,36,39,,75,-74.140516,4.697157
43757,2017,Mayo,Nicaragua,0,1,,1,-75.736374,4.815189
43758,2017,Mayo,Nicaragua,11,32,,43,-75.42726,6.170465
43759,2017,Mayo,Nicaragua,0,5,,5,-73.181317,7.1280470000000005
43760,2017,Mayo,Nigeria,0,1,,1,-74.77647900000001,10.886686
43761,2017,Mayo,Nigeria,1,1,,2,-74.140516,4.697157
43762,2017,Mayo,Noruega,0,1,,1,-74.77647900000001,10.886686
43763,2017,Mayo,Noruega,2,1,,3,-76.532004,3.451668
43764,2017,Mayo,Noruega,7,13,,20,-74.140516,4.697157
43765,2017,Mayo,Noruega,0,1,,1,-75.736374,4.815189
43766,2017,Mayo,Noruega,0,3,,3,-75.42726,6.170465
43767,2017,Mayo,Nueva Zelanda,1,0,,1,-76.532004,3.451668
43768,2017,Mayo,Nueva Zelanda,8,6,,14,-74.140516,4.697157
43769,2017,Mayo,Nueva Zelanda,1,1,,2,-75.42726,6.170465
43770,2017,Mayo,Panamá,1494,1264,,2758,-75.527794,10.406342
43771,2017,Mayo,Panamá,3309,3534,,6843,-75.516486,10.446304
43772,2017,Mayo,Panamá,255,494,,749,-74.77647900000001,10.886686
43773,2017,Mayo,Panamá,0,19,,19,-74.765343,10.970933
43774,2017,Mayo,Panamá,1,2,,3,-74.213989,11.247722999999999
43775,2017,Mayo,Panamá,6,26,,32,-81.703935,12.574411099999999
43776,2017,Mayo,Panamá,85,64,,149,-81.70216500000001,12.5862
43777,2017,Mayo,Panamá,1,1,,2,-81.372937,13.338761300000002
43778,2017,Mayo,Panamá,356,549,,905,-76.532004,3.451668
43779,2017,Mayo,Panamá,0,11,,11,-77.061029,3.8844260000000004
43780,2017,Mayo,Panamá,29,47,,76,-75.76635300000001,4.45285
43781,2017,Mayo,Panamá,3899,6174,,10073,-74.140516,4.697157
43782,2017,Mayo,Panamá,22,74,,96,-75.736374,4.815189
43783,2017,Mayo,Panamá,1609,2576,,4185,-75.42726,6.170465
43784,2017,Mayo,Panamá,1,2,,3,-77.401154,6.222551999999999
43785,2017,Mayo,Panamá,2,3,,5,-77.762647,7.102626
43786,2017,Mayo,Panamá,18,35,,53,-73.181317,7.1280470000000005
43787,2017,Mayo,Panamá,69,118,,187,-77.35002,8.63337
43788,2017,Mayo,Paraguay,5,5,,10,-75.516486,10.446304
43789,2017,Mayo,Paraguay,1,1,,2,-74.77647900000001,10.886686
43790,2017,Mayo,Paraguay,72,50,,122,-81.70216500000001,12.5862
43791,2017,Mayo,Paraguay,6,8,,14,-76.532004,3.451668
43792,2017,Mayo,Paraguay,84,97,,181,-74.140516,4.697157
43793,2017,Mayo,Paraguay,0,1,,1,-75.736374,4.815189
43794,2017,Mayo,Paraguay,20,38,,58,-75.42726,6.170465
43795,2017,Mayo,Perú,94,102,,196,-69.941498,4.191162
43796,2017,Mayo,Perú,134,200,,334,-69.94143100000001,4.214082
43797,2017,Mayo,Perú,1,3,,4,-74.78366,0.18595699999999998
43798,2017,Mayo,Perú,8,13,,21,-77.35600000000001,0.81488
43799,2017,Mayo,Perú,1214,876,,2090,-75.516486,10.446304
43800,2017,Mayo,Perú,4,11,,15,-74.77647900000001,10.886686
43801,2017,Mayo,Perú,215,145,,360,-81.70216500000001,12.5862
43802,2017,Mayo,Perú,224,260,,484,-76.532004,3.451668
43803,2017,Mayo,Perú,0,2,,2,-77.061029,3.8844260000000004
43804,2017,Mayo,Perú,6485,8413,,14898,-74.140516,4.697157
43805,2017,Mayo,Perú,4,8,,12,-75.736374,4.815189
43806,2017,Mayo,Perú,356,516,,872,-75.42726,6.170465
43807,2017,Mayo,Perú,1,1,,2,-73.181317,7.1280470000000005
43808,2017,Mayo,Polonia,15,18,,33,-74.140516,4.697157
43809,2017,Mayo,Portugal,0,1,,1,-74.77647900000001,10.886686
43810,2017,Mayo,Portugal,0,1,,1,-81.70216500000001,12.5862
43811,2017,Mayo,Portugal,0,3,,3,-76.532004,3.451668
43812,2017,Mayo,Portugal,17,54,,71,-74.140516,4.697157
43813,2017,Mayo,Portugal,4,6,,10,-75.42726,6.170465
43814,2017,Mayo,Polinesia Francesa/Colectividad de Ultramar Francesa,0,1,,1,-74.140516,4.697157
43815,2017,Mayo,Puerto Rico/Territorio de Estados Unidos,1,1,,2,-75.527794,10.406342
43816,2017,Mayo,Puerto Rico/Territorio de Estados Unidos,5,2,,7,-75.516486,10.446304
43817,2017,Mayo,Puerto Rico/Territorio de Estados Unidos,9,14,,23,-74.77647900000001,10.886686
43818,2017,Mayo,Puerto Rico/Territorio de Estados Unidos,1,3,,4,-81.70216500000001,12.5862
43819,2017,Mayo,Puerto Rico/Territorio de Estados Unidos,39,38,,77,-76.532004,3.451668
43820,2017,Mayo,Puerto Rico/Territorio de Estados Unidos,477,552,,1029,-74.140516,4.697157
43821,2017,Mayo,Puerto Rico/Territorio de Estados Unidos,0,4,,4,-75.736374,4.815189
43822,2017,Mayo,Puerto Rico/Territorio de Estados Unidos,34,126,,160,-75.42726,6.170465
43823,2017,Mayo,Puerto Rico/Territorio de Estados Unidos,2,3,,5,-73.181317,7.1280470000000005
43824,2017,Mayo,Qatar,1,0,,1,-74.140516,4.697157
43825,2017,Mayo,Reino Unido de Gran Bretaña e Irlanda del Norte,1,0,,1,-75.516486,10.446304
43826,2017,Mayo,Reino Unido de Gran Bretaña e Irlanda del Norte,1,0,,1,-74.77647900000001,10.886686
43827,2017,Mayo,Reino Unido de Gran Bretaña e Irlanda del Norte,9,8,,17,-76.532004,3.451668
43828,2017,Mayo,Reino Unido de Gran Bretaña e Irlanda del Norte,600,1019,,1619,-74.140516,4.697157
43829,2017,Mayo,Reino Unido de Gran Bretaña e Irlanda del Norte,15,31,,46,-75.42726,6.170465
43830,2017,Mayo,Federación de Rusia,13,13,,26,-74.140516,4.697157
43831,2017,Mayo,Federación de Rusia,1,2,,3,-75.42726,6.170465
43832,2017,Mayo,República Dominicana,2,18,,20,-75.527794,10.406342
43833,2017,Mayo,República Dominicana,1,14,,15,-75.516486,10.446304
43834,2017,Mayo,República Dominicana,7,15,,22,-74.77647900000001,10.886686
43835,2017,Mayo,República Dominicana,0,2,,2,-74.213989,11.247722999999999
43836,2017,Mayo,República Dominicana,16,37,,53,-76.532004,3.451668
43837,2017,Mayo,República Dominicana,746,948,,1694,-74.140516,4.697157
43838,2017,Mayo,República Dominicana,3,11,,14,-75.736374,4.815189
43839,2017,Mayo,República Dominicana,35,109,,144,-75.42726,6.170465
43840,2017,Mayo,República Dominicana,3,8,,11,-73.181317,7.1280470000000005
43841,2017,Mayo,Reunión,1,0,,1,-74.140516,4.697157
43842,2017,Mayo,República Democrática Popular de Corea,0,1,,1,-75.736374,4.815189
43843,2017,Mayo,Rumania,1,5,,6,-74.140516,4.697157
43844,2017,Mayo,Rumania,5,2,,7,-75.42726,6.170465
43845,2017,Mayo,Rwanda,0,4,,4,-76.532004,3.451668
43846,2017,Mayo,San Cristóbal y Nevis,1,2,,3,-74.140516,4.697157
43847,2017,Mayo,San  Vicente y las Granadinas,0,2,,2,-75.42726,6.170465
43848,2017,Mayo,Santa Lucia,1,1,,2,-75.42726,6.170465
43849,2017,Mayo,Serbia,0,1,,1,-74.140516,4.697157
43850,2017,Mayo,Singapur,0,4,,4,-74.213989,11.247722999999999
43851,2017,Mayo,Singapur,0,1,,1,-76.532004,3.451668
43852,2017,Mayo,Singapur,2,3,,5,-74.140516,4.697157
43853,2017,Mayo,Singapur,1,0,,1,-75.736374,4.815189
43854,2017,Mayo,Singapur,0,1,,1,-75.42726,6.170465
43855,2017,Mayo,Sudáfrica,3,4,,7,-74.140516,4.697157
43856,2017,Mayo,Sudáfrica,1,2,,3,-75.42726,6.170465
43857,2017,Mayo,Sudán,0,1,,1,-74.140516,4.697157
43858,2017,Mayo,Suecia,0,2,,2,-76.532004,3.451668
43859,2017,Mayo,Suecia,11,28,,39,-74.140516,4.697157
43860,2017,Mayo,Suecia,4,4,,8,-75.42726,6.170465
43861,2017,Mayo,Suiza,1,1,,2,-75.516486,10.446304
43862,2017,Mayo,Suiza,6,8,,14,-76.532004,3.451668
43863,2017,Mayo,Suiza,36,69,,105,-74.140516,4.697157
43864,2017,Mayo,Suiza,0,1,,1,-75.736374,4.815189
43865,2017,Mayo,Suiza,7,8,,15,-75.42726,6.170465
43866,2017,Mayo,Surinam,0,3,,3,-75.527794,10.406342
43867,2017,Mayo,Surinam,1,2,,3,-74.140516,4.697157
43868,2017,Mayo,Surinam,0,2,,2,-75.42726,6.170465
43869,2017,Mayo,Taiwán,0,1,,1,-76.532004,3.451668
43870,2017,Mayo,Taiwán,3,4,,7,-74.140516,4.697157
43871,2017,Mayo,Taiwán,2,2,,4,-75.42726,6.170465
43872,2017,Mayo,Tailandia,1,1,,2,-74.140516,4.697157
43873,2017,Mayo,Tailandia,0,3,,3,-75.42726,6.170465
43874,2017,Mayo,Tanzania,0,1,,1,-74.140516,4.697157
43875,2017,Mayo,Trinidad y Tobago,0,2,,2,-75.527794,10.406342
43876,2017,Mayo,Trinidad y Tobago,0,1,,1,-75.516486,10.446304
43877,2017,Mayo,Trinidad y Tobago,1,11,,12,-74.77647900000001,10.886686
43878,2017,Mayo,Trinidad y Tobago,2,2,,4,-76.532004,3.451668
43879,2017,Mayo,Trinidad y Tobago,3,6,,9,-74.140516,4.697157
43880,2017,Mayo,Trinidad y Tobago,0,1,,1,-75.736374,4.815189
43881,2017,Mayo,Trinidad y Tobago,3,5,,8,-75.42726,6.170465
43882,2017,Mayo,Trinidad y Tobago,0,2,,2,-73.181317,7.1280470000000005
43883,2017,Mayo,Túnez,1,2,,3,-74.140516,4.697157
43884,2017,Mayo,Turkmenistán,4,7,,11,-74.140516,4.697157
43885,2017,Mayo,Turquía,0,1,,1,-75.527794,10.406342
43886,2017,Mayo,Turquía,0,1,,1,-74.77647900000001,10.886686
43887,2017,Mayo,Turquía,0,1,,1,-76.532004,3.451668
43888,2017,Mayo,Turquía,191,327,,518,-74.140516,4.697157
43889,2017,Mayo,Turquía,0,4,,4,-75.42726,6.170465
43890,2017,Mayo,Ucrania,0,3,,3,-76.532004,3.451668
43891,2017,Mayo,Ucrania,2,3,,5,-74.140516,4.697157
43892,2017,Mayo,Ucrania,0,1,,1,-75.42726,6.170465
43893,2017,Mayo,Uganda,4,4,,8,-76.532004,3.451668
43894,2017,Mayo,Uruguay,5,7,,12,-75.516486,10.446304
43895,2017,Mayo,Uruguay,46,43,,89,-81.70216500000001,12.5862
43896,2017,Mayo,Uruguay,5,7,,12,-76.532004,3.451668
43897,2017,Mayo,Uruguay,227,272,,499,-74.140516,4.697157
43898,2017,Mayo,Uruguay,6,5,,11,-75.736374,4.815189
43899,2017,Mayo,Uruguay,13,33,,46,-75.42726,6.170465
43900,2017,Mayo,Venezuela,0,10,,10,-75.527794,10.406342
43901,2017,Mayo,Venezuela,0,3,,3,-73.247863,10.433608999999999
43902,2017,Mayo,Venezuela,7,43,,50,-75.516486,10.446304
43903,2017,Mayo,Venezuela,21,58,,79,-74.77647900000001,10.886686
43904,2017,Mayo,Venezuela,1,8,,9,-74.232675,11.117206
43905,2017,Mayo,Venezuela,5810,6768,,12578,-72.129595,11.360028999999999
43906,2017,Mayo,Venezuela,1,0,,1,-81.70216500000001,12.5862
43907,2017,Mayo,Venezuela,14,15,,29,-76.532004,3.451668
43908,2017,Mayo,Venezuela,11,17,,28,-67.927521,3.866713
43909,2017,Mayo,Venezuela,3145,3565,,6710,-74.140516,4.697157
43910,2017,Mayo,Venezuela,3,5,,8,-75.736374,4.815189
43911,2017,Mayo,Venezuela,375,481,,856,-75.42726,6.170465
43912,2017,Mayo,Venezuela,15,23,,38,-67.48402800000001,6.185536
43913,2017,Mayo,Venezuela,184,194,,378,-70.74025300000001,7.088728999999999
43914,2017,Mayo,Venezuela,2,1,,3,-73.181317,7.1280470000000005
43915,2017,Mayo,Venezuela,7773,10764,,18537,-72.453013,7.819
43916,2017,Mayo,Venezuela,1,2,,3,-72.508188,7.927233
43917,2017,Mayo,Venezuela,451,594,,1045,-72.409396,8.36068
43918,2017,Mayo,Vietnam,0,1,,1,-74.140516,4.697157
43919,2017,Mayo,Zambia,2,3,,5,-76.532004,3.451668
43920,2017,Mayo,Zimbabue,1,2,,3,-76.532004,3.451668
43921,2017,Mayo,Anguila/Territorio Británico de Ultramar,0,1,,1,-76.532004,3.451668
43922,2017,Junio,Afganistán,0,1,,1,-76.532004,3.451668
43923,2017,Junio,Alemania,1,0,,1,-77.35600000000001,0.81488
43924,2017,Junio,Alemania,0,3,,3,-75.527794,10.406342
43925,2017,Junio,Alemania,2,5,,7,-75.516486,10.446304
43926,2017,Junio,Alemania,3,8,,11,-74.77647900000001,10.886686
43927,2017,Junio,Alemania,1,2,,3,-81.70216500000001,12.5862
43928,2017,Junio,Alemania,26,29,,55,-76.532004,3.451668
43929,2017,Junio,Alemania,1284,1948,,3232,-74.140516,4.697157
43930,2017,Junio,Alemania,0,1,,1,-75.736374,4.815189
43931,2017,Junio,Alemania,48,40,,88,-75.42726,6.170465
43932,2017,Junio,Andorra,0,2,,2,-76.532004,3.451668
43933,2017,Junio,Andorra,0,1,,1,-75.736374,4.815189
43934,2017,Junio,Angola,0,1,,1,-74.140516,4.697157
43935,2017,Junio,Antigua y Barbuda,0,5,,5,-75.527794,10.406342
43936,2017,Junio,Antigua y Barbuda,0,2,,2,-74.140516,4.697157
43937,2017,Junio,Países Bajos,2,6,,8,-75.527794,10.406342
43938,2017,Junio,Países Bajos,108,196,,304,-75.516486,10.446304
43939,2017,Junio,Países Bajos,7,5,,12,-74.77647900000001,10.886686
43940,2017,Junio,Países Bajos,0,3,,3,-74.765343,10.970933
43941,2017,Junio,Países Bajos,3,3,,6,-74.213989,11.247722999999999
43942,2017,Junio,Países Bajos,18,30,,48,-76.532004,3.451668
43943,2017,Junio,Países Bajos,763,1054,,1817,-74.140516,4.697157
43944,2017,Junio,Países Bajos,1,1,,2,-75.736374,4.815189
43945,2017,Junio,Países Bajos,67,112,,179,-75.42726,6.170465
43946,2017,Junio,Países Bajos,2,3,,5,-73.181317,7.1280470000000005
43947,2017,Junio,Arabia Saudita,1,2,,3,-76.532004,3.451668
43948,2017,Junio,Arabia Saudita,3,3,,6,-74.140516,4.697157
43949,2017,Junio,Argelia,0,2,,2,-74.140516,4.697157
43950,2017,Junio,Argentina,12,13,,25,-77.35600000000001,0.81488
43951,2017,Junio,Argentina,60,37,,97,-75.516486,10.446304
43952,2017,Junio,Argentina,0,5,,5,-74.77647900000001,10.886686
43953,2017,Junio,Argentina,172,146,,318,-81.70216500000001,12.5862
43954,2017,Junio,Argentina,14,16,,30,-76.532004,3.451668
43955,2017,Junio,Argentina,3418,4223,,7641,-74.140516,4.697157
43956,2017,Junio,Argentina,1,5,,6,-75.736374,4.815189
43957,2017,Junio,Argentina,36,88,,124,-75.42726,6.170465
43958,2017,Junio,Argentina,1,1,,2,-73.181317,7.1280470000000005
43959,2017,Junio,República de Armenia,0,1,,1,-75.516486,10.446304
43960,2017,Junio,Aruba,5,4,,9,-75.527794,10.406342
43961,2017,Junio,Aruba,0,1,,1,-74.77647900000001,10.886686
43962,2017,Junio,Aruba,9,29,,38,-74.213989,11.247722999999999
43963,2017,Junio,Aruba,5,5,,10,-76.532004,3.451668
43964,2017,Junio,Aruba,725,833,,1558,-74.140516,4.697157
43965,2017,Junio,Aruba,6,12,,18,-75.42726,6.170465
43966,2017,Junio,Aruba,14,12,,26,-73.181317,7.1280470000000005
43967,2017,Junio,Australia,2,2,,4,-75.516486,10.446304
43968,2017,Junio,Australia,1,0,,1,-74.77647900000001,10.886686
43969,2017,Junio,Australia,6,8,,14,-76.532004,3.451668
43970,2017,Junio,Australia,45,84,,129,-74.140516,4.697157
43971,2017,Junio,Australia,0,1,,1,-75.736374,4.815189
43972,2017,Junio,Australia,14,14,,28,-75.42726,6.170465
43973,2017,Junio,Austria,1,1,,2,-76.532004,3.451668
43974,2017,Junio,Austria,23,29,,52,-74.140516,4.697157
43975,2017,Junio,Austria,1,2,,3,-75.42726,6.170465
43976,2017,Junio,Bahamas,0,1,,1,-75.516486,10.446304
43977,2017,Junio,Bahamas,0,1,,1,-74.77647900000001,10.886686
43978,2017,Junio,Bahamas,2,1,,3,-74.140516,4.697157
43979,2017,Junio,Bahamas,0,1,,1,-75.42726,6.170465
43980,2017,Junio,Bahréin,1,1,,2,-75.516486,10.446304
43981,2017,Junio,Bahréin,0,2,,2,-75.42726,6.170465
43982,2017,Junio,Barbados,37,52,,89,-74.140516,4.697157
43983,2017,Junio,Barbados,0,1,,1,-75.42726,6.170465
43984,2017,Junio,República de Belarús,1,0,,1,-74.140516,4.697157
43985,2017,Junio,República de Belarús,2,1,,3,-72.453013,7.819
43986,2017,Junio,Bélgica,3,2,,5,-75.516486,10.446304
43987,2017,Junio,Bélgica,1,0,,1,-74.77647900000001,10.886686
43988,2017,Junio,Bélgica,0,1,,1,-74.213989,11.247722999999999
43989,2017,Junio,Bélgica,3,7,,10,-76.532004,3.451668
43990,2017,Junio,Bélgica,46,59,,105,-74.140516,4.697157
43991,2017,Junio,Bélgica,0,1,,1,-75.736374,4.815189
43992,2017,Junio,Bélgica,22,19,,41,-75.42726,6.170465
43993,2017,Junio,Belice,0,2,,2,-76.532004,3.451668
43994,2017,Junio,Belice,2,2,,4,-74.140516,4.697157
43995,2017,Junio,Belice,1,2,,3,-75.42726,6.170465
43996,2017,Junio,Bermudas/Territorio Británico de Ultramar,1,0,,1,-74.140516,4.697157
43997,2017,Junio,Bermudas/Territorio Británico de Ultramar,0,1,,1,-75.42726,6.170465
43998,2017,Junio,Bolivia,0,4,,4,-77.35600000000001,0.81488
43999,2017,Junio,Bolivia,13,5,,18,-75.516486,10.446304
44000,2017,Junio,Bolivia,1,0,,1,-74.77647900000001,10.886686
44001,2017,Junio,Bolivia,9,12,,21,-81.70216500000001,12.5862
44002,2017,Junio,Bolivia,13,10,,23,-76.532004,3.451668
44003,2017,Junio,Bolivia,463,513,,976,-74.140516,4.697157
44004,2017,Junio,Bolivia,1,1,,2,-75.736374,4.815189
44005,2017,Junio,Bolivia,14,20,,34,-75.42726,6.170465
44006,2017,Junio,Bosnia y Herzegovina,0,1,,1,-74.140516,4.697157
44007,2017,Junio,Brasil,170,214,,384,-69.941498,4.191162
44008,2017,Junio,Brasil,32,39,,71,-69.94143100000001,4.214082
44009,2017,Junio,Brasil,1,1,,2,-77.35600000000001,0.81488
44010,2017,Junio,Brasil,0,6,,6,-75.527794,10.406342
44011,2017,Junio,Brasil,51,44,,95,-75.516486,10.446304
44012,2017,Junio,Brasil,9,5,,14,-74.77647900000001,10.886686
44013,2017,Junio,Brasil,371,278,,649,-81.70216500000001,12.5862
44014,2017,Junio,Brasil,27,36,,63,-76.532004,3.451668
44015,2017,Junio,Brasil,0,1,,1,-67.927521,3.866713
44016,2017,Junio,Brasil,4385,5644,,10029,-74.140516,4.697157
44017,2017,Junio,Brasil,5,4,,9,-75.736374,4.815189
44018,2017,Junio,Brasil,79,127,,206,-75.42726,6.170465
44019,2017,Junio,Brasil,2,2,,4,-73.181317,7.1280470000000005
44020,2017,Junio,Brunei Darussalam,1,0,,1,-74.140516,4.697157
44021,2017,Junio,Bulgaria,1,5,,6,-74.140516,4.697157
44022,2017,Junio,Bulgaria,0,1,,1,-75.42726,6.170465
44023,2017,Junio,Burundi,0,1,,1,-74.140516,4.697157
44024,2017,Junio,Islas Caimán/Territorio Británico de Ultramar,0,1,,1,-81.70216500000001,12.5862
44025,2017,Junio,Islas Caimán/Territorio Británico de Ultramar,1,4,,5,-74.140516,4.697157
44026,2017,Junio,Islas Caimán/Territorio Británico de Ultramar,0,1,,1,-75.42726,6.170465
44027,2017,Junio,Canadá,9,8,,17,-75.516486,10.446304
44028,2017,Junio,Canadá,7,10,,17,-74.77647900000001,10.886686
44029,2017,Junio,Canadá,0,1,,1,-81.70216500000001,12.5862
44030,2017,Junio,Canadá,47,56,,103,-76.532004,3.451668
44031,2017,Junio,Canadá,0,11,,11,-77.061029,3.8844260000000004
44032,2017,Junio,Canadá,0,1,,1,-75.76635300000001,4.45285
44033,2017,Junio,Canadá,760,1035,,1795,-74.140516,4.697157
44034,2017,Junio,Canadá,5,2,,7,-75.736374,4.815189
44035,2017,Junio,Canadá,63,168,,231,-75.42726,6.170465
44036,2017,Junio,Canadá,2,2,,4,-73.181317,7.1280470000000005
44037,2017,Junio,España,1,4,,5,-75.516486,10.446304
44038,2017,Junio,España,1,9,,10,-74.77647900000001,10.886686
44039,2017,Junio,España,1,4,,5,-81.70216500000001,12.5862
44040,2017,Junio,España,419,514,,933,-76.532004,3.451668
44041,2017,Junio,España,2817,4643,,7460,-74.140516,4.697157
44042,2017,Junio,España,9,9,,18,-75.736374,4.815189
44043,2017,Junio,España,497,800,,1297,-75.42726,6.170465
44044,2017,Junio,España,0,1,,1,-73.181317,7.1280470000000005
44045,2017,Junio,Comoras,0,1,,1,-74.140516,4.697157
44046,2017,Junio,República de Corea,0,1,,1,-74.77647900000001,10.886686
44047,2017,Junio,República de Corea,18,18,,36,-74.140516,4.697157
44048,2017,Junio,República de Corea,10,9,,19,-75.42726,6.170465
44049,2017,Junio,Costa de Marfil,0,1,,1,-76.532004,3.451668
44050,2017,Junio,Costa de Marfil,5,7,,12,-74.140516,4.697157
44051,2017,Junio,Costa Rica,3,4,,7,-75.527794,10.406342
44052,2017,Junio,Costa Rica,10,10,,20,-75.516486,10.446304
44053,2017,Junio,Costa Rica,8,14,,22,-74.77647900000001,10.886686
44054,2017,Junio,Costa Rica,0,1,,1,-74.213989,11.247722999999999
44055,2017,Junio,Costa Rica,0,3,,3,-81.703935,12.574411099999999
44056,2017,Junio,Costa Rica,41,39,,80,-81.70216500000001,12.5862
44057,2017,Junio,Costa Rica,26,44,,70,-76.532004,3.451668
44058,2017,Junio,Costa Rica,0,1,,1,-77.061029,3.8844260000000004
44059,2017,Junio,Costa Rica,1452,1877,,3329,-74.140516,4.697157
44060,2017,Junio,Costa Rica,0,5,,5,-75.736374,4.815189
44061,2017,Junio,Costa Rica,61,93,,154,-75.42726,6.170465
44062,2017,Junio,Costa Rica,0,8,,8,-73.181317,7.1280470000000005
44063,2017,Junio,Croacia,1,4,,5,-74.140516,4.697157
44064,2017,Junio,Croacia,0,1,,1,-75.42726,6.170465
44065,2017,Junio,Cuba,0,1,,1,-75.527794,10.406342
44066,2017,Junio,Cuba,2,2,,4,-75.516486,10.446304
44067,2017,Junio,Cuba,3,8,,11,-74.77647900000001,10.886686
44068,2017,Junio,Cuba,1,1,,2,-81.70216500000001,12.5862
44069,2017,Junio,Cuba,1,1,,2,-81.372937,13.338761300000002
44070,2017,Junio,Cuba,16,20,,36,-76.532004,3.451668
44071,2017,Junio,Cuba,357,579,,936,-74.140516,4.697157
44072,2017,Junio,Cuba,1,2,,3,-75.736374,4.815189
44073,2017,Junio,Cuba,17,19,,36,-75.42726,6.170465
44074,2017,Junio,Curazao,6,6,,12,-74.140516,4.697157
44075,2017,Junio,República Checa,0,1,,1,-76.532004,3.451668
44076,2017,Junio,República Checa,9,5,,14,-74.140516,4.697157
44077,2017,Junio,Chile,2,6,,8,-77.35600000000001,0.81488
44078,2017,Junio,Chile,22,17,,39,-75.516486,10.446304
44079,2017,Junio,Chile,1,7,,8,-74.77647900000001,10.886686
44080,2017,Junio,Chile,124,93,,217,-81.70216500000001,12.5862
44081,2017,Junio,Chile,31,52,,83,-76.532004,3.451668
44082,2017,Junio,Chile,4407,5749,,10156,-74.140516,4.697157
44083,2017,Junio,Chile,1,3,,4,-75.736374,4.815189
44084,2017,Junio,Chile,10,32,,42,-75.42726,6.170465
44085,2017,Junio,Chile,0,7,,7,-73.181317,7.1280470000000005
44086,2017,Junio,China,2,0,,2,-75.516486,10.446304
44087,2017,Junio,China,1,3,,4,-74.77647900000001,10.886686
44088,2017,Junio,China,1,7,,8,-76.532004,3.451668
44089,2017,Junio,China,42,74,,116,-74.140516,4.697157
44090,2017,Junio,China,0,4,,4,-75.42726,6.170465
44091,2017,Junio,Dinamarca,1,1,,2,-74.77647900000001,10.886686
44092,2017,Junio,Dinamarca,4,5,,9,-76.532004,3.451668
44093,2017,Junio,Dinamarca,20,20,,40,-74.140516,4.697157
44094,2017,Junio,Dinamarca,2,6,,8,-75.42726,6.170465
44095,2017,Junio,Dinamarca,0,1,,1,-73.181317,7.1280470000000005
44096,2017,Junio,Dominica,1,1,,2,-74.140516,4.697157
44097,2017,Junio,Ecuador,2,2,,4,-74.78366,0.18595699999999998
44098,2017,Junio,Ecuador,127,409,,536,-76.876446,0.33002
44099,2017,Junio,Ecuador,1,3,,4,-77.84700600000001,0.8124359999999999
44100,2017,Junio,Ecuador,3222,4954,,8176,-77.35600000000001,0.81488
44101,2017,Junio,Ecuador,31,73,,104,-78.802679,18.00143
44102,2017,Junio,Ecuador,0,1,,1,-75.527794,10.406342
44103,2017,Junio,Ecuador,4,3,,7,-75.516486,10.446304
44104,2017,Junio,Ecuador,6,7,,13,-74.77647900000001,10.886686
44105,2017,Junio,Ecuador,11,14,,25,-81.70216500000001,12.5862
44106,2017,Junio,Ecuador,255,317,,572,-76.532004,3.451668
44107,2017,Junio,Ecuador,0,1,,1,-77.061029,3.8844260000000004
44108,2017,Junio,Ecuador,2753,4343,,7096,-74.140516,4.697157
44109,2017,Junio,Ecuador,3,3,,6,-75.736374,4.815189
44110,2017,Junio,Ecuador,22,45,,67,-75.42726,6.170465
44111,2017,Junio,Ecuador,0,1,,1,-73.181317,7.1280470000000005
44112,2017,Junio,Egipto,2,3,,5,-74.140516,4.697157
44113,2017,Junio,El Salvador,1,0,,1,-75.516486,10.446304
44114,2017,Junio,El Salvador,1,2,,3,-74.77647900000001,10.886686
44115,2017,Junio,El Salvador,4,7,,11,-74.232675,11.117206
44116,2017,Junio,El Salvador,2,2,,4,-81.70216500000001,12.5862
44117,2017,Junio,El Salvador,168,191,,359,-76.532004,3.451668
44118,2017,Junio,El Salvador,748,1104,,1852,-74.140516,4.697157
44119,2017,Junio,El Salvador,169,269,,438,-75.42726,6.170465
44120,2017,Junio,Emiratos Árabes,2,1,,3,-76.532004,3.451668
44121,2017,Junio,Emiratos Árabes,3,8,,11,-74.140516,4.697157
44122,2017,Junio,Emiratos Árabes,3,1,,4,-75.42726,6.170465
44123,2017,Junio,Eslovaquia,1,2,,3,-74.140516,4.697157
44124,2017,Junio,Eslovenia,0,1,,1,-76.532004,3.451668
44125,2017,Junio,Eslovenia,6,10,,16,-74.140516,4.697157
44126,2017,Junio,Eslovenia,1,0,,1,-75.42726,6.170465
44127,2017,Junio,Estados Unidos de América,2,27,,29,-75.527794,10.406342
44128,2017,Junio,Estados Unidos de América,3188,4299,,7487,-75.516486,10.446304
44129,2017,Junio,Estados Unidos de América,958,1417,,2375,-74.77647900000001,10.886686
44130,2017,Junio,Estados Unidos de América,0,17,,17,-74.765343,10.970933
44131,2017,Junio,Estados Unidos de América,0,19,,19,-74.213989,11.247722999999999
44132,2017,Junio,Estados Unidos de América,38,51,,89,-81.70216500000001,12.5862
44133,2017,Junio,Estados Unidos de América,2056,2516,,4572,-76.532004,3.451668
44134,2017,Junio,Estados Unidos de América,333,377,,710,-75.76635300000001,4.45285
44135,2017,Junio,Estados Unidos de América,12285,18211,,30496,-74.140516,4.697157
44136,2017,Junio,Estados Unidos de América,314,365,,679,-75.736374,4.815189
44137,2017,Junio,Estados Unidos de América,3719,6438,,10157,-75.42726,6.170465
44138,2017,Junio,Estados Unidos de América,44,84,,128,-73.181317,7.1280470000000005
44139,2017,Junio,Estados Unidos de América,0,23,,23,-75.68164200000001,9.402597
44140,2017,Junio,Estonia,3,2,,5,-74.140516,4.697157
44141,2017,Junio,Filipinas,0,4,,4,-75.516486,10.446304
44142,2017,Junio,Filipinas,0,4,,4,-74.77647900000001,10.886686
44143,2017,Junio,Filipinas,0,16,,16,-76.532004,3.451668
44144,2017,Junio,Filipinas,6,6,,12,-74.140516,4.697157
44145,2017,Junio,Finlandia,2,4,,6,-74.140516,4.697157
44146,2017,Junio,Finlandia,3,4,,7,-75.42726,6.170465
44147,2017,Junio,Francia,1,4,,5,-75.516486,10.446304
44148,2017,Junio,Francia,1,2,,3,-74.77647900000001,10.886686
44149,2017,Junio,Francia,1,0,,1,-81.70216500000001,12.5862
44150,2017,Junio,Francia,28,45,,73,-76.532004,3.451668
44151,2017,Junio,Francia,1166,1974,,3140,-74.140516,4.697157
44152,2017,Junio,Francia,2,7,,9,-75.736374,4.815189
44153,2017,Junio,Francia,28,44,,72,-75.42726,6.170465
44154,2017,Junio,Georgia,0,2,,2,-76.532004,3.451668
44155,2017,Junio,Georgia,0,1,,1,-74.140516,4.697157
44156,2017,Junio,Ghana,0,2,,2,-74.140516,4.697157
44157,2017,Junio,Gibraltar/Territorio Británico de Ultramar,1,1,,2,-77.35600000000001,0.81488
44158,2017,Junio,Granada,3,4,,7,-75.527794,10.406342
44159,2017,Junio,Grecia,3,6,,9,-74.140516,4.697157
44160,2017,Junio,Grecia,1,1,,2,-75.42726,6.170465
44161,2017,Junio,Grecia,0,1,,1,-73.181317,7.1280470000000005
44162,2017,Junio,Guatemala,14,12,,26,-75.516486,10.446304
44163,2017,Junio,Guatemala,7,8,,15,-74.77647900000001,10.886686
44164,2017,Junio,Guatemala,3,2,,5,-81.70216500000001,12.5862
44165,2017,Junio,Guatemala,23,41,,64,-76.532004,3.451668
44166,2017,Junio,Guatemala,347,565,,912,-74.140516,4.697157
44167,2017,Junio,Guatemala,2,4,,6,-75.736374,4.815189
44168,2017,Junio,Guatemala,40,71,,111,-75.42726,6.170465
44169,2017,Junio,Guatemala,0,2,,2,-73.181317,7.1280470000000005
44170,2017,Junio,Guyana,1,0,,1,-76.532004,3.451668
44171,2017,Junio,Guyana,2,0,,2,-74.140516,4.697157
44172,2017,Junio,Guyana,0,1,,1,-75.42726,6.170465
44173,2017,Junio,Guyana,0,1,,1,-76.7333,8.06667
44174,2017,Junio,Guinea,0,1,,1,-75.527794,10.406342
44175,2017,Junio,Guinea,0,1,,1,-74.140516,4.697157
44176,2017,Junio,Guadalupe/Territorio Francés,0,2,,2,-74.765343,10.970933
44177,2017,Junio,Guadalupe/Territorio Francés,1,3,,4,-74.140516,4.697157
44178,2017,Junio,Guadalupe/Territorio Francés,1,0,,1,-75.42726,6.170465
44179,2017,Junio,Guam/Territorio no incorporado de Estados Unidos,1,0,,1,-74.140516,4.697157
44180,2017,Junio,Guayana Francesa/Departamento de Ultramar Francés,0,2,,2,-75.527794,10.406342
44181,2017,Junio,Guayana Francesa/Departamento de Ultramar Francés,1,2,,3,-74.140516,4.697157
44182,2017,Junio,Guayana Francesa/Departamento de Ultramar Francés,1,0,,1,-75.42726,6.170465
44183,2017,Junio,Haití,0,4,,4,-74.765343,10.970933
44184,2017,Junio,Haití,3,3,,6,-74.140516,4.697157
44185,2017,Junio,Haití,3,2,,5,-75.42726,6.170465
44186,2017,Junio,Honduras,0,2,,2,-75.516486,10.446304
44187,2017,Junio,Honduras,3,5,,8,-74.77647900000001,10.886686
44188,2017,Junio,Honduras,1,3,,4,-81.703935,12.574411099999999
44189,2017,Junio,Honduras,1,5,,6,-81.70216500000001,12.5862
44190,2017,Junio,Honduras,11,20,,31,-76.532004,3.451668
44191,2017,Junio,Honduras,42,65,,107,-74.140516,4.697157
44192,2017,Junio,Honduras,0,2,,2,-75.736374,4.815189
44193,2017,Junio,Honduras,23,38,,61,-75.42726,6.170465
44194,2017,Junio,Honduras,1,2,,3,-73.181317,7.1280470000000005
44195,2017,Junio,Hong Kong,0,1,,1,-76.532004,3.451668
44196,2017,Junio,Hong Kong,4,0,,4,-74.140516,4.697157
44197,2017,Junio,Hong Kong,0,2,,2,-75.42726,6.170465
44198,2017,Junio,Hungría,1,0,,1,-76.532004,3.451668
44199,2017,Junio,Hungría,6,4,,10,-74.140516,4.697157
44200,2017,Junio,India,0,3,,3,-74.77647900000001,10.886686
44201,2017,Junio,India,0,3,,3,-76.532004,3.451668
44202,2017,Junio,India,7,19,,26,-74.140516,4.697157
44203,2017,Junio,India,2,4,,6,-75.42726,6.170465
44204,2017,Junio,Indonesia,0,2,,2,-74.140516,4.697157
44205,2017,Junio,Iraq,0,1,,1,-74.140516,4.697157
44206,2017,Junio,Irán,0,2,,2,-74.140516,4.697157
44207,2017,Junio,Irán,0,1,,1,-75.736374,4.815189
44208,2017,Junio,República de Irlanda,16,19,,35,-74.140516,4.697157
44209,2017,Junio,República de Irlanda,3,5,,8,-75.42726,6.170465
44210,2017,Junio,Islandia,3,1,,4,-75.42726,6.170465
44211,2017,Junio,Israel,0,3,,3,-76.532004,3.451668
44212,2017,Junio,Israel,23,63,,86,-74.140516,4.697157
44213,2017,Junio,Israel,0,3,,3,-75.42726,6.170465
44214,2017,Junio,Italia,1,6,,7,-75.516486,10.446304
44215,2017,Junio,Italia,2,5,,7,-74.77647900000001,10.886686
44216,2017,Junio,Italia,1,0,,1,-81.70216500000001,12.5862
44217,2017,Junio,Italia,15,25,,40,-76.532004,3.451668
44218,2017,Junio,Italia,104,221,,325,-74.140516,4.697157
44219,2017,Junio,Italia,17,55,,72,-75.42726,6.170465
44220,2017,Junio,Jamaica,0,3,,3,-75.527794,10.406342
44221,2017,Junio,Jamaica,1,2,,3,-75.516486,10.446304
44222,2017,Junio,Jamaica,0,1,,1,-74.77647900000001,10.886686
44223,2017,Junio,Jamaica,0,30,,30,-74.765343,10.970933
44224,2017,Junio,Jamaica,1,2,,3,-81.372937,13.338761300000002
44225,2017,Junio,Jamaica,3,9,,12,-74.140516,4.697157
44226,2017,Junio,Japón,0,3,,3,-76.532004,3.451668
44227,2017,Junio,Japón,8,18,,26,-74.140516,4.697157
44228,2017,Junio,Japón,2,1,,3,-75.42726,6.170465
44229,2017,Junio,Jordania,2,0,,2,-74.140516,4.697157
44230,2017,Junio,Kenia,1,1,,2,-76.532004,3.451668
44231,2017,Junio,Kenia,1,1,,2,-74.140516,4.697157
44232,2017,Junio,Kirguistán,0,1,,1,-74.140516,4.697157
44233,2017,Junio,Kuwait,0,2,,2,-74.140516,4.697157
44234,2017,Junio,Letonia,1,5,,6,-74.140516,4.697157
44235,2017,Junio,Lituania,0,1,,1,-76.532004,3.451668
44236,2017,Junio,Lituania,0,1,,1,-74.140516,4.697157
44237,2017,Junio,Líbano,3,8,,11,-74.140516,4.697157
44238,2017,Junio,Liechtenstein,1,0,,1,-74.140516,4.697157
44239,2017,Junio,Luxemburgo,0,3,,3,-74.140516,4.697157
44240,2017,Junio,Luxemburgo,1,0,,1,-75.42726,6.170465
44241,2017,Junio,Luxemburgo,1,0,,1,-73.181317,7.1280470000000005
44242,2017,Junio,Madagascar,2,0,,2,-74.140516,4.697157
44243,2017,Junio,Malasia,0,2,,2,-74.140516,4.697157
44244,2017,Junio,Malta,1,1,,2,-74.140516,4.697157
44245,2017,Junio,Malta,0,1,,1,-75.42726,6.170465
44246,2017,Junio,Marruecos,0,2,,2,-74.765343,10.970933
44247,2017,Junio,Marruecos,0,2,,2,-74.140516,4.697157
44248,2017,Junio,México,0,11,,11,-75.527794,10.406342
44249,2017,Junio,México,33,60,,93,-75.516486,10.446304
44250,2017,Junio,México,22,41,,63,-74.77647900000001,10.886686
44251,2017,Junio,México,0,1,,1,-74.213989,11.247722999999999
44252,2017,Junio,México,1,1,,2,-81.70216500000001,12.5862
44253,2017,Junio,México,130,257,,387,-76.532004,3.451668
44254,2017,Junio,México,5340,8380,,13720,-74.140516,4.697157
44255,2017,Junio,México,11,29,,40,-75.736374,4.815189
44256,2017,Junio,México,548,1157,,1705,-75.42726,6.170465
44257,2017,Junio,México,7,12,,19,-73.181317,7.1280470000000005
44258,2017,Junio,Mónaco,0,1,,1,-74.140516,4.697157
44259,2017,Junio,Nauru,0,1,,1,-74.140516,4.697157
44260,2017,Junio,Nicaragua,0,2,,2,-75.516486,10.446304
44261,2017,Junio,Nicaragua,0,4,,4,-81.703935,12.574411099999999
44262,2017,Junio,Nicaragua,3,13,,16,-76.532004,3.451668
44263,2017,Junio,Nicaragua,41,40,,81,-74.140516,4.697157
44264,2017,Junio,Nicaragua,3,0,,3,-75.736374,4.815189
44265,2017,Junio,Nicaragua,6,12,,18,-75.42726,6.170465
44266,2017,Junio,Nicaragua,1,2,,3,-73.181317,7.1280470000000005
44267,2017,Junio,Nigeria,0,23,,23,-74.213989,11.247722999999999
44268,2017,Junio,Nigeria,1,3,,4,-74.140516,4.697157
44269,2017,Junio,Noruega,9,2,,11,-76.532004,3.451668
44270,2017,Junio,Noruega,38,56,,94,-74.140516,4.697157
44271,2017,Junio,Noruega,0,2,,2,-75.736374,4.815189
44272,2017,Junio,Noruega,2,5,,7,-75.42726,6.170465
44273,2017,Junio,Noruega,2,1,,3,-73.181317,7.1280470000000005
44274,2017,Junio,Nueva Zelanda,1,0,,1,-76.532004,3.451668
44275,2017,Junio,Nueva Zelanda,8,10,,18,-74.140516,4.697157
44276,2017,Junio,Nueva Zelanda,4,0,,4,-75.42726,6.170465
44277,2017,Junio,Omán,2,0,,2,-74.140516,4.697157
44278,2017,Junio,Omán,1,0,,1,-75.42726,6.170465
44279,2017,Junio,Papúa Nueva Guinea,1,0,,1,-74.140516,4.697157
44280,2017,Junio,Panamá,0,1,,1,-78.802679,18.00143
44281,2017,Junio,Panamá,951,919,,1870,-75.527794,10.406342
44282,2017,Junio,Panamá,3470,3687,,7157,-75.516486,10.446304
44283,2017,Junio,Panamá,358,645,,1003,-74.77647900000001,10.886686
44284,2017,Junio,Panamá,0,30,,30,-74.765343,10.970933
44285,2017,Junio,Panamá,0,3,,3,-74.213989,11.247722999999999
44286,2017,Junio,Panamá,5,8,,13,-81.703935,12.574411099999999
44287,2017,Junio,Panamá,164,147,,311,-81.70216500000001,12.5862
44288,2017,Junio,Panamá,2,1,,3,-81.372937,13.338761300000002
44289,2017,Junio,Panamá,368,529,,897,-76.532004,3.451668
44290,2017,Junio,Panamá,0,27,,27,-77.061029,3.8844260000000004
44291,2017,Junio,Panamá,58,53,,111,-75.76635300000001,4.45285
44292,2017,Junio,Panamá,3968,5690,,9658,-74.140516,4.697157
44293,2017,Junio,Panamá,25,65,,90,-75.736374,4.815189
44294,2017,Junio,Panamá,1879,2431,,4310,-75.42726,6.170465
44295,2017,Junio,Panamá,0,1,,1,-77.762647,7.102626
44296,2017,Junio,Panamá,21,31,,52,-73.181317,7.1280470000000005
44297,2017,Junio,Panamá,0,1,,1,-76.7333,8.06667
44298,2017,Junio,Panamá,91,114,,205,-77.35002,8.63337
44299,2017,Junio,Paraguay,1,0,,1,-77.35600000000001,0.81488
44300,2017,Junio,Paraguay,0,2,,2,-75.516486,10.446304
44301,2017,Junio,Paraguay,3,4,,7,-74.77647900000001,10.886686
44302,2017,Junio,Paraguay,69,35,,104,-81.70216500000001,12.5862
44303,2017,Junio,Paraguay,3,8,,11,-76.532004,3.451668
44304,2017,Junio,Paraguay,85,116,,201,-74.140516,4.697157
44305,2017,Junio,Paraguay,1,2,,3,-75.736374,4.815189
44306,2017,Junio,Paraguay,13,12,,25,-75.42726,6.170465
44307,2017,Junio,Paraguay,0,1,,1,-73.181317,7.1280470000000005
44308,2017,Junio,Perú,24,54,,78,-69.941498,4.191162
44309,2017,Junio,Perú,170,206,,376,-69.94143100000001,4.214082
44310,2017,Junio,Perú,24,50,,74,-74.78366,0.18595699999999998
44311,2017,Junio,Perú,5,22,,27,-77.35600000000001,0.81488
44312,2017,Junio,Perú,0,5,,5,-75.527794,10.406342
44313,2017,Junio,Perú,1022,806,,1828,-75.516486,10.446304
44314,2017,Junio,Perú,9,3,,12,-74.77647900000001,10.886686
44315,2017,Junio,Perú,293,140,,433,-81.70216500000001,12.5862
44316,2017,Junio,Perú,222,286,,508,-76.532004,3.451668
44317,2017,Junio,Perú,0,2,,2,-77.061029,3.8844260000000004
44318,2017,Junio,Perú,5437,7540,,12977,-74.140516,4.697157
44319,2017,Junio,Perú,8,6,,14,-75.736374,4.815189
44320,2017,Junio,Perú,289,466,,755,-75.42726,6.170465
44321,2017,Junio,Perú,0,1,,1,-73.181317,7.1280470000000005
44322,2017,Junio,Polonia,1,0,,1,-76.532004,3.451668
44323,2017,Junio,Polonia,6,16,,22,-74.140516,4.697157
44324,2017,Junio,Polonia,1,4,,5,-75.42726,6.170465
44325,2017,Junio,Portugal,0,1,,1,-76.532004,3.451668
44326,2017,Junio,Portugal,28,44,,72,-74.140516,4.697157
44327,2017,Junio,Portugal,7,10,,17,-75.42726,6.170465
44328,2017,Junio,Polinesia Francesa/Colectividad de Ultramar Francesa,0,1,,1,-76.532004,3.451668
44329,2017,Junio,Polinesia Francesa/Colectividad de Ultramar Francesa,0,2,,2,-74.140516,4.697157
44330,2017,Junio,Puerto Rico/Territorio de Estados Unidos,1,1,,2,-75.516486,10.446304
44331,2017,Junio,Puerto Rico/Territorio de Estados Unidos,3,17,,20,-74.77647900000001,10.886686
44332,2017,Junio,Puerto Rico/Territorio de Estados Unidos,1,1,,2,-81.70216500000001,12.5862
44333,2017,Junio,Puerto Rico/Territorio de Estados Unidos,43,66,,109,-76.532004,3.451668
44334,2017,Junio,Puerto Rico/Territorio de Estados Unidos,604,676,,1280,-74.140516,4.697157
44335,2017,Junio,Puerto Rico/Territorio de Estados Unidos,2,8,,10,-75.736374,4.815189
44336,2017,Junio,Puerto Rico/Territorio de Estados Unidos,63,122,,185,-75.42726,6.170465
44337,2017,Junio,Puerto Rico/Territorio de Estados Unidos,1,1,,2,-73.181317,7.1280470000000005
44338,2017,Junio,Qatar,1,0,,1,-76.532004,3.451668
44339,2017,Junio,Qatar,1,1,,2,-74.140516,4.697157
44340,2017,Junio,Qatar,0,2,,2,-75.42726,6.170465
44341,2017,Junio,Reino Unido de Gran Bretaña e Irlanda del Norte,0,1,,1,-75.516486,10.446304
44342,2017,Junio,Reino Unido de Gran Bretaña e Irlanda del Norte,0,1,,1,-74.77647900000001,10.886686
44343,2017,Junio,Reino Unido de Gran Bretaña e Irlanda del Norte,13,18,,31,-76.532004,3.451668
44344,2017,Junio,Reino Unido de Gran Bretaña e Irlanda del Norte,672,1067,,1739,-74.140516,4.697157
44345,2017,Junio,Reino Unido de Gran Bretaña e Irlanda del Norte,21,47,,68,-75.42726,6.170465
44346,2017,Junio,República CentroÁfricana,1,0,,1,-74.77647900000001,10.886686
44347,2017,Junio,República CentroÁfricana,1,0,,1,-76.532004,3.451668
44348,2017,Junio,República CentroÁfricana,2,2,,4,-74.140516,4.697157
44349,2017,Junio,Federación de Rusia,0,2,,2,-75.527794,10.406342
44350,2017,Junio,Federación de Rusia,1,2,,3,-75.516486,10.446304
44351,2017,Junio,Federación de Rusia,17,35,,52,-74.140516,4.697157
44352,2017,Junio,Federación de Rusia,1,2,,3,-75.42726,6.170465
44353,2017,Junio,República Dominicana,0,10,,10,-75.527794,10.406342
44354,2017,Junio,República Dominicana,10,20,,30,-75.516486,10.446304
44355,2017,Junio,República Dominicana,16,28,,44,-74.77647900000001,10.886686
44356,2017,Junio,República Dominicana,0,1,,1,-81.70216500000001,12.5862
44357,2017,Junio,República Dominicana,17,24,,41,-76.532004,3.451668
44358,2017,Junio,República Dominicana,758,1020,,1778,-74.140516,4.697157
44359,2017,Junio,República Dominicana,4,10,,14,-75.736374,4.815189
44360,2017,Junio,República Dominicana,35,61,,96,-75.42726,6.170465
44361,2017,Junio,República Dominicana,4,5,,9,-73.181317,7.1280470000000005
44362,2017,Junio,Reunión,0,1,,1,-74.140516,4.697157
44363,2017,Junio,República Democrática Popular de Corea,0,1,,1,-74.140516,4.697157
44364,2017,Junio,Rumania,0,1,,1,-76.532004,3.451668
44365,2017,Junio,Rumania,7,9,,16,-74.140516,4.697157
44366,2017,Junio,San  Vicente y las Granadinas,0,2,,2,-75.527794,10.406342
44367,2017,Junio,San  Vicente y las Granadinas,0,3,,3,-74.140516,4.697157
44368,2017,Junio,Santa Lucia,0,1,,1,-74.140516,4.697157
44369,2017,Junio,Santa Sede/Ciudad del Vaticano,1,0,,1,-74.140516,4.697157
44370,2017,Junio,Serbia,0,1,,1,-74.140516,4.697157
44371,2017,Junio,Sierra Leona,0,1,,1,-75.516486,10.446304
44372,2017,Junio,Singapur,7,8,,15,-74.140516,4.697157
44373,2017,Junio,Singapur,1,2,,3,-75.42726,6.170465
44374,2017,Junio,Sri Lanka,1,0,,1,-72.129595,11.360028999999999
44375,2017,Junio,Sudáfrica,3,5,,8,-74.140516,4.697157
44376,2017,Junio,Suecia,0,1,,1,-75.516486,10.446304
44377,2017,Junio,Suecia,1,0,,1,-74.77647900000001,10.886686
44378,2017,Junio,Suecia,6,8,,14,-76.532004,3.451668
44379,2017,Junio,Suecia,30,57,,87,-74.140516,4.697157
44380,2017,Junio,Suecia,1,0,,1,-75.736374,4.815189
44381,2017,Junio,Suecia,22,16,,38,-75.42726,6.170465
44382,2017,Junio,Suiza,1,1,,2,-75.516486,10.446304
44383,2017,Junio,Suiza,0,1,,1,-74.77647900000001,10.886686
44384,2017,Junio,Suiza,17,24,,41,-76.532004,3.451668
44385,2017,Junio,Suiza,73,84,,157,-74.140516,4.697157
44386,2017,Junio,Suiza,0,1,,1,-75.736374,4.815189
44387,2017,Junio,Suiza,10,19,,29,-75.42726,6.170465
44388,2017,Junio,Taiwán,3,3,,6,-76.532004,3.451668
44389,2017,Junio,Taiwán,3,6,,9,-74.140516,4.697157
44390,2017,Junio,Taiwán,1,0,,1,-75.42726,6.170465
44391,2017,Junio,Tailandia,6,4,,10,-74.140516,4.697157
44392,2017,Junio,Tanzania,1,1,,2,-74.140516,4.697157
44393,2017,Junio,Trinidad y Tobago,1,3,,4,-75.516486,10.446304
44394,2017,Junio,Trinidad y Tobago,3,5,,8,-76.532004,3.451668
44395,2017,Junio,Trinidad y Tobago,5,15,,20,-74.140516,4.697157
44396,2017,Junio,Trinidad y Tobago,1,2,,3,-75.736374,4.815189
44397,2017,Junio,Trinidad y Tobago,2,3,,5,-75.42726,6.170465
44398,2017,Junio,Trinidad y Tobago,1,1,,2,-73.181317,7.1280470000000005
44399,2017,Junio,Túnez,1,3,,4,-74.140516,4.697157
44400,2017,Junio,Túnez,1,0,,1,-75.42726,6.170465
44401,2017,Junio,Turkmenistán,4,3,,7,-74.140516,4.697157
44402,2017,Junio,Turquía,0,3,,3,-75.527794,10.406342
44403,2017,Junio,Turquía,265,394,,659,-74.140516,4.697157
44404,2017,Junio,Turquía,0,1,,1,-75.42726,6.170465
44405,2017,Junio,Ucrania,0,1,,1,-74.77647900000001,10.886686
44406,2017,Junio,Ucrania,0,1,,1,-76.532004,3.451668
44407,2017,Junio,Ucrania,1,0,,1,-74.140516,4.697157
44408,2017,Junio,Ucrania,0,1,,1,-75.42726,6.170465
44409,2017,Junio,Uganda,2,0,,2,-74.140516,4.697157
44410,2017,Junio,Uruguay,0,3,,3,-77.35600000000001,0.81488
44411,2017,Junio,Uruguay,7,7,,14,-75.516486,10.446304
44412,2017,Junio,Uruguay,14,7,,21,-81.70216500000001,12.5862
44413,2017,Junio,Uruguay,6,11,,17,-76.532004,3.451668
44414,2017,Junio,Uruguay,508,562,,1070,-74.140516,4.697157
44415,2017,Junio,Uruguay,11,33,,44,-75.42726,6.170465
44416,2017,Junio,Venezuela,0,10,,10,-75.527794,10.406342
44417,2017,Junio,Venezuela,7,25,,32,-75.516486,10.446304
44418,2017,Junio,Venezuela,6,46,,52,-74.77647900000001,10.886686
44419,2017,Junio,Venezuela,5009,5745,,10754,-72.129595,11.360028999999999
44420,2017,Junio,Venezuela,1,0,,1,-81.70216500000001,12.5862
44421,2017,Junio,Venezuela,8,15,,23,-76.532004,3.451668
44422,2017,Junio,Venezuela,2,12,,14,-67.927521,3.866713
44423,2017,Junio,Venezuela,3191,3644,,6835,-74.140516,4.697157
44424,2017,Junio,Venezuela,4,6,,10,-75.736374,4.815189
44425,2017,Junio,Venezuela,431,503,,934,-75.42726,6.170465
44426,2017,Junio,Venezuela,14,15,,29,-67.48402800000001,6.185536
44427,2017,Junio,Venezuela,143,181,,324,-70.74025300000001,7.088728999999999
44428,2017,Junio,Venezuela,4,6,,10,-73.181317,7.1280470000000005
44429,2017,Junio,Venezuela,9674,13026,,22700,-72.453013,7.819
44430,2017,Junio,Venezuela,245,316,,561,-72.409396,8.36068
44431,2017,Junio,Vietnam,0,1,,1,-76.532004,3.451668
44432,2017,Junio,Vietnam,2,2,,4,-74.140516,4.697157
44433,2017,Junio,Islas Vírgenes Británicas/Territorio Británico de Ultramar,0,3,,3,-74.213989,11.247722999999999
44434,2017,Julio,Afganistán,1,0,,1,-75.516486,10.446304
44435,2017,Julio,Afganistán,1,2,,3,-74.140516,4.697157
44436,2017,Julio,Albania,0,1,,1,-74.140516,4.697157
44437,2017,Julio,Alemania,3,0,,3,-77.35600000000001,0.81488
44438,2017,Julio,Alemania,4,5,,9,-75.516486,10.446304
44439,2017,Julio,Alemania,17,9,,26,-74.77647900000001,10.886686
44440,2017,Julio,Alemania,0,2,,2,-74.213989,11.247722999999999
44441,2017,Julio,Alemania,56,56,,112,-76.532004,3.451668
44442,2017,Julio,Alemania,1812,2233,,4045,-74.140516,4.697157
44443,2017,Julio,Alemania,6,9,,15,-75.736374,4.815189
44444,2017,Julio,Alemania,85,93,,178,-75.42726,6.170465
44445,2017,Julio,Alemania,2,0,,2,-73.181317,7.1280470000000005
44446,2017,Julio,Andorra,1,0,,1,-75.42726,6.170465
44447,2017,Julio,Antigua y Barbuda,1,4,,5,-75.527794,10.406342
44448,2017,Julio,Antigua y Barbuda,0,1,,1,-74.140516,4.697157
44449,2017,Julio,Antigua y Barbuda,0,1,,1,-75.42726,6.170465
44450,2017,Julio,Países Bajos,0,5,,5,-75.527794,10.406342
44451,2017,Julio,Países Bajos,205,297,,502,-75.516486,10.446304
44452,2017,Julio,Países Bajos,5,6,,11,-74.77647900000001,10.886686
44453,2017,Julio,Países Bajos,0,46,,46,-74.765343,10.970933
44454,2017,Julio,Países Bajos,5,13,,18,-74.213989,11.247722999999999
44455,2017,Julio,Países Bajos,45,63,,108,-76.532004,3.451668
44456,2017,Julio,Países Bajos,1305,1589,,2894,-74.140516,4.697157
44457,2017,Julio,Países Bajos,8,7,,15,-75.736374,4.815189
44458,2017,Julio,Países Bajos,201,242,,443,-75.42726,6.170465
44459,2017,Julio,Países Bajos,4,0,,4,-73.181317,7.1280470000000005
44460,2017,Julio,Arabia Saudita,0,1,,1,-74.213989,11.247722999999999
44461,2017,Julio,Arabia Saudita,0,3,,3,-74.140516,4.697157
44462,2017,Julio,Arabia Saudita,1,0,,1,-75.42726,6.170465
44463,2017,Julio,Argelia,1,0,,1,-75.516486,10.446304
44464,2017,Julio,Argelia,0,1,,1,-76.532004,3.451668
44465,2017,Julio,Argelia,3,2,,5,-74.140516,4.697157
44466,2017,Julio,Argentina,9,13,,22,-77.35600000000001,0.81488
44467,2017,Julio,Argentina,96,70,,166,-75.516486,10.446304
44468,2017,Julio,Argentina,3,7,,10,-74.77647900000001,10.886686
44469,2017,Julio,Argentina,170,136,,306,-81.70216500000001,12.5862
44470,2017,Julio,Argentina,30,30,,60,-76.532004,3.451668
44471,2017,Julio,Argentina,5201,5396,,10597,-74.140516,4.697157
44472,2017,Julio,Argentina,4,2,,6,-75.736374,4.815189
44473,2017,Julio,Argentina,22,62,,84,-75.42726,6.170465
44474,2017,Julio,Argentina,1,1,,2,-73.181317,7.1280470000000005
44475,2017,Julio,República de Armenia,1,0,,1,-74.140516,4.697157
44476,2017,Julio,Aruba,1,4,,5,-75.527794,10.406342
44477,2017,Julio,Aruba,3,1,,4,-74.77647900000001,10.886686
44478,2017,Julio,Aruba,7,10,,17,-74.213989,11.247722999999999
44479,2017,Julio,Aruba,1,1,,2,-81.70216500000001,12.5862
44480,2017,Julio,Aruba,1,8,,9,-75.29321,2.947286
44481,2017,Julio,Aruba,13,8,,21,-76.532004,3.451668
44482,2017,Julio,Aruba,1416,1436,,2852,-74.140516,4.697157
44483,2017,Julio,Aruba,2,2,,4,-75.736374,4.815189
44484,2017,Julio,Aruba,40,47,,87,-75.42726,6.170465
44485,2017,Julio,Aruba,11,14,,25,-73.181317,7.1280470000000005
44486,2017,Julio,Australia,1,7,,8,-75.516486,10.446304
44487,2017,Julio,Australia,1,2,,3,-74.77647900000001,10.886686
44488,2017,Julio,Australia,1,4,,5,-76.532004,3.451668
44489,2017,Julio,Australia,48,84,,132,-74.140516,4.697157
44490,2017,Julio,Australia,18,24,,42,-75.42726,6.170465
44491,2017,Julio,Australia,0,1,,1,-73.181317,7.1280470000000005
44492,2017,Julio,Austria,1,0,,1,-75.516486,10.446304
44493,2017,Julio,Austria,2,1,,3,-74.77647900000001,10.886686
44494,2017,Julio,Austria,1,4,,5,-76.532004,3.451668
44495,2017,Julio,Austria,52,50,,102,-74.140516,4.697157
44496,2017,Julio,Austria,0,1,,1,-75.736374,4.815189
44497,2017,Julio,Austria,7,10,,17,-75.42726,6.170465
44498,2017,Julio,Azerbaiyán,0,1,,1,-74.140516,4.697157
44499,2017,Julio,Bahamas,0,2,,2,-76.532004,3.451668
44500,2017,Julio,Bahamas,3,3,,6,-74.140516,4.697157
44501,2017,Julio,Bahamas,11,6,,17,-75.42726,6.170465
44502,2017,Julio,Bahamas,1,0,,1,-73.181317,7.1280470000000005
44503,2017,Julio,Bahréin,0,1,,1,-75.527794,10.406342
44504,2017,Julio,Bahréin,2,1,,3,-74.140516,4.697157
44505,2017,Julio,Barbados,102,140,,242,-74.140516,4.697157
44506,2017,Julio,República de Belarús,2,1,,3,-74.140516,4.697157
44507,2017,Julio,República de Belarús,2,0,,2,-72.453013,7.819
44508,2017,Julio,Bélgica,1,3,,4,-75.516486,10.446304
44509,2017,Julio,Bélgica,0,3,,3,-74.213989,11.247722999999999
44510,2017,Julio,Bélgica,12,21,,33,-76.532004,3.451668
44511,2017,Julio,Bélgica,88,110,,198,-74.140516,4.697157
44512,2017,Julio,Bélgica,0,4,,4,-75.736374,4.815189
44513,2017,Julio,Bélgica,20,39,,59,-75.42726,6.170465
44514,2017,Julio,Bélgica,0,1,,1,-73.181317,7.1280470000000005
44515,2017,Julio,Belice,1,1,,2,-74.77647900000001,10.886686
44516,2017,Julio,Belice,3,4,,7,-74.140516,4.697157
44517,2017,Julio,Belice,0,2,,2,-75.42726,6.170465
44518,2017,Julio,Benín,1,0,,1,-81.70216500000001,12.5862
44519,2017,Julio,Benín,0,1,,1,-76.532004,3.451668
44520,2017,Julio,Benín,0,2,,2,-74.140516,4.697157
44521,2017,Julio,Bermudas/Territorio Británico de Ultramar,0,1,,1,-74.140516,4.697157
44522,2017,Julio,Bolivia,0,1,,1,-77.35600000000001,0.81488
44523,2017,Julio,Bolivia,10,4,,14,-75.516486,10.446304
44524,2017,Julio,Bolivia,0,3,,3,-74.77647900000001,10.886686
44525,2017,Julio,Bolivia,18,18,,36,-81.70216500000001,12.5862
44526,2017,Julio,Bolivia,8,12,,20,-76.532004,3.451668
44527,2017,Julio,Bolivia,578,576,,1154,-74.140516,4.697157
44528,2017,Julio,Bolivia,2,0,,2,-75.736374,4.815189
44529,2017,Julio,Bolivia,15,29,,44,-75.42726,6.170465
44530,2017,Julio,Bosnia y Herzegovina,1,0,,1,-74.77647900000001,10.886686
44531,2017,Julio,Bosnia y Herzegovina,0,1,,1,-75.42726,6.170465
44532,2017,Julio,Brasil,227,187,,414,-69.941498,4.191162
44533,2017,Julio,Brasil,26,31,,57,-69.94143100000001,4.214082
44534,2017,Julio,Brasil,4,4,,8,-77.35600000000001,0.81488
44535,2017,Julio,Brasil,0,5,,5,-75.527794,10.406342
44536,2017,Julio,Brasil,49,39,,88,-75.516486,10.446304
44537,2017,Julio,Brasil,6,14,,20,-74.77647900000001,10.886686
44538,2017,Julio,Brasil,2,6,,8,-74.232675,11.117206
44539,2017,Julio,Brasil,3,123,,126,-74.213989,11.247722999999999
44540,2017,Julio,Brasil,220,188,,408,-81.70216500000001,12.5862
44541,2017,Julio,Brasil,21,33,,54,-76.532004,3.451668
44542,2017,Julio,Brasil,1,2,,3,-67.927521,3.866713
44543,2017,Julio,Brasil,5661,6607,,12268,-74.140516,4.697157
44544,2017,Julio,Brasil,2,2,,4,-75.736374,4.815189
44545,2017,Julio,Brasil,66,194,,260,-75.42726,6.170465
44546,2017,Julio,Brasil,3,1,,4,-73.181317,7.1280470000000005
44547,2017,Julio,Brunei Darussalam,1,0,,1,-74.140516,4.697157
44548,2017,Julio,Bulgaria,1,1,,2,-74.140516,4.697157
44549,2017,Julio,Bulgaria,0,2,,2,-75.42726,6.170465
44550,2017,Julio,Cabo Verde,0,1,,1,-76.532004,3.451668
44551,2017,Julio,Islas Caimán/Territorio Británico de Ultramar,2,1,,3,-76.532004,3.451668
44552,2017,Julio,Islas Caimán/Territorio Británico de Ultramar,1,4,,5,-74.140516,4.697157
44553,2017,Julio,Islas Caimán/Territorio Británico de Ultramar,0,3,,3,-75.42726,6.170465
44554,2017,Julio,Camboya,0,1,,1,-74.140516,4.697157
44555,2017,Julio,Camerún,0,5,,5,-74.140516,4.697157
44556,2017,Julio,Canadá,14,19,,33,-75.516486,10.446304
44557,2017,Julio,Canadá,8,17,,25,-74.77647900000001,10.886686
44558,2017,Julio,Canadá,1,0,,1,-81.70216500000001,12.5862
44559,2017,Julio,Canadá,57,41,,98,-76.532004,3.451668
44560,2017,Julio,Canadá,1,0,,1,-75.76635300000001,4.45285
44561,2017,Julio,Canadá,1002,1255,,2257,-74.140516,4.697157
44562,2017,Julio,Canadá,9,11,,20,-75.736374,4.815189
44563,2017,Julio,Canadá,103,198,,301,-75.42726,6.170465
44564,2017,Julio,Canadá,2,6,,8,-73.181317,7.1280470000000005
44565,2017,Julio,Chad,5,2,,7,-74.140516,4.697157
44566,2017,Julio,España,0,1,,1,-75.527794,10.406342
44567,2017,Julio,España,0,2,,2,-75.516486,10.446304
44568,2017,Julio,España,3,7,,10,-74.77647900000001,10.886686
44569,2017,Julio,España,0,3,,3,-74.765343,10.970933
44570,2017,Julio,España,0,7,,7,-74.213989,11.247722999999999
44571,2017,Julio,España,513,727,,1240,-76.532004,3.451668
44572,2017,Julio,España,3929,5510,,9439,-74.140516,4.697157
44573,2017,Julio,España,2,2,,4,-75.736374,4.815189
44574,2017,Julio,España,688,937,,1625,-75.42726,6.170465
44575,2017,Julio,España,4,1,,5,-73.181317,7.1280470000000005
44576,2017,Julio,República de Corea,8,21,,29,-74.140516,4.697157
44577,2017,Julio,República de Corea,4,7,,11,-75.42726,6.170465
44578,2017,Julio,Costa de Marfil,0,1,,1,-76.532004,3.451668
44579,2017,Julio,Costa de Marfil,10,2,,12,-74.140516,4.697157
44580,2017,Julio,Costa Rica,27,16,,43,-75.516486,10.446304
44581,2017,Julio,Costa Rica,3,7,,10,-74.77647900000001,10.886686
44582,2017,Julio,Costa Rica,70,46,,116,-81.70216500000001,12.5862
44583,2017,Julio,Costa Rica,22,32,,54,-76.532004,3.451668
44584,2017,Julio,Costa Rica,1695,2039,,3734,-74.140516,4.697157
44585,2017,Julio,Costa Rica,7,3,,10,-75.736374,4.815189
44586,2017,Julio,Costa Rica,113,143,,256,-75.42726,6.170465
44587,2017,Julio,Costa Rica,1,2,,3,-73.181317,7.1280470000000005
44588,2017,Julio,Croacia,3,7,,10,-74.140516,4.697157
44589,2017,Julio,Cuba,0,3,,3,-75.516486,10.446304
44590,2017,Julio,Cuba,6,12,,18,-74.77647900000001,10.886686
44591,2017,Julio,Cuba,14,10,,24,-76.532004,3.451668
44592,2017,Julio,Cuba,563,699,,1262,-74.140516,4.697157
44593,2017,Julio,Cuba,0,2,,2,-75.736374,4.815189
44594,2017,Julio,Cuba,16,18,,34,-75.42726,6.170465
44595,2017,Julio,Cuba,1,2,,3,-73.181317,7.1280470000000005
44596,2017,Julio,Curazao,4,1,,5,-74.140516,4.697157
44597,2017,Julio,República Checa,1,0,,1,-74.77647900000001,10.886686
44598,2017,Julio,República Checa,0,1,,1,-76.532004,3.451668
44599,2017,Julio,República Checa,6,7,,13,-74.140516,4.697157
44600,2017,Julio,República Checa,2,0,,2,-75.42726,6.170465
44601,2017,Julio,Chile,3,4,,7,-77.35600000000001,0.81488
44602,2017,Julio,Chile,0,5,,5,-75.527794,10.406342
44603,2017,Julio,Chile,17,12,,29,-75.516486,10.446304
44604,2017,Julio,Chile,6,2,,8,-74.77647900000001,10.886686
44605,2017,Julio,Chile,201,148,,349,-81.70216500000001,12.5862
44606,2017,Julio,Chile,18,21,,39,-76.532004,3.451668
44607,2017,Julio,Chile,5785,6340,,12125,-74.140516,4.697157
44608,2017,Julio,Chile,2,4,,6,-75.736374,4.815189
44609,2017,Julio,Chile,18,37,,55,-75.42726,6.170465
44610,2017,Julio,Chile,0,1,,1,-73.181317,7.1280470000000005
44611,2017,Julio,China,1,0,,1,-75.516486,10.446304
44612,2017,Julio,China,1,2,,3,-74.77647900000001,10.886686
44613,2017,Julio,China,2,2,,4,-76.532004,3.451668
44614,2017,Julio,China,32,69,,101,-74.140516,4.697157
44615,2017,Julio,China,0,1,,1,-75.736374,4.815189
44616,2017,Julio,China,1,11,,12,-75.42726,6.170465
44617,2017,Julio,China,1,0,,1,-73.181317,7.1280470000000005
44618,2017,Julio,Chipre,0,1,,1,-76.532004,3.451668
44619,2017,Julio,Chipre,1,2,,3,-74.140516,4.697157
44620,2017,Julio,Dinamarca,1,1,,2,-75.516486,10.446304
44621,2017,Julio,Dinamarca,0,2,,2,-74.77647900000001,10.886686
44622,2017,Julio,Dinamarca,2,0,,2,-81.70216500000001,12.5862
44623,2017,Julio,Dinamarca,0,1,,1,-76.532004,3.451668
44624,2017,Julio,Dinamarca,21,21,,42,-74.140516,4.697157
44625,2017,Julio,Dinamarca,2,5,,7,-75.736374,4.815189
44626,2017,Julio,Dinamarca,4,8,,12,-75.42726,6.170465
44627,2017,Julio,Ecuador,0,2,,2,-74.78366,0.18595699999999998
44628,2017,Julio,Ecuador,171,501,,672,-76.876446,0.33002
44629,2017,Julio,Ecuador,4,2,,6,-77.84700600000001,0.8124359999999999
44630,2017,Julio,Ecuador,4752,6231,,10983,-77.35600000000001,0.81488
44631,2017,Julio,Ecuador,32,108,,140,-78.802679,18.00143
44632,2017,Julio,Ecuador,0,1,,1,-75.527794,10.406342
44633,2017,Julio,Ecuador,168,79,,247,-75.516486,10.446304
44634,2017,Julio,Ecuador,1,2,,3,-74.77647900000001,10.886686
44635,2017,Julio,Ecuador,0,5,,5,-74.765343,10.970933
44636,2017,Julio,Ecuador,19,21,,40,-81.70216500000001,12.5862
44637,2017,Julio,Ecuador,433,506,,939,-76.532004,3.451668
44638,2017,Julio,Ecuador,3850,5201,,9051,-74.140516,4.697157
44639,2017,Julio,Ecuador,17,26,,43,-75.42726,6.170465
44640,2017,Julio,Ecuador,1,2,,3,-73.181317,7.1280470000000005
44641,2017,Julio,Ecuador,0,2,,2,-72.453013,7.819
44642,2017,Julio,Egipto,1,0,,1,-76.532004,3.451668
44643,2017,Julio,Egipto,6,10,,16,-74.140516,4.697157
44644,2017,Julio,Egipto,0,1,,1,-75.42726,6.170465
44645,2017,Julio,El Salvador,2,2,,4,-75.516486,10.446304
44646,2017,Julio,El Salvador,1,2,,3,-74.77647900000001,10.886686
44647,2017,Julio,El Salvador,5,4,,9,-81.70216500000001,12.5862
44648,2017,Julio,El Salvador,112,160,,272,-76.532004,3.451668
44649,2017,Julio,El Salvador,949,1287,,2236,-74.140516,4.697157
44650,2017,Julio,El Salvador,1,1,,2,-75.736374,4.815189
44651,2017,Julio,El Salvador,192,304,,496,-75.42726,6.170465
44652,2017,Julio,Emiratos Árabes,2,1,,3,-76.532004,3.451668
44653,2017,Julio,Emiratos Árabes,5,11,,16,-74.140516,4.697157
44654,2017,Julio,Emiratos Árabes,2,3,,5,-75.42726,6.170465
44655,2017,Julio,Eslovaquia,3,1,,4,-76.532004,3.451668
44656,2017,Julio,Eslovaquia,1,1,,2,-74.140516,4.697157
44657,2017,Julio,Eslovenia,0,1,,1,-74.77647900000001,10.886686
44658,2017,Julio,Eslovenia,1,5,,6,-74.140516,4.697157
44659,2017,Julio,Eslovenia,0,1,,1,-75.42726,6.170465
44660,2017,Julio,Estados Unidos de América,0,24,,24,-75.527794,10.406342
44661,2017,Julio,Estados Unidos de América,3480,4446,,7926,-75.516486,10.446304
44662,2017,Julio,Estados Unidos de América,877,1274,,2151,-74.77647900000001,10.886686
44663,2017,Julio,Estados Unidos de América,0,2,,2,-74.765343,10.970933
44664,2017,Julio,Estados Unidos de América,0,13,,13,-74.213989,11.247722999999999
44665,2017,Julio,Estados Unidos de América,59,64,,123,-81.70216500000001,12.5862
44666,2017,Julio,Estados Unidos de América,1609,1983,,3592,-76.532004,3.451668
44667,2017,Julio,Estados Unidos de América,0,1,,1,-77.061029,3.8844260000000004
44668,2017,Julio,Estados Unidos de América,264,315,,579,-75.76635300000001,4.45285
44669,2017,Julio,Estados Unidos de América,12977,18986,,31963,-74.140516,4.697157
44670,2017,Julio,Estados Unidos de América,285,341,,626,-75.736374,4.815189
44671,2017,Julio,Estados Unidos de América,4011,6817,,10828,-75.42726,6.170465
44672,2017,Julio,Estados Unidos de América,59,74,,133,-73.181317,7.1280470000000005
44673,2017,Julio,Estados Unidos de América,0,12,,12,-75.68164200000001,9.402597
44674,2017,Julio,Estonia,1,0,,1,-75.516486,10.446304
44675,2017,Julio,Estonia,0,1,,1,-74.77647900000001,10.886686
44676,2017,Julio,Estonia,2,2,,4,-74.140516,4.697157
44677,2017,Julio,Estonia,1,0,,1,-75.42726,6.170465
44678,2017,Julio,Etiopia,0,1,,1,-74.140516,4.697157
44679,2017,Julio,Filipinas,0,1,,1,-76.532004,3.451668
44680,2017,Julio,Filipinas,4,8,,12,-74.140516,4.697157
44681,2017,Julio,Filipinas,1,0,,1,-75.42726,6.170465
44682,2017,Julio,Finlandia,0,1,,1,-74.77647900000001,10.886686
44683,2017,Julio,Finlandia,1,0,,1,-76.532004,3.451668
44684,2017,Julio,Finlandia,6,5,,11,-74.140516,4.697157
44685,2017,Julio,Finlandia,1,6,,7,-75.42726,6.170465
44686,2017,Julio,Francia,0,1,,1,-75.527794,10.406342
44687,2017,Julio,Francia,11,3,,14,-75.516486,10.446304
44688,2017,Julio,Francia,5,8,,13,-74.77647900000001,10.886686
44689,2017,Julio,Francia,75,106,,181,-76.532004,3.451668
44690,2017,Julio,Francia,1913,2642,,4555,-74.140516,4.697157
44691,2017,Julio,Francia,10,17,,27,-75.736374,4.815189
44692,2017,Julio,Francia,91,144,,235,-75.42726,6.170465
44693,2017,Julio,Francia,2,5,,7,-73.181317,7.1280470000000005
44694,2017,Julio,Georgia,0,1,,1,-74.77647900000001,10.886686
44695,2017,Julio,Gibraltar/Territorio Británico de Ultramar,0,2,,2,-77.35600000000001,0.81488
44696,2017,Julio,Grecia,0,1,,1,-74.77647900000001,10.886686
44697,2017,Julio,Grecia,2,5,,7,-74.140516,4.697157
44698,2017,Julio,Grecia,0,1,,1,-75.42726,6.170465
44699,2017,Julio,Guatemala,3,1,,4,-75.516486,10.446304
44700,2017,Julio,Guatemala,4,12,,16,-74.77647900000001,10.886686
44701,2017,Julio,Guatemala,1,1,,2,-81.70216500000001,12.5862
44702,2017,Julio,Guatemala,11,31,,42,-76.532004,3.451668
44703,2017,Julio,Guatemala,367,679,,1046,-74.140516,4.697157
44704,2017,Julio,Guatemala,5,9,,14,-75.736374,4.815189
44705,2017,Julio,Guatemala,61,113,,174,-75.42726,6.170465
44706,2017,Julio,Guatemala,3,2,,5,-73.181317,7.1280470000000005
44707,2017,Julio,Guyana,1,1,,2,-74.140516,4.697157
44708,2017,Julio,Guinea,1,0,,1,-77.35600000000001,0.81488
44709,2017,Julio,Guinea Ecuatorial,0,1,,1,-74.140516,4.697157
44710,2017,Julio,Guadalupe/Territorio Francés,0,1,,1,-74.77647900000001,10.886686
44711,2017,Julio,Guadalupe/Territorio Francés,1,0,,1,-76.532004,3.451668
44712,2017,Julio,Guam/Territorio no incorporado de Estados Unidos,1,0,,1,-74.140516,4.697157
44713,2017,Julio,Guayana Francesa/Departamento de Ultramar Francés,0,1,,1,-74.140516,4.697157
44714,2017,Julio,Guayana Francesa/Departamento de Ultramar Francés,0,1,,1,-75.42726,6.170465
44715,2017,Julio,Haití,0,3,,3,-74.213989,11.247722999999999
44716,2017,Julio,Haití,8,25,,33,-74.140516,4.697157
44717,2017,Julio,Haití,1,0,,1,-75.736374,4.815189
44718,2017,Julio,Haití,3,4,,7,-75.42726,6.170465
44719,2017,Julio,Honduras,0,7,,7,-75.527794,10.406342
44720,2017,Julio,Honduras,3,2,,5,-75.516486,10.446304
44721,2017,Julio,Honduras,3,4,,7,-74.77647900000001,10.886686
44722,2017,Julio,Honduras,0,1,,1,-74.765343,10.970933
44723,2017,Julio,Honduras,0,11,,11,-81.703935,12.574411099999999
44724,2017,Julio,Honduras,1,0,,1,-81.70216500000001,12.5862
44725,2017,Julio,Honduras,1,1,,2,-81.372937,13.338761300000002
44726,2017,Julio,Honduras,10,28,,38,-76.532004,3.451668
44727,2017,Julio,Honduras,63,90,,153,-74.140516,4.697157
44728,2017,Julio,Honduras,0,2,,2,-75.736374,4.815189
44729,2017,Julio,Honduras,38,84,,122,-75.42726,6.170465
44730,2017,Julio,Hong Kong,1,0,,1,-76.532004,3.451668
44731,2017,Julio,Hong Kong,1,2,,3,-74.140516,4.697157
44732,2017,Julio,Hungría,1,0,,1,-74.77647900000001,10.886686
44733,2017,Julio,Hungría,1,0,,1,-76.532004,3.451668
44734,2017,Julio,Hungría,3,11,,14,-74.140516,4.697157
44735,2017,Julio,Hungría,0,1,,1,-75.42726,6.170465
44736,2017,Julio,India,0,5,,5,-75.516486,10.446304
44737,2017,Julio,India,0,1,,1,-74.77647900000001,10.886686
44738,2017,Julio,India,0,1,,1,-76.532004,3.451668
44739,2017,Julio,India,0,1,,1,-77.061029,3.8844260000000004
44740,2017,Julio,India,11,30,,41,-74.140516,4.697157
44741,2017,Julio,India,0,6,,6,-75.42726,6.170465
44742,2017,Julio,Indonesia,1,7,,8,-74.140516,4.697157
44743,2017,Julio,Irán,3,1,,4,-74.140516,4.697157
44744,2017,Julio,Irán,1,1,,2,-75.736374,4.815189
44745,2017,Julio,República de Irlanda,0,1,,1,-75.516486,10.446304
44746,2017,Julio,República de Irlanda,1,2,,3,-81.70216500000001,12.5862
44747,2017,Julio,República de Irlanda,1,1,,2,-76.532004,3.451668
44748,2017,Julio,República de Irlanda,14,17,,31,-74.140516,4.697157
44749,2017,Julio,República de Irlanda,4,6,,10,-75.42726,6.170465
44750,2017,Julio,Islandia,3,3,,6,-74.140516,4.697157
44751,2017,Julio,Islandia,2,2,,4,-75.42726,6.170465
44752,2017,Julio,Israel,1,2,,3,-76.532004,3.451668
44753,2017,Julio,Israel,21,46,,67,-74.140516,4.697157
44754,2017,Julio,Israel,4,12,,16,-75.42726,6.170465
44755,2017,Julio,Italia,0,3,,3,-75.527794,10.406342
44756,2017,Julio,Italia,1,2,,3,-75.516486,10.446304
44757,2017,Julio,Italia,3,5,,8,-74.77647900000001,10.886686
44758,2017,Julio,Italia,2,1,,3,-81.70216500000001,12.5862
44759,2017,Julio,Italia,14,32,,46,-76.532004,3.451668
44760,2017,Julio,Italia,138,236,,374,-74.140516,4.697157
44761,2017,Julio,Italia,2,1,,3,-75.736374,4.815189
44762,2017,Julio,Italia,27,55,,82,-75.42726,6.170465
44763,2017,Julio,Jamaica,0,2,,2,-75.527794,10.406342
44764,2017,Julio,Jamaica,1,8,,9,-75.516486,10.446304
44765,2017,Julio,Jamaica,1,1,,2,-74.77647900000001,10.886686
44766,2017,Julio,Jamaica,0,1,,1,-74.213989,11.247722999999999
44767,2017,Julio,Jamaica,0,1,,1,-81.70216500000001,12.5862
44768,2017,Julio,Jamaica,4,7,,11,-81.372937,13.338761300000002
44769,2017,Julio,Jamaica,0,2,,2,-76.532004,3.451668
44770,2017,Julio,Jamaica,7,3,,10,-74.140516,4.697157
44771,2017,Julio,Jamaica,2,0,,2,-75.42726,6.170465
44772,2017,Julio,Jamaica,0,2,,2,-75.586989,6.2188349999999994
44773,2017,Julio,Japón,1,2,,3,-74.77647900000001,10.886686
44774,2017,Julio,Japón,1,0,,1,-76.532004,3.451668
44775,2017,Julio,Japón,12,23,,35,-74.140516,4.697157
44776,2017,Julio,Japón,0,1,,1,-75.736374,4.815189
44777,2017,Julio,Japón,9,5,,14,-75.42726,6.170465
44778,2017,Julio,Kenia,3,3,,6,-74.140516,4.697157
44779,2017,Julio,Kenia,0,1,,1,-75.42726,6.170465
44780,2017,Julio,República de Kosovo,0,1,,1,-74.140516,4.697157
44781,2017,Julio,República Democrática Popular  Lao,1,0,,1,-74.140516,4.697157
44782,2017,Julio,Lesoto,0,1,,1,-74.140516,4.697157
44783,2017,Julio,Letonia,1,1,,2,-74.140516,4.697157
44784,2017,Julio,Lituania,2,1,,3,-74.140516,4.697157
44785,2017,Julio,Líbano,3,4,,7,-74.140516,4.697157
44786,2017,Julio,Liechtenstein,1,1,,2,-74.140516,4.697157
44787,2017,Julio,Luxemburgo,3,2,,5,-74.140516,4.697157
44788,2017,Julio,Macao,0,1,,1,-74.140516,4.697157
44789,2017,Julio,Madagascar,1,0,,1,-74.140516,4.697157
44790,2017,Julio,Malasia,0,5,,5,-74.140516,4.697157
44791,2017,Julio,Maldivas,0,1,,1,-74.140516,4.697157
44792,2017,Julio,Malta,2,1,,3,-74.77647900000001,10.886686
44793,2017,Julio,Malta,2,3,,5,-74.140516,4.697157
44794,2017,Julio,Malta,0,1,,1,-75.42726,6.170465
44795,2017,Julio,Marruecos,1,2,,3,-74.140516,4.697157
44796,2017,Julio,Martinica/Departamento de Ultramar Francés,1,2,,3,-74.213989,11.247722999999999
44797,2017,Julio,Martinica/Departamento de Ultramar Francés,0,1,,1,-73.181317,7.1280470000000005
44798,2017,Julio,México,0,14,,14,-75.527794,10.406342
44799,2017,Julio,México,24,37,,61,-75.516486,10.446304
44800,2017,Julio,México,30,46,,76,-74.77647900000001,10.886686
44801,2017,Julio,México,0,3,,3,-74.765343,10.970933
44802,2017,Julio,México,0,2,,2,-74.232675,11.117206
44803,2017,Julio,México,2,5,,7,-81.70216500000001,12.5862
44804,2017,Julio,México,92,138,,230,-76.532004,3.451668
44805,2017,Julio,México,7387,10497,,17884,-74.140516,4.697157
44806,2017,Julio,México,17,12,,29,-75.736374,4.815189
44807,2017,Julio,México,741,1390,,2131,-75.42726,6.170465
44808,2017,Julio,México,20,19,,39,-73.181317,7.1280470000000005
44809,2017,Julio,Mongolia,1,0,,1,-74.140516,4.697157
44810,2017,Julio,Montenegro,1,0,,1,-75.42726,6.170465
44811,2017,Julio,Mozambique,1,1,,2,-74.140516,4.697157
44812,2017,Julio,Myanmar,2,0,,2,-74.140516,4.697157
44813,2017,Julio,Nicaragua,2,2,,4,-74.77647900000001,10.886686
44814,2017,Julio,Nicaragua,15,35,,50,-76.532004,3.451668
44815,2017,Julio,Nicaragua,36,57,,93,-74.140516,4.697157
44816,2017,Julio,Nicaragua,1,0,,1,-75.736374,4.815189
44817,2017,Julio,Nicaragua,19,35,,54,-75.42726,6.170465
44818,2017,Julio,Nicaragua,2,1,,3,-73.181317,7.1280470000000005
44819,2017,Julio,Nigeria,0,1,,1,-74.140516,4.697157
44820,2017,Julio,Noruega,1,1,,2,-75.516486,10.446304
44821,2017,Julio,Noruega,2,2,,4,-74.77647900000001,10.886686
44822,2017,Julio,Noruega,5,3,,8,-76.532004,3.451668
44823,2017,Julio,Noruega,43,33,,76,-74.140516,4.697157
44824,2017,Julio,Noruega,10,12,,22,-75.42726,6.170465
44825,2017,Julio,Nueva Zelanda,3,0,,3,-75.516486,10.446304
44826,2017,Julio,Nueva Zelanda,2,1,,3,-76.532004,3.451668
44827,2017,Julio,Nueva Zelanda,8,12,,20,-74.140516,4.697157
44828,2017,Julio,Nueva Zelanda,2,1,,3,-75.42726,6.170465
44829,2017,Julio,Pakistán,0,1,,1,-74.140516,4.697157
44830,2017,Julio,Panamá,1032,897,,1929,-75.527794,10.406342
44831,2017,Julio,Panamá,3682,3857,,7539,-75.516486,10.446304
44832,2017,Julio,Panamá,475,677,,1152,-74.77647900000001,10.886686
44833,2017,Julio,Panamá,0,12,,12,-74.765343,10.970933
44834,2017,Julio,Panamá,0,6,,6,-81.703935,12.574411099999999
44835,2017,Julio,Panamá,175,193,,368,-81.70216500000001,12.5862
44836,2017,Julio,Panamá,439,594,,1033,-76.532004,3.451668
44837,2017,Julio,Panamá,0,7,,7,-77.061029,3.8844260000000004
44838,2017,Julio,Panamá,0,1,,1,-74.642361,4.253669
44839,2017,Julio,Panamá,27,52,,79,-75.76635300000001,4.45285
44840,2017,Julio,Panamá,4449,6086,,10535,-74.140516,4.697157
44841,2017,Julio,Panamá,55,93,,148,-75.736374,4.815189
44842,2017,Julio,Panamá,1984,2709,,4693,-75.42726,6.170465
44843,2017,Julio,Panamá,2,1,,3,-77.762647,7.102626
44844,2017,Julio,Panamá,11,20,,31,-73.181317,7.1280470000000005
44845,2017,Julio,Panamá,1,1,,2,-72.508188,7.927233
44846,2017,Julio,Panamá,125,151,,276,-77.35002,8.63337
44847,2017,Julio,Paraguay,7,1,,8,-75.516486,10.446304
44848,2017,Julio,Paraguay,2,5,,7,-74.77647900000001,10.886686
44849,2017,Julio,Paraguay,49,35,,84,-81.70216500000001,12.5862
44850,2017,Julio,Paraguay,7,11,,18,-76.532004,3.451668
44851,2017,Julio,Paraguay,62,62,,124,-74.140516,4.697157
44852,2017,Julio,Paraguay,1,0,,1,-75.736374,4.815189
44853,2017,Julio,Paraguay,4,11,,15,-75.42726,6.170465
44854,2017,Julio,Paraguay,2,0,,2,-73.181317,7.1280470000000005
44855,2017,Julio,Perú,109,150,,259,-69.941498,4.191162
44856,2017,Julio,Perú,158,204,,362,-69.94143100000001,4.214082
44857,2017,Julio,Perú,1,1,,2,-74.78366,0.18595699999999998
44858,2017,Julio,Perú,7,21,,28,-77.35600000000001,0.81488
44859,2017,Julio,Perú,1245,998,,2243,-75.516486,10.446304
44860,2017,Julio,Perú,3,2,,5,-74.77647900000001,10.886686
44861,2017,Julio,Perú,280,158,,438,-81.70216500000001,12.5862
44862,2017,Julio,Perú,219,245,,464,-76.532004,3.451668
44863,2017,Julio,Perú,7919,9056,,16975,-74.140516,4.697157
44864,2017,Julio,Perú,2,5,,7,-75.736374,4.815189
44865,2017,Julio,Perú,211,285,,496,-75.42726,6.170465
44866,2017,Julio,Polonia,0,2,,2,-75.516486,10.446304
44867,2017,Julio,Polonia,0,1,,1,-74.77647900000001,10.886686
44868,2017,Julio,Polonia,0,1,,1,-74.213989,11.247722999999999
44869,2017,Julio,Polonia,1,0,,1,-76.532004,3.451668
44870,2017,Julio,Polonia,14,10,,24,-74.140516,4.697157
44871,2017,Julio,Polonia,1,5,,6,-75.42726,6.170465
44872,2017,Julio,Portugal,1,1,,2,-75.516486,10.446304
44873,2017,Julio,Portugal,5,13,,18,-76.532004,3.451668
44874,2017,Julio,Portugal,18,41,,59,-74.140516,4.697157
44875,2017,Julio,Portugal,0,1,,1,-75.736374,4.815189
44876,2017,Julio,Portugal,3,17,,20,-75.42726,6.170465
44877,2017,Julio,Puerto Rico/Territorio de Estados Unidos,0,13,,13,-75.527794,10.406342
44878,2017,Julio,Puerto Rico/Territorio de Estados Unidos,1,3,,4,-75.516486,10.446304
44879,2017,Julio,Puerto Rico/Territorio de Estados Unidos,5,16,,21,-74.77647900000001,10.886686
44880,2017,Julio,Puerto Rico/Territorio de Estados Unidos,5,2,,7,-81.70216500000001,12.5862
44881,2017,Julio,Puerto Rico/Territorio de Estados Unidos,46,46,,92,-76.532004,3.451668
44882,2017,Julio,Puerto Rico/Territorio de Estados Unidos,771,791,,1562,-74.140516,4.697157
44883,2017,Julio,Puerto Rico/Territorio de Estados Unidos,7,8,,15,-75.736374,4.815189
44884,2017,Julio,Puerto Rico/Territorio de Estados Unidos,164,240,,404,-75.42726,6.170465
44885,2017,Julio,Puerto Rico/Territorio de Estados Unidos,2,2,,4,-73.181317,7.1280470000000005
44886,2017,Julio,Reino Unido de Gran Bretaña e Irlanda del Norte,5,6,,11,-75.516486,10.446304
44887,2017,Julio,Reino Unido de Gran Bretaña e Irlanda del Norte,2,2,,4,-74.77647900000001,10.886686
44888,2017,Julio,Reino Unido de Gran Bretaña e Irlanda del Norte,35,41,,76,-76.532004,3.451668
44889,2017,Julio,Reino Unido de Gran Bretaña e Irlanda del Norte,864,1146,,2010,-74.140516,4.697157
44890,2017,Julio,Reino Unido de Gran Bretaña e Irlanda del Norte,1,0,,1,-75.736374,4.815189
44891,2017,Julio,Reino Unido de Gran Bretaña e Irlanda del Norte,39,56,,95,-75.42726,6.170465
44892,2017,Julio,Reino Unido de Gran Bretaña e Irlanda del Norte,2,1,,3,-73.181317,7.1280470000000005
44893,2017,Julio,República CentroÁfricana,3,2,,5,-74.140516,4.697157
44894,2017,Julio,Federación de Rusia,0,5,,5,-75.527794,10.406342
44895,2017,Julio,Federación de Rusia,1,0,,1,-74.77647900000001,10.886686
44896,2017,Julio,Federación de Rusia,0,1,,1,-74.213989,11.247722999999999
44897,2017,Julio,Federación de Rusia,0,2,,2,-76.532004,3.451668
44898,2017,Julio,Federación de Rusia,11,19,,30,-74.140516,4.697157
44899,2017,Julio,Federación de Rusia,2,1,,3,-75.42726,6.170465
44900,2017,Julio,República Dominicana,1,13,,14,-75.527794,10.406342
44901,2017,Julio,República Dominicana,2,6,,8,-75.516486,10.446304
44902,2017,Julio,República Dominicana,6,38,,44,-74.77647900000001,10.886686
44903,2017,Julio,República Dominicana,1,3,,4,-74.232675,11.117206
44904,2017,Julio,República Dominicana,0,1,,1,-81.70216500000001,12.5862
44905,2017,Julio,República Dominicana,9,31,,40,-76.532004,3.451668
44906,2017,Julio,República Dominicana,868,1201,,2069,-74.140516,4.697157
44907,2017,Julio,República Dominicana,9,9,,18,-75.736374,4.815189
44908,2017,Julio,República Dominicana,41,54,,95,-75.42726,6.170465
44909,2017,Julio,República Dominicana,3,2,,5,-73.181317,7.1280470000000005
44910,2017,Julio,Reunión,1,0,,1,-74.140516,4.697157
44911,2017,Julio,República Democrática Popular de Corea,0,1,,1,-74.140516,4.697157
44912,2017,Julio,Rumania,0,2,,2,-75.516486,10.446304
44913,2017,Julio,Rumania,1,3,,4,-76.532004,3.451668
44914,2017,Julio,Rumania,4,1,,5,-74.140516,4.697157
44915,2017,Julio,Rumania,0,3,,3,-75.42726,6.170465
44916,2017,Julio,San Cristóbal y Nevis,0,1,,1,-75.42726,6.170465
44917,2017,Julio,San Marino,1,1,,2,-74.140516,4.697157
44918,2017,Julio,San  Vicente y las Granadinas,0,3,,3,-74.140516,4.697157
44919,2017,Julio,San  Vicente y las Granadinas,2,0,,2,-75.42726,6.170465
44920,2017,Julio,Santa Lucia,3,7,,10,-75.527794,10.406342
44921,2017,Julio,Santa Lucia,1,0,,1,-75.42726,6.170465
44922,2017,Julio,Serbia,1,0,,1,-74.77647900000001,10.886686
44923,2017,Julio,Serbia,1,0,,1,-74.140516,4.697157
44924,2017,Julio,Serbia,1,1,,2,-75.42726,6.170465
44925,2017,Julio,Singapur,5,8,,13,-74.140516,4.697157
44926,2017,Julio,Singapur,1,0,,1,-75.42726,6.170465
44927,2017,Julio,República Árabe Siria,1,0,,1,-74.140516,4.697157
44928,2017,Julio,Sri Lanka,0,1,,1,-74.140516,4.697157
44929,2017,Julio,Sudáfrica,0,1,,1,-75.516486,10.446304
44930,2017,Julio,Sudáfrica,9,7,,16,-74.140516,4.697157
44931,2017,Julio,Sudáfrica,1,1,,2,-75.42726,6.170465
44932,2017,Julio,Suecia,1,1,,2,-75.516486,10.446304
44933,2017,Julio,Suecia,2,4,,6,-74.77647900000001,10.886686
44934,2017,Julio,Suecia,5,7,,12,-76.532004,3.451668
44935,2017,Julio,Suecia,21,23,,44,-74.140516,4.697157
44936,2017,Julio,Suecia,2,3,,5,-75.736374,4.815189
44937,2017,Julio,Suecia,4,9,,13,-75.42726,6.170465
44938,2017,Julio,Suiza,1,0,,1,-75.516486,10.446304
44939,2017,Julio,Suiza,1,0,,1,-74.77647900000001,10.886686
44940,2017,Julio,Suiza,1,1,,2,-81.70216500000001,12.5862
44941,2017,Julio,Suiza,29,31,,60,-76.532004,3.451668
44942,2017,Julio,Suiza,191,207,,398,-74.140516,4.697157
44943,2017,Julio,Suiza,8,4,,12,-75.736374,4.815189
44944,2017,Julio,Suiza,27,34,,61,-75.42726,6.170465
44945,2017,Julio,Surinam,1,1,,2,-74.140516,4.697157
44946,2017,Julio,Surinam,0,2,,2,-75.42726,6.170465
44947,2017,Julio,Taiwán,0,1,,1,-76.532004,3.451668
44948,2017,Julio,Taiwán,1,6,,7,-74.140516,4.697157
44949,2017,Julio,Taiwán,2,0,,2,-75.42726,6.170465
44950,2017,Julio,República de Tayikistán,1,0,,1,-76.532004,3.451668
44951,2017,Julio,Tailandia,3,1,,4,-74.140516,4.697157
44952,2017,Julio,Tailandia,2,0,,2,-75.42726,6.170465
44953,2017,Julio,Tanzania,0,1,,1,-74.140516,4.697157
44954,2017,Julio,Trinidad y Tobago,0,3,,3,-75.527794,10.406342
44955,2017,Julio,Trinidad y Tobago,2,1,,3,-75.516486,10.446304
44956,2017,Julio,Trinidad y Tobago,0,1,,1,-74.77647900000001,10.886686
44957,2017,Julio,Trinidad y Tobago,0,1,,1,-74.213989,11.247722999999999
44958,2017,Julio,Trinidad y Tobago,5,6,,11,-76.532004,3.451668
44959,2017,Julio,Trinidad y Tobago,7,8,,15,-74.140516,4.697157
44960,2017,Julio,Trinidad y Tobago,3,4,,7,-75.736374,4.815189
44961,2017,Julio,Trinidad y Tobago,7,2,,9,-75.42726,6.170465
44962,2017,Julio,Trinidad y Tobago,1,7,,8,-73.181317,7.1280470000000005
44963,2017,Julio,Túnez,0,1,,1,-74.77647900000001,10.886686
44964,2017,Julio,Turkmenistán,1,7,,8,-74.140516,4.697157
44965,2017,Julio,Turquía,0,1,,1,-74.77647900000001,10.886686
44966,2017,Julio,Turquía,0,5,,5,-76.532004,3.451668
44967,2017,Julio,Turquía,439,557,,996,-74.140516,4.697157
44968,2017,Julio,Ucrania,0,2,,2,-76.532004,3.451668
44969,2017,Julio,Ucrania,2,2,,4,-74.140516,4.697157
44970,2017,Julio,Ucrania,0,1,,1,-75.42726,6.170465
44971,2017,Julio,Uganda,0,2,,2,-75.42726,6.170465
44972,2017,Julio,Uruguay,6,6,,12,-75.516486,10.446304
44973,2017,Julio,Uruguay,1,1,,2,-74.77647900000001,10.886686
44974,2017,Julio,Uruguay,36,33,,69,-81.70216500000001,12.5862
44975,2017,Julio,Uruguay,7,9,,16,-76.532004,3.451668
44976,2017,Julio,Uruguay,449,429,,878,-74.140516,4.697157
44977,2017,Julio,Uruguay,1,1,,2,-75.736374,4.815189
44978,2017,Julio,Uruguay,19,17,,36,-75.42726,6.170465
44979,2017,Julio,Venezuela,0,5,,5,-75.527794,10.406342
44980,2017,Julio,Venezuela,3,19,,22,-75.516486,10.446304
44981,2017,Julio,Venezuela,17,47,,64,-74.77647900000001,10.886686
44982,2017,Julio,Venezuela,0,1,,1,-74.765343,10.970933
44983,2017,Julio,Venezuela,7076,7243,,14319,-72.129595,11.360028999999999
44984,2017,Julio,Venezuela,1,1,,2,-81.70216500000001,12.5862
44985,2017,Julio,Venezuela,25,34,,59,-76.532004,3.451668
44986,2017,Julio,Venezuela,12,18,,30,-67.927521,3.866713
44987,2017,Julio,Venezuela,4785,4542,,9327,-74.140516,4.697157
44988,2017,Julio,Venezuela,3,3,,6,-75.736374,4.815189
44989,2017,Julio,Venezuela,713,715,,1428,-75.42726,6.170465
44990,2017,Julio,Venezuela,17,16,,33,-67.48402800000001,6.185536
44991,2017,Julio,Venezuela,179,175,,354,-70.74025300000001,7.088728999999999
44992,2017,Julio,Venezuela,19406,22408,,41814,-72.453013,7.819
44993,2017,Julio,Venezuela,3,5,,8,-72.508188,7.927233
44994,2017,Julio,Venezuela,0,4,,4,-76.7333,8.06667
44995,2017,Julio,Venezuela,854,811,,1665,-72.409396,8.36068
44996,2017,Julio,Vietnam,1,1,,2,-74.140516,4.697157
44997,2017,Julio,Islas Vírgenes Británicas/Territorio Británico de Ultramar,1,1,,2,-75.42726,6.170465
44998,2017,Julio,Zambia,0,1,,1,-75.42726,6.170465
44999,2017,Julio,Zimbabue,0,1,,1,-74.77647900000001,10.886686
45000,2017,Julio,Islas Turcas y Caicos/Territorio Británico de Ultramar,2,3,,5,-74.140516,4.697157
45001,2017,Agosto,Afganistán,2,2,,4,-74.140516,4.697157
45002,2017,Agosto,Alemania,1,0,,1,-77.35600000000001,0.81488
45003,2017,Agosto,Alemania,6,5,,11,-75.516486,10.446304
45004,2017,Agosto,Alemania,6,8,,14,-74.77647900000001,10.886686
45005,2017,Agosto,Alemania,1,1,,2,-81.70216500000001,12.5862
45006,2017,Agosto,Alemania,33,23,,56,-76.532004,3.451668
45007,2017,Agosto,Alemania,0,2,,2,-77.061029,3.8844260000000004
45008,2017,Agosto,Alemania,1834,2432,,4266,-74.140516,4.697157
45009,2017,Agosto,Alemania,5,5,,10,-75.736374,4.815189
45010,2017,Agosto,Alemania,54,65,,119,-75.42726,6.170465
45011,2017,Agosto,Andorra,2,1,,3,-75.42726,6.170465
45012,2017,Agosto,Andorra,0,1,,1,-75.68164200000001,9.402597
45013,2017,Agosto,Angola,0,11,,11,-75.68164200000001,9.402597
45014,2017,Agosto,Antigua y Barbuda,1,3,,4,-74.140516,4.697157
45015,2017,Agosto,Países Bajos,0,16,,16,-75.527794,10.406342
45016,2017,Agosto,Países Bajos,151,299,,450,-75.516486,10.446304
45017,2017,Agosto,Países Bajos,11,5,,16,-74.77647900000001,10.886686
45018,2017,Agosto,Países Bajos,0,12,,12,-74.765343,10.970933
45019,2017,Agosto,Países Bajos,22,33,,55,-76.532004,3.451668
45020,2017,Agosto,Países Bajos,1127,1477,,2604,-74.140516,4.697157
45021,2017,Agosto,Países Bajos,6,6,,12,-75.736374,4.815189
45022,2017,Agosto,Países Bajos,87,105,,192,-75.42726,6.170465
45023,2017,Agosto,Países Bajos,6,5,,11,-73.181317,7.1280470000000005
45024,2017,Agosto,Arabia Saudita,0,2,,2,-74.140516,4.697157
45025,2017,Agosto,Argelia,5,8,,13,-74.140516,4.697157
45026,2017,Agosto,Argentina,6,8,,14,-77.35600000000001,0.81488
45027,2017,Agosto,Argentina,81,60,,141,-75.516486,10.446304
45028,2017,Agosto,Argentina,5,5,,10,-74.77647900000001,10.886686
45029,2017,Agosto,Argentina,218,196,,414,-81.70216500000001,12.5862
45030,2017,Agosto,Argentina,33,32,,65,-76.532004,3.451668
45031,2017,Agosto,Argentina,3832,4628,,8460,-74.140516,4.697157
45032,2017,Agosto,Argentina,6,6,,12,-75.736374,4.815189
45033,2017,Agosto,Argentina,29,69,,98,-75.42726,6.170465
45034,2017,Agosto,Argentina,1,3,,4,-73.181317,7.1280470000000005
45035,2017,Agosto,República de Armenia,2,0,,2,-74.140516,4.697157
45036,2017,Agosto,Aruba,71,57,,128,-75.527794,10.406342
45037,2017,Agosto,Aruba,8,60,,68,-74.213989,11.247722999999999
45038,2017,Agosto,Aruba,11,6,,17,-76.532004,3.451668
45039,2017,Agosto,Aruba,1022,1155,,2177,-74.140516,4.697157
45040,2017,Agosto,Aruba,1,3,,4,-75.736374,4.815189
45041,2017,Agosto,Aruba,4,7,,11,-75.42726,6.170465
45042,2017,Agosto,Aruba,19,13,,32,-73.181317,7.1280470000000005
45043,2017,Agosto,Australia,0,1,,1,-74.77647900000001,10.886686
45044,2017,Agosto,Australia,2,1,,3,-81.70216500000001,12.5862
45045,2017,Agosto,Australia,3,4,,7,-76.532004,3.451668
45046,2017,Agosto,Australia,51,69,,120,-74.140516,4.697157
45047,2017,Agosto,Australia,2,1,,3,-75.736374,4.815189
45048,2017,Agosto,Australia,7,19,,26,-75.42726,6.170465
45049,2017,Agosto,Australia,0,1,,1,-73.181317,7.1280470000000005
45050,2017,Agosto,Austria,3,1,,4,-76.532004,3.451668
45051,2017,Agosto,Austria,29,29,,58,-74.140516,4.697157
45052,2017,Agosto,Austria,0,1,,1,-75.736374,4.815189
45053,2017,Agosto,Austria,5,9,,14,-75.42726,6.170465
45054,2017,Agosto,Bahamas,0,4,,4,-75.516486,10.446304
45055,2017,Agosto,Bahamas,3,1,,4,-76.532004,3.451668
45056,2017,Agosto,Bahamas,0,2,,2,-74.140516,4.697157
45057,2017,Agosto,Bahamas,0,1,,1,-75.736374,4.815189
45058,2017,Agosto,Bahamas,0,1,,1,-73.181317,7.1280470000000005
45059,2017,Agosto,Bahréin,1,0,,1,-75.516486,10.446304
45060,2017,Agosto,Bahréin,2,0,,2,-72.129595,11.360028999999999
45061,2017,Agosto,Bahréin,0,1,,1,-76.532004,3.451668
45062,2017,Agosto,Bahréin,0,1,,1,-74.140516,4.697157
45063,2017,Agosto,Barbados,5,5,,10,-74.140516,4.697157
45064,2017,Agosto,República de Belarús,1,1,,2,-72.129595,11.360028999999999
45065,2017,Agosto,República de Belarús,0,2,,2,-74.140516,4.697157
45066,2017,Agosto,República de Belarús,9,6,,15,-72.453013,7.819
45067,2017,Agosto,Bélgica,0,2,,2,-74.213989,11.247722999999999
45068,2017,Agosto,Bélgica,1,0,,1,-81.70216500000001,12.5862
45069,2017,Agosto,Bélgica,8,8,,16,-76.532004,3.451668
45070,2017,Agosto,Bélgica,72,68,,140,-74.140516,4.697157
45071,2017,Agosto,Bélgica,2,1,,3,-75.736374,4.815189
45072,2017,Agosto,Bélgica,5,12,,17,-75.42726,6.170465
45073,2017,Agosto,Belice,0,1,,1,-76.532004,3.451668
45074,2017,Agosto,Belice,2,2,,4,-74.140516,4.697157
45075,2017,Agosto,Belice,0,2,,2,-75.42726,6.170465
45076,2017,Agosto,Bermudas/Territorio Británico de Ultramar,2,4,,6,-76.532004,3.451668
45077,2017,Agosto,Bolivia,0,1,,1,-77.35600000000001,0.81488
45078,2017,Agosto,Bolivia,6,8,,14,-75.516486,10.446304
45079,2017,Agosto,Bolivia,0,1,,1,-74.77647900000001,10.886686
45080,2017,Agosto,Bolivia,14,13,,27,-81.70216500000001,12.5862
45081,2017,Agosto,Bolivia,4,11,,15,-76.532004,3.451668
45082,2017,Agosto,Bolivia,550,633,,1183,-74.140516,4.697157
45083,2017,Agosto,Bolivia,14,29,,43,-75.42726,6.170465
45084,2017,Agosto,Brasil,211,235,,446,-69.941498,4.191162
45085,2017,Agosto,Brasil,1,0,,1,-69.94143100000001,4.214082
45086,2017,Agosto,Brasil,2,0,,2,-77.35600000000001,0.81488
45087,2017,Agosto,Brasil,0,3,,3,-75.527794,10.406342
45088,2017,Agosto,Brasil,68,42,,110,-75.516486,10.446304
45089,2017,Agosto,Brasil,1,7,,8,-74.77647900000001,10.886686
45090,2017,Agosto,Brasil,0,5,,5,-74.213989,11.247722999999999
45091,2017,Agosto,Brasil,389,332,,721,-81.70216500000001,12.5862
45092,2017,Agosto,Brasil,25,27,,52,-76.532004,3.451668
45093,2017,Agosto,Brasil,0,3,,3,-67.927521,3.866713
45094,2017,Agosto,Brasil,5401,6771,,12172,-74.140516,4.697157
45095,2017,Agosto,Brasil,3,2,,5,-75.736374,4.815189
45096,2017,Agosto,Brasil,61,98,,159,-75.42726,6.170465
45097,2017,Agosto,Brunei Darussalam,0,1,,1,-74.140516,4.697157
45098,2017,Agosto,Bulgaria,1,3,,4,-74.140516,4.697157
45099,2017,Agosto,Bulgaria,1,1,,2,-75.42726,6.170465
45100,2017,Agosto,Cabo Verde,0,1,,1,-74.140516,4.697157
45101,2017,Agosto,Islas Caimán/Territorio Británico de Ultramar,1,2,,3,-81.70216500000001,12.5862
45102,2017,Agosto,Camboya,0,1,,1,-76.532004,3.451668
45103,2017,Agosto,Camerún,0,1,,1,-74.140516,4.697157
45104,2017,Agosto,Canadá,14,25,,39,-75.516486,10.446304
45105,2017,Agosto,Canadá,11,12,,23,-74.77647900000001,10.886686
45106,2017,Agosto,Canadá,2,4,,6,-81.70216500000001,12.5862
45107,2017,Agosto,Canadá,40,46,,86,-76.532004,3.451668
45108,2017,Agosto,Canadá,862,1211,,2073,-74.140516,4.697157
45109,2017,Agosto,Canadá,9,8,,17,-75.736374,4.815189
45110,2017,Agosto,Canadá,95,148,,243,-75.42726,6.170465
45111,2017,Agosto,Canadá,0,1,,1,-73.181317,7.1280470000000005
45112,2017,Agosto,España,1,4,,5,-75.516486,10.446304
45113,2017,Agosto,España,6,10,,16,-74.77647900000001,10.886686
45114,2017,Agosto,España,4,7,,11,-81.70216500000001,12.5862
45115,2017,Agosto,España,548,672,,1220,-76.532004,3.451668
45116,2017,Agosto,España,4815,6378,,11193,-74.140516,4.697157
45117,2017,Agosto,España,7,10,,17,-75.736374,4.815189
45118,2017,Agosto,España,743,1092,,1835,-75.42726,6.170465
45119,2017,Agosto,España,0,1,,1,-73.181317,7.1280470000000005
45120,2017,Agosto,República de Corea,8,16,,24,-74.140516,4.697157
45121,2017,Agosto,República de Corea,0,3,,3,-75.736374,4.815189
45122,2017,Agosto,República de Corea,7,4,,11,-75.42726,6.170465
45123,2017,Agosto,Costa de Marfil,4,8,,12,-74.140516,4.697157
45124,2017,Agosto,Costa Rica,2,4,,6,-75.527794,10.406342
45125,2017,Agosto,Costa Rica,8,9,,17,-75.516486,10.446304
45126,2017,Agosto,Costa Rica,6,9,,15,-74.77647900000001,10.886686
45127,2017,Agosto,Costa Rica,0,1,,1,-74.213989,11.247722999999999
45128,2017,Agosto,Costa Rica,0,2,,2,-81.703935,12.574411099999999
45129,2017,Agosto,Costa Rica,58,39,,97,-81.70216500000001,12.5862
45130,2017,Agosto,Costa Rica,2,1,,3,-81.372937,13.338761300000002
45131,2017,Agosto,Costa Rica,14,33,,47,-76.532004,3.451668
45132,2017,Agosto,Costa Rica,1456,2073,,3529,-74.140516,4.697157
45133,2017,Agosto,Costa Rica,2,2,,4,-75.736374,4.815189
45134,2017,Agosto,Costa Rica,70,131,,201,-75.42726,6.170465
45135,2017,Agosto,Costa Rica,3,3,,6,-73.181317,7.1280470000000005
45136,2017,Agosto,Croacia,1,0,,1,-76.532004,3.451668
45137,2017,Agosto,Croacia,0,2,,2,-74.140516,4.697157
45138,2017,Agosto,Croacia,0,1,,1,-75.42726,6.170465
45139,2017,Agosto,Cuba,4,1,,5,-75.527794,10.406342
45140,2017,Agosto,Cuba,3,3,,6,-75.516486,10.446304
45141,2017,Agosto,Cuba,10,25,,35,-74.77647900000001,10.886686
45142,2017,Agosto,Cuba,4,1,,5,-81.70216500000001,12.5862
45143,2017,Agosto,Cuba,13,21,,34,-76.532004,3.451668
45144,2017,Agosto,Cuba,469,761,,1230,-74.140516,4.697157
45145,2017,Agosto,Cuba,4,2,,6,-75.736374,4.815189
45146,2017,Agosto,Cuba,11,12,,23,-75.42726,6.170465
45147,2017,Agosto,Cuba,2,5,,7,-73.181317,7.1280470000000005
45148,2017,Agosto,Curazao,3,3,,6,-74.140516,4.697157
45149,2017,Agosto,República Checa,7,6,,13,-74.140516,4.697157
45150,2017,Agosto,Chile,1,1,,2,-77.35600000000001,0.81488
45151,2017,Agosto,Chile,23,30,,53,-75.516486,10.446304
45152,2017,Agosto,Chile,1,3,,4,-74.77647900000001,10.886686
45153,2017,Agosto,Chile,187,121,,308,-81.70216500000001,12.5862
45154,2017,Agosto,Chile,7,13,,20,-76.532004,3.451668
45155,2017,Agosto,Chile,5552,6723,,12275,-74.140516,4.697157
45156,2017,Agosto,Chile,3,4,,7,-75.736374,4.815189
45157,2017,Agosto,Chile,12,33,,45,-75.42726,6.170465
45158,2017,Agosto,Chile,1,0,,1,-73.181317,7.1280470000000005
45159,2017,Agosto,China,0,1,,1,-75.516486,10.446304
45160,2017,Agosto,China,0,1,,1,-74.77647900000001,10.886686
45161,2017,Agosto,China,0,2,,2,-76.532004,3.451668
45162,2017,Agosto,China,28,79,,107,-74.140516,4.697157
45163,2017,Agosto,China,0,2,,2,-75.736374,4.815189
45164,2017,Agosto,China,4,3,,7,-75.42726,6.170465
45165,2017,Agosto,Chipre,1,0,,1,-74.140516,4.697157
45166,2017,Agosto,Dinamarca,0,1,,1,-76.532004,3.451668
45167,2017,Agosto,Dinamarca,14,23,,37,-74.140516,4.697157
45168,2017,Agosto,Dinamarca,0,1,,1,-75.736374,4.815189
45169,2017,Agosto,Dinamarca,1,3,,4,-75.42726,6.170465
45170,2017,Agosto,Dominica,0,1,,1,-75.516486,10.446304
45171,2017,Agosto,Ecuador,2,0,,2,-74.78366,0.18595699999999998
45172,2017,Agosto,Ecuador,186,472,,658,-76.876446,0.33002
45173,2017,Agosto,Ecuador,7,9,,16,-77.84700600000001,0.8124359999999999
45174,2017,Agosto,Ecuador,5947,7187,,13134,-77.35600000000001,0.81488
45175,2017,Agosto,Ecuador,33,176,,209,-78.802679,18.00143
45176,2017,Agosto,Ecuador,0,1,,1,-75.527794,10.406342
45177,2017,Agosto,Ecuador,442,304,,746,-75.516486,10.446304
45178,2017,Agosto,Ecuador,1,9,,10,-74.77647900000001,10.886686
45179,2017,Agosto,Ecuador,0,5,,5,-74.232675,11.117206
45180,2017,Agosto,Ecuador,19,13,,32,-81.70216500000001,12.5862
45181,2017,Agosto,Ecuador,682,912,,1594,-76.532004,3.451668
45182,2017,Agosto,Ecuador,0,3,,3,-77.061029,3.8844260000000004
45183,2017,Agosto,Ecuador,4110,5101,,9211,-74.140516,4.697157
45184,2017,Agosto,Ecuador,2,1,,3,-75.736374,4.815189
45185,2017,Agosto,Ecuador,10,25,,35,-75.42726,6.170465
45186,2017,Agosto,Ecuador,2,1,,3,-73.181317,7.1280470000000005
45187,2017,Agosto,Ecuador,0,1,,1,-72.453013,7.819
45188,2017,Agosto,Egipto,4,5,,9,-74.140516,4.697157
45189,2017,Agosto,El Salvador,6,4,,10,-75.516486,10.446304
45190,2017,Agosto,El Salvador,0,3,,3,-74.77647900000001,10.886686
45191,2017,Agosto,El Salvador,6,4,,10,-81.70216500000001,12.5862
45192,2017,Agosto,El Salvador,121,166,,287,-76.532004,3.451668
45193,2017,Agosto,El Salvador,960,1240,,2200,-74.140516,4.697157
45194,2017,Agosto,El Salvador,0,1,,1,-75.736374,4.815189
45195,2017,Agosto,El Salvador,201,408,,609,-75.42726,6.170465
45196,2017,Agosto,Emiratos Árabes,1,1,,2,-76.532004,3.451668
45197,2017,Agosto,Emiratos Árabes,0,5,,5,-74.140516,4.697157
45198,2017,Agosto,Eslovaquia,0,2,,2,-76.532004,3.451668
45199,2017,Agosto,Eslovaquia,1,2,,3,-74.140516,4.697157
45200,2017,Agosto,Eslovenia,0,1,,1,-75.516486,10.446304
45201,2017,Agosto,Eslovenia,1,3,,4,-74.140516,4.697157
45202,2017,Agosto,Eslovenia,0,4,,4,-75.42726,6.170465
45203,2017,Agosto,Estados Unidos de América,0,5,,5,-78.802679,18.00143
45204,2017,Agosto,Estados Unidos de América,5,48,,53,-75.527794,10.406342
45205,2017,Agosto,Estados Unidos de América,3168,4771,,7939,-75.516486,10.446304
45206,2017,Agosto,Estados Unidos de América,713,1106,,1819,-74.77647900000001,10.886686
45207,2017,Agosto,Estados Unidos de América,0,14,,14,-74.765343,10.970933
45208,2017,Agosto,Estados Unidos de América,0,12,,12,-74.213989,11.247722999999999
45209,2017,Agosto,Estados Unidos de América,40,49,,89,-81.70216500000001,12.5862
45210,2017,Agosto,Estados Unidos de América,1356,1760,,3116,-76.532004,3.451668
45211,2017,Agosto,Estados Unidos de América,0,4,,4,-77.061029,3.8844260000000004
45212,2017,Agosto,Estados Unidos de América,248,309,,557,-75.76635300000001,4.45285
45213,2017,Agosto,Estados Unidos de América,11098,17822,,28920,-74.140516,4.697157
45214,2017,Agosto,Estados Unidos de América,179,243,,422,-75.736374,4.815189
45215,2017,Agosto,Estados Unidos de América,3153,6738,,9891,-75.42726,6.170465
45216,2017,Agosto,Estados Unidos de América,36,62,,98,-73.181317,7.1280470000000005
45217,2017,Agosto,Estados Unidos de América,0,14,,14,-75.68164200000001,9.402597
45218,2017,Agosto,Estonia,1,1,,2,-75.42726,6.170465
45219,2017,Agosto,Etiopia,0,1,,1,-74.140516,4.697157
45220,2017,Agosto,Filipinas,0,4,,4,-75.516486,10.446304
45221,2017,Agosto,Filipinas,0,5,,5,-74.77647900000001,10.886686
45222,2017,Agosto,Filipinas,0,3,,3,-76.532004,3.451668
45223,2017,Agosto,Filipinas,4,6,,10,-74.140516,4.697157
45224,2017,Agosto,Finlandia,3,2,,5,-76.532004,3.451668
45225,2017,Agosto,Finlandia,6,7,,13,-74.140516,4.697157
45226,2017,Agosto,Finlandia,1,2,,3,-75.42726,6.170465
45227,2017,Agosto,Francia,2,4,,6,-75.516486,10.446304
45228,2017,Agosto,Francia,9,13,,22,-74.77647900000001,10.886686
45229,2017,Agosto,Francia,35,58,,93,-76.532004,3.451668
45230,2017,Agosto,Francia,1979,2794,,4773,-74.140516,4.697157
45231,2017,Agosto,Francia,10,6,,16,-75.736374,4.815189
45232,2017,Agosto,Francia,50,88,,138,-75.42726,6.170465
45233,2017,Agosto,Francia,1,5,,6,-73.181317,7.1280470000000005
45234,2017,Agosto,Gambia,0,1,,1,-74.140516,4.697157
45235,2017,Agosto,Georgia,0,1,,1,-74.140516,4.697157
45236,2017,Agosto,Gibraltar/Territorio Británico de Ultramar,1,1,,2,-77.35600000000001,0.81488
45237,2017,Agosto,Granada,0,1,,1,-74.140516,4.697157
45238,2017,Agosto,Grecia,2,6,,8,-74.140516,4.697157
45239,2017,Agosto,Guatemala,10,14,,24,-75.516486,10.446304
45240,2017,Agosto,Guatemala,2,4,,6,-74.77647900000001,10.886686
45241,2017,Agosto,Guatemala,14,45,,59,-76.532004,3.451668
45242,2017,Agosto,Guatemala,355,670,,1025,-74.140516,4.697157
45243,2017,Agosto,Guatemala,6,6,,12,-75.736374,4.815189
45244,2017,Agosto,Guatemala,42,116,,158,-75.42726,6.170465
45245,2017,Agosto,Guatemala,4,2,,6,-73.181317,7.1280470000000005
45246,2017,Agosto,Guyana,0,1,,1,-74.77647900000001,10.886686
45247,2017,Agosto,Guyana,1,2,,3,-74.140516,4.697157
45248,2017,Agosto,Guyana,3,1,,4,-75.42726,6.170465
45249,2017,Agosto,Guadalupe/Territorio Francés,1,2,,3,-74.140516,4.697157
45250,2017,Agosto,Guayana Francesa/Departamento de Ultramar Francés,1,1,,2,-76.532004,3.451668
45251,2017,Agosto,Guayana Francesa/Departamento de Ultramar Francés,0,1,,1,-74.140516,4.697157
45252,2017,Agosto,Haití,4,3,,7,-74.140516,4.697157
45253,2017,Agosto,Haití,0,1,,1,-75.42726,6.170465
45254,2017,Agosto,Honduras,5,15,,20,-75.516486,10.446304
45255,2017,Agosto,Honduras,0,3,,3,-74.77647900000001,10.886686
45256,2017,Agosto,Honduras,0,69,,69,-81.703935,12.574411099999999
45257,2017,Agosto,Honduras,0,2,,2,-81.70216500000001,12.5862
45258,2017,Agosto,Honduras,18,21,,39,-76.532004,3.451668
45259,2017,Agosto,Honduras,66,100,,166,-74.140516,4.697157
45260,2017,Agosto,Honduras,0,2,,2,-75.736374,4.815189
45261,2017,Agosto,Honduras,30,37,,67,-75.42726,6.170465
45262,2017,Agosto,Honduras,1,0,,1,-73.181317,7.1280470000000005
45263,2017,Agosto,Hong Kong,3,6,,9,-74.140516,4.697157
45264,2017,Agosto,Hungría,1,3,,4,-74.140516,4.697157
45265,2017,Agosto,Hungría,0,2,,2,-75.42726,6.170465
45266,2017,Agosto,India,2,2,,4,-74.77647900000001,10.886686
45267,2017,Agosto,India,0,2,,2,-76.532004,3.451668
45268,2017,Agosto,India,12,44,,56,-74.140516,4.697157
45269,2017,Agosto,India,0,1,,1,-75.42726,6.170465
45270,2017,Agosto,Indonesia,1,1,,2,-74.140516,4.697157
45271,2017,Agosto,Indonesia,1,0,,1,-75.42726,6.170465
45272,2017,Agosto,Iraq,0,1,,1,-74.140516,4.697157
45273,2017,Agosto,Irán,1,0,,1,-74.140516,4.697157
45274,2017,Agosto,República de Irlanda,0,1,,1,-76.532004,3.451668
45275,2017,Agosto,República de Irlanda,9,15,,24,-74.140516,4.697157
45276,2017,Agosto,República de Irlanda,1,12,,13,-75.42726,6.170465
45277,2017,Agosto,Islandia,0,1,,1,-74.140516,4.697157
45278,2017,Agosto,Israel,0,3,,3,-75.516486,10.446304
45279,2017,Agosto,Israel,0,2,,2,-74.77647900000001,10.886686
45280,2017,Agosto,Israel,1,3,,4,-76.532004,3.451668
45281,2017,Agosto,Israel,42,77,,119,-74.140516,4.697157
45282,2017,Agosto,Israel,3,8,,11,-75.42726,6.170465
45283,2017,Agosto,Italia,3,20,,23,-75.516486,10.446304
45284,2017,Agosto,Italia,2,1,,3,-74.77647900000001,10.886686
45285,2017,Agosto,Italia,0,6,,6,-74.765343,10.970933
45286,2017,Agosto,Italia,1,3,,4,-81.70216500000001,12.5862
45287,2017,Agosto,Italia,9,24,,33,-76.532004,3.451668
45288,2017,Agosto,Italia,268,421,,689,-74.140516,4.697157
45289,2017,Agosto,Italia,1,2,,3,-75.736374,4.815189
45290,2017,Agosto,Italia,34,72,,106,-75.42726,6.170465
45291,2017,Agosto,Jamaica,1,4,,5,-75.527794,10.406342
45292,2017,Agosto,Jamaica,1,9,,10,-74.77647900000001,10.886686
45293,2017,Agosto,Jamaica,0,8,,8,-81.70216500000001,12.5862
45294,2017,Agosto,Jamaica,0,2,,2,-81.372937,13.338761300000002
45295,2017,Agosto,Jamaica,1,0,,1,-76.532004,3.451668
45296,2017,Agosto,Jamaica,4,7,,11,-74.140516,4.697157
45297,2017,Agosto,Jamaica,1,4,,5,-75.42726,6.170465
45298,2017,Agosto,Jamaica,3,0,,3,-73.181317,7.1280470000000005
45299,2017,Agosto,Japón,0,1,,1,-74.77647900000001,10.886686
45300,2017,Agosto,Japón,0,1,,1,-76.532004,3.451668
45301,2017,Agosto,Japón,22,40,,62,-74.140516,4.697157
45302,2017,Agosto,Japón,0,1,,1,-75.736374,4.815189
45303,2017,Agosto,Japón,0,4,,4,-75.42726,6.170465
45304,2017,Agosto,Kenia,2,3,,5,-76.532004,3.451668
45305,2017,Agosto,Kenia,3,1,,4,-74.140516,4.697157
45306,2017,Agosto,Kuwait,0,1,,1,-76.532004,3.451668
45307,2017,Agosto,Lituania,2,1,,3,-74.140516,4.697157
45308,2017,Agosto,Líbano,7,8,,15,-74.140516,4.697157
45309,2017,Agosto,Liechtenstein,2,0,,2,-74.140516,4.697157
45310,2017,Agosto,Luxemburgo,3,3,,6,-74.140516,4.697157
45311,2017,Agosto,Luxemburgo,1,1,,2,-75.42726,6.170465
45312,2017,Agosto,Malasia,3,1,,4,-74.140516,4.697157
45313,2017,Agosto,Malasia,1,0,,1,-75.42726,6.170465
45314,2017,Agosto,Malta,4,1,,5,-74.140516,4.697157
45315,2017,Agosto,Marruecos,0,1,,1,-75.527794,10.406342
45316,2017,Agosto,México,0,4,,4,-75.527794,10.406342
45317,2017,Agosto,México,14,40,,54,-75.516486,10.446304
45318,2017,Agosto,México,18,30,,48,-74.77647900000001,10.886686
45319,2017,Agosto,México,3,4,,7,-81.70216500000001,12.5862
45320,2017,Agosto,México,65,121,,186,-76.532004,3.451668
45321,2017,Agosto,México,6325,9901,,16226,-74.140516,4.697157
45322,2017,Agosto,México,39,65,,104,-75.736374,4.815189
45323,2017,Agosto,México,706,1516,,2222,-75.42726,6.170465
45324,2017,Agosto,México,4,13,,17,-73.181317,7.1280470000000005
45325,2017,Agosto,México,0,3,,3,-75.68164200000001,9.402597
45326,2017,Agosto,Mónaco,1,0,,1,-74.140516,4.697157
45327,2017,Agosto,Mongolia,1,0,,1,-74.140516,4.697157
45328,2017,Agosto,Montenegro,1,0,,1,-74.140516,4.697157
45329,2017,Agosto,Nepal,0,1,,1,-76.532004,3.451668
45330,2017,Agosto,Nepal,1,0,,1,-74.140516,4.697157
45331,2017,Agosto,Nicaragua,0,2,,2,-75.527794,10.406342
45332,2017,Agosto,Nicaragua,1,0,,1,-74.77647900000001,10.886686
45333,2017,Agosto,Nicaragua,1,1,,2,-81.70216500000001,12.5862
45334,2017,Agosto,Nicaragua,17,21,,38,-76.532004,3.451668
45335,2017,Agosto,Nicaragua,26,58,,84,-74.140516,4.697157
45336,2017,Agosto,Nicaragua,1,4,,5,-75.736374,4.815189
45337,2017,Agosto,Nicaragua,6,22,,28,-75.42726,6.170465
45338,2017,Agosto,Nigeria,0,2,,2,-74.140516,4.697157
45339,2017,Agosto,Níger,1,0,,1,-74.140516,4.697157
45340,2017,Agosto,Noruega,0,1,,1,-75.516486,10.446304
45341,2017,Agosto,Noruega,1,0,,1,-74.77647900000001,10.886686
45342,2017,Agosto,Noruega,2,3,,5,-76.532004,3.451668
45343,2017,Agosto,Noruega,12,11,,23,-74.140516,4.697157
45344,2017,Agosto,Noruega,0,1,,1,-75.736374,4.815189
45345,2017,Agosto,Noruega,1,2,,3,-75.42726,6.170465
45346,2017,Agosto,Nueva Zelanda,1,1,,2,-75.516486,10.446304
45347,2017,Agosto,Nueva Zelanda,1,1,,2,-76.532004,3.451668
45348,2017,Agosto,Nueva Zelanda,4,3,,7,-74.140516,4.697157
45349,2017,Agosto,Nueva Zelanda,1,3,,4,-75.42726,6.170465
45350,2017,Agosto,Panamá,1002,891,,1893,-75.527794,10.406342
45351,2017,Agosto,Panamá,3888,4053,,7941,-75.516486,10.446304
45352,2017,Agosto,Panamá,322,668,,990,-74.77647900000001,10.886686
45353,2017,Agosto,Panamá,1,109,,110,-74.765343,10.970933
45354,2017,Agosto,Panamá,1,4,,5,-74.213989,11.247722999999999
45355,2017,Agosto,Panamá,1,2,,3,-81.703935,12.574411099999999
45356,2017,Agosto,Panamá,94,105,,199,-81.70216500000001,12.5862
45357,2017,Agosto,Panamá,5,7,,12,-81.372937,13.338761300000002
45358,2017,Agosto,Panamá,414,663,,1077,-76.532004,3.451668
45359,2017,Agosto,Panamá,1,26,,27,-77.061029,3.8844260000000004
45360,2017,Agosto,Panamá,30,52,,82,-75.76635300000001,4.45285
45361,2017,Agosto,Panamá,4275,6116,,10391,-74.140516,4.697157
45362,2017,Agosto,Panamá,41,103,,144,-75.736374,4.815189
45363,2017,Agosto,Panamá,2257,3281,,5538,-75.42726,6.170465
45364,2017,Agosto,Panamá,0,1,,1,-77.401154,6.222551999999999
45365,2017,Agosto,Panamá,5,15,,20,-77.762647,7.102626
45366,2017,Agosto,Panamá,11,25,,36,-73.181317,7.1280470000000005
45367,2017,Agosto,Panamá,129,154,,283,-77.35002,8.63337
45368,2017,Agosto,Panamá,0,7,,7,-75.68164200000001,9.402597
45369,2017,Agosto,Paraguay,8,3,,11,-75.516486,10.446304
45370,2017,Agosto,Paraguay,3,2,,5,-74.77647900000001,10.886686
45371,2017,Agosto,Paraguay,104,67,,171,-81.70216500000001,12.5862
45372,2017,Agosto,Paraguay,2,5,,7,-76.532004,3.451668
45373,2017,Agosto,Paraguay,59,77,,136,-74.140516,4.697157
45374,2017,Agosto,Paraguay,1,1,,2,-75.736374,4.815189
45375,2017,Agosto,Paraguay,10,20,,30,-75.42726,6.170465
45376,2017,Agosto,Perú,149,189,,338,-69.941498,4.191162
45377,2017,Agosto,Perú,8,6,,14,-69.94143100000001,4.214082
45378,2017,Agosto,Perú,14,16,,30,-77.35600000000001,0.81488
45379,2017,Agosto,Perú,1210,892,,2102,-75.516486,10.446304
45380,2017,Agosto,Perú,1,8,,9,-74.77647900000001,10.886686
45381,2017,Agosto,Perú,277,168,,445,-81.70216500000001,12.5862
45382,2017,Agosto,Perú,204,285,,489,-76.532004,3.451668
45383,2017,Agosto,Perú,0,6,,6,-77.061029,3.8844260000000004
45384,2017,Agosto,Perú,7283,8905,,16188,-74.140516,4.697157
45385,2017,Agosto,Perú,8,9,,17,-75.736374,4.815189
45386,2017,Agosto,Perú,325,574,,899,-75.42726,6.170465
45387,2017,Agosto,Perú,1,1,,2,-73.181317,7.1280470000000005
45388,2017,Agosto,Polonia,1,0,,1,-74.77647900000001,10.886686
45389,2017,Agosto,Polonia,14,16,,30,-74.140516,4.697157
45390,2017,Agosto,Polonia,1,2,,3,-75.42726,6.170465
45391,2017,Agosto,Portugal,2,3,,5,-75.516486,10.446304
45392,2017,Agosto,Portugal,0,1,,1,-74.77647900000001,10.886686
45393,2017,Agosto,Portugal,0,1,,1,-81.70216500000001,12.5862
45394,2017,Agosto,Portugal,3,11,,14,-76.532004,3.451668
45395,2017,Agosto,Portugal,54,51,,105,-74.140516,4.697157
45396,2017,Agosto,Portugal,12,15,,27,-75.42726,6.170465
45397,2017,Agosto,Puerto Rico/Territorio de Estados Unidos,1,13,,14,-75.527794,10.406342
45398,2017,Agosto,Puerto Rico/Territorio de Estados Unidos,2,11,,13,-75.516486,10.446304
45399,2017,Agosto,Puerto Rico/Territorio de Estados Unidos,10,35,,45,-74.77647900000001,10.886686
45400,2017,Agosto,Puerto Rico/Territorio de Estados Unidos,31,69,,100,-76.532004,3.451668
45401,2017,Agosto,Puerto Rico/Territorio de Estados Unidos,561,852,,1413,-74.140516,4.697157
45402,2017,Agosto,Puerto Rico/Territorio de Estados Unidos,1,15,,16,-75.736374,4.815189
45403,2017,Agosto,Puerto Rico/Territorio de Estados Unidos,78,198,,276,-75.42726,6.170465
45404,2017,Agosto,Puerto Rico/Territorio de Estados Unidos,1,1,,2,-73.181317,7.1280470000000005
45405,2017,Agosto,Reino Unido de Gran Bretaña e Irlanda del Norte,2,3,,5,-75.516486,10.446304
45406,2017,Agosto,Reino Unido de Gran Bretaña e Irlanda del Norte,2,4,,6,-74.77647900000001,10.886686
45407,2017,Agosto,Reino Unido de Gran Bretaña e Irlanda del Norte,13,14,,27,-76.532004,3.451668
45408,2017,Agosto,Reino Unido de Gran Bretaña e Irlanda del Norte,826,1169,,1995,-74.140516,4.697157
45409,2017,Agosto,Reino Unido de Gran Bretaña e Irlanda del Norte,0,2,,2,-75.736374,4.815189
45410,2017,Agosto,Reino Unido de Gran Bretaña e Irlanda del Norte,26,44,,70,-75.42726,6.170465
45411,2017,Agosto,República CentroÁfricana,2,2,,4,-74.140516,4.697157
45412,2017,Agosto,República CentroÁfricana,0,1,,1,-75.42726,6.170465
45413,2017,Agosto,Federación de Rusia,0,5,,5,-75.527794,10.406342
45414,2017,Agosto,Federación de Rusia,22,29,,51,-74.140516,4.697157
45415,2017,Agosto,Federación de Rusia,0,3,,3,-75.42726,6.170465
45416,2017,Agosto,República Dominicana,0,17,,17,-75.527794,10.406342
45417,2017,Agosto,República Dominicana,3,23,,26,-75.516486,10.446304
45418,2017,Agosto,República Dominicana,6,24,,30,-74.77647900000001,10.886686
45419,2017,Agosto,República Dominicana,0,4,,4,-74.765343,10.970933
45420,2017,Agosto,República Dominicana,0,1,,1,-74.213989,11.247722999999999
45421,2017,Agosto,República Dominicana,1,0,,1,-81.70216500000001,12.5862
45422,2017,Agosto,República Dominicana,14,21,,35,-76.532004,3.451668
45423,2017,Agosto,República Dominicana,1081,1420,,2501,-74.140516,4.697157
45424,2017,Agosto,República Dominicana,9,5,,14,-75.736374,4.815189
45425,2017,Agosto,República Dominicana,48,91,,139,-75.42726,6.170465
45426,2017,Agosto,República Dominicana,1,5,,6,-73.181317,7.1280470000000005
45427,2017,Agosto,República Democrática Popular de Corea,0,1,,1,-74.140516,4.697157
45428,2017,Agosto,Rumania,0,2,,2,-76.532004,3.451668
45429,2017,Agosto,Rumania,3,5,,8,-74.140516,4.697157
45430,2017,Agosto,Rumania,0,1,,1,-75.42726,6.170465
45431,2017,Agosto,Rwanda,0,1,,1,-76.532004,3.451668
45432,2017,Agosto,San  Vicente y las Granadinas,1,0,,1,-74.140516,4.697157
45433,2017,Agosto,Santa Lucia,1,1,,2,-74.140516,4.697157
45434,2017,Agosto,Santa Sede/Ciudad del Vaticano,0,1,,1,-75.42726,6.170465
45435,2017,Agosto,Santo Tomé y Príncipe,0,1,,1,-74.140516,4.697157
45436,2017,Agosto,Islas Svalbard,0,1,,1,-72.508188,7.927233
45437,2017,Agosto,Singapur,1,4,,5,-74.140516,4.697157
45438,2017,Agosto,Sudáfrica,0,1,,1,-78.802679,18.00143
45439,2017,Agosto,Sudáfrica,4,5,,9,-74.140516,4.697157
45440,2017,Agosto,Suecia,7,5,,12,-76.532004,3.451668
45441,2017,Agosto,Suecia,13,22,,35,-74.140516,4.697157
45442,2017,Agosto,Suecia,0,10,,10,-75.42726,6.170465
45443,2017,Agosto,Suiza,0,1,,1,-81.70216500000001,12.5862
45444,2017,Agosto,Suiza,13,17,,30,-76.532004,3.451668
45445,2017,Agosto,Suiza,76,92,,168,-74.140516,4.697157
45446,2017,Agosto,Suiza,1,1,,2,-75.736374,4.815189
45447,2017,Agosto,Suiza,6,16,,22,-75.42726,6.170465
45448,2017,Agosto,Surinam,1,2,,3,-74.140516,4.697157
45449,2017,Agosto,Surinam,0,2,,2,-75.42726,6.170465
45450,2017,Agosto,Suazilandia,1,1,,2,-74.140516,4.697157
45451,2017,Agosto,Taiwán,0,4,,4,-74.140516,4.697157
45452,2017,Agosto,Taiwán,2,2,,4,-75.42726,6.170465
45453,2017,Agosto,Tailandia,1,1,,2,-74.140516,4.697157
45454,2017,Agosto,Tanzania,0,1,,1,-74.140516,4.697157
45455,2017,Agosto,Trinidad y Tobago,1,1,,2,-75.516486,10.446304
45456,2017,Agosto,Trinidad y Tobago,1,1,,2,-74.77647900000001,10.886686
45457,2017,Agosto,Trinidad y Tobago,4,4,,8,-76.532004,3.451668
45458,2017,Agosto,Trinidad y Tobago,14,13,,27,-74.140516,4.697157
45459,2017,Agosto,Trinidad y Tobago,0,1,,1,-75.736374,4.815189
45460,2017,Agosto,Trinidad y Tobago,3,5,,8,-75.42726,6.170465
45461,2017,Agosto,Túnez,0,4,,4,-74.140516,4.697157
45462,2017,Agosto,Turkmenistán,5,6,,11,-74.140516,4.697157
45463,2017,Agosto,Turquía,0,3,,3,-76.532004,3.451668
45464,2017,Agosto,Turquía,427,510,,937,-74.140516,4.697157
45465,2017,Agosto,Turquía,0,2,,2,-75.42726,6.170465
45466,2017,Agosto,Ucrania,4,9,,13,-74.140516,4.697157
45467,2017,Agosto,Ucrania,1,0,,1,-75.42726,6.170465
45468,2017,Agosto,Uganda,0,1,,1,-76.532004,3.451668
45469,2017,Agosto,Uganda,1,1,,2,-74.140516,4.697157
45470,2017,Agosto,Uruguay,5,5,,10,-75.516486,10.446304
45471,2017,Agosto,Uruguay,40,28,,68,-81.70216500000001,12.5862
45472,2017,Agosto,Uruguay,7,11,,18,-76.532004,3.451668
45473,2017,Agosto,Uruguay,426,523,,949,-74.140516,4.697157
45474,2017,Agosto,Uruguay,0,2,,2,-75.736374,4.815189
45475,2017,Agosto,Uruguay,11,24,,35,-75.42726,6.170465
45476,2017,Agosto,Uruguay,1,0,,1,-73.181317,7.1280470000000005
45477,2017,Agosto,Venezuela,1,28,,29,-75.527794,10.406342
45478,2017,Agosto,Venezuela,10,29,,39,-75.516486,10.446304
45479,2017,Agosto,Venezuela,24,69,,93,-74.77647900000001,10.886686
45480,2017,Agosto,Venezuela,0,1,,1,-74.232675,11.117206
45481,2017,Agosto,Venezuela,1,3,,4,-74.213989,11.247722999999999
45482,2017,Agosto,Venezuela,9677,10072,,19749,-72.129595,11.360028999999999
45483,2017,Agosto,Venezuela,3,3,,6,-81.70216500000001,12.5862
45484,2017,Agosto,Venezuela,22,23,,45,-76.532004,3.451668
45485,2017,Agosto,Venezuela,15,19,,34,-67.927521,3.866713
45486,2017,Agosto,Venezuela,3015,2904,,5919,-74.140516,4.697157
45487,2017,Agosto,Venezuela,2,3,,5,-75.736374,4.815189
45488,2017,Agosto,Venezuela,573,678,,1251,-75.42726,6.170465
45489,2017,Agosto,Venezuela,26,29,,55,-67.48402800000001,6.185536
45490,2017,Agosto,Venezuela,299,318,,617,-70.74025300000001,7.088728999999999
45491,2017,Agosto,Venezuela,3,5,,8,-73.181317,7.1280470000000005
45492,2017,Agosto,Venezuela,23560,27330,,50890,-72.453013,7.819
45493,2017,Agosto,Venezuela,4,26,,30,-72.508188,7.927233
45494,2017,Agosto,Venezuela,850,868,,1718,-72.409396,8.36068
45495,2017,Agosto,Vietnam,2,0,,2,-74.140516,4.697157
45496,2017,Agosto,República Árabe de Yemen,0,1,,1,-74.140516,4.697157
45497,2017,Agosto,Desconocido,224,506,,730,-75.42726,6.170465
45498,2017,Septiembre,Afganistán,1,0,,1,-74.140516,4.697157
45499,2017,Septiembre,Albania,1,0,,1,-76.532004,3.451668
45500,2017,Septiembre,Albania,0,1,,1,-74.140516,4.697157
45501,2017,Septiembre,Alemania,1,0,,1,-77.35600000000001,0.81488
45502,2017,Septiembre,Alemania,3,0,,3,-75.516486,10.446304
45503,2017,Septiembre,Alemania,2,4,,6,-74.77647900000001,10.886686
45504,2017,Septiembre,Alemania,0,2,,2,-81.70216500000001,12.5862
45505,2017,Septiembre,Alemania,18,23,,41,-76.532004,3.451668
45506,2017,Septiembre,Alemania,1347,2181,,3528,-74.140516,4.697157
45507,2017,Septiembre,Alemania,2,4,,6,-75.736374,4.815189
45508,2017,Septiembre,Alemania,1,2,,3,-73.181317,7.1280470000000005
45509,2017,Septiembre,Andorra,0,1,,1,-74.140516,4.697157
45510,2017,Septiembre,Antigua y Barbuda,0,4,,4,-75.527794,10.406342
45511,2017,Septiembre,Antigua y Barbuda,0,1,,1,-76.532004,3.451668
45512,2017,Septiembre,Antigua y Barbuda,1,3,,4,-74.140516,4.697157
45513,2017,Septiembre,Países Bajos,2,2,,4,-75.527794,10.406342
45514,2017,Septiembre,Países Bajos,182,323,,505,-75.516486,10.446304
45515,2017,Septiembre,Países Bajos,9,19,,28,-74.77647900000001,10.886686
45516,2017,Septiembre,Países Bajos,0,3,,3,-74.765343,10.970933
45517,2017,Septiembre,Países Bajos,5,3,,8,-74.213989,11.247722999999999
45518,2017,Septiembre,Países Bajos,3,13,,16,-76.532004,3.451668
45519,2017,Septiembre,Países Bajos,889,1199,,2088,-74.140516,4.697157
45520,2017,Septiembre,Países Bajos,2,3,,5,-75.736374,4.815189
45521,2017,Septiembre,Países Bajos,19,34,,53,-75.42726,6.170465
45522,2017,Septiembre,Países Bajos,0,2,,2,-75.586989,6.2188349999999994
45523,2017,Septiembre,Países Bajos,0,1,,1,-73.181317,7.1280470000000005
45524,2017,Septiembre,Arabia Saudita,2,2,,4,-74.140516,4.697157
45525,2017,Septiembre,Argelia,1,1,,2,-74.140516,4.697157
45526,2017,Septiembre,Argentina,4,3,,7,-77.35600000000001,0.81488
45527,2017,Septiembre,Argentina,0,8,,8,-75.527794,10.406342
45528,2017,Septiembre,Argentina,135,90,,225,-75.516486,10.446304
45529,2017,Septiembre,Argentina,12,22,,34,-74.77647900000001,10.886686
45530,2017,Septiembre,Argentina,29,13,,42,-81.70216500000001,12.5862
45531,2017,Septiembre,Argentina,32,41,,73,-76.532004,3.451668
45532,2017,Septiembre,Argentina,3182,3878,,7060,-74.140516,4.697157
45533,2017,Septiembre,Argentina,6,11,,17,-75.736374,4.815189
45534,2017,Septiembre,Argentina,2,15,,17,-75.42726,6.170465
45535,2017,Septiembre,Argentina,1,3,,4,-73.181317,7.1280470000000005
45536,2017,Septiembre,Aruba,11,14,,25,-75.527794,10.406342
45537,2017,Septiembre,Aruba,1,1,,2,-75.516486,10.446304
45538,2017,Septiembre,Aruba,0,1,,1,-74.77647900000001,10.886686
45539,2017,Septiembre,Aruba,1,1,,2,-74.765343,10.970933
45540,2017,Septiembre,Aruba,11,20,,31,-74.213989,11.247722999999999
45541,2017,Septiembre,Aruba,5,12,,17,-72.919186,11.52863
45542,2017,Septiembre,Aruba,5,1,,6,-76.532004,3.451668
45543,2017,Septiembre,Aruba,706,862,,1568,-74.140516,4.697157
45544,2017,Septiembre,Aruba,0,2,,2,-75.736374,4.815189
45545,2017,Septiembre,Aruba,0,1,,1,-75.42726,6.170465
45546,2017,Septiembre,Aruba,32,19,,51,-73.181317,7.1280470000000005
45547,2017,Septiembre,Australia,1,1,,2,-75.516486,10.446304
45548,2017,Septiembre,Australia,0,1,,1,-81.70216500000001,12.5862
45549,2017,Septiembre,Australia,7,7,,14,-76.532004,3.451668
45550,2017,Septiembre,Australia,32,46,,78,-74.140516,4.697157
45551,2017,Septiembre,Australia,0,1,,1,-73.181317,7.1280470000000005
45552,2017,Septiembre,Austria,1,2,,3,-75.516486,10.446304
45553,2017,Septiembre,Austria,0,1,,1,-76.532004,3.451668
45554,2017,Septiembre,Austria,10,21,,31,-74.140516,4.697157
45555,2017,Septiembre,Bahamas,2,2,,4,-75.516486,10.446304
45556,2017,Septiembre,Bahamas,0,1,,1,-76.532004,3.451668
45557,2017,Septiembre,Bahamas,5,14,,19,-74.140516,4.697157
45558,2017,Septiembre,Bahréin,2,0,,2,-74.140516,4.697157
45559,2017,Septiembre,Barbados,0,1,,1,-75.516486,10.446304
45560,2017,Septiembre,Barbados,3,0,,3,-74.140516,4.697157
45561,2017,Septiembre,República de Belarús,1,0,,1,-72.129595,11.360028999999999
45562,2017,Septiembre,República de Belarús,0,2,,2,-72.453013,7.819
45563,2017,Septiembre,Bélgica,0,2,,2,-75.516486,10.446304
45564,2017,Septiembre,Bélgica,1,0,,1,-81.70216500000001,12.5862
45565,2017,Septiembre,Bélgica,3,8,,11,-76.532004,3.451668
45566,2017,Septiembre,Bélgica,46,53,,99,-74.140516,4.697157
45567,2017,Septiembre,Bélgica,0,1,,1,-75.736374,4.815189
45568,2017,Septiembre,Belice,0,1,,1,-76.532004,3.451668
45569,2017,Septiembre,Belice,0,3,,3,-74.140516,4.697157
45570,2017,Septiembre,Bolivia,0,1,,1,-77.35600000000001,0.81488
45571,2017,Septiembre,Bolivia,29,14,,43,-75.516486,10.446304
45572,2017,Septiembre,Bolivia,1,0,,1,-74.77647900000001,10.886686
45573,2017,Septiembre,Bolivia,7,1,,8,-81.70216500000001,12.5862
45574,2017,Septiembre,Bolivia,37,43,,80,-76.532004,3.451668
45575,2017,Septiembre,Bolivia,448,560,,1008,-74.140516,4.697157
45576,2017,Septiembre,Bolivia,1,2,,3,-75.736374,4.815189
45577,2017,Septiembre,Brasil,312,283,,595,-69.941498,4.191162
45578,2017,Septiembre,Brasil,0,1,,1,-69.94143100000001,4.214082
45579,2017,Septiembre,Brasil,0,1,,1,-77.35600000000001,0.81488
45580,2017,Septiembre,Brasil,0,17,,17,-75.527794,10.406342
45581,2017,Septiembre,Brasil,127,99,,226,-75.516486,10.446304
45582,2017,Septiembre,Brasil,1,75,,76,-74.77647900000001,10.886686
45583,2017,Septiembre,Brasil,0,6,,6,-74.213989,11.247722999999999
45584,2017,Septiembre,Brasil,123,109,,232,-81.70216500000001,12.5862
45585,2017,Septiembre,Brasil,35,57,,92,-76.532004,3.451668
45586,2017,Septiembre,Brasil,4982,5762,,10744,-74.140516,4.697157
45587,2017,Septiembre,Brasil,3,5,,8,-75.736374,4.815189
45588,2017,Septiembre,Brasil,1,5,,6,-75.42726,6.170465
45589,2017,Septiembre,Brasil,2,2,,4,-73.181317,7.1280470000000005
45590,2017,Septiembre,Bulgaria,0,2,,2,-74.140516,4.697157
45591,2017,Septiembre,Islas Caimán/Territorio Británico de Ultramar,2,2,,4,-75.516486,10.446304
45592,2017,Septiembre,Islas Caimán/Territorio Británico de Ultramar,0,4,,4,-81.70216500000001,12.5862
45593,2017,Septiembre,Islas Caimán/Territorio Británico de Ultramar,0,2,,2,-74.140516,4.697157
45594,2017,Septiembre,Camboya,0,1,,1,-74.140516,4.697157
45595,2017,Septiembre,Canadá,15,23,,38,-75.516486,10.446304
45596,2017,Septiembre,Canadá,2,13,,15,-74.77647900000001,10.886686
45597,2017,Septiembre,Canadá,2,0,,2,-81.70216500000001,12.5862
45598,2017,Septiembre,Canadá,36,53,,89,-76.532004,3.451668
45599,2017,Septiembre,Canadá,0,6,,6,-77.061029,3.8844260000000004
45600,2017,Septiembre,Canadá,425,685,,1110,-74.140516,4.697157
45601,2017,Septiembre,Canadá,2,4,,6,-75.736374,4.815189
45602,2017,Septiembre,Canadá,0,4,,4,-73.181317,7.1280470000000005
45603,2017,Septiembre,España,0,1,,1,-75.527794,10.406342
45604,2017,Septiembre,España,5,5,,10,-75.516486,10.446304
45605,2017,Septiembre,España,2,2,,4,-74.77647900000001,10.886686
45606,2017,Septiembre,España,166,279,,445,-76.532004,3.451668
45607,2017,Septiembre,España,3384,5386,,8770,-74.140516,4.697157
45608,2017,Septiembre,España,4,12,,16,-75.736374,4.815189
45609,2017,Septiembre,España,534,1030,,1564,-75.42726,6.170465
45610,2017,Septiembre,España,0,2,,2,-73.181317,7.1280470000000005
45611,2017,Septiembre,República de Corea,1,5,,6,-76.532004,3.451668
45612,2017,Septiembre,República de Corea,7,13,,20,-74.140516,4.697157
45613,2017,Septiembre,República de Corea,0,2,,2,-75.736374,4.815189
45614,2017,Septiembre,Costa de Marfil,7,1,,8,-74.140516,4.697157
45615,2017,Septiembre,Costa Rica,0,3,,3,-75.527794,10.406342
45616,2017,Septiembre,Costa Rica,14,14,,28,-75.516486,10.446304
45617,2017,Septiembre,Costa Rica,6,6,,12,-74.77647900000001,10.886686
45618,2017,Septiembre,Costa Rica,1,0,,1,-74.232675,11.117206
45619,2017,Septiembre,Costa Rica,0,1,,1,-81.703935,12.574411099999999
45620,2017,Septiembre,Costa Rica,7,7,,14,-81.70216500000001,12.5862
45621,2017,Septiembre,Costa Rica,32,43,,75,-76.532004,3.451668
45622,2017,Septiembre,Costa Rica,0,1,,1,-77.061029,3.8844260000000004
45623,2017,Septiembre,Costa Rica,1490,1770,,3260,-74.140516,4.697157
45624,2017,Septiembre,Costa Rica,6,2,,8,-75.736374,4.815189
45625,2017,Septiembre,Costa Rica,0,8,,8,-75.42726,6.170465
45626,2017,Septiembre,Costa Rica,3,2,,5,-73.181317,7.1280470000000005
45627,2017,Septiembre,Croacia,0,4,,4,-77.061029,3.8844260000000004
45628,2017,Septiembre,Croacia,1,6,,7,-74.140516,4.697157
45629,2017,Septiembre,Cuba,2,11,,13,-74.77647900000001,10.886686
45630,2017,Septiembre,Cuba,24,16,,40,-76.532004,3.451668
45631,2017,Septiembre,Cuba,315,545,,860,-74.140516,4.697157
45632,2017,Septiembre,Cuba,3,10,,13,-75.736374,4.815189
45633,2017,Septiembre,Curazao,5,5,,10,-74.140516,4.697157
45634,2017,Septiembre,República Checa,0,1,,1,-76.532004,3.451668
45635,2017,Septiembre,República Checa,5,4,,9,-74.140516,4.697157
45636,2017,Septiembre,Chile,3,3,,6,-77.35600000000001,0.81488
45637,2017,Septiembre,Chile,41,34,,75,-75.516486,10.446304
45638,2017,Septiembre,Chile,4,8,,12,-74.77647900000001,10.886686
45639,2017,Septiembre,Chile,18,11,,29,-81.70216500000001,12.5862
45640,2017,Septiembre,Chile,24,35,,59,-76.532004,3.451668
45641,2017,Septiembre,Chile,0,1,,1,-77.061029,3.8844260000000004
45642,2017,Septiembre,Chile,4671,5618,,10289,-74.140516,4.697157
45643,2017,Septiembre,Chile,2,3,,5,-75.736374,4.815189
45644,2017,Septiembre,Chile,0,1,,1,-75.42726,6.170465
45645,2017,Septiembre,Chile,0,1,,1,-73.181317,7.1280470000000005
45646,2017,Septiembre,China,0,2,,2,-75.516486,10.446304
45647,2017,Septiembre,China,0,1,,1,-74.77647900000001,10.886686
45648,2017,Septiembre,China,2,2,,4,-76.532004,3.451668
45649,2017,Septiembre,China,17,61,,78,-74.140516,4.697157
45650,2017,Septiembre,Dinamarca,0,2,,2,-76.532004,3.451668
45651,2017,Septiembre,Dinamarca,4,6,,10,-74.140516,4.697157
45652,2017,Septiembre,Dinamarca,0,1,,1,-73.181317,7.1280470000000005
45653,2017,Septiembre,Ecuador,0,5,,5,-69.94143100000001,4.214082
45654,2017,Septiembre,Ecuador,124,441,,565,-76.876446,0.33002
45655,2017,Septiembre,Ecuador,1,3,,4,-77.84700600000001,0.8124359999999999
45656,2017,Septiembre,Ecuador,4365,5599,,9964,-77.35600000000001,0.81488
45657,2017,Septiembre,Ecuador,36,311,,347,-78.802679,18.00143
45658,2017,Septiembre,Ecuador,7,17,,24,-75.516486,10.446304
45659,2017,Septiembre,Ecuador,4,5,,9,-74.77647900000001,10.886686
45660,2017,Septiembre,Ecuador,0,6,,6,-74.765343,10.970933
45661,2017,Septiembre,Ecuador,2,2,,4,-81.70216500000001,12.5862
45662,2017,Septiembre,Ecuador,312,361,,673,-76.532004,3.451668
45663,2017,Septiembre,Ecuador,2475,3432,,5907,-74.140516,4.697157
45664,2017,Septiembre,Ecuador,2,2,,4,-75.736374,4.815189
45665,2017,Septiembre,Ecuador,0,1,,1,-75.42726,6.170465
45666,2017,Septiembre,Ecuador,1,1,,2,-73.181317,7.1280470000000005
45667,2017,Septiembre,Egipto,0,2,,2,-74.140516,4.697157
45668,2017,Septiembre,El Salvador,6,3,,9,-75.516486,10.446304
45669,2017,Septiembre,El Salvador,2,0,,2,-74.77647900000001,10.886686
45670,2017,Septiembre,El Salvador,90,159,,249,-76.532004,3.451668
45671,2017,Septiembre,El Salvador,1223,1603,,2826,-74.140516,4.697157
45672,2017,Septiembre,El Salvador,2,1,,3,-75.736374,4.815189
45673,2017,Septiembre,El Salvador,345,690,,1035,-75.42726,6.170465
45674,2017,Septiembre,Emiratos Árabes,6,6,,12,-74.140516,4.697157
45675,2017,Septiembre,Eslovaquia,1,1,,2,-75.516486,10.446304
45676,2017,Septiembre,Eslovaquia,0,3,,3,-74.140516,4.697157
45677,2017,Septiembre,Eslovenia,0,1,,1,-74.140516,4.697157
45678,2017,Septiembre,Estados Unidos de América,0,37,,37,-75.527794,10.406342
45679,2017,Septiembre,Estados Unidos de América,2019,3265,,5284,-75.516486,10.446304
45680,2017,Septiembre,Estados Unidos de América,440,849,,1289,-74.77647900000001,10.886686
45681,2017,Septiembre,Estados Unidos de América,0,4,,4,-74.765343,10.970933
45682,2017,Septiembre,Estados Unidos de América,0,27,,27,-74.213989,11.247722999999999
45683,2017,Septiembre,Estados Unidos de América,1,2,,3,-81.703935,12.574411099999999
45684,2017,Septiembre,Estados Unidos de América,1,10,,11,-81.70216500000001,12.5862
45685,2017,Septiembre,Estados Unidos de América,742,1146,,1888,-76.532004,3.451668
45686,2017,Septiembre,Estados Unidos de América,103,200,,303,-75.76635300000001,4.45285
45687,2017,Septiembre,Estados Unidos de América,7912,13710,,21622,-74.140516,4.697157
45688,2017,Septiembre,Estados Unidos de América,61,119,,180,-75.736374,4.815189
45689,2017,Septiembre,Estados Unidos de América,1722,4168,,5890,-75.42726,6.170465
45690,2017,Septiembre,Estados Unidos de América,16,46,,62,-73.181317,7.1280470000000005
45691,2017,Septiembre,Estados Unidos de América,0,16,,16,-75.68164200000001,9.402597
45692,2017,Septiembre,Estonia,0,2,,2,-74.140516,4.697157
45693,2017,Septiembre,Etiopia,0,1,,1,-74.140516,4.697157
45694,2017,Septiembre,Filipinas,0,2,,2,-75.516486,10.446304
45695,2017,Septiembre,Filipinas,0,1,,1,-74.213989,11.247722999999999
45696,2017,Septiembre,Filipinas,0,10,,10,-76.532004,3.451668
45697,2017,Septiembre,Filipinas,0,2,,2,-77.061029,3.8844260000000004
45698,2017,Septiembre,Filipinas,3,5,,8,-74.140516,4.697157
45699,2017,Septiembre,Finlandia,1,0,,1,-76.532004,3.451668
45700,2017,Septiembre,Finlandia,0,5,,5,-74.140516,4.697157
45701,2017,Septiembre,Francia,0,5,,5,-75.527794,10.406342
45702,2017,Septiembre,Francia,0,1,,1,-75.516486,10.446304
45703,2017,Septiembre,Francia,1,1,,2,-74.77647900000001,10.886686
45704,2017,Septiembre,Francia,11,29,,40,-76.532004,3.451668
45705,2017,Septiembre,Francia,1285,2154,,3439,-74.140516,4.697157
45706,2017,Septiembre,Francia,1,4,,5,-75.736374,4.815189
45707,2017,Septiembre,Ghana,1,2,,3,-74.140516,4.697157
45708,2017,Septiembre,Gibraltar/Territorio Británico de Ultramar,0,2,,2,-77.35600000000001,0.81488
45709,2017,Septiembre,Grecia,4,6,,10,-74.140516,4.697157
45710,2017,Septiembre,Guatemala,0,2,,2,-75.527794,10.406342
45711,2017,Septiembre,Guatemala,14,14,,28,-75.516486,10.446304
45712,2017,Septiembre,Guatemala,4,2,,6,-74.77647900000001,10.886686
45713,2017,Septiembre,Guatemala,0,1,,1,-81.372937,13.338761300000002
45714,2017,Septiembre,Guatemala,29,56,,85,-76.532004,3.451668
45715,2017,Septiembre,Guatemala,316,457,,773,-74.140516,4.697157
45716,2017,Septiembre,Guatemala,2,11,,13,-75.736374,4.815189
45717,2017,Septiembre,Guatemala,2,4,,6,-73.181317,7.1280470000000005
45718,2017,Septiembre,Guyana,0,3,,3,-75.527794,10.406342
45719,2017,Septiembre,Guyana,0,1,,1,-74.77647900000001,10.886686
45720,2017,Septiembre,Guyana,1,0,,1,-76.532004,3.451668
45721,2017,Septiembre,Guadalupe/Territorio Francés,0,1,,1,-74.140516,4.697157
45722,2017,Septiembre,Guayana Francesa/Departamento de Ultramar Francés,0,1,,1,-75.527794,10.406342
45723,2017,Septiembre,Haití,0,1,,1,-75.527794,10.406342
45724,2017,Septiembre,Honduras,0,1,,1,-75.527794,10.406342
45725,2017,Septiembre,Honduras,5,2,,7,-75.516486,10.446304
45726,2017,Septiembre,Honduras,0,6,,6,-74.77647900000001,10.886686
45727,2017,Septiembre,Honduras,0,8,,8,-81.703935,12.574411099999999
45728,2017,Septiembre,Honduras,0,1,,1,-81.70216500000001,12.5862
45729,2017,Septiembre,Honduras,8,5,,13,-81.372937,13.338761300000002
45730,2017,Septiembre,Honduras,10,29,,39,-76.532004,3.451668
45731,2017,Septiembre,Honduras,67,63,,130,-74.140516,4.697157
45732,2017,Septiembre,Honduras,2,3,,5,-75.736374,4.815189
45733,2017,Septiembre,Hong Kong,0,2,,2,-75.516486,10.446304
45734,2017,Septiembre,Hong Kong,0,1,,1,-76.532004,3.451668
45735,2017,Septiembre,Hong Kong,1,1,,2,-74.140516,4.697157
45736,2017,Septiembre,Hungría,0,1,,1,-76.532004,3.451668
45737,2017,Septiembre,Hungría,2,3,,5,-74.140516,4.697157
45738,2017,Septiembre,Hungría,0,1,,1,-75.736374,4.815189
45739,2017,Septiembre,India,0,4,,4,-75.516486,10.446304
45740,2017,Septiembre,India,0,1,,1,-76.532004,3.451668
45741,2017,Septiembre,India,0,4,,4,-77.061029,3.8844260000000004
45742,2017,Septiembre,India,3,35,,38,-74.140516,4.697157
45743,2017,Septiembre,India,0,1,,1,-75.736374,4.815189
45744,2017,Septiembre,Indonesia,0,1,,1,-75.516486,10.446304
45745,2017,Septiembre,Indonesia,0,2,,2,-74.140516,4.697157
45746,2017,Septiembre,Iraq,0,1,,1,-74.140516,4.697157
45747,2017,Septiembre,República de Irlanda,0,1,,1,-76.532004,3.451668
45748,2017,Septiembre,República de Irlanda,10,10,,20,-74.140516,4.697157
45749,2017,Septiembre,Israel,26,73,,99,-74.140516,4.697157
45750,2017,Septiembre,Italia,0,9,,9,-75.516486,10.446304
45751,2017,Septiembre,Italia,8,22,,30,-76.532004,3.451668
45752,2017,Septiembre,Italia,91,244,,335,-74.140516,4.697157
45753,2017,Septiembre,Italia,0,2,,2,-75.736374,4.815189
45754,2017,Septiembre,Jamaica,0,2,,2,-75.527794,10.406342
45755,2017,Septiembre,Jamaica,1,0,,1,-75.516486,10.446304
45756,2017,Septiembre,Jamaica,0,3,,3,-74.77647900000001,10.886686
45757,2017,Septiembre,Jamaica,0,3,,3,-81.703935,12.574411099999999
45758,2017,Septiembre,Jamaica,3,15,,18,-81.70216500000001,12.5862
45759,2017,Septiembre,Jamaica,1,0,,1,-76.532004,3.451668
45760,2017,Septiembre,Jamaica,1,1,,2,-74.140516,4.697157
45761,2017,Septiembre,Jamaica,0,1,,1,-73.181317,7.1280470000000005
45762,2017,Septiembre,Japón,0,1,,1,-74.77647900000001,10.886686
45763,2017,Septiembre,Japón,0,1,,1,-76.532004,3.451668
45764,2017,Septiembre,Japón,8,21,,29,-74.140516,4.697157
45765,2017,Septiembre,Japón,0,1,,1,-75.736374,4.815189
45766,2017,Septiembre,Japón,0,2,,2,-73.181317,7.1280470000000005
45767,2017,Septiembre,Jordania,1,0,,1,-74.140516,4.697157
45768,2017,Septiembre,Kazajistán,0,1,,1,-75.516486,10.446304
45769,2017,Septiembre,Kenia,1,0,,1,-76.532004,3.451668
45770,2017,Septiembre,Kenia,0,5,,5,-74.140516,4.697157
45771,2017,Septiembre,República Democrática Popular  Lao,1,0,,1,-74.140516,4.697157
45772,2017,Septiembre,Letonia,1,2,,3,-74.140516,4.697157
45773,2017,Septiembre,Líbano,6,6,,12,-74.140516,4.697157
45774,2017,Septiembre,Luxemburgo,0,4,,4,-74.140516,4.697157
45775,2017,Septiembre,Macedonia,0,1,,1,-74.140516,4.697157
45776,2017,Septiembre,Madagascar,1,0,,1,-74.140516,4.697157
45777,2017,Septiembre,Malasia,0,3,,3,-74.140516,4.697157
45778,2017,Septiembre,Malta,1,0,,1,-74.140516,4.697157
45779,2017,Septiembre,Marruecos,0,2,,2,-74.140516,4.697157
45780,2017,Septiembre,Islas Marshall,0,2,,2,-74.765343,10.970933
45781,2017,Septiembre,México,3,1,,4,-75.527794,10.406342
45782,2017,Septiembre,México,31,55,,86,-75.516486,10.446304
45783,2017,Septiembre,México,8,21,,29,-74.77647900000001,10.886686
45784,2017,Septiembre,México,0,3,,3,-74.765343,10.970933
45785,2017,Septiembre,México,74,182,,256,-76.532004,3.451668
45786,2017,Septiembre,México,0,4,,4,-77.061029,3.8844260000000004
45787,2017,Septiembre,México,5625,9103,,14728,-74.140516,4.697157
45788,2017,Septiembre,México,21,43,,64,-75.736374,4.815189
45789,2017,Septiembre,México,556,1255,,1811,-75.42726,6.170465
45790,2017,Septiembre,México,8,27,,35,-73.181317,7.1280470000000005
45791,2017,Septiembre,Montenegro,0,1,,1,-76.532004,3.451668
45792,2017,Septiembre,Nicaragua,5,0,,5,-75.516486,10.446304
45793,2017,Septiembre,Nicaragua,2,0,,2,-74.77647900000001,10.886686
45794,2017,Septiembre,Nicaragua,0,6,,6,-81.703935,12.574411099999999
45795,2017,Septiembre,Nicaragua,11,11,,22,-76.532004,3.451668
45796,2017,Septiembre,Nicaragua,21,24,,45,-74.140516,4.697157
45797,2017,Septiembre,Nicaragua,3,6,,9,-75.736374,4.815189
45798,2017,Septiembre,Nicaragua,0,3,,3,-73.181317,7.1280470000000005
45799,2017,Septiembre,Nigeria,3,2,,5,-74.140516,4.697157
45800,2017,Septiembre,Noruega,0,1,,1,-75.516486,10.446304
45801,2017,Septiembre,Noruega,2,3,,5,-76.532004,3.451668
45802,2017,Septiembre,Noruega,13,18,,31,-74.140516,4.697157
45803,2017,Septiembre,Nueva Zelanda,1,1,,2,-75.516486,10.446304
45804,2017,Septiembre,Nueva Zelanda,1,0,,1,-76.532004,3.451668
45805,2017,Septiembre,Nueva Zelanda,4,9,,13,-74.140516,4.697157
45806,2017,Septiembre,Omán,0,1,,1,-74.140516,4.697157
45807,2017,Septiembre,Pakistán,0,1,,1,-74.140516,4.697157
45808,2017,Septiembre,Panamá,1264,1086,,2350,-75.527794,10.406342
45809,2017,Septiembre,Panamá,4649,4513,,9162,-75.516486,10.446304
45810,2017,Septiembre,Panamá,366,802,,1168,-74.77647900000001,10.886686
45811,2017,Septiembre,Panamá,0,55,,55,-74.765343,10.970933
45812,2017,Septiembre,Panamá,3,10,,13,-81.703935,12.574411099999999
45813,2017,Septiembre,Panamá,875,636,,1511,-81.70216500000001,12.5862
45814,2017,Septiembre,Panamá,389,578,,967,-76.532004,3.451668
45815,2017,Septiembre,Panamá,1,32,,33,-77.061029,3.8844260000000004
45816,2017,Septiembre,Panamá,71,58,,129,-75.76635300000001,4.45285
45817,2017,Septiembre,Panamá,5625,7229,,12854,-74.140516,4.697157
45818,2017,Septiembre,Panamá,73,141,,214,-75.736374,4.815189
45819,2017,Septiembre,Panamá,3075,4521,,7596,-75.42726,6.170465
45820,2017,Septiembre,Panamá,1,2,,3,-77.401154,6.222551999999999
45821,2017,Septiembre,Panamá,1,6,,7,-77.762647,7.102626
45822,2017,Septiembre,Panamá,17,39,,56,-73.181317,7.1280470000000005
45823,2017,Septiembre,Panamá,0,2,,2,-76.7333,8.06667
45824,2017,Septiembre,Panamá,75,99,,174,-77.35002,8.63337
45825,2017,Septiembre,Panamá,0,15,,15,-75.68164200000001,9.402597
45826,2017,Septiembre,Paraguay,10,9,,19,-75.516486,10.446304
45827,2017,Septiembre,Paraguay,0,2,,2,-74.77647900000001,10.886686
45828,2017,Septiembre,Paraguay,12,12,,24,-81.70216500000001,12.5862
45829,2017,Septiembre,Paraguay,15,16,,31,-76.532004,3.451668
45830,2017,Septiembre,Paraguay,43,102,,145,-74.140516,4.697157
45831,2017,Septiembre,Paraguay,6,6,,12,-75.736374,4.815189
45832,2017,Septiembre,Paraguay,0,1,,1,-73.181317,7.1280470000000005
45833,2017,Septiembre,Perú,76,112,,188,-69.941498,4.191162
45834,2017,Septiembre,Perú,13,37,,50,-69.94143100000001,4.214082
45835,2017,Septiembre,Perú,21,31,,52,-77.35600000000001,0.81488
45836,2017,Septiembre,Perú,1392,1043,,2435,-75.516486,10.446304
45837,2017,Septiembre,Perú,48,47,,95,-74.77647900000001,10.886686
45838,2017,Septiembre,Perú,37,25,,62,-81.70216500000001,12.5862
45839,2017,Septiembre,Perú,281,409,,690,-76.532004,3.451668
45840,2017,Septiembre,Perú,0,4,,4,-77.061029,3.8844260000000004
45841,2017,Septiembre,Perú,4927,6370,,11297,-74.140516,4.697157
45842,2017,Septiembre,Perú,11,7,,18,-75.736374,4.815189
45843,2017,Septiembre,Perú,436,934,,1370,-75.42726,6.170465
45844,2017,Septiembre,Perú,0,3,,3,-73.181317,7.1280470000000005
45845,2017,Septiembre,Polonia,0,1,,1,-74.213989,11.247722999999999
45846,2017,Septiembre,Polonia,1,0,,1,-76.532004,3.451668
45847,2017,Septiembre,Polonia,12,17,,29,-74.140516,4.697157
45848,2017,Septiembre,Portugal,1,0,,1,-75.516486,10.446304
45849,2017,Septiembre,Portugal,0,1,,1,-76.532004,3.451668
45850,2017,Septiembre,Portugal,14,41,,55,-74.140516,4.697157
45851,2017,Septiembre,Polinesia Francesa/Colectividad de Ultramar Francesa,0,5,,5,-75.527794,10.406342
45852,2017,Septiembre,Puerto Rico/Territorio de Estados Unidos,0,5,,5,-75.527794,10.406342
45853,2017,Septiembre,Puerto Rico/Territorio de Estados Unidos,4,3,,7,-75.516486,10.446304
45854,2017,Septiembre,Puerto Rico/Territorio de Estados Unidos,1,22,,23,-74.77647900000001,10.886686
45855,2017,Septiembre,Puerto Rico/Territorio de Estados Unidos,10,39,,49,-76.532004,3.451668
45856,2017,Septiembre,Puerto Rico/Territorio de Estados Unidos,296,383,,679,-74.140516,4.697157
45857,2017,Septiembre,Puerto Rico/Territorio de Estados Unidos,0,2,,2,-75.736374,4.815189
45858,2017,Septiembre,Puerto Rico/Territorio de Estados Unidos,0,3,,3,-75.42726,6.170465
45859,2017,Septiembre,Puerto Rico/Territorio de Estados Unidos,3,4,,7,-73.181317,7.1280470000000005
45860,2017,Septiembre,Qatar,0,2,,2,-76.532004,3.451668
45861,2017,Septiembre,Qatar,0,1,,1,-74.140516,4.697157
45862,2017,Septiembre,Reino Unido de Gran Bretaña e Irlanda del Norte,2,6,,8,-75.516486,10.446304
45863,2017,Septiembre,Reino Unido de Gran Bretaña e Irlanda del Norte,6,20,,26,-76.532004,3.451668
45864,2017,Septiembre,Reino Unido de Gran Bretaña e Irlanda del Norte,655,1057,,1712,-74.140516,4.697157
45865,2017,Septiembre,República CentroÁfricana,0,1,,1,-74.140516,4.697157
45866,2017,Septiembre,Federación de Rusia,0,15,,15,-75.527794,10.406342
45867,2017,Septiembre,Federación de Rusia,1,2,,3,-76.532004,3.451668
45868,2017,Septiembre,Federación de Rusia,15,10,,25,-74.140516,4.697157
45869,2017,Septiembre,Federación de Rusia,1,0,,1,-75.736374,4.815189
45870,2017,Septiembre,República Dominicana,0,12,,12,-75.527794,10.406342
45871,2017,Septiembre,República Dominicana,6,13,,19,-75.516486,10.446304
45872,2017,Septiembre,República Dominicana,0,2,,2,-74.77647900000001,10.886686
45873,2017,Septiembre,República Dominicana,0,1,,1,-74.765343,10.970933
45874,2017,Septiembre,República Dominicana,9,19,,28,-76.532004,3.451668
45875,2017,Septiembre,República Dominicana,723,935,,1658,-74.140516,4.697157
45876,2017,Septiembre,República Dominicana,11,9,,20,-75.736374,4.815189
45877,2017,Septiembre,República Dominicana,3,8,,11,-75.42726,6.170465
45878,2017,Septiembre,República Dominicana,1,1,,2,-73.181317,7.1280470000000005
45879,2017,Septiembre,Rumania,3,3,,6,-74.140516,4.697157
45880,2017,Septiembre,Rwanda,0,1,,1,-74.140516,4.697157
45881,2017,Septiembre,Singapur,1,2,,3,-74.140516,4.697157
45882,2017,Septiembre,República Árabe Siria,2,1,,3,-74.140516,4.697157
45883,2017,Septiembre,Sri Lanka,0,1,,1,-74.140516,4.697157
45884,2017,Septiembre,Sudáfrica,1,0,,1,-76.532004,3.451668
45885,2017,Septiembre,Sudáfrica,1,4,,5,-74.140516,4.697157
45886,2017,Septiembre,Sudáfrica,1,0,,1,-75.68164200000001,9.402597
45887,2017,Septiembre,Sudán,2,0,,2,-74.140516,4.697157
45888,2017,Septiembre,Suecia,0,1,,1,-75.516486,10.446304
45889,2017,Septiembre,Suecia,1,1,,2,-74.77647900000001,10.886686
45890,2017,Septiembre,Suecia,0,1,,1,-74.213989,11.247722999999999
45891,2017,Septiembre,Suecia,5,3,,8,-76.532004,3.451668
45892,2017,Septiembre,Suecia,10,14,,24,-74.140516,4.697157
45893,2017,Septiembre,Suecia,1,0,,1,-73.181317,7.1280470000000005
45894,2017,Septiembre,Suiza,2,2,,4,-75.516486,10.446304
45895,2017,Septiembre,Suiza,7,5,,12,-76.532004,3.451668
45896,2017,Septiembre,Suiza,31,53,,84,-74.140516,4.697157
45897,2017,Septiembre,Suiza,2,3,,5,-75.736374,4.815189
45898,2017,Septiembre,Surinam,1,0,,1,-74.140516,4.697157
45899,2017,Septiembre,Taiwán,0,1,,1,-76.532004,3.451668
45900,2017,Septiembre,Taiwán,1,2,,3,-74.140516,4.697157
45901,2017,Septiembre,Taiwán,0,2,,2,-75.736374,4.815189
45902,2017,Septiembre,Tailandia,1,0,,1,-74.140516,4.697157
45903,2017,Septiembre,Tanzania,0,1,,1,-76.532004,3.451668
45904,2017,Septiembre,Tanzania,1,0,,1,-74.140516,4.697157
45905,2017,Septiembre,Trinidad y Tobago,0,3,,3,-74.213989,11.247722999999999
45906,2017,Septiembre,Trinidad y Tobago,0,12,,12,-81.70216500000001,12.5862
45907,2017,Septiembre,Trinidad y Tobago,1,3,,4,-76.532004,3.451668
45908,2017,Septiembre,Trinidad y Tobago,4,12,,16,-74.140516,4.697157
45909,2017,Septiembre,Trinidad y Tobago,1,3,,4,-75.736374,4.815189
45910,2017,Septiembre,Trinidad y Tobago,1,1,,2,-75.42726,6.170465
45911,2017,Septiembre,Trinidad y Tobago,1,5,,6,-73.181317,7.1280470000000005
45912,2017,Septiembre,Trinidad y Tobago,0,6,,6,-75.68164200000001,9.402597
45913,2017,Septiembre,Túnez,0,1,,1,-74.140516,4.697157
45914,2017,Septiembre,Turkmenistán,1,0,,1,-72.453013,7.819
45915,2017,Septiembre,Turquía,0,2,,2,-74.765343,10.970933
45916,2017,Septiembre,Turquía,244,379,,623,-74.140516,4.697157
45917,2017,Septiembre,Ucrania,1,0,,1,-76.532004,3.451668
45918,2017,Septiembre,Ucrania,0,1,,1,-74.140516,4.697157
45919,2017,Septiembre,Uganda,0,3,,3,-76.532004,3.451668
45920,2017,Septiembre,Uruguay,15,14,,29,-75.516486,10.446304
45921,2017,Septiembre,Uruguay,2,4,,6,-81.70216500000001,12.5862
45922,2017,Septiembre,Uruguay,7,19,,26,-76.532004,3.451668
45923,2017,Septiembre,Uruguay,190,258,,448,-74.140516,4.697157
45924,2017,Septiembre,Uruguay,1,1,,2,-75.736374,4.815189
45925,2017,Septiembre,Uruguay,0,2,,2,-73.181317,7.1280470000000005
45926,2017,Septiembre,Vanuatu,1,0,,1,-72.453013,7.819
45927,2017,Septiembre,Venezuela,0,14,,14,-75.527794,10.406342
45928,2017,Septiembre,Venezuela,9,18,,27,-75.516486,10.446304
45929,2017,Septiembre,Venezuela,8,37,,45,-74.77647900000001,10.886686
45930,2017,Septiembre,Venezuela,0,1,,1,-74.765343,10.970933
45931,2017,Septiembre,Venezuela,6905,7574,,14479,-72.129595,11.360028999999999
45932,2017,Septiembre,Venezuela,17,22,,39,-76.532004,3.451668
45933,2017,Septiembre,Venezuela,13,12,,25,-67.927521,3.866713
45934,2017,Septiembre,Venezuela,1620,1720,,3340,-74.140516,4.697157
45935,2017,Septiembre,Venezuela,0,1,,1,-75.736374,4.815189
45936,2017,Septiembre,Venezuela,516,633,,1149,-75.42726,6.170465
45937,2017,Septiembre,Venezuela,30,25,,55,-67.48402800000001,6.185536
45938,2017,Septiembre,Venezuela,186,204,,390,-70.74025300000001,7.088728999999999
45939,2017,Septiembre,Venezuela,1,3,,4,-73.181317,7.1280470000000005
45940,2017,Septiembre,Venezuela,20416,24712,,45128,-72.453013,7.819
45941,2017,Septiembre,Venezuela,0,13,,13,-72.508188,7.927233
45942,2017,Septiembre,Venezuela,611,694,,1305,-72.409396,8.36068
45943,2017,Octubre,Afganistán,0,1,,1,-75.516486,10.446304
45944,2017,Octubre,Alemania,3,2,,5,-75.516486,10.446304
45945,2017,Octubre,Alemania,2,6,,8,-74.77647900000001,10.886686
45946,2017,Octubre,Alemania,14,28,,42,-76.532004,3.451668
45947,2017,Octubre,Alemania,1648,2706,,4354,-74.140516,4.697157
45948,2017,Octubre,Alemania,1,3,,4,-75.736374,4.815189
45949,2017,Octubre,Alemania,1,2,,3,-73.181317,7.1280470000000005
45950,2017,Octubre,Antigua y Barbuda,0,2,,2,-75.527794,10.406342
45951,2017,Octubre,Países Bajos,2,4,,6,-75.527794,10.406342
45952,2017,Octubre,Países Bajos,189,333,,522,-75.516486,10.446304
45953,2017,Octubre,Países Bajos,22,27,,49,-74.77647900000001,10.886686
45954,2017,Octubre,Países Bajos,9,28,,37,-76.532004,3.451668
45955,2017,Octubre,Países Bajos,852,1162,,2014,-74.140516,4.697157
45956,2017,Octubre,Países Bajos,0,1,,1,-75.736374,4.815189
45957,2017,Octubre,Países Bajos,9,23,,32,-75.42726,6.170465
45958,2017,Octubre,Argentina,4,6,,10,-77.35600000000001,0.81488
45959,2017,Octubre,Argentina,95,61,,156,-75.516486,10.446304
45960,2017,Octubre,Argentina,7,36,,43,-74.77647900000001,10.886686
45961,2017,Octubre,Argentina,17,67,,84,-76.532004,3.451668
45962,2017,Octubre,Argentina,1447,2251,,3698,-74.140516,4.697157
45963,2017,Octubre,Argentina,0,4,,4,-75.736374,4.815189
45964,2017,Octubre,Argentina,0,3,,3,-73.181317,7.1280470000000005
45965,2017,Octubre,Aruba,2,16,,18,-75.527794,10.406342
45966,2017,Octubre,Aruba,0,1,,1,-74.77647900000001,10.886686
45967,2017,Octubre,Aruba,1,2,,3,-74.765343,10.970933
45968,2017,Octubre,Aruba,21,28,,49,-74.213989,11.247722999999999
45969,2017,Octubre,Aruba,0,3,,3,-72.919186,11.52863
45970,2017,Octubre,Aruba,5,6,,11,-76.532004,3.451668
45971,2017,Octubre,Aruba,839,926,,1765,-74.140516,4.697157
45972,2017,Octubre,Aruba,1,0,,1,-75.736374,4.815189
45973,2017,Octubre,Aruba,14,17,,31,-73.181317,7.1280470000000005
45974,2017,Octubre,Australia,0,1,,1,-75.516486,10.446304
45975,2017,Octubre,Australia,3,5,,8,-76.532004,3.451668
45976,2017,Octubre,Austria,0,1,,1,-76.532004,3.451668
45977,2017,Octubre,Bahamas,0,1,,1,-75.527794,10.406342
45978,2017,Octubre,Bahamas,0,1,,1,-74.765343,10.970933
45979,2017,Octubre,Bahamas,1,2,,3,-74.140516,4.697157
45980,2017,Octubre,Bahréin,1,0,,1,-75.527794,10.406342
45981,2017,Octubre,Bahréin,1,0,,1,-75.516486,10.446304
45982,2017,Octubre,Bahréin,1,0,,1,-76.532004,3.451668
45983,2017,Octubre,Barbados,0,1,,1,-76.532004,3.451668
45984,2017,Octubre,Barbados,0,2,,2,-74.140516,4.697157
45985,2017,Octubre,República de Belarús,4,5,,9,-72.453013,7.819
45986,2017,Octubre,Bélgica,5,6,,11,-76.532004,3.451668
45987,2017,Octubre,Bélgica,0,1,,1,-75.736374,4.815189
45988,2017,Octubre,Belice,0,1,,1,-76.532004,3.451668
45989,2017,Octubre,Bermudas/Territorio Británico de Ultramar,3,6,,9,-75.527794,10.406342
45990,2017,Octubre,Bolivia,0,2,,2,-77.35600000000001,0.81488
45991,2017,Octubre,Bolivia,20,13,,33,-75.516486,10.446304
45992,2017,Octubre,Bolivia,19,30,,49,-76.532004,3.451668
45993,2017,Octubre,Bolivia,329,469,,798,-74.140516,4.697157
45994,2017,Octubre,Bolivia,0,10,,10,-75.42726,6.170465
45995,2017,Octubre,Bolivia,10,8,,18,-73.181317,7.1280470000000005
45996,2017,Octubre,Brasil,180,197,,377,-69.941498,4.191162
45997,2017,Octubre,Brasil,1,3,,4,-69.94143100000001,4.214082
45998,2017,Octubre,Brasil,6,1,,7,-77.35600000000001,0.81488
45999,2017,Octubre,Brasil,1,5,,6,-75.527794,10.406342
46000,2017,Octubre,Brasil,172,121,,293,-75.516486,10.446304
46001,2017,Octubre,Brasil,49,118,,167,-76.532004,3.451668
46002,2017,Octubre,Brasil,3,1,,4,-67.927521,3.866713
46003,2017,Octubre,Brasil,3319,4115,,7434,-74.140516,4.697157
46004,2017,Octubre,Brasil,4,6,,10,-75.736374,4.815189
46005,2017,Octubre,Brasil,0,5,,5,-75.42726,6.170465
46006,2017,Octubre,Brasil,0,1,,1,-73.181317,7.1280470000000005
46007,2017,Octubre,Bulgaria,0,1,,1,-75.736374,4.815189
46008,2017,Octubre,Islas Caimán/Territorio Británico de Ultramar,1,0,,1,-76.532004,3.451668
46009,2017,Octubre,Islas Caimán/Territorio Británico de Ultramar,0,5,,5,-74.140516,4.697157
46010,2017,Octubre,Canadá,1,2,,3,-75.516486,10.446304
46011,2017,Octubre,Canadá,1,13,,14,-74.77647900000001,10.886686
46012,2017,Octubre,Canadá,0,6,,6,-74.213989,11.247722999999999
46013,2017,Octubre,Canadá,51,55,,106,-76.532004,3.451668
46014,2017,Octubre,Canadá,0,1,,1,-77.061029,3.8844260000000004
46015,2017,Octubre,Canadá,7,25,,32,-74.140516,4.697157
46016,2017,Octubre,Canadá,2,2,,4,-75.736374,4.815189
46017,2017,Octubre,Canadá,0,8,,8,-75.42726,6.170465
46018,2017,Octubre,Canadá,2,1,,3,-73.181317,7.1280470000000005
46019,2017,Octubre,España,0,1,,1,-75.527794,10.406342
46020,2017,Octubre,España,1,0,,1,-75.516486,10.446304
46021,2017,Octubre,España,0,6,,6,-74.213989,11.247722999999999
46022,2017,Octubre,España,659,722,,1381,-76.532004,3.451668
46023,2017,Octubre,España,2642,4548,,7190,-74.140516,4.697157
46024,2017,Octubre,España,4,9,,13,-75.736374,4.815189
46025,2017,Octubre,España,401,877,,1278,-75.42726,6.170465
46026,2017,Octubre,España,1,1,,2,-73.181317,7.1280470000000005
46027,2017,Octubre,República de Corea,2,0,,2,-75.516486,10.446304
46028,2017,Octubre,República de Corea,2,3,,5,-76.532004,3.451668
46029,2017,Octubre,Costa Rica,15,14,,29,-75.527794,10.406342
46030,2017,Octubre,Costa Rica,12,9,,21,-75.516486,10.446304
46031,2017,Octubre,Costa Rica,51,44,,95,-76.532004,3.451668
46032,2017,Octubre,Costa Rica,1207,1637,,2844,-74.140516,4.697157
46033,2017,Octubre,Costa Rica,4,9,,13,-75.736374,4.815189
46034,2017,Octubre,Costa Rica,2,4,,6,-75.42726,6.170465
46035,2017,Octubre,Costa Rica,2,2,,4,-73.181317,7.1280470000000005
46036,2017,Octubre,Cuba,1,6,,7,-75.516486,10.446304
46037,2017,Octubre,Cuba,0,13,,13,-74.77647900000001,10.886686
46038,2017,Octubre,Cuba,0,4,,4,-81.70216500000001,12.5862
46039,2017,Octubre,Cuba,21,29,,50,-76.532004,3.451668
46040,2017,Octubre,Cuba,285,518,,803,-74.140516,4.697157
46041,2017,Octubre,Cuba,3,0,,3,-75.736374,4.815189
46042,2017,Octubre,Cuba,2,1,,3,-73.181317,7.1280470000000005
46043,2017,Octubre,Curazao,1,15,,16,-74.140516,4.697157
46044,2017,Octubre,República Checa,0,2,,2,-75.516486,10.446304
46045,2017,Octubre,República Checa,1,0,,1,-76.532004,3.451668
46046,2017,Octubre,Chile,1,8,,9,-77.35600000000001,0.81488
46047,2017,Octubre,Chile,32,26,,58,-75.516486,10.446304
46048,2017,Octubre,Chile,21,50,,71,-76.532004,3.451668
46049,2017,Octubre,Chile,4640,5190,,9830,-74.140516,4.697157
46050,2017,Octubre,Chile,6,8,,14,-75.736374,4.815189
46051,2017,Octubre,Chile,1,0,,1,-73.181317,7.1280470000000005
46052,2017,Octubre,China,1,0,,1,-76.532004,3.451668
46053,2017,Octubre,Dinamarca,1,1,,2,-76.532004,3.451668
46054,2017,Octubre,Ecuador,1,0,,1,-74.78366,0.18595699999999998
46055,2017,Octubre,Ecuador,141,454,,595,-76.876446,0.33002
46056,2017,Octubre,Ecuador,2,2,,4,-77.84700600000001,0.8124359999999999
46057,2017,Octubre,Ecuador,3929,5611,,9540,-77.35600000000001,0.81488
46058,2017,Octubre,Ecuador,32,166,,198,-78.802679,18.00143
46059,2017,Octubre,Ecuador,0,13,,13,-75.527794,10.406342
46060,2017,Octubre,Ecuador,7,10,,17,-75.516486,10.446304
46061,2017,Octubre,Ecuador,0,4,,4,-74.77647900000001,10.886686
46062,2017,Octubre,Ecuador,384,494,,878,-76.532004,3.451668
46063,2017,Octubre,Ecuador,0,4,,4,-77.061029,3.8844260000000004
46064,2017,Octubre,Ecuador,1029,1677,,2706,-74.140516,4.697157
46065,2017,Octubre,Ecuador,5,13,,18,-75.736374,4.815189
46066,2017,Octubre,Ecuador,0,7,,7,-75.42726,6.170465
46067,2017,Octubre,Ecuador,0,3,,3,-73.181317,7.1280470000000005
46068,2017,Octubre,El Salvador,0,2,,2,-75.516486,10.446304
46069,2017,Octubre,El Salvador,91,143,,234,-76.532004,3.451668
46070,2017,Octubre,El Salvador,1361,1936,,3297,-74.140516,4.697157
46071,2017,Octubre,El Salvador,3,2,,5,-75.736374,4.815189
46072,2017,Octubre,El Salvador,351,605,,956,-75.42726,6.170465
46073,2017,Octubre,Emiratos Árabes,1,1,,2,-76.532004,3.451668
46074,2017,Octubre,Emiratos Árabes,0,1,,1,-75.736374,4.815189
46075,2017,Octubre,Eslovaquia,0,1,,1,-76.532004,3.451668
46076,2017,Octubre,Eslovenia,0,1,,1,-76.532004,3.451668
46077,2017,Octubre,Estados Unidos de América,6,46,,52,-75.527794,10.406342
46078,2017,Octubre,Estados Unidos de América,1959,3124,,5083,-75.516486,10.446304
46079,2017,Octubre,Estados Unidos de América,430,870,,1300,-74.77647900000001,10.886686
46080,2017,Octubre,Estados Unidos de América,0,5,,5,-74.765343,10.970933
46081,2017,Octubre,Estados Unidos de América,0,23,,23,-74.213989,11.247722999999999
46082,2017,Octubre,Estados Unidos de América,900,1303,,2203,-76.532004,3.451668
46083,2017,Octubre,Estados Unidos de América,139,272,,411,-75.76635300000001,4.45285
46084,2017,Octubre,Estados Unidos de América,6957,13021,,19978,-74.140516,4.697157
46085,2017,Octubre,Estados Unidos de América,65,147,,212,-75.736374,4.815189
46086,2017,Octubre,Estados Unidos de América,1739,4597,,6336,-75.42726,6.170465
46087,2017,Octubre,Estados Unidos de América,15,37,,52,-73.181317,7.1280470000000005
46088,2017,Octubre,Estados Unidos de América,0,3,,3,-72.508188,7.927233
46089,2017,Octubre,Estados Unidos de América,0,5,,5,-75.68164200000001,9.402597
46090,2017,Octubre,Filipinas,0,2,,2,-75.516486,10.446304
46091,2017,Octubre,Filipinas,1,4,,5,-76.532004,3.451668
46092,2017,Octubre,Finlandia,1,1,,2,-76.532004,3.451668
46093,2017,Octubre,Finlandia,0,1,,1,-75.736374,4.815189
46094,2017,Octubre,Francia,2,4,,6,-75.516486,10.446304
46095,2017,Octubre,Francia,1,8,,9,-74.77647900000001,10.886686
46096,2017,Octubre,Francia,26,35,,61,-76.532004,3.451668
46097,2017,Octubre,Francia,1434,2115,,3549,-74.140516,4.697157
46098,2017,Octubre,Francia,2,2,,4,-75.736374,4.815189
46099,2017,Octubre,Francia,1,1,,2,-73.181317,7.1280470000000005
46100,2017,Octubre,Gibraltar/Territorio Británico de Ultramar,0,1,,1,-77.35600000000001,0.81488
46101,2017,Octubre,Granada,0,1,,1,-74.140516,4.697157
46102,2017,Octubre,Grecia,0,1,,1,-76.532004,3.451668
46103,2017,Octubre,Guatemala,0,1,,1,-75.527794,10.406342
46104,2017,Octubre,Guatemala,8,9,,17,-75.516486,10.446304
46105,2017,Octubre,Guatemala,0,1,,1,-74.213989,11.247722999999999
46106,2017,Octubre,Guatemala,29,67,,96,-76.532004,3.451668
46107,2017,Octubre,Guatemala,4,20,,24,-74.140516,4.697157
46108,2017,Octubre,Guatemala,6,15,,21,-75.736374,4.815189
46109,2017,Octubre,Guatemala,1,3,,4,-73.181317,7.1280470000000005
46110,2017,Octubre,Guyana,1,1,,2,-75.516486,10.446304
46111,2017,Octubre,Guyana,0,2,,2,-76.532004,3.451668
46112,2017,Octubre,Guadalupe/Territorio Francés,0,1,,1,-75.527794,10.406342
46113,2017,Octubre,Haití,0,11,,11,-75.527794,10.406342
46114,2017,Octubre,Honduras,9,5,,14,-75.516486,10.446304
46115,2017,Octubre,Honduras,1,5,,6,-81.703935,12.574411099999999
46116,2017,Octubre,Honduras,1,6,,7,-81.70216500000001,12.5862
46117,2017,Octubre,Honduras,10,15,,25,-76.532004,3.451668
46118,2017,Octubre,Honduras,1,1,,2,-75.736374,4.815189
46119,2017,Octubre,Honduras,0,1,,1,-73.181317,7.1280470000000005
46120,2017,Octubre,India,1,4,,5,-76.532004,3.451668
46121,2017,Octubre,República de Irlanda,0,1,,1,-74.765343,10.970933
46122,2017,Octubre,República de Irlanda,0,1,,1,-76.532004,3.451668
46123,2017,Octubre,Islandia,0,2,,2,-76.532004,3.451668
46124,2017,Octubre,Israel,0,2,,2,-76.532004,3.451668
46125,2017,Octubre,Italia,4,2,,6,-75.516486,10.446304
46126,2017,Octubre,Italia,9,28,,37,-76.532004,3.451668
46127,2017,Octubre,Italia,1,3,,4,-75.736374,4.815189
46128,2017,Octubre,Jamaica,0,10,,10,-75.527794,10.406342
46129,2017,Octubre,Jamaica,0,1,,1,-75.516486,10.446304
46130,2017,Octubre,Jamaica,0,1,,1,-81.703935,12.574411099999999
46131,2017,Octubre,Jamaica,0,1,,1,-74.140516,4.697157
46132,2017,Octubre,Jamaica,1,1,,2,-73.181317,7.1280470000000005
46133,2017,Octubre,Japón,1,2,,3,-76.532004,3.451668
46134,2017,Octubre,Kenia,0,1,,1,-76.532004,3.451668
46135,2017,Octubre,Letonia,0,1,,1,-76.532004,3.451668
46136,2017,Octubre,México,0,3,,3,-75.527794,10.406342
46137,2017,Octubre,México,31,60,,91,-75.516486,10.446304
46138,2017,Octubre,México,0,4,,4,-74.765343,10.970933
46139,2017,Octubre,México,0,1,,1,-74.213989,11.247722999999999
46140,2017,Octubre,México,117,196,,313,-76.532004,3.451668
46141,2017,Octubre,México,1,0,,1,-77.061029,3.8844260000000004
46142,2017,Octubre,México,4984,7764,,12748,-74.140516,4.697157
46143,2017,Octubre,México,11,67,,78,-75.736374,4.815189
46144,2017,Octubre,México,529,1185,,1714,-75.42726,6.170465
46145,2017,Octubre,México,7,13,,20,-73.181317,7.1280470000000005
46146,2017,Octubre,Nicaragua,1,0,,1,-75.516486,10.446304
46147,2017,Octubre,Nicaragua,0,2,,2,-81.703935,12.574411099999999
46148,2017,Octubre,Nicaragua,6,13,,19,-76.532004,3.451668
46149,2017,Octubre,Nicaragua,1,5,,6,-74.140516,4.697157
46150,2017,Octubre,Nicaragua,4,2,,6,-75.736374,4.815189
46151,2017,Octubre,Nicaragua,0,7,,7,-75.42726,6.170465
46152,2017,Octubre,Nicaragua,0,1,,1,-73.181317,7.1280470000000005
46153,2017,Octubre,Noruega,0,1,,1,-75.516486,10.446304
46154,2017,Octubre,Noruega,1,3,,4,-76.532004,3.451668
46155,2017,Octubre,Nueva Zelanda,4,3,,7,-76.532004,3.451668
46156,2017,Octubre,Panamá,1159,981,,2140,-75.527794,10.406342
46157,2017,Octubre,Panamá,4610,4652,,9262,-75.516486,10.446304
46158,2017,Octubre,Panamá,516,1046,,1562,-74.77647900000001,10.886686
46159,2017,Octubre,Panamá,0,28,,28,-74.765343,10.970933
46160,2017,Octubre,Panamá,0,10,,10,-74.213989,11.247722999999999
46161,2017,Octubre,Panamá,3,11,,14,-81.703935,12.574411099999999
46162,2017,Octubre,Panamá,1586,1211,,2797,-81.70216500000001,12.5862
46163,2017,Octubre,Panamá,0,7,,7,-81.372937,13.338761300000002
46164,2017,Octubre,Panamá,398,622,,1020,-76.532004,3.451668
46165,2017,Octubre,Panamá,0,9,,9,-77.061029,3.8844260000000004
46166,2017,Octubre,Panamá,69,94,,163,-75.76635300000001,4.45285
46167,2017,Octubre,Panamá,5651,8098,,13749,-74.140516,4.697157
46168,2017,Octubre,Panamá,65,126,,191,-75.736374,4.815189
46169,2017,Octubre,Panamá,2710,4731,,7441,-75.42726,6.170465
46170,2017,Octubre,Panamá,0,3,,3,-77.762647,7.102626
46171,2017,Octubre,Panamá,18,29,,47,-73.181317,7.1280470000000005
46172,2017,Octubre,Panamá,0,1,,1,-76.7333,8.06667
46173,2017,Octubre,Panamá,84,89,,173,-77.35002,8.63337
46174,2017,Octubre,Panamá,0,9,,9,-75.68164200000001,9.402597
46175,2017,Octubre,Paraguay,9,12,,21,-75.516486,10.446304
46176,2017,Octubre,Paraguay,9,20,,29,-76.532004,3.451668
46177,2017,Octubre,Paraguay,11,24,,35,-74.140516,4.697157
46178,2017,Octubre,Paraguay,3,3,,6,-75.736374,4.815189
46179,2017,Octubre,Paraguay,0,3,,3,-75.42726,6.170465
46180,2017,Octubre,Perú,71,108,,179,-69.941498,4.191162
46181,2017,Octubre,Perú,14,32,,46,-69.94143100000001,4.214082
46182,2017,Octubre,Perú,8,12,,20,-74.78366,0.18595699999999998
46183,2017,Octubre,Perú,47,68,,115,-77.35600000000001,0.81488
46184,2017,Octubre,Perú,1267,1003,,2270,-75.516486,10.446304
46185,2017,Octubre,Perú,0,1,,1,-74.77647900000001,10.886686
46186,2017,Octubre,Perú,349,497,,846,-76.532004,3.451668
46187,2017,Octubre,Perú,0,1,,1,-77.061029,3.8844260000000004
46188,2017,Octubre,Perú,3582,4659,,8241,-74.140516,4.697157
46189,2017,Octubre,Perú,2,9,,11,-75.736374,4.815189
46190,2017,Octubre,Perú,430,944,,1374,-75.42726,6.170465
46191,2017,Octubre,Perú,1,1,,2,-73.181317,7.1280470000000005
46192,2017,Octubre,Polonia,1,0,,1,-75.516486,10.446304
46193,2017,Octubre,Polonia,0,4,,4,-76.532004,3.451668
46194,2017,Octubre,Portugal,2,2,,4,-74.77647900000001,10.886686
46195,2017,Octubre,Portugal,2,5,,7,-76.532004,3.451668
46196,2017,Octubre,Portugal,9,20,,29,-74.140516,4.697157
46197,2017,Octubre,Puerto Rico/Territorio de Estados Unidos,0,3,,3,-75.516486,10.446304
46198,2017,Octubre,Puerto Rico/Territorio de Estados Unidos,0,3,,3,-74.765343,10.970933
46199,2017,Octubre,Puerto Rico/Territorio de Estados Unidos,36,49,,85,-76.532004,3.451668
46200,2017,Octubre,Puerto Rico/Territorio de Estados Unidos,31,47,,78,-74.140516,4.697157
46201,2017,Octubre,Puerto Rico/Territorio de Estados Unidos,2,4,,6,-75.736374,4.815189
46202,2017,Octubre,Puerto Rico/Territorio de Estados Unidos,0,33,,33,-75.42726,6.170465
46203,2017,Octubre,Puerto Rico/Territorio de Estados Unidos,3,2,,5,-73.181317,7.1280470000000005
46204,2017,Octubre,Reino Unido de Gran Bretaña e Irlanda del Norte,6,14,,20,-76.532004,3.451668
46205,2017,Octubre,Reino Unido de Gran Bretaña e Irlanda del Norte,741,1154,,1895,-74.140516,4.697157
46206,2017,Octubre,Reino Unido de Gran Bretaña e Irlanda del Norte,0,4,,4,-75.736374,4.815189
46207,2017,Octubre,Reino Unido de Gran Bretaña e Irlanda del Norte,1,5,,6,-75.42726,6.170465
46208,2017,Octubre,Federación de Rusia,1,1,,2,-76.532004,3.451668
46209,2017,Octubre,Federación de Rusia,0,1,,1,-73.181317,7.1280470000000005
46210,2017,Octubre,República Dominicana,2,14,,16,-75.527794,10.406342
46211,2017,Octubre,República Dominicana,2,7,,9,-75.516486,10.446304
46212,2017,Octubre,República Dominicana,0,2,,2,-74.77647900000001,10.886686
46213,2017,Octubre,República Dominicana,0,1,,1,-74.213989,11.247722999999999
46214,2017,Octubre,República Dominicana,21,35,,56,-76.532004,3.451668
46215,2017,Octubre,República Dominicana,683,800,,1483,-74.140516,4.697157
46216,2017,Octubre,República Dominicana,4,7,,11,-75.736374,4.815189
46217,2017,Octubre,República Dominicana,4,13,,17,-73.181317,7.1280470000000005
46218,2017,Octubre,República Dominicana,0,1,,1,-76.7333,8.06667
46219,2017,Octubre,San  Vicente y las Granadinas,0,1,,1,-74.140516,4.697157
46220,2017,Octubre,Santa Lucia,0,2,,2,-75.68164200000001,9.402597
46221,2017,Octubre,Senegal,0,7,,7,-74.765343,10.970933
46222,2017,Octubre,Singapur,0,3,,3,-76.532004,3.451668
46223,2017,Octubre,Sudáfrica,0,1,,1,-74.765343,10.970933
46224,2017,Octubre,Suecia,2,6,,8,-75.516486,10.446304
46225,2017,Octubre,Suecia,1,3,,4,-76.532004,3.451668
46226,2017,Octubre,Suecia,0,1,,1,-73.181317,7.1280470000000005
46227,2017,Octubre,Suiza,7,15,,22,-76.532004,3.451668
46228,2017,Octubre,Suiza,1,5,,6,-75.736374,4.815189
46229,2017,Octubre,Suiza,1,1,,2,-73.181317,7.1280470000000005
46230,2017,Octubre,Surinam,0,1,,1,-76.7333,8.06667
46231,2017,Octubre,Taiwán,0,6,,6,-76.532004,3.451668
46232,2017,Octubre,Trinidad y Tobago,1,3,,4,-76.532004,3.451668
46233,2017,Octubre,Trinidad y Tobago,0,7,,7,-74.140516,4.697157
46234,2017,Octubre,Trinidad y Tobago,0,1,,1,-75.736374,4.815189
46235,2017,Octubre,Trinidad y Tobago,0,1,,1,-73.181317,7.1280470000000005
46236,2017,Octubre,Turquía,2,2,,4,-76.532004,3.451668
46237,2017,Octubre,Turquía,233,371,,604,-74.140516,4.697157
46238,2017,Octubre,Ucrania,0,1,,1,-76.532004,3.451668
46239,2017,Octubre,Uruguay,18,6,,24,-75.516486,10.446304
46240,2017,Octubre,Uruguay,13,28,,41,-76.532004,3.451668
46241,2017,Octubre,Uruguay,5,10,,15,-74.140516,4.697157
46242,2017,Octubre,Venezuela,0,17,,17,-75.527794,10.406342
46243,2017,Octubre,Venezuela,3,18,,21,-75.516486,10.446304
46244,2017,Octubre,Venezuela,4,16,,20,-74.77647900000001,10.886686
46245,2017,Octubre,Venezuela,0,1,,1,-74.765343,10.970933
46246,2017,Octubre,Venezuela,0,5,,5,-74.232675,11.117206
46247,2017,Octubre,Venezuela,6655,7340,,13995,-72.129595,11.360028999999999
46248,2017,Octubre,Venezuela,12,50,,62,-76.532004,3.451668
46249,2017,Octubre,Venezuela,12,13,,25,-67.927521,3.866713
46250,2017,Octubre,Venezuela,173,354,,527,-74.140516,4.697157
46251,2017,Octubre,Venezuela,3,9,,12,-75.736374,4.815189
46252,2017,Octubre,Venezuela,526,646,,1172,-75.42726,6.170465
46253,2017,Octubre,Venezuela,15,24,,39,-67.48402800000001,6.185536
46254,2017,Octubre,Venezuela,202,283,,485,-70.74025300000001,7.088728999999999
46255,2017,Octubre,Venezuela,1,7,,8,-73.181317,7.1280470000000005
46256,2017,Octubre,Venezuela,22981,28522,,51503,-72.453013,7.819
46257,2017,Octubre,Venezuela,4,65,,69,-72.508188,7.927233
46258,2017,Octubre,Venezuela,665,747,,1412,-72.409396,8.36068
46259,2017,Octubre,Venezuela,0,7,,7,-75.68164200000001,9.402597
46260,2017,Noviembre,Afganistán,2,0,,2,-74.140516,4.697157
46261,2017,Noviembre,Albania,1,0,,1,-76.532004,3.451668
46262,2017,Noviembre,Alemania,0,1,,1,-77.35600000000001,0.81488
46263,2017,Noviembre,Alemania,0,4,,4,-75.527794,10.406342
46264,2017,Noviembre,Alemania,3,3,,6,-75.516486,10.446304
46265,2017,Noviembre,Alemania,8,4,,12,-74.77647900000001,10.886686
46266,2017,Noviembre,Alemania,4,5,,9,-81.70216500000001,12.5862
46267,2017,Noviembre,Alemania,22,22,,44,-76.532004,3.451668
46268,2017,Noviembre,Alemania,1440,2403,,3843,-74.140516,4.697157
46269,2017,Noviembre,Alemania,2,2,,4,-75.736374,4.815189
46270,2017,Noviembre,Alemania,27,61,,88,-75.42726,6.170465
46271,2017,Noviembre,Alemania,1,2,,3,-73.181317,7.1280470000000005
46272,2017,Noviembre,Andorra,0,2,,2,-74.140516,4.697157
46273,2017,Noviembre,Andorra,0,1,,1,-75.42726,6.170465
46274,2017,Noviembre,Antigua y Barbuda,0,4,,4,-75.527794,10.406342
46275,2017,Noviembre,Antigua y Barbuda,0,1,,1,-75.42726,6.170465
46276,2017,Noviembre,Países Bajos,15,256,,271,-75.527794,10.406342
46277,2017,Noviembre,Países Bajos,212,373,,585,-75.516486,10.446304
46278,2017,Noviembre,Países Bajos,4,12,,16,-74.77647900000001,10.886686
46279,2017,Noviembre,Países Bajos,0,1,,1,-74.765343,10.970933
46280,2017,Noviembre,Países Bajos,0,3,,3,-81.70216500000001,12.5862
46281,2017,Noviembre,Países Bajos,13,20,,33,-76.532004,3.451668
46282,2017,Noviembre,Países Bajos,1004,1411,,2415,-74.140516,4.697157
46283,2017,Noviembre,Países Bajos,2,6,,8,-75.736374,4.815189
46284,2017,Noviembre,Países Bajos,100,145,,245,-75.42726,6.170465
46285,2017,Noviembre,Arabia Saudita,0,2,,2,-74.140516,4.697157
46286,2017,Noviembre,Argelia,2,3,,5,-74.140516,4.697157
46287,2017,Noviembre,Argentina,4,6,,10,-77.35600000000001,0.81488
46288,2017,Noviembre,Argentina,126,88,,214,-75.516486,10.446304
46289,2017,Noviembre,Argentina,4,5,,9,-74.77647900000001,10.886686
46290,2017,Noviembre,Argentina,0,2,,2,-74.765343,10.970933
46291,2017,Noviembre,Argentina,157,95,,252,-81.70216500000001,12.5862
46292,2017,Noviembre,Argentina,36,70,,106,-76.532004,3.451668
46293,2017,Noviembre,Argentina,0,8,,8,-77.061029,3.8844260000000004
46294,2017,Noviembre,Argentina,3224,4160,,7384,-74.140516,4.697157
46295,2017,Noviembre,Argentina,9,13,,22,-75.736374,4.815189
46296,2017,Noviembre,Argentina,58,140,,198,-75.42726,6.170465
46297,2017,Noviembre,Argentina,0,1,,1,-73.181317,7.1280470000000005
46298,2017,Noviembre,Aruba,5,224,,229,-75.527794,10.406342
46299,2017,Noviembre,Aruba,0,1,,1,-75.516486,10.446304
46300,2017,Noviembre,Aruba,1,0,,1,-74.77647900000001,10.886686
46301,2017,Noviembre,Aruba,40,66,,106,-74.213989,11.247722999999999
46302,2017,Noviembre,Aruba,2,3,,5,-72.919186,11.52863
46303,2017,Noviembre,Aruba,0,1,,1,-71.983761,12.165168
46304,2017,Noviembre,Aruba,4,3,,7,-76.532004,3.451668
46305,2017,Noviembre,Aruba,673,844,,1517,-74.140516,4.697157
46306,2017,Noviembre,Aruba,1,3,,4,-75.736374,4.815189
46307,2017,Noviembre,Aruba,22,38,,60,-75.42726,6.170465
46308,2017,Noviembre,Aruba,6,6,,12,-73.181317,7.1280470000000005
46309,2017,Noviembre,Australia,1,0,,1,-77.35600000000001,0.81488
46310,2017,Noviembre,Australia,4,4,,8,-74.77647900000001,10.886686
46311,2017,Noviembre,Australia,0,1,,1,-81.70216500000001,12.5862
46312,2017,Noviembre,Australia,7,14,,21,-76.532004,3.451668
46313,2017,Noviembre,Australia,68,99,,167,-74.140516,4.697157
46314,2017,Noviembre,Australia,15,15,,30,-75.42726,6.170465
46315,2017,Noviembre,Australia,0,3,,3,-73.181317,7.1280470000000005
46316,2017,Noviembre,Austria,0,1,,1,-76.532004,3.451668
46317,2017,Noviembre,Austria,21,47,,68,-74.140516,4.697157
46318,2017,Noviembre,Austria,1,5,,6,-75.42726,6.170465
46319,2017,Noviembre,Azerbaiyán,1,0,,1,-74.140516,4.697157
46320,2017,Noviembre,Bahamas,12,22,,34,-75.527794,10.406342
46321,2017,Noviembre,Bahamas,3,3,,6,-75.516486,10.446304
46322,2017,Noviembre,Bahamas,0,2,,2,-74.77647900000001,10.886686
46323,2017,Noviembre,Bahamas,1,1,,2,-74.140516,4.697157
46324,2017,Noviembre,Bahamas,0,1,,1,-75.42726,6.170465
46325,2017,Noviembre,Bahréin,0,1,,1,-75.516486,10.446304
46326,2017,Noviembre,Bahréin,0,1,,1,-75.42726,6.170465
46327,2017,Noviembre,Bahréin,1,0,,1,-72.453013,7.819
46328,2017,Noviembre,Barbados,1,8,,9,-74.77647900000001,10.886686
46329,2017,Noviembre,Barbados,0,5,,5,-74.140516,4.697157
46330,2017,Noviembre,Barbados,0,1,,1,-75.42726,6.170465
46331,2017,Noviembre,República de Belarús,6,13,,19,-72.453013,7.819
46332,2017,Noviembre,Bélgica,0,2,,2,-75.516486,10.446304
46333,2017,Noviembre,Bélgica,0,1,,1,-74.77647900000001,10.886686
46334,2017,Noviembre,Bélgica,0,1,,1,-74.213989,11.247722999999999
46335,2017,Noviembre,Bélgica,6,9,,15,-76.532004,3.451668
46336,2017,Noviembre,Bélgica,44,68,,112,-74.140516,4.697157
46337,2017,Noviembre,Bélgica,9,10,,19,-75.42726,6.170465
46338,2017,Noviembre,Bélgica,1,0,,1,-72.409396,8.36068
46339,2017,Noviembre,Belice,1,1,,2,-74.77647900000001,10.886686
46340,2017,Noviembre,Belice,0,2,,2,-74.140516,4.697157
46341,2017,Noviembre,Belice,1,2,,3,-75.42726,6.170465
46342,2017,Noviembre,Benín,1,0,,1,-75.516486,10.446304
46343,2017,Noviembre,Benín,1,0,,1,-74.140516,4.697157
46344,2017,Noviembre,Bermudas/Territorio Británico de Ultramar,0,1,,1,-75.42726,6.170465
46345,2017,Noviembre,Bolivia,12,15,,27,-75.516486,10.446304
46346,2017,Noviembre,Bolivia,2,6,,8,-74.77647900000001,10.886686
46347,2017,Noviembre,Bolivia,14,8,,22,-81.70216500000001,12.5862
46348,2017,Noviembre,Bolivia,28,34,,62,-76.532004,3.451668
46349,2017,Noviembre,Bolivia,615,776,,1391,-74.140516,4.697157
46350,2017,Noviembre,Bolivia,64,64,,128,-75.42726,6.170465
46351,2017,Noviembre,Bosnia y Herzegovina,0,1,,1,-74.140516,4.697157
46352,2017,Noviembre,Brasil,145,163,,308,-69.941498,4.191162
46353,2017,Noviembre,Brasil,11,16,,27,-69.94143100000001,4.214082
46354,2017,Noviembre,Brasil,1,1,,2,-77.35600000000001,0.81488
46355,2017,Noviembre,Brasil,0,3,,3,-75.527794,10.406342
46356,2017,Noviembre,Brasil,110,95,,205,-75.516486,10.446304
46357,2017,Noviembre,Brasil,5,56,,61,-74.77647900000001,10.886686
46358,2017,Noviembre,Brasil,0,2,,2,-74.213989,11.247722999999999
46359,2017,Noviembre,Brasil,374,298,,672,-81.70216500000001,12.5862
46360,2017,Noviembre,Brasil,72,114,,186,-76.532004,3.451668
46361,2017,Noviembre,Brasil,2,1,,3,-67.927521,3.866713
46362,2017,Noviembre,Brasil,5119,6075,,11194,-74.140516,4.697157
46363,2017,Noviembre,Brasil,1,8,,9,-75.736374,4.815189
46364,2017,Noviembre,Brasil,116,238,,354,-75.42726,6.170465
46365,2017,Noviembre,Brasil,1,0,,1,-73.181317,7.1280470000000005
46366,2017,Noviembre,Bulgaria,2,3,,5,-74.140516,4.697157
46367,2017,Noviembre,Bulgaria,0,2,,2,-75.42726,6.170465
46368,2017,Noviembre,Islas Caimán/Territorio Británico de Ultramar,0,9,,9,-75.527794,10.406342
46369,2017,Noviembre,Islas Caimán/Territorio Británico de Ultramar,1,3,,4,-74.77647900000001,10.886686
46370,2017,Noviembre,Islas Caimán/Territorio Británico de Ultramar,0,1,,1,-81.372937,13.338761300000002
46371,2017,Noviembre,Islas Caimán/Territorio Británico de Ultramar,0,1,,1,-74.140516,4.697157
46372,2017,Noviembre,Camboya,0,1,,1,-74.140516,4.697157
46373,2017,Noviembre,Camerún,1,0,,1,-75.42726,6.170465
46374,2017,Noviembre,Canadá,16,27,,43,-75.516486,10.446304
46375,2017,Noviembre,Canadá,7,17,,24,-74.77647900000001,10.886686
46376,2017,Noviembre,Canadá,0,1,,1,-74.765343,10.970933
46377,2017,Noviembre,Canadá,0,1,,1,-81.70216500000001,12.5862
46378,2017,Noviembre,Canadá,48,54,,102,-76.532004,3.451668
46379,2017,Noviembre,Canadá,659,1047,,1706,-74.140516,4.697157
46380,2017,Noviembre,Canadá,1,7,,8,-75.736374,4.815189
46381,2017,Noviembre,Canadá,121,246,,367,-75.42726,6.170465
46382,2017,Noviembre,Canadá,6,6,,12,-73.181317,7.1280470000000005
46383,2017,Noviembre,España,2,4,,6,-75.516486,10.446304
46384,2017,Noviembre,España,3,4,,7,-74.77647900000001,10.886686
46385,2017,Noviembre,España,0,3,,3,-81.70216500000001,12.5862
46386,2017,Noviembre,España,787,951,,1738,-76.532004,3.451668
46387,2017,Noviembre,España,0,1,,1,-77.061029,3.8844260000000004
46388,2017,Noviembre,España,3622,6407,,10029,-74.140516,4.697157
46389,2017,Noviembre,España,3,5,,8,-75.736374,4.815189
46390,2017,Noviembre,España,322,676,,998,-75.42726,6.170465
46391,2017,Noviembre,España,0,1,,1,-73.181317,7.1280470000000005
46392,2017,Noviembre,República Del Congo,2,0,,2,-74.140516,4.697157
46393,2017,Noviembre,Comoras,0,1,,1,-74.140516,4.697157
46394,2017,Noviembre,República Democrática del Congo,1,0,,1,-74.140516,4.697157
46395,2017,Noviembre,República de Corea,1,1,,2,-75.516486,10.446304
46396,2017,Noviembre,República de Corea,0,1,,1,-76.532004,3.451668
46397,2017,Noviembre,República de Corea,9,33,,42,-74.140516,4.697157
46398,2017,Noviembre,República de Corea,2,5,,7,-75.42726,6.170465
46399,2017,Noviembre,Costa de Marfil,0,1,,1,-75.516486,10.446304
46400,2017,Noviembre,Costa de Marfil,3,8,,11,-74.140516,4.697157
46401,2017,Noviembre,Costa Rica,7,41,,48,-75.527794,10.406342
46402,2017,Noviembre,Costa Rica,7,5,,12,-75.516486,10.446304
46403,2017,Noviembre,Costa Rica,9,23,,32,-74.77647900000001,10.886686
46404,2017,Noviembre,Costa Rica,38,15,,53,-81.70216500000001,12.5862
46405,2017,Noviembre,Costa Rica,48,63,,111,-76.532004,3.451668
46406,2017,Noviembre,Costa Rica,1298,1960,,3258,-74.140516,4.697157
46407,2017,Noviembre,Costa Rica,4,6,,10,-75.736374,4.815189
46408,2017,Noviembre,Costa Rica,121,208,,329,-75.42726,6.170465
46409,2017,Noviembre,Costa Rica,0,4,,4,-73.181317,7.1280470000000005
46410,2017,Noviembre,Croacia,0,1,,1,-76.532004,3.451668
46411,2017,Noviembre,Croacia,2,11,,13,-74.140516,4.697157
46412,2017,Noviembre,Cuba,3,4,,7,-75.516486,10.446304
46413,2017,Noviembre,Cuba,9,12,,21,-74.77647900000001,10.886686
46414,2017,Noviembre,Cuba,1,1,,2,-81.70216500000001,12.5862
46415,2017,Noviembre,Cuba,12,14,,26,-76.532004,3.451668
46416,2017,Noviembre,Cuba,339,610,,949,-74.140516,4.697157
46417,2017,Noviembre,Cuba,1,2,,3,-75.736374,4.815189
46418,2017,Noviembre,Cuba,22,12,,34,-75.42726,6.170465
46419,2017,Noviembre,Cuba,1,4,,5,-73.181317,7.1280470000000005
46420,2017,Noviembre,Curazao,6,18,,24,-74.140516,4.697157
46421,2017,Noviembre,República Checa,13,23,,36,-74.140516,4.697157
46422,2017,Noviembre,República Checa,0,2,,2,-75.42726,6.170465
46423,2017,Noviembre,Chile,7,9,,16,-77.35600000000001,0.81488
46424,2017,Noviembre,Chile,51,28,,79,-75.516486,10.446304
46425,2017,Noviembre,Chile,3,6,,9,-74.77647900000001,10.886686
46426,2017,Noviembre,Chile,40,30,,70,-81.70216500000001,12.5862
46427,2017,Noviembre,Chile,37,68,,105,-76.532004,3.451668
46428,2017,Noviembre,Chile,5138,6235,,11373,-74.140516,4.697157
46429,2017,Noviembre,Chile,2,2,,4,-75.736374,4.815189
46430,2017,Noviembre,Chile,19,89,,108,-75.42726,6.170465
46431,2017,Noviembre,Chile,2,0,,2,-73.181317,7.1280470000000005
46432,2017,Noviembre,China,1,0,,1,-74.77647900000001,10.886686
46433,2017,Noviembre,China,2,3,,5,-76.532004,3.451668
46434,2017,Noviembre,China,25,69,,94,-74.140516,4.697157
46435,2017,Noviembre,China,0,2,,2,-75.736374,4.815189
46436,2017,Noviembre,China,5,19,,24,-75.42726,6.170465
46437,2017,Noviembre,Chipre,1,1,,2,-74.140516,4.697157
46438,2017,Noviembre,Dinamarca,0,3,,3,-76.532004,3.451668
46439,2017,Noviembre,Dinamarca,11,22,,33,-74.140516,4.697157
46440,2017,Noviembre,Dinamarca,1,1,,2,-75.736374,4.815189
46441,2017,Noviembre,Dinamarca,1,5,,6,-75.42726,6.170465
46442,2017,Noviembre,Dominica,1,1,,2,-74.140516,4.697157
46443,2017,Noviembre,Dominica,0,1,,1,-75.42726,6.170465
46444,2017,Noviembre,Ecuador,2,6,,8,-74.78366,0.18595699999999998
46445,2017,Noviembre,Ecuador,165,424,,589,-76.876446,0.33002
46446,2017,Noviembre,Ecuador,3,6,,9,-77.84700600000001,0.8124359999999999
46447,2017,Noviembre,Ecuador,4922,6346,,11268,-77.35600000000001,0.81488
46448,2017,Noviembre,Ecuador,34,114,,148,-78.802679,18.00143
46449,2017,Noviembre,Ecuador,15,12,,27,-75.516486,10.446304
46450,2017,Noviembre,Ecuador,1,13,,14,-74.77647900000001,10.886686
46451,2017,Noviembre,Ecuador,6,8,,14,-81.70216500000001,12.5862
46452,2017,Noviembre,Ecuador,493,563,,1056,-76.532004,3.451668
46453,2017,Noviembre,Ecuador,0,4,,4,-77.061029,3.8844260000000004
46454,2017,Noviembre,Ecuador,2798,4751,,7549,-74.140516,4.697157
46455,2017,Noviembre,Ecuador,2,7,,9,-75.736374,4.815189
46456,2017,Noviembre,Ecuador,41,64,,105,-75.42726,6.170465
46457,2017,Noviembre,Ecuador,1,1,,2,-73.181317,7.1280470000000005
46458,2017,Noviembre,Ecuador,1,0,,1,-72.453013,7.819
46459,2017,Noviembre,Egipto,0,1,,1,-76.532004,3.451668
46460,2017,Noviembre,Egipto,0,3,,3,-74.140516,4.697157
46461,2017,Noviembre,El Salvador,3,6,,9,-75.516486,10.446304
46462,2017,Noviembre,El Salvador,1,2,,3,-74.77647900000001,10.886686
46463,2017,Noviembre,El Salvador,0,4,,4,-74.232675,11.117206
46464,2017,Noviembre,El Salvador,2,2,,4,-81.70216500000001,12.5862
46465,2017,Noviembre,El Salvador,159,194,,353,-76.532004,3.451668
46466,2017,Noviembre,El Salvador,1164,1729,,2893,-74.140516,4.697157
46467,2017,Noviembre,El Salvador,0,3,,3,-75.736374,4.815189
46468,2017,Noviembre,El Salvador,206,394,,600,-75.42726,6.170465
46469,2017,Noviembre,Emiratos Árabes,1,0,,1,-74.77647900000001,10.886686
46470,2017,Noviembre,Emiratos Árabes,0,10,,10,-74.642361,4.253669
46471,2017,Noviembre,Emiratos Árabes,1,5,,6,-74.140516,4.697157
46472,2017,Noviembre,Emiratos Árabes,0,1,,1,-75.42726,6.170465
46473,2017,Noviembre,Eslovaquia,1,1,,2,-76.532004,3.451668
46474,2017,Noviembre,Eslovaquia,0,8,,8,-74.140516,4.697157
46475,2017,Noviembre,Eslovaquia,1,0,,1,-75.42726,6.170465
46476,2017,Noviembre,Eslovaquia,0,1,,1,-73.181317,7.1280470000000005
46477,2017,Noviembre,Eslovenia,6,8,,14,-74.140516,4.697157
46478,2017,Noviembre,Eslovenia,1,2,,3,-75.42726,6.170465
46479,2017,Noviembre,Estados Unidos de América,2,37,,39,-75.527794,10.406342
46480,2017,Noviembre,Estados Unidos de América,2370,3389,,5759,-75.516486,10.446304
46481,2017,Noviembre,Estados Unidos de América,544,1030,,1574,-74.77647900000001,10.886686
46482,2017,Noviembre,Estados Unidos de América,0,2,,2,-74.765343,10.970933
46483,2017,Noviembre,Estados Unidos de América,0,14,,14,-74.213989,11.247722999999999
46484,2017,Noviembre,Estados Unidos de América,0,2,,2,-81.703935,12.574411099999999
46485,2017,Noviembre,Estados Unidos de América,12,17,,29,-81.70216500000001,12.5862
46486,2017,Noviembre,Estados Unidos de América,984,1512,,2496,-76.532004,3.451668
46487,2017,Noviembre,Estados Unidos de América,92,152,,244,-75.76635300000001,4.45285
46488,2017,Noviembre,Estados Unidos de América,9500,16697,,26197,-74.140516,4.697157
46489,2017,Noviembre,Estados Unidos de América,91,127,,218,-75.736374,4.815189
46490,2017,Noviembre,Estados Unidos de América,2598,6302,,8900,-75.42726,6.170465
46491,2017,Noviembre,Estados Unidos de América,16,51,,67,-73.181317,7.1280470000000005
46492,2017,Noviembre,Estados Unidos de América,0,2,,2,-72.508188,7.927233
46493,2017,Noviembre,Estados Unidos de América,0,7,,7,-75.68164200000001,9.402597
46494,2017,Noviembre,Estonia,0,5,,5,-74.140516,4.697157
46495,2017,Noviembre,Estonia,1,0,,1,-75.42726,6.170465
46496,2017,Noviembre,Filipinas,0,1,,1,-75.527794,10.406342
46497,2017,Noviembre,Filipinas,0,3,,3,-75.516486,10.446304
46498,2017,Noviembre,Filipinas,0,2,,2,-76.532004,3.451668
46499,2017,Noviembre,Filipinas,0,1,,1,-77.061029,3.8844260000000004
46500,2017,Noviembre,Filipinas,3,6,,9,-74.140516,4.697157
46501,2017,Noviembre,Filipinas,1,1,,2,-75.42726,6.170465
46502,2017,Noviembre,Finlandia,0,1,,1,-75.516486,10.446304
46503,2017,Noviembre,Finlandia,5,9,,14,-74.140516,4.697157
46504,2017,Noviembre,Finlandia,1,2,,3,-75.42726,6.170465
46505,2017,Noviembre,Francia,3,3,,6,-75.516486,10.446304
46506,2017,Noviembre,Francia,1,6,,7,-74.77647900000001,10.886686
46507,2017,Noviembre,Francia,23,36,,59,-76.532004,3.451668
46508,2017,Noviembre,Francia,1527,2381,,3908,-74.140516,4.697157
46509,2017,Noviembre,Francia,39,53,,92,-75.42726,6.170465
46510,2017,Noviembre,Francia,0,1,,1,-73.181317,7.1280470000000005
46511,2017,Noviembre,Georgia,0,1,,1,-74.140516,4.697157
46512,2017,Noviembre,Ghana,0,1,,1,-74.140516,4.697157
46513,2017,Noviembre,Ghana,0,1,,1,-75.42726,6.170465
46514,2017,Noviembre,Gibraltar/Territorio Británico de Ultramar,2,4,,6,-77.35600000000001,0.81488
46515,2017,Noviembre,Gibraltar/Territorio Británico de Ultramar,0,4,,4,-75.527794,10.406342
46516,2017,Noviembre,Granada,0,2,,2,-74.77647900000001,10.886686
46517,2017,Noviembre,Granada,0,1,,1,-75.42726,6.170465
46518,2017,Noviembre,Grecia,2,6,,8,-76.532004,3.451668
46519,2017,Noviembre,Grecia,3,13,,16,-74.140516,4.697157
46520,2017,Noviembre,Grecia,1,0,,1,-75.42726,6.170465
46521,2017,Noviembre,Guatemala,14,9,,23,-75.516486,10.446304
46522,2017,Noviembre,Guatemala,4,8,,12,-74.77647900000001,10.886686
46523,2017,Noviembre,Guatemala,0,1,,1,-74.765343,10.970933
46524,2017,Noviembre,Guatemala,6,4,,10,-81.70216500000001,12.5862
46525,2017,Noviembre,Guatemala,1,1,,2,-81.372937,13.338761300000002
46526,2017,Noviembre,Guatemala,61,94,,155,-76.532004,3.451668
46527,2017,Noviembre,Guatemala,164,254,,418,-74.140516,4.697157
46528,2017,Noviembre,Guatemala,3,6,,9,-75.736374,4.815189
46529,2017,Noviembre,Guatemala,78,144,,222,-75.42726,6.170465
46530,2017,Noviembre,Guatemala,7,6,,13,-73.181317,7.1280470000000005
46531,2017,Noviembre,Guyana,0,2,,2,-81.70216500000001,12.5862
46532,2017,Noviembre,Guyana,0,1,,1,-76.532004,3.451668
46533,2017,Noviembre,Guyana,0,1,,1,-75.42726,6.170465
46534,2017,Noviembre,Guadalupe/Territorio Francés,0,1,,1,-75.516486,10.446304
46535,2017,Noviembre,Guadalupe/Territorio Francés,0,1,,1,-76.532004,3.451668
46536,2017,Noviembre,Guadalupe/Territorio Francés,0,1,,1,-74.140516,4.697157
46537,2017,Noviembre,Haití,0,1,,1,-75.527794,10.406342
46538,2017,Noviembre,Haití,1,2,,3,-74.140516,4.697157
46539,2017,Noviembre,Haití,0,1,,1,-75.42726,6.170465
46540,2017,Noviembre,Honduras,0,7,,7,-75.527794,10.406342
46541,2017,Noviembre,Honduras,1,1,,2,-75.516486,10.446304
46542,2017,Noviembre,Honduras,1,6,,7,-74.77647900000001,10.886686
46543,2017,Noviembre,Honduras,1,2,,3,-81.372937,13.338761300000002
46544,2017,Noviembre,Honduras,20,25,,45,-76.532004,3.451668
46545,2017,Noviembre,Honduras,41,66,,107,-74.140516,4.697157
46546,2017,Noviembre,Honduras,0,2,,2,-75.736374,4.815189
46547,2017,Noviembre,Honduras,25,47,,72,-75.42726,6.170465
46548,2017,Noviembre,Hong Kong,1,3,,4,-74.140516,4.697157
46549,2017,Noviembre,Hong Kong,0,2,,2,-75.42726,6.170465
46550,2017,Noviembre,Hungría,6,8,,14,-74.140516,4.697157
46551,2017,Noviembre,Hungría,1,0,,1,-75.42726,6.170465
46552,2017,Noviembre,India,0,1,,1,-75.516486,10.446304
46553,2017,Noviembre,India,0,2,,2,-74.77647900000001,10.886686
46554,2017,Noviembre,India,0,5,,5,-76.532004,3.451668
46555,2017,Noviembre,India,3,31,,34,-74.140516,4.697157
46556,2017,Noviembre,India,0,6,,6,-75.42726,6.170465
46557,2017,Noviembre,Indonesia,0,1,,1,-74.140516,4.697157
46558,2017,Noviembre,República de Irlanda,4,17,,21,-74.140516,4.697157
46559,2017,Noviembre,República de Irlanda,1,3,,4,-75.42726,6.170465
46560,2017,Noviembre,Islandia,1,0,,1,-74.140516,4.697157
46561,2017,Noviembre,Isla de Man,0,1,,1,-74.140516,4.697157
46562,2017,Noviembre,Israel,0,1,,1,-74.77647900000001,10.886686
46563,2017,Noviembre,Israel,1,2,,3,-76.532004,3.451668
46564,2017,Noviembre,Israel,17,69,,86,-74.140516,4.697157
46565,2017,Noviembre,Israel,0,2,,2,-75.42726,6.170465
46566,2017,Noviembre,Italia,3,7,,10,-75.516486,10.446304
46567,2017,Noviembre,Italia,1,2,,3,-74.77647900000001,10.886686
46568,2017,Noviembre,Italia,0,1,,1,-81.70216500000001,12.5862
46569,2017,Noviembre,Italia,10,40,,50,-76.532004,3.451668
46570,2017,Noviembre,Italia,89,218,,307,-74.140516,4.697157
46571,2017,Noviembre,Italia,0,4,,4,-75.736374,4.815189
46572,2017,Noviembre,Italia,17,58,,75,-75.42726,6.170465
46573,2017,Noviembre,Jamaica,0,8,,8,-75.527794,10.406342
46574,2017,Noviembre,Jamaica,0,3,,3,-75.516486,10.446304
46575,2017,Noviembre,Jamaica,0,3,,3,-74.77647900000001,10.886686
46576,2017,Noviembre,Jamaica,0,5,,5,-81.703935,12.574411099999999
46577,2017,Noviembre,Jamaica,1,1,,2,-76.532004,3.451668
46578,2017,Noviembre,Jamaica,7,13,,20,-74.140516,4.697157
46579,2017,Noviembre,Jamaica,0,2,,2,-75.736374,4.815189
46580,2017,Noviembre,Jamaica,1,5,,6,-75.42726,6.170465
46581,2017,Noviembre,Jamaica,0,6,,6,-75.68164200000001,9.402597
46582,2017,Noviembre,Japón,1,1,,2,-76.532004,3.451668
46583,2017,Noviembre,Japón,13,28,,41,-74.140516,4.697157
46584,2017,Noviembre,Japón,0,1,,1,-75.736374,4.815189
46585,2017,Noviembre,Japón,4,22,,26,-75.42726,6.170465
46586,2017,Noviembre,Jordania,1,1,,2,-74.140516,4.697157
46587,2017,Noviembre,Kazajistán,1,2,,3,-74.140516,4.697157
46588,2017,Noviembre,Kenia,0,1,,1,-74.140516,4.697157
46589,2017,Noviembre,Kenia,0,1,,1,-75.42726,6.170465
46590,2017,Noviembre,Letonia,6,1,,7,-74.140516,4.697157
46591,2017,Noviembre,Lituania,1,3,,4,-74.140516,4.697157
46592,2017,Noviembre,Líbano,1,0,,1,-76.532004,3.451668
46593,2017,Noviembre,Líbano,1,4,,5,-74.140516,4.697157
46594,2017,Noviembre,Luxemburgo,1,0,,1,-75.516486,10.446304
46595,2017,Noviembre,Luxemburgo,2,3,,5,-74.140516,4.697157
46596,2017,Noviembre,Malasia,4,2,,6,-74.140516,4.697157
46597,2017,Noviembre,Malasia,1,2,,3,-75.42726,6.170465
46598,2017,Noviembre,Malta,1,1,,2,-74.140516,4.697157
46599,2017,Noviembre,Marruecos,0,1,,1,-74.140516,4.697157
46600,2017,Noviembre,Mauritania,0,1,,1,-74.140516,4.697157
46601,2017,Noviembre,Martinica/Departamento de Ultramar Francés,0,1,,1,-75.527794,10.406342
46602,2017,Noviembre,Martinica/Departamento de Ultramar Francés,1,0,,1,-74.140516,4.697157
46603,2017,Noviembre,México,0,11,,11,-75.527794,10.406342
46604,2017,Noviembre,México,26,26,,52,-75.516486,10.446304
46605,2017,Noviembre,México,33,43,,76,-74.77647900000001,10.886686
46606,2017,Noviembre,México,0,6,,6,-74.213989,11.247722999999999
46607,2017,Noviembre,México,4,2,,6,-81.70216500000001,12.5862
46608,2017,Noviembre,México,86,186,,272,-76.532004,3.451668
46609,2017,Noviembre,México,0,1,,1,-77.061029,3.8844260000000004
46610,2017,Noviembre,México,5497,9295,,14792,-74.140516,4.697157
46611,2017,Noviembre,México,17,34,,51,-75.736374,4.815189
46612,2017,Noviembre,México,785,1788,,2573,-75.42726,6.170465
46613,2017,Noviembre,México,13,39,,52,-73.181317,7.1280470000000005
46614,2017,Noviembre,República de Moldavia,1,1,,2,-74.140516,4.697157
46615,2017,Noviembre,Mónaco,0,1,,1,-74.140516,4.697157
46616,2017,Noviembre,Mongolia,0,3,,3,-74.140516,4.697157
46617,2017,Noviembre,Montenegro,0,1,,1,-74.140516,4.697157
46618,2017,Noviembre,Nauru,1,1,,2,-74.140516,4.697157
46619,2017,Noviembre,Nepal,0,1,,1,-75.42726,6.170465
46620,2017,Noviembre,Nicaragua,1,0,,1,-75.516486,10.446304
46621,2017,Noviembre,Nicaragua,1,1,,2,-74.77647900000001,10.886686
46622,2017,Noviembre,Nicaragua,13,23,,36,-76.532004,3.451668
46623,2017,Noviembre,Nicaragua,37,46,,83,-74.140516,4.697157
46624,2017,Noviembre,Nicaragua,6,9,,15,-75.736374,4.815189
46625,2017,Noviembre,Nicaragua,13,54,,67,-75.42726,6.170465
46626,2017,Noviembre,Nicaragua,1,13,,14,-73.181317,7.1280470000000005
46627,2017,Noviembre,Nigeria,0,1,,1,-74.140516,4.697157
46628,2017,Noviembre,Noruega,1,2,,3,-76.532004,3.451668
46629,2017,Noviembre,Noruega,20,15,,35,-74.140516,4.697157
46630,2017,Noviembre,Noruega,1,2,,3,-75.42726,6.170465
46631,2017,Noviembre,Noruega,1,0,,1,-73.181317,7.1280470000000005
46632,2017,Noviembre,Nueva Caledonia/Territorio francés,0,1,,1,-76.876446,0.33002
46633,2017,Noviembre,Nueva Zelanda,0,1,,1,-76.532004,3.451668
46634,2017,Noviembre,Nueva Zelanda,11,13,,24,-74.140516,4.697157
46635,2017,Noviembre,Nueva Zelanda,0,4,,4,-75.42726,6.170465
46636,2017,Noviembre,Papúa Nueva Guinea,1,0,,1,-75.516486,10.446304
46637,2017,Noviembre,Panamá,988,950,,1938,-75.527794,10.406342
46638,2017,Noviembre,Panamá,4455,4436,,8891,-75.516486,10.446304
46639,2017,Noviembre,Panamá,407,828,,1235,-74.77647900000001,10.886686
46640,2017,Noviembre,Panamá,0,53,,53,-74.765343,10.970933
46641,2017,Noviembre,Panamá,2,4,,6,-74.213989,11.247722999999999
46642,2017,Noviembre,Panamá,8,26,,34,-81.703935,12.574411099999999
46643,2017,Noviembre,Panamá,834,642,,1476,-81.70216500000001,12.5862
46644,2017,Noviembre,Panamá,3,9,,12,-81.372937,13.338761300000002
46645,2017,Noviembre,Panamá,503,618,,1121,-76.532004,3.451668
46646,2017,Noviembre,Panamá,0,31,,31,-77.061029,3.8844260000000004
46647,2017,Noviembre,Panamá,73,71,,144,-75.76635300000001,4.45285
46648,2017,Noviembre,Panamá,5832,7803,,13635,-74.140516,4.697157
46649,2017,Noviembre,Panamá,106,141,,247,-75.736374,4.815189
46650,2017,Noviembre,Panamá,3580,4085,,7665,-75.42726,6.170465
46651,2017,Noviembre,Panamá,0,2,,2,-77.401154,6.222551999999999
46652,2017,Noviembre,Panamá,0,3,,3,-77.762647,7.102626
46653,2017,Noviembre,Panamá,31,41,,72,-73.181317,7.1280470000000005
46654,2017,Noviembre,Panamá,1,0,,1,-72.453013,7.819
46655,2017,Noviembre,Panamá,0,19,,19,-76.7333,8.06667
46656,2017,Noviembre,Panamá,87,95,,182,-77.35002,8.63337
46657,2017,Noviembre,Paraguay,6,6,,12,-75.516486,10.446304
46658,2017,Noviembre,Paraguay,5,11,,16,-74.77647900000001,10.886686
46659,2017,Noviembre,Paraguay,56,43,,99,-81.70216500000001,12.5862
46660,2017,Noviembre,Paraguay,4,16,,20,-76.532004,3.451668
46661,2017,Noviembre,Paraguay,83,116,,199,-74.140516,4.697157
46662,2017,Noviembre,Paraguay,1,2,,3,-75.736374,4.815189
46663,2017,Noviembre,Paraguay,11,32,,43,-75.42726,6.170465
46664,2017,Noviembre,Perú,49,55,,104,-69.941498,4.191162
46665,2017,Noviembre,Perú,103,138,,241,-69.94143100000001,4.214082
46666,2017,Noviembre,Perú,9,17,,26,-74.78366,0.18595699999999998
46667,2017,Noviembre,Perú,55,89,,144,-77.35600000000001,0.81488
46668,2017,Noviembre,Perú,0,1,,1,-75.527794,10.406342
46669,2017,Noviembre,Perú,1211,1003,,2214,-75.516486,10.446304
46670,2017,Noviembre,Perú,2,3,,5,-74.77647900000001,10.886686
46671,2017,Noviembre,Perú,122,63,,185,-81.70216500000001,12.5862
46672,2017,Noviembre,Perú,353,489,,842,-76.532004,3.451668
46673,2017,Noviembre,Perú,0,2,,2,-77.061029,3.8844260000000004
46674,2017,Noviembre,Perú,5844,8221,,14065,-74.140516,4.697157
46675,2017,Noviembre,Perú,4,5,,9,-75.736374,4.815189
46676,2017,Noviembre,Perú,398,844,,1242,-75.42726,6.170465
46677,2017,Noviembre,Perú,0,3,,3,-73.181317,7.1280470000000005
46678,2017,Noviembre,Polonia,2,1,,3,-75.516486,10.446304
46679,2017,Noviembre,Polonia,35,38,,73,-74.140516,4.697157
46680,2017,Noviembre,Polonia,2,4,,6,-75.42726,6.170465
46681,2017,Noviembre,Portugal,0,2,,2,-74.77647900000001,10.886686
46682,2017,Noviembre,Portugal,5,7,,12,-76.532004,3.451668
46683,2017,Noviembre,Portugal,48,81,,129,-74.140516,4.697157
46684,2017,Noviembre,Portugal,4,8,,12,-75.42726,6.170465
46685,2017,Noviembre,Puerto Rico/Territorio de Estados Unidos,0,1,,1,-75.527794,10.406342
46686,2017,Noviembre,Puerto Rico/Territorio de Estados Unidos,4,6,,10,-75.516486,10.446304
46687,2017,Noviembre,Puerto Rico/Territorio de Estados Unidos,1,11,,12,-74.77647900000001,10.886686
46688,2017,Noviembre,Puerto Rico/Territorio de Estados Unidos,0,2,,2,-81.70216500000001,12.5862
46689,2017,Noviembre,Puerto Rico/Territorio de Estados Unidos,10,28,,38,-76.532004,3.451668
46690,2017,Noviembre,Puerto Rico/Territorio de Estados Unidos,419,564,,983,-74.140516,4.697157
46691,2017,Noviembre,Puerto Rico/Territorio de Estados Unidos,7,13,,20,-75.736374,4.815189
46692,2017,Noviembre,Puerto Rico/Territorio de Estados Unidos,40,120,,160,-75.42726,6.170465
46693,2017,Noviembre,Puerto Rico/Territorio de Estados Unidos,0,4,,4,-73.181317,7.1280470000000005
46694,2017,Noviembre,Reino Unido de Gran Bretaña e Irlanda del Norte,4,2,,6,-75.516486,10.446304
46695,2017,Noviembre,Reino Unido de Gran Bretaña e Irlanda del Norte,0,3,,3,-74.77647900000001,10.886686
46696,2017,Noviembre,Reino Unido de Gran Bretaña e Irlanda del Norte,10,13,,23,-76.532004,3.451668
46697,2017,Noviembre,Reino Unido de Gran Bretaña e Irlanda del Norte,806,1554,,2360,-74.140516,4.697157
46698,2017,Noviembre,Reino Unido de Gran Bretaña e Irlanda del Norte,19,50,,69,-75.42726,6.170465
46699,2017,Noviembre,República CentroÁfricana,0,1,,1,-74.140516,4.697157
46700,2017,Noviembre,Federación de Rusia,0,1,,1,-75.516486,10.446304
46701,2017,Noviembre,Federación de Rusia,0,1,,1,-74.77647900000001,10.886686
46702,2017,Noviembre,Federación de Rusia,0,1,,1,-76.532004,3.451668
46703,2017,Noviembre,Federación de Rusia,17,26,,43,-74.140516,4.697157
46704,2017,Noviembre,Federación de Rusia,1,1,,2,-75.42726,6.170465
46705,2017,Noviembre,República Dominicana,0,9,,9,-75.527794,10.406342
46706,2017,Noviembre,República Dominicana,1,2,,3,-75.516486,10.446304
46707,2017,Noviembre,República Dominicana,48,111,,159,-74.77647900000001,10.886686
46708,2017,Noviembre,República Dominicana,0,2,,2,-74.765343,10.970933
46709,2017,Noviembre,República Dominicana,0,1,,1,-81.70216500000001,12.5862
46710,2017,Noviembre,República Dominicana,18,29,,47,-76.532004,3.451668
46711,2017,Noviembre,República Dominicana,865,1123,,1988,-74.140516,4.697157
46712,2017,Noviembre,República Dominicana,6,13,,19,-75.736374,4.815189
46713,2017,Noviembre,República Dominicana,103,136,,239,-75.42726,6.170465
46714,2017,Noviembre,República Dominicana,3,0,,3,-73.181317,7.1280470000000005
46715,2017,Noviembre,Rumania,1,1,,2,-76.532004,3.451668
46716,2017,Noviembre,Rumania,4,5,,9,-74.140516,4.697157
46717,2017,Noviembre,Rumania,0,2,,2,-75.42726,6.170465
46718,2017,Noviembre,San Cristóbal y Nevis,1,1,,2,-81.70216500000001,12.5862
46719,2017,Noviembre,San Cristóbal y Nevis,3,2,,5,-74.140516,4.697157
46720,2017,Noviembre,San  Vicente y las Granadinas,1,1,,2,-76.532004,3.451668
46721,2017,Noviembre,Santa Lucia,1,1,,2,-74.140516,4.697157
46722,2017,Noviembre,Santa Lucia,1,3,,4,-75.42726,6.170465
46723,2017,Noviembre,Santa Sede/Ciudad del Vaticano,0,3,,3,-74.140516,4.697157
46724,2017,Noviembre,Senegal,0,1,,1,-74.765343,10.970933
46725,2017,Noviembre,Senegal,1,0,,1,-76.532004,3.451668
46726,2017,Noviembre,Serbia,1,1,,2,-76.532004,3.451668
46727,2017,Noviembre,Serbia,0,1,,1,-74.140516,4.697157
46728,2017,Noviembre,Serbia,1,0,,1,-75.42726,6.170465
46729,2017,Noviembre,Singapur,2,1,,3,-76.532004,3.451668
46730,2017,Noviembre,Singapur,2,5,,7,-74.140516,4.697157
46731,2017,Noviembre,Singapur,1,1,,2,-75.42726,6.170465
46732,2017,Noviembre,Sri Lanka,0,1,,1,-74.140516,4.697157
46733,2017,Noviembre,Sri Lanka,0,1,,1,-75.42726,6.170465
46734,2017,Noviembre,Sudáfrica,1,1,,2,-74.77647900000001,10.886686
46735,2017,Noviembre,Sudáfrica,0,1,,1,-74.765343,10.970933
46736,2017,Noviembre,Sudáfrica,3,14,,17,-74.140516,4.697157
46737,2017,Noviembre,Sudáfrica,0,2,,2,-75.42726,6.170465
46738,2017,Noviembre,Suecia,1,0,,1,-75.516486,10.446304
46739,2017,Noviembre,Suecia,0,2,,2,-74.77647900000001,10.886686
46740,2017,Noviembre,Suecia,1,6,,7,-76.532004,3.451668
46741,2017,Noviembre,Suecia,23,41,,64,-74.140516,4.697157
46742,2017,Noviembre,Suecia,0,2,,2,-75.736374,4.815189
46743,2017,Noviembre,Suecia,2,8,,10,-75.42726,6.170465
46744,2017,Noviembre,Suecia,0,1,,1,-73.181317,7.1280470000000005
46745,2017,Noviembre,Suiza,1,1,,2,-81.70216500000001,12.5862
46746,2017,Noviembre,Suiza,7,7,,14,-76.532004,3.451668
46747,2017,Noviembre,Suiza,70,115,,185,-74.140516,4.697157
46748,2017,Noviembre,Suiza,17,31,,48,-75.42726,6.170465
46749,2017,Noviembre,Suiza,1,4,,5,-72.508188,7.927233
46750,2017,Noviembre,Surinam,4,2,,6,-74.140516,4.697157
46751,2017,Noviembre,Surinam,0,1,,1,-75.42726,6.170465
46752,2017,Noviembre,Taiwán,4,2,,6,-74.140516,4.697157
46753,2017,Noviembre,República de Tayikistán,0,1,,1,-74.140516,4.697157
46754,2017,Noviembre,Tailandia,2,4,,6,-74.140516,4.697157
46755,2017,Noviembre,Tailandia,2,2,,4,-75.42726,6.170465
46756,2017,Noviembre,Tanzania,1,0,,1,-74.140516,4.697157
46757,2017,Noviembre,Togo,0,1,,1,-75.42726,6.170465
46758,2017,Noviembre,Trinidad y Tobago,1,1,,2,-74.77647900000001,10.886686
46759,2017,Noviembre,Trinidad y Tobago,12,4,,16,-76.532004,3.451668
46760,2017,Noviembre,Trinidad y Tobago,2,10,,12,-74.140516,4.697157
46761,2017,Noviembre,Trinidad y Tobago,2,4,,6,-75.736374,4.815189
46762,2017,Noviembre,Trinidad y Tobago,4,14,,18,-75.42726,6.170465
46763,2017,Noviembre,Trinidad y Tobago,1,0,,1,-73.181317,7.1280470000000005
46764,2017,Noviembre,Túnez,2,3,,5,-74.140516,4.697157
46765,2017,Noviembre,Turkmenistán,5,0,,5,-74.140516,4.697157
46766,2017,Noviembre,Turquía,0,1,,1,-76.532004,3.451668
46767,2017,Noviembre,Turquía,231,353,,584,-74.140516,4.697157
46768,2017,Noviembre,Turquía,0,2,,2,-75.42726,6.170465
46769,2017,Noviembre,Ucrania,2,0,,2,-75.516486,10.446304
46770,2017,Noviembre,Ucrania,0,2,,2,-74.77647900000001,10.886686
46771,2017,Noviembre,Ucrania,0,1,,1,-76.532004,3.451668
46772,2017,Noviembre,Ucrania,3,4,,7,-74.140516,4.697157
46773,2017,Noviembre,Ucrania,1,0,,1,-75.42726,6.170465
46774,2017,Noviembre,Uganda,1,0,,1,-74.140516,4.697157
46775,2017,Noviembre,Uganda,0,1,,1,-75.42726,6.170465
46776,2017,Noviembre,Uruguay,0,2,,2,-77.35600000000001,0.81488
46777,2017,Noviembre,Uruguay,4,3,,7,-75.516486,10.446304
46778,2017,Noviembre,Uruguay,17,9,,26,-81.70216500000001,12.5862
46779,2017,Noviembre,Uruguay,21,24,,45,-76.532004,3.451668
46780,2017,Noviembre,Uruguay,233,356,,589,-74.140516,4.697157
46781,2017,Noviembre,Uruguay,0,1,,1,-75.736374,4.815189
46782,2017,Noviembre,Uruguay,8,41,,49,-75.42726,6.170465
46783,2017,Noviembre,Venezuela,0,4,,4,-75.527794,10.406342
46784,2017,Noviembre,Venezuela,4,16,,20,-75.516486,10.446304
46785,2017,Noviembre,Venezuela,19,78,,97,-74.77647900000001,10.886686
46786,2017,Noviembre,Venezuela,0,1,,1,-74.765343,10.970933
46787,2017,Noviembre,Venezuela,0,6,,6,-74.232675,11.117206
46788,2017,Noviembre,Venezuela,6550,7478,,14028,-72.129595,11.360028999999999
46789,2017,Noviembre,Venezuela,4,14,,18,-72.919186,11.52863
46790,2017,Noviembre,Venezuela,2,0,,2,-81.70216500000001,12.5862
46791,2017,Noviembre,Venezuela,29,52,,81,-76.532004,3.451668
46792,2017,Noviembre,Venezuela,15,14,,29,-67.927521,3.866713
46793,2017,Noviembre,Venezuela,2667,2949,,5616,-74.140516,4.697157
46794,2017,Noviembre,Venezuela,3,6,,9,-75.736374,4.815189
46795,2017,Noviembre,Venezuela,575,612,,1187,-75.42726,6.170465
46796,2017,Noviembre,Venezuela,53,47,,100,-67.48402800000001,6.185536
46797,2017,Noviembre,Venezuela,1,7,,8,-75.586989,6.2188349999999994
46798,2017,Noviembre,Venezuela,262,298,,560,-70.74025300000001,7.088728999999999
46799,2017,Noviembre,Venezuela,3,4,,7,-73.181317,7.1280470000000005
46800,2017,Noviembre,Venezuela,27470,33868,,61338,-72.453013,7.819
46801,2017,Noviembre,Venezuela,3,19,,22,-72.508188,7.927233
46802,2017,Noviembre,Venezuela,846,905,,1751,-72.409396,8.36068
46803,2017,Noviembre,Vietnam,3,1,,4,-74.140516,4.697157
46804,2017,Noviembre,Islas Vírgenes Británicas/Territorio Británico de Ultramar,0,1,,1,-74.140516,4.697157
46805,2017,Noviembre,Islas Vírgenes Británicas/Territorio Británico de Ultramar,3,1,,4,-75.42726,6.170465
46806,2017,Noviembre,Islas Vírgenes Estadounidenses/Territorio de Estados Unidos,0,7,,7,-74.140516,4.697157
46807,2017,Diciembre,Afganistán,0,2,,2,-74.140516,4.697157
46808,2017,Diciembre,Albania,0,1,,1,-74.140516,4.697157
46809,2017,Diciembre,Albania,0,2,,2,-75.42726,6.170465
46810,2017,Diciembre,Alemania,0,1,,1,-77.35600000000001,0.81488
46811,2017,Diciembre,Alemania,11,13,,24,-75.516486,10.446304
46812,2017,Diciembre,Alemania,8,9,,17,-74.77647900000001,10.886686
46813,2017,Diciembre,Alemania,3,5,,8,-81.70216500000001,12.5862
46814,2017,Diciembre,Alemania,37,57,,94,-76.532004,3.451668
46815,2017,Diciembre,Alemania,1547,2309,,3856,-74.140516,4.697157
46816,2017,Diciembre,Alemania,2,10,,12,-75.736374,4.815189
46817,2017,Diciembre,Alemania,57,102,,159,-75.42726,6.170465
46818,2017,Diciembre,Alemania,3,2,,5,-73.181317,7.1280470000000005
46819,2017,Diciembre,Andorra,2,2,,4,-75.42726,6.170465
46820,2017,Diciembre,Antigua y Barbuda,0,2,,2,-75.527794,10.406342
46821,2017,Diciembre,Antigua y Barbuda,2,1,,3,-76.532004,3.451668
46822,2017,Diciembre,Países Bajos,16,57,,73,-75.527794,10.406342
46823,2017,Diciembre,Países Bajos,253,396,,649,-75.516486,10.446304
46824,2017,Diciembre,Países Bajos,15,12,,27,-74.77647900000001,10.886686
46825,2017,Diciembre,Países Bajos,0,17,,17,-74.765343,10.970933
46826,2017,Diciembre,Países Bajos,2,4,,6,-81.70216500000001,12.5862
46827,2017,Diciembre,Países Bajos,1,1,,2,-81.372937,13.338761300000002
46828,2017,Diciembre,Países Bajos,31,43,,74,-76.532004,3.451668
46829,2017,Diciembre,Países Bajos,919,1369,,2288,-74.140516,4.697157
46830,2017,Diciembre,Países Bajos,2,8,,10,-75.736374,4.815189
46831,2017,Diciembre,Países Bajos,83,128,,211,-75.42726,6.170465
46832,2017,Diciembre,Países Bajos,2,2,,4,-75.586989,6.2188349999999994
46833,2017,Diciembre,Países Bajos,3,6,,9,-73.181317,7.1280470000000005
46834,2017,Diciembre,Arabia Saudita,0,2,,2,-74.140516,4.697157
46835,2017,Diciembre,Arabia Saudita,0,1,,1,-75.736374,4.815189
46836,2017,Diciembre,Arabia Saudita,0,1,,1,-75.42726,6.170465
46837,2017,Diciembre,Argelia,2,8,,10,-74.140516,4.697157
46838,2017,Diciembre,Argelia,0,1,,1,-75.42726,6.170465
46839,2017,Diciembre,Argentina,10,11,,21,-77.35600000000001,0.81488
46840,2017,Diciembre,Argentina,1,0,,1,-78.802679,18.00143
46841,2017,Diciembre,Argentina,0,3,,3,-75.527794,10.406342
46842,2017,Diciembre,Argentina,87,73,,160,-75.516486,10.446304
46843,2017,Diciembre,Argentina,11,14,,25,-74.77647900000001,10.886686
46844,2017,Diciembre,Argentina,208,196,,404,-81.70216500000001,12.5862
46845,2017,Diciembre,Argentina,68,93,,161,-76.532004,3.451668
46846,2017,Diciembre,Argentina,4682,5519,,10201,-74.140516,4.697157
46847,2017,Diciembre,Argentina,4,2,,6,-75.736374,4.815189
46848,2017,Diciembre,Argentina,74,127,,201,-75.42726,6.170465
46849,2017,Diciembre,Argentina,1,0,,1,-73.181317,7.1280470000000005
46850,2017,Diciembre,Aruba,9,6,,15,-75.527794,10.406342
46851,2017,Diciembre,Aruba,3,13,,16,-75.516486,10.446304
46852,2017,Diciembre,Aruba,0,1,,1,-74.77647900000001,10.886686
46853,2017,Diciembre,Aruba,29,33,,62,-74.213989,11.247722999999999
46854,2017,Diciembre,Aruba,0,4,,4,-71.983761,12.165168
46855,2017,Diciembre,Aruba,0,2,,2,-76.532004,3.451668
46856,2017,Diciembre,Aruba,886,1149,,2035,-74.140516,4.697157
46857,2017,Diciembre,Aruba,0,1,,1,-75.736374,4.815189
46858,2017,Diciembre,Aruba,23,36,,59,-75.42726,6.170465
46859,2017,Diciembre,Aruba,11,7,,18,-73.181317,7.1280470000000005
46860,2017,Diciembre,Australia,4,2,,6,-75.516486,10.446304
46861,2017,Diciembre,Australia,1,2,,3,-74.77647900000001,10.886686
46862,2017,Diciembre,Australia,0,1,,1,-81.70216500000001,12.5862
46863,2017,Diciembre,Australia,10,14,,24,-76.532004,3.451668
46864,2017,Diciembre,Australia,124,178,,302,-74.140516,4.697157
46865,2017,Diciembre,Australia,3,6,,9,-75.736374,4.815189
46866,2017,Diciembre,Australia,22,47,,69,-75.42726,6.170465
46867,2017,Diciembre,Australia,0,1,,1,-73.181317,7.1280470000000005
46868,2017,Diciembre,Austria,0,1,,1,-75.516486,10.446304
46869,2017,Diciembre,Austria,1,1,,2,-74.77647900000001,10.886686
46870,2017,Diciembre,Austria,0,1,,1,-81.70216500000001,12.5862
46871,2017,Diciembre,Austria,1,7,,8,-76.532004,3.451668
46872,2017,Diciembre,Austria,40,70,,110,-74.140516,4.697157
46873,2017,Diciembre,Austria,1,1,,2,-75.736374,4.815189
46874,2017,Diciembre,Austria,6,7,,13,-75.42726,6.170465
46875,2017,Diciembre,Bahamas,1,19,,20,-75.527794,10.406342
46876,2017,Diciembre,Bahamas,1,3,,4,-75.516486,10.446304
46877,2017,Diciembre,Bahamas,0,1,,1,-74.77647900000001,10.886686
46878,2017,Diciembre,Bahamas,2,0,,2,-76.532004,3.451668
46879,2017,Diciembre,Bahamas,1,4,,5,-74.140516,4.697157
46880,2017,Diciembre,Bahamas,0,1,,1,-75.736374,4.815189
46881,2017,Diciembre,Bahamas,0,4,,4,-75.42726,6.170465
46882,2017,Diciembre,Bahréin,2,0,,2,-75.516486,10.446304
46883,2017,Diciembre,Bahréin,0,1,,1,-72.129595,11.360028999999999
46884,2017,Diciembre,Bahréin,0,1,,1,-74.140516,4.697157
46885,2017,Diciembre,Bangladesh,1,0,,1,-74.140516,4.697157
46886,2017,Diciembre,Barbados,0,1,,1,-74.77647900000001,10.886686
46887,2017,Diciembre,Barbados,1,2,,3,-74.140516,4.697157
46888,2017,Diciembre,Barbados,1,0,,1,-75.736374,4.815189
46889,2017,Diciembre,Barbados,0,1,,1,-75.42726,6.170465
46890,2017,Diciembre,República de Belarús,2,0,,2,-72.129595,11.360028999999999
46891,2017,Diciembre,República de Belarús,0,1,,1,-72.409396,8.36068
46892,2017,Diciembre,Bélgica,0,1,,1,-75.527794,10.406342
46893,2017,Diciembre,Bélgica,0,2,,2,-75.516486,10.446304
46894,2017,Diciembre,Bélgica,0,1,,1,-81.70216500000001,12.5862
46895,2017,Diciembre,Bélgica,1,11,,12,-76.532004,3.451668
46896,2017,Diciembre,Bélgica,67,98,,165,-74.140516,4.697157
46897,2017,Diciembre,Bélgica,1,2,,3,-75.736374,4.815189
46898,2017,Diciembre,Bélgica,14,26,,40,-75.42726,6.170465
46899,2017,Diciembre,Bélgica,0,1,,1,-72.453013,7.819
46900,2017,Diciembre,Belice,5,2,,7,-74.140516,4.697157
46901,2017,Diciembre,Belice,0,1,,1,-75.42726,6.170465
46902,2017,Diciembre,Benín,0,1,,1,-74.140516,4.697157
46903,2017,Diciembre,Bermudas/Territorio Británico de Ultramar,0,1,,1,-75.736374,4.815189
46904,2017,Diciembre,Bolivia,1,1,,2,-77.35600000000001,0.81488
46905,2017,Diciembre,Bolivia,16,15,,31,-75.516486,10.446304
46906,2017,Diciembre,Bolivia,1,1,,2,-74.77647900000001,10.886686
46907,2017,Diciembre,Bolivia,28,22,,50,-81.70216500000001,12.5862
46908,2017,Diciembre,Bolivia,39,17,,56,-76.532004,3.451668
46909,2017,Diciembre,Bolivia,729,742,,1471,-74.140516,4.697157
46910,2017,Diciembre,Bolivia,1,3,,4,-75.736374,4.815189
46911,2017,Diciembre,Bolivia,67,66,,133,-75.42726,6.170465
46912,2017,Diciembre,Brasil,227,233,,460,-69.941498,4.191162
46913,2017,Diciembre,Brasil,23,26,,49,-69.94143100000001,4.214082
46914,2017,Diciembre,Brasil,3,1,,4,-77.35600000000001,0.81488
46915,2017,Diciembre,Brasil,0,7,,7,-75.527794,10.406342
46916,2017,Diciembre,Brasil,118,77,,195,-75.516486,10.446304
46917,2017,Diciembre,Brasil,3,5,,8,-74.77647900000001,10.886686
46918,2017,Diciembre,Brasil,0,1,,1,-74.213989,11.247722999999999
46919,2017,Diciembre,Brasil,296,220,,516,-81.70216500000001,12.5862
46920,2017,Diciembre,Brasil,56,49,,105,-76.532004,3.451668
46921,2017,Diciembre,Brasil,6797,7075,,13872,-74.140516,4.697157
46922,2017,Diciembre,Brasil,1,3,,4,-75.736374,4.815189
46923,2017,Diciembre,Brasil,92,135,,227,-75.42726,6.170465
46924,2017,Diciembre,Brasil,0,3,,3,-70.74025300000001,7.088728999999999
46925,2017,Diciembre,Brasil,3,1,,4,-73.181317,7.1280470000000005
46926,2017,Diciembre,Bulgaria,2,10,,12,-74.140516,4.697157
46927,2017,Diciembre,Bulgaria,0,2,,2,-75.42726,6.170465
46928,2017,Diciembre,Islas Caimán/Territorio Británico de Ultramar,3,21,,24,-75.527794,10.406342
46929,2017,Diciembre,Islas Caimán/Territorio Británico de Ultramar,2,3,,5,-75.516486,10.446304
46930,2017,Diciembre,Islas Caimán/Territorio Británico de Ultramar,1,1,,2,-81.703935,12.574411099999999
46931,2017,Diciembre,Islas Caimán/Territorio Británico de Ultramar,10,15,,25,-81.70216500000001,12.5862
46932,2017,Diciembre,Islas Caimán/Territorio Británico de Ultramar,0,1,,1,-75.736374,4.815189
46933,2017,Diciembre,Canadá,0,3,,3,-75.527794,10.406342
46934,2017,Diciembre,Canadá,357,400,,757,-75.516486,10.446304
46935,2017,Diciembre,Canadá,24,30,,54,-74.77647900000001,10.886686
46936,2017,Diciembre,Canadá,4,3,,7,-74.232675,11.117206
46937,2017,Diciembre,Canadá,135,138,,273,-81.70216500000001,12.5862
46938,2017,Diciembre,Canadá,110,138,,248,-76.532004,3.451668
46939,2017,Diciembre,Canadá,1,0,,1,-75.76635300000001,4.45285
46940,2017,Diciembre,Canadá,1301,1897,,3198,-74.140516,4.697157
46941,2017,Diciembre,Canadá,17,35,,52,-75.736374,4.815189
46942,2017,Diciembre,Canadá,198,372,,570,-75.42726,6.170465
46943,2017,Diciembre,Canadá,21,11,,32,-73.181317,7.1280470000000005
46944,2017,Diciembre,Canadá,0,3,,3,-75.68164200000001,9.402597
46945,2017,Diciembre,Chad,0,1,,1,-74.140516,4.697157
46946,2017,Diciembre,España,0,2,,2,-75.527794,10.406342
46947,2017,Diciembre,España,3,3,,6,-75.516486,10.446304
46948,2017,Diciembre,España,2,6,,8,-74.77647900000001,10.886686
46949,2017,Diciembre,España,0,1,,1,-74.765343,10.970933
46950,2017,Diciembre,España,0,3,,3,-74.213989,11.247722999999999
46951,2017,Diciembre,España,1,8,,9,-81.70216500000001,12.5862
46952,2017,Diciembre,España,910,1230,,2140,-76.532004,3.451668
46953,2017,Diciembre,España,4371,6933,,11304,-74.140516,4.697157
46954,2017,Diciembre,España,8,5,,13,-75.736374,4.815189
46955,2017,Diciembre,España,886,1369,,2255,-75.42726,6.170465
46956,2017,Diciembre,República Del Congo,1,0,,1,-74.140516,4.697157
46957,2017,Diciembre,República de Corea,0,1,,1,-74.77647900000001,10.886686
46958,2017,Diciembre,República de Corea,0,1,,1,-74.765343,10.970933
46959,2017,Diciembre,República de Corea,0,1,,1,-76.532004,3.451668
46960,2017,Diciembre,República de Corea,24,24,,48,-74.140516,4.697157
46961,2017,Diciembre,República de Corea,1,1,,2,-75.736374,4.815189
46962,2017,Diciembre,República de Corea,4,2,,6,-75.42726,6.170465
46963,2017,Diciembre,Costa de Marfil,7,10,,17,-74.140516,4.697157
46964,2017,Diciembre,Costa de Marfil,0,1,,1,-75.736374,4.815189
46965,2017,Diciembre,Costa Rica,8,15,,23,-75.527794,10.406342
46966,2017,Diciembre,Costa Rica,39,41,,80,-75.516486,10.446304
46967,2017,Diciembre,Costa Rica,26,22,,48,-74.77647900000001,10.886686
46968,2017,Diciembre,Costa Rica,0,1,,1,-81.703935,12.574411099999999
46969,2017,Diciembre,Costa Rica,73,61,,134,-81.70216500000001,12.5862
46970,2017,Diciembre,Costa Rica,91,70,,161,-76.532004,3.451668
46971,2017,Diciembre,Costa Rica,1692,2017,,3709,-74.140516,4.697157
46972,2017,Diciembre,Costa Rica,20,29,,49,-75.736374,4.815189
46973,2017,Diciembre,Costa Rica,230,274,,504,-75.42726,6.170465
46974,2017,Diciembre,Costa Rica,2,5,,7,-73.181317,7.1280470000000005
46975,2017,Diciembre,Croacia,0,1,,1,-76.532004,3.451668
46976,2017,Diciembre,Croacia,2,9,,11,-74.140516,4.697157
46977,2017,Diciembre,Croacia,0,2,,2,-75.42726,6.170465
46978,2017,Diciembre,Cuba,0,2,,2,-75.527794,10.406342
46979,2017,Diciembre,Cuba,4,4,,8,-75.516486,10.446304
46980,2017,Diciembre,Cuba,7,9,,16,-74.77647900000001,10.886686
46981,2017,Diciembre,Cuba,2,1,,3,-81.70216500000001,12.5862
46982,2017,Diciembre,Cuba,8,26,,34,-76.532004,3.451668
46983,2017,Diciembre,Cuba,543,865,,1408,-74.140516,4.697157
46984,2017,Diciembre,Cuba,0,1,,1,-75.736374,4.815189
46985,2017,Diciembre,Cuba,12,19,,31,-75.42726,6.170465
46986,2017,Diciembre,Cuba,2,1,,3,-73.181317,7.1280470000000005
46987,2017,Diciembre,Curazao,4,10,,14,-74.140516,4.697157
46988,2017,Diciembre,República Checa,7,9,,16,-74.140516,4.697157
46989,2017,Diciembre,República Checa,1,2,,3,-75.42726,6.170465
46990,2017,Diciembre,Chile,7,9,,16,-77.35600000000001,0.81488
46991,2017,Diciembre,Chile,40,37,,77,-75.516486,10.446304
46992,2017,Diciembre,Chile,0,1,,1,-74.77647900000001,10.886686
46993,2017,Diciembre,Chile,44,40,,84,-81.70216500000001,12.5862
46994,2017,Diciembre,Chile,46,68,,114,-76.532004,3.451668
46995,2017,Diciembre,Chile,0,1,,1,-77.061029,3.8844260000000004
46996,2017,Diciembre,Chile,4760,5917,,10677,-74.140516,4.697157
46997,2017,Diciembre,Chile,0,4,,4,-75.736374,4.815189
46998,2017,Diciembre,Chile,20,34,,54,-75.42726,6.170465
46999,2017,Diciembre,Chile,1,1,,2,-73.181317,7.1280470000000005
47000,2017,Diciembre,China,0,1,,1,-74.213989,11.247722999999999
47001,2017,Diciembre,China,0,2,,2,-76.532004,3.451668
47002,2017,Diciembre,China,19,60,,79,-74.140516,4.697157
47003,2017,Diciembre,China,2,6,,8,-75.42726,6.170465
47004,2017,Diciembre,Chipre,1,0,,1,-76.532004,3.451668
47005,2017,Diciembre,Chipre,1,2,,3,-74.140516,4.697157
47006,2017,Diciembre,Dinamarca,0,2,,2,-74.77647900000001,10.886686
47007,2017,Diciembre,Dinamarca,0,1,,1,-76.532004,3.451668
47008,2017,Diciembre,Dinamarca,46,57,,103,-74.140516,4.697157
47009,2017,Diciembre,Dinamarca,0,3,,3,-75.736374,4.815189
47010,2017,Diciembre,Dinamarca,4,5,,9,-75.42726,6.170465
47011,2017,Diciembre,Ecuador,219,464,,683,-76.876446,0.33002
47012,2017,Diciembre,Ecuador,5,24,,29,-77.84700600000001,0.8124359999999999
47013,2017,Diciembre,Ecuador,7261,9780,,17041,-77.35600000000001,0.81488
47014,2017,Diciembre,Ecuador,48,41,,89,-78.802679,18.00143
47015,2017,Diciembre,Ecuador,5,8,,13,-75.516486,10.446304
47016,2017,Diciembre,Ecuador,1,1,,2,-74.77647900000001,10.886686
47017,2017,Diciembre,Ecuador,16,12,,28,-81.70216500000001,12.5862
47018,2017,Diciembre,Ecuador,488,502,,990,-76.532004,3.451668
47019,2017,Diciembre,Ecuador,3529,4500,,8029,-74.140516,4.697157
47020,2017,Diciembre,Ecuador,0,1,,1,-75.736374,4.815189
47021,2017,Diciembre,Ecuador,16,32,,48,-75.42726,6.170465
47022,2017,Diciembre,Ecuador,0,1,,1,-72.453013,7.819
47023,2017,Diciembre,Egipto,0,3,,3,-74.140516,4.697157
47024,2017,Diciembre,El Salvador,3,2,,5,-75.516486,10.446304
47025,2017,Diciembre,El Salvador,2,4,,6,-74.77647900000001,10.886686
47026,2017,Diciembre,El Salvador,1,0,,1,-81.70216500000001,12.5862
47027,2017,Diciembre,El Salvador,183,256,,439,-76.532004,3.451668
47028,2017,Diciembre,El Salvador,878,1171,,2049,-74.140516,4.697157
47029,2017,Diciembre,El Salvador,0,1,,1,-75.736374,4.815189
47030,2017,Diciembre,El Salvador,232,319,,551,-75.42726,6.170465
47031,2017,Diciembre,El Salvador,0,2,,2,-73.181317,7.1280470000000005
47032,2017,Diciembre,Emiratos Árabes,14,14,,28,-74.140516,4.697157
47033,2017,Diciembre,Emiratos Árabes,0,1,,1,-75.42726,6.170465
47034,2017,Diciembre,Eritrea,0,1,,1,-74.140516,4.697157
47035,2017,Diciembre,Eslovaquia,7,6,,13,-74.140516,4.697157
47036,2017,Diciembre,Eslovaquia,1,0,,1,-75.42726,6.170465
47037,2017,Diciembre,Eslovenia,2,9,,11,-74.140516,4.697157
47038,2017,Diciembre,Estados Unidos de América,5,82,,87,-75.527794,10.406342
47039,2017,Diciembre,Estados Unidos de América,4599,6075,,10674,-75.516486,10.446304
47040,2017,Diciembre,Estados Unidos de América,825,1421,,2246,-74.77647900000001,10.886686
47041,2017,Diciembre,Estados Unidos de América,0,1,,1,-74.765343,10.970933
47042,2017,Diciembre,Estados Unidos de América,8,30,,38,-74.213989,11.247722999999999
47043,2017,Diciembre,Estados Unidos de América,68,80,,148,-81.70216500000001,12.5862
47044,2017,Diciembre,Estados Unidos de América,1645,2396,,4041,-76.532004,3.451668
47045,2017,Diciembre,Estados Unidos de América,0,2,,2,-77.061029,3.8844260000000004
47046,2017,Diciembre,Estados Unidos de América,158,231,,389,-75.76635300000001,4.45285
47047,2017,Diciembre,Estados Unidos de América,12548,20125,,32673,-74.140516,4.697157
47048,2017,Diciembre,Estados Unidos de América,269,352,,621,-75.736374,4.815189
47049,2017,Diciembre,Estados Unidos de América,3790,7183,,10973,-75.42726,6.170465
47050,2017,Diciembre,Estados Unidos de América,48,87,,135,-73.181317,7.1280470000000005
47051,2017,Diciembre,Estados Unidos de América,0,9,,9,-75.68164200000001,9.402597
47052,2017,Diciembre,Estonia,2,0,,2,-74.140516,4.697157
47053,2017,Diciembre,Etiopia,0,1,,1,-76.532004,3.451668
47054,2017,Diciembre,Filipinas,0,1,,1,-75.516486,10.446304
47055,2017,Diciembre,Filipinas,0,2,,2,-74.77647900000001,10.886686
47056,2017,Diciembre,Filipinas,0,4,,4,-76.532004,3.451668
47057,2017,Diciembre,Filipinas,0,3,,3,-77.061029,3.8844260000000004
47058,2017,Diciembre,Filipinas,3,9,,12,-74.140516,4.697157
47059,2017,Diciembre,Filipinas,0,1,,1,-73.181317,7.1280470000000005
47060,2017,Diciembre,Finlandia,1,2,,3,-75.516486,10.446304
47061,2017,Diciembre,Finlandia,1,4,,5,-76.532004,3.451668
47062,2017,Diciembre,Finlandia,16,21,,37,-74.140516,4.697157
47063,2017,Diciembre,Finlandia,2,0,,2,-75.42726,6.170465
47064,2017,Diciembre,Francia,6,11,,17,-75.516486,10.446304
47065,2017,Diciembre,Francia,4,6,,10,-74.77647900000001,10.886686
47066,2017,Diciembre,Francia,2,1,,3,-81.70216500000001,12.5862
47067,2017,Diciembre,Francia,37,80,,117,-76.532004,3.451668
47068,2017,Diciembre,Francia,1822,2772,,4594,-74.140516,4.697157
47069,2017,Diciembre,Francia,5,6,,11,-75.736374,4.815189
47070,2017,Diciembre,Francia,70,119,,189,-75.42726,6.170465
47071,2017,Diciembre,Francia,0,1,,1,-73.181317,7.1280470000000005
47072,2017,Diciembre,Ghana,0,1,,1,-74.140516,4.697157
47073,2017,Diciembre,Gibraltar/Territorio Británico de Ultramar,0,1,,1,-77.35600000000001,0.81488
47074,2017,Diciembre,Granada,205,144,,349,-74.213989,11.247722999999999
47075,2017,Diciembre,Grecia,0,2,,2,-75.516486,10.446304
47076,2017,Diciembre,Grecia,9,8,,17,-74.140516,4.697157
47077,2017,Diciembre,Grecia,0,1,,1,-75.42726,6.170465
47078,2017,Diciembre,Groenlandia,1,0,,1,-75.527794,10.406342
47079,2017,Diciembre,Guatemala,0,1,,1,-75.527794,10.406342
47080,2017,Diciembre,Guatemala,14,13,,27,-75.516486,10.446304
47081,2017,Diciembre,Guatemala,6,6,,12,-74.77647900000001,10.886686
47082,2017,Diciembre,Guatemala,7,10,,17,-81.70216500000001,12.5862
47083,2017,Diciembre,Guatemala,0,1,,1,-81.372937,13.338761300000002
47084,2017,Diciembre,Guatemala,38,49,,87,-76.532004,3.451668
47085,2017,Diciembre,Guatemala,0,1,,1,-77.061029,3.8844260000000004
47086,2017,Diciembre,Guatemala,549,678,,1227,-74.140516,4.697157
47087,2017,Diciembre,Guatemala,10,9,,19,-75.736374,4.815189
47088,2017,Diciembre,Guatemala,54,98,,152,-75.42726,6.170465
47089,2017,Diciembre,Guatemala,7,9,,16,-73.181317,7.1280470000000005
47090,2017,Diciembre,Guyana,0,2,,2,-74.140516,4.697157
47091,2017,Diciembre,Guyana,0,1,,1,-73.181317,7.1280470000000005
47092,2017,Diciembre,Guadalupe/Territorio Francés,1,1,,2,-75.527794,10.406342
47093,2017,Diciembre,Guadalupe/Territorio Francés,2,6,,8,-74.140516,4.697157
47094,2017,Diciembre,Guam/Territorio no incorporado de Estados Unidos,1,0,,1,-74.140516,4.697157
47095,2017,Diciembre,Haití,0,10,,10,-75.527794,10.406342
47096,2017,Diciembre,Haití,0,2,,2,-76.532004,3.451668
47097,2017,Diciembre,Haití,7,7,,14,-74.140516,4.697157
47098,2017,Diciembre,Haití,0,1,,1,-75.42726,6.170465
47099,2017,Diciembre,Honduras,8,6,,14,-75.516486,10.446304
47100,2017,Diciembre,Honduras,3,3,,6,-74.77647900000001,10.886686
47101,2017,Diciembre,Honduras,0,2,,2,-81.703935,12.574411099999999
47102,2017,Diciembre,Honduras,1,2,,3,-81.70216500000001,12.5862
47103,2017,Diciembre,Honduras,1,2,,3,-81.372937,13.338761300000002
47104,2017,Diciembre,Honduras,18,11,,29,-76.532004,3.451668
47105,2017,Diciembre,Honduras,82,73,,155,-74.140516,4.697157
47106,2017,Diciembre,Honduras,1,2,,3,-75.736374,4.815189
47107,2017,Diciembre,Honduras,27,38,,65,-75.42726,6.170465
47108,2017,Diciembre,Honduras,2,0,,2,-73.181317,7.1280470000000005
47109,2017,Diciembre,Hong Kong,0,2,,2,-75.516486,10.446304
47110,2017,Diciembre,Hong Kong,1,0,,1,-76.532004,3.451668
47111,2017,Diciembre,Hong Kong,4,7,,11,-74.140516,4.697157
47112,2017,Diciembre,Hong Kong,3,2,,5,-75.42726,6.170465
47113,2017,Diciembre,Hungría,1,1,,2,-75.516486,10.446304
47114,2017,Diciembre,Hungría,0,1,,1,-76.532004,3.451668
47115,2017,Diciembre,Hungría,7,16,,23,-74.140516,4.697157
47116,2017,Diciembre,India,0,3,,3,-74.77647900000001,10.886686
47117,2017,Diciembre,India,0,3,,3,-76.532004,3.451668
47118,2017,Diciembre,India,8,31,,39,-74.140516,4.697157
47119,2017,Diciembre,India,0,6,,6,-75.42726,6.170465
47120,2017,Diciembre,Indonesia,0,5,,5,-74.140516,4.697157
47121,2017,Diciembre,Indonesia,1,0,,1,-75.42726,6.170465
47122,2017,Diciembre,Irán,0,1,,1,-74.140516,4.697157
47123,2017,Diciembre,República de Irlanda,0,1,,1,-74.77647900000001,10.886686
47124,2017,Diciembre,República de Irlanda,1,2,,3,-76.532004,3.451668
47125,2017,Diciembre,República de Irlanda,12,25,,37,-74.140516,4.697157
47126,2017,Diciembre,República de Irlanda,3,11,,14,-75.42726,6.170465
47127,2017,Diciembre,Islandia,2,0,,2,-74.140516,4.697157
47128,2017,Diciembre,Israel,0,2,,2,-76.532004,3.451668
47129,2017,Diciembre,Israel,25,91,,116,-74.140516,4.697157
47130,2017,Diciembre,Israel,0,2,,2,-75.736374,4.815189
47131,2017,Diciembre,Israel,2,7,,9,-75.42726,6.170465
47132,2017,Diciembre,Italia,6,14,,20,-75.516486,10.446304
47133,2017,Diciembre,Italia,0,2,,2,-74.77647900000001,10.886686
47134,2017,Diciembre,Italia,2,3,,5,-81.70216500000001,12.5862
47135,2017,Diciembre,Italia,17,59,,76,-76.532004,3.451668
47136,2017,Diciembre,Italia,185,402,,587,-74.140516,4.697157
47137,2017,Diciembre,Italia,3,2,,5,-75.736374,4.815189
47138,2017,Diciembre,Italia,23,82,,105,-75.42726,6.170465
47139,2017,Diciembre,Islas Christmas,0,1,,1,-75.516486,10.446304
47140,2017,Diciembre,Jamaica,2,11,,13,-75.527794,10.406342
47141,2017,Diciembre,Jamaica,1,1,,2,-74.213989,11.247722999999999
47142,2017,Diciembre,Jamaica,1,1,,2,-81.70216500000001,12.5862
47143,2017,Diciembre,Jamaica,0,2,,2,-76.532004,3.451668
47144,2017,Diciembre,Jamaica,0,7,,7,-74.140516,4.697157
47145,2017,Diciembre,Jamaica,1,1,,2,-75.42726,6.170465
47146,2017,Diciembre,Japón,1,2,,3,-75.516486,10.446304
47147,2017,Diciembre,Japón,1,4,,5,-76.532004,3.451668
47148,2017,Diciembre,Japón,28,36,,64,-74.140516,4.697157
47149,2017,Diciembre,Japón,3,19,,22,-75.42726,6.170465
47150,2017,Diciembre,Japón,0,1,,1,-73.181317,7.1280470000000005
47151,2017,Diciembre,Jordania,0,1,,1,-77.35600000000001,0.81488
47152,2017,Diciembre,Jordania,0,4,,4,-74.140516,4.697157
47153,2017,Diciembre,Kazajistán,0,2,,2,-74.140516,4.697157
47154,2017,Diciembre,Kenia,2,4,,6,-74.140516,4.697157
47155,2017,Diciembre,Letonia,0,2,,2,-74.140516,4.697157
47156,2017,Diciembre,Letonia,0,1,,1,-75.736374,4.815189
47157,2017,Diciembre,Lituania,3,2,,5,-74.140516,4.697157
47158,2017,Diciembre,Lituania,2,0,,2,-75.42726,6.170465
47159,2017,Diciembre,Líbano,0,1,,1,-74.77647900000001,10.886686
47160,2017,Diciembre,Líbano,7,6,,13,-74.140516,4.697157
47161,2017,Diciembre,Libia,0,1,,1,-74.140516,4.697157
47162,2017,Diciembre,Liechtenstein,1,0,,1,-74.140516,4.697157
47163,2017,Diciembre,Luxemburgo,0,1,,1,-76.532004,3.451668
47164,2017,Diciembre,Luxemburgo,2,8,,10,-74.140516,4.697157
47165,2017,Diciembre,Luxemburgo,0,2,,2,-75.736374,4.815189
47166,2017,Diciembre,Madagascar,0,1,,1,-72.453013,7.819
47167,2017,Diciembre,Malasia,1,0,,1,-74.140516,4.697157
47168,2017,Diciembre,Malta,2,4,,6,-74.140516,4.697157
47169,2017,Diciembre,Marruecos,0,1,,1,-75.516486,10.446304
47170,2017,Diciembre,Marruecos,0,4,,4,-74.140516,4.697157
47171,2017,Diciembre,Marruecos,2,0,,2,-75.42726,6.170465
47172,2017,Diciembre,México,31,57,,88,-75.516486,10.446304
47173,2017,Diciembre,México,12,37,,49,-74.77647900000001,10.886686
47174,2017,Diciembre,México,0,4,,4,-74.765343,10.970933
47175,2017,Diciembre,México,5,6,,11,-81.70216500000001,12.5862
47176,2017,Diciembre,México,116,175,,291,-76.532004,3.451668
47177,2017,Diciembre,México,6275,9106,,15381,-74.140516,4.697157
47178,2017,Diciembre,México,17,33,,50,-75.736374,4.815189
47179,2017,Diciembre,México,774,1327,,2101,-75.42726,6.170465
47180,2017,Diciembre,México,9,15,,24,-73.181317,7.1280470000000005
47181,2017,Diciembre,Mónaco,0,1,,1,-74.140516,4.697157
47182,2017,Diciembre,Mónaco,0,1,,1,-75.42726,6.170465
47183,2017,Diciembre,Mozambique,0,2,,2,-74.140516,4.697157
47184,2017,Diciembre,Nicaragua,5,1,,6,-75.516486,10.446304
47185,2017,Diciembre,Nicaragua,2,2,,4,-74.77647900000001,10.886686
47186,2017,Diciembre,Nicaragua,1,1,,2,-81.703935,12.574411099999999
47187,2017,Diciembre,Nicaragua,21,17,,38,-76.532004,3.451668
47188,2017,Diciembre,Nicaragua,38,51,,89,-74.140516,4.697157
47189,2017,Diciembre,Nicaragua,8,9,,17,-75.736374,4.815189
47190,2017,Diciembre,Nicaragua,11,18,,29,-75.42726,6.170465
47191,2017,Diciembre,Nicaragua,4,8,,12,-73.181317,7.1280470000000005
47192,2017,Diciembre,Noruega,3,1,,4,-75.516486,10.446304
47193,2017,Diciembre,Noruega,6,11,,17,-76.532004,3.451668
47194,2017,Diciembre,Noruega,42,46,,88,-74.140516,4.697157
47195,2017,Diciembre,Noruega,1,1,,2,-75.736374,4.815189
47196,2017,Diciembre,Noruega,3,8,,11,-75.42726,6.170465
47197,2017,Diciembre,Nueva Zelanda,1,1,,2,-75.516486,10.446304
47198,2017,Diciembre,Nueva Zelanda,1,0,,1,-76.532004,3.451668
47199,2017,Diciembre,Nueva Zelanda,13,20,,33,-74.140516,4.697157
47200,2017,Diciembre,Nueva Zelanda,2,1,,3,-75.42726,6.170465
47201,2017,Diciembre,Omán,0,1,,1,-74.140516,4.697157
47202,2017,Diciembre,Papúa Nueva Guinea,0,1,,1,-74.77647900000001,10.886686
47203,2017,Diciembre,Pakistán,2,2,,4,-74.140516,4.697157
47204,2017,Diciembre,Palau,0,1,,1,-74.140516,4.697157
47205,2017,Diciembre,Panamá,723,747,,1470,-75.527794,10.406342
47206,2017,Diciembre,Panamá,4841,4940,,9781,-75.516486,10.446304
47207,2017,Diciembre,Panamá,332,640,,972,-74.77647900000001,10.886686
47208,2017,Diciembre,Panamá,0,32,,32,-74.765343,10.970933
47209,2017,Diciembre,Panamá,1,1,,2,-74.213989,11.247722999999999
47210,2017,Diciembre,Panamá,2,11,,13,-71.983761,12.165168
47211,2017,Diciembre,Panamá,8,15,,23,-81.703935,12.574411099999999
47212,2017,Diciembre,Panamá,384,324,,708,-81.70216500000001,12.5862
47213,2017,Diciembre,Panamá,1,1,,2,-81.372937,13.338761300000002
47214,2017,Diciembre,Panamá,494,729,,1223,-76.532004,3.451668
47215,2017,Diciembre,Panamá,0,22,,22,-77.061029,3.8844260000000004
47216,2017,Diciembre,Panamá,59,101,,160,-75.76635300000001,4.45285
47217,2017,Diciembre,Panamá,3859,5295,,9154,-74.140516,4.697157
47218,2017,Diciembre,Panamá,88,148,,236,-75.736374,4.815189
47219,2017,Diciembre,Panamá,2861,3865,,6726,-75.42726,6.170465
47220,2017,Diciembre,Panamá,1,0,,1,-77.401154,6.222551999999999
47221,2017,Diciembre,Panamá,12,10,,22,-77.762647,7.102626
47222,2017,Diciembre,Panamá,18,39,,57,-73.181317,7.1280470000000005
47223,2017,Diciembre,Panamá,2,3,,5,-76.7333,8.06667
47224,2017,Diciembre,Panamá,92,111,,203,-77.35002,8.63337
47225,2017,Diciembre,Paraguay,1,0,,1,-77.35600000000001,0.81488
47226,2017,Diciembre,Paraguay,7,5,,12,-75.516486,10.446304
47227,2017,Diciembre,Paraguay,1,0,,1,-74.77647900000001,10.886686
47228,2017,Diciembre,Paraguay,43,32,,75,-81.70216500000001,12.5862
47229,2017,Diciembre,Paraguay,7,1,,8,-76.532004,3.451668
47230,2017,Diciembre,Paraguay,58,58,,116,-74.140516,4.697157
47231,2017,Diciembre,Paraguay,2,0,,2,-75.736374,4.815189
47232,2017,Diciembre,Paraguay,6,5,,11,-75.42726,6.170465
47233,2017,Diciembre,Paraguay,0,1,,1,-73.181317,7.1280470000000005
47234,2017,Diciembre,Perú,24,31,,55,-69.941498,4.191162
47235,2017,Diciembre,Perú,117,141,,258,-69.94143100000001,4.214082
47236,2017,Diciembre,Perú,1,4,,5,-74.78366,0.18595699999999998
47237,2017,Diciembre,Perú,72,161,,233,-77.35600000000001,0.81488
47238,2017,Diciembre,Perú,1243,1006,,2249,-75.516486,10.446304
47239,2017,Diciembre,Perú,4,16,,20,-74.77647900000001,10.886686
47240,2017,Diciembre,Perú,255,180,,435,-81.70216500000001,12.5862
47241,2017,Diciembre,Perú,226,328,,554,-76.532004,3.451668
47242,2017,Diciembre,Perú,0,3,,3,-77.061029,3.8844260000000004
47243,2017,Diciembre,Perú,6119,7516,,13635,-74.140516,4.697157
47244,2017,Diciembre,Perú,4,5,,9,-75.736374,4.815189
47245,2017,Diciembre,Perú,408,697,,1105,-75.42726,6.170465
47246,2017,Diciembre,Perú,0,2,,2,-73.181317,7.1280470000000005
47247,2017,Diciembre,Polonia,1,0,,1,-75.516486,10.446304
47248,2017,Diciembre,Polonia,0,3,,3,-76.532004,3.451668
47249,2017,Diciembre,Polonia,22,17,,39,-74.140516,4.697157
47250,2017,Diciembre,Polonia,1,4,,5,-75.42726,6.170465
47251,2017,Diciembre,Portugal,0,1,,1,-74.77647900000001,10.886686
47252,2017,Diciembre,Portugal,1,0,,1,-81.70216500000001,12.5862
47253,2017,Diciembre,Portugal,1,1,,2,-76.532004,3.451668
47254,2017,Diciembre,Portugal,41,58,,99,-74.140516,4.697157
47255,2017,Diciembre,Portugal,3,9,,12,-75.42726,6.170465
47256,2017,Diciembre,Polinesia Francesa/Colectividad de Ultramar Francesa,1,1,,2,-76.532004,3.451668
47257,2017,Diciembre,Polinesia Francesa/Colectividad de Ultramar Francesa,1,2,,3,-74.140516,4.697157
47258,2017,Diciembre,Puerto Rico/Territorio de Estados Unidos,0,1,,1,-75.527794,10.406342
47259,2017,Diciembre,Puerto Rico/Territorio de Estados Unidos,1,2,,3,-75.516486,10.446304
47260,2017,Diciembre,Puerto Rico/Territorio de Estados Unidos,8,37,,45,-74.77647900000001,10.886686
47261,2017,Diciembre,Puerto Rico/Territorio de Estados Unidos,1,4,,5,-81.70216500000001,12.5862
47262,2017,Diciembre,Puerto Rico/Territorio de Estados Unidos,22,100,,122,-76.532004,3.451668
47263,2017,Diciembre,Puerto Rico/Territorio de Estados Unidos,531,875,,1406,-74.140516,4.697157
47264,2017,Diciembre,Puerto Rico/Territorio de Estados Unidos,5,9,,14,-75.736374,4.815189
47265,2017,Diciembre,Puerto Rico/Territorio de Estados Unidos,53,120,,173,-75.42726,6.170465
47266,2017,Diciembre,Puerto Rico/Territorio de Estados Unidos,3,4,,7,-73.181317,7.1280470000000005
47267,2017,Diciembre,Qatar,1,0,,1,-76.532004,3.451668
47268,2017,Diciembre,Qatar,0,1,,1,-74.140516,4.697157
47269,2017,Diciembre,Reino Unido de Gran Bretaña e Irlanda del Norte,0,9,,9,-75.516486,10.446304
47270,2017,Diciembre,Reino Unido de Gran Bretaña e Irlanda del Norte,1,1,,2,-74.77647900000001,10.886686
47271,2017,Diciembre,Reino Unido de Gran Bretaña e Irlanda del Norte,24,28,,52,-76.532004,3.451668
47272,2017,Diciembre,Reino Unido de Gran Bretaña e Irlanda del Norte,1070,1791,,2861,-74.140516,4.697157
47273,2017,Diciembre,Reino Unido de Gran Bretaña e Irlanda del Norte,0,2,,2,-75.736374,4.815189
47274,2017,Diciembre,Reino Unido de Gran Bretaña e Irlanda del Norte,52,93,,145,-75.42726,6.170465
47275,2017,Diciembre,República CentroÁfricana,0,3,,3,-75.516486,10.446304
47276,2017,Diciembre,República CentroÁfricana,2,1,,3,-74.140516,4.697157
47277,2017,Diciembre,Federación de Rusia,0,2,,2,-74.77647900000001,10.886686
47278,2017,Diciembre,Federación de Rusia,1,2,,3,-81.70216500000001,12.5862
47279,2017,Diciembre,Federación de Rusia,2,1,,3,-76.532004,3.451668
47280,2017,Diciembre,Federación de Rusia,25,48,,73,-74.140516,4.697157
47281,2017,Diciembre,Federación de Rusia,4,3,,7,-75.42726,6.170465
47282,2017,Diciembre,República Dominicana,0,8,,8,-75.527794,10.406342
47283,2017,Diciembre,República Dominicana,3,6,,9,-75.516486,10.446304
47284,2017,Diciembre,República Dominicana,4,25,,29,-74.77647900000001,10.886686
47285,2017,Diciembre,República Dominicana,0,6,,6,-74.765343,10.970933
47286,2017,Diciembre,República Dominicana,1,2,,3,-74.232675,11.117206
47287,2017,Diciembre,República Dominicana,7,42,,49,-76.532004,3.451668
47288,2017,Diciembre,República Dominicana,826,1032,,1858,-74.140516,4.697157
47289,2017,Diciembre,República Dominicana,5,7,,12,-75.736374,4.815189
47290,2017,Diciembre,República Dominicana,41,61,,102,-75.42726,6.170465
47291,2017,Diciembre,República Dominicana,1,3,,4,-73.181317,7.1280470000000005
47292,2017,Diciembre,Rumania,9,10,,19,-74.140516,4.697157
47293,2017,Diciembre,Rumania,1,2,,3,-75.42726,6.170465
47294,2017,Diciembre,Sahara Occidental/Desierto Sahara,1,0,,1,-75.516486,10.446304
47295,2017,Diciembre,San Cristóbal y Nevis,1,0,,1,-74.140516,4.697157
47296,2017,Diciembre,San Cristóbal y Nevis,1,1,,2,-73.181317,7.1280470000000005
47297,2017,Diciembre,San Marino,0,2,,2,-74.77647900000001,10.886686
47298,2017,Diciembre,San  Vicente y las Granadinas,0,1,,1,-75.516486,10.446304
47299,2017,Diciembre,San  Vicente y las Granadinas,0,2,,2,-74.213989,11.247722999999999
47300,2017,Diciembre,Santa Elena/Territorio Británico de Ultramar,0,1,,1,-74.140516,4.697157
47301,2017,Diciembre,Santa Lucia,0,2,,2,-75.527794,10.406342
47302,2017,Diciembre,Santo Tomé y Príncipe,0,1,,1,-75.527794,10.406342
47303,2017,Diciembre,Senegal,0,1,,1,-74.140516,4.697157
47304,2017,Diciembre,Senegal,0,1,,1,-75.42726,6.170465
47305,2017,Diciembre,Serbia,0,2,,2,-74.140516,4.697157
47306,2017,Diciembre,Singapur,5,7,,12,-74.140516,4.697157
47307,2017,Diciembre,República Árabe Siria,0,1,,1,-74.140516,4.697157
47308,2017,Diciembre,Sudáfrica,0,1,,1,-75.516486,10.446304
47309,2017,Diciembre,Sudáfrica,13,8,,21,-74.140516,4.697157
47310,2017,Diciembre,Sudáfrica,1,0,,1,-75.42726,6.170465
47311,2017,Diciembre,Suecia,0,2,,2,-75.516486,10.446304
47312,2017,Diciembre,Suecia,2,2,,4,-74.77647900000001,10.886686
47313,2017,Diciembre,Suecia,19,24,,43,-76.532004,3.451668
47314,2017,Diciembre,Suecia,78,113,,191,-74.140516,4.697157
47315,2017,Diciembre,Suecia,2,2,,4,-75.736374,4.815189
47316,2017,Diciembre,Suecia,21,22,,43,-75.42726,6.170465
47317,2017,Diciembre,Suecia,1,1,,2,-73.181317,7.1280470000000005
47318,2017,Diciembre,Suiza,1,2,,3,-75.516486,10.446304
47319,2017,Diciembre,Suiza,3,6,,9,-74.77647900000001,10.886686
47320,2017,Diciembre,Suiza,0,1,,1,-74.765343,10.970933
47321,2017,Diciembre,Suiza,16,46,,62,-76.532004,3.451668
47322,2017,Diciembre,Suiza,203,278,,481,-74.140516,4.697157
47323,2017,Diciembre,Suiza,0,1,,1,-75.736374,4.815189
47324,2017,Diciembre,Suiza,31,60,,91,-75.42726,6.170465
47325,2017,Diciembre,Surinam,0,1,,1,-74.765343,10.970933
47326,2017,Diciembre,Surinam,2,5,,7,-74.140516,4.697157
47327,2017,Diciembre,Surinam,0,5,,5,-75.42726,6.170465
47328,2017,Diciembre,Taiwán,4,3,,7,-74.140516,4.697157
47329,2017,Diciembre,Taiwán,0,1,,1,-75.42726,6.170465
47330,2017,Diciembre,Tailandia,0,1,,1,-76.532004,3.451668
47331,2017,Diciembre,Tanzania,3,2,,5,-74.140516,4.697157
47332,2017,Diciembre,Trinidad y Tobago,0,2,,2,-75.527794,10.406342
47333,2017,Diciembre,Trinidad y Tobago,0,1,,1,-74.77647900000001,10.886686
47334,2017,Diciembre,Trinidad y Tobago,15,15,,30,-76.532004,3.451668
47335,2017,Diciembre,Trinidad y Tobago,5,6,,11,-74.140516,4.697157
47336,2017,Diciembre,Trinidad y Tobago,0,3,,3,-75.736374,4.815189
47337,2017,Diciembre,Trinidad y Tobago,2,14,,16,-75.42726,6.170465
47338,2017,Diciembre,Trinidad y Tobago,0,3,,3,-73.181317,7.1280470000000005
47339,2017,Diciembre,Trinidad y Tobago,0,1,,1,-75.68164200000001,9.402597
47340,2017,Diciembre,Túnez,2,3,,5,-74.140516,4.697157
47341,2017,Diciembre,Túnez,1,0,,1,-75.42726,6.170465
47342,2017,Diciembre,Turkmenistán,0,2,,2,-74.140516,4.697157
47343,2017,Diciembre,Turquía,1,1,,2,-75.516486,10.446304
47344,2017,Diciembre,Turquía,0,1,,1,-76.532004,3.451668
47345,2017,Diciembre,Turquía,351,517,,868,-74.140516,4.697157
47346,2017,Diciembre,Turquía,0,1,,1,-75.42726,6.170465
47347,2017,Diciembre,Ucrania,0,1,,1,-74.77647900000001,10.886686
47348,2017,Diciembre,Ucrania,7,7,,14,-74.140516,4.697157
47349,2017,Diciembre,Uganda,1,0,,1,-74.140516,4.697157
47350,2017,Diciembre,Uruguay,0,1,,1,-77.35600000000001,0.81488
47351,2017,Diciembre,Uruguay,4,6,,10,-75.516486,10.446304
47352,2017,Diciembre,Uruguay,0,3,,3,-74.77647900000001,10.886686
47353,2017,Diciembre,Uruguay,22,13,,35,-81.70216500000001,12.5862
47354,2017,Diciembre,Uruguay,8,16,,24,-76.532004,3.451668
47355,2017,Diciembre,Uruguay,414,526,,940,-74.140516,4.697157
47356,2017,Diciembre,Uruguay,0,2,,2,-75.736374,4.815189
47357,2017,Diciembre,Uruguay,11,15,,26,-75.42726,6.170465
47358,2017,Diciembre,Uruguay,1,0,,1,-73.181317,7.1280470000000005
47359,2017,Diciembre,Vanuatu,0,1,,1,-72.453013,7.819
47360,2017,Diciembre,Venezuela,0,5,,5,-75.527794,10.406342
47361,2017,Diciembre,Venezuela,28,40,,68,-75.516486,10.446304
47362,2017,Diciembre,Venezuela,16,63,,79,-74.77647900000001,10.886686
47363,2017,Diciembre,Venezuela,0,4,,4,-74.765343,10.970933
47364,2017,Diciembre,Venezuela,2,2,,4,-74.232675,11.117206
47365,2017,Diciembre,Venezuela,7412,7323,,14735,-72.129595,11.360028999999999
47366,2017,Diciembre,Venezuela,9,10,,19,-72.919186,11.52863
47367,2017,Diciembre,Venezuela,32,46,,78,-76.532004,3.451668
47368,2017,Diciembre,Venezuela,12,9,,21,-67.927521,3.866713
47369,2017,Diciembre,Venezuela,3981,3648,,7629,-74.140516,4.697157
47370,2017,Diciembre,Venezuela,1,3,,4,-75.736374,4.815189
47371,2017,Diciembre,Venezuela,847,806,,1653,-75.42726,6.170465
47372,2017,Diciembre,Venezuela,26,30,,56,-67.48402800000001,6.185536
47373,2017,Diciembre,Venezuela,1,2,,3,-75.586989,6.2188349999999994
47374,2017,Diciembre,Venezuela,369,403,,772,-70.74025300000001,7.088728999999999
47375,2017,Diciembre,Venezuela,5,12,,17,-73.181317,7.1280470000000005
47376,2017,Diciembre,Venezuela,32717,35264,,67981,-72.453013,7.819
47377,2017,Diciembre,Venezuela,8,8,,16,-72.508188,7.927233
47378,2017,Diciembre,Venezuela,1452,1354,,2806,-72.409396,8.36068
47379,2017,Diciembre,Islas Vírgenes Británicas/Territorio Británico de Ultramar,0,4,,4,-75.527794,10.406342
47380,2017,Diciembre,Islas Vírgenes Británicas/Territorio Británico de Ultramar,3,1,,4,-75.42726,6.170465
47381,2017,Diciembre,Zambia,1,1,,2,-75.42726,6.170465
47382,2017,Diciembre,Zimbabue,0,1,,1,-75.42726,6.170465
47383,2017,Diciembre,Desconocido,30948,40454,,71402,-74.140516,4.697157
47384,2018,Enero,Afganistán,0,1,,1,-75.516486,10.446304
47385,2018,Enero,Afganistán,1,0,,1,-74.140516,4.697157
47386,2018,Enero,Albania,1,1,,2,-75.516486,10.446304
47387,2018,Enero,Albania,1,8,,9,-74.140516,4.697157
47388,2018,Enero,Albania,0,1,,1,-75.42726,6.170465
47389,2018,Enero,Albania,0,1,,1,-72.409396,8.36068
47390,2018,Enero,Alemania,16,11,,27,-69.941498,4.191162
47391,2018,Enero,Alemania,19,15,,34,-69.94143100000001,4.214082
47392,2018,Enero,Alemania,1,0,,1,-74.78366,0.18595699999999998
47393,2018,Enero,Alemania,3,5,,8,-76.876446,0.33002
47394,2018,Enero,Alemania,109,128,,237,-77.35600000000001,0.81488
47395,2018,Enero,Alemania,49,56,,105,-75.527794,10.406342
47396,2018,Enero,Alemania,191,244,,435,-75.516486,10.446304
47397,2018,Enero,Alemania,26,54,,80,-74.77647900000001,10.886686
47398,2018,Enero,Alemania,4,9,,13,-74.213989,11.247722999999999
47399,2018,Enero,Alemania,2,1,,3,-72.129595,11.360028999999999
47400,2018,Enero,Alemania,1,2,,3,-81.703935,12.574411099999999
47401,2018,Enero,Alemania,0,7,,7,-81.70216500000001,12.5862
47402,2018,Enero,Alemania,0,1,,1,-81.372937,13.338761300000002
47403,2018,Enero,Alemania,72,123,,195,-76.532004,3.451668
47404,2018,Enero,Alemania,1,2,,3,-77.061029,3.8844260000000004
47405,2018,Enero,Alemania,2,0,,2,-75.76635300000001,4.45285
47406,2018,Enero,Alemania,1934,2762,,4696,-74.140516,4.697157
47407,2018,Enero,Alemania,3,18,,21,-75.736374,4.815189
47408,2018,Enero,Alemania,191,312,,503,-75.42726,6.170465
47409,2018,Enero,Alemania,0,6,,6,-73.181317,7.1280470000000005
47410,2018,Enero,Alemania,4,5,,9,-72.453013,7.819
47411,2018,Enero,Alemania,15,19,,34,-77.35002,8.63337
47412,2018,Enero,Andorra,3,11,,14,-74.140516,4.697157
47413,2018,Enero,Andorra,0,1,,1,-75.42726,6.170465
47414,2018,Enero,Angola,0,2,,2,-74.140516,4.697157
47415,2018,Enero,Antigua y Barbuda,0,1,,1,-74.77647900000001,10.886686
47416,2018,Enero,Antigua y Barbuda,1,0,,1,-74.140516,4.697157
47417,2018,Enero,Países Bajos,0,1,,1,-74.140516,4.697157
47418,2018,Enero,Países Bajos,1,0,,1,-75.42726,6.170465
47419,2018,Enero,Arabia Saudita,0,15,,15,-74.140516,4.697157
47420,2018,Enero,Arabia Saudita,0,1,,1,-75.42726,6.170465
47421,2018,Enero,Argelia,4,9,,13,-74.140516,4.697157
47422,2018,Enero,Argelia,1,0,,1,-75.42726,6.170465
47423,2018,Enero,Argentina,6,5,,11,-69.941498,4.191162
47424,2018,Enero,Argentina,11,17,,28,-69.94143100000001,4.214082
47425,2018,Enero,Argentina,6,11,,17,-76.876446,0.33002
47426,2018,Enero,Argentina,0,1,,1,-77.84700600000001,0.8124359999999999
47427,2018,Enero,Argentina,226,334,,560,-77.35600000000001,0.81488
47428,2018,Enero,Argentina,0,1,,1,-78.802679,18.00143
47429,2018,Enero,Argentina,275,200,,475,-75.527794,10.406342
47430,2018,Enero,Argentina,2164,1559,,3723,-75.516486,10.446304
47431,2018,Enero,Argentina,28,41,,69,-74.77647900000001,10.886686
47432,2018,Enero,Argentina,0,1,,1,-74.232675,11.117206
47433,2018,Enero,Argentina,14,27,,41,-72.129595,11.360028999999999
47434,2018,Enero,Argentina,425,320,,745,-81.70216500000001,12.5862
47435,2018,Enero,Argentina,87,109,,196,-76.532004,3.451668
47436,2018,Enero,Argentina,0,1,,1,-75.76635300000001,4.45285
47437,2018,Enero,Argentina,10812,9790,,20602,-74.140516,4.697157
47438,2018,Enero,Argentina,8,6,,14,-75.736374,4.815189
47439,2018,Enero,Argentina,179,266,,445,-75.42726,6.170465
47440,2018,Enero,Argentina,2,1,,3,-73.181317,7.1280470000000005
47441,2018,Enero,Argentina,11,29,,40,-72.453013,7.819
47442,2018,Enero,Argentina,0,6,,6,-72.508188,7.927233
47443,2018,Enero,Argentina,4,2,,6,-72.409396,8.36068
47444,2018,Enero,Argentina,0,3,,3,-77.35002,8.63337
47445,2018,Enero,República de Armenia,2,2,,4,-74.140516,4.697157
47446,2018,Enero,Aruba,1,0,,1,-73.181317,7.1280470000000005
47447,2018,Enero,Australia,1,2,,3,-69.941498,4.191162
47448,2018,Enero,Australia,6,8,,14,-69.94143100000001,4.214082
47449,2018,Enero,Australia,1,1,,2,-76.876446,0.33002
47450,2018,Enero,Australia,25,52,,77,-77.35600000000001,0.81488
47451,2018,Enero,Australia,24,42,,66,-75.527794,10.406342
47452,2018,Enero,Australia,75,132,,207,-75.516486,10.446304
47453,2018,Enero,Australia,15,24,,39,-74.77647900000001,10.886686
47454,2018,Enero,Australia,1,3,,4,-74.213989,11.247722999999999
47455,2018,Enero,Australia,0,1,,1,-72.129595,11.360028999999999
47456,2018,Enero,Australia,0,1,,1,-81.703935,12.574411099999999
47457,2018,Enero,Australia,0,2,,2,-81.70216500000001,12.5862
47458,2018,Enero,Australia,0,1,,1,-81.372937,13.338761300000002
47459,2018,Enero,Australia,15,24,,39,-76.532004,3.451668
47460,2018,Enero,Australia,1,1,,2,-75.76635300000001,4.45285
47461,2018,Enero,Australia,397,634,,1031,-74.140516,4.697157
47462,2018,Enero,Australia,0,1,,1,-75.736374,4.815189
47463,2018,Enero,Australia,55,149,,204,-75.42726,6.170465
47464,2018,Enero,Australia,0,2,,2,-73.181317,7.1280470000000005
47465,2018,Enero,Australia,0,2,,2,-72.453013,7.819
47466,2018,Enero,Australia,20,27,,47,-77.35002,8.63337
47467,2018,Enero,Austria,0,2,,2,-69.941498,4.191162
47468,2018,Enero,Austria,3,1,,4,-69.94143100000001,4.214082
47469,2018,Enero,Austria,4,3,,7,-76.876446,0.33002
47470,2018,Enero,Austria,9,14,,23,-77.35600000000001,0.81488
47471,2018,Enero,Austria,2,6,,8,-75.527794,10.406342
47472,2018,Enero,Austria,27,29,,56,-75.516486,10.446304
47473,2018,Enero,Austria,8,6,,14,-74.77647900000001,10.886686
47474,2018,Enero,Austria,3,6,,9,-74.213989,11.247722999999999
47475,2018,Enero,Austria,1,2,,3,-81.70216500000001,12.5862
47476,2018,Enero,Austria,6,16,,22,-76.532004,3.451668
47477,2018,Enero,Austria,221,344,,565,-74.140516,4.697157
47478,2018,Enero,Austria,0,1,,1,-75.736374,4.815189
47479,2018,Enero,Austria,22,43,,65,-75.42726,6.170465
47480,2018,Enero,Austria,0,1,,1,-73.181317,7.1280470000000005
47481,2018,Enero,Austria,1,3,,4,-77.35002,8.63337
47482,2018,Enero,Azerbaiyán,0,1,,1,-77.35600000000001,0.81488
47483,2018,Enero,Azerbaiyán,3,4,,7,-74.140516,4.697157
47484,2018,Enero,Bahamas,0,1,,1,-77.35600000000001,0.81488
47485,2018,Enero,Bahamas,2,6,,8,-75.516486,10.446304
47486,2018,Enero,Bahamas,0,1,,1,-74.77647900000001,10.886686
47487,2018,Enero,Bahamas,0,3,,3,-76.532004,3.451668
47488,2018,Enero,Bahamas,5,8,,13,-74.140516,4.697157
47489,2018,Enero,Bahamas,1,1,,2,-75.42726,6.170465
47490,2018,Enero,Bahamas,0,1,,1,-73.181317,7.1280470000000005
47491,2018,Enero,Bahréin,1,0,,1,-74.140516,4.697157
47492,2018,Enero,Bangladesh,0,1,,1,-75.76635300000001,4.45285
47493,2018,Enero,Bangladesh,0,3,,3,-74.140516,4.697157
47494,2018,Enero,Barbados,1,3,,4,-75.516486,10.446304
47495,2018,Enero,Barbados,0,1,,1,-74.77647900000001,10.886686
47496,2018,Enero,Barbados,1,2,,3,-76.532004,3.451668
47497,2018,Enero,Barbados,4,10,,14,-74.140516,4.697157
47498,2018,Enero,Barbados,1,2,,3,-75.42726,6.170465
47499,2018,Enero,República de Belarús,1,0,,1,-75.516486,10.446304
47500,2018,Enero,República de Belarús,5,6,,11,-74.140516,4.697157
47501,2018,Enero,Bélgica,1,3,,4,-69.941498,4.191162
47502,2018,Enero,Bélgica,1,0,,1,-69.94143100000001,4.214082
47503,2018,Enero,Bélgica,1,1,,2,-76.876446,0.33002
47504,2018,Enero,Bélgica,10,14,,24,-77.35600000000001,0.81488
47505,2018,Enero,Bélgica,3,8,,11,-75.527794,10.406342
47506,2018,Enero,Bélgica,28,54,,82,-75.516486,10.446304
47507,2018,Enero,Bélgica,4,6,,10,-74.77647900000001,10.886686
47508,2018,Enero,Bélgica,0,3,,3,-74.765343,10.970933
47509,2018,Enero,Bélgica,15,21,,36,-76.532004,3.451668
47510,2018,Enero,Bélgica,313,506,,819,-74.140516,4.697157
47511,2018,Enero,Bélgica,0,1,,1,-75.736374,4.815189
47512,2018,Enero,Bélgica,33,69,,102,-75.42726,6.170465
47513,2018,Enero,Bélgica,2,0,,2,-72.453013,7.819
47514,2018,Enero,Bélgica,2,1,,3,-77.35002,8.63337
47515,2018,Enero,Belice,0,1,,1,-75.516486,10.446304
47516,2018,Enero,Belice,0,1,,1,-74.77647900000001,10.886686
47517,2018,Enero,Belice,0,1,,1,-76.532004,3.451668
47518,2018,Enero,Belice,5,5,,10,-74.140516,4.697157
47519,2018,Enero,Belice,2,3,,5,-75.42726,6.170465
47520,2018,Enero,Belice,0,2,,2,-72.453013,7.819
47521,2018,Enero,Bermudas/Territorio Británico de Ultramar,0,1,,1,-76.532004,3.451668
47522,2018,Enero,Bolivia,4,4,,8,-69.941498,4.191162
47523,2018,Enero,Bolivia,0,1,,1,-76.876446,0.33002
47524,2018,Enero,Bolivia,27,26,,53,-77.35600000000001,0.81488
47525,2018,Enero,Bolivia,35,12,,47,-75.527794,10.406342
47526,2018,Enero,Bolivia,116,104,,220,-75.516486,10.446304
47527,2018,Enero,Bolivia,9,7,,16,-74.77647900000001,10.886686
47528,2018,Enero,Bolivia,1,0,,1,-72.129595,11.360028999999999
47529,2018,Enero,Bolivia,15,19,,34,-81.70216500000001,12.5862
47530,2018,Enero,Bolivia,24,24,,48,-76.532004,3.451668
47531,2018,Enero,Bolivia,975,877,,1852,-74.140516,4.697157
47532,2018,Enero,Bolivia,1,1,,2,-75.736374,4.815189
47533,2018,Enero,Bolivia,47,51,,98,-75.42726,6.170465
47534,2018,Enero,Bolivia,0,1,,1,-70.74025300000001,7.088728999999999
47535,2018,Enero,Bolivia,5,12,,17,-72.453013,7.819
47536,2018,Enero,Bolivia,0,2,,2,-72.409396,8.36068
47537,2018,Enero,Bosnia y Herzegovina,0,1,,1,-75.527794,10.406342
47538,2018,Enero,Bosnia y Herzegovina,3,2,,5,-74.140516,4.697157
47539,2018,Enero,Brasil,143,130,,273,-69.941498,4.191162
47540,2018,Enero,Brasil,5,4,,9,-69.94143100000001,4.214082
47541,2018,Enero,Brasil,1,0,,1,-74.78366,0.18595699999999998
47542,2018,Enero,Brasil,1,3,,4,-76.876446,0.33002
47543,2018,Enero,Brasil,38,60,,98,-77.35600000000001,0.81488
47544,2018,Enero,Brasil,2,1,,3,-78.802679,18.00143
47545,2018,Enero,Brasil,305,244,,549,-75.527794,10.406342
47546,2018,Enero,Brasil,700,575,,1275,-75.516486,10.446304
47547,2018,Enero,Brasil,30,50,,80,-74.77647900000001,10.886686
47548,2018,Enero,Brasil,2,7,,9,-72.129595,11.360028999999999
47549,2018,Enero,Brasil,0,2,,2,-81.703935,12.574411099999999
47550,2018,Enero,Brasil,204,175,,379,-81.70216500000001,12.5862
47551,2018,Enero,Brasil,103,119,,222,-76.532004,3.451668
47552,2018,Enero,Brasil,0,1,,1,-67.927521,3.866713
47553,2018,Enero,Brasil,9200,8774,,17974,-74.140516,4.697157
47554,2018,Enero,Brasil,7,5,,12,-75.736374,4.815189
47555,2018,Enero,Brasil,230,339,,569,-75.42726,6.170465
47556,2018,Enero,Brasil,2,0,,2,-70.74025300000001,7.088728999999999
47557,2018,Enero,Brasil,0,1,,1,-73.181317,7.1280470000000005
47558,2018,Enero,Brasil,9,12,,21,-72.453013,7.819
47559,2018,Enero,Brasil,1,0,,1,-72.409396,8.36068
47560,2018,Enero,Brasil,0,3,,3,-77.35002,8.63337
47561,2018,Enero,Bulgaria,3,5,,8,-77.35600000000001,0.81488
47562,2018,Enero,Bulgaria,0,3,,3,-75.527794,10.406342
47563,2018,Enero,Bulgaria,9,6,,15,-75.516486,10.446304
47564,2018,Enero,Bulgaria,1,1,,2,-74.77647900000001,10.886686
47565,2018,Enero,Bulgaria,0,1,,1,-81.70216500000001,12.5862
47566,2018,Enero,Bulgaria,2,8,,10,-76.532004,3.451668
47567,2018,Enero,Bulgaria,0,4,,4,-77.061029,3.8844260000000004
47568,2018,Enero,Bulgaria,1,0,,1,-75.76635300000001,4.45285
47569,2018,Enero,Bulgaria,35,35,,70,-74.140516,4.697157
47570,2018,Enero,Bulgaria,3,12,,15,-75.42726,6.170465
47571,2018,Enero,Bulgaria,0,1,,1,-72.453013,7.819
47572,2018,Enero,Bután,1,0,,1,-74.140516,4.697157
47573,2018,Enero,Cabo Verde,0,5,,5,-75.516486,10.446304
47574,2018,Enero,Islas Caimán/Territorio Británico de Ultramar,0,1,,1,-81.70216500000001,12.5862
47575,2018,Enero,Islas Caimán/Territorio Británico de Ultramar,0,1,,1,-76.532004,3.451668
47576,2018,Enero,Islas Caimán/Territorio Británico de Ultramar,0,1,,1,-73.181317,7.1280470000000005
47577,2018,Enero,Camerún,0,1,,1,-77.35600000000001,0.81488
47578,2018,Enero,Camerún,0,1,,1,-76.532004,3.451668
47579,2018,Enero,Canadá,1,1,,2,-69.941498,4.191162
47580,2018,Enero,Canadá,1,6,,7,-69.94143100000001,4.214082
47581,2018,Enero,Canadá,0,2,,2,-76.876446,0.33002
47582,2018,Enero,Canadá,23,34,,57,-77.35600000000001,0.81488
47583,2018,Enero,Canadá,17,19,,36,-75.527794,10.406342
47584,2018,Enero,Canadá,974,1098,,2072,-75.516486,10.446304
47585,2018,Enero,Canadá,51,66,,117,-74.77647900000001,10.886686
47586,2018,Enero,Canadá,1,3,,4,-74.232675,11.117206
47587,2018,Enero,Canadá,4,2,,6,-74.213989,11.247722999999999
47588,2018,Enero,Canadá,0,5,,5,-81.703935,12.574411099999999
47589,2018,Enero,Canadá,285,288,,573,-81.70216500000001,12.5862
47590,2018,Enero,Canadá,0,2,,2,-81.372937,13.338761300000002
47591,2018,Enero,Canadá,62,79,,141,-76.532004,3.451668
47592,2018,Enero,Canadá,2,1,,3,-75.76635300000001,4.45285
47593,2018,Enero,Canadá,1362,2136,,3498,-74.140516,4.697157
47594,2018,Enero,Canadá,12,21,,33,-75.736374,4.815189
47595,2018,Enero,Canadá,226,471,,697,-75.42726,6.170465
47596,2018,Enero,Canadá,2,8,,10,-73.181317,7.1280470000000005
47597,2018,Enero,Canadá,0,3,,3,-72.453013,7.819
47598,2018,Enero,Canadá,8,7,,15,-77.35002,8.63337
47599,2018,Enero,República Democrática del Congo,1,5,,6,-74.140516,4.697157
47600,2018,Enero,República Democrática del Congo,2,0,,2,-75.42726,6.170465
47601,2018,Enero,República Democrática del Congo,0,1,,1,-72.453013,7.819
47602,2018,Enero,República de Corea,0,1,,1,-69.941498,4.191162
47603,2018,Enero,República de Corea,25,18,,43,-77.35600000000001,0.81488
47604,2018,Enero,República de Corea,1,2,,3,-75.527794,10.406342
47605,2018,Enero,República de Corea,14,6,,20,-75.516486,10.446304
47606,2018,Enero,República de Corea,1,7,,8,-74.77647900000001,10.886686
47607,2018,Enero,República de Corea,0,1,,1,-74.213989,11.247722999999999
47608,2018,Enero,República de Corea,2,2,,4,-81.70216500000001,12.5862
47609,2018,Enero,República de Corea,3,2,,5,-76.532004,3.451668
47610,2018,Enero,República de Corea,463,609,,1072,-74.140516,4.697157
47611,2018,Enero,República de Corea,25,52,,77,-75.42726,6.170465
47612,2018,Enero,República de Corea,3,7,,10,-72.453013,7.819
47613,2018,Enero,República de Corea,0,1,,1,-77.35002,8.63337
47614,2018,Enero,Costa de Marfil,0,1,,1,-75.516486,10.446304
47615,2018,Enero,Costa de Marfil,1,2,,3,-74.140516,4.697157
47616,2018,Enero,Costa Rica,0,1,,1,-69.94143100000001,4.214082
47617,2018,Enero,Costa Rica,2,1,,3,-76.876446,0.33002
47618,2018,Enero,Costa Rica,7,9,,16,-77.35600000000001,0.81488
47619,2018,Enero,Costa Rica,2,1,,3,-75.527794,10.406342
47620,2018,Enero,Costa Rica,399,265,,664,-75.516486,10.446304
47621,2018,Enero,Costa Rica,32,32,,64,-74.77647900000001,10.886686
47622,2018,Enero,Costa Rica,1,0,,1,-72.129595,11.360028999999999
47623,2018,Enero,Costa Rica,123,84,,207,-81.70216500000001,12.5862
47624,2018,Enero,Costa Rica,94,118,,212,-76.532004,3.451668
47625,2018,Enero,Costa Rica,0,1,,1,-75.76635300000001,4.45285
47626,2018,Enero,Costa Rica,1541,1511,,3052,-74.140516,4.697157
47627,2018,Enero,Costa Rica,15,11,,26,-75.736374,4.815189
47628,2018,Enero,Costa Rica,233,257,,490,-75.42726,6.170465
47629,2018,Enero,Costa Rica,4,2,,6,-73.181317,7.1280470000000005
47630,2018,Enero,Costa Rica,0,3,,3,-72.453013,7.819
47631,2018,Enero,Croacia,1,1,,2,-77.35600000000001,0.81488
47632,2018,Enero,Croacia,0,3,,3,-75.527794,10.406342
47633,2018,Enero,Croacia,12,16,,28,-75.516486,10.446304
47634,2018,Enero,Croacia,1,2,,3,-74.77647900000001,10.886686
47635,2018,Enero,Croacia,0,3,,3,-74.765343,10.970933
47636,2018,Enero,Croacia,3,0,,3,-76.532004,3.451668
47637,2018,Enero,Croacia,29,65,,94,-74.140516,4.697157
47638,2018,Enero,Croacia,2,3,,5,-75.42726,6.170465
47639,2018,Enero,Croacia,0,2,,2,-75.68164200000001,9.402597
47640,2018,Enero,Cuba,0,1,,1,-76.876446,0.33002
47641,2018,Enero,Cuba,1,3,,4,-77.35600000000001,0.81488
47642,2018,Enero,Cuba,0,9,,9,-75.527794,10.406342
47643,2018,Enero,Cuba,18,37,,55,-75.516486,10.446304
47644,2018,Enero,Cuba,11,29,,40,-74.77647900000001,10.886686
47645,2018,Enero,Cuba,1,0,,1,-81.70216500000001,12.5862
47646,2018,Enero,Cuba,22,44,,66,-76.532004,3.451668
47647,2018,Enero,Cuba,892,885,,1777,-74.140516,4.697157
47648,2018,Enero,Cuba,2,5,,7,-75.736374,4.815189
47649,2018,Enero,Cuba,29,33,,62,-75.42726,6.170465
47650,2018,Enero,Cuba,0,1,,1,-70.74025300000001,7.088728999999999
47651,2018,Enero,Cuba,1,2,,3,-73.181317,7.1280470000000005
47652,2018,Enero,Cuba,0,2,,2,-72.453013,7.819
47653,2018,Enero,Cuba,1,0,,1,-72.409396,8.36068
47654,2018,Enero,República Checa,5,7,,12,-77.35600000000001,0.81488
47655,2018,Enero,República Checa,3,1,,4,-75.527794,10.406342
47656,2018,Enero,República Checa,12,8,,20,-75.516486,10.446304
47657,2018,Enero,República Checa,4,3,,7,-74.77647900000001,10.886686
47658,2018,Enero,República Checa,4,6,,10,-76.532004,3.451668
47659,2018,Enero,República Checa,78,114,,192,-74.140516,4.697157
47660,2018,Enero,República Checa,1,1,,2,-75.736374,4.815189
47661,2018,Enero,República Checa,4,10,,14,-75.42726,6.170465
47662,2018,Enero,República Checa,0,1,,1,-72.453013,7.819
47663,2018,Enero,República Checa,1,3,,4,-77.35002,8.63337
47664,2018,Enero,Chile,3,2,,5,-69.941498,4.191162
47665,2018,Enero,Chile,6,2,,8,-69.94143100000001,4.214082
47666,2018,Enero,Chile,3,3,,6,-76.876446,0.33002
47667,2018,Enero,Chile,104,157,,261,-77.35600000000001,0.81488
47668,2018,Enero,Chile,0,1,,1,-78.802679,18.00143
47669,2018,Enero,Chile,65,52,,117,-75.527794,10.406342
47670,2018,Enero,Chile,195,185,,380,-75.516486,10.446304
47671,2018,Enero,Chile,8,14,,22,-74.77647900000001,10.886686
47672,2018,Enero,Chile,2,5,,7,-72.129595,11.360028999999999
47673,2018,Enero,Chile,0,3,,3,-81.703935,12.574411099999999
47674,2018,Enero,Chile,62,39,,101,-81.70216500000001,12.5862
47675,2018,Enero,Chile,36,71,,107,-76.532004,3.451668
47676,2018,Enero,Chile,1,1,,2,-77.061029,3.8844260000000004
47677,2018,Enero,Chile,1,0,,1,-75.76635300000001,4.45285
47678,2018,Enero,Chile,4507,4909,,9416,-74.140516,4.697157
47679,2018,Enero,Chile,0,4,,4,-75.736374,4.815189
47680,2018,Enero,Chile,56,94,,150,-75.42726,6.170465
47681,2018,Enero,Chile,0,2,,2,-70.74025300000001,7.088728999999999
47682,2018,Enero,Chile,0,2,,2,-73.181317,7.1280470000000005
47683,2018,Enero,Chile,17,44,,61,-72.453013,7.819
47684,2018,Enero,Chile,0,6,,6,-72.409396,8.36068
47685,2018,Enero,Chile,0,1,,1,-77.35002,8.63337
47686,2018,Enero,China,0,1,,1,-69.941498,4.191162
47687,2018,Enero,China,1,0,,1,-76.876446,0.33002
47688,2018,Enero,China,11,9,,20,-77.35600000000001,0.81488
47689,2018,Enero,China,13,27,,40,-75.516486,10.446304
47690,2018,Enero,China,21,12,,33,-74.77647900000001,10.886686
47691,2018,Enero,China,0,2,,2,-74.765343,10.970933
47692,2018,Enero,China,1,1,,2,-74.213989,11.247722999999999
47693,2018,Enero,China,3,6,,9,-72.129595,11.360028999999999
47694,2018,Enero,China,0,1,,1,-81.70216500000001,12.5862
47695,2018,Enero,China,12,16,,28,-76.532004,3.451668
47696,2018,Enero,China,380,705,,1085,-74.140516,4.697157
47697,2018,Enero,China,2,0,,2,-75.736374,4.815189
47698,2018,Enero,China,39,63,,102,-75.42726,6.170465
47699,2018,Enero,China,0,1,,1,-70.74025300000001,7.088728999999999
47700,2018,Enero,China,2,0,,2,-73.181317,7.1280470000000005
47701,2018,Enero,China,6,16,,22,-72.453013,7.819
47702,2018,Enero,China,1,2,,3,-72.409396,8.36068
47703,2018,Enero,China,0,2,,2,-75.68164200000001,9.402597
47704,2018,Enero,Taiwán,1,0,,1,-69.941498,4.191162
47705,2018,Enero,Taiwán,1,0,,1,-76.876446,0.33002
47706,2018,Enero,Taiwán,1,3,,4,-77.35600000000001,0.81488
47707,2018,Enero,Taiwán,6,3,,9,-75.516486,10.446304
47708,2018,Enero,Taiwán,3,7,,10,-76.532004,3.451668
47709,2018,Enero,Taiwán,46,67,,113,-74.140516,4.697157
47710,2018,Enero,Taiwán,6,16,,22,-75.42726,6.170465
47711,2018,Enero,Taiwán,1,0,,1,-72.453013,7.819
47712,2018,Enero,Chipre,0,1,,1,-77.35600000000001,0.81488
47713,2018,Enero,Chipre,2,1,,3,-75.516486,10.446304
47714,2018,Enero,Chipre,1,0,,1,-76.532004,3.451668
47715,2018,Enero,Chipre,6,5,,11,-74.140516,4.697157
47716,2018,Enero,Chipre,0,1,,1,-75.42726,6.170465
47717,2018,Enero,Dinamarca,1,0,,1,-69.941498,4.191162
47718,2018,Enero,Dinamarca,2,0,,2,-69.94143100000001,4.214082
47719,2018,Enero,Dinamarca,0,1,,1,-76.876446,0.33002
47720,2018,Enero,Dinamarca,4,10,,14,-77.35600000000001,0.81488
47721,2018,Enero,Dinamarca,4,10,,14,-75.527794,10.406342
47722,2018,Enero,Dinamarca,26,49,,75,-75.516486,10.446304
47723,2018,Enero,Dinamarca,11,11,,22,-74.77647900000001,10.886686
47724,2018,Enero,Dinamarca,4,7,,11,-74.213989,11.247722999999999
47725,2018,Enero,Dinamarca,0,1,,1,-81.703935,12.574411099999999
47726,2018,Enero,Dinamarca,2,4,,6,-81.70216500000001,12.5862
47727,2018,Enero,Dinamarca,9,10,,19,-76.532004,3.451668
47728,2018,Enero,Dinamarca,0,1,,1,-67.927521,3.866713
47729,2018,Enero,Dinamarca,1,0,,1,-75.76635300000001,4.45285
47730,2018,Enero,Dinamarca,179,222,,401,-74.140516,4.697157
47731,2018,Enero,Dinamarca,0,1,,1,-75.736374,4.815189
47732,2018,Enero,Dinamarca,14,38,,52,-75.42726,6.170465
47733,2018,Enero,Dinamarca,0,1,,1,-73.181317,7.1280470000000005
47734,2018,Enero,Dinamarca,0,2,,2,-72.453013,7.819
47735,2018,Enero,Dinamarca,1,1,,2,-72.409396,8.36068
47736,2018,Enero,Dinamarca,2,1,,3,-77.35002,8.63337
47737,2018,Enero,Dominica,7,4,,11,-74.140516,4.697157
47738,2018,Enero,Dominica,0,4,,4,-75.42726,6.170465
47739,2018,Enero,Ecuador,0,1,,1,-69.941498,4.191162
47740,2018,Enero,Ecuador,0,5,,5,-69.94143100000001,4.214082
47741,2018,Enero,Ecuador,79,291,,370,-76.876446,0.33002
47742,2018,Enero,Ecuador,3,6,,9,-77.84700600000001,0.8124359999999999
47743,2018,Enero,Ecuador,1349,2140,,3489,-77.35600000000001,0.81488
47744,2018,Enero,Ecuador,24,40,,64,-78.802679,18.00143
47745,2018,Enero,Ecuador,0,14,,14,-75.527794,10.406342
47746,2018,Enero,Ecuador,27,29,,56,-75.516486,10.446304
47747,2018,Enero,Ecuador,8,10,,18,-74.77647900000001,10.886686
47748,2018,Enero,Ecuador,0,1,,1,-74.765343,10.970933
47749,2018,Enero,Ecuador,8,9,,17,-72.129595,11.360028999999999
47750,2018,Enero,Ecuador,7,7,,14,-81.70216500000001,12.5862
47751,2018,Enero,Ecuador,359,389,,748,-76.532004,3.451668
47752,2018,Enero,Ecuador,0,2,,2,-67.927521,3.866713
47753,2018,Enero,Ecuador,1,3,,4,-75.76635300000001,4.45285
47754,2018,Enero,Ecuador,2721,3394,,6115,-74.140516,4.697157
47755,2018,Enero,Ecuador,2,2,,4,-75.736374,4.815189
47756,2018,Enero,Ecuador,76,138,,214,-75.42726,6.170465
47757,2018,Enero,Ecuador,2,2,,4,-70.74025300000001,7.088728999999999
47758,2018,Enero,Ecuador,1,3,,4,-73.181317,7.1280470000000005
47759,2018,Enero,Ecuador,145,314,,459,-72.453013,7.819
47760,2018,Enero,Ecuador,82,380,,462,-72.508188,7.927233
47761,2018,Enero,Ecuador,5,13,,18,-72.409396,8.36068
47762,2018,Enero,Ecuador,0,5,,5,-77.35002,8.63337
47763,2018,Enero,Egipto,0,3,,3,-75.516486,10.446304
47764,2018,Enero,Egipto,6,27,,33,-74.140516,4.697157
47765,2018,Enero,Egipto,0,2,,2,-75.42726,6.170465
47766,2018,Enero,El Salvador,0,1,,1,-69.94143100000001,4.214082
47767,2018,Enero,El Salvador,1,1,,2,-76.876446,0.33002
47768,2018,Enero,El Salvador,3,3,,6,-77.35600000000001,0.81488
47769,2018,Enero,El Salvador,34,24,,58,-75.516486,10.446304
47770,2018,Enero,El Salvador,5,6,,11,-74.77647900000001,10.886686
47771,2018,Enero,El Salvador,9,9,,18,-81.70216500000001,12.5862
47772,2018,Enero,El Salvador,89,105,,194,-76.532004,3.451668
47773,2018,Enero,El Salvador,671,845,,1516,-74.140516,4.697157
47774,2018,Enero,El Salvador,3,5,,8,-75.736374,4.815189
47775,2018,Enero,El Salvador,131,189,,320,-75.42726,6.170465
47776,2018,Enero,Emiratos Árabes,0,1,,1,-77.35600000000001,0.81488
47777,2018,Enero,Emiratos Árabes,1,13,,14,-74.140516,4.697157
47778,2018,Enero,España,5,2,,7,-69.941498,4.191162
47779,2018,Enero,España,5,12,,17,-69.94143100000001,4.214082
47780,2018,Enero,España,6,14,,20,-76.876446,0.33002
47781,2018,Enero,España,48,76,,124,-77.35600000000001,0.81488
47782,2018,Enero,España,13,21,,34,-75.527794,10.406342
47783,2018,Enero,España,111,176,,287,-75.516486,10.446304
47784,2018,Enero,España,14,47,,61,-74.77647900000001,10.886686
47785,2018,Enero,España,0,2,,2,-74.765343,10.970933
47786,2018,Enero,España,0,1,,1,-74.232675,11.117206
47787,2018,Enero,España,0,3,,3,-74.213989,11.247722999999999
47788,2018,Enero,España,6,12,,18,-72.129595,11.360028999999999
47789,2018,Enero,España,0,1,,1,-81.703935,12.574411099999999
47790,2018,Enero,España,2,3,,5,-81.70216500000001,12.5862
47791,2018,Enero,España,447,634,,1081,-76.532004,3.451668
47792,2018,Enero,España,0,4,,4,-75.76635300000001,4.45285
47793,2018,Enero,España,2814,5473,,8287,-74.140516,4.697157
47794,2018,Enero,España,3,8,,11,-75.736374,4.815189
47795,2018,Enero,España,454,872,,1326,-75.42726,6.170465
47796,2018,Enero,España,1,0,,1,-67.48402800000001,6.185536
47797,2018,Enero,España,2,1,,3,-73.181317,7.1280470000000005
47798,2018,Enero,España,31,51,,82,-72.453013,7.819
47799,2018,Enero,España,0,1,,1,-72.508188,7.927233
47800,2018,Enero,España,4,4,,8,-72.409396,8.36068
47801,2018,Enero,España,4,3,,7,-77.35002,8.63337
47802,2018,Enero,Eslovaquia,0,1,,1,-77.35600000000001,0.81488
47803,2018,Enero,Eslovaquia,1,1,,2,-75.527794,10.406342
47804,2018,Enero,Eslovaquia,3,4,,7,-75.516486,10.446304
47805,2018,Enero,Eslovaquia,1,0,,1,-74.77647900000001,10.886686
47806,2018,Enero,Eslovaquia,0,1,,1,-72.129595,11.360028999999999
47807,2018,Enero,Eslovaquia,1,2,,3,-76.532004,3.451668
47808,2018,Enero,Eslovaquia,53,68,,121,-74.140516,4.697157
47809,2018,Enero,Eslovaquia,0,3,,3,-75.736374,4.815189
47810,2018,Enero,Eslovaquia,4,7,,11,-75.42726,6.170465
47811,2018,Enero,Eslovenia,1,2,,3,-75.516486,10.446304
47812,2018,Enero,Eslovenia,1,1,,2,-76.532004,3.451668
47813,2018,Enero,Eslovenia,41,59,,100,-74.140516,4.697157
47814,2018,Enero,Eslovenia,4,4,,8,-75.42726,6.170465
47815,2018,Enero,Eslovenia,0,1,,1,-67.48402800000001,6.185536
47816,2018,Enero,Estados Unidos de América,13,15,,28,-69.941498,4.191162
47817,2018,Enero,Estados Unidos de América,8,14,,22,-69.94143100000001,4.214082
47818,2018,Enero,Estados Unidos de América,4,6,,10,-76.876446,0.33002
47819,2018,Enero,Estados Unidos de América,79,132,,211,-77.35600000000001,0.81488
47820,2018,Enero,Estados Unidos de América,0,2,,2,-78.802679,18.00143
47821,2018,Enero,Estados Unidos de América,51,85,,136,-75.527794,10.406342
47822,2018,Enero,Estados Unidos de América,3861,5585,,9446,-75.516486,10.446304
47823,2018,Enero,Estados Unidos de América,496,760,,1256,-74.77647900000001,10.886686
47824,2018,Enero,Estados Unidos de América,1,0,,1,-74.232675,11.117206
47825,2018,Enero,Estados Unidos de América,21,29,,50,-74.213989,11.247722999999999
47826,2018,Enero,Estados Unidos de América,4,6,,10,-72.129595,11.360028999999999
47827,2018,Enero,Estados Unidos de América,5,13,,18,-81.703935,12.574411099999999
47828,2018,Enero,Estados Unidos de América,51,55,,106,-81.70216500000001,12.5862
47829,2018,Enero,Estados Unidos de América,0,1,,1,-81.372937,13.338761300000002
47830,2018,Enero,Estados Unidos de América,918,1417,,2335,-76.532004,3.451668
47831,2018,Enero,Estados Unidos de América,61,112,,173,-75.76635300000001,4.45285
47832,2018,Enero,Estados Unidos de América,7366,12552,,19918,-74.140516,4.697157
47833,2018,Enero,Estados Unidos de América,147,222,,369,-75.736374,4.815189
47834,2018,Enero,Estados Unidos de América,2110,5418,,7528,-75.42726,6.170465
47835,2018,Enero,Estados Unidos de América,0,1,,1,-70.74025300000001,7.088728999999999
47836,2018,Enero,Estados Unidos de América,27,38,,65,-73.181317,7.1280470000000005
47837,2018,Enero,Estados Unidos de América,15,17,,32,-72.453013,7.819
47838,2018,Enero,Estados Unidos de América,0,2,,2,-72.508188,7.927233
47839,2018,Enero,Estados Unidos de América,0,6,,6,-76.7333,8.06667
47840,2018,Enero,Estados Unidos de América,4,3,,7,-72.409396,8.36068
47841,2018,Enero,Estados Unidos de América,13,13,,26,-77.35002,8.63337
47842,2018,Enero,Estonia,3,1,,4,-77.35600000000001,0.81488
47843,2018,Enero,Estonia,0,12,,12,-75.527794,10.406342
47844,2018,Enero,Estonia,2,4,,6,-75.516486,10.446304
47845,2018,Enero,Estonia,4,2,,6,-76.532004,3.451668
47846,2018,Enero,Estonia,10,17,,27,-74.140516,4.697157
47847,2018,Enero,Estonia,2,3,,5,-75.42726,6.170465
47848,2018,Enero,Etiopia,0,1,,1,-75.516486,10.446304
47849,2018,Enero,Etiopia,1,4,,5,-74.140516,4.697157
47850,2018,Enero,Filipinas,1,0,,1,-69.941498,4.191162
47851,2018,Enero,Filipinas,3,1,,4,-77.35600000000001,0.81488
47852,2018,Enero,Filipinas,4,44,,48,-75.527794,10.406342
47853,2018,Enero,Filipinas,8,42,,50,-75.516486,10.446304
47854,2018,Enero,Filipinas,0,6,,6,-74.77647900000001,10.886686
47855,2018,Enero,Filipinas,0,10,,10,-74.765343,10.970933
47856,2018,Enero,Filipinas,0,14,,14,-74.213989,11.247722999999999
47857,2018,Enero,Filipinas,0,7,,7,-81.703935,12.574411099999999
47858,2018,Enero,Filipinas,4,10,,14,-76.532004,3.451668
47859,2018,Enero,Filipinas,0,12,,12,-77.061029,3.8844260000000004
47860,2018,Enero,Filipinas,49,66,,115,-74.140516,4.697157
47861,2018,Enero,Filipinas,5,3,,8,-75.42726,6.170465
47862,2018,Enero,Filipinas,0,8,,8,-75.68164200000001,9.402597
47863,2018,Enero,Finlandia,0,1,,1,-69.94143100000001,4.214082
47864,2018,Enero,Finlandia,7,6,,13,-77.35600000000001,0.81488
47865,2018,Enero,Finlandia,1,4,,5,-75.527794,10.406342
47866,2018,Enero,Finlandia,15,18,,33,-75.516486,10.446304
47867,2018,Enero,Finlandia,0,4,,4,-74.77647900000001,10.886686
47868,2018,Enero,Finlandia,5,2,,7,-74.213989,11.247722999999999
47869,2018,Enero,Finlandia,9,3,,12,-76.532004,3.451668
47870,2018,Enero,Finlandia,69,63,,132,-74.140516,4.697157
47871,2018,Enero,Finlandia,7,6,,13,-75.42726,6.170465
47872,2018,Enero,Finlandia,1,0,,1,-72.453013,7.819
47873,2018,Enero,Finlandia,2,0,,2,-77.35002,8.63337
47874,2018,Enero,Francia,10,9,,19,-69.941498,4.191162
47875,2018,Enero,Francia,18,20,,38,-69.94143100000001,4.214082
47876,2018,Enero,Francia,7,6,,13,-76.876446,0.33002
47877,2018,Enero,Francia,127,128,,255,-77.35600000000001,0.81488
47878,2018,Enero,Francia,16,16,,32,-75.527794,10.406342
47879,2018,Enero,Francia,192,308,,500,-75.516486,10.446304
47880,2018,Enero,Francia,20,42,,62,-74.77647900000001,10.886686
47881,2018,Enero,Francia,0,2,,2,-74.765343,10.970933
47882,2018,Enero,Francia,3,4,,7,-74.213989,11.247722999999999
47883,2018,Enero,Francia,4,10,,14,-72.129595,11.360028999999999
47884,2018,Enero,Francia,2,5,,7,-81.70216500000001,12.5862
47885,2018,Enero,Francia,5,5,,10,-81.372937,13.338761300000002
47886,2018,Enero,Francia,91,159,,250,-76.532004,3.451668
47887,2018,Enero,Francia,1,1,,2,-67.927521,3.866713
47888,2018,Enero,Francia,0,1,,1,-75.76635300000001,4.45285
47889,2018,Enero,Francia,2845,3781,,6626,-74.140516,4.697157
47890,2018,Enero,Francia,3,5,,8,-75.736374,4.815189
47891,2018,Enero,Francia,206,395,,601,-75.42726,6.170465
47892,2018,Enero,Francia,2,14,,16,-72.453013,7.819
47893,2018,Enero,Francia,13,12,,25,-77.35002,8.63337
47894,2018,Enero,Georgia,0,1,,1,-76.532004,3.451668
47895,2018,Enero,Georgia,3,3,,6,-74.140516,4.697157
47896,2018,Enero,Ghana,0,6,,6,-77.35600000000001,0.81488
47897,2018,Enero,Ghana,0,2,,2,-76.532004,3.451668
47898,2018,Enero,Ghana,2,8,,10,-74.140516,4.697157
47899,2018,Enero,Granada,0,1,,1,-75.516486,10.446304
47900,2018,Enero,Granada,0,1,,1,-74.140516,4.697157
47901,2018,Enero,Granada,1,0,,1,-75.42726,6.170465
47902,2018,Enero,Grecia,1,0,,1,-69.94143100000001,4.214082
47903,2018,Enero,Grecia,1,2,,3,-77.35600000000001,0.81488
47904,2018,Enero,Grecia,0,2,,2,-75.527794,10.406342
47905,2018,Enero,Grecia,4,15,,19,-75.516486,10.446304
47906,2018,Enero,Grecia,0,2,,2,-74.77647900000001,10.886686
47907,2018,Enero,Grecia,0,1,,1,-74.213989,11.247722999999999
47908,2018,Enero,Grecia,0,6,,6,-76.532004,3.451668
47909,2018,Enero,Grecia,31,48,,79,-74.140516,4.697157
47910,2018,Enero,Grecia,3,12,,15,-75.42726,6.170465
47911,2018,Enero,Grecia,0,2,,2,-72.453013,7.819
47912,2018,Enero,Guatemala,3,3,,6,-77.35600000000001,0.81488
47913,2018,Enero,Guatemala,0,1,,1,-78.802679,18.00143
47914,2018,Enero,Guatemala,0,4,,4,-75.527794,10.406342
47915,2018,Enero,Guatemala,165,144,,309,-75.516486,10.446304
47916,2018,Enero,Guatemala,7,28,,35,-74.77647900000001,10.886686
47917,2018,Enero,Guatemala,0,1,,1,-72.129595,11.360028999999999
47918,2018,Enero,Guatemala,5,6,,11,-81.70216500000001,12.5862
47919,2018,Enero,Guatemala,17,40,,57,-76.532004,3.451668
47920,2018,Enero,Guatemala,341,581,,922,-74.140516,4.697157
47921,2018,Enero,Guatemala,7,10,,17,-75.736374,4.815189
47922,2018,Enero,Guatemala,63,149,,212,-75.42726,6.170465
47923,2018,Enero,Guatemala,3,0,,3,-73.181317,7.1280470000000005
47924,2018,Enero,Guatemala,0,6,,6,-72.453013,7.819
47925,2018,Enero,Guatemala,4,0,,4,-72.409396,8.36068
47926,2018,Enero,Guyana,0,1,,1,-75.527794,10.406342
47927,2018,Enero,Guyana,0,2,,2,-75.516486,10.446304
47928,2018,Enero,Guyana,1,0,,1,-74.77647900000001,10.886686
47929,2018,Enero,Guyana,6,10,,16,-74.140516,4.697157
47930,2018,Enero,Guyana,0,1,,1,-75.42726,6.170465
47931,2018,Enero,Haití,1,2,,3,-75.516486,10.446304
47932,2018,Enero,Haití,6,18,,24,-74.140516,4.697157
47933,2018,Enero,Haití,3,6,,9,-75.42726,6.170465
47934,2018,Enero,Honduras,8,7,,15,-77.35600000000001,0.81488
47935,2018,Enero,Honduras,0,24,,24,-75.527794,10.406342
47936,2018,Enero,Honduras,53,46,,99,-75.516486,10.446304
47937,2018,Enero,Honduras,6,15,,21,-74.77647900000001,10.886686
47938,2018,Enero,Honduras,0,2,,2,-74.765343,10.970933
47939,2018,Enero,Honduras,1,0,,1,-81.70216500000001,12.5862
47940,2018,Enero,Honduras,42,40,,82,-76.532004,3.451668
47941,2018,Enero,Honduras,186,198,,384,-74.140516,4.697157
47942,2018,Enero,Honduras,1,1,,2,-75.736374,4.815189
47943,2018,Enero,Honduras,45,93,,138,-75.42726,6.170465
47944,2018,Enero,Honduras,1,3,,4,-72.453013,7.819
47945,2018,Enero,Honduras,0,1,,1,-77.35002,8.63337
47946,2018,Enero,Hong Kong,0,2,,2,-77.35600000000001,0.81488
47947,2018,Enero,Hong Kong,0,1,,1,-72.129595,11.360028999999999
47948,2018,Enero,Hong Kong,8,6,,14,-74.140516,4.697157
47949,2018,Enero,Hungría,1,2,,3,-69.941498,4.191162
47950,2018,Enero,Hungría,1,4,,5,-77.35600000000001,0.81488
47951,2018,Enero,Hungría,2,1,,3,-75.527794,10.406342
47952,2018,Enero,Hungría,9,13,,22,-75.516486,10.446304
47953,2018,Enero,Hungría,1,3,,4,-74.77647900000001,10.886686
47954,2018,Enero,Hungría,1,1,,2,-74.213989,11.247722999999999
47955,2018,Enero,Hungría,0,1,,1,-81.70216500000001,12.5862
47956,2018,Enero,Hungría,4,7,,11,-76.532004,3.451668
47957,2018,Enero,Hungría,60,86,,146,-74.140516,4.697157
47958,2018,Enero,Hungría,5,14,,19,-75.42726,6.170465
47959,2018,Enero,India,0,1,,1,-69.94143100000001,4.214082
47960,2018,Enero,India,4,7,,11,-77.35600000000001,0.81488
47961,2018,Enero,India,0,16,,16,-75.527794,10.406342
47962,2018,Enero,India,12,43,,55,-75.516486,10.446304
47963,2018,Enero,India,0,5,,5,-74.77647900000001,10.886686
47964,2018,Enero,India,2,1,,3,-74.213989,11.247722999999999
47965,2018,Enero,India,5,11,,16,-76.532004,3.451668
47966,2018,Enero,India,0,4,,4,-77.061029,3.8844260000000004
47967,2018,Enero,India,0,1,,1,-75.76635300000001,4.45285
47968,2018,Enero,India,85,370,,455,-74.140516,4.697157
47969,2018,Enero,India,0,2,,2,-75.736374,4.815189
47970,2018,Enero,India,15,103,,118,-75.42726,6.170465
47971,2018,Enero,India,0,1,,1,-73.181317,7.1280470000000005
47972,2018,Enero,India,0,1,,1,-75.68164200000001,9.402597
47973,2018,Enero,Indonesia,0,3,,3,-75.527794,10.406342
47974,2018,Enero,Indonesia,1,5,,6,-75.516486,10.446304
47975,2018,Enero,Indonesia,0,2,,2,-74.77647900000001,10.886686
47976,2018,Enero,Indonesia,0,3,,3,-74.765343,10.970933
47977,2018,Enero,Indonesia,0,1,,1,-81.703935,12.574411099999999
47978,2018,Enero,Indonesia,16,24,,40,-74.140516,4.697157
47979,2018,Enero,Indonesia,1,2,,3,-75.42726,6.170465
47980,2018,Enero,Iraq,0,2,,2,-74.140516,4.697157
47981,2018,Enero,Irán,1,1,,2,-75.516486,10.446304
47982,2018,Enero,Irán,9,13,,22,-74.140516,4.697157
47983,2018,Enero,Irán,0,1,,1,-75.42726,6.170465
47984,2018,Enero,República de Irlanda,0,2,,2,-69.941498,4.191162
47985,2018,Enero,República de Irlanda,0,1,,1,-69.94143100000001,4.214082
47986,2018,Enero,República de Irlanda,9,6,,15,-77.35600000000001,0.81488
47987,2018,Enero,República de Irlanda,4,3,,7,-75.527794,10.406342
47988,2018,Enero,República de Irlanda,23,45,,68,-75.516486,10.446304
47989,2018,Enero,República de Irlanda,0,5,,5,-74.77647900000001,10.886686
47990,2018,Enero,República de Irlanda,3,3,,6,-74.213989,11.247722999999999
47991,2018,Enero,República de Irlanda,1,10,,11,-76.532004,3.451668
47992,2018,Enero,República de Irlanda,120,214,,334,-74.140516,4.697157
47993,2018,Enero,República de Irlanda,16,37,,53,-75.42726,6.170465
47994,2018,Enero,República de Irlanda,0,1,,1,-72.453013,7.819
47995,2018,Enero,República de Irlanda,2,3,,5,-77.35002,8.63337
47996,2018,Enero,Islandia,7,5,,12,-75.516486,10.446304
47997,2018,Enero,Islandia,0,1,,1,-76.532004,3.451668
47998,2018,Enero,Islandia,7,8,,15,-74.140516,4.697157
47999,2018,Enero,Islandia,3,0,,3,-75.736374,4.815189
48000,2018,Enero,Islandia,0,1,,1,-75.42726,6.170465
48001,2018,Enero,Israel,0,2,,2,-69.941498,4.191162
48002,2018,Enero,Israel,0,2,,2,-69.94143100000001,4.214082
48003,2018,Enero,Israel,1,2,,3,-76.876446,0.33002
48004,2018,Enero,Israel,3,18,,21,-77.35600000000001,0.81488
48005,2018,Enero,Israel,1,2,,3,-75.527794,10.406342
48006,2018,Enero,Israel,22,87,,109,-75.516486,10.446304
48007,2018,Enero,Israel,2,3,,5,-74.77647900000001,10.886686
48008,2018,Enero,Israel,1,1,,2,-81.70216500000001,12.5862
48009,2018,Enero,Israel,5,17,,22,-76.532004,3.451668
48010,2018,Enero,Israel,160,521,,681,-74.140516,4.697157
48011,2018,Enero,Israel,1,0,,1,-75.736374,4.815189
48012,2018,Enero,Israel,23,95,,118,-75.42726,6.170465
48013,2018,Enero,Israel,0,1,,1,-73.181317,7.1280470000000005
48014,2018,Enero,Israel,0,2,,2,-77.35002,8.63337
48015,2018,Enero,Italia,2,1,,3,-69.941498,4.191162
48016,2018,Enero,Italia,3,5,,8,-69.94143100000001,4.214082
48017,2018,Enero,Italia,2,11,,13,-76.876446,0.33002
48018,2018,Enero,Italia,1,0,,1,-77.84700600000001,0.8124359999999999
48019,2018,Enero,Italia,25,47,,72,-77.35600000000001,0.81488
48020,2018,Enero,Italia,11,32,,43,-75.527794,10.406342
48021,2018,Enero,Italia,104,303,,407,-75.516486,10.446304
48022,2018,Enero,Italia,16,36,,52,-74.77647900000001,10.886686
48023,2018,Enero,Italia,1,5,,6,-74.213989,11.247722999999999
48024,2018,Enero,Italia,1,10,,11,-72.129595,11.360028999999999
48025,2018,Enero,Italia,10,9,,19,-81.70216500000001,12.5862
48026,2018,Enero,Italia,46,116,,162,-76.532004,3.451668
48027,2018,Enero,Italia,907,2096,,3003,-74.140516,4.697157
48028,2018,Enero,Italia,2,4,,6,-75.736374,4.815189
48029,2018,Enero,Italia,122,363,,485,-75.42726,6.170465
48030,2018,Enero,Italia,2,2,,4,-67.48402800000001,6.185536
48031,2018,Enero,Italia,0,2,,2,-70.74025300000001,7.088728999999999
48032,2018,Enero,Italia,1,4,,5,-73.181317,7.1280470000000005
48033,2018,Enero,Italia,17,23,,40,-72.453013,7.819
48034,2018,Enero,Italia,3,3,,6,-72.409396,8.36068
48035,2018,Enero,Italia,1,5,,6,-77.35002,8.63337
48036,2018,Enero,Jamaica,5,11,,16,-75.516486,10.446304
48037,2018,Enero,Jamaica,2,3,,5,-74.77647900000001,10.886686
48038,2018,Enero,Jamaica,0,1,,1,-72.129595,11.360028999999999
48039,2018,Enero,Jamaica,1,0,,1,-81.70216500000001,12.5862
48040,2018,Enero,Jamaica,5,2,,7,-76.532004,3.451668
48041,2018,Enero,Jamaica,28,27,,55,-74.140516,4.697157
48042,2018,Enero,Jamaica,2,5,,7,-75.42726,6.170465
48043,2018,Enero,Japón,2,1,,3,-69.94143100000001,4.214082
48044,2018,Enero,Japón,2,17,,19,-77.35600000000001,0.81488
48045,2018,Enero,Japón,0,1,,1,-75.527794,10.406342
48046,2018,Enero,Japón,16,22,,38,-75.516486,10.446304
48047,2018,Enero,Japón,1,7,,8,-74.77647900000001,10.886686
48048,2018,Enero,Japón,0,1,,1,-74.213989,11.247722999999999
48049,2018,Enero,Japón,4,6,,10,-76.532004,3.451668
48050,2018,Enero,Japón,215,445,,660,-74.140516,4.697157
48051,2018,Enero,Japón,1,0,,1,-75.736374,4.815189
48052,2018,Enero,Japón,11,68,,79,-75.42726,6.170465
48053,2018,Enero,Jordania,0,1,,1,-77.35600000000001,0.81488
48054,2018,Enero,Jordania,0,3,,3,-75.516486,10.446304
48055,2018,Enero,Jordania,1,1,,2,-74.140516,4.697157
48056,2018,Enero,Jordania,1,1,,2,-75.42726,6.170465
48057,2018,Enero,Kazajistán,1,0,,1,-75.516486,10.446304
48058,2018,Enero,Kazajistán,0,1,,1,-76.532004,3.451668
48059,2018,Enero,Kazajistán,3,7,,10,-74.140516,4.697157
48060,2018,Enero,Kazajistán,1,0,,1,-75.42726,6.170465
48061,2018,Enero,Kenia,0,1,,1,-77.35600000000001,0.81488
48062,2018,Enero,Kenia,0,1,,1,-76.532004,3.451668
48063,2018,Enero,Kenia,6,7,,13,-74.140516,4.697157
48064,2018,Enero,Kenia,1,2,,3,-75.42726,6.170465
48065,2018,Enero,Kirguistán,1,0,,1,-74.140516,4.697157
48066,2018,Enero,Kirguistán,1,1,,2,-75.42726,6.170465
48067,2018,Enero,Kuwait,0,1,,1,-76.532004,3.451668
48068,2018,Enero,Kuwait,0,6,,6,-74.140516,4.697157
48069,2018,Enero,República de Kosovo,0,1,,1,-74.140516,4.697157
48070,2018,Enero,República Democrática Popular  Lao,1,0,,1,-74.140516,4.697157
48071,2018,Enero,Letonia,1,0,,1,-76.876446,0.33002
48072,2018,Enero,Letonia,3,3,,6,-75.516486,10.446304
48073,2018,Enero,Letonia,1,0,,1,-74.77647900000001,10.886686
48074,2018,Enero,Letonia,0,1,,1,-81.70216500000001,12.5862
48075,2018,Enero,Letonia,0,1,,1,-76.532004,3.451668
48076,2018,Enero,Letonia,16,25,,41,-74.140516,4.697157
48077,2018,Enero,Letonia,1,0,,1,-75.42726,6.170465
48078,2018,Enero,Lituania,0,1,,1,-77.35600000000001,0.81488
48079,2018,Enero,Lituania,1,2,,3,-75.527794,10.406342
48080,2018,Enero,Lituania,1,2,,3,-75.516486,10.446304
48081,2018,Enero,Lituania,0,1,,1,-74.77647900000001,10.886686
48082,2018,Enero,Lituania,1,0,,1,-81.70216500000001,12.5862
48083,2018,Enero,Lituania,1,3,,4,-76.532004,3.451668
48084,2018,Enero,Lituania,16,36,,52,-74.140516,4.697157
48085,2018,Enero,Lituania,3,3,,6,-75.42726,6.170465
48086,2018,Enero,Lituania,1,0,,1,-77.35002,8.63337
48087,2018,Enero,Líbano,2,1,,3,-74.77647900000001,10.886686
48088,2018,Enero,Líbano,2,0,,2,-72.129595,11.360028999999999
48089,2018,Enero,Líbano,9,26,,35,-74.140516,4.697157
48090,2018,Enero,Liberia,1,0,,1,-76.532004,3.451668
48091,2018,Enero,Libia,0,1,,1,-74.140516,4.697157
48092,2018,Enero,Libia,0,1,,1,-75.42726,6.170465
48093,2018,Enero,Liechtenstein,0,1,,1,-75.527794,10.406342
48094,2018,Enero,Liechtenstein,3,1,,4,-74.140516,4.697157
48095,2018,Enero,Liechtenstein,0,1,,1,-77.35002,8.63337
48096,2018,Enero,Luxemburgo,1,0,,1,-77.35600000000001,0.81488
48097,2018,Enero,Luxemburgo,1,1,,2,-75.516486,10.446304
48098,2018,Enero,Luxemburgo,1,1,,2,-76.532004,3.451668
48099,2018,Enero,Luxemburgo,13,15,,28,-74.140516,4.697157
48100,2018,Enero,Luxemburgo,1,1,,2,-75.42726,6.170465
48101,2018,Enero,Macedonia,0,1,,1,-75.516486,10.446304
48102,2018,Enero,Macedonia,0,1,,1,-74.140516,4.697157
48103,2018,Enero,Madagascar,2,1,,3,-74.140516,4.697157
48104,2018,Enero,Malasia,1,0,,1,-69.941498,4.191162
48105,2018,Enero,Malasia,2,2,,4,-75.516486,10.446304
48106,2018,Enero,Malasia,1,1,,2,-74.77647900000001,10.886686
48107,2018,Enero,Malasia,12,17,,29,-74.140516,4.697157
48108,2018,Enero,Malasia,0,1,,1,-75.736374,4.815189
48109,2018,Enero,Malasia,1,5,,6,-75.42726,6.170465
48110,2018,Enero,Malawi,0,1,,1,-74.140516,4.697157
48111,2018,Enero,Malí,0,2,,2,-74.140516,4.697157
48112,2018,Enero,Malta,0,1,,1,-77.35600000000001,0.81488
48113,2018,Enero,Malta,1,2,,3,-75.516486,10.446304
48114,2018,Enero,Malta,5,11,,16,-74.140516,4.697157
48115,2018,Enero,Malta,1,0,,1,-75.42726,6.170465
48116,2018,Enero,Marruecos,0,1,,1,-77.35600000000001,0.81488
48117,2018,Enero,Marruecos,0,1,,1,-75.516486,10.446304
48118,2018,Enero,Marruecos,0,1,,1,-76.532004,3.451668
48119,2018,Enero,Marruecos,14,14,,28,-74.140516,4.697157
48120,2018,Enero,Marruecos,1,2,,3,-75.42726,6.170465
48121,2018,Enero,Mauricio,0,1,,1,-75.527794,10.406342
48122,2018,Enero,Mauricio,0,2,,2,-74.140516,4.697157
48123,2018,Enero,Mauricio,1,0,,1,-75.42726,6.170465
48124,2018,Enero,México,0,1,,1,-69.941498,4.191162
48125,2018,Enero,México,0,2,,2,-69.94143100000001,4.214082
48126,2018,Enero,México,0,1,,1,-76.876446,0.33002
48127,2018,Enero,México,25,35,,60,-77.35600000000001,0.81488
48128,2018,Enero,México,5,15,,20,-75.527794,10.406342
48129,2018,Enero,México,171,282,,453,-75.516486,10.446304
48130,2018,Enero,México,33,61,,94,-74.77647900000001,10.886686
48131,2018,Enero,México,1,4,,5,-72.129595,11.360028999999999
48132,2018,Enero,México,0,1,,1,-81.703935,12.574411099999999
48133,2018,Enero,México,2,3,,5,-81.70216500000001,12.5862
48134,2018,Enero,México,81,156,,237,-76.532004,3.451668
48135,2018,Enero,México,1,0,,1,-75.76635300000001,4.45285
48136,2018,Enero,México,3763,6109,,9872,-74.140516,4.697157
48137,2018,Enero,México,12,22,,34,-75.736374,4.815189
48138,2018,Enero,México,556,1154,,1710,-75.42726,6.170465
48139,2018,Enero,México,0,1,,1,-67.48402800000001,6.185536
48140,2018,Enero,México,4,1,,5,-70.74025300000001,7.088728999999999
48141,2018,Enero,México,5,14,,19,-73.181317,7.1280470000000005
48142,2018,Enero,México,17,35,,52,-72.453013,7.819
48143,2018,Enero,México,3,4,,7,-72.508188,7.927233
48144,2018,Enero,México,1,2,,3,-72.409396,8.36068
48145,2018,Enero,México,1,0,,1,-77.35002,8.63337
48146,2018,Enero,República de Moldavia,1,0,,1,-75.516486,10.446304
48147,2018,Enero,República de Moldavia,5,0,,5,-74.140516,4.697157
48148,2018,Enero,Mónaco,0,1,,1,-75.516486,10.446304
48149,2018,Enero,Mónaco,0,2,,2,-76.532004,3.451668
48150,2018,Enero,Mónaco,0,1,,1,-74.140516,4.697157
48151,2018,Enero,Mónaco,1,0,,1,-75.42726,6.170465
48152,2018,Enero,Mongolia,1,1,,2,-75.516486,10.446304
48153,2018,Enero,Mongolia,3,1,,4,-74.140516,4.697157
48154,2018,Enero,Montenegro,3,2,,5,-75.516486,10.446304
48155,2018,Enero,Montenegro,2,2,,4,-74.140516,4.697157
48156,2018,Enero,Montenegro,0,1,,1,-75.42726,6.170465
48157,2018,Enero,Mozambique,1,4,,5,-74.140516,4.697157
48158,2018,Enero,Myanmar,0,1,,1,-74.77647900000001,10.886686
48159,2018,Enero,Myanmar,0,1,,1,-74.213989,11.247722999999999
48160,2018,Enero,Myanmar,0,2,,2,-74.140516,4.697157
48161,2018,Enero,Nepal,1,0,,1,-75.516486,10.446304
48162,2018,Enero,Nepal,0,1,,1,-76.532004,3.451668
48163,2018,Enero,Nepal,1,1,,2,-74.140516,4.697157
48164,2018,Enero,Nicaragua,0,1,,1,-77.35600000000001,0.81488
48165,2018,Enero,Nicaragua,0,5,,5,-75.527794,10.406342
48166,2018,Enero,Nicaragua,29,29,,58,-75.516486,10.446304
48167,2018,Enero,Nicaragua,1,2,,3,-74.77647900000001,10.886686
48168,2018,Enero,Nicaragua,1,3,,4,-81.70216500000001,12.5862
48169,2018,Enero,Nicaragua,21,10,,31,-76.532004,3.451668
48170,2018,Enero,Nicaragua,1,0,,1,-75.76635300000001,4.45285
48171,2018,Enero,Nicaragua,98,77,,175,-74.140516,4.697157
48172,2018,Enero,Nicaragua,10,8,,18,-75.736374,4.815189
48173,2018,Enero,Nicaragua,19,27,,46,-75.42726,6.170465
48174,2018,Enero,Nicaragua,0,1,,1,-73.181317,7.1280470000000005
48175,2018,Enero,Nigeria,2,0,,2,-77.35600000000001,0.81488
48176,2018,Enero,Nigeria,1,0,,1,-76.532004,3.451668
48177,2018,Enero,Nigeria,3,7,,10,-74.140516,4.697157
48178,2018,Enero,Nigeria,0,2,,2,-75.42726,6.170465
48179,2018,Enero,Níger,0,1,,1,-74.140516,4.697157
48180,2018,Enero,Noruega,1,0,,1,-69.941498,4.191162
48181,2018,Enero,Noruega,0,1,,1,-69.94143100000001,4.214082
48182,2018,Enero,Noruega,3,6,,9,-77.35600000000001,0.81488
48183,2018,Enero,Noruega,3,8,,11,-75.527794,10.406342
48184,2018,Enero,Noruega,37,50,,87,-75.516486,10.446304
48185,2018,Enero,Noruega,33,31,,64,-74.213989,11.247722999999999
48186,2018,Enero,Noruega,9,10,,19,-76.532004,3.451668
48187,2018,Enero,Noruega,164,176,,340,-74.140516,4.697157
48188,2018,Enero,Noruega,17,22,,39,-75.42726,6.170465
48189,2018,Enero,Noruega,2,3,,5,-77.35002,8.63337
48190,2018,Enero,Nueva Zelanda,1,1,,2,-69.941498,4.191162
48191,2018,Enero,Nueva Zelanda,1,1,,2,-76.876446,0.33002
48192,2018,Enero,Nueva Zelanda,7,8,,15,-77.35600000000001,0.81488
48193,2018,Enero,Nueva Zelanda,6,5,,11,-75.527794,10.406342
48194,2018,Enero,Nueva Zelanda,21,24,,45,-75.516486,10.446304
48195,2018,Enero,Nueva Zelanda,2,6,,8,-74.77647900000001,10.886686
48196,2018,Enero,Nueva Zelanda,1,1,,2,-74.213989,11.247722999999999
48197,2018,Enero,Nueva Zelanda,0,1,,1,-72.129595,11.360028999999999
48198,2018,Enero,Nueva Zelanda,1,2,,3,-76.532004,3.451668
48199,2018,Enero,Nueva Zelanda,71,101,,172,-74.140516,4.697157
48200,2018,Enero,Nueva Zelanda,16,30,,46,-75.42726,6.170465
48201,2018,Enero,Nueva Zelanda,3,3,,6,-77.35002,8.63337
48202,2018,Enero,Omán,0,1,,1,-74.140516,4.697157
48203,2018,Enero,Países Bajos,0,2,,2,-69.941498,4.191162
48204,2018,Enero,Países Bajos,2,7,,9,-69.94143100000001,4.214082
48205,2018,Enero,Países Bajos,2,5,,7,-76.876446,0.33002
48206,2018,Enero,Países Bajos,42,43,,85,-77.35600000000001,0.81488
48207,2018,Enero,Países Bajos,50,67,,117,-75.527794,10.406342
48208,2018,Enero,Países Bajos,150,218,,368,-75.516486,10.446304
48209,2018,Enero,Países Bajos,10,17,,27,-74.77647900000001,10.886686
48210,2018,Enero,Países Bajos,0,3,,3,-74.765343,10.970933
48211,2018,Enero,Países Bajos,1,2,,3,-74.213989,11.247722999999999
48212,2018,Enero,Países Bajos,1,8,,9,-72.129595,11.360028999999999
48213,2018,Enero,Países Bajos,1,0,,1,-81.372937,13.338761300000002
48214,2018,Enero,Países Bajos,27,44,,71,-76.532004,3.451668
48215,2018,Enero,Países Bajos,0,2,,2,-75.76635300000001,4.45285
48216,2018,Enero,Países Bajos,1396,1817,,3213,-74.140516,4.697157
48217,2018,Enero,Países Bajos,3,4,,7,-75.736374,4.815189
48218,2018,Enero,Países Bajos,161,226,,387,-75.42726,6.170465
48219,2018,Enero,Países Bajos,11,6,,17,-73.181317,7.1280470000000005
48220,2018,Enero,Países Bajos,0,11,,11,-72.453013,7.819
48221,2018,Enero,Países Bajos,0,1,,1,-72.409396,8.36068
48222,2018,Enero,Países Bajos,5,7,,12,-77.35002,8.63337
48223,2018,Enero,Pakistán,0,2,,2,-75.516486,10.446304
48224,2018,Enero,Pakistán,5,16,,21,-74.140516,4.697157
48225,2018,Enero,Pakistán,0,5,,5,-75.42726,6.170465
48226,2018,Enero,Panamá,0,1,,1,-69.941498,4.191162
48227,2018,Enero,Panamá,1,5,,6,-77.35600000000001,0.81488
48228,2018,Enero,Panamá,0,30,,30,-75.527794,10.406342
48229,2018,Enero,Panamá,665,652,,1317,-75.516486,10.446304
48230,2018,Enero,Panamá,119,137,,256,-74.77647900000001,10.886686
48231,2018,Enero,Panamá,0,1,,1,-72.129595,11.360028999999999
48232,2018,Enero,Panamá,73,69,,142,-81.70216500000001,12.5862
48233,2018,Enero,Panamá,335,225,,560,-76.532004,3.451668
48234,2018,Enero,Panamá,39,36,,75,-75.76635300000001,4.45285
48235,2018,Enero,Panamá,1476,1353,,2829,-74.140516,4.697157
48236,2018,Enero,Panamá,54,67,,121,-75.736374,4.815189
48237,2018,Enero,Panamá,2384,1569,,3953,-75.42726,6.170465
48238,2018,Enero,Panamá,2,6,,8,-77.762647,7.102626
48239,2018,Enero,Panamá,13,16,,29,-73.181317,7.1280470000000005
48240,2018,Enero,Panamá,3,4,,7,-72.453013,7.819
48241,2018,Enero,Panamá,0,1,,1,-76.7333,8.06667
48242,2018,Enero,Panamá,0,1,,1,-72.409396,8.36068
48243,2018,Enero,Panamá,8,8,,16,-77.35002,8.63337
48244,2018,Enero,Papúa Nueva Guinea,0,1,,1,-75.516486,10.446304
48245,2018,Enero,Paraguay,3,1,,4,-77.35600000000001,0.81488
48246,2018,Enero,Paraguay,3,2,,5,-75.527794,10.406342
48247,2018,Enero,Paraguay,71,47,,118,-75.516486,10.446304
48248,2018,Enero,Paraguay,2,11,,13,-74.77647900000001,10.886686
48249,2018,Enero,Paraguay,0,1,,1,-72.129595,11.360028999999999
48250,2018,Enero,Paraguay,60,44,,104,-81.70216500000001,12.5862
48251,2018,Enero,Paraguay,13,10,,23,-76.532004,3.451668
48252,2018,Enero,Paraguay,310,199,,509,-74.140516,4.697157
48253,2018,Enero,Paraguay,1,2,,3,-75.736374,4.815189
48254,2018,Enero,Paraguay,17,24,,41,-75.42726,6.170465
48255,2018,Enero,Paraguay,0,1,,1,-72.453013,7.819
48256,2018,Enero,Paraguay,0,3,,3,-72.508188,7.927233
48257,2018,Enero,Perú,21,18,,39,-69.941498,4.191162
48258,2018,Enero,Perú,64,75,,139,-69.94143100000001,4.214082
48259,2018,Enero,Perú,0,2,,2,-74.78366,0.18595699999999998
48260,2018,Enero,Perú,14,15,,29,-76.876446,0.33002
48261,2018,Enero,Perú,0,2,,2,-77.84700600000001,0.8124359999999999
48262,2018,Enero,Perú,250,515,,765,-77.35600000000001,0.81488
48263,2018,Enero,Perú,33,38,,71,-75.527794,10.406342
48264,2018,Enero,Perú,518,361,,879,-75.516486,10.446304
48265,2018,Enero,Perú,12,15,,27,-74.77647900000001,10.886686
48266,2018,Enero,Perú,0,5,,5,-74.765343,10.970933
48267,2018,Enero,Perú,0,1,,1,-74.213989,11.247722999999999
48268,2018,Enero,Perú,8,18,,26,-72.129595,11.360028999999999
48269,2018,Enero,Perú,341,276,,617,-81.70216500000001,12.5862
48270,2018,Enero,Perú,182,261,,443,-76.532004,3.451668
48271,2018,Enero,Perú,0,2,,2,-77.061029,3.8844260000000004
48272,2018,Enero,Perú,3471,4080,,7551,-74.140516,4.697157
48273,2018,Enero,Perú,2,7,,9,-75.736374,4.815189
48274,2018,Enero,Perú,330,533,,863,-75.42726,6.170465
48275,2018,Enero,Perú,0,1,,1,-67.48402800000001,6.185536
48276,2018,Enero,Perú,0,2,,2,-70.74025300000001,7.088728999999999
48277,2018,Enero,Perú,4,2,,6,-73.181317,7.1280470000000005
48278,2018,Enero,Perú,98,213,,311,-72.453013,7.819
48279,2018,Enero,Perú,1,4,,5,-72.409396,8.36068
48280,2018,Enero,Perú,2,0,,2,-77.35002,8.63337
48281,2018,Enero,Palestina,1,2,,3,-74.140516,4.697157
48282,2018,Enero,Palestina,1,0,,1,-75.42726,6.170465
48283,2018,Enero,Polonia,0,1,,1,-69.94143100000001,4.214082
48284,2018,Enero,Polonia,0,1,,1,-76.876446,0.33002
48285,2018,Enero,Polonia,3,8,,11,-77.35600000000001,0.81488
48286,2018,Enero,Polonia,1,10,,11,-75.527794,10.406342
48287,2018,Enero,Polonia,30,58,,88,-75.516486,10.446304
48288,2018,Enero,Polonia,1,4,,5,-74.77647900000001,10.886686
48289,2018,Enero,Polonia,1,1,,2,-74.213989,11.247722999999999
48290,2018,Enero,Polonia,0,1,,1,-81.70216500000001,12.5862
48291,2018,Enero,Polonia,15,14,,29,-76.532004,3.451668
48292,2018,Enero,Polonia,0,2,,2,-77.061029,3.8844260000000004
48293,2018,Enero,Polonia,200,236,,436,-74.140516,4.697157
48294,2018,Enero,Polonia,2,11,,13,-75.736374,4.815189
48295,2018,Enero,Polonia,22,24,,46,-75.42726,6.170465
48296,2018,Enero,Polonia,0,8,,8,-67.48402800000001,6.185536
48297,2018,Enero,Polonia,2,2,,4,-77.35002,8.63337
48298,2018,Enero,Portugal,0,1,,1,-69.94143100000001,4.214082
48299,2018,Enero,Portugal,27,27,,54,-77.35600000000001,0.81488
48300,2018,Enero,Portugal,31,26,,57,-75.516486,10.446304
48301,2018,Enero,Portugal,2,12,,14,-74.77647900000001,10.886686
48302,2018,Enero,Portugal,1,1,,2,-74.213989,11.247722999999999
48303,2018,Enero,Portugal,2,5,,7,-72.129595,11.360028999999999
48304,2018,Enero,Portugal,1,2,,3,-81.70216500000001,12.5862
48305,2018,Enero,Portugal,23,35,,58,-76.532004,3.451668
48306,2018,Enero,Portugal,244,534,,778,-74.140516,4.697157
48307,2018,Enero,Portugal,0,1,,1,-75.736374,4.815189
48308,2018,Enero,Portugal,31,76,,107,-75.42726,6.170465
48309,2018,Enero,Portugal,1,2,,3,-70.74025300000001,7.088728999999999
48310,2018,Enero,Portugal,0,1,,1,-73.181317,7.1280470000000005
48311,2018,Enero,Portugal,11,19,,30,-72.453013,7.819
48312,2018,Enero,Portugal,1,0,,1,-72.409396,8.36068
48313,2018,Enero,Puerto Rico/Territorio de Estados Unidos,1,0,,1,-74.140516,4.697157
48314,2018,Enero,Reino Unido de Gran Bretaña e Irlanda del Norte,3,1,,4,-69.941498,4.191162
48315,2018,Enero,Reino Unido de Gran Bretaña e Irlanda del Norte,6,6,,12,-69.94143100000001,4.214082
48316,2018,Enero,Reino Unido de Gran Bretaña e Irlanda del Norte,5,4,,9,-76.876446,0.33002
48317,2018,Enero,Reino Unido de Gran Bretaña e Irlanda del Norte,43,81,,124,-77.35600000000001,0.81488
48318,2018,Enero,Reino Unido de Gran Bretaña e Irlanda del Norte,30,39,,69,-75.527794,10.406342
48319,2018,Enero,Reino Unido de Gran Bretaña e Irlanda del Norte,161,190,,351,-75.516486,10.446304
48320,2018,Enero,Reino Unido de Gran Bretaña e Irlanda del Norte,2,20,,22,-74.77647900000001,10.886686
48321,2018,Enero,Reino Unido de Gran Bretaña e Irlanda del Norte,13,17,,30,-74.213989,11.247722999999999
48322,2018,Enero,Reino Unido de Gran Bretaña e Irlanda del Norte,4,1,,5,-72.129595,11.360028999999999
48323,2018,Enero,Reino Unido de Gran Bretaña e Irlanda del Norte,1,4,,5,-81.70216500000001,12.5862
48324,2018,Enero,Reino Unido de Gran Bretaña e Irlanda del Norte,26,62,,88,-76.532004,3.451668
48325,2018,Enero,Reino Unido de Gran Bretaña e Irlanda del Norte,1,0,,1,-77.061029,3.8844260000000004
48326,2018,Enero,Reino Unido de Gran Bretaña e Irlanda del Norte,0,2,,2,-75.76635300000001,4.45285
48327,2018,Enero,Reino Unido de Gran Bretaña e Irlanda del Norte,1220,2161,,3381,-74.140516,4.697157
48328,2018,Enero,Reino Unido de Gran Bretaña e Irlanda del Norte,1,7,,8,-75.736374,4.815189
48329,2018,Enero,Reino Unido de Gran Bretaña e Irlanda del Norte,112,236,,348,-75.42726,6.170465
48330,2018,Enero,Reino Unido de Gran Bretaña e Irlanda del Norte,1,1,,2,-73.181317,7.1280470000000005
48331,2018,Enero,Reino Unido de Gran Bretaña e Irlanda del Norte,3,4,,7,-72.453013,7.819
48332,2018,Enero,Reino Unido de Gran Bretaña e Irlanda del Norte,22,22,,44,-77.35002,8.63337
48333,2018,Enero,República Dominicana,0,10,,10,-69.941498,4.191162
48334,2018,Enero,República Dominicana,0,1,,1,-76.876446,0.33002
48335,2018,Enero,República Dominicana,7,15,,22,-77.35600000000001,0.81488
48336,2018,Enero,República Dominicana,2,3,,5,-75.527794,10.406342
48337,2018,Enero,República Dominicana,105,111,,216,-75.516486,10.446304
48338,2018,Enero,República Dominicana,18,30,,48,-74.77647900000001,10.886686
48339,2018,Enero,República Dominicana,1,1,,2,-72.129595,11.360028999999999
48340,2018,Enero,República Dominicana,0,2,,2,-81.70216500000001,12.5862
48341,2018,Enero,República Dominicana,25,30,,55,-76.532004,3.451668
48342,2018,Enero,República Dominicana,470,545,,1015,-74.140516,4.697157
48343,2018,Enero,República Dominicana,3,3,,6,-75.736374,4.815189
48344,2018,Enero,República Dominicana,58,75,,133,-75.42726,6.170465
48345,2018,Enero,República Dominicana,1,2,,3,-73.181317,7.1280470000000005
48346,2018,Enero,República Dominicana,4,10,,14,-72.453013,7.819
48347,2018,Enero,República Dominicana,0,1,,1,-72.409396,8.36068
48348,2018,Enero,Rumania,3,0,,3,-76.876446,0.33002
48349,2018,Enero,Rumania,5,6,,11,-77.35600000000001,0.81488
48350,2018,Enero,Rumania,1,2,,3,-75.527794,10.406342
48351,2018,Enero,Rumania,10,27,,37,-75.516486,10.446304
48352,2018,Enero,Rumania,2,3,,5,-74.77647900000001,10.886686
48353,2018,Enero,Rumania,0,1,,1,-81.70216500000001,12.5862
48354,2018,Enero,Rumania,6,3,,9,-76.532004,3.451668
48355,2018,Enero,Rumania,70,75,,145,-74.140516,4.697157
48356,2018,Enero,Rumania,13,8,,21,-75.42726,6.170465
48357,2018,Enero,Rumania,1,0,,1,-72.453013,7.819
48358,2018,Enero,Federación de Rusia,1,1,,2,-69.941498,4.191162
48359,2018,Enero,Federación de Rusia,3,2,,5,-69.94143100000001,4.214082
48360,2018,Enero,Federación de Rusia,15,13,,28,-77.35600000000001,0.81488
48361,2018,Enero,Federación de Rusia,3,10,,13,-75.527794,10.406342
48362,2018,Enero,Federación de Rusia,30,27,,57,-75.516486,10.446304
48363,2018,Enero,Federación de Rusia,4,4,,8,-74.77647900000001,10.886686
48364,2018,Enero,Federación de Rusia,0,2,,2,-74.765343,10.970933
48365,2018,Enero,Federación de Rusia,0,3,,3,-74.213989,11.247722999999999
48366,2018,Enero,Federación de Rusia,1,1,,2,-81.70216500000001,12.5862
48367,2018,Enero,Federación de Rusia,1,1,,2,-81.372937,13.338761300000002
48368,2018,Enero,Federación de Rusia,5,16,,21,-76.532004,3.451668
48369,2018,Enero,Federación de Rusia,1,0,,1,-75.76635300000001,4.45285
48370,2018,Enero,Federación de Rusia,249,272,,521,-74.140516,4.697157
48371,2018,Enero,Federación de Rusia,0,1,,1,-75.736374,4.815189
48372,2018,Enero,Federación de Rusia,18,9,,27,-75.42726,6.170465
48373,2018,Enero,Federación de Rusia,2,3,,5,-72.453013,7.819
48374,2018,Enero,Federación de Rusia,1,0,,1,-72.409396,8.36068
48375,2018,Enero,Federación de Rusia,1,4,,5,-77.35002,8.63337
48376,2018,Enero,Federación de Rusia,0,5,,5,-75.68164200000001,9.402597
48377,2018,Enero,Rwanda,0,1,,1,-74.140516,4.697157
48378,2018,Enero,San Cristóbal y Nevis,0,1,,1,-75.516486,10.446304
48379,2018,Enero,San Cristóbal y Nevis,3,4,,7,-74.140516,4.697157
48380,2018,Enero,San Cristóbal y Nevis,1,0,,1,-73.181317,7.1280470000000005
48381,2018,Enero,San Marino,1,1,,2,-74.140516,4.697157
48382,2018,Enero,San  Vicente y las Granadinas,0,1,,1,-81.70216500000001,12.5862
48383,2018,Enero,San  Vicente y las Granadinas,0,1,,1,-76.532004,3.451668
48384,2018,Enero,San  Vicente y las Granadinas,2,3,,5,-74.140516,4.697157
48385,2018,Enero,San  Vicente y las Granadinas,1,0,,1,-75.42726,6.170465
48386,2018,Enero,Santa Lucia,2,0,,2,-75.516486,10.446304
48387,2018,Enero,Santa Lucia,1,0,,1,-74.77647900000001,10.886686
48388,2018,Enero,Santa Lucia,1,4,,5,-74.140516,4.697157
48389,2018,Enero,Santa Sede/Ciudad del Vaticano,0,1,,1,-74.140516,4.697157
48390,2018,Enero,Senegal,0,2,,2,-74.140516,4.697157
48391,2018,Enero,Serbia,0,1,,1,-76.876446,0.33002
48392,2018,Enero,Serbia,1,2,,3,-76.532004,3.451668
48393,2018,Enero,Serbia,7,24,,31,-74.140516,4.697157
48394,2018,Enero,Serbia,1,3,,4,-75.42726,6.170465
48395,2018,Enero,Serbia,0,1,,1,-72.453013,7.819
48396,2018,Enero,Singapur,0,1,,1,-69.94143100000001,4.214082
48397,2018,Enero,Singapur,3,2,,5,-75.516486,10.446304
48398,2018,Enero,Singapur,0,3,,3,-74.77647900000001,10.886686
48399,2018,Enero,Singapur,27,33,,60,-74.140516,4.697157
48400,2018,Enero,Singapur,2,2,,4,-75.42726,6.170465
48401,2018,Enero,República Árabe Siria,1,1,,2,-74.140516,4.697157
48402,2018,Enero,República Árabe Siria,0,1,,1,-75.42726,6.170465
48403,2018,Enero,Sri Lanka,0,4,,4,-75.527794,10.406342
48404,2018,Enero,Sri Lanka,0,5,,5,-75.516486,10.446304
48405,2018,Enero,Sri Lanka,2,2,,4,-74.140516,4.697157
48406,2018,Enero,Sri Lanka,0,2,,2,-75.42726,6.170465
48407,2018,Enero,Sudáfrica,1,1,,2,-77.35600000000001,0.81488
48408,2018,Enero,Sudáfrica,3,7,,10,-75.527794,10.406342
48409,2018,Enero,Sudáfrica,3,2,,5,-75.516486,10.446304
48410,2018,Enero,Sudáfrica,4,5,,9,-74.77647900000001,10.886686
48411,2018,Enero,Sudáfrica,0,1,,1,-76.532004,3.451668
48412,2018,Enero,Sudáfrica,23,35,,58,-74.140516,4.697157
48413,2018,Enero,Sudáfrica,1,1,,2,-75.736374,4.815189
48414,2018,Enero,Sudáfrica,1,2,,3,-75.42726,6.170465
48415,2018,Enero,Sudáfrica,0,1,,1,-72.453013,7.819
48416,2018,Enero,Suecia,0,1,,1,-69.941498,4.191162
48417,2018,Enero,Suecia,3,4,,7,-69.94143100000001,4.214082
48418,2018,Enero,Suecia,9,18,,27,-77.35600000000001,0.81488
48419,2018,Enero,Suecia,10,8,,18,-75.527794,10.406342
48420,2018,Enero,Suecia,76,92,,168,-75.516486,10.446304
48421,2018,Enero,Suecia,5,8,,13,-74.77647900000001,10.886686
48422,2018,Enero,Suecia,1,6,,7,-74.213989,11.247722999999999
48423,2018,Enero,Suecia,0,1,,1,-72.129595,11.360028999999999
48424,2018,Enero,Suecia,0,2,,2,-81.70216500000001,12.5862
48425,2018,Enero,Suecia,17,20,,37,-76.532004,3.451668
48426,2018,Enero,Suecia,330,414,,744,-74.140516,4.697157
48427,2018,Enero,Suecia,0,2,,2,-75.736374,4.815189
48428,2018,Enero,Suecia,39,58,,97,-75.42726,6.170465
48429,2018,Enero,Suecia,0,2,,2,-70.74025300000001,7.088728999999999
48430,2018,Enero,Suecia,1,4,,5,-72.453013,7.819
48431,2018,Enero,Suecia,5,3,,8,-77.35002,8.63337
48432,2018,Enero,Suiza,5,4,,9,-69.941498,4.191162
48433,2018,Enero,Suiza,3,6,,9,-69.94143100000001,4.214082
48434,2018,Enero,Suiza,2,4,,6,-76.876446,0.33002
48435,2018,Enero,Suiza,27,37,,64,-77.35600000000001,0.81488
48436,2018,Enero,Suiza,24,13,,37,-75.527794,10.406342
48437,2018,Enero,Suiza,59,83,,142,-75.516486,10.446304
48438,2018,Enero,Suiza,7,10,,17,-74.77647900000001,10.886686
48439,2018,Enero,Suiza,1,13,,14,-74.213989,11.247722999999999
48440,2018,Enero,Suiza,4,3,,7,-81.70216500000001,12.5862
48441,2018,Enero,Suiza,31,51,,82,-76.532004,3.451668
48442,2018,Enero,Suiza,575,825,,1400,-74.140516,4.697157
48443,2018,Enero,Suiza,0,2,,2,-75.736374,4.815189
48444,2018,Enero,Suiza,66,114,,180,-75.42726,6.170465
48445,2018,Enero,Suiza,1,0,,1,-67.48402800000001,6.185536
48446,2018,Enero,Suiza,2,1,,3,-72.453013,7.819
48447,2018,Enero,Suiza,0,2,,2,-72.409396,8.36068
48448,2018,Enero,Suiza,6,6,,12,-77.35002,8.63337
48449,2018,Enero,Surinam,8,29,,37,-74.140516,4.697157
48450,2018,Enero,Surinam,0,2,,2,-75.42726,6.170465
48451,2018,Enero,Taiwán,1,0,,1,-74.140516,4.697157
48452,2018,Enero,Tailandia,1,2,,3,-75.516486,10.446304
48453,2018,Enero,Tailandia,19,15,,34,-74.140516,4.697157
48454,2018,Enero,Tailandia,2,3,,5,-75.42726,6.170465
48455,2018,Enero,Tanzania,1,0,,1,-74.140516,4.697157
48456,2018,Enero,Togo,0,1,,1,-74.140516,4.697157
48457,2018,Enero,Trinidad y Tobago,1,0,,1,-77.35600000000001,0.81488
48458,2018,Enero,Trinidad y Tobago,0,1,,1,-75.527794,10.406342
48459,2018,Enero,Trinidad y Tobago,5,5,,10,-75.516486,10.446304
48460,2018,Enero,Trinidad y Tobago,0,1,,1,-74.77647900000001,10.886686
48461,2018,Enero,Trinidad y Tobago,4,6,,10,-76.532004,3.451668
48462,2018,Enero,Trinidad y Tobago,21,30,,51,-74.140516,4.697157
48463,2018,Enero,Trinidad y Tobago,3,13,,16,-75.42726,6.170465
48464,2018,Enero,Trinidad y Tobago,0,2,,2,-70.74025300000001,7.088728999999999
48465,2018,Enero,Trinidad y Tobago,0,1,,1,-73.181317,7.1280470000000005
48466,2018,Enero,Trinidad y Tobago,1,1,,2,-72.453013,7.819
48467,2018,Enero,Túnez,16,14,,30,-75.516486,10.446304
48468,2018,Enero,Túnez,6,8,,14,-74.140516,4.697157
48469,2018,Enero,Turquía,6,9,,15,-77.35600000000001,0.81488
48470,2018,Enero,Turquía,0,2,,2,-75.527794,10.406342
48471,2018,Enero,Turquía,8,20,,28,-75.516486,10.446304
48472,2018,Enero,Turquía,2,5,,7,-74.77647900000001,10.886686
48473,2018,Enero,Turquía,5,9,,14,-76.532004,3.451668
48474,2018,Enero,Turquía,182,377,,559,-74.140516,4.697157
48475,2018,Enero,Turquía,3,20,,23,-75.42726,6.170465
48476,2018,Enero,Ucrania,1,0,,1,-76.876446,0.33002
48477,2018,Enero,Ucrania,2,2,,4,-77.35600000000001,0.81488
48478,2018,Enero,Ucrania,1,6,,7,-75.527794,10.406342
48479,2018,Enero,Ucrania,3,5,,8,-75.516486,10.446304
48480,2018,Enero,Ucrania,0,9,,9,-74.77647900000001,10.886686
48481,2018,Enero,Ucrania,0,11,,11,-74.213989,11.247722999999999
48482,2018,Enero,Ucrania,1,2,,3,-76.532004,3.451668
48483,2018,Enero,Ucrania,36,19,,55,-74.140516,4.697157
48484,2018,Enero,Ucrania,6,2,,8,-75.42726,6.170465
48485,2018,Enero,Uganda,1,2,,3,-74.140516,4.697157
48486,2018,Enero,Uruguay,1,0,,1,-69.94143100000001,4.214082
48487,2018,Enero,Uruguay,7,24,,31,-77.35600000000001,0.81488
48488,2018,Enero,Uruguay,8,4,,12,-75.527794,10.406342
48489,2018,Enero,Uruguay,89,62,,151,-75.516486,10.446304
48490,2018,Enero,Uruguay,4,4,,8,-74.77647900000001,10.886686
48491,2018,Enero,Uruguay,3,4,,7,-72.129595,11.360028999999999
48492,2018,Enero,Uruguay,5,4,,9,-81.70216500000001,12.5862
48493,2018,Enero,Uruguay,8,25,,33,-76.532004,3.451668
48494,2018,Enero,Uruguay,482,550,,1032,-74.140516,4.697157
48495,2018,Enero,Uruguay,2,0,,2,-75.736374,4.815189
48496,2018,Enero,Uruguay,37,46,,83,-75.42726,6.170465
48497,2018,Enero,Uruguay,3,3,,6,-73.181317,7.1280470000000005
48498,2018,Enero,Uruguay,4,7,,11,-72.453013,7.819
48499,2018,Enero,Uzbekistán,1,0,,1,-75.516486,10.446304
48500,2018,Enero,Uzbekistán,1,0,,1,-74.140516,4.697157
48501,2018,Enero,Venezuela,5,3,,8,-69.941498,4.191162
48502,2018,Enero,Venezuela,0,1,,1,-69.94143100000001,4.214082
48503,2018,Enero,Venezuela,24,24,,48,-76.876446,0.33002
48504,2018,Enero,Venezuela,2200,2314,,4514,-77.35600000000001,0.81488
48505,2018,Enero,Venezuela,0,1,,1,-78.802679,18.00143
48506,2018,Enero,Venezuela,11,21,,32,-75.527794,10.406342
48507,2018,Enero,Venezuela,214,332,,546,-75.516486,10.446304
48508,2018,Enero,Venezuela,128,212,,340,-74.77647900000001,10.886686
48509,2018,Enero,Venezuela,0,2,,2,-74.765343,10.970933
48510,2018,Enero,Venezuela,6,32,,38,-74.232675,11.117206
48511,2018,Enero,Venezuela,7809,10209,,18018,-72.129595,11.360028999999999
48512,2018,Enero,Venezuela,7,2,,9,-72.919186,11.52863
48513,2018,Enero,Venezuela,0,3,,3,-71.983761,12.165168
48514,2018,Enero,Venezuela,2,1,,3,-81.70216500000001,12.5862
48515,2018,Enero,Venezuela,108,134,,242,-76.532004,3.451668
48516,2018,Enero,Venezuela,3,8,,11,-67.927521,3.866713
48517,2018,Enero,Venezuela,4,2,,6,-75.76635300000001,4.45285
48518,2018,Enero,Venezuela,7073,6646,,13719,-74.140516,4.697157
48519,2018,Enero,Venezuela,13,18,,31,-75.736374,4.815189
48520,2018,Enero,Venezuela,980,1123,,2103,-75.42726,6.170465
48521,2018,Enero,Venezuela,25,35,,60,-67.48402800000001,6.185536
48522,2018,Enero,Venezuela,405,571,,976,-70.74025300000001,7.088728999999999
48523,2018,Enero,Venezuela,13,16,,29,-73.181317,7.1280470000000005
48524,2018,Enero,Venezuela,33395,47879,,81274,-72.453013,7.819
48525,2018,Enero,Venezuela,5,15,,20,-72.508188,7.927233
48526,2018,Enero,Venezuela,2086,2853,,4939,-72.409396,8.36068
48527,2018,Enero,Venezuela,3,1,,4,-77.35002,8.63337
48528,2018,Enero,Vietnam,1,0,,1,-77.35600000000001,0.81488
48529,2018,Enero,Vietnam,0,1,,1,-74.77647900000001,10.886686
48530,2018,Enero,Vietnam,3,8,,11,-74.140516,4.697157
48531,2018,Enero,República Árabe de Yemen,0,1,,1,-74.140516,4.697157
48532,2018,Enero,Zimbabue,0,1,,1,-76.532004,3.451668
48533,2018,Enero,Zimbabue,0,2,,2,-74.140516,4.697157
48534,2018,Enero,Islas Turcas y Caicos/Territorio Británico de Ultramar,0,1,,1,-75.42726,6.170465
48535,2018,Enero,Refugiado Otro,0,1,,1,-74.140516,4.697157
48536,2018,Enero,Refugiado,1,3,,4,-75.516486,10.446304
48537,2018,Enero,Refugiado,2,1,,3,-74.140516,4.697157
48538,2018,Enero,Refugiado,2,1,,3,-75.42726,6.170465
48539,2018,Enero,Desconocido,0,1,,1,-77.84700600000001,0.8124359999999999
48540,2018,Enero,Desconocido,1,5,,6,-75.516486,10.446304
48541,2018,Enero,Desconocido,1,0,,1,-74.77647900000001,10.886686
48542,2018,Enero,Desconocido,0,2,,2,-76.532004,3.451668
48543,2018,Enero,Desconocido,57,110,,167,-74.140516,4.697157
48544,2018,Enero,Desconocido,0,4,,4,-72.453013,7.819
48545,2018,Febrero,Albania,1,0,,1,-74.140516,4.697157
48546,2018,Febrero,Albania,0,2,,2,-75.42726,6.170465
48547,2018,Febrero,Alemania,9,15,,24,-69.941498,4.191162
48548,2018,Febrero,Alemania,15,12,,27,-69.94143100000001,4.214082
48549,2018,Febrero,Alemania,4,5,,9,-76.876446,0.33002
48550,2018,Febrero,Alemania,0,1,,1,-77.84700600000001,0.8124359999999999
48551,2018,Febrero,Alemania,124,141,,265,-77.35600000000001,0.81488
48552,2018,Febrero,Alemania,47,46,,93,-75.527794,10.406342
48553,2018,Febrero,Alemania,148,245,,393,-75.516486,10.446304
48554,2018,Febrero,Alemania,40,48,,88,-74.77647900000001,10.886686
48555,2018,Febrero,Alemania,6,9,,15,-74.213989,11.247722999999999
48556,2018,Febrero,Alemania,1,2,,3,-72.129595,11.360028999999999
48557,2018,Febrero,Alemania,1,5,,6,-81.703935,12.574411099999999
48558,2018,Febrero,Alemania,4,6,,10,-81.70216500000001,12.5862
48559,2018,Febrero,Alemania,4,4,,8,-81.372937,13.338761300000002
48560,2018,Febrero,Alemania,75,92,,167,-76.532004,3.451668
48561,2018,Febrero,Alemania,2,0,,2,-77.061029,3.8844260000000004
48562,2018,Febrero,Alemania,1,0,,1,-75.76635300000001,4.45285
48563,2018,Febrero,Alemania,2390,3168,,5558,-74.140516,4.697157
48564,2018,Febrero,Alemania,2,4,,6,-75.736374,4.815189
48565,2018,Febrero,Alemania,184,319,,503,-75.42726,6.170465
48566,2018,Febrero,Alemania,2,3,,5,-73.181317,7.1280470000000005
48567,2018,Febrero,Alemania,5,11,,16,-72.453013,7.819
48568,2018,Febrero,Alemania,0,3,,3,-72.409396,8.36068
48569,2018,Febrero,Alemania,17,21,,38,-77.35002,8.63337
48570,2018,Febrero,Andorra,1,0,,1,-69.94143100000001,4.214082
48571,2018,Febrero,Andorra,0,1,,1,-75.516486,10.446304
48572,2018,Febrero,Andorra,1,10,,11,-74.140516,4.697157
48573,2018,Febrero,Andorra,2,2,,4,-75.42726,6.170465
48574,2018,Febrero,Angola,3,0,,3,-76.532004,3.451668
48575,2018,Febrero,Angola,1,3,,4,-74.140516,4.697157
48576,2018,Febrero,Antigua y Barbuda,1,1,,2,-74.140516,4.697157
48577,2018,Febrero,Antigua y Barbuda,1,0,,1,-75.42726,6.170465
48578,2018,Febrero,Países Bajos,1,3,,4,-75.42726,6.170465
48579,2018,Febrero,Arabia Saudita,0,1,,1,-75.516486,10.446304
48580,2018,Febrero,Arabia Saudita,0,6,,6,-74.140516,4.697157
48581,2018,Febrero,Arabia Saudita,0,1,,1,-75.42726,6.170465
48582,2018,Febrero,Argelia,0,1,,1,-74.213989,11.247722999999999
48583,2018,Febrero,Argelia,1,4,,5,-74.140516,4.697157
48584,2018,Febrero,Argelia,0,1,,1,-75.42726,6.170465
48585,2018,Febrero,Argentina,2,4,,6,-69.941498,4.191162
48586,2018,Febrero,Argentina,2,5,,7,-69.94143100000001,4.214082
48587,2018,Febrero,Argentina,10,10,,20,-76.876446,0.33002
48588,2018,Febrero,Argentina,121,188,,309,-77.35600000000001,0.81488
48589,2018,Febrero,Argentina,0,2,,2,-78.802679,18.00143
48590,2018,Febrero,Argentina,361,277,,638,-75.527794,10.406342
48591,2018,Febrero,Argentina,1551,1181,,2732,-75.516486,10.446304
48592,2018,Febrero,Argentina,39,67,,106,-74.77647900000001,10.886686
48593,2018,Febrero,Argentina,3,8,,11,-72.129595,11.360028999999999
48594,2018,Febrero,Argentina,408,339,,747,-81.70216500000001,12.5862
48595,2018,Febrero,Argentina,63,84,,147,-76.532004,3.451668
48596,2018,Febrero,Argentina,0,1,,1,-75.76635300000001,4.45285
48597,2018,Febrero,Argentina,8206,8665,,16871,-74.140516,4.697157
48598,2018,Febrero,Argentina,9,9,,18,-75.736374,4.815189
48599,2018,Febrero,Argentina,136,258,,394,-75.42726,6.170465
48600,2018,Febrero,Argentina,1,4,,5,-73.181317,7.1280470000000005
48601,2018,Febrero,Argentina,8,28,,36,-72.453013,7.819
48602,2018,Febrero,Argentina,2,5,,7,-72.409396,8.36068
48603,2018,Febrero,Argentina,1,2,,3,-77.35002,8.63337
48604,2018,Febrero,República de Armenia,1,0,,1,-75.516486,10.446304
48605,2018,Febrero,República de Armenia,1,1,,2,-74.140516,4.697157
48606,2018,Febrero,Australia,1,4,,5,-69.941498,4.191162
48607,2018,Febrero,Australia,5,2,,7,-69.94143100000001,4.214082
48608,2018,Febrero,Australia,1,1,,2,-76.876446,0.33002
48609,2018,Febrero,Australia,22,32,,54,-77.35600000000001,0.81488
48610,2018,Febrero,Australia,15,27,,42,-75.527794,10.406342
48611,2018,Febrero,Australia,58,79,,137,-75.516486,10.446304
48612,2018,Febrero,Australia,3,18,,21,-74.77647900000001,10.886686
48613,2018,Febrero,Australia,1,1,,2,-74.213989,11.247722999999999
48614,2018,Febrero,Australia,0,1,,1,-72.129595,11.360028999999999
48615,2018,Febrero,Australia,5,17,,22,-76.532004,3.451668
48616,2018,Febrero,Australia,284,493,,777,-74.140516,4.697157
48617,2018,Febrero,Australia,3,0,,3,-75.736374,4.815189
48618,2018,Febrero,Australia,29,93,,122,-75.42726,6.170465
48619,2018,Febrero,Australia,9,6,,15,-77.35002,8.63337
48620,2018,Febrero,Austria,3,2,,5,-69.94143100000001,4.214082
48621,2018,Febrero,Austria,10,14,,24,-77.35600000000001,0.81488
48622,2018,Febrero,Austria,7,6,,13,-75.527794,10.406342
48623,2018,Febrero,Austria,24,27,,51,-75.516486,10.446304
48624,2018,Febrero,Austria,0,7,,7,-74.77647900000001,10.886686
48625,2018,Febrero,Austria,1,0,,1,-74.213989,11.247722999999999
48626,2018,Febrero,Austria,0,1,,1,-72.129595,11.360028999999999
48627,2018,Febrero,Austria,6,7,,13,-76.532004,3.451668
48628,2018,Febrero,Austria,0,1,,1,-75.76635300000001,4.45285
48629,2018,Febrero,Austria,306,367,,673,-74.140516,4.697157
48630,2018,Febrero,Austria,38,48,,86,-75.42726,6.170465
48631,2018,Febrero,Austria,0,1,,1,-77.35002,8.63337
48632,2018,Febrero,Azerbaiyán,2,6,,8,-74.140516,4.697157
48633,2018,Febrero,Bahamas,4,4,,8,-75.516486,10.446304
48634,2018,Febrero,Bahamas,1,1,,2,-74.77647900000001,10.886686
48635,2018,Febrero,Bahamas,1,0,,1,-76.532004,3.451668
48636,2018,Febrero,Bahamas,4,21,,25,-74.140516,4.697157
48637,2018,Febrero,Bahamas,1,2,,3,-75.42726,6.170465
48638,2018,Febrero,Bahréin,0,2,,2,-74.140516,4.697157
48639,2018,Febrero,Bangladesh,1,0,,1,-74.140516,4.697157
48640,2018,Febrero,Barbados,1,1,,2,-75.516486,10.446304
48641,2018,Febrero,Barbados,0,2,,2,-74.77647900000001,10.886686
48642,2018,Febrero,Barbados,6,6,,12,-74.140516,4.697157
48643,2018,Febrero,Barbados,1,2,,3,-75.42726,6.170465
48644,2018,Febrero,República de Belarús,1,0,,1,-75.516486,10.446304
48645,2018,Febrero,República de Belarús,5,6,,11,-74.140516,4.697157
48646,2018,Febrero,Bélgica,7,4,,11,-69.941498,4.191162
48647,2018,Febrero,Bélgica,1,2,,3,-69.94143100000001,4.214082
48648,2018,Febrero,Bélgica,2,0,,2,-76.876446,0.33002
48649,2018,Febrero,Bélgica,4,8,,12,-77.35600000000001,0.81488
48650,2018,Febrero,Bélgica,3,5,,8,-75.527794,10.406342
48651,2018,Febrero,Bélgica,27,55,,82,-75.516486,10.446304
48652,2018,Febrero,Bélgica,3,10,,13,-74.77647900000001,10.886686
48653,2018,Febrero,Bélgica,0,1,,1,-74.765343,10.970933
48654,2018,Febrero,Bélgica,0,2,,2,-72.129595,11.360028999999999
48655,2018,Febrero,Bélgica,0,2,,2,-81.703935,12.574411099999999
48656,2018,Febrero,Bélgica,13,15,,28,-76.532004,3.451668
48657,2018,Febrero,Bélgica,261,406,,667,-74.140516,4.697157
48658,2018,Febrero,Bélgica,1,1,,2,-75.736374,4.815189
48659,2018,Febrero,Bélgica,45,81,,126,-75.42726,6.170465
48660,2018,Febrero,Bélgica,0,1,,1,-73.181317,7.1280470000000005
48661,2018,Febrero,Bélgica,1,3,,4,-72.453013,7.819
48662,2018,Febrero,Bélgica,0,1,,1,-72.409396,8.36068
48663,2018,Febrero,Bélgica,0,1,,1,-77.35002,8.63337
48664,2018,Febrero,Belice,0,1,,1,-77.35600000000001,0.81488
48665,2018,Febrero,Belice,0,2,,2,-75.527794,10.406342
48666,2018,Febrero,Belice,0,1,,1,-75.516486,10.446304
48667,2018,Febrero,Belice,0,2,,2,-74.213989,11.247722999999999
48668,2018,Febrero,Belice,2,6,,8,-74.140516,4.697157
48669,2018,Febrero,Belice,0,2,,2,-75.42726,6.170465
48670,2018,Febrero,Bermudas/Territorio Británico de Ultramar,1,0,,1,-74.140516,4.697157
48671,2018,Febrero,Bermudas/Territorio Británico de Ultramar,1,1,,2,-75.42726,6.170465
48672,2018,Febrero,Bolivia,1,0,,1,-69.941498,4.191162
48673,2018,Febrero,Bolivia,1,0,,1,-69.94143100000001,4.214082
48674,2018,Febrero,Bolivia,1,0,,1,-76.876446,0.33002
48675,2018,Febrero,Bolivia,11,18,,29,-77.35600000000001,0.81488
48676,2018,Febrero,Bolivia,7,3,,10,-75.527794,10.406342
48677,2018,Febrero,Bolivia,189,129,,318,-75.516486,10.446304
48678,2018,Febrero,Bolivia,4,6,,10,-74.77647900000001,10.886686
48679,2018,Febrero,Bolivia,0,2,,2,-72.129595,11.360028999999999
48680,2018,Febrero,Bolivia,16,10,,26,-81.70216500000001,12.5862
48681,2018,Febrero,Bolivia,13,19,,32,-76.532004,3.451668
48682,2018,Febrero,Bolivia,558,548,,1106,-74.140516,4.697157
48683,2018,Febrero,Bolivia,3,0,,3,-75.736374,4.815189
48684,2018,Febrero,Bolivia,45,47,,92,-75.42726,6.170465
48685,2018,Febrero,Bolivia,8,9,,17,-72.453013,7.819
48686,2018,Febrero,Bolivia,0,1,,1,-72.409396,8.36068
48687,2018,Febrero,Bosnia y Herzegovina,0,7,,7,-74.140516,4.697157
48688,2018,Febrero,Botsuana,0,1,,1,-74.140516,4.697157
48689,2018,Febrero,Botsuana,1,0,,1,-75.42726,6.170465
48690,2018,Febrero,Brasil,145,119,,264,-69.941498,4.191162
48691,2018,Febrero,Brasil,1,2,,3,-69.94143100000001,4.214082
48692,2018,Febrero,Brasil,0,4,,4,-76.876446,0.33002
48693,2018,Febrero,Brasil,24,35,,59,-77.35600000000001,0.81488
48694,2018,Febrero,Brasil,452,299,,751,-75.527794,10.406342
48695,2018,Febrero,Brasil,1059,780,,1839,-75.516486,10.446304
48696,2018,Febrero,Brasil,33,104,,137,-74.77647900000001,10.886686
48697,2018,Febrero,Brasil,1,0,,1,-74.213989,11.247722999999999
48698,2018,Febrero,Brasil,3,4,,7,-72.129595,11.360028999999999
48699,2018,Febrero,Brasil,2,3,,5,-81.703935,12.574411099999999
48700,2018,Febrero,Brasil,351,289,,640,-81.70216500000001,12.5862
48701,2018,Febrero,Brasil,54,82,,136,-76.532004,3.451668
48702,2018,Febrero,Brasil,3,5,,8,-67.927521,3.866713
48703,2018,Febrero,Brasil,7086,7397,,14483,-74.140516,4.697157
48704,2018,Febrero,Brasil,1,1,,2,-75.736374,4.815189
48705,2018,Febrero,Brasil,131,221,,352,-75.42726,6.170465
48706,2018,Febrero,Brasil,0,2,,2,-67.48402800000001,6.185536
48707,2018,Febrero,Brasil,0,1,,1,-70.74025300000001,7.088728999999999
48708,2018,Febrero,Brasil,1,1,,2,-73.181317,7.1280470000000005
48709,2018,Febrero,Brasil,10,11,,21,-72.453013,7.819
48710,2018,Febrero,Brasil,0,1,,1,-72.409396,8.36068
48711,2018,Febrero,Brasil,2,2,,4,-77.35002,8.63337
48712,2018,Febrero,Bulgaria,0,1,,1,-76.876446,0.33002
48713,2018,Febrero,Bulgaria,1,0,,1,-77.35600000000001,0.81488
48714,2018,Febrero,Bulgaria,0,1,,1,-75.527794,10.406342
48715,2018,Febrero,Bulgaria,6,4,,10,-75.516486,10.446304
48716,2018,Febrero,Bulgaria,0,1,,1,-74.213989,11.247722999999999
48717,2018,Febrero,Bulgaria,4,2,,6,-76.532004,3.451668
48718,2018,Febrero,Bulgaria,33,37,,70,-74.140516,4.697157
48719,2018,Febrero,Bulgaria,0,1,,1,-75.736374,4.815189
48720,2018,Febrero,Bulgaria,11,9,,20,-75.42726,6.170465
48721,2018,Febrero,Burkina Faso,1,6,,7,-74.140516,4.697157
48722,2018,Febrero,Bután,0,1,,1,-74.140516,4.697157
48723,2018,Febrero,Islas Caimán/Territorio Británico de Ultramar,1,0,,1,-75.516486,10.446304
48724,2018,Febrero,Islas Caimán/Territorio Británico de Ultramar,1,1,,2,-74.77647900000001,10.886686
48725,2018,Febrero,Islas Caimán/Territorio Británico de Ultramar,0,1,,1,-81.70216500000001,12.5862
48726,2018,Febrero,Islas Caimán/Territorio Británico de Ultramar,0,1,,1,-74.140516,4.697157
48727,2018,Febrero,Islas Caimán/Territorio Británico de Ultramar,0,1,,1,-75.42726,6.170465
48728,2018,Febrero,Camerún,1,1,,2,-77.35600000000001,0.81488
48729,2018,Febrero,Camerún,0,1,,1,-75.516486,10.446304
48730,2018,Febrero,Camerún,0,3,,3,-74.140516,4.697157
48731,2018,Febrero,Camerún,0,1,,1,-75.42726,6.170465
48732,2018,Febrero,Canadá,0,3,,3,-69.941498,4.191162
48733,2018,Febrero,Canadá,3,6,,9,-69.94143100000001,4.214082
48734,2018,Febrero,Canadá,16,30,,46,-77.35600000000001,0.81488
48735,2018,Febrero,Canadá,35,41,,76,-75.527794,10.406342
48736,2018,Febrero,Canadá,926,979,,1905,-75.516486,10.446304
48737,2018,Febrero,Canadá,36,63,,99,-74.77647900000001,10.886686
48738,2018,Febrero,Canadá,0,1,,1,-74.232675,11.117206
48739,2018,Febrero,Canadá,0,2,,2,-74.213989,11.247722999999999
48740,2018,Febrero,Canadá,2,6,,8,-72.129595,11.360028999999999
48741,2018,Febrero,Canadá,0,2,,2,-81.703935,12.574411099999999
48742,2018,Febrero,Canadá,286,276,,562,-81.70216500000001,12.5862
48743,2018,Febrero,Canadá,54,73,,127,-76.532004,3.451668
48744,2018,Febrero,Canadá,3,5,,8,-75.76635300000001,4.45285
48745,2018,Febrero,Canadá,1427,2217,,3644,-74.140516,4.697157
48746,2018,Febrero,Canadá,3,10,,13,-75.736374,4.815189
48747,2018,Febrero,Canadá,260,591,,851,-75.42726,6.170465
48748,2018,Febrero,Canadá,4,6,,10,-73.181317,7.1280470000000005
48749,2018,Febrero,Canadá,1,5,,6,-72.453013,7.819
48750,2018,Febrero,Canadá,0,1,,1,-72.409396,8.36068
48751,2018,Febrero,Canadá,7,14,,21,-77.35002,8.63337
48752,2018,Febrero,Chad,1,0,,1,-74.140516,4.697157
48753,2018,Febrero,República Democrática del Congo,0,4,,4,-74.140516,4.697157
48754,2018,Febrero,República Democrática del Congo,0,1,,1,-72.453013,7.819
48755,2018,Febrero,República de Corea,1,4,,5,-69.941498,4.191162
48756,2018,Febrero,República de Corea,3,0,,3,-69.94143100000001,4.214082
48757,2018,Febrero,República de Corea,0,1,,1,-76.876446,0.33002
48758,2018,Febrero,República de Corea,11,13,,24,-77.35600000000001,0.81488
48759,2018,Febrero,República de Corea,0,2,,2,-75.527794,10.406342
48760,2018,Febrero,República de Corea,3,6,,9,-75.516486,10.446304
48761,2018,Febrero,República de Corea,3,7,,10,-74.77647900000001,10.886686
48762,2018,Febrero,República de Corea,0,2,,2,-74.765343,10.970933
48763,2018,Febrero,República de Corea,0,1,,1,-74.213989,11.247722999999999
48764,2018,Febrero,República de Corea,5,6,,11,-76.532004,3.451668
48765,2018,Febrero,República de Corea,242,380,,622,-74.140516,4.697157
48766,2018,Febrero,República de Corea,18,33,,51,-75.42726,6.170465
48767,2018,Febrero,República de Corea,3,3,,6,-72.453013,7.819
48768,2018,Febrero,Costa de Marfil,0,1,,1,-75.516486,10.446304
48769,2018,Febrero,Costa de Marfil,0,3,,3,-74.140516,4.697157
48770,2018,Febrero,Costa Rica,1,1,,2,-69.941498,4.191162
48771,2018,Febrero,Costa Rica,1,0,,1,-76.876446,0.33002
48772,2018,Febrero,Costa Rica,3,3,,6,-77.35600000000001,0.81488
48773,2018,Febrero,Costa Rica,1,1,,2,-75.527794,10.406342
48774,2018,Febrero,Costa Rica,138,120,,258,-75.516486,10.446304
48775,2018,Febrero,Costa Rica,9,28,,37,-74.77647900000001,10.886686
48776,2018,Febrero,Costa Rica,19,21,,40,-81.70216500000001,12.5862
48777,2018,Febrero,Costa Rica,70,89,,159,-76.532004,3.451668
48778,2018,Febrero,Costa Rica,1010,1223,,2233,-74.140516,4.697157
48779,2018,Febrero,Costa Rica,3,8,,11,-75.736374,4.815189
48780,2018,Febrero,Costa Rica,139,229,,368,-75.42726,6.170465
48781,2018,Febrero,Costa Rica,4,1,,5,-73.181317,7.1280470000000005
48782,2018,Febrero,Costa Rica,1,2,,3,-72.453013,7.819
48783,2018,Febrero,Costa Rica,1,0,,1,-72.409396,8.36068
48784,2018,Febrero,Croacia,0,1,,1,-76.876446,0.33002
48785,2018,Febrero,Croacia,1,2,,3,-77.35600000000001,0.81488
48786,2018,Febrero,Croacia,0,7,,7,-75.527794,10.406342
48787,2018,Febrero,Croacia,1,10,,11,-75.516486,10.446304
48788,2018,Febrero,Croacia,0,2,,2,-74.77647900000001,10.886686
48789,2018,Febrero,Croacia,0,1,,1,-74.765343,10.970933
48790,2018,Febrero,Croacia,0,1,,1,-76.532004,3.451668
48791,2018,Febrero,Croacia,0,1,,1,-77.061029,3.8844260000000004
48792,2018,Febrero,Croacia,22,46,,68,-74.140516,4.697157
48793,2018,Febrero,Croacia,1,9,,10,-75.42726,6.170465
48794,2018,Febrero,Cuba,4,5,,9,-77.35600000000001,0.81488
48795,2018,Febrero,Cuba,6,15,,21,-75.516486,10.446304
48796,2018,Febrero,Cuba,9,11,,20,-74.77647900000001,10.886686
48797,2018,Febrero,Cuba,18,17,,35,-76.532004,3.451668
48798,2018,Febrero,Cuba,1057,798,,1855,-74.140516,4.697157
48799,2018,Febrero,Cuba,0,1,,1,-75.736374,4.815189
48800,2018,Febrero,Cuba,8,23,,31,-75.42726,6.170465
48801,2018,Febrero,Cuba,2,1,,3,-73.181317,7.1280470000000005
48802,2018,Febrero,Cuba,1,2,,3,-72.453013,7.819
48803,2018,Febrero,República Checa,0,1,,1,-69.94143100000001,4.214082
48804,2018,Febrero,República Checa,0,1,,1,-76.876446,0.33002
48805,2018,Febrero,República Checa,6,7,,13,-77.35600000000001,0.81488
48806,2018,Febrero,República Checa,1,0,,1,-75.527794,10.406342
48807,2018,Febrero,República Checa,10,25,,35,-75.516486,10.446304
48808,2018,Febrero,República Checa,0,3,,3,-74.77647900000001,10.886686
48809,2018,Febrero,República Checa,1,1,,2,-74.213989,11.247722999999999
48810,2018,Febrero,República Checa,6,5,,11,-76.532004,3.451668
48811,2018,Febrero,República Checa,81,109,,190,-74.140516,4.697157
48812,2018,Febrero,República Checa,5,13,,18,-75.42726,6.170465
48813,2018,Febrero,República Checa,0,1,,1,-72.453013,7.819
48814,2018,Febrero,República Checa,0,2,,2,-77.35002,8.63337
48815,2018,Febrero,Chile,2,1,,3,-69.941498,4.191162
48816,2018,Febrero,Chile,11,10,,21,-69.94143100000001,4.214082
48817,2018,Febrero,Chile,0,4,,4,-76.876446,0.33002
48818,2018,Febrero,Chile,130,157,,287,-77.35600000000001,0.81488
48819,2018,Febrero,Chile,548,406,,954,-75.527794,10.406342
48820,2018,Febrero,Chile,512,377,,889,-75.516486,10.446304
48821,2018,Febrero,Chile,21,23,,44,-74.77647900000001,10.886686
48822,2018,Febrero,Chile,3,3,,6,-72.129595,11.360028999999999
48823,2018,Febrero,Chile,0,1,,1,-81.703935,12.574411099999999
48824,2018,Febrero,Chile,74,49,,123,-81.70216500000001,12.5862
48825,2018,Febrero,Chile,25,51,,76,-76.532004,3.451668
48826,2018,Febrero,Chile,0,2,,2,-77.061029,3.8844260000000004
48827,2018,Febrero,Chile,6797,6542,,13339,-74.140516,4.697157
48828,2018,Febrero,Chile,2,5,,7,-75.736374,4.815189
48829,2018,Febrero,Chile,57,113,,170,-75.42726,6.170465
48830,2018,Febrero,Chile,0,1,,1,-70.74025300000001,7.088728999999999
48831,2018,Febrero,Chile,9,19,,28,-72.453013,7.819
48832,2018,Febrero,Chile,4,5,,9,-72.409396,8.36068
48833,2018,Febrero,Chile,0,1,,1,-75.68164200000001,9.402597
48834,2018,Febrero,China,1,2,,3,-69.941498,4.191162
48835,2018,Febrero,China,7,4,,11,-77.35600000000001,0.81488
48836,2018,Febrero,China,0,6,,6,-75.527794,10.406342
48837,2018,Febrero,China,17,19,,36,-75.516486,10.446304
48838,2018,Febrero,China,0,8,,8,-74.77647900000001,10.886686
48839,2018,Febrero,China,0,1,,1,-72.129595,11.360028999999999
48840,2018,Febrero,China,12,18,,30,-76.532004,3.451668
48841,2018,Febrero,China,421,582,,1003,-74.140516,4.697157
48842,2018,Febrero,China,1,0,,1,-75.736374,4.815189
48843,2018,Febrero,China,39,47,,86,-75.42726,6.170465
48844,2018,Febrero,China,7,5,,12,-72.453013,7.819
48845,2018,Febrero,China,1,2,,3,-72.409396,8.36068
48846,2018,Febrero,Taiwán,1,1,,2,-77.35600000000001,0.81488
48847,2018,Febrero,Taiwán,3,3,,6,-75.527794,10.406342
48848,2018,Febrero,Taiwán,5,3,,8,-75.516486,10.446304
48849,2018,Febrero,Taiwán,0,2,,2,-74.77647900000001,10.886686
48850,2018,Febrero,Taiwán,0,5,,5,-76.532004,3.451668
48851,2018,Febrero,Taiwán,96,79,,175,-74.140516,4.697157
48852,2018,Febrero,Taiwán,3,8,,11,-75.42726,6.170465
48853,2018,Febrero,Taiwán,0,1,,1,-73.181317,7.1280470000000005
48854,2018,Febrero,Taiwán,1,3,,4,-72.453013,7.819
48855,2018,Febrero,Chipre,2,1,,3,-76.532004,3.451668
48856,2018,Febrero,Chipre,12,12,,24,-74.140516,4.697157
48857,2018,Febrero,Dinamarca,3,2,,5,-69.94143100000001,4.214082
48858,2018,Febrero,Dinamarca,4,3,,7,-77.35600000000001,0.81488
48859,2018,Febrero,Dinamarca,6,10,,16,-75.527794,10.406342
48860,2018,Febrero,Dinamarca,30,46,,76,-75.516486,10.446304
48861,2018,Febrero,Dinamarca,2,2,,4,-74.77647900000001,10.886686
48862,2018,Febrero,Dinamarca,6,10,,16,-76.532004,3.451668
48863,2018,Febrero,Dinamarca,0,1,,1,-77.061029,3.8844260000000004
48864,2018,Febrero,Dinamarca,170,230,,400,-74.140516,4.697157
48865,2018,Febrero,Dinamarca,0,1,,1,-75.736374,4.815189
48866,2018,Febrero,Dinamarca,22,42,,64,-75.42726,6.170465
48867,2018,Febrero,Dominica,0,1,,1,-76.532004,3.451668
48868,2018,Febrero,Dominica,3,6,,9,-74.140516,4.697157
48869,2018,Febrero,Dominica,0,3,,3,-75.42726,6.170465
48870,2018,Febrero,Ecuador,1,3,,4,-69.94143100000001,4.214082
48871,2018,Febrero,Ecuador,2,0,,2,-74.78366,0.18595699999999998
48872,2018,Febrero,Ecuador,61,285,,346,-76.876446,0.33002
48873,2018,Febrero,Ecuador,17,15,,32,-77.84700600000001,0.8124359999999999
48874,2018,Febrero,Ecuador,1557,2278,,3835,-77.35600000000001,0.81488
48875,2018,Febrero,Ecuador,9,15,,24,-78.802679,18.00143
48876,2018,Febrero,Ecuador,15,10,,25,-75.527794,10.406342
48877,2018,Febrero,Ecuador,75,68,,143,-75.516486,10.446304
48878,2018,Febrero,Ecuador,74,61,,135,-74.77647900000001,10.886686
48879,2018,Febrero,Ecuador,6,17,,23,-72.129595,11.360028999999999
48880,2018,Febrero,Ecuador,8,6,,14,-81.70216500000001,12.5862
48881,2018,Febrero,Ecuador,441,455,,896,-76.532004,3.451668
48882,2018,Febrero,Ecuador,0,1,,1,-67.927521,3.866713
48883,2018,Febrero,Ecuador,0,3,,3,-77.061029,3.8844260000000004
48884,2018,Febrero,Ecuador,0,1,,1,-75.76635300000001,4.45285
48885,2018,Febrero,Ecuador,2899,3643,,6542,-74.140516,4.697157
48886,2018,Febrero,Ecuador,43,127,,170,-75.736374,4.815189
48887,2018,Febrero,Ecuador,67,131,,198,-75.42726,6.170465
48888,2018,Febrero,Ecuador,3,4,,7,-73.181317,7.1280470000000005
48889,2018,Febrero,Ecuador,166,253,,419,-72.453013,7.819
48890,2018,Febrero,Ecuador,2,6,,8,-72.409396,8.36068
48891,2018,Febrero,Egipto,0,1,,1,-75.516486,10.446304
48892,2018,Febrero,Egipto,2,34,,36,-74.140516,4.697157
48893,2018,Febrero,Egipto,0,4,,4,-75.42726,6.170465
48894,2018,Febrero,Egipto,0,2,,2,-72.453013,7.819
48895,2018,Febrero,El Salvador,1,1,,2,-69.94143100000001,4.214082
48896,2018,Febrero,El Salvador,3,3,,6,-77.35600000000001,0.81488
48897,2018,Febrero,El Salvador,0,2,,2,-75.527794,10.406342
48898,2018,Febrero,El Salvador,37,34,,71,-75.516486,10.446304
48899,2018,Febrero,El Salvador,3,5,,8,-74.77647900000001,10.886686
48900,2018,Febrero,El Salvador,2,2,,4,-81.70216500000001,12.5862
48901,2018,Febrero,El Salvador,84,89,,173,-76.532004,3.451668
48902,2018,Febrero,El Salvador,753,907,,1660,-74.140516,4.697157
48903,2018,Febrero,El Salvador,2,3,,5,-75.736374,4.815189
48904,2018,Febrero,El Salvador,156,179,,335,-75.42726,6.170465
48905,2018,Febrero,El Salvador,1,1,,2,-72.453013,7.819
48906,2018,Febrero,El Salvador,0,1,,1,-77.35002,8.63337
48907,2018,Febrero,Emiratos Árabes,3,8,,11,-74.140516,4.697157
48908,2018,Febrero,Emiratos Árabes,0,4,,4,-75.42726,6.170465
48909,2018,Febrero,España,0,2,,2,-69.941498,4.191162
48910,2018,Febrero,España,7,10,,17,-69.94143100000001,4.214082
48911,2018,Febrero,España,2,3,,5,-76.876446,0.33002
48912,2018,Febrero,España,0,2,,2,-77.84700600000001,0.8124359999999999
48913,2018,Febrero,España,39,72,,111,-77.35600000000001,0.81488
48914,2018,Febrero,España,27,25,,52,-75.527794,10.406342
48915,2018,Febrero,España,136,189,,325,-75.516486,10.446304
48916,2018,Febrero,España,23,54,,77,-74.77647900000001,10.886686
48917,2018,Febrero,España,0,2,,2,-74.765343,10.970933
48918,2018,Febrero,España,0,7,,7,-74.213989,11.247722999999999
48919,2018,Febrero,España,4,7,,11,-72.129595,11.360028999999999
48920,2018,Febrero,España,6,5,,11,-81.70216500000001,12.5862
48921,2018,Febrero,España,1,1,,2,-81.372937,13.338761300000002
48922,2018,Febrero,España,364,515,,879,-76.532004,3.451668
48923,2018,Febrero,España,1,2,,3,-75.76635300000001,4.45285
48924,2018,Febrero,España,2615,5344,,7959,-74.140516,4.697157
48925,2018,Febrero,España,9,8,,17,-75.736374,4.815189
48926,2018,Febrero,España,374,756,,1130,-75.42726,6.170465
48927,2018,Febrero,España,0,1,,1,-75.586989,6.2188349999999994
48928,2018,Febrero,España,0,2,,2,-70.74025300000001,7.088728999999999
48929,2018,Febrero,España,4,6,,10,-73.181317,7.1280470000000005
48930,2018,Febrero,España,27,47,,74,-72.453013,7.819
48931,2018,Febrero,España,7,7,,14,-72.409396,8.36068
48932,2018,Febrero,España,0,6,,6,-77.35002,8.63337
48933,2018,Febrero,Eritrea,1,0,,1,-74.140516,4.697157
48934,2018,Febrero,Eslovaquia,17,25,,42,-77.35600000000001,0.81488
48935,2018,Febrero,Eslovaquia,0,1,,1,-75.527794,10.406342
48936,2018,Febrero,Eslovaquia,1,0,,1,-75.516486,10.446304
48937,2018,Febrero,Eslovaquia,0,2,,2,-74.77647900000001,10.886686
48938,2018,Febrero,Eslovaquia,32,71,,103,-74.140516,4.697157
48939,2018,Febrero,Eslovaquia,3,3,,6,-75.42726,6.170465
48940,2018,Febrero,Eslovenia,1,2,,3,-77.35600000000001,0.81488
48941,2018,Febrero,Eslovenia,0,5,,5,-75.516486,10.446304
48942,2018,Febrero,Eslovenia,2,2,,4,-74.213989,11.247722999999999
48943,2018,Febrero,Eslovenia,1,1,,2,-76.532004,3.451668
48944,2018,Febrero,Eslovenia,27,32,,59,-74.140516,4.697157
48945,2018,Febrero,Eslovenia,0,2,,2,-75.42726,6.170465
48946,2018,Febrero,Eslovenia,0,1,,1,-77.35002,8.63337
48947,2018,Febrero,Estados Unidos de América,5,17,,22,-69.941498,4.191162
48948,2018,Febrero,Estados Unidos de América,11,10,,21,-69.94143100000001,4.214082
48949,2018,Febrero,Estados Unidos de América,3,7,,10,-76.876446,0.33002
48950,2018,Febrero,Estados Unidos de América,52,95,,147,-77.35600000000001,0.81488
48951,2018,Febrero,Estados Unidos de América,0,1,,1,-78.802679,18.00143
48952,2018,Febrero,Estados Unidos de América,76,90,,166,-75.527794,10.406342
48953,2018,Febrero,Estados Unidos de América,5116,6623,,11739,-75.516486,10.446304
48954,2018,Febrero,Estados Unidos de América,656,1190,,1846,-74.77647900000001,10.886686
48955,2018,Febrero,Estados Unidos de América,0,1,,1,-74.232675,11.117206
48956,2018,Febrero,Estados Unidos de América,1,2,,3,-74.213989,11.247722999999999
48957,2018,Febrero,Estados Unidos de América,1,3,,4,-72.129595,11.360028999999999
48958,2018,Febrero,Estados Unidos de América,1,3,,4,-81.703935,12.574411099999999
48959,2018,Febrero,Estados Unidos de América,27,39,,66,-81.70216500000001,12.5862
48960,2018,Febrero,Estados Unidos de América,3,4,,7,-81.372937,13.338761300000002
48961,2018,Febrero,Estados Unidos de América,1081,1539,,2620,-76.532004,3.451668
48962,2018,Febrero,Estados Unidos de América,88,144,,232,-75.76635300000001,4.45285
48963,2018,Febrero,Estados Unidos de América,8745,14761,,23506,-74.140516,4.697157
48964,2018,Febrero,Estados Unidos de América,131,158,,289,-75.736374,4.815189
48965,2018,Febrero,Estados Unidos de América,2755,6528,,9283,-75.42726,6.170465
48966,2018,Febrero,Estados Unidos de América,0,1,,1,-75.586989,6.2188349999999994
48967,2018,Febrero,Estados Unidos de América,0,2,,2,-77.401154,6.222551999999999
48968,2018,Febrero,Estados Unidos de América,23,45,,68,-73.181317,7.1280470000000005
48969,2018,Febrero,Estados Unidos de América,12,15,,27,-72.453013,7.819
48970,2018,Febrero,Estados Unidos de América,3,4,,7,-72.409396,8.36068
48971,2018,Febrero,Estados Unidos de América,8,16,,24,-77.35002,8.63337
48972,2018,Febrero,Estonia,1,1,,2,-76.876446,0.33002
48973,2018,Febrero,Estonia,1,0,,1,-77.35600000000001,0.81488
48974,2018,Febrero,Estonia,4,4,,8,-75.516486,10.446304
48975,2018,Febrero,Estonia,0,1,,1,-74.77647900000001,10.886686
48976,2018,Febrero,Estonia,0,1,,1,-74.765343,10.970933
48977,2018,Febrero,Estonia,5,2,,7,-76.532004,3.451668
48978,2018,Febrero,Estonia,11,9,,20,-74.140516,4.697157
48979,2018,Febrero,Etiopia,0,2,,2,-76.532004,3.451668
48980,2018,Febrero,Etiopia,2,3,,5,-74.140516,4.697157
48981,2018,Febrero,Etiopia,0,1,,1,-75.42726,6.170465
48982,2018,Febrero,Islas Fiji,0,2,,2,-75.42726,6.170465
48983,2018,Febrero,Filipinas,2,0,,2,-77.35600000000001,0.81488
48984,2018,Febrero,Filipinas,0,33,,33,-75.527794,10.406342
48985,2018,Febrero,Filipinas,3,38,,41,-75.516486,10.446304
48986,2018,Febrero,Filipinas,0,16,,16,-74.77647900000001,10.886686
48987,2018,Febrero,Filipinas,0,19,,19,-74.765343,10.970933
48988,2018,Febrero,Filipinas,0,14,,14,-74.213989,11.247722999999999
48989,2018,Febrero,Filipinas,3,18,,21,-76.532004,3.451668
48990,2018,Febrero,Filipinas,0,15,,15,-77.061029,3.8844260000000004
48991,2018,Febrero,Filipinas,40,70,,110,-74.140516,4.697157
48992,2018,Febrero,Filipinas,9,4,,13,-75.42726,6.170465
48993,2018,Febrero,Filipinas,0,3,,3,-75.68164200000001,9.402597
48994,2018,Febrero,Finlandia,3,2,,5,-77.35600000000001,0.81488
48995,2018,Febrero,Finlandia,2,3,,5,-75.527794,10.406342
48996,2018,Febrero,Finlandia,4,13,,17,-75.516486,10.446304
48997,2018,Febrero,Finlandia,4,6,,10,-81.70216500000001,12.5862
48998,2018,Febrero,Finlandia,6,2,,8,-76.532004,3.451668
48999,2018,Febrero,Finlandia,79,91,,170,-74.140516,4.697157
49000,2018,Febrero,Finlandia,8,12,,20,-75.42726,6.170465
49001,2018,Febrero,Francia,4,10,,14,-69.941498,4.191162
49002,2018,Febrero,Francia,9,11,,20,-69.94143100000001,4.214082
49003,2018,Febrero,Francia,5,12,,17,-76.876446,0.33002
49004,2018,Febrero,Francia,2,2,,4,-77.84700600000001,0.8124359999999999
49005,2018,Febrero,Francia,131,157,,288,-77.35600000000001,0.81488
49006,2018,Febrero,Francia,22,20,,42,-75.527794,10.406342
49007,2018,Febrero,Francia,187,252,,439,-75.516486,10.446304
49008,2018,Febrero,Francia,26,39,,65,-74.77647900000001,10.886686
49009,2018,Febrero,Francia,2,4,,6,-74.213989,11.247722999999999
49010,2018,Febrero,Francia,2,1,,3,-72.129595,11.360028999999999
49011,2018,Febrero,Francia,0,2,,2,-81.703935,12.574411099999999
49012,2018,Febrero,Francia,1,3,,4,-81.70216500000001,12.5862
49013,2018,Febrero,Francia,3,10,,13,-81.372937,13.338761300000002
49014,2018,Febrero,Francia,85,116,,201,-76.532004,3.451668
49015,2018,Febrero,Francia,3020,3866,,6886,-74.140516,4.697157
49016,2018,Febrero,Francia,1,4,,5,-75.736374,4.815189
49017,2018,Febrero,Francia,234,327,,561,-75.42726,6.170465
49018,2018,Febrero,Francia,0,2,,2,-67.48402800000001,6.185536
49019,2018,Febrero,Francia,5,1,,6,-73.181317,7.1280470000000005
49020,2018,Febrero,Francia,0,8,,8,-72.453013,7.819
49021,2018,Febrero,Francia,0,2,,2,-72.409396,8.36068
49022,2018,Febrero,Francia,7,3,,10,-77.35002,8.63337
49023,2018,Febrero,Georgia,0,1,,1,-75.527794,10.406342
49024,2018,Febrero,Georgia,0,1,,1,-75.516486,10.446304
49025,2018,Febrero,Georgia,0,1,,1,-74.77647900000001,10.886686
49026,2018,Febrero,Georgia,0,3,,3,-74.213989,11.247722999999999
49027,2018,Febrero,Georgia,1,6,,7,-74.140516,4.697157
49028,2018,Febrero,Ghana,2,6,,8,-77.35600000000001,0.81488
49029,2018,Febrero,Ghana,0,2,,2,-75.516486,10.446304
49030,2018,Febrero,Ghana,1,0,,1,-76.532004,3.451668
49031,2018,Febrero,Ghana,3,7,,10,-74.140516,4.697157
49032,2018,Febrero,Granada,0,2,,2,-75.516486,10.446304
49033,2018,Febrero,Granada,1,2,,3,-74.140516,4.697157
49034,2018,Febrero,Grecia,0,1,,1,-69.94143100000001,4.214082
49035,2018,Febrero,Grecia,1,1,,2,-77.35600000000001,0.81488
49036,2018,Febrero,Grecia,0,2,,2,-75.527794,10.406342
49037,2018,Febrero,Grecia,6,9,,15,-75.516486,10.446304
49038,2018,Febrero,Grecia,0,2,,2,-74.77647900000001,10.886686
49039,2018,Febrero,Grecia,0,1,,1,-74.765343,10.970933
49040,2018,Febrero,Grecia,0,1,,1,-74.213989,11.247722999999999
49041,2018,Febrero,Grecia,38,89,,127,-74.140516,4.697157
49042,2018,Febrero,Grecia,0,1,,1,-75.736374,4.815189
49043,2018,Febrero,Grecia,2,10,,12,-75.42726,6.170465
49044,2018,Febrero,Grecia,0,3,,3,-72.453013,7.819
49045,2018,Febrero,Grecia,0,1,,1,-77.35002,8.63337
49046,2018,Febrero,Guatemala,0,1,,1,-69.94143100000001,4.214082
49047,2018,Febrero,Guatemala,2,1,,3,-77.35600000000001,0.81488
49048,2018,Febrero,Guatemala,1,1,,2,-75.527794,10.406342
49049,2018,Febrero,Guatemala,124,182,,306,-75.516486,10.446304
49050,2018,Febrero,Guatemala,8,18,,26,-74.77647900000001,10.886686
49051,2018,Febrero,Guatemala,0,2,,2,-72.129595,11.360028999999999
49052,2018,Febrero,Guatemala,3,1,,4,-81.70216500000001,12.5862
49053,2018,Febrero,Guatemala,38,57,,95,-76.532004,3.451668
49054,2018,Febrero,Guatemala,0,1,,1,-75.76635300000001,4.45285
49055,2018,Febrero,Guatemala,702,906,,1608,-74.140516,4.697157
49056,2018,Febrero,Guatemala,4,6,,10,-75.736374,4.815189
49057,2018,Febrero,Guatemala,82,169,,251,-75.42726,6.170465
49058,2018,Febrero,Guatemala,1,0,,1,-70.74025300000001,7.088728999999999
49059,2018,Febrero,Guatemala,3,2,,5,-73.181317,7.1280470000000005
49060,2018,Febrero,Guatemala,0,6,,6,-72.453013,7.819
49061,2018,Febrero,Guyana,1,1,,2,-75.516486,10.446304
49062,2018,Febrero,Guyana,2,2,,4,-74.77647900000001,10.886686
49063,2018,Febrero,Guyana,1,0,,1,-76.532004,3.451668
49064,2018,Febrero,Guyana,2,7,,9,-74.140516,4.697157
49065,2018,Febrero,Guyana,3,2,,5,-75.42726,6.170465
49066,2018,Febrero,Guyana,2,1,,3,-72.453013,7.819
49067,2018,Febrero,Haití,5,10,,15,-75.516486,10.446304
49068,2018,Febrero,Haití,2,5,,7,-74.77647900000001,10.886686
49069,2018,Febrero,Haití,0,1,,1,-76.532004,3.451668
49070,2018,Febrero,Haití,9,8,,17,-74.140516,4.697157
49071,2018,Febrero,Haití,16,20,,36,-75.42726,6.170465
49072,2018,Febrero,Honduras,1,0,,1,-69.941498,4.191162
49073,2018,Febrero,Honduras,0,1,,1,-77.35600000000001,0.81488
49074,2018,Febrero,Honduras,0,1,,1,-78.802679,18.00143
49075,2018,Febrero,Honduras,0,13,,13,-75.527794,10.406342
49076,2018,Febrero,Honduras,22,26,,48,-75.516486,10.446304
49077,2018,Febrero,Honduras,3,6,,9,-74.77647900000001,10.886686
49078,2018,Febrero,Honduras,59,42,,101,-76.532004,3.451668
49079,2018,Febrero,Honduras,0,1,,1,-75.76635300000001,4.45285
49080,2018,Febrero,Honduras,338,334,,672,-74.140516,4.697157
49081,2018,Febrero,Honduras,1,1,,2,-75.736374,4.815189
49082,2018,Febrero,Honduras,57,78,,135,-75.42726,6.170465
49083,2018,Febrero,Honduras,2,2,,4,-73.181317,7.1280470000000005
49084,2018,Febrero,Hong Kong,2,1,,3,-69.941498,4.191162
49085,2018,Febrero,Hong Kong,0,4,,4,-77.35600000000001,0.81488
49086,2018,Febrero,Hong Kong,8,10,,18,-74.140516,4.697157
49087,2018,Febrero,Hungría,1,0,,1,-75.527794,10.406342
49088,2018,Febrero,Hungría,1,5,,6,-75.516486,10.446304
49089,2018,Febrero,Hungría,0,2,,2,-74.77647900000001,10.886686
49090,2018,Febrero,Hungría,7,9,,16,-76.532004,3.451668
49091,2018,Febrero,Hungría,32,67,,99,-74.140516,4.697157
49092,2018,Febrero,Hungría,8,9,,17,-75.42726,6.170465
49093,2018,Febrero,India,2,4,,6,-77.35600000000001,0.81488
49094,2018,Febrero,India,0,15,,15,-75.527794,10.406342
49095,2018,Febrero,India,23,43,,66,-75.516486,10.446304
49096,2018,Febrero,India,2,14,,16,-74.77647900000001,10.886686
49097,2018,Febrero,India,0,3,,3,-74.213989,11.247722999999999
49098,2018,Febrero,India,0,1,,1,-81.70216500000001,12.5862
49099,2018,Febrero,India,2,19,,21,-76.532004,3.451668
49100,2018,Febrero,India,64,335,,399,-74.140516,4.697157
49101,2018,Febrero,India,1,1,,2,-75.736374,4.815189
49102,2018,Febrero,India,5,59,,64,-75.42726,6.170465
49103,2018,Febrero,India,0,1,,1,-73.181317,7.1280470000000005
49104,2018,Febrero,India,0,3,,3,-75.68164200000001,9.402597
49105,2018,Febrero,Indonesia,0,6,,6,-75.527794,10.406342
49106,2018,Febrero,Indonesia,3,7,,10,-75.516486,10.446304
49107,2018,Febrero,Indonesia,1,0,,1,-74.77647900000001,10.886686
49108,2018,Febrero,Indonesia,0,3,,3,-74.213989,11.247722999999999
49109,2018,Febrero,Indonesia,1,1,,2,-76.532004,3.451668
49110,2018,Febrero,Indonesia,18,41,,59,-74.140516,4.697157
49111,2018,Febrero,Indonesia,1,0,,1,-75.42726,6.170465
49112,2018,Febrero,Indonesia,1,1,,2,-73.181317,7.1280470000000005
49113,2018,Febrero,Iraq,0,1,,1,-75.516486,10.446304
49114,2018,Febrero,Iraq,0,1,,1,-74.140516,4.697157
49115,2018,Febrero,Irán,0,1,,1,-75.516486,10.446304
49116,2018,Febrero,Irán,0,1,,1,-74.77647900000001,10.886686
49117,2018,Febrero,Irán,0,1,,1,-72.129595,11.360028999999999
49118,2018,Febrero,Irán,2,12,,14,-74.140516,4.697157
49119,2018,Febrero,Irán,0,1,,1,-75.736374,4.815189
49120,2018,Febrero,República de Irlanda,0,1,,1,-69.94143100000001,4.214082
49121,2018,Febrero,República de Irlanda,6,11,,17,-77.35600000000001,0.81488
49122,2018,Febrero,República de Irlanda,2,1,,3,-75.527794,10.406342
49123,2018,Febrero,República de Irlanda,19,37,,56,-75.516486,10.446304
49124,2018,Febrero,República de Irlanda,1,4,,5,-74.77647900000001,10.886686
49125,2018,Febrero,República de Irlanda,3,4,,7,-76.532004,3.451668
49126,2018,Febrero,República de Irlanda,92,189,,281,-74.140516,4.697157
49127,2018,Febrero,República de Irlanda,10,33,,43,-75.42726,6.170465
49128,2018,Febrero,República de Irlanda,0,1,,1,-67.48402800000001,6.185536
49129,2018,Febrero,República de Irlanda,4,2,,6,-77.35002,8.63337
49130,2018,Febrero,Islandia,0,1,,1,-75.527794,10.406342
49131,2018,Febrero,Islandia,2,7,,9,-75.516486,10.446304
49132,2018,Febrero,Islandia,0,1,,1,-74.77647900000001,10.886686
49133,2018,Febrero,Islandia,3,0,,3,-76.532004,3.451668
49134,2018,Febrero,Islandia,15,21,,36,-74.140516,4.697157
49135,2018,Febrero,Islandia,2,6,,8,-75.42726,6.170465
49136,2018,Febrero,Israel,0,1,,1,-69.94143100000001,4.214082
49137,2018,Febrero,Israel,6,13,,19,-77.35600000000001,0.81488
49138,2018,Febrero,Israel,0,4,,4,-75.527794,10.406342
49139,2018,Febrero,Israel,23,93,,116,-75.516486,10.446304
49140,2018,Febrero,Israel,2,8,,10,-74.77647900000001,10.886686
49141,2018,Febrero,Israel,0,1,,1,-74.213989,11.247722999999999
49142,2018,Febrero,Israel,1,1,,2,-81.70216500000001,12.5862
49143,2018,Febrero,Israel,7,27,,34,-76.532004,3.451668
49144,2018,Febrero,Israel,256,770,,1026,-74.140516,4.697157
49145,2018,Febrero,Israel,27,91,,118,-75.42726,6.170465
49146,2018,Febrero,Israel,0,1,,1,-73.181317,7.1280470000000005
49147,2018,Febrero,Islas Aland/Provincia de Finlandia,0,1,,1,-74.140516,4.697157
49148,2018,Febrero,Italia,2,6,,8,-69.941498,4.191162
49149,2018,Febrero,Italia,4,5,,9,-69.94143100000001,4.214082
49150,2018,Febrero,Italia,1,1,,2,-76.876446,0.33002
49151,2018,Febrero,Italia,2,2,,4,-77.84700600000001,0.8124359999999999
49152,2018,Febrero,Italia,9,37,,46,-77.35600000000001,0.81488
49153,2018,Febrero,Italia,1,2,,3,-78.802679,18.00143
49154,2018,Febrero,Italia,10,23,,33,-75.527794,10.406342
49155,2018,Febrero,Italia,109,172,,281,-75.516486,10.446304
49156,2018,Febrero,Italia,7,26,,33,-74.77647900000001,10.886686
49157,2018,Febrero,Italia,1,0,,1,-74.232675,11.117206
49158,2018,Febrero,Italia,1,5,,6,-74.213989,11.247722999999999
49159,2018,Febrero,Italia,0,10,,10,-72.129595,11.360028999999999
49160,2018,Febrero,Italia,6,16,,22,-81.70216500000001,12.5862
49161,2018,Febrero,Italia,31,113,,144,-76.532004,3.451668
49162,2018,Febrero,Italia,0,2,,2,-75.76635300000001,4.45285
49163,2018,Febrero,Italia,958,2062,,3020,-74.140516,4.697157
49164,2018,Febrero,Italia,0,2,,2,-75.736374,4.815189
49165,2018,Febrero,Italia,73,242,,315,-75.42726,6.170465
49166,2018,Febrero,Italia,0,1,,1,-70.74025300000001,7.088728999999999
49167,2018,Febrero,Italia,3,3,,6,-73.181317,7.1280470000000005
49168,2018,Febrero,Italia,10,21,,31,-72.453013,7.819
49169,2018,Febrero,Italia,2,5,,7,-72.409396,8.36068
49170,2018,Febrero,Italia,4,8,,12,-77.35002,8.63337
49171,2018,Febrero,Jamaica,0,1,,1,-77.35600000000001,0.81488
49172,2018,Febrero,Jamaica,9,8,,17,-75.516486,10.446304
49173,2018,Febrero,Jamaica,3,4,,7,-74.77647900000001,10.886686
49174,2018,Febrero,Jamaica,1,0,,1,-81.70216500000001,12.5862
49175,2018,Febrero,Jamaica,1,3,,4,-76.532004,3.451668
49176,2018,Febrero,Jamaica,27,28,,55,-74.140516,4.697157
49177,2018,Febrero,Jamaica,9,16,,25,-75.42726,6.170465
49178,2018,Febrero,Jamaica,1,0,,1,-73.181317,7.1280470000000005
49179,2018,Febrero,Jamaica,1,0,,1,-72.453013,7.819
49180,2018,Febrero,Islas Salomón,0,1,,1,-74.140516,4.697157
49181,2018,Febrero,Japón,0,1,,1,-69.941498,4.191162
49182,2018,Febrero,Japón,0,1,,1,-69.94143100000001,4.214082
49183,2018,Febrero,Japón,0,1,,1,-76.876446,0.33002
49184,2018,Febrero,Japón,4,15,,19,-77.35600000000001,0.81488
49185,2018,Febrero,Japón,0,2,,2,-75.527794,10.406342
49186,2018,Febrero,Japón,21,13,,34,-75.516486,10.446304
49187,2018,Febrero,Japón,4,10,,14,-74.77647900000001,10.886686
49188,2018,Febrero,Japón,1,0,,1,-81.70216500000001,12.5862
49189,2018,Febrero,Japón,3,14,,17,-76.532004,3.451668
49190,2018,Febrero,Japón,220,571,,791,-74.140516,4.697157
49191,2018,Febrero,Japón,18,52,,70,-75.42726,6.170465
49192,2018,Febrero,Japón,0,1,,1,-77.401154,6.222551999999999
49193,2018,Febrero,Japón,0,2,,2,-72.453013,7.819
49194,2018,Febrero,Japón,0,1,,1,-77.35002,8.63337
49195,2018,Febrero,Jordania,1,10,,11,-74.140516,4.697157
49196,2018,Febrero,Kazajistán,0,1,,1,-77.35600000000001,0.81488
49197,2018,Febrero,Kazajistán,3,0,,3,-75.516486,10.446304
49198,2018,Febrero,Kazajistán,6,4,,10,-74.140516,4.697157
49199,2018,Febrero,Kenia,0,1,,1,-75.516486,10.446304
49200,2018,Febrero,Kenia,1,3,,4,-76.532004,3.451668
49201,2018,Febrero,Kenia,9,6,,15,-74.140516,4.697157
49202,2018,Febrero,Kiribati,0,4,,4,-75.527794,10.406342
49203,2018,Febrero,Kiribati,0,1,,1,-75.516486,10.446304
49204,2018,Febrero,Kirguistán,1,0,,1,-74.140516,4.697157
49205,2018,Febrero,Kirguistán,0,1,,1,-75.42726,6.170465
49206,2018,Febrero,Kuwait,0,6,,6,-74.140516,4.697157
49207,2018,Febrero,República de Kosovo,0,2,,2,-74.140516,4.697157
49208,2018,Febrero,Letonia,0,2,,2,-75.527794,10.406342
49209,2018,Febrero,Letonia,4,2,,6,-75.516486,10.446304
49210,2018,Febrero,Letonia,0,1,,1,-74.765343,10.970933
49211,2018,Febrero,Letonia,2,0,,2,-76.532004,3.451668
49212,2018,Febrero,Letonia,8,18,,26,-74.140516,4.697157
49213,2018,Febrero,Letonia,1,2,,3,-75.42726,6.170465
49214,2018,Febrero,Lituania,0,2,,2,-75.527794,10.406342
49215,2018,Febrero,Lituania,2,1,,3,-75.516486,10.446304
49216,2018,Febrero,Lituania,0,2,,2,-74.77647900000001,10.886686
49217,2018,Febrero,Lituania,1,4,,5,-76.532004,3.451668
49218,2018,Febrero,Lituania,50,35,,85,-74.140516,4.697157
49219,2018,Febrero,Lituania,2,4,,6,-75.42726,6.170465
49220,2018,Febrero,Líbano,1,3,,4,-75.516486,10.446304
49221,2018,Febrero,Líbano,0,1,,1,-74.77647900000001,10.886686
49222,2018,Febrero,Líbano,2,0,,2,-72.129595,11.360028999999999
49223,2018,Febrero,Líbano,18,22,,40,-74.140516,4.697157
49224,2018,Febrero,Líbano,0,1,,1,-75.736374,4.815189
49225,2018,Febrero,Líbano,2,3,,5,-75.42726,6.170465
49226,2018,Febrero,Líbano,1,1,,2,-73.181317,7.1280470000000005
49227,2018,Febrero,Liechtenstein,1,1,,2,-74.140516,4.697157
49228,2018,Febrero,Luxemburgo,0,1,,1,-75.527794,10.406342
49229,2018,Febrero,Luxemburgo,1,0,,1,-74.77647900000001,10.886686
49230,2018,Febrero,Luxemburgo,1,0,,1,-74.213989,11.247722999999999
49231,2018,Febrero,Luxemburgo,0,1,,1,-76.532004,3.451668
49232,2018,Febrero,Luxemburgo,9,17,,26,-74.140516,4.697157
49233,2018,Febrero,Luxemburgo,1,2,,3,-75.42726,6.170465
49234,2018,Febrero,Luxemburgo,0,1,,1,-72.453013,7.819
49235,2018,Febrero,Macedonia,0,1,,1,-75.527794,10.406342
49236,2018,Febrero,Macedonia,0,3,,3,-74.140516,4.697157
49237,2018,Febrero,Madagascar,1,0,,1,-74.140516,4.697157
49238,2018,Febrero,Malasia,1,1,,2,-75.527794,10.406342
49239,2018,Febrero,Malasia,1,2,,3,-75.516486,10.446304
49240,2018,Febrero,Malasia,0,1,,1,-76.532004,3.451668
49241,2018,Febrero,Malasia,23,14,,37,-74.140516,4.697157
49242,2018,Febrero,Malasia,1,0,,1,-75.42726,6.170465
49243,2018,Febrero,Malasia,1,1,,2,-77.35002,8.63337
49244,2018,Febrero,Malasia,0,3,,3,-75.68164200000001,9.402597
49245,2018,Febrero,Malawi,3,1,,4,-74.140516,4.697157
49246,2018,Febrero,Malí,0,1,,1,-75.516486,10.446304
49247,2018,Febrero,Malta,1,0,,1,-76.876446,0.33002
49248,2018,Febrero,Malta,1,0,,1,-77.35600000000001,0.81488
49249,2018,Febrero,Malta,1,1,,2,-75.516486,10.446304
49250,2018,Febrero,Malta,5,15,,20,-74.140516,4.697157
49251,2018,Febrero,Malta,0,1,,1,-75.42726,6.170465
49252,2018,Febrero,Marruecos,2,2,,4,-77.35600000000001,0.81488
49253,2018,Febrero,Marruecos,1,1,,2,-75.516486,10.446304
49254,2018,Febrero,Marruecos,10,14,,24,-74.140516,4.697157
49255,2018,Febrero,Marruecos,0,2,,2,-75.42726,6.170465
49256,2018,Febrero,Mauricio,0,1,,1,-75.527794,10.406342
49257,2018,Febrero,Mauricio,0,1,,1,-74.140516,4.697157
49258,2018,Febrero,México,0,1,,1,-69.941498,4.191162
49259,2018,Febrero,México,0,2,,2,-69.94143100000001,4.214082
49260,2018,Febrero,México,2,1,,3,-76.876446,0.33002
49261,2018,Febrero,México,16,28,,44,-77.35600000000001,0.81488
49262,2018,Febrero,México,0,1,,1,-78.802679,18.00143
49263,2018,Febrero,México,14,15,,29,-75.527794,10.406342
49264,2018,Febrero,México,152,212,,364,-75.516486,10.446304
49265,2018,Febrero,México,20,57,,77,-74.77647900000001,10.886686
49266,2018,Febrero,México,3,4,,7,-72.129595,11.360028999999999
49267,2018,Febrero,México,0,2,,2,-81.703935,12.574411099999999
49268,2018,Febrero,México,4,4,,8,-81.70216500000001,12.5862
49269,2018,Febrero,México,0,8,,8,-81.372937,13.338761300000002
49270,2018,Febrero,México,81,246,,327,-76.532004,3.451668
49271,2018,Febrero,México,0,2,,2,-75.76635300000001,4.45285
49272,2018,Febrero,México,3701,6794,,10495,-74.140516,4.697157
49273,2018,Febrero,México,31,35,,66,-75.736374,4.815189
49274,2018,Febrero,México,515,1226,,1741,-75.42726,6.170465
49275,2018,Febrero,México,3,0,,3,-70.74025300000001,7.088728999999999
49276,2018,Febrero,México,7,11,,18,-73.181317,7.1280470000000005
49277,2018,Febrero,México,20,26,,46,-72.453013,7.819
49278,2018,Febrero,México,2,10,,12,-72.409396,8.36068
49279,2018,Febrero,República de Moldavia,1,0,,1,-76.532004,3.451668
49280,2018,Febrero,República de Moldavia,1,1,,2,-74.140516,4.697157
49281,2018,Febrero,Mónaco,0,1,,1,-76.532004,3.451668
49282,2018,Febrero,Mongolia,1,0,,1,-74.140516,4.697157
49283,2018,Febrero,Montenegro,0,5,,5,-75.516486,10.446304
49284,2018,Febrero,Montenegro,0,1,,1,-74.213989,11.247722999999999
49285,2018,Febrero,Montenegro,2,1,,3,-74.140516,4.697157
49286,2018,Febrero,Mozambique,2,1,,3,-74.140516,4.697157
49287,2018,Febrero,Myanmar,0,4,,4,-75.527794,10.406342
49288,2018,Febrero,Myanmar,0,2,,2,-75.516486,10.446304
49289,2018,Febrero,Myanmar,1,0,,1,-74.140516,4.697157
49290,2018,Febrero,Namibia,0,1,,1,-77.35600000000001,0.81488
49291,2018,Febrero,Nepal,1,5,,6,-74.140516,4.697157
49292,2018,Febrero,Nepal,0,1,,1,-75.42726,6.170465
49293,2018,Febrero,Nicaragua,1,0,,1,-69.941498,4.191162
49294,2018,Febrero,Nicaragua,0,1,,1,-75.527794,10.406342
49295,2018,Febrero,Nicaragua,23,25,,48,-75.516486,10.446304
49296,2018,Febrero,Nicaragua,2,8,,10,-74.77647900000001,10.886686
49297,2018,Febrero,Nicaragua,0,3,,3,-81.703935,12.574411099999999
49298,2018,Febrero,Nicaragua,17,4,,21,-76.532004,3.451668
49299,2018,Febrero,Nicaragua,1,0,,1,-75.76635300000001,4.45285
49300,2018,Febrero,Nicaragua,97,81,,178,-74.140516,4.697157
49301,2018,Febrero,Nicaragua,4,5,,9,-75.736374,4.815189
49302,2018,Febrero,Nicaragua,14,27,,41,-75.42726,6.170465
49303,2018,Febrero,Nigeria,0,4,,4,-77.35600000000001,0.81488
49304,2018,Febrero,Nigeria,1,0,,1,-75.516486,10.446304
49305,2018,Febrero,Nigeria,2,0,,2,-76.532004,3.451668
49306,2018,Febrero,Nigeria,4,7,,11,-74.140516,4.697157
49307,2018,Febrero,Nigeria,0,2,,2,-75.42726,6.170465
49308,2018,Febrero,Nigeria,0,1,,1,-72.453013,7.819
49309,2018,Febrero,Noruega,0,1,,1,-69.94143100000001,4.214082
49310,2018,Febrero,Noruega,2,2,,4,-77.35600000000001,0.81488
49311,2018,Febrero,Noruega,5,2,,7,-75.527794,10.406342
49312,2018,Febrero,Noruega,22,35,,57,-75.516486,10.446304
49313,2018,Febrero,Noruega,0,1,,1,-74.77647900000001,10.886686
49314,2018,Febrero,Noruega,1,1,,2,-74.213989,11.247722999999999
49315,2018,Febrero,Noruega,0,1,,1,-81.70216500000001,12.5862
49316,2018,Febrero,Noruega,1,1,,2,-81.372937,13.338761300000002
49317,2018,Febrero,Noruega,3,5,,8,-76.532004,3.451668
49318,2018,Febrero,Noruega,139,167,,306,-74.140516,4.697157
49319,2018,Febrero,Noruega,0,1,,1,-75.736374,4.815189
49320,2018,Febrero,Noruega,8,17,,25,-75.42726,6.170465
49321,2018,Febrero,Noruega,0,1,,1,-72.453013,7.819
49322,2018,Febrero,Noruega,1,0,,1,-77.35002,8.63337
49323,2018,Febrero,Nueva Zelanda,0,2,,2,-69.94143100000001,4.214082
49324,2018,Febrero,Nueva Zelanda,5,2,,7,-77.35600000000001,0.81488
49325,2018,Febrero,Nueva Zelanda,3,6,,9,-75.527794,10.406342
49326,2018,Febrero,Nueva Zelanda,12,15,,27,-75.516486,10.446304
49327,2018,Febrero,Nueva Zelanda,1,1,,2,-74.77647900000001,10.886686
49328,2018,Febrero,Nueva Zelanda,1,1,,2,-76.532004,3.451668
49329,2018,Febrero,Nueva Zelanda,0,1,,1,-75.76635300000001,4.45285
49330,2018,Febrero,Nueva Zelanda,46,65,,111,-74.140516,4.697157
49331,2018,Febrero,Nueva Zelanda,1,2,,3,-75.736374,4.815189
49332,2018,Febrero,Nueva Zelanda,4,15,,19,-75.42726,6.170465
49333,2018,Febrero,Nueva Zelanda,2,1,,3,-77.35002,8.63337
49334,2018,Febrero,Países Bajos,3,3,,6,-69.941498,4.191162
49335,2018,Febrero,Países Bajos,2,5,,7,-69.94143100000001,4.214082
49336,2018,Febrero,Países Bajos,2,5,,7,-76.876446,0.33002
49337,2018,Febrero,Países Bajos,27,23,,50,-77.35600000000001,0.81488
49338,2018,Febrero,Países Bajos,31,38,,69,-75.527794,10.406342
49339,2018,Febrero,Países Bajos,146,190,,336,-75.516486,10.446304
49340,2018,Febrero,Países Bajos,16,22,,38,-74.77647900000001,10.886686
49341,2018,Febrero,Países Bajos,0,1,,1,-74.765343,10.970933
49342,2018,Febrero,Países Bajos,2,4,,6,-74.213989,11.247722999999999
49343,2018,Febrero,Países Bajos,0,2,,2,-72.129595,11.360028999999999
49344,2018,Febrero,Países Bajos,2,2,,4,-81.70216500000001,12.5862
49345,2018,Febrero,Países Bajos,42,57,,99,-76.532004,3.451668
49346,2018,Febrero,Países Bajos,1464,1987,,3451,-74.140516,4.697157
49347,2018,Febrero,Países Bajos,2,6,,8,-75.736374,4.815189
49348,2018,Febrero,Países Bajos,112,206,,318,-75.42726,6.170465
49349,2018,Febrero,Países Bajos,0,1,,1,-75.586989,6.2188349999999994
49350,2018,Febrero,Países Bajos,6,6,,12,-73.181317,7.1280470000000005
49351,2018,Febrero,Países Bajos,1,6,,7,-72.453013,7.819
49352,2018,Febrero,Países Bajos,15,4,,19,-77.35002,8.63337
49353,2018,Febrero,Pakistán,1,0,,1,-69.94143100000001,4.214082
49354,2018,Febrero,Pakistán,0,1,,1,-77.35600000000001,0.81488
49355,2018,Febrero,Pakistán,1,3,,4,-75.516486,10.446304
49356,2018,Febrero,Pakistán,5,16,,21,-74.140516,4.697157
49357,2018,Febrero,Pakistán,0,1,,1,-75.42726,6.170465
49358,2018,Febrero,Pakistán,0,1,,1,-72.453013,7.819
49359,2018,Febrero,Panamá,6,6,,12,-77.35600000000001,0.81488
49360,2018,Febrero,Panamá,0,10,,10,-75.527794,10.406342
49361,2018,Febrero,Panamá,766,688,,1454,-75.516486,10.446304
49362,2018,Febrero,Panamá,129,122,,251,-74.77647900000001,10.886686
49363,2018,Febrero,Panamá,105,92,,197,-81.70216500000001,12.5862
49364,2018,Febrero,Panamá,390,343,,733,-76.532004,3.451668
49365,2018,Febrero,Panamá,30,57,,87,-75.76635300000001,4.45285
49366,2018,Febrero,Panamá,2541,2237,,4778,-74.140516,4.697157
49367,2018,Febrero,Panamá,68,55,,123,-75.736374,4.815189
49368,2018,Febrero,Panamá,2829,2178,,5007,-75.42726,6.170465
49369,2018,Febrero,Panamá,0,1,,1,-75.586989,6.2188349999999994
49370,2018,Febrero,Panamá,0,1,,1,-77.401154,6.222551999999999
49371,2018,Febrero,Panamá,0,2,,2,-77.762647,7.102626
49372,2018,Febrero,Panamá,12,12,,24,-73.181317,7.1280470000000005
49373,2018,Febrero,Panamá,1,2,,3,-72.453013,7.819
49374,2018,Febrero,Panamá,0,1,,1,-72.409396,8.36068
49375,2018,Febrero,Panamá,2,11,,13,-77.35002,8.63337
49376,2018,Febrero,Paraguay,0,2,,2,-69.94143100000001,4.214082
49377,2018,Febrero,Paraguay,2,3,,5,-77.35600000000001,0.81488
49378,2018,Febrero,Paraguay,5,4,,9,-75.527794,10.406342
49379,2018,Febrero,Paraguay,75,48,,123,-75.516486,10.446304
49380,2018,Febrero,Paraguay,12,158,,170,-74.77647900000001,10.886686
49381,2018,Febrero,Paraguay,0,2,,2,-72.129595,11.360028999999999
49382,2018,Febrero,Paraguay,47,28,,75,-81.70216500000001,12.5862
49383,2018,Febrero,Paraguay,9,2,,11,-76.532004,3.451668
49384,2018,Febrero,Paraguay,193,192,,385,-74.140516,4.697157
49385,2018,Febrero,Paraguay,10,16,,26,-75.42726,6.170465
49386,2018,Febrero,Paraguay,0,1,,1,-72.409396,8.36068
49387,2018,Febrero,Perú,27,23,,50,-69.941498,4.191162
49388,2018,Febrero,Perú,52,57,,109,-69.94143100000001,4.214082
49389,2018,Febrero,Perú,1,0,,1,-74.78366,0.18595699999999998
49390,2018,Febrero,Perú,2,6,,8,-76.876446,0.33002
49391,2018,Febrero,Perú,158,341,,499,-77.35600000000001,0.81488
49392,2018,Febrero,Perú,50,25,,75,-75.527794,10.406342
49393,2018,Febrero,Perú,832,612,,1444,-75.516486,10.446304
49394,2018,Febrero,Perú,11,25,,36,-74.77647900000001,10.886686
49395,2018,Febrero,Perú,13,21,,34,-72.129595,11.360028999999999
49396,2018,Febrero,Perú,405,290,,695,-81.70216500000001,12.5862
49397,2018,Febrero,Perú,141,201,,342,-76.532004,3.451668
49398,2018,Febrero,Perú,3951,4509,,8460,-74.140516,4.697157
49399,2018,Febrero,Perú,3,4,,7,-75.736374,4.815189
49400,2018,Febrero,Perú,340,543,,883,-75.42726,6.170465
49401,2018,Febrero,Perú,2,1,,3,-67.48402800000001,6.185536
49402,2018,Febrero,Perú,2,1,,3,-70.74025300000001,7.088728999999999
49403,2018,Febrero,Perú,8,6,,14,-73.181317,7.1280470000000005
49404,2018,Febrero,Perú,130,246,,376,-72.453013,7.819
49405,2018,Febrero,Perú,4,6,,10,-72.409396,8.36068
49406,2018,Febrero,Palestina,1,0,,1,-77.35600000000001,0.81488
49407,2018,Febrero,Palestina,2,6,,8,-74.140516,4.697157
49408,2018,Febrero,Polonia,4,3,,7,-69.94143100000001,4.214082
49409,2018,Febrero,Polonia,9,4,,13,-76.876446,0.33002
49410,2018,Febrero,Polonia,13,8,,21,-77.35600000000001,0.81488
49411,2018,Febrero,Polonia,1,4,,5,-75.527794,10.406342
49412,2018,Febrero,Polonia,36,32,,68,-75.516486,10.446304
49413,2018,Febrero,Polonia,0,2,,2,-74.77647900000001,10.886686
49414,2018,Febrero,Polonia,0,1,,1,-74.213989,11.247722999999999
49415,2018,Febrero,Polonia,0,1,,1,-72.129595,11.360028999999999
49416,2018,Febrero,Polonia,0,1,,1,-81.70216500000001,12.5862
49417,2018,Febrero,Polonia,9,21,,30,-76.532004,3.451668
49418,2018,Febrero,Polonia,194,232,,426,-74.140516,4.697157
49419,2018,Febrero,Polonia,0,1,,1,-75.736374,4.815189
49420,2018,Febrero,Polonia,16,23,,39,-75.42726,6.170465
49421,2018,Febrero,Polonia,2,1,,3,-72.453013,7.819
49422,2018,Febrero,Polonia,0,4,,4,-76.7333,8.06667
49423,2018,Febrero,Polonia,2,4,,6,-77.35002,8.63337
49424,2018,Febrero,Portugal,2,1,,3,-69.941498,4.191162
49425,2018,Febrero,Portugal,1,0,,1,-69.94143100000001,4.214082
49426,2018,Febrero,Portugal,2,8,,10,-77.35600000000001,0.81488
49427,2018,Febrero,Portugal,0,3,,3,-75.527794,10.406342
49428,2018,Febrero,Portugal,12,30,,42,-75.516486,10.446304
49429,2018,Febrero,Portugal,0,3,,3,-74.77647900000001,10.886686
49430,2018,Febrero,Portugal,0,2,,2,-74.213989,11.247722999999999
49431,2018,Febrero,Portugal,3,5,,8,-72.129595,11.360028999999999
49432,2018,Febrero,Portugal,5,0,,5,-81.70216500000001,12.5862
49433,2018,Febrero,Portugal,12,33,,45,-76.532004,3.451668
49434,2018,Febrero,Portugal,224,415,,639,-74.140516,4.697157
49435,2018,Febrero,Portugal,1,2,,3,-75.736374,4.815189
49436,2018,Febrero,Portugal,17,54,,71,-75.42726,6.170465
49437,2018,Febrero,Portugal,1,0,,1,-73.181317,7.1280470000000005
49438,2018,Febrero,Portugal,8,20,,28,-72.453013,7.819
49439,2018,Febrero,Portugal,0,2,,2,-72.409396,8.36068
49440,2018,Febrero,Puerto Rico/Territorio de Estados Unidos,2,0,,2,-74.140516,4.697157
49441,2018,Febrero,Qatar,0,1,,1,-75.42726,6.170465
49442,2018,Febrero,Reino Unido de Gran Bretaña e Irlanda del Norte,0,3,,3,-69.941498,4.191162
49443,2018,Febrero,Reino Unido de Gran Bretaña e Irlanda del Norte,5,10,,15,-69.94143100000001,4.214082
49444,2018,Febrero,Reino Unido de Gran Bretaña e Irlanda del Norte,2,1,,3,-76.876446,0.33002
49445,2018,Febrero,Reino Unido de Gran Bretaña e Irlanda del Norte,41,57,,98,-77.35600000000001,0.81488
49446,2018,Febrero,Reino Unido de Gran Bretaña e Irlanda del Norte,13,23,,36,-75.527794,10.406342
49447,2018,Febrero,Reino Unido de Gran Bretaña e Irlanda del Norte,117,190,,307,-75.516486,10.446304
49448,2018,Febrero,Reino Unido de Gran Bretaña e Irlanda del Norte,8,18,,26,-74.77647900000001,10.886686
49449,2018,Febrero,Reino Unido de Gran Bretaña e Irlanda del Norte,6,4,,10,-74.213989,11.247722999999999
49450,2018,Febrero,Reino Unido de Gran Bretaña e Irlanda del Norte,0,1,,1,-72.129595,11.360028999999999
49451,2018,Febrero,Reino Unido de Gran Bretaña e Irlanda del Norte,0,3,,3,-81.703935,12.574411099999999
49452,2018,Febrero,Reino Unido de Gran Bretaña e Irlanda del Norte,1,2,,3,-81.70216500000001,12.5862
49453,2018,Febrero,Reino Unido de Gran Bretaña e Irlanda del Norte,1,1,,2,-81.372937,13.338761300000002
49454,2018,Febrero,Reino Unido de Gran Bretaña e Irlanda del Norte,31,56,,87,-76.532004,3.451668
49455,2018,Febrero,Reino Unido de Gran Bretaña e Irlanda del Norte,1,0,,1,-77.061029,3.8844260000000004
49456,2018,Febrero,Reino Unido de Gran Bretaña e Irlanda del Norte,1,1,,2,-75.76635300000001,4.45285
49457,2018,Febrero,Reino Unido de Gran Bretaña e Irlanda del Norte,1186,2066,,3252,-74.140516,4.697157
49458,2018,Febrero,Reino Unido de Gran Bretaña e Irlanda del Norte,1,2,,3,-75.736374,4.815189
49459,2018,Febrero,Reino Unido de Gran Bretaña e Irlanda del Norte,112,250,,362,-75.42726,6.170465
49460,2018,Febrero,Reino Unido de Gran Bretaña e Irlanda del Norte,5,3,,8,-67.48402800000001,6.185536
49461,2018,Febrero,Reino Unido de Gran Bretaña e Irlanda del Norte,1,1,,2,-73.181317,7.1280470000000005
49462,2018,Febrero,Reino Unido de Gran Bretaña e Irlanda del Norte,2,5,,7,-72.453013,7.819
49463,2018,Febrero,Reino Unido de Gran Bretaña e Irlanda del Norte,24,17,,41,-77.35002,8.63337
49464,2018,Febrero,República Dominicana,4,9,,13,-77.35600000000001,0.81488
49465,2018,Febrero,República Dominicana,0,1,,1,-75.527794,10.406342
49466,2018,Febrero,República Dominicana,36,121,,157,-75.516486,10.446304
49467,2018,Febrero,República Dominicana,55,83,,138,-74.77647900000001,10.886686
49468,2018,Febrero,República Dominicana,0,3,,3,-74.232675,11.117206
49469,2018,Febrero,República Dominicana,1,5,,6,-72.129595,11.360028999999999
49470,2018,Febrero,República Dominicana,1,2,,3,-81.70216500000001,12.5862
49471,2018,Febrero,República Dominicana,26,37,,63,-76.532004,3.451668
49472,2018,Febrero,República Dominicana,1,2,,3,-75.76635300000001,4.45285
49473,2018,Febrero,República Dominicana,548,726,,1274,-74.140516,4.697157
49474,2018,Febrero,República Dominicana,4,6,,10,-75.736374,4.815189
49475,2018,Febrero,República Dominicana,92,97,,189,-75.42726,6.170465
49476,2018,Febrero,República Dominicana,2,1,,3,-73.181317,7.1280470000000005
49477,2018,Febrero,República Dominicana,1,7,,8,-72.453013,7.819
49478,2018,Febrero,Rumania,1,0,,1,-69.941498,4.191162
49479,2018,Febrero,Rumania,1,5,,6,-77.35600000000001,0.81488
49480,2018,Febrero,Rumania,0,5,,5,-75.527794,10.406342
49481,2018,Febrero,Rumania,10,17,,27,-75.516486,10.446304
49482,2018,Febrero,Rumania,0,1,,1,-74.77647900000001,10.886686
49483,2018,Febrero,Rumania,0,1,,1,-74.765343,10.970933
49484,2018,Febrero,Rumania,8,6,,14,-76.532004,3.451668
49485,2018,Febrero,Rumania,74,92,,166,-74.140516,4.697157
49486,2018,Febrero,Rumania,0,1,,1,-75.736374,4.815189
49487,2018,Febrero,Rumania,7,5,,12,-75.42726,6.170465
49488,2018,Febrero,Rumania,0,1,,1,-72.453013,7.819
49489,2018,Febrero,Federación de Rusia,3,1,,4,-69.94143100000001,4.214082
49490,2018,Febrero,Federación de Rusia,5,7,,12,-77.35600000000001,0.81488
49491,2018,Febrero,Federación de Rusia,1,21,,22,-75.527794,10.406342
49492,2018,Febrero,Federación de Rusia,24,25,,49,-75.516486,10.446304
49493,2018,Febrero,Federación de Rusia,1,1,,2,-74.77647900000001,10.886686
49494,2018,Febrero,Federación de Rusia,0,1,,1,-74.765343,10.970933
49495,2018,Febrero,Federación de Rusia,1,6,,7,-74.213989,11.247722999999999
49496,2018,Febrero,Federación de Rusia,0,1,,1,-81.703935,12.574411099999999
49497,2018,Febrero,Federación de Rusia,7,6,,13,-76.532004,3.451668
49498,2018,Febrero,Federación de Rusia,0,1,,1,-77.061029,3.8844260000000004
49499,2018,Febrero,Federación de Rusia,142,196,,338,-74.140516,4.697157
49500,2018,Febrero,Federación de Rusia,20,18,,38,-75.42726,6.170465
49501,2018,Febrero,Federación de Rusia,2,0,,2,-72.453013,7.819
49502,2018,Febrero,Federación de Rusia,2,0,,2,-77.35002,8.63337
49503,2018,Febrero,Federación de Rusia,0,2,,2,-75.68164200000001,9.402597
49504,2018,Febrero,Rwanda,0,2,,2,-74.140516,4.697157
49505,2018,Febrero,San Cristóbal y Nevis,3,3,,6,-74.140516,4.697157
49506,2018,Febrero,Samoa Estadounidense/Territorio no incorporado de Estados Unidos,1,0,,1,-74.140516,4.697157
49507,2018,Febrero,San Marino,0,1,,1,-69.941498,4.191162
49508,2018,Febrero,San Marino,0,1,,1,-74.140516,4.697157
49509,2018,Febrero,San  Vicente y las Granadinas,0,1,,1,-74.140516,4.697157
49510,2018,Febrero,San  Vicente y las Granadinas,0,1,,1,-75.42726,6.170465
49511,2018,Febrero,Santa Lucia,0,2,,2,-75.516486,10.446304
49512,2018,Febrero,Santa Lucia,0,3,,3,-74.140516,4.697157
49513,2018,Febrero,Santa Lucia,0,1,,1,-75.42726,6.170465
49514,2018,Febrero,Senegal,0,1,,1,-75.516486,10.446304
49515,2018,Febrero,Senegal,1,1,,2,-76.532004,3.451668
49516,2018,Febrero,Senegal,1,0,,1,-74.140516,4.697157
49517,2018,Febrero,Serbia,0,1,,1,-75.527794,10.406342
49518,2018,Febrero,Serbia,2,0,,2,-75.516486,10.446304
49519,2018,Febrero,Serbia,12,20,,32,-74.140516,4.697157
49520,2018,Febrero,Serbia,1,4,,5,-75.42726,6.170465
49521,2018,Febrero,Serbia,0,1,,1,-72.453013,7.819
49522,2018,Febrero,Singapur,1,0,,1,-77.35600000000001,0.81488
49523,2018,Febrero,Singapur,3,0,,3,-75.516486,10.446304
49524,2018,Febrero,Singapur,0,1,,1,-74.77647900000001,10.886686
49525,2018,Febrero,Singapur,17,11,,28,-74.140516,4.697157
49526,2018,Febrero,República Árabe Siria,1,6,,7,-74.140516,4.697157
49527,2018,Febrero,República Árabe Siria,0,2,,2,-75.42726,6.170465
49528,2018,Febrero,República Árabe Siria,0,1,,1,-72.453013,7.819
49529,2018,Febrero,Sri Lanka,1,6,,7,-75.516486,10.446304
49530,2018,Febrero,Sri Lanka,3,4,,7,-74.140516,4.697157
49531,2018,Febrero,Sri Lanka,0,1,,1,-75.42726,6.170465
49532,2018,Febrero,Sudáfrica,1,0,,1,-69.941498,4.191162
49533,2018,Febrero,Sudáfrica,0,2,,2,-77.35600000000001,0.81488
49534,2018,Febrero,Sudáfrica,2,6,,8,-75.527794,10.406342
49535,2018,Febrero,Sudáfrica,3,2,,5,-75.516486,10.446304
49536,2018,Febrero,Sudáfrica,1,2,,3,-74.77647900000001,10.886686
49537,2018,Febrero,Sudáfrica,1,1,,2,-76.532004,3.451668
49538,2018,Febrero,Sudáfrica,9,27,,36,-74.140516,4.697157
49539,2018,Febrero,Sudáfrica,1,3,,4,-75.42726,6.170465
49540,2018,Febrero,Suecia,0,2,,2,-69.941498,4.191162
49541,2018,Febrero,Suecia,0,3,,3,-69.94143100000001,4.214082
49542,2018,Febrero,Suecia,1,0,,1,-76.876446,0.33002
49543,2018,Febrero,Suecia,7,7,,14,-77.35600000000001,0.81488
49544,2018,Febrero,Suecia,15,10,,25,-75.527794,10.406342
49545,2018,Febrero,Suecia,55,69,,124,-75.516486,10.446304
49546,2018,Febrero,Suecia,6,7,,13,-74.77647900000001,10.886686
49547,2018,Febrero,Suecia,1,0,,1,-81.70216500000001,12.5862
49548,2018,Febrero,Suecia,9,12,,21,-76.532004,3.451668
49549,2018,Febrero,Suecia,293,375,,668,-74.140516,4.697157
49550,2018,Febrero,Suecia,30,60,,90,-75.42726,6.170465
49551,2018,Febrero,Suecia,2,1,,3,-72.453013,7.819
49552,2018,Febrero,Suecia,2,0,,2,-77.35002,8.63337
49553,2018,Febrero,Suiza,2,5,,7,-69.941498,4.191162
49554,2018,Febrero,Suiza,2,3,,5,-69.94143100000001,4.214082
49555,2018,Febrero,Suiza,1,3,,4,-76.876446,0.33002
49556,2018,Febrero,Suiza,44,38,,82,-77.35600000000001,0.81488
49557,2018,Febrero,Suiza,15,24,,39,-75.527794,10.406342
49558,2018,Febrero,Suiza,51,59,,110,-75.516486,10.446304
49559,2018,Febrero,Suiza,8,6,,14,-74.77647900000001,10.886686
49560,2018,Febrero,Suiza,1,1,,2,-72.129595,11.360028999999999
49561,2018,Febrero,Suiza,3,1,,4,-81.70216500000001,12.5862
49562,2018,Febrero,Suiza,0,1,,1,-81.372937,13.338761300000002
49563,2018,Febrero,Suiza,19,31,,50,-76.532004,3.451668
49564,2018,Febrero,Suiza,597,830,,1427,-74.140516,4.697157
49565,2018,Febrero,Suiza,1,0,,1,-75.736374,4.815189
49566,2018,Febrero,Suiza,67,118,,185,-75.42726,6.170465
49567,2018,Febrero,Suiza,1,2,,3,-72.453013,7.819
49568,2018,Febrero,Suiza,5,4,,9,-77.35002,8.63337
49569,2018,Febrero,Surinam,0,1,,1,-74.77647900000001,10.886686
49570,2018,Febrero,Surinam,8,14,,22,-74.140516,4.697157
49571,2018,Febrero,Surinam,0,1,,1,-75.42726,6.170465
49572,2018,Febrero,Tailandia,0,1,,1,-75.527794,10.406342
49573,2018,Febrero,Tailandia,0,1,,1,-75.516486,10.446304
49574,2018,Febrero,Tailandia,5,7,,12,-74.140516,4.697157
49575,2018,Febrero,Tailandia,1,0,,1,-75.42726,6.170465
49576,2018,Febrero,Tanzania,1,1,,2,-74.140516,4.697157
49577,2018,Febrero,Tonga,0,1,,1,-74.140516,4.697157
49578,2018,Febrero,Trinidad y Tobago,0,1,,1,-77.35600000000001,0.81488
49579,2018,Febrero,Trinidad y Tobago,5,5,,10,-75.516486,10.446304
49580,2018,Febrero,Trinidad y Tobago,2,3,,5,-74.77647900000001,10.886686
49581,2018,Febrero,Trinidad y Tobago,6,7,,13,-76.532004,3.451668
49582,2018,Febrero,Trinidad y Tobago,9,37,,46,-74.140516,4.697157
49583,2018,Febrero,Trinidad y Tobago,1,1,,2,-75.736374,4.815189
49584,2018,Febrero,Trinidad y Tobago,5,10,,15,-75.42726,6.170465
49585,2018,Febrero,Trinidad y Tobago,0,1,,1,-72.453013,7.819
49586,2018,Febrero,Túnez,0,1,,1,-76.876446,0.33002
49587,2018,Febrero,Túnez,0,1,,1,-75.527794,10.406342
49588,2018,Febrero,Túnez,0,2,,2,-76.532004,3.451668
49589,2018,Febrero,Túnez,0,8,,8,-74.140516,4.697157
49590,2018,Febrero,Turquía,0,1,,1,-69.941498,4.191162
49591,2018,Febrero,Turquía,4,8,,12,-77.35600000000001,0.81488
49592,2018,Febrero,Turquía,10,15,,25,-75.516486,10.446304
49593,2018,Febrero,Turquía,2,8,,10,-74.77647900000001,10.886686
49594,2018,Febrero,Turquía,0,1,,1,-72.129595,11.360028999999999
49595,2018,Febrero,Turquía,0,12,,12,-76.532004,3.451668
49596,2018,Febrero,Turquía,167,330,,497,-74.140516,4.697157
49597,2018,Febrero,Turquía,7,16,,23,-75.42726,6.170465
49598,2018,Febrero,Turquía,0,2,,2,-72.453013,7.819
49599,2018,Febrero,Turquía,0,1,,1,-77.35002,8.63337
49600,2018,Febrero,Ucrania,4,13,,17,-75.527794,10.406342
49601,2018,Febrero,Ucrania,4,14,,18,-75.516486,10.446304
49602,2018,Febrero,Ucrania,0,4,,4,-74.77647900000001,10.886686
49603,2018,Febrero,Ucrania,0,2,,2,-74.213989,11.247722999999999
49604,2018,Febrero,Ucrania,0,1,,1,-76.532004,3.451668
49605,2018,Febrero,Ucrania,0,1,,1,-77.061029,3.8844260000000004
49606,2018,Febrero,Ucrania,27,19,,46,-74.140516,4.697157
49607,2018,Febrero,Ucrania,7,0,,7,-75.42726,6.170465
49608,2018,Febrero,Uganda,2,1,,3,-77.35600000000001,0.81488
49609,2018,Febrero,Uganda,1,0,,1,-74.140516,4.697157
49610,2018,Febrero,Uruguay,1,0,,1,-69.94143100000001,4.214082
49611,2018,Febrero,Uruguay,2,0,,2,-76.876446,0.33002
49612,2018,Febrero,Uruguay,5,14,,19,-77.35600000000001,0.81488
49613,2018,Febrero,Uruguay,17,15,,32,-75.527794,10.406342
49614,2018,Febrero,Uruguay,76,70,,146,-75.516486,10.446304
49615,2018,Febrero,Uruguay,5,16,,21,-74.77647900000001,10.886686
49616,2018,Febrero,Uruguay,0,1,,1,-72.129595,11.360028999999999
49617,2018,Febrero,Uruguay,19,10,,29,-81.70216500000001,12.5862
49618,2018,Febrero,Uruguay,8,33,,41,-76.532004,3.451668
49619,2018,Febrero,Uruguay,425,566,,991,-74.140516,4.697157
49620,2018,Febrero,Uruguay,2,1,,3,-75.736374,4.815189
49621,2018,Febrero,Uruguay,33,42,,75,-75.42726,6.170465
49622,2018,Febrero,Uruguay,2,15,,17,-72.453013,7.819
49623,2018,Febrero,Uruguay,1,2,,3,-72.409396,8.36068
49624,2018,Febrero,Uzbekistán,0,1,,1,-75.42726,6.170465
49625,2018,Febrero,Venezuela,2,15,,17,-69.941498,4.191162
49626,2018,Febrero,Venezuela,1,5,,6,-69.94143100000001,4.214082
49627,2018,Febrero,Venezuela,24,30,,54,-76.876446,0.33002
49628,2018,Febrero,Venezuela,0,1,,1,-77.84700600000001,0.8124359999999999
49629,2018,Febrero,Venezuela,1465,1736,,3201,-77.35600000000001,0.81488
49630,2018,Febrero,Venezuela,1,0,,1,-78.802679,18.00143
49631,2018,Febrero,Venezuela,9,8,,17,-75.527794,10.406342
49632,2018,Febrero,Venezuela,156,229,,385,-75.516486,10.446304
49633,2018,Febrero,Venezuela,117,188,,305,-74.77647900000001,10.886686
49634,2018,Febrero,Venezuela,28,62,,90,-74.232675,11.117206
49635,2018,Febrero,Venezuela,10064,12466,,22530,-72.129595,11.360028999999999
49636,2018,Febrero,Venezuela,0,3,,3,-72.919186,11.52863
49637,2018,Febrero,Venezuela,1,4,,5,-71.983761,12.165168
49638,2018,Febrero,Venezuela,84,138,,222,-76.532004,3.451668
49639,2018,Febrero,Venezuela,14,8,,22,-67.927521,3.866713
49640,2018,Febrero,Venezuela,2,2,,4,-75.76635300000001,4.45285
49641,2018,Febrero,Venezuela,5009,5257,,10266,-74.140516,4.697157
49642,2018,Febrero,Venezuela,6,5,,11,-75.736374,4.815189
49643,2018,Febrero,Venezuela,742,818,,1560,-75.42726,6.170465
49644,2018,Febrero,Venezuela,41,37,,78,-67.48402800000001,6.185536
49645,2018,Febrero,Venezuela,0,3,,3,-75.586989,6.2188349999999994
49646,2018,Febrero,Venezuela,756,1076,,1832,-70.74025300000001,7.088728999999999
49647,2018,Febrero,Venezuela,14,12,,26,-73.181317,7.1280470000000005
49648,2018,Febrero,Venezuela,34568,48041,,82609,-72.453013,7.819
49649,2018,Febrero,Venezuela,3,13,,16,-72.508188,7.927233
49650,2018,Febrero,Venezuela,2447,2963,,5410,-72.409396,8.36068
49651,2018,Febrero,Vietnam,0,2,,2,-75.527794,10.406342
49652,2018,Febrero,Vietnam,4,1,,5,-74.140516,4.697157
49653,2018,Febrero,Vietnam,0,1,,1,-75.42726,6.170465
49654,2018,Febrero,Islas Vírgenes Británicas/Territorio Británico de Ultramar,1,1,,2,-75.42726,6.170465
49655,2018,Febrero,República Árabe de Yemen,0,1,,1,-77.35600000000001,0.81488
49656,2018,Febrero,República Árabe de Yemen,0,1,,1,-74.140516,4.697157
49657,2018,Febrero,Zimbabue,0,1,,1,-76.532004,3.451668
49658,2018,Febrero,Zimbabue,1,1,,2,-74.140516,4.697157
49659,2018,Febrero,Refugiado Otro,0,5,,5,-74.140516,4.697157
49660,2018,Febrero,Refugiado,0,1,,1,-75.516486,10.446304
49661,2018,Febrero,Refugiado,3,4,,7,-74.140516,4.697157
49662,2018,Febrero,Refugiado,0,1,,1,-75.42726,6.170465
49663,2018,Febrero,Desconocido,0,2,,2,-76.532004,3.451668
49664,2018,Febrero,Desconocido,60,132,,192,-74.140516,4.697157
49665,2018,Febrero,Desconocido,1,6,,7,-75.42726,6.170465
49666,2018,Febrero,Desconocido,1,2,,3,-72.453013,7.819
49667,2018,Marzo,Afganistán,1,1,,2,-75.516486,10.446304
49668,2018,Marzo,Afganistán,0,2,,2,-74.140516,4.697157
49669,2018,Marzo,Afganistán,0,1,,1,-75.42726,6.170465
49670,2018,Marzo,Albania,1,0,,1,-75.516486,10.446304
49671,2018,Marzo,Albania,4,4,,8,-74.140516,4.697157
49672,2018,Marzo,Alemania,9,10,,19,-69.941498,4.191162
49673,2018,Marzo,Alemania,11,29,,40,-69.94143100000001,4.214082
49674,2018,Marzo,Alemania,16,10,,26,-76.876446,0.33002
49675,2018,Marzo,Alemania,98,102,,200,-77.35600000000001,0.81488
49676,2018,Marzo,Alemania,57,52,,109,-75.527794,10.406342
49677,2018,Marzo,Alemania,244,276,,520,-75.516486,10.446304
49678,2018,Marzo,Alemania,41,41,,82,-74.77647900000001,10.886686
49679,2018,Marzo,Alemania,1,3,,4,-74.213989,11.247722999999999
49680,2018,Marzo,Alemania,4,4,,8,-72.129595,11.360028999999999
49681,2018,Marzo,Alemania,3,4,,7,-81.70216500000001,12.5862
49682,2018,Marzo,Alemania,3,8,,11,-81.372937,13.338761300000002
49683,2018,Marzo,Alemania,72,83,,155,-76.532004,3.451668
49684,2018,Marzo,Alemania,1,1,,2,-75.76635300000001,4.45285
49685,2018,Marzo,Alemania,2546,3558,,6104,-74.140516,4.697157
49686,2018,Marzo,Alemania,5,11,,16,-75.736374,4.815189
49687,2018,Marzo,Alemania,193,287,,480,-75.42726,6.170465
49688,2018,Marzo,Alemania,1,2,,3,-73.181317,7.1280470000000005
49689,2018,Marzo,Alemania,3,5,,8,-72.453013,7.819
49690,2018,Marzo,Alemania,2,2,,4,-72.409396,8.36068
49691,2018,Marzo,Alemania,21,16,,37,-77.35002,8.63337
49692,2018,Marzo,Andorra,2,7,,9,-74.140516,4.697157
49693,2018,Marzo,Andorra,0,1,,1,-75.42726,6.170465
49694,2018,Marzo,Angola,2,0,,2,-75.516486,10.446304
49695,2018,Marzo,Angola,0,1,,1,-74.140516,4.697157
49696,2018,Marzo,Angola,1,0,,1,-75.42726,6.170465
49697,2018,Marzo,Antigua y Barbuda,0,1,,1,-75.516486,10.446304
49698,2018,Marzo,Antigua y Barbuda,3,9,,12,-74.140516,4.697157
49699,2018,Marzo,Antigua y Barbuda,1,0,,1,-75.42726,6.170465
49700,2018,Marzo,Países Bajos,0,1,,1,-74.140516,4.697157
49701,2018,Marzo,Arabia Saudita,1,0,,1,-77.35600000000001,0.81488
49702,2018,Marzo,Arabia Saudita,0,10,,10,-74.140516,4.697157
49703,2018,Marzo,Argelia,0,1,,1,-81.70216500000001,12.5862
49704,2018,Marzo,Argelia,1,4,,5,-74.140516,4.697157
49705,2018,Marzo,Argelia,1,1,,2,-75.42726,6.170465
49706,2018,Marzo,Argentina,5,10,,15,-69.941498,4.191162
49707,2018,Marzo,Argentina,2,7,,9,-69.94143100000001,4.214082
49708,2018,Marzo,Argentina,8,8,,16,-76.876446,0.33002
49709,2018,Marzo,Argentina,1,0,,1,-77.84700600000001,0.8124359999999999
49710,2018,Marzo,Argentina,97,158,,255,-77.35600000000001,0.81488
49711,2018,Marzo,Argentina,387,280,,667,-75.527794,10.406342
49712,2018,Marzo,Argentina,2745,2003,,4748,-75.516486,10.446304
49713,2018,Marzo,Argentina,24,44,,68,-74.77647900000001,10.886686
49714,2018,Marzo,Argentina,1,1,,2,-74.232675,11.117206
49715,2018,Marzo,Argentina,5,13,,18,-72.129595,11.360028999999999
49716,2018,Marzo,Argentina,578,418,,996,-81.70216500000001,12.5862
49717,2018,Marzo,Argentina,54,80,,134,-76.532004,3.451668
49718,2018,Marzo,Argentina,2,2,,4,-75.76635300000001,4.45285
49719,2018,Marzo,Argentina,9272,9467,,18739,-74.140516,4.697157
49720,2018,Marzo,Argentina,6,5,,11,-75.736374,4.815189
49721,2018,Marzo,Argentina,266,368,,634,-75.42726,6.170465
49722,2018,Marzo,Argentina,1,1,,2,-70.74025300000001,7.088728999999999
49723,2018,Marzo,Argentina,0,1,,1,-77.762647,7.102626
49724,2018,Marzo,Argentina,0,1,,1,-73.181317,7.1280470000000005
49725,2018,Marzo,Argentina,6,23,,29,-72.453013,7.819
49726,2018,Marzo,Argentina,2,1,,3,-72.409396,8.36068
49727,2018,Marzo,Argentina,8,1,,9,-77.35002,8.63337
49728,2018,Marzo,República de Armenia,1,0,,1,-74.140516,4.697157
49729,2018,Marzo,República de Armenia,0,1,,1,-75.42726,6.170465
49730,2018,Marzo,Australia,4,2,,6,-69.941498,4.191162
49731,2018,Marzo,Australia,3,4,,7,-69.94143100000001,4.214082
49732,2018,Marzo,Australia,1,1,,2,-76.876446,0.33002
49733,2018,Marzo,Australia,1,0,,1,-77.84700600000001,0.8124359999999999
49734,2018,Marzo,Australia,23,27,,50,-77.35600000000001,0.81488
49735,2018,Marzo,Australia,16,22,,38,-75.527794,10.406342
49736,2018,Marzo,Australia,46,59,,105,-75.516486,10.446304
49737,2018,Marzo,Australia,9,18,,27,-74.77647900000001,10.886686
49738,2018,Marzo,Australia,1,1,,2,-74.213989,11.247722999999999
49739,2018,Marzo,Australia,0,1,,1,-72.129595,11.360028999999999
49740,2018,Marzo,Australia,0,2,,2,-81.703935,12.574411099999999
49741,2018,Marzo,Australia,5,8,,13,-76.532004,3.451668
49742,2018,Marzo,Australia,306,558,,864,-74.140516,4.697157
49743,2018,Marzo,Australia,1,2,,3,-75.736374,4.815189
49744,2018,Marzo,Australia,32,98,,130,-75.42726,6.170465
49745,2018,Marzo,Australia,0,1,,1,-73.181317,7.1280470000000005
49746,2018,Marzo,Australia,0,3,,3,-72.453013,7.819
49747,2018,Marzo,Australia,3,11,,14,-77.35002,8.63337
49748,2018,Marzo,Austria,0,1,,1,-69.941498,4.191162
49749,2018,Marzo,Austria,1,1,,2,-69.94143100000001,4.214082
49750,2018,Marzo,Austria,3,2,,5,-76.876446,0.33002
49751,2018,Marzo,Austria,5,8,,13,-77.35600000000001,0.81488
49752,2018,Marzo,Austria,5,10,,15,-75.527794,10.406342
49753,2018,Marzo,Austria,22,22,,44,-75.516486,10.446304
49754,2018,Marzo,Austria,0,6,,6,-74.77647900000001,10.886686
49755,2018,Marzo,Austria,0,1,,1,-81.372937,13.338761300000002
49756,2018,Marzo,Austria,6,15,,21,-76.532004,3.451668
49757,2018,Marzo,Austria,196,354,,550,-74.140516,4.697157
49758,2018,Marzo,Austria,27,37,,64,-75.42726,6.170465
49759,2018,Marzo,Austria,0,1,,1,-73.181317,7.1280470000000005
49760,2018,Marzo,Austria,1,0,,1,-72.453013,7.819
49761,2018,Marzo,Austria,0,1,,1,-77.35002,8.63337
49762,2018,Marzo,Azerbaiyán,4,4,,8,-74.140516,4.697157
49763,2018,Marzo,Azerbaiyán,1,2,,3,-75.42726,6.170465
49764,2018,Marzo,Bahamas,3,7,,10,-75.516486,10.446304
49765,2018,Marzo,Bahamas,0,1,,1,-74.77647900000001,10.886686
49766,2018,Marzo,Bahamas,0,3,,3,-76.532004,3.451668
49767,2018,Marzo,Bahamas,5,10,,15,-74.140516,4.697157
49768,2018,Marzo,Bahamas,1,3,,4,-75.42726,6.170465
49769,2018,Marzo,Bahréin,1,1,,2,-75.516486,10.446304
49770,2018,Marzo,Bahréin,0,3,,3,-74.140516,4.697157
49771,2018,Marzo,Bangladesh,0,1,,1,-75.516486,10.446304
49772,2018,Marzo,Bangladesh,4,2,,6,-74.140516,4.697157
49773,2018,Marzo,Bangladesh,0,1,,1,-75.42726,6.170465
49774,2018,Marzo,Bangladesh,0,1,,1,-75.68164200000001,9.402597
49775,2018,Marzo,Barbados,1,1,,2,-76.532004,3.451668
49776,2018,Marzo,Barbados,5,6,,11,-74.140516,4.697157
49777,2018,Marzo,Barbados,0,1,,1,-75.736374,4.815189
49778,2018,Marzo,Barbados,0,1,,1,-75.42726,6.170465
49779,2018,Marzo,República de Belarús,0,1,,1,-74.77647900000001,10.886686
49780,2018,Marzo,República de Belarús,2,3,,5,-74.140516,4.697157
49781,2018,Marzo,República de Belarús,1,3,,4,-75.42726,6.170465
49782,2018,Marzo,Bélgica,1,1,,2,-69.941498,4.191162
49783,2018,Marzo,Bélgica,2,2,,4,-69.94143100000001,4.214082
49784,2018,Marzo,Bélgica,1,1,,2,-76.876446,0.33002
49785,2018,Marzo,Bélgica,11,12,,23,-77.35600000000001,0.81488
49786,2018,Marzo,Bélgica,2,5,,7,-75.527794,10.406342
49787,2018,Marzo,Bélgica,41,56,,97,-75.516486,10.446304
49788,2018,Marzo,Bélgica,2,5,,7,-74.77647900000001,10.886686
49789,2018,Marzo,Bélgica,0,1,,1,-72.129595,11.360028999999999
49790,2018,Marzo,Bélgica,14,15,,29,-76.532004,3.451668
49791,2018,Marzo,Bélgica,307,486,,793,-74.140516,4.697157
49792,2018,Marzo,Bélgica,1,2,,3,-75.736374,4.815189
49793,2018,Marzo,Bélgica,26,58,,84,-75.42726,6.170465
49794,2018,Marzo,Bélgica,0,1,,1,-72.453013,7.819
49795,2018,Marzo,Belice,3,1,,4,-77.35600000000001,0.81488
49796,2018,Marzo,Belice,0,4,,4,-75.516486,10.446304
49797,2018,Marzo,Belice,1,0,,1,-76.532004,3.451668
49798,2018,Marzo,Belice,8,14,,22,-74.140516,4.697157
49799,2018,Marzo,Belice,4,7,,11,-75.42726,6.170465
49800,2018,Marzo,Benín,2,3,,5,-74.140516,4.697157
49801,2018,Marzo,Bermudas/Territorio Británico de Ultramar,2,1,,3,-75.516486,10.446304
49802,2018,Marzo,Bermudas/Territorio Británico de Ultramar,0,4,,4,-74.77647900000001,10.886686
49803,2018,Marzo,Bermudas/Territorio Británico de Ultramar,0,1,,1,-76.532004,3.451668
49804,2018,Marzo,Bermudas/Territorio Británico de Ultramar,1,2,,3,-75.42726,6.170465
49805,2018,Marzo,Bolivia,13,8,,21,-77.35600000000001,0.81488
49806,2018,Marzo,Bolivia,1,0,,1,-78.802679,18.00143
49807,2018,Marzo,Bolivia,4,2,,6,-75.527794,10.406342
49808,2018,Marzo,Bolivia,132,103,,235,-75.516486,10.446304
49809,2018,Marzo,Bolivia,3,9,,12,-74.77647900000001,10.886686
49810,2018,Marzo,Bolivia,1,1,,2,-72.129595,11.360028999999999
49811,2018,Marzo,Bolivia,10,7,,17,-81.70216500000001,12.5862
49812,2018,Marzo,Bolivia,10,11,,21,-76.532004,3.451668
49813,2018,Marzo,Bolivia,0,1,,1,-75.76635300000001,4.45285
49814,2018,Marzo,Bolivia,490,592,,1082,-74.140516,4.697157
49815,2018,Marzo,Bolivia,3,4,,7,-75.736374,4.815189
49816,2018,Marzo,Bolivia,42,37,,79,-75.42726,6.170465
49817,2018,Marzo,Bolivia,2,10,,12,-72.453013,7.819
49818,2018,Marzo,Bosnia y Herzegovina,1,0,,1,-75.527794,10.406342
49819,2018,Marzo,Bosnia y Herzegovina,0,1,,1,-75.516486,10.446304
49820,2018,Marzo,Bosnia y Herzegovina,2,5,,7,-74.140516,4.697157
49821,2018,Marzo,Bosnia y Herzegovina,2,0,,2,-75.42726,6.170465
49822,2018,Marzo,Botsuana,1,0,,1,-75.42726,6.170465
49823,2018,Marzo,Brasil,59,69,,128,-69.941498,4.191162
49824,2018,Marzo,Brasil,6,7,,13,-69.94143100000001,4.214082
49825,2018,Marzo,Brasil,19,29,,48,-77.35600000000001,0.81488
49826,2018,Marzo,Brasil,875,558,,1433,-75.527794,10.406342
49827,2018,Marzo,Brasil,1200,845,,2045,-75.516486,10.446304
49828,2018,Marzo,Brasil,16,27,,43,-74.77647900000001,10.886686
49829,2018,Marzo,Brasil,2,3,,5,-72.129595,11.360028999999999
49830,2018,Marzo,Brasil,447,321,,768,-81.70216500000001,12.5862
49831,2018,Marzo,Brasil,36,85,,121,-76.532004,3.451668
49832,2018,Marzo,Brasil,0,4,,4,-67.927521,3.866713
49833,2018,Marzo,Brasil,6415,6817,,13232,-74.140516,4.697157
49834,2018,Marzo,Brasil,3,8,,11,-75.736374,4.815189
49835,2018,Marzo,Brasil,112,193,,305,-75.42726,6.170465
49836,2018,Marzo,Brasil,0,3,,3,-73.181317,7.1280470000000005
49837,2018,Marzo,Brasil,6,10,,16,-72.453013,7.819
49838,2018,Marzo,Brasil,0,2,,2,-77.35002,8.63337
49839,2018,Marzo,Brasil,0,1,,1,-75.68164200000001,9.402597
49840,2018,Marzo,Bulgaria,1,1,,2,-77.35600000000001,0.81488
49841,2018,Marzo,Bulgaria,0,1,,1,-75.527794,10.406342
49842,2018,Marzo,Bulgaria,4,1,,5,-75.516486,10.446304
49843,2018,Marzo,Bulgaria,0,1,,1,-74.765343,10.970933
49844,2018,Marzo,Bulgaria,0,3,,3,-81.70216500000001,12.5862
49845,2018,Marzo,Bulgaria,3,1,,4,-76.532004,3.451668
49846,2018,Marzo,Bulgaria,32,47,,79,-74.140516,4.697157
49847,2018,Marzo,Bulgaria,0,1,,1,-75.736374,4.815189
49848,2018,Marzo,Bulgaria,5,10,,15,-75.42726,6.170465
49849,2018,Marzo,Burkina Faso,1,2,,3,-74.140516,4.697157
49850,2018,Marzo,Burkina Faso,1,0,,1,-75.42726,6.170465
49851,2018,Marzo,Burundi,1,0,,1,-74.140516,4.697157
49852,2018,Marzo,Bután,0,1,,1,-74.140516,4.697157
49853,2018,Marzo,Bután,0,1,,1,-75.42726,6.170465
49854,2018,Marzo,Cabo Verde,0,1,,1,-76.532004,3.451668
49855,2018,Marzo,Islas Caimán/Territorio Británico de Ultramar,1,1,,2,-81.70216500000001,12.5862
49856,2018,Marzo,Islas Caimán/Territorio Británico de Ultramar,1,2,,3,-76.532004,3.451668
49857,2018,Marzo,Camboya,2,0,,2,-74.140516,4.697157
49858,2018,Marzo,Camerún,3,6,,9,-74.140516,4.697157
49859,2018,Marzo,Camerún,1,0,,1,-75.42726,6.170465
49860,2018,Marzo,Canadá,0,3,,3,-69.941498,4.191162
49861,2018,Marzo,Canadá,1,0,,1,-69.94143100000001,4.214082
49862,2018,Marzo,Canadá,2,0,,2,-76.876446,0.33002
49863,2018,Marzo,Canadá,23,35,,58,-77.35600000000001,0.81488
49864,2018,Marzo,Canadá,27,23,,50,-75.527794,10.406342
49865,2018,Marzo,Canadá,971,1017,,1988,-75.516486,10.446304
49866,2018,Marzo,Canadá,40,59,,99,-74.77647900000001,10.886686
49867,2018,Marzo,Canadá,3,3,,6,-72.129595,11.360028999999999
49868,2018,Marzo,Canadá,0,2,,2,-81.703935,12.574411099999999
49869,2018,Marzo,Canadá,307,290,,597,-81.70216500000001,12.5862
49870,2018,Marzo,Canadá,1,4,,5,-81.372937,13.338761300000002
49871,2018,Marzo,Canadá,89,77,,166,-76.532004,3.451668
49872,2018,Marzo,Canadá,2,7,,9,-75.76635300000001,4.45285
49873,2018,Marzo,Canadá,1518,2228,,3746,-74.140516,4.697157
49874,2018,Marzo,Canadá,5,18,,23,-75.736374,4.815189
49875,2018,Marzo,Canadá,225,475,,700,-75.42726,6.170465
49876,2018,Marzo,Canadá,1,0,,1,-70.74025300000001,7.088728999999999
49877,2018,Marzo,Canadá,7,12,,19,-73.181317,7.1280470000000005
49878,2018,Marzo,Canadá,0,2,,2,-72.453013,7.819
49879,2018,Marzo,Canadá,20,8,,28,-77.35002,8.63337
49880,2018,Marzo,Chad,0,2,,2,-74.140516,4.697157
49881,2018,Marzo,Chad,0,1,,1,-75.42726,6.170465
49882,2018,Marzo,Comoras,0,1,,1,-75.42726,6.170465
49883,2018,Marzo,República Democrática del Congo,2,3,,5,-74.140516,4.697157
49884,2018,Marzo,República Democrática del Congo,0,1,,1,-75.42726,6.170465
49885,2018,Marzo,República Democrática del Congo,0,1,,1,-72.453013,7.819
49886,2018,Marzo,República de Corea,2,2,,4,-69.941498,4.191162
49887,2018,Marzo,República de Corea,0,1,,1,-74.78366,0.18595699999999998
49888,2018,Marzo,República de Corea,10,10,,20,-77.35600000000001,0.81488
49889,2018,Marzo,República de Corea,1,0,,1,-75.527794,10.406342
49890,2018,Marzo,República de Corea,16,22,,38,-75.516486,10.446304
49891,2018,Marzo,República de Corea,0,2,,2,-74.77647900000001,10.886686
49892,2018,Marzo,República de Corea,0,4,,4,-74.213989,11.247722999999999
49893,2018,Marzo,República de Corea,4,4,,8,-76.532004,3.451668
49894,2018,Marzo,República de Corea,245,434,,679,-74.140516,4.697157
49895,2018,Marzo,República de Corea,0,2,,2,-75.736374,4.815189
49896,2018,Marzo,República de Corea,22,43,,65,-75.42726,6.170465
49897,2018,Marzo,República de Corea,0,2,,2,-72.453013,7.819
49898,2018,Marzo,Costa de Marfil,0,2,,2,-75.516486,10.446304
49899,2018,Marzo,Costa de Marfil,3,1,,4,-74.140516,4.697157
49900,2018,Marzo,Costa de Marfil,0,1,,1,-75.42726,6.170465
49901,2018,Marzo,Costa Rica,0,1,,1,-69.941498,4.191162
49902,2018,Marzo,Costa Rica,5,4,,9,-77.35600000000001,0.81488
49903,2018,Marzo,Costa Rica,3,4,,7,-75.527794,10.406342
49904,2018,Marzo,Costa Rica,175,138,,313,-75.516486,10.446304
49905,2018,Marzo,Costa Rica,31,36,,67,-74.77647900000001,10.886686
49906,2018,Marzo,Costa Rica,2,0,,2,-72.129595,11.360028999999999
49907,2018,Marzo,Costa Rica,92,81,,173,-81.70216500000001,12.5862
49908,2018,Marzo,Costa Rica,47,68,,115,-76.532004,3.451668
49909,2018,Marzo,Costa Rica,1280,1483,,2763,-74.140516,4.697157
49910,2018,Marzo,Costa Rica,7,12,,19,-75.736374,4.815189
49911,2018,Marzo,Costa Rica,193,300,,493,-75.42726,6.170465
49912,2018,Marzo,Costa Rica,2,3,,5,-73.181317,7.1280470000000005
49913,2018,Marzo,Croacia,3,0,,3,-77.35600000000001,0.81488
49914,2018,Marzo,Croacia,0,5,,5,-75.527794,10.406342
49915,2018,Marzo,Croacia,2,5,,7,-75.516486,10.446304
49916,2018,Marzo,Croacia,0,1,,1,-74.77647900000001,10.886686
49917,2018,Marzo,Croacia,0,1,,1,-76.532004,3.451668
49918,2018,Marzo,Croacia,33,59,,92,-74.140516,4.697157
49919,2018,Marzo,Croacia,1,2,,3,-75.42726,6.170465
49920,2018,Marzo,Croacia,0,2,,2,-75.68164200000001,9.402597
49921,2018,Marzo,Cuba,0,2,,2,-77.35600000000001,0.81488
49922,2018,Marzo,Cuba,0,8,,8,-75.527794,10.406342
49923,2018,Marzo,Cuba,10,31,,41,-75.516486,10.446304
49924,2018,Marzo,Cuba,20,25,,45,-74.77647900000001,10.886686
49925,2018,Marzo,Cuba,18,30,,48,-76.532004,3.451668
49926,2018,Marzo,Cuba,618,569,,1187,-74.140516,4.697157
49927,2018,Marzo,Cuba,2,2,,4,-75.736374,4.815189
49928,2018,Marzo,Cuba,19,22,,41,-75.42726,6.170465
49929,2018,Marzo,Cuba,1,1,,2,-73.181317,7.1280470000000005
49930,2018,Marzo,Cuba,0,8,,8,-72.453013,7.819
49931,2018,Marzo,República Checa,0,1,,1,-69.941498,4.191162
49932,2018,Marzo,República Checa,0,1,,1,-69.94143100000001,4.214082
49933,2018,Marzo,República Checa,1,1,,2,-76.876446,0.33002
49934,2018,Marzo,República Checa,2,2,,4,-77.84700600000001,0.8124359999999999
49935,2018,Marzo,República Checa,14,9,,23,-77.35600000000001,0.81488
49936,2018,Marzo,República Checa,2,0,,2,-75.527794,10.406342
49937,2018,Marzo,República Checa,8,14,,22,-75.516486,10.446304
49938,2018,Marzo,República Checa,0,1,,1,-74.77647900000001,10.886686
49939,2018,Marzo,República Checa,6,2,,8,-76.532004,3.451668
49940,2018,Marzo,República Checa,73,113,,186,-74.140516,4.697157
49941,2018,Marzo,República Checa,2,10,,12,-75.42726,6.170465
49942,2018,Marzo,República Checa,0,1,,1,-72.453013,7.819
49943,2018,Marzo,Chile,3,2,,5,-69.941498,4.191162
49944,2018,Marzo,Chile,1,4,,5,-69.94143100000001,4.214082
49945,2018,Marzo,Chile,1,4,,5,-76.876446,0.33002
49946,2018,Marzo,Chile,62,84,,146,-77.35600000000001,0.81488
49947,2018,Marzo,Chile,1,1,,2,-78.802679,18.00143
49948,2018,Marzo,Chile,166,119,,285,-75.527794,10.406342
49949,2018,Marzo,Chile,504,409,,913,-75.516486,10.446304
49950,2018,Marzo,Chile,27,30,,57,-74.77647900000001,10.886686
49951,2018,Marzo,Chile,3,7,,10,-72.129595,11.360028999999999
49952,2018,Marzo,Chile,0,3,,3,-81.703935,12.574411099999999
49953,2018,Marzo,Chile,50,43,,93,-81.70216500000001,12.5862
49954,2018,Marzo,Chile,29,57,,86,-76.532004,3.451668
49955,2018,Marzo,Chile,4069,5090,,9159,-74.140516,4.697157
49956,2018,Marzo,Chile,1,4,,5,-75.736374,4.815189
49957,2018,Marzo,Chile,79,176,,255,-75.42726,6.170465
49958,2018,Marzo,Chile,0,2,,2,-73.181317,7.1280470000000005
49959,2018,Marzo,Chile,7,25,,32,-72.453013,7.819
49960,2018,Marzo,Chile,2,6,,8,-72.409396,8.36068
49961,2018,Marzo,China,1,0,,1,-69.941498,4.191162
49962,2018,Marzo,China,1,0,,1,-69.94143100000001,4.214082
49963,2018,Marzo,China,15,15,,30,-77.35600000000001,0.81488
49964,2018,Marzo,China,4,3,,7,-75.527794,10.406342
49965,2018,Marzo,China,41,56,,97,-75.516486,10.446304
49966,2018,Marzo,China,7,21,,28,-74.77647900000001,10.886686
49967,2018,Marzo,China,0,3,,3,-74.765343,10.970933
49968,2018,Marzo,China,0,5,,5,-74.213989,11.247722999999999
49969,2018,Marzo,China,2,3,,5,-81.70216500000001,12.5862
49970,2018,Marzo,China,10,17,,27,-76.532004,3.451668
49971,2018,Marzo,China,0,4,,4,-77.061029,3.8844260000000004
49972,2018,Marzo,China,1,0,,1,-75.76635300000001,4.45285
49973,2018,Marzo,China,442,965,,1407,-74.140516,4.697157
49974,2018,Marzo,China,1,0,,1,-75.736374,4.815189
49975,2018,Marzo,China,38,87,,125,-75.42726,6.170465
49976,2018,Marzo,China,4,7,,11,-72.453013,7.819
49977,2018,Marzo,China,0,2,,2,-72.409396,8.36068
49978,2018,Marzo,Taiwán,1,0,,1,-69.941498,4.191162
49979,2018,Marzo,Taiwán,0,2,,2,-77.35600000000001,0.81488
49980,2018,Marzo,Taiwán,0,1,,1,-75.527794,10.406342
49981,2018,Marzo,Taiwán,7,8,,15,-75.516486,10.446304
49982,2018,Marzo,Taiwán,0,2,,2,-74.77647900000001,10.886686
49983,2018,Marzo,Taiwán,4,3,,7,-76.532004,3.451668
49984,2018,Marzo,Taiwán,128,129,,257,-74.140516,4.697157
49985,2018,Marzo,Taiwán,9,15,,24,-75.42726,6.170465
49986,2018,Marzo,Taiwán,2,1,,3,-72.453013,7.819
49987,2018,Marzo,Chipre,1,0,,1,-75.516486,10.446304
49988,2018,Marzo,Chipre,8,11,,19,-74.140516,4.697157
49989,2018,Marzo,Chipre,1,1,,2,-75.42726,6.170465
49990,2018,Marzo,Dinamarca,1,0,,1,-69.94143100000001,4.214082
49991,2018,Marzo,Dinamarca,6,8,,14,-77.35600000000001,0.81488
49992,2018,Marzo,Dinamarca,4,5,,9,-75.527794,10.406342
49993,2018,Marzo,Dinamarca,27,52,,79,-75.516486,10.446304
49994,2018,Marzo,Dinamarca,2,4,,6,-74.77647900000001,10.886686
49995,2018,Marzo,Dinamarca,0,1,,1,-74.765343,10.970933
49996,2018,Marzo,Dinamarca,8,9,,17,-74.213989,11.247722999999999
49997,2018,Marzo,Dinamarca,0,1,,1,-72.129595,11.360028999999999
49998,2018,Marzo,Dinamarca,1,4,,5,-81.70216500000001,12.5862
49999,2018,Marzo,Dinamarca,3,10,,13,-76.532004,3.451668
50000,2018,Marzo,Dinamarca,181,299,,480,-74.140516,4.697157
50001,2018,Marzo,Dinamarca,8,20,,28,-75.42726,6.170465
50002,2018,Marzo,Dinamarca,1,0,,1,-72.453013,7.819
50003,2018,Marzo,Dinamarca,4,0,,4,-77.35002,8.63337
50004,2018,Marzo,Dominica,1,1,,2,-75.516486,10.446304
50005,2018,Marzo,Dominica,0,1,,1,-76.532004,3.451668
50006,2018,Marzo,Dominica,6,4,,10,-74.140516,4.697157
50007,2018,Marzo,Dominica,0,3,,3,-75.42726,6.170465
50008,2018,Marzo,Ecuador,1,0,,1,-69.941498,4.191162
50009,2018,Marzo,Ecuador,1,2,,3,-69.94143100000001,4.214082
50010,2018,Marzo,Ecuador,1,0,,1,-74.78366,0.18595699999999998
50011,2018,Marzo,Ecuador,76,282,,358,-76.876446,0.33002
50012,2018,Marzo,Ecuador,6,15,,21,-77.84700600000001,0.8124359999999999
50013,2018,Marzo,Ecuador,2368,2839,,5207,-77.35600000000001,0.81488
50014,2018,Marzo,Ecuador,32,37,,69,-78.802679,18.00143
50015,2018,Marzo,Ecuador,11,14,,25,-75.527794,10.406342
50016,2018,Marzo,Ecuador,49,51,,100,-75.516486,10.446304
50017,2018,Marzo,Ecuador,5,10,,15,-74.77647900000001,10.886686
50018,2018,Marzo,Ecuador,5,15,,20,-72.129595,11.360028999999999
50019,2018,Marzo,Ecuador,22,16,,38,-81.70216500000001,12.5862
50020,2018,Marzo,Ecuador,682,642,,1324,-76.532004,3.451668
50021,2018,Marzo,Ecuador,0,1,,1,-75.76635300000001,4.45285
50022,2018,Marzo,Ecuador,3322,4072,,7394,-74.140516,4.697157
50023,2018,Marzo,Ecuador,1,4,,5,-75.736374,4.815189
50024,2018,Marzo,Ecuador,73,190,,263,-75.42726,6.170465
50025,2018,Marzo,Ecuador,0,2,,2,-70.74025300000001,7.088728999999999
50026,2018,Marzo,Ecuador,0,2,,2,-73.181317,7.1280470000000005
50027,2018,Marzo,Ecuador,110,173,,283,-72.453013,7.819
50028,2018,Marzo,Ecuador,7,17,,24,-72.409396,8.36068
50029,2018,Marzo,Egipto,0,3,,3,-75.516486,10.446304
50030,2018,Marzo,Egipto,0,4,,4,-76.532004,3.451668
50031,2018,Marzo,Egipto,8,20,,28,-74.140516,4.697157
50032,2018,Marzo,Egipto,0,1,,1,-75.42726,6.170465
50033,2018,Marzo,El Salvador,0,1,,1,-77.35600000000001,0.81488
50034,2018,Marzo,El Salvador,0,2,,2,-75.527794,10.406342
50035,2018,Marzo,El Salvador,53,60,,113,-75.516486,10.446304
50036,2018,Marzo,El Salvador,10,23,,33,-74.77647900000001,10.886686
50037,2018,Marzo,El Salvador,2,2,,4,-81.70216500000001,12.5862
50038,2018,Marzo,El Salvador,115,121,,236,-76.532004,3.451668
50039,2018,Marzo,El Salvador,1,0,,1,-75.76635300000001,4.45285
50040,2018,Marzo,El Salvador,877,954,,1831,-74.140516,4.697157
50041,2018,Marzo,El Salvador,2,1,,3,-75.736374,4.815189
50042,2018,Marzo,El Salvador,175,207,,382,-75.42726,6.170465
50043,2018,Marzo,El Salvador,1,4,,5,-73.181317,7.1280470000000005
50044,2018,Marzo,El Salvador,0,3,,3,-72.453013,7.819
50045,2018,Marzo,Emiratos Árabes,0,1,,1,-69.94143100000001,4.214082
50046,2018,Marzo,Emiratos Árabes,1,0,,1,-75.516486,10.446304
50047,2018,Marzo,Emiratos Árabes,1,15,,16,-74.140516,4.697157
50048,2018,Marzo,Emiratos Árabes,0,1,,1,-75.42726,6.170465
50049,2018,Marzo,Emiratos Árabes,0,3,,3,-73.181317,7.1280470000000005
50050,2018,Marzo,España,4,3,,7,-69.941498,4.191162
50051,2018,Marzo,España,5,4,,9,-69.94143100000001,4.214082
50052,2018,Marzo,España,1,3,,4,-76.876446,0.33002
50053,2018,Marzo,España,0,1,,1,-77.84700600000001,0.8124359999999999
50054,2018,Marzo,España,32,60,,92,-77.35600000000001,0.81488
50055,2018,Marzo,España,10,23,,33,-75.527794,10.406342
50056,2018,Marzo,España,176,234,,410,-75.516486,10.446304
50057,2018,Marzo,España,21,60,,81,-74.77647900000001,10.886686
50058,2018,Marzo,España,5,6,,11,-74.213989,11.247722999999999
50059,2018,Marzo,España,4,4,,8,-72.129595,11.360028999999999
50060,2018,Marzo,España,2,4,,6,-81.703935,12.574411099999999
50061,2018,Marzo,España,5,4,,9,-81.70216500000001,12.5862
50062,2018,Marzo,España,1,1,,2,-81.372937,13.338761300000002
50063,2018,Marzo,España,400,506,,906,-76.532004,3.451668
50064,2018,Marzo,España,0,1,,1,-77.061029,3.8844260000000004
50065,2018,Marzo,España,0,2,,2,-75.76635300000001,4.45285
50066,2018,Marzo,España,3532,5992,,9524,-74.140516,4.697157
50067,2018,Marzo,España,3,7,,10,-75.736374,4.815189
50068,2018,Marzo,España,466,814,,1280,-75.42726,6.170465
50069,2018,Marzo,España,1,1,,2,-70.74025300000001,7.088728999999999
50070,2018,Marzo,España,2,5,,7,-73.181317,7.1280470000000005
50071,2018,Marzo,España,20,40,,60,-72.453013,7.819
50072,2018,Marzo,España,0,1,,1,-72.508188,7.927233
50073,2018,Marzo,España,4,3,,7,-72.409396,8.36068
50074,2018,Marzo,España,1,2,,3,-77.35002,8.63337
50075,2018,Marzo,Eritrea,1,1,,2,-74.140516,4.697157
50076,2018,Marzo,Eslovaquia,1,0,,1,-77.84700600000001,0.8124359999999999
50077,2018,Marzo,Eslovaquia,1,1,,2,-77.35600000000001,0.81488
50078,2018,Marzo,Eslovaquia,3,8,,11,-75.516486,10.446304
50079,2018,Marzo,Eslovaquia,1,1,,2,-74.77647900000001,10.886686
50080,2018,Marzo,Eslovaquia,3,1,,4,-74.213989,11.247722999999999
50081,2018,Marzo,Eslovaquia,32,57,,89,-74.140516,4.697157
50082,2018,Marzo,Eslovaquia,4,6,,10,-75.42726,6.170465
50083,2018,Marzo,Eslovaquia,1,0,,1,-73.181317,7.1280470000000005
50084,2018,Marzo,Eslovaquia,0,2,,2,-72.453013,7.819
50085,2018,Marzo,Eslovenia,0,3,,3,-75.516486,10.446304
50086,2018,Marzo,Eslovenia,0,1,,1,-74.77647900000001,10.886686
50087,2018,Marzo,Eslovenia,1,0,,1,-72.129595,11.360028999999999
50088,2018,Marzo,Eslovenia,50,73,,123,-74.140516,4.697157
50089,2018,Marzo,Eslovenia,2,1,,3,-75.42726,6.170465
50090,2018,Marzo,Estados Unidos de América,8,10,,18,-69.941498,4.191162
50091,2018,Marzo,Estados Unidos de América,6,8,,14,-69.94143100000001,4.214082
50092,2018,Marzo,Estados Unidos de América,1,7,,8,-76.876446,0.33002
50093,2018,Marzo,Estados Unidos de América,0,1,,1,-77.84700600000001,0.8124359999999999
50094,2018,Marzo,Estados Unidos de América,83,97,,180,-77.35600000000001,0.81488
50095,2018,Marzo,Estados Unidos de América,60,87,,147,-75.527794,10.406342
50096,2018,Marzo,Estados Unidos de América,6605,7629,,14234,-75.516486,10.446304
50097,2018,Marzo,Estados Unidos de América,828,1246,,2074,-74.77647900000001,10.886686
50098,2018,Marzo,Estados Unidos de América,5,4,,9,-74.232675,11.117206
50099,2018,Marzo,Estados Unidos de América,1,2,,3,-74.213989,11.247722999999999
50100,2018,Marzo,Estados Unidos de América,1,4,,5,-72.129595,11.360028999999999
50101,2018,Marzo,Estados Unidos de América,2,8,,10,-81.703935,12.574411099999999
50102,2018,Marzo,Estados Unidos de América,45,45,,90,-81.70216500000001,12.5862
50103,2018,Marzo,Estados Unidos de América,11,15,,26,-81.372937,13.338761300000002
50104,2018,Marzo,Estados Unidos de América,1368,1635,,3003,-76.532004,3.451668
50105,2018,Marzo,Estados Unidos de América,147,196,,343,-75.76635300000001,4.45285
50106,2018,Marzo,Estados Unidos de América,11231,16509,,27740,-74.140516,4.697157
50107,2018,Marzo,Estados Unidos de América,130,217,,347,-75.736374,4.815189
50108,2018,Marzo,Estados Unidos de América,3627,7083,,10710,-75.42726,6.170465
50109,2018,Marzo,Estados Unidos de América,0,4,,4,-75.586989,6.2188349999999994
50110,2018,Marzo,Estados Unidos de América,0,1,,1,-70.74025300000001,7.088728999999999
50111,2018,Marzo,Estados Unidos de América,1,0,,1,-77.762647,7.102626
50112,2018,Marzo,Estados Unidos de América,27,61,,88,-73.181317,7.1280470000000005
50113,2018,Marzo,Estados Unidos de América,18,16,,34,-72.453013,7.819
50114,2018,Marzo,Estados Unidos de América,2,3,,5,-72.409396,8.36068
50115,2018,Marzo,Estados Unidos de América,8,14,,22,-77.35002,8.63337
50116,2018,Marzo,Estonia,1,0,,1,-76.876446,0.33002
50117,2018,Marzo,Estonia,2,1,,3,-77.35600000000001,0.81488
50118,2018,Marzo,Estonia,5,3,,8,-75.516486,10.446304
50119,2018,Marzo,Estonia,2,1,,3,-74.77647900000001,10.886686
50120,2018,Marzo,Estonia,2,1,,3,-76.532004,3.451668
50121,2018,Marzo,Estonia,16,24,,40,-74.140516,4.697157
50122,2018,Marzo,Estonia,1,2,,3,-75.42726,6.170465
50123,2018,Marzo,Estonia,0,2,,2,-75.68164200000001,9.402597
50124,2018,Marzo,Etiopia,0,2,,2,-75.516486,10.446304
50125,2018,Marzo,Etiopia,3,3,,6,-74.140516,4.697157
50126,2018,Marzo,Etiopia,0,3,,3,-75.42726,6.170465
50127,2018,Marzo,Islas Fiji,0,1,,1,-75.527794,10.406342
50128,2018,Marzo,Islas Fiji,1,2,,3,-74.140516,4.697157
50129,2018,Marzo,Filipinas,1,1,,2,-77.35600000000001,0.81488
50130,2018,Marzo,Filipinas,1,38,,39,-75.527794,10.406342
50131,2018,Marzo,Filipinas,9,51,,60,-75.516486,10.446304
50132,2018,Marzo,Filipinas,0,18,,18,-74.77647900000001,10.886686
50133,2018,Marzo,Filipinas,0,27,,27,-74.765343,10.970933
50134,2018,Marzo,Filipinas,0,13,,13,-74.213989,11.247722999999999
50135,2018,Marzo,Filipinas,1,20,,21,-76.532004,3.451668
50136,2018,Marzo,Filipinas,0,25,,25,-77.061029,3.8844260000000004
50137,2018,Marzo,Filipinas,1,0,,1,-75.76635300000001,4.45285
50138,2018,Marzo,Filipinas,46,84,,130,-74.140516,4.697157
50139,2018,Marzo,Filipinas,5,6,,11,-75.42726,6.170465
50140,2018,Marzo,Filipinas,0,13,,13,-75.68164200000001,9.402597
50141,2018,Marzo,Finlandia,2,0,,2,-69.94143100000001,4.214082
50142,2018,Marzo,Finlandia,4,4,,8,-77.35600000000001,0.81488
50143,2018,Marzo,Finlandia,1,0,,1,-75.527794,10.406342
50144,2018,Marzo,Finlandia,9,6,,15,-75.516486,10.446304
50145,2018,Marzo,Finlandia,3,5,,8,-74.77647900000001,10.886686
50146,2018,Marzo,Finlandia,6,7,,13,-76.532004,3.451668
50147,2018,Marzo,Finlandia,52,72,,124,-74.140516,4.697157
50148,2018,Marzo,Finlandia,6,9,,15,-75.42726,6.170465
50149,2018,Marzo,Finlandia,1,1,,2,-77.35002,8.63337
50150,2018,Marzo,Francia,4,12,,16,-69.941498,4.191162
50151,2018,Marzo,Francia,12,15,,27,-69.94143100000001,4.214082
50152,2018,Marzo,Francia,9,16,,25,-76.876446,0.33002
50153,2018,Marzo,Francia,121,116,,237,-77.35600000000001,0.81488
50154,2018,Marzo,Francia,13,21,,34,-75.527794,10.406342
50155,2018,Marzo,Francia,192,256,,448,-75.516486,10.446304
50156,2018,Marzo,Francia,26,53,,79,-74.77647900000001,10.886686
50157,2018,Marzo,Francia,1,8,,9,-74.213989,11.247722999999999
50158,2018,Marzo,Francia,0,4,,4,-72.129595,11.360028999999999
50159,2018,Marzo,Francia,0,2,,2,-81.703935,12.574411099999999
50160,2018,Marzo,Francia,4,5,,9,-81.70216500000001,12.5862
50161,2018,Marzo,Francia,3,3,,6,-81.372937,13.338761300000002
50162,2018,Marzo,Francia,66,109,,175,-76.532004,3.451668
50163,2018,Marzo,Francia,1,3,,4,-77.061029,3.8844260000000004
50164,2018,Marzo,Francia,1,2,,3,-75.76635300000001,4.45285
50165,2018,Marzo,Francia,2586,3445,,6031,-74.140516,4.697157
50166,2018,Marzo,Francia,4,9,,13,-75.736374,4.815189
50167,2018,Marzo,Francia,156,319,,475,-75.42726,6.170465
50168,2018,Marzo,Francia,0,2,,2,-67.48402800000001,6.185536
50169,2018,Marzo,Francia,1,3,,4,-73.181317,7.1280470000000005
50170,2018,Marzo,Francia,1,11,,12,-72.453013,7.819
50171,2018,Marzo,Francia,1,1,,2,-72.409396,8.36068
50172,2018,Marzo,Francia,4,7,,11,-77.35002,8.63337
50173,2018,Marzo,Georgia,1,2,,3,-75.516486,10.446304
50174,2018,Marzo,Georgia,4,0,,4,-74.140516,4.697157
50175,2018,Marzo,Ghana,0,1,,1,-77.35600000000001,0.81488
50176,2018,Marzo,Ghana,0,1,,1,-75.516486,10.446304
50177,2018,Marzo,Ghana,9,9,,18,-74.140516,4.697157
50178,2018,Marzo,Ghana,2,4,,6,-75.42726,6.170465
50179,2018,Marzo,Granada,2,5,,7,-74.140516,4.697157
50180,2018,Marzo,Granada,1,2,,3,-75.42726,6.170465
50181,2018,Marzo,Grecia,1,0,,1,-76.876446,0.33002
50182,2018,Marzo,Grecia,1,1,,2,-77.35600000000001,0.81488
50183,2018,Marzo,Grecia,0,2,,2,-75.527794,10.406342
50184,2018,Marzo,Grecia,5,15,,20,-75.516486,10.446304
50185,2018,Marzo,Grecia,0,5,,5,-74.77647900000001,10.886686
50186,2018,Marzo,Grecia,1,3,,4,-76.532004,3.451668
50187,2018,Marzo,Grecia,0,2,,2,-77.061029,3.8844260000000004
50188,2018,Marzo,Grecia,44,96,,140,-74.140516,4.697157
50189,2018,Marzo,Grecia,0,10,,10,-75.42726,6.170465
50190,2018,Marzo,Grecia,0,1,,1,-72.453013,7.819
50191,2018,Marzo,Guatemala,1,1,,2,-76.876446,0.33002
50192,2018,Marzo,Guatemala,1,1,,2,-77.35600000000001,0.81488
50193,2018,Marzo,Guatemala,0,3,,3,-75.527794,10.406342
50194,2018,Marzo,Guatemala,171,199,,370,-75.516486,10.446304
50195,2018,Marzo,Guatemala,25,48,,73,-74.77647900000001,10.886686
50196,2018,Marzo,Guatemala,0,2,,2,-72.129595,11.360028999999999
50197,2018,Marzo,Guatemala,22,14,,36,-81.70216500000001,12.5862
50198,2018,Marzo,Guatemala,22,58,,80,-76.532004,3.451668
50199,2018,Marzo,Guatemala,460,732,,1192,-74.140516,4.697157
50200,2018,Marzo,Guatemala,1,5,,6,-75.736374,4.815189
50201,2018,Marzo,Guatemala,89,169,,258,-75.42726,6.170465
50202,2018,Marzo,Guatemala,6,6,,12,-73.181317,7.1280470000000005
50203,2018,Marzo,Guatemala,0,1,,1,-72.453013,7.819
50204,2018,Marzo,Guatemala,0,2,,2,-77.35002,8.63337
50205,2018,Marzo,Guyana,2,4,,6,-75.516486,10.446304
50206,2018,Marzo,Guyana,0,1,,1,-74.77647900000001,10.886686
50207,2018,Marzo,Guyana,0,1,,1,-76.532004,3.451668
50208,2018,Marzo,Guyana,9,13,,22,-74.140516,4.697157
50209,2018,Marzo,Guyana,0,1,,1,-72.453013,7.819
50210,2018,Marzo,Guinea,0,1,,1,-74.140516,4.697157
50211,2018,Marzo,Guinea Bissau,0,1,,1,-74.140516,4.697157
50212,2018,Marzo,Guinea Bissau,0,1,,1,-75.42726,6.170465
50213,2018,Marzo,Haití,0,1,,1,-77.35600000000001,0.81488
50214,2018,Marzo,Haití,5,12,,17,-75.516486,10.446304
50215,2018,Marzo,Haití,0,3,,3,-74.77647900000001,10.886686
50216,2018,Marzo,Haití,7,11,,18,-74.140516,4.697157
50217,2018,Marzo,Haití,2,2,,4,-75.42726,6.170465
50218,2018,Marzo,Haití,1,0,,1,-73.181317,7.1280470000000005
50219,2018,Marzo,Honduras,1,1,,2,-77.35600000000001,0.81488
50220,2018,Marzo,Honduras,0,6,,6,-75.527794,10.406342
50221,2018,Marzo,Honduras,59,75,,134,-75.516486,10.446304
50222,2018,Marzo,Honduras,11,17,,28,-74.77647900000001,10.886686
50223,2018,Marzo,Honduras,0,2,,2,-81.703935,12.574411099999999
50224,2018,Marzo,Honduras,0,3,,3,-81.70216500000001,12.5862
50225,2018,Marzo,Honduras,66,40,,106,-76.532004,3.451668
50226,2018,Marzo,Honduras,1,1,,2,-75.76635300000001,4.45285
50227,2018,Marzo,Honduras,299,303,,602,-74.140516,4.697157
50228,2018,Marzo,Honduras,5,5,,10,-75.736374,4.815189
50229,2018,Marzo,Honduras,76,69,,145,-75.42726,6.170465
50230,2018,Marzo,Honduras,1,1,,2,-73.181317,7.1280470000000005
50231,2018,Marzo,Honduras,0,1,,1,-77.35002,8.63337
50232,2018,Marzo,Hong Kong,1,0,,1,-75.516486,10.446304
50233,2018,Marzo,Hong Kong,13,11,,24,-74.140516,4.697157
50234,2018,Marzo,Hong Kong,1,0,,1,-75.42726,6.170465
50235,2018,Marzo,Hungría,0,1,,1,-69.94143100000001,4.214082
50236,2018,Marzo,Hungría,0,2,,2,-77.35600000000001,0.81488
50237,2018,Marzo,Hungría,2,1,,3,-75.527794,10.406342
50238,2018,Marzo,Hungría,16,15,,31,-75.516486,10.446304
50239,2018,Marzo,Hungría,1,0,,1,-74.77647900000001,10.886686
50240,2018,Marzo,Hungría,1,1,,2,-76.532004,3.451668
50241,2018,Marzo,Hungría,51,56,,107,-74.140516,4.697157
50242,2018,Marzo,Hungría,4,12,,16,-75.42726,6.170465
50243,2018,Marzo,Hungría,0,1,,1,-77.35002,8.63337
50244,2018,Marzo,India,0,2,,2,-77.35600000000001,0.81488
50245,2018,Marzo,India,0,13,,13,-75.527794,10.406342
50246,2018,Marzo,India,27,64,,91,-75.516486,10.446304
50247,2018,Marzo,India,2,11,,13,-74.77647900000001,10.886686
50248,2018,Marzo,India,0,3,,3,-74.765343,10.970933
50249,2018,Marzo,India,2,11,,13,-76.532004,3.451668
50250,2018,Marzo,India,0,2,,2,-77.061029,3.8844260000000004
50251,2018,Marzo,India,114,403,,517,-74.140516,4.697157
50252,2018,Marzo,India,0,3,,3,-75.736374,4.815189
50253,2018,Marzo,India,12,61,,73,-75.42726,6.170465
50254,2018,Marzo,India,0,2,,2,-73.181317,7.1280470000000005
50255,2018,Marzo,India,0,1,,1,-77.35002,8.63337
50256,2018,Marzo,India,0,4,,4,-75.68164200000001,9.402597
50257,2018,Marzo,Indonesia,0,1,,1,-77.35600000000001,0.81488
50258,2018,Marzo,Indonesia,1,4,,5,-75.527794,10.406342
50259,2018,Marzo,Indonesia,3,15,,18,-75.516486,10.446304
50260,2018,Marzo,Indonesia,16,34,,50,-74.140516,4.697157
50261,2018,Marzo,Indonesia,1,2,,3,-75.42726,6.170465
50262,2018,Marzo,Iraq,1,3,,4,-74.140516,4.697157
50263,2018,Marzo,Irán,1,0,,1,-77.35600000000001,0.81488
50264,2018,Marzo,Irán,3,2,,5,-75.516486,10.446304
50265,2018,Marzo,Irán,2,15,,17,-74.140516,4.697157
50266,2018,Marzo,Irán,2,1,,3,-75.42726,6.170465
50267,2018,Marzo,República de Irlanda,0,1,,1,-76.876446,0.33002
50268,2018,Marzo,República de Irlanda,8,10,,18,-77.35600000000001,0.81488
50269,2018,Marzo,República de Irlanda,8,5,,13,-75.527794,10.406342
50270,2018,Marzo,República de Irlanda,25,35,,60,-75.516486,10.446304
50271,2018,Marzo,República de Irlanda,0,4,,4,-74.77647900000001,10.886686
50272,2018,Marzo,República de Irlanda,0,1,,1,-72.129595,11.360028999999999
50273,2018,Marzo,República de Irlanda,0,11,,11,-76.532004,3.451668
50274,2018,Marzo,República de Irlanda,166,271,,437,-74.140516,4.697157
50275,2018,Marzo,República de Irlanda,13,48,,61,-75.42726,6.170465
50276,2018,Marzo,República de Irlanda,0,3,,3,-72.453013,7.819
50277,2018,Marzo,República de Irlanda,5,4,,9,-77.35002,8.63337
50278,2018,Marzo,Islandia,1,2,,3,-77.35600000000001,0.81488
50279,2018,Marzo,Islandia,1,1,,2,-75.516486,10.446304
50280,2018,Marzo,Islandia,2,0,,2,-76.532004,3.451668
50281,2018,Marzo,Islandia,10,13,,23,-74.140516,4.697157
50282,2018,Marzo,Islandia,1,0,,1,-75.736374,4.815189
50283,2018,Marzo,Islandia,1,2,,3,-75.42726,6.170465
50284,2018,Marzo,Israel,2,2,,4,-69.941498,4.191162
50285,2018,Marzo,Israel,5,11,,16,-69.94143100000001,4.214082
50286,2018,Marzo,Israel,0,3,,3,-76.876446,0.33002
50287,2018,Marzo,Israel,11,15,,26,-77.35600000000001,0.81488
50288,2018,Marzo,Israel,34,75,,109,-75.516486,10.446304
50289,2018,Marzo,Israel,5,8,,13,-74.77647900000001,10.886686
50290,2018,Marzo,Israel,1,2,,3,-74.213989,11.247722999999999
50291,2018,Marzo,Israel,4,0,,4,-81.70216500000001,12.5862
50292,2018,Marzo,Israel,5,12,,17,-76.532004,3.451668
50293,2018,Marzo,Israel,423,769,,1192,-74.140516,4.697157
50294,2018,Marzo,Israel,118,216,,334,-75.42726,6.170465
50295,2018,Marzo,Italia,0,2,,2,-69.941498,4.191162
50296,2018,Marzo,Italia,3,3,,6,-69.94143100000001,4.214082
50297,2018,Marzo,Italia,2,3,,5,-76.876446,0.33002
50298,2018,Marzo,Italia,22,28,,50,-77.35600000000001,0.81488
50299,2018,Marzo,Italia,15,30,,45,-75.527794,10.406342
50300,2018,Marzo,Italia,91,191,,282,-75.516486,10.446304
50301,2018,Marzo,Italia,12,29,,41,-74.77647900000001,10.886686
50302,2018,Marzo,Italia,0,8,,8,-72.129595,11.360028999999999
50303,2018,Marzo,Italia,0,2,,2,-81.703935,12.574411099999999
50304,2018,Marzo,Italia,7,10,,17,-81.70216500000001,12.5862
50305,2018,Marzo,Italia,0,2,,2,-81.372937,13.338761300000002
50306,2018,Marzo,Italia,31,85,,116,-76.532004,3.451668
50307,2018,Marzo,Italia,0,1,,1,-77.061029,3.8844260000000004
50308,2018,Marzo,Italia,0,1,,1,-75.76635300000001,4.45285
50309,2018,Marzo,Italia,749,1772,,2521,-74.140516,4.697157
50310,2018,Marzo,Italia,2,5,,7,-75.736374,4.815189
50311,2018,Marzo,Italia,86,249,,335,-75.42726,6.170465
50312,2018,Marzo,Italia,6,6,,12,-70.74025300000001,7.088728999999999
50313,2018,Marzo,Italia,1,5,,6,-73.181317,7.1280470000000005
50314,2018,Marzo,Italia,11,20,,31,-72.453013,7.819
50315,2018,Marzo,Italia,0,4,,4,-72.409396,8.36068
50316,2018,Marzo,Italia,4,4,,8,-77.35002,8.63337
50317,2018,Marzo,Jamaica,0,1,,1,-77.35600000000001,0.81488
50318,2018,Marzo,Jamaica,3,2,,5,-75.516486,10.446304
50319,2018,Marzo,Jamaica,3,2,,5,-74.77647900000001,10.886686
50320,2018,Marzo,Jamaica,3,3,,6,-76.532004,3.451668
50321,2018,Marzo,Jamaica,32,34,,66,-74.140516,4.697157
50322,2018,Marzo,Jamaica,0,2,,2,-75.736374,4.815189
50323,2018,Marzo,Jamaica,7,7,,14,-75.42726,6.170465
50324,2018,Marzo,Japón,0,1,,1,-69.941498,4.191162
50325,2018,Marzo,Japón,2,2,,4,-69.94143100000001,4.214082
50326,2018,Marzo,Japón,6,9,,15,-77.35600000000001,0.81488
50327,2018,Marzo,Japón,0,2,,2,-75.527794,10.406342
50328,2018,Marzo,Japón,15,11,,26,-75.516486,10.446304
50329,2018,Marzo,Japón,1,5,,6,-74.77647900000001,10.886686
50330,2018,Marzo,Japón,9,11,,20,-76.532004,3.451668
50331,2018,Marzo,Japón,230,521,,751,-74.140516,4.697157
50332,2018,Marzo,Japón,35,72,,107,-75.42726,6.170465
50333,2018,Marzo,Japón,0,1,,1,-72.453013,7.819
50334,2018,Marzo,Japón,0,1,,1,-77.35002,8.63337
50335,2018,Marzo,Jordania,3,7,,10,-74.140516,4.697157
50336,2018,Marzo,Jordania,1,0,,1,-75.42726,6.170465
50337,2018,Marzo,Kazajistán,2,0,,2,-75.516486,10.446304
50338,2018,Marzo,Kazajistán,3,0,,3,-74.140516,4.697157
50339,2018,Marzo,Kazajistán,3,1,,4,-75.42726,6.170465
50340,2018,Marzo,Kenia,8,15,,23,-74.140516,4.697157
50341,2018,Marzo,Kenia,1,0,,1,-75.736374,4.815189
50342,2018,Marzo,Kenia,4,3,,7,-75.42726,6.170465
50343,2018,Marzo,Kirguistán,0,2,,2,-75.42726,6.170465
50344,2018,Marzo,Kuwait,1,0,,1,-75.516486,10.446304
50345,2018,Marzo,Kuwait,2,5,,7,-74.140516,4.697157
50346,2018,Marzo,Kuwait,0,1,,1,-75.42726,6.170465
50347,2018,Marzo,Kuwait,0,1,,1,-73.181317,7.1280470000000005
50348,2018,Marzo,República de Kosovo,2,2,,4,-74.140516,4.697157
50349,2018,Marzo,Lesoto,1,0,,1,-74.140516,4.697157
50350,2018,Marzo,Letonia,0,5,,5,-75.527794,10.406342
50351,2018,Marzo,Letonia,2,4,,6,-75.516486,10.446304
50352,2018,Marzo,Letonia,0,1,,1,-74.77647900000001,10.886686
50353,2018,Marzo,Letonia,0,4,,4,-74.213989,11.247722999999999
50354,2018,Marzo,Letonia,0,1,,1,-76.532004,3.451668
50355,2018,Marzo,Letonia,15,24,,39,-74.140516,4.697157
50356,2018,Marzo,Letonia,2,0,,2,-75.42726,6.170465
50357,2018,Marzo,Lituania,0,1,,1,-69.941498,4.191162
50358,2018,Marzo,Lituania,1,1,,2,-76.876446,0.33002
50359,2018,Marzo,Lituania,0,1,,1,-77.35600000000001,0.81488
50360,2018,Marzo,Lituania,0,1,,1,-75.527794,10.406342
50361,2018,Marzo,Lituania,8,3,,11,-75.516486,10.446304
50362,2018,Marzo,Lituania,0,2,,2,-74.77647900000001,10.886686
50363,2018,Marzo,Lituania,0,3,,3,-76.532004,3.451668
50364,2018,Marzo,Lituania,17,27,,44,-74.140516,4.697157
50365,2018,Marzo,Lituania,2,1,,3,-75.42726,6.170465
50366,2018,Marzo,Líbano,1,0,,1,-77.35600000000001,0.81488
50367,2018,Marzo,Líbano,1,1,,2,-75.516486,10.446304
50368,2018,Marzo,Líbano,2,0,,2,-74.77647900000001,10.886686
50369,2018,Marzo,Líbano,2,0,,2,-72.129595,11.360028999999999
50370,2018,Marzo,Líbano,0,1,,1,-81.70216500000001,12.5862
50371,2018,Marzo,Líbano,15,33,,48,-74.140516,4.697157
50372,2018,Marzo,Líbano,2,1,,3,-75.42726,6.170465
50373,2018,Marzo,Líbano,1,0,,1,-73.181317,7.1280470000000005
50374,2018,Marzo,Liberia,1,0,,1,-76.532004,3.451668
50375,2018,Marzo,Liechtenstein,5,5,,10,-74.140516,4.697157
50376,2018,Marzo,Luxemburgo,0,1,,1,-77.35600000000001,0.81488
50377,2018,Marzo,Luxemburgo,1,0,,1,-75.516486,10.446304
50378,2018,Marzo,Luxemburgo,13,28,,41,-74.140516,4.697157
50379,2018,Marzo,Luxemburgo,0,2,,2,-75.42726,6.170465
50380,2018,Marzo,Macedonia,0,2,,2,-75.516486,10.446304
50381,2018,Marzo,Macedonia,0,1,,1,-76.532004,3.451668
50382,2018,Marzo,Macedonia,1,0,,1,-74.140516,4.697157
50383,2018,Marzo,Madagascar,0,1,,1,-74.140516,4.697157
50384,2018,Marzo,Malasia,0,1,,1,-77.35600000000001,0.81488
50385,2018,Marzo,Malasia,2,4,,6,-75.516486,10.446304
50386,2018,Marzo,Malasia,26,27,,53,-74.140516,4.697157
50387,2018,Marzo,Malasia,3,1,,4,-75.42726,6.170465
50388,2018,Marzo,Malasia,0,1,,1,-75.68164200000001,9.402597
50389,2018,Marzo,Malawi,0,1,,1,-74.140516,4.697157
50390,2018,Marzo,Malawi,1,1,,2,-75.42726,6.170465
50391,2018,Marzo,Maldivas,1,0,,1,-74.140516,4.697157
50392,2018,Marzo,Malí,0,4,,4,-74.140516,4.697157
50393,2018,Marzo,Malta,0,1,,1,-75.516486,10.446304
50394,2018,Marzo,Malta,1,2,,3,-76.532004,3.451668
50395,2018,Marzo,Malta,4,11,,15,-74.140516,4.697157
50396,2018,Marzo,Malta,0,1,,1,-75.42726,6.170465
50397,2018,Marzo,Marruecos,0,1,,1,-77.35600000000001,0.81488
50398,2018,Marzo,Marruecos,1,0,,1,-76.532004,3.451668
50399,2018,Marzo,Marruecos,9,8,,17,-74.140516,4.697157
50400,2018,Marzo,Marruecos,2,5,,7,-75.42726,6.170465
50401,2018,Marzo,Mauricio,2,1,,3,-75.527794,10.406342
50402,2018,Marzo,Mauricio,2,0,,2,-75.516486,10.446304
50403,2018,Marzo,Mauricio,0,1,,1,-74.140516,4.697157
50404,2018,Marzo,Mauritania,0,1,,1,-74.140516,4.697157
50405,2018,Marzo,México,0,1,,1,-69.94143100000001,4.214082
50406,2018,Marzo,México,1,1,,2,-76.876446,0.33002
50407,2018,Marzo,México,2,3,,5,-77.84700600000001,0.8124359999999999
50408,2018,Marzo,México,21,43,,64,-77.35600000000001,0.81488
50409,2018,Marzo,México,31,40,,71,-75.527794,10.406342
50410,2018,Marzo,México,294,412,,706,-75.516486,10.446304
50411,2018,Marzo,México,50,87,,137,-74.77647900000001,10.886686
50412,2018,Marzo,México,2,4,,6,-72.129595,11.360028999999999
50413,2018,Marzo,México,0,2,,2,-81.70216500000001,12.5862
50414,2018,Marzo,México,90,155,,245,-76.532004,3.451668
50415,2018,Marzo,México,0,1,,1,-75.76635300000001,4.45285
50416,2018,Marzo,México,5040,8189,,13229,-74.140516,4.697157
50417,2018,Marzo,México,4,19,,23,-75.736374,4.815189
50418,2018,Marzo,México,767,1395,,2162,-75.42726,6.170465
50419,2018,Marzo,México,2,0,,2,-70.74025300000001,7.088728999999999
50420,2018,Marzo,México,5,12,,17,-73.181317,7.1280470000000005
50421,2018,Marzo,México,10,28,,38,-72.453013,7.819
50422,2018,Marzo,México,0,2,,2,-72.409396,8.36068
50423,2018,Marzo,México,1,4,,5,-77.35002,8.63337
50424,2018,Marzo,República de Moldavia,6,3,,9,-74.140516,4.697157
50425,2018,Marzo,Mónaco,0,4,,4,-75.516486,10.446304
50426,2018,Marzo,Mónaco,1,3,,4,-74.140516,4.697157
50427,2018,Marzo,Montenegro,0,1,,1,-75.527794,10.406342
50428,2018,Marzo,Montenegro,0,1,,1,-75.516486,10.446304
50429,2018,Marzo,Montenegro,2,5,,7,-74.140516,4.697157
50430,2018,Marzo,Mozambique,2,0,,2,-74.140516,4.697157
50431,2018,Marzo,Myanmar,0,11,,11,-75.527794,10.406342
50432,2018,Marzo,Myanmar,0,10,,10,-75.516486,10.446304
50433,2018,Marzo,Myanmar,1,2,,3,-74.140516,4.697157
50434,2018,Marzo,Namibia,1,0,,1,-74.140516,4.697157
50435,2018,Marzo,Nepal,0,1,,1,-75.527794,10.406342
50436,2018,Marzo,Nepal,0,1,,1,-74.77647900000001,10.886686
50437,2018,Marzo,Nepal,1,5,,6,-74.140516,4.697157
50438,2018,Marzo,Nepal,1,1,,2,-75.42726,6.170465
50439,2018,Marzo,Nicaragua,0,1,,1,-77.35600000000001,0.81488
50440,2018,Marzo,Nicaragua,1,0,,1,-75.527794,10.406342
50441,2018,Marzo,Nicaragua,72,45,,117,-75.516486,10.446304
50442,2018,Marzo,Nicaragua,11,10,,21,-74.77647900000001,10.886686
50443,2018,Marzo,Nicaragua,2,2,,4,-81.70216500000001,12.5862
50444,2018,Marzo,Nicaragua,11,11,,22,-76.532004,3.451668
50445,2018,Marzo,Nicaragua,109,106,,215,-74.140516,4.697157
50446,2018,Marzo,Nicaragua,2,4,,6,-75.736374,4.815189
50447,2018,Marzo,Nicaragua,25,24,,49,-75.42726,6.170465
50448,2018,Marzo,Nicaragua,2,1,,3,-73.181317,7.1280470000000005
50449,2018,Marzo,Nicaragua,1,0,,1,-72.453013,7.819
50450,2018,Marzo,Nigeria,1,2,,3,-77.35600000000001,0.81488
50451,2018,Marzo,Nigeria,1,0,,1,-75.516486,10.446304
50452,2018,Marzo,Nigeria,3,12,,15,-74.140516,4.697157
50453,2018,Marzo,Nigeria,0,2,,2,-75.42726,6.170465
50454,2018,Marzo,Noruega,1,2,,3,-69.941498,4.191162
50455,2018,Marzo,Noruega,0,1,,1,-76.876446,0.33002
50456,2018,Marzo,Noruega,2,1,,3,-77.35600000000001,0.81488
50457,2018,Marzo,Noruega,8,3,,11,-75.527794,10.406342
50458,2018,Marzo,Noruega,23,36,,59,-75.516486,10.446304
50459,2018,Marzo,Noruega,4,1,,5,-74.77647900000001,10.886686
50460,2018,Marzo,Noruega,0,1,,1,-74.213989,11.247722999999999
50461,2018,Marzo,Noruega,3,1,,4,-81.70216500000001,12.5862
50462,2018,Marzo,Noruega,6,7,,13,-76.532004,3.451668
50463,2018,Marzo,Noruega,158,172,,330,-74.140516,4.697157
50464,2018,Marzo,Noruega,17,20,,37,-75.42726,6.170465
50465,2018,Marzo,Noruega,2,1,,3,-77.35002,8.63337
50466,2018,Marzo,Nueva Zelanda,9,8,,17,-77.35600000000001,0.81488
50467,2018,Marzo,Nueva Zelanda,4,4,,8,-75.527794,10.406342
50468,2018,Marzo,Nueva Zelanda,8,14,,22,-75.516486,10.446304
50469,2018,Marzo,Nueva Zelanda,0,2,,2,-74.77647900000001,10.886686
50470,2018,Marzo,Nueva Zelanda,3,4,,7,-74.213989,11.247722999999999
50471,2018,Marzo,Nueva Zelanda,1,0,,1,-81.70216500000001,12.5862
50472,2018,Marzo,Nueva Zelanda,2,2,,4,-81.372937,13.338761300000002
50473,2018,Marzo,Nueva Zelanda,0,3,,3,-76.532004,3.451668
50474,2018,Marzo,Nueva Zelanda,67,116,,183,-74.140516,4.697157
50475,2018,Marzo,Nueva Zelanda,12,19,,31,-75.42726,6.170465
50476,2018,Marzo,Nueva Zelanda,0,5,,5,-77.35002,8.63337
50477,2018,Marzo,Omán,1,2,,3,-74.140516,4.697157
50478,2018,Marzo,Países Bajos,1,1,,2,-69.941498,4.191162
50479,2018,Marzo,Países Bajos,5,2,,7,-69.94143100000001,4.214082
50480,2018,Marzo,Países Bajos,0,1,,1,-76.876446,0.33002
50481,2018,Marzo,Países Bajos,26,27,,53,-77.35600000000001,0.81488
50482,2018,Marzo,Países Bajos,38,43,,81,-75.527794,10.406342
50483,2018,Marzo,Países Bajos,127,172,,299,-75.516486,10.446304
50484,2018,Marzo,Países Bajos,12,28,,40,-74.77647900000001,10.886686
50485,2018,Marzo,Países Bajos,0,3,,3,-74.765343,10.970933
50486,2018,Marzo,Países Bajos,0,2,,2,-74.232675,11.117206
50487,2018,Marzo,Países Bajos,1,3,,4,-74.213989,11.247722999999999
50488,2018,Marzo,Países Bajos,0,1,,1,-72.129595,11.360028999999999
50489,2018,Marzo,Países Bajos,0,1,,1,-81.70216500000001,12.5862
50490,2018,Marzo,Países Bajos,26,36,,62,-76.532004,3.451668
50491,2018,Marzo,Países Bajos,1677,2133,,3810,-74.140516,4.697157
50492,2018,Marzo,Países Bajos,1,6,,7,-75.736374,4.815189
50493,2018,Marzo,Países Bajos,179,218,,397,-75.42726,6.170465
50494,2018,Marzo,Países Bajos,7,15,,22,-73.181317,7.1280470000000005
50495,2018,Marzo,Países Bajos,1,12,,13,-72.453013,7.819
50496,2018,Marzo,Países Bajos,0,3,,3,-72.409396,8.36068
50497,2018,Marzo,Países Bajos,12,2,,14,-77.35002,8.63337
50498,2018,Marzo,Pakistán,2,1,,3,-75.516486,10.446304
50499,2018,Marzo,Pakistán,10,23,,33,-74.140516,4.697157
50500,2018,Marzo,Pakistán,0,1,,1,-75.42726,6.170465
50501,2018,Marzo,Panamá,1,1,,2,-77.35600000000001,0.81488
50502,2018,Marzo,Panamá,0,14,,14,-75.527794,10.406342
50503,2018,Marzo,Panamá,543,543,,1086,-75.516486,10.446304
50504,2018,Marzo,Panamá,71,92,,163,-74.77647900000001,10.886686
50505,2018,Marzo,Panamá,0,1,,1,-74.765343,10.970933
50506,2018,Marzo,Panamá,31,33,,64,-81.70216500000001,12.5862
50507,2018,Marzo,Panamá,184,196,,380,-76.532004,3.451668
50508,2018,Marzo,Panamá,9,22,,31,-75.76635300000001,4.45285
50509,2018,Marzo,Panamá,1510,1533,,3043,-74.140516,4.697157
50510,2018,Marzo,Panamá,28,42,,70,-75.736374,4.815189
50511,2018,Marzo,Panamá,1241,1130,,2371,-75.42726,6.170465
50512,2018,Marzo,Panamá,0,1,,1,-77.401154,6.222551999999999
50513,2018,Marzo,Panamá,2,2,,4,-77.762647,7.102626
50514,2018,Marzo,Panamá,17,26,,43,-73.181317,7.1280470000000005
50515,2018,Marzo,Panamá,2,1,,3,-72.453013,7.819
50516,2018,Marzo,Panamá,2,5,,7,-77.35002,8.63337
50517,2018,Marzo,Papúa Nueva Guinea,0,2,,2,-74.140516,4.697157
50518,2018,Marzo,Paraguay,0,3,,3,-77.35600000000001,0.81488
50519,2018,Marzo,Paraguay,2,4,,6,-75.527794,10.406342
50520,2018,Marzo,Paraguay,76,50,,126,-75.516486,10.446304
50521,2018,Marzo,Paraguay,0,13,,13,-74.77647900000001,10.886686
50522,2018,Marzo,Paraguay,66,49,,115,-81.70216500000001,12.5862
50523,2018,Marzo,Paraguay,13,14,,27,-76.532004,3.451668
50524,2018,Marzo,Paraguay,204,180,,384,-74.140516,4.697157
50525,2018,Marzo,Paraguay,0,1,,1,-75.736374,4.815189
50526,2018,Marzo,Paraguay,25,11,,36,-75.42726,6.170465
50527,2018,Marzo,Paraguay,2,1,,3,-73.181317,7.1280470000000005
50528,2018,Marzo,Paraguay,0,1,,1,-72.453013,7.819
50529,2018,Marzo,Perú,14,17,,31,-69.941498,4.191162
50530,2018,Marzo,Perú,30,62,,92,-69.94143100000001,4.214082
50531,2018,Marzo,Perú,1,2,,3,-74.78366,0.18595699999999998
50532,2018,Marzo,Perú,7,14,,21,-76.876446,0.33002
50533,2018,Marzo,Perú,135,358,,493,-77.35600000000001,0.81488
50534,2018,Marzo,Perú,49,29,,78,-75.527794,10.406342
50535,2018,Marzo,Perú,643,474,,1117,-75.516486,10.446304
50536,2018,Marzo,Perú,20,20,,40,-74.77647900000001,10.886686
50537,2018,Marzo,Perú,0,2,,2,-74.765343,10.970933
50538,2018,Marzo,Perú,0,2,,2,-74.213989,11.247722999999999
50539,2018,Marzo,Perú,5,18,,23,-72.129595,11.360028999999999
50540,2018,Marzo,Perú,226,153,,379,-81.70216500000001,12.5862
50541,2018,Marzo,Perú,160,199,,359,-76.532004,3.451668
50542,2018,Marzo,Perú,0,6,,6,-77.061029,3.8844260000000004
50543,2018,Marzo,Perú,0,1,,1,-75.76635300000001,4.45285
50544,2018,Marzo,Perú,3977,4572,,8549,-74.140516,4.697157
50545,2018,Marzo,Perú,0,9,,9,-75.736374,4.815189
50546,2018,Marzo,Perú,426,639,,1065,-75.42726,6.170465
50547,2018,Marzo,Perú,0,1,,1,-67.48402800000001,6.185536
50548,2018,Marzo,Perú,6,13,,19,-70.74025300000001,7.088728999999999
50549,2018,Marzo,Perú,2,1,,3,-73.181317,7.1280470000000005
50550,2018,Marzo,Perú,118,244,,362,-72.453013,7.819
50551,2018,Marzo,Perú,2,8,,10,-72.409396,8.36068
50552,2018,Marzo,Palestina,1,4,,5,-74.140516,4.697157
50553,2018,Marzo,Polonia,0,1,,1,-69.941498,4.191162
50554,2018,Marzo,Polonia,2,0,,2,-69.94143100000001,4.214082
50555,2018,Marzo,Polonia,0,2,,2,-76.876446,0.33002
50556,2018,Marzo,Polonia,12,13,,25,-77.35600000000001,0.81488
50557,2018,Marzo,Polonia,1,14,,15,-75.527794,10.406342
50558,2018,Marzo,Polonia,21,39,,60,-75.516486,10.446304
50559,2018,Marzo,Polonia,3,4,,7,-74.77647900000001,10.886686
50560,2018,Marzo,Polonia,0,2,,2,-74.765343,10.970933
50561,2018,Marzo,Polonia,0,3,,3,-74.213989,11.247722999999999
50562,2018,Marzo,Polonia,9,7,,16,-76.532004,3.451668
50563,2018,Marzo,Polonia,0,3,,3,-77.061029,3.8844260000000004
50564,2018,Marzo,Polonia,179,251,,430,-74.140516,4.697157
50565,2018,Marzo,Polonia,2,0,,2,-75.736374,4.815189
50566,2018,Marzo,Polonia,14,17,,31,-75.42726,6.170465
50567,2018,Marzo,Polonia,0,1,,1,-72.453013,7.819
50568,2018,Marzo,Polonia,0,3,,3,-77.35002,8.63337
50569,2018,Marzo,Portugal,2,0,,2,-69.941498,4.191162
50570,2018,Marzo,Portugal,1,0,,1,-69.94143100000001,4.214082
50571,2018,Marzo,Portugal,4,5,,9,-77.35600000000001,0.81488
50572,2018,Marzo,Portugal,6,8,,14,-75.527794,10.406342
50573,2018,Marzo,Portugal,19,23,,42,-75.516486,10.446304
50574,2018,Marzo,Portugal,5,5,,10,-74.77647900000001,10.886686
50575,2018,Marzo,Portugal,4,2,,6,-72.129595,11.360028999999999
50576,2018,Marzo,Portugal,5,7,,12,-81.70216500000001,12.5862
50577,2018,Marzo,Portugal,47,35,,82,-76.532004,3.451668
50578,2018,Marzo,Portugal,273,510,,783,-74.140516,4.697157
50579,2018,Marzo,Portugal,21,46,,67,-75.42726,6.170465
50580,2018,Marzo,Portugal,8,13,,21,-72.453013,7.819
50581,2018,Marzo,Portugal,0,2,,2,-72.409396,8.36068
50582,2018,Marzo,Puerto Rico/Territorio de Estados Unidos,0,1,,1,-74.140516,4.697157
50583,2018,Marzo,Qatar,0,2,,2,-74.140516,4.697157
50584,2018,Marzo,Reino Unido de Gran Bretaña e Irlanda del Norte,8,5,,13,-69.941498,4.191162
50585,2018,Marzo,Reino Unido de Gran Bretaña e Irlanda del Norte,12,10,,22,-69.94143100000001,4.214082
50586,2018,Marzo,Reino Unido de Gran Bretaña e Irlanda del Norte,1,5,,6,-76.876446,0.33002
50587,2018,Marzo,Reino Unido de Gran Bretaña e Irlanda del Norte,0,1,,1,-77.84700600000001,0.8124359999999999
50588,2018,Marzo,Reino Unido de Gran Bretaña e Irlanda del Norte,39,69,,108,-77.35600000000001,0.81488
50589,2018,Marzo,Reino Unido de Gran Bretaña e Irlanda del Norte,32,31,,63,-75.527794,10.406342
50590,2018,Marzo,Reino Unido de Gran Bretaña e Irlanda del Norte,123,187,,310,-75.516486,10.446304
50591,2018,Marzo,Reino Unido de Gran Bretaña e Irlanda del Norte,5,37,,42,-74.77647900000001,10.886686
50592,2018,Marzo,Reino Unido de Gran Bretaña e Irlanda del Norte,0,1,,1,-74.232675,11.117206
50593,2018,Marzo,Reino Unido de Gran Bretaña e Irlanda del Norte,5,4,,9,-74.213989,11.247722999999999
50594,2018,Marzo,Reino Unido de Gran Bretaña e Irlanda del Norte,1,2,,3,-72.129595,11.360028999999999
50595,2018,Marzo,Reino Unido de Gran Bretaña e Irlanda del Norte,1,3,,4,-81.70216500000001,12.5862
50596,2018,Marzo,Reino Unido de Gran Bretaña e Irlanda del Norte,0,2,,2,-81.372937,13.338761300000002
50597,2018,Marzo,Reino Unido de Gran Bretaña e Irlanda del Norte,31,51,,82,-76.532004,3.451668
50598,2018,Marzo,Reino Unido de Gran Bretaña e Irlanda del Norte,1,1,,2,-75.76635300000001,4.45285
50599,2018,Marzo,Reino Unido de Gran Bretaña e Irlanda del Norte,1462,2481,,3943,-74.140516,4.697157
50600,2018,Marzo,Reino Unido de Gran Bretaña e Irlanda del Norte,1,2,,3,-75.736374,4.815189
50601,2018,Marzo,Reino Unido de Gran Bretaña e Irlanda del Norte,105,272,,377,-75.42726,6.170465
50602,2018,Marzo,Reino Unido de Gran Bretaña e Irlanda del Norte,1,0,,1,-67.48402800000001,6.185536
50603,2018,Marzo,Reino Unido de Gran Bretaña e Irlanda del Norte,0,2,,2,-73.181317,7.1280470000000005
50604,2018,Marzo,Reino Unido de Gran Bretaña e Irlanda del Norte,2,2,,4,-72.453013,7.819
50605,2018,Marzo,Reino Unido de Gran Bretaña e Irlanda del Norte,0,1,,1,-72.409396,8.36068
50606,2018,Marzo,Reino Unido de Gran Bretaña e Irlanda del Norte,26,31,,57,-77.35002,8.63337
50607,2018,Marzo,República Dominicana,5,16,,21,-77.35600000000001,0.81488
50608,2018,Marzo,República Dominicana,55,73,,128,-75.516486,10.446304
50609,2018,Marzo,República Dominicana,20,24,,44,-74.77647900000001,10.886686
50610,2018,Marzo,República Dominicana,3,3,,6,-72.129595,11.360028999999999
50611,2018,Marzo,República Dominicana,35,29,,64,-76.532004,3.451668
50612,2018,Marzo,República Dominicana,1,0,,1,-75.76635300000001,4.45285
50613,2018,Marzo,República Dominicana,873,893,,1766,-74.140516,4.697157
50614,2018,Marzo,República Dominicana,4,5,,9,-75.736374,4.815189
50615,2018,Marzo,República Dominicana,99,98,,197,-75.42726,6.170465
50616,2018,Marzo,República Dominicana,1,0,,1,-70.74025300000001,7.088728999999999
50617,2018,Marzo,República Dominicana,2,3,,5,-73.181317,7.1280470000000005
50618,2018,Marzo,República Dominicana,3,4,,7,-72.453013,7.819
50619,2018,Marzo,Rumania,1,8,,9,-75.527794,10.406342
50620,2018,Marzo,Rumania,7,23,,30,-75.516486,10.446304
50621,2018,Marzo,Rumania,0,1,,1,-74.77647900000001,10.886686
50622,2018,Marzo,Rumania,6,3,,9,-76.532004,3.451668
50623,2018,Marzo,Rumania,71,86,,157,-74.140516,4.697157
50624,2018,Marzo,Rumania,1,0,,1,-75.736374,4.815189
50625,2018,Marzo,Rumania,13,10,,23,-75.42726,6.170465
50626,2018,Marzo,Rumania,0,1,,1,-72.453013,7.819
50627,2018,Marzo,Rumania,0,2,,2,-75.68164200000001,9.402597
50628,2018,Marzo,Federación de Rusia,1,1,,2,-69.941498,4.191162
50629,2018,Marzo,Federación de Rusia,1,1,,2,-69.94143100000001,4.214082
50630,2018,Marzo,Federación de Rusia,5,2,,7,-77.35600000000001,0.81488
50631,2018,Marzo,Federación de Rusia,4,9,,13,-75.527794,10.406342
50632,2018,Marzo,Federación de Rusia,32,18,,50,-75.516486,10.446304
50633,2018,Marzo,Federación de Rusia,1,0,,1,-74.77647900000001,10.886686
50634,2018,Marzo,Federación de Rusia,0,5,,5,-74.765343,10.970933
50635,2018,Marzo,Federación de Rusia,1,2,,3,-72.129595,11.360028999999999
50636,2018,Marzo,Federación de Rusia,2,0,,2,-81.70216500000001,12.5862
50637,2018,Marzo,Federación de Rusia,6,5,,11,-76.532004,3.451668
50638,2018,Marzo,Federación de Rusia,0,4,,4,-77.061029,3.8844260000000004
50639,2018,Marzo,Federación de Rusia,150,207,,357,-74.140516,4.697157
50640,2018,Marzo,Federación de Rusia,0,1,,1,-75.736374,4.815189
50641,2018,Marzo,Federación de Rusia,15,17,,32,-75.42726,6.170465
50642,2018,Marzo,Federación de Rusia,1,0,,1,-73.181317,7.1280470000000005
50643,2018,Marzo,Federación de Rusia,0,1,,1,-72.453013,7.819
50644,2018,Marzo,Federación de Rusia,1,0,,1,-72.409396,8.36068
50645,2018,Marzo,Federación de Rusia,0,1,,1,-75.68164200000001,9.402597
50646,2018,Marzo,Rwanda,0,1,,1,-76.532004,3.451668
50647,2018,Marzo,San Cristóbal y Nevis,0,2,,2,-75.516486,10.446304
50648,2018,Marzo,San Cristóbal y Nevis,0,1,,1,-76.532004,3.451668
50649,2018,Marzo,San Cristóbal y Nevis,2,3,,5,-74.140516,4.697157
50650,2018,Marzo,San Cristóbal y Nevis,0,1,,1,-75.42726,6.170465
50651,2018,Marzo,San Cristóbal y Nevis,1,0,,1,-72.453013,7.819
50652,2018,Marzo,San Marino,0,1,,1,-75.516486,10.446304
50653,2018,Marzo,San Marino,1,2,,3,-74.140516,4.697157
50654,2018,Marzo,San  Vicente y las Granadinas,1,0,,1,-75.516486,10.446304
50655,2018,Marzo,San  Vicente y las Granadinas,1,1,,2,-74.140516,4.697157
50656,2018,Marzo,Santa Lucia,1,6,,7,-74.77647900000001,10.886686
50657,2018,Marzo,Santa Lucia,1,0,,1,-81.372937,13.338761300000002
50658,2018,Marzo,Santa Lucia,0,2,,2,-76.532004,3.451668
50659,2018,Marzo,Santa Lucia,1,3,,4,-74.140516,4.697157
50660,2018,Marzo,Santa Lucia,0,1,,1,-75.42726,6.170465
50661,2018,Marzo,Santa Sede/Ciudad del Vaticano,1,0,,1,-74.140516,4.697157
50662,2018,Marzo,Senegal,2,7,,9,-74.140516,4.697157
50663,2018,Marzo,Serbia,0,1,,1,-77.35600000000001,0.81488
50664,2018,Marzo,Serbia,0,1,,1,-75.527794,10.406342
50665,2018,Marzo,Serbia,1,2,,3,-75.516486,10.446304
50666,2018,Marzo,Serbia,0,1,,1,-76.532004,3.451668
50667,2018,Marzo,Serbia,11,21,,32,-74.140516,4.697157
50668,2018,Marzo,Serbia,0,2,,2,-75.42726,6.170465
50669,2018,Marzo,Sierra Leona,0,1,,1,-74.140516,4.697157
50670,2018,Marzo,Singapur,1,0,,1,-75.527794,10.406342
50671,2018,Marzo,Singapur,4,5,,9,-75.516486,10.446304
50672,2018,Marzo,Singapur,27,26,,53,-74.140516,4.697157
50673,2018,Marzo,Singapur,4,11,,15,-75.42726,6.170465
50674,2018,Marzo,Singapur,0,1,,1,-75.68164200000001,9.402597
50675,2018,Marzo,República Árabe Siria,0,1,,1,-75.516486,10.446304
50676,2018,Marzo,República Árabe Siria,1,0,,1,-72.129595,11.360028999999999
50677,2018,Marzo,República Árabe Siria,0,1,,1,-76.532004,3.451668
50678,2018,Marzo,República Árabe Siria,0,3,,3,-74.140516,4.697157
50679,2018,Marzo,Sri Lanka,0,2,,2,-75.527794,10.406342
50680,2018,Marzo,Sri Lanka,0,1,,1,-75.516486,10.446304
50681,2018,Marzo,Sri Lanka,0,1,,1,-77.061029,3.8844260000000004
50682,2018,Marzo,Sri Lanka,1,2,,3,-74.140516,4.697157
50683,2018,Marzo,Sudáfrica,1,1,,2,-77.35600000000001,0.81488
50684,2018,Marzo,Sudáfrica,3,5,,8,-75.527794,10.406342
50685,2018,Marzo,Sudáfrica,5,4,,9,-75.516486,10.446304
50686,2018,Marzo,Sudáfrica,1,3,,4,-74.77647900000001,10.886686
50687,2018,Marzo,Sudáfrica,1,0,,1,-72.129595,11.360028999999999
50688,2018,Marzo,Sudáfrica,2,1,,3,-76.532004,3.451668
50689,2018,Marzo,Sudáfrica,41,59,,100,-74.140516,4.697157
50690,2018,Marzo,Sudáfrica,2,4,,6,-75.42726,6.170465
50691,2018,Marzo,Sudáfrica,0,1,,1,-73.181317,7.1280470000000005
50692,2018,Marzo,Sudáfrica,0,2,,2,-72.453013,7.819
50693,2018,Marzo,Sudán,1,1,,2,-74.140516,4.697157
50694,2018,Marzo,Sudán,1,0,,1,-75.42726,6.170465
50695,2018,Marzo,Suecia,6,0,,6,-69.941498,4.191162
50696,2018,Marzo,Suecia,2,2,,4,-69.94143100000001,4.214082
50697,2018,Marzo,Suecia,5,2,,7,-76.876446,0.33002
50698,2018,Marzo,Suecia,9,10,,19,-77.35600000000001,0.81488
50699,2018,Marzo,Suecia,18,15,,33,-75.527794,10.406342
50700,2018,Marzo,Suecia,66,65,,131,-75.516486,10.446304
50701,2018,Marzo,Suecia,4,6,,10,-74.77647900000001,10.886686
50702,2018,Marzo,Suecia,4,9,,13,-74.213989,11.247722999999999
50703,2018,Marzo,Suecia,0,4,,4,-81.70216500000001,12.5862
50704,2018,Marzo,Suecia,1,3,,4,-81.372937,13.338761300000002
50705,2018,Marzo,Suecia,18,10,,28,-76.532004,3.451668
50706,2018,Marzo,Suecia,0,1,,1,-75.76635300000001,4.45285
50707,2018,Marzo,Suecia,218,296,,514,-74.140516,4.697157
50708,2018,Marzo,Suecia,0,2,,2,-75.736374,4.815189
50709,2018,Marzo,Suecia,36,51,,87,-75.42726,6.170465
50710,2018,Marzo,Suecia,1,0,,1,-73.181317,7.1280470000000005
50711,2018,Marzo,Suecia,0,3,,3,-72.453013,7.819
50712,2018,Marzo,Suecia,3,0,,3,-77.35002,8.63337
50713,2018,Marzo,Suiza,4,1,,5,-69.941498,4.191162
50714,2018,Marzo,Suiza,3,1,,4,-69.94143100000001,4.214082
50715,2018,Marzo,Suiza,3,1,,4,-76.876446,0.33002
50716,2018,Marzo,Suiza,31,38,,69,-77.35600000000001,0.81488
50717,2018,Marzo,Suiza,21,22,,43,-75.527794,10.406342
50718,2018,Marzo,Suiza,65,54,,119,-75.516486,10.446304
50719,2018,Marzo,Suiza,7,8,,15,-74.77647900000001,10.886686
50720,2018,Marzo,Suiza,1,2,,3,-74.213989,11.247722999999999
50721,2018,Marzo,Suiza,1,0,,1,-72.129595,11.360028999999999
50722,2018,Marzo,Suiza,1,1,,2,-81.703935,12.574411099999999
50723,2018,Marzo,Suiza,1,0,,1,-81.70216500000001,12.5862
50724,2018,Marzo,Suiza,22,27,,49,-76.532004,3.451668
50725,2018,Marzo,Suiza,0,2,,2,-77.061029,3.8844260000000004
50726,2018,Marzo,Suiza,544,770,,1314,-74.140516,4.697157
50727,2018,Marzo,Suiza,1,2,,3,-75.736374,4.815189
50728,2018,Marzo,Suiza,57,97,,154,-75.42726,6.170465
50729,2018,Marzo,Suiza,1,1,,2,-72.453013,7.819
50730,2018,Marzo,Suiza,0,1,,1,-72.409396,8.36068
50731,2018,Marzo,Suiza,7,5,,12,-77.35002,8.63337
50732,2018,Marzo,Surinam,16,25,,41,-74.140516,4.697157
50733,2018,Marzo,Surinam,0,1,,1,-75.42726,6.170465
50734,2018,Marzo,Surinam,1,1,,2,-73.181317,7.1280470000000005
50735,2018,Marzo,Suazilandia,2,0,,2,-74.140516,4.697157
50736,2018,Marzo,Taiwán,1,0,,1,-74.140516,4.697157
50737,2018,Marzo,Tailandia,1,0,,1,-77.35600000000001,0.81488
50738,2018,Marzo,Tailandia,3,1,,4,-75.516486,10.446304
50739,2018,Marzo,Tailandia,19,24,,43,-74.140516,4.697157
50740,2018,Marzo,Tailandia,2,3,,5,-75.42726,6.170465
50741,2018,Marzo,Tanzania,4,4,,8,-74.140516,4.697157
50742,2018,Marzo,Tanzania,1,0,,1,-75.42726,6.170465
50743,2018,Marzo,Togo,1,1,,2,-74.140516,4.697157
50744,2018,Marzo,Togo,0,1,,1,-75.42726,6.170465
50745,2018,Marzo,Trinidad y Tobago,2,1,,3,-77.35600000000001,0.81488
50746,2018,Marzo,Trinidad y Tobago,3,9,,12,-75.516486,10.446304
50747,2018,Marzo,Trinidad y Tobago,2,12,,14,-74.77647900000001,10.886686
50748,2018,Marzo,Trinidad y Tobago,0,1,,1,-72.129595,11.360028999999999
50749,2018,Marzo,Trinidad y Tobago,1,10,,11,-76.532004,3.451668
50750,2018,Marzo,Trinidad y Tobago,24,43,,67,-74.140516,4.697157
50751,2018,Marzo,Trinidad y Tobago,0,2,,2,-75.736374,4.815189
50752,2018,Marzo,Trinidad y Tobago,8,14,,22,-75.42726,6.170465
50753,2018,Marzo,Trinidad y Tobago,0,1,,1,-72.453013,7.819
50754,2018,Marzo,Túnez,0,1,,1,-77.35600000000001,0.81488
50755,2018,Marzo,Túnez,1,0,,1,-76.532004,3.451668
50756,2018,Marzo,Túnez,3,6,,9,-74.140516,4.697157
50757,2018,Marzo,Túnez,0,1,,1,-75.42726,6.170465
50758,2018,Marzo,Turquía,0,2,,2,-69.94143100000001,4.214082
50759,2018,Marzo,Turquía,4,6,,10,-77.35600000000001,0.81488
50760,2018,Marzo,Turquía,0,4,,4,-75.527794,10.406342
50761,2018,Marzo,Turquía,13,20,,33,-75.516486,10.446304
50762,2018,Marzo,Turquía,0,1,,1,-74.77647900000001,10.886686
50763,2018,Marzo,Turquía,0,7,,7,-74.213989,11.247722999999999
50764,2018,Marzo,Turquía,3,4,,7,-76.532004,3.451668
50765,2018,Marzo,Turquía,236,424,,660,-74.140516,4.697157
50766,2018,Marzo,Turquía,5,9,,14,-75.42726,6.170465
50767,2018,Marzo,Turquía,0,2,,2,-72.453013,7.819
50768,2018,Marzo,Turquía,0,5,,5,-75.68164200000001,9.402597
50769,2018,Marzo,Ucrania,1,0,,1,-77.35600000000001,0.81488
50770,2018,Marzo,Ucrania,0,8,,8,-75.527794,10.406342
50771,2018,Marzo,Ucrania,2,7,,9,-75.516486,10.446304
50772,2018,Marzo,Ucrania,0,7,,7,-74.77647900000001,10.886686
50773,2018,Marzo,Ucrania,0,6,,6,-74.765343,10.970933
50774,2018,Marzo,Ucrania,0,4,,4,-74.213989,11.247722999999999
50775,2018,Marzo,Ucrania,0,2,,2,-76.532004,3.451668
50776,2018,Marzo,Ucrania,32,20,,52,-74.140516,4.697157
50777,2018,Marzo,Ucrania,3,1,,4,-75.42726,6.170465
50778,2018,Marzo,Uganda,1,0,,1,-77.35600000000001,0.81488
50779,2018,Marzo,Uganda,0,2,,2,-74.140516,4.697157
50780,2018,Marzo,Uganda,1,0,,1,-75.42726,6.170465
50781,2018,Marzo,Uruguay,1,2,,3,-69.94143100000001,4.214082
50782,2018,Marzo,Uruguay,3,2,,5,-76.876446,0.33002
50783,2018,Marzo,Uruguay,0,1,,1,-77.84700600000001,0.8124359999999999
50784,2018,Marzo,Uruguay,5,11,,16,-77.35600000000001,0.81488
50785,2018,Marzo,Uruguay,19,15,,34,-75.527794,10.406342
50786,2018,Marzo,Uruguay,110,90,,200,-75.516486,10.446304
50787,2018,Marzo,Uruguay,2,6,,8,-74.77647900000001,10.886686
50788,2018,Marzo,Uruguay,18,21,,39,-81.70216500000001,12.5862
50789,2018,Marzo,Uruguay,0,1,,1,-81.372937,13.338761300000002
50790,2018,Marzo,Uruguay,14,23,,37,-76.532004,3.451668
50791,2018,Marzo,Uruguay,552,685,,1237,-74.140516,4.697157
50792,2018,Marzo,Uruguay,0,1,,1,-75.736374,4.815189
50793,2018,Marzo,Uruguay,40,74,,114,-75.42726,6.170465
50794,2018,Marzo,Uruguay,2,2,,4,-72.453013,7.819
50795,2018,Marzo,Uruguay,0,1,,1,-72.409396,8.36068
50796,2018,Marzo,Uzbekistán,0,7,,7,-74.140516,4.697157
50797,2018,Marzo,Vanuatu,1,0,,1,-75.527794,10.406342
50798,2018,Marzo,Venezuela,3,3,,6,-69.941498,4.191162
50799,2018,Marzo,Venezuela,1,1,,2,-69.94143100000001,4.214082
50800,2018,Marzo,Venezuela,20,32,,52,-76.876446,0.33002
50801,2018,Marzo,Venezuela,2,1,,3,-77.84700600000001,0.8124359999999999
50802,2018,Marzo,Venezuela,1552,2092,,3644,-77.35600000000001,0.81488
50803,2018,Marzo,Venezuela,1,2,,3,-78.802679,18.00143
50804,2018,Marzo,Venezuela,17,14,,31,-75.527794,10.406342
50805,2018,Marzo,Venezuela,172,191,,363,-75.516486,10.446304
50806,2018,Marzo,Venezuela,116,191,,307,-74.77647900000001,10.886686
50807,2018,Marzo,Venezuela,0,5,,5,-74.765343,10.970933
50808,2018,Marzo,Venezuela,9,21,,30,-74.232675,11.117206
50809,2018,Marzo,Venezuela,8988,10090,,19078,-72.129595,11.360028999999999
50810,2018,Marzo,Venezuela,0,1,,1,-72.919186,11.52863
50811,2018,Marzo,Venezuela,0,8,,8,-71.983761,12.165168
50812,2018,Marzo,Venezuela,3,1,,4,-81.70216500000001,12.5862
50813,2018,Marzo,Venezuela,0,1,,1,-81.372937,13.338761300000002
50814,2018,Marzo,Venezuela,101,109,,210,-76.532004,3.451668
50815,2018,Marzo,Venezuela,10,15,,25,-67.927521,3.866713
50816,2018,Marzo,Venezuela,3,1,,4,-75.76635300000001,4.45285
50817,2018,Marzo,Venezuela,5215,5546,,10761,-74.140516,4.697157
50818,2018,Marzo,Venezuela,9,9,,18,-75.736374,4.815189
50819,2018,Marzo,Venezuela,883,896,,1779,-75.42726,6.170465
50820,2018,Marzo,Venezuela,53,64,,117,-67.48402800000001,6.185536
50821,2018,Marzo,Venezuela,892,1080,,1972,-70.74025300000001,7.088728999999999
50822,2018,Marzo,Venezuela,6,17,,23,-73.181317,7.1280470000000005
50823,2018,Marzo,Venezuela,32599,41798,,74397,-72.453013,7.819
50824,2018,Marzo,Venezuela,0,6,,6,-72.508188,7.927233
50825,2018,Marzo,Venezuela,2618,2992,,5610,-72.409396,8.36068
50826,2018,Marzo,Vietnam,0,1,,1,-75.527794,10.406342
50827,2018,Marzo,Vietnam,5,2,,7,-75.516486,10.446304
50828,2018,Marzo,Vietnam,13,11,,24,-74.140516,4.697157
50829,2018,Marzo,República Árabe de Yemen,1,4,,5,-77.35600000000001,0.81488
50830,2018,Marzo,Zambia,3,0,,3,-74.140516,4.697157
50831,2018,Marzo,Zimbabue,0,3,,3,-74.140516,4.697157
50832,2018,Marzo,Zimbabue,1,1,,2,-75.42726,6.170465
50833,2018,Marzo,Refugiado,0,1,,1,-77.35600000000001,0.81488
50834,2018,Marzo,Refugiado,0,1,,1,-81.70216500000001,12.5862
50835,2018,Marzo,Refugiado,3,10,,13,-74.140516,4.697157
50836,2018,Marzo,Desconocido,1,0,,1,-76.876446,0.33002
50837,2018,Marzo,Desconocido,1,2,,3,-75.516486,10.446304
50838,2018,Marzo,Desconocido,0,1,,1,-76.532004,3.451668
50839,2018,Marzo,Desconocido,80,132,,212,-74.140516,4.697157
50840,2018,Marzo,Desconocido,10,10,,20,-75.42726,6.170465
50841,2018,Marzo,Desconocido,1,2,,3,-70.74025300000001,7.088728999999999
50842,2018,Marzo,Desconocido,1,2,,3,-72.453013,7.819
50843,2018,Abril,Afganistán,0,1,,1,-76.532004,3.451668
50844,2018,Abril,Albania,1,0,,1,-75.527794,10.406342
50845,2018,Abril,Albania,0,1,,1,-75.516486,10.446304
50846,2018,Abril,Albania,2,1,,3,-74.140516,4.697157
50847,2018,Abril,Albania,0,1,,1,-75.42726,6.170465
50848,2018,Abril,Alemania,11,9,,20,-69.941498,4.191162
50849,2018,Abril,Alemania,21,24,,45,-69.94143100000001,4.214082
50850,2018,Abril,Alemania,8,8,,16,-76.876446,0.33002
50851,2018,Abril,Alemania,77,85,,162,-77.35600000000001,0.81488
50852,2018,Abril,Alemania,39,51,,90,-75.527794,10.406342
50853,2018,Abril,Alemania,125,176,,301,-75.516486,10.446304
50854,2018,Abril,Alemania,17,15,,32,-74.77647900000001,10.886686
50855,2018,Abril,Alemania,1,2,,3,-72.129595,11.360028999999999
50856,2018,Abril,Alemania,1,0,,1,-81.703935,12.574411099999999
50857,2018,Abril,Alemania,5,1,,6,-81.70216500000001,12.5862
50858,2018,Abril,Alemania,1,0,,1,-81.372937,13.338761300000002
50859,2018,Abril,Alemania,49,76,,125,-76.532004,3.451668
50860,2018,Abril,Alemania,0,4,,4,-77.061029,3.8844260000000004
50861,2018,Abril,Alemania,0,2,,2,-75.76635300000001,4.45285
50862,2018,Abril,Alemania,1515,2391,,3906,-74.140516,4.697157
50863,2018,Abril,Alemania,2,8,,10,-75.736374,4.815189
50864,2018,Abril,Alemania,131,251,,382,-75.42726,6.170465
50865,2018,Abril,Alemania,1,2,,3,-67.48402800000001,6.185536
50866,2018,Abril,Alemania,1,0,,1,-77.762647,7.102626
50867,2018,Abril,Alemania,0,1,,1,-73.181317,7.1280470000000005
50868,2018,Abril,Alemania,2,6,,8,-72.453013,7.819
50869,2018,Abril,Alemania,0,3,,3,-72.409396,8.36068
50870,2018,Abril,Alemania,10,14,,24,-77.35002,8.63337
50871,2018,Abril,Andorra,1,0,,1,-77.35600000000001,0.81488
50872,2018,Abril,Andorra,1,7,,8,-74.140516,4.697157
50873,2018,Abril,Antigua y Barbuda,0,1,,1,-74.77647900000001,10.886686
50874,2018,Abril,Antigua y Barbuda,1,5,,6,-74.140516,4.697157
50875,2018,Abril,Arabia Saudita,1,4,,5,-74.140516,4.697157
50876,2018,Abril,Arabia Saudita,0,2,,2,-75.42726,6.170465
50877,2018,Abril,Argelia,0,1,,1,-75.516486,10.446304
50878,2018,Abril,Argelia,1,4,,5,-74.140516,4.697157
50879,2018,Abril,Argentina,9,19,,28,-69.941498,4.191162
50880,2018,Abril,Argentina,7,8,,15,-69.94143100000001,4.214082
50881,2018,Abril,Argentina,12,20,,32,-76.876446,0.33002
50882,2018,Abril,Argentina,1,1,,2,-77.84700600000001,0.8124359999999999
50883,2018,Abril,Argentina,81,152,,233,-77.35600000000001,0.81488
50884,2018,Abril,Argentina,0,1,,1,-78.802679,18.00143
50885,2018,Abril,Argentina,414,256,,670,-75.527794,10.406342
50886,2018,Abril,Argentina,0,1,,1,-73.247863,10.433608999999999
50887,2018,Abril,Argentina,2461,1683,,4144,-75.516486,10.446304
50888,2018,Abril,Argentina,20,115,,135,-74.77647900000001,10.886686
50889,2018,Abril,Argentina,7,8,,15,-72.129595,11.360028999999999
50890,2018,Abril,Argentina,432,322,,754,-81.70216500000001,12.5862
50891,2018,Abril,Argentina,1,2,,3,-81.372937,13.338761300000002
50892,2018,Abril,Argentina,39,59,,98,-76.532004,3.451668
50893,2018,Abril,Argentina,6889,7982,,14871,-74.140516,4.697157
50894,2018,Abril,Argentina,7,19,,26,-75.736374,4.815189
50895,2018,Abril,Argentina,251,378,,629,-75.42726,6.170465
50896,2018,Abril,Argentina,2,3,,5,-73.181317,7.1280470000000005
50897,2018,Abril,Argentina,13,15,,28,-72.453013,7.819
50898,2018,Abril,Argentina,3,2,,5,-72.409396,8.36068
50899,2018,Abril,Argentina,4,1,,5,-77.35002,8.63337
50900,2018,Abril,República de Armenia,3,3,,6,-74.140516,4.697157
50901,2018,Abril,Aruba,2,0,,2,-74.140516,4.697157
50902,2018,Abril,Australia,3,2,,5,-69.941498,4.191162
50903,2018,Abril,Australia,3,2,,5,-69.94143100000001,4.214082
50904,2018,Abril,Australia,3,2,,5,-76.876446,0.33002
50905,2018,Abril,Australia,19,15,,34,-77.35600000000001,0.81488
50906,2018,Abril,Australia,8,21,,29,-75.527794,10.406342
50907,2018,Abril,Australia,59,67,,126,-75.516486,10.446304
50908,2018,Abril,Australia,7,22,,29,-74.77647900000001,10.886686
50909,2018,Abril,Australia,1,1,,2,-74.213989,11.247722999999999
50910,2018,Abril,Australia,0,1,,1,-81.703935,12.574411099999999
50911,2018,Abril,Australia,0,1,,1,-81.70216500000001,12.5862
50912,2018,Abril,Australia,9,13,,22,-76.532004,3.451668
50913,2018,Abril,Australia,300,465,,765,-74.140516,4.697157
50914,2018,Abril,Australia,0,1,,1,-75.736374,4.815189
50915,2018,Abril,Australia,50,96,,146,-75.42726,6.170465
50916,2018,Abril,Australia,0,1,,1,-73.181317,7.1280470000000005
50917,2018,Abril,Australia,0,1,,1,-72.453013,7.819
50918,2018,Abril,Australia,5,10,,15,-77.35002,8.63337
50919,2018,Abril,Austria,2,0,,2,-69.94143100000001,4.214082
50920,2018,Abril,Austria,2,3,,5,-76.876446,0.33002
50921,2018,Abril,Austria,11,12,,23,-77.35600000000001,0.81488
50922,2018,Abril,Austria,3,3,,6,-75.527794,10.406342
50923,2018,Abril,Austria,12,17,,29,-75.516486,10.446304
50924,2018,Abril,Austria,1,6,,7,-74.77647900000001,10.886686
50925,2018,Abril,Austria,2,6,,8,-76.532004,3.451668
50926,2018,Abril,Austria,147,222,,369,-74.140516,4.697157
50927,2018,Abril,Austria,13,26,,39,-75.42726,6.170465
50928,2018,Abril,Austria,0,1,,1,-77.35002,8.63337
50929,2018,Abril,Azerbaiyán,1,2,,3,-74.140516,4.697157
50930,2018,Abril,Azerbaiyán,1,0,,1,-75.42726,6.170465
50931,2018,Abril,Bahamas,5,7,,12,-75.516486,10.446304
50932,2018,Abril,Bahamas,0,1,,1,-74.77647900000001,10.886686
50933,2018,Abril,Bahamas,5,1,,6,-76.532004,3.451668
50934,2018,Abril,Bahamas,3,8,,11,-74.140516,4.697157
50935,2018,Abril,Bahamas,4,1,,5,-75.42726,6.170465
50936,2018,Abril,Bahréin,0,1,,1,-74.140516,4.697157
50937,2018,Abril,Bangladesh,0,1,,1,-74.765343,10.970933
50938,2018,Abril,Bangladesh,0,3,,3,-74.140516,4.697157
50939,2018,Abril,Bangladesh,0,1,,1,-75.42726,6.170465
50940,2018,Abril,Barbados,3,3,,6,-75.516486,10.446304
50941,2018,Abril,Barbados,2,2,,4,-74.77647900000001,10.886686
50942,2018,Abril,Barbados,0,2,,2,-76.532004,3.451668
50943,2018,Abril,Barbados,9,12,,21,-74.140516,4.697157
50944,2018,Abril,República de Belarús,0,1,,1,-75.527794,10.406342
50945,2018,Abril,República de Belarús,1,0,,1,-75.516486,10.446304
50946,2018,Abril,República de Belarús,2,6,,8,-74.140516,4.697157
50947,2018,Abril,Bélgica,3,2,,5,-69.94143100000001,4.214082
50948,2018,Abril,Bélgica,0,1,,1,-76.876446,0.33002
50949,2018,Abril,Bélgica,10,13,,23,-77.35600000000001,0.81488
50950,2018,Abril,Bélgica,3,3,,6,-75.527794,10.406342
50951,2018,Abril,Bélgica,34,51,,85,-75.516486,10.446304
50952,2018,Abril,Bélgica,0,6,,6,-74.77647900000001,10.886686
50953,2018,Abril,Bélgica,0,4,,4,-74.765343,10.970933
50954,2018,Abril,Bélgica,0,1,,1,-72.129595,11.360028999999999
50955,2018,Abril,Bélgica,1,3,,4,-81.372937,13.338761300000002
50956,2018,Abril,Bélgica,8,17,,25,-76.532004,3.451668
50957,2018,Abril,Bélgica,182,404,,586,-74.140516,4.697157
50958,2018,Abril,Bélgica,21,38,,59,-75.42726,6.170465
50959,2018,Abril,Belice,0,1,,1,-75.516486,10.446304
50960,2018,Abril,Belice,0,1,,1,-74.77647900000001,10.886686
50961,2018,Abril,Belice,0,2,,2,-76.532004,3.451668
50962,2018,Abril,Belice,8,11,,19,-74.140516,4.697157
50963,2018,Abril,Belice,0,3,,3,-75.42726,6.170465
50964,2018,Abril,Belice,0,3,,3,-72.453013,7.819
50965,2018,Abril,Bermudas/Territorio Británico de Ultramar,1,0,,1,-75.516486,10.446304
50966,2018,Abril,Bermudas/Territorio Británico de Ultramar,0,1,,1,-74.140516,4.697157
50967,2018,Abril,Bolivia,1,0,,1,-77.84700600000001,0.8124359999999999
50968,2018,Abril,Bolivia,17,10,,27,-77.35600000000001,0.81488
50969,2018,Abril,Bolivia,26,22,,48,-75.527794,10.406342
50970,2018,Abril,Bolivia,126,97,,223,-75.516486,10.446304
50971,2018,Abril,Bolivia,5,7,,12,-74.77647900000001,10.886686
50972,2018,Abril,Bolivia,23,18,,41,-81.70216500000001,12.5862
50973,2018,Abril,Bolivia,9,12,,21,-76.532004,3.451668
50974,2018,Abril,Bolivia,478,596,,1074,-74.140516,4.697157
50975,2018,Abril,Bolivia,4,1,,5,-75.736374,4.815189
50976,2018,Abril,Bolivia,35,60,,95,-75.42726,6.170465
50977,2018,Abril,Bolivia,0,1,,1,-67.48402800000001,6.185536
50978,2018,Abril,Bolivia,0,1,,1,-73.181317,7.1280470000000005
50979,2018,Abril,Bolivia,17,12,,29,-72.453013,7.819
50980,2018,Abril,Bolivia,1,3,,4,-72.409396,8.36068
50981,2018,Abril,Bosnia y Herzegovina,0,1,,1,-75.516486,10.446304
50982,2018,Abril,Bosnia y Herzegovina,5,11,,16,-74.140516,4.697157
50983,2018,Abril,Bosnia y Herzegovina,1,0,,1,-75.42726,6.170465
50984,2018,Abril,Brasil,92,133,,225,-69.941498,4.191162
50985,2018,Abril,Brasil,4,5,,9,-69.94143100000001,4.214082
50986,2018,Abril,Brasil,0,2,,2,-76.876446,0.33002
50987,2018,Abril,Brasil,27,40,,67,-77.35600000000001,0.81488
50988,2018,Abril,Brasil,705,460,,1165,-75.527794,10.406342
50989,2018,Abril,Brasil,1209,832,,2041,-75.516486,10.446304
50990,2018,Abril,Brasil,11,19,,30,-74.77647900000001,10.886686
50991,2018,Abril,Brasil,0,1,,1,-74.232675,11.117206
50992,2018,Abril,Brasil,3,1,,4,-72.129595,11.360028999999999
50993,2018,Abril,Brasil,414,328,,742,-81.70216500000001,12.5862
50994,2018,Abril,Brasil,33,74,,107,-76.532004,3.451668
50995,2018,Abril,Brasil,1,5,,6,-67.927521,3.866713
50996,2018,Abril,Brasil,1,0,,1,-75.76635300000001,4.45285
50997,2018,Abril,Brasil,5778,6897,,12675,-74.140516,4.697157
50998,2018,Abril,Brasil,4,3,,7,-75.736374,4.815189
50999,2018,Abril,Brasil,124,267,,391,-75.42726,6.170465
51000,2018,Abril,Brasil,0,2,,2,-73.181317,7.1280470000000005
51001,2018,Abril,Brasil,9,11,,20,-72.453013,7.819
51002,2018,Abril,Brasil,3,6,,9,-72.409396,8.36068
51003,2018,Abril,Bulgaria,0,1,,1,-69.941498,4.191162
51004,2018,Abril,Bulgaria,2,0,,2,-77.35600000000001,0.81488
51005,2018,Abril,Bulgaria,0,1,,1,-75.527794,10.406342
51006,2018,Abril,Bulgaria,5,3,,8,-75.516486,10.446304
51007,2018,Abril,Bulgaria,0,1,,1,-74.77647900000001,10.886686
51008,2018,Abril,Bulgaria,1,0,,1,-72.129595,11.360028999999999
51009,2018,Abril,Bulgaria,3,3,,6,-76.532004,3.451668
51010,2018,Abril,Bulgaria,54,55,,109,-74.140516,4.697157
51011,2018,Abril,Bulgaria,4,10,,14,-75.42726,6.170465
51012,2018,Abril,Burkina Faso,0,2,,2,-74.140516,4.697157
51013,2018,Abril,Cabo Verde,0,5,,5,-75.527794,10.406342
51014,2018,Abril,Cabo Verde,1,5,,6,-74.140516,4.697157
51015,2018,Abril,Cabo Verde,1,0,,1,-75.42726,6.170465
51016,2018,Abril,Islas Caimán/Territorio Británico de Ultramar,0,1,,1,-75.516486,10.446304
51017,2018,Abril,Islas Caimán/Territorio Británico de Ultramar,0,1,,1,-74.77647900000001,10.886686
51018,2018,Abril,Islas Caimán/Territorio Británico de Ultramar,1,0,,1,-76.532004,3.451668
51019,2018,Abril,Islas Caimán/Territorio Británico de Ultramar,0,1,,1,-75.42726,6.170465
51020,2018,Abril,Camerún,1,1,,2,-74.140516,4.697157
51021,2018,Abril,Canadá,2,1,,3,-69.941498,4.191162
51022,2018,Abril,Canadá,1,1,,2,-69.94143100000001,4.214082
51023,2018,Abril,Canadá,0,1,,1,-77.84700600000001,0.8124359999999999
51024,2018,Abril,Canadá,15,16,,31,-77.35600000000001,0.81488
51025,2018,Abril,Canadá,8,8,,16,-75.527794,10.406342
51026,2018,Abril,Canadá,0,1,,1,-73.247863,10.433608999999999
51027,2018,Abril,Canadá,299,363,,662,-75.516486,10.446304
51028,2018,Abril,Canadá,17,52,,69,-74.77647900000001,10.886686
51029,2018,Abril,Canadá,1,1,,2,-72.129595,11.360028999999999
51030,2018,Abril,Canadá,1,4,,5,-81.703935,12.574411099999999
51031,2018,Abril,Canadá,4,3,,7,-81.70216500000001,12.5862
51032,2018,Abril,Canadá,1,2,,3,-81.372937,13.338761300000002
51033,2018,Abril,Canadá,39,61,,100,-76.532004,3.451668
51034,2018,Abril,Canadá,2,4,,6,-75.76635300000001,4.45285
51035,2018,Abril,Canadá,1080,1766,,2846,-74.140516,4.697157
51036,2018,Abril,Canadá,5,12,,17,-75.736374,4.815189
51037,2018,Abril,Canadá,225,547,,772,-75.42726,6.170465
51038,2018,Abril,Canadá,4,3,,7,-73.181317,7.1280470000000005
51039,2018,Abril,Canadá,1,2,,3,-72.453013,7.819
51040,2018,Abril,Canadá,7,11,,18,-77.35002,8.63337
51041,2018,Abril,República Democrática del Congo,3,4,,7,-74.140516,4.697157
51042,2018,Abril,República Democrática del Congo,0,1,,1,-72.453013,7.819
51043,2018,Abril,República de Corea,13,11,,24,-77.35600000000001,0.81488
51044,2018,Abril,República de Corea,5,5,,10,-75.516486,10.446304
51045,2018,Abril,República de Corea,2,2,,4,-74.77647900000001,10.886686
51046,2018,Abril,República de Corea,239,450,,689,-74.140516,4.697157
51047,2018,Abril,República de Corea,1,5,,6,-75.736374,4.815189
51048,2018,Abril,República de Corea,8,34,,42,-75.42726,6.170465
51049,2018,Abril,República de Corea,0,1,,1,-72.453013,7.819
51050,2018,Abril,República de Corea,0,1,,1,-72.409396,8.36068
51051,2018,Abril,Costa de Marfil,3,0,,3,-74.140516,4.697157
51052,2018,Abril,Costa Rica,0,1,,1,-76.876446,0.33002
51053,2018,Abril,Costa Rica,1,2,,3,-77.35600000000001,0.81488
51054,2018,Abril,Costa Rica,169,176,,345,-75.516486,10.446304
51055,2018,Abril,Costa Rica,31,28,,59,-74.77647900000001,10.886686
51056,2018,Abril,Costa Rica,1,1,,2,-72.129595,11.360028999999999
51057,2018,Abril,Costa Rica,20,21,,41,-81.70216500000001,12.5862
51058,2018,Abril,Costa Rica,35,40,,75,-76.532004,3.451668
51059,2018,Abril,Costa Rica,0,1,,1,-75.76635300000001,4.45285
51060,2018,Abril,Costa Rica,1568,1966,,3534,-74.140516,4.697157
51061,2018,Abril,Costa Rica,8,15,,23,-75.736374,4.815189
51062,2018,Abril,Costa Rica,187,225,,412,-75.42726,6.170465
51063,2018,Abril,Costa Rica,2,2,,4,-73.181317,7.1280470000000005
51064,2018,Abril,Costa Rica,0,3,,3,-72.453013,7.819
51065,2018,Abril,Croacia,0,1,,1,-75.527794,10.406342
51066,2018,Abril,Croacia,1,5,,6,-75.516486,10.446304
51067,2018,Abril,Croacia,0,3,,3,-74.77647900000001,10.886686
51068,2018,Abril,Croacia,0,6,,6,-74.765343,10.970933
51069,2018,Abril,Croacia,0,1,,1,-76.532004,3.451668
51070,2018,Abril,Croacia,23,44,,67,-74.140516,4.697157
51071,2018,Abril,Croacia,1,5,,6,-75.42726,6.170465
51072,2018,Abril,Cuba,0,4,,4,-77.35600000000001,0.81488
51073,2018,Abril,Cuba,0,3,,3,-75.527794,10.406342
51074,2018,Abril,Cuba,16,18,,34,-75.516486,10.446304
51075,2018,Abril,Cuba,5,22,,27,-74.77647900000001,10.886686
51076,2018,Abril,Cuba,1,0,,1,-72.129595,11.360028999999999
51077,2018,Abril,Cuba,14,23,,37,-76.532004,3.451668
51078,2018,Abril,Cuba,0,1,,1,-77.061029,3.8844260000000004
51079,2018,Abril,Cuba,0,1,,1,-75.76635300000001,4.45285
51080,2018,Abril,Cuba,240,331,,571,-74.140516,4.697157
51081,2018,Abril,Cuba,2,2,,4,-75.736374,4.815189
51082,2018,Abril,Cuba,21,21,,42,-75.42726,6.170465
51083,2018,Abril,Cuba,0,1,,1,-70.74025300000001,7.088728999999999
51084,2018,Abril,Cuba,0,2,,2,-73.181317,7.1280470000000005
51085,2018,Abril,Cuba,2,2,,4,-72.453013,7.819
51086,2018,Abril,Curazao,0,2,,2,-74.140516,4.697157
51087,2018,Abril,República Checa,0,2,,2,-69.94143100000001,4.214082
51088,2018,Abril,República Checa,4,6,,10,-77.35600000000001,0.81488
51089,2018,Abril,República Checa,1,0,,1,-75.527794,10.406342
51090,2018,Abril,República Checa,9,11,,20,-75.516486,10.446304
51091,2018,Abril,República Checa,1,1,,2,-74.77647900000001,10.886686
51092,2018,Abril,República Checa,3,0,,3,-76.532004,3.451668
51093,2018,Abril,República Checa,63,115,,178,-74.140516,4.697157
51094,2018,Abril,República Checa,2,9,,11,-75.42726,6.170465
51095,2018,Abril,República Checa,17,2,,19,-77.35002,8.63337
51096,2018,Abril,Chile,0,4,,4,-69.941498,4.191162
51097,2018,Abril,Chile,4,6,,10,-69.94143100000001,4.214082
51098,2018,Abril,Chile,2,2,,4,-76.876446,0.33002
51099,2018,Abril,Chile,1,0,,1,-77.84700600000001,0.8124359999999999
51100,2018,Abril,Chile,44,61,,105,-77.35600000000001,0.81488
51101,2018,Abril,Chile,144,109,,253,-75.527794,10.406342
51102,2018,Abril,Chile,656,541,,1197,-75.516486,10.446304
51103,2018,Abril,Chile,19,24,,43,-74.77647900000001,10.886686
51104,2018,Abril,Chile,0,3,,3,-74.213989,11.247722999999999
51105,2018,Abril,Chile,1,9,,10,-72.129595,11.360028999999999
51106,2018,Abril,Chile,0,1,,1,-81.703935,12.574411099999999
51107,2018,Abril,Chile,150,119,,269,-81.70216500000001,12.5862
51108,2018,Abril,Chile,33,54,,87,-76.532004,3.451668
51109,2018,Abril,Chile,1,1,,2,-77.061029,3.8844260000000004
51110,2018,Abril,Chile,4229,5462,,9691,-74.140516,4.697157
51111,2018,Abril,Chile,5,5,,10,-75.736374,4.815189
51112,2018,Abril,Chile,91,197,,288,-75.42726,6.170465
51113,2018,Abril,Chile,0,1,,1,-67.48402800000001,6.185536
51114,2018,Abril,Chile,2,2,,4,-73.181317,7.1280470000000005
51115,2018,Abril,Chile,17,30,,47,-72.453013,7.819
51116,2018,Abril,Chile,2,9,,11,-72.409396,8.36068
51117,2018,Abril,Chile,0,1,,1,-77.35002,8.63337
51118,2018,Abril,China,2,1,,3,-69.941498,4.191162
51119,2018,Abril,China,0,1,,1,-69.94143100000001,4.214082
51120,2018,Abril,China,0,2,,2,-76.876446,0.33002
51121,2018,Abril,China,7,10,,17,-77.35600000000001,0.81488
51122,2018,Abril,China,18,16,,34,-75.516486,10.446304
51123,2018,Abril,China,5,14,,19,-74.77647900000001,10.886686
51124,2018,Abril,China,0,2,,2,-74.765343,10.970933
51125,2018,Abril,China,0,2,,2,-74.213989,11.247722999999999
51126,2018,Abril,China,1,0,,1,-72.129595,11.360028999999999
51127,2018,Abril,China,1,0,,1,-81.70216500000001,12.5862
51128,2018,Abril,China,4,13,,17,-76.532004,3.451668
51129,2018,Abril,China,0,3,,3,-67.927521,3.866713
51130,2018,Abril,China,400,908,,1308,-74.140516,4.697157
51131,2018,Abril,China,0,1,,1,-75.736374,4.815189
51132,2018,Abril,China,49,79,,128,-75.42726,6.170465
51133,2018,Abril,China,4,7,,11,-72.453013,7.819
51134,2018,Abril,China,1,3,,4,-72.409396,8.36068
51135,2018,Abril,Taiwán,3,0,,3,-69.941498,4.191162
51136,2018,Abril,Taiwán,1,2,,3,-69.94143100000001,4.214082
51137,2018,Abril,Taiwán,3,0,,3,-77.35600000000001,0.81488
51138,2018,Abril,Taiwán,2,5,,7,-75.516486,10.446304
51139,2018,Abril,Taiwán,2,2,,4,-74.77647900000001,10.886686
51140,2018,Abril,Taiwán,5,3,,8,-76.532004,3.451668
51141,2018,Abril,Taiwán,58,92,,150,-74.140516,4.697157
51142,2018,Abril,Taiwán,6,16,,22,-75.42726,6.170465
51143,2018,Abril,Taiwán,2,2,,4,-72.453013,7.819
51144,2018,Abril,Chipre,2,4,,6,-74.140516,4.697157
51145,2018,Abril,Chipre,0,1,,1,-75.42726,6.170465
51146,2018,Abril,Dinamarca,2,0,,2,-69.941498,4.191162
51147,2018,Abril,Dinamarca,8,9,,17,-77.35600000000001,0.81488
51148,2018,Abril,Dinamarca,2,1,,3,-75.527794,10.406342
51149,2018,Abril,Dinamarca,21,30,,51,-75.516486,10.446304
51150,2018,Abril,Dinamarca,2,4,,6,-74.77647900000001,10.886686
51151,2018,Abril,Dinamarca,0,1,,1,-74.213989,11.247722999999999
51152,2018,Abril,Dinamarca,0,1,,1,-81.70216500000001,12.5862
51153,2018,Abril,Dinamarca,5,2,,7,-76.532004,3.451668
51154,2018,Abril,Dinamarca,104,172,,276,-74.140516,4.697157
51155,2018,Abril,Dinamarca,1,1,,2,-75.736374,4.815189
51156,2018,Abril,Dinamarca,15,19,,34,-75.42726,6.170465
51157,2018,Abril,Dinamarca,1,3,,4,-77.35002,8.63337
51158,2018,Abril,Dominica,3,3,,6,-74.140516,4.697157
51159,2018,Abril,Dominica,0,3,,3,-75.42726,6.170465
51160,2018,Abril,Dominica,0,1,,1,-72.508188,7.927233
51161,2018,Abril,Ecuador,0,1,,1,-69.941498,4.191162
51162,2018,Abril,Ecuador,40,231,,271,-76.876446,0.33002
51163,2018,Abril,Ecuador,17,16,,33,-77.84700600000001,0.8124359999999999
51164,2018,Abril,Ecuador,1234,1947,,3181,-77.35600000000001,0.81488
51165,2018,Abril,Ecuador,25,26,,51,-78.802679,18.00143
51166,2018,Abril,Ecuador,0,9,,9,-78.75132099999999,18.124979999999997
51167,2018,Abril,Ecuador,8,32,,40,-75.527794,10.406342
51168,2018,Abril,Ecuador,94,84,,178,-75.516486,10.446304
51169,2018,Abril,Ecuador,4,7,,11,-74.77647900000001,10.886686
51170,2018,Abril,Ecuador,13,28,,41,-72.129595,11.360028999999999
51171,2018,Abril,Ecuador,17,14,,31,-81.70216500000001,12.5862
51172,2018,Abril,Ecuador,449,435,,884,-76.532004,3.451668
51173,2018,Abril,Ecuador,0,1,,1,-75.76635300000001,4.45285
51174,2018,Abril,Ecuador,3146,4113,,7259,-74.140516,4.697157
51175,2018,Abril,Ecuador,3,4,,7,-75.736374,4.815189
51176,2018,Abril,Ecuador,61,109,,170,-75.42726,6.170465
51177,2018,Abril,Ecuador,0,1,,1,-67.48402800000001,6.185536
51178,2018,Abril,Ecuador,0,1,,1,-77.401154,6.222551999999999
51179,2018,Abril,Ecuador,1,0,,1,-70.74025300000001,7.088728999999999
51180,2018,Abril,Ecuador,1,1,,2,-73.181317,7.1280470000000005
51181,2018,Abril,Ecuador,153,193,,346,-72.453013,7.819
51182,2018,Abril,Ecuador,10,14,,24,-72.409396,8.36068
51183,2018,Abril,Ecuador,0,1,,1,-77.35002,8.63337
51184,2018,Abril,Egipto,0,1,,1,-75.527794,10.406342
51185,2018,Abril,Egipto,4,12,,16,-74.140516,4.697157
51186,2018,Abril,Egipto,0,1,,1,-75.42726,6.170465
51187,2018,Abril,El Salvador,1,0,,1,-76.876446,0.33002
51188,2018,Abril,El Salvador,1,4,,5,-77.35600000000001,0.81488
51189,2018,Abril,El Salvador,0,1,,1,-75.527794,10.406342
51190,2018,Abril,El Salvador,53,47,,100,-75.516486,10.446304
51191,2018,Abril,El Salvador,3,6,,9,-74.77647900000001,10.886686
51192,2018,Abril,El Salvador,6,8,,14,-81.70216500000001,12.5862
51193,2018,Abril,El Salvador,39,35,,74,-76.532004,3.451668
51194,2018,Abril,El Salvador,763,967,,1730,-74.140516,4.697157
51195,2018,Abril,El Salvador,0,2,,2,-75.736374,4.815189
51196,2018,Abril,El Salvador,156,207,,363,-75.42726,6.170465
51197,2018,Abril,El Salvador,1,1,,2,-73.181317,7.1280470000000005
51198,2018,Abril,El Salvador,2,2,,4,-72.453013,7.819
51199,2018,Abril,El Salvador,0,2,,2,-72.409396,8.36068
51200,2018,Abril,Emiratos Árabes,2,1,,3,-75.516486,10.446304
51201,2018,Abril,Emiratos Árabes,0,1,,1,-74.77647900000001,10.886686
51202,2018,Abril,Emiratos Árabes,2,9,,11,-74.140516,4.697157
51203,2018,Abril,Emiratos Árabes,0,2,,2,-75.42726,6.170465
51204,2018,Abril,España,0,1,,1,-69.941498,4.191162
51205,2018,Abril,España,6,5,,11,-69.94143100000001,4.214082
51206,2018,Abril,España,2,3,,5,-76.876446,0.33002
51207,2018,Abril,España,28,53,,81,-77.35600000000001,0.81488
51208,2018,Abril,España,0,1,,1,-78.802679,18.00143
51209,2018,Abril,España,16,24,,40,-75.527794,10.406342
51210,2018,Abril,España,0,2,,2,-73.247863,10.433608999999999
51211,2018,Abril,España,95,204,,299,-75.516486,10.446304
51212,2018,Abril,España,13,43,,56,-74.77647900000001,10.886686
51213,2018,Abril,España,0,1,,1,-74.213989,11.247722999999999
51214,2018,Abril,España,2,6,,8,-72.129595,11.360028999999999
51215,2018,Abril,España,0,2,,2,-81.703935,12.574411099999999
51216,2018,Abril,España,10,10,,20,-81.70216500000001,12.5862
51217,2018,Abril,España,358,445,,803,-76.532004,3.451668
51218,2018,Abril,España,2,0,,2,-75.76635300000001,4.45285
51219,2018,Abril,España,3074,5988,,9062,-74.140516,4.697157
51220,2018,Abril,España,7,14,,21,-75.736374,4.815189
51221,2018,Abril,España,348,634,,982,-75.42726,6.170465
51222,2018,Abril,España,0,2,,2,-67.48402800000001,6.185536
51223,2018,Abril,España,1,6,,7,-70.74025300000001,7.088728999999999
51224,2018,Abril,España,1,1,,2,-73.181317,7.1280470000000005
51225,2018,Abril,España,29,29,,58,-72.453013,7.819
51226,2018,Abril,España,1,4,,5,-72.409396,8.36068
51227,2018,Abril,España,2,4,,6,-77.35002,8.63337
51228,2018,Abril,Eslovaquia,3,1,,4,-77.35600000000001,0.81488
51229,2018,Abril,Eslovaquia,0,5,,5,-75.516486,10.446304
51230,2018,Abril,Eslovaquia,69,85,,154,-74.140516,4.697157
51231,2018,Abril,Eslovaquia,1,6,,7,-75.42726,6.170465
51232,2018,Abril,Eslovenia,2,1,,3,-77.35600000000001,0.81488
51233,2018,Abril,Eslovenia,5,8,,13,-75.516486,10.446304
51234,2018,Abril,Eslovenia,0,2,,2,-74.77647900000001,10.886686
51235,2018,Abril,Eslovenia,0,1,,1,-81.70216500000001,12.5862
51236,2018,Abril,Eslovenia,1,0,,1,-76.532004,3.451668
51237,2018,Abril,Eslovenia,29,53,,82,-74.140516,4.697157
51238,2018,Abril,Eslovenia,1,6,,7,-75.42726,6.170465
51239,2018,Abril,Eslovenia,1,1,,2,-72.453013,7.819
51240,2018,Abril,Eslovenia,0,1,,1,-72.409396,8.36068
51241,2018,Abril,Estados Unidos de América,2,10,,12,-69.941498,4.191162
51242,2018,Abril,Estados Unidos de América,4,4,,8,-69.94143100000001,4.214082
51243,2018,Abril,Estados Unidos de América,1,1,,2,-76.876446,0.33002
51244,2018,Abril,Estados Unidos de América,33,67,,100,-77.35600000000001,0.81488
51245,2018,Abril,Estados Unidos de América,51,81,,132,-75.527794,10.406342
51246,2018,Abril,Estados Unidos de América,6,13,,19,-73.247863,10.433608999999999
51247,2018,Abril,Estados Unidos de América,4479,6348,,10827,-75.516486,10.446304
51248,2018,Abril,Estados Unidos de América,475,895,,1370,-74.77647900000001,10.886686
51249,2018,Abril,Estados Unidos de América,0,1,,1,-74.765343,10.970933
51250,2018,Abril,Estados Unidos de América,3,11,,14,-74.213989,11.247722999999999
51251,2018,Abril,Estados Unidos de América,3,5,,8,-72.129595,11.360028999999999
51252,2018,Abril,Estados Unidos de América,1,9,,10,-81.703935,12.574411099999999
51253,2018,Abril,Estados Unidos de América,25,38,,63,-81.70216500000001,12.5862
51254,2018,Abril,Estados Unidos de América,6,8,,14,-81.372937,13.338761300000002
51255,2018,Abril,Estados Unidos de América,1022,1341,,2363,-76.532004,3.451668
51256,2018,Abril,Estados Unidos de América,83,176,,259,-75.76635300000001,4.45285
51257,2018,Abril,Estados Unidos de América,7829,14047,,21876,-74.140516,4.697157
51258,2018,Abril,Estados Unidos de América,104,158,,262,-75.736374,4.815189
51259,2018,Abril,Estados Unidos de América,2543,6654,,9197,-75.42726,6.170465
51260,2018,Abril,Estados Unidos de América,0,4,,4,-75.586989,6.2188349999999994
51261,2018,Abril,Estados Unidos de América,2,0,,2,-70.74025300000001,7.088728999999999
51262,2018,Abril,Estados Unidos de América,24,43,,67,-73.181317,7.1280470000000005
51263,2018,Abril,Estados Unidos de América,5,13,,18,-72.453013,7.819
51264,2018,Abril,Estados Unidos de América,2,2,,4,-72.409396,8.36068
51265,2018,Abril,Estados Unidos de América,8,13,,21,-77.35002,8.63337
51266,2018,Abril,Estonia,0,4,,4,-75.527794,10.406342
51267,2018,Abril,Estonia,4,2,,6,-75.516486,10.446304
51268,2018,Abril,Estonia,1,0,,1,-76.532004,3.451668
51269,2018,Abril,Estonia,6,8,,14,-74.140516,4.697157
51270,2018,Abril,Estonia,1,2,,3,-75.42726,6.170465
51271,2018,Abril,Etiopia,0,1,,1,-76.532004,3.451668
51272,2018,Abril,Etiopia,0,5,,5,-74.140516,4.697157
51273,2018,Abril,Filipinas,3,42,,45,-75.527794,10.406342
51274,2018,Abril,Filipinas,17,69,,86,-75.516486,10.446304
51275,2018,Abril,Filipinas,1,8,,9,-74.77647900000001,10.886686
51276,2018,Abril,Filipinas,0,18,,18,-74.765343,10.970933
51277,2018,Abril,Filipinas,0,12,,12,-74.213989,11.247722999999999
51278,2018,Abril,Filipinas,0,1,,1,-72.129595,11.360028999999999
51279,2018,Abril,Filipinas,4,8,,12,-76.532004,3.451668
51280,2018,Abril,Filipinas,0,11,,11,-77.061029,3.8844260000000004
51281,2018,Abril,Filipinas,46,79,,125,-74.140516,4.697157
51282,2018,Abril,Filipinas,1,0,,1,-75.736374,4.815189
51283,2018,Abril,Filipinas,3,2,,5,-75.42726,6.170465
51284,2018,Abril,Filipinas,0,17,,17,-75.68164200000001,9.402597
51285,2018,Abril,Finlandia,1,1,,2,-76.876446,0.33002
51286,2018,Abril,Finlandia,4,5,,9,-77.35600000000001,0.81488
51287,2018,Abril,Finlandia,2,1,,3,-75.527794,10.406342
51288,2018,Abril,Finlandia,3,7,,10,-75.516486,10.446304
51289,2018,Abril,Finlandia,1,1,,2,-74.77647900000001,10.886686
51290,2018,Abril,Finlandia,9,1,,10,-76.532004,3.451668
51291,2018,Abril,Finlandia,37,66,,103,-74.140516,4.697157
51292,2018,Abril,Finlandia,0,1,,1,-75.736374,4.815189
51293,2018,Abril,Finlandia,3,15,,18,-75.42726,6.170465
51294,2018,Abril,Francia,13,7,,20,-69.941498,4.191162
51295,2018,Abril,Francia,17,18,,35,-69.94143100000001,4.214082
51296,2018,Abril,Francia,6,9,,15,-76.876446,0.33002
51297,2018,Abril,Francia,1,1,,2,-77.84700600000001,0.8124359999999999
51298,2018,Abril,Francia,96,118,,214,-77.35600000000001,0.81488
51299,2018,Abril,Francia,10,14,,24,-75.527794,10.406342
51300,2018,Abril,Francia,165,210,,375,-75.516486,10.446304
51301,2018,Abril,Francia,13,28,,41,-74.77647900000001,10.886686
51302,2018,Abril,Francia,1,1,,2,-74.765343,10.970933
51303,2018,Abril,Francia,1,3,,4,-74.213989,11.247722999999999
51304,2018,Abril,Francia,1,5,,6,-72.129595,11.360028999999999
51305,2018,Abril,Francia,1,7,,8,-81.703935,12.574411099999999
51306,2018,Abril,Francia,5,2,,7,-81.70216500000001,12.5862
51307,2018,Abril,Francia,4,4,,8,-81.372937,13.338761300000002
51308,2018,Abril,Francia,53,96,,149,-76.532004,3.451668
51309,2018,Abril,Francia,0,1,,1,-75.76635300000001,4.45285
51310,2018,Abril,Francia,2163,2971,,5134,-74.140516,4.697157
51311,2018,Abril,Francia,6,9,,15,-75.736374,4.815189
51312,2018,Abril,Francia,118,259,,377,-75.42726,6.170465
51313,2018,Abril,Francia,1,0,,1,-70.74025300000001,7.088728999999999
51314,2018,Abril,Francia,1,1,,2,-73.181317,7.1280470000000005
51315,2018,Abril,Francia,2,5,,7,-72.453013,7.819
51316,2018,Abril,Francia,0,1,,1,-72.409396,8.36068
51317,2018,Abril,Francia,1,12,,13,-77.35002,8.63337
51318,2018,Abril,Gabón,0,1,,1,-74.140516,4.697157
51319,2018,Abril,Georgia,0,1,,1,-75.527794,10.406342
51320,2018,Abril,Georgia,1,1,,2,-75.516486,10.446304
51321,2018,Abril,Georgia,2,1,,3,-74.140516,4.697157
51322,2018,Abril,Ghana,0,2,,2,-77.35600000000001,0.81488
51323,2018,Abril,Ghana,2,13,,15,-74.140516,4.697157
51324,2018,Abril,Ghana,1,2,,3,-75.42726,6.170465
51325,2018,Abril,Granada,0,1,,1,-75.527794,10.406342
51326,2018,Abril,Granada,1,0,,1,-75.516486,10.446304
51327,2018,Abril,Granada,0,1,,1,-74.77647900000001,10.886686
51328,2018,Abril,Granada,0,4,,4,-74.140516,4.697157
51329,2018,Abril,Granada,0,1,,1,-75.42726,6.170465
51330,2018,Abril,Grecia,0,2,,2,-77.35600000000001,0.81488
51331,2018,Abril,Grecia,1,4,,5,-75.527794,10.406342
51332,2018,Abril,Grecia,6,9,,15,-75.516486,10.446304
51333,2018,Abril,Grecia,0,1,,1,-74.77647900000001,10.886686
51334,2018,Abril,Grecia,2,2,,4,-76.532004,3.451668
51335,2018,Abril,Grecia,32,79,,111,-74.140516,4.697157
51336,2018,Abril,Grecia,0,5,,5,-75.42726,6.170465
51337,2018,Abril,Grecia,0,1,,1,-72.453013,7.819
51338,2018,Abril,Grecia,0,2,,2,-76.7333,8.06667
51339,2018,Abril,Grecia,0,3,,3,-75.68164200000001,9.402597
51340,2018,Abril,Guatemala,2,0,,2,-69.941498,4.191162
51341,2018,Abril,Guatemala,3,4,,7,-77.35600000000001,0.81488
51342,2018,Abril,Guatemala,1,3,,4,-75.527794,10.406342
51343,2018,Abril,Guatemala,111,195,,306,-75.516486,10.446304
51344,2018,Abril,Guatemala,10,15,,25,-74.77647900000001,10.886686
51345,2018,Abril,Guatemala,0,3,,3,-72.129595,11.360028999999999
51346,2018,Abril,Guatemala,14,10,,24,-81.70216500000001,12.5862
51347,2018,Abril,Guatemala,16,34,,50,-76.532004,3.451668
51348,2018,Abril,Guatemala,1,0,,1,-75.76635300000001,4.45285
51349,2018,Abril,Guatemala,383,767,,1150,-74.140516,4.697157
51350,2018,Abril,Guatemala,3,4,,7,-75.736374,4.815189
51351,2018,Abril,Guatemala,57,157,,214,-75.42726,6.170465
51352,2018,Abril,Guatemala,0,2,,2,-67.48402800000001,6.185536
51353,2018,Abril,Guatemala,2,3,,5,-73.181317,7.1280470000000005
51354,2018,Abril,Guatemala,0,7,,7,-72.453013,7.819
51355,2018,Abril,Guyana,1,1,,2,-69.941498,4.191162
51356,2018,Abril,Guyana,2,1,,3,-75.516486,10.446304
51357,2018,Abril,Guyana,1,1,,2,-74.77647900000001,10.886686
51358,2018,Abril,Guyana,0,1,,1,-72.129595,11.360028999999999
51359,2018,Abril,Guyana,0,1,,1,-81.70216500000001,12.5862
51360,2018,Abril,Guyana,0,1,,1,-76.532004,3.451668
51361,2018,Abril,Guyana,17,24,,41,-74.140516,4.697157
51362,2018,Abril,Guyana,2,1,,3,-72.453013,7.819
51363,2018,Abril,Haití,0,5,,5,-75.516486,10.446304
51364,2018,Abril,Haití,1,2,,3,-74.77647900000001,10.886686
51365,2018,Abril,Haití,13,19,,32,-74.140516,4.697157
51366,2018,Abril,Haití,2,9,,11,-75.42726,6.170465
51367,2018,Abril,Honduras,1,1,,2,-77.35600000000001,0.81488
51368,2018,Abril,Honduras,0,7,,7,-75.527794,10.406342
51369,2018,Abril,Honduras,65,71,,136,-75.516486,10.446304
51370,2018,Abril,Honduras,10,16,,26,-74.77647900000001,10.886686
51371,2018,Abril,Honduras,0,2,,2,-72.129595,11.360028999999999
51372,2018,Abril,Honduras,0,3,,3,-81.70216500000001,12.5862
51373,2018,Abril,Honduras,41,26,,67,-76.532004,3.451668
51374,2018,Abril,Honduras,0,1,,1,-75.76635300000001,4.45285
51375,2018,Abril,Honduras,238,355,,593,-74.140516,4.697157
51376,2018,Abril,Honduras,41,59,,100,-75.42726,6.170465
51377,2018,Abril,Honduras,1,6,,7,-73.181317,7.1280470000000005
51378,2018,Abril,Honduras,0,2,,2,-72.453013,7.819
51379,2018,Abril,Honduras,0,1,,1,-72.409396,8.36068
51380,2018,Abril,Hong Kong,1,1,,2,-69.941498,4.191162
51381,2018,Abril,Hong Kong,0,1,,1,-77.35600000000001,0.81488
51382,2018,Abril,Hong Kong,1,1,,2,-75.516486,10.446304
51383,2018,Abril,Hong Kong,6,13,,19,-74.140516,4.697157
51384,2018,Abril,Hungría,1,1,,2,-77.35600000000001,0.81488
51385,2018,Abril,Hungría,2,0,,2,-75.527794,10.406342
51386,2018,Abril,Hungría,18,16,,34,-75.516486,10.446304
51387,2018,Abril,Hungría,4,3,,7,-76.532004,3.451668
51388,2018,Abril,Hungría,36,66,,102,-74.140516,4.697157
51389,2018,Abril,Hungría,5,7,,12,-75.42726,6.170465
51390,2018,Abril,India,0,1,,1,-77.35600000000001,0.81488
51391,2018,Abril,India,0,9,,9,-75.527794,10.406342
51392,2018,Abril,India,11,60,,71,-75.516486,10.446304
51393,2018,Abril,India,1,18,,19,-74.77647900000001,10.886686
51394,2018,Abril,India,0,3,,3,-74.765343,10.970933
51395,2018,Abril,India,0,1,,1,-74.213989,11.247722999999999
51396,2018,Abril,India,2,6,,8,-76.532004,3.451668
51397,2018,Abril,India,0,3,,3,-77.061029,3.8844260000000004
51398,2018,Abril,India,87,358,,445,-74.140516,4.697157
51399,2018,Abril,India,0,3,,3,-75.736374,4.815189
51400,2018,Abril,India,14,69,,83,-75.42726,6.170465
51401,2018,Abril,India,0,1,,1,-73.181317,7.1280470000000005
51402,2018,Abril,India,0,3,,3,-75.68164200000001,9.402597
51403,2018,Abril,Indonesia,1,2,,3,-77.35600000000001,0.81488
51404,2018,Abril,Indonesia,0,2,,2,-75.527794,10.406342
51405,2018,Abril,Indonesia,2,3,,5,-75.516486,10.446304
51406,2018,Abril,Indonesia,0,1,,1,-74.77647900000001,10.886686
51407,2018,Abril,Indonesia,0,1,,1,-74.765343,10.970933
51408,2018,Abril,Indonesia,8,22,,30,-74.140516,4.697157
51409,2018,Abril,Indonesia,2,2,,4,-75.42726,6.170465
51410,2018,Abril,Indonesia,0,2,,2,-75.68164200000001,9.402597
51411,2018,Abril,Iraq,1,2,,3,-74.140516,4.697157
51412,2018,Abril,Irán,1,1,,2,-75.516486,10.446304
51413,2018,Abril,Irán,6,14,,20,-74.140516,4.697157
51414,2018,Abril,Irán,0,2,,2,-75.42726,6.170465
51415,2018,Abril,República de Irlanda,1,1,,2,-69.941498,4.191162
51416,2018,Abril,República de Irlanda,2,4,,6,-69.94143100000001,4.214082
51417,2018,Abril,República de Irlanda,0,1,,1,-76.876446,0.33002
51418,2018,Abril,República de Irlanda,8,11,,19,-77.35600000000001,0.81488
51419,2018,Abril,República de Irlanda,2,4,,6,-75.527794,10.406342
51420,2018,Abril,República de Irlanda,17,25,,42,-75.516486,10.446304
51421,2018,Abril,República de Irlanda,1,3,,4,-74.77647900000001,10.886686
51422,2018,Abril,República de Irlanda,0,1,,1,-74.213989,11.247722999999999
51423,2018,Abril,República de Irlanda,6,6,,12,-76.532004,3.451668
51424,2018,Abril,República de Irlanda,139,212,,351,-74.140516,4.697157
51425,2018,Abril,República de Irlanda,8,43,,51,-75.42726,6.170465
51426,2018,Abril,República de Irlanda,3,4,,7,-77.35002,8.63337
51427,2018,Abril,Islandia,0,1,,1,-77.35600000000001,0.81488
51428,2018,Abril,Islandia,0,3,,3,-75.516486,10.446304
51429,2018,Abril,Islandia,0,1,,1,-76.532004,3.451668
51430,2018,Abril,Islandia,4,11,,15,-74.140516,4.697157
51431,2018,Abril,Islandia,3,0,,3,-75.42726,6.170465
51432,2018,Abril,Israel,1,5,,6,-69.941498,4.191162
51433,2018,Abril,Israel,3,9,,12,-69.94143100000001,4.214082
51434,2018,Abril,Israel,1,1,,2,-76.876446,0.33002
51435,2018,Abril,Israel,17,50,,67,-77.35600000000001,0.81488
51436,2018,Abril,Israel,3,2,,5,-75.527794,10.406342
51437,2018,Abril,Israel,56,102,,158,-75.516486,10.446304
51438,2018,Abril,Israel,0,7,,7,-74.77647900000001,10.886686
51439,2018,Abril,Israel,2,3,,5,-81.70216500000001,12.5862
51440,2018,Abril,Israel,19,38,,57,-76.532004,3.451668
51441,2018,Abril,Israel,658,1267,,1925,-74.140516,4.697157
51442,2018,Abril,Israel,0,1,,1,-75.736374,4.815189
51443,2018,Abril,Israel,134,196,,330,-75.42726,6.170465
51444,2018,Abril,Italia,1,2,,3,-69.941498,4.191162
51445,2018,Abril,Italia,3,7,,10,-69.94143100000001,4.214082
51446,2018,Abril,Italia,5,6,,11,-76.876446,0.33002
51447,2018,Abril,Italia,18,23,,41,-77.35600000000001,0.81488
51448,2018,Abril,Italia,11,16,,27,-75.527794,10.406342
51449,2018,Abril,Italia,57,142,,199,-75.516486,10.446304
51450,2018,Abril,Italia,5,26,,31,-74.77647900000001,10.886686
51451,2018,Abril,Italia,1,1,,2,-74.232675,11.117206
51452,2018,Abril,Italia,0,3,,3,-72.129595,11.360028999999999
51453,2018,Abril,Italia,0,2,,2,-81.703935,12.574411099999999
51454,2018,Abril,Italia,5,7,,12,-81.70216500000001,12.5862
51455,2018,Abril,Italia,33,75,,108,-76.532004,3.451668
51456,2018,Abril,Italia,0,1,,1,-75.76635300000001,4.45285
51457,2018,Abril,Italia,724,1686,,2410,-74.140516,4.697157
51458,2018,Abril,Italia,0,7,,7,-75.736374,4.815189
51459,2018,Abril,Italia,73,215,,288,-75.42726,6.170465
51460,2018,Abril,Italia,2,0,,2,-67.48402800000001,6.185536
51461,2018,Abril,Italia,0,3,,3,-70.74025300000001,7.088728999999999
51462,2018,Abril,Italia,0,1,,1,-77.762647,7.102626
51463,2018,Abril,Italia,2,6,,8,-73.181317,7.1280470000000005
51464,2018,Abril,Italia,16,14,,30,-72.453013,7.819
51465,2018,Abril,Italia,1,1,,2,-72.409396,8.36068
51466,2018,Abril,Italia,4,5,,9,-77.35002,8.63337
51467,2018,Abril,Jamaica,0,1,,1,-77.35600000000001,0.81488
51468,2018,Abril,Jamaica,4,8,,12,-75.516486,10.446304
51469,2018,Abril,Jamaica,3,2,,5,-74.77647900000001,10.886686
51470,2018,Abril,Jamaica,0,1,,1,-81.70216500000001,12.5862
51471,2018,Abril,Jamaica,7,0,,7,-76.532004,3.451668
51472,2018,Abril,Jamaica,26,32,,58,-74.140516,4.697157
51473,2018,Abril,Jamaica,5,12,,17,-75.42726,6.170465
51474,2018,Abril,Japón,1,1,,2,-69.941498,4.191162
51475,2018,Abril,Japón,2,1,,3,-69.94143100000001,4.214082
51476,2018,Abril,Japón,16,14,,30,-77.35600000000001,0.81488
51477,2018,Abril,Japón,0,1,,1,-75.527794,10.406342
51478,2018,Abril,Japón,7,10,,17,-75.516486,10.446304
51479,2018,Abril,Japón,2,5,,7,-74.77647900000001,10.886686
51480,2018,Abril,Japón,5,5,,10,-76.532004,3.451668
51481,2018,Abril,Japón,148,462,,610,-74.140516,4.697157
51482,2018,Abril,Japón,1,4,,5,-75.736374,4.815189
51483,2018,Abril,Japón,17,48,,65,-75.42726,6.170465
51484,2018,Abril,Japón,0,1,,1,-73.181317,7.1280470000000005
51485,2018,Abril,Japón,0,3,,3,-72.453013,7.819
51486,2018,Abril,Japón,0,1,,1,-72.409396,8.36068
51487,2018,Abril,Jordania,1,1,,2,-75.516486,10.446304
51488,2018,Abril,Jordania,1,0,,1,-76.532004,3.451668
51489,2018,Abril,Jordania,4,6,,10,-74.140516,4.697157
51490,2018,Abril,Kazajistán,1,1,,2,-75.516486,10.446304
51491,2018,Abril,Kazajistán,1,1,,2,-74.140516,4.697157
51492,2018,Abril,Kenia,0,3,,3,-75.516486,10.446304
51493,2018,Abril,Kenia,4,12,,16,-74.140516,4.697157
51494,2018,Abril,Kenia,2,0,,2,-75.42726,6.170465
51495,2018,Abril,Kuwait,0,7,,7,-74.140516,4.697157
51496,2018,Abril,República de Kosovo,1,0,,1,-74.140516,4.697157
51497,2018,Abril,Letonia,0,1,,1,-69.941498,4.191162
51498,2018,Abril,Letonia,1,1,,2,-76.876446,0.33002
51499,2018,Abril,Letonia,0,1,,1,-77.35600000000001,0.81488
51500,2018,Abril,Letonia,1,0,,1,-75.516486,10.446304
51501,2018,Abril,Letonia,5,13,,18,-74.140516,4.697157
51502,2018,Abril,Letonia,2,3,,5,-75.42726,6.170465
51503,2018,Abril,Lituania,1,1,,2,-77.35600000000001,0.81488
51504,2018,Abril,Lituania,0,4,,4,-75.527794,10.406342
51505,2018,Abril,Lituania,6,6,,12,-75.516486,10.446304
51506,2018,Abril,Lituania,1,2,,3,-76.532004,3.451668
51507,2018,Abril,Lituania,20,13,,33,-74.140516,4.697157
51508,2018,Abril,Lituania,1,2,,3,-75.42726,6.170465
51509,2018,Abril,Líbano,2,0,,2,-74.77647900000001,10.886686
51510,2018,Abril,Líbano,1,0,,1,-72.129595,11.360028999999999
51511,2018,Abril,Líbano,13,23,,36,-74.140516,4.697157
51512,2018,Abril,Líbano,1,0,,1,-75.42726,6.170465
51513,2018,Abril,Líbano,1,1,,2,-73.181317,7.1280470000000005
51514,2018,Abril,Liberia,1,0,,1,-76.532004,3.451668
51515,2018,Abril,Liechtenstein,1,1,,2,-74.140516,4.697157
51516,2018,Abril,Liechtenstein,0,2,,2,-75.42726,6.170465
51517,2018,Abril,Luxemburgo,1,1,,2,-77.35600000000001,0.81488
51518,2018,Abril,Luxemburgo,2,1,,3,-75.516486,10.446304
51519,2018,Abril,Luxemburgo,6,8,,14,-74.140516,4.697157
51520,2018,Abril,Luxemburgo,1,2,,3,-75.42726,6.170465
51521,2018,Abril,Macedonia,0,1,,1,-76.532004,3.451668
51522,2018,Abril,Macedonia,2,3,,5,-74.140516,4.697157
51523,2018,Abril,Madagascar,2,1,,3,-74.140516,4.697157
51524,2018,Abril,Malasia,1,0,,1,-69.94143100000001,4.214082
51525,2018,Abril,Malasia,3,6,,9,-75.516486,10.446304
51526,2018,Abril,Malasia,33,41,,74,-74.140516,4.697157
51527,2018,Abril,Malasia,1,5,,6,-75.42726,6.170465
51528,2018,Abril,Malasia,1,0,,1,-72.453013,7.819
51529,2018,Abril,Malasia,0,2,,2,-75.68164200000001,9.402597
51530,2018,Abril,Malawi,0,2,,2,-74.140516,4.697157
51531,2018,Abril,Maldivas,1,0,,1,-75.516486,10.446304
51532,2018,Abril,Malí,0,1,,1,-74.140516,4.697157
51533,2018,Abril,Malta,1,4,,5,-74.140516,4.697157
51534,2018,Abril,Malta,0,1,,1,-75.42726,6.170465
51535,2018,Abril,Marruecos,0,2,,2,-75.516486,10.446304
51536,2018,Abril,Marruecos,1,0,,1,-76.532004,3.451668
51537,2018,Abril,Marruecos,14,16,,30,-74.140516,4.697157
51538,2018,Abril,Marruecos,0,1,,1,-75.42726,6.170465
51539,2018,Abril,Marruecos,0,1,,1,-72.453013,7.819
51540,2018,Abril,Mauricio,0,2,,2,-75.527794,10.406342
51541,2018,Abril,Mauricio,0,4,,4,-74.140516,4.697157
51542,2018,Abril,México,0,2,,2,-69.941498,4.191162
51543,2018,Abril,México,0,4,,4,-69.94143100000001,4.214082
51544,2018,Abril,México,2,1,,3,-76.876446,0.33002
51545,2018,Abril,México,19,32,,51,-77.35600000000001,0.81488
51546,2018,Abril,México,21,19,,40,-75.527794,10.406342
51547,2018,Abril,México,3,7,,10,-73.247863,10.433608999999999
51548,2018,Abril,México,223,320,,543,-75.516486,10.446304
51549,2018,Abril,México,35,66,,101,-74.77647900000001,10.886686
51550,2018,Abril,México,1,4,,5,-72.129595,11.360028999999999
51551,2018,Abril,México,0,1,,1,-81.703935,12.574411099999999
51552,2018,Abril,México,2,4,,6,-81.70216500000001,12.5862
51553,2018,Abril,México,0,1,,1,-81.372937,13.338761300000002
51554,2018,Abril,México,67,152,,219,-76.532004,3.451668
51555,2018,Abril,México,1,1,,2,-75.76635300000001,4.45285
51556,2018,Abril,México,4212,7667,,11879,-74.140516,4.697157
51557,2018,Abril,México,5,13,,18,-75.736374,4.815189
51558,2018,Abril,México,613,1539,,2152,-75.42726,6.170465
51559,2018,Abril,México,0,1,,1,-77.401154,6.222551999999999
51560,2018,Abril,México,6,6,,12,-70.74025300000001,7.088728999999999
51561,2018,Abril,México,4,9,,13,-73.181317,7.1280470000000005
51562,2018,Abril,México,31,27,,58,-72.453013,7.819
51563,2018,Abril,México,0,1,,1,-76.7333,8.06667
51564,2018,Abril,México,4,9,,13,-72.409396,8.36068
51565,2018,Abril,México,2,0,,2,-77.35002,8.63337
51566,2018,Abril,República de Moldavia,2,2,,4,-74.140516,4.697157
51567,2018,Abril,República de Moldavia,0,1,,1,-75.42726,6.170465
51568,2018,Abril,Mónaco,1,1,,2,-74.140516,4.697157
51569,2018,Abril,Mongolia,1,0,,1,-74.140516,4.697157
51570,2018,Abril,Montenegro,0,1,,1,-75.527794,10.406342
51571,2018,Abril,Montenegro,0,1,,1,-75.516486,10.446304
51572,2018,Abril,Montenegro,1,3,,4,-74.140516,4.697157
51573,2018,Abril,Mozambique,1,3,,4,-74.140516,4.697157
51574,2018,Abril,Myanmar,1,0,,1,-75.516486,10.446304
51575,2018,Abril,Namibia,0,1,,1,-75.516486,10.446304
51576,2018,Abril,Namibia,1,0,,1,-76.532004,3.451668
51577,2018,Abril,Nepal,2,4,,6,-74.140516,4.697157
51578,2018,Abril,Nicaragua,18,21,,39,-75.516486,10.446304
51579,2018,Abril,Nicaragua,0,8,,8,-74.77647900000001,10.886686
51580,2018,Abril,Nicaragua,7,6,,13,-81.703935,12.574411099999999
51581,2018,Abril,Nicaragua,7,4,,11,-76.532004,3.451668
51582,2018,Abril,Nicaragua,81,111,,192,-74.140516,4.697157
51583,2018,Abril,Nicaragua,0,2,,2,-75.736374,4.815189
51584,2018,Abril,Nicaragua,18,27,,45,-75.42726,6.170465
51585,2018,Abril,Nigeria,0,1,,1,-76.532004,3.451668
51586,2018,Abril,Nigeria,0,5,,5,-74.140516,4.697157
51587,2018,Abril,Nigeria,1,0,,1,-75.42726,6.170465
51588,2018,Abril,Noruega,0,1,,1,-76.876446,0.33002
51589,2018,Abril,Noruega,3,2,,5,-77.35600000000001,0.81488
51590,2018,Abril,Noruega,2,1,,3,-75.527794,10.406342
51591,2018,Abril,Noruega,16,14,,30,-75.516486,10.446304
51592,2018,Abril,Noruega,1,1,,2,-74.77647900000001,10.886686
51593,2018,Abril,Noruega,1,2,,3,-74.213989,11.247722999999999
51594,2018,Abril,Noruega,1,0,,1,-81.70216500000001,12.5862
51595,2018,Abril,Noruega,5,6,,11,-76.532004,3.451668
51596,2018,Abril,Noruega,70,114,,184,-74.140516,4.697157
51597,2018,Abril,Noruega,0,1,,1,-75.736374,4.815189
51598,2018,Abril,Noruega,13,7,,20,-75.42726,6.170465
51599,2018,Abril,Noruega,0,1,,1,-77.35002,8.63337
51600,2018,Abril,Nueva Zelanda,3,6,,9,-77.35600000000001,0.81488
51601,2018,Abril,Nueva Zelanda,5,10,,15,-75.527794,10.406342
51602,2018,Abril,Nueva Zelanda,16,18,,34,-75.516486,10.446304
51603,2018,Abril,Nueva Zelanda,1,5,,6,-74.77647900000001,10.886686
51604,2018,Abril,Nueva Zelanda,0,1,,1,-81.372937,13.338761300000002
51605,2018,Abril,Nueva Zelanda,1,3,,4,-76.532004,3.451668
51606,2018,Abril,Nueva Zelanda,71,109,,180,-74.140516,4.697157
51607,2018,Abril,Nueva Zelanda,11,17,,28,-75.42726,6.170465
51608,2018,Abril,Nueva Zelanda,1,1,,2,-77.35002,8.63337
51609,2018,Abril,Omán,0,1,,1,-74.140516,4.697157
51610,2018,Abril,Países Bajos,0,2,,2,-69.941498,4.191162
51611,2018,Abril,Países Bajos,4,3,,7,-69.94143100000001,4.214082
51612,2018,Abril,Países Bajos,2,3,,5,-76.876446,0.33002
51613,2018,Abril,Países Bajos,20,31,,51,-77.35600000000001,0.81488
51614,2018,Abril,Países Bajos,31,32,,63,-75.527794,10.406342
51615,2018,Abril,Países Bajos,102,185,,287,-75.516486,10.446304
51616,2018,Abril,Países Bajos,11,22,,33,-74.77647900000001,10.886686
51617,2018,Abril,Países Bajos,0,1,,1,-74.765343,10.970933
51618,2018,Abril,Países Bajos,1,4,,5,-72.129595,11.360028999999999
51619,2018,Abril,Países Bajos,2,0,,2,-81.703935,12.574411099999999
51620,2018,Abril,Países Bajos,35,47,,82,-76.532004,3.451668
51621,2018,Abril,Países Bajos,0,1,,1,-75.76635300000001,4.45285
51622,2018,Abril,Países Bajos,1689,2024,,3713,-74.140516,4.697157
51623,2018,Abril,Países Bajos,4,7,,11,-75.736374,4.815189
51624,2018,Abril,Países Bajos,124,219,,343,-75.42726,6.170465
51625,2018,Abril,Países Bajos,0,1,,1,-67.48402800000001,6.185536
51626,2018,Abril,Países Bajos,0,1,,1,-70.74025300000001,7.088728999999999
51627,2018,Abril,Países Bajos,4,2,,6,-73.181317,7.1280470000000005
51628,2018,Abril,Países Bajos,3,1,,4,-72.453013,7.819
51629,2018,Abril,Países Bajos,1,3,,4,-72.508188,7.927233
51630,2018,Abril,Países Bajos,0,3,,3,-72.409396,8.36068
51631,2018,Abril,Países Bajos,8,12,,20,-77.35002,8.63337
51632,2018,Abril,Pakistán,3,13,,16,-74.140516,4.697157
51633,2018,Abril,Pakistán,0,1,,1,-75.42726,6.170465
51634,2018,Abril,Panamá,0,2,,2,-77.35600000000001,0.81488
51635,2018,Abril,Panamá,0,25,,25,-75.527794,10.406342
51636,2018,Abril,Panamá,1,1,,2,-73.247863,10.433608999999999
51637,2018,Abril,Panamá,430,445,,875,-75.516486,10.446304
51638,2018,Abril,Panamá,91,126,,217,-74.77647900000001,10.886686
51639,2018,Abril,Panamá,1,4,,5,-72.129595,11.360028999999999
51640,2018,Abril,Panamá,0,3,,3,-81.703935,12.574411099999999
51641,2018,Abril,Panamá,52,35,,87,-81.70216500000001,12.5862
51642,2018,Abril,Panamá,217,204,,421,-76.532004,3.451668
51643,2018,Abril,Panamá,20,11,,31,-75.76635300000001,4.45285
51644,2018,Abril,Panamá,1515,1662,,3177,-74.140516,4.697157
51645,2018,Abril,Panamá,28,55,,83,-75.736374,4.815189
51646,2018,Abril,Panamá,1254,1192,,2446,-75.42726,6.170465
51647,2018,Abril,Panamá,2,3,,5,-77.762647,7.102626
51648,2018,Abril,Panamá,13,22,,35,-73.181317,7.1280470000000005
51649,2018,Abril,Panamá,4,0,,4,-72.453013,7.819
51650,2018,Abril,Panamá,0,1,,1,-72.409396,8.36068
51651,2018,Abril,Panamá,2,3,,5,-77.35002,8.63337
51652,2018,Abril,Paraguay,0,1,,1,-69.941498,4.191162
51653,2018,Abril,Paraguay,2,3,,5,-77.35600000000001,0.81488
51654,2018,Abril,Paraguay,6,1,,7,-75.527794,10.406342
51655,2018,Abril,Paraguay,77,51,,128,-75.516486,10.446304
51656,2018,Abril,Paraguay,5,7,,12,-74.77647900000001,10.886686
51657,2018,Abril,Paraguay,63,39,,102,-81.70216500000001,12.5862
51658,2018,Abril,Paraguay,10,2,,12,-76.532004,3.451668
51659,2018,Abril,Paraguay,167,155,,322,-74.140516,4.697157
51660,2018,Abril,Paraguay,0,2,,2,-75.736374,4.815189
51661,2018,Abril,Paraguay,26,27,,53,-75.42726,6.170465
51662,2018,Abril,Paraguay,0,2,,2,-73.181317,7.1280470000000005
51663,2018,Abril,Perú,18,20,,38,-69.941498,4.191162
51664,2018,Abril,Perú,29,38,,67,-69.94143100000001,4.214082
51665,2018,Abril,Perú,2,13,,15,-76.876446,0.33002
51666,2018,Abril,Perú,96,268,,364,-77.35600000000001,0.81488
51667,2018,Abril,Perú,36,35,,71,-75.527794,10.406342
51668,2018,Abril,Perú,801,530,,1331,-75.516486,10.446304
51669,2018,Abril,Perú,9,18,,27,-74.77647900000001,10.886686
51670,2018,Abril,Perú,0,1,,1,-74.765343,10.970933
51671,2018,Abril,Perú,9,20,,29,-72.129595,11.360028999999999
51672,2018,Abril,Perú,323,214,,537,-81.70216500000001,12.5862
51673,2018,Abril,Perú,77,127,,204,-76.532004,3.451668
51674,2018,Abril,Perú,0,1,,1,-67.927521,3.866713
51675,2018,Abril,Perú,0,2,,2,-75.76635300000001,4.45285
51676,2018,Abril,Perú,3543,4478,,8021,-74.140516,4.697157
51677,2018,Abril,Perú,7,6,,13,-75.736374,4.815189
51678,2018,Abril,Perú,373,602,,975,-75.42726,6.170465
51679,2018,Abril,Perú,6,6,,12,-70.74025300000001,7.088728999999999
51680,2018,Abril,Perú,6,7,,13,-73.181317,7.1280470000000005
51681,2018,Abril,Perú,122,212,,334,-72.453013,7.819
51682,2018,Abril,Perú,5,13,,18,-72.409396,8.36068
51683,2018,Abril,Perú,0,1,,1,-77.35002,8.63337
51684,2018,Abril,Palestina,0,1,,1,-74.77647900000001,10.886686
51685,2018,Abril,Palestina,2,0,,2,-74.140516,4.697157
51686,2018,Abril,Polonia,2,3,,5,-69.94143100000001,4.214082
51687,2018,Abril,Polonia,3,2,,5,-76.876446,0.33002
51688,2018,Abril,Polonia,9,4,,13,-77.35600000000001,0.81488
51689,2018,Abril,Polonia,1,8,,9,-75.527794,10.406342
51690,2018,Abril,Polonia,12,33,,45,-75.516486,10.446304
51691,2018,Abril,Polonia,0,2,,2,-74.77647900000001,10.886686
51692,2018,Abril,Polonia,0,2,,2,-74.765343,10.970933
51693,2018,Abril,Polonia,0,2,,2,-74.213989,11.247722999999999
51694,2018,Abril,Polonia,0,1,,1,-72.129595,11.360028999999999
51695,2018,Abril,Polonia,1,0,,1,-81.70216500000001,12.5862
51696,2018,Abril,Polonia,8,1,,9,-76.532004,3.451668
51697,2018,Abril,Polonia,164,189,,353,-74.140516,4.697157
51698,2018,Abril,Polonia,11,19,,30,-75.42726,6.170465
51699,2018,Abril,Polonia,1,0,,1,-67.48402800000001,6.185536
51700,2018,Abril,Polonia,0,1,,1,-77.35002,8.63337
51701,2018,Abril,Portugal,0,1,,1,-69.941498,4.191162
51702,2018,Abril,Portugal,0,1,,1,-77.84700600000001,0.8124359999999999
51703,2018,Abril,Portugal,1,7,,8,-77.35600000000001,0.81488
51704,2018,Abril,Portugal,7,3,,10,-75.527794,10.406342
51705,2018,Abril,Portugal,19,32,,51,-75.516486,10.446304
51706,2018,Abril,Portugal,2,4,,6,-74.77647900000001,10.886686
51707,2018,Abril,Portugal,1,0,,1,-74.213989,11.247722999999999
51708,2018,Abril,Portugal,1,6,,7,-72.129595,11.360028999999999
51709,2018,Abril,Portugal,0,1,,1,-81.372937,13.338761300000002
51710,2018,Abril,Portugal,32,38,,70,-76.532004,3.451668
51711,2018,Abril,Portugal,217,512,,729,-74.140516,4.697157
51712,2018,Abril,Portugal,0,2,,2,-75.736374,4.815189
51713,2018,Abril,Portugal,32,55,,87,-75.42726,6.170465
51714,2018,Abril,Portugal,0,1,,1,-70.74025300000001,7.088728999999999
51715,2018,Abril,Portugal,1,0,,1,-73.181317,7.1280470000000005
51716,2018,Abril,Portugal,6,17,,23,-72.453013,7.819
51717,2018,Abril,Portugal,2,2,,4,-72.409396,8.36068
51718,2018,Abril,Qatar,1,3,,4,-75.516486,10.446304
51719,2018,Abril,Qatar,0,1,,1,-76.532004,3.451668
51720,2018,Abril,Qatar,0,1,,1,-74.140516,4.697157
51721,2018,Abril,Reino Unido de Gran Bretaña e Irlanda del Norte,3,15,,18,-69.941498,4.191162
51722,2018,Abril,Reino Unido de Gran Bretaña e Irlanda del Norte,11,10,,21,-69.94143100000001,4.214082
51723,2018,Abril,Reino Unido de Gran Bretaña e Irlanda del Norte,4,4,,8,-76.876446,0.33002
51724,2018,Abril,Reino Unido de Gran Bretaña e Irlanda del Norte,63,72,,135,-77.35600000000001,0.81488
51725,2018,Abril,Reino Unido de Gran Bretaña e Irlanda del Norte,28,36,,64,-75.527794,10.406342
51726,2018,Abril,Reino Unido de Gran Bretaña e Irlanda del Norte,113,179,,292,-75.516486,10.446304
51727,2018,Abril,Reino Unido de Gran Bretaña e Irlanda del Norte,9,31,,40,-74.77647900000001,10.886686
51728,2018,Abril,Reino Unido de Gran Bretaña e Irlanda del Norte,0,2,,2,-74.213989,11.247722999999999
51729,2018,Abril,Reino Unido de Gran Bretaña e Irlanda del Norte,0,2,,2,-72.129595,11.360028999999999
51730,2018,Abril,Reino Unido de Gran Bretaña e Irlanda del Norte,0,1,,1,-81.703935,12.574411099999999
51731,2018,Abril,Reino Unido de Gran Bretaña e Irlanda del Norte,3,1,,4,-81.70216500000001,12.5862
51732,2018,Abril,Reino Unido de Gran Bretaña e Irlanda del Norte,1,0,,1,-81.372937,13.338761300000002
51733,2018,Abril,Reino Unido de Gran Bretaña e Irlanda del Norte,15,43,,58,-76.532004,3.451668
51734,2018,Abril,Reino Unido de Gran Bretaña e Irlanda del Norte,1223,2063,,3286,-74.140516,4.697157
51735,2018,Abril,Reino Unido de Gran Bretaña e Irlanda del Norte,1,3,,4,-75.736374,4.815189
51736,2018,Abril,Reino Unido de Gran Bretaña e Irlanda del Norte,89,198,,287,-75.42726,6.170465
51737,2018,Abril,Reino Unido de Gran Bretaña e Irlanda del Norte,1,1,,2,-77.762647,7.102626
51738,2018,Abril,Reino Unido de Gran Bretaña e Irlanda del Norte,0,4,,4,-73.181317,7.1280470000000005
51739,2018,Abril,Reino Unido de Gran Bretaña e Irlanda del Norte,1,1,,2,-72.453013,7.819
51740,2018,Abril,Reino Unido de Gran Bretaña e Irlanda del Norte,2,0,,2,-72.508188,7.927233
51741,2018,Abril,Reino Unido de Gran Bretaña e Irlanda del Norte,1,1,,2,-72.409396,8.36068
51742,2018,Abril,Reino Unido de Gran Bretaña e Irlanda del Norte,19,25,,44,-77.35002,8.63337
51743,2018,Abril,República Dominicana,0,1,,1,-69.941498,4.191162
51744,2018,Abril,República Dominicana,2,13,,15,-77.35600000000001,0.81488
51745,2018,Abril,República Dominicana,13,9,,22,-75.527794,10.406342
51746,2018,Abril,República Dominicana,61,87,,148,-75.516486,10.446304
51747,2018,Abril,República Dominicana,22,29,,51,-74.77647900000001,10.886686
51748,2018,Abril,República Dominicana,3,4,,7,-72.129595,11.360028999999999
51749,2018,Abril,República Dominicana,1,1,,2,-81.70216500000001,12.5862
51750,2018,Abril,República Dominicana,26,23,,49,-76.532004,3.451668
51751,2018,Abril,República Dominicana,1,0,,1,-75.76635300000001,4.45285
51752,2018,Abril,República Dominicana,634,654,,1288,-74.140516,4.697157
51753,2018,Abril,República Dominicana,5,3,,8,-75.736374,4.815189
51754,2018,Abril,República Dominicana,63,74,,137,-75.42726,6.170465
51755,2018,Abril,República Dominicana,1,3,,4,-73.181317,7.1280470000000005
51756,2018,Abril,República Dominicana,1,1,,2,-72.453013,7.819
51757,2018,Abril,Rumania,1,0,,1,-77.35600000000001,0.81488
51758,2018,Abril,Rumania,1,9,,10,-75.527794,10.406342
51759,2018,Abril,Rumania,5,10,,15,-75.516486,10.446304
51760,2018,Abril,Rumania,0,1,,1,-74.765343,10.970933
51761,2018,Abril,Rumania,10,1,,11,-76.532004,3.451668
51762,2018,Abril,Rumania,0,1,,1,-77.061029,3.8844260000000004
51763,2018,Abril,Rumania,83,58,,141,-74.140516,4.697157
51764,2018,Abril,Rumania,8,14,,22,-75.42726,6.170465
51765,2018,Abril,Rumania,0,1,,1,-73.181317,7.1280470000000005
51766,2018,Abril,Federación de Rusia,2,0,,2,-69.94143100000001,4.214082
51767,2018,Abril,Federación de Rusia,3,5,,8,-77.35600000000001,0.81488
51768,2018,Abril,Federación de Rusia,1,8,,9,-75.527794,10.406342
51769,2018,Abril,Federación de Rusia,22,20,,42,-75.516486,10.446304
51770,2018,Abril,Federación de Rusia,1,2,,3,-74.77647900000001,10.886686
51771,2018,Abril,Federación de Rusia,0,3,,3,-74.765343,10.970933
51772,2018,Abril,Federación de Rusia,4,0,,4,-81.70216500000001,12.5862
51773,2018,Abril,Federación de Rusia,4,3,,7,-76.532004,3.451668
51774,2018,Abril,Federación de Rusia,156,194,,350,-74.140516,4.697157
51775,2018,Abril,Federación de Rusia,16,21,,37,-75.42726,6.170465
51776,2018,Abril,Federación de Rusia,0,2,,2,-72.453013,7.819
51777,2018,Abril,Federación de Rusia,0,1,,1,-75.68164200000001,9.402597
51778,2018,Abril,Rwanda,1,1,,2,-74.140516,4.697157
51779,2018,Abril,San Cristóbal y Nevis,3,3,,6,-74.140516,4.697157
51780,2018,Abril,San Cristóbal y Nevis,0,1,,1,-72.508188,7.927233
51781,2018,Abril,San Marino,1,1,,2,-74.140516,4.697157
51782,2018,Abril,San Marino,0,1,,1,-75.42726,6.170465
51783,2018,Abril,San  Vicente y las Granadinas,0,1,,1,-75.516486,10.446304
51784,2018,Abril,San  Vicente y las Granadinas,0,2,,2,-74.77647900000001,10.886686
51785,2018,Abril,Santa Lucia,3,8,,11,-74.140516,4.697157
51786,2018,Abril,Santa Sede/Ciudad del Vaticano,0,2,,2,-74.140516,4.697157
51787,2018,Abril,Senegal,0,1,,1,-72.129595,11.360028999999999
51788,2018,Abril,Senegal,0,2,,2,-74.140516,4.697157
51789,2018,Abril,Serbia,1,3,,4,-75.516486,10.446304
51790,2018,Abril,Serbia,0,1,,1,-76.532004,3.451668
51791,2018,Abril,Serbia,11,27,,38,-74.140516,4.697157
51792,2018,Abril,Serbia,0,2,,2,-75.42726,6.170465
51793,2018,Abril,Seychelles,0,1,,1,-74.140516,4.697157
51794,2018,Abril,Sierra Leona,0,1,,1,-74.140516,4.697157
51795,2018,Abril,Singapur,2,0,,2,-77.35600000000001,0.81488
51796,2018,Abril,Singapur,1,3,,4,-75.516486,10.446304
51797,2018,Abril,Singapur,0,1,,1,-74.77647900000001,10.886686
51798,2018,Abril,Singapur,16,22,,38,-74.140516,4.697157
51799,2018,Abril,Singapur,1,0,,1,-75.736374,4.815189
51800,2018,Abril,Singapur,3,6,,9,-75.42726,6.170465
51801,2018,Abril,Singapur,0,1,,1,-72.409396,8.36068
51802,2018,Abril,República Árabe Siria,0,5,,5,-74.140516,4.697157
51803,2018,Abril,Sri Lanka,2,0,,2,-75.516486,10.446304
51804,2018,Abril,Sri Lanka,0,1,,1,-74.765343,10.970933
51805,2018,Abril,Sri Lanka,1,3,,4,-74.140516,4.697157
51806,2018,Abril,Sudáfrica,2,7,,9,-75.527794,10.406342
51807,2018,Abril,Sudáfrica,2,5,,7,-75.516486,10.446304
51808,2018,Abril,Sudáfrica,1,5,,6,-74.77647900000001,10.886686
51809,2018,Abril,Sudáfrica,16,49,,65,-74.140516,4.697157
51810,2018,Abril,Sudáfrica,2,5,,7,-75.42726,6.170465
51811,2018,Abril,Sudán,0,2,,2,-74.140516,4.697157
51812,2018,Abril,Suecia,2,3,,5,-76.876446,0.33002
51813,2018,Abril,Suecia,12,14,,26,-77.35600000000001,0.81488
51814,2018,Abril,Suecia,5,7,,12,-75.527794,10.406342
51815,2018,Abril,Suecia,16,24,,40,-75.516486,10.446304
51816,2018,Abril,Suecia,1,5,,6,-74.77647900000001,10.886686
51817,2018,Abril,Suecia,3,9,,12,-74.213989,11.247722999999999
51818,2018,Abril,Suecia,2,0,,2,-72.129595,11.360028999999999
51819,2018,Abril,Suecia,1,0,,1,-81.372937,13.338761300000002
51820,2018,Abril,Suecia,11,8,,19,-76.532004,3.451668
51821,2018,Abril,Suecia,186,256,,442,-74.140516,4.697157
51822,2018,Abril,Suecia,19,39,,58,-75.42726,6.170465
51823,2018,Abril,Suecia,1,0,,1,-73.181317,7.1280470000000005
51824,2018,Abril,Suecia,0,1,,1,-72.453013,7.819
51825,2018,Abril,Suecia,2,3,,5,-77.35002,8.63337
51826,2018,Abril,Suiza,6,4,,10,-69.941498,4.191162
51827,2018,Abril,Suiza,2,4,,6,-69.94143100000001,4.214082
51828,2018,Abril,Suiza,0,1,,1,-76.876446,0.33002
51829,2018,Abril,Suiza,13,16,,29,-77.35600000000001,0.81488
51830,2018,Abril,Suiza,24,18,,42,-75.527794,10.406342
51831,2018,Abril,Suiza,67,54,,121,-75.516486,10.446304
51832,2018,Abril,Suiza,2,4,,6,-74.77647900000001,10.886686
51833,2018,Abril,Suiza,2,5,,7,-74.213989,11.247722999999999
51834,2018,Abril,Suiza,0,1,,1,-72.129595,11.360028999999999
51835,2018,Abril,Suiza,3,4,,7,-81.70216500000001,12.5862
51836,2018,Abril,Suiza,22,32,,54,-76.532004,3.451668
51837,2018,Abril,Suiza,436,679,,1115,-74.140516,4.697157
51838,2018,Abril,Suiza,35,66,,101,-75.42726,6.170465
51839,2018,Abril,Suiza,2,4,,6,-72.453013,7.819
51840,2018,Abril,Suiza,6,9,,15,-77.35002,8.63337
51841,2018,Abril,Surinam,25,25,,50,-74.140516,4.697157
51842,2018,Abril,Surinam,1,3,,4,-75.42726,6.170465
51843,2018,Abril,Taiwán,1,0,,1,-74.140516,4.697157
51844,2018,Abril,Tailandia,1,2,,3,-75.516486,10.446304
51845,2018,Abril,Tailandia,2,0,,2,-76.532004,3.451668
51846,2018,Abril,Tailandia,35,31,,66,-74.140516,4.697157
51847,2018,Abril,Tailandia,2,0,,2,-75.42726,6.170465
51848,2018,Abril,Tailandia,1,0,,1,-77.35002,8.63337
51849,2018,Abril,Tanzania,0,1,,1,-74.140516,4.697157
51850,2018,Abril,Togo,0,1,,1,-75.516486,10.446304
51851,2018,Abril,Trinidad y Tobago,14,15,,29,-75.516486,10.446304
51852,2018,Abril,Trinidad y Tobago,2,4,,6,-74.77647900000001,10.886686
51853,2018,Abril,Trinidad y Tobago,3,3,,6,-76.532004,3.451668
51854,2018,Abril,Trinidad y Tobago,23,43,,66,-74.140516,4.697157
51855,2018,Abril,Trinidad y Tobago,0,2,,2,-75.736374,4.815189
51856,2018,Abril,Trinidad y Tobago,2,7,,9,-75.42726,6.170465
51857,2018,Abril,Trinidad y Tobago,0,3,,3,-73.181317,7.1280470000000005
51858,2018,Abril,Trinidad y Tobago,0,1,,1,-72.453013,7.819
51859,2018,Abril,Trinidad y Tobago,1,1,,2,-72.508188,7.927233
51860,2018,Abril,Túnez,1,0,,1,-76.532004,3.451668
51861,2018,Abril,Túnez,3,9,,12,-74.140516,4.697157
51862,2018,Abril,Turquía,1,0,,1,-69.94143100000001,4.214082
51863,2018,Abril,Turquía,1,3,,4,-77.35600000000001,0.81488
51864,2018,Abril,Turquía,0,1,,1,-75.527794,10.406342
51865,2018,Abril,Turquía,2,14,,16,-75.516486,10.446304
51866,2018,Abril,Turquía,1,0,,1,-74.77647900000001,10.886686
51867,2018,Abril,Turquía,0,7,,7,-74.765343,10.970933
51868,2018,Abril,Turquía,0,3,,3,-74.213989,11.247722999999999
51869,2018,Abril,Turquía,0,5,,5,-76.532004,3.451668
51870,2018,Abril,Turquía,197,390,,587,-74.140516,4.697157
51871,2018,Abril,Turquía,8,22,,30,-75.42726,6.170465
51872,2018,Abril,Turquía,0,2,,2,-75.68164200000001,9.402597
51873,2018,Abril,Ucrania,0,4,,4,-75.527794,10.406342
51874,2018,Abril,Ucrania,2,5,,7,-75.516486,10.446304
51875,2018,Abril,Ucrania,0,7,,7,-74.77647900000001,10.886686
51876,2018,Abril,Ucrania,0,5,,5,-74.765343,10.970933
51877,2018,Abril,Ucrania,0,2,,2,-74.213989,11.247722999999999
51878,2018,Abril,Ucrania,0,1,,1,-76.532004,3.451668
51879,2018,Abril,Ucrania,0,1,,1,-77.061029,3.8844260000000004
51880,2018,Abril,Ucrania,24,18,,42,-74.140516,4.697157
51881,2018,Abril,Ucrania,3,4,,7,-75.42726,6.170465
51882,2018,Abril,Ucrania,0,1,,1,-75.68164200000001,9.402597
51883,2018,Abril,Uganda,1,0,,1,-75.516486,10.446304
51884,2018,Abril,Uganda,0,1,,1,-74.140516,4.697157
51885,2018,Abril,Uganda,1,0,,1,-75.42726,6.170465
51886,2018,Abril,Uruguay,1,0,,1,-69.941498,4.191162
51887,2018,Abril,Uruguay,1,2,,3,-69.94143100000001,4.214082
51888,2018,Abril,Uruguay,0,1,,1,-76.876446,0.33002
51889,2018,Abril,Uruguay,9,13,,22,-77.35600000000001,0.81488
51890,2018,Abril,Uruguay,42,21,,63,-75.527794,10.406342
51891,2018,Abril,Uruguay,127,94,,221,-75.516486,10.446304
51892,2018,Abril,Uruguay,2,9,,11,-74.77647900000001,10.886686
51893,2018,Abril,Uruguay,0,1,,1,-72.129595,11.360028999999999
51894,2018,Abril,Uruguay,18,16,,34,-81.70216500000001,12.5862
51895,2018,Abril,Uruguay,11,64,,75,-76.532004,3.451668
51896,2018,Abril,Uruguay,0,1,,1,-75.76635300000001,4.45285
51897,2018,Abril,Uruguay,573,781,,1354,-74.140516,4.697157
51898,2018,Abril,Uruguay,3,4,,7,-75.736374,4.815189
51899,2018,Abril,Uruguay,45,78,,123,-75.42726,6.170465
51900,2018,Abril,Uruguay,0,2,,2,-73.181317,7.1280470000000005
51901,2018,Abril,Uruguay,5,11,,16,-72.453013,7.819
51902,2018,Abril,Uruguay,0,1,,1,-72.409396,8.36068
51903,2018,Abril,Uzbekistán,1,0,,1,-75.42726,6.170465
51904,2018,Abril,Venezuela,1,6,,7,-69.941498,4.191162
51905,2018,Abril,Venezuela,39,51,,90,-76.876446,0.33002
51906,2018,Abril,Venezuela,6,1,,7,-77.84700600000001,0.8124359999999999
51907,2018,Abril,Venezuela,1590,2241,,3831,-77.35600000000001,0.81488
51908,2018,Abril,Venezuela,1,3,,4,-78.802679,18.00143
51909,2018,Abril,Venezuela,7,36,,43,-75.527794,10.406342
51910,2018,Abril,Venezuela,15,35,,50,-73.247863,10.433608999999999
51911,2018,Abril,Venezuela,114,155,,269,-75.516486,10.446304
51912,2018,Abril,Venezuela,92,165,,257,-74.77647900000001,10.886686
51913,2018,Abril,Venezuela,8,19,,27,-74.232675,11.117206
51914,2018,Abril,Venezuela,8482,9745,,18227,-72.129595,11.360028999999999
51915,2018,Abril,Venezuela,6,6,,12,-72.919186,11.52863
51916,2018,Abril,Venezuela,4,1,,5,-81.70216500000001,12.5862
51917,2018,Abril,Venezuela,64,98,,162,-76.532004,3.451668
51918,2018,Abril,Venezuela,11,10,,21,-67.927521,3.866713
51919,2018,Abril,Venezuela,0,1,,1,-75.76635300000001,4.45285
51920,2018,Abril,Venezuela,5750,6043,,11793,-74.140516,4.697157
51921,2018,Abril,Venezuela,7,7,,14,-75.736374,4.815189
51922,2018,Abril,Venezuela,1446,1683,,3129,-75.42726,6.170465
51923,2018,Abril,Venezuela,73,48,,121,-67.48402800000001,6.185536
51924,2018,Abril,Venezuela,4,10,,14,-75.586989,6.2188349999999994
51925,2018,Abril,Venezuela,896,1176,,2072,-70.74025300000001,7.088728999999999
51926,2018,Abril,Venezuela,25,31,,56,-73.181317,7.1280470000000005
51927,2018,Abril,Venezuela,34810,42529,,77339,-72.453013,7.819
51928,2018,Abril,Venezuela,12,25,,37,-72.508188,7.927233
51929,2018,Abril,Venezuela,2660,2901,,5561,-72.409396,8.36068
51930,2018,Abril,Vietnam,1,1,,2,-75.516486,10.446304
51931,2018,Abril,Vietnam,2,0,,2,-76.532004,3.451668
51932,2018,Abril,Vietnam,2,5,,7,-74.140516,4.697157
51933,2018,Abril,Vietnam,1,0,,1,-75.42726,6.170465
51934,2018,Abril,Islas Vírgenes Británicas/Territorio Británico de Ultramar,0,1,,1,-75.42726,6.170465
51935,2018,Abril,República Árabe de Yemen,0,1,,1,-77.35600000000001,0.81488
51936,2018,Abril,República Árabe de Yemen,0,3,,3,-74.140516,4.697157
51937,2018,Abril,Zambia,1,0,,1,-75.516486,10.446304
51938,2018,Abril,Zambia,0,1,,1,-74.140516,4.697157
51939,2018,Abril,Zimbabue,0,1,,1,-76.532004,3.451668
51940,2018,Abril,Zimbabue,0,3,,3,-74.140516,4.697157
51941,2018,Abril,Anguila/Territorio Británico de Ultramar,1,0,,1,-74.140516,4.697157
51942,2018,Abril,Refugiado,1,0,,1,-76.532004,3.451668
51943,2018,Abril,Refugiado,7,4,,11,-74.140516,4.697157
51944,2018,Abril,Refugiado,2,3,,5,-75.42726,6.170465
51945,2018,Abril,Desconocido,19,23,,42,-75.516486,10.446304
51946,2018,Abril,Desconocido,0,1,,1,-74.77647900000001,10.886686
51947,2018,Abril,Desconocido,0,1,,1,-76.532004,3.451668
51948,2018,Abril,Desconocido,98,176,,274,-74.140516,4.697157
51949,2018,Abril,Desconocido,0,6,,6,-75.42726,6.170465
51950,2018,Abril,República CentroÁfricana,1,0,,1,-74.140516,4.697157
51951,2018,Mayo,Albania,1,3,,4,-74.140516,4.697157
51952,2018,Mayo,Albania,1,0,,1,-75.42726,6.170465
51953,2018,Mayo,Alemania,5,4,,9,-69.941498,4.191162
51954,2018,Mayo,Alemania,15,20,,35,-69.94143100000001,4.214082
51955,2018,Mayo,Alemania,8,3,,11,-76.876446,0.33002
51956,2018,Mayo,Alemania,68,99,,167,-77.35600000000001,0.81488
51957,2018,Mayo,Alemania,20,40,,60,-75.527794,10.406342
51958,2018,Mayo,Alemania,107,166,,273,-75.516486,10.446304
51959,2018,Mayo,Alemania,22,23,,45,-74.77647900000001,10.886686
51960,2018,Mayo,Alemania,0,2,,2,-74.765343,10.970933
51961,2018,Mayo,Alemania,1,2,,3,-74.213989,11.247722999999999
51962,2018,Mayo,Alemania,1,6,,7,-72.129595,11.360028999999999
51963,2018,Mayo,Alemania,1,3,,4,-81.70216500000001,12.5862
51964,2018,Mayo,Alemania,1,5,,6,-81.372937,13.338761300000002
51965,2018,Mayo,Alemania,43,48,,91,-76.532004,3.451668
51966,2018,Mayo,Alemania,0,2,,2,-77.061029,3.8844260000000004
51967,2018,Mayo,Alemania,0,1,,1,-75.76635300000001,4.45285
51968,2018,Mayo,Alemania,1455,2189,,3644,-74.140516,4.697157
51969,2018,Mayo,Alemania,1,5,,6,-75.736374,4.815189
51970,2018,Mayo,Alemania,81,189,,270,-75.42726,6.170465
51971,2018,Mayo,Alemania,1,3,,4,-73.181317,7.1280470000000005
51972,2018,Mayo,Alemania,1,1,,2,-72.409396,8.36068
51973,2018,Mayo,Alemania,9,6,,15,-77.35002,8.63337
51974,2018,Mayo,Andorra,0,2,,2,-75.516486,10.446304
51975,2018,Mayo,Andorra,1,7,,8,-74.140516,4.697157
51976,2018,Mayo,Antigua y Barbuda,0,1,,1,-75.516486,10.446304
51977,2018,Mayo,Antigua y Barbuda,1,7,,8,-74.140516,4.697157
51978,2018,Mayo,Antigua y Barbuda,0,2,,2,-75.42726,6.170465
51979,2018,Mayo,Países Bajos,0,1,,1,-74.77647900000001,10.886686
51980,2018,Mayo,Arabia Saudita,0,6,,6,-74.140516,4.697157
51981,2018,Mayo,Arabia Saudita,0,1,,1,-75.42726,6.170465
51982,2018,Mayo,Argelia,1,0,,1,-75.516486,10.446304
51983,2018,Mayo,Argelia,1,0,,1,-76.532004,3.451668
51984,2018,Mayo,Argelia,2,2,,4,-74.140516,4.697157
51985,2018,Mayo,Argentina,3,6,,9,-69.941498,4.191162
51986,2018,Mayo,Argentina,3,6,,9,-69.94143100000001,4.214082
51987,2018,Mayo,Argentina,9,23,,32,-76.876446,0.33002
51988,2018,Mayo,Argentina,83,117,,200,-77.35600000000001,0.81488
51989,2018,Mayo,Argentina,118,84,,202,-75.527794,10.406342
51990,2018,Mayo,Argentina,1973,1283,,3256,-75.516486,10.446304
51991,2018,Mayo,Argentina,22,45,,67,-74.77647900000001,10.886686
51992,2018,Mayo,Argentina,4,5,,9,-72.129595,11.360028999999999
51993,2018,Mayo,Argentina,295,209,,504,-81.70216500000001,12.5862
51994,2018,Mayo,Argentina,35,55,,90,-76.532004,3.451668
51995,2018,Mayo,Argentina,1,1,,2,-67.927521,3.866713
51996,2018,Mayo,Argentina,0,2,,2,-75.76635300000001,4.45285
51997,2018,Mayo,Argentina,5368,6258,,11626,-74.140516,4.697157
51998,2018,Mayo,Argentina,3,9,,12,-75.736374,4.815189
51999,2018,Mayo,Argentina,254,476,,730,-75.42726,6.170465
52000,2018,Mayo,Argentina,0,1,,1,-70.74025300000001,7.088728999999999
52001,2018,Mayo,Argentina,2,3,,5,-73.181317,7.1280470000000005
52002,2018,Mayo,Argentina,7,13,,20,-72.453013,7.819
52003,2018,Mayo,Argentina,0,3,,3,-72.409396,8.36068
52004,2018,Mayo,Argentina,0,2,,2,-77.35002,8.63337
52005,2018,Mayo,República de Armenia,1,0,,1,-76.532004,3.451668
52006,2018,Mayo,República de Armenia,1,2,,3,-74.140516,4.697157
52007,2018,Mayo,República de Armenia,1,0,,1,-75.42726,6.170465
52008,2018,Mayo,Australia,0,1,,1,-69.941498,4.191162
52009,2018,Mayo,Australia,3,2,,5,-69.94143100000001,4.214082
52010,2018,Mayo,Australia,16,32,,48,-77.35600000000001,0.81488
52011,2018,Mayo,Australia,15,20,,35,-75.527794,10.406342
52012,2018,Mayo,Australia,47,73,,120,-75.516486,10.446304
52013,2018,Mayo,Australia,7,25,,32,-74.77647900000001,10.886686
52014,2018,Mayo,Australia,0,1,,1,-72.129595,11.360028999999999
52015,2018,Mayo,Australia,1,0,,1,-81.70216500000001,12.5862
52016,2018,Mayo,Australia,7,14,,21,-76.532004,3.451668
52017,2018,Mayo,Australia,311,532,,843,-74.140516,4.697157
52018,2018,Mayo,Australia,48,100,,148,-75.42726,6.170465
52019,2018,Mayo,Australia,1,1,,2,-73.181317,7.1280470000000005
52020,2018,Mayo,Australia,0,1,,1,-72.453013,7.819
52021,2018,Mayo,Australia,10,6,,16,-77.35002,8.63337
52022,2018,Mayo,Austria,1,0,,1,-69.94143100000001,4.214082
52023,2018,Mayo,Austria,2,1,,3,-76.876446,0.33002
52024,2018,Mayo,Austria,9,8,,17,-77.35600000000001,0.81488
52025,2018,Mayo,Austria,2,3,,5,-75.527794,10.406342
52026,2018,Mayo,Austria,12,17,,29,-75.516486,10.446304
52027,2018,Mayo,Austria,2,0,,2,-74.77647900000001,10.886686
52028,2018,Mayo,Austria,0,1,,1,-74.213989,11.247722999999999
52029,2018,Mayo,Austria,8,11,,19,-76.532004,3.451668
52030,2018,Mayo,Austria,122,240,,362,-74.140516,4.697157
52031,2018,Mayo,Austria,1,1,,2,-75.736374,4.815189
52032,2018,Mayo,Austria,8,27,,35,-75.42726,6.170465
52033,2018,Mayo,Austria,2,0,,2,-77.35002,8.63337
52034,2018,Mayo,Azerbaiyán,2,1,,3,-75.516486,10.446304
52035,2018,Mayo,Azerbaiyán,0,5,,5,-74.140516,4.697157
52036,2018,Mayo,Azerbaiyán,0,2,,2,-75.42726,6.170465
52037,2018,Mayo,Bahamas,2,10,,12,-75.516486,10.446304
52038,2018,Mayo,Bahamas,0,3,,3,-74.77647900000001,10.886686
52039,2018,Mayo,Bahamas,2,1,,3,-76.532004,3.451668
52040,2018,Mayo,Bahamas,1,8,,9,-74.140516,4.697157
52041,2018,Mayo,Bahamas,0,2,,2,-75.42726,6.170465
52042,2018,Mayo,Bahréin,0,1,,1,-74.140516,4.697157
52043,2018,Mayo,Bangladesh,4,1,,5,-74.140516,4.697157
52044,2018,Mayo,Barbados,2,1,,3,-75.516486,10.446304
52045,2018,Mayo,Barbados,2,2,,4,-74.77647900000001,10.886686
52046,2018,Mayo,Barbados,2,1,,3,-76.532004,3.451668
52047,2018,Mayo,Barbados,14,19,,33,-74.140516,4.697157
52048,2018,Mayo,Barbados,1,1,,2,-75.42726,6.170465
52049,2018,Mayo,República de Belarús,2,0,,2,-75.516486,10.446304
52050,2018,Mayo,República de Belarús,6,1,,7,-74.140516,4.697157
52051,2018,Mayo,República de Belarús,1,0,,1,-77.762647,7.102626
52052,2018,Mayo,Bélgica,0,1,,1,-69.941498,4.191162
52053,2018,Mayo,Bélgica,2,5,,7,-69.94143100000001,4.214082
52054,2018,Mayo,Bélgica,0,1,,1,-76.876446,0.33002
52055,2018,Mayo,Bélgica,11,23,,34,-77.35600000000001,0.81488
52056,2018,Mayo,Bélgica,5,4,,9,-75.527794,10.406342
52057,2018,Mayo,Bélgica,26,45,,71,-75.516486,10.446304
52058,2018,Mayo,Bélgica,1,7,,8,-74.77647900000001,10.886686
52059,2018,Mayo,Bélgica,1,0,,1,-72.129595,11.360028999999999
52060,2018,Mayo,Bélgica,0,1,,1,-81.372937,13.338761300000002
52061,2018,Mayo,Bélgica,11,14,,25,-76.532004,3.451668
52062,2018,Mayo,Bélgica,0,8,,8,-77.061029,3.8844260000000004
52063,2018,Mayo,Bélgica,150,305,,455,-74.140516,4.697157
52064,2018,Mayo,Bélgica,21,38,,59,-75.42726,6.170465
52065,2018,Mayo,Bélgica,0,1,,1,-73.181317,7.1280470000000005
52066,2018,Mayo,Bélgica,0,2,,2,-72.453013,7.819
52067,2018,Mayo,Bélgica,3,0,,3,-77.35002,8.63337
52068,2018,Mayo,Belice,0,1,,1,-77.35600000000001,0.81488
52069,2018,Mayo,Belice,0,2,,2,-75.516486,10.446304
52070,2018,Mayo,Belice,1,0,,1,-81.70216500000001,12.5862
52071,2018,Mayo,Belice,0,1,,1,-76.532004,3.451668
52072,2018,Mayo,Belice,2,5,,7,-74.140516,4.697157
52073,2018,Mayo,Belice,5,1,,6,-75.42726,6.170465
52074,2018,Mayo,Bermudas/Territorio Británico de Ultramar,2,1,,3,-75.516486,10.446304
52075,2018,Mayo,Bermudas/Territorio Británico de Ultramar,0,1,,1,-76.532004,3.451668
52076,2018,Mayo,Bolivia,1,0,,1,-69.941498,4.191162
52077,2018,Mayo,Bolivia,0,1,,1,-76.876446,0.33002
52078,2018,Mayo,Bolivia,1,0,,1,-77.84700600000001,0.8124359999999999
52079,2018,Mayo,Bolivia,16,16,,32,-77.35600000000001,0.81488
52080,2018,Mayo,Bolivia,1,1,,2,-75.527794,10.406342
52081,2018,Mayo,Bolivia,185,100,,285,-75.516486,10.446304
52082,2018,Mayo,Bolivia,1,2,,3,-74.77647900000001,10.886686
52083,2018,Mayo,Bolivia,41,14,,55,-81.70216500000001,12.5862
52084,2018,Mayo,Bolivia,9,10,,19,-76.532004,3.451668
52085,2018,Mayo,Bolivia,0,1,,1,-75.76635300000001,4.45285
52086,2018,Mayo,Bolivia,504,486,,990,-74.140516,4.697157
52087,2018,Mayo,Bolivia,3,3,,6,-75.736374,4.815189
52088,2018,Mayo,Bolivia,38,34,,72,-75.42726,6.170465
52089,2018,Mayo,Bolivia,0,1,,1,-73.181317,7.1280470000000005
52090,2018,Mayo,Bolivia,0,6,,6,-72.453013,7.819
52091,2018,Mayo,Bosnia y Herzegovina,2,1,,3,-75.516486,10.446304
52092,2018,Mayo,Bosnia y Herzegovina,4,7,,11,-74.140516,4.697157
52093,2018,Mayo,Botsuana,0,1,,1,-74.140516,4.697157
52094,2018,Mayo,Brasil,98,102,,200,-69.941498,4.191162
52095,2018,Mayo,Brasil,4,3,,7,-69.94143100000001,4.214082
52096,2018,Mayo,Brasil,0,2,,2,-76.876446,0.33002
52097,2018,Mayo,Brasil,19,29,,48,-77.35600000000001,0.81488
52098,2018,Mayo,Brasil,122,71,,193,-75.527794,10.406342
52099,2018,Mayo,Brasil,878,649,,1527,-75.516486,10.446304
52100,2018,Mayo,Brasil,20,27,,47,-74.77647900000001,10.886686
52101,2018,Mayo,Brasil,1,1,,2,-72.129595,11.360028999999999
52102,2018,Mayo,Brasil,292,223,,515,-81.70216500000001,12.5862
52103,2018,Mayo,Brasil,43,53,,96,-76.532004,3.451668
52104,2018,Mayo,Brasil,4,6,,10,-67.927521,3.866713
52105,2018,Mayo,Brasil,5559,6701,,12260,-74.140516,4.697157
52106,2018,Mayo,Brasil,2,6,,8,-75.736374,4.815189
52107,2018,Mayo,Brasil,125,249,,374,-75.42726,6.170465
52108,2018,Mayo,Brasil,0,1,,1,-67.48402800000001,6.185536
52109,2018,Mayo,Brasil,0,2,,2,-73.181317,7.1280470000000005
52110,2018,Mayo,Brasil,1,9,,10,-72.453013,7.819
52111,2018,Mayo,Brasil,0,4,,4,-72.409396,8.36068
52112,2018,Mayo,Brasil,0,1,,1,-77.35002,8.63337
52113,2018,Mayo,Brunei Darussalam,1,0,,1,-74.140516,4.697157
52114,2018,Mayo,Bulgaria,1,1,,2,-76.876446,0.33002
52115,2018,Mayo,Bulgaria,1,2,,3,-77.35600000000001,0.81488
52116,2018,Mayo,Bulgaria,3,1,,4,-75.516486,10.446304
52117,2018,Mayo,Bulgaria,1,0,,1,-74.77647900000001,10.886686
52118,2018,Mayo,Bulgaria,3,2,,5,-76.532004,3.451668
52119,2018,Mayo,Bulgaria,40,39,,79,-74.140516,4.697157
52120,2018,Mayo,Bulgaria,2,4,,6,-75.42726,6.170465
52121,2018,Mayo,Burkina Faso,0,2,,2,-74.140516,4.697157
52122,2018,Mayo,Burkina Faso,1,0,,1,-75.42726,6.170465
52123,2018,Mayo,Bután,0,1,,1,-75.516486,10.446304
52124,2018,Mayo,Islas Caimán/Territorio Británico de Ultramar,1,0,,1,-75.516486,10.446304
52125,2018,Mayo,Islas Caimán/Territorio Británico de Ultramar,1,0,,1,-74.77647900000001,10.886686
52126,2018,Mayo,Islas Caimán/Territorio Británico de Ultramar,0,1,,1,-81.70216500000001,12.5862
52127,2018,Mayo,Islas Caimán/Territorio Británico de Ultramar,4,1,,5,-74.140516,4.697157
52128,2018,Mayo,Islas Caimán/Territorio Británico de Ultramar,0,1,,1,-75.42726,6.170465
52129,2018,Mayo,Camboya,0,1,,1,-75.516486,10.446304
52130,2018,Mayo,Camerún,0,1,,1,-75.516486,10.446304
52131,2018,Mayo,Camerún,0,4,,4,-74.140516,4.697157
52132,2018,Mayo,Camerún,1,1,,2,-75.42726,6.170465
52133,2018,Mayo,Canadá,2,2,,4,-69.941498,4.191162
52134,2018,Mayo,Canadá,10,7,,17,-69.94143100000001,4.214082
52135,2018,Mayo,Canadá,0,1,,1,-76.876446,0.33002
52136,2018,Mayo,Canadá,0,1,,1,-77.84700600000001,0.8124359999999999
52137,2018,Mayo,Canadá,18,10,,28,-77.35600000000001,0.81488
52138,2018,Mayo,Canadá,15,14,,29,-75.527794,10.406342
52139,2018,Mayo,Canadá,208,224,,432,-75.516486,10.446304
52140,2018,Mayo,Canadá,29,48,,77,-74.77647900000001,10.886686
52141,2018,Mayo,Canadá,0,1,,1,-72.129595,11.360028999999999
52142,2018,Mayo,Canadá,3,3,,6,-81.70216500000001,12.5862
52143,2018,Mayo,Canadá,1,0,,1,-81.372937,13.338761300000002
52144,2018,Mayo,Canadá,52,67,,119,-76.532004,3.451668
52145,2018,Mayo,Canadá,2,2,,4,-75.76635300000001,4.45285
52146,2018,Mayo,Canadá,1059,1608,,2667,-74.140516,4.697157
52147,2018,Mayo,Canadá,22,17,,39,-75.736374,4.815189
52148,2018,Mayo,Canadá,194,404,,598,-75.42726,6.170465
52149,2018,Mayo,Canadá,0,2,,2,-67.48402800000001,6.185536
52150,2018,Mayo,Canadá,2,5,,7,-73.181317,7.1280470000000005
52151,2018,Mayo,Canadá,1,8,,9,-72.453013,7.819
52152,2018,Mayo,Canadá,7,3,,10,-77.35002,8.63337
52153,2018,Mayo,República Del Congo,0,1,,1,-77.35600000000001,0.81488
52154,2018,Mayo,República Democrática del Congo,1,0,,1,-77.35600000000001,0.81488
52155,2018,Mayo,República Democrática del Congo,0,1,,1,-75.516486,10.446304
52156,2018,Mayo,República Democrática del Congo,5,3,,8,-74.140516,4.697157
52157,2018,Mayo,República Democrática del Congo,1,0,,1,-75.42726,6.170465
52158,2018,Mayo,República de Corea,0,1,,1,-76.876446,0.33002
52159,2018,Mayo,República de Corea,13,17,,30,-77.35600000000001,0.81488
52160,2018,Mayo,República de Corea,0,1,,1,-75.527794,10.406342
52161,2018,Mayo,República de Corea,10,9,,19,-75.516486,10.446304
52162,2018,Mayo,República de Corea,0,3,,3,-74.77647900000001,10.886686
52163,2018,Mayo,República de Corea,1,1,,2,-72.129595,11.360028999999999
52164,2018,Mayo,República de Corea,7,17,,24,-76.532004,3.451668
52165,2018,Mayo,República de Corea,190,381,,571,-74.140516,4.697157
52166,2018,Mayo,República de Corea,0,1,,1,-75.736374,4.815189
52167,2018,Mayo,República de Corea,13,29,,42,-75.42726,6.170465
52168,2018,Mayo,República de Corea,2,0,,2,-72.453013,7.819
52169,2018,Mayo,Costa de Marfil,0,1,,1,-74.140516,4.697157
52170,2018,Mayo,Costa de Marfil,0,1,,1,-75.42726,6.170465
52171,2018,Mayo,Costa Rica,2,2,,4,-77.35600000000001,0.81488
52172,2018,Mayo,Costa Rica,0,1,,1,-78.802679,18.00143
52173,2018,Mayo,Costa Rica,159,113,,272,-75.516486,10.446304
52174,2018,Mayo,Costa Rica,22,25,,47,-74.77647900000001,10.886686
52175,2018,Mayo,Costa Rica,1,0,,1,-72.129595,11.360028999999999
52176,2018,Mayo,Costa Rica,45,39,,84,-81.70216500000001,12.5862
52177,2018,Mayo,Costa Rica,24,47,,71,-76.532004,3.451668
52178,2018,Mayo,Costa Rica,0,1,,1,-77.061029,3.8844260000000004
52179,2018,Mayo,Costa Rica,0,1,,1,-75.76635300000001,4.45285
52180,2018,Mayo,Costa Rica,1282,1795,,3077,-74.140516,4.697157
52181,2018,Mayo,Costa Rica,7,2,,9,-75.736374,4.815189
52182,2018,Mayo,Costa Rica,160,217,,377,-75.42726,6.170465
52183,2018,Mayo,Costa Rica,0,4,,4,-75.586989,6.2188349999999994
52184,2018,Mayo,Costa Rica,0,2,,2,-73.181317,7.1280470000000005
52185,2018,Mayo,Costa Rica,1,0,,1,-72.453013,7.819
52186,2018,Mayo,Croacia,2,1,,3,-75.516486,10.446304
52187,2018,Mayo,Croacia,0,2,,2,-74.77647900000001,10.886686
52188,2018,Mayo,Croacia,0,1,,1,-76.532004,3.451668
52189,2018,Mayo,Croacia,0,6,,6,-77.061029,3.8844260000000004
52190,2018,Mayo,Croacia,10,40,,50,-74.140516,4.697157
52191,2018,Mayo,Croacia,1,5,,6,-75.42726,6.170465
52192,2018,Mayo,Cuba,1,0,,1,-69.941498,4.191162
52193,2018,Mayo,Cuba,0,1,,1,-77.35600000000001,0.81488
52194,2018,Mayo,Cuba,0,2,,2,-75.527794,10.406342
52195,2018,Mayo,Cuba,13,19,,32,-75.516486,10.446304
52196,2018,Mayo,Cuba,7,21,,28,-74.77647900000001,10.886686
52197,2018,Mayo,Cuba,0,1,,1,-74.213989,11.247722999999999
52198,2018,Mayo,Cuba,21,23,,44,-76.532004,3.451668
52199,2018,Mayo,Cuba,0,1,,1,-75.76635300000001,4.45285
52200,2018,Mayo,Cuba,178,319,,497,-74.140516,4.697157
52201,2018,Mayo,Cuba,1,4,,5,-75.736374,4.815189
52202,2018,Mayo,Cuba,19,26,,45,-75.42726,6.170465
52203,2018,Mayo,Cuba,0,1,,1,-67.48402800000001,6.185536
52204,2018,Mayo,Cuba,2,2,,4,-72.453013,7.819
52205,2018,Mayo,Curazao,0,1,,1,-74.140516,4.697157
52206,2018,Mayo,República Checa,1,0,,1,-69.94143100000001,4.214082
52207,2018,Mayo,República Checa,4,9,,13,-77.35600000000001,0.81488
52208,2018,Mayo,República Checa,12,12,,24,-75.516486,10.446304
52209,2018,Mayo,República Checa,0,2,,2,-74.77647900000001,10.886686
52210,2018,Mayo,República Checa,1,3,,4,-81.372937,13.338761300000002
52211,2018,Mayo,República Checa,3,10,,13,-76.532004,3.451668
52212,2018,Mayo,República Checa,35,70,,105,-74.140516,4.697157
52213,2018,Mayo,República Checa,2,5,,7,-75.42726,6.170465
52214,2018,Mayo,Chile,1,2,,3,-69.941498,4.191162
52215,2018,Mayo,Chile,1,4,,5,-69.94143100000001,4.214082
52216,2018,Mayo,Chile,3,0,,3,-76.876446,0.33002
52217,2018,Mayo,Chile,45,100,,145,-77.35600000000001,0.81488
52218,2018,Mayo,Chile,2,1,,3,-78.802679,18.00143
52219,2018,Mayo,Chile,89,80,,169,-75.527794,10.406342
52220,2018,Mayo,Chile,603,505,,1108,-75.516486,10.446304
52221,2018,Mayo,Chile,16,17,,33,-74.77647900000001,10.886686
52222,2018,Mayo,Chile,0,21,,21,-72.129595,11.360028999999999
52223,2018,Mayo,Chile,140,100,,240,-81.70216500000001,12.5862
52224,2018,Mayo,Chile,29,57,,86,-76.532004,3.451668
52225,2018,Mayo,Chile,0,1,,1,-75.76635300000001,4.45285
52226,2018,Mayo,Chile,4277,5487,,9764,-74.140516,4.697157
52227,2018,Mayo,Chile,3,5,,8,-75.736374,4.815189
52228,2018,Mayo,Chile,133,459,,592,-75.42726,6.170465
52229,2018,Mayo,Chile,8,25,,33,-72.453013,7.819
52230,2018,Mayo,Chile,3,6,,9,-72.409396,8.36068
52231,2018,Mayo,China,1,1,,2,-69.941498,4.191162
52232,2018,Mayo,China,1,0,,1,-69.94143100000001,4.214082
52233,2018,Mayo,China,5,5,,10,-77.35600000000001,0.81488
52234,2018,Mayo,China,0,4,,4,-75.527794,10.406342
52235,2018,Mayo,China,22,23,,45,-75.516486,10.446304
52236,2018,Mayo,China,8,21,,29,-74.77647900000001,10.886686
52237,2018,Mayo,China,0,1,,1,-74.765343,10.970933
52238,2018,Mayo,China,0,5,,5,-74.213989,11.247722999999999
52239,2018,Mayo,China,0,4,,4,-72.129595,11.360028999999999
52240,2018,Mayo,China,16,24,,40,-76.532004,3.451668
52241,2018,Mayo,China,0,4,,4,-77.061029,3.8844260000000004
52242,2018,Mayo,China,397,935,,1332,-74.140516,4.697157
52243,2018,Mayo,China,0,1,,1,-75.736374,4.815189
52244,2018,Mayo,China,60,94,,154,-75.42726,6.170465
52245,2018,Mayo,China,1,1,,2,-73.181317,7.1280470000000005
52246,2018,Mayo,China,3,4,,7,-72.453013,7.819
52247,2018,Mayo,China,2,1,,3,-72.409396,8.36068
52248,2018,Mayo,China,0,1,,1,-75.68164200000001,9.402597
52249,2018,Mayo,Taiwán,3,3,,6,-77.35600000000001,0.81488
52250,2018,Mayo,Taiwán,0,1,,1,-75.527794,10.406342
52251,2018,Mayo,Taiwán,2,3,,5,-75.516486,10.446304
52252,2018,Mayo,Taiwán,1,1,,2,-76.532004,3.451668
52253,2018,Mayo,Taiwán,71,80,,151,-74.140516,4.697157
52254,2018,Mayo,Taiwán,7,17,,24,-75.42726,6.170465
52255,2018,Mayo,Taiwán,0,4,,4,-72.453013,7.819
52256,2018,Mayo,Chipre,0,1,,1,-75.516486,10.446304
52257,2018,Mayo,Chipre,3,4,,7,-74.140516,4.697157
52258,2018,Mayo,Chipre,2,3,,5,-75.42726,6.170465
52259,2018,Mayo,Dinamarca,2,6,,8,-69.94143100000001,4.214082
52260,2018,Mayo,Dinamarca,1,1,,2,-76.876446,0.33002
52261,2018,Mayo,Dinamarca,5,5,,10,-77.35600000000001,0.81488
52262,2018,Mayo,Dinamarca,1,2,,3,-75.527794,10.406342
52263,2018,Mayo,Dinamarca,12,22,,34,-75.516486,10.446304
52264,2018,Mayo,Dinamarca,1,2,,3,-74.77647900000001,10.886686
52265,2018,Mayo,Dinamarca,0,1,,1,-74.765343,10.970933
52266,2018,Mayo,Dinamarca,3,6,,9,-76.532004,3.451668
52267,2018,Mayo,Dinamarca,84,123,,207,-74.140516,4.697157
52268,2018,Mayo,Dinamarca,0,1,,1,-75.736374,4.815189
52269,2018,Mayo,Dinamarca,5,13,,18,-75.42726,6.170465
52270,2018,Mayo,Dinamarca,0,2,,2,-72.453013,7.819
52271,2018,Mayo,Dinamarca,1,0,,1,-77.35002,8.63337
52272,2018,Mayo,Dominica,0,2,,2,-75.516486,10.446304
52273,2018,Mayo,Dominica,1,1,,2,-74.77647900000001,10.886686
52274,2018,Mayo,Dominica,0,1,,1,-76.532004,3.451668
52275,2018,Mayo,Dominica,2,0,,2,-74.140516,4.697157
52276,2018,Mayo,Dominica,0,2,,2,-75.42726,6.170465
52277,2018,Mayo,Ecuador,0,1,,1,-69.94143100000001,4.214082
52278,2018,Mayo,Ecuador,43,185,,228,-76.876446,0.33002
52279,2018,Mayo,Ecuador,24,25,,49,-77.84700600000001,0.8124359999999999
52280,2018,Mayo,Ecuador,1059,1314,,2373,-77.35600000000001,0.81488
52281,2018,Mayo,Ecuador,11,19,,30,-78.802679,18.00143
52282,2018,Mayo,Ecuador,11,10,,21,-75.527794,10.406342
52283,2018,Mayo,Ecuador,71,63,,134,-75.516486,10.446304
52284,2018,Mayo,Ecuador,16,14,,30,-74.77647900000001,10.886686
52285,2018,Mayo,Ecuador,11,10,,21,-72.129595,11.360028999999999
52286,2018,Mayo,Ecuador,32,37,,69,-81.70216500000001,12.5862
52287,2018,Mayo,Ecuador,390,389,,779,-76.532004,3.451668
52288,2018,Mayo,Ecuador,1,0,,1,-67.927521,3.866713
52289,2018,Mayo,Ecuador,0,2,,2,-75.76635300000001,4.45285
52290,2018,Mayo,Ecuador,3066,3704,,6770,-74.140516,4.697157
52291,2018,Mayo,Ecuador,3,5,,8,-75.736374,4.815189
52292,2018,Mayo,Ecuador,57,85,,142,-75.42726,6.170465
52293,2018,Mayo,Ecuador,1,3,,4,-70.74025300000001,7.088728999999999
52294,2018,Mayo,Ecuador,103,158,,261,-72.453013,7.819
52295,2018,Mayo,Ecuador,2,12,,14,-72.409396,8.36068
52296,2018,Mayo,Ecuador,0,1,,1,-77.35002,8.63337
52297,2018,Mayo,Egipto,1,1,,2,-75.516486,10.446304
52298,2018,Mayo,Egipto,0,2,,2,-76.532004,3.451668
52299,2018,Mayo,Egipto,7,24,,31,-74.140516,4.697157
52300,2018,Mayo,Egipto,0,4,,4,-75.42726,6.170465
52301,2018,Mayo,Egipto,0,1,,1,-73.181317,7.1280470000000005
52302,2018,Mayo,El Salvador,1,4,,5,-77.35600000000001,0.81488
52303,2018,Mayo,El Salvador,0,2,,2,-75.527794,10.406342
52304,2018,Mayo,El Salvador,48,45,,93,-75.516486,10.446304
52305,2018,Mayo,El Salvador,24,19,,43,-74.77647900000001,10.886686
52306,2018,Mayo,El Salvador,1,1,,2,-81.70216500000001,12.5862
52307,2018,Mayo,El Salvador,7,12,,19,-76.532004,3.451668
52308,2018,Mayo,El Salvador,793,945,,1738,-74.140516,4.697157
52309,2018,Mayo,El Salvador,4,2,,6,-75.736374,4.815189
52310,2018,Mayo,El Salvador,171,239,,410,-75.42726,6.170465
52311,2018,Mayo,Emiratos Árabes,1,6,,7,-75.516486,10.446304
52312,2018,Mayo,Emiratos Árabes,1,5,,6,-74.140516,4.697157
52313,2018,Mayo,España,1,3,,4,-69.941498,4.191162
52314,2018,Mayo,España,5,8,,13,-69.94143100000001,4.214082
52315,2018,Mayo,España,3,6,,9,-76.876446,0.33002
52316,2018,Mayo,España,33,41,,74,-77.35600000000001,0.81488
52317,2018,Mayo,España,11,19,,30,-75.527794,10.406342
52318,2018,Mayo,España,117,186,,303,-75.516486,10.446304
52319,2018,Mayo,España,25,56,,81,-74.77647900000001,10.886686
52320,2018,Mayo,España,0,1,,1,-74.232675,11.117206
52321,2018,Mayo,España,0,2,,2,-74.213989,11.247722999999999
52322,2018,Mayo,España,1,3,,4,-72.129595,11.360028999999999
52323,2018,Mayo,España,8,15,,23,-81.70216500000001,12.5862
52324,2018,Mayo,España,347,413,,760,-76.532004,3.451668
52325,2018,Mayo,España,2864,5536,,8400,-74.140516,4.697157
52326,2018,Mayo,España,1,13,,14,-75.736374,4.815189
52327,2018,Mayo,España,341,710,,1051,-75.42726,6.170465
52328,2018,Mayo,España,0,1,,1,-70.74025300000001,7.088728999999999
52329,2018,Mayo,España,0,3,,3,-73.181317,7.1280470000000005
52330,2018,Mayo,España,15,48,,63,-72.453013,7.819
52331,2018,Mayo,España,4,7,,11,-72.409396,8.36068
52332,2018,Mayo,España,1,4,,5,-77.35002,8.63337
52333,2018,Mayo,Eslovaquia,0,2,,2,-77.35600000000001,0.81488
52334,2018,Mayo,Eslovaquia,0,1,,1,-75.527794,10.406342
52335,2018,Mayo,Eslovaquia,6,6,,12,-75.516486,10.446304
52336,2018,Mayo,Eslovaquia,1,0,,1,-76.532004,3.451668
52337,2018,Mayo,Eslovaquia,17,32,,49,-74.140516,4.697157
52338,2018,Mayo,Eslovaquia,4,5,,9,-75.42726,6.170465
52339,2018,Mayo,Eslovenia,1,0,,1,-77.35600000000001,0.81488
52340,2018,Mayo,Eslovenia,1,1,,2,-76.532004,3.451668
52341,2018,Mayo,Eslovenia,8,15,,23,-74.140516,4.697157
52342,2018,Mayo,Eslovenia,0,4,,4,-75.42726,6.170465
52343,2018,Mayo,Estados Unidos de América,10,11,,21,-69.941498,4.191162
52344,2018,Mayo,Estados Unidos de América,19,21,,40,-69.94143100000001,4.214082
52345,2018,Mayo,Estados Unidos de América,4,5,,9,-76.876446,0.33002
52346,2018,Mayo,Estados Unidos de América,1,0,,1,-77.84700600000001,0.8124359999999999
52347,2018,Mayo,Estados Unidos de América,71,62,,133,-77.35600000000001,0.81488
52348,2018,Mayo,Estados Unidos de América,26,42,,68,-75.527794,10.406342
52349,2018,Mayo,Estados Unidos de América,5194,6737,,11931,-75.516486,10.446304
52350,2018,Mayo,Estados Unidos de América,606,1011,,1617,-74.77647900000001,10.886686
52351,2018,Mayo,Estados Unidos de América,3,6,,9,-74.213989,11.247722999999999
52352,2018,Mayo,Estados Unidos de América,1,5,,6,-72.129595,11.360028999999999
52353,2018,Mayo,Estados Unidos de América,0,6,,6,-81.703935,12.574411099999999
52354,2018,Mayo,Estados Unidos de América,40,46,,86,-81.70216500000001,12.5862
52355,2018,Mayo,Estados Unidos de América,2,8,,10,-81.372937,13.338761300000002
52356,2018,Mayo,Estados Unidos de América,1171,1583,,2754,-76.532004,3.451668
52357,2018,Mayo,Estados Unidos de América,183,239,,422,-75.76635300000001,4.45285
52358,2018,Mayo,Estados Unidos de América,9211,15113,,24324,-74.140516,4.697157
52359,2018,Mayo,Estados Unidos de América,143,161,,304,-75.736374,4.815189
52360,2018,Mayo,Estados Unidos de América,2865,6813,,9678,-75.42726,6.170465
52361,2018,Mayo,Estados Unidos de América,0,1,,1,-67.48402800000001,6.185536
52362,2018,Mayo,Estados Unidos de América,0,1,,1,-70.74025300000001,7.088728999999999
52363,2018,Mayo,Estados Unidos de América,37,63,,100,-73.181317,7.1280470000000005
52364,2018,Mayo,Estados Unidos de América,13,14,,27,-72.453013,7.819
52365,2018,Mayo,Estados Unidos de América,2,3,,5,-72.409396,8.36068
52366,2018,Mayo,Estados Unidos de América,4,9,,13,-77.35002,8.63337
52367,2018,Mayo,Estonia,1,0,,1,-75.516486,10.446304
52368,2018,Mayo,Estonia,1,0,,1,-76.532004,3.451668
52369,2018,Mayo,Estonia,6,8,,14,-74.140516,4.697157
52370,2018,Mayo,Estonia,2,1,,3,-75.42726,6.170465
52371,2018,Mayo,Etiopia,0,1,,1,-77.061029,3.8844260000000004
52372,2018,Mayo,Etiopia,0,1,,1,-74.140516,4.697157
52373,2018,Mayo,Islas Fiji,1,0,,1,-75.516486,10.446304
52374,2018,Mayo,Islas Fiji,0,1,,1,-74.140516,4.697157
52375,2018,Mayo,Filipinas,2,0,,2,-77.35600000000001,0.81488
52376,2018,Mayo,Filipinas,2,31,,33,-75.527794,10.406342
52377,2018,Mayo,Filipinas,6,86,,92,-75.516486,10.446304
52378,2018,Mayo,Filipinas,1,15,,16,-74.77647900000001,10.886686
52379,2018,Mayo,Filipinas,0,25,,25,-74.765343,10.970933
52380,2018,Mayo,Filipinas,0,26,,26,-74.213989,11.247722999999999
52381,2018,Mayo,Filipinas,1,1,,2,-81.70216500000001,12.5862
52382,2018,Mayo,Filipinas,4,11,,15,-76.532004,3.451668
52383,2018,Mayo,Filipinas,0,20,,20,-77.061029,3.8844260000000004
52384,2018,Mayo,Filipinas,39,78,,117,-74.140516,4.697157
52385,2018,Mayo,Filipinas,7,5,,12,-75.42726,6.170465
52386,2018,Mayo,Filipinas,0,1,,1,-75.68164200000001,9.402597
52387,2018,Mayo,Finlandia,0,1,,1,-69.94143100000001,4.214082
52388,2018,Mayo,Finlandia,4,2,,6,-77.35600000000001,0.81488
52389,2018,Mayo,Finlandia,6,6,,12,-75.516486,10.446304
52390,2018,Mayo,Finlandia,10,4,,14,-76.532004,3.451668
52391,2018,Mayo,Finlandia,42,61,,103,-74.140516,4.697157
52392,2018,Mayo,Finlandia,0,1,,1,-75.736374,4.815189
52393,2018,Mayo,Finlandia,6,6,,12,-75.42726,6.170465
52394,2018,Mayo,Finlandia,1,0,,1,-77.35002,8.63337
52395,2018,Mayo,Francia,9,10,,19,-69.941498,4.191162
52396,2018,Mayo,Francia,26,14,,40,-69.94143100000001,4.214082
52397,2018,Mayo,Francia,4,10,,14,-76.876446,0.33002
52398,2018,Mayo,Francia,1,0,,1,-77.84700600000001,0.8124359999999999
52399,2018,Mayo,Francia,101,122,,223,-77.35600000000001,0.81488
52400,2018,Mayo,Francia,1,1,,2,-78.802679,18.00143
52401,2018,Mayo,Francia,16,15,,31,-75.527794,10.406342
52402,2018,Mayo,Francia,112,158,,270,-75.516486,10.446304
52403,2018,Mayo,Francia,5,20,,25,-74.77647900000001,10.886686
52404,2018,Mayo,Francia,1,1,,2,-74.765343,10.970933
52405,2018,Mayo,Francia,1,2,,3,-74.213989,11.247722999999999
52406,2018,Mayo,Francia,1,6,,7,-72.129595,11.360028999999999
52407,2018,Mayo,Francia,1,1,,2,-81.703935,12.574411099999999
52408,2018,Mayo,Francia,1,3,,4,-81.70216500000001,12.5862
52409,2018,Mayo,Francia,2,2,,4,-81.372937,13.338761300000002
52410,2018,Mayo,Francia,59,84,,143,-76.532004,3.451668
52411,2018,Mayo,Francia,1,0,,1,-75.76635300000001,4.45285
52412,2018,Mayo,Francia,1504,2343,,3847,-74.140516,4.697157
52413,2018,Mayo,Francia,10,9,,19,-75.736374,4.815189
52414,2018,Mayo,Francia,113,218,,331,-75.42726,6.170465
52415,2018,Mayo,Francia,0,1,,1,-70.74025300000001,7.088728999999999
52416,2018,Mayo,Francia,2,4,,6,-73.181317,7.1280470000000005
52417,2018,Mayo,Francia,12,10,,22,-72.453013,7.819
52418,2018,Mayo,Francia,2,1,,3,-72.409396,8.36068
52419,2018,Mayo,Francia,8,11,,19,-77.35002,8.63337
52420,2018,Mayo,Gabón,1,0,,1,-76.532004,3.451668
52421,2018,Mayo,Georgia,0,1,,1,-74.213989,11.247722999999999
52422,2018,Mayo,Georgia,1,7,,8,-74.140516,4.697157
52423,2018,Mayo,Ghana,0,1,,1,-77.35600000000001,0.81488
52424,2018,Mayo,Ghana,1,3,,4,-75.516486,10.446304
52425,2018,Mayo,Ghana,1,0,,1,-76.532004,3.451668
52426,2018,Mayo,Ghana,2,1,,3,-74.140516,4.697157
52427,2018,Mayo,Granada,0,1,,1,-75.516486,10.446304
52428,2018,Mayo,Granada,3,3,,6,-74.140516,4.697157
52429,2018,Mayo,Grecia,1,0,,1,-77.35600000000001,0.81488
52430,2018,Mayo,Grecia,0,2,,2,-75.527794,10.406342
52431,2018,Mayo,Grecia,2,13,,15,-75.516486,10.446304
52432,2018,Mayo,Grecia,0,1,,1,-74.765343,10.970933
52433,2018,Mayo,Grecia,0,1,,1,-76.532004,3.451668
52434,2018,Mayo,Grecia,21,71,,92,-74.140516,4.697157
52435,2018,Mayo,Grecia,3,3,,6,-75.42726,6.170465
52436,2018,Mayo,Grecia,0,1,,1,-72.453013,7.819
52437,2018,Mayo,Grecia,0,1,,1,-76.7333,8.06667
52438,2018,Mayo,Grecia,1,0,,1,-72.409396,8.36068
52439,2018,Mayo,Grecia,0,5,,5,-75.68164200000001,9.402597
52440,2018,Mayo,Guatemala,3,4,,7,-77.35600000000001,0.81488
52441,2018,Mayo,Guatemala,0,1,,1,-75.527794,10.406342
52442,2018,Mayo,Guatemala,86,92,,178,-75.516486,10.446304
52443,2018,Mayo,Guatemala,11,14,,25,-74.77647900000001,10.886686
52444,2018,Mayo,Guatemala,6,2,,8,-81.70216500000001,12.5862
52445,2018,Mayo,Guatemala,12,22,,34,-76.532004,3.451668
52446,2018,Mayo,Guatemala,385,764,,1149,-74.140516,4.697157
52447,2018,Mayo,Guatemala,8,14,,22,-75.736374,4.815189
52448,2018,Mayo,Guatemala,75,179,,254,-75.42726,6.170465
52449,2018,Mayo,Guatemala,1,2,,3,-73.181317,7.1280470000000005
52450,2018,Mayo,Guatemala,1,2,,3,-72.453013,7.819
52451,2018,Mayo,Guatemala,2,0,,2,-72.409396,8.36068
52452,2018,Mayo,Guyana,0,1,,1,-77.35600000000001,0.81488
52453,2018,Mayo,Guyana,0,1,,1,-75.516486,10.446304
52454,2018,Mayo,Guyana,1,6,,7,-74.77647900000001,10.886686
52455,2018,Mayo,Guyana,1,0,,1,-76.532004,3.451668
52456,2018,Mayo,Guyana,4,12,,16,-74.140516,4.697157
52457,2018,Mayo,Guyana,1,1,,2,-75.42726,6.170465
52458,2018,Mayo,Guyana,1,1,,2,-72.453013,7.819
52459,2018,Mayo,Haití,4,9,,13,-75.516486,10.446304
52460,2018,Mayo,Haití,0,3,,3,-74.77647900000001,10.886686
52461,2018,Mayo,Haití,2,0,,2,-76.532004,3.451668
52462,2018,Mayo,Haití,11,15,,26,-74.140516,4.697157
52463,2018,Mayo,Haití,1,0,,1,-75.42726,6.170465
52464,2018,Mayo,Honduras,0,3,,3,-77.35600000000001,0.81488
52465,2018,Mayo,Honduras,1,0,,1,-75.527794,10.406342
52466,2018,Mayo,Honduras,33,41,,74,-75.516486,10.446304
52467,2018,Mayo,Honduras,6,8,,14,-74.77647900000001,10.886686
52468,2018,Mayo,Honduras,0,1,,1,-72.129595,11.360028999999999
52469,2018,Mayo,Honduras,3,2,,5,-81.70216500000001,12.5862
52470,2018,Mayo,Honduras,0,1,,1,-81.372937,13.338761300000002
52471,2018,Mayo,Honduras,21,16,,37,-76.532004,3.451668
52472,2018,Mayo,Honduras,1,0,,1,-75.76635300000001,4.45285
52473,2018,Mayo,Honduras,258,321,,579,-74.140516,4.697157
52474,2018,Mayo,Honduras,0,7,,7,-75.736374,4.815189
52475,2018,Mayo,Honduras,59,67,,126,-75.42726,6.170465
52476,2018,Mayo,Honduras,1,1,,2,-73.181317,7.1280470000000005
52477,2018,Mayo,Honduras,0,1,,1,-77.35002,8.63337
52478,2018,Mayo,Honduras,0,1,,1,-75.68164200000001,9.402597
52479,2018,Mayo,Hong Kong,0,2,,2,-77.35600000000001,0.81488
52480,2018,Mayo,Hong Kong,9,13,,22,-74.140516,4.697157
52481,2018,Mayo,Hong Kong,0,1,,1,-75.42726,6.170465
52482,2018,Mayo,Hungría,1,0,,1,-69.941498,4.191162
52483,2018,Mayo,Hungría,0,1,,1,-69.94143100000001,4.214082
52484,2018,Mayo,Hungría,0,1,,1,-77.35600000000001,0.81488
52485,2018,Mayo,Hungría,6,6,,12,-75.516486,10.446304
52486,2018,Mayo,Hungría,1,0,,1,-74.77647900000001,10.886686
52487,2018,Mayo,Hungría,2,3,,5,-76.532004,3.451668
52488,2018,Mayo,Hungría,26,58,,84,-74.140516,4.697157
52489,2018,Mayo,Hungría,4,4,,8,-75.42726,6.170465
52490,2018,Mayo,India,0,1,,1,-77.35600000000001,0.81488
52491,2018,Mayo,India,0,8,,8,-75.527794,10.406342
52492,2018,Mayo,India,18,52,,70,-75.516486,10.446304
52493,2018,Mayo,India,2,11,,13,-74.77647900000001,10.886686
52494,2018,Mayo,India,1,0,,1,-74.765343,10.970933
52495,2018,Mayo,India,1,6,,7,-74.213989,11.247722999999999
52496,2018,Mayo,India,1,10,,11,-76.532004,3.451668
52497,2018,Mayo,India,0,1,,1,-77.061029,3.8844260000000004
52498,2018,Mayo,India,101,445,,546,-74.140516,4.697157
52499,2018,Mayo,India,0,4,,4,-75.736374,4.815189
52500,2018,Mayo,India,5,63,,68,-75.42726,6.170465
52501,2018,Mayo,India,0,2,,2,-73.181317,7.1280470000000005
52502,2018,Mayo,India,0,4,,4,-75.68164200000001,9.402597
52503,2018,Mayo,Indonesia,0,2,,2,-77.35600000000001,0.81488
52504,2018,Mayo,Indonesia,1,1,,2,-75.527794,10.406342
52505,2018,Mayo,Indonesia,3,11,,14,-75.516486,10.446304
52506,2018,Mayo,Indonesia,0,6,,6,-77.061029,3.8844260000000004
52507,2018,Mayo,Indonesia,27,34,,61,-74.140516,4.697157
52508,2018,Mayo,Indonesia,1,1,,2,-75.42726,6.170465
52509,2018,Mayo,Irán,1,0,,1,-75.516486,10.446304
52510,2018,Mayo,Irán,7,18,,25,-74.140516,4.697157
52511,2018,Mayo,Irán,2,1,,3,-75.42726,6.170465
52512,2018,Mayo,República de Irlanda,2,1,,3,-69.94143100000001,4.214082
52513,2018,Mayo,República de Irlanda,0,1,,1,-76.876446,0.33002
52514,2018,Mayo,República de Irlanda,9,20,,29,-77.35600000000001,0.81488
52515,2018,Mayo,República de Irlanda,10,10,,20,-75.527794,10.406342
52516,2018,Mayo,República de Irlanda,19,19,,38,-75.516486,10.446304
52517,2018,Mayo,República de Irlanda,2,4,,6,-74.77647900000001,10.886686
52518,2018,Mayo,República de Irlanda,3,4,,7,-76.532004,3.451668
52519,2018,Mayo,República de Irlanda,128,209,,337,-74.140516,4.697157
52520,2018,Mayo,República de Irlanda,0,1,,1,-75.736374,4.815189
52521,2018,Mayo,República de Irlanda,16,29,,45,-75.42726,6.170465
52522,2018,Mayo,República de Irlanda,8,8,,16,-77.35002,8.63337
52523,2018,Mayo,Islandia,0,2,,2,-75.516486,10.446304
52524,2018,Mayo,Islandia,0,1,,1,-74.77647900000001,10.886686
52525,2018,Mayo,Islandia,2,1,,3,-76.532004,3.451668
52526,2018,Mayo,Islandia,3,3,,6,-74.140516,4.697157
52527,2018,Mayo,Islandia,4,4,,8,-75.42726,6.170465
52528,2018,Mayo,Israel,2,1,,3,-69.941498,4.191162
52529,2018,Mayo,Israel,4,6,,10,-69.94143100000001,4.214082
52530,2018,Mayo,Israel,42,81,,123,-77.35600000000001,0.81488
52531,2018,Mayo,Israel,1,2,,3,-75.527794,10.406342
52532,2018,Mayo,Israel,13,37,,50,-75.516486,10.446304
52533,2018,Mayo,Israel,1,2,,3,-81.70216500000001,12.5862
52534,2018,Mayo,Israel,16,29,,45,-76.532004,3.451668
52535,2018,Mayo,Israel,0,1,,1,-75.76635300000001,4.45285
52536,2018,Mayo,Israel,330,717,,1047,-74.140516,4.697157
52537,2018,Mayo,Israel,0,1,,1,-75.736374,4.815189
52538,2018,Mayo,Israel,62,118,,180,-75.42726,6.170465
52539,2018,Mayo,Israel,1,0,,1,-77.35002,8.63337
52540,2018,Mayo,Italia,3,5,,8,-69.941498,4.191162
52541,2018,Mayo,Italia,4,4,,8,-69.94143100000001,4.214082
52542,2018,Mayo,Italia,0,2,,2,-76.876446,0.33002
52543,2018,Mayo,Italia,0,1,,1,-77.84700600000001,0.8124359999999999
52544,2018,Mayo,Italia,14,25,,39,-77.35600000000001,0.81488
52545,2018,Mayo,Italia,3,5,,8,-75.527794,10.406342
52546,2018,Mayo,Italia,78,140,,218,-75.516486,10.446304
52547,2018,Mayo,Italia,11,33,,44,-74.77647900000001,10.886686
52548,2018,Mayo,Italia,0,5,,5,-72.129595,11.360028999999999
52549,2018,Mayo,Italia,10,8,,18,-81.70216500000001,12.5862
52550,2018,Mayo,Italia,33,87,,120,-76.532004,3.451668
52551,2018,Mayo,Italia,0,1,,1,-77.061029,3.8844260000000004
52552,2018,Mayo,Italia,575,1525,,2100,-74.140516,4.697157
52553,2018,Mayo,Italia,3,2,,5,-75.736374,4.815189
52554,2018,Mayo,Italia,61,184,,245,-75.42726,6.170465
52555,2018,Mayo,Italia,2,0,,2,-73.181317,7.1280470000000005
52556,2018,Mayo,Italia,9,14,,23,-72.453013,7.819
52557,2018,Mayo,Italia,2,2,,4,-72.409396,8.36068
52558,2018,Mayo,Italia,2,1,,3,-77.35002,8.63337
52559,2018,Mayo,Jamaica,6,7,,13,-75.516486,10.446304
52560,2018,Mayo,Jamaica,0,3,,3,-74.77647900000001,10.886686
52561,2018,Mayo,Jamaica,0,3,,3,-81.70216500000001,12.5862
52562,2018,Mayo,Jamaica,6,4,,10,-76.532004,3.451668
52563,2018,Mayo,Jamaica,20,30,,50,-74.140516,4.697157
52564,2018,Mayo,Jamaica,1,7,,8,-75.42726,6.170465
52565,2018,Mayo,Jamaica,1,0,,1,-72.453013,7.819
52566,2018,Mayo,Japón,1,0,,1,-69.941498,4.191162
52567,2018,Mayo,Japón,7,17,,24,-77.35600000000001,0.81488
52568,2018,Mayo,Japón,10,25,,35,-75.516486,10.446304
52569,2018,Mayo,Japón,1,7,,8,-74.77647900000001,10.886686
52570,2018,Mayo,Japón,17,22,,39,-76.532004,3.451668
52571,2018,Mayo,Japón,115,457,,572,-74.140516,4.697157
52572,2018,Mayo,Japón,8,43,,51,-75.42726,6.170465
52573,2018,Mayo,Japón,1,2,,3,-77.35002,8.63337
52574,2018,Mayo,Jordania,1,0,,1,-77.35600000000001,0.81488
52575,2018,Mayo,Jordania,1,3,,4,-74.140516,4.697157
52576,2018,Mayo,Kazajistán,5,4,,9,-75.516486,10.446304
52577,2018,Mayo,Kazajistán,0,2,,2,-76.532004,3.451668
52578,2018,Mayo,Kazajistán,5,6,,11,-74.140516,4.697157
52579,2018,Mayo,Kazajistán,0,1,,1,-75.42726,6.170465
52580,2018,Mayo,Kenia,1,0,,1,-77.35600000000001,0.81488
52581,2018,Mayo,Kenia,3,2,,5,-75.516486,10.446304
52582,2018,Mayo,Kenia,2,9,,11,-74.140516,4.697157
52583,2018,Mayo,Kenia,0,1,,1,-75.42726,6.170465
52584,2018,Mayo,Kirguistán,1,0,,1,-74.140516,4.697157
52585,2018,Mayo,Kirguistán,1,0,,1,-75.42726,6.170465
52586,2018,Mayo,Kuwait,1,1,,2,-75.516486,10.446304
52587,2018,Mayo,Kuwait,0,1,,1,-74.140516,4.697157
52588,2018,Mayo,Kuwait,1,0,,1,-75.42726,6.170465
52589,2018,Mayo,República de Kosovo,0,1,,1,-75.516486,10.446304
52590,2018,Mayo,República de Kosovo,5,0,,5,-74.140516,4.697157
52591,2018,Mayo,Letonia,0,2,,2,-77.35600000000001,0.81488
52592,2018,Mayo,Letonia,0,1,,1,-75.527794,10.406342
52593,2018,Mayo,Letonia,1,0,,1,-75.516486,10.446304
52594,2018,Mayo,Letonia,0,1,,1,-81.70216500000001,12.5862
52595,2018,Mayo,Letonia,4,4,,8,-74.140516,4.697157
52596,2018,Mayo,Letonia,2,1,,3,-75.42726,6.170465
52597,2018,Mayo,Lituania,3,4,,7,-77.35600000000001,0.81488
52598,2018,Mayo,Lituania,0,2,,2,-75.527794,10.406342
52599,2018,Mayo,Lituania,3,8,,11,-75.516486,10.446304
52600,2018,Mayo,Lituania,1,0,,1,-81.372937,13.338761300000002
52601,2018,Mayo,Lituania,0,4,,4,-76.532004,3.451668
52602,2018,Mayo,Lituania,16,15,,31,-74.140516,4.697157
52603,2018,Mayo,Lituania,0,1,,1,-75.736374,4.815189
52604,2018,Mayo,Lituania,3,5,,8,-75.42726,6.170465
52605,2018,Mayo,Líbano,0,1,,1,-77.35600000000001,0.81488
52606,2018,Mayo,Líbano,1,0,,1,-75.516486,10.446304
52607,2018,Mayo,Líbano,1,1,,2,-74.77647900000001,10.886686
52608,2018,Mayo,Líbano,1,3,,4,-72.129595,11.360028999999999
52609,2018,Mayo,Líbano,1,0,,1,-76.532004,3.451668
52610,2018,Mayo,Líbano,13,31,,44,-74.140516,4.697157
52611,2018,Mayo,Líbano,1,3,,4,-75.42726,6.170465
52612,2018,Mayo,Libia,0,1,,1,-74.140516,4.697157
52613,2018,Mayo,Liechtenstein,0,2,,2,-74.140516,4.697157
52614,2018,Mayo,Liechtenstein,0,1,,1,-75.42726,6.170465
52615,2018,Mayo,Luxemburgo,1,0,,1,-69.941498,4.191162
52616,2018,Mayo,Luxemburgo,1,1,,2,-69.94143100000001,4.214082
52617,2018,Mayo,Luxemburgo,0,1,,1,-75.516486,10.446304
52618,2018,Mayo,Luxemburgo,0,1,,1,-76.532004,3.451668
52619,2018,Mayo,Luxemburgo,0,6,,6,-74.140516,4.697157
52620,2018,Mayo,Luxemburgo,1,1,,2,-75.736374,4.815189
52621,2018,Mayo,Macedonia,0,1,,1,-75.516486,10.446304
52622,2018,Mayo,Macedonia,1,2,,3,-74.140516,4.697157
52623,2018,Mayo,Madagascar,1,0,,1,-75.516486,10.446304
52624,2018,Mayo,Madagascar,1,0,,1,-74.140516,4.697157
52625,2018,Mayo,Madagascar,1,0,,1,-75.42726,6.170465
52626,2018,Mayo,Malasia,2,0,,2,-75.527794,10.406342
52627,2018,Mayo,Malasia,1,0,,1,-75.516486,10.446304
52628,2018,Mayo,Malasia,0,1,,1,-76.532004,3.451668
52629,2018,Mayo,Malasia,29,30,,59,-74.140516,4.697157
52630,2018,Mayo,Malasia,5,9,,14,-75.42726,6.170465
52631,2018,Mayo,Malí,0,1,,1,-74.140516,4.697157
52632,2018,Mayo,Malí,1,0,,1,-75.42726,6.170465
52633,2018,Mayo,Malta,0,1,,1,-75.516486,10.446304
52634,2018,Mayo,Malta,3,5,,8,-74.140516,4.697157
52635,2018,Mayo,Malta,0,1,,1,-75.42726,6.170465
52636,2018,Mayo,Marruecos,6,11,,17,-74.140516,4.697157
52637,2018,Mayo,Marruecos,0,1,,1,-75.42726,6.170465
52638,2018,Mayo,Mauricio,0,2,,2,-75.527794,10.406342
52639,2018,Mayo,Mauricio,0,1,,1,-75.516486,10.446304
52640,2018,Mayo,Mauricio,0,3,,3,-74.140516,4.697157
52641,2018,Mayo,Mauricio,0,2,,2,-75.42726,6.170465
52642,2018,Mayo,México,0,1,,1,-69.94143100000001,4.214082
52643,2018,Mayo,México,2,0,,2,-76.876446,0.33002
52644,2018,Mayo,México,1,0,,1,-77.84700600000001,0.8124359999999999
52645,2018,Mayo,México,9,20,,29,-77.35600000000001,0.81488
52646,2018,Mayo,México,0,3,,3,-75.527794,10.406342
52647,2018,Mayo,México,498,540,,1038,-75.516486,10.446304
52648,2018,Mayo,México,50,79,,129,-74.77647900000001,10.886686
52649,2018,Mayo,México,0,3,,3,-74.232675,11.117206
52650,2018,Mayo,México,0,2,,2,-74.213989,11.247722999999999
52651,2018,Mayo,México,1,13,,14,-72.129595,11.360028999999999
52652,2018,Mayo,México,0,1,,1,-81.703935,12.574411099999999
52653,2018,Mayo,México,3,5,,8,-81.70216500000001,12.5862
52654,2018,Mayo,México,0,1,,1,-81.372937,13.338761300000002
52655,2018,Mayo,México,77,170,,247,-76.532004,3.451668
52656,2018,Mayo,México,5,0,,5,-75.76635300000001,4.45285
52657,2018,Mayo,México,4346,7256,,11602,-74.140516,4.697157
52658,2018,Mayo,México,16,33,,49,-75.736374,4.815189
52659,2018,Mayo,México,597,1333,,1930,-75.42726,6.170465
52660,2018,Mayo,México,1,1,,2,-70.74025300000001,7.088728999999999
52661,2018,Mayo,México,1,10,,11,-73.181317,7.1280470000000005
52662,2018,Mayo,México,13,14,,27,-72.453013,7.819
52663,2018,Mayo,México,2,3,,5,-72.409396,8.36068
52664,2018,Mayo,México,1,4,,5,-77.35002,8.63337
52665,2018,Mayo,República de Moldavia,0,1,,1,-75.516486,10.446304
52666,2018,Mayo,República de Moldavia,1,1,,2,-74.140516,4.697157
52667,2018,Mayo,República de Moldavia,1,0,,1,-73.181317,7.1280470000000005
52668,2018,Mayo,Mónaco,1,2,,3,-74.140516,4.697157
52669,2018,Mayo,Mongolia,0,1,,1,-75.516486,10.446304
52670,2018,Mayo,Mongolia,3,10,,13,-74.140516,4.697157
52671,2018,Mayo,Mongolia,1,0,,1,-75.42726,6.170465
52672,2018,Mayo,Montenegro,0,1,,1,-74.213989,11.247722999999999
52673,2018,Mayo,Montenegro,0,1,,1,-77.061029,3.8844260000000004
52674,2018,Mayo,Montenegro,0,3,,3,-74.140516,4.697157
52675,2018,Mayo,Mozambique,1,4,,5,-74.140516,4.697157
52676,2018,Mayo,Myanmar,0,1,,1,-74.77647900000001,10.886686
52677,2018,Mayo,Myanmar,3,11,,14,-74.140516,4.697157
52678,2018,Mayo,Nepal,1,1,,2,-75.516486,10.446304
52679,2018,Mayo,Nepal,2,0,,2,-74.77647900000001,10.886686
52680,2018,Mayo,Nepal,0,6,,6,-74.140516,4.697157
52681,2018,Mayo,Nicaragua,1,0,,1,-69.941498,4.191162
52682,2018,Mayo,Nicaragua,16,15,,31,-75.516486,10.446304
52683,2018,Mayo,Nicaragua,2,0,,2,-74.77647900000001,10.886686
52684,2018,Mayo,Nicaragua,0,2,,2,-72.129595,11.360028999999999
52685,2018,Mayo,Nicaragua,8,14,,22,-81.703935,12.574411099999999
52686,2018,Mayo,Nicaragua,1,0,,1,-81.70216500000001,12.5862
52687,2018,Mayo,Nicaragua,13,9,,22,-76.532004,3.451668
52688,2018,Mayo,Nicaragua,79,97,,176,-74.140516,4.697157
52689,2018,Mayo,Nicaragua,1,2,,3,-75.736374,4.815189
52690,2018,Mayo,Nicaragua,14,21,,35,-75.42726,6.170465
52691,2018,Mayo,Nicaragua,1,2,,3,-73.181317,7.1280470000000005
52692,2018,Mayo,Nicaragua,1,0,,1,-72.453013,7.819
52693,2018,Mayo,Nicaragua,1,2,,3,-72.409396,8.36068
52694,2018,Mayo,Nigeria,1,1,,2,-75.516486,10.446304
52695,2018,Mayo,Nigeria,0,1,,1,-74.77647900000001,10.886686
52696,2018,Mayo,Nigeria,1,0,,1,-76.532004,3.451668
52697,2018,Mayo,Nigeria,3,12,,15,-74.140516,4.697157
52698,2018,Mayo,Nigeria,0,3,,3,-75.42726,6.170465
52699,2018,Mayo,Noruega,3,0,,3,-69.94143100000001,4.214082
52700,2018,Mayo,Noruega,1,1,,2,-77.35600000000001,0.81488
52701,2018,Mayo,Noruega,3,5,,8,-75.527794,10.406342
52702,2018,Mayo,Noruega,6,14,,20,-75.516486,10.446304
52703,2018,Mayo,Noruega,0,2,,2,-74.77647900000001,10.886686
52704,2018,Mayo,Noruega,1,2,,3,-81.70216500000001,12.5862
52705,2018,Mayo,Noruega,8,3,,11,-76.532004,3.451668
52706,2018,Mayo,Noruega,81,83,,164,-74.140516,4.697157
52707,2018,Mayo,Noruega,0,1,,1,-75.736374,4.815189
52708,2018,Mayo,Noruega,8,18,,26,-75.42726,6.170465
52709,2018,Mayo,Noruega,1,2,,3,-77.35002,8.63337
52710,2018,Mayo,Nueva Zelanda,1,1,,2,-69.941498,4.191162
52711,2018,Mayo,Nueva Zelanda,5,11,,16,-77.35600000000001,0.81488
52712,2018,Mayo,Nueva Zelanda,2,8,,10,-75.527794,10.406342
52713,2018,Mayo,Nueva Zelanda,14,16,,30,-75.516486,10.446304
52714,2018,Mayo,Nueva Zelanda,0,4,,4,-74.77647900000001,10.886686
52715,2018,Mayo,Nueva Zelanda,0,1,,1,-76.532004,3.451668
52716,2018,Mayo,Nueva Zelanda,66,98,,164,-74.140516,4.697157
52717,2018,Mayo,Nueva Zelanda,5,28,,33,-75.42726,6.170465
52718,2018,Mayo,Nueva Zelanda,2,6,,8,-77.35002,8.63337
52719,2018,Mayo,Países Bajos,1,1,,2,-69.941498,4.191162
52720,2018,Mayo,Países Bajos,1,9,,10,-69.94143100000001,4.214082
52721,2018,Mayo,Países Bajos,2,3,,5,-76.876446,0.33002
52722,2018,Mayo,Países Bajos,28,28,,56,-77.35600000000001,0.81488
52723,2018,Mayo,Países Bajos,23,16,,39,-75.527794,10.406342
52724,2018,Mayo,Países Bajos,147,197,,344,-75.516486,10.446304
52725,2018,Mayo,Países Bajos,8,12,,20,-74.77647900000001,10.886686
52726,2018,Mayo,Países Bajos,1,3,,4,-72.129595,11.360028999999999
52727,2018,Mayo,Países Bajos,2,0,,2,-81.703935,12.574411099999999
52728,2018,Mayo,Países Bajos,2,1,,3,-81.70216500000001,12.5862
52729,2018,Mayo,Países Bajos,1,0,,1,-81.372937,13.338761300000002
52730,2018,Mayo,Países Bajos,32,49,,81,-76.532004,3.451668
52731,2018,Mayo,Países Bajos,0,2,,2,-77.061029,3.8844260000000004
52732,2018,Mayo,Países Bajos,1305,1715,,3020,-74.140516,4.697157
52733,2018,Mayo,Países Bajos,2,3,,5,-75.736374,4.815189
52734,2018,Mayo,Países Bajos,157,229,,386,-75.42726,6.170465
52735,2018,Mayo,Países Bajos,6,5,,11,-73.181317,7.1280470000000005
52736,2018,Mayo,Países Bajos,2,4,,6,-72.453013,7.819
52737,2018,Mayo,Países Bajos,9,4,,13,-77.35002,8.63337
52738,2018,Mayo,Pakistán,0,1,,1,-75.527794,10.406342
52739,2018,Mayo,Pakistán,1,4,,5,-75.516486,10.446304
52740,2018,Mayo,Pakistán,2,11,,13,-74.140516,4.697157
52741,2018,Mayo,Pakistán,0,4,,4,-75.42726,6.170465
52742,2018,Mayo,Panamá,1,0,,1,-69.941498,4.191162
52743,2018,Mayo,Panamá,3,5,,8,-77.35600000000001,0.81488
52744,2018,Mayo,Panamá,0,2,,2,-78.802679,18.00143
52745,2018,Mayo,Panamá,3,14,,17,-75.527794,10.406342
52746,2018,Mayo,Panamá,403,442,,845,-75.516486,10.446304
52747,2018,Mayo,Panamá,78,106,,184,-74.77647900000001,10.886686
52748,2018,Mayo,Panamá,0,1,,1,-81.703935,12.574411099999999
52749,2018,Mayo,Panamá,23,26,,49,-81.70216500000001,12.5862
52750,2018,Mayo,Panamá,171,202,,373,-76.532004,3.451668
52751,2018,Mayo,Panamá,19,13,,32,-75.76635300000001,4.45285
52752,2018,Mayo,Panamá,1291,1464,,2755,-74.140516,4.697157
52753,2018,Mayo,Panamá,39,60,,99,-75.736374,4.815189
52754,2018,Mayo,Panamá,998,1015,,2013,-75.42726,6.170465
52755,2018,Mayo,Panamá,6,6,,12,-77.762647,7.102626
52756,2018,Mayo,Panamá,6,6,,12,-73.181317,7.1280470000000005
52757,2018,Mayo,Panamá,1,5,,6,-72.453013,7.819
52758,2018,Mayo,Panamá,0,2,,2,-72.409396,8.36068
52759,2018,Mayo,Panamá,5,7,,12,-77.35002,8.63337
52760,2018,Mayo,Panamá,0,1,,1,-75.68164200000001,9.402597
52761,2018,Mayo,Paraguay,0,1,,1,-76.876446,0.33002
52762,2018,Mayo,Paraguay,4,2,,6,-77.35600000000001,0.81488
52763,2018,Mayo,Paraguay,1,0,,1,-75.527794,10.406342
52764,2018,Mayo,Paraguay,104,57,,161,-75.516486,10.446304
52765,2018,Mayo,Paraguay,12,16,,28,-74.77647900000001,10.886686
52766,2018,Mayo,Paraguay,0,1,,1,-72.129595,11.360028999999999
52767,2018,Mayo,Paraguay,82,45,,127,-81.70216500000001,12.5862
52768,2018,Mayo,Paraguay,12,6,,18,-76.532004,3.451668
52769,2018,Mayo,Paraguay,190,145,,335,-74.140516,4.697157
52770,2018,Mayo,Paraguay,0,1,,1,-75.736374,4.815189
52771,2018,Mayo,Paraguay,15,61,,76,-75.42726,6.170465
52772,2018,Mayo,Paraguay,0,2,,2,-72.453013,7.819
52773,2018,Mayo,Perú,18,17,,35,-69.941498,4.191162
52774,2018,Mayo,Perú,23,39,,62,-69.94143100000001,4.214082
52775,2018,Mayo,Perú,1,4,,5,-74.78366,0.18595699999999998
52776,2018,Mayo,Perú,4,9,,13,-76.876446,0.33002
52777,2018,Mayo,Perú,70,252,,322,-77.35600000000001,0.81488
52778,2018,Mayo,Perú,4,8,,12,-75.527794,10.406342
52779,2018,Mayo,Perú,909,552,,1461,-75.516486,10.446304
52780,2018,Mayo,Perú,24,33,,57,-74.77647900000001,10.886686
52781,2018,Mayo,Perú,0,2,,2,-74.213989,11.247722999999999
52782,2018,Mayo,Perú,6,18,,24,-72.129595,11.360028999999999
52783,2018,Mayo,Perú,353,199,,552,-81.70216500000001,12.5862
52784,2018,Mayo,Perú,84,123,,207,-76.532004,3.451668
52785,2018,Mayo,Perú,1,0,,1,-75.76635300000001,4.45285
52786,2018,Mayo,Perú,3935,4532,,8467,-74.140516,4.697157
52787,2018,Mayo,Perú,6,9,,15,-75.736374,4.815189
52788,2018,Mayo,Perú,376,651,,1027,-75.42726,6.170465
52789,2018,Mayo,Perú,4,10,,14,-70.74025300000001,7.088728999999999
52790,2018,Mayo,Perú,0,1,,1,-73.181317,7.1280470000000005
52791,2018,Mayo,Perú,97,202,,299,-72.453013,7.819
52792,2018,Mayo,Perú,2,18,,20,-72.409396,8.36068
52793,2018,Mayo,Perú,0,1,,1,-77.35002,8.63337
52794,2018,Mayo,Palestina,0,1,,1,-74.140516,4.697157
52795,2018,Mayo,Polonia,1,2,,3,-69.94143100000001,4.214082
52796,2018,Mayo,Polonia,1,1,,2,-76.876446,0.33002
52797,2018,Mayo,Polonia,2,2,,4,-77.35600000000001,0.81488
52798,2018,Mayo,Polonia,1,14,,15,-75.527794,10.406342
52799,2018,Mayo,Polonia,23,26,,49,-75.516486,10.446304
52800,2018,Mayo,Polonia,2,2,,4,-74.77647900000001,10.886686
52801,2018,Mayo,Polonia,0,2,,2,-74.765343,10.970933
52802,2018,Mayo,Polonia,2,3,,5,-81.703935,12.574411099999999
52803,2018,Mayo,Polonia,1,0,,1,-81.70216500000001,12.5862
52804,2018,Mayo,Polonia,8,9,,17,-76.532004,3.451668
52805,2018,Mayo,Polonia,118,153,,271,-74.140516,4.697157
52806,2018,Mayo,Polonia,14,27,,41,-75.42726,6.170465
52807,2018,Mayo,Portugal,0,1,,1,-69.94143100000001,4.214082
52808,2018,Mayo,Portugal,0,1,,1,-76.876446,0.33002
52809,2018,Mayo,Portugal,1,7,,8,-77.35600000000001,0.81488
52810,2018,Mayo,Portugal,29,24,,53,-75.516486,10.446304
52811,2018,Mayo,Portugal,0,6,,6,-74.77647900000001,10.886686
52812,2018,Mayo,Portugal,4,4,,8,-72.129595,11.360028999999999
52813,2018,Mayo,Portugal,1,0,,1,-81.70216500000001,12.5862
52814,2018,Mayo,Portugal,6,11,,17,-76.532004,3.451668
52815,2018,Mayo,Portugal,173,426,,599,-74.140516,4.697157
52816,2018,Mayo,Portugal,10,42,,52,-75.42726,6.170465
52817,2018,Mayo,Portugal,8,13,,21,-72.453013,7.819
52818,2018,Mayo,Portugal,0,1,,1,-72.409396,8.36068
52819,2018,Mayo,Portugal,1,0,,1,-77.35002,8.63337
52820,2018,Mayo,Qatar,0,1,,1,-74.140516,4.697157
52821,2018,Mayo,Reino Unido de Gran Bretaña e Irlanda del Norte,4,2,,6,-69.941498,4.191162
52822,2018,Mayo,Reino Unido de Gran Bretaña e Irlanda del Norte,3,8,,11,-69.94143100000001,4.214082
52823,2018,Mayo,Reino Unido de Gran Bretaña e Irlanda del Norte,4,5,,9,-76.876446,0.33002
52824,2018,Mayo,Reino Unido de Gran Bretaña e Irlanda del Norte,97,137,,234,-77.35600000000001,0.81488
52825,2018,Mayo,Reino Unido de Gran Bretaña e Irlanda del Norte,37,48,,85,-75.527794,10.406342
52826,2018,Mayo,Reino Unido de Gran Bretaña e Irlanda del Norte,121,164,,285,-75.516486,10.446304
52827,2018,Mayo,Reino Unido de Gran Bretaña e Irlanda del Norte,12,10,,22,-74.77647900000001,10.886686
52828,2018,Mayo,Reino Unido de Gran Bretaña e Irlanda del Norte,1,0,,1,-74.213989,11.247722999999999
52829,2018,Mayo,Reino Unido de Gran Bretaña e Irlanda del Norte,0,1,,1,-72.129595,11.360028999999999
52830,2018,Mayo,Reino Unido de Gran Bretaña e Irlanda del Norte,1,1,,2,-81.703935,12.574411099999999
52831,2018,Mayo,Reino Unido de Gran Bretaña e Irlanda del Norte,1,1,,2,-81.70216500000001,12.5862
52832,2018,Mayo,Reino Unido de Gran Bretaña e Irlanda del Norte,1,2,,3,-81.372937,13.338761300000002
52833,2018,Mayo,Reino Unido de Gran Bretaña e Irlanda del Norte,27,41,,68,-76.532004,3.451668
52834,2018,Mayo,Reino Unido de Gran Bretaña e Irlanda del Norte,1,2,,3,-75.76635300000001,4.45285
52835,2018,Mayo,Reino Unido de Gran Bretaña e Irlanda del Norte,1002,1900,,2902,-74.140516,4.697157
52836,2018,Mayo,Reino Unido de Gran Bretaña e Irlanda del Norte,1,1,,2,-75.736374,4.815189
52837,2018,Mayo,Reino Unido de Gran Bretaña e Irlanda del Norte,92,238,,330,-75.42726,6.170465
52838,2018,Mayo,Reino Unido de Gran Bretaña e Irlanda del Norte,0,1,,1,-75.586989,6.2188349999999994
52839,2018,Mayo,Reino Unido de Gran Bretaña e Irlanda del Norte,0,3,,3,-72.453013,7.819
52840,2018,Mayo,Reino Unido de Gran Bretaña e Irlanda del Norte,30,27,,57,-77.35002,8.63337
52841,2018,Mayo,República Dominicana,0,2,,2,-69.941498,4.191162
52842,2018,Mayo,República Dominicana,4,8,,12,-77.35600000000001,0.81488
52843,2018,Mayo,República Dominicana,1,4,,5,-75.527794,10.406342
52844,2018,Mayo,República Dominicana,55,67,,122,-75.516486,10.446304
52845,2018,Mayo,República Dominicana,21,58,,79,-74.77647900000001,10.886686
52846,2018,Mayo,República Dominicana,0,6,,6,-72.129595,11.360028999999999
52847,2018,Mayo,República Dominicana,25,27,,52,-76.532004,3.451668
52848,2018,Mayo,República Dominicana,1,0,,1,-75.76635300000001,4.45285
52849,2018,Mayo,República Dominicana,694,703,,1397,-74.140516,4.697157
52850,2018,Mayo,República Dominicana,2,9,,11,-75.736374,4.815189
52851,2018,Mayo,República Dominicana,74,128,,202,-75.42726,6.170465
52852,2018,Mayo,República Dominicana,1,1,,2,-73.181317,7.1280470000000005
52853,2018,Mayo,República Dominicana,2,2,,4,-72.453013,7.819
52854,2018,Mayo,Rumania,0,2,,2,-77.35600000000001,0.81488
52855,2018,Mayo,Rumania,4,8,,12,-75.527794,10.406342
52856,2018,Mayo,Rumania,8,11,,19,-75.516486,10.446304
52857,2018,Mayo,Rumania,1,0,,1,-72.129595,11.360028999999999
52858,2018,Mayo,Rumania,13,1,,14,-76.532004,3.451668
52859,2018,Mayo,Rumania,116,84,,200,-74.140516,4.697157
52860,2018,Mayo,Rumania,4,5,,9,-75.42726,6.170465
52861,2018,Mayo,Rumania,0,1,,1,-73.181317,7.1280470000000005
52862,2018,Mayo,Federación de Rusia,1,0,,1,-69.941498,4.191162
52863,2018,Mayo,Federación de Rusia,0,1,,1,-69.94143100000001,4.214082
52864,2018,Mayo,Federación de Rusia,0,1,,1,-76.876446,0.33002
52865,2018,Mayo,Federación de Rusia,4,9,,13,-77.35600000000001,0.81488
52866,2018,Mayo,Federación de Rusia,0,10,,10,-75.527794,10.406342
52867,2018,Mayo,Federación de Rusia,18,27,,45,-75.516486,10.446304
52868,2018,Mayo,Federación de Rusia,4,2,,6,-74.77647900000001,10.886686
52869,2018,Mayo,Federación de Rusia,0,4,,4,-74.765343,10.970933
52870,2018,Mayo,Federación de Rusia,0,3,,3,-74.213989,11.247722999999999
52871,2018,Mayo,Federación de Rusia,1,0,,1,-72.129595,11.360028999999999
52872,2018,Mayo,Federación de Rusia,4,6,,10,-76.532004,3.451668
52873,2018,Mayo,Federación de Rusia,150,147,,297,-74.140516,4.697157
52874,2018,Mayo,Federación de Rusia,7,21,,28,-75.42726,6.170465
52875,2018,Mayo,Federación de Rusia,1,2,,3,-73.181317,7.1280470000000005
52876,2018,Mayo,Federación de Rusia,0,1,,1,-77.35002,8.63337
52877,2018,Mayo,Rwanda,0,1,,1,-74.140516,4.697157
52878,2018,Mayo,San Cristóbal y Nevis,0,1,,1,-75.516486,10.446304
52879,2018,Mayo,San Cristóbal y Nevis,2,2,,4,-74.140516,4.697157
52880,2018,Mayo,San  Vicente y las Granadinas,2,1,,3,-75.516486,10.446304
52881,2018,Mayo,San  Vicente y las Granadinas,0,1,,1,-74.77647900000001,10.886686
52882,2018,Mayo,San  Vicente y las Granadinas,0,1,,1,-81.70216500000001,12.5862
52883,2018,Mayo,San  Vicente y las Granadinas,3,5,,8,-74.140516,4.697157
52884,2018,Mayo,San  Vicente y las Granadinas,0,1,,1,-75.42726,6.170465
52885,2018,Mayo,San  Vicente y las Granadinas,7,3,,10,-73.181317,7.1280470000000005
52886,2018,Mayo,Santa Lucia,1,1,,2,-75.516486,10.446304
52887,2018,Mayo,Santa Lucia,1,0,,1,-74.77647900000001,10.886686
52888,2018,Mayo,Santa Lucia,4,6,,10,-74.140516,4.697157
52889,2018,Mayo,Santa Lucia,1,3,,4,-75.42726,6.170465
52890,2018,Mayo,Senegal,0,3,,3,-74.140516,4.697157
52891,2018,Mayo,Serbia,0,1,,1,-69.94143100000001,4.214082
52892,2018,Mayo,Serbia,2,5,,7,-75.516486,10.446304
52893,2018,Mayo,Serbia,0,1,,1,-74.77647900000001,10.886686
52894,2018,Mayo,Serbia,0,1,,1,-77.061029,3.8844260000000004
52895,2018,Mayo,Serbia,11,16,,27,-74.140516,4.697157
52896,2018,Mayo,Serbia,0,6,,6,-75.42726,6.170465
52897,2018,Mayo,Singapur,1,1,,2,-77.35600000000001,0.81488
52898,2018,Mayo,Singapur,3,1,,4,-75.516486,10.446304
52899,2018,Mayo,Singapur,1,0,,1,-74.77647900000001,10.886686
52900,2018,Mayo,Singapur,1,0,,1,-76.532004,3.451668
52901,2018,Mayo,Singapur,29,41,,70,-74.140516,4.697157
52902,2018,Mayo,Singapur,3,2,,5,-75.42726,6.170465
52903,2018,Mayo,República Árabe Siria,0,1,,1,-74.140516,4.697157
52904,2018,Mayo,República Árabe Siria,0,1,,1,-70.74025300000001,7.088728999999999
52905,2018,Mayo,Sri Lanka,0,1,,1,-75.516486,10.446304
52906,2018,Mayo,Sri Lanka,0,1,,1,-74.77647900000001,10.886686
52907,2018,Mayo,Sri Lanka,0,1,,1,-74.765343,10.970933
52908,2018,Mayo,Sri Lanka,0,2,,2,-74.213989,11.247722999999999
52909,2018,Mayo,Sri Lanka,1,5,,6,-74.140516,4.697157
52910,2018,Mayo,Sri Lanka,0,1,,1,-75.42726,6.170465
52911,2018,Mayo,Sudáfrica,2,1,,3,-77.35600000000001,0.81488
52912,2018,Mayo,Sudáfrica,0,2,,2,-75.527794,10.406342
52913,2018,Mayo,Sudáfrica,4,5,,9,-75.516486,10.446304
52914,2018,Mayo,Sudáfrica,1,5,,6,-74.77647900000001,10.886686
52915,2018,Mayo,Sudáfrica,0,2,,2,-76.532004,3.451668
52916,2018,Mayo,Sudáfrica,0,2,,2,-77.061029,3.8844260000000004
52917,2018,Mayo,Sudáfrica,19,33,,52,-74.140516,4.697157
52918,2018,Mayo,Sudáfrica,2,6,,8,-75.42726,6.170465
52919,2018,Mayo,Sudán,1,2,,3,-74.140516,4.697157
52920,2018,Mayo,Suecia,1,2,,3,-69.94143100000001,4.214082
52921,2018,Mayo,Suecia,13,10,,23,-77.35600000000001,0.81488
52922,2018,Mayo,Suecia,8,8,,16,-75.527794,10.406342
52923,2018,Mayo,Suecia,14,20,,34,-75.516486,10.446304
52924,2018,Mayo,Suecia,2,8,,10,-74.77647900000001,10.886686
52925,2018,Mayo,Suecia,1,1,,2,-81.372937,13.338761300000002
52926,2018,Mayo,Suecia,10,11,,21,-76.532004,3.451668
52927,2018,Mayo,Suecia,0,1,,1,-75.76635300000001,4.45285
52928,2018,Mayo,Suecia,118,194,,312,-74.140516,4.697157
52929,2018,Mayo,Suecia,0,1,,1,-75.736374,4.815189
52930,2018,Mayo,Suecia,10,25,,35,-75.42726,6.170465
52931,2018,Mayo,Suecia,0,1,,1,-73.181317,7.1280470000000005
52932,2018,Mayo,Suecia,4,3,,7,-77.35002,8.63337
52933,2018,Mayo,Suiza,2,2,,4,-69.941498,4.191162
52934,2018,Mayo,Suiza,5,6,,11,-69.94143100000001,4.214082
52935,2018,Mayo,Suiza,1,3,,4,-76.876446,0.33002
52936,2018,Mayo,Suiza,19,26,,45,-77.35600000000001,0.81488
52937,2018,Mayo,Suiza,27,18,,45,-75.527794,10.406342
52938,2018,Mayo,Suiza,36,36,,72,-75.516486,10.446304
52939,2018,Mayo,Suiza,4,5,,9,-74.77647900000001,10.886686
52940,2018,Mayo,Suiza,1,1,,2,-81.703935,12.574411099999999
52941,2018,Mayo,Suiza,0,2,,2,-81.70216500000001,12.5862
52942,2018,Mayo,Suiza,24,32,,56,-76.532004,3.451668
52943,2018,Mayo,Suiza,291,544,,835,-74.140516,4.697157
52944,2018,Mayo,Suiza,0,1,,1,-75.736374,4.815189
52945,2018,Mayo,Suiza,28,84,,112,-75.42726,6.170465
52946,2018,Mayo,Suiza,0,1,,1,-70.74025300000001,7.088728999999999
52947,2018,Mayo,Suiza,7,7,,14,-77.35002,8.63337
52948,2018,Mayo,Surinam,0,1,,1,-69.941498,4.191162
52949,2018,Mayo,Surinam,0,1,,1,-77.35600000000001,0.81488
52950,2018,Mayo,Surinam,1,3,,4,-75.516486,10.446304
52951,2018,Mayo,Surinam,18,39,,57,-74.140516,4.697157
52952,2018,Mayo,Surinam,2,0,,2,-75.42726,6.170465
52953,2018,Mayo,Surinam,2,2,,4,-73.181317,7.1280470000000005
52954,2018,Mayo,Tailandia,1,2,,3,-77.35600000000001,0.81488
52955,2018,Mayo,Tailandia,1,1,,2,-75.516486,10.446304
52956,2018,Mayo,Tailandia,13,22,,35,-74.140516,4.697157
52957,2018,Mayo,Tailandia,1,0,,1,-75.42726,6.170465
52958,2018,Mayo,Tanzania,0,1,,1,-75.516486,10.446304
52959,2018,Mayo,Tanzania,0,2,,2,-74.140516,4.697157
52960,2018,Mayo,Trinidad y Tobago,9,9,,18,-75.516486,10.446304
52961,2018,Mayo,Trinidad y Tobago,2,4,,6,-74.77647900000001,10.886686
52962,2018,Mayo,Trinidad y Tobago,9,11,,20,-76.532004,3.451668
52963,2018,Mayo,Trinidad y Tobago,18,49,,67,-74.140516,4.697157
52964,2018,Mayo,Trinidad y Tobago,0,1,,1,-75.736374,4.815189
52965,2018,Mayo,Trinidad y Tobago,2,15,,17,-75.42726,6.170465
52966,2018,Mayo,Túnez,0,1,,1,-76.532004,3.451668
52967,2018,Mayo,Túnez,0,6,,6,-74.140516,4.697157
52968,2018,Mayo,Túnez,1,1,,2,-75.42726,6.170465
52969,2018,Mayo,Turquía,0,1,,1,-69.94143100000001,4.214082
52970,2018,Mayo,Turquía,3,7,,10,-77.35600000000001,0.81488
52971,2018,Mayo,Turquía,0,2,,2,-75.527794,10.406342
52972,2018,Mayo,Turquía,4,8,,12,-75.516486,10.446304
52973,2018,Mayo,Turquía,0,1,,1,-72.129595,11.360028999999999
52974,2018,Mayo,Turquía,1,4,,5,-76.532004,3.451668
52975,2018,Mayo,Turquía,156,297,,453,-74.140516,4.697157
52976,2018,Mayo,Turquía,1,17,,18,-75.42726,6.170465
52977,2018,Mayo,Turquía,0,4,,4,-72.453013,7.819
52978,2018,Mayo,Turquía,1,0,,1,-77.35002,8.63337
52979,2018,Mayo,Ucrania,0,15,,15,-75.527794,10.406342
52980,2018,Mayo,Ucrania,3,6,,9,-75.516486,10.446304
52981,2018,Mayo,Ucrania,0,4,,4,-74.77647900000001,10.886686
52982,2018,Mayo,Ucrania,0,2,,2,-74.765343,10.970933
52983,2018,Mayo,Ucrania,0,2,,2,-74.213989,11.247722999999999
52984,2018,Mayo,Ucrania,0,1,,1,-76.532004,3.451668
52985,2018,Mayo,Ucrania,0,2,,2,-77.061029,3.8844260000000004
52986,2018,Mayo,Ucrania,18,26,,44,-74.140516,4.697157
52987,2018,Mayo,Ucrania,1,0,,1,-75.42726,6.170465
52988,2018,Mayo,Uganda,0,1,,1,-75.516486,10.446304
52989,2018,Mayo,Uganda,1,0,,1,-74.140516,4.697157
52990,2018,Mayo,Uruguay,1,1,,2,-69.941498,4.191162
52991,2018,Mayo,Uruguay,0,1,,1,-76.876446,0.33002
52992,2018,Mayo,Uruguay,5,9,,14,-77.35600000000001,0.81488
52993,2018,Mayo,Uruguay,6,9,,15,-75.527794,10.406342
52994,2018,Mayo,Uruguay,111,105,,216,-75.516486,10.446304
52995,2018,Mayo,Uruguay,10,13,,23,-74.77647900000001,10.886686
52996,2018,Mayo,Uruguay,0,3,,3,-72.129595,11.360028999999999
52997,2018,Mayo,Uruguay,13,7,,20,-81.70216500000001,12.5862
52998,2018,Mayo,Uruguay,5,13,,18,-76.532004,3.451668
52999,2018,Mayo,Uruguay,558,704,,1262,-74.140516,4.697157
53000,2018,Mayo,Uruguay,2,1,,3,-75.736374,4.815189
53001,2018,Mayo,Uruguay,36,99,,135,-75.42726,6.170465
53002,2018,Mayo,Uruguay,3,4,,7,-72.453013,7.819
53003,2018,Mayo,Uzbekistán,1,1,,2,-74.140516,4.697157
53004,2018,Mayo,Venezuela,0,6,,6,-69.941498,4.191162
53005,2018,Mayo,Venezuela,2,3,,5,-69.94143100000001,4.214082
53006,2018,Mayo,Venezuela,54,51,,105,-76.876446,0.33002
53007,2018,Mayo,Venezuela,0,2,,2,-77.84700600000001,0.8124359999999999
53008,2018,Mayo,Venezuela,1759,2426,,4185,-77.35600000000001,0.81488
53009,2018,Mayo,Venezuela,3,0,,3,-78.802679,18.00143
53010,2018,Mayo,Venezuela,4,3,,7,-75.527794,10.406342
53011,2018,Mayo,Venezuela,150,196,,346,-75.516486,10.446304
53012,2018,Mayo,Venezuela,109,205,,314,-74.77647900000001,10.886686
53013,2018,Mayo,Venezuela,0,2,,2,-74.213989,11.247722999999999
53014,2018,Mayo,Venezuela,7143,8040,,15183,-72.129595,11.360028999999999
53015,2018,Mayo,Venezuela,6,5,,11,-72.919186,11.52863
53016,2018,Mayo,Venezuela,0,31,,31,-71.983761,12.165168
53017,2018,Mayo,Venezuela,8,3,,11,-81.70216500000001,12.5862
53018,2018,Mayo,Venezuela,72,107,,179,-76.532004,3.451668
53019,2018,Mayo,Venezuela,11,20,,31,-67.927521,3.866713
53020,2018,Mayo,Venezuela,6278,6305,,12583,-74.140516,4.697157
53021,2018,Mayo,Venezuela,8,24,,32,-75.736374,4.815189
53022,2018,Mayo,Venezuela,1195,1319,,2514,-75.42726,6.170465
53023,2018,Mayo,Venezuela,72,64,,136,-67.48402800000001,6.185536
53024,2018,Mayo,Venezuela,874,1013,,1887,-70.74025300000001,7.088728999999999
53025,2018,Mayo,Venezuela,23,16,,39,-73.181317,7.1280470000000005
53026,2018,Mayo,Venezuela,33579,37933,,71512,-72.453013,7.819
53027,2018,Mayo,Venezuela,4,7,,11,-72.508188,7.927233
53028,2018,Mayo,Venezuela,2583,2689,,5272,-72.409396,8.36068
53029,2018,Mayo,Vietnam,0,1,,1,-77.35600000000001,0.81488
53030,2018,Mayo,Vietnam,0,1,,1,-76.532004,3.451668
53031,2018,Mayo,Vietnam,6,5,,11,-74.140516,4.697157
53032,2018,Mayo,República Árabe de Yemen,0,1,,1,-74.140516,4.697157
53033,2018,Mayo,Zambia,1,0,,1,-75.516486,10.446304
53034,2018,Mayo,Zimbabue,0,1,,1,-75.516486,10.446304
53035,2018,Mayo,Zimbabue,1,2,,3,-74.140516,4.697157
53036,2018,Mayo,Zimbabue,1,0,,1,-75.42726,6.170465
53037,2018,Mayo,Anguila/Territorio Británico de Ultramar,0,1,,1,-74.140516,4.697157
53038,2018,Mayo,Refugiado,2,0,,2,-75.516486,10.446304
53039,2018,Mayo,Refugiado,2,2,,4,-74.140516,4.697157
53040,2018,Mayo,Desconocido,6,8,,14,-75.516486,10.446304
53041,2018,Mayo,Desconocido,1,1,,2,-76.532004,3.451668
53042,2018,Mayo,Desconocido,79,152,,231,-74.140516,4.697157
53043,2018,Mayo,Desconocido,1,5,,6,-75.42726,6.170465
53044,2018,Mayo,Desconocido,1,0,,1,-70.74025300000001,7.088728999999999
53045,2018,Mayo,República CentroÁfricana,1,0,,1,-76.532004,3.451668
53046,2018,Junio,Afganistán,0,2,,2,-74.140516,4.697157
53047,2018,Junio,Albania,1,4,,5,-74.140516,4.697157
53048,2018,Junio,Albania,2,1,,3,-75.42726,6.170465
53049,2018,Junio,Alemania,4,5,,9,-69.941498,4.191162
53050,2018,Junio,Alemania,15,22,,37,-69.94143100000001,4.214082
53051,2018,Junio,Alemania,2,4,,6,-76.876446,0.33002
53052,2018,Junio,Alemania,91,73,,164,-77.35600000000001,0.81488
53053,2018,Junio,Alemania,29,28,,57,-75.527794,10.406342
53054,2018,Junio,Alemania,104,134,,238,-75.516486,10.446304
53055,2018,Junio,Alemania,14,29,,43,-74.77647900000001,10.886686
53056,2018,Junio,Alemania,1,3,,4,-74.213989,11.247722999999999
53057,2018,Junio,Alemania,2,1,,3,-72.129595,11.360028999999999
53058,2018,Junio,Alemania,1,3,,4,-81.70216500000001,12.5862
53059,2018,Junio,Alemania,32,58,,90,-76.532004,3.451668
53060,2018,Junio,Alemania,0,2,,2,-77.061029,3.8844260000000004
53061,2018,Junio,Alemania,1523,2128,,3651,-74.140516,4.697157
53062,2018,Junio,Alemania,2,4,,6,-75.736374,4.815189
53063,2018,Junio,Alemania,73,145,,218,-75.42726,6.170465
53064,2018,Junio,Alemania,1,1,,2,-73.181317,7.1280470000000005
53065,2018,Junio,Alemania,3,4,,7,-72.453013,7.819
53066,2018,Junio,Alemania,0,1,,1,-72.409396,8.36068
53067,2018,Junio,Alemania,12,8,,20,-77.35002,8.63337
53068,2018,Junio,Andorra,1,7,,8,-74.140516,4.697157
53069,2018,Junio,Antigua y Barbuda,1,1,,2,-75.516486,10.446304
53070,2018,Junio,Antigua y Barbuda,1,0,,1,-74.77647900000001,10.886686
53071,2018,Junio,Antigua y Barbuda,3,6,,9,-74.140516,4.697157
53072,2018,Junio,Países Bajos,0,1,,1,-74.140516,4.697157
53073,2018,Junio,Arabia Saudita,0,1,,1,-77.35600000000001,0.81488
53074,2018,Junio,Arabia Saudita,0,1,,1,-74.77647900000001,10.886686
53075,2018,Junio,Arabia Saudita,0,13,,13,-74.140516,4.697157
53076,2018,Junio,Arabia Saudita,1,2,,3,-75.42726,6.170465
53077,2018,Junio,Arabia Saudita,0,1,,1,-73.181317,7.1280470000000005
53078,2018,Junio,Argelia,2,5,,7,-74.140516,4.697157
53079,2018,Junio,Argelia,0,2,,2,-75.42726,6.170465
53080,2018,Junio,Argentina,2,1,,3,-69.941498,4.191162
53081,2018,Junio,Argentina,3,13,,16,-69.94143100000001,4.214082
53082,2018,Junio,Argentina,8,17,,25,-76.876446,0.33002
53083,2018,Junio,Argentina,70,121,,191,-77.35600000000001,0.81488
53084,2018,Junio,Argentina,0,1,,1,-78.802679,18.00143
53085,2018,Junio,Argentina,1272,529,,1801,-75.527794,10.406342
53086,2018,Junio,Argentina,1555,1143,,2698,-75.516486,10.446304
53087,2018,Junio,Argentina,13,33,,46,-74.77647900000001,10.886686
53088,2018,Junio,Argentina,3,6,,9,-72.129595,11.360028999999999
53089,2018,Junio,Argentina,397,333,,730,-81.70216500000001,12.5862
53090,2018,Junio,Argentina,0,3,,3,-81.372937,13.338761300000002
53091,2018,Junio,Argentina,30,60,,90,-76.532004,3.451668
53092,2018,Junio,Argentina,0,1,,1,-75.76635300000001,4.45285
53093,2018,Junio,Argentina,3958,4673,,8631,-74.140516,4.697157
53094,2018,Junio,Argentina,3,8,,11,-75.736374,4.815189
53095,2018,Junio,Argentina,133,349,,482,-75.42726,6.170465
53096,2018,Junio,Argentina,0,1,,1,-73.181317,7.1280470000000005
53097,2018,Junio,Argentina,3,17,,20,-72.453013,7.819
53098,2018,Junio,Argentina,0,5,,5,-72.409396,8.36068
53099,2018,Junio,Argentina,0,4,,4,-77.35002,8.63337
53100,2018,Junio,República de Armenia,1,0,,1,-74.140516,4.697157
53101,2018,Junio,República de Armenia,0,1,,1,-75.42726,6.170465
53102,2018,Junio,Australia,1,0,,1,-69.941498,4.191162
53103,2018,Junio,Australia,2,8,,10,-69.94143100000001,4.214082
53104,2018,Junio,Australia,1,0,,1,-76.876446,0.33002
53105,2018,Junio,Australia,23,28,,51,-77.35600000000001,0.81488
53106,2018,Junio,Australia,15,27,,42,-75.527794,10.406342
53107,2018,Junio,Australia,51,76,,127,-75.516486,10.446304
53108,2018,Junio,Australia,7,19,,26,-74.77647900000001,10.886686
53109,2018,Junio,Australia,0,1,,1,-74.213989,11.247722999999999
53110,2018,Junio,Australia,0,1,,1,-72.129595,11.360028999999999
53111,2018,Junio,Australia,1,1,,2,-81.70216500000001,12.5862
53112,2018,Junio,Australia,10,15,,25,-76.532004,3.451668
53113,2018,Junio,Australia,352,579,,931,-74.140516,4.697157
53114,2018,Junio,Australia,38,80,,118,-75.42726,6.170465
53115,2018,Junio,Australia,0,1,,1,-72.453013,7.819
53116,2018,Junio,Australia,12,18,,30,-77.35002,8.63337
53117,2018,Junio,Austria,1,1,,2,-69.941498,4.191162
53118,2018,Junio,Austria,0,2,,2,-69.94143100000001,4.214082
53119,2018,Junio,Austria,2,0,,2,-76.876446,0.33002
53120,2018,Junio,Austria,4,5,,9,-77.35600000000001,0.81488
53121,2018,Junio,Austria,3,7,,10,-75.527794,10.406342
53122,2018,Junio,Austria,8,17,,25,-75.516486,10.446304
53123,2018,Junio,Austria,0,2,,2,-74.77647900000001,10.886686
53124,2018,Junio,Austria,0,1,,1,-81.70216500000001,12.5862
53125,2018,Junio,Austria,1,4,,5,-76.532004,3.451668
53126,2018,Junio,Austria,112,178,,290,-74.140516,4.697157
53127,2018,Junio,Austria,12,21,,33,-75.42726,6.170465
53128,2018,Junio,Austria,1,1,,2,-77.35002,8.63337
53129,2018,Junio,Azerbaiyán,1,3,,4,-74.140516,4.697157
53130,2018,Junio,Azerbaiyán,1,0,,1,-75.42726,6.170465
53131,2018,Junio,Bahamas,0,1,,1,-75.527794,10.406342
53132,2018,Junio,Bahamas,5,2,,7,-75.516486,10.446304
53133,2018,Junio,Bahamas,2,4,,6,-76.532004,3.451668
53134,2018,Junio,Bahamas,7,5,,12,-74.140516,4.697157
53135,2018,Junio,Bahamas,1,6,,7,-75.42726,6.170465
53136,2018,Junio,Bahréin,0,1,,1,-75.516486,10.446304
53137,2018,Junio,Bangladesh,1,0,,1,-75.516486,10.446304
53138,2018,Junio,Bangladesh,2,2,,4,-74.140516,4.697157
53139,2018,Junio,Barbados,1,0,,1,-75.527794,10.406342
53140,2018,Junio,Barbados,11,4,,15,-75.516486,10.446304
53141,2018,Junio,Barbados,0,2,,2,-74.77647900000001,10.886686
53142,2018,Junio,Barbados,0,1,,1,-76.532004,3.451668
53143,2018,Junio,Barbados,6,11,,17,-74.140516,4.697157
53144,2018,Junio,Barbados,3,2,,5,-75.42726,6.170465
53145,2018,Junio,República de Belarús,1,0,,1,-75.516486,10.446304
53146,2018,Junio,República de Belarús,4,3,,7,-74.140516,4.697157
53147,2018,Junio,Bélgica,1,1,,2,-69.941498,4.191162
53148,2018,Junio,Bélgica,3,1,,4,-69.94143100000001,4.214082
53149,2018,Junio,Bélgica,0,1,,1,-76.876446,0.33002
53150,2018,Junio,Bélgica,11,14,,25,-77.35600000000001,0.81488
53151,2018,Junio,Bélgica,2,3,,5,-75.527794,10.406342
53152,2018,Junio,Bélgica,17,27,,44,-75.516486,10.446304
53153,2018,Junio,Bélgica,4,6,,10,-74.77647900000001,10.886686
53154,2018,Junio,Bélgica,0,1,,1,-81.703935,12.574411099999999
53155,2018,Junio,Bélgica,15,25,,40,-76.532004,3.451668
53156,2018,Junio,Bélgica,276,425,,701,-74.140516,4.697157
53157,2018,Junio,Bélgica,35,51,,86,-75.42726,6.170465
53158,2018,Junio,Bélgica,0,2,,2,-73.181317,7.1280470000000005
53159,2018,Junio,Bélgica,2,1,,3,-77.35002,8.63337
53160,2018,Junio,Belice,0,2,,2,-75.516486,10.446304
53161,2018,Junio,Belice,0,1,,1,-81.70216500000001,12.5862
53162,2018,Junio,Belice,0,1,,1,-76.532004,3.451668
53163,2018,Junio,Belice,9,11,,20,-74.140516,4.697157
53164,2018,Junio,Benín,1,0,,1,-74.77647900000001,10.886686
53165,2018,Junio,Benín,0,3,,3,-74.140516,4.697157
53166,2018,Junio,Bermudas/Territorio Británico de Ultramar,0,2,,2,-75.516486,10.446304
53167,2018,Junio,Bermudas/Territorio Británico de Ultramar,0,1,,1,-76.532004,3.451668
53168,2018,Junio,Bermudas/Territorio Británico de Ultramar,0,1,,1,-74.140516,4.697157
53169,2018,Junio,Bolivia,1,0,,1,-69.94143100000001,4.214082
53170,2018,Junio,Bolivia,5,5,,10,-77.35600000000001,0.81488
53171,2018,Junio,Bolivia,11,9,,20,-75.527794,10.406342
53172,2018,Junio,Bolivia,108,62,,170,-75.516486,10.446304
53173,2018,Junio,Bolivia,0,2,,2,-74.77647900000001,10.886686
53174,2018,Junio,Bolivia,1,0,,1,-72.129595,11.360028999999999
53175,2018,Junio,Bolivia,9,6,,15,-81.70216500000001,12.5862
53176,2018,Junio,Bolivia,22,29,,51,-76.532004,3.451668
53177,2018,Junio,Bolivia,627,716,,1343,-74.140516,4.697157
53178,2018,Junio,Bolivia,2,0,,2,-75.736374,4.815189
53179,2018,Junio,Bolivia,30,51,,81,-75.42726,6.170465
53180,2018,Junio,Bolivia,0,1,,1,-70.74025300000001,7.088728999999999
53181,2018,Junio,Bolivia,0,1,,1,-73.181317,7.1280470000000005
53182,2018,Junio,Bolivia,1,8,,9,-72.453013,7.819
53183,2018,Junio,Bosnia y Herzegovina,1,0,,1,-75.516486,10.446304
53184,2018,Junio,Bosnia y Herzegovina,0,1,,1,-76.532004,3.451668
53185,2018,Junio,Bosnia y Herzegovina,1,7,,8,-74.140516,4.697157
53186,2018,Junio,Botsuana,1,0,,1,-75.42726,6.170465
53187,2018,Junio,Brasil,119,116,,235,-69.941498,4.191162
53188,2018,Junio,Brasil,1,6,,7,-69.94143100000001,4.214082
53189,2018,Junio,Brasil,1,2,,3,-76.876446,0.33002
53190,2018,Junio,Brasil,0,1,,1,-77.84700600000001,0.8124359999999999
53191,2018,Junio,Brasil,15,47,,62,-77.35600000000001,0.81488
53192,2018,Junio,Brasil,302,190,,492,-75.527794,10.406342
53193,2018,Junio,Brasil,827,602,,1429,-75.516486,10.446304
53194,2018,Junio,Brasil,9,23,,32,-74.77647900000001,10.886686
53195,2018,Junio,Brasil,1,2,,3,-72.129595,11.360028999999999
53196,2018,Junio,Brasil,344,271,,615,-81.70216500000001,12.5862
53197,2018,Junio,Brasil,33,48,,81,-76.532004,3.451668
53198,2018,Junio,Brasil,1,3,,4,-67.927521,3.866713
53199,2018,Junio,Brasil,4746,5864,,10610,-74.140516,4.697157
53200,2018,Junio,Brasil,3,2,,5,-75.736374,4.815189
53201,2018,Junio,Brasil,118,211,,329,-75.42726,6.170465
53202,2018,Junio,Brasil,1,0,,1,-67.48402800000001,6.185536
53203,2018,Junio,Brasil,1,1,,2,-73.181317,7.1280470000000005
53204,2018,Junio,Brasil,5,7,,12,-72.453013,7.819
53205,2018,Junio,Brasil,2,2,,4,-72.409396,8.36068
53206,2018,Junio,Brasil,0,2,,2,-77.35002,8.63337
53207,2018,Junio,Brunei Darussalam,1,1,,2,-74.140516,4.697157
53208,2018,Junio,Bulgaria,0,1,,1,-75.527794,10.406342
53209,2018,Junio,Bulgaria,5,3,,8,-75.516486,10.446304
53210,2018,Junio,Bulgaria,1,0,,1,-74.77647900000001,10.886686
53211,2018,Junio,Bulgaria,2,4,,6,-76.532004,3.451668
53212,2018,Junio,Bulgaria,25,20,,45,-74.140516,4.697157
53213,2018,Junio,Bulgaria,2,3,,5,-75.42726,6.170465
53214,2018,Junio,Burkina Faso,0,1,,1,-74.140516,4.697157
53215,2018,Junio,Burundi,0,2,,2,-74.140516,4.697157
53216,2018,Junio,Bután,1,0,,1,-74.140516,4.697157
53217,2018,Junio,Cabo Verde,0,1,,1,-75.516486,10.446304
53218,2018,Junio,Cabo Verde,1,1,,2,-74.140516,4.697157
53219,2018,Junio,Cabo Verde,1,0,,1,-75.42726,6.170465
53220,2018,Junio,Islas Caimán/Territorio Británico de Ultramar,3,1,,4,-75.516486,10.446304
53221,2018,Junio,Islas Caimán/Territorio Británico de Ultramar,0,1,,1,-74.77647900000001,10.886686
53222,2018,Junio,Islas Caimán/Territorio Británico de Ultramar,3,1,,4,-81.70216500000001,12.5862
53223,2018,Junio,Islas Caimán/Territorio Británico de Ultramar,7,3,,10,-74.140516,4.697157
53224,2018,Junio,Islas Caimán/Territorio Británico de Ultramar,0,1,,1,-75.42726,6.170465
53225,2018,Junio,Camerún,0,1,,1,-77.35600000000001,0.81488
53226,2018,Junio,Camerún,1,0,,1,-75.516486,10.446304
53227,2018,Junio,Camerún,4,2,,6,-74.140516,4.697157
53228,2018,Junio,Camerún,1,0,,1,-75.736374,4.815189
53229,2018,Junio,Canadá,1,1,,2,-69.94143100000001,4.214082
53230,2018,Junio,Canadá,0,1,,1,-76.876446,0.33002
53231,2018,Junio,Canadá,15,12,,27,-77.35600000000001,0.81488
53232,2018,Junio,Canadá,7,10,,17,-75.527794,10.406342
53233,2018,Junio,Canadá,178,245,,423,-75.516486,10.446304
53234,2018,Junio,Canadá,28,32,,60,-74.77647900000001,10.886686
53235,2018,Junio,Canadá,0,1,,1,-72.129595,11.360028999999999
53236,2018,Junio,Canadá,1,3,,4,-81.70216500000001,12.5862
53237,2018,Junio,Canadá,0,1,,1,-81.372937,13.338761300000002
53238,2018,Junio,Canadá,57,52,,109,-76.532004,3.451668
53239,2018,Junio,Canadá,2,3,,5,-75.76635300000001,4.45285
53240,2018,Junio,Canadá,1075,1574,,2649,-74.140516,4.697157
53241,2018,Junio,Canadá,5,19,,24,-75.736374,4.815189
53242,2018,Junio,Canadá,183,391,,574,-75.42726,6.170465
53243,2018,Junio,Canadá,4,9,,13,-73.181317,7.1280470000000005
53244,2018,Junio,Canadá,1,1,,2,-72.453013,7.819
53245,2018,Junio,Canadá,0,1,,1,-72.409396,8.36068
53246,2018,Junio,Canadá,0,2,,2,-77.35002,8.63337
53247,2018,Junio,República Democrática del Congo,5,3,,8,-74.140516,4.697157
53248,2018,Junio,República de Corea,0,1,,1,-69.941498,4.191162
53249,2018,Junio,República de Corea,2,2,,4,-69.94143100000001,4.214082
53250,2018,Junio,República de Corea,15,11,,26,-77.35600000000001,0.81488
53251,2018,Junio,República de Corea,1,2,,3,-75.527794,10.406342
53252,2018,Junio,República de Corea,18,22,,40,-75.516486,10.446304
53253,2018,Junio,República de Corea,1,2,,3,-74.77647900000001,10.886686
53254,2018,Junio,República de Corea,0,1,,1,-81.70216500000001,12.5862
53255,2018,Junio,República de Corea,2,3,,5,-76.532004,3.451668
53256,2018,Junio,República de Corea,251,402,,653,-74.140516,4.697157
53257,2018,Junio,República de Corea,9,33,,42,-75.42726,6.170465
53258,2018,Junio,República de Corea,1,3,,4,-72.453013,7.819
53259,2018,Junio,Costa de Marfil,0,3,,3,-74.140516,4.697157
53260,2018,Junio,Costa de Marfil,1,0,,1,-75.42726,6.170465
53261,2018,Junio,Costa Rica,5,3,,8,-77.35600000000001,0.81488
53262,2018,Junio,Costa Rica,2,0,,2,-75.527794,10.406342
53263,2018,Junio,Costa Rica,151,108,,259,-75.516486,10.446304
53264,2018,Junio,Costa Rica,10,15,,25,-74.77647900000001,10.886686
53265,2018,Junio,Costa Rica,1,0,,1,-72.129595,11.360028999999999
53266,2018,Junio,Costa Rica,0,1,,1,-81.703935,12.574411099999999
53267,2018,Junio,Costa Rica,46,28,,74,-81.70216500000001,12.5862
53268,2018,Junio,Costa Rica,31,49,,80,-76.532004,3.451668
53269,2018,Junio,Costa Rica,1,0,,1,-75.76635300000001,4.45285
53270,2018,Junio,Costa Rica,1432,1721,,3153,-74.140516,4.697157
53271,2018,Junio,Costa Rica,1,3,,4,-75.736374,4.815189
53272,2018,Junio,Costa Rica,119,178,,297,-75.42726,6.170465
53273,2018,Junio,Costa Rica,0,1,,1,-70.74025300000001,7.088728999999999
53274,2018,Junio,Costa Rica,2,6,,8,-73.181317,7.1280470000000005
53275,2018,Junio,Costa Rica,0,1,,1,-77.35002,8.63337
53276,2018,Junio,Croacia,1,0,,1,-69.94143100000001,4.214082
53277,2018,Junio,Croacia,0,1,,1,-75.527794,10.406342
53278,2018,Junio,Croacia,1,3,,4,-75.516486,10.446304
53279,2018,Junio,Croacia,0,1,,1,-72.129595,11.360028999999999
53280,2018,Junio,Croacia,0,2,,2,-77.061029,3.8844260000000004
53281,2018,Junio,Croacia,14,38,,52,-74.140516,4.697157
53282,2018,Junio,Croacia,1,4,,5,-75.42726,6.170465
53283,2018,Junio,Cuba,1,0,,1,-69.941498,4.191162
53284,2018,Junio,Cuba,0,1,,1,-76.876446,0.33002
53285,2018,Junio,Cuba,0,1,,1,-77.35600000000001,0.81488
53286,2018,Junio,Cuba,9,24,,33,-75.516486,10.446304
53287,2018,Junio,Cuba,11,49,,60,-74.77647900000001,10.886686
53288,2018,Junio,Cuba,0,1,,1,-81.703935,12.574411099999999
53289,2018,Junio,Cuba,14,28,,42,-76.532004,3.451668
53290,2018,Junio,Cuba,217,399,,616,-74.140516,4.697157
53291,2018,Junio,Cuba,1,1,,2,-75.736374,4.815189
53292,2018,Junio,Cuba,24,36,,60,-75.42726,6.170465
53293,2018,Junio,Cuba,2,0,,2,-73.181317,7.1280470000000005
53294,2018,Junio,Cuba,1,1,,2,-72.453013,7.819
53295,2018,Junio,República Checa,0,1,,1,-69.94143100000001,4.214082
53296,2018,Junio,República Checa,3,5,,8,-77.35600000000001,0.81488
53297,2018,Junio,República Checa,6,2,,8,-75.516486,10.446304
53298,2018,Junio,República Checa,4,3,,7,-74.77647900000001,10.886686
53299,2018,Junio,República Checa,1,0,,1,-81.372937,13.338761300000002
53300,2018,Junio,República Checa,5,3,,8,-76.532004,3.451668
53301,2018,Junio,República Checa,0,1,,1,-77.061029,3.8844260000000004
53302,2018,Junio,República Checa,38,83,,121,-74.140516,4.697157
53303,2018,Junio,República Checa,5,6,,11,-75.42726,6.170465
53304,2018,Junio,Chile,3,0,,3,-69.941498,4.191162
53305,2018,Junio,Chile,2,5,,7,-69.94143100000001,4.214082
53306,2018,Junio,Chile,3,4,,7,-76.876446,0.33002
53307,2018,Junio,Chile,31,61,,92,-77.35600000000001,0.81488
53308,2018,Junio,Chile,152,100,,252,-75.527794,10.406342
53309,2018,Junio,Chile,573,451,,1024,-75.516486,10.446304
53310,2018,Junio,Chile,7,15,,22,-74.77647900000001,10.886686
53311,2018,Junio,Chile,1,2,,3,-72.129595,11.360028999999999
53312,2018,Junio,Chile,0,1,,1,-81.703935,12.574411099999999
53313,2018,Junio,Chile,114,83,,197,-81.70216500000001,12.5862
53314,2018,Junio,Chile,22,48,,70,-76.532004,3.451668
53315,2018,Junio,Chile,0,2,,2,-75.76635300000001,4.45285
53316,2018,Junio,Chile,4032,5164,,9196,-74.140516,4.697157
53317,2018,Junio,Chile,0,5,,5,-75.736374,4.815189
53318,2018,Junio,Chile,75,128,,203,-75.42726,6.170465
53319,2018,Junio,Chile,0,3,,3,-70.74025300000001,7.088728999999999
53320,2018,Junio,Chile,0,1,,1,-73.181317,7.1280470000000005
53321,2018,Junio,Chile,9,23,,32,-72.453013,7.819
53322,2018,Junio,Chile,3,5,,8,-72.409396,8.36068
53323,2018,Junio,Chile,1,1,,2,-77.35002,8.63337
53324,2018,Junio,China,5,8,,13,-77.35600000000001,0.81488
53325,2018,Junio,China,0,4,,4,-75.527794,10.406342
53326,2018,Junio,China,29,39,,68,-75.516486,10.446304
53327,2018,Junio,China,7,17,,24,-74.77647900000001,10.886686
53328,2018,Junio,China,0,2,,2,-74.765343,10.970933
53329,2018,Junio,China,0,5,,5,-74.213989,11.247722999999999
53330,2018,Junio,China,1,4,,5,-72.129595,11.360028999999999
53331,2018,Junio,China,12,23,,35,-76.532004,3.451668
53332,2018,Junio,China,0,2,,2,-77.061029,3.8844260000000004
53333,2018,Junio,China,385,825,,1210,-74.140516,4.697157
53334,2018,Junio,China,1,0,,1,-75.736374,4.815189
53335,2018,Junio,China,69,142,,211,-75.42726,6.170465
53336,2018,Junio,China,0,3,,3,-72.453013,7.819
53337,2018,Junio,Taiwán,0,1,,1,-69.941498,4.191162
53338,2018,Junio,Taiwán,1,1,,2,-69.94143100000001,4.214082
53339,2018,Junio,Taiwán,0,4,,4,-77.35600000000001,0.81488
53340,2018,Junio,Taiwán,3,3,,6,-75.516486,10.446304
53341,2018,Junio,Taiwán,1,0,,1,-74.77647900000001,10.886686
53342,2018,Junio,Taiwán,2,0,,2,-76.532004,3.451668
53343,2018,Junio,Taiwán,65,69,,134,-74.140516,4.697157
53344,2018,Junio,Taiwán,8,6,,14,-75.42726,6.170465
53345,2018,Junio,Chipre,1,1,,2,-75.516486,10.446304
53346,2018,Junio,Chipre,0,1,,1,-76.532004,3.451668
53347,2018,Junio,Chipre,9,5,,14,-74.140516,4.697157
53348,2018,Junio,Chipre,0,1,,1,-75.42726,6.170465
53349,2018,Junio,Dinamarca,6,8,,14,-77.35600000000001,0.81488
53350,2018,Junio,Dinamarca,0,1,,1,-75.527794,10.406342
53351,2018,Junio,Dinamarca,13,16,,29,-75.516486,10.446304
53352,2018,Junio,Dinamarca,0,5,,5,-74.77647900000001,10.886686
53353,2018,Junio,Dinamarca,1,0,,1,-81.703935,12.574411099999999
53354,2018,Junio,Dinamarca,7,10,,17,-76.532004,3.451668
53355,2018,Junio,Dinamarca,132,200,,332,-74.140516,4.697157
53356,2018,Junio,Dinamarca,7,25,,32,-75.42726,6.170465
53357,2018,Junio,Dinamarca,1,2,,3,-77.35002,8.63337
53358,2018,Junio,Dominica,1,1,,2,-75.516486,10.446304
53359,2018,Junio,Dominica,4,6,,10,-74.140516,4.697157
53360,2018,Junio,Dominica,0,1,,1,-75.42726,6.170465
53361,2018,Junio,Ecuador,0,2,,2,-69.94143100000001,4.214082
53362,2018,Junio,Ecuador,45,178,,223,-76.876446,0.33002
53363,2018,Junio,Ecuador,19,30,,49,-77.84700600000001,0.8124359999999999
53364,2018,Junio,Ecuador,830,1451,,2281,-77.35600000000001,0.81488
53365,2018,Junio,Ecuador,15,42,,57,-78.802679,18.00143
53366,2018,Junio,Ecuador,7,5,,12,-75.527794,10.406342
53367,2018,Junio,Ecuador,127,105,,232,-75.516486,10.446304
53368,2018,Junio,Ecuador,6,12,,18,-74.77647900000001,10.886686
53369,2018,Junio,Ecuador,5,5,,10,-72.129595,11.360028999999999
53370,2018,Junio,Ecuador,0,1,,1,-81.703935,12.574411099999999
53371,2018,Junio,Ecuador,17,11,,28,-81.70216500000001,12.5862
53372,2018,Junio,Ecuador,329,394,,723,-76.532004,3.451668
53373,2018,Junio,Ecuador,1,0,,1,-67.927521,3.866713
53374,2018,Junio,Ecuador,1,2,,3,-75.76635300000001,4.45285
53375,2018,Junio,Ecuador,2751,3734,,6485,-74.140516,4.697157
53376,2018,Junio,Ecuador,1,0,,1,-75.736374,4.815189
53377,2018,Junio,Ecuador,88,114,,202,-75.42726,6.170465
53378,2018,Junio,Ecuador,0,1,,1,-70.74025300000001,7.088728999999999
53379,2018,Junio,Ecuador,1,0,,1,-73.181317,7.1280470000000005
53380,2018,Junio,Ecuador,84,116,,200,-72.453013,7.819
53381,2018,Junio,Ecuador,1,5,,6,-72.409396,8.36068
53382,2018,Junio,Egipto,1,1,,2,-75.516486,10.446304
53383,2018,Junio,Egipto,1,2,,3,-76.532004,3.451668
53384,2018,Junio,Egipto,5,22,,27,-74.140516,4.697157
53385,2018,Junio,Egipto,1,2,,3,-75.42726,6.170465
53386,2018,Junio,El Salvador,0,2,,2,-69.94143100000001,4.214082
53387,2018,Junio,El Salvador,2,1,,3,-77.35600000000001,0.81488
53388,2018,Junio,El Salvador,0,1,,1,-75.527794,10.406342
53389,2018,Junio,El Salvador,39,45,,84,-75.516486,10.446304
53390,2018,Junio,El Salvador,2,2,,4,-74.77647900000001,10.886686
53391,2018,Junio,El Salvador,2,3,,5,-81.70216500000001,12.5862
53392,2018,Junio,El Salvador,8,8,,16,-76.532004,3.451668
53393,2018,Junio,El Salvador,682,927,,1609,-74.140516,4.697157
53394,2018,Junio,El Salvador,1,0,,1,-75.736374,4.815189
53395,2018,Junio,El Salvador,129,149,,278,-75.42726,6.170465
53396,2018,Junio,El Salvador,1,0,,1,-70.74025300000001,7.088728999999999
53397,2018,Junio,El Salvador,0,1,,1,-73.181317,7.1280470000000005
53398,2018,Junio,El Salvador,0,2,,2,-72.453013,7.819
53399,2018,Junio,El Salvador,0,1,,1,-77.35002,8.63337
53400,2018,Junio,Emiratos Árabes,2,2,,4,-75.516486,10.446304
53401,2018,Junio,Emiratos Árabes,6,11,,17,-74.140516,4.697157
53402,2018,Junio,Emiratos Árabes,0,1,,1,-75.42726,6.170465
53403,2018,Junio,España,2,2,,4,-69.941498,4.191162
53404,2018,Junio,España,3,6,,9,-69.94143100000001,4.214082
53405,2018,Junio,España,4,1,,5,-76.876446,0.33002
53406,2018,Junio,España,30,41,,71,-77.35600000000001,0.81488
53407,2018,Junio,España,17,22,,39,-75.527794,10.406342
53408,2018,Junio,España,101,153,,254,-75.516486,10.446304
53409,2018,Junio,España,27,63,,90,-74.77647900000001,10.886686
53410,2018,Junio,España,0,1,,1,-74.765343,10.970933
53411,2018,Junio,España,0,2,,2,-74.213989,11.247722999999999
53412,2018,Junio,España,1,9,,10,-72.129595,11.360028999999999
53413,2018,Junio,España,0,2,,2,-81.70216500000001,12.5862
53414,2018,Junio,España,537,593,,1130,-76.532004,3.451668
53415,2018,Junio,España,1,0,,1,-75.76635300000001,4.45285
53416,2018,Junio,España,3099,5432,,8531,-74.140516,4.697157
53417,2018,Junio,España,8,10,,18,-75.736374,4.815189
53418,2018,Junio,España,438,730,,1168,-75.42726,6.170465
53419,2018,Junio,España,0,3,,3,-70.74025300000001,7.088728999999999
53420,2018,Junio,España,0,1,,1,-73.181317,7.1280470000000005
53421,2018,Junio,España,16,27,,43,-72.453013,7.819
53422,2018,Junio,España,3,1,,4,-72.409396,8.36068
53423,2018,Junio,España,1,1,,2,-77.35002,8.63337
53424,2018,Junio,Eslovaquia,4,0,,4,-77.35600000000001,0.81488
53425,2018,Junio,Eslovaquia,2,0,,2,-75.516486,10.446304
53426,2018,Junio,Eslovaquia,1,1,,2,-76.532004,3.451668
53427,2018,Junio,Eslovaquia,22,20,,42,-74.140516,4.697157
53428,2018,Junio,Eslovaquia,1,4,,5,-75.42726,6.170465
53429,2018,Junio,Eslovenia,2,1,,3,-75.516486,10.446304
53430,2018,Junio,Eslovenia,1,1,,2,-76.532004,3.451668
53431,2018,Junio,Eslovenia,8,17,,25,-74.140516,4.697157
53432,2018,Junio,Eslovenia,0,4,,4,-75.42726,6.170465
53433,2018,Junio,Estados Unidos de América,22,28,,50,-69.941498,4.191162
53434,2018,Junio,Estados Unidos de América,13,8,,21,-69.94143100000001,4.214082
53435,2018,Junio,Estados Unidos de América,1,3,,4,-76.876446,0.33002
53436,2018,Junio,Estados Unidos de América,0,1,,1,-77.84700600000001,0.8124359999999999
53437,2018,Junio,Estados Unidos de América,34,55,,89,-77.35600000000001,0.81488
53438,2018,Junio,Estados Unidos de América,14,40,,54,-75.527794,10.406342
53439,2018,Junio,Estados Unidos de América,5501,7292,,12793,-75.516486,10.446304
53440,2018,Junio,Estados Unidos de América,1042,1561,,2603,-74.77647900000001,10.886686
53441,2018,Junio,Estados Unidos de América,1,2,,3,-74.213989,11.247722999999999
53442,2018,Junio,Estados Unidos de América,7,8,,15,-72.129595,11.360028999999999
53443,2018,Junio,Estados Unidos de América,1,12,,13,-81.703935,12.574411099999999
53444,2018,Junio,Estados Unidos de América,74,72,,146,-81.70216500000001,12.5862
53445,2018,Junio,Estados Unidos de América,2,2,,4,-81.372937,13.338761300000002
53446,2018,Junio,Estados Unidos de América,2022,2450,,4472,-76.532004,3.451668
53447,2018,Junio,Estados Unidos de América,273,294,,567,-75.76635300000001,4.45285
53448,2018,Junio,Estados Unidos de América,13650,19136,,32786,-74.140516,4.697157
53449,2018,Junio,Estados Unidos de América,309,373,,682,-75.736374,4.815189
53450,2018,Junio,Estados Unidos de América,4384,7645,,12029,-75.42726,6.170465
53451,2018,Junio,Estados Unidos de América,1,1,,2,-70.74025300000001,7.088728999999999
53452,2018,Junio,Estados Unidos de América,74,109,,183,-73.181317,7.1280470000000005
53453,2018,Junio,Estados Unidos de América,8,11,,19,-72.453013,7.819
53454,2018,Junio,Estados Unidos de América,0,3,,3,-72.409396,8.36068
53455,2018,Junio,Estados Unidos de América,6,14,,20,-77.35002,8.63337
53456,2018,Junio,Estonia,1,2,,3,-77.35600000000001,0.81488
53457,2018,Junio,Estonia,0,1,,1,-75.527794,10.406342
53458,2018,Junio,Estonia,4,0,,4,-76.532004,3.451668
53459,2018,Junio,Estonia,6,4,,10,-74.140516,4.697157
53460,2018,Junio,Estonia,3,5,,8,-75.42726,6.170465
53461,2018,Junio,Etiopia,0,2,,2,-75.516486,10.446304
53462,2018,Junio,Etiopia,3,15,,18,-74.140516,4.697157
53463,2018,Junio,Filipinas,1,1,,2,-77.35600000000001,0.81488
53464,2018,Junio,Filipinas,0,32,,32,-75.527794,10.406342
53465,2018,Junio,Filipinas,9,51,,60,-75.516486,10.446304
53466,2018,Junio,Filipinas,0,5,,5,-74.77647900000001,10.886686
53467,2018,Junio,Filipinas,0,7,,7,-74.765343,10.970933
53468,2018,Junio,Filipinas,0,12,,12,-74.213989,11.247722999999999
53469,2018,Junio,Filipinas,5,16,,21,-76.532004,3.451668
53470,2018,Junio,Filipinas,0,22,,22,-77.061029,3.8844260000000004
53471,2018,Junio,Filipinas,39,60,,99,-74.140516,4.697157
53472,2018,Junio,Filipinas,8,6,,14,-75.42726,6.170465
53473,2018,Junio,Filipinas,0,3,,3,-75.68164200000001,9.402597
53474,2018,Junio,Finlandia,0,1,,1,-69.94143100000001,4.214082
53475,2018,Junio,Finlandia,2,0,,2,-77.35600000000001,0.81488
53476,2018,Junio,Finlandia,6,2,,8,-75.516486,10.446304
53477,2018,Junio,Finlandia,3,1,,4,-74.77647900000001,10.886686
53478,2018,Junio,Finlandia,5,4,,9,-76.532004,3.451668
53479,2018,Junio,Finlandia,47,50,,97,-74.140516,4.697157
53480,2018,Junio,Finlandia,7,11,,18,-75.42726,6.170465
53481,2018,Junio,Finlandia,1,1,,2,-77.35002,8.63337
53482,2018,Junio,Francia,6,2,,8,-69.941498,4.191162
53483,2018,Junio,Francia,19,25,,44,-69.94143100000001,4.214082
53484,2018,Junio,Francia,8,9,,17,-76.876446,0.33002
53485,2018,Junio,Francia,0,1,,1,-77.84700600000001,0.8124359999999999
53486,2018,Junio,Francia,109,118,,227,-77.35600000000001,0.81488
53487,2018,Junio,Francia,12,13,,25,-75.527794,10.406342
53488,2018,Junio,Francia,114,170,,284,-75.516486,10.446304
53489,2018,Junio,Francia,32,42,,74,-74.77647900000001,10.886686
53490,2018,Junio,Francia,3,5,,8,-74.213989,11.247722999999999
53491,2018,Junio,Francia,3,7,,10,-72.129595,11.360028999999999
53492,2018,Junio,Francia,2,2,,4,-81.70216500000001,12.5862
53493,2018,Junio,Francia,1,1,,2,-81.372937,13.338761300000002
53494,2018,Junio,Francia,54,86,,140,-76.532004,3.451668
53495,2018,Junio,Francia,1554,2314,,3868,-74.140516,4.697157
53496,2018,Junio,Francia,3,9,,12,-75.736374,4.815189
53497,2018,Junio,Francia,112,226,,338,-75.42726,6.170465
53498,2018,Junio,Francia,0,1,,1,-70.74025300000001,7.088728999999999
53499,2018,Junio,Francia,0,4,,4,-73.181317,7.1280470000000005
53500,2018,Junio,Francia,1,2,,3,-72.453013,7.819
53501,2018,Junio,Francia,2,0,,2,-72.409396,8.36068
53502,2018,Junio,Francia,8,9,,17,-77.35002,8.63337
53503,2018,Junio,Gabón,1,1,,2,-74.140516,4.697157
53504,2018,Junio,Georgia,1,0,,1,-76.532004,3.451668
53505,2018,Junio,Georgia,2,0,,2,-74.140516,4.697157
53506,2018,Junio,Ghana,1,0,,1,-75.516486,10.446304
53507,2018,Junio,Ghana,0,4,,4,-74.140516,4.697157
53508,2018,Junio,Granada,1,3,,4,-76.532004,3.451668
53509,2018,Junio,Granada,1,3,,4,-74.140516,4.697157
53510,2018,Junio,Grecia,0,3,,3,-75.527794,10.406342
53511,2018,Junio,Grecia,1,11,,12,-75.516486,10.446304
53512,2018,Junio,Grecia,0,2,,2,-74.765343,10.970933
53513,2018,Junio,Grecia,0,1,,1,-72.129595,11.360028999999999
53514,2018,Junio,Grecia,0,1,,1,-76.532004,3.451668
53515,2018,Junio,Grecia,25,57,,82,-74.140516,4.697157
53516,2018,Junio,Grecia,2,5,,7,-75.42726,6.170465
53517,2018,Junio,Grecia,0,1,,1,-75.68164200000001,9.402597
53518,2018,Junio,Guatemala,0,1,,1,-69.94143100000001,4.214082
53519,2018,Junio,Guatemala,0,3,,3,-77.35600000000001,0.81488
53520,2018,Junio,Guatemala,5,7,,12,-75.527794,10.406342
53521,2018,Junio,Guatemala,186,204,,390,-75.516486,10.446304
53522,2018,Junio,Guatemala,12,16,,28,-74.77647900000001,10.886686
53523,2018,Junio,Guatemala,1,2,,3,-81.703935,12.574411099999999
53524,2018,Junio,Guatemala,18,5,,23,-81.70216500000001,12.5862
53525,2018,Junio,Guatemala,19,34,,53,-76.532004,3.451668
53526,2018,Junio,Guatemala,2,1,,3,-75.76635300000001,4.45285
53527,2018,Junio,Guatemala,524,769,,1293,-74.140516,4.697157
53528,2018,Junio,Guatemala,2,2,,4,-75.736374,4.815189
53529,2018,Junio,Guatemala,86,136,,222,-75.42726,6.170465
53530,2018,Junio,Guatemala,1,3,,4,-73.181317,7.1280470000000005
53531,2018,Junio,Guatemala,1,2,,3,-72.453013,7.819
53532,2018,Junio,Guyana,0,1,,1,-69.941498,4.191162
53533,2018,Junio,Guyana,1,2,,3,-75.516486,10.446304
53534,2018,Junio,Guyana,0,1,,1,-72.129595,11.360028999999999
53535,2018,Junio,Guyana,1,2,,3,-76.532004,3.451668
53536,2018,Junio,Guyana,5,9,,14,-74.140516,4.697157
53537,2018,Junio,Guyana,7,1,,8,-75.42726,6.170465
53538,2018,Junio,Guyana,0,1,,1,-72.453013,7.819
53539,2018,Junio,Guinea Ecuatorial,1,2,,3,-74.140516,4.697157
53540,2018,Junio,Haití,0,3,,3,-75.527794,10.406342
53541,2018,Junio,Haití,10,7,,17,-75.516486,10.446304
53542,2018,Junio,Haití,0,4,,4,-74.77647900000001,10.886686
53543,2018,Junio,Haití,1,0,,1,-76.532004,3.451668
53544,2018,Junio,Haití,8,16,,24,-74.140516,4.697157
53545,2018,Junio,Haití,2,6,,8,-75.42726,6.170465
53546,2018,Junio,Honduras,2,6,,8,-77.35600000000001,0.81488
53547,2018,Junio,Honduras,0,4,,4,-75.527794,10.406342
53548,2018,Junio,Honduras,51,53,,104,-75.516486,10.446304
53549,2018,Junio,Honduras,5,5,,10,-74.77647900000001,10.886686
53550,2018,Junio,Honduras,0,23,,23,-81.703935,12.574411099999999
53551,2018,Junio,Honduras,1,3,,4,-81.70216500000001,12.5862
53552,2018,Junio,Honduras,12,19,,31,-76.532004,3.451668
53553,2018,Junio,Honduras,2,1,,3,-75.76635300000001,4.45285
53554,2018,Junio,Honduras,245,292,,537,-74.140516,4.697157
53555,2018,Junio,Honduras,0,1,,1,-75.736374,4.815189
53556,2018,Junio,Honduras,43,71,,114,-75.42726,6.170465
53557,2018,Junio,Honduras,1,0,,1,-72.409396,8.36068
53558,2018,Junio,Hong Kong,1,0,,1,-76.876446,0.33002
53559,2018,Junio,Hong Kong,1,0,,1,-77.35600000000001,0.81488
53560,2018,Junio,Hong Kong,3,0,,3,-75.516486,10.446304
53561,2018,Junio,Hong Kong,14,11,,25,-74.140516,4.697157
53562,2018,Junio,Hungría,0,2,,2,-69.94143100000001,4.214082
53563,2018,Junio,Hungría,0,1,,1,-77.35600000000001,0.81488
53564,2018,Junio,Hungría,1,3,,4,-75.516486,10.446304
53565,2018,Junio,Hungría,1,1,,2,-74.77647900000001,10.886686
53566,2018,Junio,Hungría,0,1,,1,-76.532004,3.451668
53567,2018,Junio,Hungría,26,46,,72,-74.140516,4.697157
53568,2018,Junio,Hungría,4,8,,12,-75.42726,6.170465
53569,2018,Junio,India,0,1,,1,-76.876446,0.33002
53570,2018,Junio,India,1,3,,4,-77.35600000000001,0.81488
53571,2018,Junio,India,3,11,,14,-75.527794,10.406342
53572,2018,Junio,India,25,83,,108,-75.516486,10.446304
53573,2018,Junio,India,1,21,,22,-74.77647900000001,10.886686
53574,2018,Junio,India,0,6,,6,-74.765343,10.970933
53575,2018,Junio,India,0,4,,4,-74.213989,11.247722999999999
53576,2018,Junio,India,2,17,,19,-76.532004,3.451668
53577,2018,Junio,India,0,2,,2,-77.061029,3.8844260000000004
53578,2018,Junio,India,100,364,,464,-74.140516,4.697157
53579,2018,Junio,India,1,0,,1,-75.736374,4.815189
53580,2018,Junio,India,10,56,,66,-75.42726,6.170465
53581,2018,Junio,India,1,0,,1,-77.35002,8.63337
53582,2018,Junio,India,0,2,,2,-75.68164200000001,9.402597
53583,2018,Junio,Indonesia,0,1,,1,-75.527794,10.406342
53584,2018,Junio,Indonesia,1,4,,5,-75.516486,10.446304
53585,2018,Junio,Indonesia,0,1,,1,-72.129595,11.360028999999999
53586,2018,Junio,Indonesia,28,39,,67,-74.140516,4.697157
53587,2018,Junio,Indonesia,1,1,,2,-75.42726,6.170465
53588,2018,Junio,Iraq,1,3,,4,-74.140516,4.697157
53589,2018,Junio,Irán,1,2,,3,-75.516486,10.446304
53590,2018,Junio,Irán,3,18,,21,-74.140516,4.697157
53591,2018,Junio,Irán,0,1,,1,-75.736374,4.815189
53592,2018,Junio,Irán,0,2,,2,-75.42726,6.170465
53593,2018,Junio,República de Irlanda,4,4,,8,-69.94143100000001,4.214082
53594,2018,Junio,República de Irlanda,1,0,,1,-76.876446,0.33002
53595,2018,Junio,República de Irlanda,12,19,,31,-77.35600000000001,0.81488
53596,2018,Junio,República de Irlanda,6,5,,11,-75.527794,10.406342
53597,2018,Junio,República de Irlanda,36,44,,80,-75.516486,10.446304
53598,2018,Junio,República de Irlanda,1,1,,2,-74.77647900000001,10.886686
53599,2018,Junio,República de Irlanda,1,5,,6,-76.532004,3.451668
53600,2018,Junio,República de Irlanda,177,252,,429,-74.140516,4.697157
53601,2018,Junio,República de Irlanda,17,44,,61,-75.42726,6.170465
53602,2018,Junio,República de Irlanda,3,9,,12,-77.35002,8.63337
53603,2018,Junio,Islandia,0,1,,1,-76.532004,3.451668
53604,2018,Junio,Islandia,4,6,,10,-74.140516,4.697157
53605,2018,Junio,Islandia,2,3,,5,-75.42726,6.170465
53606,2018,Junio,Israel,0,2,,2,-69.941498,4.191162
53607,2018,Junio,Israel,0,5,,5,-69.94143100000001,4.214082
53608,2018,Junio,Israel,1,1,,2,-76.876446,0.33002
53609,2018,Junio,Israel,35,69,,104,-77.35600000000001,0.81488
53610,2018,Junio,Israel,1,1,,2,-75.527794,10.406342
53611,2018,Junio,Israel,17,34,,51,-75.516486,10.446304
53612,2018,Junio,Israel,3,4,,7,-74.77647900000001,10.886686
53613,2018,Junio,Israel,4,6,,10,-81.70216500000001,12.5862
53614,2018,Junio,Israel,7,25,,32,-76.532004,3.451668
53615,2018,Junio,Israel,153,433,,586,-74.140516,4.697157
53616,2018,Junio,Israel,35,90,,125,-75.42726,6.170465
53617,2018,Junio,Israel,0,1,,1,-77.35002,8.63337
53618,2018,Junio,Italia,0,2,,2,-69.941498,4.191162
53619,2018,Junio,Italia,3,1,,4,-69.94143100000001,4.214082
53620,2018,Junio,Italia,17,24,,41,-77.35600000000001,0.81488
53621,2018,Junio,Italia,36,26,,62,-75.527794,10.406342
53622,2018,Junio,Italia,72,134,,206,-75.516486,10.446304
53623,2018,Junio,Italia,8,30,,38,-74.77647900000001,10.886686
53624,2018,Junio,Italia,0,1,,1,-74.213989,11.247722999999999
53625,2018,Junio,Italia,1,3,,4,-72.129595,11.360028999999999
53626,2018,Junio,Italia,7,5,,12,-81.70216500000001,12.5862
53627,2018,Junio,Italia,48,91,,139,-76.532004,3.451668
53628,2018,Junio,Italia,0,1,,1,-77.061029,3.8844260000000004
53629,2018,Junio,Italia,683,1672,,2355,-74.140516,4.697157
53630,2018,Junio,Italia,0,4,,4,-75.736374,4.815189
53631,2018,Junio,Italia,77,191,,268,-75.42726,6.170465
53632,2018,Junio,Italia,0,2,,2,-70.74025300000001,7.088728999999999
53633,2018,Junio,Italia,0,1,,1,-73.181317,7.1280470000000005
53634,2018,Junio,Italia,8,14,,22,-72.453013,7.819
53635,2018,Junio,Italia,1,3,,4,-72.409396,8.36068
53636,2018,Junio,Jamaica,0,1,,1,-75.527794,10.406342
53637,2018,Junio,Jamaica,9,12,,21,-75.516486,10.446304
53638,2018,Junio,Jamaica,1,2,,3,-74.77647900000001,10.886686
53639,2018,Junio,Jamaica,4,16,,20,-81.70216500000001,12.5862
53640,2018,Junio,Jamaica,4,5,,9,-76.532004,3.451668
53641,2018,Junio,Jamaica,10,20,,30,-74.140516,4.697157
53642,2018,Junio,Jamaica,1,0,,1,-75.736374,4.815189
53643,2018,Junio,Jamaica,7,14,,21,-75.42726,6.170465
53644,2018,Junio,Jamaica,1,0,,1,-73.181317,7.1280470000000005
53645,2018,Junio,Japón,1,2,,3,-69.941498,4.191162
53646,2018,Junio,Japón,1,1,,2,-69.94143100000001,4.214082
53647,2018,Junio,Japón,0,1,,1,-76.876446,0.33002
53648,2018,Junio,Japón,6,11,,17,-77.35600000000001,0.81488
53649,2018,Junio,Japón,14,12,,26,-75.527794,10.406342
53650,2018,Junio,Japón,36,35,,71,-75.516486,10.446304
53651,2018,Junio,Japón,2,11,,13,-74.77647900000001,10.886686
53652,2018,Junio,Japón,1,0,,1,-81.70216500000001,12.5862
53653,2018,Junio,Japón,9,11,,20,-76.532004,3.451668
53654,2018,Junio,Japón,158,469,,627,-74.140516,4.697157
53655,2018,Junio,Japón,10,33,,43,-75.42726,6.170465
53656,2018,Junio,Jordania,1,0,,1,-77.35600000000001,0.81488
53657,2018,Junio,Jordania,0,1,,1,-75.516486,10.446304
53658,2018,Junio,Jordania,1,5,,6,-74.140516,4.697157
53659,2018,Junio,Jordania,0,1,,1,-75.42726,6.170465
53660,2018,Junio,Kazajistán,1,2,,3,-74.140516,4.697157
53661,2018,Junio,Kenia,0,2,,2,-75.516486,10.446304
53662,2018,Junio,Kenia,8,7,,15,-74.140516,4.697157
53663,2018,Junio,Kirguistán,0,1,,1,-74.140516,4.697157
53664,2018,Junio,Kirguistán,0,2,,2,-75.42726,6.170465
53665,2018,Junio,Kuwait,0,1,,1,-75.516486,10.446304
53666,2018,Junio,Kuwait,4,4,,8,-74.140516,4.697157
53667,2018,Junio,República de Kosovo,0,1,,1,-75.516486,10.446304
53668,2018,Junio,República de Kosovo,0,1,,1,-74.140516,4.697157
53669,2018,Junio,Lesoto,0,1,,1,-74.140516,4.697157
53670,2018,Junio,Letonia,0,1,,1,-77.35600000000001,0.81488
53671,2018,Junio,Letonia,0,1,,1,-75.527794,10.406342
53672,2018,Junio,Letonia,0,1,,1,-74.77647900000001,10.886686
53673,2018,Junio,Letonia,0,3,,3,-74.765343,10.970933
53674,2018,Junio,Letonia,1,0,,1,-76.532004,3.451668
53675,2018,Junio,Letonia,6,13,,19,-74.140516,4.697157
53676,2018,Junio,Letonia,1,0,,1,-75.42726,6.170465
53677,2018,Junio,Lituania,1,0,,1,-77.35600000000001,0.81488
53678,2018,Junio,Lituania,1,0,,1,-75.527794,10.406342
53679,2018,Junio,Lituania,3,0,,3,-75.516486,10.446304
53680,2018,Junio,Lituania,1,0,,1,-74.77647900000001,10.886686
53681,2018,Junio,Lituania,6,3,,9,-76.532004,3.451668
53682,2018,Junio,Lituania,21,22,,43,-74.140516,4.697157
53683,2018,Junio,Lituania,6,3,,9,-75.42726,6.170465
53684,2018,Junio,Líbano,1,1,,2,-74.77647900000001,10.886686
53685,2018,Junio,Líbano,5,3,,8,-72.129595,11.360028999999999
53686,2018,Junio,Líbano,0,1,,1,-76.532004,3.451668
53687,2018,Junio,Líbano,14,25,,39,-74.140516,4.697157
53688,2018,Junio,Líbano,0,1,,1,-75.42726,6.170465
53689,2018,Junio,Líbano,0,1,,1,-73.181317,7.1280470000000005
53690,2018,Junio,Liechtenstein,0,1,,1,-75.42726,6.170465
53691,2018,Junio,Luxemburgo,1,0,,1,-75.516486,10.446304
53692,2018,Junio,Luxemburgo,1,0,,1,-74.77647900000001,10.886686
53693,2018,Junio,Luxemburgo,16,14,,30,-74.140516,4.697157
53694,2018,Junio,Macedonia,1,1,,2,-75.516486,10.446304
53695,2018,Junio,Macedonia,0,1,,1,-76.532004,3.451668
53696,2018,Junio,Macedonia,0,2,,2,-74.140516,4.697157
53697,2018,Junio,Madagascar,0,1,,1,-74.140516,4.697157
53698,2018,Junio,Malasia,1,0,,1,-77.35600000000001,0.81488
53699,2018,Junio,Malasia,1,2,,3,-75.516486,10.446304
53700,2018,Junio,Malasia,0,4,,4,-76.532004,3.451668
53701,2018,Junio,Malasia,27,17,,44,-74.140516,4.697157
53702,2018,Junio,Malasia,2,3,,5,-75.42726,6.170465
53703,2018,Junio,Malasia,0,1,,1,-75.68164200000001,9.402597
53704,2018,Junio,Malawi,0,3,,3,-74.140516,4.697157
53705,2018,Junio,Maldivas,1,0,,1,-74.140516,4.697157
53706,2018,Junio,Malta,0,1,,1,-69.941498,4.191162
53707,2018,Junio,Malta,0,1,,1,-75.516486,10.446304
53708,2018,Junio,Malta,2,7,,9,-74.140516,4.697157
53709,2018,Junio,Marruecos,3,2,,5,-77.35600000000001,0.81488
53710,2018,Junio,Marruecos,0,1,,1,-75.516486,10.446304
53711,2018,Junio,Marruecos,0,1,,1,-74.77647900000001,10.886686
53712,2018,Junio,Marruecos,0,1,,1,-76.532004,3.451668
53713,2018,Junio,Marruecos,10,12,,22,-74.140516,4.697157
53714,2018,Junio,Marruecos,0,1,,1,-75.42726,6.170465
53715,2018,Junio,Islas Marshall,1,0,,1,-74.140516,4.697157
53716,2018,Junio,Mauricio,5,2,,7,-74.140516,4.697157
53717,2018,Junio,Mauricio,0,1,,1,-75.42726,6.170465
53718,2018,Junio,Mauritania,0,1,,1,-74.140516,4.697157
53719,2018,Junio,México,1,2,,3,-69.941498,4.191162
53720,2018,Junio,México,3,4,,7,-69.94143100000001,4.214082
53721,2018,Junio,México,0,2,,2,-76.876446,0.33002
53722,2018,Junio,México,1,1,,2,-77.84700600000001,0.8124359999999999
53723,2018,Junio,México,48,35,,83,-77.35600000000001,0.81488
53724,2018,Junio,México,17,18,,35,-75.527794,10.406342
53725,2018,Junio,México,234,350,,584,-75.516486,10.446304
53726,2018,Junio,México,62,105,,167,-74.77647900000001,10.886686
53727,2018,Junio,México,4,4,,8,-72.129595,11.360028999999999
53728,2018,Junio,México,0,1,,1,-81.703935,12.574411099999999
53729,2018,Junio,México,99,192,,291,-76.532004,3.451668
53730,2018,Junio,México,2,3,,5,-75.76635300000001,4.45285
53731,2018,Junio,México,4449,6620,,11069,-74.140516,4.697157
53732,2018,Junio,México,13,30,,43,-75.736374,4.815189
53733,2018,Junio,México,588,1282,,1870,-75.42726,6.170465
53734,2018,Junio,México,4,9,,13,-73.181317,7.1280470000000005
53735,2018,Junio,México,16,28,,44,-72.453013,7.819
53736,2018,Junio,México,2,3,,5,-72.409396,8.36068
53737,2018,Junio,México,1,1,,2,-77.35002,8.63337
53738,2018,Junio,República de Moldavia,0,1,,1,-76.532004,3.451668
53739,2018,Junio,República de Moldavia,2,1,,3,-74.140516,4.697157
53740,2018,Junio,Mónaco,1,0,,1,-74.140516,4.697157
53741,2018,Junio,Mongolia,2,0,,2,-74.140516,4.697157
53742,2018,Junio,Montenegro,0,1,,1,-74.213989,11.247722999999999
53743,2018,Junio,Montenegro,1,2,,3,-74.140516,4.697157
53744,2018,Junio,Mozambique,1,2,,3,-74.140516,4.697157
53745,2018,Junio,Myanmar,0,1,,1,-74.77647900000001,10.886686
53746,2018,Junio,Myanmar,0,1,,1,-74.765343,10.970933
53747,2018,Junio,Myanmar,0,2,,2,-74.140516,4.697157
53748,2018,Junio,Nepal,0,1,,1,-75.516486,10.446304
53749,2018,Junio,Nepal,5,4,,9,-74.140516,4.697157
53750,2018,Junio,Nicaragua,1,1,,2,-75.527794,10.406342
53751,2018,Junio,Nicaragua,28,19,,47,-75.516486,10.446304
53752,2018,Junio,Nicaragua,4,1,,5,-74.77647900000001,10.886686
53753,2018,Junio,Nicaragua,3,1,,4,-81.70216500000001,12.5862
53754,2018,Junio,Nicaragua,4,7,,11,-76.532004,3.451668
53755,2018,Junio,Nicaragua,84,90,,174,-74.140516,4.697157
53756,2018,Junio,Nicaragua,4,1,,5,-75.736374,4.815189
53757,2018,Junio,Nicaragua,14,14,,28,-75.42726,6.170465
53758,2018,Junio,Nicaragua,0,5,,5,-73.181317,7.1280470000000005
53759,2018,Junio,Nigeria,0,1,,1,-77.35600000000001,0.81488
53760,2018,Junio,Nigeria,2,1,,3,-75.516486,10.446304
53761,2018,Junio,Nigeria,2,8,,10,-74.140516,4.697157
53762,2018,Junio,Nigeria,2,3,,5,-75.42726,6.170465
53763,2018,Junio,Níger,1,0,,1,-74.140516,4.697157
53764,2018,Junio,Noruega,1,0,,1,-69.94143100000001,4.214082
53765,2018,Junio,Noruega,2,3,,5,-77.35600000000001,0.81488
53766,2018,Junio,Noruega,1,1,,2,-75.527794,10.406342
53767,2018,Junio,Noruega,22,17,,39,-75.516486,10.446304
53768,2018,Junio,Noruega,0,3,,3,-74.77647900000001,10.886686
53769,2018,Junio,Noruega,11,7,,18,-76.532004,3.451668
53770,2018,Junio,Noruega,180,210,,390,-74.140516,4.697157
53771,2018,Junio,Noruega,1,1,,2,-75.736374,4.815189
53772,2018,Junio,Noruega,13,22,,35,-75.42726,6.170465
53773,2018,Junio,Noruega,0,1,,1,-73.181317,7.1280470000000005
53774,2018,Junio,Noruega,0,1,,1,-72.453013,7.819
53775,2018,Junio,Noruega,2,0,,2,-77.35002,8.63337
53776,2018,Junio,Nueva Zelanda,1,1,,2,-76.876446,0.33002
53777,2018,Junio,Nueva Zelanda,9,10,,19,-77.35600000000001,0.81488
53778,2018,Junio,Nueva Zelanda,4,11,,15,-75.527794,10.406342
53779,2018,Junio,Nueva Zelanda,12,13,,25,-75.516486,10.446304
53780,2018,Junio,Nueva Zelanda,1,0,,1,-74.77647900000001,10.886686
53781,2018,Junio,Nueva Zelanda,1,0,,1,-76.532004,3.451668
53782,2018,Junio,Nueva Zelanda,90,130,,220,-74.140516,4.697157
53783,2018,Junio,Nueva Zelanda,10,21,,31,-75.42726,6.170465
53784,2018,Junio,Nueva Zelanda,0,1,,1,-77.35002,8.63337
53785,2018,Junio,Omán,0,1,,1,-74.77647900000001,10.886686
53786,2018,Junio,Países Bajos,7,6,,13,-69.941498,4.191162
53787,2018,Junio,Países Bajos,5,5,,10,-69.94143100000001,4.214082
53788,2018,Junio,Países Bajos,30,29,,59,-77.35600000000001,0.81488
53789,2018,Junio,Países Bajos,32,43,,75,-75.527794,10.406342
53790,2018,Junio,Países Bajos,250,247,,497,-75.516486,10.446304
53791,2018,Junio,Países Bajos,9,17,,26,-74.77647900000001,10.886686
53792,2018,Junio,Países Bajos,2,3,,5,-74.213989,11.247722999999999
53793,2018,Junio,Países Bajos,1,2,,3,-81.70216500000001,12.5862
53794,2018,Junio,Países Bajos,35,58,,93,-76.532004,3.451668
53795,2018,Junio,Países Bajos,0,1,,1,-75.76635300000001,4.45285
53796,2018,Junio,Países Bajos,1254,1750,,3004,-74.140516,4.697157
53797,2018,Junio,Países Bajos,1,2,,3,-75.736374,4.815189
53798,2018,Junio,Países Bajos,71,130,,201,-75.42726,6.170465
53799,2018,Junio,Países Bajos,7,4,,11,-73.181317,7.1280470000000005
53800,2018,Junio,Países Bajos,0,4,,4,-72.453013,7.819
53801,2018,Junio,Países Bajos,0,1,,1,-72.409396,8.36068
53802,2018,Junio,Pakistán,0,2,,2,-75.516486,10.446304
53803,2018,Junio,Pakistán,0,1,,1,-74.765343,10.970933
53804,2018,Junio,Pakistán,1,17,,18,-74.140516,4.697157
53805,2018,Junio,Pakistán,1,2,,3,-75.42726,6.170465
53806,2018,Junio,Panamá,5,8,,13,-77.35600000000001,0.81488
53807,2018,Junio,Panamá,0,7,,7,-75.527794,10.406342
53808,2018,Junio,Panamá,510,563,,1073,-75.516486,10.446304
53809,2018,Junio,Panamá,48,67,,115,-74.77647900000001,10.886686
53810,2018,Junio,Panamá,0,1,,1,-74.213989,11.247722999999999
53811,2018,Junio,Panamá,1,0,,1,-71.983761,12.165168
53812,2018,Junio,Panamá,1,0,,1,-81.703935,12.574411099999999
53813,2018,Junio,Panamá,38,54,,92,-81.70216500000001,12.5862
53814,2018,Junio,Panamá,205,178,,383,-76.532004,3.451668
53815,2018,Junio,Panamá,13,22,,35,-75.76635300000001,4.45285
53816,2018,Junio,Panamá,1351,1508,,2859,-74.140516,4.697157
53817,2018,Junio,Panamá,39,55,,94,-75.736374,4.815189
53818,2018,Junio,Panamá,1206,1029,,2235,-75.42726,6.170465
53819,2018,Junio,Panamá,0,2,,2,-77.401154,6.222551999999999
53820,2018,Junio,Panamá,0,1,,1,-70.74025300000001,7.088728999999999
53821,2018,Junio,Panamá,1,3,,4,-77.762647,7.102626
53822,2018,Junio,Panamá,14,9,,23,-73.181317,7.1280470000000005
53823,2018,Junio,Panamá,1,0,,1,-72.453013,7.819
53824,2018,Junio,Panamá,0,2,,2,-72.508188,7.927233
53825,2018,Junio,Panamá,0,1,,1,-72.409396,8.36068
53826,2018,Junio,Panamá,1,7,,8,-77.35002,8.63337
53827,2018,Junio,Paraguay,1,0,,1,-69.941498,4.191162
53828,2018,Junio,Paraguay,0,3,,3,-77.35600000000001,0.81488
53829,2018,Junio,Paraguay,12,3,,15,-75.527794,10.406342
53830,2018,Junio,Paraguay,63,45,,108,-75.516486,10.446304
53831,2018,Junio,Paraguay,3,11,,14,-74.77647900000001,10.886686
53832,2018,Junio,Paraguay,82,50,,132,-81.70216500000001,12.5862
53833,2018,Junio,Paraguay,22,8,,30,-76.532004,3.451668
53834,2018,Junio,Paraguay,219,210,,429,-74.140516,4.697157
53835,2018,Junio,Paraguay,2,1,,3,-75.736374,4.815189
53836,2018,Junio,Paraguay,13,31,,44,-75.42726,6.170465
53837,2018,Junio,Paraguay,1,0,,1,-70.74025300000001,7.088728999999999
53838,2018,Junio,Perú,11,16,,27,-69.941498,4.191162
53839,2018,Junio,Perú,40,51,,91,-69.94143100000001,4.214082
53840,2018,Junio,Perú,1,1,,2,-74.78366,0.18595699999999998
53841,2018,Junio,Perú,5,10,,15,-76.876446,0.33002
53842,2018,Junio,Perú,0,2,,2,-77.84700600000001,0.8124359999999999
53843,2018,Junio,Perú,91,254,,345,-77.35600000000001,0.81488
53844,2018,Junio,Perú,0,2,,2,-78.802679,18.00143
53845,2018,Junio,Perú,20,19,,39,-75.527794,10.406342
53846,2018,Junio,Perú,733,475,,1208,-75.516486,10.446304
53847,2018,Junio,Perú,2,15,,17,-74.77647900000001,10.886686
53848,2018,Junio,Perú,0,19,,19,-72.129595,11.360028999999999
53849,2018,Junio,Perú,0,3,,3,-81.703935,12.574411099999999
53850,2018,Junio,Perú,232,154,,386,-81.70216500000001,12.5862
53851,2018,Junio,Perú,141,232,,373,-76.532004,3.451668
53852,2018,Junio,Perú,1,0,,1,-75.76635300000001,4.45285
53853,2018,Junio,Perú,3424,4237,,7661,-74.140516,4.697157
53854,2018,Junio,Perú,6,8,,14,-75.736374,4.815189
53855,2018,Junio,Perú,351,513,,864,-75.42726,6.170465
53856,2018,Junio,Perú,0,3,,3,-67.48402800000001,6.185536
53857,2018,Junio,Perú,1,0,,1,-70.74025300000001,7.088728999999999
53858,2018,Junio,Perú,1,2,,3,-73.181317,7.1280470000000005
53859,2018,Junio,Perú,78,159,,237,-72.453013,7.819
53860,2018,Junio,Perú,8,3,,11,-72.409396,8.36068
53861,2018,Junio,Palestina,2,0,,2,-74.77647900000001,10.886686
53862,2018,Junio,Palestina,1,3,,4,-74.140516,4.697157
53863,2018,Junio,Polonia,1,1,,2,-69.94143100000001,4.214082
53864,2018,Junio,Polonia,12,9,,21,-77.35600000000001,0.81488
53865,2018,Junio,Polonia,0,9,,9,-75.527794,10.406342
53866,2018,Junio,Polonia,8,14,,22,-75.516486,10.446304
53867,2018,Junio,Polonia,1,2,,3,-74.77647900000001,10.886686
53868,2018,Junio,Polonia,0,1,,1,-74.765343,10.970933
53869,2018,Junio,Polonia,12,3,,15,-76.532004,3.451668
53870,2018,Junio,Polonia,0,1,,1,-77.061029,3.8844260000000004
53871,2018,Junio,Polonia,106,152,,258,-74.140516,4.697157
53872,2018,Junio,Polonia,7,21,,28,-75.42726,6.170465
53873,2018,Junio,Polonia,1,0,,1,-73.181317,7.1280470000000005
53874,2018,Junio,Polonia,0,3,,3,-72.453013,7.819
53875,2018,Junio,Portugal,1,1,,2,-69.941498,4.191162
53876,2018,Junio,Portugal,3,1,,4,-77.35600000000001,0.81488
53877,2018,Junio,Portugal,1,0,,1,-75.527794,10.406342
53878,2018,Junio,Portugal,8,16,,24,-75.516486,10.446304
53879,2018,Junio,Portugal,4,8,,12,-74.77647900000001,10.886686
53880,2018,Junio,Portugal,2,4,,6,-72.129595,11.360028999999999
53881,2018,Junio,Portugal,1,1,,2,-81.70216500000001,12.5862
53882,2018,Junio,Portugal,5,16,,21,-76.532004,3.451668
53883,2018,Junio,Portugal,165,411,,576,-74.140516,4.697157
53884,2018,Junio,Portugal,15,32,,47,-75.42726,6.170465
53885,2018,Junio,Portugal,8,12,,20,-72.453013,7.819
53886,2018,Junio,Portugal,0,2,,2,-72.409396,8.36068
53887,2018,Junio,Qatar,0,1,,1,-74.140516,4.697157
53888,2018,Junio,Qatar,0,1,,1,-75.42726,6.170465
53889,2018,Junio,Reino Unido de Gran Bretaña e Irlanda del Norte,0,8,,8,-69.941498,4.191162
53890,2018,Junio,Reino Unido de Gran Bretaña e Irlanda del Norte,3,11,,14,-69.94143100000001,4.214082
53891,2018,Junio,Reino Unido de Gran Bretaña e Irlanda del Norte,1,1,,2,-76.876446,0.33002
53892,2018,Junio,Reino Unido de Gran Bretaña e Irlanda del Norte,79,116,,195,-77.35600000000001,0.81488
53893,2018,Junio,Reino Unido de Gran Bretaña e Irlanda del Norte,16,24,,40,-75.527794,10.406342
53894,2018,Junio,Reino Unido de Gran Bretaña e Irlanda del Norte,113,167,,280,-75.516486,10.446304
53895,2018,Junio,Reino Unido de Gran Bretaña e Irlanda del Norte,7,19,,26,-74.77647900000001,10.886686
53896,2018,Junio,Reino Unido de Gran Bretaña e Irlanda del Norte,2,5,,7,-74.213989,11.247722999999999
53897,2018,Junio,Reino Unido de Gran Bretaña e Irlanda del Norte,2,0,,2,-72.129595,11.360028999999999
53898,2018,Junio,Reino Unido de Gran Bretaña e Irlanda del Norte,0,1,,1,-81.70216500000001,12.5862
53899,2018,Junio,Reino Unido de Gran Bretaña e Irlanda del Norte,31,48,,79,-76.532004,3.451668
53900,2018,Junio,Reino Unido de Gran Bretaña e Irlanda del Norte,1154,2047,,3201,-74.140516,4.697157
53901,2018,Junio,Reino Unido de Gran Bretaña e Irlanda del Norte,0,4,,4,-75.736374,4.815189
53902,2018,Junio,Reino Unido de Gran Bretaña e Irlanda del Norte,123,225,,348,-75.42726,6.170465
53903,2018,Junio,Reino Unido de Gran Bretaña e Irlanda del Norte,0,2,,2,-72.453013,7.819
53904,2018,Junio,Reino Unido de Gran Bretaña e Irlanda del Norte,37,26,,63,-77.35002,8.63337
53905,2018,Junio,República Dominicana,0,1,,1,-69.94143100000001,4.214082
53906,2018,Junio,República Dominicana,3,13,,16,-77.35600000000001,0.81488
53907,2018,Junio,República Dominicana,0,1,,1,-78.802679,18.00143
53908,2018,Junio,República Dominicana,0,2,,2,-75.527794,10.406342
53909,2018,Junio,República Dominicana,64,92,,156,-75.516486,10.446304
53910,2018,Junio,República Dominicana,17,36,,53,-74.77647900000001,10.886686
53911,2018,Junio,República Dominicana,1,9,,10,-72.129595,11.360028999999999
53912,2018,Junio,República Dominicana,0,1,,1,-71.983761,12.165168
53913,2018,Junio,República Dominicana,2,2,,4,-81.70216500000001,12.5862
53914,2018,Junio,República Dominicana,22,20,,42,-76.532004,3.451668
53915,2018,Junio,República Dominicana,2,0,,2,-75.76635300000001,4.45285
53916,2018,Junio,República Dominicana,576,773,,1349,-74.140516,4.697157
53917,2018,Junio,República Dominicana,3,2,,5,-75.736374,4.815189
53918,2018,Junio,República Dominicana,61,63,,124,-75.42726,6.170465
53919,2018,Junio,República Dominicana,3,3,,6,-73.181317,7.1280470000000005
53920,2018,Junio,República Dominicana,3,2,,5,-72.453013,7.819
53921,2018,Junio,República Dominicana,0,1,,1,-72.409396,8.36068
53922,2018,Junio,Rumania,3,3,,6,-77.35600000000001,0.81488
53923,2018,Junio,Rumania,0,7,,7,-75.527794,10.406342
53924,2018,Junio,Rumania,6,13,,19,-75.516486,10.446304
53925,2018,Junio,Rumania,0,2,,2,-74.77647900000001,10.886686
53926,2018,Junio,Rumania,0,1,,1,-74.213989,11.247722999999999
53927,2018,Junio,Rumania,9,3,,12,-76.532004,3.451668
53928,2018,Junio,Rumania,0,3,,3,-77.061029,3.8844260000000004
53929,2018,Junio,Rumania,98,53,,151,-74.140516,4.697157
53930,2018,Junio,Rumania,9,9,,18,-75.42726,6.170465
53931,2018,Junio,Rumania,0,1,,1,-72.453013,7.819
53932,2018,Junio,Federación de Rusia,0,1,,1,-69.94143100000001,4.214082
53933,2018,Junio,Federación de Rusia,3,5,,8,-77.35600000000001,0.81488
53934,2018,Junio,Federación de Rusia,0,5,,5,-75.527794,10.406342
53935,2018,Junio,Federación de Rusia,16,14,,30,-75.516486,10.446304
53936,2018,Junio,Federación de Rusia,0,1,,1,-74.77647900000001,10.886686
53937,2018,Junio,Federación de Rusia,0,2,,2,-74.765343,10.970933
53938,2018,Junio,Federación de Rusia,0,1,,1,-72.129595,11.360028999999999
53939,2018,Junio,Federación de Rusia,1,0,,1,-81.70216500000001,12.5862
53940,2018,Junio,Federación de Rusia,4,3,,7,-76.532004,3.451668
53941,2018,Junio,Federación de Rusia,116,117,,233,-74.140516,4.697157
53942,2018,Junio,Federación de Rusia,1,0,,1,-75.736374,4.815189
53943,2018,Junio,Federación de Rusia,20,16,,36,-75.42726,6.170465
53944,2018,Junio,Federación de Rusia,1,0,,1,-73.181317,7.1280470000000005
53945,2018,Junio,Federación de Rusia,2,0,,2,-72.453013,7.819
53946,2018,Junio,Rwanda,0,1,,1,-74.140516,4.697157
53947,2018,Junio,San Cristóbal y Nevis,1,1,,2,-75.516486,10.446304
53948,2018,Junio,San Cristóbal y Nevis,1,2,,3,-74.140516,4.697157
53949,2018,Junio,San Cristóbal y Nevis,0,4,,4,-75.42726,6.170465
53950,2018,Junio,San  Vicente y las Granadinas,0,3,,3,-75.516486,10.446304
53951,2018,Junio,San  Vicente y las Granadinas,0,1,,1,-74.77647900000001,10.886686
53952,2018,Junio,San  Vicente y las Granadinas,0,1,,1,-81.70216500000001,12.5862
53953,2018,Junio,San  Vicente y las Granadinas,0,2,,2,-74.140516,4.697157
53954,2018,Junio,San  Vicente y las Granadinas,0,2,,2,-75.42726,6.170465
53955,2018,Junio,Santa Lucia,2,0,,2,-75.527794,10.406342
53956,2018,Junio,Santa Lucia,1,0,,1,-75.516486,10.446304
53957,2018,Junio,Santa Lucia,1,0,,1,-74.77647900000001,10.886686
53958,2018,Junio,Santa Lucia,2,4,,6,-74.140516,4.697157
53959,2018,Junio,Santa Lucia,1,0,,1,-75.42726,6.170465
53960,2018,Junio,Santa Sede/Ciudad del Vaticano,0,1,,1,-74.140516,4.697157
53961,2018,Junio,Senegal,0,1,,1,-72.129595,11.360028999999999
53962,2018,Junio,Serbia,0,1,,1,-76.876446,0.33002
53963,2018,Junio,Serbia,2,5,,7,-75.516486,10.446304
53964,2018,Junio,Serbia,6,16,,22,-74.140516,4.697157
53965,2018,Junio,Serbia,4,2,,6,-75.42726,6.170465
53966,2018,Junio,Sierra Leona,0,1,,1,-74.140516,4.697157
53967,2018,Junio,Sierra Leona,0,1,,1,-75.42726,6.170465
53968,2018,Junio,Singapur,0,2,,2,-77.35600000000001,0.81488
53969,2018,Junio,Singapur,3,4,,7,-75.516486,10.446304
53970,2018,Junio,Singapur,0,1,,1,-76.532004,3.451668
53971,2018,Junio,Singapur,28,42,,70,-74.140516,4.697157
53972,2018,Junio,Singapur,6,4,,10,-75.42726,6.170465
53973,2018,Junio,Singapur,0,1,,1,-75.68164200000001,9.402597
53974,2018,Junio,República Árabe Siria,0,1,,1,-75.516486,10.446304
53975,2018,Junio,República Árabe Siria,1,3,,4,-74.140516,4.697157
53976,2018,Junio,Somalia,0,1,,1,-74.140516,4.697157
53977,2018,Junio,Sri Lanka,0,1,,1,-75.527794,10.406342
53978,2018,Junio,Sri Lanka,0,1,,1,-74.77647900000001,10.886686
53979,2018,Junio,Sri Lanka,0,1,,1,-77.061029,3.8844260000000004
53980,2018,Junio,Sri Lanka,1,2,,3,-74.140516,4.697157
53981,2018,Junio,Sudáfrica,1,3,,4,-75.527794,10.406342
53982,2018,Junio,Sudáfrica,3,2,,5,-75.516486,10.446304
53983,2018,Junio,Sudáfrica,0,1,,1,-74.77647900000001,10.886686
53984,2018,Junio,Sudáfrica,1,1,,2,-74.213989,11.247722999999999
53985,2018,Junio,Sudáfrica,27,49,,76,-74.140516,4.697157
53986,2018,Junio,Sudáfrica,1,2,,3,-75.42726,6.170465
53987,2018,Junio,Sudán,2,3,,5,-74.140516,4.697157
53988,2018,Junio,Suecia,0,1,,1,-69.941498,4.191162
53989,2018,Junio,Suecia,2,1,,3,-69.94143100000001,4.214082
53990,2018,Junio,Suecia,6,6,,12,-77.35600000000001,0.81488
53991,2018,Junio,Suecia,4,4,,8,-75.527794,10.406342
53992,2018,Junio,Suecia,22,32,,54,-75.516486,10.446304
53993,2018,Junio,Suecia,5,6,,11,-74.77647900000001,10.886686
53994,2018,Junio,Suecia,0,1,,1,-74.213989,11.247722999999999
53995,2018,Junio,Suecia,0,1,,1,-81.703935,12.574411099999999
53996,2018,Junio,Suecia,23,27,,50,-76.532004,3.451668
53997,2018,Junio,Suecia,211,309,,520,-74.140516,4.697157
53998,2018,Junio,Suecia,1,1,,2,-75.736374,4.815189
53999,2018,Junio,Suecia,14,42,,56,-75.42726,6.170465
54000,2018,Junio,Suecia,0,1,,1,-72.409396,8.36068
54001,2018,Junio,Suecia,4,1,,5,-77.35002,8.63337
54002,2018,Junio,Suiza,2,4,,6,-69.941498,4.191162
54003,2018,Junio,Suiza,5,6,,11,-69.94143100000001,4.214082
54004,2018,Junio,Suiza,1,0,,1,-76.876446,0.33002
54005,2018,Junio,Suiza,1,1,,2,-77.84700600000001,0.8124359999999999
54006,2018,Junio,Suiza,28,25,,53,-77.35600000000001,0.81488
54007,2018,Junio,Suiza,16,15,,31,-75.527794,10.406342
54008,2018,Junio,Suiza,46,61,,107,-75.516486,10.446304
54009,2018,Junio,Suiza,5,4,,9,-74.77647900000001,10.886686
54010,2018,Junio,Suiza,0,1,,1,-74.213989,11.247722999999999
54011,2018,Junio,Suiza,2,4,,6,-81.70216500000001,12.5862
54012,2018,Junio,Suiza,2,0,,2,-81.372937,13.338761300000002
54013,2018,Junio,Suiza,24,46,,70,-76.532004,3.451668
54014,2018,Junio,Suiza,373,593,,966,-74.140516,4.697157
54015,2018,Junio,Suiza,1,1,,2,-75.736374,4.815189
54016,2018,Junio,Suiza,34,70,,104,-75.42726,6.170465
54017,2018,Junio,Suiza,1,0,,1,-72.453013,7.819
54018,2018,Junio,Suiza,8,3,,11,-77.35002,8.63337
54019,2018,Junio,Surinam,0,1,,1,-69.941498,4.191162
54020,2018,Junio,Surinam,1,1,,2,-75.516486,10.446304
54021,2018,Junio,Surinam,3,32,,35,-74.140516,4.697157
54022,2018,Junio,Surinam,1,1,,2,-75.42726,6.170465
54023,2018,Junio,Surinam,1,1,,2,-73.181317,7.1280470000000005
54024,2018,Junio,Taiwán,1,0,,1,-74.140516,4.697157
54025,2018,Junio,República de Tayikistán,1,0,,1,-74.140516,4.697157
54026,2018,Junio,Tailandia,0,1,,1,-77.35600000000001,0.81488
54027,2018,Junio,Tailandia,1,0,,1,-75.516486,10.446304
54028,2018,Junio,Tailandia,16,14,,30,-74.140516,4.697157
54029,2018,Junio,Tanzania,2,0,,2,-74.140516,4.697157
54030,2018,Junio,Tanzania,1,0,,1,-75.42726,6.170465
54031,2018,Junio,Togo,0,2,,2,-74.140516,4.697157
54032,2018,Junio,Trinidad y Tobago,0,1,,1,-69.941498,4.191162
54033,2018,Junio,Trinidad y Tobago,11,5,,16,-75.516486,10.446304
54034,2018,Junio,Trinidad y Tobago,1,3,,4,-74.77647900000001,10.886686
54035,2018,Junio,Trinidad y Tobago,1,0,,1,-81.70216500000001,12.5862
54036,2018,Junio,Trinidad y Tobago,0,1,,1,-76.532004,3.451668
54037,2018,Junio,Trinidad y Tobago,27,38,,65,-74.140516,4.697157
54038,2018,Junio,Trinidad y Tobago,8,15,,23,-75.42726,6.170465
54039,2018,Junio,Trinidad y Tobago,4,2,,6,-73.181317,7.1280470000000005
54040,2018,Junio,Trinidad y Tobago,0,2,,2,-72.453013,7.819
54041,2018,Junio,Túnez,0,1,,1,-75.516486,10.446304
54042,2018,Junio,Túnez,3,2,,5,-74.140516,4.697157
54043,2018,Junio,Turquía,2,0,,2,-69.94143100000001,4.214082
54044,2018,Junio,Turquía,0,1,,1,-76.876446,0.33002
54045,2018,Junio,Turquía,2,3,,5,-77.35600000000001,0.81488
54046,2018,Junio,Turquía,1,4,,5,-75.527794,10.406342
54047,2018,Junio,Turquía,3,7,,10,-75.516486,10.446304
54048,2018,Junio,Turquía,0,3,,3,-74.77647900000001,10.886686
54049,2018,Junio,Turquía,2,3,,5,-76.532004,3.451668
54050,2018,Junio,Turquía,179,319,,498,-74.140516,4.697157
54051,2018,Junio,Turquía,6,16,,22,-75.42726,6.170465
54052,2018,Junio,Turquía,0,1,,1,-73.181317,7.1280470000000005
54053,2018,Junio,Turquía,0,1,,1,-72.453013,7.819
54054,2018,Junio,Turkmenistán,1,0,,1,-74.140516,4.697157
54055,2018,Junio,Ucrania,1,0,,1,-69.941498,4.191162
54056,2018,Junio,Ucrania,0,7,,7,-75.527794,10.406342
54057,2018,Junio,Ucrania,2,9,,11,-75.516486,10.446304
54058,2018,Junio,Ucrania,0,1,,1,-74.77647900000001,10.886686
54059,2018,Junio,Ucrania,0,1,,1,-74.765343,10.970933
54060,2018,Junio,Ucrania,7,1,,8,-76.532004,3.451668
54061,2018,Junio,Ucrania,0,3,,3,-77.061029,3.8844260000000004
54062,2018,Junio,Ucrania,0,1,,1,-75.76635300000001,4.45285
54063,2018,Junio,Ucrania,28,20,,48,-74.140516,4.697157
54064,2018,Junio,Ucrania,4,4,,8,-75.42726,6.170465
54065,2018,Junio,Uganda,0,1,,1,-77.35600000000001,0.81488
54066,2018,Junio,Uganda,0,1,,1,-78.802679,18.00143
54067,2018,Junio,Uganda,1,0,,1,-75.516486,10.446304
54068,2018,Junio,Uganda,2,3,,5,-74.140516,4.697157
54069,2018,Junio,Uruguay,1,0,,1,-69.941498,4.191162
54070,2018,Junio,Uruguay,0,1,,1,-76.876446,0.33002
54071,2018,Junio,Uruguay,9,12,,21,-77.35600000000001,0.81488
54072,2018,Junio,Uruguay,29,16,,45,-75.527794,10.406342
54073,2018,Junio,Uruguay,87,88,,175,-75.516486,10.446304
54074,2018,Junio,Uruguay,1,3,,4,-74.77647900000001,10.886686
54075,2018,Junio,Uruguay,12,7,,19,-81.70216500000001,12.5862
54076,2018,Junio,Uruguay,4,18,,22,-76.532004,3.451668
54077,2018,Junio,Uruguay,565,641,,1206,-74.140516,4.697157
54078,2018,Junio,Uruguay,33,54,,87,-75.42726,6.170465
54079,2018,Junio,Uruguay,1,2,,3,-72.453013,7.819
54080,2018,Junio,Uzbekistán,1,1,,2,-74.140516,4.697157
54081,2018,Junio,Venezuela,3,6,,9,-69.941498,4.191162
54082,2018,Junio,Venezuela,2,6,,8,-69.94143100000001,4.214082
54083,2018,Junio,Venezuela,45,53,,98,-76.876446,0.33002
54084,2018,Junio,Venezuela,1,0,,1,-77.84700600000001,0.8124359999999999
54085,2018,Junio,Venezuela,1966,2434,,4400,-77.35600000000001,0.81488
54086,2018,Junio,Venezuela,2,3,,5,-78.802679,18.00143
54087,2018,Junio,Venezuela,11,61,,72,-75.527794,10.406342
54088,2018,Junio,Venezuela,168,275,,443,-75.516486,10.446304
54089,2018,Junio,Venezuela,98,183,,281,-74.77647900000001,10.886686
54090,2018,Junio,Venezuela,0,3,,3,-74.765343,10.970933
54091,2018,Junio,Venezuela,3,1,,4,-74.232675,11.117206
54092,2018,Junio,Venezuela,1,0,,1,-74.213989,11.247722999999999
54093,2018,Junio,Venezuela,6375,7289,,13664,-72.129595,11.360028999999999
54094,2018,Junio,Venezuela,1,2,,3,-71.983761,12.165168
54095,2018,Junio,Venezuela,0,1,,1,-81.703935,12.574411099999999
54096,2018,Junio,Venezuela,2,5,,7,-81.70216500000001,12.5862
54097,2018,Junio,Venezuela,90,123,,213,-76.532004,3.451668
54098,2018,Junio,Venezuela,7,19,,26,-67.927521,3.866713
54099,2018,Junio,Venezuela,5151,5393,,10544,-74.140516,4.697157
54100,2018,Junio,Venezuela,8,7,,15,-75.736374,4.815189
54101,2018,Junio,Venezuela,849,829,,1678,-75.42726,6.170465
54102,2018,Junio,Venezuela,54,60,,114,-67.48402800000001,6.185536
54103,2018,Junio,Venezuela,740,911,,1651,-70.74025300000001,7.088728999999999
54104,2018,Junio,Venezuela,14,17,,31,-73.181317,7.1280470000000005
54105,2018,Junio,Venezuela,26710,29983,,56693,-72.453013,7.819
54106,2018,Junio,Venezuela,4,14,,18,-72.508188,7.927233
54107,2018,Junio,Venezuela,2270,2189,,4459,-72.409396,8.36068
54108,2018,Junio,Venezuela,0,1,,1,-77.35002,8.63337
54109,2018,Junio,Vietnam,1,1,,2,-75.516486,10.446304
54110,2018,Junio,Vietnam,2,3,,5,-74.140516,4.697157
54111,2018,Junio,Vietnam,2,0,,2,-75.42726,6.170465
54112,2018,Junio,Islas Vírgenes Británicas/Territorio Británico de Ultramar,1,0,,1,-74.140516,4.697157
54113,2018,Junio,Islas Vírgenes Británicas/Territorio Británico de Ultramar,0,1,,1,-75.42726,6.170465
54114,2018,Junio,República Árabe de Yemen,0,1,,1,-75.516486,10.446304
54115,2018,Junio,República Árabe de Yemen,0,3,,3,-74.140516,4.697157
54116,2018,Junio,Zambia,0,2,,2,-74.140516,4.697157
54117,2018,Junio,Zimbabue,0,1,,1,-76.532004,3.451668
54118,2018,Junio,Zimbabue,0,2,,2,-74.140516,4.697157
54119,2018,Junio,Refugiado Otro,0,1,,1,-74.140516,4.697157
54120,2018,Junio,Refugiado,1,6,,7,-74.140516,4.697157
54121,2018,Junio,Refugiado,0,1,,1,-75.42726,6.170465
54122,2018,Junio,Desconocido,10,21,,31,-75.516486,10.446304
54123,2018,Junio,Desconocido,0,2,,2,-74.77647900000001,10.886686
54124,2018,Junio,Desconocido,0,1,,1,-81.70216500000001,12.5862
54125,2018,Junio,Desconocido,0,1,,1,-76.532004,3.451668
54126,2018,Junio,Desconocido,97,165,,262,-74.140516,4.697157
54127,2018,Junio,Desconocido,2,2,,4,-75.42726,6.170465
54128,2018,Junio,Desconocido,2,0,,2,-70.74025300000001,7.088728999999999
54129,2018,Junio,Desconocido,0,2,,2,-72.453013,7.819
54130,2018,Junio,República CentroÁfricana,0,1,,1,-74.140516,4.697157
54131,2018,Julio,Afganistán,0,2,,2,-74.140516,4.697157
54132,2018,Julio,Albania,0,1,,1,-75.516486,10.446304
54133,2018,Julio,Albania,1,5,,6,-74.140516,4.697157
54134,2018,Julio,Albania,1,0,,1,-75.42726,6.170465
54135,2018,Julio,Alemania,14,23,,37,-69.941498,4.191162
54136,2018,Julio,Alemania,4,9,,13,-69.94143100000001,4.214082
54137,2018,Julio,Alemania,5,1,,6,-76.876446,0.33002
54138,2018,Julio,Alemania,122,94,,216,-77.35600000000001,0.81488
54139,2018,Julio,Alemania,36,42,,78,-75.527794,10.406342
54140,2018,Julio,Alemania,153,186,,339,-75.516486,10.446304
54141,2018,Julio,Alemania,35,32,,67,-74.77647900000001,10.886686
54142,2018,Julio,Alemania,1,1,,2,-74.765343,10.970933
54143,2018,Julio,Alemania,5,3,,8,-74.213989,11.247722999999999
54144,2018,Julio,Alemania,1,2,,3,-72.129595,11.360028999999999
54145,2018,Julio,Alemania,4,3,,7,-81.70216500000001,12.5862
54146,2018,Julio,Alemania,73,90,,163,-76.532004,3.451668
54147,2018,Julio,Alemania,1,1,,2,-77.061029,3.8844260000000004
54148,2018,Julio,Alemania,3,0,,3,-75.76635300000001,4.45285
54149,2018,Julio,Alemania,2248,2667,,4915,-74.140516,4.697157
54150,2018,Julio,Alemania,3,4,,7,-75.736374,4.815189
54151,2018,Julio,Alemania,186,270,,456,-75.42726,6.170465
54152,2018,Julio,Alemania,0,1,,1,-67.48402800000001,6.185536
54153,2018,Julio,Alemania,0,2,,2,-73.181317,7.1280470000000005
54154,2018,Julio,Alemania,4,10,,14,-72.453013,7.819
54155,2018,Julio,Alemania,33,15,,48,-77.35002,8.63337
54156,2018,Julio,Andorra,1,6,,7,-74.140516,4.697157
54157,2018,Julio,Angola,0,1,,1,-75.516486,10.446304
54158,2018,Julio,Angola,0,1,,1,-74.140516,4.697157
54159,2018,Julio,Antigua y Barbuda,7,16,,23,-74.77647900000001,10.886686
54160,2018,Julio,Antigua y Barbuda,2,5,,7,-74.140516,4.697157
54161,2018,Julio,Antigua y Barbuda,2,0,,2,-75.736374,4.815189
54162,2018,Julio,Antigua y Barbuda,1,0,,1,-75.42726,6.170465
54163,2018,Julio,Arabia Saudita,2,20,,22,-74.140516,4.697157
54164,2018,Julio,Arabia Saudita,1,1,,2,-75.42726,6.170465
54165,2018,Julio,Argelia,4,9,,13,-74.140516,4.697157
54166,2018,Julio,Argelia,1,0,,1,-75.42726,6.170465
54167,2018,Julio,Argentina,6,6,,12,-69.941498,4.191162
54168,2018,Julio,Argentina,2,8,,10,-69.94143100000001,4.214082
54169,2018,Julio,Argentina,8,11,,19,-76.876446,0.33002
54170,2018,Julio,Argentina,73,128,,201,-77.35600000000001,0.81488
54171,2018,Julio,Argentina,346,238,,584,-75.527794,10.406342
54172,2018,Julio,Argentina,1489,1087,,2576,-75.516486,10.446304
54173,2018,Julio,Argentina,22,69,,91,-74.77647900000001,10.886686
54174,2018,Julio,Argentina,0,2,,2,-74.213989,11.247722999999999
54175,2018,Julio,Argentina,9,7,,16,-72.129595,11.360028999999999
54176,2018,Julio,Argentina,290,235,,525,-81.70216500000001,12.5862
54177,2018,Julio,Argentina,32,67,,99,-76.532004,3.451668
54178,2018,Julio,Argentina,0,1,,1,-75.76635300000001,4.45285
54179,2018,Julio,Argentina,4804,5317,,10121,-74.140516,4.697157
54180,2018,Julio,Argentina,14,11,,25,-75.736374,4.815189
54181,2018,Julio,Argentina,235,364,,599,-75.42726,6.170465
54182,2018,Julio,Argentina,0,1,,1,-73.181317,7.1280470000000005
54183,2018,Julio,Argentina,9,16,,25,-72.453013,7.819
54184,2018,Julio,Argentina,1,4,,5,-72.409396,8.36068
54185,2018,Julio,Argentina,1,2,,3,-77.35002,8.63337
54186,2018,Julio,República de Armenia,1,2,,3,-74.140516,4.697157
54187,2018,Julio,Australia,0,7,,7,-69.941498,4.191162
54188,2018,Julio,Australia,1,6,,7,-69.94143100000001,4.214082
54189,2018,Julio,Australia,2,3,,5,-76.876446,0.33002
54190,2018,Julio,Australia,34,31,,65,-77.35600000000001,0.81488
54191,2018,Julio,Australia,20,37,,57,-75.527794,10.406342
54192,2018,Julio,Australia,71,97,,168,-75.516486,10.446304
54193,2018,Julio,Australia,3,21,,24,-74.77647900000001,10.886686
54194,2018,Julio,Australia,4,16,,20,-76.532004,3.451668
54195,2018,Julio,Australia,361,536,,897,-74.140516,4.697157
54196,2018,Julio,Australia,1,0,,1,-75.736374,4.815189
54197,2018,Julio,Australia,49,80,,129,-75.42726,6.170465
54198,2018,Julio,Australia,1,2,,3,-72.453013,7.819
54199,2018,Julio,Australia,19,17,,36,-77.35002,8.63337
54200,2018,Julio,Austria,1,1,,2,-69.941498,4.191162
54201,2018,Julio,Austria,1,0,,1,-76.876446,0.33002
54202,2018,Julio,Austria,9,9,,18,-77.35600000000001,0.81488
54203,2018,Julio,Austria,4,8,,12,-75.527794,10.406342
54204,2018,Julio,Austria,30,28,,58,-75.516486,10.446304
54205,2018,Julio,Austria,3,4,,7,-74.77647900000001,10.886686
54206,2018,Julio,Austria,2,1,,3,-81.70216500000001,12.5862
54207,2018,Julio,Austria,7,3,,10,-76.532004,3.451668
54208,2018,Julio,Austria,293,324,,617,-74.140516,4.697157
54209,2018,Julio,Austria,25,40,,65,-75.42726,6.170465
54210,2018,Julio,Austria,2,5,,7,-77.35002,8.63337
54211,2018,Julio,Azerbaiyán,1,2,,3,-74.140516,4.697157
54212,2018,Julio,Bahamas,7,5,,12,-75.516486,10.446304
54213,2018,Julio,Bahamas,7,40,,47,-74.77647900000001,10.886686
54214,2018,Julio,Bahamas,5,1,,6,-76.532004,3.451668
54215,2018,Julio,Bahamas,18,33,,51,-74.140516,4.697157
54216,2018,Julio,Bahamas,3,3,,6,-75.42726,6.170465
54217,2018,Julio,Bahamas,0,1,,1,-72.409396,8.36068
54218,2018,Julio,Bahréin,0,1,,1,-75.42726,6.170465
54219,2018,Julio,Bangladesh,1,0,,1,-77.35600000000001,0.81488
54220,2018,Julio,Bangladesh,0,1,,1,-74.765343,10.970933
54221,2018,Julio,Bangladesh,0,6,,6,-74.140516,4.697157
54222,2018,Julio,Bangladesh,1,0,,1,-75.42726,6.170465
54223,2018,Julio,Bangladesh,0,1,,1,-75.68164200000001,9.402597
54224,2018,Julio,Barbados,14,1,,15,-75.516486,10.446304
54225,2018,Julio,Barbados,50,64,,114,-74.77647900000001,10.886686
54226,2018,Julio,Barbados,4,11,,15,-76.532004,3.451668
54227,2018,Julio,Barbados,16,16,,32,-74.140516,4.697157
54228,2018,Julio,Barbados,0,1,,1,-75.42726,6.170465
54229,2018,Julio,República de Belarús,0,1,,1,-76.532004,3.451668
54230,2018,Julio,República de Belarús,3,4,,7,-74.140516,4.697157
54231,2018,Julio,Bélgica,2,6,,8,-69.941498,4.191162
54232,2018,Julio,Bélgica,0,1,,1,-76.876446,0.33002
54233,2018,Julio,Bélgica,15,8,,23,-77.35600000000001,0.81488
54234,2018,Julio,Bélgica,4,4,,8,-75.527794,10.406342
54235,2018,Julio,Bélgica,37,57,,94,-75.516486,10.446304
54236,2018,Julio,Bélgica,0,2,,2,-74.77647900000001,10.886686
54237,2018,Julio,Bélgica,0,9,,9,-74.765343,10.970933
54238,2018,Julio,Bélgica,0,1,,1,-72.129595,11.360028999999999
54239,2018,Julio,Bélgica,2,1,,3,-81.70216500000001,12.5862
54240,2018,Julio,Bélgica,20,25,,45,-76.532004,3.451668
54241,2018,Julio,Bélgica,0,2,,2,-77.061029,3.8844260000000004
54242,2018,Julio,Bélgica,682,743,,1425,-74.140516,4.697157
54243,2018,Julio,Bélgica,58,94,,152,-75.42726,6.170465
54244,2018,Julio,Bélgica,0,2,,2,-73.181317,7.1280470000000005
54245,2018,Julio,Bélgica,0,1,,1,-72.453013,7.819
54246,2018,Julio,Belice,1,2,,3,-75.516486,10.446304
54247,2018,Julio,Belice,4,2,,6,-74.77647900000001,10.886686
54248,2018,Julio,Belice,0,1,,1,-81.703935,12.574411099999999
54249,2018,Julio,Belice,0,1,,1,-81.70216500000001,12.5862
54250,2018,Julio,Belice,7,9,,16,-76.532004,3.451668
54251,2018,Julio,Belice,11,13,,24,-74.140516,4.697157
54252,2018,Julio,Belice,6,7,,13,-75.42726,6.170465
54253,2018,Julio,Benín,0,3,,3,-74.140516,4.697157
54254,2018,Julio,Benín,0,1,,1,-75.42726,6.170465
54255,2018,Julio,Bermudas/Territorio Británico de Ultramar,0,1,,1,-75.516486,10.446304
54256,2018,Julio,Bermudas/Territorio Británico de Ultramar,5,8,,13,-74.77647900000001,10.886686
54257,2018,Julio,Bermudas/Territorio Británico de Ultramar,1,8,,9,-76.532004,3.451668
54258,2018,Julio,Bermudas/Territorio Británico de Ultramar,4,5,,9,-74.140516,4.697157
54259,2018,Julio,Bermudas/Territorio Británico de Ultramar,0,4,,4,-75.42726,6.170465
54260,2018,Julio,Bolivia,1,0,,1,-69.941498,4.191162
54261,2018,Julio,Bolivia,4,13,,17,-77.35600000000001,0.81488
54262,2018,Julio,Bolivia,36,18,,54,-75.527794,10.406342
54263,2018,Julio,Bolivia,174,129,,303,-75.516486,10.446304
54264,2018,Julio,Bolivia,0,2,,2,-74.77647900000001,10.886686
54265,2018,Julio,Bolivia,1,3,,4,-72.129595,11.360028999999999
54266,2018,Julio,Bolivia,11,10,,21,-81.70216500000001,12.5862
54267,2018,Julio,Bolivia,29,59,,88,-76.532004,3.451668
54268,2018,Julio,Bolivia,0,1,,1,-67.927521,3.866713
54269,2018,Julio,Bolivia,692,707,,1399,-74.140516,4.697157
54270,2018,Julio,Bolivia,2,1,,3,-75.736374,4.815189
54271,2018,Julio,Bolivia,78,59,,137,-75.42726,6.170465
54272,2018,Julio,Bolivia,0,1,,1,-70.74025300000001,7.088728999999999
54273,2018,Julio,Bolivia,2,5,,7,-72.453013,7.819
54274,2018,Julio,Bosnia y Herzegovina,0,1,,1,-75.516486,10.446304
54275,2018,Julio,Bosnia y Herzegovina,0,1,,1,-76.532004,3.451668
54276,2018,Julio,Bosnia y Herzegovina,4,10,,14,-74.140516,4.697157
54277,2018,Julio,Brasil,84,95,,179,-69.941498,4.191162
54278,2018,Julio,Brasil,2,2,,4,-69.94143100000001,4.214082
54279,2018,Julio,Brasil,0,4,,4,-76.876446,0.33002
54280,2018,Julio,Brasil,12,39,,51,-77.35600000000001,0.81488
54281,2018,Julio,Brasil,342,325,,667,-75.527794,10.406342
54282,2018,Julio,Brasil,930,722,,1652,-75.516486,10.446304
54283,2018,Julio,Brasil,13,26,,39,-74.77647900000001,10.886686
54284,2018,Julio,Brasil,5,2,,7,-72.129595,11.360028999999999
54285,2018,Julio,Brasil,279,228,,507,-81.70216500000001,12.5862
54286,2018,Julio,Brasil,59,50,,109,-76.532004,3.451668
54287,2018,Julio,Brasil,2,4,,6,-67.927521,3.866713
54288,2018,Julio,Brasil,0,1,,1,-75.76635300000001,4.45285
54289,2018,Julio,Brasil,6209,6895,,13104,-74.140516,4.697157
54290,2018,Julio,Brasil,2,3,,5,-75.736374,4.815189
54291,2018,Julio,Brasil,198,255,,453,-75.42726,6.170465
54292,2018,Julio,Brasil,1,3,,4,-67.48402800000001,6.185536
54293,2018,Julio,Brasil,2,1,,3,-73.181317,7.1280470000000005
54294,2018,Julio,Brasil,4,8,,12,-72.453013,7.819
54295,2018,Julio,Brasil,1,2,,3,-72.409396,8.36068
54296,2018,Julio,Brasil,0,2,,2,-77.35002,8.63337
54297,2018,Julio,Bulgaria,1,1,,2,-77.35600000000001,0.81488
54298,2018,Julio,Bulgaria,0,1,,1,-75.527794,10.406342
54299,2018,Julio,Bulgaria,0,4,,4,-75.516486,10.446304
54300,2018,Julio,Bulgaria,1,1,,2,-74.77647900000001,10.886686
54301,2018,Julio,Bulgaria,0,1,,1,-74.765343,10.970933
54302,2018,Julio,Bulgaria,1,0,,1,-76.532004,3.451668
54303,2018,Julio,Bulgaria,18,25,,43,-74.140516,4.697157
54304,2018,Julio,Bulgaria,4,8,,12,-75.42726,6.170465
54305,2018,Julio,Bulgaria,0,1,,1,-72.453013,7.819
54306,2018,Julio,Bulgaria,0,1,,1,-75.68164200000001,9.402597
54307,2018,Julio,Burkina Faso,0,1,,1,-75.42726,6.170465
54308,2018,Julio,Burundi,1,1,,2,-74.140516,4.697157
54309,2018,Julio,Bután,1,0,,1,-77.35600000000001,0.81488
54310,2018,Julio,Bután,0,5,,5,-74.140516,4.697157
54311,2018,Julio,Cabo Verde,1,0,,1,-75.42726,6.170465
54312,2018,Julio,Islas Caimán/Territorio Británico de Ultramar,1,1,,2,-75.516486,10.446304
54313,2018,Julio,Islas Caimán/Territorio Británico de Ultramar,1,4,,5,-74.77647900000001,10.886686
54314,2018,Julio,Islas Caimán/Territorio Británico de Ultramar,1,2,,3,-81.70216500000001,12.5862
54315,2018,Julio,Islas Caimán/Territorio Británico de Ultramar,1,1,,2,-76.532004,3.451668
54316,2018,Julio,Camboya,1,0,,1,-75.516486,10.446304
54317,2018,Julio,Camboya,0,3,,3,-74.140516,4.697157
54318,2018,Julio,Camerún,0,1,,1,-75.516486,10.446304
54319,2018,Julio,Camerún,2,3,,5,-74.140516,4.697157
54320,2018,Julio,Camerún,1,1,,2,-75.42726,6.170465
54321,2018,Julio,Canadá,8,2,,10,-69.941498,4.191162
54322,2018,Julio,Canadá,1,1,,2,-69.94143100000001,4.214082
54323,2018,Julio,Canadá,19,22,,41,-77.35600000000001,0.81488
54324,2018,Julio,Canadá,6,8,,14,-75.527794,10.406342
54325,2018,Julio,Canadá,241,249,,490,-75.516486,10.446304
54326,2018,Julio,Canadá,33,48,,81,-74.77647900000001,10.886686
54327,2018,Julio,Canadá,1,0,,1,-74.232675,11.117206
54328,2018,Julio,Canadá,2,2,,4,-74.213989,11.247722999999999
54329,2018,Julio,Canadá,2,1,,3,-81.703935,12.574411099999999
54330,2018,Julio,Canadá,11,5,,16,-81.70216500000001,12.5862
54331,2018,Julio,Canadá,74,76,,150,-76.532004,3.451668
54332,2018,Julio,Canadá,3,3,,6,-75.76635300000001,4.45285
54333,2018,Julio,Canadá,1179,1782,,2961,-74.140516,4.697157
54334,2018,Julio,Canadá,13,19,,32,-75.736374,4.815189
54335,2018,Julio,Canadá,214,394,,608,-75.42726,6.170465
54336,2018,Julio,Canadá,1,3,,4,-73.181317,7.1280470000000005
54337,2018,Julio,Canadá,1,1,,2,-72.453013,7.819
54338,2018,Julio,Canadá,1,0,,1,-72.409396,8.36068
54339,2018,Julio,Canadá,1,4,,5,-77.35002,8.63337
54340,2018,Julio,Chad,1,0,,1,-74.140516,4.697157
54341,2018,Julio,República Democrática del Congo,8,6,,14,-74.140516,4.697157
54342,2018,Julio,República Democrática del Congo,0,1,,1,-75.42726,6.170465
54343,2018,Julio,República de Corea,1,3,,4,-69.941498,4.191162
54344,2018,Julio,República de Corea,1,2,,3,-69.94143100000001,4.214082
54345,2018,Julio,República de Corea,8,20,,28,-77.35600000000001,0.81488
54346,2018,Julio,República de Corea,3,8,,11,-75.516486,10.446304
54347,2018,Julio,República de Corea,0,2,,2,-74.77647900000001,10.886686
54348,2018,Julio,República de Corea,0,1,,1,-72.129595,11.360028999999999
54349,2018,Julio,República de Corea,3,2,,5,-81.70216500000001,12.5862
54350,2018,Julio,República de Corea,1,8,,9,-76.532004,3.451668
54351,2018,Julio,República de Corea,225,406,,631,-74.140516,4.697157
54352,2018,Julio,República de Corea,5,31,,36,-75.42726,6.170465
54353,2018,Julio,República de Corea,0,1,,1,-77.35002,8.63337
54354,2018,Julio,Costa de Marfil,0,1,,1,-76.532004,3.451668
54355,2018,Julio,Costa de Marfil,2,5,,7,-74.140516,4.697157
54356,2018,Julio,Costa Rica,0,1,,1,-69.94143100000001,4.214082
54357,2018,Julio,Costa Rica,0,1,,1,-77.35600000000001,0.81488
54358,2018,Julio,Costa Rica,222,167,,389,-75.516486,10.446304
54359,2018,Julio,Costa Rica,29,33,,62,-74.77647900000001,10.886686
54360,2018,Julio,Costa Rica,2,0,,2,-72.129595,11.360028999999999
54361,2018,Julio,Costa Rica,187,126,,313,-81.70216500000001,12.5862
54362,2018,Julio,Costa Rica,49,75,,124,-76.532004,3.451668
54363,2018,Julio,Costa Rica,0,5,,5,-77.061029,3.8844260000000004
54364,2018,Julio,Costa Rica,0,1,,1,-75.76635300000001,4.45285
54365,2018,Julio,Costa Rica,1688,1876,,3564,-74.140516,4.697157
54366,2018,Julio,Costa Rica,5,8,,13,-75.736374,4.815189
54367,2018,Julio,Costa Rica,171,170,,341,-75.42726,6.170465
54368,2018,Julio,Costa Rica,1,1,,2,-73.181317,7.1280470000000005
54369,2018,Julio,Costa Rica,1,5,,6,-72.453013,7.819
54370,2018,Julio,Costa Rica,0,2,,2,-77.35002,8.63337
54371,2018,Julio,Croacia,1,0,,1,-77.35600000000001,0.81488
54372,2018,Julio,Croacia,1,2,,3,-75.527794,10.406342
54373,2018,Julio,Croacia,0,4,,4,-75.516486,10.446304
54374,2018,Julio,Croacia,0,1,,1,-74.213989,11.247722999999999
54375,2018,Julio,Croacia,1,1,,2,-76.532004,3.451668
54376,2018,Julio,Croacia,0,3,,3,-77.061029,3.8844260000000004
54377,2018,Julio,Croacia,12,24,,36,-74.140516,4.697157
54378,2018,Julio,Croacia,0,1,,1,-75.42726,6.170465
54379,2018,Julio,Cuba,1,3,,4,-77.35600000000001,0.81488
54380,2018,Julio,Cuba,1,0,,1,-75.527794,10.406342
54381,2018,Julio,Cuba,13,48,,61,-75.516486,10.446304
54382,2018,Julio,Cuba,242,419,,661,-74.77647900000001,10.886686
54383,2018,Julio,Cuba,1,0,,1,-72.129595,11.360028999999999
54384,2018,Julio,Cuba,0,1,,1,-81.70216500000001,12.5862
54385,2018,Julio,Cuba,31,50,,81,-76.532004,3.451668
54386,2018,Julio,Cuba,300,540,,840,-74.140516,4.697157
54387,2018,Julio,Cuba,6,2,,8,-75.736374,4.815189
54388,2018,Julio,Cuba,34,39,,73,-75.42726,6.170465
54389,2018,Julio,Cuba,0,1,,1,-70.74025300000001,7.088728999999999
54390,2018,Julio,Cuba,1,2,,3,-73.181317,7.1280470000000005
54391,2018,Julio,Cuba,1,2,,3,-72.453013,7.819
54392,2018,Julio,Curazao,0,1,,1,-74.140516,4.697157
54393,2018,Julio,República Checa,4,3,,7,-77.35600000000001,0.81488
54394,2018,Julio,República Checa,2,1,,3,-75.527794,10.406342
54395,2018,Julio,República Checa,3,3,,6,-75.516486,10.446304
54396,2018,Julio,República Checa,0,1,,1,-74.77647900000001,10.886686
54397,2018,Julio,República Checa,2,1,,3,-76.532004,3.451668
54398,2018,Julio,República Checa,56,47,,103,-74.140516,4.697157
54399,2018,Julio,República Checa,1,0,,1,-75.736374,4.815189
54400,2018,Julio,República Checa,4,1,,5,-75.42726,6.170465
54401,2018,Julio,República Checa,1,0,,1,-77.35002,8.63337
54402,2018,Julio,Chile,2,5,,7,-69.941498,4.191162
54403,2018,Julio,Chile,3,1,,4,-69.94143100000001,4.214082
54404,2018,Julio,Chile,5,3,,8,-76.876446,0.33002
54405,2018,Julio,Chile,48,73,,121,-77.35600000000001,0.81488
54406,2018,Julio,Chile,0,3,,3,-78.802679,18.00143
54407,2018,Julio,Chile,204,337,,541,-75.527794,10.406342
54408,2018,Julio,Chile,514,350,,864,-75.516486,10.446304
54409,2018,Julio,Chile,9,19,,28,-74.77647900000001,10.886686
54410,2018,Julio,Chile,0,3,,3,-74.765343,10.970933
54411,2018,Julio,Chile,2,11,,13,-72.129595,11.360028999999999
54412,2018,Julio,Chile,209,146,,355,-81.70216500000001,12.5862
54413,2018,Julio,Chile,35,57,,92,-76.532004,3.451668
54414,2018,Julio,Chile,0,1,,1,-75.76635300000001,4.45285
54415,2018,Julio,Chile,5027,5464,,10491,-74.140516,4.697157
54416,2018,Julio,Chile,2,6,,8,-75.736374,4.815189
54417,2018,Julio,Chile,124,159,,283,-75.42726,6.170465
54418,2018,Julio,Chile,0,3,,3,-70.74025300000001,7.088728999999999
54419,2018,Julio,Chile,2,2,,4,-73.181317,7.1280470000000005
54420,2018,Julio,Chile,16,17,,33,-72.453013,7.819
54421,2018,Julio,Chile,3,2,,5,-72.409396,8.36068
54422,2018,Julio,Chile,0,1,,1,-77.35002,8.63337
54423,2018,Julio,China,1,0,,1,-69.941498,4.191162
54424,2018,Julio,China,6,10,,16,-77.35600000000001,0.81488
54425,2018,Julio,China,0,2,,2,-75.527794,10.406342
54426,2018,Julio,China,20,14,,34,-75.516486,10.446304
54427,2018,Julio,China,10,15,,25,-74.77647900000001,10.886686
54428,2018,Julio,China,0,3,,3,-74.765343,10.970933
54429,2018,Julio,China,1,0,,1,-72.129595,11.360028999999999
54430,2018,Julio,China,0,1,,1,-81.70216500000001,12.5862
54431,2018,Julio,China,11,16,,27,-76.532004,3.451668
54432,2018,Julio,China,479,837,,1316,-74.140516,4.697157
54433,2018,Julio,China,0,2,,2,-75.736374,4.815189
54434,2018,Julio,China,38,40,,78,-75.42726,6.170465
54435,2018,Julio,China,4,9,,13,-72.453013,7.819
54436,2018,Julio,China,0,2,,2,-72.409396,8.36068
54437,2018,Julio,China,0,1,,1,-77.35002,8.63337
54438,2018,Julio,China,0,1,,1,-75.68164200000001,9.402597
54439,2018,Julio,Taiwán,0,2,,2,-69.941498,4.191162
54440,2018,Julio,Taiwán,1,0,,1,-69.94143100000001,4.214082
54441,2018,Julio,Taiwán,5,2,,7,-77.35600000000001,0.81488
54442,2018,Julio,Taiwán,1,0,,1,-75.527794,10.406342
54443,2018,Julio,Taiwán,5,5,,10,-75.516486,10.446304
54444,2018,Julio,Taiwán,1,1,,2,-74.77647900000001,10.886686
54445,2018,Julio,Taiwán,4,2,,6,-76.532004,3.451668
54446,2018,Julio,Taiwán,78,63,,141,-74.140516,4.697157
54447,2018,Julio,Taiwán,1,1,,2,-75.736374,4.815189
54448,2018,Julio,Taiwán,6,12,,18,-75.42726,6.170465
54449,2018,Julio,Taiwán,1,0,,1,-73.181317,7.1280470000000005
54450,2018,Julio,Taiwán,1,1,,2,-72.453013,7.819
54451,2018,Julio,Taiwán,0,1,,1,-77.35002,8.63337
54452,2018,Julio,Chipre,1,0,,1,-77.35600000000001,0.81488
54453,2018,Julio,Chipre,0,1,,1,-75.516486,10.446304
54454,2018,Julio,Chipre,4,5,,9,-74.140516,4.697157
54455,2018,Julio,Dinamarca,0,2,,2,-69.941498,4.191162
54456,2018,Julio,Dinamarca,1,3,,4,-69.94143100000001,4.214082
54457,2018,Julio,Dinamarca,0,1,,1,-77.35600000000001,0.81488
54458,2018,Julio,Dinamarca,0,3,,3,-75.527794,10.406342
54459,2018,Julio,Dinamarca,23,30,,53,-75.516486,10.446304
54460,2018,Julio,Dinamarca,0,6,,6,-74.77647900000001,10.886686
54461,2018,Julio,Dinamarca,5,13,,18,-76.532004,3.451668
54462,2018,Julio,Dinamarca,212,252,,464,-74.140516,4.697157
54463,2018,Julio,Dinamarca,1,3,,4,-75.736374,4.815189
54464,2018,Julio,Dinamarca,13,30,,43,-75.42726,6.170465
54465,2018,Julio,Dinamarca,0,1,,1,-73.181317,7.1280470000000005
54466,2018,Julio,Dominica,2,6,,8,-75.516486,10.446304
54467,2018,Julio,Dominica,0,1,,1,-74.77647900000001,10.886686
54468,2018,Julio,Dominica,3,0,,3,-76.532004,3.451668
54469,2018,Julio,Dominica,3,2,,5,-74.140516,4.697157
54470,2018,Julio,Dominica,0,2,,2,-75.42726,6.170465
54471,2018,Julio,Ecuador,1,5,,6,-69.941498,4.191162
54472,2018,Julio,Ecuador,0,1,,1,-69.94143100000001,4.214082
54473,2018,Julio,Ecuador,1,0,,1,-74.78366,0.18595699999999998
54474,2018,Julio,Ecuador,68,212,,280,-76.876446,0.33002
54475,2018,Julio,Ecuador,36,22,,58,-77.84700600000001,0.8124359999999999
54476,2018,Julio,Ecuador,1646,2258,,3904,-77.35600000000001,0.81488
54477,2018,Julio,Ecuador,8,38,,46,-78.802679,18.00143
54478,2018,Julio,Ecuador,13,22,,35,-75.527794,10.406342
54479,2018,Julio,Ecuador,707,511,,1218,-75.516486,10.446304
54480,2018,Julio,Ecuador,6,8,,14,-74.77647900000001,10.886686
54481,2018,Julio,Ecuador,6,9,,15,-72.129595,11.360028999999999
54482,2018,Julio,Ecuador,20,18,,38,-81.70216500000001,12.5862
54483,2018,Julio,Ecuador,590,562,,1152,-76.532004,3.451668
54484,2018,Julio,Ecuador,1,2,,3,-75.76635300000001,4.45285
54485,2018,Julio,Ecuador,3837,4365,,8202,-74.140516,4.697157
54486,2018,Julio,Ecuador,1,2,,3,-75.736374,4.815189
54487,2018,Julio,Ecuador,59,104,,163,-75.42726,6.170465
54488,2018,Julio,Ecuador,1,4,,5,-70.74025300000001,7.088728999999999
54489,2018,Julio,Ecuador,1,0,,1,-73.181317,7.1280470000000005
54490,2018,Julio,Ecuador,138,166,,304,-72.453013,7.819
54491,2018,Julio,Ecuador,9,7,,16,-72.409396,8.36068
54492,2018,Julio,Ecuador,0,1,,1,-77.35002,8.63337
54493,2018,Julio,Egipto,0,1,,1,-75.516486,10.446304
54494,2018,Julio,Egipto,0,1,,1,-74.77647900000001,10.886686
54495,2018,Julio,Egipto,10,23,,33,-74.140516,4.697157
54496,2018,Julio,Egipto,1,2,,3,-75.42726,6.170465
54497,2018,Julio,El Salvador,72,62,,134,-75.516486,10.446304
54498,2018,Julio,El Salvador,17,28,,45,-74.77647900000001,10.886686
54499,2018,Julio,El Salvador,3,4,,7,-81.70216500000001,12.5862
54500,2018,Julio,El Salvador,120,158,,278,-76.532004,3.451668
54501,2018,Julio,El Salvador,1006,1145,,2151,-74.140516,4.697157
54502,2018,Julio,El Salvador,0,5,,5,-75.736374,4.815189
54503,2018,Julio,El Salvador,208,215,,423,-75.42726,6.170465
54504,2018,Julio,El Salvador,1,1,,2,-72.453013,7.819
54505,2018,Julio,Emiratos Árabes,0,5,,5,-75.516486,10.446304
54506,2018,Julio,Emiratos Árabes,4,14,,18,-74.140516,4.697157
54507,2018,Julio,España,5,6,,11,-69.941498,4.191162
54508,2018,Julio,España,4,8,,12,-69.94143100000001,4.214082
54509,2018,Julio,España,2,1,,3,-76.876446,0.33002
54510,2018,Julio,España,46,71,,117,-77.35600000000001,0.81488
54511,2018,Julio,España,0,1,,1,-78.802679,18.00143
54512,2018,Julio,España,16,20,,36,-75.527794,10.406342
54513,2018,Julio,España,146,200,,346,-75.516486,10.446304
54514,2018,Julio,España,40,63,,103,-74.77647900000001,10.886686
54515,2018,Julio,España,0,1,,1,-74.213989,11.247722999999999
54516,2018,Julio,España,4,12,,16,-72.129595,11.360028999999999
54517,2018,Julio,España,1,7,,8,-81.70216500000001,12.5862
54518,2018,Julio,España,632,789,,1421,-76.532004,3.451668
54519,2018,Julio,España,0,1,,1,-75.76635300000001,4.45285
54520,2018,Julio,España,3563,5783,,9346,-74.140516,4.697157
54521,2018,Julio,España,1,7,,8,-75.736374,4.815189
54522,2018,Julio,España,604,880,,1484,-75.42726,6.170465
54523,2018,Julio,España,1,0,,1,-67.48402800000001,6.185536
54524,2018,Julio,España,0,4,,4,-70.74025300000001,7.088728999999999
54525,2018,Julio,España,5,4,,9,-73.181317,7.1280470000000005
54526,2018,Julio,España,17,32,,49,-72.453013,7.819
54527,2018,Julio,España,10,14,,24,-72.409396,8.36068
54528,2018,Julio,España,3,3,,6,-77.35002,8.63337
54529,2018,Julio,Eritrea,0,1,,1,-74.140516,4.697157
54530,2018,Julio,Eslovaquia,0,1,,1,-75.527794,10.406342
54531,2018,Julio,Eslovaquia,8,4,,12,-75.516486,10.446304
54532,2018,Julio,Eslovaquia,1,0,,1,-72.129595,11.360028999999999
54533,2018,Julio,Eslovaquia,1,1,,2,-76.532004,3.451668
54534,2018,Julio,Eslovaquia,17,18,,35,-74.140516,4.697157
54535,2018,Julio,Eslovaquia,2,1,,3,-75.42726,6.170465
54536,2018,Julio,Eslovenia,0,1,,1,-69.941498,4.191162
54537,2018,Julio,Eslovenia,3,3,,6,-77.35600000000001,0.81488
54538,2018,Julio,Eslovenia,1,0,,1,-76.532004,3.451668
54539,2018,Julio,Eslovenia,7,15,,22,-74.140516,4.697157
54540,2018,Julio,Estados Unidos de América,19,24,,43,-69.941498,4.191162
54541,2018,Julio,Estados Unidos de América,22,26,,48,-69.94143100000001,4.214082
54542,2018,Julio,Estados Unidos de América,4,5,,9,-76.876446,0.33002
54543,2018,Julio,Estados Unidos de América,66,114,,180,-77.35600000000001,0.81488
54544,2018,Julio,Estados Unidos de América,0,2,,2,-78.802679,18.00143
54545,2018,Julio,Estados Unidos de América,42,65,,107,-75.527794,10.406342
54546,2018,Julio,Estados Unidos de América,5661,6887,,12548,-75.516486,10.446304
54547,2018,Julio,Estados Unidos de América,1212,1820,,3032,-74.77647900000001,10.886686
54548,2018,Julio,Estados Unidos de América,1,2,,3,-74.232675,11.117206
54549,2018,Julio,Estados Unidos de América,4,4,,8,-74.213989,11.247722999999999
54550,2018,Julio,Estados Unidos de América,2,4,,6,-72.129595,11.360028999999999
54551,2018,Julio,Estados Unidos de América,68,88,,156,-81.70216500000001,12.5862
54552,2018,Julio,Estados Unidos de América,2,2,,4,-81.372937,13.338761300000002
54553,2018,Julio,Estados Unidos de América,1643,1925,,3568,-76.532004,3.451668
54554,2018,Julio,Estados Unidos de América,0,2,,2,-77.061029,3.8844260000000004
54555,2018,Julio,Estados Unidos de América,273,314,,587,-75.76635300000001,4.45285
54556,2018,Julio,Estados Unidos de América,12278,17186,,29464,-74.140516,4.697157
54557,2018,Julio,Estados Unidos de América,312,364,,676,-75.736374,4.815189
54558,2018,Julio,Estados Unidos de América,4298,7588,,11886,-75.42726,6.170465
54559,2018,Julio,Estados Unidos de América,55,86,,141,-73.181317,7.1280470000000005
54560,2018,Julio,Estados Unidos de América,10,15,,25,-72.453013,7.819
54561,2018,Julio,Estados Unidos de América,0,1,,1,-72.409396,8.36068
54562,2018,Julio,Estados Unidos de América,20,19,,39,-77.35002,8.63337
54563,2018,Julio,Estonia,2,3,,5,-76.532004,3.451668
54564,2018,Julio,Estonia,1,0,,1,-75.76635300000001,4.45285
54565,2018,Julio,Estonia,6,3,,9,-74.140516,4.697157
54566,2018,Julio,Estonia,1,0,,1,-75.42726,6.170465
54567,2018,Julio,Etiopia,1,0,,1,-75.516486,10.446304
54568,2018,Julio,Etiopia,0,1,,1,-76.532004,3.451668
54569,2018,Julio,Etiopia,4,6,,10,-74.140516,4.697157
54570,2018,Julio,Etiopia,0,1,,1,-75.42726,6.170465
54571,2018,Julio,Islas Fiji,0,1,,1,-75.516486,10.446304
54572,2018,Julio,Filipinas,1,0,,1,-76.876446,0.33002
54573,2018,Julio,Filipinas,1,0,,1,-77.35600000000001,0.81488
54574,2018,Julio,Filipinas,0,52,,52,-75.527794,10.406342
54575,2018,Julio,Filipinas,7,55,,62,-75.516486,10.446304
54576,2018,Julio,Filipinas,2,10,,12,-74.77647900000001,10.886686
54577,2018,Julio,Filipinas,0,38,,38,-74.765343,10.970933
54578,2018,Julio,Filipinas,0,5,,5,-74.213989,11.247722999999999
54579,2018,Julio,Filipinas,0,1,,1,-72.129595,11.360028999999999
54580,2018,Julio,Filipinas,6,6,,12,-76.532004,3.451668
54581,2018,Julio,Filipinas,0,21,,21,-77.061029,3.8844260000000004
54582,2018,Julio,Filipinas,44,81,,125,-74.140516,4.697157
54583,2018,Julio,Filipinas,2,1,,3,-75.736374,4.815189
54584,2018,Julio,Filipinas,1,3,,4,-75.42726,6.170465
54585,2018,Julio,Filipinas,0,14,,14,-75.68164200000001,9.402597
54586,2018,Julio,Finlandia,3,0,,3,-76.876446,0.33002
54587,2018,Julio,Finlandia,4,1,,5,-77.35600000000001,0.81488
54588,2018,Julio,Finlandia,8,5,,13,-75.516486,10.446304
54589,2018,Julio,Finlandia,2,3,,5,-76.532004,3.451668
54590,2018,Julio,Finlandia,43,43,,86,-74.140516,4.697157
54591,2018,Julio,Finlandia,3,8,,11,-75.42726,6.170465
54592,2018,Julio,Finlandia,1,1,,2,-77.35002,8.63337
54593,2018,Julio,Francia,21,25,,46,-69.941498,4.191162
54594,2018,Julio,Francia,8,19,,27,-69.94143100000001,4.214082
54595,2018,Julio,Francia,6,5,,11,-76.876446,0.33002
54596,2018,Julio,Francia,117,149,,266,-77.35600000000001,0.81488
54597,2018,Julio,Francia,6,5,,11,-75.527794,10.406342
54598,2018,Julio,Francia,212,280,,492,-75.516486,10.446304
54599,2018,Julio,Francia,44,61,,105,-74.77647900000001,10.886686
54600,2018,Julio,Francia,2,2,,4,-74.765343,10.970933
54601,2018,Julio,Francia,1,3,,4,-74.213989,11.247722999999999
54602,2018,Julio,Francia,3,2,,5,-72.129595,11.360028999999999
54603,2018,Julio,Francia,5,2,,7,-81.70216500000001,12.5862
54604,2018,Julio,Francia,1,1,,2,-81.372937,13.338761300000002
54605,2018,Julio,Francia,177,187,,364,-76.532004,3.451668
54606,2018,Julio,Francia,3270,4039,,7309,-74.140516,4.697157
54607,2018,Julio,Francia,21,31,,52,-75.736374,4.815189
54608,2018,Julio,Francia,279,432,,711,-75.42726,6.170465
54609,2018,Julio,Francia,4,10,,14,-73.181317,7.1280470000000005
54610,2018,Julio,Francia,4,11,,15,-72.453013,7.819
54611,2018,Julio,Francia,0,1,,1,-72.409396,8.36068
54612,2018,Julio,Francia,4,6,,10,-77.35002,8.63337
54613,2018,Julio,Francia,0,2,,2,-75.68164200000001,9.402597
54614,2018,Julio,Gambia,0,1,,1,-76.532004,3.451668
54615,2018,Julio,Georgia,1,3,,4,-75.516486,10.446304
54616,2018,Julio,Georgia,0,4,,4,-74.140516,4.697157
54617,2018,Julio,Georgia,1,0,,1,-75.42726,6.170465
54618,2018,Julio,Ghana,0,1,,1,-77.35600000000001,0.81488
54619,2018,Julio,Ghana,2,1,,3,-75.516486,10.446304
54620,2018,Julio,Ghana,5,7,,12,-74.140516,4.697157
54621,2018,Julio,Ghana,0,1,,1,-75.68164200000001,9.402597
54622,2018,Julio,Granada,3,6,,9,-75.516486,10.446304
54623,2018,Julio,Granada,1,3,,4,-74.77647900000001,10.886686
54624,2018,Julio,Granada,0,2,,2,-74.765343,10.970933
54625,2018,Julio,Granada,4,3,,7,-74.140516,4.697157
54626,2018,Julio,Grecia,1,0,,1,-69.94143100000001,4.214082
54627,2018,Julio,Grecia,1,0,,1,-75.527794,10.406342
54628,2018,Julio,Grecia,3,15,,18,-75.516486,10.446304
54629,2018,Julio,Grecia,0,1,,1,-74.77647900000001,10.886686
54630,2018,Julio,Grecia,2,3,,5,-76.532004,3.451668
54631,2018,Julio,Grecia,32,62,,94,-74.140516,4.697157
54632,2018,Julio,Grecia,0,4,,4,-75.42726,6.170465
54633,2018,Julio,Grecia,0,2,,2,-72.453013,7.819
54634,2018,Julio,Grecia,0,1,,1,-75.68164200000001,9.402597
54635,2018,Julio,Guatemala,1,0,,1,-69.941498,4.191162
54636,2018,Julio,Guatemala,0,1,,1,-74.78366,0.18595699999999998
54637,2018,Julio,Guatemala,0,1,,1,-76.876446,0.33002
54638,2018,Julio,Guatemala,0,1,,1,-77.84700600000001,0.8124359999999999
54639,2018,Julio,Guatemala,1,2,,3,-77.35600000000001,0.81488
54640,2018,Julio,Guatemala,0,3,,3,-75.527794,10.406342
54641,2018,Julio,Guatemala,89,118,,207,-75.516486,10.446304
54642,2018,Julio,Guatemala,46,69,,115,-74.77647900000001,10.886686
54643,2018,Julio,Guatemala,0,4,,4,-72.129595,11.360028999999999
54644,2018,Julio,Guatemala,6,4,,10,-81.70216500000001,12.5862
54645,2018,Julio,Guatemala,33,64,,97,-76.532004,3.451668
54646,2018,Julio,Guatemala,0,1,,1,-75.76635300000001,4.45285
54647,2018,Julio,Guatemala,570,1049,,1619,-74.140516,4.697157
54648,2018,Julio,Guatemala,6,2,,8,-75.736374,4.815189
54649,2018,Julio,Guatemala,82,160,,242,-75.42726,6.170465
54650,2018,Julio,Guatemala,0,2,,2,-72.453013,7.819
54651,2018,Julio,Guatemala,1,0,,1,-72.409396,8.36068
54652,2018,Julio,Guyana,4,14,,18,-75.516486,10.446304
54653,2018,Julio,Guyana,2,14,,16,-74.77647900000001,10.886686
54654,2018,Julio,Guyana,7,8,,15,-76.532004,3.451668
54655,2018,Julio,Guyana,27,52,,79,-74.140516,4.697157
54656,2018,Julio,Guyana,1,1,,2,-75.42726,6.170465
54657,2018,Julio,Guyana,1,0,,1,-70.74025300000001,7.088728999999999
54658,2018,Julio,Guyana,1,0,,1,-72.453013,7.819
54659,2018,Julio,Guinea,0,1,,1,-74.140516,4.697157
54660,2018,Julio,Guinea Ecuatorial,2,0,,2,-74.77647900000001,10.886686
54661,2018,Julio,Haití,9,13,,22,-75.516486,10.446304
54662,2018,Julio,Haití,1,8,,9,-74.77647900000001,10.886686
54663,2018,Julio,Haití,5,7,,12,-76.532004,3.451668
54664,2018,Julio,Haití,26,51,,77,-74.140516,4.697157
54665,2018,Julio,Haití,1,4,,5,-75.42726,6.170465
54666,2018,Julio,Honduras,1,1,,2,-77.35600000000001,0.81488
54667,2018,Julio,Honduras,0,21,,21,-75.527794,10.406342
54668,2018,Julio,Honduras,75,66,,141,-75.516486,10.446304
54669,2018,Julio,Honduras,4,53,,57,-74.77647900000001,10.886686
54670,2018,Julio,Honduras,0,1,,1,-74.765343,10.970933
54671,2018,Julio,Honduras,1,0,,1,-72.129595,11.360028999999999
54672,2018,Julio,Honduras,0,23,,23,-81.703935,12.574411099999999
54673,2018,Julio,Honduras,0,1,,1,-81.70216500000001,12.5862
54674,2018,Julio,Honduras,39,44,,83,-76.532004,3.451668
54675,2018,Julio,Honduras,1,0,,1,-75.76635300000001,4.45285
54676,2018,Julio,Honduras,289,355,,644,-74.140516,4.697157
54677,2018,Julio,Honduras,1,3,,4,-75.736374,4.815189
54678,2018,Julio,Honduras,74,70,,144,-75.42726,6.170465
54679,2018,Julio,Honduras,0,1,,1,-73.181317,7.1280470000000005
54680,2018,Julio,Honduras,3,0,,3,-72.453013,7.819
54681,2018,Julio,Honduras,0,1,,1,-77.35002,8.63337
54682,2018,Julio,Hong Kong,9,5,,14,-77.35600000000001,0.81488
54683,2018,Julio,Hong Kong,8,6,,14,-74.140516,4.697157
54684,2018,Julio,Hong Kong,1,1,,2,-75.42726,6.170465
54685,2018,Julio,Hungría,1,2,,3,-77.35600000000001,0.81488
54686,2018,Julio,Hungría,0,1,,1,-75.527794,10.406342
54687,2018,Julio,Hungría,0,4,,4,-75.516486,10.446304
54688,2018,Julio,Hungría,2,1,,3,-74.77647900000001,10.886686
54689,2018,Julio,Hungría,22,41,,63,-74.140516,4.697157
54690,2018,Julio,Hungría,2,9,,11,-75.42726,6.170465
54691,2018,Julio,Hungría,0,1,,1,-72.409396,8.36068
54692,2018,Julio,India,5,8,,13,-77.35600000000001,0.81488
54693,2018,Julio,India,0,4,,4,-75.527794,10.406342
54694,2018,Julio,India,19,53,,72,-75.516486,10.446304
54695,2018,Julio,India,0,9,,9,-74.77647900000001,10.886686
54696,2018,Julio,India,0,1,,1,-74.232675,11.117206
54697,2018,Julio,India,0,1,,1,-74.213989,11.247722999999999
54698,2018,Julio,India,13,17,,30,-76.532004,3.451668
54699,2018,Julio,India,109,396,,505,-74.140516,4.697157
54700,2018,Julio,India,0,1,,1,-75.736374,4.815189
54701,2018,Julio,India,16,61,,77,-75.42726,6.170465
54702,2018,Julio,India,0,1,,1,-73.181317,7.1280470000000005
54703,2018,Julio,India,0,1,,1,-72.409396,8.36068
54704,2018,Julio,India,0,5,,5,-75.68164200000001,9.402597
54705,2018,Julio,Indonesia,1,0,,1,-75.516486,10.446304
54706,2018,Julio,Indonesia,0,1,,1,-74.765343,10.970933
54707,2018,Julio,Indonesia,0,1,,1,-76.532004,3.451668
54708,2018,Julio,Indonesia,19,23,,42,-74.140516,4.697157
54709,2018,Julio,Indonesia,1,3,,4,-75.42726,6.170465
54710,2018,Julio,Iraq,3,2,,5,-74.140516,4.697157
54711,2018,Julio,Irán,0,1,,1,-75.527794,10.406342
54712,2018,Julio,Irán,0,1,,1,-75.516486,10.446304
54713,2018,Julio,Irán,0,1,,1,-72.129595,11.360028999999999
54714,2018,Julio,Irán,8,13,,21,-74.140516,4.697157
54715,2018,Julio,Irán,0,1,,1,-75.736374,4.815189
54716,2018,Julio,Irán,0,1,,1,-75.42726,6.170465
54717,2018,Julio,República de Irlanda,1,3,,4,-69.941498,4.191162
54718,2018,Julio,República de Irlanda,1,1,,2,-69.94143100000001,4.214082
54719,2018,Julio,República de Irlanda,0,1,,1,-76.876446,0.33002
54720,2018,Julio,República de Irlanda,13,21,,34,-77.35600000000001,0.81488
54721,2018,Julio,República de Irlanda,8,9,,17,-75.527794,10.406342
54722,2018,Julio,República de Irlanda,24,54,,78,-75.516486,10.446304
54723,2018,Julio,República de Irlanda,0,1,,1,-74.77647900000001,10.886686
54724,2018,Julio,República de Irlanda,8,12,,20,-76.532004,3.451668
54725,2018,Julio,República de Irlanda,201,309,,510,-74.140516,4.697157
54726,2018,Julio,República de Irlanda,1,3,,4,-75.736374,4.815189
54727,2018,Julio,República de Irlanda,15,28,,43,-75.42726,6.170465
54728,2018,Julio,República de Irlanda,0,1,,1,-72.453013,7.819
54729,2018,Julio,República de Irlanda,21,13,,34,-77.35002,8.63337
54730,2018,Julio,Islandia,5,6,,11,-75.516486,10.446304
54731,2018,Julio,Islandia,0,1,,1,-74.77647900000001,10.886686
54732,2018,Julio,Islandia,3,1,,4,-76.532004,3.451668
54733,2018,Julio,Islandia,13,8,,21,-74.140516,4.697157
54734,2018,Julio,Islandia,1,4,,5,-75.42726,6.170465
54735,2018,Julio,Israel,2,4,,6,-69.941498,4.191162
54736,2018,Julio,Israel,0,1,,1,-69.94143100000001,4.214082
54737,2018,Julio,Israel,0,1,,1,-76.876446,0.33002
54738,2018,Julio,Israel,34,63,,97,-77.35600000000001,0.81488
54739,2018,Julio,Israel,7,59,,66,-75.516486,10.446304
54740,2018,Julio,Israel,0,3,,3,-74.77647900000001,10.886686
54741,2018,Julio,Israel,0,2,,2,-81.70216500000001,12.5862
54742,2018,Julio,Israel,8,17,,25,-76.532004,3.451668
54743,2018,Julio,Israel,2,2,,4,-75.76635300000001,4.45285
54744,2018,Julio,Israel,182,457,,639,-74.140516,4.697157
54745,2018,Julio,Israel,28,69,,97,-75.42726,6.170465
54746,2018,Julio,Israel,0,1,,1,-73.181317,7.1280470000000005
54747,2018,Julio,Israel,1,5,,6,-77.35002,8.63337
54748,2018,Julio,Italia,0,1,,1,-69.941498,4.191162
54749,2018,Julio,Italia,1,1,,2,-69.94143100000001,4.214082
54750,2018,Julio,Italia,19,18,,37,-77.35600000000001,0.81488
54751,2018,Julio,Italia,15,21,,36,-75.527794,10.406342
54752,2018,Julio,Italia,75,125,,200,-75.516486,10.446304
54753,2018,Julio,Italia,31,40,,71,-74.77647900000001,10.886686
54754,2018,Julio,Italia,0,5,,5,-74.213989,11.247722999999999
54755,2018,Julio,Italia,4,7,,11,-72.129595,11.360028999999999
54756,2018,Julio,Italia,0,2,,2,-81.703935,12.574411099999999
54757,2018,Julio,Italia,2,1,,3,-81.70216500000001,12.5862
54758,2018,Julio,Italia,1,1,,2,-81.372937,13.338761300000002
54759,2018,Julio,Italia,73,93,,166,-76.532004,3.451668
54760,2018,Julio,Italia,0,3,,3,-75.76635300000001,4.45285
54761,2018,Julio,Italia,929,1698,,2627,-74.140516,4.697157
54762,2018,Julio,Italia,1,6,,7,-75.736374,4.815189
54763,2018,Julio,Italia,99,217,,316,-75.42726,6.170465
54764,2018,Julio,Italia,0,1,,1,-67.48402800000001,6.185536
54765,2018,Julio,Italia,1,2,,3,-70.74025300000001,7.088728999999999
54766,2018,Julio,Italia,2,3,,5,-73.181317,7.1280470000000005
54767,2018,Julio,Italia,12,15,,27,-72.453013,7.819
54768,2018,Julio,Italia,4,4,,8,-72.409396,8.36068
54769,2018,Julio,Italia,0,3,,3,-77.35002,8.63337
54770,2018,Julio,Jamaica,9,5,,14,-75.516486,10.446304
54771,2018,Julio,Jamaica,90,102,,192,-74.77647900000001,10.886686
54772,2018,Julio,Jamaica,4,8,,12,-76.532004,3.451668
54773,2018,Julio,Jamaica,31,37,,68,-74.140516,4.697157
54774,2018,Julio,Jamaica,5,6,,11,-75.42726,6.170465
54775,2018,Julio,Japón,0,4,,4,-69.941498,4.191162
54776,2018,Julio,Japón,0,2,,2,-69.94143100000001,4.214082
54777,2018,Julio,Japón,3,11,,14,-77.35600000000001,0.81488
54778,2018,Julio,Japón,0,2,,2,-75.527794,10.406342
54779,2018,Julio,Japón,7,10,,17,-75.516486,10.446304
54780,2018,Julio,Japón,0,10,,10,-74.77647900000001,10.886686
54781,2018,Julio,Japón,11,11,,22,-76.532004,3.451668
54782,2018,Julio,Japón,160,426,,586,-74.140516,4.697157
54783,2018,Julio,Japón,27,41,,68,-75.42726,6.170465
54784,2018,Julio,Japón,0,1,,1,-73.181317,7.1280470000000005
54785,2018,Julio,Japón,0,5,,5,-72.453013,7.819
54786,2018,Julio,Japón,1,0,,1,-77.35002,8.63337
54787,2018,Julio,Jordania,1,7,,8,-74.140516,4.697157
54788,2018,Julio,Jordania,1,2,,3,-75.42726,6.170465
54789,2018,Julio,Kazajistán,1,0,,1,-77.35600000000001,0.81488
54790,2018,Julio,Kazajistán,8,4,,12,-74.140516,4.697157
54791,2018,Julio,Kazajistán,1,0,,1,-75.42726,6.170465
54792,2018,Julio,Kenia,0,1,,1,-76.876446,0.33002
54793,2018,Julio,Kenia,0,1,,1,-75.527794,10.406342
54794,2018,Julio,Kenia,0,1,,1,-75.516486,10.446304
54795,2018,Julio,Kenia,2,2,,4,-76.532004,3.451668
54796,2018,Julio,Kenia,11,14,,25,-74.140516,4.697157
54797,2018,Julio,Kuwait,0,3,,3,-74.140516,4.697157
54798,2018,Julio,República de Kosovo,1,0,,1,-76.532004,3.451668
54799,2018,Julio,República de Kosovo,1,1,,2,-74.140516,4.697157
54800,2018,Julio,República de Kosovo,0,1,,1,-75.42726,6.170465
54801,2018,Julio,República Democrática Popular  Lao,1,2,,3,-74.140516,4.697157
54802,2018,Julio,Letonia,1,2,,3,-75.516486,10.446304
54803,2018,Julio,Letonia,8,8,,16,-74.140516,4.697157
54804,2018,Julio,Letonia,1,1,,2,-75.42726,6.170465
54805,2018,Julio,Lituania,0,1,,1,-76.876446,0.33002
54806,2018,Julio,Lituania,0,3,,3,-75.527794,10.406342
54807,2018,Julio,Lituania,2,1,,3,-75.516486,10.446304
54808,2018,Julio,Lituania,0,1,,1,-74.77647900000001,10.886686
54809,2018,Julio,Lituania,0,1,,1,-74.765343,10.970933
54810,2018,Julio,Lituania,2,3,,5,-76.532004,3.451668
54811,2018,Julio,Lituania,22,12,,34,-74.140516,4.697157
54812,2018,Julio,Lituania,3,2,,5,-75.42726,6.170465
54813,2018,Julio,Líbano,2,1,,3,-75.516486,10.446304
54814,2018,Julio,Líbano,1,0,,1,-74.77647900000001,10.886686
54815,2018,Julio,Líbano,1,0,,1,-72.129595,11.360028999999999
54816,2018,Julio,Líbano,1,0,,1,-76.532004,3.451668
54817,2018,Julio,Líbano,11,28,,39,-74.140516,4.697157
54818,2018,Julio,Líbano,0,1,,1,-75.736374,4.815189
54819,2018,Julio,Líbano,0,5,,5,-75.42726,6.170465
54820,2018,Julio,Libia,0,1,,1,-74.140516,4.697157
54821,2018,Julio,Liechtenstein,1,1,,2,-74.140516,4.697157
54822,2018,Julio,Luxemburgo,1,0,,1,-77.35600000000001,0.81488
54823,2018,Julio,Luxemburgo,1,0,,1,-75.516486,10.446304
54824,2018,Julio,Luxemburgo,0,2,,2,-76.532004,3.451668
54825,2018,Julio,Luxemburgo,13,17,,30,-74.140516,4.697157
54826,2018,Julio,Luxemburgo,3,2,,5,-75.42726,6.170465
54827,2018,Julio,Luxemburgo,2,0,,2,-77.35002,8.63337
54828,2018,Julio,Macedonia,0,1,,1,-75.516486,10.446304
54829,2018,Julio,Macedonia,0,1,,1,-74.140516,4.697157
54830,2018,Julio,Macedonia,1,0,,1,-75.42726,6.170465
54831,2018,Julio,Madagascar,2,1,,3,-74.140516,4.697157
54832,2018,Julio,Malasia,1,3,,4,-77.35600000000001,0.81488
54833,2018,Julio,Malasia,1,6,,7,-75.516486,10.446304
54834,2018,Julio,Malasia,0,1,,1,-74.77647900000001,10.886686
54835,2018,Julio,Malasia,0,1,,1,-76.532004,3.451668
54836,2018,Julio,Malasia,21,24,,45,-74.140516,4.697157
54837,2018,Julio,Malasia,1,1,,2,-75.42726,6.170465
54838,2018,Julio,Malasia,0,1,,1,-75.68164200000001,9.402597
54839,2018,Julio,Malta,0,1,,1,-77.35600000000001,0.81488
54840,2018,Julio,Malta,3,4,,7,-74.140516,4.697157
54841,2018,Julio,Malta,0,2,,2,-75.42726,6.170465
54842,2018,Julio,Marruecos,1,0,,1,-75.516486,10.446304
54843,2018,Julio,Marruecos,0,1,,1,-74.77647900000001,10.886686
54844,2018,Julio,Marruecos,1,1,,2,-76.532004,3.451668
54845,2018,Julio,Marruecos,15,17,,32,-74.140516,4.697157
54846,2018,Julio,Marruecos,1,5,,6,-75.42726,6.170465
54847,2018,Julio,Mauricio,0,1,,1,-74.140516,4.697157
54848,2018,Julio,México,4,3,,7,-69.941498,4.191162
54849,2018,Julio,México,4,4,,8,-76.876446,0.33002
54850,2018,Julio,México,37,56,,93,-77.35600000000001,0.81488
54851,2018,Julio,México,39,62,,101,-75.527794,10.406342
54852,2018,Julio,México,357,429,,786,-75.516486,10.446304
54853,2018,Julio,México,308,438,,746,-74.77647900000001,10.886686
54854,2018,Julio,México,0,4,,4,-74.213989,11.247722999999999
54855,2018,Julio,México,3,1,,4,-72.129595,11.360028999999999
54856,2018,Julio,México,8,4,,12,-81.70216500000001,12.5862
54857,2018,Julio,México,132,219,,351,-76.532004,3.451668
54858,2018,Julio,México,2,1,,3,-75.76635300000001,4.45285
54859,2018,Julio,México,6114,8600,,14714,-74.140516,4.697157
54860,2018,Julio,México,20,38,,58,-75.736374,4.815189
54861,2018,Julio,México,944,1442,,2386,-75.42726,6.170465
54862,2018,Julio,México,1,2,,3,-67.48402800000001,6.185536
54863,2018,Julio,México,2,1,,3,-70.74025300000001,7.088728999999999
54864,2018,Julio,México,6,10,,16,-73.181317,7.1280470000000005
54865,2018,Julio,México,23,36,,59,-72.453013,7.819
54866,2018,Julio,México,2,4,,6,-72.409396,8.36068
54867,2018,Julio,México,2,1,,3,-77.35002,8.63337
54868,2018,Julio,República de Moldavia,9,2,,11,-74.140516,4.697157
54869,2018,Julio,Mónaco,1,2,,3,-74.140516,4.697157
54870,2018,Julio,Mónaco,0,2,,2,-75.42726,6.170465
54871,2018,Julio,Mongolia,8,1,,9,-74.140516,4.697157
54872,2018,Julio,Montenegro,1,0,,1,-75.516486,10.446304
54873,2018,Julio,Montenegro,1,1,,2,-76.532004,3.451668
54874,2018,Julio,Montenegro,2,1,,3,-74.140516,4.697157
54875,2018,Julio,Montenegro,0,2,,2,-75.42726,6.170465
54876,2018,Julio,Mozambique,0,5,,5,-74.140516,4.697157
54877,2018,Julio,Mozambique,1,1,,2,-75.42726,6.170465
54878,2018,Julio,Myanmar,0,1,,1,-75.527794,10.406342
54879,2018,Julio,Myanmar,0,2,,2,-75.516486,10.446304
54880,2018,Julio,Myanmar,7,10,,17,-74.140516,4.697157
54881,2018,Julio,Namibia,0,1,,1,-74.140516,4.697157
54882,2018,Julio,Nepal,2,5,,7,-74.140516,4.697157
54883,2018,Julio,Nicaragua,0,12,,12,-75.527794,10.406342
54884,2018,Julio,Nicaragua,16,13,,29,-75.516486,10.446304
54885,2018,Julio,Nicaragua,12,17,,29,-74.77647900000001,10.886686
54886,2018,Julio,Nicaragua,4,3,,7,-81.70216500000001,12.5862
54887,2018,Julio,Nicaragua,45,29,,74,-76.532004,3.451668
54888,2018,Julio,Nicaragua,0,1,,1,-77.061029,3.8844260000000004
54889,2018,Julio,Nicaragua,1,1,,2,-75.76635300000001,4.45285
54890,2018,Julio,Nicaragua,108,156,,264,-74.140516,4.697157
54891,2018,Julio,Nicaragua,2,1,,3,-75.736374,4.815189
54892,2018,Julio,Nicaragua,46,61,,107,-75.42726,6.170465
54893,2018,Julio,Nicaragua,0,1,,1,-73.181317,7.1280470000000005
54894,2018,Julio,Nigeria,0,1,,1,-75.516486,10.446304
54895,2018,Julio,Nigeria,0,2,,2,-72.129595,11.360028999999999
54896,2018,Julio,Nigeria,5,12,,17,-74.140516,4.697157
54897,2018,Julio,Nigeria,0,4,,4,-75.42726,6.170465
54898,2018,Julio,Noruega,5,1,,6,-77.35600000000001,0.81488
54899,2018,Julio,Noruega,4,4,,8,-75.527794,10.406342
54900,2018,Julio,Noruega,61,41,,102,-75.516486,10.446304
54901,2018,Julio,Noruega,1,1,,2,-74.77647900000001,10.886686
54902,2018,Julio,Noruega,1,1,,2,-81.70216500000001,12.5862
54903,2018,Julio,Noruega,19,16,,35,-76.532004,3.451668
54904,2018,Julio,Noruega,185,233,,418,-74.140516,4.697157
54905,2018,Julio,Noruega,25,32,,57,-75.42726,6.170465
54906,2018,Julio,Noruega,3,0,,3,-73.181317,7.1280470000000005
54907,2018,Julio,Noruega,1,2,,3,-72.453013,7.819
54908,2018,Julio,Nueva Zelanda,0,3,,3,-69.941498,4.191162
54909,2018,Julio,Nueva Zelanda,0,2,,2,-69.94143100000001,4.214082
54910,2018,Julio,Nueva Zelanda,0,2,,2,-76.876446,0.33002
54911,2018,Julio,Nueva Zelanda,8,10,,18,-77.35600000000001,0.81488
54912,2018,Julio,Nueva Zelanda,4,14,,18,-75.527794,10.406342
54913,2018,Julio,Nueva Zelanda,16,16,,32,-75.516486,10.446304
54914,2018,Julio,Nueva Zelanda,0,2,,2,-74.77647900000001,10.886686
54915,2018,Julio,Nueva Zelanda,3,2,,5,-76.532004,3.451668
54916,2018,Julio,Nueva Zelanda,72,106,,178,-74.140516,4.697157
54917,2018,Julio,Nueva Zelanda,0,1,,1,-75.736374,4.815189
54918,2018,Julio,Nueva Zelanda,9,23,,32,-75.42726,6.170465
54919,2018,Julio,Nueva Zelanda,0,1,,1,-73.181317,7.1280470000000005
54920,2018,Julio,Nueva Zelanda,2,5,,7,-77.35002,8.63337
54921,2018,Julio,Omán,0,2,,2,-74.140516,4.697157
54922,2018,Julio,Países Bajos,6,6,,12,-69.941498,4.191162
54923,2018,Julio,Países Bajos,2,8,,10,-69.94143100000001,4.214082
54924,2018,Julio,Países Bajos,0,1,,1,-76.876446,0.33002
54925,2018,Julio,Países Bajos,21,29,,50,-77.35600000000001,0.81488
54926,2018,Julio,Países Bajos,35,36,,71,-75.527794,10.406342
54927,2018,Julio,Países Bajos,361,334,,695,-75.516486,10.446304
54928,2018,Julio,Países Bajos,51,54,,105,-74.77647900000001,10.886686
54929,2018,Julio,Países Bajos,0,3,,3,-74.765343,10.970933
54930,2018,Julio,Países Bajos,0,4,,4,-74.213989,11.247722999999999
54931,2018,Julio,Países Bajos,1,3,,4,-72.129595,11.360028999999999
54932,2018,Julio,Países Bajos,1,2,,3,-81.70216500000001,12.5862
54933,2018,Julio,Países Bajos,75,117,,192,-76.532004,3.451668
54934,2018,Julio,Países Bajos,0,5,,5,-77.061029,3.8844260000000004
54935,2018,Julio,Países Bajos,2849,3333,,6182,-74.140516,4.697157
54936,2018,Julio,Países Bajos,4,7,,11,-75.736374,4.815189
54937,2018,Julio,Países Bajos,251,318,,569,-75.42726,6.170465
54938,2018,Julio,Países Bajos,17,14,,31,-73.181317,7.1280470000000005
54939,2018,Julio,Países Bajos,0,1,,1,-72.409396,8.36068
54940,2018,Julio,Países Bajos,13,16,,29,-77.35002,8.63337
54941,2018,Julio,Pakistán,4,17,,21,-74.140516,4.697157
54942,2018,Julio,Pakistán,0,1,,1,-75.42726,6.170465
54943,2018,Julio,Panamá,0,9,,9,-77.35600000000001,0.81488
54944,2018,Julio,Panamá,3,43,,46,-75.527794,10.406342
54945,2018,Julio,Panamá,491,560,,1051,-75.516486,10.446304
54946,2018,Julio,Panamá,31,70,,101,-74.77647900000001,10.886686
54947,2018,Julio,Panamá,2,5,,7,-72.129595,11.360028999999999
54948,2018,Julio,Panamá,46,47,,93,-81.70216500000001,12.5862
54949,2018,Julio,Panamá,394,218,,612,-76.532004,3.451668
54950,2018,Julio,Panamá,13,20,,33,-75.76635300000001,4.45285
54951,2018,Julio,Panamá,1329,1468,,2797,-74.140516,4.697157
54952,2018,Julio,Panamá,43,42,,85,-75.736374,4.815189
54953,2018,Julio,Panamá,850,909,,1759,-75.42726,6.170465
54954,2018,Julio,Panamá,0,2,,2,-77.401154,6.222551999999999
54955,2018,Julio,Panamá,1,3,,4,-77.762647,7.102626
54956,2018,Julio,Panamá,7,11,,18,-73.181317,7.1280470000000005
54957,2018,Julio,Panamá,4,2,,6,-72.453013,7.819
54958,2018,Julio,Panamá,1,5,,6,-77.35002,8.63337
54959,2018,Julio,Papúa Nueva Guinea,1,0,,1,-74.140516,4.697157
54960,2018,Julio,Paraguay,1,2,,3,-77.35600000000001,0.81488
54961,2018,Julio,Paraguay,3,0,,3,-75.527794,10.406342
54962,2018,Julio,Paraguay,55,34,,89,-75.516486,10.446304
54963,2018,Julio,Paraguay,2,6,,8,-74.77647900000001,10.886686
54964,2018,Julio,Paraguay,24,17,,41,-81.70216500000001,12.5862
54965,2018,Julio,Paraguay,7,3,,10,-76.532004,3.451668
54966,2018,Julio,Paraguay,151,146,,297,-74.140516,4.697157
54967,2018,Julio,Paraguay,1,1,,2,-75.736374,4.815189
54968,2018,Julio,Paraguay,36,27,,63,-75.42726,6.170465
54969,2018,Julio,Paraguay,1,0,,1,-73.181317,7.1280470000000005
54970,2018,Julio,Paraguay,0,3,,3,-72.453013,7.819
54971,2018,Julio,Perú,28,36,,64,-69.941498,4.191162
54972,2018,Julio,Perú,46,78,,124,-69.94143100000001,4.214082
54973,2018,Julio,Perú,0,4,,4,-74.78366,0.18595699999999998
54974,2018,Julio,Perú,6,13,,19,-76.876446,0.33002
54975,2018,Julio,Perú,0,1,,1,-77.84700600000001,0.8124359999999999
54976,2018,Julio,Perú,127,320,,447,-77.35600000000001,0.81488
54977,2018,Julio,Perú,39,123,,162,-75.527794,10.406342
54978,2018,Julio,Perú,1096,808,,1904,-75.516486,10.446304
54979,2018,Julio,Perú,6,8,,14,-74.77647900000001,10.886686
54980,2018,Julio,Perú,0,1,,1,-74.765343,10.970933
54981,2018,Julio,Perú,0,1,,1,-74.213989,11.247722999999999
54982,2018,Julio,Perú,6,29,,35,-72.129595,11.360028999999999
54983,2018,Julio,Perú,153,112,,265,-81.70216500000001,12.5862
54984,2018,Julio,Perú,186,172,,358,-76.532004,3.451668
54985,2018,Julio,Perú,0,1,,1,-77.061029,3.8844260000000004
54986,2018,Julio,Perú,0,1,,1,-75.76635300000001,4.45285
54987,2018,Julio,Perú,4394,4914,,9308,-74.140516,4.697157
54988,2018,Julio,Perú,1,2,,3,-75.736374,4.815189
54989,2018,Julio,Perú,644,686,,1330,-75.42726,6.170465
54990,2018,Julio,Perú,0,1,,1,-67.48402800000001,6.185536
54991,2018,Julio,Perú,0,1,,1,-70.74025300000001,7.088728999999999
54992,2018,Julio,Perú,95,148,,243,-72.453013,7.819
54993,2018,Julio,Perú,2,8,,10,-72.409396,8.36068
54994,2018,Julio,Perú,0,1,,1,-77.35002,8.63337
54995,2018,Julio,Palestina,1,0,,1,-77.35600000000001,0.81488
54996,2018,Julio,Palestina,2,2,,4,-74.140516,4.697157
54997,2018,Julio,Polonia,1,0,,1,-69.941498,4.191162
54998,2018,Julio,Polonia,1,1,,2,-69.94143100000001,4.214082
54999,2018,Julio,Polonia,4,5,,9,-77.35600000000001,0.81488
55000,2018,Julio,Polonia,2,14,,16,-75.527794,10.406342
55001,2018,Julio,Polonia,7,23,,30,-75.516486,10.446304
55002,2018,Julio,Polonia,0,1,,1,-74.77647900000001,10.886686
55003,2018,Julio,Polonia,0,2,,2,-74.765343,10.970933
55004,2018,Julio,Polonia,14,5,,19,-76.532004,3.451668
55005,2018,Julio,Polonia,194,181,,375,-74.140516,4.697157
55006,2018,Julio,Polonia,0,1,,1,-75.736374,4.815189
55007,2018,Julio,Polonia,16,17,,33,-75.42726,6.170465
55008,2018,Julio,Polonia,1,0,,1,-72.453013,7.819
55009,2018,Julio,Polonia,0,1,,1,-72.409396,8.36068
55010,2018,Julio,Portugal,3,3,,6,-69.941498,4.191162
55011,2018,Julio,Portugal,1,0,,1,-69.94143100000001,4.214082
55012,2018,Julio,Portugal,6,9,,15,-77.35600000000001,0.81488
55013,2018,Julio,Portugal,4,21,,25,-75.527794,10.406342
55014,2018,Julio,Portugal,13,26,,39,-75.516486,10.446304
55015,2018,Julio,Portugal,2,3,,5,-74.77647900000001,10.886686
55016,2018,Julio,Portugal,0,8,,8,-74.213989,11.247722999999999
55017,2018,Julio,Portugal,3,1,,4,-72.129595,11.360028999999999
55018,2018,Julio,Portugal,1,0,,1,-81.70216500000001,12.5862
55019,2018,Julio,Portugal,7,33,,40,-76.532004,3.451668
55020,2018,Julio,Portugal,235,416,,651,-74.140516,4.697157
55021,2018,Julio,Portugal,1,0,,1,-75.736374,4.815189
55022,2018,Julio,Portugal,23,43,,66,-75.42726,6.170465
55023,2018,Julio,Portugal,1,2,,3,-73.181317,7.1280470000000005
55024,2018,Julio,Portugal,5,17,,22,-72.453013,7.819
55025,2018,Julio,Portugal,2,1,,3,-72.409396,8.36068
55026,2018,Julio,Portugal,0,1,,1,-77.35002,8.63337
55027,2018,Julio,Qatar,0,1,,1,-74.140516,4.697157
55028,2018,Julio,Reino Unido de Gran Bretaña e Irlanda del Norte,5,20,,25,-69.941498,4.191162
55029,2018,Julio,Reino Unido de Gran Bretaña e Irlanda del Norte,3,12,,15,-69.94143100000001,4.214082
55030,2018,Julio,Reino Unido de Gran Bretaña e Irlanda del Norte,1,5,,6,-76.876446,0.33002
55031,2018,Julio,Reino Unido de Gran Bretaña e Irlanda del Norte,122,130,,252,-77.35600000000001,0.81488
55032,2018,Julio,Reino Unido de Gran Bretaña e Irlanda del Norte,13,29,,42,-75.527794,10.406342
55033,2018,Julio,Reino Unido de Gran Bretaña e Irlanda del Norte,154,193,,347,-75.516486,10.446304
55034,2018,Julio,Reino Unido de Gran Bretaña e Irlanda del Norte,55,71,,126,-74.77647900000001,10.886686
55035,2018,Julio,Reino Unido de Gran Bretaña e Irlanda del Norte,2,2,,4,-74.213989,11.247722999999999
55036,2018,Julio,Reino Unido de Gran Bretaña e Irlanda del Norte,0,1,,1,-72.129595,11.360028999999999
55037,2018,Julio,Reino Unido de Gran Bretaña e Irlanda del Norte,0,2,,2,-81.703935,12.574411099999999
55038,2018,Julio,Reino Unido de Gran Bretaña e Irlanda del Norte,1,0,,1,-81.70216500000001,12.5862
55039,2018,Julio,Reino Unido de Gran Bretaña e Irlanda del Norte,126,122,,248,-76.532004,3.451668
55040,2018,Julio,Reino Unido de Gran Bretaña e Irlanda del Norte,1,2,,3,-75.76635300000001,4.45285
55041,2018,Julio,Reino Unido de Gran Bretaña e Irlanda del Norte,1490,2254,,3744,-74.140516,4.697157
55042,2018,Julio,Reino Unido de Gran Bretaña e Irlanda del Norte,0,1,,1,-75.736374,4.815189
55043,2018,Julio,Reino Unido de Gran Bretaña e Irlanda del Norte,136,254,,390,-75.42726,6.170465
55044,2018,Julio,Reino Unido de Gran Bretaña e Irlanda del Norte,3,4,,7,-73.181317,7.1280470000000005
55045,2018,Julio,Reino Unido de Gran Bretaña e Irlanda del Norte,1,4,,5,-72.453013,7.819
55046,2018,Julio,Reino Unido de Gran Bretaña e Irlanda del Norte,0,3,,3,-72.409396,8.36068
55047,2018,Julio,Reino Unido de Gran Bretaña e Irlanda del Norte,33,34,,67,-77.35002,8.63337
55048,2018,Julio,República Dominicana,0,1,,1,-69.941498,4.191162
55049,2018,Julio,República Dominicana,8,18,,26,-77.35600000000001,0.81488
55050,2018,Julio,República Dominicana,1,2,,3,-75.527794,10.406342
55051,2018,Julio,República Dominicana,48,75,,123,-75.516486,10.446304
55052,2018,Julio,República Dominicana,29,55,,84,-74.77647900000001,10.886686
55053,2018,Julio,República Dominicana,1,0,,1,-74.213989,11.247722999999999
55054,2018,Julio,República Dominicana,0,1,,1,-72.129595,11.360028999999999
55055,2018,Julio,República Dominicana,1,0,,1,-81.70216500000001,12.5862
55056,2018,Julio,República Dominicana,33,44,,77,-76.532004,3.451668
55057,2018,Julio,República Dominicana,4,0,,4,-75.76635300000001,4.45285
55058,2018,Julio,República Dominicana,977,1259,,2236,-74.140516,4.697157
55059,2018,Julio,República Dominicana,8,3,,11,-75.736374,4.815189
55060,2018,Julio,República Dominicana,65,79,,144,-75.42726,6.170465
55061,2018,Julio,República Dominicana,1,2,,3,-73.181317,7.1280470000000005
55062,2018,Julio,República Dominicana,1,6,,7,-72.453013,7.819
55063,2018,Julio,República Dominicana,0,1,,1,-72.409396,8.36068
55064,2018,Julio,Rumania,3,3,,6,-77.35600000000001,0.81488
55065,2018,Julio,Rumania,0,3,,3,-75.527794,10.406342
55066,2018,Julio,Rumania,6,4,,10,-75.516486,10.446304
55067,2018,Julio,Rumania,0,1,,1,-72.129595,11.360028999999999
55068,2018,Julio,Rumania,1,0,,1,-81.70216500000001,12.5862
55069,2018,Julio,Rumania,8,4,,12,-76.532004,3.451668
55070,2018,Julio,Rumania,0,1,,1,-77.061029,3.8844260000000004
55071,2018,Julio,Rumania,1,2,,3,-75.76635300000001,4.45285
55072,2018,Julio,Rumania,72,57,,129,-74.140516,4.697157
55073,2018,Julio,Rumania,7,7,,14,-75.42726,6.170465
55074,2018,Julio,Rumania,0,2,,2,-72.453013,7.819
55075,2018,Julio,Rumania,1,0,,1,-77.35002,8.63337
55076,2018,Julio,Federación de Rusia,1,0,,1,-69.941498,4.191162
55077,2018,Julio,Federación de Rusia,1,1,,2,-69.94143100000001,4.214082
55078,2018,Julio,Federación de Rusia,13,11,,24,-77.35600000000001,0.81488
55079,2018,Julio,Federación de Rusia,0,5,,5,-75.527794,10.406342
55080,2018,Julio,Federación de Rusia,10,19,,29,-75.516486,10.446304
55081,2018,Julio,Federación de Rusia,3,5,,8,-74.77647900000001,10.886686
55082,2018,Julio,Federación de Rusia,0,1,,1,-74.765343,10.970933
55083,2018,Julio,Federación de Rusia,0,3,,3,-74.213989,11.247722999999999
55084,2018,Julio,Federación de Rusia,3,2,,5,-76.532004,3.451668
55085,2018,Julio,Federación de Rusia,148,167,,315,-74.140516,4.697157
55086,2018,Julio,Federación de Rusia,14,12,,26,-75.42726,6.170465
55087,2018,Julio,Federación de Rusia,2,0,,2,-67.48402800000001,6.185536
55088,2018,Julio,Federación de Rusia,1,1,,2,-72.453013,7.819
55089,2018,Julio,Federación de Rusia,1,0,,1,-72.409396,8.36068
55090,2018,Julio,Federación de Rusia,0,1,,1,-77.35002,8.63337
55091,2018,Julio,Federación de Rusia,0,2,,2,-75.68164200000001,9.402597
55092,2018,Julio,Rwanda,0,1,,1,-76.532004,3.451668
55093,2018,Julio,Rwanda,2,0,,2,-74.140516,4.697157
55094,2018,Julio,San Cristóbal y Nevis,0,1,,1,-75.516486,10.446304
55095,2018,Julio,San Cristóbal y Nevis,4,7,,11,-74.77647900000001,10.886686
55096,2018,Julio,San Cristóbal y Nevis,3,14,,17,-74.140516,4.697157
55097,2018,Julio,San Cristóbal y Nevis,0,1,,1,-75.42726,6.170465
55098,2018,Julio,San  Vicente y las Granadinas,1,3,,4,-75.516486,10.446304
55099,2018,Julio,San  Vicente y las Granadinas,7,9,,16,-74.77647900000001,10.886686
55100,2018,Julio,San  Vicente y las Granadinas,0,6,,6,-76.532004,3.451668
55101,2018,Julio,San  Vicente y las Granadinas,7,3,,10,-74.140516,4.697157
55102,2018,Julio,San  Vicente y las Granadinas,0,3,,3,-75.42726,6.170465
55103,2018,Julio,Santa Lucia,1,3,,4,-75.516486,10.446304
55104,2018,Julio,Santa Lucia,3,6,,9,-74.77647900000001,10.886686
55105,2018,Julio,Santa Lucia,2,10,,12,-74.140516,4.697157
55106,2018,Julio,Santa Lucia,0,1,,1,-75.42726,6.170465
55107,2018,Julio,Santa Sede/Ciudad del Vaticano,0,1,,1,-74.140516,4.697157
55108,2018,Julio,Senegal,3,1,,4,-74.140516,4.697157
55109,2018,Julio,Serbia,0,1,,1,-77.35600000000001,0.81488
55110,2018,Julio,Serbia,1,1,,2,-75.516486,10.446304
55111,2018,Julio,Serbia,0,2,,2,-76.532004,3.451668
55112,2018,Julio,Serbia,12,19,,31,-74.140516,4.697157
55113,2018,Julio,Serbia,3,3,,6,-75.42726,6.170465
55114,2018,Julio,Sierra Leona,0,2,,2,-74.140516,4.697157
55115,2018,Julio,Singapur,0,1,,1,-77.35600000000001,0.81488
55116,2018,Julio,Singapur,1,0,,1,-75.527794,10.406342
55117,2018,Julio,Singapur,2,1,,3,-75.516486,10.446304
55118,2018,Julio,Singapur,21,36,,57,-74.140516,4.697157
55119,2018,Julio,Singapur,2,4,,6,-75.42726,6.170465
55120,2018,Julio,Singapur,0,1,,1,-75.68164200000001,9.402597
55121,2018,Julio,República Árabe Siria,0,2,,2,-74.140516,4.697157
55122,2018,Julio,República Árabe Siria,0,1,,1,-75.42726,6.170465
55123,2018,Julio,Somalia,0,1,,1,-74.140516,4.697157
55124,2018,Julio,Sri Lanka,0,1,,1,-75.516486,10.446304
55125,2018,Julio,Sri Lanka,0,1,,1,-74.765343,10.970933
55126,2018,Julio,Sri Lanka,0,1,,1,-76.532004,3.451668
55127,2018,Julio,Sri Lanka,0,3,,3,-74.140516,4.697157
55128,2018,Julio,Sri Lanka,0,2,,2,-75.42726,6.170465
55129,2018,Julio,Sudáfrica,1,2,,3,-75.527794,10.406342
55130,2018,Julio,Sudáfrica,5,0,,5,-75.516486,10.446304
55131,2018,Julio,Sudáfrica,0,2,,2,-74.77647900000001,10.886686
55132,2018,Julio,Sudáfrica,0,1,,1,-72.129595,11.360028999999999
55133,2018,Julio,Sudáfrica,0,1,,1,-77.061029,3.8844260000000004
55134,2018,Julio,Sudáfrica,26,49,,75,-74.140516,4.697157
55135,2018,Julio,Sudáfrica,1,5,,6,-75.42726,6.170465
55136,2018,Julio,Sudáfrica,2,0,,2,-77.35002,8.63337
55137,2018,Julio,Suecia,1,0,,1,-69.941498,4.191162
55138,2018,Julio,Suecia,1,7,,8,-69.94143100000001,4.214082
55139,2018,Julio,Suecia,1,0,,1,-76.876446,0.33002
55140,2018,Julio,Suecia,3,7,,10,-77.35600000000001,0.81488
55141,2018,Julio,Suecia,4,3,,7,-75.527794,10.406342
55142,2018,Julio,Suecia,26,46,,72,-75.516486,10.446304
55143,2018,Julio,Suecia,1,2,,3,-74.77647900000001,10.886686
55144,2018,Julio,Suecia,15,15,,30,-76.532004,3.451668
55145,2018,Julio,Suecia,177,246,,423,-74.140516,4.697157
55146,2018,Julio,Suecia,3,2,,5,-75.736374,4.815189
55147,2018,Julio,Suecia,21,41,,62,-75.42726,6.170465
55148,2018,Julio,Suecia,1,0,,1,-73.181317,7.1280470000000005
55149,2018,Julio,Suecia,0,2,,2,-72.453013,7.819
55150,2018,Julio,Suecia,0,2,,2,-72.409396,8.36068
55151,2018,Julio,Suecia,3,1,,4,-77.35002,8.63337
55152,2018,Julio,Suiza,3,6,,9,-69.941498,4.191162
55153,2018,Julio,Suiza,0,4,,4,-69.94143100000001,4.214082
55154,2018,Julio,Suiza,1,3,,4,-76.876446,0.33002
55155,2018,Julio,Suiza,0,1,,1,-77.84700600000001,0.8124359999999999
55156,2018,Julio,Suiza,27,30,,57,-77.35600000000001,0.81488
55157,2018,Julio,Suiza,16,12,,28,-75.527794,10.406342
55158,2018,Julio,Suiza,62,76,,138,-75.516486,10.446304
55159,2018,Julio,Suiza,9,8,,17,-74.77647900000001,10.886686
55160,2018,Julio,Suiza,0,2,,2,-74.213989,11.247722999999999
55161,2018,Julio,Suiza,1,2,,3,-81.70216500000001,12.5862
55162,2018,Julio,Suiza,0,1,,1,-81.372937,13.338761300000002
55163,2018,Julio,Suiza,31,61,,92,-76.532004,3.451668
55164,2018,Julio,Suiza,911,1076,,1987,-74.140516,4.697157
55165,2018,Julio,Suiza,1,2,,3,-75.736374,4.815189
55166,2018,Julio,Suiza,92,133,,225,-75.42726,6.170465
55167,2018,Julio,Suiza,0,1,,1,-73.181317,7.1280470000000005
55168,2018,Julio,Suiza,1,5,,6,-72.453013,7.819
55169,2018,Julio,Suiza,1,0,,1,-72.409396,8.36068
55170,2018,Julio,Suiza,4,6,,10,-77.35002,8.63337
55171,2018,Julio,Surinam,1,2,,3,-75.516486,10.446304
55172,2018,Julio,Surinam,3,2,,5,-74.77647900000001,10.886686
55173,2018,Julio,Surinam,1,3,,4,-76.532004,3.451668
55174,2018,Julio,Surinam,23,33,,56,-74.140516,4.697157
55175,2018,Julio,Surinam,0,2,,2,-75.42726,6.170465
55176,2018,Julio,Taiwán,1,0,,1,-74.140516,4.697157
55177,2018,Julio,República de Tayikistán,0,1,,1,-74.140516,4.697157
55178,2018,Julio,Tailandia,0,1,,1,-75.527794,10.406342
55179,2018,Julio,Tailandia,2,1,,3,-75.516486,10.446304
55180,2018,Julio,Tailandia,1,0,,1,-81.70216500000001,12.5862
55181,2018,Julio,Tailandia,2,0,,2,-76.532004,3.451668
55182,2018,Julio,Tailandia,28,15,,43,-74.140516,4.697157
55183,2018,Julio,Tailandia,4,1,,5,-75.42726,6.170465
55184,2018,Julio,Tanzania,0,1,,1,-74.77647900000001,10.886686
55185,2018,Julio,Tanzania,1,6,,7,-74.140516,4.697157
55186,2018,Julio,Togo,0,3,,3,-74.140516,4.697157
55187,2018,Julio,Togo,0,1,,1,-73.181317,7.1280470000000005
55188,2018,Julio,Trinidad y Tobago,3,0,,3,-77.35600000000001,0.81488
55189,2018,Julio,Trinidad y Tobago,29,31,,60,-75.516486,10.446304
55190,2018,Julio,Trinidad y Tobago,73,96,,169,-74.77647900000001,10.886686
55191,2018,Julio,Trinidad y Tobago,0,1,,1,-81.70216500000001,12.5862
55192,2018,Julio,Trinidad y Tobago,10,27,,37,-76.532004,3.451668
55193,2018,Julio,Trinidad y Tobago,53,107,,160,-74.140516,4.697157
55194,2018,Julio,Trinidad y Tobago,22,21,,43,-75.42726,6.170465
55195,2018,Julio,Trinidad y Tobago,1,1,,2,-73.181317,7.1280470000000005
55196,2018,Julio,Trinidad y Tobago,0,1,,1,-72.453013,7.819
55197,2018,Julio,Túnez,0,1,,1,-77.35600000000001,0.81488
55198,2018,Julio,Túnez,5,10,,15,-74.140516,4.697157
55199,2018,Julio,Túnez,0,2,,2,-75.42726,6.170465
55200,2018,Julio,Turquía,0,3,,3,-77.35600000000001,0.81488
55201,2018,Julio,Turquía,0,1,,1,-75.527794,10.406342
55202,2018,Julio,Turquía,5,8,,13,-75.516486,10.446304
55203,2018,Julio,Turquía,0,1,,1,-72.129595,11.360028999999999
55204,2018,Julio,Turquía,0,1,,1,-71.983761,12.165168
55205,2018,Julio,Turquía,1,6,,7,-76.532004,3.451668
55206,2018,Julio,Turquía,150,246,,396,-74.140516,4.697157
55207,2018,Julio,Turquía,7,20,,27,-75.42726,6.170465
55208,2018,Julio,Turquía,0,1,,1,-72.453013,7.819
55209,2018,Julio,Ucrania,1,0,,1,-77.35600000000001,0.81488
55210,2018,Julio,Ucrania,0,6,,6,-75.527794,10.406342
55211,2018,Julio,Ucrania,5,2,,7,-75.516486,10.446304
55212,2018,Julio,Ucrania,0,8,,8,-74.77647900000001,10.886686
55213,2018,Julio,Ucrania,0,6,,6,-74.765343,10.970933
55214,2018,Julio,Ucrania,0,1,,1,-74.213989,11.247722999999999
55215,2018,Julio,Ucrania,6,2,,8,-76.532004,3.451668
55216,2018,Julio,Ucrania,0,1,,1,-77.061029,3.8844260000000004
55217,2018,Julio,Ucrania,24,27,,51,-74.140516,4.697157
55218,2018,Julio,Ucrania,1,3,,4,-75.42726,6.170465
55219,2018,Julio,Ucrania,0,2,,2,-75.68164200000001,9.402597
55220,2018,Julio,Uganda,1,4,,5,-74.140516,4.697157
55221,2018,Julio,Uruguay,0,2,,2,-69.941498,4.191162
55222,2018,Julio,Uruguay,0,3,,3,-76.876446,0.33002
55223,2018,Julio,Uruguay,0,1,,1,-77.84700600000001,0.8124359999999999
55224,2018,Julio,Uruguay,5,7,,12,-77.35600000000001,0.81488
55225,2018,Julio,Uruguay,18,14,,32,-75.527794,10.406342
55226,2018,Julio,Uruguay,117,106,,223,-75.516486,10.446304
55227,2018,Julio,Uruguay,1,7,,8,-74.77647900000001,10.886686
55228,2018,Julio,Uruguay,0,1,,1,-72.129595,11.360028999999999
55229,2018,Julio,Uruguay,17,19,,36,-81.70216500000001,12.5862
55230,2018,Julio,Uruguay,8,22,,30,-76.532004,3.451668
55231,2018,Julio,Uruguay,518,567,,1085,-74.140516,4.697157
55232,2018,Julio,Uruguay,1,4,,5,-75.736374,4.815189
55233,2018,Julio,Uruguay,43,53,,96,-75.42726,6.170465
55234,2018,Julio,Uruguay,1,10,,11,-72.453013,7.819
55235,2018,Julio,Uruguay,0,1,,1,-77.35002,8.63337
55236,2018,Julio,Uzbekistán,0,1,,1,-75.516486,10.446304
55237,2018,Julio,Uzbekistán,1,1,,2,-74.140516,4.697157
55238,2018,Julio,Venezuela,0,1,,1,-69.941498,4.191162
55239,2018,Julio,Venezuela,4,0,,4,-69.94143100000001,4.214082
55240,2018,Julio,Venezuela,0,1,,1,-74.78366,0.18595699999999998
55241,2018,Julio,Venezuela,64,65,,129,-76.876446,0.33002
55242,2018,Julio,Venezuela,2566,3150,,5716,-77.35600000000001,0.81488
55243,2018,Julio,Venezuela,3,5,,8,-78.802679,18.00143
55244,2018,Julio,Venezuela,13,13,,26,-75.527794,10.406342
55245,2018,Julio,Venezuela,276,361,,637,-75.516486,10.446304
55246,2018,Julio,Venezuela,306,586,,892,-74.77647900000001,10.886686
55247,2018,Julio,Venezuela,1,3,,4,-74.232675,11.117206
55248,2018,Julio,Venezuela,1,0,,1,-74.213989,11.247722999999999
55249,2018,Julio,Venezuela,8805,8320,,17125,-72.129595,11.360028999999999
55250,2018,Julio,Venezuela,0,15,,15,-71.983761,12.165168
55251,2018,Julio,Venezuela,10,5,,15,-81.70216500000001,12.5862
55252,2018,Julio,Venezuela,146,175,,321,-76.532004,3.451668
55253,2018,Julio,Venezuela,14,12,,26,-67.927521,3.866713
55254,2018,Julio,Venezuela,1,0,,1,-75.76635300000001,4.45285
55255,2018,Julio,Venezuela,5395,5389,,10784,-74.140516,4.697157
55256,2018,Julio,Venezuela,9,16,,25,-75.736374,4.815189
55257,2018,Julio,Venezuela,871,896,,1767,-75.42726,6.170465
55258,2018,Julio,Venezuela,44,31,,75,-67.48402800000001,6.185536
55259,2018,Julio,Venezuela,3,4,,7,-75.586989,6.2188349999999994
55260,2018,Julio,Venezuela,1139,1266,,2405,-70.74025300000001,7.088728999999999
55261,2018,Julio,Venezuela,12,7,,19,-73.181317,7.1280470000000005
55262,2018,Julio,Venezuela,36362,36633,,72995,-72.453013,7.819
55263,2018,Julio,Venezuela,1,3,,4,-72.508188,7.927233
55264,2018,Julio,Venezuela,3675,3143,,6818,-72.409396,8.36068
55265,2018,Julio,Vietnam,2,0,,2,-77.35600000000001,0.81488
55266,2018,Julio,Vietnam,0,1,,1,-75.516486,10.446304
55267,2018,Julio,Vietnam,1,2,,3,-76.532004,3.451668
55268,2018,Julio,Vietnam,8,6,,14,-74.140516,4.697157
55269,2018,Julio,Vietnam,1,0,,1,-77.35002,8.63337
55270,2018,Julio,Islas Vírgenes Británicas/Territorio Británico de Ultramar,1,0,,1,-74.77647900000001,10.886686
55271,2018,Julio,Islas Vírgenes Británicas/Territorio Británico de Ultramar,0,1,,1,-74.140516,4.697157
55272,2018,Julio,República Árabe de Yemen,0,2,,2,-74.140516,4.697157
55273,2018,Julio,Zimbabue,3,4,,7,-74.140516,4.697157
55274,2018,Julio,Zimbabue,1,0,,1,-75.42726,6.170465
55275,2018,Julio,Islas Turcas y Caicos/Territorio Británico de Ultramar,1,5,,6,-75.516486,10.446304
55276,2018,Julio,Islas Turcas y Caicos/Territorio Británico de Ultramar,1,0,,1,-74.77647900000001,10.886686
55277,2018,Julio,Refugiado,1,0,,1,-76.532004,3.451668
55278,2018,Julio,Refugiado,0,3,,3,-74.140516,4.697157
55279,2018,Julio,Desconocido,0,1,,1,-77.35600000000001,0.81488
55280,2018,Julio,Desconocido,1,3,,4,-75.516486,10.446304
55281,2018,Julio,Desconocido,1,0,,1,-76.532004,3.451668
55282,2018,Julio,Desconocido,81,150,,231,-74.140516,4.697157
55283,2018,Julio,Desconocido,0,4,,4,-75.42726,6.170465
55284,2018,Julio,Desconocido,0,1,,1,-72.453013,7.819
55285,2018,Julio,República CentroÁfricana,0,1,,1,-76.532004,3.451668
55286,2018,Agosto,Albania,0,2,,2,-77.35600000000001,0.81488
55287,2018,Agosto,Albania,1,4,,5,-74.140516,4.697157
55288,2018,Agosto,Alemania,14,12,,26,-69.941498,4.191162
55289,2018,Agosto,Alemania,7,7,,14,-69.94143100000001,4.214082
55290,2018,Agosto,Alemania,0,1,,1,-74.78366,0.18595699999999998
55291,2018,Agosto,Alemania,4,9,,13,-76.876446,0.33002
55292,2018,Agosto,Alemania,82,69,,151,-77.35600000000001,0.81488
55293,2018,Agosto,Alemania,44,36,,80,-75.527794,10.406342
55294,2018,Agosto,Alemania,170,202,,372,-75.516486,10.446304
55295,2018,Agosto,Alemania,23,34,,57,-74.77647900000001,10.886686
55296,2018,Agosto,Alemania,3,3,,6,-74.232675,11.117206
55297,2018,Agosto,Alemania,3,3,,6,-74.213989,11.247722999999999
55298,2018,Agosto,Alemania,1,0,,1,-72.129595,11.360028999999999
55299,2018,Agosto,Alemania,4,2,,6,-81.70216500000001,12.5862
55300,2018,Agosto,Alemania,4,4,,8,-81.372937,13.338761300000002
55301,2018,Agosto,Alemania,78,80,,158,-76.532004,3.451668
55302,2018,Agosto,Alemania,2487,3007,,5494,-74.140516,4.697157
55303,2018,Agosto,Alemania,6,1,,7,-75.736374,4.815189
55304,2018,Agosto,Alemania,161,267,,428,-75.42726,6.170465
55305,2018,Agosto,Alemania,2,1,,3,-73.181317,7.1280470000000005
55306,2018,Agosto,Alemania,4,6,,10,-72.453013,7.819
55307,2018,Agosto,Alemania,1,0,,1,-72.409396,8.36068
55308,2018,Agosto,Alemania,17,13,,30,-77.35002,8.63337
55309,2018,Agosto,Andorra,1,1,,2,-76.532004,3.451668
55310,2018,Agosto,Andorra,3,7,,10,-74.140516,4.697157
55311,2018,Agosto,Angola,1,0,,1,-74.140516,4.697157
55312,2018,Agosto,Antigua y Barbuda,1,2,,3,-74.77647900000001,10.886686
55313,2018,Agosto,Antigua y Barbuda,0,4,,4,-74.140516,4.697157
55314,2018,Agosto,Arabia Saudita,0,5,,5,-75.516486,10.446304
55315,2018,Agosto,Arabia Saudita,0,15,,15,-74.140516,4.697157
55316,2018,Agosto,Arabia Saudita,0,2,,2,-75.42726,6.170465
55317,2018,Agosto,Argelia,10,5,,15,-74.140516,4.697157
55318,2018,Agosto,Argelia,1,0,,1,-75.42726,6.170465
55319,2018,Agosto,Argentina,4,8,,12,-69.941498,4.191162
55320,2018,Agosto,Argentina,1,6,,7,-69.94143100000001,4.214082
55321,2018,Agosto,Argentina,3,9,,12,-76.876446,0.33002
55322,2018,Agosto,Argentina,0,1,,1,-77.84700600000001,0.8124359999999999
55323,2018,Agosto,Argentina,61,121,,182,-77.35600000000001,0.81488
55324,2018,Agosto,Argentina,0,2,,2,-78.802679,18.00143
55325,2018,Agosto,Argentina,178,116,,294,-75.527794,10.406342
55326,2018,Agosto,Argentina,1663,1377,,3040,-75.516486,10.446304
55327,2018,Agosto,Argentina,21,56,,77,-74.77647900000001,10.886686
55328,2018,Agosto,Argentina,0,2,,2,-74.232675,11.117206
55329,2018,Agosto,Argentina,8,8,,16,-72.129595,11.360028999999999
55330,2018,Agosto,Argentina,343,276,,619,-81.70216500000001,12.5862
55331,2018,Agosto,Argentina,1,2,,3,-81.372937,13.338761300000002
55332,2018,Agosto,Argentina,43,90,,133,-76.532004,3.451668
55333,2018,Agosto,Argentina,0,2,,2,-75.76635300000001,4.45285
55334,2018,Agosto,Argentina,3779,5364,,9143,-74.140516,4.697157
55335,2018,Agosto,Argentina,9,9,,18,-75.736374,4.815189
55336,2018,Agosto,Argentina,224,503,,727,-75.42726,6.170465
55337,2018,Agosto,Argentina,4,4,,8,-73.181317,7.1280470000000005
55338,2018,Agosto,Argentina,5,17,,22,-72.453013,7.819
55339,2018,Agosto,Argentina,21,24,,45,-72.409396,8.36068
55340,2018,Agosto,República de Armenia,2,1,,3,-74.140516,4.697157
55341,2018,Agosto,Australia,6,1,,7,-69.941498,4.191162
55342,2018,Agosto,Australia,0,1,,1,-69.94143100000001,4.214082
55343,2018,Agosto,Australia,0,1,,1,-76.876446,0.33002
55344,2018,Agosto,Australia,21,35,,56,-77.35600000000001,0.81488
55345,2018,Agosto,Australia,13,20,,33,-75.527794,10.406342
55346,2018,Agosto,Australia,67,77,,144,-75.516486,10.446304
55347,2018,Agosto,Australia,7,14,,21,-74.77647900000001,10.886686
55348,2018,Agosto,Australia,0,1,,1,-74.213989,11.247722999999999
55349,2018,Agosto,Australia,9,14,,23,-76.532004,3.451668
55350,2018,Agosto,Australia,0,2,,2,-75.76635300000001,4.45285
55351,2018,Agosto,Australia,287,577,,864,-74.140516,4.697157
55352,2018,Agosto,Australia,1,3,,4,-75.736374,4.815189
55353,2018,Agosto,Australia,44,104,,148,-75.42726,6.170465
55354,2018,Agosto,Australia,0,1,,1,-73.181317,7.1280470000000005
55355,2018,Agosto,Australia,0,1,,1,-72.453013,7.819
55356,2018,Agosto,Australia,10,9,,19,-77.35002,8.63337
55357,2018,Agosto,Austria,0,4,,4,-69.941498,4.191162
55358,2018,Agosto,Austria,0,3,,3,-76.876446,0.33002
55359,2018,Agosto,Austria,12,11,,23,-77.35600000000001,0.81488
55360,2018,Agosto,Austria,4,3,,7,-75.527794,10.406342
55361,2018,Agosto,Austria,22,13,,35,-75.516486,10.446304
55362,2018,Agosto,Austria,3,5,,8,-74.77647900000001,10.886686
55363,2018,Agosto,Austria,0,2,,2,-74.765343,10.970933
55364,2018,Agosto,Austria,1,1,,2,-81.372937,13.338761300000002
55365,2018,Agosto,Austria,6,10,,16,-76.532004,3.451668
55366,2018,Agosto,Austria,226,292,,518,-74.140516,4.697157
55367,2018,Agosto,Austria,13,31,,44,-75.42726,6.170465
55368,2018,Agosto,Austria,6,6,,12,-77.35002,8.63337
55369,2018,Agosto,Azerbaiyán,1,7,,8,-74.140516,4.697157
55370,2018,Agosto,Bahamas,1,0,,1,-75.516486,10.446304
55371,2018,Agosto,Bahamas,4,1,,5,-76.532004,3.451668
55372,2018,Agosto,Bahamas,4,18,,22,-74.140516,4.697157
55373,2018,Agosto,Bahamas,3,8,,11,-75.42726,6.170465
55374,2018,Agosto,Bahréin,1,0,,1,-74.140516,4.697157
55375,2018,Agosto,Bangladesh,1,0,,1,-75.516486,10.446304
55376,2018,Agosto,Bangladesh,2,5,,7,-74.140516,4.697157
55377,2018,Agosto,Bangladesh,0,1,,1,-75.42726,6.170465
55378,2018,Agosto,Barbados,6,0,,6,-75.516486,10.446304
55379,2018,Agosto,Barbados,0,2,,2,-76.532004,3.451668
55380,2018,Agosto,Barbados,5,7,,12,-74.140516,4.697157
55381,2018,Agosto,Barbados,3,5,,8,-75.42726,6.170465
55382,2018,Agosto,República de Belarús,1,1,,2,-75.516486,10.446304
55383,2018,Agosto,República de Belarús,6,1,,7,-74.140516,4.697157
55384,2018,Agosto,Bélgica,4,2,,6,-69.941498,4.191162
55385,2018,Agosto,Bélgica,2,2,,4,-69.94143100000001,4.214082
55386,2018,Agosto,Bélgica,0,5,,5,-76.876446,0.33002
55387,2018,Agosto,Bélgica,12,18,,30,-77.35600000000001,0.81488
55388,2018,Agosto,Bélgica,2,5,,7,-75.527794,10.406342
55389,2018,Agosto,Bélgica,21,34,,55,-75.516486,10.446304
55390,2018,Agosto,Bélgica,3,3,,6,-74.77647900000001,10.886686
55391,2018,Agosto,Bélgica,0,1,,1,-72.129595,11.360028999999999
55392,2018,Agosto,Bélgica,0,2,,2,-81.70216500000001,12.5862
55393,2018,Agosto,Bélgica,25,17,,42,-76.532004,3.451668
55394,2018,Agosto,Bélgica,421,524,,945,-74.140516,4.697157
55395,2018,Agosto,Bélgica,3,3,,6,-75.736374,4.815189
55396,2018,Agosto,Bélgica,32,55,,87,-75.42726,6.170465
55397,2018,Agosto,Bélgica,0,2,,2,-73.181317,7.1280470000000005
55398,2018,Agosto,Bélgica,5,4,,9,-77.35002,8.63337
55399,2018,Agosto,Belice,0,1,,1,-77.35600000000001,0.81488
55400,2018,Agosto,Belice,4,4,,8,-75.516486,10.446304
55401,2018,Agosto,Belice,4,20,,24,-74.140516,4.697157
55402,2018,Agosto,Belice,1,1,,2,-75.42726,6.170465
55403,2018,Agosto,Benín,2,1,,3,-74.140516,4.697157
55404,2018,Agosto,Bermudas/Territorio Británico de Ultramar,1,0,,1,-75.516486,10.446304
55405,2018,Agosto,Bermudas/Territorio Británico de Ultramar,0,3,,3,-76.532004,3.451668
55406,2018,Agosto,Bermudas/Territorio Británico de Ultramar,0,1,,1,-74.140516,4.697157
55407,2018,Agosto,Bermudas/Territorio Británico de Ultramar,0,2,,2,-75.42726,6.170465
55408,2018,Agosto,Bolivia,0,1,,1,-69.941498,4.191162
55409,2018,Agosto,Bolivia,11,14,,25,-77.35600000000001,0.81488
55410,2018,Agosto,Bolivia,14,11,,25,-75.527794,10.406342
55411,2018,Agosto,Bolivia,144,123,,267,-75.516486,10.446304
55412,2018,Agosto,Bolivia,2,3,,5,-74.77647900000001,10.886686
55413,2018,Agosto,Bolivia,18,11,,29,-81.70216500000001,12.5862
55414,2018,Agosto,Bolivia,15,20,,35,-76.532004,3.451668
55415,2018,Agosto,Bolivia,643,662,,1305,-74.140516,4.697157
55416,2018,Agosto,Bolivia,49,58,,107,-75.42726,6.170465
55417,2018,Agosto,Bolivia,5,6,,11,-72.453013,7.819
55418,2018,Agosto,Bolivia,1,2,,3,-72.409396,8.36068
55419,2018,Agosto,Bosnia y Herzegovina,0,1,,1,-75.516486,10.446304
55420,2018,Agosto,Bosnia y Herzegovina,3,7,,10,-74.140516,4.697157
55421,2018,Agosto,Brasil,107,87,,194,-69.941498,4.191162
55422,2018,Agosto,Brasil,1,0,,1,-69.94143100000001,4.214082
55423,2018,Agosto,Brasil,2,2,,4,-76.876446,0.33002
55424,2018,Agosto,Brasil,17,37,,54,-77.35600000000001,0.81488
55425,2018,Agosto,Brasil,377,412,,789,-75.527794,10.406342
55426,2018,Agosto,Brasil,999,707,,1706,-75.516486,10.446304
55427,2018,Agosto,Brasil,16,35,,51,-74.77647900000001,10.886686
55428,2018,Agosto,Brasil,3,3,,6,-72.129595,11.360028999999999
55429,2018,Agosto,Brasil,363,279,,642,-81.70216500000001,12.5862
55430,2018,Agosto,Brasil,45,73,,118,-76.532004,3.451668
55431,2018,Agosto,Brasil,0,2,,2,-67.927521,3.866713
55432,2018,Agosto,Brasil,1,5,,6,-74.642361,4.253669
55433,2018,Agosto,Brasil,1,0,,1,-75.76635300000001,4.45285
55434,2018,Agosto,Brasil,5677,6729,,12406,-74.140516,4.697157
55435,2018,Agosto,Brasil,4,7,,11,-75.736374,4.815189
55436,2018,Agosto,Brasil,140,251,,391,-75.42726,6.170465
55437,2018,Agosto,Brasil,1,1,,2,-67.48402800000001,6.185536
55438,2018,Agosto,Brasil,0,1,,1,-73.181317,7.1280470000000005
55439,2018,Agosto,Brasil,8,12,,20,-72.453013,7.819
55440,2018,Agosto,Brasil,9,12,,21,-72.409396,8.36068
55441,2018,Agosto,Brasil,0,2,,2,-77.35002,8.63337
55442,2018,Agosto,Bulgaria,0,4,,4,-75.516486,10.446304
55443,2018,Agosto,Bulgaria,0,6,,6,-74.77647900000001,10.886686
55444,2018,Agosto,Bulgaria,0,4,,4,-74.765343,10.970933
55445,2018,Agosto,Bulgaria,1,2,,3,-76.532004,3.451668
55446,2018,Agosto,Bulgaria,35,19,,54,-74.140516,4.697157
55447,2018,Agosto,Bulgaria,6,8,,14,-75.42726,6.170465
55448,2018,Agosto,Bután,0,1,,1,-76.532004,3.451668
55449,2018,Agosto,Cabo Verde,1,0,,1,-75.516486,10.446304
55450,2018,Agosto,Cabo Verde,0,1,,1,-73.181317,7.1280470000000005
55451,2018,Agosto,Islas Caimán/Territorio Británico de Ultramar,0,1,,1,-81.70216500000001,12.5862
55452,2018,Agosto,Islas Caimán/Territorio Británico de Ultramar,1,0,,1,-74.140516,4.697157
55453,2018,Agosto,Camboya,1,0,,1,-74.140516,4.697157
55454,2018,Agosto,Camerún,2,4,,6,-74.140516,4.697157
55455,2018,Agosto,Canadá,2,4,,6,-69.941498,4.191162
55456,2018,Agosto,Canadá,0,2,,2,-69.94143100000001,4.214082
55457,2018,Agosto,Canadá,0,2,,2,-76.876446,0.33002
55458,2018,Agosto,Canadá,4,13,,17,-77.35600000000001,0.81488
55459,2018,Agosto,Canadá,10,8,,18,-75.527794,10.406342
55460,2018,Agosto,Canadá,181,242,,423,-75.516486,10.446304
55461,2018,Agosto,Canadá,25,49,,74,-74.77647900000001,10.886686
55462,2018,Agosto,Canadá,1,1,,2,-74.213989,11.247722999999999
55463,2018,Agosto,Canadá,0,2,,2,-72.129595,11.360028999999999
55464,2018,Agosto,Canadá,1,0,,1,-81.70216500000001,12.5862
55465,2018,Agosto,Canadá,49,69,,118,-76.532004,3.451668
55466,2018,Agosto,Canadá,4,4,,8,-75.76635300000001,4.45285
55467,2018,Agosto,Canadá,1119,1750,,2869,-74.140516,4.697157
55468,2018,Agosto,Canadá,7,9,,16,-75.736374,4.815189
55469,2018,Agosto,Canadá,227,412,,639,-75.42726,6.170465
55470,2018,Agosto,Canadá,4,6,,10,-73.181317,7.1280470000000005
55471,2018,Agosto,Canadá,1,2,,3,-72.453013,7.819
55472,2018,Agosto,Canadá,0,6,,6,-77.35002,8.63337
55473,2018,Agosto,República Democrática del Congo,6,17,,23,-74.140516,4.697157
55474,2018,Agosto,República Democrática del Congo,1,0,,1,-75.42726,6.170465
55475,2018,Agosto,República de Corea,0,2,,2,-69.941498,4.191162
55476,2018,Agosto,República de Corea,0,1,,1,-69.94143100000001,4.214082
55477,2018,Agosto,República de Corea,11,8,,19,-77.35600000000001,0.81488
55478,2018,Agosto,República de Corea,0,1,,1,-75.527794,10.406342
55479,2018,Agosto,República de Corea,7,11,,18,-75.516486,10.446304
55480,2018,Agosto,República de Corea,0,2,,2,-74.77647900000001,10.886686
55481,2018,Agosto,República de Corea,1,3,,4,-72.129595,11.360028999999999
55482,2018,Agosto,República de Corea,3,7,,10,-76.532004,3.451668
55483,2018,Agosto,República de Corea,0,2,,2,-77.061029,3.8844260000000004
55484,2018,Agosto,República de Corea,252,458,,710,-74.140516,4.697157
55485,2018,Agosto,República de Corea,1,0,,1,-75.736374,4.815189
55486,2018,Agosto,República de Corea,15,34,,49,-75.42726,6.170465
55487,2018,Agosto,República de Corea,0,1,,1,-72.453013,7.819
55488,2018,Agosto,República de Corea,1,0,,1,-72.409396,8.36068
55489,2018,Agosto,Costa de Marfil,2,8,,10,-74.140516,4.697157
55490,2018,Agosto,Costa Rica,0,2,,2,-77.35600000000001,0.81488
55491,2018,Agosto,Costa Rica,1,0,,1,-75.527794,10.406342
55492,2018,Agosto,Costa Rica,161,109,,270,-75.516486,10.446304
55493,2018,Agosto,Costa Rica,11,22,,33,-74.77647900000001,10.886686
55494,2018,Agosto,Costa Rica,0,4,,4,-74.232675,11.117206
55495,2018,Agosto,Costa Rica,0,2,,2,-72.129595,11.360028999999999
55496,2018,Agosto,Costa Rica,24,21,,45,-81.70216500000001,12.5862
55497,2018,Agosto,Costa Rica,23,62,,85,-76.532004,3.451668
55498,2018,Agosto,Costa Rica,1251,1537,,2788,-74.140516,4.697157
55499,2018,Agosto,Costa Rica,5,10,,15,-75.736374,4.815189
55500,2018,Agosto,Costa Rica,163,231,,394,-75.42726,6.170465
55501,2018,Agosto,Costa Rica,0,1,,1,-77.762647,7.102626
55502,2018,Agosto,Costa Rica,1,5,,6,-73.181317,7.1280470000000005
55503,2018,Agosto,Costa Rica,3,3,,6,-72.453013,7.819
55504,2018,Agosto,Costa Rica,0,2,,2,-72.409396,8.36068
55505,2018,Agosto,Costa Rica,0,2,,2,-77.35002,8.63337
55506,2018,Agosto,Croacia,0,1,,1,-75.527794,10.406342
55507,2018,Agosto,Croacia,3,4,,7,-75.516486,10.446304
55508,2018,Agosto,Croacia,0,1,,1,-74.77647900000001,10.886686
55509,2018,Agosto,Croacia,0,1,,1,-74.213989,11.247722999999999
55510,2018,Agosto,Croacia,1,1,,2,-76.532004,3.451668
55511,2018,Agosto,Croacia,18,36,,54,-74.140516,4.697157
55512,2018,Agosto,Croacia,3,7,,10,-75.42726,6.170465
55513,2018,Agosto,Cuba,0,2,,2,-76.876446,0.33002
55514,2018,Agosto,Cuba,0,4,,4,-77.35600000000001,0.81488
55515,2018,Agosto,Cuba,2,1,,3,-75.527794,10.406342
55516,2018,Agosto,Cuba,11,15,,26,-75.516486,10.446304
55517,2018,Agosto,Cuba,12,26,,38,-74.77647900000001,10.886686
55518,2018,Agosto,Cuba,2,1,,3,-81.70216500000001,12.5862
55519,2018,Agosto,Cuba,14,20,,34,-76.532004,3.451668
55520,2018,Agosto,Cuba,1,1,,2,-75.76635300000001,4.45285
55521,2018,Agosto,Cuba,225,300,,525,-74.140516,4.697157
55522,2018,Agosto,Cuba,2,7,,9,-75.736374,4.815189
55523,2018,Agosto,Cuba,41,37,,78,-75.42726,6.170465
55524,2018,Agosto,Cuba,0,1,,1,-67.48402800000001,6.185536
55525,2018,Agosto,Cuba,0,1,,1,-70.74025300000001,7.088728999999999
55526,2018,Agosto,Cuba,1,3,,4,-73.181317,7.1280470000000005
55527,2018,Agosto,Cuba,1,1,,2,-72.453013,7.819
55528,2018,Agosto,República Checa,1,1,,2,-69.94143100000001,4.214082
55529,2018,Agosto,República Checa,4,7,,11,-77.35600000000001,0.81488
55530,2018,Agosto,República Checa,2,3,,5,-75.516486,10.446304
55531,2018,Agosto,República Checa,0,1,,1,-72.129595,11.360028999999999
55532,2018,Agosto,República Checa,6,1,,7,-76.532004,3.451668
55533,2018,Agosto,República Checa,45,58,,103,-74.140516,4.697157
55534,2018,Agosto,República Checa,11,3,,14,-75.42726,6.170465
55535,2018,Agosto,Chile,1,1,,2,-69.941498,4.191162
55536,2018,Agosto,Chile,5,1,,6,-69.94143100000001,4.214082
55537,2018,Agosto,Chile,4,3,,7,-76.876446,0.33002
55538,2018,Agosto,Chile,29,46,,75,-77.35600000000001,0.81488
55539,2018,Agosto,Chile,1,2,,3,-78.802679,18.00143
55540,2018,Agosto,Chile,194,134,,328,-75.527794,10.406342
55541,2018,Agosto,Chile,550,366,,916,-75.516486,10.446304
55542,2018,Agosto,Chile,8,12,,20,-74.77647900000001,10.886686
55543,2018,Agosto,Chile,4,12,,16,-72.129595,11.360028999999999
55544,2018,Agosto,Chile,175,110,,285,-81.70216500000001,12.5862
55545,2018,Agosto,Chile,19,58,,77,-76.532004,3.451668
55546,2018,Agosto,Chile,1,1,,2,-75.76635300000001,4.45285
55547,2018,Agosto,Chile,4866,5870,,10736,-74.140516,4.697157
55548,2018,Agosto,Chile,5,7,,12,-75.736374,4.815189
55549,2018,Agosto,Chile,67,159,,226,-75.42726,6.170465
55550,2018,Agosto,Chile,1,0,,1,-67.48402800000001,6.185536
55551,2018,Agosto,Chile,0,1,,1,-73.181317,7.1280470000000005
55552,2018,Agosto,Chile,10,34,,44,-72.453013,7.819
55553,2018,Agosto,Chile,15,15,,30,-72.409396,8.36068
55554,2018,Agosto,Chile,1,1,,2,-77.35002,8.63337
55555,2018,Agosto,China,1,1,,2,-69.941498,4.191162
55556,2018,Agosto,China,1,0,,1,-69.94143100000001,4.214082
55557,2018,Agosto,China,3,7,,10,-77.35600000000001,0.81488
55558,2018,Agosto,China,2,1,,3,-75.527794,10.406342
55559,2018,Agosto,China,24,20,,44,-75.516486,10.446304
55560,2018,Agosto,China,2,21,,23,-74.77647900000001,10.886686
55561,2018,Agosto,China,0,13,,13,-74.765343,10.970933
55562,2018,Agosto,China,0,1,,1,-72.129595,11.360028999999999
55563,2018,Agosto,China,11,20,,31,-76.532004,3.451668
55564,2018,Agosto,China,0,1,,1,-77.061029,3.8844260000000004
55565,2018,Agosto,China,1,0,,1,-75.76635300000001,4.45285
55566,2018,Agosto,China,393,843,,1236,-74.140516,4.697157
55567,2018,Agosto,China,40,68,,108,-75.42726,6.170465
55568,2018,Agosto,China,0,1,,1,-73.181317,7.1280470000000005
55569,2018,Agosto,China,2,7,,9,-72.453013,7.819
55570,2018,Agosto,China,0,5,,5,-72.409396,8.36068
55571,2018,Agosto,China,1,0,,1,-77.35002,8.63337
55572,2018,Agosto,Taiwán,0,1,,1,-69.941498,4.191162
55573,2018,Agosto,Taiwán,3,3,,6,-77.35600000000001,0.81488
55574,2018,Agosto,Taiwán,4,2,,6,-75.516486,10.446304
55575,2018,Agosto,Taiwán,3,2,,5,-76.532004,3.451668
55576,2018,Agosto,Taiwán,57,66,,123,-74.140516,4.697157
55577,2018,Agosto,Taiwán,2,6,,8,-75.42726,6.170465
55578,2018,Agosto,Taiwán,1,0,,1,-72.453013,7.819
55579,2018,Agosto,Taiwán,0,1,,1,-72.409396,8.36068
55580,2018,Agosto,Taiwán,1,0,,1,-77.35002,8.63337
55581,2018,Agosto,Chipre,4,3,,7,-75.516486,10.446304
55582,2018,Agosto,Chipre,1,3,,4,-76.532004,3.451668
55583,2018,Agosto,Chipre,6,7,,13,-74.140516,4.697157
55584,2018,Agosto,Chipre,2,2,,4,-75.42726,6.170465
55585,2018,Agosto,Dinamarca,1,1,,2,-69.941498,4.191162
55586,2018,Agosto,Dinamarca,1,0,,1,-76.876446,0.33002
55587,2018,Agosto,Dinamarca,5,2,,7,-77.35600000000001,0.81488
55588,2018,Agosto,Dinamarca,1,0,,1,-75.527794,10.406342
55589,2018,Agosto,Dinamarca,15,24,,39,-75.516486,10.446304
55590,2018,Agosto,Dinamarca,0,6,,6,-74.77647900000001,10.886686
55591,2018,Agosto,Dinamarca,1,13,,14,-76.532004,3.451668
55592,2018,Agosto,Dinamarca,87,142,,229,-74.140516,4.697157
55593,2018,Agosto,Dinamarca,0,1,,1,-75.736374,4.815189
55594,2018,Agosto,Dinamarca,6,15,,21,-75.42726,6.170465
55595,2018,Agosto,Dinamarca,0,1,,1,-73.181317,7.1280470000000005
55596,2018,Agosto,Dominica,0,3,,3,-76.532004,3.451668
55597,2018,Agosto,Dominica,2,0,,2,-74.140516,4.697157
55598,2018,Agosto,Dominica,0,2,,2,-75.42726,6.170465
55599,2018,Agosto,Ecuador,1,2,,3,-69.94143100000001,4.214082
55600,2018,Agosto,Ecuador,103,263,,366,-76.876446,0.33002
55601,2018,Agosto,Ecuador,32,27,,59,-77.84700600000001,0.8124359999999999
55602,2018,Agosto,Ecuador,2533,2986,,5519,-77.35600000000001,0.81488
55603,2018,Agosto,Ecuador,8,141,,149,-78.802679,18.00143
55604,2018,Agosto,Ecuador,46,97,,143,-75.527794,10.406342
55605,2018,Agosto,Ecuador,876,736,,1612,-75.516486,10.446304
55606,2018,Agosto,Ecuador,15,22,,37,-74.77647900000001,10.886686
55607,2018,Agosto,Ecuador,8,8,,16,-72.129595,11.360028999999999
55608,2018,Agosto,Ecuador,23,17,,40,-81.70216500000001,12.5862
55609,2018,Agosto,Ecuador,755,801,,1556,-76.532004,3.451668
55610,2018,Agosto,Ecuador,0,2,,2,-67.927521,3.866713
55611,2018,Agosto,Ecuador,1,4,,5,-75.76635300000001,4.45285
55612,2018,Agosto,Ecuador,4769,5253,,10022,-74.140516,4.697157
55613,2018,Agosto,Ecuador,1,7,,8,-75.736374,4.815189
55614,2018,Agosto,Ecuador,90,118,,208,-75.42726,6.170465
55615,2018,Agosto,Ecuador,0,3,,3,-70.74025300000001,7.088728999999999
55616,2018,Agosto,Ecuador,190,224,,414,-72.453013,7.819
55617,2018,Agosto,Ecuador,19,30,,49,-72.409396,8.36068
55618,2018,Agosto,Ecuador,1,6,,7,-77.35002,8.63337
55619,2018,Agosto,Egipto,1,2,,3,-77.35600000000001,0.81488
55620,2018,Agosto,Egipto,0,1,,1,-75.527794,10.406342
55621,2018,Agosto,Egipto,0,3,,3,-75.516486,10.446304
55622,2018,Agosto,Egipto,0,1,,1,-75.76635300000001,4.45285
55623,2018,Agosto,Egipto,4,22,,26,-74.140516,4.697157
55624,2018,Agosto,Egipto,0,1,,1,-75.42726,6.170465
55625,2018,Agosto,Egipto,0,1,,1,-73.181317,7.1280470000000005
55626,2018,Agosto,El Salvador,2,0,,2,-76.876446,0.33002
55627,2018,Agosto,El Salvador,0,2,,2,-77.35600000000001,0.81488
55628,2018,Agosto,El Salvador,0,2,,2,-75.527794,10.406342
55629,2018,Agosto,El Salvador,90,76,,166,-75.516486,10.446304
55630,2018,Agosto,El Salvador,1,9,,10,-74.77647900000001,10.886686
55631,2018,Agosto,El Salvador,1,0,,1,-72.129595,11.360028999999999
55632,2018,Agosto,El Salvador,86,65,,151,-81.70216500000001,12.5862
55633,2018,Agosto,El Salvador,135,105,,240,-76.532004,3.451668
55634,2018,Agosto,El Salvador,751,879,,1630,-74.140516,4.697157
55635,2018,Agosto,El Salvador,2,2,,4,-75.736374,4.815189
55636,2018,Agosto,El Salvador,164,216,,380,-75.42726,6.170465
55637,2018,Agosto,El Salvador,0,5,,5,-72.453013,7.819
55638,2018,Agosto,El Salvador,0,1,,1,-77.35002,8.63337
55639,2018,Agosto,Emiratos Árabes,0,2,,2,-76.532004,3.451668
55640,2018,Agosto,Emiratos Árabes,9,29,,38,-74.140516,4.697157
55641,2018,Agosto,Emiratos Árabes,5,2,,7,-75.42726,6.170465
55642,2018,Agosto,España,8,9,,17,-69.941498,4.191162
55643,2018,Agosto,España,2,4,,6,-69.94143100000001,4.214082
55644,2018,Agosto,España,3,7,,10,-76.876446,0.33002
55645,2018,Agosto,España,43,58,,101,-77.35600000000001,0.81488
55646,2018,Agosto,España,0,1,,1,-78.802679,18.00143
55647,2018,Agosto,España,7,32,,39,-75.527794,10.406342
55648,2018,Agosto,España,163,276,,439,-75.516486,10.446304
55649,2018,Agosto,España,20,49,,69,-74.77647900000001,10.886686
55650,2018,Agosto,España,0,2,,2,-74.232675,11.117206
55651,2018,Agosto,España,0,2,,2,-74.213989,11.247722999999999
55652,2018,Agosto,España,3,10,,13,-72.129595,11.360028999999999
55653,2018,Agosto,España,3,10,,13,-81.70216500000001,12.5862
55654,2018,Agosto,España,500,607,,1107,-76.532004,3.451668
55655,2018,Agosto,España,2,1,,3,-75.76635300000001,4.45285
55656,2018,Agosto,España,4861,6904,,11765,-74.140516,4.697157
55657,2018,Agosto,España,10,19,,29,-75.736374,4.815189
55658,2018,Agosto,España,733,1044,,1777,-75.42726,6.170465
55659,2018,Agosto,España,2,1,,3,-70.74025300000001,7.088728999999999
55660,2018,Agosto,España,3,5,,8,-73.181317,7.1280470000000005
55661,2018,Agosto,España,27,42,,69,-72.453013,7.819
55662,2018,Agosto,España,10,8,,18,-72.409396,8.36068
55663,2018,Agosto,España,2,4,,6,-77.35002,8.63337
55664,2018,Agosto,Eslovaquia,2,2,,4,-69.941498,4.191162
55665,2018,Agosto,Eslovaquia,1,1,,2,-77.35600000000001,0.81488
55666,2018,Agosto,Eslovaquia,3,3,,6,-75.516486,10.446304
55667,2018,Agosto,Eslovaquia,1,2,,3,-76.532004,3.451668
55668,2018,Agosto,Eslovaquia,28,26,,54,-74.140516,4.697157
55669,2018,Agosto,Eslovaquia,4,14,,18,-75.42726,6.170465
55670,2018,Agosto,Eslovenia,1,1,,2,-77.35600000000001,0.81488
55671,2018,Agosto,Eslovenia,0,2,,2,-76.532004,3.451668
55672,2018,Agosto,Eslovenia,20,32,,52,-74.140516,4.697157
55673,2018,Agosto,Eslovenia,1,1,,2,-75.42726,6.170465
55674,2018,Agosto,Estados Unidos de América,16,46,,62,-69.941498,4.191162
55675,2018,Agosto,Estados Unidos de América,1,2,,3,-69.94143100000001,4.214082
55676,2018,Agosto,Estados Unidos de América,0,1,,1,-74.78366,0.18595699999999998
55677,2018,Agosto,Estados Unidos de América,1,4,,5,-76.876446,0.33002
55678,2018,Agosto,Estados Unidos de América,58,70,,128,-77.35600000000001,0.81488
55679,2018,Agosto,Estados Unidos de América,36,59,,95,-75.527794,10.406342
55680,2018,Agosto,Estados Unidos de América,5653,6953,,12606,-75.516486,10.446304
55681,2018,Agosto,Estados Unidos de América,696,1121,,1817,-74.77647900000001,10.886686
55682,2018,Agosto,Estados Unidos de América,6,5,,11,-74.232675,11.117206
55683,2018,Agosto,Estados Unidos de América,8,33,,41,-74.213989,11.247722999999999
55684,2018,Agosto,Estados Unidos de América,1,7,,8,-72.129595,11.360028999999999
55685,2018,Agosto,Estados Unidos de América,2,4,,6,-81.703935,12.574411099999999
55686,2018,Agosto,Estados Unidos de América,36,57,,93,-81.70216500000001,12.5862
55687,2018,Agosto,Estados Unidos de América,1,4,,5,-81.372937,13.338761300000002
55688,2018,Agosto,Estados Unidos de América,1271,1693,,2964,-76.532004,3.451668
55689,2018,Agosto,Estados Unidos de América,191,281,,472,-75.76635300000001,4.45285
55690,2018,Agosto,Estados Unidos de América,10728,17331,,28059,-74.140516,4.697157
55691,2018,Agosto,Estados Unidos de América,211,313,,524,-75.736374,4.815189
55692,2018,Agosto,Estados Unidos de América,3628,8104,,11732,-75.42726,6.170465
55693,2018,Agosto,Estados Unidos de América,1,1,,2,-67.48402800000001,6.185536
55694,2018,Agosto,Estados Unidos de América,0,2,,2,-77.401154,6.222551999999999
55695,2018,Agosto,Estados Unidos de América,49,89,,138,-73.181317,7.1280470000000005
55696,2018,Agosto,Estados Unidos de América,21,12,,33,-72.453013,7.819
55697,2018,Agosto,Estados Unidos de América,0,1,,1,-76.7333,8.06667
55698,2018,Agosto,Estados Unidos de América,3,3,,6,-72.409396,8.36068
55699,2018,Agosto,Estados Unidos de América,7,11,,18,-77.35002,8.63337
55700,2018,Agosto,Estonia,1,1,,2,-76.532004,3.451668
55701,2018,Agosto,Estonia,1,6,,7,-74.140516,4.697157
55702,2018,Agosto,Estonia,2,4,,6,-75.42726,6.170465
55703,2018,Agosto,Estonia,1,0,,1,-77.35002,8.63337
55704,2018,Agosto,Etiopia,3,13,,16,-74.140516,4.697157
55705,2018,Agosto,Filipinas,0,42,,42,-75.527794,10.406342
55706,2018,Agosto,Filipinas,9,49,,58,-75.516486,10.446304
55707,2018,Agosto,Filipinas,0,9,,9,-74.77647900000001,10.886686
55708,2018,Agosto,Filipinas,0,21,,21,-74.765343,10.970933
55709,2018,Agosto,Filipinas,0,4,,4,-74.213989,11.247722999999999
55710,2018,Agosto,Filipinas,6,9,,15,-76.532004,3.451668
55711,2018,Agosto,Filipinas,0,30,,30,-77.061029,3.8844260000000004
55712,2018,Agosto,Filipinas,51,48,,99,-74.140516,4.697157
55713,2018,Agosto,Filipinas,5,5,,10,-75.42726,6.170465
55714,2018,Agosto,Filipinas,1,0,,1,-72.409396,8.36068
55715,2018,Agosto,Filipinas,0,1,,1,-75.68164200000001,9.402597
55716,2018,Agosto,Finlandia,2,0,,2,-69.94143100000001,4.214082
55717,2018,Agosto,Finlandia,2,3,,5,-77.35600000000001,0.81488
55718,2018,Agosto,Finlandia,5,6,,11,-75.516486,10.446304
55719,2018,Agosto,Finlandia,1,0,,1,-74.77647900000001,10.886686
55720,2018,Agosto,Finlandia,6,1,,7,-76.532004,3.451668
55721,2018,Agosto,Finlandia,33,48,,81,-74.140516,4.697157
55722,2018,Agosto,Finlandia,2,9,,11,-75.42726,6.170465
55723,2018,Agosto,Francia,14,18,,32,-69.941498,4.191162
55724,2018,Agosto,Francia,11,9,,20,-69.94143100000001,4.214082
55725,2018,Agosto,Francia,4,4,,8,-76.876446,0.33002
55726,2018,Agosto,Francia,99,134,,233,-77.35600000000001,0.81488
55727,2018,Agosto,Francia,16,20,,36,-75.527794,10.406342
55728,2018,Agosto,Francia,195,273,,468,-75.516486,10.446304
55729,2018,Agosto,Francia,23,30,,53,-74.77647900000001,10.886686
55730,2018,Agosto,Francia,1,1,,2,-74.213989,11.247722999999999
55731,2018,Agosto,Francia,3,4,,7,-72.129595,11.360028999999999
55732,2018,Agosto,Francia,1,1,,2,-81.703935,12.574411099999999
55733,2018,Agosto,Francia,3,5,,8,-81.70216500000001,12.5862
55734,2018,Agosto,Francia,2,4,,6,-81.372937,13.338761300000002
55735,2018,Agosto,Francia,92,130,,222,-76.532004,3.451668
55736,2018,Agosto,Francia,0,5,,5,-75.76635300000001,4.45285
55737,2018,Agosto,Francia,2931,3908,,6839,-74.140516,4.697157
55738,2018,Agosto,Francia,18,17,,35,-75.736374,4.815189
55739,2018,Agosto,Francia,212,334,,546,-75.42726,6.170465
55740,2018,Agosto,Francia,2,3,,5,-73.181317,7.1280470000000005
55741,2018,Agosto,Francia,0,9,,9,-72.453013,7.819
55742,2018,Agosto,Francia,2,1,,3,-72.409396,8.36068
55743,2018,Agosto,Francia,4,11,,15,-77.35002,8.63337
55744,2018,Agosto,Georgia,8,5,,13,-74.140516,4.697157
55745,2018,Agosto,Ghana,0,3,,3,-77.35600000000001,0.81488
55746,2018,Agosto,Ghana,0,1,,1,-72.129595,11.360028999999999
55747,2018,Agosto,Ghana,2,3,,5,-74.140516,4.697157
55748,2018,Agosto,Ghana,0,1,,1,-72.453013,7.819
55749,2018,Agosto,Granada,1,1,,2,-81.70216500000001,12.5862
55750,2018,Agosto,Granada,2,4,,6,-74.140516,4.697157
55751,2018,Agosto,Grecia,0,1,,1,-69.941498,4.191162
55752,2018,Agosto,Grecia,14,11,,25,-77.35600000000001,0.81488
55753,2018,Agosto,Grecia,1,3,,4,-75.527794,10.406342
55754,2018,Agosto,Grecia,5,11,,16,-75.516486,10.446304
55755,2018,Agosto,Grecia,0,1,,1,-74.77647900000001,10.886686
55756,2018,Agosto,Grecia,1,4,,5,-76.532004,3.451668
55757,2018,Agosto,Grecia,75,91,,166,-74.140516,4.697157
55758,2018,Agosto,Grecia,3,6,,9,-75.42726,6.170465
55759,2018,Agosto,Grecia,0,1,,1,-72.409396,8.36068
55760,2018,Agosto,Grecia,0,2,,2,-75.68164200000001,9.402597
55761,2018,Agosto,Guatemala,0,6,,6,-77.35600000000001,0.81488
55762,2018,Agosto,Guatemala,0,1,,1,-78.802679,18.00143
55763,2018,Agosto,Guatemala,1,2,,3,-75.527794,10.406342
55764,2018,Agosto,Guatemala,102,103,,205,-75.516486,10.446304
55765,2018,Agosto,Guatemala,9,21,,30,-74.77647900000001,10.886686
55766,2018,Agosto,Guatemala,5,1,,6,-72.129595,11.360028999999999
55767,2018,Agosto,Guatemala,2,0,,2,-81.70216500000001,12.5862
55768,2018,Agosto,Guatemala,1,0,,1,-81.372937,13.338761300000002
55769,2018,Agosto,Guatemala,18,63,,81,-76.532004,3.451668
55770,2018,Agosto,Guatemala,418,762,,1180,-74.140516,4.697157
55771,2018,Agosto,Guatemala,1,9,,10,-75.736374,4.815189
55772,2018,Agosto,Guatemala,106,210,,316,-75.42726,6.170465
55773,2018,Agosto,Guatemala,2,1,,3,-73.181317,7.1280470000000005
55774,2018,Agosto,Guatemala,0,4,,4,-72.453013,7.819
55775,2018,Agosto,Guatemala,2,0,,2,-72.409396,8.36068
55776,2018,Agosto,Guatemala,0,1,,1,-77.35002,8.63337
55777,2018,Agosto,Guyana,0,2,,2,-75.527794,10.406342
55778,2018,Agosto,Guyana,4,0,,4,-75.516486,10.446304
55779,2018,Agosto,Guyana,0,1,,1,-74.77647900000001,10.886686
55780,2018,Agosto,Guyana,1,0,,1,-76.532004,3.451668
55781,2018,Agosto,Guyana,11,18,,29,-74.140516,4.697157
55782,2018,Agosto,Guyana,0,1,,1,-75.736374,4.815189
55783,2018,Agosto,Guyana,0,32,,32,-75.42726,6.170465
55784,2018,Agosto,Guyana,0,1,,1,-70.74025300000001,7.088728999999999
55785,2018,Agosto,Guyana,0,1,,1,-72.453013,7.819
55786,2018,Agosto,Guinea Ecuatorial,0,1,,1,-74.140516,4.697157
55787,2018,Agosto,Guinea Bissau,1,0,,1,-77.35600000000001,0.81488
55788,2018,Agosto,Haití,0,1,,1,-77.35600000000001,0.81488
55789,2018,Agosto,Haití,4,4,,8,-75.516486,10.446304
55790,2018,Agosto,Haití,1,0,,1,-74.77647900000001,10.886686
55791,2018,Agosto,Haití,8,14,,22,-74.140516,4.697157
55792,2018,Agosto,Haití,1,2,,3,-75.42726,6.170465
55793,2018,Agosto,Honduras,1,3,,4,-77.35600000000001,0.81488
55794,2018,Agosto,Honduras,1,11,,12,-75.527794,10.406342
55795,2018,Agosto,Honduras,43,36,,79,-75.516486,10.446304
55796,2018,Agosto,Honduras,7,10,,17,-74.77647900000001,10.886686
55797,2018,Agosto,Honduras,0,1,,1,-72.129595,11.360028999999999
55798,2018,Agosto,Honduras,0,11,,11,-81.703935,12.574411099999999
55799,2018,Agosto,Honduras,0,2,,2,-81.70216500000001,12.5862
55800,2018,Agosto,Honduras,50,40,,90,-76.532004,3.451668
55801,2018,Agosto,Honduras,331,290,,621,-74.140516,4.697157
55802,2018,Agosto,Honduras,3,4,,7,-75.736374,4.815189
55803,2018,Agosto,Honduras,84,102,,186,-75.42726,6.170465
55804,2018,Agosto,Honduras,0,1,,1,-70.74025300000001,7.088728999999999
55805,2018,Agosto,Honduras,0,1,,1,-73.181317,7.1280470000000005
55806,2018,Agosto,Honduras,11,7,,18,-72.409396,8.36068
55807,2018,Agosto,Hong Kong,2,1,,3,-77.35600000000001,0.81488
55808,2018,Agosto,Hong Kong,8,10,,18,-74.140516,4.697157
55809,2018,Agosto,Hong Kong,1,0,,1,-75.42726,6.170465
55810,2018,Agosto,Hong Kong,1,0,,1,-72.453013,7.819
55811,2018,Agosto,Hungría,0,1,,1,-76.876446,0.33002
55812,2018,Agosto,Hungría,1,1,,2,-77.35600000000001,0.81488
55813,2018,Agosto,Hungría,5,4,,9,-75.516486,10.446304
55814,2018,Agosto,Hungría,0,4,,4,-76.532004,3.451668
55815,2018,Agosto,Hungría,25,43,,68,-74.140516,4.697157
55816,2018,Agosto,Hungría,4,7,,11,-75.42726,6.170465
55817,2018,Agosto,India,0,1,,1,-69.941498,4.191162
55818,2018,Agosto,India,0,1,,1,-77.35600000000001,0.81488
55819,2018,Agosto,India,0,4,,4,-75.527794,10.406342
55820,2018,Agosto,India,12,51,,63,-75.516486,10.446304
55821,2018,Agosto,India,2,28,,30,-74.77647900000001,10.886686
55822,2018,Agosto,India,0,4,,4,-74.765343,10.970933
55823,2018,Agosto,India,0,1,,1,-74.213989,11.247722999999999
55824,2018,Agosto,India,5,22,,27,-76.532004,3.451668
55825,2018,Agosto,India,0,1,,1,-77.061029,3.8844260000000004
55826,2018,Agosto,India,0,1,,1,-75.76635300000001,4.45285
55827,2018,Agosto,India,112,490,,602,-74.140516,4.697157
55828,2018,Agosto,India,1,2,,3,-75.736374,4.815189
55829,2018,Agosto,India,14,59,,73,-75.42726,6.170465
55830,2018,Agosto,Indonesia,0,1,,1,-75.527794,10.406342
55831,2018,Agosto,Indonesia,1,0,,1,-75.516486,10.446304
55832,2018,Agosto,Indonesia,0,1,,1,-72.129595,11.360028999999999
55833,2018,Agosto,Indonesia,1,1,,2,-76.532004,3.451668
55834,2018,Agosto,Indonesia,17,30,,47,-74.140516,4.697157
55835,2018,Agosto,Indonesia,1,1,,2,-75.42726,6.170465
55836,2018,Agosto,Iraq,0,1,,1,-75.516486,10.446304
55837,2018,Agosto,Iraq,1,4,,5,-74.140516,4.697157
55838,2018,Agosto,Iraq,0,1,,1,-75.42726,6.170465
55839,2018,Agosto,Irán,3,1,,4,-75.516486,10.446304
55840,2018,Agosto,Irán,11,9,,20,-74.140516,4.697157
55841,2018,Agosto,Irán,2,2,,4,-75.42726,6.170465
55842,2018,Agosto,República de Irlanda,0,1,,1,-69.941498,4.191162
55843,2018,Agosto,República de Irlanda,10,14,,24,-77.35600000000001,0.81488
55844,2018,Agosto,República de Irlanda,7,4,,11,-75.527794,10.406342
55845,2018,Agosto,República de Irlanda,25,30,,55,-75.516486,10.446304
55846,2018,Agosto,República de Irlanda,2,0,,2,-74.77647900000001,10.886686
55847,2018,Agosto,República de Irlanda,3,6,,9,-76.532004,3.451668
55848,2018,Agosto,República de Irlanda,0,1,,1,-75.76635300000001,4.45285
55849,2018,Agosto,República de Irlanda,168,235,,403,-74.140516,4.697157
55850,2018,Agosto,República de Irlanda,0,1,,1,-75.736374,4.815189
55851,2018,Agosto,República de Irlanda,21,55,,76,-75.42726,6.170465
55852,2018,Agosto,República de Irlanda,10,6,,16,-77.35002,8.63337
55853,2018,Agosto,Islandia,0,1,,1,-77.35600000000001,0.81488
55854,2018,Agosto,Islandia,5,8,,13,-75.516486,10.446304
55855,2018,Agosto,Islandia,0,1,,1,-74.77647900000001,10.886686
55856,2018,Agosto,Islandia,5,10,,15,-74.140516,4.697157
55857,2018,Agosto,Islandia,0,1,,1,-75.42726,6.170465
55858,2018,Agosto,Israel,1,3,,4,-69.941498,4.191162
55859,2018,Agosto,Israel,13,43,,56,-77.35600000000001,0.81488
55860,2018,Agosto,Israel,1,2,,3,-75.527794,10.406342
55861,2018,Agosto,Israel,15,53,,68,-75.516486,10.446304
55862,2018,Agosto,Israel,1,7,,8,-74.77647900000001,10.886686
55863,2018,Agosto,Israel,4,4,,8,-81.70216500000001,12.5862
55864,2018,Agosto,Israel,3,9,,12,-76.532004,3.451668
55865,2018,Agosto,Israel,205,472,,677,-74.140516,4.697157
55866,2018,Agosto,Israel,0,1,,1,-75.736374,4.815189
55867,2018,Agosto,Israel,22,56,,78,-75.42726,6.170465
55868,2018,Agosto,Israel,0,1,,1,-77.35002,8.63337
55869,2018,Agosto,Italia,8,10,,18,-69.941498,4.191162
55870,2018,Agosto,Italia,1,2,,3,-69.94143100000001,4.214082
55871,2018,Agosto,Italia,3,5,,8,-76.876446,0.33002
55872,2018,Agosto,Italia,1,0,,1,-77.84700600000001,0.8124359999999999
55873,2018,Agosto,Italia,19,26,,45,-77.35600000000001,0.81488
55874,2018,Agosto,Italia,9,19,,28,-75.527794,10.406342
55875,2018,Agosto,Italia,158,365,,523,-75.516486,10.446304
55876,2018,Agosto,Italia,21,35,,56,-74.77647900000001,10.886686
55877,2018,Agosto,Italia,0,2,,2,-74.232675,11.117206
55878,2018,Agosto,Italia,2,13,,15,-72.129595,11.360028999999999
55879,2018,Agosto,Italia,0,2,,2,-81.703935,12.574411099999999
55880,2018,Agosto,Italia,10,13,,23,-81.70216500000001,12.5862
55881,2018,Agosto,Italia,53,139,,192,-76.532004,3.451668
55882,2018,Agosto,Italia,2,3,,5,-75.76635300000001,4.45285
55883,2018,Agosto,Italia,1709,2632,,4341,-74.140516,4.697157
55884,2018,Agosto,Italia,2,3,,5,-75.736374,4.815189
55885,2018,Agosto,Italia,103,305,,408,-75.42726,6.170465
55886,2018,Agosto,Italia,2,3,,5,-73.181317,7.1280470000000005
55887,2018,Agosto,Italia,10,17,,27,-72.453013,7.819
55888,2018,Agosto,Italia,2,7,,9,-72.409396,8.36068
55889,2018,Agosto,Italia,2,3,,5,-77.35002,8.63337
55890,2018,Agosto,Jamaica,0,3,,3,-75.527794,10.406342
55891,2018,Agosto,Jamaica,5,14,,19,-75.516486,10.446304
55892,2018,Agosto,Jamaica,1,1,,2,-74.77647900000001,10.886686
55893,2018,Agosto,Jamaica,5,3,,8,-76.532004,3.451668
55894,2018,Agosto,Jamaica,36,46,,82,-74.140516,4.697157
55895,2018,Agosto,Jamaica,1,0,,1,-75.736374,4.815189
55896,2018,Agosto,Jamaica,2,9,,11,-75.42726,6.170465
55897,2018,Agosto,Jamaica,0,1,,1,-73.181317,7.1280470000000005
55898,2018,Agosto,Japón,0,1,,1,-69.94143100000001,4.214082
55899,2018,Agosto,Japón,6,12,,18,-77.35600000000001,0.81488
55900,2018,Agosto,Japón,0,2,,2,-75.527794,10.406342
55901,2018,Agosto,Japón,7,29,,36,-75.516486,10.446304
55902,2018,Agosto,Japón,1,7,,8,-74.77647900000001,10.886686
55903,2018,Agosto,Japón,0,4,,4,-74.232675,11.117206
55904,2018,Agosto,Japón,0,2,,2,-72.129595,11.360028999999999
55905,2018,Agosto,Japón,0,4,,4,-81.70216500000001,12.5862
55906,2018,Agosto,Japón,8,16,,24,-76.532004,3.451668
55907,2018,Agosto,Japón,205,499,,704,-74.140516,4.697157
55908,2018,Agosto,Japón,35,30,,65,-75.42726,6.170465
55909,2018,Agosto,Japón,0,1,,1,-72.453013,7.819
55910,2018,Agosto,Japón,1,0,,1,-77.35002,8.63337
55911,2018,Agosto,Jordania,1,0,,1,-75.516486,10.446304
55912,2018,Agosto,Jordania,5,8,,13,-74.140516,4.697157
55913,2018,Agosto,Jordania,0,1,,1,-73.181317,7.1280470000000005
55914,2018,Agosto,Kazajistán,1,1,,2,-75.516486,10.446304
55915,2018,Agosto,Kazajistán,10,4,,14,-74.140516,4.697157
55916,2018,Agosto,Kenia,1,0,,1,-74.77647900000001,10.886686
55917,2018,Agosto,Kenia,5,3,,8,-76.532004,3.451668
55918,2018,Agosto,Kenia,3,5,,8,-74.140516,4.697157
55919,2018,Agosto,Kenia,3,1,,4,-75.42726,6.170465
55920,2018,Agosto,Kuwait,0,1,,1,-77.35600000000001,0.81488
55921,2018,Agosto,Kuwait,0,3,,3,-74.140516,4.697157
55922,2018,Agosto,Kuwait,1,1,,2,-75.42726,6.170465
55923,2018,Agosto,República de Kosovo,0,1,,1,-75.527794,10.406342
55924,2018,Agosto,República de Kosovo,1,1,,2,-74.140516,4.697157
55925,2018,Agosto,Lesoto,0,1,,1,-74.140516,4.697157
55926,2018,Agosto,Letonia,0,4,,4,-75.527794,10.406342
55927,2018,Agosto,Letonia,0,2,,2,-76.532004,3.451668
55928,2018,Agosto,Letonia,9,5,,14,-74.140516,4.697157
55929,2018,Agosto,Letonia,1,5,,6,-75.42726,6.170465
55930,2018,Agosto,Lituania,1,0,,1,-75.527794,10.406342
55931,2018,Agosto,Lituania,0,4,,4,-75.516486,10.446304
55932,2018,Agosto,Lituania,0,1,,1,-76.532004,3.451668
55933,2018,Agosto,Lituania,18,10,,28,-74.140516,4.697157
55934,2018,Agosto,Lituania,3,3,,6,-75.42726,6.170465
55935,2018,Agosto,Líbano,1,4,,5,-75.516486,10.446304
55936,2018,Agosto,Líbano,1,3,,4,-74.77647900000001,10.886686
55937,2018,Agosto,Líbano,20,36,,56,-74.140516,4.697157
55938,2018,Agosto,Líbano,0,2,,2,-75.42726,6.170465
55939,2018,Agosto,Líbano,0,1,,1,-73.181317,7.1280470000000005
55940,2018,Agosto,Libia,0,1,,1,-75.516486,10.446304
55941,2018,Agosto,Libia,0,1,,1,-74.140516,4.697157
55942,2018,Agosto,Liechtenstein,2,1,,3,-74.140516,4.697157
55943,2018,Agosto,Luxemburgo,1,0,,1,-69.94143100000001,4.214082
55944,2018,Agosto,Luxemburgo,0,1,,1,-77.35600000000001,0.81488
55945,2018,Agosto,Luxemburgo,2,2,,4,-75.516486,10.446304
55946,2018,Agosto,Luxemburgo,0,1,,1,-74.77647900000001,10.886686
55947,2018,Agosto,Luxemburgo,3,1,,4,-76.532004,3.451668
55948,2018,Agosto,Luxemburgo,13,25,,38,-74.140516,4.697157
55949,2018,Agosto,Luxemburgo,0,3,,3,-75.736374,4.815189
55950,2018,Agosto,Luxemburgo,5,2,,7,-75.42726,6.170465
55951,2018,Agosto,Macedonia,0,1,,1,-69.941498,4.191162
55952,2018,Agosto,Macedonia,0,1,,1,-75.516486,10.446304
55953,2018,Agosto,Macedonia,0,2,,2,-76.532004,3.451668
55954,2018,Agosto,Macedonia,1,2,,3,-74.140516,4.697157
55955,2018,Agosto,Madagascar,1,0,,1,-74.140516,4.697157
55956,2018,Agosto,Madagascar,1,0,,1,-75.42726,6.170465
55957,2018,Agosto,Malasia,2,2,,4,-75.516486,10.446304
55958,2018,Agosto,Malasia,19,25,,44,-74.140516,4.697157
55959,2018,Agosto,Malasia,1,3,,4,-75.42726,6.170465
55960,2018,Agosto,Malawi,0,1,,1,-76.532004,3.451668
55961,2018,Agosto,Malawi,0,1,,1,-74.140516,4.697157
55962,2018,Agosto,Malí,2,0,,2,-74.140516,4.697157
55963,2018,Agosto,Malta,0,1,,1,-75.516486,10.446304
55964,2018,Agosto,Malta,11,14,,25,-74.140516,4.697157
55965,2018,Agosto,Malta,0,1,,1,-75.736374,4.815189
55966,2018,Agosto,Malta,0,1,,1,-75.42726,6.170465
55967,2018,Agosto,Marruecos,0,2,,2,-77.35600000000001,0.81488
55968,2018,Agosto,Marruecos,2,4,,6,-75.516486,10.446304
55969,2018,Agosto,Marruecos,1,0,,1,-74.77647900000001,10.886686
55970,2018,Agosto,Marruecos,12,26,,38,-74.140516,4.697157
55971,2018,Agosto,Marruecos,1,3,,4,-75.42726,6.170465
55972,2018,Agosto,Mauricio,0,1,,1,-75.527794,10.406342
55973,2018,Agosto,Mauricio,3,0,,3,-75.516486,10.446304
55974,2018,Agosto,Mauricio,0,1,,1,-74.140516,4.697157
55975,2018,Agosto,Mauricio,0,1,,1,-75.42726,6.170465
55976,2018,Agosto,México,1,0,,1,-69.941498,4.191162
55977,2018,Agosto,México,8,1,,9,-76.876446,0.33002
55978,2018,Agosto,México,24,32,,56,-77.35600000000001,0.81488
55979,2018,Agosto,México,26,23,,49,-75.527794,10.406342
55980,2018,Agosto,México,217,307,,524,-75.516486,10.446304
55981,2018,Agosto,México,28,64,,92,-74.77647900000001,10.886686
55982,2018,Agosto,México,3,4,,7,-72.129595,11.360028999999999
55983,2018,Agosto,México,2,2,,4,-81.70216500000001,12.5862
55984,2018,Agosto,México,93,165,,258,-76.532004,3.451668
55985,2018,Agosto,México,1,2,,3,-75.76635300000001,4.45285
55986,2018,Agosto,México,4915,7905,,12820,-74.140516,4.697157
55987,2018,Agosto,México,21,37,,58,-75.736374,4.815189
55988,2018,Agosto,México,669,1701,,2370,-75.42726,6.170465
55989,2018,Agosto,México,1,1,,2,-67.48402800000001,6.185536
55990,2018,Agosto,México,0,1,,1,-70.74025300000001,7.088728999999999
55991,2018,Agosto,México,0,1,,1,-77.762647,7.102626
55992,2018,Agosto,México,9,9,,18,-73.181317,7.1280470000000005
55993,2018,Agosto,México,29,40,,69,-72.453013,7.819
55994,2018,Agosto,México,1,6,,7,-72.409396,8.36068
55995,2018,Agosto,República de Moldavia,3,2,,5,-74.140516,4.697157
55996,2018,Agosto,Mónaco,0,1,,1,-75.516486,10.446304
55997,2018,Agosto,Mónaco,1,2,,3,-74.140516,4.697157
55998,2018,Agosto,Mongolia,1,0,,1,-76.532004,3.451668
55999,2018,Agosto,Mongolia,3,0,,3,-74.140516,4.697157
56000,2018,Agosto,Montenegro,0,1,,1,-69.941498,4.191162
56001,2018,Agosto,Montenegro,0,1,,1,-75.527794,10.406342
56002,2018,Agosto,Montenegro,0,1,,1,-75.516486,10.446304
56003,2018,Agosto,Montenegro,0,1,,1,-76.532004,3.451668
56004,2018,Agosto,Montenegro,1,3,,4,-74.140516,4.697157
56005,2018,Agosto,Montenegro,0,1,,1,-75.68164200000001,9.402597
56006,2018,Agosto,Mozambique,1,4,,5,-74.140516,4.697157
56007,2018,Agosto,Myanmar,0,3,,3,-75.527794,10.406342
56008,2018,Agosto,Myanmar,0,3,,3,-75.516486,10.446304
56009,2018,Agosto,Myanmar,0,1,,1,-74.140516,4.697157
56010,2018,Agosto,Namibia,0,2,,2,-75.527794,10.406342
56011,2018,Agosto,Nepal,1,0,,1,-75.516486,10.446304
56012,2018,Agosto,Nepal,5,5,,10,-74.140516,4.697157
56013,2018,Agosto,Nepal,1,0,,1,-75.42726,6.170465
56014,2018,Agosto,Nicaragua,2,0,,2,-77.35600000000001,0.81488
56015,2018,Agosto,Nicaragua,1,2,,3,-75.527794,10.406342
56016,2018,Agosto,Nicaragua,21,16,,37,-75.516486,10.446304
56017,2018,Agosto,Nicaragua,1,5,,6,-74.77647900000001,10.886686
56018,2018,Agosto,Nicaragua,0,1,,1,-72.129595,11.360028999999999
56019,2018,Agosto,Nicaragua,1,1,,2,-81.70216500000001,12.5862
56020,2018,Agosto,Nicaragua,11,13,,24,-76.532004,3.451668
56021,2018,Agosto,Nicaragua,98,96,,194,-74.140516,4.697157
56022,2018,Agosto,Nicaragua,3,4,,7,-75.736374,4.815189
56023,2018,Agosto,Nicaragua,23,35,,58,-75.42726,6.170465
56024,2018,Agosto,Nicaragua,2,1,,3,-73.181317,7.1280470000000005
56025,2018,Agosto,Nigeria,0,1,,1,-77.35600000000001,0.81488
56026,2018,Agosto,Nigeria,1,2,,3,-75.516486,10.446304
56027,2018,Agosto,Nigeria,0,1,,1,-72.129595,11.360028999999999
56028,2018,Agosto,Nigeria,1,0,,1,-76.532004,3.451668
56029,2018,Agosto,Nigeria,4,3,,7,-74.140516,4.697157
56030,2018,Agosto,Noruega,1,0,,1,-76.876446,0.33002
56031,2018,Agosto,Noruega,2,5,,7,-75.527794,10.406342
56032,2018,Agosto,Noruega,9,10,,19,-75.516486,10.446304
56033,2018,Agosto,Noruega,2,0,,2,-74.77647900000001,10.886686
56034,2018,Agosto,Noruega,0,1,,1,-81.70216500000001,12.5862
56035,2018,Agosto,Noruega,2,4,,6,-76.532004,3.451668
56036,2018,Agosto,Noruega,56,114,,170,-74.140516,4.697157
56037,2018,Agosto,Noruega,2,4,,6,-75.736374,4.815189
56038,2018,Agosto,Noruega,5,10,,15,-75.42726,6.170465
56039,2018,Agosto,Noruega,0,1,,1,-73.181317,7.1280470000000005
56040,2018,Agosto,Noruega,2,0,,2,-77.35002,8.63337
56041,2018,Agosto,Nueva Zelanda,2,5,,7,-69.941498,4.191162
56042,2018,Agosto,Nueva Zelanda,2,1,,3,-69.94143100000001,4.214082
56043,2018,Agosto,Nueva Zelanda,11,12,,23,-77.35600000000001,0.81488
56044,2018,Agosto,Nueva Zelanda,8,11,,19,-75.527794,10.406342
56045,2018,Agosto,Nueva Zelanda,8,9,,17,-75.516486,10.446304
56046,2018,Agosto,Nueva Zelanda,4,5,,9,-74.77647900000001,10.886686
56047,2018,Agosto,Nueva Zelanda,1,3,,4,-74.213989,11.247722999999999
56048,2018,Agosto,Nueva Zelanda,79,131,,210,-74.140516,4.697157
56049,2018,Agosto,Nueva Zelanda,9,18,,27,-75.42726,6.170465
56050,2018,Agosto,Nueva Zelanda,0,1,,1,-72.453013,7.819
56051,2018,Agosto,Nueva Zelanda,2,3,,5,-77.35002,8.63337
56052,2018,Agosto,Omán,0,1,,1,-74.140516,4.697157
56053,2018,Agosto,Países Bajos,3,25,,28,-69.941498,4.191162
56054,2018,Agosto,Países Bajos,1,14,,15,-69.94143100000001,4.214082
56055,2018,Agosto,Países Bajos,15,25,,40,-77.35600000000001,0.81488
56056,2018,Agosto,Países Bajos,22,21,,43,-75.527794,10.406342
56057,2018,Agosto,Países Bajos,284,326,,610,-75.516486,10.446304
56058,2018,Agosto,Países Bajos,12,11,,23,-74.77647900000001,10.886686
56059,2018,Agosto,Países Bajos,0,1,,1,-74.213989,11.247722999999999
56060,2018,Agosto,Países Bajos,0,2,,2,-72.129595,11.360028999999999
56061,2018,Agosto,Países Bajos,1,2,,3,-81.70216500000001,12.5862
56062,2018,Agosto,Países Bajos,1,0,,1,-81.372937,13.338761300000002
56063,2018,Agosto,Países Bajos,38,67,,105,-76.532004,3.451668
56064,2018,Agosto,Países Bajos,1,14,,15,-77.061029,3.8844260000000004
56065,2018,Agosto,Países Bajos,1815,2441,,4256,-74.140516,4.697157
56066,2018,Agosto,Países Bajos,1,8,,9,-75.736374,4.815189
56067,2018,Agosto,Países Bajos,139,193,,332,-75.42726,6.170465
56068,2018,Agosto,Países Bajos,14,13,,27,-73.181317,7.1280470000000005
56069,2018,Agosto,Países Bajos,2,4,,6,-72.453013,7.819
56070,2018,Agosto,Países Bajos,1,0,,1,-72.409396,8.36068
56071,2018,Agosto,Países Bajos,7,13,,20,-77.35002,8.63337
56072,2018,Agosto,Pakistán,0,1,,1,-77.35600000000001,0.81488
56073,2018,Agosto,Pakistán,1,2,,3,-75.516486,10.446304
56074,2018,Agosto,Pakistán,6,22,,28,-74.140516,4.697157
56075,2018,Agosto,Pakistán,1,0,,1,-75.42726,6.170465
56076,2018,Agosto,Panamá,2,5,,7,-77.35600000000001,0.81488
56077,2018,Agosto,Panamá,1,30,,31,-75.527794,10.406342
56078,2018,Agosto,Panamá,697,692,,1389,-75.516486,10.446304
56079,2018,Agosto,Panamá,105,129,,234,-74.77647900000001,10.886686
56080,2018,Agosto,Panamá,0,1,,1,-74.765343,10.970933
56081,2018,Agosto,Panamá,0,2,,2,-74.232675,11.117206
56082,2018,Agosto,Panamá,1,0,,1,-72.129595,11.360028999999999
56083,2018,Agosto,Panamá,1,0,,1,-71.983761,12.165168
56084,2018,Agosto,Panamá,0,1,,1,-81.703935,12.574411099999999
56085,2018,Agosto,Panamá,21,38,,59,-81.70216500000001,12.5862
56086,2018,Agosto,Panamá,168,196,,364,-76.532004,3.451668
56087,2018,Agosto,Panamá,47,30,,77,-75.76635300000001,4.45285
56088,2018,Agosto,Panamá,1601,1635,,3236,-74.140516,4.697157
56089,2018,Agosto,Panamá,18,31,,49,-75.736374,4.815189
56090,2018,Agosto,Panamá,1618,1429,,3047,-75.42726,6.170465
56091,2018,Agosto,Panamá,9,9,,18,-77.762647,7.102626
56092,2018,Agosto,Panamá,24,19,,43,-73.181317,7.1280470000000005
56093,2018,Agosto,Panamá,2,2,,4,-72.453013,7.819
56094,2018,Agosto,Panamá,0,2,,2,-76.7333,8.06667
56095,2018,Agosto,Panamá,0,3,,3,-72.409396,8.36068
56096,2018,Agosto,Panamá,1,8,,9,-77.35002,8.63337
56097,2018,Agosto,Paraguay,1,2,,3,-77.35600000000001,0.81488
56098,2018,Agosto,Paraguay,4,0,,4,-75.527794,10.406342
56099,2018,Agosto,Paraguay,99,50,,149,-75.516486,10.446304
56100,2018,Agosto,Paraguay,2,6,,8,-74.77647900000001,10.886686
56101,2018,Agosto,Paraguay,57,41,,98,-81.70216500000001,12.5862
56102,2018,Agosto,Paraguay,18,13,,31,-76.532004,3.451668
56103,2018,Agosto,Paraguay,323,277,,600,-74.140516,4.697157
56104,2018,Agosto,Paraguay,1,0,,1,-75.736374,4.815189
56105,2018,Agosto,Paraguay,31,40,,71,-75.42726,6.170465
56106,2018,Agosto,Paraguay,1,4,,5,-73.181317,7.1280470000000005
56107,2018,Agosto,Paraguay,4,1,,5,-72.453013,7.819
56108,2018,Agosto,Paraguay,0,1,,1,-72.409396,8.36068
56109,2018,Agosto,Perú,43,31,,74,-69.941498,4.191162
56110,2018,Agosto,Perú,24,24,,48,-69.94143100000001,4.214082
56111,2018,Agosto,Perú,5,2,,7,-74.78366,0.18595699999999998
56112,2018,Agosto,Perú,3,15,,18,-76.876446,0.33002
56113,2018,Agosto,Perú,153,352,,505,-77.35600000000001,0.81488
56114,2018,Agosto,Perú,92,69,,161,-75.527794,10.406342
56115,2018,Agosto,Perú,1260,935,,2195,-75.516486,10.446304
56116,2018,Agosto,Perú,11,23,,34,-74.77647900000001,10.886686
56117,2018,Agosto,Perú,8,14,,22,-72.129595,11.360028999999999
56118,2018,Agosto,Perú,237,155,,392,-81.70216500000001,12.5862
56119,2018,Agosto,Perú,191,185,,376,-76.532004,3.451668
56120,2018,Agosto,Perú,0,2,,2,-67.927521,3.866713
56121,2018,Agosto,Perú,0,1,,1,-75.76635300000001,4.45285
56122,2018,Agosto,Perú,4320,4848,,9168,-74.140516,4.697157
56123,2018,Agosto,Perú,6,7,,13,-75.736374,4.815189
56124,2018,Agosto,Perú,702,776,,1478,-75.42726,6.170465
56125,2018,Agosto,Perú,0,1,,1,-67.48402800000001,6.185536
56126,2018,Agosto,Perú,1,2,,3,-70.74025300000001,7.088728999999999
56127,2018,Agosto,Perú,3,3,,6,-73.181317,7.1280470000000005
56128,2018,Agosto,Perú,74,151,,225,-72.453013,7.819
56129,2018,Agosto,Perú,7,17,,24,-72.409396,8.36068
56130,2018,Agosto,Perú,0,3,,3,-77.35002,8.63337
56131,2018,Agosto,Palestina,1,0,,1,-74.77647900000001,10.886686
56132,2018,Agosto,Palestina,3,1,,4,-74.140516,4.697157
56133,2018,Agosto,Polonia,0,1,,1,-69.941498,4.191162
56134,2018,Agosto,Polonia,1,0,,1,-69.94143100000001,4.214082
56135,2018,Agosto,Polonia,5,8,,13,-77.35600000000001,0.81488
56136,2018,Agosto,Polonia,0,7,,7,-75.527794,10.406342
56137,2018,Agosto,Polonia,11,18,,29,-75.516486,10.446304
56138,2018,Agosto,Polonia,0,1,,1,-74.77647900000001,10.886686
56139,2018,Agosto,Polonia,0,1,,1,-72.129595,11.360028999999999
56140,2018,Agosto,Polonia,1,2,,3,-81.70216500000001,12.5862
56141,2018,Agosto,Polonia,6,0,,6,-76.532004,3.451668
56142,2018,Agosto,Polonia,0,1,,1,-77.061029,3.8844260000000004
56143,2018,Agosto,Polonia,155,140,,295,-74.140516,4.697157
56144,2018,Agosto,Polonia,6,15,,21,-75.42726,6.170465
56145,2018,Agosto,Polonia,0,1,,1,-73.181317,7.1280470000000005
56146,2018,Agosto,Portugal,0,1,,1,-69.94143100000001,4.214082
56147,2018,Agosto,Portugal,1,0,,1,-76.876446,0.33002
56148,2018,Agosto,Portugal,15,13,,28,-77.35600000000001,0.81488
56149,2018,Agosto,Portugal,0,1,,1,-75.527794,10.406342
56150,2018,Agosto,Portugal,24,30,,54,-75.516486,10.446304
56151,2018,Agosto,Portugal,7,10,,17,-74.77647900000001,10.886686
56152,2018,Agosto,Portugal,4,5,,9,-72.129595,11.360028999999999
56153,2018,Agosto,Portugal,0,1,,1,-81.70216500000001,12.5862
56154,2018,Agosto,Portugal,8,15,,23,-76.532004,3.451668
56155,2018,Agosto,Portugal,293,480,,773,-74.140516,4.697157
56156,2018,Agosto,Portugal,3,1,,4,-75.736374,4.815189
56157,2018,Agosto,Portugal,20,45,,65,-75.42726,6.170465
56158,2018,Agosto,Portugal,1,0,,1,-73.181317,7.1280470000000005
56159,2018,Agosto,Portugal,12,23,,35,-72.453013,7.819
56160,2018,Agosto,Puerto Rico/Territorio de Estados Unidos,0,1,,1,-74.140516,4.697157
56161,2018,Agosto,Qatar,0,2,,2,-74.140516,4.697157
56162,2018,Agosto,Qatar,0,1,,1,-75.42726,6.170465
56163,2018,Agosto,Reino Unido de Gran Bretaña e Irlanda del Norte,5,10,,15,-69.941498,4.191162
56164,2018,Agosto,Reino Unido de Gran Bretaña e Irlanda del Norte,0,5,,5,-69.94143100000001,4.214082
56165,2018,Agosto,Reino Unido de Gran Bretaña e Irlanda del Norte,2,2,,4,-76.876446,0.33002
56166,2018,Agosto,Reino Unido de Gran Bretaña e Irlanda del Norte,53,77,,130,-77.35600000000001,0.81488
56167,2018,Agosto,Reino Unido de Gran Bretaña e Irlanda del Norte,19,27,,46,-75.527794,10.406342
56168,2018,Agosto,Reino Unido de Gran Bretaña e Irlanda del Norte,113,181,,294,-75.516486,10.446304
56169,2018,Agosto,Reino Unido de Gran Bretaña e Irlanda del Norte,18,30,,48,-74.77647900000001,10.886686
56170,2018,Agosto,Reino Unido de Gran Bretaña e Irlanda del Norte,0,1,,1,-72.129595,11.360028999999999
56171,2018,Agosto,Reino Unido de Gran Bretaña e Irlanda del Norte,1,1,,2,-81.372937,13.338761300000002
56172,2018,Agosto,Reino Unido de Gran Bretaña e Irlanda del Norte,63,67,,130,-76.532004,3.451668
56173,2018,Agosto,Reino Unido de Gran Bretaña e Irlanda del Norte,1,1,,2,-75.76635300000001,4.45285
56174,2018,Agosto,Reino Unido de Gran Bretaña e Irlanda del Norte,1361,2300,,3661,-74.140516,4.697157
56175,2018,Agosto,Reino Unido de Gran Bretaña e Irlanda del Norte,0,8,,8,-75.736374,4.815189
56176,2018,Agosto,Reino Unido de Gran Bretaña e Irlanda del Norte,156,263,,419,-75.42726,6.170465
56177,2018,Agosto,Reino Unido de Gran Bretaña e Irlanda del Norte,0,1,,1,-70.74025300000001,7.088728999999999
56178,2018,Agosto,Reino Unido de Gran Bretaña e Irlanda del Norte,2,7,,9,-72.453013,7.819
56179,2018,Agosto,Reino Unido de Gran Bretaña e Irlanda del Norte,31,17,,48,-77.35002,8.63337
56180,2018,Agosto,República Dominicana,2,0,,2,-69.94143100000001,4.214082
56181,2018,Agosto,República Dominicana,0,1,,1,-76.876446,0.33002
56182,2018,Agosto,República Dominicana,8,16,,24,-77.35600000000001,0.81488
56183,2018,Agosto,República Dominicana,0,1,,1,-75.527794,10.406342
56184,2018,Agosto,República Dominicana,57,86,,143,-75.516486,10.446304
56185,2018,Agosto,República Dominicana,27,52,,79,-74.77647900000001,10.886686
56186,2018,Agosto,República Dominicana,2,7,,9,-72.129595,11.360028999999999
56187,2018,Agosto,República Dominicana,0,1,,1,-71.983761,12.165168
56188,2018,Agosto,República Dominicana,2,5,,7,-81.70216500000001,12.5862
56189,2018,Agosto,República Dominicana,21,47,,68,-76.532004,3.451668
56190,2018,Agosto,República Dominicana,958,1136,,2094,-74.140516,4.697157
56191,2018,Agosto,República Dominicana,5,7,,12,-75.736374,4.815189
56192,2018,Agosto,República Dominicana,102,180,,282,-75.42726,6.170465
56193,2018,Agosto,República Dominicana,2,2,,4,-73.181317,7.1280470000000005
56194,2018,Agosto,República Dominicana,4,5,,9,-72.453013,7.819
56195,2018,Agosto,República Dominicana,1,0,,1,-77.35002,8.63337
56196,2018,Agosto,Rumania,0,1,,1,-69.94143100000001,4.214082
56197,2018,Agosto,Rumania,0,1,,1,-77.35600000000001,0.81488
56198,2018,Agosto,Rumania,1,0,,1,-75.527794,10.406342
56199,2018,Agosto,Rumania,4,7,,11,-75.516486,10.446304
56200,2018,Agosto,Rumania,0,1,,1,-74.213989,11.247722999999999
56201,2018,Agosto,Rumania,7,2,,9,-76.532004,3.451668
56202,2018,Agosto,Rumania,0,2,,2,-77.061029,3.8844260000000004
56203,2018,Agosto,Rumania,54,56,,110,-74.140516,4.697157
56204,2018,Agosto,Rumania,9,5,,14,-75.42726,6.170465
56205,2018,Agosto,Rumania,0,1,,1,-72.453013,7.819
56206,2018,Agosto,Federación de Rusia,0,1,,1,-76.876446,0.33002
56207,2018,Agosto,Federación de Rusia,3,7,,10,-77.35600000000001,0.81488
56208,2018,Agosto,Federación de Rusia,0,14,,14,-75.527794,10.406342
56209,2018,Agosto,Federación de Rusia,14,22,,36,-75.516486,10.446304
56210,2018,Agosto,Federación de Rusia,0,2,,2,-74.77647900000001,10.886686
56211,2018,Agosto,Federación de Rusia,0,1,,1,-74.765343,10.970933
56212,2018,Agosto,Federación de Rusia,0,1,,1,-74.213989,11.247722999999999
56213,2018,Agosto,Federación de Rusia,3,3,,6,-76.532004,3.451668
56214,2018,Agosto,Federación de Rusia,0,1,,1,-77.061029,3.8844260000000004
56215,2018,Agosto,Federación de Rusia,172,169,,341,-74.140516,4.697157
56216,2018,Agosto,Federación de Rusia,13,13,,26,-75.42726,6.170465
56217,2018,Agosto,Federación de Rusia,0,2,,2,-72.453013,7.819
56218,2018,Agosto,Rwanda,0,2,,2,-76.532004,3.451668
56219,2018,Agosto,Rwanda,0,1,,1,-74.140516,4.697157
56220,2018,Agosto,San Cristóbal y Nevis,0,1,,1,-75.527794,10.406342
56221,2018,Agosto,San Cristóbal y Nevis,1,0,,1,-75.516486,10.446304
56222,2018,Agosto,San Cristóbal y Nevis,0,2,,2,-76.532004,3.451668
56223,2018,Agosto,San Cristóbal y Nevis,4,3,,7,-74.140516,4.697157
56224,2018,Agosto,Samoa Occidental,0,1,,1,-74.140516,4.697157
56225,2018,Agosto,San Marino,0,1,,1,-74.140516,4.697157
56226,2018,Agosto,San  Vicente y las Granadinas,1,1,,2,-74.77647900000001,10.886686
56227,2018,Agosto,San  Vicente y las Granadinas,1,1,,2,-74.140516,4.697157
56228,2018,Agosto,Santa Lucia,2,0,,2,-75.516486,10.446304
56229,2018,Agosto,Santa Lucia,0,1,,1,-72.129595,11.360028999999999
56230,2018,Agosto,Santa Lucia,0,1,,1,-76.532004,3.451668
56231,2018,Agosto,Santa Lucia,5,3,,8,-74.140516,4.697157
56232,2018,Agosto,Santa Lucia,3,1,,4,-75.42726,6.170465
56233,2018,Agosto,Santa Sede/Ciudad del Vaticano,0,4,,4,-74.140516,4.697157
56234,2018,Agosto,Senegal,1,1,,2,-74.140516,4.697157
56235,2018,Agosto,Serbia,0,1,,1,-76.876446,0.33002
56236,2018,Agosto,Serbia,0,1,,1,-75.527794,10.406342
56237,2018,Agosto,Serbia,0,2,,2,-75.516486,10.446304
56238,2018,Agosto,Serbia,2,2,,4,-76.532004,3.451668
56239,2018,Agosto,Serbia,9,17,,26,-74.140516,4.697157
56240,2018,Agosto,Serbia,0,2,,2,-75.42726,6.170465
56241,2018,Agosto,Seychelles,0,1,,1,-74.140516,4.697157
56242,2018,Agosto,Singapur,1,0,,1,-75.527794,10.406342
56243,2018,Agosto,Singapur,5,2,,7,-75.516486,10.446304
56244,2018,Agosto,Singapur,0,1,,1,-76.532004,3.451668
56245,2018,Agosto,Singapur,23,30,,53,-74.140516,4.697157
56246,2018,Agosto,Singapur,2,0,,2,-75.42726,6.170465
56247,2018,Agosto,República Árabe Siria,0,1,,1,-75.516486,10.446304
56248,2018,Agosto,República Árabe Siria,3,3,,6,-74.140516,4.697157
56249,2018,Agosto,República Árabe Siria,0,2,,2,-75.42726,6.170465
56250,2018,Agosto,Sri Lanka,1,0,,1,-75.516486,10.446304
56251,2018,Agosto,Sri Lanka,0,1,,1,-74.77647900000001,10.886686
56252,2018,Agosto,Sri Lanka,0,1,,1,-74.765343,10.970933
56253,2018,Agosto,Sri Lanka,1,8,,9,-74.140516,4.697157
56254,2018,Agosto,Sri Lanka,2,2,,4,-75.42726,6.170465
56255,2018,Agosto,Sudáfrica,1,0,,1,-77.35600000000001,0.81488
56256,2018,Agosto,Sudáfrica,1,3,,4,-75.527794,10.406342
56257,2018,Agosto,Sudáfrica,2,3,,5,-75.516486,10.446304
56258,2018,Agosto,Sudáfrica,0,1,,1,-74.77647900000001,10.886686
56259,2018,Agosto,Sudáfrica,1,3,,4,-76.532004,3.451668
56260,2018,Agosto,Sudáfrica,16,52,,68,-74.140516,4.697157
56261,2018,Agosto,Sudáfrica,0,1,,1,-75.42726,6.170465
56262,2018,Agosto,Sudán,0,1,,1,-74.140516,4.697157
56263,2018,Agosto,Suecia,1,0,,1,-76.876446,0.33002
56264,2018,Agosto,Suecia,7,4,,11,-77.35600000000001,0.81488
56265,2018,Agosto,Suecia,1,6,,7,-75.527794,10.406342
56266,2018,Agosto,Suecia,9,12,,21,-75.516486,10.446304
56267,2018,Agosto,Suecia,2,4,,6,-74.77647900000001,10.886686
56268,2018,Agosto,Suecia,1,1,,2,-74.213989,11.247722999999999
56269,2018,Agosto,Suecia,4,6,,10,-76.532004,3.451668
56270,2018,Agosto,Suecia,0,1,,1,-75.76635300000001,4.45285
56271,2018,Agosto,Suecia,130,189,,319,-74.140516,4.697157
56272,2018,Agosto,Suecia,1,3,,4,-75.736374,4.815189
56273,2018,Agosto,Suecia,17,39,,56,-75.42726,6.170465
56274,2018,Agosto,Suecia,0,1,,1,-72.453013,7.819
56275,2018,Agosto,Suecia,0,1,,1,-77.35002,8.63337
56276,2018,Agosto,Suiza,9,13,,22,-69.941498,4.191162
56277,2018,Agosto,Suiza,1,2,,3,-69.94143100000001,4.214082
56278,2018,Agosto,Suiza,1,0,,1,-76.876446,0.33002
56279,2018,Agosto,Suiza,1,1,,2,-77.84700600000001,0.8124359999999999
56280,2018,Agosto,Suiza,18,18,,36,-77.35600000000001,0.81488
56281,2018,Agosto,Suiza,10,15,,25,-75.527794,10.406342
56282,2018,Agosto,Suiza,45,50,,95,-75.516486,10.446304
56283,2018,Agosto,Suiza,1,4,,5,-74.77647900000001,10.886686
56284,2018,Agosto,Suiza,1,1,,2,-72.129595,11.360028999999999
56285,2018,Agosto,Suiza,1,0,,1,-81.703935,12.574411099999999
56286,2018,Agosto,Suiza,0,1,,1,-81.70216500000001,12.5862
56287,2018,Agosto,Suiza,2,1,,3,-81.372937,13.338761300000002
56288,2018,Agosto,Suiza,19,32,,51,-76.532004,3.451668
56289,2018,Agosto,Suiza,482,643,,1125,-74.140516,4.697157
56290,2018,Agosto,Suiza,0,2,,2,-75.736374,4.815189
56291,2018,Agosto,Suiza,41,84,,125,-75.42726,6.170465
56292,2018,Agosto,Suiza,1,1,,2,-77.401154,6.222551999999999
56293,2018,Agosto,Suiza,1,0,,1,-72.453013,7.819
56294,2018,Agosto,Suiza,1,0,,1,-72.409396,8.36068
56295,2018,Agosto,Suiza,5,4,,9,-77.35002,8.63337
56296,2018,Agosto,Surinam,1,2,,3,-75.516486,10.446304
56297,2018,Agosto,Surinam,23,34,,57,-74.140516,4.697157
56298,2018,Agosto,Surinam,1,3,,4,-75.42726,6.170465
56299,2018,Agosto,Surinam,2,1,,3,-73.181317,7.1280470000000005
56300,2018,Agosto,Surinam,0,1,,1,-72.409396,8.36068
56301,2018,Agosto,Suazilandia,0,1,,1,-74.140516,4.697157
56302,2018,Agosto,Taiwán,1,0,,1,-74.140516,4.697157
56303,2018,Agosto,Tailandia,1,0,,1,-75.516486,10.446304
56304,2018,Agosto,Tailandia,1,0,,1,-76.532004,3.451668
56305,2018,Agosto,Tailandia,19,19,,38,-74.140516,4.697157
56306,2018,Agosto,Tailandia,2,3,,5,-75.42726,6.170465
56307,2018,Agosto,Tanzania,1,0,,1,-76.532004,3.451668
56308,2018,Agosto,Tanzania,0,1,,1,-74.140516,4.697157
56309,2018,Agosto,Trinidad y Tobago,13,10,,23,-75.516486,10.446304
56310,2018,Agosto,Trinidad y Tobago,1,0,,1,-72.129595,11.360028999999999
56311,2018,Agosto,Trinidad y Tobago,1,3,,4,-81.70216500000001,12.5862
56312,2018,Agosto,Trinidad y Tobago,5,8,,13,-76.532004,3.451668
56313,2018,Agosto,Trinidad y Tobago,61,88,,149,-74.140516,4.697157
56314,2018,Agosto,Trinidad y Tobago,6,14,,20,-75.42726,6.170465
56315,2018,Agosto,Trinidad y Tobago,3,2,,5,-73.181317,7.1280470000000005
56316,2018,Agosto,Túnez,0,1,,1,-75.527794,10.406342
56317,2018,Agosto,Túnez,5,7,,12,-74.140516,4.697157
56318,2018,Agosto,Turquía,1,1,,2,-69.941498,4.191162
56319,2018,Agosto,Turquía,0,2,,2,-69.94143100000001,4.214082
56320,2018,Agosto,Turquía,2,6,,8,-77.35600000000001,0.81488
56321,2018,Agosto,Turquía,0,2,,2,-75.527794,10.406342
56322,2018,Agosto,Turquía,15,8,,23,-75.516486,10.446304
56323,2018,Agosto,Turquía,1,1,,2,-74.213989,11.247722999999999
56324,2018,Agosto,Turquía,0,1,,1,-76.532004,3.451668
56325,2018,Agosto,Turquía,339,406,,745,-74.140516,4.697157
56326,2018,Agosto,Turquía,12,15,,27,-75.42726,6.170465
56327,2018,Agosto,Turquía,0,1,,1,-72.409396,8.36068
56328,2018,Agosto,Turquía,0,1,,1,-77.35002,8.63337
56329,2018,Agosto,Turkmenistán,1,0,,1,-74.140516,4.697157
56330,2018,Agosto,Ucrania,0,10,,10,-75.527794,10.406342
56331,2018,Agosto,Ucrania,2,10,,12,-75.516486,10.446304
56332,2018,Agosto,Ucrania,0,2,,2,-74.77647900000001,10.886686
56333,2018,Agosto,Ucrania,0,1,,1,-74.213989,11.247722999999999
56334,2018,Agosto,Ucrania,1,0,,1,-81.70216500000001,12.5862
56335,2018,Agosto,Ucrania,4,1,,5,-76.532004,3.451668
56336,2018,Agosto,Ucrania,0,2,,2,-77.061029,3.8844260000000004
56337,2018,Agosto,Ucrania,28,38,,66,-74.140516,4.697157
56338,2018,Agosto,Ucrania,3,0,,3,-75.42726,6.170465
56339,2018,Agosto,Ucrania,1,0,,1,-73.181317,7.1280470000000005
56340,2018,Agosto,Ucrania,0,1,,1,-75.68164200000001,9.402597
56341,2018,Agosto,Uganda,1,0,,1,-76.532004,3.451668
56342,2018,Agosto,Uganda,2,1,,3,-74.140516,4.697157
56343,2018,Agosto,Uganda,3,0,,3,-75.42726,6.170465
56344,2018,Agosto,Uruguay,2,0,,2,-69.941498,4.191162
56345,2018,Agosto,Uruguay,0,3,,3,-69.94143100000001,4.214082
56346,2018,Agosto,Uruguay,2,11,,13,-77.35600000000001,0.81488
56347,2018,Agosto,Uruguay,20,22,,42,-75.527794,10.406342
56348,2018,Agosto,Uruguay,149,111,,260,-75.516486,10.446304
56349,2018,Agosto,Uruguay,5,5,,10,-74.77647900000001,10.886686
56350,2018,Agosto,Uruguay,0,2,,2,-72.129595,11.360028999999999
56351,2018,Agosto,Uruguay,27,29,,56,-81.70216500000001,12.5862
56352,2018,Agosto,Uruguay,4,19,,23,-76.532004,3.451668
56353,2018,Agosto,Uruguay,619,755,,1374,-74.140516,4.697157
56354,2018,Agosto,Uruguay,0,2,,2,-75.736374,4.815189
56355,2018,Agosto,Uruguay,42,53,,95,-75.42726,6.170465
56356,2018,Agosto,Uruguay,0,1,,1,-73.181317,7.1280470000000005
56357,2018,Agosto,Uruguay,3,8,,11,-72.453013,7.819
56358,2018,Agosto,Uruguay,4,3,,7,-72.409396,8.36068
56359,2018,Agosto,Uruguay,0,1,,1,-77.35002,8.63337
56360,2018,Agosto,Venezuela,1,0,,1,-74.140516,4.697157
56361,2018,Agosto,Venezuela,5,8,,13,-69.941498,4.191162
56362,2018,Agosto,Venezuela,0,1,,1,-69.94143100000001,4.214082
56363,2018,Agosto,Venezuela,128,154,,282,-76.876446,0.33002
56364,2018,Agosto,Venezuela,3,3,,6,-77.84700600000001,0.8124359999999999
56365,2018,Agosto,Venezuela,2513,3169,,5682,-77.35600000000001,0.81488
56366,2018,Agosto,Venezuela,5,1,,6,-78.802679,18.00143
56367,2018,Agosto,Venezuela,18,29,,47,-75.527794,10.406342
56368,2018,Agosto,Venezuela,206,227,,433,-75.516486,10.446304
56369,2018,Agosto,Venezuela,136,209,,345,-74.77647900000001,10.886686
56370,2018,Agosto,Venezuela,0,8,,8,-74.232675,11.117206
56371,2018,Agosto,Venezuela,0,1,,1,-74.213989,11.247722999999999
56372,2018,Agosto,Venezuela,10940,9426,,20366,-72.129595,11.360028999999999
56373,2018,Agosto,Venezuela,1,34,,35,-71.983761,12.165168
56374,2018,Agosto,Venezuela,6,4,,10,-81.70216500000001,12.5862
56375,2018,Agosto,Venezuela,111,145,,256,-76.532004,3.451668
56376,2018,Agosto,Venezuela,7,4,,11,-67.927521,3.866713
56377,2018,Agosto,Venezuela,1,5,,6,-75.76635300000001,4.45285
56378,2018,Agosto,Venezuela,6062,6254,,12316,-74.140516,4.697157
56379,2018,Agosto,Venezuela,16,18,,34,-75.736374,4.815189
56380,2018,Agosto,Venezuela,1017,973,,1990,-75.42726,6.170465
56381,2018,Agosto,Venezuela,34,33,,67,-67.48402800000001,6.185536
56382,2018,Agosto,Venezuela,1625,1634,,3259,-70.74025300000001,7.088728999999999
56383,2018,Agosto,Venezuela,9,5,,14,-73.181317,7.1280470000000005
56384,2018,Agosto,Venezuela,38931,35940,,74871,-72.453013,7.819
56385,2018,Agosto,Venezuela,5,8,,13,-72.508188,7.927233
56386,2018,Agosto,Venezuela,4649,3773,,8422,-72.409396,8.36068
56387,2018,Agosto,Vietnam,1,1,,2,-75.516486,10.446304
56388,2018,Agosto,Vietnam,5,1,,6,-76.532004,3.451668
56389,2018,Agosto,Vietnam,6,4,,10,-74.140516,4.697157
56390,2018,Agosto,Vietnam,2,2,,4,-75.42726,6.170465
56391,2018,Agosto,Zambia,0,1,,1,-76.532004,3.451668
56392,2018,Agosto,Zambia,0,1,,1,-74.140516,4.697157
56393,2018,Agosto,Zimbabue,0,1,,1,-75.516486,10.446304
56394,2018,Agosto,Zimbabue,2,3,,5,-74.140516,4.697157
56395,2018,Agosto,Anguila/Territorio Británico de Ultramar,0,1,,1,-74.140516,4.697157
56396,2018,Agosto,Islas Turcas y Caicos/Territorio Británico de Ultramar,0,1,,1,-74.140516,4.697157
56397,2018,Agosto,Refugiado,3,2,,5,-74.77647900000001,10.886686
56398,2018,Agosto,Refugiado,5,6,,11,-74.140516,4.697157
56399,2018,Agosto,Refugiado,0,1,,1,-75.42726,6.170465
56400,2018,Agosto,Desconocido,4,7,,11,-75.516486,10.446304
56401,2018,Agosto,Desconocido,0,2,,2,-76.532004,3.451668
56402,2018,Agosto,Desconocido,73,131,,204,-74.140516,4.697157
56403,2018,Agosto,Desconocido,1,2,,3,-75.42726,6.170465
56404,2018,Agosto,Desconocido,2,0,,2,-70.74025300000001,7.088728999999999
56405,2018,Agosto,Desconocido,1,0,,1,-72.453013,7.819
56406,2018,Septiembre,Albania,1,3,,4,-75.516486,10.446304
56407,2018,Septiembre,Albania,0,1,,1,-76.532004,3.451668
56408,2018,Septiembre,Albania,3,8,,11,-74.140516,4.697157
56409,2018,Septiembre,Albania,0,2,,2,-75.42726,6.170465
56410,2018,Septiembre,Alemania,20,17,,37,-69.941498,4.191162
56411,2018,Septiembre,Alemania,4,3,,7,-69.94143100000001,4.214082
56412,2018,Septiembre,Alemania,1,1,,2,-76.876446,0.33002
56413,2018,Septiembre,Alemania,43,53,,96,-77.35600000000001,0.81488
56414,2018,Septiembre,Alemania,29,36,,65,-75.527794,10.406342
56415,2018,Septiembre,Alemania,134,182,,316,-75.516486,10.446304
56416,2018,Septiembre,Alemania,23,30,,53,-74.77647900000001,10.886686
56417,2018,Septiembre,Alemania,2,2,,4,-74.213989,11.247722999999999
56418,2018,Septiembre,Alemania,0,3,,3,-72.129595,11.360028999999999
56419,2018,Septiembre,Alemania,5,3,,8,-81.70216500000001,12.5862
56420,2018,Septiembre,Alemania,63,84,,147,-76.532004,3.451668
56421,2018,Septiembre,Alemania,1,0,,1,-77.061029,3.8844260000000004
56422,2018,Septiembre,Alemania,1747,2593,,4340,-74.140516,4.697157
56423,2018,Septiembre,Alemania,3,6,,9,-75.736374,4.815189
56424,2018,Septiembre,Alemania,143,274,,417,-75.42726,6.170465
56425,2018,Septiembre,Alemania,0,2,,2,-73.181317,7.1280470000000005
56426,2018,Septiembre,Alemania,2,2,,4,-72.453013,7.819
56427,2018,Septiembre,Alemania,0,1,,1,-72.409396,8.36068
56428,2018,Septiembre,Alemania,10,9,,19,-77.35002,8.63337
56429,2018,Septiembre,Andorra,0,2,,2,-75.516486,10.446304
56430,2018,Septiembre,Andorra,1,8,,9,-74.140516,4.697157
56431,2018,Septiembre,Andorra,0,1,,1,-75.42726,6.170465
56432,2018,Septiembre,Angola,1,0,,1,-74.140516,4.697157
56433,2018,Septiembre,Angola,0,1,,1,-75.42726,6.170465
56434,2018,Septiembre,Antigua y Barbuda,2,1,,3,-75.516486,10.446304
56435,2018,Septiembre,Antigua y Barbuda,2,6,,8,-74.140516,4.697157
56436,2018,Septiembre,Antigua y Barbuda,2,2,,4,-75.42726,6.170465
56437,2018,Septiembre,Arabia Saudita,0,1,,1,-75.516486,10.446304
56438,2018,Septiembre,Arabia Saudita,0,4,,4,-74.140516,4.697157
56439,2018,Septiembre,Arabia Saudita,0,2,,2,-75.42726,6.170465
56440,2018,Septiembre,Argelia,0,1,,1,-75.516486,10.446304
56441,2018,Septiembre,Argelia,4,4,,8,-74.140516,4.697157
56442,2018,Septiembre,Argentina,4,6,,10,-69.941498,4.191162
56443,2018,Septiembre,Argentina,1,7,,8,-69.94143100000001,4.214082
56444,2018,Septiembre,Argentina,10,21,,31,-76.876446,0.33002
56445,2018,Septiembre,Argentina,62,108,,170,-77.35600000000001,0.81488
56446,2018,Septiembre,Argentina,1,0,,1,-78.802679,18.00143
56447,2018,Septiembre,Argentina,390,228,,618,-75.527794,10.406342
56448,2018,Septiembre,Argentina,1587,1377,,2964,-75.516486,10.446304
56449,2018,Septiembre,Argentina,17,49,,66,-74.77647900000001,10.886686
56450,2018,Septiembre,Argentina,5,7,,12,-72.129595,11.360028999999999
56451,2018,Septiembre,Argentina,317,282,,599,-81.70216500000001,12.5862
56452,2018,Septiembre,Argentina,49,85,,134,-76.532004,3.451668
56453,2018,Septiembre,Argentina,0,1,,1,-75.76635300000001,4.45285
56454,2018,Septiembre,Argentina,3118,4528,,7646,-74.140516,4.697157
56455,2018,Septiembre,Argentina,5,11,,16,-75.736374,4.815189
56456,2018,Septiembre,Argentina,175,353,,528,-75.42726,6.170465
56457,2018,Septiembre,Argentina,3,3,,6,-73.181317,7.1280470000000005
56458,2018,Septiembre,Argentina,9,22,,31,-72.453013,7.819
56459,2018,Septiembre,Argentina,5,10,,15,-72.409396,8.36068
56460,2018,Septiembre,República de Armenia,3,1,,4,-74.140516,4.697157
56461,2018,Septiembre,Australia,3,2,,5,-69.941498,4.191162
56462,2018,Septiembre,Australia,3,2,,5,-69.94143100000001,4.214082
56463,2018,Septiembre,Australia,25,24,,49,-77.35600000000001,0.81488
56464,2018,Septiembre,Australia,20,32,,52,-75.527794,10.406342
56465,2018,Septiembre,Australia,56,96,,152,-75.516486,10.446304
56466,2018,Septiembre,Australia,5,15,,20,-74.77647900000001,10.886686
56467,2018,Septiembre,Australia,1,1,,2,-74.213989,11.247722999999999
56468,2018,Septiembre,Australia,0,2,,2,-72.129595,11.360028999999999
56469,2018,Septiembre,Australia,5,22,,27,-76.532004,3.451668
56470,2018,Septiembre,Australia,303,504,,807,-74.140516,4.697157
56471,2018,Septiembre,Australia,0,1,,1,-75.736374,4.815189
56472,2018,Septiembre,Australia,37,101,,138,-75.42726,6.170465
56473,2018,Septiembre,Australia,1,0,,1,-70.74025300000001,7.088728999999999
56474,2018,Septiembre,Australia,1,0,,1,-73.181317,7.1280470000000005
56475,2018,Septiembre,Australia,1,2,,3,-72.453013,7.819
56476,2018,Septiembre,Australia,13,9,,22,-77.35002,8.63337
56477,2018,Septiembre,Austria,1,1,,2,-69.941498,4.191162
56478,2018,Septiembre,Austria,1,4,,5,-69.94143100000001,4.214082
56479,2018,Septiembre,Austria,7,8,,15,-77.35600000000001,0.81488
56480,2018,Septiembre,Austria,2,7,,9,-75.527794,10.406342
56481,2018,Septiembre,Austria,15,20,,35,-75.516486,10.446304
56482,2018,Septiembre,Austria,2,3,,5,-74.77647900000001,10.886686
56483,2018,Septiembre,Austria,0,1,,1,-72.129595,11.360028999999999
56484,2018,Septiembre,Austria,3,8,,11,-76.532004,3.451668
56485,2018,Septiembre,Austria,146,281,,427,-74.140516,4.697157
56486,2018,Septiembre,Austria,13,22,,35,-75.42726,6.170465
56487,2018,Septiembre,Austria,0,1,,1,-73.181317,7.1280470000000005
56488,2018,Septiembre,Austria,0,1,,1,-72.453013,7.819
56489,2018,Septiembre,Austria,1,1,,2,-77.35002,8.63337
56490,2018,Septiembre,Azerbaiyán,2,3,,5,-74.140516,4.697157
56491,2018,Septiembre,Bahamas,0,1,,1,-75.527794,10.406342
56492,2018,Septiembre,Bahamas,6,5,,11,-75.516486,10.446304
56493,2018,Septiembre,Bahamas,0,2,,2,-74.77647900000001,10.886686
56494,2018,Septiembre,Bahamas,0,1,,1,-81.70216500000001,12.5862
56495,2018,Septiembre,Bahamas,2,2,,4,-76.532004,3.451668
56496,2018,Septiembre,Bahamas,0,9,,9,-74.140516,4.697157
56497,2018,Septiembre,Bahamas,2,2,,4,-75.42726,6.170465
56498,2018,Septiembre,Bahréin,0,2,,2,-74.140516,4.697157
56499,2018,Septiembre,Bangladesh,0,1,,1,-75.516486,10.446304
56500,2018,Septiembre,Bangladesh,0,1,,1,-77.061029,3.8844260000000004
56501,2018,Septiembre,Bangladesh,0,2,,2,-74.140516,4.697157
56502,2018,Septiembre,Barbados,2,1,,3,-75.516486,10.446304
56503,2018,Septiembre,Barbados,0,2,,2,-74.77647900000001,10.886686
56504,2018,Septiembre,Barbados,3,4,,7,-76.532004,3.451668
56505,2018,Septiembre,Barbados,6,9,,15,-74.140516,4.697157
56506,2018,Septiembre,Barbados,0,3,,3,-75.42726,6.170465
56507,2018,Septiembre,República de Belarús,1,0,,1,-75.516486,10.446304
56508,2018,Septiembre,República de Belarús,1,0,,1,-76.532004,3.451668
56509,2018,Septiembre,República de Belarús,4,1,,5,-74.140516,4.697157
56510,2018,Septiembre,Bélgica,2,7,,9,-69.941498,4.191162
56511,2018,Septiembre,Bélgica,0,1,,1,-69.94143100000001,4.214082
56512,2018,Septiembre,Bélgica,3,10,,13,-77.35600000000001,0.81488
56513,2018,Septiembre,Bélgica,4,7,,11,-75.527794,10.406342
56514,2018,Septiembre,Bélgica,27,50,,77,-75.516486,10.446304
56515,2018,Septiembre,Bélgica,4,12,,16,-74.77647900000001,10.886686
56516,2018,Septiembre,Bélgica,1,0,,1,-74.213989,11.247722999999999
56517,2018,Septiembre,Bélgica,0,1,,1,-72.129595,11.360028999999999
56518,2018,Septiembre,Bélgica,0,1,,1,-81.70216500000001,12.5862
56519,2018,Septiembre,Bélgica,8,15,,23,-76.532004,3.451668
56520,2018,Septiembre,Bélgica,330,509,,839,-74.140516,4.697157
56521,2018,Septiembre,Bélgica,0,2,,2,-75.736374,4.815189
56522,2018,Septiembre,Bélgica,40,76,,116,-75.42726,6.170465
56523,2018,Septiembre,Bélgica,0,1,,1,-73.181317,7.1280470000000005
56524,2018,Septiembre,Bélgica,0,1,,1,-72.453013,7.819
56525,2018,Septiembre,Belice,2,2,,4,-75.516486,10.446304
56526,2018,Septiembre,Belice,0,1,,1,-72.129595,11.360028999999999
56527,2018,Septiembre,Belice,3,4,,7,-76.532004,3.451668
56528,2018,Septiembre,Belice,17,25,,42,-74.140516,4.697157
56529,2018,Septiembre,Belice,0,3,,3,-75.42726,6.170465
56530,2018,Septiembre,Belice,0,1,,1,-73.181317,7.1280470000000005
56531,2018,Septiembre,Benín,0,1,,1,-74.140516,4.697157
56532,2018,Septiembre,Bermudas/Territorio Británico de Ultramar,1,1,,2,-74.140516,4.697157
56533,2018,Septiembre,Bolivia,1,1,,2,-69.941498,4.191162
56534,2018,Septiembre,Bolivia,0,1,,1,-76.876446,0.33002
56535,2018,Septiembre,Bolivia,9,12,,21,-77.35600000000001,0.81488
56536,2018,Septiembre,Bolivia,40,28,,68,-75.527794,10.406342
56537,2018,Septiembre,Bolivia,233,190,,423,-75.516486,10.446304
56538,2018,Septiembre,Bolivia,3,6,,9,-74.77647900000001,10.886686
56539,2018,Septiembre,Bolivia,25,20,,45,-81.70216500000001,12.5862
56540,2018,Septiembre,Bolivia,17,18,,35,-76.532004,3.451668
56541,2018,Septiembre,Bolivia,554,646,,1200,-74.140516,4.697157
56542,2018,Septiembre,Bolivia,1,0,,1,-75.736374,4.815189
56543,2018,Septiembre,Bolivia,58,66,,124,-75.42726,6.170465
56544,2018,Septiembre,Bolivia,0,1,,1,-73.181317,7.1280470000000005
56545,2018,Septiembre,Bolivia,0,6,,6,-72.453013,7.819
56546,2018,Septiembre,Bosnia y Herzegovina,0,1,,1,-76.532004,3.451668
56547,2018,Septiembre,Bosnia y Herzegovina,2,6,,8,-74.140516,4.697157
56548,2018,Septiembre,Botsuana,0,1,,1,-74.77647900000001,10.886686
56549,2018,Septiembre,Brasil,132,119,,251,-69.941498,4.191162
56550,2018,Septiembre,Brasil,1,0,,1,-69.94143100000001,4.214082
56551,2018,Septiembre,Brasil,1,1,,2,-76.876446,0.33002
56552,2018,Septiembre,Brasil,28,34,,62,-77.35600000000001,0.81488
56553,2018,Septiembre,Brasil,606,450,,1056,-75.527794,10.406342
56554,2018,Septiembre,Brasil,1043,823,,1866,-75.516486,10.446304
56555,2018,Septiembre,Brasil,6,23,,29,-74.77647900000001,10.886686
56556,2018,Septiembre,Brasil,3,2,,5,-72.129595,11.360028999999999
56557,2018,Septiembre,Brasil,252,231,,483,-81.70216500000001,12.5862
56558,2018,Septiembre,Brasil,39,86,,125,-76.532004,3.451668
56559,2018,Septiembre,Brasil,0,3,,3,-67.927521,3.866713
56560,2018,Septiembre,Brasil,5864,7040,,12904,-74.140516,4.697157
56561,2018,Septiembre,Brasil,0,4,,4,-75.736374,4.815189
56562,2018,Septiembre,Brasil,126,216,,342,-75.42726,6.170465
56563,2018,Septiembre,Brasil,2,2,,4,-67.48402800000001,6.185536
56564,2018,Septiembre,Brasil,0,1,,1,-70.74025300000001,7.088728999999999
56565,2018,Septiembre,Brasil,3,4,,7,-73.181317,7.1280470000000005
56566,2018,Septiembre,Brasil,5,3,,8,-72.453013,7.819
56567,2018,Septiembre,Brasil,2,1,,3,-72.409396,8.36068
56568,2018,Septiembre,Brasil,0,1,,1,-77.35002,8.63337
56569,2018,Septiembre,Bulgaria,0,2,,2,-75.527794,10.406342
56570,2018,Septiembre,Bulgaria,3,10,,13,-75.516486,10.446304
56571,2018,Septiembre,Bulgaria,0,1,,1,-76.532004,3.451668
56572,2018,Septiembre,Bulgaria,38,43,,81,-74.140516,4.697157
56573,2018,Septiembre,Bulgaria,3,8,,11,-75.42726,6.170465
56574,2018,Septiembre,Bulgaria,0,2,,2,-75.68164200000001,9.402597
56575,2018,Septiembre,Burkina Faso,1,3,,4,-74.140516,4.697157
56576,2018,Septiembre,Bután,1,1,,2,-74.140516,4.697157
56577,2018,Septiembre,Islas Caimán/Territorio Británico de Ultramar,1,2,,3,-75.516486,10.446304
56578,2018,Septiembre,Islas Caimán/Territorio Británico de Ultramar,0,1,,1,-81.70216500000001,12.5862
56579,2018,Septiembre,Islas Caimán/Territorio Británico de Ultramar,2,2,,4,-74.140516,4.697157
56580,2018,Septiembre,Camboya,0,1,,1,-74.140516,4.697157
56581,2018,Septiembre,Camerún,0,1,,1,-75.516486,10.446304
56582,2018,Septiembre,Camerún,3,3,,6,-74.140516,4.697157
56583,2018,Septiembre,Camerún,1,0,,1,-75.42726,6.170465
56584,2018,Septiembre,Canadá,0,1,,1,-69.941498,4.191162
56585,2018,Septiembre,Canadá,7,8,,15,-77.35600000000001,0.81488
56586,2018,Septiembre,Canadá,9,10,,19,-75.527794,10.406342
56587,2018,Septiembre,Canadá,198,263,,461,-75.516486,10.446304
56588,2018,Septiembre,Canadá,11,32,,43,-74.77647900000001,10.886686
56589,2018,Septiembre,Canadá,0,2,,2,-72.129595,11.360028999999999
56590,2018,Septiembre,Canadá,4,0,,4,-81.70216500000001,12.5862
56591,2018,Septiembre,Canadá,49,59,,108,-76.532004,3.451668
56592,2018,Septiembre,Canadá,1,2,,3,-75.76635300000001,4.45285
56593,2018,Septiembre,Canadá,811,1448,,2259,-74.140516,4.697157
56594,2018,Septiembre,Canadá,18,30,,48,-75.736374,4.815189
56595,2018,Septiembre,Canadá,135,334,,469,-75.42726,6.170465
56596,2018,Septiembre,Canadá,1,5,,6,-73.181317,7.1280470000000005
56597,2018,Septiembre,Canadá,0,1,,1,-77.35002,8.63337
56598,2018,Septiembre,Chad,0,2,,2,-74.140516,4.697157
56599,2018,Septiembre,República Del Congo,0,1,,1,-74.140516,4.697157
56600,2018,Septiembre,República Democrática del Congo,10,1,,11,-74.140516,4.697157
56601,2018,Septiembre,República Democrática del Congo,3,0,,3,-75.42726,6.170465
56602,2018,Septiembre,República de Corea,0,1,,1,-69.941498,4.191162
56603,2018,Septiembre,República de Corea,0,2,,2,-69.94143100000001,4.214082
56604,2018,Septiembre,República de Corea,1,0,,1,-76.876446,0.33002
56605,2018,Septiembre,República de Corea,5,6,,11,-77.35600000000001,0.81488
56606,2018,Septiembre,República de Corea,4,3,,7,-75.516486,10.446304
56607,2018,Septiembre,República de Corea,0,5,,5,-74.77647900000001,10.886686
56608,2018,Septiembre,República de Corea,3,2,,5,-81.70216500000001,12.5862
56609,2018,Septiembre,República de Corea,0,3,,3,-76.532004,3.451668
56610,2018,Septiembre,República de Corea,204,390,,594,-74.140516,4.697157
56611,2018,Septiembre,República de Corea,0,1,,1,-75.736374,4.815189
56612,2018,Septiembre,República de Corea,12,38,,50,-75.42726,6.170465
56613,2018,Septiembre,República de Corea,1,2,,3,-72.409396,8.36068
56614,2018,Septiembre,Costa de Marfil,0,1,,1,-75.516486,10.446304
56615,2018,Septiembre,Costa de Marfil,1,3,,4,-74.140516,4.697157
56616,2018,Septiembre,Costa de Marfil,0,1,,1,-75.736374,4.815189
56617,2018,Septiembre,Costa Rica,0,1,,1,-69.941498,4.191162
56618,2018,Septiembre,Costa Rica,2,2,,4,-77.35600000000001,0.81488
56619,2018,Septiembre,Costa Rica,4,6,,10,-75.527794,10.406342
56620,2018,Septiembre,Costa Rica,98,116,,214,-75.516486,10.446304
56621,2018,Septiembre,Costa Rica,5,13,,18,-74.77647900000001,10.886686
56622,2018,Septiembre,Costa Rica,38,29,,67,-81.70216500000001,12.5862
56623,2018,Septiembre,Costa Rica,41,85,,126,-76.532004,3.451668
56624,2018,Septiembre,Costa Rica,1,1,,2,-75.76635300000001,4.45285
56625,2018,Septiembre,Costa Rica,1376,1678,,3054,-74.140516,4.697157
56626,2018,Septiembre,Costa Rica,5,8,,13,-75.736374,4.815189
56627,2018,Septiembre,Costa Rica,144,220,,364,-75.42726,6.170465
56628,2018,Septiembre,Costa Rica,1,6,,7,-73.181317,7.1280470000000005
56629,2018,Septiembre,Costa Rica,0,2,,2,-72.453013,7.819
56630,2018,Septiembre,Costa Rica,0,1,,1,-72.409396,8.36068
56631,2018,Septiembre,Costa Rica,0,4,,4,-77.35002,8.63337
56632,2018,Septiembre,Croacia,0,1,,1,-77.35600000000001,0.81488
56633,2018,Septiembre,Croacia,0,2,,2,-75.527794,10.406342
56634,2018,Septiembre,Croacia,2,7,,9,-75.516486,10.446304
56635,2018,Septiembre,Croacia,1,1,,2,-72.129595,11.360028999999999
56636,2018,Septiembre,Croacia,0,3,,3,-76.532004,3.451668
56637,2018,Septiembre,Croacia,10,44,,54,-74.140516,4.697157
56638,2018,Septiembre,Croacia,5,10,,15,-75.42726,6.170465
56639,2018,Septiembre,Cuba,0,1,,1,-76.876446,0.33002
56640,2018,Septiembre,Cuba,1,0,,1,-77.35600000000001,0.81488
56641,2018,Septiembre,Cuba,0,2,,2,-75.527794,10.406342
56642,2018,Septiembre,Cuba,8,12,,20,-75.516486,10.446304
56643,2018,Septiembre,Cuba,6,26,,32,-74.77647900000001,10.886686
56644,2018,Septiembre,Cuba,20,48,,68,-76.532004,3.451668
56645,2018,Septiembre,Cuba,186,268,,454,-74.140516,4.697157
56646,2018,Septiembre,Cuba,2,4,,6,-75.736374,4.815189
56647,2018,Septiembre,Cuba,21,39,,60,-75.42726,6.170465
56648,2018,Septiembre,Cuba,1,2,,3,-73.181317,7.1280470000000005
56649,2018,Septiembre,Cuba,0,2,,2,-72.453013,7.819
56650,2018,Septiembre,República Checa,4,11,,15,-77.35600000000001,0.81488
56651,2018,Septiembre,República Checa,0,1,,1,-75.527794,10.406342
56652,2018,Septiembre,República Checa,1,8,,9,-75.516486,10.446304
56653,2018,Septiembre,República Checa,2,2,,4,-76.532004,3.451668
56654,2018,Septiembre,República Checa,108,135,,243,-74.140516,4.697157
56655,2018,Septiembre,República Checa,5,2,,7,-75.42726,6.170465
56656,2018,Septiembre,República Checa,0,1,,1,-77.35002,8.63337
56657,2018,Septiembre,Chile,1,2,,3,-69.941498,4.191162
56658,2018,Septiembre,Chile,2,1,,3,-69.94143100000001,4.214082
56659,2018,Septiembre,Chile,2,2,,4,-76.876446,0.33002
56660,2018,Septiembre,Chile,34,69,,103,-77.35600000000001,0.81488
56661,2018,Septiembre,Chile,0,1,,1,-78.802679,18.00143
56662,2018,Septiembre,Chile,128,95,,223,-75.527794,10.406342
56663,2018,Septiembre,Chile,557,439,,996,-75.516486,10.446304
56664,2018,Septiembre,Chile,30,37,,67,-74.77647900000001,10.886686
56665,2018,Septiembre,Chile,4,3,,7,-72.129595,11.360028999999999
56666,2018,Septiembre,Chile,99,75,,174,-81.70216500000001,12.5862
56667,2018,Septiembre,Chile,33,70,,103,-76.532004,3.451668
56668,2018,Septiembre,Chile,1,1,,2,-75.76635300000001,4.45285
56669,2018,Septiembre,Chile,4566,5417,,9983,-74.140516,4.697157
56670,2018,Septiembre,Chile,0,2,,2,-75.736374,4.815189
56671,2018,Septiembre,Chile,54,166,,220,-75.42726,6.170465
56672,2018,Septiembre,Chile,0,3,,3,-73.181317,7.1280470000000005
56673,2018,Septiembre,Chile,10,24,,34,-72.453013,7.819
56674,2018,Septiembre,Chile,3,4,,7,-72.409396,8.36068
56675,2018,Septiembre,Chile,0,1,,1,-77.35002,8.63337
56676,2018,Septiembre,China,5,3,,8,-77.35600000000001,0.81488
56677,2018,Septiembre,China,6,2,,8,-75.527794,10.406342
56678,2018,Septiembre,China,52,93,,145,-75.516486,10.446304
56679,2018,Septiembre,China,7,16,,23,-74.77647900000001,10.886686
56680,2018,Septiembre,China,0,4,,4,-72.129595,11.360028999999999
56681,2018,Septiembre,China,1,0,,1,-81.70216500000001,12.5862
56682,2018,Septiembre,China,10,20,,30,-76.532004,3.451668
56683,2018,Septiembre,China,1,0,,1,-75.76635300000001,4.45285
56684,2018,Septiembre,China,448,974,,1422,-74.140516,4.697157
56685,2018,Septiembre,China,1,2,,3,-75.736374,4.815189
56686,2018,Septiembre,China,38,60,,98,-75.42726,6.170465
56687,2018,Septiembre,China,3,7,,10,-72.453013,7.819
56688,2018,Septiembre,China,0,1,,1,-72.409396,8.36068
56689,2018,Septiembre,Taiwán,0,1,,1,-77.35600000000001,0.81488
56690,2018,Septiembre,Taiwán,5,3,,8,-75.527794,10.406342
56691,2018,Septiembre,Taiwán,7,11,,18,-75.516486,10.446304
56692,2018,Septiembre,Taiwán,1,1,,2,-74.77647900000001,10.886686
56693,2018,Septiembre,Taiwán,0,1,,1,-76.532004,3.451668
56694,2018,Septiembre,Taiwán,83,108,,191,-74.140516,4.697157
56695,2018,Septiembre,Taiwán,6,11,,17,-75.42726,6.170465
56696,2018,Septiembre,Taiwán,0,2,,2,-72.453013,7.819
56697,2018,Septiembre,Chipre,0,1,,1,-75.516486,10.446304
56698,2018,Septiembre,Chipre,3,10,,13,-74.140516,4.697157
56699,2018,Septiembre,Chipre,0,1,,1,-75.42726,6.170465
56700,2018,Septiembre,Dinamarca,1,1,,2,-77.35600000000001,0.81488
56701,2018,Septiembre,Dinamarca,1,2,,3,-75.527794,10.406342
56702,2018,Septiembre,Dinamarca,11,23,,34,-75.516486,10.446304
56703,2018,Septiembre,Dinamarca,2,2,,4,-74.77647900000001,10.886686
56704,2018,Septiembre,Dinamarca,1,9,,10,-76.532004,3.451668
56705,2018,Septiembre,Dinamarca,0,1,,1,-77.061029,3.8844260000000004
56706,2018,Septiembre,Dinamarca,74,120,,194,-74.140516,4.697157
56707,2018,Septiembre,Dinamarca,0,1,,1,-75.736374,4.815189
56708,2018,Septiembre,Dinamarca,12,21,,33,-75.42726,6.170465
56709,2018,Septiembre,Dinamarca,2,1,,3,-77.35002,8.63337
56710,2018,Septiembre,Dominica,2,2,,4,-75.516486,10.446304
56711,2018,Septiembre,Dominica,2,1,,3,-76.532004,3.451668
56712,2018,Septiembre,Dominica,2,0,,2,-74.140516,4.697157
56713,2018,Septiembre,Dominica,1,2,,3,-75.42726,6.170465
56714,2018,Septiembre,Ecuador,0,1,,1,-69.941498,4.191162
56715,2018,Septiembre,Ecuador,0,10,,10,-69.94143100000001,4.214082
56716,2018,Septiembre,Ecuador,0,2,,2,-74.78366,0.18595699999999998
56717,2018,Septiembre,Ecuador,43,217,,260,-76.876446,0.33002
56718,2018,Septiembre,Ecuador,3,7,,10,-77.84700600000001,0.8124359999999999
56719,2018,Septiembre,Ecuador,1488,2500,,3988,-77.35600000000001,0.81488
56720,2018,Septiembre,Ecuador,21,94,,115,-78.802679,18.00143
56721,2018,Septiembre,Ecuador,30,43,,73,-75.527794,10.406342
56722,2018,Septiembre,Ecuador,217,260,,477,-75.516486,10.446304
56723,2018,Septiembre,Ecuador,86,63,,149,-74.77647900000001,10.886686
56724,2018,Septiembre,Ecuador,10,13,,23,-72.129595,11.360028999999999
56725,2018,Septiembre,Ecuador,19,16,,35,-81.70216500000001,12.5862
56726,2018,Septiembre,Ecuador,572,703,,1275,-76.532004,3.451668
56727,2018,Septiembre,Ecuador,1,1,,2,-75.76635300000001,4.45285
56728,2018,Septiembre,Ecuador,3759,4906,,8665,-74.140516,4.697157
56729,2018,Septiembre,Ecuador,0,1,,1,-75.736374,4.815189
56730,2018,Septiembre,Ecuador,70,100,,170,-75.42726,6.170465
56731,2018,Septiembre,Ecuador,1,1,,2,-70.74025300000001,7.088728999999999
56732,2018,Septiembre,Ecuador,1,1,,2,-73.181317,7.1280470000000005
56733,2018,Septiembre,Ecuador,116,168,,284,-72.453013,7.819
56734,2018,Septiembre,Ecuador,3,10,,13,-72.409396,8.36068
56735,2018,Septiembre,Ecuador,1,0,,1,-77.35002,8.63337
56736,2018,Septiembre,Egipto,6,13,,19,-75.516486,10.446304
56737,2018,Septiembre,Egipto,0,2,,2,-74.77647900000001,10.886686
56738,2018,Septiembre,Egipto,0,2,,2,-76.532004,3.451668
56739,2018,Septiembre,Egipto,8,31,,39,-74.140516,4.697157
56740,2018,Septiembre,Egipto,0,2,,2,-75.42726,6.170465
56741,2018,Septiembre,El Salvador,0,1,,1,-69.941498,4.191162
56742,2018,Septiembre,El Salvador,0,1,,1,-77.35600000000001,0.81488
56743,2018,Septiembre,El Salvador,0,1,,1,-75.527794,10.406342
56744,2018,Septiembre,El Salvador,31,32,,63,-75.516486,10.446304
56745,2018,Septiembre,El Salvador,10,8,,18,-74.77647900000001,10.886686
56746,2018,Septiembre,El Salvador,88,132,,220,-76.532004,3.451668
56747,2018,Septiembre,El Salvador,0,1,,1,-75.76635300000001,4.45285
56748,2018,Septiembre,El Salvador,643,899,,1542,-74.140516,4.697157
56749,2018,Septiembre,El Salvador,2,2,,4,-75.736374,4.815189
56750,2018,Septiembre,El Salvador,114,201,,315,-75.42726,6.170465
56751,2018,Septiembre,El Salvador,1,1,,2,-73.181317,7.1280470000000005
56752,2018,Septiembre,El Salvador,1,1,,2,-72.453013,7.819
56753,2018,Septiembre,El Salvador,0,1,,1,-72.409396,8.36068
56754,2018,Septiembre,El Salvador,0,1,,1,-75.68164200000001,9.402597
56755,2018,Septiembre,Emiratos Árabes,0,15,,15,-74.140516,4.697157
56756,2018,Septiembre,Emiratos Árabes,0,2,,2,-75.42726,6.170465
56757,2018,Septiembre,España,1,3,,4,-69.941498,4.191162
56758,2018,Septiembre,España,4,5,,9,-69.94143100000001,4.214082
56759,2018,Septiembre,España,6,5,,11,-76.876446,0.33002
56760,2018,Septiembre,España,25,26,,51,-77.35600000000001,0.81488
56761,2018,Septiembre,España,21,24,,45,-75.527794,10.406342
56762,2018,Septiembre,España,121,215,,336,-75.516486,10.446304
56763,2018,Septiembre,España,17,63,,80,-74.77647900000001,10.886686
56764,2018,Septiembre,España,0,1,,1,-74.213989,11.247722999999999
56765,2018,Septiembre,España,2,7,,9,-72.129595,11.360028999999999
56766,2018,Septiembre,España,5,6,,11,-81.70216500000001,12.5862
56767,2018,Septiembre,España,215,363,,578,-76.532004,3.451668
56768,2018,Septiembre,España,1,0,,1,-75.76635300000001,4.45285
56769,2018,Septiembre,España,3324,5962,,9286,-74.140516,4.697157
56770,2018,Septiembre,España,7,16,,23,-75.736374,4.815189
56771,2018,Septiembre,España,330,678,,1008,-75.42726,6.170465
56772,2018,Septiembre,España,2,3,,5,-73.181317,7.1280470000000005
56773,2018,Septiembre,España,26,43,,69,-72.453013,7.819
56774,2018,Septiembre,España,2,7,,9,-72.409396,8.36068
56775,2018,Septiembre,España,1,1,,2,-77.35002,8.63337
56776,2018,Septiembre,Eritrea,0,1,,1,-74.140516,4.697157
56777,2018,Septiembre,Eslovaquia,3,1,,4,-77.35600000000001,0.81488
56778,2018,Septiembre,Eslovaquia,0,1,,1,-75.527794,10.406342
56779,2018,Septiembre,Eslovaquia,2,3,,5,-75.516486,10.446304
56780,2018,Septiembre,Eslovaquia,25,53,,78,-74.140516,4.697157
56781,2018,Septiembre,Eslovaquia,2,4,,6,-75.42726,6.170465
56782,2018,Septiembre,Eslovaquia,1,0,,1,-72.453013,7.819
56783,2018,Septiembre,Eslovenia,0,1,,1,-77.35600000000001,0.81488
56784,2018,Septiembre,Eslovenia,1,2,,3,-75.516486,10.446304
56785,2018,Septiembre,Eslovenia,30,28,,58,-74.140516,4.697157
56786,2018,Septiembre,Eslovenia,3,2,,5,-75.42726,6.170465
56787,2018,Septiembre,Estados Unidos de América,15,29,,44,-69.941498,4.191162
56788,2018,Septiembre,Estados Unidos de América,4,9,,13,-69.94143100000001,4.214082
56789,2018,Septiembre,Estados Unidos de América,2,2,,4,-76.876446,0.33002
56790,2018,Septiembre,Estados Unidos de América,23,58,,81,-77.35600000000001,0.81488
56791,2018,Septiembre,Estados Unidos de América,51,74,,125,-75.527794,10.406342
56792,2018,Septiembre,Estados Unidos de América,3809,5568,,9377,-75.516486,10.446304
56793,2018,Septiembre,Estados Unidos de América,398,841,,1239,-74.77647900000001,10.886686
56794,2018,Septiembre,Estados Unidos de América,6,8,,14,-74.213989,11.247722999999999
56795,2018,Septiembre,Estados Unidos de América,1,3,,4,-72.129595,11.360028999999999
56796,2018,Septiembre,Estados Unidos de América,39,41,,80,-81.70216500000001,12.5862
56797,2018,Septiembre,Estados Unidos de América,886,1372,,2258,-76.532004,3.451668
56798,2018,Septiembre,Estados Unidos de América,121,221,,342,-75.76635300000001,4.45285
56799,2018,Septiembre,Estados Unidos de América,7344,13368,,20712,-74.140516,4.697157
56800,2018,Septiembre,Estados Unidos de América,79,148,,227,-75.736374,4.815189
56801,2018,Septiembre,Estados Unidos de América,2158,6321,,8479,-75.42726,6.170465
56802,2018,Septiembre,Estados Unidos de América,0,1,,1,-67.48402800000001,6.185536
56803,2018,Septiembre,Estados Unidos de América,1,0,,1,-70.74025300000001,7.088728999999999
56804,2018,Septiembre,Estados Unidos de América,20,36,,56,-73.181317,7.1280470000000005
56805,2018,Septiembre,Estados Unidos de América,6,14,,20,-72.453013,7.819
56806,2018,Septiembre,Estados Unidos de América,1,7,,8,-72.409396,8.36068
56807,2018,Septiembre,Estados Unidos de América,15,16,,31,-77.35002,8.63337
56808,2018,Septiembre,Estonia,12,9,,21,-74.140516,4.697157
56809,2018,Septiembre,Estonia,2,4,,6,-75.42726,6.170465
56810,2018,Septiembre,Etiopia,0,1,,1,-76.532004,3.451668
56811,2018,Septiembre,Etiopia,2,44,,46,-74.140516,4.697157
56812,2018,Septiembre,Etiopia,2,1,,3,-75.42726,6.170465
56813,2018,Septiembre,Filipinas,2,30,,32,-75.527794,10.406342
56814,2018,Septiembre,Filipinas,2,43,,45,-75.516486,10.446304
56815,2018,Septiembre,Filipinas,0,15,,15,-74.77647900000001,10.886686
56816,2018,Septiembre,Filipinas,0,18,,18,-74.213989,11.247722999999999
56817,2018,Septiembre,Filipinas,2,3,,5,-76.532004,3.451668
56818,2018,Septiembre,Filipinas,0,1,,1,-77.061029,3.8844260000000004
56819,2018,Septiembre,Filipinas,55,71,,126,-74.140516,4.697157
56820,2018,Septiembre,Filipinas,2,0,,2,-75.736374,4.815189
56821,2018,Septiembre,Filipinas,9,8,,17,-75.42726,6.170465
56822,2018,Septiembre,Filipinas,0,5,,5,-75.68164200000001,9.402597
56823,2018,Septiembre,Finlandia,3,3,,6,-77.35600000000001,0.81488
56824,2018,Septiembre,Finlandia,1,0,,1,-75.527794,10.406342
56825,2018,Septiembre,Finlandia,2,5,,7,-75.516486,10.446304
56826,2018,Septiembre,Finlandia,1,3,,4,-76.532004,3.451668
56827,2018,Septiembre,Finlandia,42,57,,99,-74.140516,4.697157
56828,2018,Septiembre,Finlandia,0,13,,13,-75.42726,6.170465
56829,2018,Septiembre,Francia,5,19,,24,-69.941498,4.191162
56830,2018,Septiembre,Francia,5,6,,11,-69.94143100000001,4.214082
56831,2018,Septiembre,Francia,1,3,,4,-76.876446,0.33002
56832,2018,Septiembre,Francia,51,78,,129,-77.35600000000001,0.81488
56833,2018,Septiembre,Francia,5,14,,19,-75.527794,10.406342
56834,2018,Septiembre,Francia,105,183,,288,-75.516486,10.446304
56835,2018,Septiembre,Francia,19,23,,42,-74.77647900000001,10.886686
56836,2018,Septiembre,Francia,0,1,,1,-74.213989,11.247722999999999
56837,2018,Septiembre,Francia,1,3,,4,-72.129595,11.360028999999999
56838,2018,Septiembre,Francia,1,1,,2,-81.70216500000001,12.5862
56839,2018,Septiembre,Francia,1,1,,2,-81.372937,13.338761300000002
56840,2018,Septiembre,Francia,49,79,,128,-76.532004,3.451668
56841,2018,Septiembre,Francia,1,0,,1,-75.76635300000001,4.45285
56842,2018,Septiembre,Francia,1529,2442,,3971,-74.140516,4.697157
56843,2018,Septiembre,Francia,6,9,,15,-75.736374,4.815189
56844,2018,Septiembre,Francia,143,315,,458,-75.42726,6.170465
56845,2018,Septiembre,Francia,1,0,,1,-67.48402800000001,6.185536
56846,2018,Septiembre,Francia,0,1,,1,-70.74025300000001,7.088728999999999
56847,2018,Septiembre,Francia,1,3,,4,-73.181317,7.1280470000000005
56848,2018,Septiembre,Francia,1,7,,8,-72.453013,7.819
56849,2018,Septiembre,Francia,0,1,,1,-72.409396,8.36068
56850,2018,Septiembre,Francia,1,4,,5,-77.35002,8.63337
56851,2018,Septiembre,Gambia,0,1,,1,-74.140516,4.697157
56852,2018,Septiembre,Georgia,0,4,,4,-75.516486,10.446304
56853,2018,Septiembre,Georgia,0,2,,2,-74.213989,11.247722999999999
56854,2018,Septiembre,Georgia,2,5,,7,-74.140516,4.697157
56855,2018,Septiembre,Georgia,0,7,,7,-75.68164200000001,9.402597
56856,2018,Septiembre,Ghana,0,1,,1,-75.516486,10.446304
56857,2018,Septiembre,Ghana,2,3,,5,-74.140516,4.697157
56858,2018,Septiembre,Granada,1,2,,3,-75.516486,10.446304
56859,2018,Septiembre,Granada,0,1,,1,-72.129595,11.360028999999999
56860,2018,Septiembre,Granada,0,2,,2,-74.140516,4.697157
56861,2018,Septiembre,Grecia,0,1,,1,-77.35600000000001,0.81488
56862,2018,Septiembre,Grecia,0,2,,2,-75.527794,10.406342
56863,2018,Septiembre,Grecia,3,4,,7,-75.516486,10.446304
56864,2018,Septiembre,Grecia,0,3,,3,-74.77647900000001,10.886686
56865,2018,Septiembre,Grecia,0,2,,2,-74.213989,11.247722999999999
56866,2018,Septiembre,Grecia,0,1,,1,-76.532004,3.451668
56867,2018,Septiembre,Grecia,1,0,,1,-77.061029,3.8844260000000004
56868,2018,Septiembre,Grecia,27,66,,93,-74.140516,4.697157
56869,2018,Septiembre,Grecia,2,9,,11,-75.42726,6.170465
56870,2018,Septiembre,Grecia,0,1,,1,-72.453013,7.819
56871,2018,Septiembre,Grecia,1,5,,6,-75.68164200000001,9.402597
56872,2018,Septiembre,Guatemala,1,2,,3,-77.35600000000001,0.81488
56873,2018,Septiembre,Guatemala,1,2,,3,-75.527794,10.406342
56874,2018,Septiembre,Guatemala,99,177,,276,-75.516486,10.446304
56875,2018,Septiembre,Guatemala,19,47,,66,-74.77647900000001,10.886686
56876,2018,Septiembre,Guatemala,3,2,,5,-81.70216500000001,12.5862
56877,2018,Septiembre,Guatemala,26,90,,116,-76.532004,3.451668
56878,2018,Septiembre,Guatemala,496,877,,1373,-74.140516,4.697157
56879,2018,Septiembre,Guatemala,3,6,,9,-75.736374,4.815189
56880,2018,Septiembre,Guatemala,94,219,,313,-75.42726,6.170465
56881,2018,Septiembre,Guatemala,2,0,,2,-70.74025300000001,7.088728999999999
56882,2018,Septiembre,Guatemala,1,3,,4,-73.181317,7.1280470000000005
56883,2018,Septiembre,Guatemala,0,1,,1,-72.453013,7.819
56884,2018,Septiembre,Guyana,1,1,,2,-75.527794,10.406342
56885,2018,Septiembre,Guyana,2,7,,9,-75.516486,10.446304
56886,2018,Septiembre,Guyana,1,0,,1,-74.77647900000001,10.886686
56887,2018,Septiembre,Guyana,3,1,,4,-76.532004,3.451668
56888,2018,Septiembre,Guyana,8,6,,14,-74.140516,4.697157
56889,2018,Septiembre,Guyana,2,8,,10,-75.42726,6.170465
56890,2018,Septiembre,Guyana,0,1,,1,-72.453013,7.819
56891,2018,Septiembre,Guinea Ecuatorial,0,1,,1,-75.42726,6.170465
56892,2018,Septiembre,Guinea Bissau,1,0,,1,-76.532004,3.451668
56893,2018,Septiembre,Guinea Bissau,1,0,,1,-74.140516,4.697157
56894,2018,Septiembre,Haití,0,1,,1,-77.35600000000001,0.81488
56895,2018,Septiembre,Haití,2,6,,8,-75.516486,10.446304
56896,2018,Septiembre,Haití,4,7,,11,-74.140516,4.697157
56897,2018,Septiembre,Haití,1,4,,5,-75.42726,6.170465
56898,2018,Septiembre,Honduras,2,5,,7,-77.35600000000001,0.81488
56899,2018,Septiembre,Honduras,1,10,,11,-75.527794,10.406342
56900,2018,Septiembre,Honduras,100,123,,223,-75.516486,10.446304
56901,2018,Septiembre,Honduras,8,9,,17,-74.77647900000001,10.886686
56902,2018,Septiembre,Honduras,2,0,,2,-81.70216500000001,12.5862
56903,2018,Septiembre,Honduras,53,65,,118,-76.532004,3.451668
56904,2018,Septiembre,Honduras,0,3,,3,-75.76635300000001,4.45285
56905,2018,Septiembre,Honduras,336,385,,721,-74.140516,4.697157
56906,2018,Septiembre,Honduras,4,7,,11,-75.736374,4.815189
56907,2018,Septiembre,Honduras,66,95,,161,-75.42726,6.170465
56908,2018,Septiembre,Honduras,0,1,,1,-73.181317,7.1280470000000005
56909,2018,Septiembre,Honduras,0,1,,1,-72.453013,7.819
56910,2018,Septiembre,Honduras,0,1,,1,-75.68164200000001,9.402597
56911,2018,Septiembre,Hong Kong,1,1,,2,-77.35600000000001,0.81488
56912,2018,Septiembre,Hong Kong,2,2,,4,-75.516486,10.446304
56913,2018,Septiembre,Hong Kong,0,1,,1,-72.129595,11.360028999999999
56914,2018,Septiembre,Hong Kong,11,14,,25,-74.140516,4.697157
56915,2018,Septiembre,Hungría,0,2,,2,-69.941498,4.191162
56916,2018,Septiembre,Hungría,1,0,,1,-77.35600000000001,0.81488
56917,2018,Septiembre,Hungría,1,2,,3,-75.527794,10.406342
56918,2018,Septiembre,Hungría,9,10,,19,-75.516486,10.446304
56919,2018,Septiembre,Hungría,0,1,,1,-74.77647900000001,10.886686
56920,2018,Septiembre,Hungría,0,3,,3,-76.532004,3.451668
56921,2018,Septiembre,Hungría,18,40,,58,-74.140516,4.697157
56922,2018,Septiembre,Hungría,4,10,,14,-75.42726,6.170465
56923,2018,Septiembre,Hungría,0,1,,1,-72.409396,8.36068
56924,2018,Septiembre,India,0,1,,1,-77.35600000000001,0.81488
56925,2018,Septiembre,India,0,20,,20,-75.527794,10.406342
56926,2018,Septiembre,India,35,164,,199,-75.516486,10.446304
56927,2018,Septiembre,India,0,16,,16,-74.77647900000001,10.886686
56928,2018,Septiembre,India,0,1,,1,-74.213989,11.247722999999999
56929,2018,Septiembre,India,6,31,,37,-76.532004,3.451668
56930,2018,Septiembre,India,0,10,,10,-77.061029,3.8844260000000004
56931,2018,Septiembre,India,81,574,,655,-74.140516,4.697157
56932,2018,Septiembre,India,0,6,,6,-75.736374,4.815189
56933,2018,Septiembre,India,11,80,,91,-75.42726,6.170465
56934,2018,Septiembre,India,0,2,,2,-75.68164200000001,9.402597
56935,2018,Septiembre,Indonesia,1,0,,1,-77.35600000000001,0.81488
56936,2018,Septiembre,Indonesia,0,2,,2,-75.527794,10.406342
56937,2018,Septiembre,Indonesia,11,22,,33,-75.516486,10.446304
56938,2018,Septiembre,Indonesia,0,2,,2,-74.77647900000001,10.886686
56939,2018,Septiembre,Indonesia,0,1,,1,-74.213989,11.247722999999999
56940,2018,Septiembre,Indonesia,9,18,,27,-74.140516,4.697157
56941,2018,Septiembre,Indonesia,0,1,,1,-75.42726,6.170465
56942,2018,Septiembre,Iraq,0,1,,1,-76.532004,3.451668
56943,2018,Septiembre,Iraq,1,1,,2,-74.140516,4.697157
56944,2018,Septiembre,Irán,0,1,,1,-72.129595,11.360028999999999
56945,2018,Septiembre,Irán,3,11,,14,-74.140516,4.697157
56946,2018,Septiembre,República de Irlanda,0,1,,1,-69.94143100000001,4.214082
56947,2018,Septiembre,República de Irlanda,6,11,,17,-77.35600000000001,0.81488
56948,2018,Septiembre,República de Irlanda,7,5,,12,-75.527794,10.406342
56949,2018,Septiembre,República de Irlanda,22,31,,53,-75.516486,10.446304
56950,2018,Septiembre,República de Irlanda,0,1,,1,-74.77647900000001,10.886686
56951,2018,Septiembre,República de Irlanda,0,1,,1,-72.129595,11.360028999999999
56952,2018,Septiembre,República de Irlanda,2,5,,7,-76.532004,3.451668
56953,2018,Septiembre,República de Irlanda,116,208,,324,-74.140516,4.697157
56954,2018,Septiembre,República de Irlanda,22,50,,72,-75.42726,6.170465
56955,2018,Septiembre,República de Irlanda,8,4,,12,-77.35002,8.63337
56956,2018,Septiembre,Islandia,1,0,,1,-77.35600000000001,0.81488
56957,2018,Septiembre,Islandia,2,1,,3,-75.516486,10.446304
56958,2018,Septiembre,Islandia,4,5,,9,-74.140516,4.697157
56959,2018,Septiembre,Islandia,0,1,,1,-75.42726,6.170465
56960,2018,Septiembre,Israel,1,0,,1,-69.941498,4.191162
56961,2018,Septiembre,Israel,0,1,,1,-69.94143100000001,4.214082
56962,2018,Septiembre,Israel,15,23,,38,-77.35600000000001,0.81488
56963,2018,Septiembre,Israel,2,3,,5,-75.527794,10.406342
56964,2018,Septiembre,Israel,27,71,,98,-75.516486,10.446304
56965,2018,Septiembre,Israel,0,6,,6,-74.77647900000001,10.886686
56966,2018,Septiembre,Israel,0,2,,2,-81.70216500000001,12.5862
56967,2018,Septiembre,Israel,6,22,,28,-76.532004,3.451668
56968,2018,Septiembre,Israel,1,2,,3,-75.76635300000001,4.45285
56969,2018,Septiembre,Israel,188,448,,636,-74.140516,4.697157
56970,2018,Septiembre,Israel,2,3,,5,-75.736374,4.815189
56971,2018,Septiembre,Israel,17,52,,69,-75.42726,6.170465
56972,2018,Septiembre,Israel,3,3,,6,-77.35002,8.63337
56973,2018,Septiembre,Italia,2,0,,2,-69.941498,4.191162
56974,2018,Septiembre,Italia,1,2,,3,-69.94143100000001,4.214082
56975,2018,Septiembre,Italia,2,2,,4,-76.876446,0.33002
56976,2018,Septiembre,Italia,16,11,,27,-77.35600000000001,0.81488
56977,2018,Septiembre,Italia,10,17,,27,-75.527794,10.406342
56978,2018,Septiembre,Italia,86,182,,268,-75.516486,10.446304
56979,2018,Septiembre,Italia,16,40,,56,-74.77647900000001,10.886686
56980,2018,Septiembre,Italia,1,6,,7,-72.129595,11.360028999999999
56981,2018,Septiembre,Italia,4,9,,13,-81.70216500000001,12.5862
56982,2018,Septiembre,Italia,23,79,,102,-76.532004,3.451668
56983,2018,Septiembre,Italia,676,1710,,2386,-74.140516,4.697157
56984,2018,Septiembre,Italia,1,5,,6,-75.736374,4.815189
56985,2018,Septiembre,Italia,71,177,,248,-75.42726,6.170465
56986,2018,Septiembre,Italia,1,0,,1,-70.74025300000001,7.088728999999999
56987,2018,Septiembre,Italia,0,3,,3,-73.181317,7.1280470000000005
56988,2018,Septiembre,Italia,11,19,,30,-72.453013,7.819
56989,2018,Septiembre,Italia,2,4,,6,-72.409396,8.36068
56990,2018,Septiembre,Italia,0,4,,4,-77.35002,8.63337
56991,2018,Septiembre,Jamaica,0,1,,1,-75.527794,10.406342
56992,2018,Septiembre,Jamaica,6,21,,27,-75.516486,10.446304
56993,2018,Septiembre,Jamaica,2,4,,6,-74.77647900000001,10.886686
56994,2018,Septiembre,Jamaica,1,0,,1,-81.70216500000001,12.5862
56995,2018,Septiembre,Jamaica,0,2,,2,-81.372937,13.338761300000002
56996,2018,Septiembre,Jamaica,2,1,,3,-76.532004,3.451668
56997,2018,Septiembre,Jamaica,33,26,,59,-74.140516,4.697157
56998,2018,Septiembre,Jamaica,4,17,,21,-75.42726,6.170465
56999,2018,Septiembre,Japón,3,5,,8,-77.35600000000001,0.81488
57000,2018,Septiembre,Japón,1,4,,5,-75.527794,10.406342
57001,2018,Septiembre,Japón,15,27,,42,-75.516486,10.446304
57002,2018,Septiembre,Japón,0,2,,2,-74.77647900000001,10.886686
57003,2018,Septiembre,Japón,1,14,,15,-76.532004,3.451668
57004,2018,Septiembre,Japón,214,503,,717,-74.140516,4.697157
57005,2018,Septiembre,Japón,0,2,,2,-75.736374,4.815189
57006,2018,Septiembre,Japón,35,80,,115,-75.42726,6.170465
57007,2018,Septiembre,Japón,1,1,,2,-72.453013,7.819
57008,2018,Septiembre,Japón,0,2,,2,-77.35002,8.63337
57009,2018,Septiembre,Jordania,0,1,,1,-75.516486,10.446304
57010,2018,Septiembre,Jordania,0,10,,10,-74.140516,4.697157
57011,2018,Septiembre,Kazajistán,1,0,,1,-77.35600000000001,0.81488
57012,2018,Septiembre,Kazajistán,2,2,,4,-75.527794,10.406342
57013,2018,Septiembre,Kazajistán,1,0,,1,-75.516486,10.446304
57014,2018,Septiembre,Kazajistán,3,2,,5,-76.532004,3.451668
57015,2018,Septiembre,Kazajistán,2,5,,7,-74.140516,4.697157
57016,2018,Septiembre,Kenia,2,0,,2,-75.516486,10.446304
57017,2018,Septiembre,Kenia,2,0,,2,-76.532004,3.451668
57018,2018,Septiembre,Kenia,11,8,,19,-74.140516,4.697157
57019,2018,Septiembre,Kenia,1,8,,9,-75.42726,6.170465
57020,2018,Septiembre,República de Kosovo,1,1,,2,-74.140516,4.697157
57021,2018,Septiembre,República de Kosovo,0,1,,1,-75.42726,6.170465
57022,2018,Septiembre,Letonia,1,0,,1,-77.35600000000001,0.81488
57023,2018,Septiembre,Letonia,0,1,,1,-75.527794,10.406342
57024,2018,Septiembre,Letonia,6,8,,14,-75.516486,10.446304
57025,2018,Septiembre,Letonia,0,1,,1,-74.77647900000001,10.886686
57026,2018,Septiembre,Letonia,0,1,,1,-77.061029,3.8844260000000004
57027,2018,Septiembre,Letonia,17,13,,30,-74.140516,4.697157
57028,2018,Septiembre,Letonia,0,1,,1,-75.42726,6.170465
57029,2018,Septiembre,Letonia,0,1,,1,-76.7333,8.06667
57030,2018,Septiembre,Letonia,1,1,,2,-75.68164200000001,9.402597
57031,2018,Septiembre,Lituania,2,0,,2,-77.35600000000001,0.81488
57032,2018,Septiembre,Lituania,0,3,,3,-75.527794,10.406342
57033,2018,Septiembre,Lituania,3,6,,9,-75.516486,10.446304
57034,2018,Septiembre,Lituania,1,0,,1,-81.70216500000001,12.5862
57035,2018,Septiembre,Lituania,1,2,,3,-76.532004,3.451668
57036,2018,Septiembre,Lituania,37,35,,72,-74.140516,4.697157
57037,2018,Septiembre,Lituania,2,3,,5,-75.42726,6.170465
57038,2018,Septiembre,Lituania,1,0,,1,-70.74025300000001,7.088728999999999
57039,2018,Septiembre,Líbano,1,0,,1,-77.35600000000001,0.81488
57040,2018,Septiembre,Líbano,1,2,,3,-74.77647900000001,10.886686
57041,2018,Septiembre,Líbano,0,1,,1,-72.129595,11.360028999999999
57042,2018,Septiembre,Líbano,15,26,,41,-74.140516,4.697157
57043,2018,Septiembre,Líbano,1,3,,4,-75.42726,6.170465
57044,2018,Septiembre,Líbano,1,0,,1,-73.181317,7.1280470000000005
57045,2018,Septiembre,Liberia,0,1,,1,-74.140516,4.697157
57046,2018,Septiembre,Libia,1,0,,1,-74.140516,4.697157
57047,2018,Septiembre,Liechtenstein,0,1,,1,-74.140516,4.697157
57048,2018,Septiembre,Liechtenstein,0,1,,1,-75.42726,6.170465
57049,2018,Septiembre,Luxemburgo,0,1,,1,-77.35600000000001,0.81488
57050,2018,Septiembre,Luxemburgo,4,14,,18,-74.140516,4.697157
57051,2018,Septiembre,Luxemburgo,2,0,,2,-75.42726,6.170465
57052,2018,Septiembre,Macedonia,1,0,,1,-75.527794,10.406342
57053,2018,Septiembre,Macedonia,2,2,,4,-74.140516,4.697157
57054,2018,Septiembre,Madagascar,3,1,,4,-74.140516,4.697157
57055,2018,Septiembre,Madagascar,1,0,,1,-75.42726,6.170465
57056,2018,Septiembre,Malasia,0,1,,1,-75.527794,10.406342
57057,2018,Septiembre,Malasia,3,17,,20,-75.516486,10.446304
57058,2018,Septiembre,Malasia,0,1,,1,-76.532004,3.451668
57059,2018,Septiembre,Malasia,0,1,,1,-77.061029,3.8844260000000004
57060,2018,Septiembre,Malasia,14,55,,69,-74.140516,4.697157
57061,2018,Septiembre,Malasia,1,0,,1,-75.42726,6.170465
57062,2018,Septiembre,Malasia,0,1,,1,-73.181317,7.1280470000000005
57063,2018,Septiembre,Malawi,2,1,,3,-74.140516,4.697157
57064,2018,Septiembre,Maldivas,1,0,,1,-74.140516,4.697157
57065,2018,Septiembre,Malí,1,0,,1,-74.140516,4.697157
57066,2018,Septiembre,Malta,0,1,,1,-76.532004,3.451668
57067,2018,Septiembre,Malta,1,3,,4,-74.140516,4.697157
57068,2018,Septiembre,Marruecos,2,1,,3,-75.516486,10.446304
57069,2018,Septiembre,Marruecos,16,21,,37,-74.140516,4.697157
57070,2018,Septiembre,Marruecos,2,3,,5,-75.42726,6.170465
57071,2018,Septiembre,Mauricio,0,1,,1,-75.527794,10.406342
57072,2018,Septiembre,Mauricio,1,0,,1,-75.516486,10.446304
57073,2018,Septiembre,Mauricio,0,3,,3,-74.140516,4.697157
57074,2018,Septiembre,Mauricio,0,1,,1,-75.42726,6.170465
57075,2018,Septiembre,México,0,4,,4,-69.941498,4.191162
57076,2018,Septiembre,México,1,0,,1,-76.876446,0.33002
57077,2018,Septiembre,México,16,21,,37,-77.35600000000001,0.81488
57078,2018,Septiembre,México,17,22,,39,-75.527794,10.406342
57079,2018,Septiembre,México,245,387,,632,-75.516486,10.446304
57080,2018,Septiembre,México,32,64,,96,-74.77647900000001,10.886686
57081,2018,Septiembre,México,1,0,,1,-74.213989,11.247722999999999
57082,2018,Septiembre,México,3,2,,5,-72.129595,11.360028999999999
57083,2018,Septiembre,México,2,5,,7,-81.70216500000001,12.5862
57084,2018,Septiembre,México,80,224,,304,-76.532004,3.451668
57085,2018,Septiembre,México,4,4,,8,-75.76635300000001,4.45285
57086,2018,Septiembre,México,4691,8144,,12835,-74.140516,4.697157
57087,2018,Septiembre,México,9,23,,32,-75.736374,4.815189
57088,2018,Septiembre,México,602,1471,,2073,-75.42726,6.170465
57089,2018,Septiembre,México,2,2,,4,-67.48402800000001,6.185536
57090,2018,Septiembre,México,2,10,,12,-73.181317,7.1280470000000005
57091,2018,Septiembre,México,15,31,,46,-72.453013,7.819
57092,2018,Septiembre,México,0,4,,4,-72.409396,8.36068
57093,2018,Septiembre,México,1,4,,5,-77.35002,8.63337
57094,2018,Septiembre,República de Moldavia,3,2,,5,-74.140516,4.697157
57095,2018,Septiembre,Mongolia,4,5,,9,-74.140516,4.697157
57096,2018,Septiembre,Montenegro,0,1,,1,-75.527794,10.406342
57097,2018,Septiembre,Montenegro,0,5,,5,-74.140516,4.697157
57098,2018,Septiembre,Mozambique,1,1,,2,-74.140516,4.697157
57099,2018,Septiembre,Mozambique,0,1,,1,-75.42726,6.170465
57100,2018,Septiembre,Myanmar,0,2,,2,-75.527794,10.406342
57101,2018,Septiembre,Myanmar,0,1,,1,-74.140516,4.697157
57102,2018,Septiembre,Namibia,0,1,,1,-77.35600000000001,0.81488
57103,2018,Septiembre,Namibia,0,1,,1,-74.140516,4.697157
57104,2018,Septiembre,Nepal,1,0,,1,-75.516486,10.446304
57105,2018,Septiembre,Nepal,0,1,,1,-76.532004,3.451668
57106,2018,Septiembre,Nepal,0,4,,4,-74.140516,4.697157
57107,2018,Septiembre,Nicaragua,1,0,,1,-75.527794,10.406342
57108,2018,Septiembre,Nicaragua,15,40,,55,-75.516486,10.446304
57109,2018,Septiembre,Nicaragua,3,3,,6,-74.77647900000001,10.886686
57110,2018,Septiembre,Nicaragua,20,30,,50,-76.532004,3.451668
57111,2018,Septiembre,Nicaragua,106,122,,228,-74.140516,4.697157
57112,2018,Septiembre,Nicaragua,2,3,,5,-75.736374,4.815189
57113,2018,Septiembre,Nicaragua,17,44,,61,-75.42726,6.170465
57114,2018,Septiembre,Nicaragua,0,2,,2,-73.181317,7.1280470000000005
57115,2018,Septiembre,Nigeria,0,1,,1,-75.516486,10.446304
57116,2018,Septiembre,Nigeria,3,11,,14,-74.140516,4.697157
57117,2018,Septiembre,Nigeria,1,2,,3,-75.42726,6.170465
57118,2018,Septiembre,Níger,1,0,,1,-76.532004,3.451668
57119,2018,Septiembre,Noruega,0,1,,1,-69.941498,4.191162
57120,2018,Septiembre,Noruega,0,1,,1,-76.876446,0.33002
57121,2018,Septiembre,Noruega,0,1,,1,-77.35600000000001,0.81488
57122,2018,Septiembre,Noruega,6,5,,11,-75.527794,10.406342
57123,2018,Septiembre,Noruega,10,12,,22,-75.516486,10.446304
57124,2018,Septiembre,Noruega,3,3,,6,-74.77647900000001,10.886686
57125,2018,Septiembre,Noruega,1,0,,1,-72.129595,11.360028999999999
57126,2018,Septiembre,Noruega,1,6,,7,-76.532004,3.451668
57127,2018,Septiembre,Noruega,57,112,,169,-74.140516,4.697157
57128,2018,Septiembre,Noruega,6,16,,22,-75.42726,6.170465
57129,2018,Septiembre,Noruega,0,1,,1,-73.181317,7.1280470000000005
57130,2018,Septiembre,Noruega,1,0,,1,-77.35002,8.63337
57131,2018,Septiembre,Nueva Zelanda,0,1,,1,-76.876446,0.33002
57132,2018,Septiembre,Nueva Zelanda,5,7,,12,-77.35600000000001,0.81488
57133,2018,Septiembre,Nueva Zelanda,6,9,,15,-75.527794,10.406342
57134,2018,Septiembre,Nueva Zelanda,7,14,,21,-75.516486,10.446304
57135,2018,Septiembre,Nueva Zelanda,0,3,,3,-74.77647900000001,10.886686
57136,2018,Septiembre,Nueva Zelanda,1,3,,4,-76.532004,3.451668
57137,2018,Septiembre,Nueva Zelanda,62,90,,152,-74.140516,4.697157
57138,2018,Septiembre,Nueva Zelanda,7,14,,21,-75.42726,6.170465
57139,2018,Septiembre,Nueva Zelanda,0,1,,1,-77.35002,8.63337
57140,2018,Septiembre,Países Bajos,0,4,,4,-69.941498,4.191162
57141,2018,Septiembre,Países Bajos,0,1,,1,-69.94143100000001,4.214082
57142,2018,Septiembre,Países Bajos,0,2,,2,-76.876446,0.33002
57143,2018,Septiembre,Países Bajos,9,15,,24,-77.35600000000001,0.81488
57144,2018,Septiembre,Países Bajos,12,11,,23,-75.527794,10.406342
57145,2018,Septiembre,Países Bajos,274,281,,555,-75.516486,10.446304
57146,2018,Septiembre,Países Bajos,11,18,,29,-74.77647900000001,10.886686
57147,2018,Septiembre,Países Bajos,2,5,,7,-74.213989,11.247722999999999
57148,2018,Septiembre,Países Bajos,2,1,,3,-72.129595,11.360028999999999
57149,2018,Septiembre,Países Bajos,0,1,,1,-81.70216500000001,12.5862
57150,2018,Septiembre,Países Bajos,59,82,,141,-76.532004,3.451668
57151,2018,Septiembre,Países Bajos,1694,2169,,3863,-74.140516,4.697157
57152,2018,Septiembre,Países Bajos,1,8,,9,-75.736374,4.815189
57153,2018,Septiembre,Países Bajos,156,259,,415,-75.42726,6.170465
57154,2018,Septiembre,Países Bajos,4,4,,8,-73.181317,7.1280470000000005
57155,2018,Septiembre,Países Bajos,0,5,,5,-72.453013,7.819
57156,2018,Septiembre,Países Bajos,0,1,,1,-72.409396,8.36068
57157,2018,Septiembre,Países Bajos,8,8,,16,-77.35002,8.63337
57158,2018,Septiembre,Pakistán,0,1,,1,-76.532004,3.451668
57159,2018,Septiembre,Pakistán,0,20,,20,-74.140516,4.697157
57160,2018,Septiembre,Pakistán,0,2,,2,-75.42726,6.170465
57161,2018,Septiembre,Pakistán,0,1,,1,-72.453013,7.819
57162,2018,Septiembre,Pakistán,0,1,,1,-75.68164200000001,9.402597
57163,2018,Septiembre,Panamá,1,0,,1,-69.941498,4.191162
57164,2018,Septiembre,Panamá,2,2,,4,-77.35600000000001,0.81488
57165,2018,Septiembre,Panamá,2,24,,26,-75.527794,10.406342
57166,2018,Septiembre,Panamá,680,613,,1293,-75.516486,10.446304
57167,2018,Septiembre,Panamá,58,100,,158,-74.77647900000001,10.886686
57168,2018,Septiembre,Panamá,0,2,,2,-72.129595,11.360028999999999
57169,2018,Septiembre,Panamá,72,38,,110,-81.70216500000001,12.5862
57170,2018,Septiembre,Panamá,389,330,,719,-76.532004,3.451668
57171,2018,Septiembre,Panamá,14,23,,37,-75.76635300000001,4.45285
57172,2018,Septiembre,Panamá,1793,1691,,3484,-74.140516,4.697157
57173,2018,Septiembre,Panamá,36,68,,104,-75.736374,4.815189
57174,2018,Septiembre,Panamá,1868,1454,,3322,-75.42726,6.170465
57175,2018,Septiembre,Panamá,0,1,,1,-75.586989,6.2188349999999994
57176,2018,Septiembre,Panamá,1,0,,1,-77.401154,6.222551999999999
57177,2018,Septiembre,Panamá,1,3,,4,-77.762647,7.102626
57178,2018,Septiembre,Panamá,9,14,,23,-73.181317,7.1280470000000005
57179,2018,Septiembre,Panamá,3,7,,10,-72.453013,7.819
57180,2018,Septiembre,Panamá,0,2,,2,-72.508188,7.927233
57181,2018,Septiembre,Panamá,1,2,,3,-77.35002,8.63337
57182,2018,Septiembre,Paraguay,5,6,,11,-77.35600000000001,0.81488
57183,2018,Septiembre,Paraguay,10,6,,16,-75.527794,10.406342
57184,2018,Septiembre,Paraguay,109,70,,179,-75.516486,10.446304
57185,2018,Septiembre,Paraguay,12,7,,19,-74.77647900000001,10.886686
57186,2018,Septiembre,Paraguay,120,83,,203,-81.70216500000001,12.5862
57187,2018,Septiembre,Paraguay,5,5,,10,-76.532004,3.451668
57188,2018,Septiembre,Paraguay,1,0,,1,-75.76635300000001,4.45285
57189,2018,Septiembre,Paraguay,247,225,,472,-74.140516,4.697157
57190,2018,Septiembre,Paraguay,31,26,,57,-75.42726,6.170465
57191,2018,Septiembre,Paraguay,0,2,,2,-72.453013,7.819
57192,2018,Septiembre,Perú,21,15,,36,-69.941498,4.191162
57193,2018,Septiembre,Perú,23,27,,50,-69.94143100000001,4.214082
57194,2018,Septiembre,Perú,9,11,,20,-76.876446,0.33002
57195,2018,Septiembre,Perú,134,280,,414,-77.35600000000001,0.81488
57196,2018,Septiembre,Perú,30,27,,57,-75.527794,10.406342
57197,2018,Septiembre,Perú,1145,856,,2001,-75.516486,10.446304
57198,2018,Septiembre,Perú,20,21,,41,-74.77647900000001,10.886686
57199,2018,Septiembre,Perú,2,19,,21,-72.129595,11.360028999999999
57200,2018,Septiembre,Perú,269,182,,451,-81.70216500000001,12.5862
57201,2018,Septiembre,Perú,146,164,,310,-76.532004,3.451668
57202,2018,Septiembre,Perú,0,2,,2,-75.76635300000001,4.45285
57203,2018,Septiembre,Perú,3257,4542,,7799,-74.140516,4.697157
57204,2018,Septiembre,Perú,1,4,,5,-75.736374,4.815189
57205,2018,Septiembre,Perú,439,693,,1132,-75.42726,6.170465
57206,2018,Septiembre,Perú,0,1,,1,-67.48402800000001,6.185536
57207,2018,Septiembre,Perú,2,5,,7,-70.74025300000001,7.088728999999999
57208,2018,Septiembre,Perú,0,2,,2,-73.181317,7.1280470000000005
57209,2018,Septiembre,Perú,91,129,,220,-72.453013,7.819
57210,2018,Septiembre,Perú,7,9,,16,-72.409396,8.36068
57211,2018,Septiembre,Palestina,2,3,,5,-74.140516,4.697157
57212,2018,Septiembre,Palestina,1,1,,2,-75.42726,6.170465
57213,2018,Septiembre,Polonia,2,1,,3,-69.941498,4.191162
57214,2018,Septiembre,Polonia,9,6,,15,-77.35600000000001,0.81488
57215,2018,Septiembre,Polonia,1,3,,4,-75.527794,10.406342
57216,2018,Septiembre,Polonia,13,41,,54,-75.516486,10.446304
57217,2018,Septiembre,Polonia,1,0,,1,-74.77647900000001,10.886686
57218,2018,Septiembre,Polonia,1,7,,8,-76.532004,3.451668
57219,2018,Septiembre,Polonia,150,203,,353,-74.140516,4.697157
57220,2018,Septiembre,Polonia,1,0,,1,-75.736374,4.815189
57221,2018,Septiembre,Polonia,11,12,,23,-75.42726,6.170465
57222,2018,Septiembre,Polonia,0,1,,1,-72.453013,7.819
57223,2018,Septiembre,Portugal,0,1,,1,-76.876446,0.33002
57224,2018,Septiembre,Portugal,3,5,,8,-77.35600000000001,0.81488
57225,2018,Septiembre,Portugal,4,3,,7,-75.527794,10.406342
57226,2018,Septiembre,Portugal,12,30,,42,-75.516486,10.446304
57227,2018,Septiembre,Portugal,5,14,,19,-74.77647900000001,10.886686
57228,2018,Septiembre,Portugal,1,6,,7,-72.129595,11.360028999999999
57229,2018,Septiembre,Portugal,1,1,,2,-81.70216500000001,12.5862
57230,2018,Septiembre,Portugal,5,6,,11,-76.532004,3.451668
57231,2018,Septiembre,Portugal,201,442,,643,-74.140516,4.697157
57232,2018,Septiembre,Portugal,1,2,,3,-75.736374,4.815189
57233,2018,Septiembre,Portugal,13,38,,51,-75.42726,6.170465
57234,2018,Septiembre,Portugal,6,19,,25,-72.453013,7.819
57235,2018,Septiembre,Portugal,0,2,,2,-72.409396,8.36068
57236,2018,Septiembre,Puerto Rico/Territorio de Estados Unidos,0,2,,2,-74.140516,4.697157
57237,2018,Septiembre,Qatar,0,7,,7,-74.140516,4.697157
57238,2018,Septiembre,Qatar,0,1,,1,-75.42726,6.170465
57239,2018,Septiembre,Reino Unido de Gran Bretaña e Irlanda del Norte,1,4,,5,-69.941498,4.191162
57240,2018,Septiembre,Reino Unido de Gran Bretaña e Irlanda del Norte,1,1,,2,-76.876446,0.33002
57241,2018,Septiembre,Reino Unido de Gran Bretaña e Irlanda del Norte,29,40,,69,-77.35600000000001,0.81488
57242,2018,Septiembre,Reino Unido de Gran Bretaña e Irlanda del Norte,11,18,,29,-75.527794,10.406342
57243,2018,Septiembre,Reino Unido de Gran Bretaña e Irlanda del Norte,123,199,,322,-75.516486,10.446304
57244,2018,Septiembre,Reino Unido de Gran Bretaña e Irlanda del Norte,7,15,,22,-74.77647900000001,10.886686
57245,2018,Septiembre,Reino Unido de Gran Bretaña e Irlanda del Norte,0,1,,1,-74.213989,11.247722999999999
57246,2018,Septiembre,Reino Unido de Gran Bretaña e Irlanda del Norte,2,0,,2,-72.129595,11.360028999999999
57247,2018,Septiembre,Reino Unido de Gran Bretaña e Irlanda del Norte,2,2,,4,-81.70216500000001,12.5862
57248,2018,Septiembre,Reino Unido de Gran Bretaña e Irlanda del Norte,27,68,,95,-76.532004,3.451668
57249,2018,Septiembre,Reino Unido de Gran Bretaña e Irlanda del Norte,0,1,,1,-75.76635300000001,4.45285
57250,2018,Septiembre,Reino Unido de Gran Bretaña e Irlanda del Norte,914,1790,,2704,-74.140516,4.697157
57251,2018,Septiembre,Reino Unido de Gran Bretaña e Irlanda del Norte,0,2,,2,-75.736374,4.815189
57252,2018,Septiembre,Reino Unido de Gran Bretaña e Irlanda del Norte,71,209,,280,-75.42726,6.170465
57253,2018,Septiembre,Reino Unido de Gran Bretaña e Irlanda del Norte,0,2,,2,-70.74025300000001,7.088728999999999
57254,2018,Septiembre,Reino Unido de Gran Bretaña e Irlanda del Norte,0,5,,5,-72.453013,7.819
57255,2018,Septiembre,Reino Unido de Gran Bretaña e Irlanda del Norte,13,15,,28,-77.35002,8.63337
57256,2018,Septiembre,República Dominicana,0,2,,2,-69.941498,4.191162
57257,2018,Septiembre,República Dominicana,5,15,,20,-77.35600000000001,0.81488
57258,2018,Septiembre,República Dominicana,45,27,,72,-75.527794,10.406342
57259,2018,Septiembre,República Dominicana,76,74,,150,-75.516486,10.446304
57260,2018,Septiembre,República Dominicana,15,52,,67,-74.77647900000001,10.886686
57261,2018,Septiembre,República Dominicana,0,2,,2,-72.129595,11.360028999999999
57262,2018,Septiembre,República Dominicana,5,5,,10,-81.70216500000001,12.5862
57263,2018,Septiembre,República Dominicana,19,44,,63,-76.532004,3.451668
57264,2018,Septiembre,República Dominicana,884,922,,1806,-74.140516,4.697157
57265,2018,Septiembre,República Dominicana,3,5,,8,-75.736374,4.815189
57266,2018,Septiembre,República Dominicana,59,114,,173,-75.42726,6.170465
57267,2018,Septiembre,República Dominicana,1,0,,1,-77.401154,6.222551999999999
57268,2018,Septiembre,República Dominicana,1,5,,6,-73.181317,7.1280470000000005
57269,2018,Septiembre,República Dominicana,1,3,,4,-72.453013,7.819
57270,2018,Septiembre,Rumania,1,1,,2,-77.35600000000001,0.81488
57271,2018,Septiembre,Rumania,1,7,,8,-75.527794,10.406342
57272,2018,Septiembre,Rumania,4,15,,19,-75.516486,10.446304
57273,2018,Septiembre,Rumania,0,2,,2,-74.77647900000001,10.886686
57274,2018,Septiembre,Rumania,1,3,,4,-76.532004,3.451668
57275,2018,Septiembre,Rumania,104,99,,203,-74.140516,4.697157
57276,2018,Septiembre,Rumania,5,5,,10,-75.42726,6.170465
57277,2018,Septiembre,Federación de Rusia,3,3,,6,-77.35600000000001,0.81488
57278,2018,Septiembre,Federación de Rusia,2,15,,17,-75.527794,10.406342
57279,2018,Septiembre,Federación de Rusia,22,26,,48,-75.516486,10.446304
57280,2018,Septiembre,Federación de Rusia,1,2,,3,-74.77647900000001,10.886686
57281,2018,Septiembre,Federación de Rusia,1,0,,1,-72.129595,11.360028999999999
57282,2018,Septiembre,Federación de Rusia,0,2,,2,-81.70216500000001,12.5862
57283,2018,Septiembre,Federación de Rusia,4,3,,7,-76.532004,3.451668
57284,2018,Septiembre,Federación de Rusia,0,1,,1,-77.061029,3.8844260000000004
57285,2018,Septiembre,Federación de Rusia,152,186,,338,-74.140516,4.697157
57286,2018,Septiembre,Federación de Rusia,1,1,,2,-75.736374,4.815189
57287,2018,Septiembre,Federación de Rusia,11,11,,22,-75.42726,6.170465
57288,2018,Septiembre,Federación de Rusia,0,1,,1,-73.181317,7.1280470000000005
57289,2018,Septiembre,Federación de Rusia,1,0,,1,-72.453013,7.819
57290,2018,Septiembre,Federación de Rusia,1,1,,2,-75.68164200000001,9.402597
57291,2018,Septiembre,Rwanda,2,0,,2,-75.516486,10.446304
57292,2018,Septiembre,Rwanda,1,1,,2,-74.140516,4.697157
57293,2018,Septiembre,San Cristóbal y Nevis,0,1,,1,-75.516486,10.446304
57294,2018,Septiembre,San Cristóbal y Nevis,1,4,,5,-74.140516,4.697157
57295,2018,Septiembre,San  Vicente y las Granadinas,0,2,,2,-75.516486,10.446304
57296,2018,Septiembre,San  Vicente y las Granadinas,0,1,,1,-74.77647900000001,10.886686
57297,2018,Septiembre,San  Vicente y las Granadinas,1,1,,2,-75.736374,4.815189
57298,2018,Septiembre,Santa Lucia,2,2,,4,-75.516486,10.446304
57299,2018,Septiembre,Santa Lucia,2,4,,6,-74.140516,4.697157
57300,2018,Septiembre,Santa Lucia,1,2,,3,-75.42726,6.170465
57301,2018,Septiembre,Santa Sede/Ciudad del Vaticano,0,1,,1,-74.140516,4.697157
57302,2018,Septiembre,Senegal,1,1,,2,-74.140516,4.697157
57303,2018,Septiembre,Serbia,0,1,,1,-77.35600000000001,0.81488
57304,2018,Septiembre,Serbia,1,0,,1,-75.527794,10.406342
57305,2018,Septiembre,Serbia,1,3,,4,-75.516486,10.446304
57306,2018,Septiembre,Serbia,0,1,,1,-74.77647900000001,10.886686
57307,2018,Septiembre,Serbia,0,1,,1,-81.70216500000001,12.5862
57308,2018,Septiembre,Serbia,2,0,,2,-76.532004,3.451668
57309,2018,Septiembre,Serbia,5,9,,14,-74.140516,4.697157
57310,2018,Septiembre,Serbia,1,4,,5,-75.42726,6.170465
57311,2018,Septiembre,Seychelles,0,1,,1,-74.140516,4.697157
57312,2018,Septiembre,Singapur,0,1,,1,-77.35600000000001,0.81488
57313,2018,Septiembre,Singapur,3,8,,11,-75.516486,10.446304
57314,2018,Septiembre,Singapur,21,39,,60,-74.140516,4.697157
57315,2018,Septiembre,Singapur,0,2,,2,-75.42726,6.170465
57316,2018,Septiembre,República Árabe Siria,0,1,,1,-75.516486,10.446304
57317,2018,Septiembre,República Árabe Siria,2,7,,9,-74.140516,4.697157
57318,2018,Septiembre,República Árabe Siria,0,2,,2,-75.42726,6.170465
57319,2018,Septiembre,Sri Lanka,2,3,,5,-75.516486,10.446304
57320,2018,Septiembre,Sri Lanka,1,3,,4,-74.140516,4.697157
57321,2018,Septiembre,Sri Lanka,0,1,,1,-75.42726,6.170465
57322,2018,Septiembre,Sudáfrica,2,0,,2,-77.35600000000001,0.81488
57323,2018,Septiembre,Sudáfrica,1,5,,6,-75.527794,10.406342
57324,2018,Septiembre,Sudáfrica,3,5,,8,-75.516486,10.446304
57325,2018,Septiembre,Sudáfrica,0,1,,1,-74.77647900000001,10.886686
57326,2018,Septiembre,Sudáfrica,1,1,,2,-81.372937,13.338761300000002
57327,2018,Septiembre,Sudáfrica,2,5,,7,-76.532004,3.451668
57328,2018,Septiembre,Sudáfrica,21,44,,65,-74.140516,4.697157
57329,2018,Septiembre,Sudáfrica,1,2,,3,-75.42726,6.170465
57330,2018,Septiembre,Sudáfrica,0,1,,1,-73.181317,7.1280470000000005
57331,2018,Septiembre,Sudán,0,1,,1,-74.140516,4.697157
57332,2018,Septiembre,Suecia,0,1,,1,-69.941498,4.191162
57333,2018,Septiembre,Suecia,2,0,,2,-69.94143100000001,4.214082
57334,2018,Septiembre,Suecia,4,0,,4,-77.35600000000001,0.81488
57335,2018,Septiembre,Suecia,1,1,,2,-75.527794,10.406342
57336,2018,Septiembre,Suecia,18,20,,38,-75.516486,10.446304
57337,2018,Septiembre,Suecia,4,5,,9,-74.77647900000001,10.886686
57338,2018,Septiembre,Suecia,1,2,,3,-74.213989,11.247722999999999
57339,2018,Septiembre,Suecia,0,1,,1,-72.129595,11.360028999999999
57340,2018,Septiembre,Suecia,0,1,,1,-81.70216500000001,12.5862
57341,2018,Septiembre,Suecia,3,11,,14,-76.532004,3.451668
57342,2018,Septiembre,Suecia,1,0,,1,-77.061029,3.8844260000000004
57343,2018,Septiembre,Suecia,111,214,,325,-74.140516,4.697157
57344,2018,Septiembre,Suecia,16,34,,50,-75.42726,6.170465
57345,2018,Septiembre,Suecia,1,0,,1,-73.181317,7.1280470000000005
57346,2018,Septiembre,Suiza,2,2,,4,-69.941498,4.191162
57347,2018,Septiembre,Suiza,1,2,,3,-69.94143100000001,4.214082
57348,2018,Septiembre,Suiza,3,1,,4,-76.876446,0.33002
57349,2018,Septiembre,Suiza,11,21,,32,-77.35600000000001,0.81488
57350,2018,Septiembre,Suiza,14,14,,28,-75.527794,10.406342
57351,2018,Septiembre,Suiza,59,50,,109,-75.516486,10.446304
57352,2018,Septiembre,Suiza,1,7,,8,-74.77647900000001,10.886686
57353,2018,Septiembre,Suiza,5,2,,7,-74.213989,11.247722999999999
57354,2018,Septiembre,Suiza,1,1,,2,-81.70216500000001,12.5862
57355,2018,Septiembre,Suiza,15,36,,51,-76.532004,3.451668
57356,2018,Septiembre,Suiza,383,589,,972,-74.140516,4.697157
57357,2018,Septiembre,Suiza,43,87,,130,-75.42726,6.170465
57358,2018,Septiembre,Suiza,1,0,,1,-70.74025300000001,7.088728999999999
57359,2018,Septiembre,Suiza,1,0,,1,-73.181317,7.1280470000000005
57360,2018,Septiembre,Suiza,1,1,,2,-72.453013,7.819
57361,2018,Septiembre,Suiza,3,2,,5,-77.35002,8.63337
57362,2018,Septiembre,Surinam,16,24,,40,-74.140516,4.697157
57363,2018,Septiembre,Surinam,0,1,,1,-75.42726,6.170465
57364,2018,Septiembre,Tailandia,0,2,,2,-75.516486,10.446304
57365,2018,Septiembre,Tailandia,7,14,,21,-74.140516,4.697157
57366,2018,Septiembre,Tailandia,2,0,,2,-75.42726,6.170465
57367,2018,Septiembre,Tanzania,0,4,,4,-74.140516,4.697157
57368,2018,Septiembre,Trinidad y Tobago,7,14,,21,-75.516486,10.446304
57369,2018,Septiembre,Trinidad y Tobago,1,2,,3,-74.77647900000001,10.886686
57370,2018,Septiembre,Trinidad y Tobago,0,1,,1,-74.213989,11.247722999999999
57371,2018,Septiembre,Trinidad y Tobago,3,12,,15,-76.532004,3.451668
57372,2018,Septiembre,Trinidad y Tobago,28,35,,63,-74.140516,4.697157
57373,2018,Septiembre,Trinidad y Tobago,1,2,,3,-75.736374,4.815189
57374,2018,Septiembre,Trinidad y Tobago,3,16,,19,-75.42726,6.170465
57375,2018,Septiembre,Túnez,2,7,,9,-74.140516,4.697157
57376,2018,Septiembre,Turquía,0,1,,1,-69.94143100000001,4.214082
57377,2018,Septiembre,Turquía,1,0,,1,-76.876446,0.33002
57378,2018,Septiembre,Turquía,0,2,,2,-77.35600000000001,0.81488
57379,2018,Septiembre,Turquía,0,1,,1,-75.527794,10.406342
57380,2018,Septiembre,Turquía,3,10,,13,-75.516486,10.446304
57381,2018,Septiembre,Turquía,2,3,,5,-74.77647900000001,10.886686
57382,2018,Septiembre,Turquía,1,2,,3,-74.213989,11.247722999999999
57383,2018,Septiembre,Turquía,0,3,,3,-76.532004,3.451668
57384,2018,Septiembre,Turquía,178,301,,479,-74.140516,4.697157
57385,2018,Septiembre,Turquía,7,21,,28,-75.42726,6.170465
57386,2018,Septiembre,Turquía,0,1,,1,-77.35002,8.63337
57387,2018,Septiembre,Ucrania,1,8,,9,-75.527794,10.406342
57388,2018,Septiembre,Ucrania,1,15,,16,-75.516486,10.446304
57389,2018,Septiembre,Ucrania,0,3,,3,-74.77647900000001,10.886686
57390,2018,Septiembre,Ucrania,0,2,,2,-74.213989,11.247722999999999
57391,2018,Septiembre,Ucrania,1,3,,4,-76.532004,3.451668
57392,2018,Septiembre,Ucrania,0,2,,2,-77.061029,3.8844260000000004
57393,2018,Septiembre,Ucrania,20,38,,58,-74.140516,4.697157
57394,2018,Septiembre,Ucrania,1,4,,5,-75.42726,6.170465
57395,2018,Septiembre,Ucrania,0,3,,3,-75.68164200000001,9.402597
57396,2018,Septiembre,Uganda,0,1,,1,-74.140516,4.697157
57397,2018,Septiembre,Uganda,1,0,,1,-75.42726,6.170465
57398,2018,Septiembre,Uruguay,0,2,,2,-69.941498,4.191162
57399,2018,Septiembre,Uruguay,0,1,,1,-69.94143100000001,4.214082
57400,2018,Septiembre,Uruguay,11,13,,24,-77.35600000000001,0.81488
57401,2018,Septiembre,Uruguay,21,22,,43,-75.527794,10.406342
57402,2018,Septiembre,Uruguay,148,119,,267,-75.516486,10.446304
57403,2018,Septiembre,Uruguay,12,9,,21,-74.77647900000001,10.886686
57404,2018,Septiembre,Uruguay,0,1,,1,-72.129595,11.360028999999999
57405,2018,Septiembre,Uruguay,23,24,,47,-81.70216500000001,12.5862
57406,2018,Septiembre,Uruguay,7,26,,33,-76.532004,3.451668
57407,2018,Septiembre,Uruguay,467,602,,1069,-74.140516,4.697157
57408,2018,Septiembre,Uruguay,0,4,,4,-75.736374,4.815189
57409,2018,Septiembre,Uruguay,37,57,,94,-75.42726,6.170465
57410,2018,Septiembre,Uruguay,0,1,,1,-70.74025300000001,7.088728999999999
57411,2018,Septiembre,Uruguay,3,8,,11,-72.453013,7.819
57412,2018,Septiembre,Uruguay,0,2,,2,-72.409396,8.36068
57413,2018,Septiembre,Uzbekistán,0,1,,1,-74.140516,4.697157
57414,2018,Septiembre,Venezuela,1,2,,3,-69.941498,4.191162
57415,2018,Septiembre,Venezuela,2,3,,5,-69.94143100000001,4.214082
57416,2018,Septiembre,Venezuela,0,1,,1,-74.78366,0.18595699999999998
57417,2018,Septiembre,Venezuela,58,98,,156,-76.876446,0.33002
57418,2018,Septiembre,Venezuela,3492,4012,,7504,-77.35600000000001,0.81488
57419,2018,Septiembre,Venezuela,2,1,,3,-78.802679,18.00143
57420,2018,Septiembre,Venezuela,16,28,,44,-75.527794,10.406342
57421,2018,Septiembre,Venezuela,203,225,,428,-75.516486,10.446304
57422,2018,Septiembre,Venezuela,116,180,,296,-74.77647900000001,10.886686
57423,2018,Septiembre,Venezuela,0,2,,2,-74.232675,11.117206
57424,2018,Septiembre,Venezuela,7874,7088,,14962,-72.129595,11.360028999999999
57425,2018,Septiembre,Venezuela,0,11,,11,-71.983761,12.165168
57426,2018,Septiembre,Venezuela,3,5,,8,-81.70216500000001,12.5862
57427,2018,Septiembre,Venezuela,118,124,,242,-76.532004,3.451668
57428,2018,Septiembre,Venezuela,5,9,,14,-67.927521,3.866713
57429,2018,Septiembre,Venezuela,3,3,,6,-75.76635300000001,4.45285
57430,2018,Septiembre,Venezuela,6755,6815,,13570,-74.140516,4.697157
57431,2018,Septiembre,Venezuela,8,12,,20,-75.736374,4.815189
57432,2018,Septiembre,Venezuela,839,955,,1794,-75.42726,6.170465
57433,2018,Septiembre,Venezuela,59,41,,100,-67.48402800000001,6.185536
57434,2018,Septiembre,Venezuela,0,4,,4,-75.586989,6.2188349999999994
57435,2018,Septiembre,Venezuela,1063,1037,,2100,-70.74025300000001,7.088728999999999
57436,2018,Septiembre,Venezuela,11,16,,27,-73.181317,7.1280470000000005
57437,2018,Septiembre,Venezuela,27880,24472,,52352,-72.453013,7.819
57438,2018,Septiembre,Venezuela,2703,2291,,4994,-72.409396,8.36068
57439,2018,Septiembre,Vietnam,6,4,,10,-75.516486,10.446304
57440,2018,Septiembre,Vietnam,11,14,,25,-74.140516,4.697157
57441,2018,Septiembre,Vietnam,1,0,,1,-75.42726,6.170465
57442,2018,Septiembre,República Árabe de Yemen,0,2,,2,-74.140516,4.697157
57443,2018,Septiembre,Zambia,0,1,,1,-75.516486,10.446304
57444,2018,Septiembre,Zambia,1,2,,3,-74.140516,4.697157
57445,2018,Septiembre,Zimbabue,0,1,,1,-76.532004,3.451668
57446,2018,Septiembre,Zimbabue,3,4,,7,-74.140516,4.697157
57447,2018,Septiembre,Zimbabue,0,1,,1,-75.42726,6.170465
57448,2018,Septiembre,Refugiado,4,7,,11,-74.140516,4.697157
57449,2018,Septiembre,Refugiado,1,1,,2,-75.42726,6.170465
57450,2018,Septiembre,Desconocido,3,8,,11,-75.516486,10.446304
57451,2018,Septiembre,Desconocido,1,0,,1,-76.532004,3.451668
57452,2018,Septiembre,Desconocido,90,154,,244,-74.140516,4.697157
57453,2018,Septiembre,Desconocido,1,7,,8,-75.42726,6.170465
57454,2018,Septiembre,Desconocido,1,0,,1,-73.181317,7.1280470000000005
57455,2018,Septiembre,Desconocido,1,0,,1,-72.453013,7.819
57456,2018,Octubre,Afganistán,0,1,,1,-74.140516,4.697157
57457,2018,Octubre,Albania,2,0,,2,-75.516486,10.446304
57458,2018,Octubre,Albania,0,1,,1,-76.532004,3.451668
57459,2018,Octubre,Albania,2,7,,9,-74.140516,4.697157
57460,2018,Octubre,Albania,0,2,,2,-75.42726,6.170465
57461,2018,Octubre,Albania,0,1,,1,-72.453013,7.819
57462,2018,Octubre,Alemania,5,7,,12,-69.941498,4.191162
57463,2018,Octubre,Alemania,1,1,,2,-69.94143100000001,4.214082
57464,2018,Octubre,Alemania,2,4,,6,-76.876446,0.33002
57465,2018,Octubre,Alemania,31,44,,75,-77.35600000000001,0.81488
57466,2018,Octubre,Alemania,32,38,,70,-75.527794,10.406342
57467,2018,Octubre,Alemania,126,169,,295,-75.516486,10.446304
57468,2018,Octubre,Alemania,25,15,,40,-74.77647900000001,10.886686
57469,2018,Octubre,Alemania,2,0,,2,-72.129595,11.360028999999999
57470,2018,Octubre,Alemania,3,0,,3,-81.70216500000001,12.5862
57471,2018,Octubre,Alemania,52,68,,120,-76.532004,3.451668
57472,2018,Octubre,Alemania,1,2,,3,-75.76635300000001,4.45285
57473,2018,Octubre,Alemania,1786,2647,,4433,-74.140516,4.697157
57474,2018,Octubre,Alemania,3,1,,4,-75.736374,4.815189
57475,2018,Octubre,Alemania,118,196,,314,-75.42726,6.170465
57476,2018,Octubre,Alemania,2,8,,10,-72.453013,7.819
57477,2018,Octubre,Alemania,0,1,,1,-72.409396,8.36068
57478,2018,Octubre,Alemania,8,13,,21,-77.35002,8.63337
57479,2018,Octubre,Andorra,2,6,,8,-74.140516,4.697157
57480,2018,Octubre,Andorra,1,0,,1,-75.42726,6.170465
57481,2018,Octubre,Angola,1,1,,2,-74.140516,4.697157
57482,2018,Octubre,Antigua y Barbuda,1,2,,3,-75.516486,10.446304
57483,2018,Octubre,Antigua y Barbuda,2,1,,3,-81.70216500000001,12.5862
57484,2018,Octubre,Antigua y Barbuda,4,2,,6,-74.140516,4.697157
57485,2018,Octubre,Antigua y Barbuda,0,1,,1,-75.42726,6.170465
57486,2018,Octubre,Países Bajos,0,1,,1,-74.140516,4.697157
57487,2018,Octubre,Países Bajos,1,0,,1,-75.42726,6.170465
57488,2018,Octubre,Arabia Saudita,1,1,,2,-76.532004,3.451668
57489,2018,Octubre,Arabia Saudita,0,2,,2,-74.140516,4.697157
57490,2018,Octubre,Arabia Saudita,0,1,,1,-75.42726,6.170465
57491,2018,Octubre,Argelia,1,8,,9,-74.140516,4.697157
57492,2018,Octubre,Argelia,1,1,,2,-75.42726,6.170465
57493,2018,Octubre,Argentina,1,9,,10,-69.941498,4.191162
57494,2018,Octubre,Argentina,0,2,,2,-69.94143100000001,4.214082
57495,2018,Octubre,Argentina,7,14,,21,-76.876446,0.33002
57496,2018,Octubre,Argentina,61,92,,153,-77.35600000000001,0.81488
57497,2018,Octubre,Argentina,0,2,,2,-78.802679,18.00143
57498,2018,Octubre,Argentina,166,131,,297,-75.527794,10.406342
57499,2018,Octubre,Argentina,1223,1007,,2230,-75.516486,10.446304
57500,2018,Octubre,Argentina,30,78,,108,-74.77647900000001,10.886686
57501,2018,Octubre,Argentina,2,6,,8,-72.129595,11.360028999999999
57502,2018,Octubre,Argentina,290,241,,531,-81.70216500000001,12.5862
57503,2018,Octubre,Argentina,47,83,,130,-76.532004,3.451668
57504,2018,Octubre,Argentina,0,1,,1,-75.76635300000001,4.45285
57505,2018,Octubre,Argentina,2920,4416,,7336,-74.140516,4.697157
57506,2018,Octubre,Argentina,2,18,,20,-75.736374,4.815189
57507,2018,Octubre,Argentina,143,364,,507,-75.42726,6.170465
57508,2018,Octubre,Argentina,1,2,,3,-73.181317,7.1280470000000005
57509,2018,Octubre,Argentina,6,20,,26,-72.453013,7.819
57510,2018,Octubre,Argentina,1,0,,1,-72.409396,8.36068
57511,2018,Octubre,Argentina,0,2,,2,-77.35002,8.63337
57512,2018,Octubre,República de Armenia,4,1,,5,-74.140516,4.697157
57513,2018,Octubre,Australia,2,2,,4,-69.941498,4.191162
57514,2018,Octubre,Australia,1,3,,4,-69.94143100000001,4.214082
57515,2018,Octubre,Australia,13,26,,39,-77.35600000000001,0.81488
57516,2018,Octubre,Australia,12,18,,30,-75.527794,10.406342
57517,2018,Octubre,Australia,68,69,,137,-75.516486,10.446304
57518,2018,Octubre,Australia,8,21,,29,-74.77647900000001,10.886686
57519,2018,Octubre,Australia,0,1,,1,-72.129595,11.360028999999999
57520,2018,Octubre,Australia,7,6,,13,-76.532004,3.451668
57521,2018,Octubre,Australia,291,549,,840,-74.140516,4.697157
57522,2018,Octubre,Australia,32,98,,130,-75.42726,6.170465
57523,2018,Octubre,Australia,22,17,,39,-77.35002,8.63337
57524,2018,Octubre,Austria,0,1,,1,-69.941498,4.191162
57525,2018,Octubre,Austria,0,1,,1,-76.876446,0.33002
57526,2018,Octubre,Austria,1,0,,1,-77.84700600000001,0.8124359999999999
57527,2018,Octubre,Austria,3,5,,8,-77.35600000000001,0.81488
57528,2018,Octubre,Austria,3,5,,8,-75.527794,10.406342
57529,2018,Octubre,Austria,11,19,,30,-75.516486,10.446304
57530,2018,Octubre,Austria,0,4,,4,-74.77647900000001,10.886686
57531,2018,Octubre,Austria,2,2,,4,-74.213989,11.247722999999999
57532,2018,Octubre,Austria,0,1,,1,-72.129595,11.360028999999999
57533,2018,Octubre,Austria,1,0,,1,-81.70216500000001,12.5862
57534,2018,Octubre,Austria,4,9,,13,-76.532004,3.451668
57535,2018,Octubre,Austria,184,285,,469,-74.140516,4.697157
57536,2018,Octubre,Austria,18,21,,39,-75.42726,6.170465
57537,2018,Octubre,Azerbaiyán,5,8,,13,-74.140516,4.697157
57538,2018,Octubre,Bahamas,4,10,,14,-75.516486,10.446304
57539,2018,Octubre,Bahamas,5,4,,9,-74.77647900000001,10.886686
57540,2018,Octubre,Bahamas,0,1,,1,-81.70216500000001,12.5862
57541,2018,Octubre,Bahamas,3,5,,8,-76.532004,3.451668
57542,2018,Octubre,Bahamas,8,8,,16,-74.140516,4.697157
57543,2018,Octubre,Bahamas,2,3,,5,-75.42726,6.170465
57544,2018,Octubre,Bahréin,1,0,,1,-74.140516,4.697157
57545,2018,Octubre,Bangladesh,0,2,,2,-75.516486,10.446304
57546,2018,Octubre,Barbados,8,7,,15,-75.516486,10.446304
57547,2018,Octubre,Barbados,2,3,,5,-74.77647900000001,10.886686
57548,2018,Octubre,Barbados,5,8,,13,-74.140516,4.697157
57549,2018,Octubre,Barbados,1,2,,3,-75.42726,6.170465
57550,2018,Octubre,República de Belarús,2,1,,3,-75.516486,10.446304
57551,2018,Octubre,República de Belarús,5,3,,8,-74.140516,4.697157
57552,2018,Octubre,Bélgica,3,2,,5,-69.941498,4.191162
57553,2018,Octubre,Bélgica,1,1,,2,-69.94143100000001,4.214082
57554,2018,Octubre,Bélgica,0,2,,2,-76.876446,0.33002
57555,2018,Octubre,Bélgica,5,6,,11,-77.35600000000001,0.81488
57556,2018,Octubre,Bélgica,2,2,,4,-75.527794,10.406342
57557,2018,Octubre,Bélgica,24,41,,65,-75.516486,10.446304
57558,2018,Octubre,Bélgica,1,3,,4,-74.77647900000001,10.886686
57559,2018,Octubre,Bélgica,2,1,,3,-74.213989,11.247722999999999
57560,2018,Octubre,Bélgica,1,0,,1,-81.70216500000001,12.5862
57561,2018,Octubre,Bélgica,9,22,,31,-76.532004,3.451668
57562,2018,Octubre,Bélgica,267,416,,683,-74.140516,4.697157
57563,2018,Octubre,Bélgica,1,3,,4,-75.736374,4.815189
57564,2018,Octubre,Bélgica,19,54,,73,-75.42726,6.170465
57565,2018,Octubre,Bélgica,0,2,,2,-73.181317,7.1280470000000005
57566,2018,Octubre,Bélgica,2,0,,2,-77.35002,8.63337
57567,2018,Octubre,Belice,2,6,,8,-75.516486,10.446304
57568,2018,Octubre,Belice,2,2,,4,-76.532004,3.451668
57569,2018,Octubre,Belice,9,16,,25,-74.140516,4.697157
57570,2018,Octubre,Belice,0,4,,4,-75.42726,6.170465
57571,2018,Octubre,Benín,2,0,,2,-74.77647900000001,10.886686
57572,2018,Octubre,Benín,0,6,,6,-74.140516,4.697157
57573,2018,Octubre,Benín,0,2,,2,-75.42726,6.170465
57574,2018,Octubre,Bermudas/Territorio Británico de Ultramar,0,5,,5,-75.516486,10.446304
57575,2018,Octubre,Bolivia,10,9,,19,-77.35600000000001,0.81488
57576,2018,Octubre,Bolivia,23,11,,34,-75.527794,10.406342
57577,2018,Octubre,Bolivia,123,113,,236,-75.516486,10.446304
57578,2018,Octubre,Bolivia,2,16,,18,-74.77647900000001,10.886686
57579,2018,Octubre,Bolivia,0,1,,1,-72.129595,11.360028999999999
57580,2018,Octubre,Bolivia,31,18,,49,-81.70216500000001,12.5862
57581,2018,Octubre,Bolivia,31,24,,55,-76.532004,3.451668
57582,2018,Octubre,Bolivia,515,623,,1138,-74.140516,4.697157
57583,2018,Octubre,Bolivia,1,0,,1,-75.736374,4.815189
57584,2018,Octubre,Bolivia,47,51,,98,-75.42726,6.170465
57585,2018,Octubre,Bolivia,1,0,,1,-70.74025300000001,7.088728999999999
57586,2018,Octubre,Bolivia,1,3,,4,-72.453013,7.819
57587,2018,Octubre,Bolivia,0,1,,1,-72.409396,8.36068
57588,2018,Octubre,Bosnia y Herzegovina,3,7,,10,-74.140516,4.697157
57589,2018,Octubre,Botsuana,1,0,,1,-74.140516,4.697157
57590,2018,Octubre,Brasil,90,108,,198,-69.941498,4.191162
57591,2018,Octubre,Brasil,2,1,,3,-69.94143100000001,4.214082
57592,2018,Octubre,Brasil,0,2,,2,-76.876446,0.33002
57593,2018,Octubre,Brasil,25,39,,64,-77.35600000000001,0.81488
57594,2018,Octubre,Brasil,435,354,,789,-75.527794,10.406342
57595,2018,Octubre,Brasil,667,571,,1238,-75.516486,10.446304
57596,2018,Octubre,Brasil,16,37,,53,-74.77647900000001,10.886686
57597,2018,Octubre,Brasil,0,1,,1,-74.213989,11.247722999999999
57598,2018,Octubre,Brasil,0,3,,3,-72.129595,11.360028999999999
57599,2018,Octubre,Brasil,177,143,,320,-81.70216500000001,12.5862
57600,2018,Octubre,Brasil,49,83,,132,-76.532004,3.451668
57601,2018,Octubre,Brasil,1,2,,3,-67.927521,3.866713
57602,2018,Octubre,Brasil,1,1,,2,-75.76635300000001,4.45285
57603,2018,Octubre,Brasil,5956,7143,,13099,-74.140516,4.697157
57604,2018,Octubre,Brasil,5,4,,9,-75.736374,4.815189
57605,2018,Octubre,Brasil,134,223,,357,-75.42726,6.170465
57606,2018,Octubre,Brasil,1,0,,1,-67.48402800000001,6.185536
57607,2018,Octubre,Brasil,0,2,,2,-73.181317,7.1280470000000005
57608,2018,Octubre,Brasil,3,7,,10,-72.453013,7.819
57609,2018,Octubre,Brasil,0,2,,2,-72.409396,8.36068
57610,2018,Octubre,Brasil,0,2,,2,-77.35002,8.63337
57611,2018,Octubre,Brunei Darussalam,1,0,,1,-75.516486,10.446304
57612,2018,Octubre,Brunei Darussalam,1,0,,1,-74.140516,4.697157
57613,2018,Octubre,Bulgaria,2,2,,4,-77.35600000000001,0.81488
57614,2018,Octubre,Bulgaria,0,1,,1,-75.527794,10.406342
57615,2018,Octubre,Bulgaria,9,3,,12,-75.516486,10.446304
57616,2018,Octubre,Bulgaria,35,44,,79,-74.140516,4.697157
57617,2018,Octubre,Bulgaria,0,4,,4,-75.42726,6.170465
57618,2018,Octubre,Burundi,0,1,,1,-74.140516,4.697157
57619,2018,Octubre,Cabo Verde,1,0,,1,-76.532004,3.451668
57620,2018,Octubre,Islas Caimán/Territorio Británico de Ultramar,2,0,,2,-75.516486,10.446304
57621,2018,Octubre,Camerún,0,1,,1,-75.516486,10.446304
57622,2018,Octubre,Camerún,0,1,,1,-76.532004,3.451668
57623,2018,Octubre,Camerún,3,7,,10,-74.140516,4.697157
57624,2018,Octubre,Camerún,1,2,,3,-75.42726,6.170465
57625,2018,Octubre,Canadá,2,2,,4,-69.941498,4.191162
57626,2018,Octubre,Canadá,1,3,,4,-76.876446,0.33002
57627,2018,Octubre,Canadá,9,9,,18,-77.35600000000001,0.81488
57628,2018,Octubre,Canadá,16,12,,28,-75.527794,10.406342
57629,2018,Octubre,Canadá,217,291,,508,-75.516486,10.446304
57630,2018,Octubre,Canadá,18,38,,56,-74.77647900000001,10.886686
57631,2018,Octubre,Canadá,3,6,,9,-74.213989,11.247722999999999
57632,2018,Octubre,Canadá,2,2,,4,-81.70216500000001,12.5862
57633,2018,Octubre,Canadá,36,70,,106,-76.532004,3.451668
57634,2018,Octubre,Canadá,0,1,,1,-75.76635300000001,4.45285
57635,2018,Octubre,Canadá,939,1683,,2622,-74.140516,4.697157
57636,2018,Octubre,Canadá,7,14,,21,-75.736374,4.815189
57637,2018,Octubre,Canadá,138,368,,506,-75.42726,6.170465
57638,2018,Octubre,Canadá,2,6,,8,-73.181317,7.1280470000000005
57639,2018,Octubre,Canadá,3,6,,9,-72.453013,7.819
57640,2018,Octubre,Canadá,2,7,,9,-77.35002,8.63337
57641,2018,Octubre,República Democrática del Congo,0,1,,1,-75.516486,10.446304
57642,2018,Octubre,República Democrática del Congo,2,5,,7,-74.140516,4.697157
57643,2018,Octubre,República Democrática del Congo,0,1,,1,-72.453013,7.819
57644,2018,Octubre,República de Corea,0,1,,1,-69.94143100000001,4.214082
57645,2018,Octubre,República de Corea,3,6,,9,-77.35600000000001,0.81488
57646,2018,Octubre,República de Corea,5,7,,12,-75.516486,10.446304
57647,2018,Octubre,República de Corea,1,36,,37,-74.77647900000001,10.886686
57648,2018,Octubre,República de Corea,0,1,,1,-81.70216500000001,12.5862
57649,2018,Octubre,República de Corea,2,3,,5,-76.532004,3.451668
57650,2018,Octubre,República de Corea,0,1,,1,-75.76635300000001,4.45285
57651,2018,Octubre,República de Corea,220,427,,647,-74.140516,4.697157
57652,2018,Octubre,República de Corea,11,33,,44,-75.42726,6.170465
57653,2018,Octubre,República de Corea,0,1,,1,-72.453013,7.819
57654,2018,Octubre,República de Corea,0,1,,1,-72.409396,8.36068
57655,2018,Octubre,Costa de Marfil,0,1,,1,-76.532004,3.451668
57656,2018,Octubre,Costa de Marfil,0,1,,1,-74.140516,4.697157
57657,2018,Octubre,Costa Rica,0,1,,1,-76.876446,0.33002
57658,2018,Octubre,Costa Rica,1,6,,7,-77.35600000000001,0.81488
57659,2018,Octubre,Costa Rica,0,2,,2,-75.527794,10.406342
57660,2018,Octubre,Costa Rica,172,146,,318,-75.516486,10.446304
57661,2018,Octubre,Costa Rica,21,23,,44,-74.77647900000001,10.886686
57662,2018,Octubre,Costa Rica,0,1,,1,-81.703935,12.574411099999999
57663,2018,Octubre,Costa Rica,12,12,,24,-81.70216500000001,12.5862
57664,2018,Octubre,Costa Rica,55,56,,111,-76.532004,3.451668
57665,2018,Octubre,Costa Rica,1292,1727,,3019,-74.140516,4.697157
57666,2018,Octubre,Costa Rica,3,8,,11,-75.736374,4.815189
57667,2018,Octubre,Costa Rica,142,205,,347,-75.42726,6.170465
57668,2018,Octubre,Costa Rica,2,1,,3,-73.181317,7.1280470000000005
57669,2018,Octubre,Costa Rica,1,2,,3,-72.453013,7.819
57670,2018,Octubre,Costa Rica,2,0,,2,-72.409396,8.36068
57671,2018,Octubre,Costa Rica,0,1,,1,-77.35002,8.63337
57672,2018,Octubre,Croacia,1,1,,2,-75.527794,10.406342
57673,2018,Octubre,Croacia,1,1,,2,-75.516486,10.446304
57674,2018,Octubre,Croacia,2,2,,4,-76.532004,3.451668
57675,2018,Octubre,Croacia,15,48,,63,-74.140516,4.697157
57676,2018,Octubre,Croacia,2,7,,9,-75.42726,6.170465
57677,2018,Octubre,Cuba,0,2,,2,-77.35600000000001,0.81488
57678,2018,Octubre,Cuba,0,13,,13,-75.527794,10.406342
57679,2018,Octubre,Cuba,14,39,,53,-75.516486,10.446304
57680,2018,Octubre,Cuba,11,27,,38,-74.77647900000001,10.886686
57681,2018,Octubre,Cuba,1,1,,2,-81.70216500000001,12.5862
57682,2018,Octubre,Cuba,32,34,,66,-76.532004,3.451668
57683,2018,Octubre,Cuba,0,1,,1,-75.76635300000001,4.45285
57684,2018,Octubre,Cuba,180,276,,456,-74.140516,4.697157
57685,2018,Octubre,Cuba,2,2,,4,-75.736374,4.815189
57686,2018,Octubre,Cuba,24,32,,56,-75.42726,6.170465
57687,2018,Octubre,Cuba,2,2,,4,-73.181317,7.1280470000000005
57688,2018,Octubre,Cuba,2,2,,4,-72.453013,7.819
57689,2018,Octubre,Curazao,0,1,,1,-74.140516,4.697157
57690,2018,Octubre,República Checa,0,1,,1,-69.941498,4.191162
57691,2018,Octubre,República Checa,1,8,,9,-77.35600000000001,0.81488
57692,2018,Octubre,República Checa,1,2,,3,-75.527794,10.406342
57693,2018,Octubre,República Checa,2,11,,13,-75.516486,10.446304
57694,2018,Octubre,República Checa,0,26,,26,-74.77647900000001,10.886686
57695,2018,Octubre,República Checa,1,5,,6,-76.532004,3.451668
57696,2018,Octubre,República Checa,50,101,,151,-74.140516,4.697157
57697,2018,Octubre,República Checa,6,12,,18,-75.42726,6.170465
57698,2018,Octubre,República Checa,0,1,,1,-77.35002,8.63337
57699,2018,Octubre,Chile,2,1,,3,-69.941498,4.191162
57700,2018,Octubre,Chile,1,2,,3,-69.94143100000001,4.214082
57701,2018,Octubre,Chile,2,3,,5,-76.876446,0.33002
57702,2018,Octubre,Chile,31,60,,91,-77.35600000000001,0.81488
57703,2018,Octubre,Chile,0,1,,1,-78.802679,18.00143
57704,2018,Octubre,Chile,70,48,,118,-75.527794,10.406342
57705,2018,Octubre,Chile,595,490,,1085,-75.516486,10.446304
57706,2018,Octubre,Chile,10,21,,31,-74.77647900000001,10.886686
57707,2018,Octubre,Chile,3,4,,7,-72.129595,11.360028999999999
57708,2018,Octubre,Chile,0,1,,1,-81.703935,12.574411099999999
57709,2018,Octubre,Chile,178,120,,298,-81.70216500000001,12.5862
57710,2018,Octubre,Chile,29,64,,93,-76.532004,3.451668
57711,2018,Octubre,Chile,0,1,,1,-75.76635300000001,4.45285
57712,2018,Octubre,Chile,4439,5552,,9991,-74.140516,4.697157
57713,2018,Octubre,Chile,1,6,,7,-75.736374,4.815189
57714,2018,Octubre,Chile,57,150,,207,-75.42726,6.170465
57715,2018,Octubre,Chile,0,1,,1,-70.74025300000001,7.088728999999999
57716,2018,Octubre,Chile,15,32,,47,-72.453013,7.819
57717,2018,Octubre,Chile,6,8,,14,-72.409396,8.36068
57718,2018,Octubre,Chile,2,2,,4,-77.35002,8.63337
57719,2018,Octubre,China,7,8,,15,-77.35600000000001,0.81488
57720,2018,Octubre,China,1,5,,6,-75.527794,10.406342
57721,2018,Octubre,China,17,31,,48,-75.516486,10.446304
57722,2018,Octubre,China,3,9,,12,-74.77647900000001,10.886686
57723,2018,Octubre,China,0,2,,2,-74.213989,11.247722999999999
57724,2018,Octubre,China,0,2,,2,-72.129595,11.360028999999999
57725,2018,Octubre,China,12,16,,28,-76.532004,3.451668
57726,2018,Octubre,China,0,1,,1,-77.061029,3.8844260000000004
57727,2018,Octubre,China,310,762,,1072,-74.140516,4.697157
57728,2018,Octubre,China,3,2,,5,-75.736374,4.815189
57729,2018,Octubre,China,22,55,,77,-75.42726,6.170465
57730,2018,Octubre,China,2,2,,4,-72.453013,7.819
57731,2018,Octubre,China,1,1,,2,-72.409396,8.36068
57732,2018,Octubre,Taiwán,2,1,,3,-77.35600000000001,0.81488
57733,2018,Octubre,Taiwán,2,3,,5,-75.516486,10.446304
57734,2018,Octubre,Taiwán,2,1,,3,-74.77647900000001,10.886686
57735,2018,Octubre,Taiwán,0,1,,1,-76.532004,3.451668
57736,2018,Octubre,Taiwán,53,105,,158,-74.140516,4.697157
57737,2018,Octubre,Taiwán,0,1,,1,-75.736374,4.815189
57738,2018,Octubre,Taiwán,6,13,,19,-75.42726,6.170465
57739,2018,Octubre,Taiwán,0,1,,1,-72.453013,7.819
57740,2018,Octubre,Chipre,1,0,,1,-75.516486,10.446304
57741,2018,Octubre,Chipre,0,1,,1,-76.532004,3.451668
57742,2018,Octubre,Chipre,6,12,,18,-74.140516,4.697157
57743,2018,Octubre,Chipre,0,1,,1,-75.42726,6.170465
57744,2018,Octubre,Dinamarca,2,3,,5,-69.941498,4.191162
57745,2018,Octubre,Dinamarca,1,1,,2,-77.35600000000001,0.81488
57746,2018,Octubre,Dinamarca,1,2,,3,-75.527794,10.406342
57747,2018,Octubre,Dinamarca,15,32,,47,-75.516486,10.446304
57748,2018,Octubre,Dinamarca,0,2,,2,-74.77647900000001,10.886686
57749,2018,Octubre,Dinamarca,3,1,,4,-74.213989,11.247722999999999
57750,2018,Octubre,Dinamarca,4,10,,14,-76.532004,3.451668
57751,2018,Octubre,Dinamarca,60,174,,234,-74.140516,4.697157
57752,2018,Octubre,Dinamarca,0,1,,1,-75.736374,4.815189
57753,2018,Octubre,Dinamarca,9,29,,38,-75.42726,6.170465
57754,2018,Octubre,Dinamarca,3,1,,4,-77.35002,8.63337
57755,2018,Octubre,Dominica,1,0,,1,-76.532004,3.451668
57756,2018,Octubre,Dominica,3,1,,4,-74.140516,4.697157
57757,2018,Octubre,Dominica,0,3,,3,-75.42726,6.170465
57758,2018,Octubre,Ecuador,2,6,,8,-69.941498,4.191162
57759,2018,Octubre,Ecuador,0,1,,1,-69.94143100000001,4.214082
57760,2018,Octubre,Ecuador,63,240,,303,-76.876446,0.33002
57761,2018,Octubre,Ecuador,3,8,,11,-77.84700600000001,0.8124359999999999
57762,2018,Octubre,Ecuador,1540,2152,,3692,-77.35600000000001,0.81488
57763,2018,Octubre,Ecuador,18,64,,82,-78.802679,18.00143
57764,2018,Octubre,Ecuador,7,10,,17,-75.527794,10.406342
57765,2018,Octubre,Ecuador,60,83,,143,-75.516486,10.446304
57766,2018,Octubre,Ecuador,18,30,,48,-74.77647900000001,10.886686
57767,2018,Octubre,Ecuador,7,8,,15,-72.129595,11.360028999999999
57768,2018,Octubre,Ecuador,22,17,,39,-81.70216500000001,12.5862
57769,2018,Octubre,Ecuador,593,603,,1196,-76.532004,3.451668
57770,2018,Octubre,Ecuador,0,1,,1,-67.927521,3.866713
57771,2018,Octubre,Ecuador,0,2,,2,-75.76635300000001,4.45285
57772,2018,Octubre,Ecuador,3365,4429,,7794,-74.140516,4.697157
57773,2018,Octubre,Ecuador,2,2,,4,-75.736374,4.815189
57774,2018,Octubre,Ecuador,54,97,,151,-75.42726,6.170465
57775,2018,Octubre,Ecuador,3,4,,7,-70.74025300000001,7.088728999999999
57776,2018,Octubre,Ecuador,1,1,,2,-73.181317,7.1280470000000005
57777,2018,Octubre,Ecuador,81,105,,186,-72.453013,7.819
57778,2018,Octubre,Ecuador,7,18,,25,-72.409396,8.36068
57779,2018,Octubre,Egipto,2,2,,4,-75.516486,10.446304
57780,2018,Octubre,Egipto,0,1,,1,-74.77647900000001,10.886686
57781,2018,Octubre,Egipto,0,2,,2,-76.532004,3.451668
57782,2018,Octubre,Egipto,8,22,,30,-74.140516,4.697157
57783,2018,Octubre,Egipto,1,3,,4,-75.42726,6.170465
57784,2018,Octubre,El Salvador,2,4,,6,-77.35600000000001,0.81488
57785,2018,Octubre,El Salvador,0,1,,1,-75.527794,10.406342
57786,2018,Octubre,El Salvador,80,58,,138,-75.516486,10.446304
57787,2018,Octubre,El Salvador,8,28,,36,-74.77647900000001,10.886686
57788,2018,Octubre,El Salvador,125,140,,265,-76.532004,3.451668
57789,2018,Octubre,El Salvador,756,977,,1733,-74.140516,4.697157
57790,2018,Octubre,El Salvador,2,0,,2,-75.736374,4.815189
57791,2018,Octubre,El Salvador,160,157,,317,-75.42726,6.170465
57792,2018,Octubre,El Salvador,0,2,,2,-73.181317,7.1280470000000005
57793,2018,Octubre,El Salvador,2,1,,3,-72.453013,7.819
57794,2018,Octubre,Emiratos Árabes,0,3,,3,-75.516486,10.446304
57795,2018,Octubre,Emiratos Árabes,0,14,,14,-74.140516,4.697157
57796,2018,Octubre,Emiratos Árabes,0,2,,2,-75.42726,6.170465
57797,2018,Octubre,España,10,8,,18,-69.941498,4.191162
57798,2018,Octubre,España,2,2,,4,-69.94143100000001,4.214082
57799,2018,Octubre,España,2,4,,6,-76.876446,0.33002
57800,2018,Octubre,España,0,1,,1,-77.84700600000001,0.8124359999999999
57801,2018,Octubre,España,41,35,,76,-77.35600000000001,0.81488
57802,2018,Octubre,España,6,15,,21,-75.527794,10.406342
57803,2018,Octubre,España,101,195,,296,-75.516486,10.446304
57804,2018,Octubre,España,15,41,,56,-74.77647900000001,10.886686
57805,2018,Octubre,España,1,0,,1,-74.232675,11.117206
57806,2018,Octubre,España,1,1,,2,-74.213989,11.247722999999999
57807,2018,Octubre,España,3,8,,11,-72.129595,11.360028999999999
57808,2018,Octubre,España,5,6,,11,-81.70216500000001,12.5862
57809,2018,Octubre,España,203,427,,630,-76.532004,3.451668
57810,2018,Octubre,España,0,1,,1,-75.76635300000001,4.45285
57811,2018,Octubre,España,3181,6373,,9554,-74.140516,4.697157
57812,2018,Octubre,España,6,18,,24,-75.736374,4.815189
57813,2018,Octubre,España,348,622,,970,-75.42726,6.170465
57814,2018,Octubre,España,0,1,,1,-67.48402800000001,6.185536
57815,2018,Octubre,España,1,1,,2,-70.74025300000001,7.088728999999999
57816,2018,Octubre,España,1,2,,3,-73.181317,7.1280470000000005
57817,2018,Octubre,España,21,42,,63,-72.453013,7.819
57818,2018,Octubre,España,4,5,,9,-72.409396,8.36068
57819,2018,Octubre,España,1,4,,5,-77.35002,8.63337
57820,2018,Octubre,Eritrea,0,4,,4,-74.140516,4.697157
57821,2018,Octubre,Eslovaquia,0,1,,1,-69.941498,4.191162
57822,2018,Octubre,Eslovaquia,0,1,,1,-76.876446,0.33002
57823,2018,Octubre,Eslovaquia,0,1,,1,-77.35600000000001,0.81488
57824,2018,Octubre,Eslovaquia,0,1,,1,-75.527794,10.406342
57825,2018,Octubre,Eslovaquia,1,4,,5,-75.516486,10.446304
57826,2018,Octubre,Eslovaquia,2,1,,3,-74.77647900000001,10.886686
57827,2018,Octubre,Eslovaquia,0,1,,1,-76.532004,3.451668
57828,2018,Octubre,Eslovaquia,45,46,,91,-74.140516,4.697157
57829,2018,Octubre,Eslovaquia,1,3,,4,-75.42726,6.170465
57830,2018,Octubre,Eslovenia,1,0,,1,-76.876446,0.33002
57831,2018,Octubre,Eslovenia,1,1,,2,-75.527794,10.406342
57832,2018,Octubre,Eslovenia,0,1,,1,-75.516486,10.446304
57833,2018,Octubre,Eslovenia,24,36,,60,-74.140516,4.697157
57834,2018,Octubre,Eslovenia,1,7,,8,-75.42726,6.170465
57835,2018,Octubre,Estados Unidos de América,11,35,,46,-69.941498,4.191162
57836,2018,Octubre,Estados Unidos de América,8,6,,14,-69.94143100000001,4.214082
57837,2018,Octubre,Estados Unidos de América,5,2,,7,-76.876446,0.33002
57838,2018,Octubre,Estados Unidos de América,54,54,,108,-77.35600000000001,0.81488
57839,2018,Octubre,Estados Unidos de América,25,65,,90,-75.527794,10.406342
57840,2018,Octubre,Estados Unidos de América,3531,5193,,8724,-75.516486,10.446304
57841,2018,Octubre,Estados Unidos de América,499,922,,1421,-74.77647900000001,10.886686
57842,2018,Octubre,Estados Unidos de América,1,0,,1,-74.232675,11.117206
57843,2018,Octubre,Estados Unidos de América,4,10,,14,-74.213989,11.247722999999999
57844,2018,Octubre,Estados Unidos de América,2,5,,7,-72.129595,11.360028999999999
57845,2018,Octubre,Estados Unidos de América,1,7,,8,-81.703935,12.574411099999999
57846,2018,Octubre,Estados Unidos de América,20,42,,62,-81.70216500000001,12.5862
57847,2018,Octubre,Estados Unidos de América,918,1470,,2388,-76.532004,3.451668
57848,2018,Octubre,Estados Unidos de América,1,16,,17,-77.061029,3.8844260000000004
57849,2018,Octubre,Estados Unidos de América,108,190,,298,-75.76635300000001,4.45285
57850,2018,Octubre,Estados Unidos de América,7422,13811,,21233,-74.140516,4.697157
57851,2018,Octubre,Estados Unidos de América,115,176,,291,-75.736374,4.815189
57852,2018,Octubre,Estados Unidos de América,2222,6244,,8466,-75.42726,6.170465
57853,2018,Octubre,Estados Unidos de América,0,2,,2,-67.48402800000001,6.185536
57854,2018,Octubre,Estados Unidos de América,29,43,,72,-73.181317,7.1280470000000005
57855,2018,Octubre,Estados Unidos de América,10,9,,19,-72.453013,7.819
57856,2018,Octubre,Estados Unidos de América,1,4,,5,-72.508188,7.927233
57857,2018,Octubre,Estados Unidos de América,4,7,,11,-72.409396,8.36068
57858,2018,Octubre,Estados Unidos de América,5,17,,22,-77.35002,8.63337
57859,2018,Octubre,Estonia,1,1,,2,-77.35600000000001,0.81488
57860,2018,Octubre,Estonia,3,1,,4,-75.516486,10.446304
57861,2018,Octubre,Estonia,10,10,,20,-74.140516,4.697157
57862,2018,Octubre,Estonia,0,1,,1,-75.42726,6.170465
57863,2018,Octubre,Etiopia,0,1,,1,-74.77647900000001,10.886686
57864,2018,Octubre,Etiopia,2,41,,43,-74.140516,4.697157
57865,2018,Octubre,Etiopia,0,1,,1,-75.42726,6.170465
57866,2018,Octubre,Filipinas,0,2,,2,-77.35600000000001,0.81488
57867,2018,Octubre,Filipinas,1,40,,41,-75.527794,10.406342
57868,2018,Octubre,Filipinas,9,59,,68,-75.516486,10.446304
57869,2018,Octubre,Filipinas,0,15,,15,-74.77647900000001,10.886686
57870,2018,Octubre,Filipinas,0,11,,11,-74.765343,10.970933
57871,2018,Octubre,Filipinas,0,14,,14,-74.213989,11.247722999999999
57872,2018,Octubre,Filipinas,0,1,,1,-81.70216500000001,12.5862
57873,2018,Octubre,Filipinas,4,2,,6,-76.532004,3.451668
57874,2018,Octubre,Filipinas,0,2,,2,-77.061029,3.8844260000000004
57875,2018,Octubre,Filipinas,52,83,,135,-74.140516,4.697157
57876,2018,Octubre,Filipinas,4,6,,10,-75.42726,6.170465
57877,2018,Octubre,Filipinas,1,0,,1,-72.409396,8.36068
57878,2018,Octubre,Filipinas,0,9,,9,-75.68164200000001,9.402597
57879,2018,Octubre,Finlandia,1,1,,2,-77.35600000000001,0.81488
57880,2018,Octubre,Finlandia,2,1,,3,-75.527794,10.406342
57881,2018,Octubre,Finlandia,4,9,,13,-75.516486,10.446304
57882,2018,Octubre,Finlandia,1,0,,1,-74.77647900000001,10.886686
57883,2018,Octubre,Finlandia,3,6,,9,-76.532004,3.451668
57884,2018,Octubre,Finlandia,50,72,,122,-74.140516,4.697157
57885,2018,Octubre,Finlandia,0,1,,1,-75.736374,4.815189
57886,2018,Octubre,Finlandia,5,13,,18,-75.42726,6.170465
57887,2018,Octubre,Francia,3,8,,11,-69.941498,4.191162
57888,2018,Octubre,Francia,2,4,,6,-69.94143100000001,4.214082
57889,2018,Octubre,Francia,0,1,,1,-76.876446,0.33002
57890,2018,Octubre,Francia,41,59,,100,-77.35600000000001,0.81488
57891,2018,Octubre,Francia,2,17,,19,-75.527794,10.406342
57892,2018,Octubre,Francia,102,152,,254,-75.516486,10.446304
57893,2018,Octubre,Francia,15,20,,35,-74.77647900000001,10.886686
57894,2018,Octubre,Francia,4,5,,9,-74.213989,11.247722999999999
57895,2018,Octubre,Francia,1,8,,9,-72.129595,11.360028999999999
57896,2018,Octubre,Francia,7,4,,11,-81.70216500000001,12.5862
57897,2018,Octubre,Francia,46,126,,172,-76.532004,3.451668
57898,2018,Octubre,Francia,1779,2782,,4561,-74.140516,4.697157
57899,2018,Octubre,Francia,3,5,,8,-75.736374,4.815189
57900,2018,Octubre,Francia,101,240,,341,-75.42726,6.170465
57901,2018,Octubre,Francia,1,2,,3,-73.181317,7.1280470000000005
57902,2018,Octubre,Francia,5,6,,11,-72.453013,7.819
57903,2018,Octubre,Francia,1,7,,8,-77.35002,8.63337
57904,2018,Octubre,Francia,0,1,,1,-75.68164200000001,9.402597
57905,2018,Octubre,Gabón,0,1,,1,-74.140516,4.697157
57906,2018,Octubre,Georgia,0,2,,2,-74.77647900000001,10.886686
57907,2018,Octubre,Georgia,0,2,,2,-76.532004,3.451668
57908,2018,Octubre,Georgia,0,2,,2,-74.140516,4.697157
57909,2018,Octubre,Georgia,0,2,,2,-75.42726,6.170465
57910,2018,Octubre,Ghana,0,2,,2,-77.35600000000001,0.81488
57911,2018,Octubre,Ghana,3,3,,6,-76.532004,3.451668
57912,2018,Octubre,Ghana,7,8,,15,-74.140516,4.697157
57913,2018,Octubre,Granada,2,0,,2,-75.516486,10.446304
57914,2018,Octubre,Granada,1,1,,2,-74.140516,4.697157
57915,2018,Octubre,Grecia,0,4,,4,-75.527794,10.406342
57916,2018,Octubre,Grecia,0,16,,16,-75.516486,10.446304
57917,2018,Octubre,Grecia,0,2,,2,-74.77647900000001,10.886686
57918,2018,Octubre,Grecia,0,4,,4,-74.213989,11.247722999999999
57919,2018,Octubre,Grecia,1,5,,6,-76.532004,3.451668
57920,2018,Octubre,Grecia,40,82,,122,-74.140516,4.697157
57921,2018,Octubre,Grecia,3,7,,10,-75.42726,6.170465
57922,2018,Octubre,Guatemala,0,1,,1,-76.876446,0.33002
57923,2018,Octubre,Guatemala,0,3,,3,-77.35600000000001,0.81488
57924,2018,Octubre,Guatemala,0,2,,2,-75.527794,10.406342
57925,2018,Octubre,Guatemala,141,185,,326,-75.516486,10.446304
57926,2018,Octubre,Guatemala,13,46,,59,-74.77647900000001,10.886686
57927,2018,Octubre,Guatemala,2,1,,3,-81.70216500000001,12.5862
57928,2018,Octubre,Guatemala,45,86,,131,-76.532004,3.451668
57929,2018,Octubre,Guatemala,465,901,,1366,-74.140516,4.697157
57930,2018,Octubre,Guatemala,4,4,,8,-75.736374,4.815189
57931,2018,Octubre,Guatemala,55,146,,201,-75.42726,6.170465
57932,2018,Octubre,Guatemala,0,1,,1,-70.74025300000001,7.088728999999999
57933,2018,Octubre,Guatemala,0,2,,2,-73.181317,7.1280470000000005
57934,2018,Octubre,Guatemala,0,1,,1,-72.453013,7.819
57935,2018,Octubre,Guatemala,1,0,,1,-72.409396,8.36068
57936,2018,Octubre,Guyana,2,4,,6,-75.516486,10.446304
57937,2018,Octubre,Guyana,1,0,,1,-74.77647900000001,10.886686
57938,2018,Octubre,Guyana,1,1,,2,-76.532004,3.451668
57939,2018,Octubre,Guyana,11,12,,23,-74.140516,4.697157
57940,2018,Octubre,Guyana,1,0,,1,-75.736374,4.815189
57941,2018,Octubre,Guyana,0,2,,2,-75.42726,6.170465
57942,2018,Octubre,Guyana,0,1,,1,-73.181317,7.1280470000000005
57943,2018,Octubre,Guyana,0,2,,2,-72.453013,7.819
57944,2018,Octubre,Guinea Ecuatorial,1,0,,1,-75.42726,6.170465
57945,2018,Octubre,Haití,0,2,,2,-77.35600000000001,0.81488
57946,2018,Octubre,Haití,0,3,,3,-75.516486,10.446304
57947,2018,Octubre,Haití,0,1,,1,-74.77647900000001,10.886686
57948,2018,Octubre,Haití,3,0,,3,-76.532004,3.451668
57949,2018,Octubre,Haití,14,28,,42,-74.140516,4.697157
57950,2018,Octubre,Haití,0,4,,4,-75.42726,6.170465
57951,2018,Octubre,Honduras,2,2,,4,-77.35600000000001,0.81488
57952,2018,Octubre,Honduras,0,4,,4,-75.527794,10.406342
57953,2018,Octubre,Honduras,214,160,,374,-75.516486,10.446304
57954,2018,Octubre,Honduras,27,30,,57,-74.77647900000001,10.886686
57955,2018,Octubre,Honduras,0,10,,10,-81.703935,12.574411099999999
57956,2018,Octubre,Honduras,3,4,,7,-81.70216500000001,12.5862
57957,2018,Octubre,Honduras,63,59,,122,-76.532004,3.451668
57958,2018,Octubre,Honduras,3,12,,15,-75.76635300000001,4.45285
57959,2018,Octubre,Honduras,358,363,,721,-74.140516,4.697157
57960,2018,Octubre,Honduras,5,6,,11,-75.736374,4.815189
57961,2018,Octubre,Honduras,73,80,,153,-75.42726,6.170465
57962,2018,Octubre,Honduras,0,2,,2,-73.181317,7.1280470000000005
57963,2018,Octubre,Honduras,0,2,,2,-72.453013,7.819
57964,2018,Octubre,Hong Kong,10,2,,12,-77.35600000000001,0.81488
57965,2018,Octubre,Hong Kong,0,1,,1,-75.516486,10.446304
57966,2018,Octubre,Hong Kong,6,17,,23,-74.140516,4.697157
57967,2018,Octubre,Hong Kong,0,1,,1,-75.42726,6.170465
57968,2018,Octubre,Hungría,2,1,,3,-77.35600000000001,0.81488
57969,2018,Octubre,Hungría,5,19,,24,-75.516486,10.446304
57970,2018,Octubre,Hungría,60,88,,148,-74.140516,4.697157
57971,2018,Octubre,Hungría,0,1,,1,-75.736374,4.815189
57972,2018,Octubre,Hungría,4,5,,9,-75.42726,6.170465
57973,2018,Octubre,India,0,3,,3,-77.35600000000001,0.81488
57974,2018,Octubre,India,1,13,,14,-75.527794,10.406342
57975,2018,Octubre,India,16,74,,90,-75.516486,10.446304
57976,2018,Octubre,India,3,10,,13,-74.77647900000001,10.886686
57977,2018,Octubre,India,1,1,,2,-81.70216500000001,12.5862
57978,2018,Octubre,India,3,20,,23,-76.532004,3.451668
57979,2018,Octubre,India,0,6,,6,-77.061029,3.8844260000000004
57980,2018,Octubre,India,79,435,,514,-74.140516,4.697157
57981,2018,Octubre,India,5,60,,65,-75.42726,6.170465
57982,2018,Octubre,India,0,7,,7,-75.68164200000001,9.402597
57983,2018,Octubre,Indonesia,0,2,,2,-75.527794,10.406342
57984,2018,Octubre,Indonesia,0,8,,8,-75.516486,10.446304
57985,2018,Octubre,Indonesia,0,2,,2,-76.532004,3.451668
57986,2018,Octubre,Indonesia,19,24,,43,-74.140516,4.697157
57987,2018,Octubre,Indonesia,2,0,,2,-75.42726,6.170465
57988,2018,Octubre,Iraq,0,1,,1,-74.140516,4.697157
57989,2018,Octubre,Irán,0,1,,1,-75.516486,10.446304
57990,2018,Octubre,Irán,1,13,,14,-74.140516,4.697157
57991,2018,Octubre,Irán,0,4,,4,-75.42726,6.170465
57992,2018,Octubre,República de Irlanda,8,9,,17,-77.35600000000001,0.81488
57993,2018,Octubre,República de Irlanda,9,11,,20,-75.527794,10.406342
57994,2018,Octubre,República de Irlanda,25,31,,56,-75.516486,10.446304
57995,2018,Octubre,República de Irlanda,1,2,,3,-74.77647900000001,10.886686
57996,2018,Octubre,República de Irlanda,1,1,,2,-74.213989,11.247722999999999
57997,2018,Octubre,República de Irlanda,0,1,,1,-72.129595,11.360028999999999
57998,2018,Octubre,República de Irlanda,0,1,,1,-81.70216500000001,12.5862
57999,2018,Octubre,República de Irlanda,4,5,,9,-76.532004,3.451668
58000,2018,Octubre,República de Irlanda,136,238,,374,-74.140516,4.697157
58001,2018,Octubre,República de Irlanda,9,32,,41,-75.42726,6.170465
58002,2018,Octubre,República de Irlanda,4,10,,14,-77.35002,8.63337
58003,2018,Octubre,Islandia,3,5,,8,-75.516486,10.446304
58004,2018,Octubre,Islandia,7,6,,13,-74.140516,4.697157
58005,2018,Octubre,Islandia,1,1,,2,-75.736374,4.815189
58006,2018,Octubre,Islandia,1,1,,2,-75.42726,6.170465
58007,2018,Octubre,Israel,0,1,,1,-69.941498,4.191162
58008,2018,Octubre,Israel,0,1,,1,-76.876446,0.33002
58009,2018,Octubre,Israel,11,9,,20,-77.35600000000001,0.81488
58010,2018,Octubre,Israel,0,1,,1,-75.527794,10.406342
58011,2018,Octubre,Israel,7,35,,42,-75.516486,10.446304
58012,2018,Octubre,Israel,1,3,,4,-74.77647900000001,10.886686
58013,2018,Octubre,Israel,0,1,,1,-81.70216500000001,12.5862
58014,2018,Octubre,Israel,1,11,,12,-76.532004,3.451668
58015,2018,Octubre,Israel,101,416,,517,-74.140516,4.697157
58016,2018,Octubre,Israel,0,1,,1,-75.736374,4.815189
58017,2018,Octubre,Israel,17,76,,93,-75.42726,6.170465
58018,2018,Octubre,Israel,1,1,,2,-77.35002,8.63337
58019,2018,Octubre,Italia,3,3,,6,-69.941498,4.191162
58020,2018,Octubre,Italia,1,4,,5,-69.94143100000001,4.214082
58021,2018,Octubre,Italia,0,3,,3,-76.876446,0.33002
58022,2018,Octubre,Italia,7,20,,27,-77.35600000000001,0.81488
58023,2018,Octubre,Italia,4,22,,26,-75.527794,10.406342
58024,2018,Octubre,Italia,82,178,,260,-75.516486,10.446304
58025,2018,Octubre,Italia,10,42,,52,-74.77647900000001,10.886686
58026,2018,Octubre,Italia,0,7,,7,-72.129595,11.360028999999999
58027,2018,Octubre,Italia,0,5,,5,-81.70216500000001,12.5862
58028,2018,Octubre,Italia,32,92,,124,-76.532004,3.451668
58029,2018,Octubre,Italia,686,1804,,2490,-74.140516,4.697157
58030,2018,Octubre,Italia,0,1,,1,-75.736374,4.815189
58031,2018,Octubre,Italia,53,229,,282,-75.42726,6.170465
58032,2018,Octubre,Italia,1,1,,2,-67.48402800000001,6.185536
58033,2018,Octubre,Italia,0,3,,3,-73.181317,7.1280470000000005
58034,2018,Octubre,Italia,13,25,,38,-72.453013,7.819
58035,2018,Octubre,Italia,0,1,,1,-76.7333,8.06667
58036,2018,Octubre,Italia,6,2,,8,-72.409396,8.36068
58037,2018,Octubre,Italia,2,2,,4,-77.35002,8.63337
58038,2018,Octubre,Jamaica,0,1,,1,-75.527794,10.406342
58039,2018,Octubre,Jamaica,10,31,,41,-75.516486,10.446304
58040,2018,Octubre,Jamaica,3,7,,10,-74.77647900000001,10.886686
58041,2018,Octubre,Jamaica,7,4,,11,-76.532004,3.451668
58042,2018,Octubre,Jamaica,23,59,,82,-74.140516,4.697157
58043,2018,Octubre,Jamaica,8,12,,20,-75.42726,6.170465
58044,2018,Octubre,Jamaica,0,1,,1,-72.409396,8.36068
58045,2018,Octubre,Japón,0,1,,1,-69.94143100000001,4.214082
58046,2018,Octubre,Japón,2,2,,4,-77.35600000000001,0.81488
58047,2018,Octubre,Japón,0,5,,5,-75.527794,10.406342
58048,2018,Octubre,Japón,16,21,,37,-75.516486,10.446304
58049,2018,Octubre,Japón,3,26,,29,-74.77647900000001,10.886686
58050,2018,Octubre,Japón,0,1,,1,-72.129595,11.360028999999999
58051,2018,Octubre,Japón,3,11,,14,-76.532004,3.451668
58052,2018,Octubre,Japón,123,471,,594,-74.140516,4.697157
58053,2018,Octubre,Japón,1,0,,1,-75.736374,4.815189
58054,2018,Octubre,Japón,13,39,,52,-75.42726,6.170465
58055,2018,Octubre,Japón,0,2,,2,-72.453013,7.819
58056,2018,Octubre,Japón,0,1,,1,-72.409396,8.36068
58057,2018,Octubre,Jordania,0,1,,1,-75.516486,10.446304
58058,2018,Octubre,Jordania,0,1,,1,-74.77647900000001,10.886686
58059,2018,Octubre,Jordania,2,4,,6,-74.140516,4.697157
58060,2018,Octubre,Kazajistán,4,2,,6,-74.140516,4.697157
58061,2018,Octubre,Kenia,0,2,,2,-76.532004,3.451668
58062,2018,Octubre,Kenia,7,14,,21,-74.140516,4.697157
58063,2018,Octubre,Kenia,2,3,,5,-75.42726,6.170465
58064,2018,Octubre,Kirguistán,0,1,,1,-74.140516,4.697157
58065,2018,Octubre,Kirguistán,1,0,,1,-75.42726,6.170465
58066,2018,Octubre,Kuwait,1,2,,3,-76.532004,3.451668
58067,2018,Octubre,Kuwait,0,5,,5,-74.140516,4.697157
58068,2018,Octubre,Kuwait,1,0,,1,-75.42726,6.170465
58069,2018,Octubre,República de Kosovo,2,0,,2,-74.140516,4.697157
58070,2018,Octubre,República Democrática Popular  Lao,2,4,,6,-74.140516,4.697157
58071,2018,Octubre,Letonia,0,1,,1,-77.35600000000001,0.81488
58072,2018,Octubre,Letonia,2,1,,3,-75.516486,10.446304
58073,2018,Octubre,Letonia,1,0,,1,-81.70216500000001,12.5862
58074,2018,Octubre,Letonia,6,10,,16,-74.140516,4.697157
58075,2018,Octubre,Letonia,3,2,,5,-75.42726,6.170465
58076,2018,Octubre,Lituania,0,1,,1,-77.35600000000001,0.81488
58077,2018,Octubre,Lituania,2,4,,6,-75.516486,10.446304
58078,2018,Octubre,Lituania,2,3,,5,-76.532004,3.451668
58079,2018,Octubre,Lituania,32,29,,61,-74.140516,4.697157
58080,2018,Octubre,Lituania,2,2,,4,-75.42726,6.170465
58081,2018,Octubre,Líbano,1,0,,1,-77.35600000000001,0.81488
58082,2018,Octubre,Líbano,0,2,,2,-75.516486,10.446304
58083,2018,Octubre,Líbano,1,2,,3,-74.77647900000001,10.886686
58084,2018,Octubre,Líbano,0,2,,2,-72.129595,11.360028999999999
58085,2018,Octubre,Líbano,2,1,,3,-76.532004,3.451668
58086,2018,Octubre,Líbano,13,31,,44,-74.140516,4.697157
58087,2018,Octubre,Líbano,1,1,,2,-75.42726,6.170465
58088,2018,Octubre,Libia,0,1,,1,-74.140516,4.697157
58089,2018,Octubre,Liechtenstein,2,1,,3,-74.140516,4.697157
58090,2018,Octubre,Luxemburgo,0,1,,1,-75.527794,10.406342
58091,2018,Octubre,Luxemburgo,1,1,,2,-75.516486,10.446304
58092,2018,Octubre,Luxemburgo,9,15,,24,-74.140516,4.697157
58093,2018,Octubre,Luxemburgo,1,0,,1,-75.42726,6.170465
58094,2018,Octubre,Macedonia,0,1,,1,-75.516486,10.446304
58095,2018,Octubre,Macedonia,0,1,,1,-76.532004,3.451668
58096,2018,Octubre,Macedonia,0,2,,2,-74.140516,4.697157
58097,2018,Octubre,Madagascar,2,0,,2,-74.140516,4.697157
58098,2018,Octubre,Madagascar,1,1,,2,-75.42726,6.170465
58099,2018,Octubre,Malasia,1,0,,1,-77.35600000000001,0.81488
58100,2018,Octubre,Malasia,0,1,,1,-75.527794,10.406342
58101,2018,Octubre,Malasia,4,9,,13,-75.516486,10.446304
58102,2018,Octubre,Malasia,24,27,,51,-74.140516,4.697157
58103,2018,Octubre,Malasia,1,0,,1,-75.42726,6.170465
58104,2018,Octubre,Malasia,0,2,,2,-75.68164200000001,9.402597
58105,2018,Octubre,Malawi,0,2,,2,-74.140516,4.697157
58106,2018,Octubre,Malta,0,1,,1,-69.941498,4.191162
58107,2018,Octubre,Malta,1,1,,2,-75.516486,10.446304
58108,2018,Octubre,Malta,3,8,,11,-74.140516,4.697157
58109,2018,Octubre,Malta,1,1,,2,-75.42726,6.170465
58110,2018,Octubre,Marruecos,1,0,,1,-75.516486,10.446304
58111,2018,Octubre,Marruecos,0,1,,1,-76.532004,3.451668
58112,2018,Octubre,Marruecos,10,13,,23,-74.140516,4.697157
58113,2018,Octubre,Marruecos,0,3,,3,-75.42726,6.170465
58114,2018,Octubre,Mauricio,0,1,,1,-76.532004,3.451668
58115,2018,Octubre,Mauricio,0,4,,4,-74.140516,4.697157
58116,2018,Octubre,Mauricio,1,1,,2,-75.42726,6.170465
58117,2018,Octubre,México,3,2,,5,-69.941498,4.191162
58118,2018,Octubre,México,1,1,,2,-69.94143100000001,4.214082
58119,2018,Octubre,México,2,1,,3,-76.876446,0.33002
58120,2018,Octubre,México,46,35,,81,-77.35600000000001,0.81488
58121,2018,Octubre,México,10,18,,28,-75.527794,10.406342
58122,2018,Octubre,México,204,267,,471,-75.516486,10.446304
58123,2018,Octubre,México,72,117,,189,-74.77647900000001,10.886686
58124,2018,Octubre,México,1,3,,4,-72.129595,11.360028999999999
58125,2018,Octubre,México,3,3,,6,-81.70216500000001,12.5862
58126,2018,Octubre,México,80,191,,271,-76.532004,3.451668
58127,2018,Octubre,México,1,2,,3,-75.76635300000001,4.45285
58128,2018,Octubre,México,4697,8176,,12873,-74.140516,4.697157
58129,2018,Octubre,México,11,32,,43,-75.736374,4.815189
58130,2018,Octubre,México,595,1338,,1933,-75.42726,6.170465
58131,2018,Octubre,México,7,1,,8,-70.74025300000001,7.088728999999999
58132,2018,Octubre,México,6,14,,20,-73.181317,7.1280470000000005
58133,2018,Octubre,México,13,34,,47,-72.453013,7.819
58134,2018,Octubre,México,2,3,,5,-72.409396,8.36068
58135,2018,Octubre,República de Moldavia,2,1,,3,-74.140516,4.697157
58136,2018,Octubre,Mongolia,3,1,,4,-74.140516,4.697157
58137,2018,Octubre,Montenegro,0,1,,1,-69.941498,4.191162
58138,2018,Octubre,Montenegro,0,2,,2,-75.516486,10.446304
58139,2018,Octubre,Montenegro,0,1,,1,-74.765343,10.970933
58140,2018,Octubre,Montenegro,0,1,,1,-76.532004,3.451668
58141,2018,Octubre,Montenegro,0,4,,4,-74.140516,4.697157
58142,2018,Octubre,Montenegro,0,1,,1,-75.42726,6.170465
58143,2018,Octubre,Mozambique,2,2,,4,-74.140516,4.697157
58144,2018,Octubre,Myanmar,0,3,,3,-75.527794,10.406342
58145,2018,Octubre,Myanmar,0,2,,2,-75.516486,10.446304
58146,2018,Octubre,Myanmar,1,1,,2,-74.140516,4.697157
58147,2018,Octubre,Nepal,0,4,,4,-74.140516,4.697157
58148,2018,Octubre,Nepal,0,1,,1,-75.42726,6.170465
58149,2018,Octubre,Nicaragua,1,0,,1,-69.941498,4.191162
58150,2018,Octubre,Nicaragua,0,1,,1,-77.35600000000001,0.81488
58151,2018,Octubre,Nicaragua,0,1,,1,-75.527794,10.406342
58152,2018,Octubre,Nicaragua,14,22,,36,-75.516486,10.446304
58153,2018,Octubre,Nicaragua,20,21,,41,-74.77647900000001,10.886686
58154,2018,Octubre,Nicaragua,0,1,,1,-72.129595,11.360028999999999
58155,2018,Octubre,Nicaragua,4,8,,12,-81.703935,12.574411099999999
58156,2018,Octubre,Nicaragua,1,1,,2,-81.70216500000001,12.5862
58157,2018,Octubre,Nicaragua,42,39,,81,-76.532004,3.451668
58158,2018,Octubre,Nicaragua,0,1,,1,-75.76635300000001,4.45285
58159,2018,Octubre,Nicaragua,80,115,,195,-74.140516,4.697157
58160,2018,Octubre,Nicaragua,3,3,,6,-75.736374,4.815189
58161,2018,Octubre,Nicaragua,13,24,,37,-75.42726,6.170465
58162,2018,Octubre,Nicaragua,3,1,,4,-73.181317,7.1280470000000005
58163,2018,Octubre,Nigeria,3,8,,11,-76.532004,3.451668
58164,2018,Octubre,Nigeria,9,21,,30,-74.140516,4.697157
58165,2018,Octubre,Nigeria,0,1,,1,-75.42726,6.170465
58166,2018,Octubre,Nigeria,0,1,,1,-73.181317,7.1280470000000005
58167,2018,Octubre,Nigeria,0,1,,1,-72.409396,8.36068
58168,2018,Octubre,Noruega,0,1,,1,-76.876446,0.33002
58169,2018,Octubre,Noruega,4,3,,7,-77.35600000000001,0.81488
58170,2018,Octubre,Noruega,2,0,,2,-75.527794,10.406342
58171,2018,Octubre,Noruega,15,22,,37,-75.516486,10.446304
58172,2018,Octubre,Noruega,2,2,,4,-74.77647900000001,10.886686
58173,2018,Octubre,Noruega,3,3,,6,-76.532004,3.451668
58174,2018,Octubre,Noruega,78,136,,214,-74.140516,4.697157
58175,2018,Octubre,Noruega,7,11,,18,-75.42726,6.170465
58176,2018,Octubre,Noruega,0,1,,1,-73.181317,7.1280470000000005
58177,2018,Octubre,Nueva Zelanda,4,6,,10,-77.35600000000001,0.81488
58178,2018,Octubre,Nueva Zelanda,3,7,,10,-75.527794,10.406342
58179,2018,Octubre,Nueva Zelanda,8,17,,25,-75.516486,10.446304
58180,2018,Octubre,Nueva Zelanda,2,1,,3,-74.77647900000001,10.886686
58181,2018,Octubre,Nueva Zelanda,0,5,,5,-76.532004,3.451668
58182,2018,Octubre,Nueva Zelanda,71,97,,168,-74.140516,4.697157
58183,2018,Octubre,Nueva Zelanda,1,0,,1,-75.736374,4.815189
58184,2018,Octubre,Nueva Zelanda,13,17,,30,-75.42726,6.170465
58185,2018,Octubre,Nueva Zelanda,1,0,,1,-73.181317,7.1280470000000005
58186,2018,Octubre,Nueva Zelanda,5,2,,7,-77.35002,8.63337
58187,2018,Octubre,Omán,0,3,,3,-74.140516,4.697157
58188,2018,Octubre,Países Bajos,5,5,,10,-69.941498,4.191162
58189,2018,Octubre,Países Bajos,2,1,,3,-69.94143100000001,4.214082
58190,2018,Octubre,Países Bajos,1,3,,4,-76.876446,0.33002
58191,2018,Octubre,Países Bajos,13,17,,30,-77.35600000000001,0.81488
58192,2018,Octubre,Países Bajos,10,8,,18,-75.527794,10.406342
58193,2018,Octubre,Países Bajos,269,242,,511,-75.516486,10.446304
58194,2018,Octubre,Países Bajos,15,34,,49,-74.77647900000001,10.886686
58195,2018,Octubre,Países Bajos,0,1,,1,-74.213989,11.247722999999999
58196,2018,Octubre,Países Bajos,0,2,,2,-72.129595,11.360028999999999
58197,2018,Octubre,Países Bajos,1,0,,1,-81.70216500000001,12.5862
58198,2018,Octubre,Países Bajos,41,73,,114,-76.532004,3.451668
58199,2018,Octubre,Países Bajos,1574,2123,,3697,-74.140516,4.697157
58200,2018,Octubre,Países Bajos,11,7,,18,-75.736374,4.815189
58201,2018,Octubre,Países Bajos,167,220,,387,-75.42726,6.170465
58202,2018,Octubre,Países Bajos,8,11,,19,-73.181317,7.1280470000000005
58203,2018,Octubre,Países Bajos,1,1,,2,-72.453013,7.819
58204,2018,Octubre,Países Bajos,1,0,,1,-72.409396,8.36068
58205,2018,Octubre,Países Bajos,6,15,,21,-77.35002,8.63337
58206,2018,Octubre,Pakistán,0,1,,1,-77.35600000000001,0.81488
58207,2018,Octubre,Pakistán,0,4,,4,-75.516486,10.446304
58208,2018,Octubre,Pakistán,4,12,,16,-74.140516,4.697157
58209,2018,Octubre,Pakistán,0,1,,1,-75.42726,6.170465
58210,2018,Octubre,Pakistán,0,1,,1,-75.68164200000001,9.402597
58211,2018,Octubre,Panamá,2,1,,3,-77.35600000000001,0.81488
58212,2018,Octubre,Panamá,2,15,,17,-75.527794,10.406342
58213,2018,Octubre,Panamá,752,777,,1529,-75.516486,10.446304
58214,2018,Octubre,Panamá,110,128,,238,-74.77647900000001,10.886686
58215,2018,Octubre,Panamá,14,6,,20,-74.232675,11.117206
58216,2018,Octubre,Panamá,1,1,,2,-72.129595,11.360028999999999
58217,2018,Octubre,Panamá,55,54,,109,-81.70216500000001,12.5862
58218,2018,Octubre,Panamá,247,281,,528,-76.532004,3.451668
58219,2018,Octubre,Panamá,8,18,,26,-75.76635300000001,4.45285
58220,2018,Octubre,Panamá,1784,1872,,3656,-74.140516,4.697157
58221,2018,Octubre,Panamá,28,31,,59,-75.736374,4.815189
58222,2018,Octubre,Panamá,1370,1198,,2568,-75.42726,6.170465
58223,2018,Octubre,Panamá,0,1,,1,-75.586989,6.2188349999999994
58224,2018,Octubre,Panamá,0,2,,2,-77.762647,7.102626
58225,2018,Octubre,Panamá,10,9,,19,-73.181317,7.1280470000000005
58226,2018,Octubre,Panamá,0,2,,2,-72.453013,7.819
58227,2018,Octubre,Panamá,0,2,,2,-72.409396,8.36068
58228,2018,Octubre,Panamá,1,4,,5,-77.35002,8.63337
58229,2018,Octubre,Paraguay,2,0,,2,-77.35600000000001,0.81488
58230,2018,Octubre,Paraguay,2,1,,3,-75.527794,10.406342
58231,2018,Octubre,Paraguay,116,71,,187,-75.516486,10.446304
58232,2018,Octubre,Paraguay,9,28,,37,-74.77647900000001,10.886686
58233,2018,Octubre,Paraguay,45,31,,76,-81.70216500000001,12.5862
58234,2018,Octubre,Paraguay,8,28,,36,-76.532004,3.451668
58235,2018,Octubre,Paraguay,224,177,,401,-74.140516,4.697157
58236,2018,Octubre,Paraguay,5,3,,8,-75.736374,4.815189
58237,2018,Octubre,Paraguay,26,25,,51,-75.42726,6.170465
58238,2018,Octubre,Paraguay,1,0,,1,-70.74025300000001,7.088728999999999
58239,2018,Octubre,Paraguay,0,1,,1,-72.453013,7.819
58240,2018,Octubre,Paraguay,1,0,,1,-72.409396,8.36068
58241,2018,Octubre,Perú,41,14,,55,-69.941498,4.191162
58242,2018,Octubre,Perú,11,35,,46,-69.94143100000001,4.214082
58243,2018,Octubre,Perú,1,2,,3,-74.78366,0.18595699999999998
58244,2018,Octubre,Perú,4,8,,12,-76.876446,0.33002
58245,2018,Octubre,Perú,84,268,,352,-77.35600000000001,0.81488
58246,2018,Octubre,Perú,54,16,,70,-75.527794,10.406342
58247,2018,Octubre,Perú,1379,897,,2276,-75.516486,10.446304
58248,2018,Octubre,Perú,17,36,,53,-74.77647900000001,10.886686
58249,2018,Octubre,Perú,4,11,,15,-72.129595,11.360028999999999
58250,2018,Octubre,Perú,414,314,,728,-81.70216500000001,12.5862
58251,2018,Octubre,Perú,220,205,,425,-76.532004,3.451668
58252,2018,Octubre,Perú,0,2,,2,-75.76635300000001,4.45285
58253,2018,Octubre,Perú,4387,5249,,9636,-74.140516,4.697157
58254,2018,Octubre,Perú,1,4,,5,-75.736374,4.815189
58255,2018,Octubre,Perú,557,760,,1317,-75.42726,6.170465
58256,2018,Octubre,Perú,3,3,,6,-70.74025300000001,7.088728999999999
58257,2018,Octubre,Perú,2,2,,4,-73.181317,7.1280470000000005
58258,2018,Octubre,Perú,61,147,,208,-72.453013,7.819
58259,2018,Octubre,Perú,5,5,,10,-72.409396,8.36068
58260,2018,Octubre,Palestina,2,3,,5,-74.140516,4.697157
58261,2018,Octubre,Polonia,6,5,,11,-77.35600000000001,0.81488
58262,2018,Octubre,Polonia,0,7,,7,-75.527794,10.406342
58263,2018,Octubre,Polonia,16,18,,34,-75.516486,10.446304
58264,2018,Octubre,Polonia,0,5,,5,-74.77647900000001,10.886686
58265,2018,Octubre,Polonia,0,1,,1,-74.213989,11.247722999999999
58266,2018,Octubre,Polonia,5,8,,13,-76.532004,3.451668
58267,2018,Octubre,Polonia,0,1,,1,-77.061029,3.8844260000000004
58268,2018,Octubre,Polonia,169,226,,395,-74.140516,4.697157
58269,2018,Octubre,Polonia,1,0,,1,-75.736374,4.815189
58270,2018,Octubre,Polonia,7,22,,29,-75.42726,6.170465
58271,2018,Octubre,Polonia,1,2,,3,-72.453013,7.819
58272,2018,Octubre,Polonia,2,2,,4,-77.35002,8.63337
58273,2018,Octubre,Portugal,1,8,,9,-77.35600000000001,0.81488
58274,2018,Octubre,Portugal,4,2,,6,-75.527794,10.406342
58275,2018,Octubre,Portugal,14,21,,35,-75.516486,10.446304
58276,2018,Octubre,Portugal,0,2,,2,-74.77647900000001,10.886686
58277,2018,Octubre,Portugal,1,2,,3,-72.129595,11.360028999999999
58278,2018,Octubre,Portugal,0,1,,1,-81.70216500000001,12.5862
58279,2018,Octubre,Portugal,7,8,,15,-76.532004,3.451668
58280,2018,Octubre,Portugal,0,1,,1,-75.76635300000001,4.45285
58281,2018,Octubre,Portugal,201,513,,714,-74.140516,4.697157
58282,2018,Octubre,Portugal,22,42,,64,-75.42726,6.170465
58283,2018,Octubre,Portugal,1,0,,1,-70.74025300000001,7.088728999999999
58284,2018,Octubre,Portugal,1,1,,2,-73.181317,7.1280470000000005
58285,2018,Octubre,Portugal,13,17,,30,-72.453013,7.819
58286,2018,Octubre,Portugal,2,0,,2,-72.409396,8.36068
58287,2018,Octubre,Reino Unido de Gran Bretaña e Irlanda del Norte,2,8,,10,-69.941498,4.191162
58288,2018,Octubre,Reino Unido de Gran Bretaña e Irlanda del Norte,1,3,,4,-69.94143100000001,4.214082
58289,2018,Octubre,Reino Unido de Gran Bretaña e Irlanda del Norte,1,1,,2,-76.876446,0.33002
58290,2018,Octubre,Reino Unido de Gran Bretaña e Irlanda del Norte,24,43,,67,-77.35600000000001,0.81488
58291,2018,Octubre,Reino Unido de Gran Bretaña e Irlanda del Norte,21,35,,56,-75.527794,10.406342
58292,2018,Octubre,Reino Unido de Gran Bretaña e Irlanda del Norte,114,165,,279,-75.516486,10.446304
58293,2018,Octubre,Reino Unido de Gran Bretaña e Irlanda del Norte,7,15,,22,-74.77647900000001,10.886686
58294,2018,Octubre,Reino Unido de Gran Bretaña e Irlanda del Norte,1,1,,2,-74.213989,11.247722999999999
58295,2018,Octubre,Reino Unido de Gran Bretaña e Irlanda del Norte,0,1,,1,-81.70216500000001,12.5862
58296,2018,Octubre,Reino Unido de Gran Bretaña e Irlanda del Norte,19,50,,69,-76.532004,3.451668
58297,2018,Octubre,Reino Unido de Gran Bretaña e Irlanda del Norte,0,1,,1,-75.76635300000001,4.45285
58298,2018,Octubre,Reino Unido de Gran Bretaña e Irlanda del Norte,1056,2027,,3083,-74.140516,4.697157
58299,2018,Octubre,Reino Unido de Gran Bretaña e Irlanda del Norte,0,4,,4,-75.736374,4.815189
58300,2018,Octubre,Reino Unido de Gran Bretaña e Irlanda del Norte,73,254,,327,-75.42726,6.170465
58301,2018,Octubre,Reino Unido de Gran Bretaña e Irlanda del Norte,1,2,,3,-73.181317,7.1280470000000005
58302,2018,Octubre,Reino Unido de Gran Bretaña e Irlanda del Norte,0,3,,3,-72.453013,7.819
58303,2018,Octubre,Reino Unido de Gran Bretaña e Irlanda del Norte,20,15,,35,-77.35002,8.63337
58304,2018,Octubre,República Dominicana,8,15,,23,-77.35600000000001,0.81488
58305,2018,Octubre,República Dominicana,3,3,,6,-75.527794,10.406342
58306,2018,Octubre,República Dominicana,65,100,,165,-75.516486,10.446304
58307,2018,Octubre,República Dominicana,19,57,,76,-74.77647900000001,10.886686
58308,2018,Octubre,República Dominicana,0,4,,4,-72.129595,11.360028999999999
58309,2018,Octubre,República Dominicana,0,1,,1,-81.70216500000001,12.5862
58310,2018,Octubre,República Dominicana,35,71,,106,-76.532004,3.451668
58311,2018,Octubre,República Dominicana,851,1057,,1908,-74.140516,4.697157
58312,2018,Octubre,República Dominicana,0,3,,3,-75.736374,4.815189
58313,2018,Octubre,República Dominicana,56,82,,138,-75.42726,6.170465
58314,2018,Octubre,República Dominicana,0,1,,1,-73.181317,7.1280470000000005
58315,2018,Octubre,República Dominicana,0,8,,8,-72.453013,7.819
58316,2018,Octubre,República Dominicana,0,1,,1,-72.409396,8.36068
58317,2018,Octubre,Rumania,0,1,,1,-77.35600000000001,0.81488
58318,2018,Octubre,Rumania,0,1,,1,-75.527794,10.406342
58319,2018,Octubre,Rumania,4,7,,11,-75.516486,10.446304
58320,2018,Octubre,Rumania,1,1,,2,-81.70216500000001,12.5862
58321,2018,Octubre,Rumania,1,4,,5,-76.532004,3.451668
58322,2018,Octubre,Rumania,77,97,,174,-74.140516,4.697157
58323,2018,Octubre,Rumania,3,7,,10,-75.42726,6.170465
58324,2018,Octubre,Rumania,5,3,,8,-77.35002,8.63337
58325,2018,Octubre,Federación de Rusia,8,5,,13,-77.35600000000001,0.81488
58326,2018,Octubre,Federación de Rusia,1,0,,1,-75.527794,10.406342
58327,2018,Octubre,Federación de Rusia,21,10,,31,-75.516486,10.446304
58328,2018,Octubre,Federación de Rusia,1,4,,5,-74.77647900000001,10.886686
58329,2018,Octubre,Federación de Rusia,0,1,,1,-74.765343,10.970933
58330,2018,Octubre,Federación de Rusia,0,3,,3,-74.213989,11.247722999999999
58331,2018,Octubre,Federación de Rusia,5,6,,11,-76.532004,3.451668
58332,2018,Octubre,Federación de Rusia,176,196,,372,-74.140516,4.697157
58333,2018,Octubre,Federación de Rusia,0,1,,1,-75.736374,4.815189
58334,2018,Octubre,Federación de Rusia,18,14,,32,-75.42726,6.170465
58335,2018,Octubre,Federación de Rusia,0,3,,3,-72.453013,7.819
58336,2018,Octubre,Federación de Rusia,0,1,,1,-77.35002,8.63337
58337,2018,Octubre,Federación de Rusia,0,1,,1,-75.68164200000001,9.402597
58338,2018,Octubre,Rwanda,0,1,,1,-74.140516,4.697157
58339,2018,Octubre,San Cristóbal y Nevis,1,1,,2,-74.140516,4.697157
58340,2018,Octubre,San Cristóbal y Nevis,1,0,,1,-75.42726,6.170465
58341,2018,Octubre,San Marino,0,1,,1,-75.516486,10.446304
58342,2018,Octubre,San  Vicente y las Granadinas,1,1,,2,-75.516486,10.446304
58343,2018,Octubre,San  Vicente y las Granadinas,1,1,,2,-74.140516,4.697157
58344,2018,Octubre,Santa Lucia,1,0,,1,-75.516486,10.446304
58345,2018,Octubre,Santa Lucia,0,1,,1,-74.77647900000001,10.886686
58346,2018,Octubre,Santa Lucia,0,3,,3,-74.140516,4.697157
58347,2018,Octubre,Santa Lucia,0,3,,3,-75.42726,6.170465
58348,2018,Octubre,Santo Tomé y Príncipe,0,1,,1,-74.140516,4.697157
58349,2018,Octubre,Senegal,0,1,,1,-75.516486,10.446304
58350,2018,Octubre,Serbia,0,2,,2,-75.527794,10.406342
58351,2018,Octubre,Serbia,1,2,,3,-75.516486,10.446304
58352,2018,Octubre,Serbia,8,27,,35,-74.140516,4.697157
58353,2018,Octubre,Serbia,0,3,,3,-75.42726,6.170465
58354,2018,Octubre,Sierra Leona,1,0,,1,-74.140516,4.697157
58355,2018,Octubre,Sierra Leona,0,2,,2,-75.42726,6.170465
58356,2018,Octubre,Singapur,1,0,,1,-69.941498,4.191162
58357,2018,Octubre,Singapur,1,1,,2,-77.35600000000001,0.81488
58358,2018,Octubre,Singapur,1,5,,6,-75.516486,10.446304
58359,2018,Octubre,Singapur,1,0,,1,-76.532004,3.451668
58360,2018,Octubre,Singapur,20,39,,59,-74.140516,4.697157
58361,2018,Octubre,Singapur,3,0,,3,-75.42726,6.170465
58362,2018,Octubre,República Árabe Siria,0,2,,2,-75.516486,10.446304
58363,2018,Octubre,República Árabe Siria,0,4,,4,-74.140516,4.697157
58364,2018,Octubre,Sri Lanka,0,1,,1,-74.77647900000001,10.886686
58365,2018,Octubre,Sri Lanka,1,6,,7,-74.140516,4.697157
58366,2018,Octubre,Sri Lanka,0,1,,1,-75.42726,6.170465
58367,2018,Octubre,Sudáfrica,1,5,,6,-75.527794,10.406342
58368,2018,Octubre,Sudáfrica,2,5,,7,-75.516486,10.446304
58369,2018,Octubre,Sudáfrica,2,5,,7,-74.77647900000001,10.886686
58370,2018,Octubre,Sudáfrica,0,1,,1,-74.213989,11.247722999999999
58371,2018,Octubre,Sudáfrica,0,1,,1,-81.703935,12.574411099999999
58372,2018,Octubre,Sudáfrica,0,1,,1,-76.532004,3.451668
58373,2018,Octubre,Sudáfrica,23,76,,99,-74.140516,4.697157
58374,2018,Octubre,Sudáfrica,2,5,,7,-75.42726,6.170465
58375,2018,Octubre,Sudán,1,0,,1,-74.140516,4.697157
58376,2018,Octubre,Suecia,7,8,,15,-77.35600000000001,0.81488
58377,2018,Octubre,Suecia,0,2,,2,-75.527794,10.406342
58378,2018,Octubre,Suecia,14,30,,44,-75.516486,10.446304
58379,2018,Octubre,Suecia,4,2,,6,-74.77647900000001,10.886686
58380,2018,Octubre,Suecia,0,1,,1,-72.129595,11.360028999999999
58381,2018,Octubre,Suecia,1,0,,1,-81.70216500000001,12.5862
58382,2018,Octubre,Suecia,4,24,,28,-76.532004,3.451668
58383,2018,Octubre,Suecia,155,324,,479,-74.140516,4.697157
58384,2018,Octubre,Suecia,1,2,,3,-75.736374,4.815189
58385,2018,Octubre,Suecia,21,38,,59,-75.42726,6.170465
58386,2018,Octubre,Suecia,0,1,,1,-72.453013,7.819
58387,2018,Octubre,Suiza,3,3,,6,-69.941498,4.191162
58388,2018,Octubre,Suiza,0,2,,2,-69.94143100000001,4.214082
58389,2018,Octubre,Suiza,17,11,,28,-77.35600000000001,0.81488
58390,2018,Octubre,Suiza,9,17,,26,-75.527794,10.406342
58391,2018,Octubre,Suiza,46,43,,89,-75.516486,10.446304
58392,2018,Octubre,Suiza,6,7,,13,-74.77647900000001,10.886686
58393,2018,Octubre,Suiza,2,1,,3,-74.213989,11.247722999999999
58394,2018,Octubre,Suiza,0,3,,3,-81.70216500000001,12.5862
58395,2018,Octubre,Suiza,16,31,,47,-76.532004,3.451668
58396,2018,Octubre,Suiza,0,2,,2,-75.76635300000001,4.45285
58397,2018,Octubre,Suiza,405,640,,1045,-74.140516,4.697157
58398,2018,Octubre,Suiza,3,4,,7,-75.736374,4.815189
58399,2018,Octubre,Suiza,35,90,,125,-75.42726,6.170465
58400,2018,Octubre,Suiza,2,0,,2,-72.453013,7.819
58401,2018,Octubre,Suiza,1,0,,1,-72.409396,8.36068
58402,2018,Octubre,Suiza,1,4,,5,-77.35002,8.63337
58403,2018,Octubre,Surinam,1,0,,1,-74.77647900000001,10.886686
58404,2018,Octubre,Surinam,24,51,,75,-74.140516,4.697157
58405,2018,Octubre,Surinam,1,3,,4,-75.42726,6.170465
58406,2018,Octubre,Surinam,1,2,,3,-73.181317,7.1280470000000005
58407,2018,Octubre,Suazilandia,1,1,,2,-74.140516,4.697157
58408,2018,Octubre,Tailandia,1,0,,1,-75.516486,10.446304
58409,2018,Octubre,Tailandia,0,1,,1,-74.77647900000001,10.886686
58410,2018,Octubre,Tailandia,15,9,,24,-74.140516,4.697157
58411,2018,Octubre,Tailandia,1,0,,1,-75.42726,6.170465
58412,2018,Octubre,Tanzania,0,1,,1,-75.516486,10.446304
58413,2018,Octubre,Tanzania,3,1,,4,-74.140516,4.697157
58414,2018,Octubre,Togo,0,1,,1,-74.140516,4.697157
58415,2018,Octubre,Tonga,1,0,,1,-74.140516,4.697157
58416,2018,Octubre,Trinidad y Tobago,0,2,,2,-75.527794,10.406342
58417,2018,Octubre,Trinidad y Tobago,10,19,,29,-75.516486,10.446304
58418,2018,Octubre,Trinidad y Tobago,5,2,,7,-74.77647900000001,10.886686
58419,2018,Octubre,Trinidad y Tobago,5,7,,12,-76.532004,3.451668
58420,2018,Octubre,Trinidad y Tobago,20,51,,71,-74.140516,4.697157
58421,2018,Octubre,Trinidad y Tobago,0,2,,2,-75.736374,4.815189
58422,2018,Octubre,Trinidad y Tobago,1,5,,6,-75.42726,6.170465
58423,2018,Octubre,Trinidad y Tobago,1,0,,1,-72.453013,7.819
58424,2018,Octubre,Túnez,4,9,,13,-74.140516,4.697157
58425,2018,Octubre,Turquía,0,1,,1,-69.941498,4.191162
58426,2018,Octubre,Turquía,1,2,,3,-77.35600000000001,0.81488
58427,2018,Octubre,Turquía,0,6,,6,-75.527794,10.406342
58428,2018,Octubre,Turquía,8,13,,21,-75.516486,10.446304
58429,2018,Octubre,Turquía,0,4,,4,-74.77647900000001,10.886686
58430,2018,Octubre,Turquía,1,7,,8,-76.532004,3.451668
58431,2018,Octubre,Turquía,148,346,,494,-74.140516,4.697157
58432,2018,Octubre,Turquía,4,14,,18,-75.42726,6.170465
58433,2018,Octubre,Tuvalu,0,4,,4,-74.140516,4.697157
58434,2018,Octubre,Turkmenistán,0,1,,1,-74.140516,4.697157
58435,2018,Octubre,Ucrania,2,0,,2,-77.35600000000001,0.81488
58436,2018,Octubre,Ucrania,0,4,,4,-75.527794,10.406342
58437,2018,Octubre,Ucrania,0,5,,5,-75.516486,10.446304
58438,2018,Octubre,Ucrania,0,9,,9,-74.77647900000001,10.886686
58439,2018,Octubre,Ucrania,0,5,,5,-74.765343,10.970933
58440,2018,Octubre,Ucrania,0,10,,10,-74.213989,11.247722999999999
58441,2018,Octubre,Ucrania,1,1,,2,-76.532004,3.451668
58442,2018,Octubre,Ucrania,1,1,,2,-75.76635300000001,4.45285
58443,2018,Octubre,Ucrania,29,29,,58,-74.140516,4.697157
58444,2018,Octubre,Ucrania,1,3,,4,-75.42726,6.170465
58445,2018,Octubre,Ucrania,0,2,,2,-75.68164200000001,9.402597
58446,2018,Octubre,Uganda,0,2,,2,-76.532004,3.451668
58447,2018,Octubre,Uganda,2,4,,6,-74.140516,4.697157
58448,2018,Octubre,Uganda,1,1,,2,-75.42726,6.170465
58449,2018,Octubre,Uruguay,3,11,,14,-77.35600000000001,0.81488
58450,2018,Octubre,Uruguay,14,10,,24,-75.527794,10.406342
58451,2018,Octubre,Uruguay,122,95,,217,-75.516486,10.446304
58452,2018,Octubre,Uruguay,6,10,,16,-74.77647900000001,10.886686
58453,2018,Octubre,Uruguay,0,1,,1,-72.129595,11.360028999999999
58454,2018,Octubre,Uruguay,19,12,,31,-81.70216500000001,12.5862
58455,2018,Octubre,Uruguay,19,38,,57,-76.532004,3.451668
58456,2018,Octubre,Uruguay,477,593,,1070,-74.140516,4.697157
58457,2018,Octubre,Uruguay,1,0,,1,-75.736374,4.815189
58458,2018,Octubre,Uruguay,26,64,,90,-75.42726,6.170465
58459,2018,Octubre,Uruguay,0,1,,1,-73.181317,7.1280470000000005
58460,2018,Octubre,Uruguay,0,8,,8,-72.453013,7.819
58461,2018,Octubre,Uruguay,1,1,,2,-72.409396,8.36068
58462,2018,Octubre,Uzbekistán,0,2,,2,-74.140516,4.697157
58463,2018,Octubre,Venezuela,4,10,,14,-69.941498,4.191162
58464,2018,Octubre,Venezuela,0,1,,1,-69.94143100000001,4.214082
58465,2018,Octubre,Venezuela,0,1,,1,-74.78366,0.18595699999999998
58466,2018,Octubre,Venezuela,92,94,,186,-76.876446,0.33002
58467,2018,Octubre,Venezuela,4276,4900,,9176,-77.35600000000001,0.81488
58468,2018,Octubre,Venezuela,5,2,,7,-78.802679,18.00143
58469,2018,Octubre,Venezuela,5,7,,12,-75.527794,10.406342
58470,2018,Octubre,Venezuela,173,175,,348,-75.516486,10.446304
58471,2018,Octubre,Venezuela,135,232,,367,-74.77647900000001,10.886686
58472,2018,Octubre,Venezuela,4,11,,15,-74.232675,11.117206
58473,2018,Octubre,Venezuela,0,5,,5,-74.213989,11.247722999999999
58474,2018,Octubre,Venezuela,7230,6377,,13607,-72.129595,11.360028999999999
58475,2018,Octubre,Venezuela,1,6,,7,-81.70216500000001,12.5862
58476,2018,Octubre,Venezuela,94,133,,227,-76.532004,3.451668
58477,2018,Octubre,Venezuela,17,22,,39,-67.927521,3.866713
58478,2018,Octubre,Venezuela,1,2,,3,-75.76635300000001,4.45285
58479,2018,Octubre,Venezuela,6722,6937,,13659,-74.140516,4.697157
58480,2018,Octubre,Venezuela,8,14,,22,-75.736374,4.815189
58481,2018,Octubre,Venezuela,740,823,,1563,-75.42726,6.170465
58482,2018,Octubre,Venezuela,55,48,,103,-67.48402800000001,6.185536
58483,2018,Octubre,Venezuela,1280,1311,,2591,-70.74025300000001,7.088728999999999
58484,2018,Octubre,Venezuela,16,13,,29,-73.181317,7.1280470000000005
58485,2018,Octubre,Venezuela,33390,28140,,61530,-72.453013,7.819
58486,2018,Octubre,Venezuela,4,11,,15,-72.508188,7.927233
58487,2018,Octubre,Venezuela,2794,2333,,5127,-72.409396,8.36068
58488,2018,Octubre,Vietnam,1,0,,1,-75.516486,10.446304
58489,2018,Octubre,Vietnam,2,5,,7,-74.140516,4.697157
58490,2018,Octubre,República Árabe de Yemen,0,2,,2,-74.140516,4.697157
58491,2018,Octubre,Zambia,1,2,,3,-74.140516,4.697157
58492,2018,Octubre,Zimbabue,0,1,,1,-75.516486,10.446304
58493,2018,Octubre,Zimbabue,0,3,,3,-76.532004,3.451668
58494,2018,Octubre,Zimbabue,2,2,,4,-74.140516,4.697157
58495,2018,Octubre,Zimbabue,0,2,,2,-75.42726,6.170465
58496,2018,Octubre,Refugiado Otro,0,1,,1,-74.140516,4.697157
58497,2018,Octubre,Refugiado,0,1,,1,-75.516486,10.446304
58498,2018,Octubre,Refugiado,2,4,,6,-74.140516,4.697157
58499,2018,Octubre,Refugiado,0,1,,1,-75.42726,6.170465
58500,2018,Octubre,Desconocido,0,1,,1,-77.35600000000001,0.81488
58501,2018,Octubre,Desconocido,10,23,,33,-75.516486,10.446304
58502,2018,Octubre,Desconocido,0,2,,2,-74.77647900000001,10.886686
58503,2018,Octubre,Desconocido,1,0,,1,-72.129595,11.360028999999999
58504,2018,Octubre,Desconocido,2,1,,3,-76.532004,3.451668
58505,2018,Octubre,Desconocido,84,168,,252,-74.140516,4.697157
58506,2018,Octubre,Desconocido,1,6,,7,-75.42726,6.170465
58507,2018,Octubre,Desconocido,1,0,,1,-70.74025300000001,7.088728999999999
58508,2018,Octubre,Desconocido,3,4,,7,-72.453013,7.819
58509,2018,Octubre,República CentroÁfricana,1,0,,1,-74.140516,4.697157
58510,2018,Noviembre,Afganistán,0,1,,1,-74.140516,4.697157
58511,2018,Noviembre,Albania,0,1,,1,-69.941498,4.191162
58512,2018,Noviembre,Albania,3,1,,4,-75.516486,10.446304
58513,2018,Noviembre,Albania,5,17,,22,-74.140516,4.697157
58514,2018,Noviembre,Albania,0,2,,2,-75.42726,6.170465
58515,2018,Noviembre,Albania,0,1,,1,-72.453013,7.819
58516,2018,Noviembre,Alemania,18,17,,35,-69.941498,4.191162
58517,2018,Noviembre,Alemania,7,14,,21,-69.94143100000001,4.214082
58518,2018,Noviembre,Alemania,1,3,,4,-76.876446,0.33002
58519,2018,Noviembre,Alemania,59,60,,119,-77.35600000000001,0.81488
58520,2018,Noviembre,Alemania,44,40,,84,-75.527794,10.406342
58521,2018,Noviembre,Alemania,130,243,,373,-75.516486,10.446304
58522,2018,Noviembre,Alemania,13,29,,42,-74.77647900000001,10.886686
58523,2018,Noviembre,Alemania,0,1,,1,-74.765343,10.970933
58524,2018,Noviembre,Alemania,4,5,,9,-74.213989,11.247722999999999
58525,2018,Noviembre,Alemania,0,1,,1,-72.129595,11.360028999999999
58526,2018,Noviembre,Alemania,1,0,,1,-81.703935,12.574411099999999
58527,2018,Noviembre,Alemania,3,5,,8,-81.70216500000001,12.5862
58528,2018,Noviembre,Alemania,1,0,,1,-81.372937,13.338761300000002
58529,2018,Noviembre,Alemania,44,75,,119,-76.532004,3.451668
58530,2018,Noviembre,Alemania,0,1,,1,-75.76635300000001,4.45285
58531,2018,Noviembre,Alemania,2174,3259,,5433,-74.140516,4.697157
58532,2018,Noviembre,Alemania,5,8,,13,-75.736374,4.815189
58533,2018,Noviembre,Alemania,113,207,,320,-75.42726,6.170465
58534,2018,Noviembre,Alemania,0,4,,4,-73.181317,7.1280470000000005
58535,2018,Noviembre,Alemania,1,6,,7,-72.453013,7.819
58536,2018,Noviembre,Alemania,0,2,,2,-72.409396,8.36068
58537,2018,Noviembre,Alemania,13,12,,25,-77.35002,8.63337
58538,2018,Noviembre,Andorra,4,14,,18,-74.140516,4.697157
58539,2018,Noviembre,Angola,0,1,,1,-75.527794,10.406342
58540,2018,Noviembre,Angola,1,0,,1,-74.140516,4.697157
58541,2018,Noviembre,Angola,0,1,,1,-75.42726,6.170465
58542,2018,Noviembre,Antigua y Barbuda,0,2,,2,-74.140516,4.697157
58543,2018,Noviembre,Países Bajos,0,1,,1,-74.77647900000001,10.886686
58544,2018,Noviembre,Países Bajos,0,1,,1,-74.140516,4.697157
58545,2018,Noviembre,Arabia Saudita,0,4,,4,-75.516486,10.446304
58546,2018,Noviembre,Arabia Saudita,0,1,,1,-76.532004,3.451668
58547,2018,Noviembre,Arabia Saudita,1,14,,15,-74.140516,4.697157
58548,2018,Noviembre,Argelia,1,2,,3,-74.140516,4.697157
58549,2018,Noviembre,Argentina,5,3,,8,-69.941498,4.191162
58550,2018,Noviembre,Argentina,1,2,,3,-69.94143100000001,4.214082
58551,2018,Noviembre,Argentina,5,8,,13,-76.876446,0.33002
58552,2018,Noviembre,Argentina,47,88,,135,-77.35600000000001,0.81488
58553,2018,Noviembre,Argentina,1,0,,1,-78.802679,18.00143
58554,2018,Noviembre,Argentina,176,126,,302,-75.527794,10.406342
58555,2018,Noviembre,Argentina,1772,1179,,2951,-75.516486,10.446304
58556,2018,Noviembre,Argentina,22,45,,67,-74.77647900000001,10.886686
58557,2018,Noviembre,Argentina,0,2,,2,-74.232675,11.117206
58558,2018,Noviembre,Argentina,3,10,,13,-72.129595,11.360028999999999
58559,2018,Noviembre,Argentina,344,263,,607,-81.70216500000001,12.5862
58560,2018,Noviembre,Argentina,100,108,,208,-76.532004,3.451668
58561,2018,Noviembre,Argentina,3300,4441,,7741,-74.140516,4.697157
58562,2018,Noviembre,Argentina,3,10,,13,-75.736374,4.815189
58563,2018,Noviembre,Argentina,193,346,,539,-75.42726,6.170465
58564,2018,Noviembre,Argentina,0,1,,1,-70.74025300000001,7.088728999999999
58565,2018,Noviembre,Argentina,1,2,,3,-73.181317,7.1280470000000005
58566,2018,Noviembre,Argentina,5,13,,18,-72.453013,7.819
58567,2018,Noviembre,Argentina,1,0,,1,-76.7333,8.06667
58568,2018,Noviembre,Argentina,1,2,,3,-72.409396,8.36068
58569,2018,Noviembre,Argentina,1,6,,7,-77.35002,8.63337
58570,2018,Noviembre,República de Armenia,0,1,,1,-75.516486,10.446304
58571,2018,Noviembre,República de Armenia,1,0,,1,-74.77647900000001,10.886686
58572,2018,Noviembre,República de Armenia,2,1,,3,-74.140516,4.697157
58573,2018,Noviembre,República de Armenia,0,2,,2,-75.42726,6.170465
58574,2018,Noviembre,Aruba,0,1,,1,-74.140516,4.697157
58575,2018,Noviembre,Australia,0,2,,2,-69.941498,4.191162
58576,2018,Noviembre,Australia,0,1,,1,-76.876446,0.33002
58577,2018,Noviembre,Australia,16,21,,37,-77.35600000000001,0.81488
58578,2018,Noviembre,Australia,11,9,,20,-75.527794,10.406342
58579,2018,Noviembre,Australia,72,78,,150,-75.516486,10.446304
58580,2018,Noviembre,Australia,6,21,,27,-74.77647900000001,10.886686
58581,2018,Noviembre,Australia,0,3,,3,-74.213989,11.247722999999999
58582,2018,Noviembre,Australia,3,2,,5,-81.70216500000001,12.5862
58583,2018,Noviembre,Australia,9,20,,29,-76.532004,3.451668
58584,2018,Noviembre,Australia,363,711,,1074,-74.140516,4.697157
58585,2018,Noviembre,Australia,1,2,,3,-75.736374,4.815189
58586,2018,Noviembre,Australia,51,98,,149,-75.42726,6.170465
58587,2018,Noviembre,Australia,1,4,,5,-73.181317,7.1280470000000005
58588,2018,Noviembre,Australia,7,6,,13,-77.35002,8.63337
58589,2018,Noviembre,Austria,0,3,,3,-69.941498,4.191162
58590,2018,Noviembre,Austria,1,0,,1,-76.876446,0.33002
58591,2018,Noviembre,Austria,9,11,,20,-77.35600000000001,0.81488
58592,2018,Noviembre,Austria,0,2,,2,-75.527794,10.406342
58593,2018,Noviembre,Austria,21,23,,44,-75.516486,10.446304
58594,2018,Noviembre,Austria,1,5,,6,-74.77647900000001,10.886686
58595,2018,Noviembre,Austria,1,3,,4,-74.213989,11.247722999999999
58596,2018,Noviembre,Austria,4,7,,11,-76.532004,3.451668
58597,2018,Noviembre,Austria,0,1,,1,-75.76635300000001,4.45285
58598,2018,Noviembre,Austria,186,382,,568,-74.140516,4.697157
58599,2018,Noviembre,Austria,18,24,,42,-75.42726,6.170465
58600,2018,Noviembre,Austria,2,0,,2,-72.453013,7.819
58601,2018,Noviembre,Azerbaiyán,0,2,,2,-75.516486,10.446304
58602,2018,Noviembre,Azerbaiyán,1,6,,7,-74.140516,4.697157
58603,2018,Noviembre,Azerbaiyán,0,1,,1,-75.42726,6.170465
58604,2018,Noviembre,Bahamas,2,6,,8,-75.516486,10.446304
58605,2018,Noviembre,Bahamas,0,3,,3,-74.77647900000001,10.886686
58606,2018,Noviembre,Bahamas,0,1,,1,-76.532004,3.451668
58607,2018,Noviembre,Bahamas,11,8,,19,-74.140516,4.697157
58608,2018,Noviembre,Bahamas,3,2,,5,-75.42726,6.170465
58609,2018,Noviembre,Bahréin,0,2,,2,-75.42726,6.170465
58610,2018,Noviembre,Bangladesh,0,1,,1,-75.516486,10.446304
58611,2018,Noviembre,Bangladesh,1,2,,3,-74.140516,4.697157
58612,2018,Noviembre,Bangladesh,0,1,,1,-75.68164200000001,9.402597
58613,2018,Noviembre,Barbados,1,1,,2,-75.516486,10.446304
58614,2018,Noviembre,Barbados,2,2,,4,-81.70216500000001,12.5862
58615,2018,Noviembre,Barbados,1,0,,1,-76.532004,3.451668
58616,2018,Noviembre,Barbados,13,5,,18,-74.140516,4.697157
58617,2018,Noviembre,Barbados,1,2,,3,-75.42726,6.170465
58618,2018,Noviembre,Barbados,0,2,,2,-73.181317,7.1280470000000005
58619,2018,Noviembre,República de Belarús,8,7,,15,-74.140516,4.697157
58620,2018,Noviembre,República de Belarús,0,1,,1,-75.42726,6.170465
58621,2018,Noviembre,Bélgica,3,6,,9,-69.941498,4.191162
58622,2018,Noviembre,Bélgica,1,2,,3,-69.94143100000001,4.214082
58623,2018,Noviembre,Bélgica,6,13,,19,-77.35600000000001,0.81488
58624,2018,Noviembre,Bélgica,3,6,,9,-75.527794,10.406342
58625,2018,Noviembre,Bélgica,26,59,,85,-75.516486,10.446304
58626,2018,Noviembre,Bélgica,2,7,,9,-74.77647900000001,10.886686
58627,2018,Noviembre,Bélgica,0,1,,1,-74.213989,11.247722999999999
58628,2018,Noviembre,Bélgica,0,1,,1,-72.129595,11.360028999999999
58629,2018,Noviembre,Bélgica,0,1,,1,-81.70216500000001,12.5862
58630,2018,Noviembre,Bélgica,11,21,,32,-76.532004,3.451668
58631,2018,Noviembre,Bélgica,0,4,,4,-77.061029,3.8844260000000004
58632,2018,Noviembre,Bélgica,367,588,,955,-74.140516,4.697157
58633,2018,Noviembre,Bélgica,0,2,,2,-75.736374,4.815189
58634,2018,Noviembre,Bélgica,37,64,,101,-75.42726,6.170465
58635,2018,Noviembre,Bélgica,1,2,,3,-67.48402800000001,6.185536
58636,2018,Noviembre,Bélgica,0,3,,3,-73.181317,7.1280470000000005
58637,2018,Noviembre,Bélgica,4,2,,6,-77.35002,8.63337
58638,2018,Noviembre,Belice,1,1,,2,-75.516486,10.446304
58639,2018,Noviembre,Belice,0,1,,1,-74.77647900000001,10.886686
58640,2018,Noviembre,Belice,2,0,,2,-81.70216500000001,12.5862
58641,2018,Noviembre,Belice,4,9,,13,-76.532004,3.451668
58642,2018,Noviembre,Belice,11,15,,26,-74.140516,4.697157
58643,2018,Noviembre,Belice,0,6,,6,-75.42726,6.170465
58644,2018,Noviembre,Belice,0,1,,1,-77.35002,8.63337
58645,2018,Noviembre,Bermudas/Territorio Británico de Ultramar,2,1,,3,-75.516486,10.446304
58646,2018,Noviembre,Bermudas/Territorio Británico de Ultramar,0,1,,1,-76.532004,3.451668
58647,2018,Noviembre,Bermudas/Territorio Británico de Ultramar,1,1,,2,-74.140516,4.697157
58648,2018,Noviembre,Bermudas/Territorio Británico de Ultramar,0,7,,7,-75.42726,6.170465
58649,2018,Noviembre,Bolivia,0,2,,2,-76.876446,0.33002
58650,2018,Noviembre,Bolivia,6,10,,16,-77.35600000000001,0.81488
58651,2018,Noviembre,Bolivia,10,11,,21,-75.527794,10.406342
58652,2018,Noviembre,Bolivia,149,116,,265,-75.516486,10.446304
58653,2018,Noviembre,Bolivia,0,2,,2,-74.77647900000001,10.886686
58654,2018,Noviembre,Bolivia,1,0,,1,-72.129595,11.360028999999999
58655,2018,Noviembre,Bolivia,31,20,,51,-81.70216500000001,12.5862
58656,2018,Noviembre,Bolivia,5,16,,21,-76.532004,3.451668
58657,2018,Noviembre,Bolivia,665,731,,1396,-74.140516,4.697157
58658,2018,Noviembre,Bolivia,2,0,,2,-75.736374,4.815189
58659,2018,Noviembre,Bolivia,65,63,,128,-75.42726,6.170465
58660,2018,Noviembre,Bolivia,0,1,,1,-70.74025300000001,7.088728999999999
58661,2018,Noviembre,Bolivia,1,2,,3,-73.181317,7.1280470000000005
58662,2018,Noviembre,Bolivia,1,8,,9,-72.453013,7.819
58663,2018,Noviembre,Bosnia y Herzegovina,1,8,,9,-74.140516,4.697157
58664,2018,Noviembre,Bosnia y Herzegovina,1,1,,2,-75.42726,6.170465
58665,2018,Noviembre,Brasil,101,95,,196,-69.941498,4.191162
58666,2018,Noviembre,Brasil,1,4,,5,-69.94143100000001,4.214082
58667,2018,Noviembre,Brasil,0,1,,1,-76.876446,0.33002
58668,2018,Noviembre,Brasil,21,31,,52,-77.35600000000001,0.81488
58669,2018,Noviembre,Brasil,201,550,,751,-75.527794,10.406342
58670,2018,Noviembre,Brasil,895,669,,1564,-75.516486,10.446304
58671,2018,Noviembre,Brasil,7,34,,41,-74.77647900000001,10.886686
58672,2018,Noviembre,Brasil,0,3,,3,-72.129595,11.360028999999999
58673,2018,Noviembre,Brasil,233,193,,426,-81.70216500000001,12.5862
58674,2018,Noviembre,Brasil,90,130,,220,-76.532004,3.451668
58675,2018,Noviembre,Brasil,0,3,,3,-67.927521,3.866713
58676,2018,Noviembre,Brasil,0,3,,3,-73.61246899999999,4.16909
58677,2018,Noviembre,Brasil,5522,6823,,12345,-74.140516,4.697157
58678,2018,Noviembre,Brasil,1,10,,11,-75.736374,4.815189
58679,2018,Noviembre,Brasil,122,238,,360,-75.42726,6.170465
58680,2018,Noviembre,Brasil,4,3,,7,-73.181317,7.1280470000000005
58681,2018,Noviembre,Brasil,4,6,,10,-72.453013,7.819
58682,2018,Noviembre,Brasil,1,3,,4,-72.409396,8.36068
58683,2018,Noviembre,Brasil,1,0,,1,-77.35002,8.63337
58684,2018,Noviembre,Bulgaria,0,1,,1,-77.35600000000001,0.81488
58685,2018,Noviembre,Bulgaria,0,4,,4,-75.527794,10.406342
58686,2018,Noviembre,Bulgaria,7,7,,14,-75.516486,10.446304
58687,2018,Noviembre,Bulgaria,1,1,,2,-74.77647900000001,10.886686
58688,2018,Noviembre,Bulgaria,26,49,,75,-74.140516,4.697157
58689,2018,Noviembre,Bulgaria,1,5,,6,-75.42726,6.170465
58690,2018,Noviembre,Bulgaria,0,1,,1,-76.7333,8.06667
58691,2018,Noviembre,Burkina Faso,1,0,,1,-76.532004,3.451668
58692,2018,Noviembre,Burundi,0,1,,1,-74.140516,4.697157
58693,2018,Noviembre,Burundi,0,1,,1,-75.42726,6.170465
58694,2018,Noviembre,Bután,1,0,,1,-77.35600000000001,0.81488
58695,2018,Noviembre,Bután,0,2,,2,-74.140516,4.697157
58696,2018,Noviembre,Cabo Verde,1,0,,1,-74.140516,4.697157
58697,2018,Noviembre,Islas Caimán/Territorio Británico de Ultramar,1,1,,2,-75.516486,10.446304
58698,2018,Noviembre,Camboya,0,1,,1,-74.140516,4.697157
58699,2018,Noviembre,Camerún,1,1,,2,-75.516486,10.446304
58700,2018,Noviembre,Camerún,2,6,,8,-74.140516,4.697157
58701,2018,Noviembre,Camerún,1,0,,1,-75.42726,6.170465
58702,2018,Noviembre,Canadá,2,0,,2,-69.941498,4.191162
58703,2018,Noviembre,Canadá,1,2,,3,-69.94143100000001,4.214082
58704,2018,Noviembre,Canadá,0,1,,1,-76.876446,0.33002
58705,2018,Noviembre,Canadá,4,9,,13,-77.35600000000001,0.81488
58706,2018,Noviembre,Canadá,10,16,,26,-75.527794,10.406342
58707,2018,Noviembre,Canadá,239,330,,569,-75.516486,10.446304
58708,2018,Noviembre,Canadá,21,51,,72,-74.77647900000001,10.886686
58709,2018,Noviembre,Canadá,4,12,,16,-74.232675,11.117206
58710,2018,Noviembre,Canadá,0,10,,10,-74.213989,11.247722999999999
58711,2018,Noviembre,Canadá,2,1,,3,-72.129595,11.360028999999999
58712,2018,Noviembre,Canadá,1,1,,2,-81.703935,12.574411099999999
58713,2018,Noviembre,Canadá,6,5,,11,-81.70216500000001,12.5862
58714,2018,Noviembre,Canadá,75,73,,148,-76.532004,3.451668
58715,2018,Noviembre,Canadá,2,3,,5,-75.76635300000001,4.45285
58716,2018,Noviembre,Canadá,1287,2097,,3384,-74.140516,4.697157
58717,2018,Noviembre,Canadá,12,12,,24,-75.736374,4.815189
58718,2018,Noviembre,Canadá,193,511,,704,-75.42726,6.170465
58719,2018,Noviembre,Canadá,4,8,,12,-73.181317,7.1280470000000005
58720,2018,Noviembre,Canadá,2,4,,6,-72.453013,7.819
58721,2018,Noviembre,Canadá,5,10,,15,-77.35002,8.63337
58722,2018,Noviembre,República Del Congo,0,1,,1,-74.140516,4.697157
58723,2018,Noviembre,República Democrática del Congo,0,4,,4,-74.140516,4.697157
58724,2018,Noviembre,República de Corea,0,1,,1,-69.941498,4.191162
58725,2018,Noviembre,República de Corea,5,8,,13,-77.35600000000001,0.81488
58726,2018,Noviembre,República de Corea,10,17,,27,-75.516486,10.446304
58727,2018,Noviembre,República de Corea,0,3,,3,-74.77647900000001,10.886686
58728,2018,Noviembre,República de Corea,2,0,,2,-81.70216500000001,12.5862
58729,2018,Noviembre,República de Corea,1,6,,7,-76.532004,3.451668
58730,2018,Noviembre,República de Corea,272,503,,775,-74.140516,4.697157
58731,2018,Noviembre,República de Corea,0,3,,3,-75.736374,4.815189
58732,2018,Noviembre,República de Corea,11,23,,34,-75.42726,6.170465
58733,2018,Noviembre,República de Corea,0,1,,1,-72.453013,7.819
58734,2018,Noviembre,Costa de Marfil,0,1,,1,-77.35600000000001,0.81488
58735,2018,Noviembre,Costa de Marfil,0,1,,1,-75.42726,6.170465
58736,2018,Noviembre,Costa Rica,0,3,,3,-69.941498,4.191162
58737,2018,Noviembre,Costa Rica,6,4,,10,-77.35600000000001,0.81488
58738,2018,Noviembre,Costa Rica,1,13,,14,-75.527794,10.406342
58739,2018,Noviembre,Costa Rica,239,238,,477,-75.516486,10.446304
58740,2018,Noviembre,Costa Rica,33,27,,60,-74.77647900000001,10.886686
58741,2018,Noviembre,Costa Rica,10,10,,20,-81.70216500000001,12.5862
58742,2018,Noviembre,Costa Rica,54,63,,117,-76.532004,3.451668
58743,2018,Noviembre,Costa Rica,0,1,,1,-75.76635300000001,4.45285
58744,2018,Noviembre,Costa Rica,1376,1883,,3259,-74.140516,4.697157
58745,2018,Noviembre,Costa Rica,6,13,,19,-75.736374,4.815189
58746,2018,Noviembre,Costa Rica,158,218,,376,-75.42726,6.170465
58747,2018,Noviembre,Costa Rica,3,2,,5,-73.181317,7.1280470000000005
58748,2018,Noviembre,Costa Rica,2,4,,6,-72.453013,7.819
58749,2018,Noviembre,Costa Rica,0,1,,1,-76.7333,8.06667
58750,2018,Noviembre,Costa Rica,0,2,,2,-77.35002,8.63337
58751,2018,Noviembre,Croacia,0,1,,1,-69.941498,4.191162
58752,2018,Noviembre,Croacia,0,2,,2,-69.94143100000001,4.214082
58753,2018,Noviembre,Croacia,0,2,,2,-75.527794,10.406342
58754,2018,Noviembre,Croacia,2,9,,11,-75.516486,10.446304
58755,2018,Noviembre,Croacia,1,0,,1,-74.77647900000001,10.886686
58756,2018,Noviembre,Croacia,0,1,,1,-74.213989,11.247722999999999
58757,2018,Noviembre,Croacia,0,4,,4,-76.532004,3.451668
58758,2018,Noviembre,Croacia,0,2,,2,-77.061029,3.8844260000000004
58759,2018,Noviembre,Croacia,26,56,,82,-74.140516,4.697157
58760,2018,Noviembre,Croacia,0,8,,8,-75.42726,6.170465
58761,2018,Noviembre,Cuba,0,1,,1,-69.941498,4.191162
58762,2018,Noviembre,Cuba,0,3,,3,-77.35600000000001,0.81488
58763,2018,Noviembre,Cuba,0,2,,2,-75.527794,10.406342
58764,2018,Noviembre,Cuba,10,19,,29,-75.516486,10.446304
58765,2018,Noviembre,Cuba,14,20,,34,-74.77647900000001,10.886686
58766,2018,Noviembre,Cuba,3,4,,7,-81.70216500000001,12.5862
58767,2018,Noviembre,Cuba,20,30,,50,-76.532004,3.451668
58768,2018,Noviembre,Cuba,214,328,,542,-74.140516,4.697157
58769,2018,Noviembre,Cuba,1,4,,5,-75.736374,4.815189
58770,2018,Noviembre,Cuba,33,35,,68,-75.42726,6.170465
58771,2018,Noviembre,Cuba,0,3,,3,-72.453013,7.819
58772,2018,Noviembre,República Checa,1,0,,1,-76.876446,0.33002
58773,2018,Noviembre,República Checa,5,6,,11,-77.35600000000001,0.81488
58774,2018,Noviembre,República Checa,0,4,,4,-75.527794,10.406342
58775,2018,Noviembre,República Checa,7,8,,15,-75.516486,10.446304
58776,2018,Noviembre,República Checa,0,1,,1,-74.77647900000001,10.886686
58777,2018,Noviembre,República Checa,0,4,,4,-72.129595,11.360028999999999
58778,2018,Noviembre,República Checa,1,1,,2,-76.532004,3.451668
58779,2018,Noviembre,República Checa,119,155,,274,-74.140516,4.697157
58780,2018,Noviembre,República Checa,5,10,,15,-75.42726,6.170465
58781,2018,Noviembre,República Checa,1,2,,3,-77.35002,8.63337
58782,2018,Noviembre,Chile,1,0,,1,-69.941498,4.191162
58783,2018,Noviembre,Chile,2,2,,4,-76.876446,0.33002
58784,2018,Noviembre,Chile,41,63,,104,-77.35600000000001,0.81488
58785,2018,Noviembre,Chile,199,111,,310,-75.527794,10.406342
58786,2018,Noviembre,Chile,590,399,,989,-75.516486,10.446304
58787,2018,Noviembre,Chile,20,22,,42,-74.77647900000001,10.886686
58788,2018,Noviembre,Chile,0,7,,7,-72.129595,11.360028999999999
58789,2018,Noviembre,Chile,0,1,,1,-81.703935,12.574411099999999
58790,2018,Noviembre,Chile,227,182,,409,-81.70216500000001,12.5862
58791,2018,Noviembre,Chile,86,79,,165,-76.532004,3.451668
58792,2018,Noviembre,Chile,1,2,,3,-75.76635300000001,4.45285
58793,2018,Noviembre,Chile,3872,5087,,8959,-74.140516,4.697157
58794,2018,Noviembre,Chile,5,6,,11,-75.736374,4.815189
58795,2018,Noviembre,Chile,96,225,,321,-75.42726,6.170465
58796,2018,Noviembre,Chile,1,1,,2,-67.48402800000001,6.185536
58797,2018,Noviembre,Chile,0,1,,1,-70.74025300000001,7.088728999999999
58798,2018,Noviembre,Chile,13,27,,40,-72.453013,7.819
58799,2018,Noviembre,Chile,5,9,,14,-72.409396,8.36068
58800,2018,Noviembre,Chile,1,1,,2,-77.35002,8.63337
58801,2018,Noviembre,China,0,1,,1,-69.94143100000001,4.214082
58802,2018,Noviembre,China,0,1,,1,-76.876446,0.33002
58803,2018,Noviembre,China,3,5,,8,-77.35600000000001,0.81488
58804,2018,Noviembre,China,2,2,,4,-75.527794,10.406342
58805,2018,Noviembre,China,29,29,,58,-75.516486,10.446304
58806,2018,Noviembre,China,3,25,,28,-74.77647900000001,10.886686
58807,2018,Noviembre,China,0,14,,14,-74.765343,10.970933
58808,2018,Noviembre,China,0,5,,5,-74.213989,11.247722999999999
58809,2018,Noviembre,China,0,2,,2,-72.129595,11.360028999999999
58810,2018,Noviembre,China,2,2,,4,-81.70216500000001,12.5862
58811,2018,Noviembre,China,8,18,,26,-76.532004,3.451668
58812,2018,Noviembre,China,0,1,,1,-75.76635300000001,4.45285
58813,2018,Noviembre,China,390,944,,1334,-74.140516,4.697157
58814,2018,Noviembre,China,1,4,,5,-75.736374,4.815189
58815,2018,Noviembre,China,59,71,,130,-75.42726,6.170465
58816,2018,Noviembre,China,5,10,,15,-72.453013,7.819
58817,2018,Noviembre,Taiwán,0,1,,1,-69.941498,4.191162
58818,2018,Noviembre,Taiwán,1,1,,2,-77.35600000000001,0.81488
58819,2018,Noviembre,Taiwán,3,2,,5,-75.516486,10.446304
58820,2018,Noviembre,Taiwán,0,2,,2,-74.77647900000001,10.886686
58821,2018,Noviembre,Taiwán,0,1,,1,-74.765343,10.970933
58822,2018,Noviembre,Taiwán,2,3,,5,-76.532004,3.451668
58823,2018,Noviembre,Taiwán,63,75,,138,-74.140516,4.697157
58824,2018,Noviembre,Taiwán,0,1,,1,-75.736374,4.815189
58825,2018,Noviembre,Taiwán,12,8,,20,-75.42726,6.170465
58826,2018,Noviembre,Taiwán,0,1,,1,-72.453013,7.819
58827,2018,Noviembre,Chipre,2,0,,2,-69.94143100000001,4.214082
58828,2018,Noviembre,Chipre,1,1,,2,-75.516486,10.446304
58829,2018,Noviembre,Chipre,0,1,,1,-81.70216500000001,12.5862
58830,2018,Noviembre,Chipre,3,4,,7,-74.140516,4.697157
58831,2018,Noviembre,Chipre,1,1,,2,-75.42726,6.170465
58832,2018,Noviembre,Dinamarca,1,1,,2,-69.941498,4.191162
58833,2018,Noviembre,Dinamarca,0,1,,1,-69.94143100000001,4.214082
58834,2018,Noviembre,Dinamarca,5,1,,6,-77.35600000000001,0.81488
58835,2018,Noviembre,Dinamarca,2,3,,5,-75.527794,10.406342
58836,2018,Noviembre,Dinamarca,12,25,,37,-75.516486,10.446304
58837,2018,Noviembre,Dinamarca,2,2,,4,-74.77647900000001,10.886686
58838,2018,Noviembre,Dinamarca,2,2,,4,-74.213989,11.247722999999999
58839,2018,Noviembre,Dinamarca,4,8,,12,-76.532004,3.451668
58840,2018,Noviembre,Dinamarca,106,166,,272,-74.140516,4.697157
58841,2018,Noviembre,Dinamarca,12,13,,25,-75.42726,6.170465
58842,2018,Noviembre,Dinamarca,2,0,,2,-77.35002,8.63337
58843,2018,Noviembre,Dominica,0,1,,1,-76.532004,3.451668
58844,2018,Noviembre,Dominica,3,2,,5,-74.140516,4.697157
58845,2018,Noviembre,Dominica,0,1,,1,-75.42726,6.170465
58846,2018,Noviembre,Ecuador,0,1,,1,-69.941498,4.191162
58847,2018,Noviembre,Ecuador,0,6,,6,-69.94143100000001,4.214082
58848,2018,Noviembre,Ecuador,93,261,,354,-76.876446,0.33002
58849,2018,Noviembre,Ecuador,1,2,,3,-77.84700600000001,0.8124359999999999
58850,2018,Noviembre,Ecuador,1853,2314,,4167,-77.35600000000001,0.81488
58851,2018,Noviembre,Ecuador,19,29,,48,-78.802679,18.00143
58852,2018,Noviembre,Ecuador,13,27,,40,-75.527794,10.406342
58853,2018,Noviembre,Ecuador,55,86,,141,-75.516486,10.446304
58854,2018,Noviembre,Ecuador,5,14,,19,-74.77647900000001,10.886686
58855,2018,Noviembre,Ecuador,10,9,,19,-72.129595,11.360028999999999
58856,2018,Noviembre,Ecuador,20,36,,56,-81.70216500000001,12.5862
58857,2018,Noviembre,Ecuador,519,518,,1037,-76.532004,3.451668
58858,2018,Noviembre,Ecuador,2,2,,4,-67.927521,3.866713
58859,2018,Noviembre,Ecuador,2,1,,3,-75.76635300000001,4.45285
58860,2018,Noviembre,Ecuador,3354,4306,,7660,-74.140516,4.697157
58861,2018,Noviembre,Ecuador,4,3,,7,-75.736374,4.815189
58862,2018,Noviembre,Ecuador,86,112,,198,-75.42726,6.170465
58863,2018,Noviembre,Ecuador,0,1,,1,-67.48402800000001,6.185536
58864,2018,Noviembre,Ecuador,2,5,,7,-70.74025300000001,7.088728999999999
58865,2018,Noviembre,Ecuador,2,3,,5,-73.181317,7.1280470000000005
58866,2018,Noviembre,Ecuador,103,101,,204,-72.453013,7.819
58867,2018,Noviembre,Ecuador,2,5,,7,-72.409396,8.36068
58868,2018,Noviembre,Egipto,0,1,,1,-77.35600000000001,0.81488
58869,2018,Noviembre,Egipto,0,3,,3,-75.516486,10.446304
58870,2018,Noviembre,Egipto,0,3,,3,-76.532004,3.451668
58871,2018,Noviembre,Egipto,3,10,,13,-74.140516,4.697157
58872,2018,Noviembre,Egipto,0,4,,4,-75.42726,6.170465
58873,2018,Noviembre,El Salvador,0,1,,1,-69.941498,4.191162
58874,2018,Noviembre,El Salvador,0,2,,2,-76.876446,0.33002
58875,2018,Noviembre,El Salvador,2,2,,4,-77.35600000000001,0.81488
58876,2018,Noviembre,El Salvador,311,283,,594,-75.516486,10.446304
58877,2018,Noviembre,El Salvador,15,8,,23,-74.77647900000001,10.886686
58878,2018,Noviembre,El Salvador,1,0,,1,-72.129595,11.360028999999999
58879,2018,Noviembre,El Salvador,0,2,,2,-81.70216500000001,12.5862
58880,2018,Noviembre,El Salvador,101,140,,241,-76.532004,3.451668
58881,2018,Noviembre,El Salvador,0,1,,1,-75.76635300000001,4.45285
58882,2018,Noviembre,El Salvador,779,1001,,1780,-74.140516,4.697157
58883,2018,Noviembre,El Salvador,1,1,,2,-75.736374,4.815189
58884,2018,Noviembre,El Salvador,49,84,,133,-75.42726,6.170465
58885,2018,Noviembre,El Salvador,0,1,,1,-73.181317,7.1280470000000005
58886,2018,Noviembre,El Salvador,1,2,,3,-72.453013,7.819
58887,2018,Noviembre,El Salvador,1,1,,2,-77.35002,8.63337
58888,2018,Noviembre,Emiratos Árabes,3,6,,9,-74.140516,4.697157
58889,2018,Noviembre,Emiratos Árabes,0,1,,1,-75.42726,6.170465
58890,2018,Noviembre,España,1,6,,7,-69.941498,4.191162
58891,2018,Noviembre,España,8,6,,14,-69.94143100000001,4.214082
58892,2018,Noviembre,España,2,6,,8,-76.876446,0.33002
58893,2018,Noviembre,España,32,35,,67,-77.35600000000001,0.81488
58894,2018,Noviembre,España,12,20,,32,-75.527794,10.406342
58895,2018,Noviembre,España,137,234,,371,-75.516486,10.446304
58896,2018,Noviembre,España,20,41,,61,-74.77647900000001,10.886686
58897,2018,Noviembre,España,0,1,,1,-74.232675,11.117206
58898,2018,Noviembre,España,2,5,,7,-72.129595,11.360028999999999
58899,2018,Noviembre,España,7,7,,14,-81.70216500000001,12.5862
58900,2018,Noviembre,España,263,457,,720,-76.532004,3.451668
58901,2018,Noviembre,España,1,3,,4,-75.76635300000001,4.45285
58902,2018,Noviembre,España,3158,6806,,9964,-74.140516,4.697157
58903,2018,Noviembre,España,3,9,,12,-75.736374,4.815189
58904,2018,Noviembre,España,396,816,,1212,-75.42726,6.170465
58905,2018,Noviembre,España,1,5,,6,-70.74025300000001,7.088728999999999
58906,2018,Noviembre,España,1,5,,6,-73.181317,7.1280470000000005
58907,2018,Noviembre,España,29,44,,73,-72.453013,7.819
58908,2018,Noviembre,España,7,10,,17,-72.409396,8.36068
58909,2018,Noviembre,España,0,5,,5,-77.35002,8.63337
58910,2018,Noviembre,Eslovaquia,3,5,,8,-77.35600000000001,0.81488
58911,2018,Noviembre,Eslovaquia,0,1,,1,-75.527794,10.406342
58912,2018,Noviembre,Eslovaquia,8,2,,10,-75.516486,10.446304
58913,2018,Noviembre,Eslovaquia,1,4,,5,-74.77647900000001,10.886686
58914,2018,Noviembre,Eslovaquia,3,3,,6,-76.532004,3.451668
58915,2018,Noviembre,Eslovaquia,56,61,,117,-74.140516,4.697157
58916,2018,Noviembre,Eslovaquia,0,1,,1,-75.736374,4.815189
58917,2018,Noviembre,Eslovaquia,6,13,,19,-75.42726,6.170465
58918,2018,Noviembre,Eslovenia,1,0,,1,-77.35600000000001,0.81488
58919,2018,Noviembre,Eslovenia,1,0,,1,-75.516486,10.446304
58920,2018,Noviembre,Eslovenia,1,0,,1,-72.129595,11.360028999999999
58921,2018,Noviembre,Eslovenia,2,1,,3,-76.532004,3.451668
58922,2018,Noviembre,Eslovenia,23,40,,63,-74.140516,4.697157
58923,2018,Noviembre,Eslovenia,1,9,,10,-75.42726,6.170465
58924,2018,Noviembre,Estados Unidos de América,6,10,,16,-69.941498,4.191162
58925,2018,Noviembre,Estados Unidos de América,3,3,,6,-69.94143100000001,4.214082
58926,2018,Noviembre,Estados Unidos de América,0,5,,5,-76.876446,0.33002
58927,2018,Noviembre,Estados Unidos de América,32,66,,98,-77.35600000000001,0.81488
58928,2018,Noviembre,Estados Unidos de América,55,84,,139,-75.527794,10.406342
58929,2018,Noviembre,Estados Unidos de América,4589,6302,,10891,-75.516486,10.446304
58930,2018,Noviembre,Estados Unidos de América,611,1128,,1739,-74.77647900000001,10.886686
58931,2018,Noviembre,Estados Unidos de América,0,4,,4,-74.232675,11.117206
58932,2018,Noviembre,Estados Unidos de América,15,12,,27,-74.213989,11.247722999999999
58933,2018,Noviembre,Estados Unidos de América,3,0,,3,-72.129595,11.360028999999999
58934,2018,Noviembre,Estados Unidos de América,1,0,,1,-72.919186,11.52863
58935,2018,Noviembre,Estados Unidos de América,5,4,,9,-81.703935,12.574411099999999
58936,2018,Noviembre,Estados Unidos de América,44,53,,97,-81.70216500000001,12.5862
58937,2018,Noviembre,Estados Unidos de América,0,3,,3,-81.372937,13.338761300000002
58938,2018,Noviembre,Estados Unidos de América,1015,1597,,2612,-76.532004,3.451668
58939,2018,Noviembre,Estados Unidos de América,0,1,,1,-77.061029,3.8844260000000004
58940,2018,Noviembre,Estados Unidos de América,1,4,,5,-73.61246899999999,4.16909
58941,2018,Noviembre,Estados Unidos de América,142,216,,358,-75.76635300000001,4.45285
58942,2018,Noviembre,Estados Unidos de América,9795,16974,,26769,-74.140516,4.697157
58943,2018,Noviembre,Estados Unidos de América,129,209,,338,-75.736374,4.815189
58944,2018,Noviembre,Estados Unidos de América,3061,7671,,10732,-75.42726,6.170465
58945,2018,Noviembre,Estados Unidos de América,1,0,,1,-70.74025300000001,7.088728999999999
58946,2018,Noviembre,Estados Unidos de América,28,57,,85,-73.181317,7.1280470000000005
58947,2018,Noviembre,Estados Unidos de América,8,15,,23,-72.453013,7.819
58948,2018,Noviembre,Estados Unidos de América,3,13,,16,-76.7333,8.06667
58949,2018,Noviembre,Estados Unidos de América,2,2,,4,-72.409396,8.36068
58950,2018,Noviembre,Estados Unidos de América,10,15,,25,-77.35002,8.63337
58951,2018,Noviembre,Estonia,1,7,,8,-75.516486,10.446304
58952,2018,Noviembre,Estonia,1,2,,3,-74.77647900000001,10.886686
58953,2018,Noviembre,Estonia,0,5,,5,-76.532004,3.451668
58954,2018,Noviembre,Estonia,23,26,,49,-74.140516,4.697157
58955,2018,Noviembre,Estonia,3,1,,4,-75.42726,6.170465
58956,2018,Noviembre,Estonia,0,1,,1,-72.453013,7.819
58957,2018,Noviembre,Estonia,0,1,,1,-77.35002,8.63337
58958,2018,Noviembre,Etiopia,1,45,,46,-74.140516,4.697157
58959,2018,Noviembre,Etiopia,0,4,,4,-75.42726,6.170465
58960,2018,Noviembre,Islas Fiji,1,3,,4,-74.140516,4.697157
58961,2018,Noviembre,Filipinas,5,92,,97,-75.527794,10.406342
58962,2018,Noviembre,Filipinas,10,54,,64,-75.516486,10.446304
58963,2018,Noviembre,Filipinas,0,17,,17,-74.77647900000001,10.886686
58964,2018,Noviembre,Filipinas,0,14,,14,-74.765343,10.970933
58965,2018,Noviembre,Filipinas,0,14,,14,-74.213989,11.247722999999999
58966,2018,Noviembre,Filipinas,0,6,,6,-76.532004,3.451668
58967,2018,Noviembre,Filipinas,0,13,,13,-77.061029,3.8844260000000004
58968,2018,Noviembre,Filipinas,49,74,,123,-74.140516,4.697157
58969,2018,Noviembre,Filipinas,6,3,,9,-75.42726,6.170465
58970,2018,Noviembre,Filipinas,0,1,,1,-75.68164200000001,9.402597
58971,2018,Noviembre,Finlandia,1,0,,1,-69.941498,4.191162
58972,2018,Noviembre,Finlandia,5,3,,8,-77.35600000000001,0.81488
58973,2018,Noviembre,Finlandia,1,0,,1,-75.527794,10.406342
58974,2018,Noviembre,Finlandia,7,11,,18,-75.516486,10.446304
58975,2018,Noviembre,Finlandia,2,5,,7,-74.77647900000001,10.886686
58976,2018,Noviembre,Finlandia,1,3,,4,-76.532004,3.451668
58977,2018,Noviembre,Finlandia,68,82,,150,-74.140516,4.697157
58978,2018,Noviembre,Finlandia,0,1,,1,-75.736374,4.815189
58979,2018,Noviembre,Finlandia,5,7,,12,-75.42726,6.170465
58980,2018,Noviembre,Francia,5,9,,14,-69.941498,4.191162
58981,2018,Noviembre,Francia,10,20,,30,-69.94143100000001,4.214082
58982,2018,Noviembre,Francia,5,5,,10,-76.876446,0.33002
58983,2018,Noviembre,Francia,57,80,,137,-77.35600000000001,0.81488
58984,2018,Noviembre,Francia,25,110,,135,-75.527794,10.406342
58985,2018,Noviembre,Francia,157,263,,420,-75.516486,10.446304
58986,2018,Noviembre,Francia,11,24,,35,-74.77647900000001,10.886686
58987,2018,Noviembre,Francia,2,3,,5,-74.213989,11.247722999999999
58988,2018,Noviembre,Francia,1,3,,4,-72.129595,11.360028999999999
58989,2018,Noviembre,Francia,1,3,,4,-81.703935,12.574411099999999
58990,2018,Noviembre,Francia,0,1,,1,-81.70216500000001,12.5862
58991,2018,Noviembre,Francia,0,3,,3,-81.372937,13.338761300000002
58992,2018,Noviembre,Francia,55,103,,158,-76.532004,3.451668
58993,2018,Noviembre,Francia,2132,2940,,5072,-74.140516,4.697157
58994,2018,Noviembre,Francia,8,7,,15,-75.736374,4.815189
58995,2018,Noviembre,Francia,178,318,,496,-75.42726,6.170465
58996,2018,Noviembre,Francia,0,1,,1,-67.48402800000001,6.185536
58997,2018,Noviembre,Francia,1,1,,2,-70.74025300000001,7.088728999999999
58998,2018,Noviembre,Francia,3,8,,11,-73.181317,7.1280470000000005
58999,2018,Noviembre,Francia,4,3,,7,-72.453013,7.819
59000,2018,Noviembre,Francia,1,0,,1,-72.409396,8.36068
59001,2018,Noviembre,Francia,5,13,,18,-77.35002,8.63337
59002,2018,Noviembre,Francia,0,1,,1,-75.68164200000001,9.402597
59003,2018,Noviembre,Gabón,1,0,,1,-74.140516,4.697157
59004,2018,Noviembre,Gambia,0,1,,1,-74.140516,4.697157
59005,2018,Noviembre,Georgia,0,6,,6,-75.516486,10.446304
59006,2018,Noviembre,Georgia,0,1,,1,-74.77647900000001,10.886686
59007,2018,Noviembre,Georgia,0,1,,1,-74.213989,11.247722999999999
59008,2018,Noviembre,Georgia,2,3,,5,-74.140516,4.697157
59009,2018,Noviembre,Ghana,0,1,,1,-77.35600000000001,0.81488
59010,2018,Noviembre,Ghana,4,6,,10,-74.140516,4.697157
59011,2018,Noviembre,Ghana,1,1,,2,-75.42726,6.170465
59012,2018,Noviembre,Granada,1,0,,1,-75.527794,10.406342
59013,2018,Noviembre,Granada,0,1,,1,-75.516486,10.446304
59014,2018,Noviembre,Granada,0,3,,3,-81.70216500000001,12.5862
59015,2018,Noviembre,Granada,0,5,,5,-74.140516,4.697157
59016,2018,Noviembre,Granada,1,1,,2,-75.42726,6.170465
59017,2018,Noviembre,Grecia,1,0,,1,-77.35600000000001,0.81488
59018,2018,Noviembre,Grecia,0,4,,4,-75.527794,10.406342
59019,2018,Noviembre,Grecia,3,19,,22,-75.516486,10.446304
59020,2018,Noviembre,Grecia,0,2,,2,-74.77647900000001,10.886686
59021,2018,Noviembre,Grecia,0,2,,2,-74.765343,10.970933
59022,2018,Noviembre,Grecia,0,3,,3,-76.532004,3.451668
59023,2018,Noviembre,Grecia,0,1,,1,-77.061029,3.8844260000000004
59024,2018,Noviembre,Grecia,39,86,,125,-74.140516,4.697157
59025,2018,Noviembre,Grecia,1,17,,18,-75.42726,6.170465
59026,2018,Noviembre,Grecia,0,4,,4,-76.7333,8.06667
59027,2018,Noviembre,Grecia,1,1,,2,-75.68164200000001,9.402597
59028,2018,Noviembre,Guatemala,1,3,,4,-77.35600000000001,0.81488
59029,2018,Noviembre,Guatemala,4,4,,8,-75.527794,10.406342
59030,2018,Noviembre,Guatemala,217,218,,435,-75.516486,10.446304
59031,2018,Noviembre,Guatemala,10,16,,26,-74.77647900000001,10.886686
59032,2018,Noviembre,Guatemala,0,1,,1,-72.129595,11.360028999999999
59033,2018,Noviembre,Guatemala,10,7,,17,-81.70216500000001,12.5862
59034,2018,Noviembre,Guatemala,54,75,,129,-76.532004,3.451668
59035,2018,Noviembre,Guatemala,0,1,,1,-75.76635300000001,4.45285
59036,2018,Noviembre,Guatemala,651,964,,1615,-74.140516,4.697157
59037,2018,Noviembre,Guatemala,12,19,,31,-75.736374,4.815189
59038,2018,Noviembre,Guatemala,85,178,,263,-75.42726,6.170465
59039,2018,Noviembre,Guatemala,2,3,,5,-73.181317,7.1280470000000005
59040,2018,Noviembre,Guatemala,0,2,,2,-72.453013,7.819
59041,2018,Noviembre,Guatemala,1,0,,1,-72.409396,8.36068
59042,2018,Noviembre,Guatemala,1,1,,2,-77.35002,8.63337
59043,2018,Noviembre,Guyana,1,4,,5,-75.516486,10.446304
59044,2018,Noviembre,Guyana,0,1,,1,-72.129595,11.360028999999999
59045,2018,Noviembre,Guyana,3,3,,6,-76.532004,3.451668
59046,2018,Noviembre,Guyana,9,12,,21,-74.140516,4.697157
59047,2018,Noviembre,Guyana,0,2,,2,-75.42726,6.170465
59048,2018,Noviembre,Guyana,1,0,,1,-73.181317,7.1280470000000005
59049,2018,Noviembre,Guyana,0,1,,1,-72.453013,7.819
59050,2018,Noviembre,Haití,1,0,,1,-77.35600000000001,0.81488
59051,2018,Noviembre,Haití,2,2,,4,-75.516486,10.446304
59052,2018,Noviembre,Haití,0,1,,1,-74.77647900000001,10.886686
59053,2018,Noviembre,Haití,6,11,,17,-74.140516,4.697157
59054,2018,Noviembre,Haití,2,6,,8,-75.42726,6.170465
59055,2018,Noviembre,Haití,0,1,,1,-72.453013,7.819
59056,2018,Noviembre,Honduras,3,4,,7,-77.35600000000001,0.81488
59057,2018,Noviembre,Honduras,0,1,,1,-78.802679,18.00143
59058,2018,Noviembre,Honduras,2,3,,5,-75.527794,10.406342
59059,2018,Noviembre,Honduras,125,113,,238,-75.516486,10.446304
59060,2018,Noviembre,Honduras,15,19,,34,-74.77647900000001,10.886686
59061,2018,Noviembre,Honduras,0,1,,1,-74.213989,11.247722999999999
59062,2018,Noviembre,Honduras,0,3,,3,-81.703935,12.574411099999999
59063,2018,Noviembre,Honduras,0,1,,1,-81.70216500000001,12.5862
59064,2018,Noviembre,Honduras,38,49,,87,-76.532004,3.451668
59065,2018,Noviembre,Honduras,0,1,,1,-77.061029,3.8844260000000004
59066,2018,Noviembre,Honduras,334,351,,685,-74.140516,4.697157
59067,2018,Noviembre,Honduras,4,10,,14,-75.736374,4.815189
59068,2018,Noviembre,Honduras,58,58,,116,-75.42726,6.170465
59069,2018,Noviembre,Honduras,1,6,,7,-73.181317,7.1280470000000005
59070,2018,Noviembre,Honduras,0,1,,1,-72.453013,7.819
59071,2018,Noviembre,Hong Kong,0,1,,1,-69.941498,4.191162
59072,2018,Noviembre,Hong Kong,2,2,,4,-75.516486,10.446304
59073,2018,Noviembre,Hong Kong,12,12,,24,-74.140516,4.697157
59074,2018,Noviembre,Hong Kong,1,3,,4,-75.42726,6.170465
59075,2018,Noviembre,Hungría,0,1,,1,-69.941498,4.191162
59076,2018,Noviembre,Hungría,1,0,,1,-75.527794,10.406342
59077,2018,Noviembre,Hungría,10,19,,29,-75.516486,10.446304
59078,2018,Noviembre,Hungría,0,3,,3,-74.77647900000001,10.886686
59079,2018,Noviembre,Hungría,75,84,,159,-74.140516,4.697157
59080,2018,Noviembre,Hungría,6,8,,14,-75.42726,6.170465
59081,2018,Noviembre,Hungría,0,1,,1,-72.453013,7.819
59082,2018,Noviembre,India,0,2,,2,-69.941498,4.191162
59083,2018,Noviembre,India,0,2,,2,-77.35600000000001,0.81488
59084,2018,Noviembre,India,1,1,,2,-78.802679,18.00143
59085,2018,Noviembre,India,2,11,,13,-75.527794,10.406342
59086,2018,Noviembre,India,37,86,,123,-75.516486,10.446304
59087,2018,Noviembre,India,1,17,,18,-74.77647900000001,10.886686
59088,2018,Noviembre,India,0,9,,9,-74.765343,10.970933
59089,2018,Noviembre,India,0,3,,3,-74.213989,11.247722999999999
59090,2018,Noviembre,India,5,22,,27,-76.532004,3.451668
59091,2018,Noviembre,India,0,3,,3,-77.061029,3.8844260000000004
59092,2018,Noviembre,India,0,1,,1,-75.76635300000001,4.45285
59093,2018,Noviembre,India,98,446,,544,-74.140516,4.697157
59094,2018,Noviembre,India,0,4,,4,-75.736374,4.815189
59095,2018,Noviembre,India,18,102,,120,-75.42726,6.170465
59096,2018,Noviembre,India,0,1,,1,-73.181317,7.1280470000000005
59097,2018,Noviembre,India,0,1,,1,-77.35002,8.63337
59098,2018,Noviembre,India,0,5,,5,-75.68164200000001,9.402597
59099,2018,Noviembre,Indonesia,0,22,,22,-75.527794,10.406342
59100,2018,Noviembre,Indonesia,2,4,,6,-75.516486,10.446304
59101,2018,Noviembre,Indonesia,0,1,,1,-77.061029,3.8844260000000004
59102,2018,Noviembre,Indonesia,13,32,,45,-74.140516,4.697157
59103,2018,Noviembre,Indonesia,0,2,,2,-75.42726,6.170465
59104,2018,Noviembre,Irán,1,0,,1,-77.35600000000001,0.81488
59105,2018,Noviembre,Irán,0,1,,1,-75.516486,10.446304
59106,2018,Noviembre,Irán,1,0,,1,-74.77647900000001,10.886686
59107,2018,Noviembre,Irán,5,9,,14,-74.140516,4.697157
59108,2018,Noviembre,Irán,0,2,,2,-75.42726,6.170465
59109,2018,Noviembre,República de Irlanda,0,1,,1,-69.941498,4.191162
59110,2018,Noviembre,República de Irlanda,0,1,,1,-69.94143100000001,4.214082
59111,2018,Noviembre,República de Irlanda,3,3,,6,-76.876446,0.33002
59112,2018,Noviembre,República de Irlanda,3,10,,13,-77.35600000000001,0.81488
59113,2018,Noviembre,República de Irlanda,10,0,,10,-75.527794,10.406342
59114,2018,Noviembre,República de Irlanda,10,29,,39,-75.516486,10.446304
59115,2018,Noviembre,República de Irlanda,1,2,,3,-74.77647900000001,10.886686
59116,2018,Noviembre,República de Irlanda,0,9,,9,-76.532004,3.451668
59117,2018,Noviembre,República de Irlanda,142,254,,396,-74.140516,4.697157
59118,2018,Noviembre,República de Irlanda,6,30,,36,-75.42726,6.170465
59119,2018,Noviembre,República de Irlanda,0,1,,1,-72.453013,7.819
59120,2018,Noviembre,República de Irlanda,7,14,,21,-77.35002,8.63337
59121,2018,Noviembre,Islandia,0,1,,1,-77.35600000000001,0.81488
59122,2018,Noviembre,Islandia,0,4,,4,-75.516486,10.446304
59123,2018,Noviembre,Islandia,4,15,,19,-74.140516,4.697157
59124,2018,Noviembre,Islandia,0,2,,2,-75.42726,6.170465
59125,2018,Noviembre,Israel,0,1,,1,-69.941498,4.191162
59126,2018,Noviembre,Israel,0,1,,1,-69.94143100000001,4.214082
59127,2018,Noviembre,Israel,0,1,,1,-76.876446,0.33002
59128,2018,Noviembre,Israel,6,16,,22,-77.35600000000001,0.81488
59129,2018,Noviembre,Israel,1,0,,1,-78.802679,18.00143
59130,2018,Noviembre,Israel,0,4,,4,-75.527794,10.406342
59131,2018,Noviembre,Israel,15,51,,66,-75.516486,10.446304
59132,2018,Noviembre,Israel,1,4,,5,-74.77647900000001,10.886686
59133,2018,Noviembre,Israel,0,4,,4,-81.703935,12.574411099999999
59134,2018,Noviembre,Israel,3,15,,18,-76.532004,3.451668
59135,2018,Noviembre,Israel,87,335,,422,-74.140516,4.697157
59136,2018,Noviembre,Israel,12,52,,64,-75.42726,6.170465
59137,2018,Noviembre,Israel,0,1,,1,-77.35002,8.63337
59138,2018,Noviembre,Italia,3,6,,9,-69.941498,4.191162
59139,2018,Noviembre,Italia,1,2,,3,-76.876446,0.33002
59140,2018,Noviembre,Italia,20,18,,38,-77.35600000000001,0.81488
59141,2018,Noviembre,Italia,5,15,,20,-75.527794,10.406342
59142,2018,Noviembre,Italia,74,246,,320,-75.516486,10.446304
59143,2018,Noviembre,Italia,18,42,,60,-74.77647900000001,10.886686
59144,2018,Noviembre,Italia,0,1,,1,-74.213989,11.247722999999999
59145,2018,Noviembre,Italia,5,9,,14,-72.129595,11.360028999999999
59146,2018,Noviembre,Italia,3,7,,10,-81.70216500000001,12.5862
59147,2018,Noviembre,Italia,37,96,,133,-76.532004,3.451668
59148,2018,Noviembre,Italia,0,1,,1,-73.61246899999999,4.16909
59149,2018,Noviembre,Italia,0,1,,1,-75.76635300000001,4.45285
59150,2018,Noviembre,Italia,762,2017,,2779,-74.140516,4.697157
59151,2018,Noviembre,Italia,1,4,,5,-75.736374,4.815189
59152,2018,Noviembre,Italia,79,265,,344,-75.42726,6.170465
59153,2018,Noviembre,Italia,1,2,,3,-70.74025300000001,7.088728999999999
59154,2018,Noviembre,Italia,0,3,,3,-73.181317,7.1280470000000005
59155,2018,Noviembre,Italia,13,12,,25,-72.453013,7.819
59156,2018,Noviembre,Italia,4,3,,7,-72.409396,8.36068
59157,2018,Noviembre,Italia,2,4,,6,-77.35002,8.63337
59158,2018,Noviembre,Jamaica,9,9,,18,-75.516486,10.446304
59159,2018,Noviembre,Jamaica,0,1,,1,-74.77647900000001,10.886686
59160,2018,Noviembre,Jamaica,1,4,,5,-81.70216500000001,12.5862
59161,2018,Noviembre,Jamaica,3,5,,8,-76.532004,3.451668
59162,2018,Noviembre,Jamaica,30,37,,67,-74.140516,4.697157
59163,2018,Noviembre,Jamaica,0,2,,2,-75.736374,4.815189
59164,2018,Noviembre,Jamaica,4,7,,11,-75.42726,6.170465
59165,2018,Noviembre,Japón,0,1,,1,-69.941498,4.191162
59166,2018,Noviembre,Japón,2,1,,3,-69.94143100000001,4.214082
59167,2018,Noviembre,Japón,2,5,,7,-77.35600000000001,0.81488
59168,2018,Noviembre,Japón,0,8,,8,-75.527794,10.406342
59169,2018,Noviembre,Japón,11,25,,36,-75.516486,10.446304
59170,2018,Noviembre,Japón,3,3,,6,-74.77647900000001,10.886686
59171,2018,Noviembre,Japón,0,1,,1,-81.70216500000001,12.5862
59172,2018,Noviembre,Japón,3,9,,12,-76.532004,3.451668
59173,2018,Noviembre,Japón,136,504,,640,-74.140516,4.697157
59174,2018,Noviembre,Japón,0,2,,2,-75.736374,4.815189
59175,2018,Noviembre,Japón,15,59,,74,-75.42726,6.170465
59176,2018,Noviembre,Japón,0,2,,2,-72.453013,7.819
59177,2018,Noviembre,Jordania,0,1,,1,-75.516486,10.446304
59178,2018,Noviembre,Jordania,0,5,,5,-74.140516,4.697157
59179,2018,Noviembre,Jordania,1,0,,1,-75.42726,6.170465
59180,2018,Noviembre,Kazajistán,1,2,,3,-75.516486,10.446304
59181,2018,Noviembre,Kazajistán,0,1,,1,-74.77647900000001,10.886686
59182,2018,Noviembre,Kazajistán,5,2,,7,-74.140516,4.697157
59183,2018,Noviembre,Kazajistán,1,2,,3,-75.42726,6.170465
59184,2018,Noviembre,Kenia,0,1,,1,-76.876446,0.33002
59185,2018,Noviembre,Kenia,0,1,,1,-75.516486,10.446304
59186,2018,Noviembre,Kenia,2,2,,4,-76.532004,3.451668
59187,2018,Noviembre,Kenia,9,7,,16,-74.140516,4.697157
59188,2018,Noviembre,Kenia,0,1,,1,-75.42726,6.170465
59189,2018,Noviembre,Kuwait,2,6,,8,-74.140516,4.697157
59190,2018,Noviembre,Kuwait,1,0,,1,-75.42726,6.170465
59191,2018,Noviembre,República de Kosovo,1,0,,1,-74.140516,4.697157
59192,2018,Noviembre,República Democrática Popular  Lao,0,1,,1,-74.140516,4.697157
59193,2018,Noviembre,Letonia,2,5,,7,-75.516486,10.446304
59194,2018,Noviembre,Letonia,1,1,,2,-76.532004,3.451668
59195,2018,Noviembre,Letonia,2,0,,2,-75.76635300000001,4.45285
59196,2018,Noviembre,Letonia,13,19,,32,-74.140516,4.697157
59197,2018,Noviembre,Letonia,0,2,,2,-75.42726,6.170465
59198,2018,Noviembre,Letonia,0,1,,1,-72.409396,8.36068
59199,2018,Noviembre,Letonia,0,3,,3,-75.68164200000001,9.402597
59200,2018,Noviembre,Lituania,1,0,,1,-77.35600000000001,0.81488
59201,2018,Noviembre,Lituania,4,10,,14,-75.516486,10.446304
59202,2018,Noviembre,Lituania,1,0,,1,-74.77647900000001,10.886686
59203,2018,Noviembre,Lituania,0,1,,1,-74.213989,11.247722999999999
59204,2018,Noviembre,Lituania,2,3,,5,-76.532004,3.451668
59205,2018,Noviembre,Lituania,0,1,,1,-77.061029,3.8844260000000004
59206,2018,Noviembre,Lituania,39,32,,71,-74.140516,4.697157
59207,2018,Noviembre,Lituania,4,4,,8,-75.42726,6.170465
59208,2018,Noviembre,Lituania,0,1,,1,-75.68164200000001,9.402597
59209,2018,Noviembre,Líbano,0,3,,3,-75.527794,10.406342
59210,2018,Noviembre,Líbano,0,1,,1,-75.516486,10.446304
59211,2018,Noviembre,Líbano,4,4,,8,-74.77647900000001,10.886686
59212,2018,Noviembre,Líbano,2,2,,4,-72.129595,11.360028999999999
59213,2018,Noviembre,Líbano,1,0,,1,-81.70216500000001,12.5862
59214,2018,Noviembre,Líbano,1,1,,2,-76.532004,3.451668
59215,2018,Noviembre,Líbano,12,24,,36,-74.140516,4.697157
59216,2018,Noviembre,Líbano,2,4,,6,-75.42726,6.170465
59217,2018,Noviembre,Liberia,0,1,,1,-75.516486,10.446304
59218,2018,Noviembre,Liberia,0,1,,1,-75.42726,6.170465
59219,2018,Noviembre,Libia,2,2,,4,-74.140516,4.697157
59220,2018,Noviembre,Libia,0,1,,1,-75.42726,6.170465
59221,2018,Noviembre,Liechtenstein,2,4,,6,-74.140516,4.697157
59222,2018,Noviembre,Luxemburgo,0,2,,2,-75.516486,10.446304
59223,2018,Noviembre,Luxemburgo,0,1,,1,-76.532004,3.451668
59224,2018,Noviembre,Luxemburgo,9,14,,23,-74.140516,4.697157
59225,2018,Noviembre,Luxemburgo,0,1,,1,-75.42726,6.170465
59226,2018,Noviembre,Macedonia,1,0,,1,-74.77647900000001,10.886686
59227,2018,Noviembre,Macedonia,0,1,,1,-76.532004,3.451668
59228,2018,Noviembre,Macedonia,3,5,,8,-74.140516,4.697157
59229,2018,Noviembre,Madagascar,5,1,,6,-74.140516,4.697157
59230,2018,Noviembre,Madagascar,2,0,,2,-75.42726,6.170465
59231,2018,Noviembre,Malasia,1,1,,2,-77.35600000000001,0.81488
59232,2018,Noviembre,Malasia,2,0,,2,-75.516486,10.446304
59233,2018,Noviembre,Malasia,0,1,,1,-74.213989,11.247722999999999
59234,2018,Noviembre,Malasia,20,36,,56,-74.140516,4.697157
59235,2018,Noviembre,Malasia,0,2,,2,-75.42726,6.170465
59236,2018,Noviembre,Malawi,1,1,,2,-74.140516,4.697157
59237,2018,Noviembre,Malta,1,0,,1,-75.516486,10.446304
59238,2018,Noviembre,Malta,7,7,,14,-74.140516,4.697157
59239,2018,Noviembre,Malta,0,1,,1,-75.42726,6.170465
59240,2018,Noviembre,Malta,1,0,,1,-72.453013,7.819
59241,2018,Noviembre,Marruecos,1,0,,1,-77.35600000000001,0.81488
59242,2018,Noviembre,Marruecos,1,0,,1,-75.516486,10.446304
59243,2018,Noviembre,Marruecos,1,0,,1,-74.77647900000001,10.886686
59244,2018,Noviembre,Marruecos,1,0,,1,-76.532004,3.451668
59245,2018,Noviembre,Marruecos,17,23,,40,-74.140516,4.697157
59246,2018,Noviembre,Marruecos,0,1,,1,-75.42726,6.170465
59247,2018,Noviembre,Mauricio,0,5,,5,-75.527794,10.406342
59248,2018,Noviembre,Mauricio,0,4,,4,-74.140516,4.697157
59249,2018,Noviembre,Mauricio,0,2,,2,-75.42726,6.170465
59250,2018,Noviembre,México,2,1,,3,-69.941498,4.191162
59251,2018,Noviembre,México,1,0,,1,-76.876446,0.33002
59252,2018,Noviembre,México,22,33,,55,-77.35600000000001,0.81488
59253,2018,Noviembre,México,17,21,,38,-75.527794,10.406342
59254,2018,Noviembre,México,273,404,,677,-75.516486,10.446304
59255,2018,Noviembre,México,42,71,,113,-74.77647900000001,10.886686
59256,2018,Noviembre,México,0,1,,1,-74.232675,11.117206
59257,2018,Noviembre,México,2,3,,5,-72.129595,11.360028999999999
59258,2018,Noviembre,México,0,3,,3,-81.703935,12.574411099999999
59259,2018,Noviembre,México,2,1,,3,-81.70216500000001,12.5862
59260,2018,Noviembre,México,108,199,,307,-76.532004,3.451668
59261,2018,Noviembre,México,3,7,,10,-73.61246899999999,4.16909
59262,2018,Noviembre,México,0,1,,1,-75.76635300000001,4.45285
59263,2018,Noviembre,México,5049,8277,,13326,-74.140516,4.697157
59264,2018,Noviembre,México,14,26,,40,-75.736374,4.815189
59265,2018,Noviembre,México,585,1285,,1870,-75.42726,6.170465
59266,2018,Noviembre,México,1,2,,3,-70.74025300000001,7.088728999999999
59267,2018,Noviembre,México,6,16,,22,-73.181317,7.1280470000000005
59268,2018,Noviembre,México,6,16,,22,-72.453013,7.819
59269,2018,Noviembre,México,3,9,,12,-72.409396,8.36068
59270,2018,Noviembre,México,0,1,,1,-77.35002,8.63337
59271,2018,Noviembre,República de Moldavia,2,1,,3,-74.140516,4.697157
59272,2018,Noviembre,Mongolia,1,0,,1,-74.140516,4.697157
59273,2018,Noviembre,Montenegro,1,0,,1,-75.527794,10.406342
59274,2018,Noviembre,Montenegro,0,4,,4,-75.516486,10.446304
59275,2018,Noviembre,Montenegro,0,1,,1,-76.532004,3.451668
59276,2018,Noviembre,Montenegro,3,6,,9,-74.140516,4.697157
59277,2018,Noviembre,Montenegro,0,1,,1,-75.42726,6.170465
59278,2018,Noviembre,Mozambique,3,5,,8,-74.140516,4.697157
59279,2018,Noviembre,Myanmar,0,4,,4,-75.527794,10.406342
59280,2018,Noviembre,Myanmar,0,4,,4,-75.516486,10.446304
59281,2018,Noviembre,Myanmar,0,3,,3,-74.77647900000001,10.886686
59282,2018,Noviembre,Myanmar,0,2,,2,-77.061029,3.8844260000000004
59283,2018,Noviembre,Myanmar,1,1,,2,-74.140516,4.697157
59284,2018,Noviembre,Myanmar,1,0,,1,-75.736374,4.815189
59285,2018,Noviembre,Namibia,0,1,,1,-75.527794,10.406342
59286,2018,Noviembre,Nepal,1,5,,6,-74.140516,4.697157
59287,2018,Noviembre,Nepal,1,0,,1,-75.42726,6.170465
59288,2018,Noviembre,Nicaragua,0,1,,1,-75.527794,10.406342
59289,2018,Noviembre,Nicaragua,29,53,,82,-75.516486,10.446304
59290,2018,Noviembre,Nicaragua,3,6,,9,-74.77647900000001,10.886686
59291,2018,Noviembre,Nicaragua,0,4,,4,-81.703935,12.574411099999999
59292,2018,Noviembre,Nicaragua,19,22,,41,-76.532004,3.451668
59293,2018,Noviembre,Nicaragua,87,122,,209,-74.140516,4.697157
59294,2018,Noviembre,Nicaragua,0,3,,3,-75.736374,4.815189
59295,2018,Noviembre,Nicaragua,26,27,,53,-75.42726,6.170465
59296,2018,Noviembre,Nicaragua,0,2,,2,-72.453013,7.819
59297,2018,Noviembre,Nigeria,0,1,,1,-75.527794,10.406342
59298,2018,Noviembre,Nigeria,0,2,,2,-75.516486,10.446304
59299,2018,Noviembre,Nigeria,1,0,,1,-76.532004,3.451668
59300,2018,Noviembre,Nigeria,7,8,,15,-74.140516,4.697157
59301,2018,Noviembre,Nigeria,0,1,,1,-75.42726,6.170465
59302,2018,Noviembre,Noruega,0,1,,1,-69.941498,4.191162
59303,2018,Noviembre,Noruega,2,0,,2,-77.35600000000001,0.81488
59304,2018,Noviembre,Noruega,2,4,,6,-75.527794,10.406342
59305,2018,Noviembre,Noruega,22,21,,43,-75.516486,10.446304
59306,2018,Noviembre,Noruega,5,3,,8,-74.77647900000001,10.886686
59307,2018,Noviembre,Noruega,1,1,,2,-74.213989,11.247722999999999
59308,2018,Noviembre,Noruega,2,7,,9,-76.532004,3.451668
59309,2018,Noviembre,Noruega,162,211,,373,-74.140516,4.697157
59310,2018,Noviembre,Noruega,1,3,,4,-75.736374,4.815189
59311,2018,Noviembre,Noruega,6,17,,23,-75.42726,6.170465
59312,2018,Noviembre,Nueva Zelanda,5,7,,12,-77.35600000000001,0.81488
59313,2018,Noviembre,Nueva Zelanda,4,4,,8,-75.527794,10.406342
59314,2018,Noviembre,Nueva Zelanda,12,12,,24,-75.516486,10.446304
59315,2018,Noviembre,Nueva Zelanda,1,6,,7,-74.77647900000001,10.886686
59316,2018,Noviembre,Nueva Zelanda,1,4,,5,-76.532004,3.451668
59317,2018,Noviembre,Nueva Zelanda,100,146,,246,-74.140516,4.697157
59318,2018,Noviembre,Nueva Zelanda,0,1,,1,-75.736374,4.815189
59319,2018,Noviembre,Nueva Zelanda,7,18,,25,-75.42726,6.170465
59320,2018,Noviembre,Nueva Zelanda,2,3,,5,-77.35002,8.63337
59321,2018,Noviembre,Omán,0,1,,1,-75.42726,6.170465
59322,2018,Noviembre,Países Bajos,2,6,,8,-69.941498,4.191162
59323,2018,Noviembre,Países Bajos,3,2,,5,-69.94143100000001,4.214082
59324,2018,Noviembre,Países Bajos,1,1,,2,-76.876446,0.33002
59325,2018,Noviembre,Países Bajos,25,28,,53,-77.35600000000001,0.81488
59326,2018,Noviembre,Países Bajos,24,21,,45,-75.527794,10.406342
59327,2018,Noviembre,Países Bajos,258,266,,524,-75.516486,10.446304
59328,2018,Noviembre,Países Bajos,5,24,,29,-74.77647900000001,10.886686
59329,2018,Noviembre,Países Bajos,3,3,,6,-74.213989,11.247722999999999
59330,2018,Noviembre,Países Bajos,0,1,,1,-72.129595,11.360028999999999
59331,2018,Noviembre,Países Bajos,0,2,,2,-81.70216500000001,12.5862
59332,2018,Noviembre,Países Bajos,48,59,,107,-76.532004,3.451668
59333,2018,Noviembre,Países Bajos,0,3,,3,-77.061029,3.8844260000000004
59334,2018,Noviembre,Países Bajos,1739,2391,,4130,-74.140516,4.697157
59335,2018,Noviembre,Países Bajos,4,2,,6,-75.736374,4.815189
59336,2018,Noviembre,Países Bajos,116,207,,323,-75.42726,6.170465
59337,2018,Noviembre,Países Bajos,7,6,,13,-73.181317,7.1280470000000005
59338,2018,Noviembre,Países Bajos,1,7,,8,-72.453013,7.819
59339,2018,Noviembre,Países Bajos,2,0,,2,-72.508188,7.927233
59340,2018,Noviembre,Países Bajos,0,2,,2,-72.409396,8.36068
59341,2018,Noviembre,Países Bajos,16,13,,29,-77.35002,8.63337
59342,2018,Noviembre,Pakistán,0,1,,1,-69.941498,4.191162
59343,2018,Noviembre,Pakistán,2,6,,8,-75.516486,10.446304
59344,2018,Noviembre,Pakistán,0,1,,1,-74.213989,11.247722999999999
59345,2018,Noviembre,Pakistán,7,19,,26,-74.140516,4.697157
59346,2018,Noviembre,Panamá,1,4,,5,-77.35600000000001,0.81488
59347,2018,Noviembre,Panamá,1,22,,23,-75.527794,10.406342
59348,2018,Noviembre,Panamá,782,722,,1504,-75.516486,10.446304
59349,2018,Noviembre,Panamá,74,108,,182,-74.77647900000001,10.886686
59350,2018,Noviembre,Panamá,57,25,,82,-74.232675,11.117206
59351,2018,Noviembre,Panamá,0,2,,2,-81.703935,12.574411099999999
59352,2018,Noviembre,Panamá,83,75,,158,-81.70216500000001,12.5862
59353,2018,Noviembre,Panamá,342,362,,704,-76.532004,3.451668
59354,2018,Noviembre,Panamá,2,2,,4,-73.61246899999999,4.16909
59355,2018,Noviembre,Panamá,42,36,,78,-75.76635300000001,4.45285
59356,2018,Noviembre,Panamá,2642,2542,,5184,-74.140516,4.697157
59357,2018,Noviembre,Panamá,68,79,,147,-75.736374,4.815189
59358,2018,Noviembre,Panamá,2464,1978,,4442,-75.42726,6.170465
59359,2018,Noviembre,Panamá,0,1,,1,-77.401154,6.222551999999999
59360,2018,Noviembre,Panamá,1,3,,4,-77.762647,7.102626
59361,2018,Noviembre,Panamá,27,34,,61,-73.181317,7.1280470000000005
59362,2018,Noviembre,Panamá,3,2,,5,-72.453013,7.819
59363,2018,Noviembre,Panamá,0,7,,7,-77.35002,8.63337
59364,2018,Noviembre,Paraguay,0,1,,1,-77.35600000000001,0.81488
59365,2018,Noviembre,Paraguay,1,3,,4,-75.527794,10.406342
59366,2018,Noviembre,Paraguay,81,48,,129,-75.516486,10.446304
59367,2018,Noviembre,Paraguay,6,7,,13,-74.77647900000001,10.886686
59368,2018,Noviembre,Paraguay,77,44,,121,-81.70216500000001,12.5862
59369,2018,Noviembre,Paraguay,7,10,,17,-76.532004,3.451668
59370,2018,Noviembre,Paraguay,180,217,,397,-74.140516,4.697157
59371,2018,Noviembre,Paraguay,1,0,,1,-75.736374,4.815189
59372,2018,Noviembre,Paraguay,29,51,,80,-75.42726,6.170465
59373,2018,Noviembre,Paraguay,0,1,,1,-70.74025300000001,7.088728999999999
59374,2018,Noviembre,Paraguay,3,1,,4,-72.453013,7.819
59375,2018,Noviembre,Perú,15,16,,31,-69.941498,4.191162
59376,2018,Noviembre,Perú,17,37,,54,-69.94143100000001,4.214082
59377,2018,Noviembre,Perú,1,12,,13,-76.876446,0.33002
59378,2018,Noviembre,Perú,107,271,,378,-77.35600000000001,0.81488
59379,2018,Noviembre,Perú,35,25,,60,-75.527794,10.406342
59380,2018,Noviembre,Perú,1058,752,,1810,-75.516486,10.446304
59381,2018,Noviembre,Perú,4,15,,19,-74.77647900000001,10.886686
59382,2018,Noviembre,Perú,6,14,,20,-72.129595,11.360028999999999
59383,2018,Noviembre,Perú,254,182,,436,-81.70216500000001,12.5862
59384,2018,Noviembre,Perú,165,202,,367,-76.532004,3.451668
59385,2018,Noviembre,Perú,1,2,,3,-75.76635300000001,4.45285
59386,2018,Noviembre,Perú,3556,4460,,8016,-74.140516,4.697157
59387,2018,Noviembre,Perú,6,6,,12,-75.736374,4.815189
59388,2018,Noviembre,Perú,556,869,,1425,-75.42726,6.170465
59389,2018,Noviembre,Perú,0,1,,1,-67.48402800000001,6.185536
59390,2018,Noviembre,Perú,0,7,,7,-70.74025300000001,7.088728999999999
59391,2018,Noviembre,Perú,1,1,,2,-73.181317,7.1280470000000005
59392,2018,Noviembre,Perú,64,100,,164,-72.453013,7.819
59393,2018,Noviembre,Perú,2,5,,7,-72.409396,8.36068
59394,2018,Noviembre,Palestina,2,3,,5,-74.140516,4.697157
59395,2018,Noviembre,Polonia,25,4,,29,-69.941498,4.191162
59396,2018,Noviembre,Polonia,3,2,,5,-69.94143100000001,4.214082
59397,2018,Noviembre,Polonia,17,16,,33,-77.35600000000001,0.81488
59398,2018,Noviembre,Polonia,28,43,,71,-75.527794,10.406342
59399,2018,Noviembre,Polonia,51,69,,120,-75.516486,10.446304
59400,2018,Noviembre,Polonia,1,2,,3,-74.77647900000001,10.886686
59401,2018,Noviembre,Polonia,0,4,,4,-74.765343,10.970933
59402,2018,Noviembre,Polonia,1,0,,1,-74.213989,11.247722999999999
59403,2018,Noviembre,Polonia,3,0,,3,-76.532004,3.451668
59404,2018,Noviembre,Polonia,332,361,,693,-74.140516,4.697157
59405,2018,Noviembre,Polonia,1,0,,1,-75.736374,4.815189
59406,2018,Noviembre,Polonia,13,19,,32,-75.42726,6.170465
59407,2018,Noviembre,Polonia,0,1,,1,-72.453013,7.819
59408,2018,Noviembre,Polonia,0,2,,2,-77.35002,8.63337
59409,2018,Noviembre,Portugal,0,1,,1,-69.941498,4.191162
59410,2018,Noviembre,Portugal,1,0,,1,-69.94143100000001,4.214082
59411,2018,Noviembre,Portugal,3,1,,4,-77.35600000000001,0.81488
59412,2018,Noviembre,Portugal,1,3,,4,-75.527794,10.406342
59413,2018,Noviembre,Portugal,11,21,,32,-75.516486,10.446304
59414,2018,Noviembre,Portugal,2,2,,4,-74.77647900000001,10.886686
59415,2018,Noviembre,Portugal,0,1,,1,-74.765343,10.970933
59416,2018,Noviembre,Portugal,0,1,,1,-74.213989,11.247722999999999
59417,2018,Noviembre,Portugal,3,2,,5,-72.129595,11.360028999999999
59418,2018,Noviembre,Portugal,1,1,,2,-81.70216500000001,12.5862
59419,2018,Noviembre,Portugal,2,11,,13,-76.532004,3.451668
59420,2018,Noviembre,Portugal,258,492,,750,-74.140516,4.697157
59421,2018,Noviembre,Portugal,2,4,,6,-75.736374,4.815189
59422,2018,Noviembre,Portugal,11,48,,59,-75.42726,6.170465
59423,2018,Noviembre,Portugal,5,21,,26,-72.453013,7.819
59424,2018,Noviembre,Portugal,2,1,,3,-72.409396,8.36068
59425,2018,Noviembre,Puerto Rico/Territorio de Estados Unidos,1,0,,1,-74.140516,4.697157
59426,2018,Noviembre,Qatar,1,0,,1,-77.35600000000001,0.81488
59427,2018,Noviembre,Qatar,0,1,,1,-75.42726,6.170465
59428,2018,Noviembre,Reino Unido de Gran Bretaña e Irlanda del Norte,5,4,,9,-69.941498,4.191162
59429,2018,Noviembre,Reino Unido de Gran Bretaña e Irlanda del Norte,3,6,,9,-69.94143100000001,4.214082
59430,2018,Noviembre,Reino Unido de Gran Bretaña e Irlanda del Norte,4,2,,6,-76.876446,0.33002
59431,2018,Noviembre,Reino Unido de Gran Bretaña e Irlanda del Norte,44,78,,122,-77.35600000000001,0.81488
59432,2018,Noviembre,Reino Unido de Gran Bretaña e Irlanda del Norte,14,27,,41,-75.527794,10.406342
59433,2018,Noviembre,Reino Unido de Gran Bretaña e Irlanda del Norte,111,204,,315,-75.516486,10.446304
59434,2018,Noviembre,Reino Unido de Gran Bretaña e Irlanda del Norte,5,24,,29,-74.77647900000001,10.886686
59435,2018,Noviembre,Reino Unido de Gran Bretaña e Irlanda del Norte,8,8,,16,-74.213989,11.247722999999999
59436,2018,Noviembre,Reino Unido de Gran Bretaña e Irlanda del Norte,2,2,,4,-81.703935,12.574411099999999
59437,2018,Noviembre,Reino Unido de Gran Bretaña e Irlanda del Norte,1,1,,2,-81.70216500000001,12.5862
59438,2018,Noviembre,Reino Unido de Gran Bretaña e Irlanda del Norte,22,44,,66,-76.532004,3.451668
59439,2018,Noviembre,Reino Unido de Gran Bretaña e Irlanda del Norte,0,1,,1,-77.061029,3.8844260000000004
59440,2018,Noviembre,Reino Unido de Gran Bretaña e Irlanda del Norte,1,0,,1,-75.76635300000001,4.45285
59441,2018,Noviembre,Reino Unido de Gran Bretaña e Irlanda del Norte,1120,2189,,3309,-74.140516,4.697157
59442,2018,Noviembre,Reino Unido de Gran Bretaña e Irlanda del Norte,1,4,,5,-75.736374,4.815189
59443,2018,Noviembre,Reino Unido de Gran Bretaña e Irlanda del Norte,96,264,,360,-75.42726,6.170465
59444,2018,Noviembre,Reino Unido de Gran Bretaña e Irlanda del Norte,0,2,,2,-72.453013,7.819
59445,2018,Noviembre,Reino Unido de Gran Bretaña e Irlanda del Norte,0,1,,1,-72.409396,8.36068
59446,2018,Noviembre,Reino Unido de Gran Bretaña e Irlanda del Norte,21,26,,47,-77.35002,8.63337
59447,2018,Noviembre,República Dominicana,0,1,,1,-69.941498,4.191162
59448,2018,Noviembre,República Dominicana,0,1,,1,-76.876446,0.33002
59449,2018,Noviembre,República Dominicana,5,14,,19,-77.35600000000001,0.81488
59450,2018,Noviembre,República Dominicana,14,12,,26,-75.527794,10.406342
59451,2018,Noviembre,República Dominicana,57,74,,131,-75.516486,10.446304
59452,2018,Noviembre,República Dominicana,65,33,,98,-74.77647900000001,10.886686
59453,2018,Noviembre,República Dominicana,0,2,,2,-74.232675,11.117206
59454,2018,Noviembre,República Dominicana,2,4,,6,-72.129595,11.360028999999999
59455,2018,Noviembre,República Dominicana,2,1,,3,-81.70216500000001,12.5862
59456,2018,Noviembre,República Dominicana,35,27,,62,-76.532004,3.451668
59457,2018,Noviembre,República Dominicana,1,1,,2,-75.76635300000001,4.45285
59458,2018,Noviembre,República Dominicana,1186,1128,,2314,-74.140516,4.697157
59459,2018,Noviembre,República Dominicana,3,2,,5,-75.736374,4.815189
59460,2018,Noviembre,República Dominicana,66,116,,182,-75.42726,6.170465
59461,2018,Noviembre,República Dominicana,0,1,,1,-70.74025300000001,7.088728999999999
59462,2018,Noviembre,República Dominicana,2,2,,4,-73.181317,7.1280470000000005
59463,2018,Noviembre,República Dominicana,4,3,,7,-72.453013,7.819
59464,2018,Noviembre,República Dominicana,1,1,,2,-72.409396,8.36068
59465,2018,Noviembre,Rumania,2,3,,5,-77.35600000000001,0.81488
59466,2018,Noviembre,Rumania,0,13,,13,-75.527794,10.406342
59467,2018,Noviembre,Rumania,16,20,,36,-75.516486,10.446304
59468,2018,Noviembre,Rumania,0,3,,3,-74.77647900000001,10.886686
59469,2018,Noviembre,Rumania,1,2,,3,-76.532004,3.451668
59470,2018,Noviembre,Rumania,0,1,,1,-77.061029,3.8844260000000004
59471,2018,Noviembre,Rumania,92,85,,177,-74.140516,4.697157
59472,2018,Noviembre,Rumania,0,1,,1,-75.736374,4.815189
59473,2018,Noviembre,Rumania,8,12,,20,-75.42726,6.170465
59474,2018,Noviembre,Rumania,0,1,,1,-70.74025300000001,7.088728999999999
59475,2018,Noviembre,Rumania,0,2,,2,-72.453013,7.819
59476,2018,Noviembre,Rumania,0,2,,2,-77.35002,8.63337
59477,2018,Noviembre,Rumania,0,1,,1,-75.68164200000001,9.402597
59478,2018,Noviembre,Federación de Rusia,7,4,,11,-77.35600000000001,0.81488
59479,2018,Noviembre,Federación de Rusia,2,13,,15,-75.527794,10.406342
59480,2018,Noviembre,Federación de Rusia,19,54,,73,-75.516486,10.446304
59481,2018,Noviembre,Federación de Rusia,0,6,,6,-74.77647900000001,10.886686
59482,2018,Noviembre,Federación de Rusia,0,4,,4,-74.765343,10.970933
59483,2018,Noviembre,Federación de Rusia,0,6,,6,-74.213989,11.247722999999999
59484,2018,Noviembre,Federación de Rusia,0,1,,1,-72.129595,11.360028999999999
59485,2018,Noviembre,Federación de Rusia,1,1,,2,-81.70216500000001,12.5862
59486,2018,Noviembre,Federación de Rusia,1,1,,2,-76.532004,3.451668
59487,2018,Noviembre,Federación de Rusia,201,251,,452,-74.140516,4.697157
59488,2018,Noviembre,Federación de Rusia,0,2,,2,-75.736374,4.815189
59489,2018,Noviembre,Federación de Rusia,15,22,,37,-75.42726,6.170465
59490,2018,Noviembre,Federación de Rusia,1,0,,1,-72.453013,7.819
59491,2018,Noviembre,Federación de Rusia,0,4,,4,-75.68164200000001,9.402597
59492,2018,Noviembre,San Cristóbal y Nevis,0,1,,1,-77.35600000000001,0.81488
59493,2018,Noviembre,San Cristóbal y Nevis,1,0,,1,-75.516486,10.446304
59494,2018,Noviembre,San Cristóbal y Nevis,2,2,,4,-74.140516,4.697157
59495,2018,Noviembre,San Marino,0,1,,1,-74.140516,4.697157
59496,2018,Noviembre,San  Vicente y las Granadinas,0,1,,1,-75.516486,10.446304
59497,2018,Noviembre,San  Vicente y las Granadinas,0,1,,1,-74.77647900000001,10.886686
59498,2018,Noviembre,San  Vicente y las Granadinas,1,0,,1,-76.532004,3.451668
59499,2018,Noviembre,San  Vicente y las Granadinas,1,0,,1,-75.42726,6.170465
59500,2018,Noviembre,Santa Lucia,0,2,,2,-75.527794,10.406342
59501,2018,Noviembre,Santa Lucia,1,0,,1,-75.516486,10.446304
59502,2018,Noviembre,Santa Lucia,0,1,,1,-81.70216500000001,12.5862
59503,2018,Noviembre,Santa Lucia,2,6,,8,-74.140516,4.697157
59504,2018,Noviembre,Santa Sede/Ciudad del Vaticano,0,1,,1,-74.140516,4.697157
59505,2018,Noviembre,Senegal,0,1,,1,-75.527794,10.406342
59506,2018,Noviembre,Senegal,1,0,,1,-76.532004,3.451668
59507,2018,Noviembre,Senegal,1,1,,2,-74.140516,4.697157
59508,2018,Noviembre,Serbia,0,1,,1,-76.876446,0.33002
59509,2018,Noviembre,Serbia,6,3,,9,-75.516486,10.446304
59510,2018,Noviembre,Serbia,0,1,,1,-74.213989,11.247722999999999
59511,2018,Noviembre,Serbia,1,6,,7,-76.532004,3.451668
59512,2018,Noviembre,Serbia,14,38,,52,-74.140516,4.697157
59513,2018,Noviembre,Serbia,5,3,,8,-75.42726,6.170465
59514,2018,Noviembre,Singapur,0,1,,1,-69.941498,4.191162
59515,2018,Noviembre,Singapur,7,5,,12,-75.516486,10.446304
59516,2018,Noviembre,Singapur,1,3,,4,-74.77647900000001,10.886686
59517,2018,Noviembre,Singapur,0,2,,2,-76.532004,3.451668
59518,2018,Noviembre,Singapur,15,34,,49,-74.140516,4.697157
59519,2018,Noviembre,Singapur,2,6,,8,-75.42726,6.170465
59520,2018,Noviembre,República Árabe Siria,0,1,,1,-74.77647900000001,10.886686
59521,2018,Noviembre,República Árabe Siria,0,1,,1,-72.129595,11.360028999999999
59522,2018,Noviembre,República Árabe Siria,2,6,,8,-74.140516,4.697157
59523,2018,Noviembre,República Árabe Siria,1,0,,1,-72.453013,7.819
59524,2018,Noviembre,Somalia,0,1,,1,-74.140516,4.697157
59525,2018,Noviembre,Sri Lanka,0,1,,1,-77.061029,3.8844260000000004
59526,2018,Noviembre,Sri Lanka,0,5,,5,-74.140516,4.697157
59527,2018,Noviembre,Sri Lanka,0,2,,2,-75.42726,6.170465
59528,2018,Noviembre,Sudáfrica,0,1,,1,-75.527794,10.406342
59529,2018,Noviembre,Sudáfrica,3,2,,5,-75.516486,10.446304
59530,2018,Noviembre,Sudáfrica,1,3,,4,-74.77647900000001,10.886686
59531,2018,Noviembre,Sudáfrica,1,2,,3,-76.532004,3.451668
59532,2018,Noviembre,Sudáfrica,26,81,,107,-74.140516,4.697157
59533,2018,Noviembre,Sudáfrica,1,6,,7,-75.42726,6.170465
59534,2018,Noviembre,Sudáfrica,0,1,,1,-73.181317,7.1280470000000005
59535,2018,Noviembre,Suecia,3,4,,7,-69.941498,4.191162
59536,2018,Noviembre,Suecia,12,13,,25,-77.35600000000001,0.81488
59537,2018,Noviembre,Suecia,4,2,,6,-75.527794,10.406342
59538,2018,Noviembre,Suecia,22,46,,68,-75.516486,10.446304
59539,2018,Noviembre,Suecia,1,8,,9,-74.77647900000001,10.886686
59540,2018,Noviembre,Suecia,0,3,,3,-74.213989,11.247722999999999
59541,2018,Noviembre,Suecia,10,13,,23,-76.532004,3.451668
59542,2018,Noviembre,Suecia,0,1,,1,-75.76635300000001,4.45285
59543,2018,Noviembre,Suecia,198,324,,522,-74.140516,4.697157
59544,2018,Noviembre,Suecia,20,43,,63,-75.42726,6.170465
59545,2018,Noviembre,Suecia,0,1,,1,-72.453013,7.819
59546,2018,Noviembre,Suecia,1,2,,3,-72.409396,8.36068
59547,2018,Noviembre,Suiza,3,5,,8,-69.941498,4.191162
59548,2018,Noviembre,Suiza,1,1,,2,-69.94143100000001,4.214082
59549,2018,Noviembre,Suiza,33,35,,68,-77.35600000000001,0.81488
59550,2018,Noviembre,Suiza,14,22,,36,-75.527794,10.406342
59551,2018,Noviembre,Suiza,58,78,,136,-75.516486,10.446304
59552,2018,Noviembre,Suiza,5,14,,19,-74.77647900000001,10.886686
59553,2018,Noviembre,Suiza,1,3,,4,-74.213989,11.247722999999999
59554,2018,Noviembre,Suiza,0,1,,1,-81.70216500000001,12.5862
59555,2018,Noviembre,Suiza,1,0,,1,-81.372937,13.338761300000002
59556,2018,Noviembre,Suiza,21,44,,65,-76.532004,3.451668
59557,2018,Noviembre,Suiza,1,1,,2,-73.61246899999999,4.16909
59558,2018,Noviembre,Suiza,501,786,,1287,-74.140516,4.697157
59559,2018,Noviembre,Suiza,1,1,,2,-75.736374,4.815189
59560,2018,Noviembre,Suiza,67,133,,200,-75.42726,6.170465
59561,2018,Noviembre,Suiza,0,1,,1,-72.453013,7.819
59562,2018,Noviembre,Suiza,1,0,,1,-72.409396,8.36068
59563,2018,Noviembre,Suiza,15,3,,18,-77.35002,8.63337
59564,2018,Noviembre,Surinam,0,1,,1,-81.70216500000001,12.5862
59565,2018,Noviembre,Surinam,17,21,,38,-74.140516,4.697157
59566,2018,Noviembre,Surinam,0,1,,1,-75.42726,6.170465
59567,2018,Noviembre,Surinam,1,0,,1,-72.453013,7.819
59568,2018,Noviembre,Tailandia,1,0,,1,-77.35600000000001,0.81488
59569,2018,Noviembre,Tailandia,7,1,,8,-75.516486,10.446304
59570,2018,Noviembre,Tailandia,17,11,,28,-74.140516,4.697157
59571,2018,Noviembre,Tailandia,3,5,,8,-75.42726,6.170465
59572,2018,Noviembre,Tanzania,2,3,,5,-74.140516,4.697157
59573,2018,Noviembre,República Democrática de Timor Oriental,0,1,,1,-74.140516,4.697157
59574,2018,Noviembre,República Democrática de Timor Oriental,0,1,,1,-75.42726,6.170465
59575,2018,Noviembre,Togo,0,1,,1,-74.140516,4.697157
59576,2018,Noviembre,Tonga,1,0,,1,-74.140516,4.697157
59577,2018,Noviembre,Trinidad y Tobago,2,20,,22,-75.516486,10.446304
59578,2018,Noviembre,Trinidad y Tobago,1,2,,3,-74.77647900000001,10.886686
59579,2018,Noviembre,Trinidad y Tobago,6,0,,6,-81.70216500000001,12.5862
59580,2018,Noviembre,Trinidad y Tobago,5,5,,10,-76.532004,3.451668
59581,2018,Noviembre,Trinidad y Tobago,33,50,,83,-74.140516,4.697157
59582,2018,Noviembre,Trinidad y Tobago,0,6,,6,-75.736374,4.815189
59583,2018,Noviembre,Trinidad y Tobago,8,26,,34,-75.42726,6.170465
59584,2018,Noviembre,Trinidad y Tobago,1,0,,1,-73.181317,7.1280470000000005
59585,2018,Noviembre,Trinidad y Tobago,0,1,,1,-72.453013,7.819
59586,2018,Noviembre,Túnez,1,9,,10,-74.140516,4.697157
59587,2018,Noviembre,Turquía,0,2,,2,-77.35600000000001,0.81488
59588,2018,Noviembre,Turquía,8,16,,24,-75.516486,10.446304
59589,2018,Noviembre,Turquía,0,1,,1,-74.77647900000001,10.886686
59590,2018,Noviembre,Turquía,0,5,,5,-76.532004,3.451668
59591,2018,Noviembre,Turquía,187,394,,581,-74.140516,4.697157
59592,2018,Noviembre,Turquía,7,17,,24,-75.42726,6.170465
59593,2018,Noviembre,Ucrania,1,11,,12,-75.527794,10.406342
59594,2018,Noviembre,Ucrania,2,30,,32,-75.516486,10.446304
59595,2018,Noviembre,Ucrania,0,16,,16,-74.77647900000001,10.886686
59596,2018,Noviembre,Ucrania,0,8,,8,-74.765343,10.970933
59597,2018,Noviembre,Ucrania,0,1,,1,-74.213989,11.247722999999999
59598,2018,Noviembre,Ucrania,0,4,,4,-76.532004,3.451668
59599,2018,Noviembre,Ucrania,0,2,,2,-77.061029,3.8844260000000004
59600,2018,Noviembre,Ucrania,41,22,,63,-74.140516,4.697157
59601,2018,Noviembre,Ucrania,8,6,,14,-75.42726,6.170465
59602,2018,Noviembre,Ucrania,0,1,,1,-77.35002,8.63337
59603,2018,Noviembre,Ucrania,0,2,,2,-75.68164200000001,9.402597
59604,2018,Noviembre,Uganda,0,1,,1,-77.35600000000001,0.81488
59605,2018,Noviembre,Uganda,1,1,,2,-75.516486,10.446304
59606,2018,Noviembre,Uganda,0,1,,1,-74.140516,4.697157
59607,2018,Noviembre,Uruguay,3,6,,9,-77.35600000000001,0.81488
59608,2018,Noviembre,Uruguay,25,11,,36,-75.527794,10.406342
59609,2018,Noviembre,Uruguay,148,99,,247,-75.516486,10.446304
59610,2018,Noviembre,Uruguay,3,5,,8,-74.77647900000001,10.886686
59611,2018,Noviembre,Uruguay,1,1,,2,-72.129595,11.360028999999999
59612,2018,Noviembre,Uruguay,16,12,,28,-81.70216500000001,12.5862
59613,2018,Noviembre,Uruguay,4,18,,22,-76.532004,3.451668
59614,2018,Noviembre,Uruguay,1,2,,3,-75.76635300000001,4.45285
59615,2018,Noviembre,Uruguay,411,570,,981,-74.140516,4.697157
59616,2018,Noviembre,Uruguay,40,66,,106,-75.42726,6.170465
59617,2018,Noviembre,Uruguay,0,1,,1,-70.74025300000001,7.088728999999999
59618,2018,Noviembre,Uruguay,1,7,,8,-72.453013,7.819
59619,2018,Noviembre,Uruguay,2,0,,2,-72.409396,8.36068
59620,2018,Noviembre,Uzbekistán,0,1,,1,-74.140516,4.697157
59621,2018,Noviembre,Venezuela,4,6,,10,-69.941498,4.191162
59622,2018,Noviembre,Venezuela,1,1,,2,-69.94143100000001,4.214082
59623,2018,Noviembre,Venezuela,98,83,,181,-76.876446,0.33002
59624,2018,Noviembre,Venezuela,3,0,,3,-77.84700600000001,0.8124359999999999
59625,2018,Noviembre,Venezuela,4814,5704,,10518,-77.35600000000001,0.81488
59626,2018,Noviembre,Venezuela,5,2,,7,-78.802679,18.00143
59627,2018,Noviembre,Venezuela,19,37,,56,-75.527794,10.406342
59628,2018,Noviembre,Venezuela,231,249,,480,-75.516486,10.446304
59629,2018,Noviembre,Venezuela,104,171,,275,-74.77647900000001,10.886686
59630,2018,Noviembre,Venezuela,0,3,,3,-74.765343,10.970933
59631,2018,Noviembre,Venezuela,1,7,,8,-74.232675,11.117206
59632,2018,Noviembre,Venezuela,0,1,,1,-74.213989,11.247722999999999
59633,2018,Noviembre,Venezuela,6182,5413,,11595,-72.129595,11.360028999999999
59634,2018,Noviembre,Venezuela,0,1,,1,-72.919186,11.52863
59635,2018,Noviembre,Venezuela,0,1,,1,-81.703935,12.574411099999999
59636,2018,Noviembre,Venezuela,9,5,,14,-81.70216500000001,12.5862
59637,2018,Noviembre,Venezuela,100,130,,230,-76.532004,3.451668
59638,2018,Noviembre,Venezuela,31,16,,47,-67.927521,3.866713
59639,2018,Noviembre,Venezuela,1,0,,1,-75.76635300000001,4.45285
59640,2018,Noviembre,Venezuela,7314,7513,,14827,-74.140516,4.697157
59641,2018,Noviembre,Venezuela,8,14,,22,-75.736374,4.815189
59642,2018,Noviembre,Venezuela,911,927,,1838,-75.42726,6.170465
59643,2018,Noviembre,Venezuela,63,48,,111,-67.48402800000001,6.185536
59644,2018,Noviembre,Venezuela,1078,1011,,2089,-70.74025300000001,7.088728999999999
59645,2018,Noviembre,Venezuela,19,26,,45,-73.181317,7.1280470000000005
59646,2018,Noviembre,Venezuela,24218,19495,,43713,-72.453013,7.819
59647,2018,Noviembre,Venezuela,1,6,,7,-72.508188,7.927233
59648,2018,Noviembre,Venezuela,3083,2265,,5348,-72.409396,8.36068
59649,2018,Noviembre,Vietnam,1,0,,1,-74.77647900000001,10.886686
59650,2018,Noviembre,Vietnam,7,6,,13,-74.140516,4.697157
59651,2018,Noviembre,República Árabe de Yemen,0,1,,1,-75.516486,10.446304
59652,2018,Noviembre,República Árabe de Yemen,0,1,,1,-74.140516,4.697157
59653,2018,Noviembre,Zambia,0,1,,1,-75.516486,10.446304
59654,2018,Noviembre,Zimbabue,2,0,,2,-75.516486,10.446304
59655,2018,Noviembre,Zimbabue,0,1,,1,-76.532004,3.451668
59656,2018,Noviembre,Zimbabue,0,2,,2,-74.140516,4.697157
59657,2018,Noviembre,Zimbabue,0,1,,1,-75.42726,6.170465
59658,2018,Noviembre,Refugiado,1,5,,6,-74.140516,4.697157
59659,2018,Noviembre,Refugiado,1,0,,1,-75.42726,6.170465
59660,2018,Noviembre,Desconocido,1,0,,1,-77.35600000000001,0.81488
59661,2018,Noviembre,Desconocido,1,5,,6,-75.516486,10.446304
59662,2018,Noviembre,Desconocido,1,1,,2,-81.70216500000001,12.5862
59663,2018,Noviembre,Desconocido,3,3,,6,-76.532004,3.451668
59664,2018,Noviembre,Desconocido,105,178,,283,-74.140516,4.697157
59665,2018,Noviembre,Desconocido,1,4,,5,-75.42726,6.170465
59666,2018,Noviembre,Desconocido,1,0,,1,-70.74025300000001,7.088728999999999
59667,2018,Noviembre,Desconocido,1,0,,1,-72.453013,7.819
59668,2018,Noviembre,Desconocido,0,1,,1,-74.140516,4.697157
59669,2018,Diciembre,Albania,0,1,,1,-76.532004,3.451668
59670,2018,Diciembre,Albania,4,4,,8,-74.140516,4.697157
59671,2018,Diciembre,Alemania,7,6,,13,-69.941498,4.191162
59672,2018,Diciembre,Alemania,8,15,,23,-69.94143100000001,4.214082
59673,2018,Diciembre,Alemania,4,7,,11,-76.876446,0.33002
59674,2018,Diciembre,Alemania,70,69,,139,-77.35600000000001,0.81488
59675,2018,Diciembre,Alemania,34,48,,82,-75.527794,10.406342
59676,2018,Diciembre,Alemania,192,320,,512,-75.516486,10.446304
59677,2018,Diciembre,Alemania,30,50,,80,-74.77647900000001,10.886686
59678,2018,Diciembre,Alemania,2,3,,5,-74.232675,11.117206
59679,2018,Diciembre,Alemania,3,1,,4,-74.213989,11.247722999999999
59680,2018,Diciembre,Alemania,1,2,,3,-72.129595,11.360028999999999
59681,2018,Diciembre,Alemania,7,14,,21,-81.70216500000001,12.5862
59682,2018,Diciembre,Alemania,1,0,,1,-81.372937,13.338761300000002
59683,2018,Diciembre,Alemania,77,136,,213,-76.532004,3.451668
59684,2018,Diciembre,Alemania,0,1,,1,-75.76635300000001,4.45285
59685,2018,Diciembre,Alemania,2935,4139,,7074,-74.140516,4.697157
59686,2018,Diciembre,Alemania,5,16,,21,-75.736374,4.815189
59687,2018,Diciembre,Alemania,172,317,,489,-75.42726,6.170465
59688,2018,Diciembre,Alemania,1,0,,1,-77.401154,6.222551999999999
59689,2018,Diciembre,Alemania,1,2,,3,-73.181317,7.1280470000000005
59690,2018,Diciembre,Alemania,3,11,,14,-72.453013,7.819
59691,2018,Diciembre,Alemania,0,1,,1,-76.7333,8.06667
59692,2018,Diciembre,Alemania,3,2,,5,-72.409396,8.36068
59693,2018,Diciembre,Alemania,12,18,,30,-77.35002,8.63337
59694,2018,Diciembre,Andorra,0,1,,1,-75.516486,10.446304
59695,2018,Diciembre,Andorra,2,1,,3,-74.140516,4.697157
59696,2018,Diciembre,Angola,2,1,,3,-75.516486,10.446304
59697,2018,Diciembre,Angola,0,2,,2,-74.140516,4.697157
59698,2018,Diciembre,Antigua y Barbuda,0,1,,1,-72.129595,11.360028999999999
59699,2018,Diciembre,Antigua y Barbuda,0,1,,1,-74.140516,4.697157
59700,2018,Diciembre,Antigua y Barbuda,0,2,,2,-75.42726,6.170465
59701,2018,Diciembre,Antigua y Barbuda,0,1,,1,-72.453013,7.819
59702,2018,Diciembre,Arabia Saudita,0,1,,1,-75.516486,10.446304
59703,2018,Diciembre,Arabia Saudita,1,15,,16,-74.140516,4.697157
59704,2018,Diciembre,Argelia,0,1,,1,-75.516486,10.446304
59705,2018,Diciembre,Argelia,2,9,,11,-74.140516,4.697157
59706,2018,Diciembre,Argelia,1,1,,2,-75.42726,6.170465
59707,2018,Diciembre,Argentina,3,8,,11,-69.941498,4.191162
59708,2018,Diciembre,Argentina,4,3,,7,-69.94143100000001,4.214082
59709,2018,Diciembre,Argentina,4,7,,11,-76.876446,0.33002
59710,2018,Diciembre,Argentina,114,157,,271,-77.35600000000001,0.81488
59711,2018,Diciembre,Argentina,0,1,,1,-78.802679,18.00143
59712,2018,Diciembre,Argentina,115,70,,185,-75.527794,10.406342
59713,2018,Diciembre,Argentina,1335,1148,,2483,-75.516486,10.446304
59714,2018,Diciembre,Argentina,18,35,,53,-74.77647900000001,10.886686
59715,2018,Diciembre,Argentina,0,1,,1,-74.232675,11.117206
59716,2018,Diciembre,Argentina,3,3,,6,-72.129595,11.360028999999999
59717,2018,Diciembre,Argentina,247,230,,477,-81.70216500000001,12.5862
59718,2018,Diciembre,Argentina,90,106,,196,-76.532004,3.451668
59719,2018,Diciembre,Argentina,0,1,,1,-75.76635300000001,4.45285
59720,2018,Diciembre,Argentina,2956,4242,,7198,-74.140516,4.697157
59721,2018,Diciembre,Argentina,2,14,,16,-75.736374,4.815189
59722,2018,Diciembre,Argentina,278,455,,733,-75.42726,6.170465
59723,2018,Diciembre,Argentina,1,0,,1,-67.48402800000001,6.185536
59724,2018,Diciembre,Argentina,0,2,,2,-75.586989,6.2188349999999994
59725,2018,Diciembre,Argentina,1,1,,2,-73.181317,7.1280470000000005
59726,2018,Diciembre,Argentina,4,6,,10,-72.453013,7.819
59727,2018,Diciembre,Argentina,4,4,,8,-72.409396,8.36068
59728,2018,Diciembre,Argentina,1,4,,5,-77.35002,8.63337
59729,2018,Diciembre,República de Armenia,1,1,,2,-74.140516,4.697157
59730,2018,Diciembre,Australia,0,1,,1,-69.941498,4.191162
59731,2018,Diciembre,Australia,4,2,,6,-69.94143100000001,4.214082
59732,2018,Diciembre,Australia,10,19,,29,-77.35600000000001,0.81488
59733,2018,Diciembre,Australia,30,26,,56,-75.527794,10.406342
59734,2018,Diciembre,Australia,97,154,,251,-75.516486,10.446304
59735,2018,Diciembre,Australia,4,11,,15,-74.77647900000001,10.886686
59736,2018,Diciembre,Australia,1,0,,1,-74.232675,11.117206
59737,2018,Diciembre,Australia,3,3,,6,-74.213989,11.247722999999999
59738,2018,Diciembre,Australia,1,0,,1,-72.129595,11.360028999999999
59739,2018,Diciembre,Australia,1,0,,1,-81.70216500000001,12.5862
59740,2018,Diciembre,Australia,0,1,,1,-81.372937,13.338761300000002
59741,2018,Diciembre,Australia,24,37,,61,-76.532004,3.451668
59742,2018,Diciembre,Australia,635,1081,,1716,-74.140516,4.697157
59743,2018,Diciembre,Australia,1,5,,6,-75.736374,4.815189
59744,2018,Diciembre,Australia,80,170,,250,-75.42726,6.170465
59745,2018,Diciembre,Australia,5,3,,8,-73.181317,7.1280470000000005
59746,2018,Diciembre,Australia,1,0,,1,-72.453013,7.819
59747,2018,Diciembre,Australia,15,28,,43,-77.35002,8.63337
59748,2018,Diciembre,Austria,1,1,,2,-69.941498,4.191162
59749,2018,Diciembre,Austria,1,2,,3,-69.94143100000001,4.214082
59750,2018,Diciembre,Austria,1,1,,2,-76.876446,0.33002
59751,2018,Diciembre,Austria,7,6,,13,-77.35600000000001,0.81488
59752,2018,Diciembre,Austria,7,4,,11,-75.527794,10.406342
59753,2018,Diciembre,Austria,21,26,,47,-75.516486,10.446304
59754,2018,Diciembre,Austria,2,3,,5,-74.77647900000001,10.886686
59755,2018,Diciembre,Austria,2,0,,2,-74.232675,11.117206
59756,2018,Diciembre,Austria,1,1,,2,-74.213989,11.247722999999999
59757,2018,Diciembre,Austria,1,1,,2,-81.70216500000001,12.5862
59758,2018,Diciembre,Austria,7,11,,18,-76.532004,3.451668
59759,2018,Diciembre,Austria,1,0,,1,-75.76635300000001,4.45285
59760,2018,Diciembre,Austria,302,425,,727,-74.140516,4.697157
59761,2018,Diciembre,Austria,0,1,,1,-75.736374,4.815189
59762,2018,Diciembre,Austria,21,47,,68,-75.42726,6.170465
59763,2018,Diciembre,Austria,0,1,,1,-73.181317,7.1280470000000005
59764,2018,Diciembre,Austria,1,1,,2,-77.35002,8.63337
59765,2018,Diciembre,Azerbaiyán,2,2,,4,-74.140516,4.697157
59766,2018,Diciembre,Azerbaiyán,0,1,,1,-75.42726,6.170465
59767,2018,Diciembre,Bahamas,0,1,,1,-75.516486,10.446304
59768,2018,Diciembre,Bahamas,0,1,,1,-74.77647900000001,10.886686
59769,2018,Diciembre,Bahamas,0,2,,2,-76.532004,3.451668
59770,2018,Diciembre,Bahamas,1,14,,15,-74.140516,4.697157
59771,2018,Diciembre,Bahamas,2,4,,6,-75.42726,6.170465
59772,2018,Diciembre,Bahréin,2,2,,4,-74.140516,4.697157
59773,2018,Diciembre,Bahréin,0,2,,2,-75.42726,6.170465
59774,2018,Diciembre,Bangladesh,0,1,,1,-75.516486,10.446304
59775,2018,Diciembre,Bangladesh,0,1,,1,-74.77647900000001,10.886686
59776,2018,Diciembre,Barbados,3,2,,5,-75.516486,10.446304
59777,2018,Diciembre,Barbados,1,1,,2,-76.532004,3.451668
59778,2018,Diciembre,Barbados,9,8,,17,-74.140516,4.697157
59779,2018,Diciembre,Barbados,0,1,,1,-75.736374,4.815189
59780,2018,Diciembre,Barbados,1,2,,3,-75.42726,6.170465
59781,2018,Diciembre,República de Belarús,0,1,,1,-75.527794,10.406342
59782,2018,Diciembre,República de Belarús,3,2,,5,-75.516486,10.446304
59783,2018,Diciembre,República de Belarús,8,5,,13,-74.140516,4.697157
59784,2018,Diciembre,Bélgica,4,0,,4,-69.941498,4.191162
59785,2018,Diciembre,Bélgica,0,1,,1,-69.94143100000001,4.214082
59786,2018,Diciembre,Bélgica,1,1,,2,-76.876446,0.33002
59787,2018,Diciembre,Bélgica,9,10,,19,-77.35600000000001,0.81488
59788,2018,Diciembre,Bélgica,2,2,,4,-75.527794,10.406342
59789,2018,Diciembre,Bélgica,41,61,,102,-75.516486,10.446304
59790,2018,Diciembre,Bélgica,4,12,,16,-74.77647900000001,10.886686
59791,2018,Diciembre,Bélgica,0,1,,1,-72.129595,11.360028999999999
59792,2018,Diciembre,Bélgica,1,2,,3,-81.70216500000001,12.5862
59793,2018,Diciembre,Bélgica,12,21,,33,-76.532004,3.451668
59794,2018,Diciembre,Bélgica,358,594,,952,-74.140516,4.697157
59795,2018,Diciembre,Bélgica,35,72,,107,-75.42726,6.170465
59796,2018,Diciembre,Bélgica,0,1,,1,-73.181317,7.1280470000000005
59797,2018,Diciembre,Bélgica,3,4,,7,-77.35002,8.63337
59798,2018,Diciembre,Belice,2,1,,3,-75.516486,10.446304
59799,2018,Diciembre,Belice,0,1,,1,-74.77647900000001,10.886686
59800,2018,Diciembre,Belice,1,0,,1,-76.532004,3.451668
59801,2018,Diciembre,Belice,7,7,,14,-74.140516,4.697157
59802,2018,Diciembre,Belice,0,2,,2,-75.42726,6.170465
59803,2018,Diciembre,Benín,0,1,,1,-74.140516,4.697157
59804,2018,Diciembre,Bermudas/Territorio Británico de Ultramar,1,0,,1,-69.941498,4.191162
59805,2018,Diciembre,Bermudas/Territorio Británico de Ultramar,0,1,,1,-75.516486,10.446304
59806,2018,Diciembre,Bolivia,0,1,,1,-69.94143100000001,4.214082
59807,2018,Diciembre,Bolivia,27,27,,54,-77.35600000000001,0.81488
59808,2018,Diciembre,Bolivia,21,19,,40,-75.527794,10.406342
59809,2018,Diciembre,Bolivia,118,95,,213,-75.516486,10.446304
59810,2018,Diciembre,Bolivia,23,16,,39,-81.70216500000001,12.5862
59811,2018,Diciembre,Bolivia,40,20,,60,-76.532004,3.451668
59812,2018,Diciembre,Bolivia,1084,989,,2073,-74.140516,4.697157
59813,2018,Diciembre,Bolivia,28,44,,72,-75.42726,6.170465
59814,2018,Diciembre,Bolivia,1,0,,1,-67.48402800000001,6.185536
59815,2018,Diciembre,Bolivia,2,8,,10,-72.453013,7.819
59816,2018,Diciembre,Bolivia,0,2,,2,-72.409396,8.36068
59817,2018,Diciembre,Bolivia,0,1,,1,-77.35002,8.63337
59818,2018,Diciembre,Bosnia y Herzegovina,1,0,,1,-77.35600000000001,0.81488
59819,2018,Diciembre,Bosnia y Herzegovina,0,1,,1,-75.516486,10.446304
59820,2018,Diciembre,Bosnia y Herzegovina,8,4,,12,-74.140516,4.697157
59821,2018,Diciembre,Botsuana,0,1,,1,-74.140516,4.697157
59822,2018,Diciembre,Brasil,138,117,,255,-69.941498,4.191162
59823,2018,Diciembre,Brasil,2,6,,8,-69.94143100000001,4.214082
59824,2018,Diciembre,Brasil,1,1,,2,-76.876446,0.33002
59825,2018,Diciembre,Brasil,21,33,,54,-77.35600000000001,0.81488
59826,2018,Diciembre,Brasil,219,172,,391,-75.527794,10.406342
59827,2018,Diciembre,Brasil,871,709,,1580,-75.516486,10.446304
59828,2018,Diciembre,Brasil,20,130,,150,-74.77647900000001,10.886686
59829,2018,Diciembre,Brasil,0,2,,2,-74.213989,11.247722999999999
59830,2018,Diciembre,Brasil,4,6,,10,-72.129595,11.360028999999999
59831,2018,Diciembre,Brasil,343,253,,596,-81.70216500000001,12.5862
59832,2018,Diciembre,Brasil,84,115,,199,-76.532004,3.451668
59833,2018,Diciembre,Brasil,6,3,,9,-67.927521,3.866713
59834,2018,Diciembre,Brasil,5999,6539,,12538,-74.140516,4.697157
59835,2018,Diciembre,Brasil,2,0,,2,-75.736374,4.815189
59836,2018,Diciembre,Brasil,165,224,,389,-75.42726,6.170465
59837,2018,Diciembre,Brasil,0,1,,1,-67.48402800000001,6.185536
59838,2018,Diciembre,Brasil,3,3,,6,-70.74025300000001,7.088728999999999
59839,2018,Diciembre,Brasil,4,3,,7,-73.181317,7.1280470000000005
59840,2018,Diciembre,Brasil,4,5,,9,-72.453013,7.819
59841,2018,Diciembre,Brasil,2,1,,3,-72.409396,8.36068
59842,2018,Diciembre,Brasil,0,1,,1,-77.35002,8.63337
59843,2018,Diciembre,Brunei Darussalam,1,0,,1,-74.140516,4.697157
59844,2018,Diciembre,Bulgaria,0,2,,2,-77.35600000000001,0.81488
59845,2018,Diciembre,Bulgaria,1,0,,1,-75.527794,10.406342
59846,2018,Diciembre,Bulgaria,5,8,,13,-75.516486,10.446304
59847,2018,Diciembre,Bulgaria,2,5,,7,-76.532004,3.451668
59848,2018,Diciembre,Bulgaria,54,54,,108,-74.140516,4.697157
59849,2018,Diciembre,Bulgaria,5,10,,15,-75.42726,6.170465
59850,2018,Diciembre,Bulgaria,0,2,,2,-72.453013,7.819
59851,2018,Diciembre,Burkina Faso,1,1,,2,-74.140516,4.697157
59852,2018,Diciembre,Bután,0,1,,1,-76.532004,3.451668
59853,2018,Diciembre,Bután,1,2,,3,-74.140516,4.697157
59854,2018,Diciembre,Cabo Verde,0,2,,2,-74.140516,4.697157
59855,2018,Diciembre,Islas Caimán/Territorio Británico de Ultramar,2,0,,2,-74.232675,11.117206
59856,2018,Diciembre,Islas Caimán/Territorio Británico de Ultramar,0,5,,5,-81.70216500000001,12.5862
59857,2018,Diciembre,Islas Caimán/Territorio Británico de Ultramar,0,1,,1,-75.42726,6.170465
59858,2018,Diciembre,Camboya,1,1,,2,-74.140516,4.697157
59859,2018,Diciembre,Camerún,0,1,,1,-81.70216500000001,12.5862
59860,2018,Diciembre,Canadá,1,4,,5,-69.941498,4.191162
59861,2018,Diciembre,Canadá,1,5,,6,-76.876446,0.33002
59862,2018,Diciembre,Canadá,14,21,,35,-77.35600000000001,0.81488
59863,2018,Diciembre,Canadá,44,41,,85,-75.527794,10.406342
59864,2018,Diciembre,Canadá,638,848,,1486,-75.516486,10.446304
59865,2018,Diciembre,Canadá,35,69,,104,-74.77647900000001,10.886686
59866,2018,Diciembre,Canadá,2,5,,7,-74.232675,11.117206
59867,2018,Diciembre,Canadá,3,3,,6,-74.213989,11.247722999999999
59868,2018,Diciembre,Canadá,2,3,,5,-72.129595,11.360028999999999
59869,2018,Diciembre,Canadá,1,1,,2,-81.703935,12.574411099999999
59870,2018,Diciembre,Canadá,107,124,,231,-81.70216500000001,12.5862
59871,2018,Diciembre,Canadá,2,2,,4,-81.372937,13.338761300000002
59872,2018,Diciembre,Canadá,106,150,,256,-76.532004,3.451668
59873,2018,Diciembre,Canadá,8,6,,14,-75.76635300000001,4.45285
59874,2018,Diciembre,Canadá,1995,3086,,5081,-74.140516,4.697157
59875,2018,Diciembre,Canadá,16,37,,53,-75.736374,4.815189
59876,2018,Diciembre,Canadá,273,572,,845,-75.42726,6.170465
59877,2018,Diciembre,Canadá,0,2,,2,-77.401154,6.222551999999999
59878,2018,Diciembre,Canadá,14,18,,32,-73.181317,7.1280470000000005
59879,2018,Diciembre,Canadá,2,4,,6,-72.453013,7.819
59880,2018,Diciembre,Canadá,7,10,,17,-77.35002,8.63337
59881,2018,Diciembre,Canadá,0,1,,1,-75.68164200000001,9.402597
59882,2018,Diciembre,Comoras,0,1,,1,-74.140516,4.697157
59883,2018,Diciembre,República Democrática del Congo,0,3,,3,-74.140516,4.697157
59884,2018,Diciembre,República Democrática del Congo,1,1,,2,-75.42726,6.170465
59885,2018,Diciembre,República Democrática del Congo,0,1,,1,-72.453013,7.819
59886,2018,Diciembre,República de Corea,3,1,,4,-69.941498,4.191162
59887,2018,Diciembre,República de Corea,10,8,,18,-77.35600000000001,0.81488
59888,2018,Diciembre,República de Corea,1,0,,1,-75.527794,10.406342
59889,2018,Diciembre,República de Corea,18,22,,40,-75.516486,10.446304
59890,2018,Diciembre,República de Corea,0,1,,1,-74.77647900000001,10.886686
59891,2018,Diciembre,República de Corea,0,1,,1,-74.213989,11.247722999999999
59892,2018,Diciembre,República de Corea,0,1,,1,-72.129595,11.360028999999999
59893,2018,Diciembre,República de Corea,1,0,,1,-81.70216500000001,12.5862
59894,2018,Diciembre,República de Corea,1,2,,3,-76.532004,3.451668
59895,2018,Diciembre,República de Corea,307,406,,713,-74.140516,4.697157
59896,2018,Diciembre,República de Corea,19,31,,50,-75.42726,6.170465
59897,2018,Diciembre,República de Corea,0,1,,1,-73.181317,7.1280470000000005
59898,2018,Diciembre,República de Corea,2,1,,3,-72.453013,7.819
59899,2018,Diciembre,Costa de Marfil,0,1,,1,-75.516486,10.446304
59900,2018,Diciembre,Costa Rica,1,0,,1,-69.941498,4.191162
59901,2018,Diciembre,Costa Rica,0,1,,1,-76.876446,0.33002
59902,2018,Diciembre,Costa Rica,1,5,,6,-77.35600000000001,0.81488
59903,2018,Diciembre,Costa Rica,4,5,,9,-75.527794,10.406342
59904,2018,Diciembre,Costa Rica,304,217,,521,-75.516486,10.446304
59905,2018,Diciembre,Costa Rica,34,34,,68,-74.77647900000001,10.886686
59906,2018,Diciembre,Costa Rica,0,5,,5,-74.232675,11.117206
59907,2018,Diciembre,Costa Rica,1,0,,1,-72.129595,11.360028999999999
59908,2018,Diciembre,Costa Rica,0,1,,1,-81.703935,12.574411099999999
59909,2018,Diciembre,Costa Rica,52,35,,87,-81.70216500000001,12.5862
59910,2018,Diciembre,Costa Rica,61,80,,141,-76.532004,3.451668
59911,2018,Diciembre,Costa Rica,0,1,,1,-75.76635300000001,4.45285
59912,2018,Diciembre,Costa Rica,1573,1779,,3352,-74.140516,4.697157
59913,2018,Diciembre,Costa Rica,19,13,,32,-75.736374,4.815189
59914,2018,Diciembre,Costa Rica,198,249,,447,-75.42726,6.170465
59915,2018,Diciembre,Costa Rica,6,4,,10,-73.181317,7.1280470000000005
59916,2018,Diciembre,Costa Rica,2,5,,7,-72.453013,7.819
59917,2018,Diciembre,Costa Rica,0,2,,2,-77.35002,8.63337
59918,2018,Diciembre,Croacia,0,1,,1,-69.94143100000001,4.214082
59919,2018,Diciembre,Croacia,0,1,,1,-77.35600000000001,0.81488
59920,2018,Diciembre,Croacia,0,4,,4,-75.527794,10.406342
59921,2018,Diciembre,Croacia,7,12,,19,-75.516486,10.446304
59922,2018,Diciembre,Croacia,0,2,,2,-74.77647900000001,10.886686
59923,2018,Diciembre,Croacia,1,0,,1,-74.232675,11.117206
59924,2018,Diciembre,Croacia,0,1,,1,-74.213989,11.247722999999999
59925,2018,Diciembre,Croacia,1,1,,2,-76.532004,3.451668
59926,2018,Diciembre,Croacia,32,64,,96,-74.140516,4.697157
59927,2018,Diciembre,Croacia,4,12,,16,-75.42726,6.170465
59928,2018,Diciembre,Cuba,2,0,,2,-69.941498,4.191162
59929,2018,Diciembre,Cuba,2,3,,5,-77.35600000000001,0.81488
59930,2018,Diciembre,Cuba,0,4,,4,-75.527794,10.406342
59931,2018,Diciembre,Cuba,15,39,,54,-75.516486,10.446304
59932,2018,Diciembre,Cuba,4,10,,14,-74.77647900000001,10.886686
59933,2018,Diciembre,Cuba,1,2,,3,-74.232675,11.117206
59934,2018,Diciembre,Cuba,0,1,,1,-81.703935,12.574411099999999
59935,2018,Diciembre,Cuba,22,42,,64,-76.532004,3.451668
59936,2018,Diciembre,Cuba,0,2,,2,-75.76635300000001,4.45285
59937,2018,Diciembre,Cuba,291,349,,640,-74.140516,4.697157
59938,2018,Diciembre,Cuba,1,3,,4,-75.736374,4.815189
59939,2018,Diciembre,Cuba,16,30,,46,-75.42726,6.170465
59940,2018,Diciembre,Cuba,1,3,,4,-73.181317,7.1280470000000005
59941,2018,Diciembre,Cuba,1,1,,2,-72.453013,7.819
59942,2018,Diciembre,República Checa,1,1,,2,-69.941498,4.191162
59943,2018,Diciembre,República Checa,0,1,,1,-69.94143100000001,4.214082
59944,2018,Diciembre,República Checa,2,2,,4,-77.35600000000001,0.81488
59945,2018,Diciembre,República Checa,1,1,,2,-75.527794,10.406342
59946,2018,Diciembre,República Checa,5,13,,18,-75.516486,10.446304
59947,2018,Diciembre,República Checa,0,1,,1,-74.77647900000001,10.886686
59948,2018,Diciembre,República Checa,4,5,,9,-76.532004,3.451668
59949,2018,Diciembre,República Checa,91,117,,208,-74.140516,4.697157
59950,2018,Diciembre,República Checa,6,9,,15,-75.42726,6.170465
59951,2018,Diciembre,República Checa,1,0,,1,-72.453013,7.819
59952,2018,Diciembre,Chile,0,2,,2,-69.94143100000001,4.214082
59953,2018,Diciembre,Chile,3,3,,6,-76.876446,0.33002
59954,2018,Diciembre,Chile,97,125,,222,-77.35600000000001,0.81488
59955,2018,Diciembre,Chile,0,1,,1,-78.802679,18.00143
59956,2018,Diciembre,Chile,85,58,,143,-75.527794,10.406342
59957,2018,Diciembre,Chile,444,348,,792,-75.516486,10.446304
59958,2018,Diciembre,Chile,8,16,,24,-74.77647900000001,10.886686
59959,2018,Diciembre,Chile,3,3,,6,-72.129595,11.360028999999999
59960,2018,Diciembre,Chile,116,90,,206,-81.70216500000001,12.5862
59961,2018,Diciembre,Chile,144,141,,285,-76.532004,3.451668
59962,2018,Diciembre,Chile,2991,4367,,7358,-74.140516,4.697157
59963,2018,Diciembre,Chile,7,7,,14,-75.736374,4.815189
59964,2018,Diciembre,Chile,104,231,,335,-75.42726,6.170465
59965,2018,Diciembre,Chile,0,1,,1,-70.74025300000001,7.088728999999999
59966,2018,Diciembre,Chile,2,4,,6,-73.181317,7.1280470000000005
59967,2018,Diciembre,Chile,21,29,,50,-72.453013,7.819
59968,2018,Diciembre,Chile,1,12,,13,-72.409396,8.36068
59969,2018,Diciembre,Chile,2,0,,2,-77.35002,8.63337
59970,2018,Diciembre,China,1,1,,2,-69.941498,4.191162
59971,2018,Diciembre,China,8,20,,28,-77.35600000000001,0.81488
59972,2018,Diciembre,China,6,10,,16,-75.527794,10.406342
59973,2018,Diciembre,China,35,29,,64,-75.516486,10.446304
59974,2018,Diciembre,China,2,7,,9,-74.77647900000001,10.886686
59975,2018,Diciembre,China,0,2,,2,-74.765343,10.970933
59976,2018,Diciembre,China,1,0,,1,-74.232675,11.117206
59977,2018,Diciembre,China,0,4,,4,-74.213989,11.247722999999999
59978,2018,Diciembre,China,0,3,,3,-72.129595,11.360028999999999
59979,2018,Diciembre,China,17,10,,27,-76.532004,3.451668
59980,2018,Diciembre,China,0,1,,1,-77.061029,3.8844260000000004
59981,2018,Diciembre,China,412,722,,1134,-74.140516,4.697157
59982,2018,Diciembre,China,0,1,,1,-75.736374,4.815189
59983,2018,Diciembre,China,37,54,,91,-75.42726,6.170465
59984,2018,Diciembre,China,3,8,,11,-72.453013,7.819
59985,2018,Diciembre,China,1,1,,2,-72.409396,8.36068
59986,2018,Diciembre,China,0,1,,1,-77.35002,8.63337
59987,2018,Diciembre,Taiwán,2,3,,5,-75.516486,10.446304
59988,2018,Diciembre,Taiwán,70,54,,124,-74.140516,4.697157
59989,2018,Diciembre,Taiwán,4,5,,9,-75.42726,6.170465
59990,2018,Diciembre,Taiwán,0,1,,1,-73.181317,7.1280470000000005
59991,2018,Diciembre,Taiwán,1,2,,3,-72.453013,7.819
59992,2018,Diciembre,Chipre,1,0,,1,-69.941498,4.191162
59993,2018,Diciembre,Chipre,5,9,,14,-74.140516,4.697157
59994,2018,Diciembre,Chipre,0,1,,1,-75.42726,6.170465
59995,2018,Diciembre,Dinamarca,2,1,,3,-69.94143100000001,4.214082
59996,2018,Diciembre,Dinamarca,1,5,,6,-77.35600000000001,0.81488
59997,2018,Diciembre,Dinamarca,2,5,,7,-75.527794,10.406342
59998,2018,Diciembre,Dinamarca,27,26,,53,-75.516486,10.446304
59999,2018,Diciembre,Dinamarca,3,7,,10,-74.77647900000001,10.886686
60000,2018,Diciembre,Dinamarca,1,0,,1,-72.129595,11.360028999999999
60001,2018,Diciembre,Dinamarca,3,11,,14,-76.532004,3.451668
60002,2018,Diciembre,Dinamarca,158,242,,400,-74.140516,4.697157
60003,2018,Diciembre,Dinamarca,2,3,,5,-75.736374,4.815189
60004,2018,Diciembre,Dinamarca,21,22,,43,-75.42726,6.170465
60005,2018,Diciembre,Dinamarca,1,1,,2,-73.181317,7.1280470000000005
60006,2018,Diciembre,Dinamarca,1,1,,2,-77.35002,8.63337
60007,2018,Diciembre,Dominica,2,4,,6,-74.140516,4.697157
60008,2018,Diciembre,Dominica,0,1,,1,-75.42726,6.170465
60009,2018,Diciembre,Dominica,0,1,,1,-72.453013,7.819
60010,2018,Diciembre,Ecuador,0,1,,1,-69.941498,4.191162
60011,2018,Diciembre,Ecuador,1,0,,1,-69.94143100000001,4.214082
60012,2018,Diciembre,Ecuador,129,305,,434,-76.876446,0.33002
60013,2018,Diciembre,Ecuador,4,2,,6,-77.84700600000001,0.8124359999999999
60014,2018,Diciembre,Ecuador,2349,3332,,5681,-77.35600000000001,0.81488
60015,2018,Diciembre,Ecuador,43,33,,76,-78.802679,18.00143
60016,2018,Diciembre,Ecuador,3,19,,22,-75.527794,10.406342
60017,2018,Diciembre,Ecuador,47,42,,89,-75.516486,10.446304
60018,2018,Diciembre,Ecuador,5,8,,13,-74.77647900000001,10.886686
60019,2018,Diciembre,Ecuador,1,0,,1,-74.232675,11.117206
60020,2018,Diciembre,Ecuador,3,12,,15,-72.129595,11.360028999999999
60021,2018,Diciembre,Ecuador,23,14,,37,-81.70216500000001,12.5862
60022,2018,Diciembre,Ecuador,481,562,,1043,-76.532004,3.451668
60023,2018,Diciembre,Ecuador,4,3,,7,-67.927521,3.866713
60024,2018,Diciembre,Ecuador,0,3,,3,-75.76635300000001,4.45285
60025,2018,Diciembre,Ecuador,3432,3973,,7405,-74.140516,4.697157
60026,2018,Diciembre,Ecuador,2,3,,5,-75.736374,4.815189
60027,2018,Diciembre,Ecuador,60,87,,147,-75.42726,6.170465
60028,2018,Diciembre,Ecuador,109,144,,253,-72.453013,7.819
60029,2018,Diciembre,Ecuador,2,5,,7,-72.409396,8.36068
60030,2018,Diciembre,Egipto,0,1,,1,-77.35600000000001,0.81488
60031,2018,Diciembre,Egipto,1,3,,4,-75.516486,10.446304
60032,2018,Diciembre,Egipto,0,1,,1,-74.77647900000001,10.886686
60033,2018,Diciembre,Egipto,7,23,,30,-74.140516,4.697157
60034,2018,Diciembre,Egipto,0,1,,1,-75.42726,6.170465
60035,2018,Diciembre,El Salvador,1,2,,3,-77.35600000000001,0.81488
60036,2018,Diciembre,El Salvador,1,3,,4,-75.527794,10.406342
60037,2018,Diciembre,El Salvador,328,289,,617,-75.516486,10.446304
60038,2018,Diciembre,El Salvador,6,7,,13,-74.77647900000001,10.886686
60039,2018,Diciembre,El Salvador,8,5,,13,-81.70216500000001,12.5862
60040,2018,Diciembre,El Salvador,86,106,,192,-76.532004,3.451668
60041,2018,Diciembre,El Salvador,0,1,,1,-75.76635300000001,4.45285
60042,2018,Diciembre,El Salvador,664,759,,1423,-74.140516,4.697157
60043,2018,Diciembre,El Salvador,0,3,,3,-75.736374,4.815189
60044,2018,Diciembre,El Salvador,28,35,,63,-75.42726,6.170465
60045,2018,Diciembre,El Salvador,2,4,,6,-72.453013,7.819
60046,2018,Diciembre,El Salvador,1,0,,1,-72.409396,8.36068
60047,2018,Diciembre,Emiratos Árabes,0,1,,1,-75.516486,10.446304
60048,2018,Diciembre,Emiratos Árabes,4,8,,12,-74.140516,4.697157
60049,2018,Diciembre,Emiratos Árabes,0,3,,3,-75.42726,6.170465
60050,2018,Diciembre,España,5,3,,8,-69.941498,4.191162
60051,2018,Diciembre,España,5,7,,12,-69.94143100000001,4.214082
60052,2018,Diciembre,España,2,2,,4,-76.876446,0.33002
60053,2018,Diciembre,España,41,53,,94,-77.35600000000001,0.81488
60054,2018,Diciembre,España,9,18,,27,-75.527794,10.406342
60055,2018,Diciembre,España,123,195,,318,-75.516486,10.446304
60056,2018,Diciembre,España,44,62,,106,-74.77647900000001,10.886686
60057,2018,Diciembre,España,0,1,,1,-74.765343,10.970933
60058,2018,Diciembre,España,1,2,,3,-74.232675,11.117206
60059,2018,Diciembre,España,1,0,,1,-74.213989,11.247722999999999
60060,2018,Diciembre,España,0,10,,10,-72.129595,11.360028999999999
60061,2018,Diciembre,España,9,10,,19,-81.70216500000001,12.5862
60062,2018,Diciembre,España,433,617,,1050,-76.532004,3.451668
60063,2018,Diciembre,España,0,2,,2,-75.76635300000001,4.45285
60064,2018,Diciembre,España,3744,6251,,9995,-74.140516,4.697157
60065,2018,Diciembre,España,10,23,,33,-75.736374,4.815189
60066,2018,Diciembre,España,500,895,,1395,-75.42726,6.170465
60067,2018,Diciembre,España,2,1,,3,-70.74025300000001,7.088728999999999
60068,2018,Diciembre,España,0,1,,1,-73.181317,7.1280470000000005
60069,2018,Diciembre,España,28,50,,78,-72.453013,7.819
60070,2018,Diciembre,España,6,9,,15,-72.409396,8.36068
60071,2018,Diciembre,España,3,4,,7,-77.35002,8.63337
60072,2018,Diciembre,Eslovaquia,1,1,,2,-69.94143100000001,4.214082
60073,2018,Diciembre,Eslovaquia,1,2,,3,-77.35600000000001,0.81488
60074,2018,Diciembre,Eslovaquia,0,2,,2,-75.527794,10.406342
60075,2018,Diciembre,Eslovaquia,2,4,,6,-75.516486,10.446304
60076,2018,Diciembre,Eslovaquia,0,1,,1,-76.532004,3.451668
60077,2018,Diciembre,Eslovaquia,43,49,,92,-74.140516,4.697157
60078,2018,Diciembre,Eslovaquia,4,5,,9,-75.42726,6.170465
60079,2018,Diciembre,Eslovaquia,1,2,,3,-77.35002,8.63337
60080,2018,Diciembre,Eslovenia,1,1,,2,-77.35600000000001,0.81488
60081,2018,Diciembre,Eslovenia,0,1,,1,-75.516486,10.446304
60082,2018,Diciembre,Eslovenia,2,0,,2,-76.532004,3.451668
60083,2018,Diciembre,Eslovenia,29,45,,74,-74.140516,4.697157
60084,2018,Diciembre,Eslovenia,1,7,,8,-75.42726,6.170465
60085,2018,Diciembre,Eslovenia,0,1,,1,-72.453013,7.819
60086,2018,Diciembre,Estados Unidos de América,11,15,,26,-69.941498,4.191162
60087,2018,Diciembre,Estados Unidos de América,1,5,,6,-69.94143100000001,4.214082
60088,2018,Diciembre,Estados Unidos de América,1,2,,3,-76.876446,0.33002
60089,2018,Diciembre,Estados Unidos de América,34,78,,112,-77.35600000000001,0.81488
60090,2018,Diciembre,Estados Unidos de América,71,119,,190,-75.527794,10.406342
60091,2018,Diciembre,Estados Unidos de América,6094,8070,,14164,-75.516486,10.446304
60092,2018,Diciembre,Estados Unidos de América,983,1578,,2561,-74.77647900000001,10.886686
60093,2018,Diciembre,Estados Unidos de América,0,4,,4,-74.765343,10.970933
60094,2018,Diciembre,Estados Unidos de América,75,109,,184,-74.232675,11.117206
60095,2018,Diciembre,Estados Unidos de América,23,27,,50,-74.213989,11.247722999999999
60096,2018,Diciembre,Estados Unidos de América,1,2,,3,-72.129595,11.360028999999999
60097,2018,Diciembre,Estados Unidos de América,3,11,,14,-81.703935,12.574411099999999
60098,2018,Diciembre,Estados Unidos de América,67,96,,163,-81.70216500000001,12.5862
60099,2018,Diciembre,Estados Unidos de América,2,2,,4,-81.372937,13.338761300000002
60100,2018,Diciembre,Estados Unidos de América,2042,2976,,5018,-76.532004,3.451668
60101,2018,Diciembre,Estados Unidos de América,151,230,,381,-75.76635300000001,4.45285
60102,2018,Diciembre,Estados Unidos de América,13576,22138,,35714,-74.140516,4.697157
60103,2018,Diciembre,Estados Unidos de América,445,627,,1072,-75.736374,4.815189
60104,2018,Diciembre,Estados Unidos de América,4493,8514,,13007,-75.42726,6.170465
60105,2018,Diciembre,Estados Unidos de América,2,1,,3,-77.401154,6.222551999999999
60106,2018,Diciembre,Estados Unidos de América,60,93,,153,-73.181317,7.1280470000000005
60107,2018,Diciembre,Estados Unidos de América,16,16,,32,-72.453013,7.819
60108,2018,Diciembre,Estados Unidos de América,8,5,,13,-72.409396,8.36068
60109,2018,Diciembre,Estados Unidos de América,12,9,,21,-77.35002,8.63337
60110,2018,Diciembre,Estonia,1,0,,1,-77.35600000000001,0.81488
60111,2018,Diciembre,Estonia,0,1,,1,-75.527794,10.406342
60112,2018,Diciembre,Estonia,5,2,,7,-75.516486,10.446304
60113,2018,Diciembre,Estonia,22,25,,47,-74.140516,4.697157
60114,2018,Diciembre,Estonia,2,4,,6,-75.42726,6.170465
60115,2018,Diciembre,Estonia,1,1,,2,-75.68164200000001,9.402597
60116,2018,Diciembre,Etiopia,4,30,,34,-74.140516,4.697157
60117,2018,Diciembre,Islas Fiji,0,1,,1,-74.140516,4.697157
60118,2018,Diciembre,Filipinas,1,1,,2,-77.35600000000001,0.81488
60119,2018,Diciembre,Filipinas,2,37,,39,-75.527794,10.406342
60120,2018,Diciembre,Filipinas,9,65,,74,-75.516486,10.446304
60121,2018,Diciembre,Filipinas,2,1,,3,-74.77647900000001,10.886686
60122,2018,Diciembre,Filipinas,0,10,,10,-74.765343,10.970933
60123,2018,Diciembre,Filipinas,0,5,,5,-74.213989,11.247722999999999
60124,2018,Diciembre,Filipinas,1,0,,1,-81.70216500000001,12.5862
60125,2018,Diciembre,Filipinas,3,1,,4,-76.532004,3.451668
60126,2018,Diciembre,Filipinas,0,11,,11,-77.061029,3.8844260000000004
60127,2018,Diciembre,Filipinas,49,35,,84,-74.140516,4.697157
60128,2018,Diciembre,Filipinas,1,3,,4,-75.42726,6.170465
60129,2018,Diciembre,Filipinas,1,0,,1,-72.453013,7.819
60130,2018,Diciembre,Filipinas,1,0,,1,-72.409396,8.36068
60131,2018,Diciembre,Filipinas,0,3,,3,-75.68164200000001,9.402597
60132,2018,Diciembre,Finlandia,2,3,,5,-77.35600000000001,0.81488
60133,2018,Diciembre,Finlandia,2,1,,3,-75.527794,10.406342
60134,2018,Diciembre,Finlandia,19,22,,41,-75.516486,10.446304
60135,2018,Diciembre,Finlandia,3,5,,8,-74.77647900000001,10.886686
60136,2018,Diciembre,Finlandia,0,1,,1,-74.232675,11.117206
60137,2018,Diciembre,Finlandia,3,2,,5,-81.70216500000001,12.5862
60138,2018,Diciembre,Finlandia,4,9,,13,-76.532004,3.451668
60139,2018,Diciembre,Finlandia,88,118,,206,-74.140516,4.697157
60140,2018,Diciembre,Finlandia,8,18,,26,-75.42726,6.170465
60141,2018,Diciembre,Finlandia,3,4,,7,-73.181317,7.1280470000000005
60142,2018,Diciembre,Francia,10,16,,26,-69.941498,4.191162
60143,2018,Diciembre,Francia,6,9,,15,-69.94143100000001,4.214082
60144,2018,Diciembre,Francia,3,9,,12,-76.876446,0.33002
60145,2018,Diciembre,Francia,83,96,,179,-77.35600000000001,0.81488
60146,2018,Diciembre,Francia,11,19,,30,-75.527794,10.406342
60147,2018,Diciembre,Francia,225,347,,572,-75.516486,10.446304
60148,2018,Diciembre,Francia,26,57,,83,-74.77647900000001,10.886686
60149,2018,Diciembre,Francia,1,2,,3,-74.765343,10.970933
60150,2018,Diciembre,Francia,3,3,,6,-74.232675,11.117206
60151,2018,Diciembre,Francia,9,7,,16,-74.213989,11.247722999999999
60152,2018,Diciembre,Francia,0,4,,4,-72.129595,11.360028999999999
60153,2018,Diciembre,Francia,2,11,,13,-81.70216500000001,12.5862
60154,2018,Diciembre,Francia,3,5,,8,-81.372937,13.338761300000002
60155,2018,Diciembre,Francia,79,141,,220,-76.532004,3.451668
60156,2018,Diciembre,Francia,0,1,,1,-75.76635300000001,4.45285
60157,2018,Diciembre,Francia,2747,3926,,6673,-74.140516,4.697157
60158,2018,Diciembre,Francia,11,14,,25,-75.736374,4.815189
60159,2018,Diciembre,Francia,208,398,,606,-75.42726,6.170465
60160,2018,Diciembre,Francia,0,2,,2,-73.181317,7.1280470000000005
60161,2018,Diciembre,Francia,1,4,,5,-72.453013,7.819
60162,2018,Diciembre,Francia,2,2,,4,-72.409396,8.36068
60163,2018,Diciembre,Francia,4,7,,11,-77.35002,8.63337
60164,2018,Diciembre,Georgia,0,2,,2,-75.516486,10.446304
60165,2018,Diciembre,Georgia,1,0,,1,-76.532004,3.451668
60166,2018,Diciembre,Georgia,2,2,,4,-74.140516,4.697157
60167,2018,Diciembre,Georgia,0,1,,1,-75.68164200000001,9.402597
60168,2018,Diciembre,Ghana,0,4,,4,-77.35600000000001,0.81488
60169,2018,Diciembre,Ghana,1,2,,3,-75.516486,10.446304
60170,2018,Diciembre,Ghana,1,1,,2,-76.532004,3.451668
60171,2018,Diciembre,Ghana,2,6,,8,-74.140516,4.697157
60172,2018,Diciembre,Ghana,1,0,,1,-75.42726,6.170465
60173,2018,Diciembre,Granada,0,2,,2,-75.516486,10.446304
60174,2018,Diciembre,Granada,0,1,,1,-81.70216500000001,12.5862
60175,2018,Diciembre,Granada,1,1,,2,-76.532004,3.451668
60176,2018,Diciembre,Granada,1,1,,2,-74.140516,4.697157
60177,2018,Diciembre,Grecia,1,1,,2,-69.941498,4.191162
60178,2018,Diciembre,Grecia,0,1,,1,-76.876446,0.33002
60179,2018,Diciembre,Grecia,0,1,,1,-77.35600000000001,0.81488
60180,2018,Diciembre,Grecia,0,3,,3,-75.527794,10.406342
60181,2018,Diciembre,Grecia,4,9,,13,-75.516486,10.446304
60182,2018,Diciembre,Grecia,0,1,,1,-74.77647900000001,10.886686
60183,2018,Diciembre,Grecia,1,0,,1,-74.232675,11.117206
60184,2018,Diciembre,Grecia,1,1,,2,-72.129595,11.360028999999999
60185,2018,Diciembre,Grecia,4,1,,5,-76.532004,3.451668
60186,2018,Diciembre,Grecia,62,98,,160,-74.140516,4.697157
60187,2018,Diciembre,Grecia,9,12,,21,-75.42726,6.170465
60188,2018,Diciembre,Grecia,0,1,,1,-72.453013,7.819
60189,2018,Diciembre,Grecia,0,2,,2,-76.7333,8.06667
60190,2018,Diciembre,Grecia,0,2,,2,-75.68164200000001,9.402597
60191,2018,Diciembre,Guatemala,0,1,,1,-69.941498,4.191162
60192,2018,Diciembre,Guatemala,0,3,,3,-77.35600000000001,0.81488
60193,2018,Diciembre,Guatemala,0,1,,1,-78.802679,18.00143
60194,2018,Diciembre,Guatemala,2,4,,6,-75.527794,10.406342
60195,2018,Diciembre,Guatemala,248,209,,457,-75.516486,10.446304
60196,2018,Diciembre,Guatemala,9,18,,27,-74.77647900000001,10.886686
60197,2018,Diciembre,Guatemala,2,2,,4,-72.129595,11.360028999999999
60198,2018,Diciembre,Guatemala,21,24,,45,-81.70216500000001,12.5862
60199,2018,Diciembre,Guatemala,41,63,,104,-76.532004,3.451668
60200,2018,Diciembre,Guatemala,1,0,,1,-75.76635300000001,4.45285
60201,2018,Diciembre,Guatemala,676,794,,1470,-74.140516,4.697157
60202,2018,Diciembre,Guatemala,9,15,,24,-75.736374,4.815189
60203,2018,Diciembre,Guatemala,68,116,,184,-75.42726,6.170465
60204,2018,Diciembre,Guatemala,0,4,,4,-73.181317,7.1280470000000005
60205,2018,Diciembre,Guatemala,0,1,,1,-72.453013,7.819
60206,2018,Diciembre,Guatemala,1,0,,1,-72.409396,8.36068
60207,2018,Diciembre,Guatemala,1,1,,2,-77.35002,8.63337
60208,2018,Diciembre,Guyana,0,2,,2,-75.527794,10.406342
60209,2018,Diciembre,Guyana,0,1,,1,-72.129595,11.360028999999999
60210,2018,Diciembre,Guyana,0,2,,2,-76.532004,3.451668
60211,2018,Diciembre,Guyana,8,8,,16,-74.140516,4.697157
60212,2018,Diciembre,Guyana,2,2,,4,-75.42726,6.170465
60213,2018,Diciembre,Guyana,0,1,,1,-72.453013,7.819
60214,2018,Diciembre,Guyana,1,0,,1,-72.409396,8.36068
60215,2018,Diciembre,Guinea,1,0,,1,-74.140516,4.697157
60216,2018,Diciembre,Haití,0,1,,1,-77.35600000000001,0.81488
60217,2018,Diciembre,Haití,0,3,,3,-75.516486,10.446304
60218,2018,Diciembre,Haití,0,1,,1,-74.77647900000001,10.886686
60219,2018,Diciembre,Haití,1,0,,1,-81.70216500000001,12.5862
60220,2018,Diciembre,Haití,1,0,,1,-76.532004,3.451668
60221,2018,Diciembre,Haití,5,19,,24,-74.140516,4.697157
60222,2018,Diciembre,Haití,0,1,,1,-75.42726,6.170465
60223,2018,Diciembre,Honduras,1,1,,2,-76.876446,0.33002
60224,2018,Diciembre,Honduras,2,5,,7,-77.35600000000001,0.81488
60225,2018,Diciembre,Honduras,0,1,,1,-78.802679,18.00143
60226,2018,Diciembre,Honduras,5,8,,13,-75.527794,10.406342
60227,2018,Diciembre,Honduras,86,77,,163,-75.516486,10.446304
60228,2018,Diciembre,Honduras,12,9,,21,-74.77647900000001,10.886686
60229,2018,Diciembre,Honduras,1,4,,5,-72.129595,11.360028999999999
60230,2018,Diciembre,Honduras,1,12,,13,-81.703935,12.574411099999999
60231,2018,Diciembre,Honduras,0,2,,2,-81.70216500000001,12.5862
60232,2018,Diciembre,Honduras,42,35,,77,-76.532004,3.451668
60233,2018,Diciembre,Honduras,1,1,,2,-75.76635300000001,4.45285
60234,2018,Diciembre,Honduras,319,299,,618,-74.140516,4.697157
60235,2018,Diciembre,Honduras,4,2,,6,-75.736374,4.815189
60236,2018,Diciembre,Honduras,56,63,,119,-75.42726,6.170465
60237,2018,Diciembre,Honduras,0,1,,1,-73.181317,7.1280470000000005
60238,2018,Diciembre,Hong Kong,1,1,,2,-75.516486,10.446304
60239,2018,Diciembre,Hong Kong,13,17,,30,-74.140516,4.697157
60240,2018,Diciembre,Hong Kong,2,5,,7,-75.42726,6.170465
60241,2018,Diciembre,Hungría,0,1,,1,-69.94143100000001,4.214082
60242,2018,Diciembre,Hungría,0,1,,1,-76.876446,0.33002
60243,2018,Diciembre,Hungría,2,2,,4,-77.35600000000001,0.81488
60244,2018,Diciembre,Hungría,1,4,,5,-75.527794,10.406342
60245,2018,Diciembre,Hungría,11,14,,25,-75.516486,10.446304
60246,2018,Diciembre,Hungría,0,1,,1,-74.77647900000001,10.886686
60247,2018,Diciembre,Hungría,39,58,,97,-74.140516,4.697157
60248,2018,Diciembre,Hungría,1,1,,2,-75.736374,4.815189
60249,2018,Diciembre,Hungría,1,5,,6,-75.42726,6.170465
60250,2018,Diciembre,India,2,8,,10,-77.35600000000001,0.81488
60251,2018,Diciembre,India,0,9,,9,-75.527794,10.406342
60252,2018,Diciembre,India,32,58,,90,-75.516486,10.446304
60253,2018,Diciembre,India,2,6,,8,-74.77647900000001,10.886686
60254,2018,Diciembre,India,0,3,,3,-74.765343,10.970933
60255,2018,Diciembre,India,0,1,,1,-74.232675,11.117206
60256,2018,Diciembre,India,0,2,,2,-74.213989,11.247722999999999
60257,2018,Diciembre,India,3,7,,10,-76.532004,3.451668
60258,2018,Diciembre,India,0,2,,2,-77.061029,3.8844260000000004
60259,2018,Diciembre,India,130,419,,549,-74.140516,4.697157
60260,2018,Diciembre,India,0,1,,1,-75.736374,4.815189
60261,2018,Diciembre,India,11,78,,89,-75.42726,6.170465
60262,2018,Diciembre,India,0,4,,4,-75.68164200000001,9.402597
60263,2018,Diciembre,Indonesia,1,1,,2,-75.527794,10.406342
60264,2018,Diciembre,Indonesia,5,3,,8,-75.516486,10.446304
60265,2018,Diciembre,Indonesia,0,4,,4,-74.213989,11.247722999999999
60266,2018,Diciembre,Indonesia,1,0,,1,-76.532004,3.451668
60267,2018,Diciembre,Indonesia,25,20,,45,-74.140516,4.697157
60268,2018,Diciembre,Indonesia,5,3,,8,-75.42726,6.170465
60269,2018,Diciembre,Iraq,0,1,,1,-75.516486,10.446304
60270,2018,Diciembre,Iraq,0,2,,2,-74.140516,4.697157
60271,2018,Diciembre,Irán,1,0,,1,-77.35600000000001,0.81488
60272,2018,Diciembre,Irán,0,1,,1,-75.527794,10.406342
60273,2018,Diciembre,Irán,2,0,,2,-75.516486,10.446304
60274,2018,Diciembre,Irán,0,1,,1,-74.77647900000001,10.886686
60275,2018,Diciembre,Irán,0,1,,1,-72.129595,11.360028999999999
60276,2018,Diciembre,Irán,7,17,,24,-74.140516,4.697157
60277,2018,Diciembre,Irán,0,1,,1,-75.42726,6.170465
60278,2018,Diciembre,República de Irlanda,0,1,,1,-69.941498,4.191162
60279,2018,Diciembre,República de Irlanda,5,13,,18,-77.35600000000001,0.81488
60280,2018,Diciembre,República de Irlanda,9,4,,13,-75.527794,10.406342
60281,2018,Diciembre,República de Irlanda,19,32,,51,-75.516486,10.446304
60282,2018,Diciembre,República de Irlanda,0,2,,2,-74.77647900000001,10.886686
60283,2018,Diciembre,República de Irlanda,1,10,,11,-76.532004,3.451668
60284,2018,Diciembre,República de Irlanda,131,270,,401,-74.140516,4.697157
60285,2018,Diciembre,República de Irlanda,15,31,,46,-75.42726,6.170465
60286,2018,Diciembre,República de Irlanda,1,1,,2,-73.181317,7.1280470000000005
60287,2018,Diciembre,República de Irlanda,0,1,,1,-72.409396,8.36068
60288,2018,Diciembre,República de Irlanda,10,4,,14,-77.35002,8.63337
60289,2018,Diciembre,Islandia,1,0,,1,-77.35600000000001,0.81488
60290,2018,Diciembre,Islandia,5,7,,12,-75.516486,10.446304
60291,2018,Diciembre,Islandia,10,12,,22,-74.140516,4.697157
60292,2018,Diciembre,Islandia,0,1,,1,-75.736374,4.815189
60293,2018,Diciembre,Islandia,1,4,,5,-75.42726,6.170465
60294,2018,Diciembre,Islandia,1,0,,1,-77.35002,8.63337
60295,2018,Diciembre,Israel,0,1,,1,-69.941498,4.191162
60296,2018,Diciembre,Israel,0,1,,1,-69.94143100000001,4.214082
60297,2018,Diciembre,Israel,5,13,,18,-77.35600000000001,0.81488
60298,2018,Diciembre,Israel,1,0,,1,-75.527794,10.406342
60299,2018,Diciembre,Israel,19,46,,65,-75.516486,10.446304
60300,2018,Diciembre,Israel,1,9,,10,-74.77647900000001,10.886686
60301,2018,Diciembre,Israel,0,1,,1,-74.232675,11.117206
60302,2018,Diciembre,Israel,1,0,,1,-81.70216500000001,12.5862
60303,2018,Diciembre,Israel,0,4,,4,-81.372937,13.338761300000002
60304,2018,Diciembre,Israel,9,18,,27,-76.532004,3.451668
60305,2018,Diciembre,Israel,128,351,,479,-74.140516,4.697157
60306,2018,Diciembre,Israel,2,2,,4,-75.736374,4.815189
60307,2018,Diciembre,Israel,11,57,,68,-75.42726,6.170465
60308,2018,Diciembre,Israel,2,0,,2,-77.35002,8.63337
60309,2018,Diciembre,Italia,4,3,,7,-69.941498,4.191162
60310,2018,Diciembre,Italia,3,4,,7,-69.94143100000001,4.214082
60311,2018,Diciembre,Italia,10,20,,30,-77.35600000000001,0.81488
60312,2018,Diciembre,Italia,5,16,,21,-75.527794,10.406342
60313,2018,Diciembre,Italia,130,261,,391,-75.516486,10.446304
60314,2018,Diciembre,Italia,21,46,,67,-74.77647900000001,10.886686
60315,2018,Diciembre,Italia,0,2,,2,-74.232675,11.117206
60316,2018,Diciembre,Italia,0,2,,2,-74.213989,11.247722999999999
60317,2018,Diciembre,Italia,3,9,,12,-72.129595,11.360028999999999
60318,2018,Diciembre,Italia,0,4,,4,-81.703935,12.574411099999999
60319,2018,Diciembre,Italia,8,7,,15,-81.70216500000001,12.5862
60320,2018,Diciembre,Italia,0,4,,4,-81.372937,13.338761300000002
60321,2018,Diciembre,Italia,33,132,,165,-76.532004,3.451668
60322,2018,Diciembre,Italia,0,2,,2,-75.76635300000001,4.45285
60323,2018,Diciembre,Italia,1168,2353,,3521,-74.140516,4.697157
60324,2018,Diciembre,Italia,1,7,,8,-75.736374,4.815189
60325,2018,Diciembre,Italia,95,301,,396,-75.42726,6.170465
60326,2018,Diciembre,Italia,0,1,,1,-73.181317,7.1280470000000005
60327,2018,Diciembre,Italia,19,27,,46,-72.453013,7.819
60328,2018,Diciembre,Italia,0,1,,1,-72.508188,7.927233
60329,2018,Diciembre,Italia,6,4,,10,-72.409396,8.36068
60330,2018,Diciembre,Italia,1,3,,4,-77.35002,8.63337
60331,2018,Diciembre,Jamaica,1,11,,12,-75.516486,10.446304
60332,2018,Diciembre,Jamaica,2,2,,4,-74.77647900000001,10.886686
60333,2018,Diciembre,Jamaica,2,2,,4,-81.70216500000001,12.5862
60334,2018,Diciembre,Jamaica,1,4,,5,-76.532004,3.451668
60335,2018,Diciembre,Jamaica,16,30,,46,-74.140516,4.697157
60336,2018,Diciembre,Jamaica,1,1,,2,-75.736374,4.815189
60337,2018,Diciembre,Jamaica,2,6,,8,-75.42726,6.170465
60338,2018,Diciembre,Japón,0,4,,4,-69.941498,4.191162
60339,2018,Diciembre,Japón,1,2,,3,-69.94143100000001,4.214082
60340,2018,Diciembre,Japón,0,13,,13,-77.35600000000001,0.81488
60341,2018,Diciembre,Japón,24,20,,44,-75.516486,10.446304
60342,2018,Diciembre,Japón,0,16,,16,-74.77647900000001,10.886686
60343,2018,Diciembre,Japón,1,0,,1,-74.232675,11.117206
60344,2018,Diciembre,Japón,1,1,,2,-81.70216500000001,12.5862
60345,2018,Diciembre,Japón,2,7,,9,-76.532004,3.451668
60346,2018,Diciembre,Japón,1,0,,1,-75.76635300000001,4.45285
60347,2018,Diciembre,Japón,247,445,,692,-74.140516,4.697157
60348,2018,Diciembre,Japón,1,0,,1,-75.736374,4.815189
60349,2018,Diciembre,Japón,37,64,,101,-75.42726,6.170465
60350,2018,Diciembre,Japón,1,1,,2,-77.35002,8.63337
60351,2018,Diciembre,Jordania,0,1,,1,-75.516486,10.446304
60352,2018,Diciembre,Jordania,1,15,,16,-74.140516,4.697157
60353,2018,Diciembre,Kazajistán,3,0,,3,-75.516486,10.446304
60354,2018,Diciembre,Kazajistán,8,8,,16,-74.140516,4.697157
60355,2018,Diciembre,Kazajistán,1,1,,2,-75.42726,6.170465
60356,2018,Diciembre,Kenia,0,1,,1,-75.516486,10.446304
60357,2018,Diciembre,Kenia,9,15,,24,-74.140516,4.697157
60358,2018,Diciembre,Kenia,1,0,,1,-75.42726,6.170465
60359,2018,Diciembre,Kuwait,0,3,,3,-75.516486,10.446304
60360,2018,Diciembre,Kuwait,6,6,,12,-74.140516,4.697157
60361,2018,Diciembre,República de Kosovo,0,1,,1,-76.532004,3.451668
60362,2018,Diciembre,República de Kosovo,2,1,,3,-74.140516,4.697157
60363,2018,Diciembre,República de Kosovo,0,1,,1,-75.42726,6.170465
60364,2018,Diciembre,Letonia,1,1,,2,-77.35600000000001,0.81488
60365,2018,Diciembre,Letonia,0,1,,1,-75.527794,10.406342
60366,2018,Diciembre,Letonia,4,5,,9,-75.516486,10.446304
60367,2018,Diciembre,Letonia,0,2,,2,-74.213989,11.247722999999999
60368,2018,Diciembre,Letonia,1,1,,2,-76.532004,3.451668
60369,2018,Diciembre,Letonia,0,1,,1,-77.061029,3.8844260000000004
60370,2018,Diciembre,Letonia,19,18,,37,-74.140516,4.697157
60371,2018,Diciembre,Letonia,2,0,,2,-75.42726,6.170465
60372,2018,Diciembre,Lituania,1,0,,1,-77.35600000000001,0.81488
60373,2018,Diciembre,Lituania,6,8,,14,-75.516486,10.446304
60374,2018,Diciembre,Lituania,2,0,,2,-76.532004,3.451668
60375,2018,Diciembre,Lituania,35,27,,62,-74.140516,4.697157
60376,2018,Diciembre,Lituania,2,4,,6,-75.42726,6.170465
60377,2018,Diciembre,Lituania,0,1,,1,-77.35002,8.63337
60378,2018,Diciembre,Lituania,0,1,,1,-75.68164200000001,9.402597
60379,2018,Diciembre,Líbano,0,1,,1,-75.516486,10.446304
60380,2018,Diciembre,Líbano,0,4,,4,-74.77647900000001,10.886686
60381,2018,Diciembre,Líbano,1,2,,3,-72.129595,11.360028999999999
60382,2018,Diciembre,Líbano,1,1,,2,-76.532004,3.451668
60383,2018,Diciembre,Líbano,13,34,,47,-74.140516,4.697157
60384,2018,Diciembre,Líbano,3,3,,6,-75.42726,6.170465
60385,2018,Diciembre,Liechtenstein,7,6,,13,-74.140516,4.697157
60386,2018,Diciembre,Liechtenstein,0,2,,2,-75.42726,6.170465
60387,2018,Diciembre,Luxemburgo,2,0,,2,-69.941498,4.191162
60388,2018,Diciembre,Luxemburgo,2,2,,4,-75.516486,10.446304
60389,2018,Diciembre,Luxemburgo,1,0,,1,-74.77647900000001,10.886686
60390,2018,Diciembre,Luxemburgo,0,1,,1,-76.532004,3.451668
60391,2018,Diciembre,Luxemburgo,20,21,,41,-74.140516,4.697157
60392,2018,Diciembre,Luxemburgo,1,0,,1,-75.736374,4.815189
60393,2018,Diciembre,Luxemburgo,1,2,,3,-75.42726,6.170465
60394,2018,Diciembre,Macedonia,1,2,,3,-75.516486,10.446304
60395,2018,Diciembre,Macedonia,1,11,,12,-74.140516,4.697157
60396,2018,Diciembre,Malasia,5,11,,16,-75.516486,10.446304
60397,2018,Diciembre,Malasia,0,1,,1,-76.532004,3.451668
60398,2018,Diciembre,Malasia,23,33,,56,-74.140516,4.697157
60399,2018,Diciembre,Malasia,0,1,,1,-75.42726,6.170465
60400,2018,Diciembre,Malawi,0,1,,1,-74.140516,4.697157
60401,2018,Diciembre,Malta,0,2,,2,-77.35600000000001,0.81488
60402,2018,Diciembre,Malta,5,6,,11,-75.516486,10.446304
60403,2018,Diciembre,Malta,1,0,,1,-74.77647900000001,10.886686
60404,2018,Diciembre,Malta,7,19,,26,-74.140516,4.697157
60405,2018,Diciembre,Malta,5,6,,11,-75.42726,6.170465
60406,2018,Diciembre,Marruecos,0,1,,1,-75.527794,10.406342
60407,2018,Diciembre,Marruecos,3,1,,4,-75.516486,10.446304
60408,2018,Diciembre,Marruecos,18,23,,41,-74.140516,4.697157
60409,2018,Diciembre,Marruecos,1,0,,1,-75.736374,4.815189
60410,2018,Diciembre,Marruecos,3,4,,7,-75.42726,6.170465
60411,2018,Diciembre,Mauricio,0,1,,1,-75.527794,10.406342
60412,2018,Diciembre,Mauricio,1,0,,1,-74.140516,4.697157
60413,2018,Diciembre,Mauricio,0,1,,1,-75.42726,6.170465
60414,2018,Diciembre,México,0,2,,2,-69.941498,4.191162
60415,2018,Diciembre,México,0,1,,1,-76.876446,0.33002
60416,2018,Diciembre,México,26,43,,69,-77.35600000000001,0.81488
60417,2018,Diciembre,México,11,15,,26,-75.527794,10.406342
60418,2018,Diciembre,México,353,458,,811,-75.516486,10.446304
60419,2018,Diciembre,México,59,98,,157,-74.77647900000001,10.886686
60420,2018,Diciembre,México,0,1,,1,-74.232675,11.117206
60421,2018,Diciembre,México,2,3,,5,-72.129595,11.360028999999999
60422,2018,Diciembre,México,0,2,,2,-81.703935,12.574411099999999
60423,2018,Diciembre,México,6,6,,12,-81.70216500000001,12.5862
60424,2018,Diciembre,México,88,172,,260,-76.532004,3.451668
60425,2018,Diciembre,México,1,2,,3,-75.76635300000001,4.45285
60426,2018,Diciembre,México,4609,6835,,11444,-74.140516,4.697157
60427,2018,Diciembre,México,21,36,,57,-75.736374,4.815189
60428,2018,Diciembre,México,647,1168,,1815,-75.42726,6.170465
60429,2018,Diciembre,México,0,1,,1,-67.48402800000001,6.185536
60430,2018,Diciembre,México,0,4,,4,-70.74025300000001,7.088728999999999
60431,2018,Diciembre,México,9,11,,20,-73.181317,7.1280470000000005
60432,2018,Diciembre,México,10,24,,34,-72.453013,7.819
60433,2018,Diciembre,México,8,12,,20,-72.409396,8.36068
60434,2018,Diciembre,México,1,1,,2,-77.35002,8.63337
60435,2018,Diciembre,República de Moldavia,1,0,,1,-75.516486,10.446304
60436,2018,Diciembre,República de Moldavia,4,2,,6,-74.140516,4.697157
60437,2018,Diciembre,República de Moldavia,1,0,,1,-75.42726,6.170465
60438,2018,Diciembre,Mónaco,2,1,,3,-75.516486,10.446304
60439,2018,Diciembre,Mónaco,1,1,,2,-74.140516,4.697157
60440,2018,Diciembre,Mongolia,2,1,,3,-74.140516,4.697157
60441,2018,Diciembre,Montenegro,0,4,,4,-74.140516,4.697157
60442,2018,Diciembre,Micronesia,0,1,,1,-76.532004,3.451668
60443,2018,Diciembre,Mozambique,1,1,,2,-74.140516,4.697157
60444,2018,Diciembre,Myanmar,0,1,,1,-75.516486,10.446304
60445,2018,Diciembre,Myanmar,0,1,,1,-74.77647900000001,10.886686
60446,2018,Diciembre,Myanmar,1,1,,2,-74.140516,4.697157
60447,2018,Diciembre,Namibia,2,2,,4,-75.516486,10.446304
60448,2018,Diciembre,Namibia,1,0,,1,-74.140516,4.697157
60449,2018,Diciembre,Nepal,1,0,,1,-75.527794,10.406342
60450,2018,Diciembre,Nepal,1,5,,6,-75.516486,10.446304
60451,2018,Diciembre,Nepal,0,1,,1,-74.77647900000001,10.886686
60452,2018,Diciembre,Nepal,6,4,,10,-74.140516,4.697157
60453,2018,Diciembre,Nicaragua,1,0,,1,-77.35600000000001,0.81488
60454,2018,Diciembre,Nicaragua,0,1,,1,-75.527794,10.406342
60455,2018,Diciembre,Nicaragua,16,20,,36,-75.516486,10.446304
60456,2018,Diciembre,Nicaragua,2,4,,6,-74.77647900000001,10.886686
60457,2018,Diciembre,Nicaragua,1,0,,1,-72.129595,11.360028999999999
60458,2018,Diciembre,Nicaragua,0,1,,1,-81.703935,12.574411099999999
60459,2018,Diciembre,Nicaragua,5,3,,8,-81.70216500000001,12.5862
60460,2018,Diciembre,Nicaragua,14,23,,37,-76.532004,3.451668
60461,2018,Diciembre,Nicaragua,1,2,,3,-75.76635300000001,4.45285
60462,2018,Diciembre,Nicaragua,101,106,,207,-74.140516,4.697157
60463,2018,Diciembre,Nicaragua,2,1,,3,-75.736374,4.815189
60464,2018,Diciembre,Nicaragua,19,12,,31,-75.42726,6.170465
60465,2018,Diciembre,Nicaragua,2,1,,3,-73.181317,7.1280470000000005
60466,2018,Diciembre,Nigeria,0,1,,1,-75.516486,10.446304
60467,2018,Diciembre,Nigeria,2,7,,9,-74.140516,4.697157
60468,2018,Diciembre,Nigeria,0,3,,3,-75.42726,6.170465
60469,2018,Diciembre,Níger,0,1,,1,-74.140516,4.697157
60470,2018,Diciembre,Noruega,1,8,,9,-77.35600000000001,0.81488
60471,2018,Diciembre,Noruega,2,1,,3,-75.527794,10.406342
60472,2018,Diciembre,Noruega,40,59,,99,-75.516486,10.446304
60473,2018,Diciembre,Noruega,7,14,,21,-74.77647900000001,10.886686
60474,2018,Diciembre,Noruega,1,1,,2,-74.213989,11.247722999999999
60475,2018,Diciembre,Noruega,0,1,,1,-81.372937,13.338761300000002
60476,2018,Diciembre,Noruega,9,11,,20,-76.532004,3.451668
60477,2018,Diciembre,Noruega,145,213,,358,-74.140516,4.697157
60478,2018,Diciembre,Noruega,4,3,,7,-75.736374,4.815189
60479,2018,Diciembre,Noruega,19,25,,44,-75.42726,6.170465
60480,2018,Diciembre,Noruega,4,3,,7,-77.35002,8.63337
60481,2018,Diciembre,Nueva Zelanda,1,1,,2,-69.941498,4.191162
60482,2018,Diciembre,Nueva Zelanda,1,0,,1,-69.94143100000001,4.214082
60483,2018,Diciembre,Nueva Zelanda,9,16,,25,-77.35600000000001,0.81488
60484,2018,Diciembre,Nueva Zelanda,3,8,,11,-75.527794,10.406342
60485,2018,Diciembre,Nueva Zelanda,18,22,,40,-75.516486,10.446304
60486,2018,Diciembre,Nueva Zelanda,3,5,,8,-74.77647900000001,10.886686
60487,2018,Diciembre,Nueva Zelanda,1,0,,1,-81.70216500000001,12.5862
60488,2018,Diciembre,Nueva Zelanda,5,8,,13,-76.532004,3.451668
60489,2018,Diciembre,Nueva Zelanda,121,174,,295,-74.140516,4.697157
60490,2018,Diciembre,Nueva Zelanda,1,0,,1,-75.736374,4.815189
60491,2018,Diciembre,Nueva Zelanda,13,28,,41,-75.42726,6.170465
60492,2018,Diciembre,Nueva Zelanda,6,3,,9,-77.35002,8.63337
60493,2018,Diciembre,Omán,0,7,,7,-74.140516,4.697157
60494,2018,Diciembre,Países Bajos,3,3,,6,-69.941498,4.191162
60495,2018,Diciembre,Países Bajos,2,5,,7,-69.94143100000001,4.214082
60496,2018,Diciembre,Países Bajos,3,4,,7,-76.876446,0.33002
60497,2018,Diciembre,Países Bajos,17,26,,43,-77.35600000000001,0.81488
60498,2018,Diciembre,Países Bajos,20,29,,49,-75.527794,10.406342
60499,2018,Diciembre,Países Bajos,297,362,,659,-75.516486,10.446304
60500,2018,Diciembre,Países Bajos,14,20,,34,-74.77647900000001,10.886686
60501,2018,Diciembre,Países Bajos,0,1,,1,-74.765343,10.970933
60502,2018,Diciembre,Países Bajos,0,1,,1,-74.232675,11.117206
60503,2018,Diciembre,Países Bajos,2,3,,5,-74.213989,11.247722999999999
60504,2018,Diciembre,Países Bajos,4,5,,9,-72.129595,11.360028999999999
60505,2018,Diciembre,Países Bajos,0,1,,1,-81.703935,12.574411099999999
60506,2018,Diciembre,Países Bajos,1,0,,1,-81.372937,13.338761300000002
60507,2018,Diciembre,Países Bajos,57,100,,157,-76.532004,3.451668
60508,2018,Diciembre,Países Bajos,1861,2720,,4581,-74.140516,4.697157
60509,2018,Diciembre,Países Bajos,4,11,,15,-75.736374,4.815189
60510,2018,Diciembre,Países Bajos,165,275,,440,-75.42726,6.170465
60511,2018,Diciembre,Países Bajos,10,11,,21,-73.181317,7.1280470000000005
60512,2018,Diciembre,Países Bajos,0,8,,8,-72.453013,7.819
60513,2018,Diciembre,Países Bajos,0,1,,1,-72.409396,8.36068
60514,2018,Diciembre,Países Bajos,8,9,,17,-77.35002,8.63337
60515,2018,Diciembre,Pakistán,3,16,,19,-74.140516,4.697157
60516,2018,Diciembre,Pakistán,1,2,,3,-75.42726,6.170465
60517,2018,Diciembre,Panamá,3,1,,4,-77.35600000000001,0.81488
60518,2018,Diciembre,Panamá,0,9,,9,-75.527794,10.406342
60519,2018,Diciembre,Panamá,519,560,,1079,-75.516486,10.446304
60520,2018,Diciembre,Panamá,85,129,,214,-74.77647900000001,10.886686
60521,2018,Diciembre,Panamá,0,1,,1,-74.213989,11.247722999999999
60522,2018,Diciembre,Panamá,0,3,,3,-72.129595,11.360028999999999
60523,2018,Diciembre,Panamá,0,5,,5,-81.703935,12.574411099999999
60524,2018,Diciembre,Panamá,64,65,,129,-81.70216500000001,12.5862
60525,2018,Diciembre,Panamá,249,337,,586,-76.532004,3.451668
60526,2018,Diciembre,Panamá,38,51,,89,-75.76635300000001,4.45285
60527,2018,Diciembre,Panamá,1756,2053,,3809,-74.140516,4.697157
60528,2018,Diciembre,Panamá,46,58,,104,-75.736374,4.815189
60529,2018,Diciembre,Panamá,1655,1728,,3383,-75.42726,6.170465
60530,2018,Diciembre,Panamá,5,9,,14,-75.586989,6.2188349999999994
60531,2018,Diciembre,Panamá,7,6,,13,-77.762647,7.102626
60532,2018,Diciembre,Panamá,5,15,,20,-73.181317,7.1280470000000005
60533,2018,Diciembre,Panamá,2,5,,7,-72.453013,7.819
60534,2018,Diciembre,Panamá,0,2,,2,-72.508188,7.927233
60535,2018,Diciembre,Panamá,4,13,,17,-77.35002,8.63337
60536,2018,Diciembre,Paraguay,3,5,,8,-69.941498,4.191162
60537,2018,Diciembre,Paraguay,0,2,,2,-77.35600000000001,0.81488
60538,2018,Diciembre,Paraguay,3,3,,6,-75.527794,10.406342
60539,2018,Diciembre,Paraguay,58,29,,87,-75.516486,10.446304
60540,2018,Diciembre,Paraguay,5,9,,14,-74.77647900000001,10.886686
60541,2018,Diciembre,Paraguay,48,42,,90,-81.70216500000001,12.5862
60542,2018,Diciembre,Paraguay,6,2,,8,-76.532004,3.451668
60543,2018,Diciembre,Paraguay,140,110,,250,-74.140516,4.697157
60544,2018,Diciembre,Paraguay,0,1,,1,-75.736374,4.815189
60545,2018,Diciembre,Paraguay,11,19,,30,-75.42726,6.170465
60546,2018,Diciembre,Paraguay,0,1,,1,-72.453013,7.819
60547,2018,Diciembre,Paraguay,1,0,,1,-72.409396,8.36068
60548,2018,Diciembre,Perú,20,17,,37,-69.941498,4.191162
60549,2018,Diciembre,Perú,44,38,,82,-69.94143100000001,4.214082
60550,2018,Diciembre,Perú,1,55,,56,-74.78366,0.18595699999999998
60551,2018,Diciembre,Perú,3,15,,18,-76.876446,0.33002
60552,2018,Diciembre,Perú,206,360,,566,-77.35600000000001,0.81488
60553,2018,Diciembre,Perú,25,19,,44,-75.527794,10.406342
60554,2018,Diciembre,Perú,986,733,,1719,-75.516486,10.446304
60555,2018,Diciembre,Perú,13,16,,29,-74.77647900000001,10.886686
60556,2018,Diciembre,Perú,1,1,,2,-74.232675,11.117206
60557,2018,Diciembre,Perú,3,20,,23,-72.129595,11.360028999999999
60558,2018,Diciembre,Perú,0,4,,4,-81.703935,12.574411099999999
60559,2018,Diciembre,Perú,259,191,,450,-81.70216500000001,12.5862
60560,2018,Diciembre,Perú,263,253,,516,-76.532004,3.451668
60561,2018,Diciembre,Perú,3417,4003,,7420,-74.140516,4.697157
60562,2018,Diciembre,Perú,4,2,,6,-75.736374,4.815189
60563,2018,Diciembre,Perú,697,842,,1539,-75.42726,6.170465
60564,2018,Diciembre,Perú,2,0,,2,-67.48402800000001,6.185536
60565,2018,Diciembre,Perú,3,4,,7,-70.74025300000001,7.088728999999999
60566,2018,Diciembre,Perú,108,166,,274,-72.453013,7.819
60567,2018,Diciembre,Perú,8,13,,21,-72.409396,8.36068
60568,2018,Diciembre,Palestina,1,2,,3,-75.516486,10.446304
60569,2018,Diciembre,Palestina,1,1,,2,-74.140516,4.697157
60570,2018,Diciembre,Palestina,0,1,,1,-75.42726,6.170465
60571,2018,Diciembre,Polonia,2,3,,5,-69.941498,4.191162
60572,2018,Diciembre,Polonia,1,0,,1,-69.94143100000001,4.214082
60573,2018,Diciembre,Polonia,4,5,,9,-77.35600000000001,0.81488
60574,2018,Diciembre,Polonia,27,41,,68,-75.527794,10.406342
60575,2018,Diciembre,Polonia,31,43,,74,-75.516486,10.446304
60576,2018,Diciembre,Polonia,0,2,,2,-74.77647900000001,10.886686
60577,2018,Diciembre,Polonia,0,5,,5,-74.765343,10.970933
60578,2018,Diciembre,Polonia,1,6,,7,-74.213989,11.247722999999999
60579,2018,Diciembre,Polonia,6,4,,10,-76.532004,3.451668
60580,2018,Diciembre,Polonia,0,2,,2,-77.061029,3.8844260000000004
60581,2018,Diciembre,Polonia,177,180,,357,-74.140516,4.697157
60582,2018,Diciembre,Polonia,1,0,,1,-75.736374,4.815189
60583,2018,Diciembre,Polonia,11,18,,29,-75.42726,6.170465
60584,2018,Diciembre,Polonia,1,0,,1,-77.35002,8.63337
60585,2018,Diciembre,Portugal,0,1,,1,-69.941498,4.191162
60586,2018,Diciembre,Portugal,1,1,,2,-69.94143100000001,4.214082
60587,2018,Diciembre,Portugal,0,4,,4,-77.35600000000001,0.81488
60588,2018,Diciembre,Portugal,0,2,,2,-75.527794,10.406342
60589,2018,Diciembre,Portugal,18,36,,54,-75.516486,10.446304
60590,2018,Diciembre,Portugal,0,4,,4,-74.77647900000001,10.886686
60591,2018,Diciembre,Portugal,1,4,,5,-72.129595,11.360028999999999
60592,2018,Diciembre,Portugal,10,25,,35,-76.532004,3.451668
60593,2018,Diciembre,Portugal,239,419,,658,-74.140516,4.697157
60594,2018,Diciembre,Portugal,33,47,,80,-75.42726,6.170465
60595,2018,Diciembre,Portugal,0,1,,1,-70.74025300000001,7.088728999999999
60596,2018,Diciembre,Portugal,0,1,,1,-73.181317,7.1280470000000005
60597,2018,Diciembre,Portugal,11,21,,32,-72.453013,7.819
60598,2018,Diciembre,Portugal,3,3,,6,-72.409396,8.36068
60599,2018,Diciembre,Qatar,0,2,,2,-75.516486,10.446304
60600,2018,Diciembre,Qatar,2,6,,8,-74.140516,4.697157
60601,2018,Diciembre,Qatar,0,2,,2,-75.42726,6.170465
60602,2018,Diciembre,Reino Unido de Gran Bretaña e Irlanda del Norte,1,2,,3,-69.941498,4.191162
60603,2018,Diciembre,Reino Unido de Gran Bretaña e Irlanda del Norte,4,6,,10,-69.94143100000001,4.214082
60604,2018,Diciembre,Reino Unido de Gran Bretaña e Irlanda del Norte,0,2,,2,-76.876446,0.33002
60605,2018,Diciembre,Reino Unido de Gran Bretaña e Irlanda del Norte,37,39,,76,-77.35600000000001,0.81488
60606,2018,Diciembre,Reino Unido de Gran Bretaña e Irlanda del Norte,25,32,,57,-75.527794,10.406342
60607,2018,Diciembre,Reino Unido de Gran Bretaña e Irlanda del Norte,143,261,,404,-75.516486,10.446304
60608,2018,Diciembre,Reino Unido de Gran Bretaña e Irlanda del Norte,19,34,,53,-74.77647900000001,10.886686
60609,2018,Diciembre,Reino Unido de Gran Bretaña e Irlanda del Norte,1,4,,5,-74.232675,11.117206
60610,2018,Diciembre,Reino Unido de Gran Bretaña e Irlanda del Norte,21,25,,46,-74.213989,11.247722999999999
60611,2018,Diciembre,Reino Unido de Gran Bretaña e Irlanda del Norte,0,1,,1,-81.703935,12.574411099999999
60612,2018,Diciembre,Reino Unido de Gran Bretaña e Irlanda del Norte,2,4,,6,-81.70216500000001,12.5862
60613,2018,Diciembre,Reino Unido de Gran Bretaña e Irlanda del Norte,1,0,,1,-81.372937,13.338761300000002
60614,2018,Diciembre,Reino Unido de Gran Bretaña e Irlanda del Norte,53,85,,138,-76.532004,3.451668
60615,2018,Diciembre,Reino Unido de Gran Bretaña e Irlanda del Norte,0,1,,1,-77.061029,3.8844260000000004
60616,2018,Diciembre,Reino Unido de Gran Bretaña e Irlanda del Norte,3,2,,5,-75.76635300000001,4.45285
60617,2018,Diciembre,Reino Unido de Gran Bretaña e Irlanda del Norte,1470,2622,,4092,-74.140516,4.697157
60618,2018,Diciembre,Reino Unido de Gran Bretaña e Irlanda del Norte,1,9,,10,-75.736374,4.815189
60619,2018,Diciembre,Reino Unido de Gran Bretaña e Irlanda del Norte,153,308,,461,-75.42726,6.170465
60620,2018,Diciembre,Reino Unido de Gran Bretaña e Irlanda del Norte,1,0,,1,-70.74025300000001,7.088728999999999
60621,2018,Diciembre,Reino Unido de Gran Bretaña e Irlanda del Norte,1,4,,5,-73.181317,7.1280470000000005
60622,2018,Diciembre,Reino Unido de Gran Bretaña e Irlanda del Norte,2,2,,4,-72.453013,7.819
60623,2018,Diciembre,Reino Unido de Gran Bretaña e Irlanda del Norte,0,1,,1,-72.409396,8.36068
60624,2018,Diciembre,Reino Unido de Gran Bretaña e Irlanda del Norte,29,30,,59,-77.35002,8.63337
60625,2018,Diciembre,República Dominicana,2,0,,2,-69.941498,4.191162
60626,2018,Diciembre,República Dominicana,15,16,,31,-77.35600000000001,0.81488
60627,2018,Diciembre,República Dominicana,48,58,,106,-75.516486,10.446304
60628,2018,Diciembre,República Dominicana,19,28,,47,-74.77647900000001,10.886686
60629,2018,Diciembre,República Dominicana,2,0,,2,-74.765343,10.970933
60630,2018,Diciembre,República Dominicana,0,3,,3,-74.232675,11.117206
60631,2018,Diciembre,República Dominicana,0,6,,6,-72.129595,11.360028999999999
60632,2018,Diciembre,República Dominicana,1,1,,2,-81.703935,12.574411099999999
60633,2018,Diciembre,República Dominicana,0,4,,4,-81.70216500000001,12.5862
60634,2018,Diciembre,República Dominicana,1,1,,2,-81.372937,13.338761300000002
60635,2018,Diciembre,República Dominicana,29,24,,53,-76.532004,3.451668
60636,2018,Diciembre,República Dominicana,791,900,,1691,-74.140516,4.697157
60637,2018,Diciembre,República Dominicana,4,2,,6,-75.736374,4.815189
60638,2018,Diciembre,República Dominicana,49,89,,138,-75.42726,6.170465
60639,2018,Diciembre,República Dominicana,2,1,,3,-73.181317,7.1280470000000005
60640,2018,Diciembre,República Dominicana,2,6,,8,-72.453013,7.819
60641,2018,Diciembre,República Dominicana,0,2,,2,-72.409396,8.36068
60642,2018,Diciembre,Rumania,0,1,,1,-77.35600000000001,0.81488
60643,2018,Diciembre,Rumania,1,5,,6,-75.527794,10.406342
60644,2018,Diciembre,Rumania,12,10,,22,-75.516486,10.446304
60645,2018,Diciembre,Rumania,1,3,,4,-74.77647900000001,10.886686
60646,2018,Diciembre,Rumania,0,1,,1,-74.765343,10.970933
60647,2018,Diciembre,Rumania,0,1,,1,-74.213989,11.247722999999999
60648,2018,Diciembre,Rumania,0,1,,1,-76.532004,3.451668
60649,2018,Diciembre,Rumania,86,93,,179,-74.140516,4.697157
60650,2018,Diciembre,Rumania,16,15,,31,-75.42726,6.170465
60651,2018,Diciembre,Rumania,0,1,,1,-75.68164200000001,9.402597
60652,2018,Diciembre,Federación de Rusia,1,0,,1,-76.876446,0.33002
60653,2018,Diciembre,Federación de Rusia,5,5,,10,-77.35600000000001,0.81488
60654,2018,Diciembre,Federación de Rusia,1,7,,8,-75.527794,10.406342
60655,2018,Diciembre,Federación de Rusia,24,21,,45,-75.516486,10.446304
60656,2018,Diciembre,Federación de Rusia,4,0,,4,-74.77647900000001,10.886686
60657,2018,Diciembre,Federación de Rusia,0,1,,1,-74.765343,10.970933
60658,2018,Diciembre,Federación de Rusia,1,2,,3,-74.213989,11.247722999999999
60659,2018,Diciembre,Federación de Rusia,0,1,,1,-81.703935,12.574411099999999
60660,2018,Diciembre,Federación de Rusia,2,1,,3,-81.70216500000001,12.5862
60661,2018,Diciembre,Federación de Rusia,14,3,,17,-76.532004,3.451668
60662,2018,Diciembre,Federación de Rusia,243,235,,478,-74.140516,4.697157
60663,2018,Diciembre,Federación de Rusia,14,8,,22,-75.42726,6.170465
60664,2018,Diciembre,Federación de Rusia,0,2,,2,-77.762647,7.102626
60665,2018,Diciembre,Federación de Rusia,2,1,,3,-72.453013,7.819
60666,2018,Diciembre,Federación de Rusia,0,1,,1,-75.68164200000001,9.402597
60667,2018,Diciembre,San Cristóbal y Nevis,0,1,,1,-77.35600000000001,0.81488
60668,2018,Diciembre,San Cristóbal y Nevis,0,1,,1,-75.516486,10.446304
60669,2018,Diciembre,San Cristóbal y Nevis,4,3,,7,-74.140516,4.697157
60670,2018,Diciembre,San  Vicente y las Granadinas,1,0,,1,-76.532004,3.451668
60671,2018,Diciembre,San  Vicente y las Granadinas,0,2,,2,-74.140516,4.697157
60672,2018,Diciembre,Santa Lucia,1,0,,1,-75.516486,10.446304
60673,2018,Diciembre,Santa Lucia,1,2,,3,-76.532004,3.451668
60674,2018,Diciembre,Santa Lucia,4,1,,5,-74.140516,4.697157
60675,2018,Diciembre,Santa Lucia,0,2,,2,-75.42726,6.170465
60676,2018,Diciembre,Santa Lucia,0,1,,1,-72.453013,7.819
60677,2018,Diciembre,Senegal,2,2,,4,-74.140516,4.697157
60678,2018,Diciembre,Senegal,0,1,,1,-75.42726,6.170465
60679,2018,Diciembre,Serbia,2,1,,3,-77.35600000000001,0.81488
60680,2018,Diciembre,Serbia,1,3,,4,-75.527794,10.406342
60681,2018,Diciembre,Serbia,4,8,,12,-75.516486,10.446304
60682,2018,Diciembre,Serbia,0,3,,3,-76.532004,3.451668
60683,2018,Diciembre,Serbia,19,59,,78,-74.140516,4.697157
60684,2018,Diciembre,Serbia,4,1,,5,-75.42726,6.170465
60685,2018,Diciembre,Seychelles,0,1,,1,-74.140516,4.697157
60686,2018,Diciembre,Singapur,6,7,,13,-75.516486,10.446304
60687,2018,Diciembre,Singapur,1,0,,1,-74.77647900000001,10.886686
60688,2018,Diciembre,Singapur,2,1,,3,-76.532004,3.451668
60689,2018,Diciembre,Singapur,55,45,,100,-74.140516,4.697157
60690,2018,Diciembre,Singapur,6,4,,10,-75.42726,6.170465
60691,2018,Diciembre,República Árabe Siria,2,6,,8,-74.140516,4.697157
60692,2018,Diciembre,Sri Lanka,0,1,,1,-77.35600000000001,0.81488
60693,2018,Diciembre,Sri Lanka,1,0,,1,-75.516486,10.446304
60694,2018,Diciembre,Sri Lanka,1,1,,2,-74.140516,4.697157
60695,2018,Diciembre,Sudáfrica,1,1,,2,-77.35600000000001,0.81488
60696,2018,Diciembre,Sudáfrica,4,8,,12,-75.527794,10.406342
60697,2018,Diciembre,Sudáfrica,3,1,,4,-75.516486,10.446304
60698,2018,Diciembre,Sudáfrica,1,0,,1,-74.77647900000001,10.886686
60699,2018,Diciembre,Sudáfrica,0,2,,2,-76.532004,3.451668
60700,2018,Diciembre,Sudáfrica,22,30,,52,-74.140516,4.697157
60701,2018,Diciembre,Sudáfrica,1,1,,2,-75.42726,6.170465
60702,2018,Diciembre,Sudán,2,3,,5,-74.140516,4.697157
60703,2018,Diciembre,Suecia,1,2,,3,-69.941498,4.191162
60704,2018,Diciembre,Suecia,0,1,,1,-69.94143100000001,4.214082
60705,2018,Diciembre,Suecia,5,6,,11,-77.35600000000001,0.81488
60706,2018,Diciembre,Suecia,8,6,,14,-75.527794,10.406342
60707,2018,Diciembre,Suecia,90,106,,196,-75.516486,10.446304
60708,2018,Diciembre,Suecia,14,13,,27,-74.77647900000001,10.886686
60709,2018,Diciembre,Suecia,0,2,,2,-74.232675,11.117206
60710,2018,Diciembre,Suecia,1,1,,2,-74.213989,11.247722999999999
60711,2018,Diciembre,Suecia,0,2,,2,-81.70216500000001,12.5862
60712,2018,Diciembre,Suecia,38,40,,78,-76.532004,3.451668
60713,2018,Diciembre,Suecia,391,565,,956,-74.140516,4.697157
60714,2018,Diciembre,Suecia,1,3,,4,-75.736374,4.815189
60715,2018,Diciembre,Suecia,45,72,,117,-75.42726,6.170465
60716,2018,Diciembre,Suecia,1,2,,3,-73.181317,7.1280470000000005
60717,2018,Diciembre,Suecia,1,0,,1,-72.453013,7.819
60718,2018,Diciembre,Suecia,2,1,,3,-77.35002,8.63337
60719,2018,Diciembre,Suiza,2,4,,6,-69.941498,4.191162
60720,2018,Diciembre,Suiza,1,1,,2,-69.94143100000001,4.214082
60721,2018,Diciembre,Suiza,1,0,,1,-76.876446,0.33002
60722,2018,Diciembre,Suiza,29,36,,65,-77.35600000000001,0.81488
60723,2018,Diciembre,Suiza,21,25,,46,-75.527794,10.406342
60724,2018,Diciembre,Suiza,66,105,,171,-75.516486,10.446304
60725,2018,Diciembre,Suiza,9,8,,17,-74.77647900000001,10.886686
60726,2018,Diciembre,Suiza,4,5,,9,-74.232675,11.117206
60727,2018,Diciembre,Suiza,1,1,,2,-74.213989,11.247722999999999
60728,2018,Diciembre,Suiza,3,6,,9,-81.70216500000001,12.5862
60729,2018,Diciembre,Suiza,39,59,,98,-76.532004,3.451668
60730,2018,Diciembre,Suiza,808,1326,,2134,-74.140516,4.697157
60731,2018,Diciembre,Suiza,1,3,,4,-75.736374,4.815189
60732,2018,Diciembre,Suiza,65,146,,211,-75.42726,6.170465
60733,2018,Diciembre,Suiza,1,0,,1,-73.181317,7.1280470000000005
60734,2018,Diciembre,Suiza,1,2,,3,-72.453013,7.819
60735,2018,Diciembre,Suiza,1,0,,1,-72.409396,8.36068
60736,2018,Diciembre,Suiza,8,8,,16,-77.35002,8.63337
60737,2018,Diciembre,Surinam,12,8,,20,-74.140516,4.697157
60738,2018,Diciembre,Surinam,1,0,,1,-75.42726,6.170465
60739,2018,Diciembre,Surinam,3,0,,3,-73.181317,7.1280470000000005
60740,2018,Diciembre,República de Tayikistán,1,1,,2,-74.140516,4.697157
60741,2018,Diciembre,Tailandia,1,0,,1,-77.35600000000001,0.81488
60742,2018,Diciembre,Tailandia,17,10,,27,-74.140516,4.697157
60743,2018,Diciembre,Tailandia,1,0,,1,-75.42726,6.170465
60744,2018,Diciembre,Trinidad y Tobago,0,1,,1,-77.35600000000001,0.81488
60745,2018,Diciembre,Trinidad y Tobago,1,0,,1,-75.527794,10.406342
60746,2018,Diciembre,Trinidad y Tobago,8,9,,17,-75.516486,10.446304
60747,2018,Diciembre,Trinidad y Tobago,1,1,,2,-74.213989,11.247722999999999
60748,2018,Diciembre,Trinidad y Tobago,0,1,,1,-72.129595,11.360028999999999
60749,2018,Diciembre,Trinidad y Tobago,0,1,,1,-81.70216500000001,12.5862
60750,2018,Diciembre,Trinidad y Tobago,4,5,,9,-76.532004,3.451668
60751,2018,Diciembre,Trinidad y Tobago,21,54,,75,-74.140516,4.697157
60752,2018,Diciembre,Trinidad y Tobago,0,1,,1,-75.736374,4.815189
60753,2018,Diciembre,Trinidad y Tobago,9,24,,33,-75.42726,6.170465
60754,2018,Diciembre,Trinidad y Tobago,0,5,,5,-73.181317,7.1280470000000005
60755,2018,Diciembre,Trinidad y Tobago,1,0,,1,-72.453013,7.819
60756,2018,Diciembre,Túnez,3,1,,4,-75.516486,10.446304
60757,2018,Diciembre,Túnez,6,7,,13,-74.140516,4.697157
60758,2018,Diciembre,Turquía,1,5,,6,-77.35600000000001,0.81488
60759,2018,Diciembre,Turquía,1,2,,3,-75.527794,10.406342
60760,2018,Diciembre,Turquía,6,14,,20,-75.516486,10.446304
60761,2018,Diciembre,Turquía,0,3,,3,-74.77647900000001,10.886686
60762,2018,Diciembre,Turquía,0,4,,4,-76.532004,3.451668
60763,2018,Diciembre,Turquía,155,347,,502,-74.140516,4.697157
60764,2018,Diciembre,Turquía,10,18,,28,-75.42726,6.170465
60765,2018,Diciembre,Turquía,0,1,,1,-72.453013,7.819
60766,2018,Diciembre,Turkmenistán,2,3,,5,-74.140516,4.697157
60767,2018,Diciembre,Ucrania,1,9,,10,-75.527794,10.406342
60768,2018,Diciembre,Ucrania,3,10,,13,-75.516486,10.446304
60769,2018,Diciembre,Ucrania,0,1,,1,-74.77647900000001,10.886686
60770,2018,Diciembre,Ucrania,0,1,,1,-74.213989,11.247722999999999
60771,2018,Diciembre,Ucrania,3,1,,4,-76.532004,3.451668
60772,2018,Diciembre,Ucrania,0,2,,2,-77.061029,3.8844260000000004
60773,2018,Diciembre,Ucrania,59,34,,93,-74.140516,4.697157
60774,2018,Diciembre,Ucrania,7,3,,10,-75.42726,6.170465
60775,2018,Diciembre,Ucrania,0,2,,2,-75.68164200000001,9.402597
60776,2018,Diciembre,Uganda,0,1,,1,-77.35600000000001,0.81488
60777,2018,Diciembre,Uganda,1,1,,2,-74.140516,4.697157
60778,2018,Diciembre,Uruguay,1,0,,1,-69.941498,4.191162
60779,2018,Diciembre,Uruguay,1,0,,1,-69.94143100000001,4.214082
60780,2018,Diciembre,Uruguay,1,3,,4,-77.35600000000001,0.81488
60781,2018,Diciembre,Uruguay,9,5,,14,-75.527794,10.406342
60782,2018,Diciembre,Uruguay,64,69,,133,-75.516486,10.446304
60783,2018,Diciembre,Uruguay,0,9,,9,-74.77647900000001,10.886686
60784,2018,Diciembre,Uruguay,0,1,,1,-74.232675,11.117206
60785,2018,Diciembre,Uruguay,0,1,,1,-72.129595,11.360028999999999
60786,2018,Diciembre,Uruguay,3,5,,8,-81.70216500000001,12.5862
60787,2018,Diciembre,Uruguay,25,35,,60,-76.532004,3.451668
60788,2018,Diciembre,Uruguay,344,567,,911,-74.140516,4.697157
60789,2018,Diciembre,Uruguay,38,73,,111,-75.42726,6.170465
60790,2018,Diciembre,Uruguay,7,9,,16,-72.453013,7.819
60791,2018,Diciembre,Uruguay,1,1,,2,-72.409396,8.36068
60792,2018,Diciembre,Uzbekistán,0,1,,1,-74.140516,4.697157
60793,2018,Diciembre,Venezuela,7,8,,15,-69.941498,4.191162
60794,2018,Diciembre,Venezuela,6,5,,11,-69.94143100000001,4.214082
60795,2018,Diciembre,Venezuela,0,1,,1,-74.78366,0.18595699999999998
60796,2018,Diciembre,Venezuela,135,143,,278,-76.876446,0.33002
60797,2018,Diciembre,Venezuela,7788,9551,,17339,-77.35600000000001,0.81488
60798,2018,Diciembre,Venezuela,2,1,,3,-78.802679,18.00143
60799,2018,Diciembre,Venezuela,27,30,,57,-75.527794,10.406342
60800,2018,Diciembre,Venezuela,259,252,,511,-75.516486,10.446304
60801,2018,Diciembre,Venezuela,198,277,,475,-74.77647900000001,10.886686
60802,2018,Diciembre,Venezuela,1,1,,2,-74.765343,10.970933
60803,2018,Diciembre,Venezuela,4,14,,18,-74.232675,11.117206
60804,2018,Diciembre,Venezuela,1,0,,1,-74.213989,11.247722999999999
60805,2018,Diciembre,Venezuela,7020,5683,,12703,-72.129595,11.360028999999999
60806,2018,Diciembre,Venezuela,5,4,,9,-81.70216500000001,12.5862
60807,2018,Diciembre,Venezuela,338,336,,674,-76.532004,3.451668
60808,2018,Diciembre,Venezuela,23,13,,36,-67.927521,3.866713
60809,2018,Diciembre,Venezuela,4,2,,6,-75.76635300000001,4.45285
60810,2018,Diciembre,Venezuela,9164,9008,,18172,-74.140516,4.697157
60811,2018,Diciembre,Venezuela,9,24,,33,-75.736374,4.815189
60812,2018,Diciembre,Venezuela,1224,1157,,2381,-75.42726,6.170465
60813,2018,Diciembre,Venezuela,73,56,,129,-67.48402800000001,6.185536
60814,2018,Diciembre,Venezuela,1083,977,,2060,-70.74025300000001,7.088728999999999
60815,2018,Diciembre,Venezuela,17,39,,56,-73.181317,7.1280470000000005
60816,2018,Diciembre,Venezuela,26412,19223,,45635,-72.453013,7.819
60817,2018,Diciembre,Venezuela,2,19,,21,-72.508188,7.927233
60818,2018,Diciembre,Venezuela,3622,2408,,6030,-72.409396,8.36068
60819,2018,Diciembre,Venezuela,0,1,,1,-77.35002,8.63337
60820,2018,Diciembre,Vietnam,1,1,,2,-77.35600000000001,0.81488
60821,2018,Diciembre,Vietnam,1,1,,2,-75.516486,10.446304
60822,2018,Diciembre,Vietnam,7,3,,10,-74.140516,4.697157
60823,2018,Diciembre,Vietnam,0,1,,1,-75.42726,6.170465
60824,2018,Diciembre,República Árabe de Yemen,0,1,,1,-77.35600000000001,0.81488
60825,2018,Diciembre,República Árabe de Yemen,0,1,,1,-74.140516,4.697157
60826,2018,Diciembre,Zambia,0,1,,1,-74.140516,4.697157
60827,2018,Diciembre,Zimbabue,0,1,,1,-74.140516,4.697157
60828,2018,Diciembre,Zimbabue,1,0,,1,-75.42726,6.170465
60829,2018,Diciembre,Islas Turcas y Caicos/Territorio Británico de Ultramar,1,1,,2,-74.77647900000001,10.886686
60830,2018,Diciembre,Refugiado,2,1,,3,-75.516486,10.446304
60831,2018,Diciembre,Refugiado,0,2,,2,-76.532004,3.451668
60832,2018,Diciembre,Refugiado,2,10,,12,-74.140516,4.697157
60833,2018,Diciembre,Refugiado,0,2,,2,-75.42726,6.170465
60834,2018,Diciembre,Desconocido,1,2,,3,-75.516486,10.446304
60835,2018,Diciembre,Desconocido,1,1,,2,-74.77647900000001,10.886686
60836,2018,Diciembre,Desconocido,1,0,,1,-76.532004,3.451668
60837,2018,Diciembre,Desconocido,79,147,,226,-74.140516,4.697157
60838,2018,Diciembre,Desconocido,1,0,,1,-75.736374,4.815189
60839,2018,Diciembre,Desconocido,0,5,,5,-75.42726,6.170465
60840,2018,Diciembre,Desconocido,2,0,,2,-70.74025300000001,7.088728999999999
60841,2018,Diciembre,Desconocido,0,1,,1,-72.409396,8.36068
60842,2018,Diciembre,República CentroÁfricana,1,0,,1,-76.532004,3.451668
60843,2019,Enero,Afganistán,0,1,,1,-74.77647900000001,10.886686
60844,2019,Enero,Afganistán,0,1,,1,-74.140516,4.697157
60845,2019,Enero,Albania,0,1,,1,-76.532004,3.451668
60846,2019,Enero,Albania,2,11,,13,-74.140516,4.697157
60847,2019,Enero,Albania,0,3,,3,-75.42726,6.170465
60848,2019,Enero,Alemania,10,17,,27,-69.941498,4.191162
60849,2019,Enero,Alemania,13,16,,29,-69.94143100000001,4.214082
60850,2019,Enero,Alemania,1,0,,1,-74.78366,0.18595699999999998
60851,2019,Enero,Alemania,7,7,,14,-76.876446,0.33002
60852,2019,Enero,Alemania,125,121,,246,-77.35600000000001,0.81488
60853,2019,Enero,Alemania,59,59,,118,-75.527794,10.406342
60854,2019,Enero,Alemania,165,276,,441,-75.516486,10.446304
60855,2019,Enero,Alemania,24,35,,59,-74.77647900000001,10.886686
60856,2019,Enero,Alemania,3,1,,4,-74.232675,11.117206
60857,2019,Enero,Alemania,4,8,,12,-74.213989,11.247722999999999
60858,2019,Enero,Alemania,2,3,,5,-72.129595,11.360028999999999
60859,2019,Enero,Alemania,6,5,,11,-81.70216500000001,12.5862
60860,2019,Enero,Alemania,1,1,,2,-81.372937,13.338761300000002
60861,2019,Enero,Alemania,85,135,,220,-76.532004,3.451668
60862,2019,Enero,Alemania,0,1,,1,-77.061029,3.8844260000000004
60863,2019,Enero,Alemania,2,1,,3,-75.76635300000001,4.45285
60864,2019,Enero,Alemania,2311,3142,,5453,-74.140516,4.697157
60865,2019,Enero,Alemania,5,8,,13,-75.736374,4.815189
60866,2019,Enero,Alemania,167,312,,479,-75.42726,6.170465
60867,2019,Enero,Alemania,0,1,,1,-73.181317,7.1280470000000005
60868,2019,Enero,Alemania,1,13,,14,-72.453013,7.819
60869,2019,Enero,Alemania,0,1,,1,-72.409396,8.36068
60870,2019,Enero,Alemania,27,39,,66,-77.35002,8.63337
60871,2019,Enero,Andorra,6,9,,15,-74.140516,4.697157
60872,2019,Enero,Angola,1,1,,2,-74.140516,4.697157
60873,2019,Enero,Antigua y Barbuda,4,5,,9,-74.140516,4.697157
60874,2019,Enero,Antigua y Barbuda,0,1,,1,-75.42726,6.170465
60875,2019,Enero,Arabia Saudita,1,3,,4,-74.140516,4.697157
60876,2019,Enero,Arabia Saudita,0,1,,1,-75.42726,6.170465
60877,2019,Enero,Argelia,5,4,,9,-74.140516,4.697157
60878,2019,Enero,Argelia,1,1,,2,-75.42726,6.170465
60879,2019,Enero,Argentina,1,6,,7,-69.941498,4.191162
60880,2019,Enero,Argentina,5,4,,9,-69.94143100000001,4.214082
60881,2019,Enero,Argentina,10,11,,21,-76.876446,0.33002
60882,2019,Enero,Argentina,147,232,,379,-77.35600000000001,0.81488
60883,2019,Enero,Argentina,0,1,,1,-78.802679,18.00143
60884,2019,Enero,Argentina,186,157,,343,-75.527794,10.406342
60885,2019,Enero,Argentina,2466,1879,,4345,-75.516486,10.446304
60886,2019,Enero,Argentina,15,30,,45,-74.77647900000001,10.886686
60887,2019,Enero,Argentina,7,2,,9,-74.232675,11.117206
60888,2019,Enero,Argentina,10,12,,22,-72.129595,11.360028999999999
60889,2019,Enero,Argentina,286,210,,496,-81.70216500000001,12.5862
60890,2019,Enero,Argentina,317,302,,619,-76.532004,3.451668
60891,2019,Enero,Argentina,0,1,,1,-75.76635300000001,4.45285
60892,2019,Enero,Argentina,5085,5402,,10487,-74.140516,4.697157
60893,2019,Enero,Argentina,2,5,,7,-75.736374,4.815189
60894,2019,Enero,Argentina,534,540,,1074,-75.42726,6.170465
60895,2019,Enero,Argentina,3,3,,6,-73.181317,7.1280470000000005
60896,2019,Enero,Argentina,7,22,,29,-72.453013,7.819
60897,2019,Enero,Argentina,0,7,,7,-72.409396,8.36068
60898,2019,Enero,Argentina,3,1,,4,-77.35002,8.63337
60899,2019,Enero,República de Armenia,1,1,,2,-75.516486,10.446304
60900,2019,Enero,República de Armenia,5,2,,7,-74.140516,4.697157
60901,2019,Enero,Australia,2,2,,4,-69.941498,4.191162
60902,2019,Enero,Australia,1,0,,1,-69.94143100000001,4.214082
60903,2019,Enero,Australia,0,1,,1,-77.84700600000001,0.8124359999999999
60904,2019,Enero,Australia,32,30,,62,-77.35600000000001,0.81488
60905,2019,Enero,Australia,25,20,,45,-75.527794,10.406342
60906,2019,Enero,Australia,82,102,,184,-75.516486,10.446304
60907,2019,Enero,Australia,4,12,,16,-74.77647900000001,10.886686
60908,2019,Enero,Australia,0,3,,3,-74.232675,11.117206
60909,2019,Enero,Australia,2,6,,8,-74.213989,11.247722999999999
60910,2019,Enero,Australia,1,1,,2,-72.129595,11.360028999999999
60911,2019,Enero,Australia,0,3,,3,-81.70216500000001,12.5862
60912,2019,Enero,Australia,16,30,,46,-76.532004,3.451668
60913,2019,Enero,Australia,380,634,,1014,-74.140516,4.697157
60914,2019,Enero,Australia,0,2,,2,-75.736374,4.815189
60915,2019,Enero,Australia,70,136,,206,-75.42726,6.170465
60916,2019,Enero,Australia,0,1,,1,-73.181317,7.1280470000000005
60917,2019,Enero,Australia,0,1,,1,-72.409396,8.36068
60918,2019,Enero,Australia,21,20,,41,-77.35002,8.63337
60919,2019,Enero,Austria,7,5,,12,-69.941498,4.191162
60920,2019,Enero,Austria,15,11,,26,-77.35600000000001,0.81488
60921,2019,Enero,Austria,9,12,,21,-75.527794,10.406342
60922,2019,Enero,Austria,20,30,,50,-75.516486,10.446304
60923,2019,Enero,Austria,4,8,,12,-74.77647900000001,10.886686
60924,2019,Enero,Austria,0,4,,4,-74.213989,11.247722999999999
60925,2019,Enero,Austria,0,1,,1,-72.129595,11.360028999999999
60926,2019,Enero,Austria,2,2,,4,-81.70216500000001,12.5862
60927,2019,Enero,Austria,0,1,,1,-81.372937,13.338761300000002
60928,2019,Enero,Austria,8,17,,25,-76.532004,3.451668
60929,2019,Enero,Austria,1,0,,1,-75.76635300000001,4.45285
60930,2019,Enero,Austria,298,439,,737,-74.140516,4.697157
60931,2019,Enero,Austria,16,38,,54,-75.42726,6.170465
60932,2019,Enero,Austria,0,1,,1,-72.453013,7.819
60933,2019,Enero,Austria,4,3,,7,-77.35002,8.63337
60934,2019,Enero,Azerbaiyán,0,1,,1,-75.516486,10.446304
60935,2019,Enero,Azerbaiyán,1,1,,2,-74.140516,4.697157
60936,2019,Enero,Bahamas,0,4,,4,-75.516486,10.446304
60937,2019,Enero,Bahamas,1,1,,2,-76.532004,3.451668
60938,2019,Enero,Bahamas,4,23,,27,-74.140516,4.697157
60939,2019,Enero,Bahamas,3,3,,6,-75.42726,6.170465
60940,2019,Enero,Bahréin,1,2,,3,-74.140516,4.697157
60941,2019,Enero,Bangladesh,0,2,,2,-74.140516,4.697157
60942,2019,Enero,Barbados,1,0,,1,-75.527794,10.406342
60943,2019,Enero,Barbados,3,0,,3,-75.516486,10.446304
60944,2019,Enero,Barbados,1,1,,2,-76.532004,3.451668
60945,2019,Enero,Barbados,3,4,,7,-74.140516,4.697157
60946,2019,Enero,Barbados,0,2,,2,-75.42726,6.170465
60947,2019,Enero,República de Belarús,0,1,,1,-77.35600000000001,0.81488
60948,2019,Enero,República de Belarús,1,0,,1,-75.516486,10.446304
60949,2019,Enero,República de Belarús,3,2,,5,-74.140516,4.697157
60950,2019,Enero,Bélgica,0,2,,2,-69.941498,4.191162
60951,2019,Enero,Bélgica,1,1,,2,-69.94143100000001,4.214082
60952,2019,Enero,Bélgica,3,2,,5,-76.876446,0.33002
60953,2019,Enero,Bélgica,12,14,,26,-77.35600000000001,0.81488
60954,2019,Enero,Bélgica,0,3,,3,-75.527794,10.406342
60955,2019,Enero,Bélgica,26,57,,83,-75.516486,10.446304
60956,2019,Enero,Bélgica,0,4,,4,-74.77647900000001,10.886686
60957,2019,Enero,Bélgica,0,2,,2,-74.765343,10.970933
60958,2019,Enero,Bélgica,0,1,,1,-74.213989,11.247722999999999
60959,2019,Enero,Bélgica,13,24,,37,-76.532004,3.451668
60960,2019,Enero,Bélgica,0,7,,7,-77.061029,3.8844260000000004
60961,2019,Enero,Bélgica,306,488,,794,-74.140516,4.697157
60962,2019,Enero,Bélgica,3,2,,5,-75.736374,4.815189
60963,2019,Enero,Bélgica,31,65,,96,-75.42726,6.170465
60964,2019,Enero,Bélgica,1,1,,2,-72.453013,7.819
60965,2019,Enero,Bélgica,0,1,,1,-72.409396,8.36068
60966,2019,Enero,Bélgica,0,1,,1,-77.35002,8.63337
60967,2019,Enero,Belice,0,1,,1,-75.516486,10.446304
60968,2019,Enero,Belice,1,2,,3,-81.70216500000001,12.5862
60969,2019,Enero,Belice,3,2,,5,-76.532004,3.451668
60970,2019,Enero,Belice,1,11,,12,-74.140516,4.697157
60971,2019,Enero,Belice,2,6,,8,-75.42726,6.170465
60972,2019,Enero,Benín,3,1,,4,-74.140516,4.697157
60973,2019,Enero,Bermudas/Territorio Británico de Ultramar,0,3,,3,-75.516486,10.446304
60974,2019,Enero,Bermudas/Territorio Británico de Ultramar,0,3,,3,-76.532004,3.451668
60975,2019,Enero,Bermudas/Territorio Británico de Ultramar,1,0,,1,-74.140516,4.697157
60976,2019,Enero,Bolivia,0,2,,2,-69.941498,4.191162
60977,2019,Enero,Bolivia,28,20,,48,-77.35600000000001,0.81488
60978,2019,Enero,Bolivia,14,7,,21,-75.527794,10.406342
60979,2019,Enero,Bolivia,235,159,,394,-75.516486,10.446304
60980,2019,Enero,Bolivia,2,3,,5,-74.77647900000001,10.886686
60981,2019,Enero,Bolivia,0,1,,1,-72.129595,11.360028999999999
60982,2019,Enero,Bolivia,30,25,,55,-81.70216500000001,12.5862
60983,2019,Enero,Bolivia,73,41,,114,-76.532004,3.451668
60984,2019,Enero,Bolivia,1146,1046,,2192,-74.140516,4.697157
60985,2019,Enero,Bolivia,1,1,,2,-75.736374,4.815189
60986,2019,Enero,Bolivia,50,54,,104,-75.42726,6.170465
60987,2019,Enero,Bolivia,0,1,,1,-67.48402800000001,6.185536
60988,2019,Enero,Bolivia,2,2,,4,-73.181317,7.1280470000000005
60989,2019,Enero,Bolivia,2,7,,9,-72.453013,7.819
60990,2019,Enero,Bolivia,0,1,,1,-72.409396,8.36068
60991,2019,Enero,Bosnia y Herzegovina,1,2,,3,-75.516486,10.446304
60992,2019,Enero,Bosnia y Herzegovina,0,2,,2,-76.532004,3.451668
60993,2019,Enero,Bosnia y Herzegovina,4,8,,12,-74.140516,4.697157
60994,2019,Enero,Brasil,175,163,,338,-69.941498,4.191162
60995,2019,Enero,Brasil,3,8,,11,-69.94143100000001,4.214082
60996,2019,Enero,Brasil,2,3,,5,-76.876446,0.33002
60997,2019,Enero,Brasil,36,56,,92,-77.35600000000001,0.81488
60998,2019,Enero,Brasil,162,129,,291,-75.527794,10.406342
60999,2019,Enero,Brasil,773,595,,1368,-75.516486,10.446304
61000,2019,Enero,Brasil,11,35,,46,-74.77647900000001,10.886686
61001,2019,Enero,Brasil,1,0,,1,-74.232675,11.117206
61002,2019,Enero,Brasil,2,4,,6,-72.129595,11.360028999999999
61003,2019,Enero,Brasil,223,165,,388,-81.70216500000001,12.5862
61004,2019,Enero,Brasil,132,176,,308,-76.532004,3.451668
61005,2019,Enero,Brasil,4,4,,8,-67.927521,3.866713
61006,2019,Enero,Brasil,7653,7784,,15437,-74.140516,4.697157
61007,2019,Enero,Brasil,13,4,,17,-75.736374,4.815189
61008,2019,Enero,Brasil,305,340,,645,-75.42726,6.170465
61009,2019,Enero,Brasil,2,1,,3,-73.181317,7.1280470000000005
61010,2019,Enero,Brasil,6,7,,13,-72.453013,7.819
61011,2019,Enero,Brasil,3,4,,7,-72.409396,8.36068
61012,2019,Enero,Brasil,1,1,,2,-77.35002,8.63337
61013,2019,Enero,Bulgaria,1,3,,4,-77.35600000000001,0.81488
61014,2019,Enero,Bulgaria,1,1,,2,-75.527794,10.406342
61015,2019,Enero,Bulgaria,5,12,,17,-75.516486,10.446304
61016,2019,Enero,Bulgaria,1,0,,1,-81.372937,13.338761300000002
61017,2019,Enero,Bulgaria,3,2,,5,-76.532004,3.451668
61018,2019,Enero,Bulgaria,0,2,,2,-77.061029,3.8844260000000004
61019,2019,Enero,Bulgaria,1,0,,1,-75.76635300000001,4.45285
61020,2019,Enero,Bulgaria,80,77,,157,-74.140516,4.697157
61021,2019,Enero,Bulgaria,2,8,,10,-75.42726,6.170465
61022,2019,Enero,Burkina Faso,0,2,,2,-74.140516,4.697157
61023,2019,Enero,Bután,1,0,,1,-74.140516,4.697157
61024,2019,Enero,Cabo Verde,0,1,,1,-74.140516,4.697157
61025,2019,Enero,Islas Caimán/Territorio Británico de Ultramar,0,1,,1,-75.516486,10.446304
61026,2019,Enero,Islas Caimán/Territorio Británico de Ultramar,1,1,,2,-81.70216500000001,12.5862
61027,2019,Enero,Camerún,2,2,,4,-74.140516,4.697157
61028,2019,Enero,Camerún,1,2,,3,-75.42726,6.170465
61029,2019,Enero,Canadá,1,0,,1,-69.941498,4.191162
61030,2019,Enero,Canadá,2,4,,6,-69.94143100000001,4.214082
61031,2019,Enero,Canadá,0,1,,1,-76.876446,0.33002
61032,2019,Enero,Canadá,18,38,,56,-77.35600000000001,0.81488
61033,2019,Enero,Canadá,76,66,,142,-75.527794,10.406342
61034,2019,Enero,Canadá,1245,1442,,2687,-75.516486,10.446304
61035,2019,Enero,Canadá,19,37,,56,-74.77647900000001,10.886686
61036,2019,Enero,Canadá,0,1,,1,-74.232675,11.117206
61037,2019,Enero,Canadá,6,6,,12,-74.213989,11.247722999999999
61038,2019,Enero,Canadá,4,2,,6,-72.129595,11.360028999999999
61039,2019,Enero,Canadá,348,301,,649,-81.70216500000001,12.5862
61040,2019,Enero,Canadá,2,2,,4,-81.372937,13.338761300000002
61041,2019,Enero,Canadá,94,103,,197,-76.532004,3.451668
61042,2019,Enero,Canadá,3,2,,5,-75.76635300000001,4.45285
61043,2019,Enero,Canadá,1492,2325,,3817,-74.140516,4.697157
61044,2019,Enero,Canadá,17,22,,39,-75.736374,4.815189
61045,2019,Enero,Canadá,237,559,,796,-75.42726,6.170465
61046,2019,Enero,Canadá,3,7,,10,-73.181317,7.1280470000000005
61047,2019,Enero,Canadá,4,4,,8,-72.453013,7.819
61048,2019,Enero,Canadá,8,8,,16,-77.35002,8.63337
61049,2019,Enero,República Del Congo,0,1,,1,-74.140516,4.697157
61050,2019,Enero,República Democrática del Congo,0,2,,2,-77.35600000000001,0.81488
61051,2019,Enero,República Democrática del Congo,4,5,,9,-74.140516,4.697157
61052,2019,Enero,República de Corea,10,14,,24,-77.35600000000001,0.81488
61053,2019,Enero,República de Corea,1,2,,3,-75.527794,10.406342
61054,2019,Enero,República de Corea,7,10,,17,-75.516486,10.446304
61055,2019,Enero,República de Corea,7,3,,10,-74.77647900000001,10.886686
61056,2019,Enero,República de Corea,0,2,,2,-72.129595,11.360028999999999
61057,2019,Enero,República de Corea,1,1,,2,-81.70216500000001,12.5862
61058,2019,Enero,República de Corea,6,5,,11,-76.532004,3.451668
61059,2019,Enero,República de Corea,477,591,,1068,-74.140516,4.697157
61060,2019,Enero,República de Corea,5,0,,5,-75.736374,4.815189
61061,2019,Enero,República de Corea,17,28,,45,-75.42726,6.170465
61062,2019,Enero,República de Corea,2,5,,7,-72.453013,7.819
61063,2019,Enero,República de Corea,0,2,,2,-72.409396,8.36068
61064,2019,Enero,República de Corea,1,0,,1,-77.35002,8.63337
61065,2019,Enero,Costa de Marfil,0,1,,1,-77.35600000000001,0.81488
61066,2019,Enero,Costa de Marfil,1,0,,1,-75.516486,10.446304
61067,2019,Enero,Costa de Marfil,2,1,,3,-74.140516,4.697157
61068,2019,Enero,Costa Rica,1,0,,1,-69.94143100000001,4.214082
61069,2019,Enero,Costa Rica,8,9,,17,-77.35600000000001,0.81488
61070,2019,Enero,Costa Rica,5,4,,9,-75.527794,10.406342
61071,2019,Enero,Costa Rica,479,385,,864,-75.516486,10.446304
61072,2019,Enero,Costa Rica,14,27,,41,-74.77647900000001,10.886686
61073,2019,Enero,Costa Rica,2,0,,2,-72.129595,11.360028999999999
61074,2019,Enero,Costa Rica,81,82,,163,-81.70216500000001,12.5862
61075,2019,Enero,Costa Rica,57,67,,124,-76.532004,3.451668
61076,2019,Enero,Costa Rica,0,4,,4,-77.061029,3.8844260000000004
61077,2019,Enero,Costa Rica,1351,1414,,2765,-74.140516,4.697157
61078,2019,Enero,Costa Rica,9,16,,25,-75.736374,4.815189
61079,2019,Enero,Costa Rica,240,211,,451,-75.42726,6.170465
61080,2019,Enero,Costa Rica,3,4,,7,-73.181317,7.1280470000000005
61081,2019,Enero,Costa Rica,1,5,,6,-72.453013,7.819
61082,2019,Enero,Costa Rica,1,3,,4,-72.409396,8.36068
61083,2019,Enero,Croacia,0,3,,3,-77.35600000000001,0.81488
61084,2019,Enero,Croacia,1,3,,4,-75.527794,10.406342
61085,2019,Enero,Croacia,4,12,,16,-75.516486,10.446304
61086,2019,Enero,Croacia,0,2,,2,-74.77647900000001,10.886686
61087,2019,Enero,Croacia,0,4,,4,-74.765343,10.970933
61088,2019,Enero,Croacia,1,0,,1,-72.129595,11.360028999999999
61089,2019,Enero,Croacia,43,70,,113,-74.140516,4.697157
61090,2019,Enero,Croacia,3,11,,14,-75.42726,6.170465
61091,2019,Enero,Croacia,1,0,,1,-77.35002,8.63337
61092,2019,Enero,Cuba,2,0,,2,-69.941498,4.191162
61093,2019,Enero,Cuba,1,2,,3,-77.35600000000001,0.81488
61094,2019,Enero,Cuba,0,15,,15,-75.527794,10.406342
61095,2019,Enero,Cuba,11,17,,28,-75.516486,10.446304
61096,2019,Enero,Cuba,10,18,,28,-74.77647900000001,10.886686
61097,2019,Enero,Cuba,0,2,,2,-72.129595,11.360028999999999
61098,2019,Enero,Cuba,21,32,,53,-76.532004,3.451668
61099,2019,Enero,Cuba,1,1,,2,-75.76635300000001,4.45285
61100,2019,Enero,Cuba,202,331,,533,-74.140516,4.697157
61101,2019,Enero,Cuba,4,3,,7,-75.736374,4.815189
61102,2019,Enero,Cuba,21,34,,55,-75.42726,6.170465
61103,2019,Enero,Cuba,0,1,,1,-70.74025300000001,7.088728999999999
61104,2019,Enero,Cuba,0,2,,2,-73.181317,7.1280470000000005
61105,2019,Enero,Cuba,0,2,,2,-72.453013,7.819
61106,2019,Enero,Cuba,1,1,,2,-72.409396,8.36068
61107,2019,Enero,República Checa,3,7,,10,-77.35600000000001,0.81488
61108,2019,Enero,República Checa,13,25,,38,-75.516486,10.446304
61109,2019,Enero,República Checa,0,2,,2,-74.77647900000001,10.886686
61110,2019,Enero,República Checa,1,3,,4,-74.213989,11.247722999999999
61111,2019,Enero,República Checa,0,11,,11,-76.532004,3.451668
61112,2019,Enero,República Checa,1,0,,1,-75.76635300000001,4.45285
61113,2019,Enero,República Checa,116,156,,272,-74.140516,4.697157
61114,2019,Enero,República Checa,6,11,,17,-75.42726,6.170465
61115,2019,Enero,República Checa,0,1,,1,-72.453013,7.819
61116,2019,Enero,República Checa,0,3,,3,-77.35002,8.63337
61117,2019,Enero,Chile,0,2,,2,-69.941498,4.191162
61118,2019,Enero,Chile,2,6,,8,-69.94143100000001,4.214082
61119,2019,Enero,Chile,3,3,,6,-76.876446,0.33002
61120,2019,Enero,Chile,87,112,,199,-77.35600000000001,0.81488
61121,2019,Enero,Chile,1,1,,2,-78.802679,18.00143
61122,2019,Enero,Chile,167,115,,282,-75.527794,10.406342
61123,2019,Enero,Chile,564,413,,977,-75.516486,10.446304
61124,2019,Enero,Chile,8,19,,27,-74.77647900000001,10.886686
61125,2019,Enero,Chile,1,2,,3,-74.232675,11.117206
61126,2019,Enero,Chile,3,5,,8,-72.129595,11.360028999999999
61127,2019,Enero,Chile,0,1,,1,-81.703935,12.574411099999999
61128,2019,Enero,Chile,104,76,,180,-81.70216500000001,12.5862
61129,2019,Enero,Chile,218,218,,436,-76.532004,3.451668
61130,2019,Enero,Chile,2,2,,4,-75.76635300000001,4.45285
61131,2019,Enero,Chile,5234,5463,,10697,-74.140516,4.697157
61132,2019,Enero,Chile,4,4,,8,-75.736374,4.815189
61133,2019,Enero,Chile,200,243,,443,-75.42726,6.170465
61134,2019,Enero,Chile,0,1,,1,-67.48402800000001,6.185536
61135,2019,Enero,Chile,3,2,,5,-70.74025300000001,7.088728999999999
61136,2019,Enero,Chile,1,1,,2,-73.181317,7.1280470000000005
61137,2019,Enero,Chile,13,21,,34,-72.453013,7.819
61138,2019,Enero,Chile,3,9,,12,-72.409396,8.36068
61139,2019,Enero,Chile,0,3,,3,-77.35002,8.63337
61140,2019,Enero,China,1,4,,5,-69.941498,4.191162
61141,2019,Enero,China,2,0,,2,-69.94143100000001,4.214082
61142,2019,Enero,China,17,17,,34,-77.35600000000001,0.81488
61143,2019,Enero,China,0,1,,1,-75.527794,10.406342
61144,2019,Enero,China,31,32,,63,-75.516486,10.446304
61145,2019,Enero,China,3,21,,24,-74.77647900000001,10.886686
61146,2019,Enero,China,0,15,,15,-74.213989,11.247722999999999
61147,2019,Enero,China,1,3,,4,-72.129595,11.360028999999999
61148,2019,Enero,China,12,19,,31,-76.532004,3.451668
61149,2019,Enero,China,0,4,,4,-77.061029,3.8844260000000004
61150,2019,Enero,China,395,660,,1055,-74.140516,4.697157
61151,2019,Enero,China,36,67,,103,-75.42726,6.170465
61152,2019,Enero,China,0,1,,1,-67.48402800000001,6.185536
61153,2019,Enero,China,5,3,,8,-72.453013,7.819
61154,2019,Enero,China,2,1,,3,-77.35002,8.63337
61155,2019,Enero,China,0,6,,6,-75.68164200000001,9.402597
61156,2019,Enero,Taiwán,2,0,,2,-77.35600000000001,0.81488
61157,2019,Enero,Taiwán,4,4,,8,-75.516486,10.446304
61158,2019,Enero,Taiwán,7,3,,10,-76.532004,3.451668
61159,2019,Enero,Taiwán,75,77,,152,-74.140516,4.697157
61160,2019,Enero,Taiwán,13,27,,40,-75.42726,6.170465
61161,2019,Enero,Taiwán,2,3,,5,-72.453013,7.819
61162,2019,Enero,Chipre,1,0,,1,-75.516486,10.446304
61163,2019,Enero,Chipre,6,6,,12,-74.140516,4.697157
61164,2019,Enero,Chipre,1,2,,3,-75.42726,6.170465
61165,2019,Enero,Dinamarca,0,3,,3,-69.941498,4.191162
61166,2019,Enero,Dinamarca,1,2,,3,-69.94143100000001,4.214082
61167,2019,Enero,Dinamarca,4,8,,12,-77.35600000000001,0.81488
61168,2019,Enero,Dinamarca,0,7,,7,-75.527794,10.406342
61169,2019,Enero,Dinamarca,54,50,,104,-75.516486,10.446304
61170,2019,Enero,Dinamarca,3,10,,13,-74.77647900000001,10.886686
61171,2019,Enero,Dinamarca,3,3,,6,-74.213989,11.247722999999999
61172,2019,Enero,Dinamarca,1,1,,2,-72.129595,11.360028999999999
61173,2019,Enero,Dinamarca,2,1,,3,-81.70216500000001,12.5862
61174,2019,Enero,Dinamarca,5,13,,18,-76.532004,3.451668
61175,2019,Enero,Dinamarca,149,246,,395,-74.140516,4.697157
61176,2019,Enero,Dinamarca,13,26,,39,-75.42726,6.170465
61177,2019,Enero,Dinamarca,0,2,,2,-77.35002,8.63337
61178,2019,Enero,Dominica,6,4,,10,-74.140516,4.697157
61179,2019,Enero,Dominica,0,2,,2,-75.42726,6.170465
61180,2019,Enero,Ecuador,1,0,,1,-69.941498,4.191162
61181,2019,Enero,Ecuador,0,5,,5,-69.94143100000001,4.214082
61182,2019,Enero,Ecuador,49,253,,302,-76.876446,0.33002
61183,2019,Enero,Ecuador,2,2,,4,-77.84700600000001,0.8124359999999999
61184,2019,Enero,Ecuador,1234,2009,,3243,-77.35600000000001,0.81488
61185,2019,Enero,Ecuador,5,9,,14,-78.802679,18.00143
61186,2019,Enero,Ecuador,2,26,,28,-75.527794,10.406342
61187,2019,Enero,Ecuador,37,42,,79,-75.516486,10.446304
61188,2019,Enero,Ecuador,4,17,,21,-74.77647900000001,10.886686
61189,2019,Enero,Ecuador,0,2,,2,-74.232675,11.117206
61190,2019,Enero,Ecuador,6,18,,24,-72.129595,11.360028999999999
61191,2019,Enero,Ecuador,0,1,,1,-81.703935,12.574411099999999
61192,2019,Enero,Ecuador,8,14,,22,-81.70216500000001,12.5862
61193,2019,Enero,Ecuador,267,340,,607,-76.532004,3.451668
61194,2019,Enero,Ecuador,0,6,,6,-67.927521,3.866713
61195,2019,Enero,Ecuador,0,2,,2,-75.76635300000001,4.45285
61196,2019,Enero,Ecuador,2720,3570,,6290,-74.140516,4.697157
61197,2019,Enero,Ecuador,3,5,,8,-75.736374,4.815189
61198,2019,Enero,Ecuador,99,167,,266,-75.42726,6.170465
61199,2019,Enero,Ecuador,0,1,,1,-67.48402800000001,6.185536
61200,2019,Enero,Ecuador,2,2,,4,-70.74025300000001,7.088728999999999
61201,2019,Enero,Ecuador,0,1,,1,-73.181317,7.1280470000000005
61202,2019,Enero,Ecuador,80,125,,205,-72.453013,7.819
61203,2019,Enero,Ecuador,6,8,,14,-72.409396,8.36068
61204,2019,Enero,Egipto,2,3,,5,-75.516486,10.446304
61205,2019,Enero,Egipto,0,2,,2,-76.532004,3.451668
61206,2019,Enero,Egipto,9,13,,22,-74.140516,4.697157
61207,2019,Enero,Egipto,1,1,,2,-75.42726,6.170465
61208,2019,Enero,El Salvador,0,1,,1,-69.94143100000001,4.214082
61209,2019,Enero,El Salvador,3,7,,10,-77.35600000000001,0.81488
61210,2019,Enero,El Salvador,0,1,,1,-75.527794,10.406342
61211,2019,Enero,El Salvador,198,229,,427,-75.516486,10.446304
61212,2019,Enero,El Salvador,5,7,,12,-74.77647900000001,10.886686
61213,2019,Enero,El Salvador,0,1,,1,-81.70216500000001,12.5862
61214,2019,Enero,El Salvador,103,100,,203,-76.532004,3.451668
61215,2019,Enero,El Salvador,1,0,,1,-75.76635300000001,4.45285
61216,2019,Enero,El Salvador,515,683,,1198,-74.140516,4.697157
61217,2019,Enero,El Salvador,2,3,,5,-75.736374,4.815189
61218,2019,Enero,El Salvador,34,64,,98,-75.42726,6.170465
61219,2019,Enero,Emiratos Árabes,0,2,,2,-75.516486,10.446304
61220,2019,Enero,Emiratos Árabes,0,1,,1,-74.77647900000001,10.886686
61221,2019,Enero,Emiratos Árabes,4,13,,17,-74.140516,4.697157
61222,2019,Enero,Emiratos Árabes,0,3,,3,-75.42726,6.170465
61223,2019,Enero,España,4,1,,5,-69.941498,4.191162
61224,2019,Enero,España,7,5,,12,-69.94143100000001,4.214082
61225,2019,Enero,España,1,4,,5,-76.876446,0.33002
61226,2019,Enero,España,42,74,,116,-77.35600000000001,0.81488
61227,2019,Enero,España,0,1,,1,-78.802679,18.00143
61228,2019,Enero,España,14,28,,42,-75.527794,10.406342
61229,2019,Enero,España,124,172,,296,-75.516486,10.446304
61230,2019,Enero,España,12,42,,54,-74.77647900000001,10.886686
61231,2019,Enero,España,0,1,,1,-74.765343,10.970933
61232,2019,Enero,España,4,2,,6,-74.232675,11.117206
61233,2019,Enero,España,2,5,,7,-74.213989,11.247722999999999
61234,2019,Enero,España,3,12,,15,-72.129595,11.360028999999999
61235,2019,Enero,España,6,6,,12,-81.70216500000001,12.5862
61236,2019,Enero,España,240,405,,645,-76.532004,3.451668
61237,2019,Enero,España,1,1,,2,-75.76635300000001,4.45285
61238,2019,Enero,España,3070,5617,,8687,-74.140516,4.697157
61239,2019,Enero,España,4,10,,14,-75.736374,4.815189
61240,2019,Enero,España,330,757,,1087,-75.42726,6.170465
61241,2019,Enero,España,0,1,,1,-75.586989,6.2188349999999994
61242,2019,Enero,España,1,3,,4,-70.74025300000001,7.088728999999999
61243,2019,Enero,España,1,4,,5,-73.181317,7.1280470000000005
61244,2019,Enero,España,22,42,,64,-72.453013,7.819
61245,2019,Enero,España,3,10,,13,-72.409396,8.36068
61246,2019,Enero,España,3,3,,6,-77.35002,8.63337
61247,2019,Enero,Eritrea,2,1,,3,-74.140516,4.697157
61248,2019,Enero,Eslovaquia,1,1,,2,-77.35600000000001,0.81488
61249,2019,Enero,Eslovaquia,1,0,,1,-75.527794,10.406342
61250,2019,Enero,Eslovaquia,11,9,,20,-75.516486,10.446304
61251,2019,Enero,Eslovaquia,0,3,,3,-74.77647900000001,10.886686
61252,2019,Enero,Eslovaquia,0,2,,2,-76.532004,3.451668
61253,2019,Enero,Eslovaquia,50,95,,145,-74.140516,4.697157
61254,2019,Enero,Eslovaquia,0,5,,5,-75.736374,4.815189
61255,2019,Enero,Eslovaquia,7,13,,20,-75.42726,6.170465
61256,2019,Enero,Eslovaquia,2,1,,3,-72.453013,7.819
61257,2019,Enero,Eslovaquia,1,7,,8,-77.35002,8.63337
61258,2019,Enero,Eslovenia,3,3,,6,-77.35600000000001,0.81488
61259,2019,Enero,Eslovenia,1,2,,3,-75.516486,10.446304
61260,2019,Enero,Eslovenia,2,5,,7,-76.532004,3.451668
61261,2019,Enero,Eslovenia,37,47,,84,-74.140516,4.697157
61262,2019,Enero,Eslovenia,0,6,,6,-75.42726,6.170465
61263,2019,Enero,Eslovenia,0,1,,1,-72.453013,7.819
61264,2019,Enero,Estados Unidos de América,9,18,,27,-69.941498,4.191162
61265,2019,Enero,Estados Unidos de América,8,16,,24,-69.94143100000001,4.214082
61266,2019,Enero,Estados Unidos de América,3,8,,11,-76.876446,0.33002
61267,2019,Enero,Estados Unidos de América,0,1,,1,-77.84700600000001,0.8124359999999999
61268,2019,Enero,Estados Unidos de América,80,123,,203,-77.35600000000001,0.81488
61269,2019,Enero,Estados Unidos de América,1,0,,1,-78.802679,18.00143
61270,2019,Enero,Estados Unidos de América,42,75,,117,-75.527794,10.406342
61271,2019,Enero,Estados Unidos de América,5077,6991,,12068,-75.516486,10.446304
61272,2019,Enero,Estados Unidos de América,438,797,,1235,-74.77647900000001,10.886686
61273,2019,Enero,Estados Unidos de América,0,1,,1,-74.765343,10.970933
61274,2019,Enero,Estados Unidos de América,31,47,,78,-74.232675,11.117206
61275,2019,Enero,Estados Unidos de América,8,11,,19,-74.213989,11.247722999999999
61276,2019,Enero,Estados Unidos de América,1,8,,9,-72.129595,11.360028999999999
61277,2019,Enero,Estados Unidos de América,3,6,,9,-81.703935,12.574411099999999
61278,2019,Enero,Estados Unidos de América,27,34,,61,-81.70216500000001,12.5862
61279,2019,Enero,Estados Unidos de América,1,1,,2,-81.372937,13.338761300000002
61280,2019,Enero,Estados Unidos de América,1034,1612,,2646,-76.532004,3.451668
61281,2019,Enero,Estados Unidos de América,84,146,,230,-75.76635300000001,4.45285
61282,2019,Enero,Estados Unidos de América,8495,14663,,23158,-74.140516,4.697157
61283,2019,Enero,Estados Unidos de América,182,332,,514,-75.736374,4.815189
61284,2019,Enero,Estados Unidos de América,2816,6991,,9807,-75.42726,6.170465
61285,2019,Enero,Estados Unidos de América,0,1,,1,-75.586989,6.2188349999999994
61286,2019,Enero,Estados Unidos de América,1,1,,2,-70.74025300000001,7.088728999999999
61287,2019,Enero,Estados Unidos de América,26,39,,65,-73.181317,7.1280470000000005
61288,2019,Enero,Estados Unidos de América,10,25,,35,-72.453013,7.819
61289,2019,Enero,Estados Unidos de América,2,4,,6,-72.409396,8.36068
61290,2019,Enero,Estados Unidos de América,16,19,,35,-77.35002,8.63337
61291,2019,Enero,Estonia,2,0,,2,-77.35600000000001,0.81488
61292,2019,Enero,Estonia,2,9,,11,-75.516486,10.446304
61293,2019,Enero,Estonia,0,1,,1,-72.129595,11.360028999999999
61294,2019,Enero,Estonia,28,32,,60,-74.140516,4.697157
61295,2019,Enero,Estonia,1,6,,7,-75.42726,6.170465
61296,2019,Enero,Etiopia,0,1,,1,-76.532004,3.451668
61297,2019,Enero,Etiopia,3,42,,45,-74.140516,4.697157
61298,2019,Enero,Filipinas,1,0,,1,-69.94143100000001,4.214082
61299,2019,Enero,Filipinas,0,1,,1,-77.35600000000001,0.81488
61300,2019,Enero,Filipinas,5,37,,42,-75.527794,10.406342
61301,2019,Enero,Filipinas,10,45,,55,-75.516486,10.446304
61302,2019,Enero,Filipinas,1,26,,27,-74.77647900000001,10.886686
61303,2019,Enero,Filipinas,0,33,,33,-74.765343,10.970933
61304,2019,Enero,Filipinas,0,10,,10,-74.213989,11.247722999999999
61305,2019,Enero,Filipinas,3,7,,10,-76.532004,3.451668
61306,2019,Enero,Filipinas,0,20,,20,-77.061029,3.8844260000000004
61307,2019,Enero,Filipinas,64,75,,139,-74.140516,4.697157
61308,2019,Enero,Filipinas,9,5,,14,-75.42726,6.170465
61309,2019,Enero,Filipinas,0,11,,11,-75.68164200000001,9.402597
61310,2019,Enero,Finlandia,0,1,,1,-69.941498,4.191162
61311,2019,Enero,Finlandia,0,1,,1,-69.94143100000001,4.214082
61312,2019,Enero,Finlandia,7,2,,9,-77.35600000000001,0.81488
61313,2019,Enero,Finlandia,3,3,,6,-75.527794,10.406342
61314,2019,Enero,Finlandia,15,21,,36,-75.516486,10.446304
61315,2019,Enero,Finlandia,1,1,,2,-74.77647900000001,10.886686
61316,2019,Enero,Finlandia,1,0,,1,-74.232675,11.117206
61317,2019,Enero,Finlandia,2,14,,16,-76.532004,3.451668
61318,2019,Enero,Finlandia,72,84,,156,-74.140516,4.697157
61319,2019,Enero,Finlandia,7,22,,29,-75.42726,6.170465
61320,2019,Enero,Finlandia,1,0,,1,-72.453013,7.819
61321,2019,Enero,Finlandia,1,2,,3,-77.35002,8.63337
61322,2019,Enero,Francia,7,6,,13,-69.941498,4.191162
61323,2019,Enero,Francia,21,20,,41,-69.94143100000001,4.214082
61324,2019,Enero,Francia,3,5,,8,-76.876446,0.33002
61325,2019,Enero,Francia,123,163,,286,-77.35600000000001,0.81488
61326,2019,Enero,Francia,14,30,,44,-75.527794,10.406342
61327,2019,Enero,Francia,261,315,,576,-75.516486,10.446304
61328,2019,Enero,Francia,23,38,,61,-74.77647900000001,10.886686
61329,2019,Enero,Francia,4,4,,8,-74.232675,11.117206
61330,2019,Enero,Francia,2,7,,9,-74.213989,11.247722999999999
61331,2019,Enero,Francia,0,1,,1,-72.129595,11.360028999999999
61332,2019,Enero,Francia,2,1,,3,-81.703935,12.574411099999999
61333,2019,Enero,Francia,2,6,,8,-81.70216500000001,12.5862
61334,2019,Enero,Francia,3,6,,9,-81.372937,13.338761300000002
61335,2019,Enero,Francia,119,175,,294,-76.532004,3.451668
61336,2019,Enero,Francia,0,1,,1,-77.061029,3.8844260000000004
61337,2019,Enero,Francia,3466,4222,,7688,-74.140516,4.697157
61338,2019,Enero,Francia,6,9,,15,-75.736374,4.815189
61339,2019,Enero,Francia,236,432,,668,-75.42726,6.170465
61340,2019,Enero,Francia,3,4,,7,-73.181317,7.1280470000000005
61341,2019,Enero,Francia,2,8,,10,-72.453013,7.819
61342,2019,Enero,Francia,0,1,,1,-72.409396,8.36068
61343,2019,Enero,Francia,5,14,,19,-77.35002,8.63337
61344,2019,Enero,Georgia,1,1,,2,-69.94143100000001,4.214082
61345,2019,Enero,Georgia,2,1,,3,-75.516486,10.446304
61346,2019,Enero,Georgia,6,3,,9,-74.140516,4.697157
61347,2019,Enero,Georgia,1,0,,1,-73.181317,7.1280470000000005
61348,2019,Enero,Georgia,0,1,,1,-75.68164200000001,9.402597
61349,2019,Enero,Ghana,0,1,,1,-77.35600000000001,0.81488
61350,2019,Enero,Ghana,0,1,,1,-75.516486,10.446304
61351,2019,Enero,Ghana,0,1,,1,-76.532004,3.451668
61352,2019,Enero,Ghana,1,6,,7,-74.140516,4.697157
61353,2019,Enero,Granada,0,9,,9,-74.140516,4.697157
61354,2019,Enero,Granada,0,2,,2,-75.42726,6.170465
61355,2019,Enero,Grecia,0,2,,2,-69.94143100000001,4.214082
61356,2019,Enero,Grecia,0,3,,3,-75.527794,10.406342
61357,2019,Enero,Grecia,1,5,,6,-75.516486,10.446304
61358,2019,Enero,Grecia,0,3,,3,-74.213989,11.247722999999999
61359,2019,Enero,Grecia,0,4,,4,-76.532004,3.451668
61360,2019,Enero,Grecia,34,82,,116,-74.140516,4.697157
61361,2019,Enero,Grecia,1,0,,1,-75.736374,4.815189
61362,2019,Enero,Grecia,3,16,,19,-75.42726,6.170465
61363,2019,Enero,Grecia,0,3,,3,-72.453013,7.819
61364,2019,Enero,Grecia,0,1,,1,-76.7333,8.06667
61365,2019,Enero,Grecia,1,1,,2,-77.35002,8.63337
61366,2019,Enero,Grecia,0,1,,1,-75.68164200000001,9.402597
61367,2019,Enero,Guatemala,1,0,,1,-76.876446,0.33002
61368,2019,Enero,Guatemala,2,6,,8,-77.35600000000001,0.81488
61369,2019,Enero,Guatemala,0,5,,5,-75.527794,10.406342
61370,2019,Enero,Guatemala,130,153,,283,-75.516486,10.446304
61371,2019,Enero,Guatemala,6,15,,21,-74.77647900000001,10.886686
61372,2019,Enero,Guatemala,1,1,,2,-81.70216500000001,12.5862
61373,2019,Enero,Guatemala,11,34,,45,-76.532004,3.451668
61374,2019,Enero,Guatemala,414,703,,1117,-74.140516,4.697157
61375,2019,Enero,Guatemala,7,6,,13,-75.736374,4.815189
61376,2019,Enero,Guatemala,48,97,,145,-75.42726,6.170465
61377,2019,Enero,Guatemala,0,1,,1,-75.586989,6.2188349999999994
61378,2019,Enero,Guatemala,1,0,,1,-70.74025300000001,7.088728999999999
61379,2019,Enero,Guatemala,0,1,,1,-73.181317,7.1280470000000005
61380,2019,Enero,Guatemala,2,4,,6,-72.453013,7.819
61381,2019,Enero,Guatemala,1,0,,1,-72.409396,8.36068
61382,2019,Enero,Guyana,3,3,,6,-75.516486,10.446304
61383,2019,Enero,Guyana,0,1,,1,-72.129595,11.360028999999999
61384,2019,Enero,Guyana,1,2,,3,-76.532004,3.451668
61385,2019,Enero,Guyana,13,14,,27,-74.140516,4.697157
61386,2019,Enero,Guyana,0,2,,2,-75.42726,6.170465
61387,2019,Enero,Guyana,1,0,,1,-72.453013,7.819
61388,2019,Enero,Guyana,1,0,,1,-72.409396,8.36068
61389,2019,Enero,Guinea Ecuatorial,0,2,,2,-76.532004,3.451668
61390,2019,Enero,Haití,2,6,,8,-75.516486,10.446304
61391,2019,Enero,Haití,2,0,,2,-74.77647900000001,10.886686
61392,2019,Enero,Haití,0,2,,2,-76.532004,3.451668
61393,2019,Enero,Haití,17,27,,44,-74.140516,4.697157
61394,2019,Enero,Haití,3,5,,8,-75.42726,6.170465
61395,2019,Enero,Honduras,1,0,,1,-69.94143100000001,4.214082
61396,2019,Enero,Honduras,3,4,,7,-77.35600000000001,0.81488
61397,2019,Enero,Honduras,1,5,,6,-75.527794,10.406342
61398,2019,Enero,Honduras,79,67,,146,-75.516486,10.446304
61399,2019,Enero,Honduras,9,8,,17,-74.77647900000001,10.886686
61400,2019,Enero,Honduras,2,9,,11,-72.129595,11.360028999999999
61401,2019,Enero,Honduras,1,3,,4,-81.70216500000001,12.5862
61402,2019,Enero,Honduras,53,40,,93,-76.532004,3.451668
61403,2019,Enero,Honduras,238,230,,468,-74.140516,4.697157
61404,2019,Enero,Honduras,9,27,,36,-75.736374,4.815189
61405,2019,Enero,Honduras,52,74,,126,-75.42726,6.170465
61406,2019,Enero,Honduras,4,0,,4,-73.181317,7.1280470000000005
61407,2019,Enero,Honduras,0,2,,2,-72.453013,7.819
61408,2019,Enero,Honduras,0,1,,1,-72.409396,8.36068
61409,2019,Enero,Hong Kong,2,0,,2,-75.516486,10.446304
61410,2019,Enero,Hong Kong,13,11,,24,-74.140516,4.697157
61411,2019,Enero,Hong Kong,4,3,,7,-75.42726,6.170465
61412,2019,Enero,Hungría,0,1,,1,-69.94143100000001,4.214082
61413,2019,Enero,Hungría,1,1,,2,-77.35600000000001,0.81488
61414,2019,Enero,Hungría,1,2,,3,-75.527794,10.406342
61415,2019,Enero,Hungría,10,13,,23,-75.516486,10.446304
61416,2019,Enero,Hungría,1,1,,2,-74.77647900000001,10.886686
61417,2019,Enero,Hungría,0,1,,1,-74.213989,11.247722999999999
61418,2019,Enero,Hungría,0,1,,1,-81.70216500000001,12.5862
61419,2019,Enero,Hungría,6,5,,11,-76.532004,3.451668
61420,2019,Enero,Hungría,48,96,,144,-74.140516,4.697157
61421,2019,Enero,Hungría,9,17,,26,-75.42726,6.170465
61422,2019,Enero,Hungría,0,3,,3,-72.453013,7.819
61423,2019,Enero,Hungría,1,1,,2,-77.35002,8.63337
61424,2019,Enero,India,0,1,,1,-76.876446,0.33002
61425,2019,Enero,India,15,3,,18,-77.35600000000001,0.81488
61426,2019,Enero,India,0,7,,7,-75.527794,10.406342
61427,2019,Enero,India,11,58,,69,-75.516486,10.446304
61428,2019,Enero,India,0,13,,13,-74.77647900000001,10.886686
61429,2019,Enero,India,0,1,,1,-74.765343,10.970933
61430,2019,Enero,India,0,1,,1,-74.213989,11.247722999999999
61431,2019,Enero,India,2,17,,19,-76.532004,3.451668
61432,2019,Enero,India,0,1,,1,-77.061029,3.8844260000000004
61433,2019,Enero,India,104,448,,552,-74.140516,4.697157
61434,2019,Enero,India,0,1,,1,-75.736374,4.815189
61435,2019,Enero,India,27,103,,130,-75.42726,6.170465
61436,2019,Enero,India,0,1,,1,-73.181317,7.1280470000000005
61437,2019,Enero,India,0,1,,1,-75.68164200000001,9.402597
61438,2019,Enero,Indonesia,0,4,,4,-75.527794,10.406342
61439,2019,Enero,Indonesia,2,6,,8,-75.516486,10.446304
61440,2019,Enero,Indonesia,0,1,,1,-74.765343,10.970933
61441,2019,Enero,Indonesia,0,1,,1,-76.532004,3.451668
61442,2019,Enero,Indonesia,15,22,,37,-74.140516,4.697157
61443,2019,Enero,Indonesia,0,1,,1,-75.42726,6.170465
61444,2019,Enero,Iraq,0,1,,1,-75.516486,10.446304
61445,2019,Enero,Iraq,0,1,,1,-76.532004,3.451668
61446,2019,Enero,Iraq,1,4,,5,-74.140516,4.697157
61447,2019,Enero,Irán,0,1,,1,-75.516486,10.446304
61448,2019,Enero,Irán,0,1,,1,-76.532004,3.451668
61449,2019,Enero,Irán,8,13,,21,-74.140516,4.697157
61450,2019,Enero,Irán,0,1,,1,-75.42726,6.170465
61451,2019,Enero,República de Irlanda,1,0,,1,-69.941498,4.191162
61452,2019,Enero,República de Irlanda,2,2,,4,-69.94143100000001,4.214082
61453,2019,Enero,República de Irlanda,5,6,,11,-77.35600000000001,0.81488
61454,2019,Enero,República de Irlanda,10,6,,16,-75.527794,10.406342
61455,2019,Enero,República de Irlanda,17,44,,61,-75.516486,10.446304
61456,2019,Enero,República de Irlanda,2,10,,12,-74.77647900000001,10.886686
61457,2019,Enero,República de Irlanda,1,0,,1,-81.70216500000001,12.5862
61458,2019,Enero,República de Irlanda,2,10,,12,-76.532004,3.451668
61459,2019,Enero,República de Irlanda,126,245,,371,-74.140516,4.697157
61460,2019,Enero,República de Irlanda,0,1,,1,-75.736374,4.815189
61461,2019,Enero,República de Irlanda,17,43,,60,-75.42726,6.170465
61462,2019,Enero,República de Irlanda,0,1,,1,-70.74025300000001,7.088728999999999
61463,2019,Enero,República de Irlanda,0,1,,1,-72.453013,7.819
61464,2019,Enero,República de Irlanda,11,7,,18,-77.35002,8.63337
61465,2019,Enero,Islandia,1,0,,1,-77.35600000000001,0.81488
61466,2019,Enero,Islandia,1,2,,3,-75.516486,10.446304
61467,2019,Enero,Islandia,0,1,,1,-76.532004,3.451668
61468,2019,Enero,Islandia,1,5,,6,-74.140516,4.697157
61469,2019,Enero,Islandia,1,0,,1,-75.736374,4.815189
61470,2019,Enero,Islandia,1,12,,13,-75.42726,6.170465
61471,2019,Enero,Israel,4,13,,17,-77.35600000000001,0.81488
61472,2019,Enero,Israel,4,2,,6,-75.527794,10.406342
61473,2019,Enero,Israel,18,53,,71,-75.516486,10.446304
61474,2019,Enero,Israel,1,1,,2,-74.77647900000001,10.886686
61475,2019,Enero,Israel,0,1,,1,-72.129595,11.360028999999999
61476,2019,Enero,Israel,0,2,,2,-81.70216500000001,12.5862
61477,2019,Enero,Israel,6,20,,26,-76.532004,3.451668
61478,2019,Enero,Israel,108,404,,512,-74.140516,4.697157
61479,2019,Enero,Israel,12,81,,93,-75.42726,6.170465
61480,2019,Enero,Israel,0,1,,1,-77.35002,8.63337
61481,2019,Enero,Italia,2,2,,4,-69.941498,4.191162
61482,2019,Enero,Italia,3,6,,9,-69.94143100000001,4.214082
61483,2019,Enero,Italia,1,4,,5,-76.876446,0.33002
61484,2019,Enero,Italia,21,32,,53,-77.35600000000001,0.81488
61485,2019,Enero,Italia,2,12,,14,-75.527794,10.406342
61486,2019,Enero,Italia,120,312,,432,-75.516486,10.446304
61487,2019,Enero,Italia,17,42,,59,-74.77647900000001,10.886686
61488,2019,Enero,Italia,2,8,,10,-74.232675,11.117206
61489,2019,Enero,Italia,1,1,,2,-74.213989,11.247722999999999
61490,2019,Enero,Italia,1,8,,9,-72.129595,11.360028999999999
61491,2019,Enero,Italia,0,1,,1,-81.703935,12.574411099999999
61492,2019,Enero,Italia,10,15,,25,-81.70216500000001,12.5862
61493,2019,Enero,Italia,34,105,,139,-76.532004,3.451668
61494,2019,Enero,Italia,0,1,,1,-67.927521,3.866713
61495,2019,Enero,Italia,0,1,,1,-77.061029,3.8844260000000004
61496,2019,Enero,Italia,0,1,,1,-75.76635300000001,4.45285
61497,2019,Enero,Italia,1065,2239,,3304,-74.140516,4.697157
61498,2019,Enero,Italia,0,8,,8,-75.736374,4.815189
61499,2019,Enero,Italia,105,350,,455,-75.42726,6.170465
61500,2019,Enero,Italia,1,1,,2,-73.181317,7.1280470000000005
61501,2019,Enero,Italia,15,24,,39,-72.453013,7.819
61502,2019,Enero,Italia,3,4,,7,-72.409396,8.36068
61503,2019,Enero,Italia,1,3,,4,-77.35002,8.63337
61504,2019,Enero,Jamaica,0,1,,1,-77.35600000000001,0.81488
61505,2019,Enero,Jamaica,7,9,,16,-75.516486,10.446304
61506,2019,Enero,Jamaica,1,4,,5,-74.77647900000001,10.886686
61507,2019,Enero,Jamaica,0,1,,1,-81.70216500000001,12.5862
61508,2019,Enero,Jamaica,6,3,,9,-76.532004,3.451668
61509,2019,Enero,Jamaica,0,1,,1,-75.76635300000001,4.45285
61510,2019,Enero,Jamaica,23,26,,49,-74.140516,4.697157
61511,2019,Enero,Jamaica,8,9,,17,-75.42726,6.170465
61512,2019,Enero,Japón,2,1,,3,-69.941498,4.191162
61513,2019,Enero,Japón,0,3,,3,-69.94143100000001,4.214082
61514,2019,Enero,Japón,4,13,,17,-77.35600000000001,0.81488
61515,2019,Enero,Japón,11,14,,25,-75.516486,10.446304
61516,2019,Enero,Japón,0,4,,4,-74.77647900000001,10.886686
61517,2019,Enero,Japón,0,1,,1,-72.129595,11.360028999999999
61518,2019,Enero,Japón,2,2,,4,-81.70216500000001,12.5862
61519,2019,Enero,Japón,4,9,,13,-76.532004,3.451668
61520,2019,Enero,Japón,185,456,,641,-74.140516,4.697157
61521,2019,Enero,Japón,1,1,,2,-75.736374,4.815189
61522,2019,Enero,Japón,19,53,,72,-75.42726,6.170465
61523,2019,Enero,Japón,0,1,,1,-72.453013,7.819
61524,2019,Enero,Jordania,0,1,,1,-77.35600000000001,0.81488
61525,2019,Enero,Jordania,0,1,,1,-75.527794,10.406342
61526,2019,Enero,Jordania,1,0,,1,-75.516486,10.446304
61527,2019,Enero,Jordania,0,1,,1,-74.77647900000001,10.886686
61528,2019,Enero,Jordania,6,3,,9,-74.140516,4.697157
61529,2019,Enero,Kazajistán,7,7,,14,-74.140516,4.697157
61530,2019,Enero,Kazajistán,1,0,,1,-75.42726,6.170465
61531,2019,Enero,Kenia,0,1,,1,-76.876446,0.33002
61532,2019,Enero,Kenia,1,1,,2,-75.516486,10.446304
61533,2019,Enero,Kenia,0,3,,3,-76.532004,3.451668
61534,2019,Enero,Kenia,5,4,,9,-74.140516,4.697157
61535,2019,Enero,Kirguistán,1,0,,1,-74.140516,4.697157
61536,2019,Enero,Kuwait,0,1,,1,-74.140516,4.697157
61537,2019,Enero,República de Kosovo,0,1,,1,-76.532004,3.451668
61538,2019,Enero,República Democrática Popular  Lao,1,0,,1,-74.140516,4.697157
61539,2019,Enero,Letonia,0,2,,2,-77.35600000000001,0.81488
61540,2019,Enero,Letonia,0,1,,1,-75.527794,10.406342
61541,2019,Enero,Letonia,5,7,,12,-75.516486,10.446304
61542,2019,Enero,Letonia,0,1,,1,-76.532004,3.451668
61543,2019,Enero,Letonia,0,1,,1,-77.061029,3.8844260000000004
61544,2019,Enero,Letonia,23,31,,54,-74.140516,4.697157
61545,2019,Enero,Letonia,4,4,,8,-75.42726,6.170465
61546,2019,Enero,Lituania,2,0,,2,-77.35600000000001,0.81488
61547,2019,Enero,Lituania,0,1,,1,-75.527794,10.406342
61548,2019,Enero,Lituania,5,4,,9,-75.516486,10.446304
61549,2019,Enero,Lituania,0,1,,1,-74.77647900000001,10.886686
61550,2019,Enero,Lituania,1,3,,4,-76.532004,3.451668
61551,2019,Enero,Lituania,29,33,,62,-74.140516,4.697157
61552,2019,Enero,Lituania,1,0,,1,-75.736374,4.815189
61553,2019,Enero,Lituania,2,2,,4,-75.42726,6.170465
61554,2019,Enero,Líbano,0,1,,1,-75.516486,10.446304
61555,2019,Enero,Líbano,1,4,,5,-74.77647900000001,10.886686
61556,2019,Enero,Líbano,1,1,,2,-72.129595,11.360028999999999
61557,2019,Enero,Líbano,23,32,,55,-74.140516,4.697157
61558,2019,Enero,Líbano,0,2,,2,-75.42726,6.170465
61559,2019,Enero,Liberia,1,0,,1,-74.140516,4.697157
61560,2019,Enero,Liechtenstein,0,1,,1,-75.516486,10.446304
61561,2019,Enero,Liechtenstein,1,3,,4,-74.140516,4.697157
61562,2019,Enero,Liechtenstein,0,1,,1,-75.42726,6.170465
61563,2019,Enero,Liechtenstein,0,1,,1,-76.7333,8.06667
61564,2019,Enero,Luxemburgo,0,1,,1,-77.35600000000001,0.81488
61565,2019,Enero,Luxemburgo,1,3,,4,-75.516486,10.446304
61566,2019,Enero,Luxemburgo,1,2,,3,-76.532004,3.451668
61567,2019,Enero,Luxemburgo,9,20,,29,-74.140516,4.697157
61568,2019,Enero,Luxemburgo,1,2,,3,-75.42726,6.170465
61569,2019,Enero,Luxemburgo,0,1,,1,-77.35002,8.63337
61570,2019,Enero,Macedonia,1,1,,2,-75.516486,10.446304
61571,2019,Enero,Macedonia,4,6,,10,-74.140516,4.697157
61572,2019,Enero,Macedonia,0,2,,2,-75.42726,6.170465
61573,2019,Enero,Madagascar,2,1,,3,-74.140516,4.697157
61574,2019,Enero,Madagascar,1,0,,1,-75.42726,6.170465
61575,2019,Enero,Malasia,1,0,,1,-77.35600000000001,0.81488
61576,2019,Enero,Malasia,1,12,,13,-75.516486,10.446304
61577,2019,Enero,Malasia,14,8,,22,-74.140516,4.697157
61578,2019,Enero,Malasia,1,2,,3,-75.42726,6.170465
61579,2019,Enero,Malí,0,2,,2,-74.140516,4.697157
61580,2019,Enero,Malta,1,0,,1,-77.35600000000001,0.81488
61581,2019,Enero,Malta,2,2,,4,-75.516486,10.446304
61582,2019,Enero,Malta,4,11,,15,-74.140516,4.697157
61583,2019,Enero,Marruecos,0,1,,1,-75.516486,10.446304
61584,2019,Enero,Marruecos,13,13,,26,-74.140516,4.697157
61585,2019,Enero,Marruecos,0,1,,1,-75.42726,6.170465
61586,2019,Enero,Mauricio,0,1,,1,-77.35600000000001,0.81488
61587,2019,Enero,Mauricio,0,2,,2,-75.527794,10.406342
61588,2019,Enero,Mauricio,3,0,,3,-74.140516,4.697157
61589,2019,Enero,Mauricio,1,0,,1,-75.42726,6.170465
61590,2019,Enero,México,3,3,,6,-69.941498,4.191162
61591,2019,Enero,México,11,6,,17,-69.94143100000001,4.214082
61592,2019,Enero,México,2,8,,10,-76.876446,0.33002
61593,2019,Enero,México,26,38,,64,-77.35600000000001,0.81488
61594,2019,Enero,México,8,17,,25,-75.527794,10.406342
61595,2019,Enero,México,291,375,,666,-75.516486,10.446304
61596,2019,Enero,México,32,61,,93,-74.77647900000001,10.886686
61597,2019,Enero,México,0,3,,3,-72.129595,11.360028999999999
61598,2019,Enero,México,6,4,,10,-81.70216500000001,12.5862
61599,2019,Enero,México,80,156,,236,-76.532004,3.451668
61600,2019,Enero,México,3,4,,7,-75.76635300000001,4.45285
61601,2019,Enero,México,4291,6745,,11036,-74.140516,4.697157
61602,2019,Enero,México,10,24,,34,-75.736374,4.815189
61603,2019,Enero,México,456,1072,,1528,-75.42726,6.170465
61604,2019,Enero,México,2,0,,2,-67.48402800000001,6.185536
61605,2019,Enero,México,1,1,,2,-70.74025300000001,7.088728999999999
61606,2019,Enero,México,14,13,,27,-73.181317,7.1280470000000005
61607,2019,Enero,México,19,35,,54,-72.453013,7.819
61608,2019,Enero,México,2,5,,7,-72.409396,8.36068
61609,2019,Enero,México,1,0,,1,-77.35002,8.63337
61610,2019,Enero,República de Moldavia,0,1,,1,-75.516486,10.446304
61611,2019,Enero,República de Moldavia,2,4,,6,-74.140516,4.697157
61612,2019,Enero,República de Moldavia,0,1,,1,-75.736374,4.815189
61613,2019,Enero,Mónaco,0,1,,1,-77.35600000000001,0.81488
61614,2019,Enero,Mónaco,0,2,,2,-74.140516,4.697157
61615,2019,Enero,Mongolia,1,0,,1,-75.516486,10.446304
61616,2019,Enero,Mongolia,3,2,,5,-74.140516,4.697157
61617,2019,Enero,Montenegro,0,1,,1,-77.35600000000001,0.81488
61618,2019,Enero,Montenegro,1,2,,3,-75.516486,10.446304
61619,2019,Enero,Montenegro,1,1,,2,-76.532004,3.451668
61620,2019,Enero,Montenegro,0,1,,1,-77.061029,3.8844260000000004
61621,2019,Enero,Montenegro,1,1,,2,-74.140516,4.697157
61622,2019,Enero,Montenegro,0,6,,6,-75.42726,6.170465
61623,2019,Enero,Micronesia,0,1,,1,-74.140516,4.697157
61624,2019,Enero,Mozambique,1,6,,7,-74.140516,4.697157
61625,2019,Enero,Myanmar,0,3,,3,-74.77647900000001,10.886686
61626,2019,Enero,Myanmar,0,3,,3,-74.765343,10.970933
61627,2019,Enero,Myanmar,0,1,,1,-74.140516,4.697157
61628,2019,Enero,Namibia,0,2,,2,-74.140516,4.697157
61629,2019,Enero,Nepal,1,0,,1,-75.516486,10.446304
61630,2019,Enero,Nepal,0,1,,1,-74.140516,4.697157
61631,2019,Enero,Nepal,2,0,,2,-75.42726,6.170465
61632,2019,Enero,Nicaragua,0,1,,1,-77.35600000000001,0.81488
61633,2019,Enero,Nicaragua,0,3,,3,-75.527794,10.406342
61634,2019,Enero,Nicaragua,19,20,,39,-75.516486,10.446304
61635,2019,Enero,Nicaragua,2,1,,3,-74.77647900000001,10.886686
61636,2019,Enero,Nicaragua,0,1,,1,-74.213989,11.247722999999999
61637,2019,Enero,Nicaragua,1,2,,3,-81.70216500000001,12.5862
61638,2019,Enero,Nicaragua,22,19,,41,-76.532004,3.451668
61639,2019,Enero,Nicaragua,91,123,,214,-74.140516,4.697157
61640,2019,Enero,Nicaragua,5,3,,8,-75.736374,4.815189
61641,2019,Enero,Nicaragua,12,12,,24,-75.42726,6.170465
61642,2019,Enero,Nicaragua,9,8,,17,-73.181317,7.1280470000000005
61643,2019,Enero,Nigeria,0,1,,1,-77.35600000000001,0.81488
61644,2019,Enero,Nigeria,3,2,,5,-75.516486,10.446304
61645,2019,Enero,Nigeria,0,1,,1,-72.129595,11.360028999999999
61646,2019,Enero,Nigeria,1,0,,1,-76.532004,3.451668
61647,2019,Enero,Nigeria,3,5,,8,-74.140516,4.697157
61648,2019,Enero,Nigeria,1,3,,4,-75.42726,6.170465
61649,2019,Enero,Noruega,2,0,,2,-69.94143100000001,4.214082
61650,2019,Enero,Noruega,6,2,,8,-77.35600000000001,0.81488
61651,2019,Enero,Noruega,2,5,,7,-75.527794,10.406342
61652,2019,Enero,Noruega,33,34,,67,-75.516486,10.446304
61653,2019,Enero,Noruega,4,5,,9,-74.77647900000001,10.886686
61654,2019,Enero,Noruega,2,2,,4,-74.232675,11.117206
61655,2019,Enero,Noruega,1,3,,4,-74.213989,11.247722999999999
61656,2019,Enero,Noruega,0,2,,2,-72.129595,11.360028999999999
61657,2019,Enero,Noruega,0,1,,1,-81.703935,12.574411099999999
61658,2019,Enero,Noruega,1,2,,3,-81.70216500000001,12.5862
61659,2019,Enero,Noruega,1,1,,2,-81.372937,13.338761300000002
61660,2019,Enero,Noruega,5,14,,19,-76.532004,3.451668
61661,2019,Enero,Noruega,141,187,,328,-74.140516,4.697157
61662,2019,Enero,Noruega,12,26,,38,-75.42726,6.170465
61663,2019,Enero,Noruega,0,1,,1,-73.181317,7.1280470000000005
61664,2019,Enero,Noruega,1,1,,2,-72.453013,7.819
61665,2019,Enero,Noruega,1,1,,2,-77.35002,8.63337
61666,2019,Enero,Nueva Zelanda,0,2,,2,-69.941498,4.191162
61667,2019,Enero,Nueva Zelanda,0,1,,1,-69.94143100000001,4.214082
61668,2019,Enero,Nueva Zelanda,7,8,,15,-77.35600000000001,0.81488
61669,2019,Enero,Nueva Zelanda,3,3,,6,-75.527794,10.406342
61670,2019,Enero,Nueva Zelanda,15,19,,34,-75.516486,10.446304
61671,2019,Enero,Nueva Zelanda,1,0,,1,-74.77647900000001,10.886686
61672,2019,Enero,Nueva Zelanda,3,4,,7,-76.532004,3.451668
61673,2019,Enero,Nueva Zelanda,84,125,,209,-74.140516,4.697157
61674,2019,Enero,Nueva Zelanda,9,19,,28,-75.42726,6.170465
61675,2019,Enero,Nueva Zelanda,0,1,,1,-72.453013,7.819
61676,2019,Enero,Nueva Zelanda,1,4,,5,-77.35002,8.63337
61677,2019,Enero,Omán,0,1,,1,-75.516486,10.446304
61678,2019,Enero,Países Bajos,4,4,,8,-69.941498,4.191162
61679,2019,Enero,Países Bajos,3,2,,5,-69.94143100000001,4.214082
61680,2019,Enero,Países Bajos,0,1,,1,-76.876446,0.33002
61681,2019,Enero,Países Bajos,44,56,,100,-77.35600000000001,0.81488
61682,2019,Enero,Países Bajos,35,32,,67,-75.527794,10.406342
61683,2019,Enero,Países Bajos,332,315,,647,-75.516486,10.446304
61684,2019,Enero,Países Bajos,5,18,,23,-74.77647900000001,10.886686
61685,2019,Enero,Países Bajos,0,2,,2,-74.765343,10.970933
61686,2019,Enero,Países Bajos,1,1,,2,-74.232675,11.117206
61687,2019,Enero,Países Bajos,5,7,,12,-74.213989,11.247722999999999
61688,2019,Enero,Países Bajos,1,2,,3,-72.129595,11.360028999999999
61689,2019,Enero,Países Bajos,1,4,,5,-81.70216500000001,12.5862
61690,2019,Enero,Países Bajos,68,90,,158,-76.532004,3.451668
61691,2019,Enero,Países Bajos,0,1,,1,-77.061029,3.8844260000000004
61692,2019,Enero,Países Bajos,0,1,,1,-75.76635300000001,4.45285
61693,2019,Enero,Países Bajos,1646,2168,,3814,-74.140516,4.697157
61694,2019,Enero,Países Bajos,1,5,,6,-75.736374,4.815189
61695,2019,Enero,Países Bajos,140,244,,384,-75.42726,6.170465
61696,2019,Enero,Países Bajos,0,1,,1,-67.48402800000001,6.185536
61697,2019,Enero,Países Bajos,7,4,,11,-73.181317,7.1280470000000005
61698,2019,Enero,Países Bajos,0,4,,4,-72.453013,7.819
61699,2019,Enero,Países Bajos,0,1,,1,-72.409396,8.36068
61700,2019,Enero,Países Bajos,7,8,,15,-77.35002,8.63337
61701,2019,Enero,Pakistán,0,3,,3,-75.516486,10.446304
61702,2019,Enero,Pakistán,0,1,,1,-76.532004,3.451668
61703,2019,Enero,Pakistán,4,19,,23,-74.140516,4.697157
61704,2019,Enero,Pakistán,0,3,,3,-75.42726,6.170465
61705,2019,Enero,Pakistán,0,1,,1,-73.181317,7.1280470000000005
61706,2019,Enero,Panamá,10,7,,17,-77.35600000000001,0.81488
61707,2019,Enero,Panamá,2,31,,33,-75.527794,10.406342
61708,2019,Enero,Panamá,488,504,,992,-75.516486,10.446304
61709,2019,Enero,Panamá,141,144,,285,-74.77647900000001,10.886686
61710,2019,Enero,Panamá,0,1,,1,-74.213989,11.247722999999999
61711,2019,Enero,Panamá,68,68,,136,-81.70216500000001,12.5862
61712,2019,Enero,Panamá,363,276,,639,-76.532004,3.451668
61713,2019,Enero,Panamá,23,20,,43,-75.76635300000001,4.45285
61714,2019,Enero,Panamá,1851,1932,,3783,-74.140516,4.697157
61715,2019,Enero,Panamá,48,75,,123,-75.736374,4.815189
61716,2019,Enero,Panamá,1917,1405,,3322,-75.42726,6.170465
61717,2019,Enero,Panamá,0,2,,2,-77.401154,6.222551999999999
61718,2019,Enero,Panamá,3,2,,5,-77.762647,7.102626
61719,2019,Enero,Panamá,20,19,,39,-73.181317,7.1280470000000005
61720,2019,Enero,Panamá,1,4,,5,-72.453013,7.819
61721,2019,Enero,Panamá,0,1,,1,-72.409396,8.36068
61722,2019,Enero,Panamá,0,9,,9,-77.35002,8.63337
61723,2019,Enero,Paraguay,3,1,,4,-77.35600000000001,0.81488
61724,2019,Enero,Paraguay,1,2,,3,-75.527794,10.406342
61725,2019,Enero,Paraguay,141,96,,237,-75.516486,10.446304
61726,2019,Enero,Paraguay,1,2,,3,-74.77647900000001,10.886686
61727,2019,Enero,Paraguay,42,39,,81,-81.70216500000001,12.5862
61728,2019,Enero,Paraguay,16,13,,29,-76.532004,3.451668
61729,2019,Enero,Paraguay,209,146,,355,-74.140516,4.697157
61730,2019,Enero,Paraguay,1,0,,1,-75.736374,4.815189
61731,2019,Enero,Paraguay,31,27,,58,-75.42726,6.170465
61732,2019,Enero,Paraguay,0,1,,1,-73.181317,7.1280470000000005
61733,2019,Enero,Paraguay,1,0,,1,-72.453013,7.819
61734,2019,Enero,Perú,12,21,,33,-69.941498,4.191162
61735,2019,Enero,Perú,65,48,,113,-69.94143100000001,4.214082
61736,2019,Enero,Perú,1,3,,4,-74.78366,0.18595699999999998
61737,2019,Enero,Perú,2,18,,20,-76.876446,0.33002
61738,2019,Enero,Perú,239,489,,728,-77.35600000000001,0.81488
61739,2019,Enero,Perú,69,43,,112,-75.527794,10.406342
61740,2019,Enero,Perú,872,648,,1520,-75.516486,10.446304
61741,2019,Enero,Perú,14,21,,35,-74.77647900000001,10.886686
61742,2019,Enero,Perú,0,1,,1,-74.765343,10.970933
61743,2019,Enero,Perú,11,19,,30,-72.129595,11.360028999999999
61744,2019,Enero,Perú,349,245,,594,-81.70216500000001,12.5862
61745,2019,Enero,Perú,417,394,,811,-76.532004,3.451668
61746,2019,Enero,Perú,1,1,,2,-75.76635300000001,4.45285
61747,2019,Enero,Perú,3730,4145,,7875,-74.140516,4.697157
61748,2019,Enero,Perú,5,13,,18,-75.736374,4.815189
61749,2019,Enero,Perú,938,1063,,2001,-75.42726,6.170465
61750,2019,Enero,Perú,0,1,,1,-67.48402800000001,6.185536
61751,2019,Enero,Perú,6,8,,14,-70.74025300000001,7.088728999999999
61752,2019,Enero,Perú,2,2,,4,-73.181317,7.1280470000000005
61753,2019,Enero,Perú,59,125,,184,-72.453013,7.819
61754,2019,Enero,Perú,6,12,,18,-72.409396,8.36068
61755,2019,Enero,Perú,0,1,,1,-77.35002,8.63337
61756,2019,Enero,Palestina,0,1,,1,-76.532004,3.451668
61757,2019,Enero,Palestina,0,1,,1,-74.140516,4.697157
61758,2019,Enero,Polonia,1,1,,2,-69.941498,4.191162
61759,2019,Enero,Polonia,2,3,,5,-69.94143100000001,4.214082
61760,2019,Enero,Polonia,0,1,,1,-76.876446,0.33002
61761,2019,Enero,Polonia,5,7,,12,-77.35600000000001,0.81488
61762,2019,Enero,Polonia,44,37,,81,-75.527794,10.406342
61763,2019,Enero,Polonia,128,122,,250,-75.516486,10.446304
61764,2019,Enero,Polonia,1,5,,6,-74.77647900000001,10.886686
61765,2019,Enero,Polonia,0,2,,2,-74.765343,10.970933
61766,2019,Enero,Polonia,1,0,,1,-74.232675,11.117206
61767,2019,Enero,Polonia,0,1,,1,-74.213989,11.247722999999999
61768,2019,Enero,Polonia,1,2,,3,-72.129595,11.360028999999999
61769,2019,Enero,Polonia,1,1,,2,-81.70216500000001,12.5862
61770,2019,Enero,Polonia,2,25,,27,-76.532004,3.451668
61771,2019,Enero,Polonia,0,2,,2,-77.061029,3.8844260000000004
61772,2019,Enero,Polonia,258,382,,640,-74.140516,4.697157
61773,2019,Enero,Polonia,2,6,,8,-75.736374,4.815189
61774,2019,Enero,Polonia,29,25,,54,-75.42726,6.170465
61775,2019,Enero,Polonia,1,0,,1,-72.453013,7.819
61776,2019,Enero,Polonia,0,2,,2,-76.7333,8.06667
61777,2019,Enero,Polonia,5,4,,9,-77.35002,8.63337
61778,2019,Enero,Portugal,1,0,,1,-69.941498,4.191162
61779,2019,Enero,Portugal,0,1,,1,-76.876446,0.33002
61780,2019,Enero,Portugal,12,26,,38,-77.35600000000001,0.81488
61781,2019,Enero,Portugal,4,7,,11,-75.527794,10.406342
61782,2019,Enero,Portugal,19,24,,43,-75.516486,10.446304
61783,2019,Enero,Portugal,4,9,,13,-74.77647900000001,10.886686
61784,2019,Enero,Portugal,0,1,,1,-74.232675,11.117206
61785,2019,Enero,Portugal,1,1,,2,-74.213989,11.247722999999999
61786,2019,Enero,Portugal,0,2,,2,-72.129595,11.360028999999999
61787,2019,Enero,Portugal,0,1,,1,-81.70216500000001,12.5862
61788,2019,Enero,Portugal,5,17,,22,-76.532004,3.451668
61789,2019,Enero,Portugal,320,573,,893,-74.140516,4.697157
61790,2019,Enero,Portugal,1,1,,2,-75.736374,4.815189
61791,2019,Enero,Portugal,45,63,,108,-75.42726,6.170465
61792,2019,Enero,Portugal,0,2,,2,-70.74025300000001,7.088728999999999
61793,2019,Enero,Portugal,7,15,,22,-72.453013,7.819
61794,2019,Enero,Portugal,2,1,,3,-72.409396,8.36068
61795,2019,Enero,Portugal,2,1,,3,-77.35002,8.63337
61796,2019,Enero,Qatar,0,1,,1,-74.140516,4.697157
61797,2019,Enero,Reino Unido de Gran Bretaña e Irlanda del Norte,4,4,,8,-69.941498,4.191162
61798,2019,Enero,Reino Unido de Gran Bretaña e Irlanda del Norte,5,7,,12,-69.94143100000001,4.214082
61799,2019,Enero,Reino Unido de Gran Bretaña e Irlanda del Norte,1,4,,5,-76.876446,0.33002
61800,2019,Enero,Reino Unido de Gran Bretaña e Irlanda del Norte,45,74,,119,-77.35600000000001,0.81488
61801,2019,Enero,Reino Unido de Gran Bretaña e Irlanda del Norte,51,59,,110,-75.527794,10.406342
61802,2019,Enero,Reino Unido de Gran Bretaña e Irlanda del Norte,148,243,,391,-75.516486,10.446304
61803,2019,Enero,Reino Unido de Gran Bretaña e Irlanda del Norte,12,21,,33,-74.77647900000001,10.886686
61804,2019,Enero,Reino Unido de Gran Bretaña e Irlanda del Norte,2,4,,6,-74.232675,11.117206
61805,2019,Enero,Reino Unido de Gran Bretaña e Irlanda del Norte,14,16,,30,-74.213989,11.247722999999999
61806,2019,Enero,Reino Unido de Gran Bretaña e Irlanda del Norte,0,1,,1,-72.129595,11.360028999999999
61807,2019,Enero,Reino Unido de Gran Bretaña e Irlanda del Norte,1,1,,2,-81.703935,12.574411099999999
61808,2019,Enero,Reino Unido de Gran Bretaña e Irlanda del Norte,2,3,,5,-81.70216500000001,12.5862
61809,2019,Enero,Reino Unido de Gran Bretaña e Irlanda del Norte,21,76,,97,-76.532004,3.451668
61810,2019,Enero,Reino Unido de Gran Bretaña e Irlanda del Norte,2,1,,3,-75.76635300000001,4.45285
61811,2019,Enero,Reino Unido de Gran Bretaña e Irlanda del Norte,1382,2306,,3688,-74.140516,4.697157
61812,2019,Enero,Reino Unido de Gran Bretaña e Irlanda del Norte,4,6,,10,-75.736374,4.815189
61813,2019,Enero,Reino Unido de Gran Bretaña e Irlanda del Norte,99,274,,373,-75.42726,6.170465
61814,2019,Enero,Reino Unido de Gran Bretaña e Irlanda del Norte,0,2,,2,-73.181317,7.1280470000000005
61815,2019,Enero,Reino Unido de Gran Bretaña e Irlanda del Norte,0,4,,4,-72.453013,7.819
61816,2019,Enero,Reino Unido de Gran Bretaña e Irlanda del Norte,0,1,,1,-72.409396,8.36068
61817,2019,Enero,Reino Unido de Gran Bretaña e Irlanda del Norte,21,32,,53,-77.35002,8.63337
61818,2019,Enero,República Dominicana,0,1,,1,-76.876446,0.33002
61819,2019,Enero,República Dominicana,2,9,,11,-77.35600000000001,0.81488
61820,2019,Enero,República Dominicana,0,1,,1,-78.802679,18.00143
61821,2019,Enero,República Dominicana,0,1,,1,-75.527794,10.406342
61822,2019,Enero,República Dominicana,43,48,,91,-75.516486,10.446304
61823,2019,Enero,República Dominicana,19,46,,65,-74.77647900000001,10.886686
61824,2019,Enero,República Dominicana,0,1,,1,-74.232675,11.117206
61825,2019,Enero,República Dominicana,0,1,,1,-81.70216500000001,12.5862
61826,2019,Enero,República Dominicana,35,33,,68,-76.532004,3.451668
61827,2019,Enero,República Dominicana,1,0,,1,-75.76635300000001,4.45285
61828,2019,Enero,República Dominicana,755,765,,1520,-74.140516,4.697157
61829,2019,Enero,República Dominicana,3,3,,6,-75.736374,4.815189
61830,2019,Enero,República Dominicana,88,118,,206,-75.42726,6.170465
61831,2019,Enero,República Dominicana,1,1,,2,-70.74025300000001,7.088728999999999
61832,2019,Enero,República Dominicana,2,1,,3,-73.181317,7.1280470000000005
61833,2019,Enero,República Dominicana,4,5,,9,-72.453013,7.819
61834,2019,Enero,Rumania,0,1,,1,-69.94143100000001,4.214082
61835,2019,Enero,Rumania,0,1,,1,-77.35600000000001,0.81488
61836,2019,Enero,Rumania,3,10,,13,-75.527794,10.406342
61837,2019,Enero,Rumania,14,25,,39,-75.516486,10.446304
61838,2019,Enero,Rumania,0,1,,1,-74.765343,10.970933
61839,2019,Enero,Rumania,1,1,,2,-74.213989,11.247722999999999
61840,2019,Enero,Rumania,4,5,,9,-81.70216500000001,12.5862
61841,2019,Enero,Rumania,1,2,,3,-76.532004,3.451668
61842,2019,Enero,Rumania,105,121,,226,-74.140516,4.697157
61843,2019,Enero,Rumania,1,1,,2,-75.736374,4.815189
61844,2019,Enero,Rumania,15,9,,24,-75.42726,6.170465
61845,2019,Enero,Rumania,1,0,,1,-72.409396,8.36068
61846,2019,Enero,Federación de Rusia,2,2,,4,-69.94143100000001,4.214082
61847,2019,Enero,Federación de Rusia,39,25,,64,-77.35600000000001,0.81488
61848,2019,Enero,Federación de Rusia,1,18,,19,-75.527794,10.406342
61849,2019,Enero,Federación de Rusia,37,29,,66,-75.516486,10.446304
61850,2019,Enero,Federación de Rusia,1,1,,2,-74.77647900000001,10.886686
61851,2019,Enero,Federación de Rusia,2,1,,3,-81.70216500000001,12.5862
61852,2019,Enero,Federación de Rusia,7,11,,18,-76.532004,3.451668
61853,2019,Enero,Federación de Rusia,0,1,,1,-77.061029,3.8844260000000004
61854,2019,Enero,Federación de Rusia,287,368,,655,-74.140516,4.697157
61855,2019,Enero,Federación de Rusia,1,1,,2,-75.736374,4.815189
61856,2019,Enero,Federación de Rusia,15,15,,30,-75.42726,6.170465
61857,2019,Enero,Federación de Rusia,1,1,,2,-73.181317,7.1280470000000005
61858,2019,Enero,Federación de Rusia,0,1,,1,-72.453013,7.819
61859,2019,Enero,Federación de Rusia,0,1,,1,-77.35002,8.63337
61860,2019,Enero,Rwanda,0,1,,1,-74.140516,4.697157
61861,2019,Enero,Rwanda,1,0,,1,-75.42726,6.170465
61862,2019,Enero,Sahara Occidental/Desierto Sahara,0,1,,1,-74.140516,4.697157
61863,2019,Enero,San Cristóbal y Nevis,3,3,,6,-74.140516,4.697157
61864,2019,Enero,San Cristóbal y Nevis,0,1,,1,-75.42726,6.170465
61865,2019,Enero,Samoa Occidental,1,0,,1,-74.140516,4.697157
61866,2019,Enero,San Marino,1,1,,2,-74.140516,4.697157
61867,2019,Enero,San  Vicente y las Granadinas,1,0,,1,-75.516486,10.446304
61868,2019,Enero,Santa Lucia,1,1,,2,-75.516486,10.446304
61869,2019,Enero,Santa Lucia,0,1,,1,-72.129595,11.360028999999999
61870,2019,Enero,Santa Lucia,0,1,,1,-76.532004,3.451668
61871,2019,Enero,Santa Lucia,2,3,,5,-74.140516,4.697157
61872,2019,Enero,Santa Lucia,1,1,,2,-75.42726,6.170465
61873,2019,Enero,Santa Lucia,1,1,,2,-73.181317,7.1280470000000005
61874,2019,Enero,Senegal,2,0,,2,-74.140516,4.697157
61875,2019,Enero,Serbia,1,3,,4,-77.35600000000001,0.81488
61876,2019,Enero,Serbia,0,2,,2,-75.527794,10.406342
61877,2019,Enero,Serbia,0,3,,3,-75.516486,10.446304
61878,2019,Enero,Serbia,3,2,,5,-81.70216500000001,12.5862
61879,2019,Enero,Serbia,1,1,,2,-76.532004,3.451668
61880,2019,Enero,Serbia,27,63,,90,-74.140516,4.697157
61881,2019,Enero,Serbia,1,4,,5,-75.42726,6.170465
61882,2019,Enero,Singapur,1,1,,2,-75.516486,10.446304
61883,2019,Enero,Singapur,1,0,,1,-76.532004,3.451668
61884,2019,Enero,Singapur,25,41,,66,-74.140516,4.697157
61885,2019,Enero,Singapur,2,2,,4,-75.42726,6.170465
61886,2019,Enero,República Árabe Siria,1,2,,3,-74.140516,4.697157
61887,2019,Enero,Sri Lanka,0,2,,2,-75.527794,10.406342
61888,2019,Enero,Sri Lanka,2,4,,6,-74.140516,4.697157
61889,2019,Enero,Sudáfrica,3,3,,6,-75.527794,10.406342
61890,2019,Enero,Sudáfrica,3,8,,11,-75.516486,10.446304
61891,2019,Enero,Sudáfrica,0,1,,1,-74.77647900000001,10.886686
61892,2019,Enero,Sudáfrica,0,1,,1,-74.765343,10.970933
61893,2019,Enero,Sudáfrica,22,42,,64,-74.140516,4.697157
61894,2019,Enero,Sudáfrica,3,7,,10,-75.42726,6.170465
61895,2019,Enero,Sudáfrica,0,1,,1,-72.453013,7.819
61896,2019,Enero,Suecia,4,3,,7,-69.941498,4.191162
61897,2019,Enero,Suecia,0,1,,1,-76.876446,0.33002
61898,2019,Enero,Suecia,5,6,,11,-77.35600000000001,0.81488
61899,2019,Enero,Suecia,9,5,,14,-75.527794,10.406342
61900,2019,Enero,Suecia,55,65,,120,-75.516486,10.446304
61901,2019,Enero,Suecia,5,5,,10,-74.77647900000001,10.886686
61902,2019,Enero,Suecia,2,3,,5,-74.213989,11.247722999999999
61903,2019,Enero,Suecia,0,8,,8,-81.70216500000001,12.5862
61904,2019,Enero,Suecia,18,23,,41,-76.532004,3.451668
61905,2019,Enero,Suecia,325,427,,752,-74.140516,4.697157
61906,2019,Enero,Suecia,1,1,,2,-75.736374,4.815189
61907,2019,Enero,Suecia,19,52,,71,-75.42726,6.170465
61908,2019,Enero,Suecia,0,2,,2,-73.181317,7.1280470000000005
61909,2019,Enero,Suecia,1,0,,1,-72.453013,7.819
61910,2019,Enero,Suecia,0,3,,3,-72.409396,8.36068
61911,2019,Enero,Suiza,4,3,,7,-69.941498,4.191162
61912,2019,Enero,Suiza,12,7,,19,-69.94143100000001,4.214082
61913,2019,Enero,Suiza,2,5,,7,-76.876446,0.33002
61914,2019,Enero,Suiza,26,56,,82,-77.35600000000001,0.81488
61915,2019,Enero,Suiza,37,36,,73,-75.527794,10.406342
61916,2019,Enero,Suiza,75,81,,156,-75.516486,10.446304
61917,2019,Enero,Suiza,8,9,,17,-74.77647900000001,10.886686
61918,2019,Enero,Suiza,2,0,,2,-74.232675,11.117206
61919,2019,Enero,Suiza,4,5,,9,-74.213989,11.247722999999999
61920,2019,Enero,Suiza,2,2,,4,-72.129595,11.360028999999999
61921,2019,Enero,Suiza,3,7,,10,-81.70216500000001,12.5862
61922,2019,Enero,Suiza,1,1,,2,-81.372937,13.338761300000002
61923,2019,Enero,Suiza,48,76,,124,-76.532004,3.451668
61924,2019,Enero,Suiza,676,939,,1615,-74.140516,4.697157
61925,2019,Enero,Suiza,4,5,,9,-75.736374,4.815189
61926,2019,Enero,Suiza,84,147,,231,-75.42726,6.170465
61927,2019,Enero,Suiza,1,0,,1,-72.453013,7.819
61928,2019,Enero,Suiza,1,1,,2,-72.409396,8.36068
61929,2019,Enero,Suiza,7,8,,15,-77.35002,8.63337
61930,2019,Enero,Surinam,0,1,,1,-72.129595,11.360028999999999
61931,2019,Enero,Surinam,16,19,,35,-74.140516,4.697157
61932,2019,Enero,Surinam,1,3,,4,-75.42726,6.170465
61933,2019,Enero,Surinam,4,3,,7,-73.181317,7.1280470000000005
61934,2019,Enero,Surinam,0,1,,1,-72.409396,8.36068
61935,2019,Enero,Taiwán,1,0,,1,-74.140516,4.697157
61936,2019,Enero,Tailandia,1,1,,2,-75.527794,10.406342
61937,2019,Enero,Tailandia,1,1,,2,-75.516486,10.446304
61938,2019,Enero,Tailandia,2,0,,2,-76.532004,3.451668
61939,2019,Enero,Tailandia,10,12,,22,-74.140516,4.697157
61940,2019,Enero,Tanzania,2,1,,3,-74.140516,4.697157
61941,2019,Enero,Togo,0,1,,1,-77.35600000000001,0.81488
61942,2019,Enero,Togo,0,1,,1,-74.140516,4.697157
61943,2019,Enero,Tonga,1,0,,1,-74.140516,4.697157
61944,2019,Enero,Trinidad y Tobago,3,8,,11,-75.516486,10.446304
61945,2019,Enero,Trinidad y Tobago,1,4,,5,-74.77647900000001,10.886686
61946,2019,Enero,Trinidad y Tobago,1,1,,2,-81.70216500000001,12.5862
61947,2019,Enero,Trinidad y Tobago,8,10,,18,-76.532004,3.451668
61948,2019,Enero,Trinidad y Tobago,21,53,,74,-74.140516,4.697157
61949,2019,Enero,Trinidad y Tobago,1,1,,2,-75.736374,4.815189
61950,2019,Enero,Trinidad y Tobago,1,10,,11,-75.42726,6.170465
61951,2019,Enero,Trinidad y Tobago,0,1,,1,-73.181317,7.1280470000000005
61952,2019,Enero,Trinidad y Tobago,1,0,,1,-72.453013,7.819
61953,2019,Enero,Túnez,9,8,,17,-74.140516,4.697157
61954,2019,Enero,Túnez,0,1,,1,-75.42726,6.170465
61955,2019,Enero,Túnez,0,1,,1,-73.181317,7.1280470000000005
61956,2019,Enero,Turquía,0,1,,1,-69.94143100000001,4.214082
61957,2019,Enero,Turquía,2,3,,5,-77.35600000000001,0.81488
61958,2019,Enero,Turquía,0,1,,1,-75.527794,10.406342
61959,2019,Enero,Turquía,7,10,,17,-75.516486,10.446304
61960,2019,Enero,Turquía,0,1,,1,-74.77647900000001,10.886686
61961,2019,Enero,Turquía,0,3,,3,-74.213989,11.247722999999999
61962,2019,Enero,Turquía,1,6,,7,-76.532004,3.451668
61963,2019,Enero,Turquía,187,384,,571,-74.140516,4.697157
61964,2019,Enero,Turquía,6,18,,24,-75.42726,6.170465
61965,2019,Enero,Turquía,0,1,,1,-70.74025300000001,7.088728999999999
61966,2019,Enero,Turquía,0,2,,2,-72.453013,7.819
61967,2019,Enero,Ucrania,1,0,,1,-69.941498,4.191162
61968,2019,Enero,Ucrania,1,1,,2,-77.35600000000001,0.81488
61969,2019,Enero,Ucrania,1,10,,11,-75.527794,10.406342
61970,2019,Enero,Ucrania,2,10,,12,-75.516486,10.446304
61971,2019,Enero,Ucrania,0,2,,2,-74.77647900000001,10.886686
61972,2019,Enero,Ucrania,0,1,,1,-74.765343,10.970933
61973,2019,Enero,Ucrania,0,5,,5,-74.213989,11.247722999999999
61974,2019,Enero,Ucrania,1,4,,5,-76.532004,3.451668
61975,2019,Enero,Ucrania,0,1,,1,-77.061029,3.8844260000000004
61976,2019,Enero,Ucrania,31,55,,86,-74.140516,4.697157
61977,2019,Enero,Ucrania,0,1,,1,-75.736374,4.815189
61978,2019,Enero,Ucrania,6,4,,10,-75.42726,6.170465
61979,2019,Enero,Ucrania,2,2,,4,-77.35002,8.63337
61980,2019,Enero,Ucrania,0,1,,1,-75.68164200000001,9.402597
61981,2019,Enero,Uganda,1,1,,2,-74.140516,4.697157
61982,2019,Enero,Uruguay,0,1,,1,-69.94143100000001,4.214082
61983,2019,Enero,Uruguay,5,14,,19,-77.35600000000001,0.81488
61984,2019,Enero,Uruguay,45,15,,60,-75.527794,10.406342
61985,2019,Enero,Uruguay,98,71,,169,-75.516486,10.446304
61986,2019,Enero,Uruguay,0,5,,5,-74.77647900000001,10.886686
61987,2019,Enero,Uruguay,1,0,,1,-74.232675,11.117206
61988,2019,Enero,Uruguay,14,13,,27,-81.70216500000001,12.5862
61989,2019,Enero,Uruguay,26,30,,56,-76.532004,3.451668
61990,2019,Enero,Uruguay,574,600,,1174,-74.140516,4.697157
61991,2019,Enero,Uruguay,2,2,,4,-75.736374,4.815189
61992,2019,Enero,Uruguay,49,70,,119,-75.42726,6.170465
61993,2019,Enero,Uruguay,0,1,,1,-73.181317,7.1280470000000005
61994,2019,Enero,Uruguay,0,3,,3,-72.453013,7.819
61995,2019,Enero,Uruguay,0,2,,2,-77.35002,8.63337
61996,2019,Enero,Uzbekistán,0,1,,1,-74.140516,4.697157
61997,2019,Enero,Vanuatu,1,0,,1,-72.453013,7.819
61998,2019,Enero,Venezuela,9,4,,13,-69.941498,4.191162
61999,2019,Enero,Venezuela,1,2,,3,-69.94143100000001,4.214082
62000,2019,Enero,Venezuela,103,83,,186,-76.876446,0.33002
62001,2019,Enero,Venezuela,3,4,,7,-77.84700600000001,0.8124359999999999
62002,2019,Enero,Venezuela,4952,4762,,9714,-77.35600000000001,0.81488
62003,2019,Enero,Venezuela,5,2,,7,-78.802679,18.00143
62004,2019,Enero,Venezuela,32,48,,80,-75.527794,10.406342
62005,2019,Enero,Venezuela,189,205,,394,-75.516486,10.446304
62006,2019,Enero,Venezuela,171,219,,390,-74.77647900000001,10.886686
62007,2019,Enero,Venezuela,0,1,,1,-74.765343,10.970933
62008,2019,Enero,Venezuela,9,7,,16,-74.232675,11.117206
62009,2019,Enero,Venezuela,5527,5326,,10853,-72.129595,11.360028999999999
62010,2019,Enero,Venezuela,0,2,,2,-71.983761,12.165168
62011,2019,Enero,Venezuela,7,2,,9,-81.70216500000001,12.5862
62012,2019,Enero,Venezuela,299,348,,647,-76.532004,3.451668
62013,2019,Enero,Venezuela,25,30,,55,-67.927521,3.866713
62014,2019,Enero,Venezuela,3,2,,5,-75.76635300000001,4.45285
62015,2019,Enero,Venezuela,8371,7406,,15777,-74.140516,4.697157
62016,2019,Enero,Venezuela,24,23,,47,-75.736374,4.815189
62017,2019,Enero,Venezuela,874,870,,1744,-75.42726,6.170465
62018,2019,Enero,Venezuela,49,31,,80,-67.48402800000001,6.185536
62019,2019,Enero,Venezuela,1,7,,8,-75.586989,6.2188349999999994
62020,2019,Enero,Venezuela,1159,1108,,2267,-70.74025300000001,7.088728999999999
62021,2019,Enero,Venezuela,18,21,,39,-73.181317,7.1280470000000005
62022,2019,Enero,Venezuela,23014,21954,,44968,-72.453013,7.819
62023,2019,Enero,Venezuela,2,9,,11,-72.508188,7.927233
62024,2019,Enero,Venezuela,2331,2061,,4392,-72.409396,8.36068
62025,2019,Enero,Venezuela,0,1,,1,-75.68164200000001,9.402597
62026,2019,Enero,Vietnam,0,3,,3,-77.35600000000001,0.81488
62027,2019,Enero,Vietnam,2,1,,3,-75.516486,10.446304
62028,2019,Enero,Vietnam,3,10,,13,-74.140516,4.697157
62029,2019,Enero,República Árabe de Yemen,1,2,,3,-74.140516,4.697157
62030,2019,Enero,Zambia,0,1,,1,-74.140516,4.697157
62031,2019,Enero,Zimbabue,0,2,,2,-74.140516,4.697157
62032,2019,Enero,Islas Turcas y Caicos/Territorio Británico de Ultramar,0,3,,3,-74.77647900000001,10.886686
62033,2019,Enero,Refugiado,2,1,,3,-75.516486,10.446304
62034,2019,Enero,Refugiado,0,8,,8,-74.140516,4.697157
62035,2019,Enero,Desconocido,1,0,,1,-76.876446,0.33002
62036,2019,Enero,Desconocido,1,2,,3,-75.516486,10.446304
62037,2019,Enero,Desconocido,0,1,,1,-76.532004,3.451668
62038,2019,Enero,Desconocido,90,123,,213,-74.140516,4.697157
62039,2019,Enero,Desconocido,1,0,,1,-75.736374,4.815189
62040,2019,Enero,Desconocido,1,3,,4,-75.42726,6.170465
62041,2019,Enero,Desconocido,2,0,,2,-70.74025300000001,7.088728999999999
62042,2019,Enero,Desconocido,0,1,,1,-75.42726,6.170465
62043,2019,Febrero,Afganistán,0,1,,1,-74.140516,4.697157
62044,2019,Febrero,Albania,2,0,,2,-75.516486,10.446304
62045,2019,Febrero,Albania,0,2,,2,-76.532004,3.451668
62046,2019,Febrero,Albania,3,16,,19,-74.140516,4.697157
62047,2019,Febrero,Albania,2,3,,5,-75.42726,6.170465
62048,2019,Febrero,Alemania,7,13,,20,-69.941498,4.191162
62049,2019,Febrero,Alemania,21,20,,41,-69.94143100000001,4.214082
62050,2019,Febrero,Alemania,3,4,,7,-76.876446,0.33002
62051,2019,Febrero,Alemania,107,115,,222,-77.35600000000001,0.81488
62052,2019,Febrero,Alemania,44,35,,79,-75.527794,10.406342
62053,2019,Febrero,Alemania,232,328,,560,-75.516486,10.446304
62054,2019,Febrero,Alemania,17,42,,59,-74.77647900000001,10.886686
62055,2019,Febrero,Alemania,0,2,,2,-74.765343,10.970933
62056,2019,Febrero,Alemania,0,2,,2,-74.232675,11.117206
62057,2019,Febrero,Alemania,9,3,,12,-74.213989,11.247722999999999
62058,2019,Febrero,Alemania,0,1,,1,-72.129595,11.360028999999999
62059,2019,Febrero,Alemania,1,1,,2,-81.703935,12.574411099999999
62060,2019,Febrero,Alemania,3,6,,9,-81.70216500000001,12.5862
62061,2019,Febrero,Alemania,82,108,,190,-76.532004,3.451668
62062,2019,Febrero,Alemania,5,6,,11,-75.76635300000001,4.45285
62063,2019,Febrero,Alemania,3213,3991,,7204,-74.140516,4.697157
62064,2019,Febrero,Alemania,3,11,,14,-75.736374,4.815189
62065,2019,Febrero,Alemania,218,363,,581,-75.42726,6.170465
62066,2019,Febrero,Alemania,1,1,,2,-77.401154,6.222551999999999
62067,2019,Febrero,Alemania,0,1,,1,-70.74025300000001,7.088728999999999
62068,2019,Febrero,Alemania,3,4,,7,-73.181317,7.1280470000000005
62069,2019,Febrero,Alemania,1,9,,10,-72.453013,7.819
62070,2019,Febrero,Alemania,0,1,,1,-72.508188,7.927233
62071,2019,Febrero,Alemania,0,1,,1,-72.409396,8.36068
62072,2019,Febrero,Alemania,19,21,,40,-77.35002,8.63337
62073,2019,Febrero,Andorra,1,0,,1,-75.516486,10.446304
62074,2019,Febrero,Andorra,2,9,,11,-74.140516,4.697157
62075,2019,Febrero,Andorra,1,0,,1,-75.42726,6.170465
62076,2019,Febrero,Angola,0,1,,1,-75.516486,10.446304
62077,2019,Febrero,Angola,1,1,,2,-74.140516,4.697157
62078,2019,Febrero,Angola,0,1,,1,-75.42726,6.170465
62079,2019,Febrero,Antigua y Barbuda,0,1,,1,-76.532004,3.451668
62080,2019,Febrero,Antigua y Barbuda,0,2,,2,-74.140516,4.697157
62081,2019,Febrero,Arabia Saudita,1,3,,4,-74.140516,4.697157
62082,2019,Febrero,Arabia Saudita,0,1,,1,-75.736374,4.815189
62083,2019,Febrero,Argelia,0,1,,1,-77.35600000000001,0.81488
62084,2019,Febrero,Argelia,1,1,,2,-75.516486,10.446304
62085,2019,Febrero,Argelia,1,0,,1,-76.532004,3.451668
62086,2019,Febrero,Argelia,4,6,,10,-74.140516,4.697157
62087,2019,Febrero,Argelia,0,1,,1,-75.42726,6.170465
62088,2019,Febrero,Argentina,9,14,,23,-69.94143100000001,4.214082
62089,2019,Febrero,Argentina,3,9,,12,-76.876446,0.33002
62090,2019,Febrero,Argentina,67,110,,177,-77.35600000000001,0.81488
62091,2019,Febrero,Argentina,298,228,,526,-75.527794,10.406342
62092,2019,Febrero,Argentina,1805,1489,,3294,-75.516486,10.446304
62093,2019,Febrero,Argentina,21,34,,55,-74.77647900000001,10.886686
62094,2019,Febrero,Argentina,1,0,,1,-74.232675,11.117206
62095,2019,Febrero,Argentina,4,3,,7,-72.129595,11.360028999999999
62096,2019,Febrero,Argentina,329,277,,606,-81.70216500000001,12.5862
62097,2019,Febrero,Argentina,1,0,,1,-81.372937,13.338761300000002
62098,2019,Febrero,Argentina,173,236,,409,-76.532004,3.451668
62099,2019,Febrero,Argentina,1,0,,1,-75.76635300000001,4.45285
62100,2019,Febrero,Argentina,4539,5660,,10199,-74.140516,4.697157
62101,2019,Febrero,Argentina,0,12,,12,-75.736374,4.815189
62102,2019,Febrero,Argentina,372,511,,883,-75.42726,6.170465
62103,2019,Febrero,Argentina,1,0,,1,-73.181317,7.1280470000000005
62104,2019,Febrero,Argentina,4,14,,18,-72.453013,7.819
62105,2019,Febrero,Argentina,0,4,,4,-72.508188,7.927233
62106,2019,Febrero,Argentina,3,6,,9,-72.409396,8.36068
62107,2019,Febrero,Argentina,1,8,,9,-77.35002,8.63337
62108,2019,Febrero,República de Armenia,0,2,,2,-75.516486,10.446304
62109,2019,Febrero,República de Armenia,0,2,,2,-74.140516,4.697157
62110,2019,Febrero,Australia,2,1,,3,-69.94143100000001,4.214082
62111,2019,Febrero,Australia,1,9,,10,-76.876446,0.33002
62112,2019,Febrero,Australia,18,17,,35,-77.35600000000001,0.81488
62113,2019,Febrero,Australia,10,11,,21,-75.527794,10.406342
62114,2019,Febrero,Australia,45,63,,108,-75.516486,10.446304
62115,2019,Febrero,Australia,7,11,,18,-74.77647900000001,10.886686
62116,2019,Febrero,Australia,0,1,,1,-74.213989,11.247722999999999
62117,2019,Febrero,Australia,0,1,,1,-72.129595,11.360028999999999
62118,2019,Febrero,Australia,5,13,,18,-76.532004,3.451668
62119,2019,Febrero,Australia,1,0,,1,-75.76635300000001,4.45285
62120,2019,Febrero,Australia,224,446,,670,-74.140516,4.697157
62121,2019,Febrero,Australia,1,1,,2,-75.736374,4.815189
62122,2019,Febrero,Australia,37,90,,127,-75.42726,6.170465
62123,2019,Febrero,Australia,1,1,,2,-72.453013,7.819
62124,2019,Febrero,Australia,15,13,,28,-77.35002,8.63337
62125,2019,Febrero,Austria,0,2,,2,-69.94143100000001,4.214082
62126,2019,Febrero,Austria,1,0,,1,-76.876446,0.33002
62127,2019,Febrero,Austria,8,14,,22,-77.35600000000001,0.81488
62128,2019,Febrero,Austria,11,8,,19,-75.527794,10.406342
62129,2019,Febrero,Austria,15,17,,32,-75.516486,10.446304
62130,2019,Febrero,Austria,2,4,,6,-74.77647900000001,10.886686
62131,2019,Febrero,Austria,1,1,,2,-74.232675,11.117206
62132,2019,Febrero,Austria,0,2,,2,-74.213989,11.247722999999999
62133,2019,Febrero,Austria,9,12,,21,-76.532004,3.451668
62134,2019,Febrero,Austria,385,458,,843,-74.140516,4.697157
62135,2019,Febrero,Austria,2,0,,2,-75.736374,4.815189
62136,2019,Febrero,Austria,30,39,,69,-75.42726,6.170465
62137,2019,Febrero,Austria,1,1,,2,-77.35002,8.63337
62138,2019,Febrero,Azerbaiyán,1,0,,1,-75.516486,10.446304
62139,2019,Febrero,Azerbaiyán,3,0,,3,-74.140516,4.697157
62140,2019,Febrero,Azerbaiyán,1,1,,2,-75.42726,6.170465
62141,2019,Febrero,Bahamas,0,1,,1,-77.35600000000001,0.81488
62142,2019,Febrero,Bahamas,2,1,,3,-75.516486,10.446304
62143,2019,Febrero,Bahamas,1,4,,5,-76.532004,3.451668
62144,2019,Febrero,Bahamas,5,18,,23,-74.140516,4.697157
62145,2019,Febrero,Bahamas,0,1,,1,-75.736374,4.815189
62146,2019,Febrero,Bahamas,0,9,,9,-75.42726,6.170465
62147,2019,Febrero,Bangladesh,2,0,,2,-75.516486,10.446304
62148,2019,Febrero,Bangladesh,1,2,,3,-74.140516,4.697157
62149,2019,Febrero,Barbados,1,0,,1,-75.516486,10.446304
62150,2019,Febrero,Barbados,0,1,,1,-74.77647900000001,10.886686
62151,2019,Febrero,Barbados,2,1,,3,-76.532004,3.451668
62152,2019,Febrero,Barbados,9,6,,15,-74.140516,4.697157
62153,2019,Febrero,Barbados,1,3,,4,-75.42726,6.170465
62154,2019,Febrero,República de Belarús,2,0,,2,-75.516486,10.446304
62155,2019,Febrero,República de Belarús,0,1,,1,-76.532004,3.451668
62156,2019,Febrero,República de Belarús,2,1,,3,-74.140516,4.697157
62157,2019,Febrero,República de Belarús,1,0,,1,-75.42726,6.170465
62158,2019,Febrero,República de Belarús,1,0,,1,-77.35002,8.63337
62159,2019,Febrero,Bélgica,1,1,,2,-69.941498,4.191162
62160,2019,Febrero,Bélgica,2,0,,2,-69.94143100000001,4.214082
62161,2019,Febrero,Bélgica,2,0,,2,-76.876446,0.33002
62162,2019,Febrero,Bélgica,23,27,,50,-77.35600000000001,0.81488
62163,2019,Febrero,Bélgica,2,2,,4,-75.527794,10.406342
62164,2019,Febrero,Bélgica,44,43,,87,-75.516486,10.446304
62165,2019,Febrero,Bélgica,1,7,,8,-74.77647900000001,10.886686
62166,2019,Febrero,Bélgica,2,2,,4,-74.213989,11.247722999999999
62167,2019,Febrero,Bélgica,1,1,,2,-81.703935,12.574411099999999
62168,2019,Febrero,Bélgica,0,2,,2,-81.70216500000001,12.5862
62169,2019,Febrero,Bélgica,18,36,,54,-76.532004,3.451668
62170,2019,Febrero,Bélgica,361,538,,899,-74.140516,4.697157
62171,2019,Febrero,Bélgica,1,3,,4,-75.736374,4.815189
62172,2019,Febrero,Bélgica,46,57,,103,-75.42726,6.170465
62173,2019,Febrero,Bélgica,0,1,,1,-73.181317,7.1280470000000005
62174,2019,Febrero,Bélgica,1,2,,3,-77.35002,8.63337
62175,2019,Febrero,Belice,1,2,,3,-75.516486,10.446304
62176,2019,Febrero,Belice,1,0,,1,-74.77647900000001,10.886686
62177,2019,Febrero,Belice,2,2,,4,-76.532004,3.451668
62178,2019,Febrero,Belice,5,12,,17,-74.140516,4.697157
62179,2019,Febrero,Belice,0,1,,1,-75.42726,6.170465
62180,2019,Febrero,Benín,0,1,,1,-75.516486,10.446304
62181,2019,Febrero,Benín,0,2,,2,-74.140516,4.697157
62182,2019,Febrero,Benín,0,1,,1,-75.42726,6.170465
62183,2019,Febrero,Bermudas/Territorio Británico de Ultramar,0,2,,2,-75.516486,10.446304
62184,2019,Febrero,Bermudas/Territorio Británico de Ultramar,2,1,,3,-74.77647900000001,10.886686
62185,2019,Febrero,Bermudas/Territorio Británico de Ultramar,0,2,,2,-75.42726,6.170465
62186,2019,Febrero,Bolivia,1,1,,2,-69.941498,4.191162
62187,2019,Febrero,Bolivia,17,14,,31,-77.35600000000001,0.81488
62188,2019,Febrero,Bolivia,31,14,,45,-75.527794,10.406342
62189,2019,Febrero,Bolivia,137,98,,235,-75.516486,10.446304
62190,2019,Febrero,Bolivia,2,4,,6,-74.77647900000001,10.886686
62191,2019,Febrero,Bolivia,13,14,,27,-81.70216500000001,12.5862
62192,2019,Febrero,Bolivia,22,29,,51,-76.532004,3.451668
62193,2019,Febrero,Bolivia,692,646,,1338,-74.140516,4.697157
62194,2019,Febrero,Bolivia,4,0,,4,-75.736374,4.815189
62195,2019,Febrero,Bolivia,33,43,,76,-75.42726,6.170465
62196,2019,Febrero,Bolivia,0,1,,1,-67.48402800000001,6.185536
62197,2019,Febrero,Bolivia,2,1,,3,-70.74025300000001,7.088728999999999
62198,2019,Febrero,Bolivia,0,2,,2,-72.453013,7.819
62199,2019,Febrero,Bolivia,0,1,,1,-72.409396,8.36068
62200,2019,Febrero,Bosnia y Herzegovina,1,1,,2,-75.516486,10.446304
62201,2019,Febrero,Bosnia y Herzegovina,0,1,,1,-76.532004,3.451668
62202,2019,Febrero,Bosnia y Herzegovina,8,5,,13,-74.140516,4.697157
62203,2019,Febrero,Botsuana,1,0,,1,-74.140516,4.697157
62204,2019,Febrero,Brasil,106,83,,189,-69.941498,4.191162
62205,2019,Febrero,Brasil,5,8,,13,-69.94143100000001,4.214082
62206,2019,Febrero,Brasil,25,39,,64,-77.35600000000001,0.81488
62207,2019,Febrero,Brasil,337,252,,589,-75.527794,10.406342
62208,2019,Febrero,Brasil,659,520,,1179,-75.516486,10.446304
62209,2019,Febrero,Brasil,10,24,,34,-74.77647900000001,10.886686
62210,2019,Febrero,Brasil,1,0,,1,-74.232675,11.117206
62211,2019,Febrero,Brasil,1,4,,5,-72.129595,11.360028999999999
62212,2019,Febrero,Brasil,1,1,,2,-81.703935,12.574411099999999
62213,2019,Febrero,Brasil,292,238,,530,-81.70216500000001,12.5862
62214,2019,Febrero,Brasil,106,161,,267,-76.532004,3.451668
62215,2019,Febrero,Brasil,1,4,,5,-67.927521,3.866713
62216,2019,Febrero,Brasil,5635,6883,,12518,-74.140516,4.697157
62217,2019,Febrero,Brasil,3,6,,9,-75.736374,4.815189
62218,2019,Febrero,Brasil,251,358,,609,-75.42726,6.170465
62219,2019,Febrero,Brasil,0,3,,3,-73.181317,7.1280470000000005
62220,2019,Febrero,Brasil,1,4,,5,-72.453013,7.819
62221,2019,Febrero,Brasil,0,9,,9,-72.508188,7.927233
62222,2019,Febrero,Brasil,4,1,,5,-72.409396,8.36068
62223,2019,Febrero,Brasil,0,2,,2,-77.35002,8.63337
62224,2019,Febrero,Bulgaria,5,3,,8,-77.35600000000001,0.81488
62225,2019,Febrero,Bulgaria,4,5,,9,-75.527794,10.406342
62226,2019,Febrero,Bulgaria,4,4,,8,-75.516486,10.446304
62227,2019,Febrero,Bulgaria,1,1,,2,-81.70216500000001,12.5862
62228,2019,Febrero,Bulgaria,1,0,,1,-76.532004,3.451668
62229,2019,Febrero,Bulgaria,0,1,,1,-77.061029,3.8844260000000004
62230,2019,Febrero,Bulgaria,68,81,,149,-74.140516,4.697157
62231,2019,Febrero,Bulgaria,1,0,,1,-75.736374,4.815189
62232,2019,Febrero,Bulgaria,4,14,,18,-75.42726,6.170465
62233,2019,Febrero,Burkina Faso,0,1,,1,-75.516486,10.446304
62234,2019,Febrero,Burkina Faso,2,1,,3,-74.140516,4.697157
62235,2019,Febrero,Burundi,1,0,,1,-75.516486,10.446304
62236,2019,Febrero,Bután,0,1,,1,-75.516486,10.446304
62237,2019,Febrero,Cabo Verde,1,0,,1,-75.516486,10.446304
62238,2019,Febrero,Cabo Verde,0,2,,2,-74.140516,4.697157
62239,2019,Febrero,Islas Caimán/Territorio Británico de Ultramar,0,1,,1,-75.516486,10.446304
62240,2019,Febrero,Islas Caimán/Territorio Británico de Ultramar,0,1,,1,-74.140516,4.697157
62241,2019,Febrero,Camboya,1,1,,2,-75.516486,10.446304
62242,2019,Febrero,Camerún,0,1,,1,-75.516486,10.446304
62243,2019,Febrero,Camerún,0,1,,1,-76.532004,3.451668
62244,2019,Febrero,Camerún,0,5,,5,-74.140516,4.697157
62245,2019,Febrero,Camerún,1,0,,1,-75.42726,6.170465
62246,2019,Febrero,Canadá,0,4,,4,-69.941498,4.191162
62247,2019,Febrero,Canadá,2,13,,15,-69.94143100000001,4.214082
62248,2019,Febrero,Canadá,4,2,,6,-76.876446,0.33002
62249,2019,Febrero,Canadá,20,29,,49,-77.35600000000001,0.81488
62250,2019,Febrero,Canadá,70,64,,134,-75.527794,10.406342
62251,2019,Febrero,Canadá,1349,1439,,2788,-75.516486,10.446304
62252,2019,Febrero,Canadá,39,64,,103,-74.77647900000001,10.886686
62253,2019,Febrero,Canadá,1,0,,1,-74.765343,10.970933
62254,2019,Febrero,Canadá,2,2,,4,-74.232675,11.117206
62255,2019,Febrero,Canadá,0,1,,1,-72.129595,11.360028999999999
62256,2019,Febrero,Canadá,1,1,,2,-81.703935,12.574411099999999
62257,2019,Febrero,Canadá,259,274,,533,-81.70216500000001,12.5862
62258,2019,Febrero,Canadá,82,130,,212,-76.532004,3.451668
62259,2019,Febrero,Canadá,2,2,,4,-75.76635300000001,4.45285
62260,2019,Febrero,Canadá,1864,2767,,4631,-74.140516,4.697157
62261,2019,Febrero,Canadá,12,22,,34,-75.736374,4.815189
62262,2019,Febrero,Canadá,233,551,,784,-75.42726,6.170465
62263,2019,Febrero,Canadá,1,2,,3,-73.181317,7.1280470000000005
62264,2019,Febrero,Canadá,1,4,,5,-72.453013,7.819
62265,2019,Febrero,Canadá,1,2,,3,-72.508188,7.927233
62266,2019,Febrero,Canadá,14,17,,31,-77.35002,8.63337
62267,2019,Febrero,República Democrática del Congo,1,0,,1,-76.532004,3.451668
62268,2019,Febrero,República Democrática del Congo,7,2,,9,-74.140516,4.697157
62269,2019,Febrero,República Democrática del Congo,1,0,,1,-75.736374,4.815189
62270,2019,Febrero,República de Corea,0,1,,1,-69.94143100000001,4.214082
62271,2019,Febrero,República de Corea,7,13,,20,-77.35600000000001,0.81488
62272,2019,Febrero,República de Corea,0,1,,1,-75.527794,10.406342
62273,2019,Febrero,República de Corea,20,11,,31,-75.516486,10.446304
62274,2019,Febrero,República de Corea,0,2,,2,-74.77647900000001,10.886686
62275,2019,Febrero,República de Corea,1,0,,1,-81.70216500000001,12.5862
62276,2019,Febrero,República de Corea,2,9,,11,-76.532004,3.451668
62277,2019,Febrero,República de Corea,247,426,,673,-74.140516,4.697157
62278,2019,Febrero,República de Corea,0,2,,2,-75.736374,4.815189
62279,2019,Febrero,República de Corea,15,53,,68,-75.42726,6.170465
62280,2019,Febrero,República de Corea,0,1,,1,-72.409396,8.36068
62281,2019,Febrero,Costa de Marfil,2,3,,5,-74.140516,4.697157
62282,2019,Febrero,Costa de Marfil,0,2,,2,-75.42726,6.170465
62283,2019,Febrero,Costa Rica,0,6,,6,-77.35600000000001,0.81488
62284,2019,Febrero,Costa Rica,4,3,,7,-75.527794,10.406342
62285,2019,Febrero,Costa Rica,261,212,,473,-75.516486,10.446304
62286,2019,Febrero,Costa Rica,9,15,,24,-74.77647900000001,10.886686
62287,2019,Febrero,Costa Rica,0,1,,1,-81.703935,12.574411099999999
62288,2019,Febrero,Costa Rica,60,50,,110,-81.70216500000001,12.5862
62289,2019,Febrero,Costa Rica,44,70,,114,-76.532004,3.451668
62290,2019,Febrero,Costa Rica,977,1291,,2268,-74.140516,4.697157
62291,2019,Febrero,Costa Rica,7,10,,17,-75.736374,4.815189
62292,2019,Febrero,Costa Rica,134,256,,390,-75.42726,6.170465
62293,2019,Febrero,Costa Rica,2,3,,5,-73.181317,7.1280470000000005
62294,2019,Febrero,Costa Rica,0,2,,2,-72.453013,7.819
62295,2019,Febrero,Costa Rica,0,1,,1,-72.508188,7.927233
62296,2019,Febrero,Croacia,1,0,,1,-76.876446,0.33002
62297,2019,Febrero,Croacia,1,3,,4,-77.35600000000001,0.81488
62298,2019,Febrero,Croacia,1,4,,5,-75.527794,10.406342
62299,2019,Febrero,Croacia,1,7,,8,-75.516486,10.446304
62300,2019,Febrero,Croacia,0,2,,2,-76.532004,3.451668
62301,2019,Febrero,Croacia,35,58,,93,-74.140516,4.697157
62302,2019,Febrero,Croacia,1,11,,12,-75.42726,6.170465
62303,2019,Febrero,Croacia,0,1,,1,-77.35002,8.63337
62304,2019,Febrero,Cuba,2,1,,3,-69.941498,4.191162
62305,2019,Febrero,Cuba,0,1,,1,-76.876446,0.33002
62306,2019,Febrero,Cuba,0,3,,3,-77.35600000000001,0.81488
62307,2019,Febrero,Cuba,0,9,,9,-75.527794,10.406342
62308,2019,Febrero,Cuba,9,10,,19,-75.516486,10.446304
62309,2019,Febrero,Cuba,12,36,,48,-74.77647900000001,10.886686
62310,2019,Febrero,Cuba,1,1,,2,-72.129595,11.360028999999999
62311,2019,Febrero,Cuba,16,26,,42,-76.532004,3.451668
62312,2019,Febrero,Cuba,0,1,,1,-75.76635300000001,4.45285
62313,2019,Febrero,Cuba,158,245,,403,-74.140516,4.697157
62314,2019,Febrero,Cuba,0,3,,3,-75.736374,4.815189
62315,2019,Febrero,Cuba,14,16,,30,-75.42726,6.170465
62316,2019,Febrero,Cuba,0,2,,2,-73.181317,7.1280470000000005
62317,2019,Febrero,Cuba,1,0,,1,-72.508188,7.927233
62318,2019,Febrero,República Checa,0,1,,1,-69.94143100000001,4.214082
62319,2019,Febrero,República Checa,5,8,,13,-77.35600000000001,0.81488
62320,2019,Febrero,República Checa,0,1,,1,-75.527794,10.406342
62321,2019,Febrero,República Checa,7,14,,21,-75.516486,10.446304
62322,2019,Febrero,República Checa,1,0,,1,-74.77647900000001,10.886686
62323,2019,Febrero,República Checa,2,5,,7,-76.532004,3.451668
62324,2019,Febrero,República Checa,125,217,,342,-74.140516,4.697157
62325,2019,Febrero,República Checa,7,13,,20,-75.42726,6.170465
62326,2019,Febrero,República Checa,1,4,,5,-77.35002,8.63337
62327,2019,Febrero,Chile,4,7,,11,-69.94143100000001,4.214082
62328,2019,Febrero,Chile,2,4,,6,-76.876446,0.33002
62329,2019,Febrero,Chile,78,134,,212,-77.35600000000001,0.81488
62330,2019,Febrero,Chile,561,420,,981,-75.527794,10.406342
62331,2019,Febrero,Chile,831,655,,1486,-75.516486,10.446304
62332,2019,Febrero,Chile,7,14,,21,-74.77647900000001,10.886686
62333,2019,Febrero,Chile,1,0,,1,-74.232675,11.117206
62334,2019,Febrero,Chile,2,7,,9,-72.129595,11.360028999999999
62335,2019,Febrero,Chile,99,73,,172,-81.70216500000001,12.5862
62336,2019,Febrero,Chile,191,214,,405,-76.532004,3.451668
62337,2019,Febrero,Chile,0,1,,1,-75.76635300000001,4.45285
62338,2019,Febrero,Chile,7346,7095,,14441,-74.140516,4.697157
62339,2019,Febrero,Chile,1,8,,9,-75.736374,4.815189
62340,2019,Febrero,Chile,313,327,,640,-75.42726,6.170465
62341,2019,Febrero,Chile,0,1,,1,-77.401154,6.222551999999999
62342,2019,Febrero,Chile,0,1,,1,-73.181317,7.1280470000000005
62343,2019,Febrero,Chile,9,31,,40,-72.453013,7.819
62344,2019,Febrero,Chile,15,55,,70,-72.508188,7.927233
62345,2019,Febrero,Chile,0,4,,4,-72.409396,8.36068
62346,2019,Febrero,China,1,1,,2,-69.941498,4.191162
62347,2019,Febrero,China,1,0,,1,-69.94143100000001,4.214082
62348,2019,Febrero,China,7,5,,12,-77.35600000000001,0.81488
62349,2019,Febrero,China,0,1,,1,-75.527794,10.406342
62350,2019,Febrero,China,50,54,,104,-75.516486,10.446304
62351,2019,Febrero,China,2,10,,12,-74.77647900000001,10.886686
62352,2019,Febrero,China,0,5,,5,-74.213989,11.247722999999999
62353,2019,Febrero,China,1,0,,1,-81.70216500000001,12.5862
62354,2019,Febrero,China,22,42,,64,-76.532004,3.451668
62355,2019,Febrero,China,0,4,,4,-77.061029,3.8844260000000004
62356,2019,Febrero,China,469,778,,1247,-74.140516,4.697157
62357,2019,Febrero,China,1,3,,4,-75.736374,4.815189
62358,2019,Febrero,China,45,72,,117,-75.42726,6.170465
62359,2019,Febrero,China,4,2,,6,-72.453013,7.819
62360,2019,Febrero,China,1,1,,2,-72.409396,8.36068
62361,2019,Febrero,China,0,3,,3,-75.68164200000001,9.402597
62362,2019,Febrero,Taiwán,4,2,,6,-77.35600000000001,0.81488
62363,2019,Febrero,Taiwán,4,1,,5,-75.516486,10.446304
62364,2019,Febrero,Taiwán,1,0,,1,-74.77647900000001,10.886686
62365,2019,Febrero,Taiwán,2,7,,9,-76.532004,3.451668
62366,2019,Febrero,Taiwán,62,68,,130,-74.140516,4.697157
62367,2019,Febrero,Taiwán,0,1,,1,-75.736374,4.815189
62368,2019,Febrero,Taiwán,6,9,,15,-75.42726,6.170465
62369,2019,Febrero,Taiwán,0,1,,1,-72.453013,7.819
62370,2019,Febrero,Chipre,1,0,,1,-76.532004,3.451668
62371,2019,Febrero,Chipre,2,5,,7,-74.140516,4.697157
62372,2019,Febrero,Chipre,0,1,,1,-75.42726,6.170465
62373,2019,Febrero,Dinamarca,0,2,,2,-69.94143100000001,4.214082
62374,2019,Febrero,Dinamarca,1,3,,4,-77.35600000000001,0.81488
62375,2019,Febrero,Dinamarca,4,1,,5,-75.527794,10.406342
62376,2019,Febrero,Dinamarca,41,35,,76,-75.516486,10.446304
62377,2019,Febrero,Dinamarca,1,7,,8,-74.77647900000001,10.886686
62378,2019,Febrero,Dinamarca,2,1,,3,-74.765343,10.970933
62379,2019,Febrero,Dinamarca,3,2,,5,-74.213989,11.247722999999999
62380,2019,Febrero,Dinamarca,0,5,,5,-81.70216500000001,12.5862
62381,2019,Febrero,Dinamarca,3,7,,10,-76.532004,3.451668
62382,2019,Febrero,Dinamarca,204,266,,470,-74.140516,4.697157
62383,2019,Febrero,Dinamarca,0,1,,1,-75.736374,4.815189
62384,2019,Febrero,Dinamarca,19,31,,50,-75.42726,6.170465
62385,2019,Febrero,Dinamarca,1,0,,1,-72.409396,8.36068
62386,2019,Febrero,Dinamarca,0,3,,3,-77.35002,8.63337
62387,2019,Febrero,Dominica,1,0,,1,-76.532004,3.451668
62388,2019,Febrero,Dominica,4,3,,7,-74.140516,4.697157
62389,2019,Febrero,Dominica,0,1,,1,-75.42726,6.170465
62390,2019,Febrero,Ecuador,3,0,,3,-69.941498,4.191162
62391,2019,Febrero,Ecuador,0,2,,2,-69.94143100000001,4.214082
62392,2019,Febrero,Ecuador,50,237,,287,-76.876446,0.33002
62393,2019,Febrero,Ecuador,11,8,,19,-77.84700600000001,0.8124359999999999
62394,2019,Febrero,Ecuador,1846,2137,,3983,-77.35600000000001,0.81488
62395,2019,Febrero,Ecuador,19,14,,33,-78.802679,18.00143
62396,2019,Febrero,Ecuador,41,41,,82,-75.527794,10.406342
62397,2019,Febrero,Ecuador,84,77,,161,-75.516486,10.446304
62398,2019,Febrero,Ecuador,16,19,,35,-74.77647900000001,10.886686
62399,2019,Febrero,Ecuador,0,1,,1,-74.232675,11.117206
62400,2019,Febrero,Ecuador,4,12,,16,-72.129595,11.360028999999999
62401,2019,Febrero,Ecuador,19,19,,38,-81.70216500000001,12.5862
62402,2019,Febrero,Ecuador,596,618,,1214,-76.532004,3.451668
62403,2019,Febrero,Ecuador,1,4,,5,-67.927521,3.866713
62404,2019,Febrero,Ecuador,0,1,,1,-77.061029,3.8844260000000004
62405,2019,Febrero,Ecuador,1,2,,3,-75.76635300000001,4.45285
62406,2019,Febrero,Ecuador,2814,3571,,6385,-74.140516,4.697157
62407,2019,Febrero,Ecuador,6,10,,16,-75.736374,4.815189
62408,2019,Febrero,Ecuador,51,97,,148,-75.42726,6.170465
62409,2019,Febrero,Ecuador,2,3,,5,-73.181317,7.1280470000000005
62410,2019,Febrero,Ecuador,78,104,,182,-72.453013,7.819
62411,2019,Febrero,Ecuador,7,6,,13,-72.409396,8.36068
62412,2019,Febrero,Ecuador,0,1,,1,-77.35002,8.63337
62413,2019,Febrero,Egipto,1,2,,3,-77.35600000000001,0.81488
62414,2019,Febrero,Egipto,0,3,,3,-76.532004,3.451668
62415,2019,Febrero,Egipto,7,28,,35,-74.140516,4.697157
62416,2019,Febrero,Egipto,1,0,,1,-73.181317,7.1280470000000005
62417,2019,Febrero,El Salvador,2,1,,3,-77.35600000000001,0.81488
62418,2019,Febrero,El Salvador,0,2,,2,-75.527794,10.406342
62419,2019,Febrero,El Salvador,190,212,,402,-75.516486,10.446304
62420,2019,Febrero,El Salvador,9,8,,17,-74.77647900000001,10.886686
62421,2019,Febrero,El Salvador,0,1,,1,-74.765343,10.970933
62422,2019,Febrero,El Salvador,0,1,,1,-72.129595,11.360028999999999
62423,2019,Febrero,El Salvador,4,5,,9,-81.70216500000001,12.5862
62424,2019,Febrero,El Salvador,83,116,,199,-76.532004,3.451668
62425,2019,Febrero,El Salvador,480,678,,1158,-74.140516,4.697157
62426,2019,Febrero,El Salvador,1,3,,4,-75.736374,4.815189
62427,2019,Febrero,El Salvador,24,31,,55,-75.42726,6.170465
62428,2019,Febrero,El Salvador,1,0,,1,-72.409396,8.36068
62429,2019,Febrero,Emiratos Árabes,0,1,,1,-75.516486,10.446304
62430,2019,Febrero,Emiratos Árabes,2,14,,16,-74.140516,4.697157
62431,2019,Febrero,Emiratos Árabes,0,1,,1,-75.42726,6.170465
62432,2019,Febrero,Emiratos Árabes,0,1,,1,-73.181317,7.1280470000000005
62433,2019,Febrero,España,2,4,,6,-69.941498,4.191162
62434,2019,Febrero,España,9,7,,16,-69.94143100000001,4.214082
62435,2019,Febrero,España,4,6,,10,-76.876446,0.33002
62436,2019,Febrero,España,46,81,,127,-77.35600000000001,0.81488
62437,2019,Febrero,España,24,39,,63,-75.527794,10.406342
62438,2019,Febrero,España,109,193,,302,-75.516486,10.446304
62439,2019,Febrero,España,25,63,,88,-74.77647900000001,10.886686
62440,2019,Febrero,España,2,1,,3,-74.232675,11.117206
62441,2019,Febrero,España,2,7,,9,-72.129595,11.360028999999999
62442,2019,Febrero,España,6,5,,11,-81.70216500000001,12.5862
62443,2019,Febrero,España,0,1,,1,-81.372937,13.338761300000002
62444,2019,Febrero,España,233,373,,606,-76.532004,3.451668
62445,2019,Febrero,España,0,1,,1,-75.76635300000001,4.45285
62446,2019,Febrero,España,2797,5681,,8478,-74.140516,4.697157
62447,2019,Febrero,España,5,15,,20,-75.736374,4.815189
62448,2019,Febrero,España,292,714,,1006,-75.42726,6.170465
62449,2019,Febrero,España,0,2,,2,-67.48402800000001,6.185536
62450,2019,Febrero,España,0,2,,2,-70.74025300000001,7.088728999999999
62451,2019,Febrero,España,0,1,,1,-73.181317,7.1280470000000005
62452,2019,Febrero,España,20,49,,69,-72.453013,7.819
62453,2019,Febrero,España,4,12,,16,-72.508188,7.927233
62454,2019,Febrero,España,5,8,,13,-72.409396,8.36068
62455,2019,Febrero,España,3,9,,12,-77.35002,8.63337
62456,2019,Febrero,Eslovaquia,0,1,,1,-69.94143100000001,4.214082
62457,2019,Febrero,Eslovaquia,0,3,,3,-77.35600000000001,0.81488
62458,2019,Febrero,Eslovaquia,5,12,,17,-75.516486,10.446304
62459,2019,Febrero,Eslovaquia,1,1,,2,-74.77647900000001,10.886686
62460,2019,Febrero,Eslovaquia,1,0,,1,-76.532004,3.451668
62461,2019,Febrero,Eslovaquia,79,95,,174,-74.140516,4.697157
62462,2019,Febrero,Eslovaquia,4,4,,8,-75.42726,6.170465
62463,2019,Febrero,Eslovenia,2,1,,3,-77.35600000000001,0.81488
62464,2019,Febrero,Eslovenia,1,0,,1,-75.527794,10.406342
62465,2019,Febrero,Eslovenia,1,3,,4,-75.516486,10.446304
62466,2019,Febrero,Eslovenia,1,0,,1,-74.77647900000001,10.886686
62467,2019,Febrero,Eslovenia,3,6,,9,-76.532004,3.451668
62468,2019,Febrero,Eslovenia,43,64,,107,-74.140516,4.697157
62469,2019,Febrero,Eslovenia,0,5,,5,-75.42726,6.170465
62470,2019,Febrero,Estados Unidos de América,3,6,,9,-69.941498,4.191162
62471,2019,Febrero,Estados Unidos de América,22,26,,48,-69.94143100000001,4.214082
62472,2019,Febrero,Estados Unidos de América,0,2,,2,-76.876446,0.33002
62473,2019,Febrero,Estados Unidos de América,47,84,,131,-77.35600000000001,0.81488
62474,2019,Febrero,Estados Unidos de América,55,91,,146,-75.527794,10.406342
62475,2019,Febrero,Estados Unidos de América,6692,8261,,14953,-75.516486,10.446304
62476,2019,Febrero,Estados Unidos de América,688,1237,,1925,-74.77647900000001,10.886686
62477,2019,Febrero,Estados Unidos de América,31,46,,77,-74.232675,11.117206
62478,2019,Febrero,Estados Unidos de América,5,5,,10,-74.213989,11.247722999999999
62479,2019,Febrero,Estados Unidos de América,1,5,,6,-72.129595,11.360028999999999
62480,2019,Febrero,Estados Unidos de América,1,7,,8,-81.703935,12.574411099999999
62481,2019,Febrero,Estados Unidos de América,42,48,,90,-81.70216500000001,12.5862
62482,2019,Febrero,Estados Unidos de América,5,10,,15,-81.372937,13.338761300000002
62483,2019,Febrero,Estados Unidos de América,1295,1955,,3250,-76.532004,3.451668
62484,2019,Febrero,Estados Unidos de América,97,178,,275,-75.76635300000001,4.45285
62485,2019,Febrero,Estados Unidos de América,9719,16663,,26382,-74.140516,4.697157
62486,2019,Febrero,Estados Unidos de América,162,303,,465,-75.736374,4.815189
62487,2019,Febrero,Estados Unidos de América,2995,7699,,10694,-75.42726,6.170465
62488,2019,Febrero,Estados Unidos de América,0,1,,1,-77.401154,6.222551999999999
62489,2019,Febrero,Estados Unidos de América,1,1,,2,-70.74025300000001,7.088728999999999
62490,2019,Febrero,Estados Unidos de América,22,48,,70,-73.181317,7.1280470000000005
62491,2019,Febrero,Estados Unidos de América,14,10,,24,-72.453013,7.819
62492,2019,Febrero,Estados Unidos de América,30,121,,151,-72.508188,7.927233
62493,2019,Febrero,Estados Unidos de América,6,6,,12,-72.409396,8.36068
62494,2019,Febrero,Estados Unidos de América,10,11,,21,-77.35002,8.63337
62495,2019,Febrero,Estonia,3,0,,3,-69.94143100000001,4.214082
62496,2019,Febrero,Estonia,3,11,,14,-75.516486,10.446304
62497,2019,Febrero,Estonia,2,5,,7,-76.532004,3.451668
62498,2019,Febrero,Estonia,37,65,,102,-74.140516,4.697157
62499,2019,Febrero,Estonia,6,5,,11,-75.42726,6.170465
62500,2019,Febrero,Etiopia,0,1,,1,-74.77647900000001,10.886686
62501,2019,Febrero,Etiopia,1,0,,1,-76.532004,3.451668
62502,2019,Febrero,Etiopia,4,35,,39,-74.140516,4.697157
62503,2019,Febrero,Islas Fiji,0,1,,1,-74.77647900000001,10.886686
62504,2019,Febrero,Islas Fiji,0,2,,2,-74.140516,4.697157
62505,2019,Febrero,Filipinas,1,0,,1,-77.35600000000001,0.81488
62506,2019,Febrero,Filipinas,6,72,,78,-75.527794,10.406342
62507,2019,Febrero,Filipinas,10,64,,74,-75.516486,10.446304
62508,2019,Febrero,Filipinas,0,11,,11,-74.77647900000001,10.886686
62509,2019,Febrero,Filipinas,0,24,,24,-74.765343,10.970933
62510,2019,Febrero,Filipinas,0,7,,7,-74.213989,11.247722999999999
62511,2019,Febrero,Filipinas,1,24,,25,-76.532004,3.451668
62512,2019,Febrero,Filipinas,0,19,,19,-77.061029,3.8844260000000004
62513,2019,Febrero,Filipinas,48,67,,115,-74.140516,4.697157
62514,2019,Febrero,Filipinas,3,2,,5,-75.42726,6.170465
62515,2019,Febrero,Filipinas,0,1,,1,-75.68164200000001,9.402597
62516,2019,Febrero,Finlandia,1,0,,1,-69.94143100000001,4.214082
62517,2019,Febrero,Finlandia,2,1,,3,-77.35600000000001,0.81488
62518,2019,Febrero,Finlandia,0,2,,2,-75.527794,10.406342
62519,2019,Febrero,Finlandia,12,10,,22,-75.516486,10.446304
62520,2019,Febrero,Finlandia,2,0,,2,-74.77647900000001,10.886686
62521,2019,Febrero,Finlandia,1,1,,2,-74.213989,11.247722999999999
62522,2019,Febrero,Finlandia,0,1,,1,-81.70216500000001,12.5862
62523,2019,Febrero,Finlandia,4,9,,13,-76.532004,3.451668
62524,2019,Febrero,Finlandia,100,110,,210,-74.140516,4.697157
62525,2019,Febrero,Finlandia,10,19,,29,-75.42726,6.170465
62526,2019,Febrero,Finlandia,0,1,,1,-72.453013,7.819
62527,2019,Febrero,Finlandia,0,1,,1,-77.35002,8.63337
62528,2019,Febrero,Francia,4,8,,12,-69.941498,4.191162
62529,2019,Febrero,Francia,14,27,,41,-69.94143100000001,4.214082
62530,2019,Febrero,Francia,4,7,,11,-76.876446,0.33002
62531,2019,Febrero,Francia,114,170,,284,-77.35600000000001,0.81488
62532,2019,Febrero,Francia,11,23,,34,-75.527794,10.406342
62533,2019,Febrero,Francia,247,312,,559,-75.516486,10.446304
62534,2019,Febrero,Francia,45,60,,105,-74.77647900000001,10.886686
62535,2019,Febrero,Francia,0,1,,1,-74.765343,10.970933
62536,2019,Febrero,Francia,2,2,,4,-74.232675,11.117206
62537,2019,Febrero,Francia,5,3,,8,-74.213989,11.247722999999999
62538,2019,Febrero,Francia,1,0,,1,-72.129595,11.360028999999999
62539,2019,Febrero,Francia,1,1,,2,-81.703935,12.574411099999999
62540,2019,Febrero,Francia,2,2,,4,-81.70216500000001,12.5862
62541,2019,Febrero,Francia,2,4,,6,-81.372937,13.338761300000002
62542,2019,Febrero,Francia,113,197,,310,-76.532004,3.451668
62543,2019,Febrero,Francia,3782,4691,,8473,-74.140516,4.697157
62544,2019,Febrero,Francia,3,20,,23,-75.736374,4.815189
62545,2019,Febrero,Francia,313,504,,817,-75.42726,6.170465
62546,2019,Febrero,Francia,0,2,,2,-77.401154,6.222551999999999
62547,2019,Febrero,Francia,5,7,,12,-73.181317,7.1280470000000005
62548,2019,Febrero,Francia,2,3,,5,-72.453013,7.819
62549,2019,Febrero,Francia,0,1,,1,-72.508188,7.927233
62550,2019,Febrero,Francia,0,1,,1,-72.409396,8.36068
62551,2019,Febrero,Francia,14,13,,27,-77.35002,8.63337
62552,2019,Febrero,Francia,0,1,,1,-75.68164200000001,9.402597
62553,2019,Febrero,Gabón,1,0,,1,-74.140516,4.697157
62554,2019,Febrero,Georgia,1,1,,2,-77.35600000000001,0.81488
62555,2019,Febrero,Georgia,0,1,,1,-75.527794,10.406342
62556,2019,Febrero,Georgia,1,2,,3,-75.516486,10.446304
62557,2019,Febrero,Georgia,0,1,,1,-77.061029,3.8844260000000004
62558,2019,Febrero,Georgia,2,15,,17,-74.140516,4.697157
62559,2019,Febrero,Georgia,2,0,,2,-75.42726,6.170465
62560,2019,Febrero,Ghana,4,5,,9,-74.140516,4.697157
62561,2019,Febrero,Ghana,0,1,,1,-75.42726,6.170465
62562,2019,Febrero,Granada,1,1,,2,-74.140516,4.697157
62563,2019,Febrero,Grecia,2,4,,6,-77.35600000000001,0.81488
62564,2019,Febrero,Grecia,2,2,,4,-75.527794,10.406342
62565,2019,Febrero,Grecia,4,10,,14,-75.516486,10.446304
62566,2019,Febrero,Grecia,1,0,,1,-74.77647900000001,10.886686
62567,2019,Febrero,Grecia,0,2,,2,-74.213989,11.247722999999999
62568,2019,Febrero,Grecia,0,1,,1,-76.532004,3.451668
62569,2019,Febrero,Grecia,39,104,,143,-74.140516,4.697157
62570,2019,Febrero,Grecia,3,6,,9,-75.42726,6.170465
62571,2019,Febrero,Grecia,1,0,,1,-72.453013,7.819
62572,2019,Febrero,Grecia,0,1,,1,-72.409396,8.36068
62573,2019,Febrero,Grecia,1,1,,2,-75.68164200000001,9.402597
62574,2019,Febrero,Guatemala,0,1,,1,-69.94143100000001,4.214082
62575,2019,Febrero,Guatemala,2,3,,5,-77.35600000000001,0.81488
62576,2019,Febrero,Guatemala,1,3,,4,-75.527794,10.406342
62577,2019,Febrero,Guatemala,106,133,,239,-75.516486,10.446304
62578,2019,Febrero,Guatemala,8,16,,24,-74.77647900000001,10.886686
62579,2019,Febrero,Guatemala,1,0,,1,-81.372937,13.338761300000002
62580,2019,Febrero,Guatemala,24,62,,86,-76.532004,3.451668
62581,2019,Febrero,Guatemala,471,752,,1223,-74.140516,4.697157
62582,2019,Febrero,Guatemala,0,7,,7,-75.736374,4.815189
62583,2019,Febrero,Guatemala,48,127,,175,-75.42726,6.170465
62584,2019,Febrero,Guatemala,0,2,,2,-72.453013,7.819
62585,2019,Febrero,Guatemala,0,2,,2,-72.409396,8.36068
62586,2019,Febrero,Guyana,0,1,,1,-77.35600000000001,0.81488
62587,2019,Febrero,Guyana,1,0,,1,-75.527794,10.406342
62588,2019,Febrero,Guyana,1,3,,4,-75.516486,10.446304
62589,2019,Febrero,Guyana,1,0,,1,-74.77647900000001,10.886686
62590,2019,Febrero,Guyana,0,1,,1,-72.129595,11.360028999999999
62591,2019,Febrero,Guyana,2,3,,5,-76.532004,3.451668
62592,2019,Febrero,Guyana,3,23,,26,-74.140516,4.697157
62593,2019,Febrero,Guyana,0,1,,1,-75.42726,6.170465
62594,2019,Febrero,Guyana,0,1,,1,-73.181317,7.1280470000000005
62595,2019,Febrero,Guyana,0,2,,2,-72.453013,7.819
62596,2019,Febrero,Haití,0,1,,1,-77.35600000000001,0.81488
62597,2019,Febrero,Haití,0,1,,1,-75.527794,10.406342
62598,2019,Febrero,Haití,3,5,,8,-75.516486,10.446304
62599,2019,Febrero,Haití,1,1,,2,-76.532004,3.451668
62600,2019,Febrero,Haití,18,22,,40,-74.140516,4.697157
62601,2019,Febrero,Haití,3,6,,9,-75.42726,6.170465
62602,2019,Febrero,Honduras,3,1,,4,-77.35600000000001,0.81488
62603,2019,Febrero,Honduras,1,13,,14,-75.527794,10.406342
62604,2019,Febrero,Honduras,88,99,,187,-75.516486,10.446304
62605,2019,Febrero,Honduras,7,11,,18,-74.77647900000001,10.886686
62606,2019,Febrero,Honduras,0,1,,1,-81.70216500000001,12.5862
62607,2019,Febrero,Honduras,36,28,,64,-76.532004,3.451668
62608,2019,Febrero,Honduras,0,1,,1,-77.061029,3.8844260000000004
62609,2019,Febrero,Honduras,287,309,,596,-74.140516,4.697157
62610,2019,Febrero,Honduras,3,6,,9,-75.736374,4.815189
62611,2019,Febrero,Honduras,43,52,,95,-75.42726,6.170465
62612,2019,Febrero,Honduras,1,1,,2,-73.181317,7.1280470000000005
62613,2019,Febrero,Honduras,0,3,,3,-72.453013,7.819
62614,2019,Febrero,Honduras,1,0,,1,-72.409396,8.36068
62615,2019,Febrero,Hong Kong,1,2,,3,-77.35600000000001,0.81488
62616,2019,Febrero,Hong Kong,2,0,,2,-75.516486,10.446304
62617,2019,Febrero,Hong Kong,17,25,,42,-74.140516,4.697157
62618,2019,Febrero,Hungría,2,3,,5,-77.35600000000001,0.81488
62619,2019,Febrero,Hungría,0,1,,1,-75.527794,10.406342
62620,2019,Febrero,Hungría,4,4,,8,-75.516486,10.446304
62621,2019,Febrero,Hungría,8,14,,22,-76.532004,3.451668
62622,2019,Febrero,Hungría,72,123,,195,-74.140516,4.697157
62623,2019,Febrero,Hungría,7,12,,19,-75.42726,6.170465
62624,2019,Febrero,India,0,1,,1,-69.94143100000001,4.214082
62625,2019,Febrero,India,1,14,,15,-75.527794,10.406342
62626,2019,Febrero,India,9,61,,70,-75.516486,10.446304
62627,2019,Febrero,India,1,15,,16,-74.77647900000001,10.886686
62628,2019,Febrero,India,0,7,,7,-74.213989,11.247722999999999
62629,2019,Febrero,India,6,23,,29,-76.532004,3.451668
62630,2019,Febrero,India,0,1,,1,-77.061029,3.8844260000000004
62631,2019,Febrero,India,94,418,,512,-74.140516,4.697157
62632,2019,Febrero,India,1,1,,2,-75.736374,4.815189
62633,2019,Febrero,India,13,78,,91,-75.42726,6.170465
62634,2019,Febrero,India,0,1,,1,-73.181317,7.1280470000000005
62635,2019,Febrero,India,0,3,,3,-76.7333,8.06667
62636,2019,Febrero,India,0,3,,3,-75.68164200000001,9.402597
62637,2019,Febrero,Indonesia,0,1,,1,-75.527794,10.406342
62638,2019,Febrero,Indonesia,5,1,,6,-75.516486,10.446304
62639,2019,Febrero,Indonesia,1,2,,3,-76.532004,3.451668
62640,2019,Febrero,Indonesia,13,16,,29,-74.140516,4.697157
62641,2019,Febrero,Indonesia,0,1,,1,-75.42726,6.170465
62642,2019,Febrero,Iraq,1,0,,1,-74.140516,4.697157
62643,2019,Febrero,Irán,0,2,,2,-77.35600000000001,0.81488
62644,2019,Febrero,Irán,0,1,,1,-75.527794,10.406342
62645,2019,Febrero,Irán,2,1,,3,-75.516486,10.446304
62646,2019,Febrero,Irán,1,1,,2,-76.532004,3.451668
62647,2019,Febrero,Irán,5,18,,23,-74.140516,4.697157
62648,2019,Febrero,Irán,0,2,,2,-75.42726,6.170465
62649,2019,Febrero,República de Irlanda,0,1,,1,-69.941498,4.191162
62650,2019,Febrero,República de Irlanda,1,2,,3,-69.94143100000001,4.214082
62651,2019,Febrero,República de Irlanda,6,11,,17,-77.35600000000001,0.81488
62652,2019,Febrero,República de Irlanda,2,10,,12,-75.527794,10.406342
62653,2019,Febrero,República de Irlanda,20,32,,52,-75.516486,10.446304
62654,2019,Febrero,República de Irlanda,0,6,,6,-74.77647900000001,10.886686
62655,2019,Febrero,República de Irlanda,1,0,,1,-74.232675,11.117206
62656,2019,Febrero,República de Irlanda,4,13,,17,-76.532004,3.451668
62657,2019,Febrero,República de Irlanda,104,177,,281,-74.140516,4.697157
62658,2019,Febrero,República de Irlanda,15,36,,51,-75.42726,6.170465
62659,2019,Febrero,República de Irlanda,0,1,,1,-72.508188,7.927233
62660,2019,Febrero,República de Irlanda,5,4,,9,-77.35002,8.63337
62661,2019,Febrero,Islandia,1,1,,2,-75.527794,10.406342
62662,2019,Febrero,Islandia,3,2,,5,-75.516486,10.446304
62663,2019,Febrero,Islandia,6,17,,23,-74.140516,4.697157
62664,2019,Febrero,Islandia,1,1,,2,-75.42726,6.170465
62665,2019,Febrero,Islandia,0,1,,1,-77.35002,8.63337
62666,2019,Febrero,Israel,1,2,,3,-69.941498,4.191162
62667,2019,Febrero,Israel,1,3,,4,-76.876446,0.33002
62668,2019,Febrero,Israel,10,20,,30,-77.35600000000001,0.81488
62669,2019,Febrero,Israel,0,2,,2,-75.527794,10.406342
62670,2019,Febrero,Israel,21,110,,131,-75.516486,10.446304
62671,2019,Febrero,Israel,0,5,,5,-74.77647900000001,10.886686
62672,2019,Febrero,Israel,0,1,,1,-74.232675,11.117206
62673,2019,Febrero,Israel,9,22,,31,-76.532004,3.451668
62674,2019,Febrero,Israel,155,396,,551,-74.140516,4.697157
62675,2019,Febrero,Israel,0,1,,1,-75.736374,4.815189
62676,2019,Febrero,Israel,28,91,,119,-75.42726,6.170465
62677,2019,Febrero,Israel,0,1,,1,-72.453013,7.819
62678,2019,Febrero,Israel,0,4,,4,-77.35002,8.63337
62679,2019,Febrero,Italia,1,2,,3,-69.941498,4.191162
62680,2019,Febrero,Italia,2,3,,5,-69.94143100000001,4.214082
62681,2019,Febrero,Italia,0,3,,3,-76.876446,0.33002
62682,2019,Febrero,Italia,14,31,,45,-77.35600000000001,0.81488
62683,2019,Febrero,Italia,4,20,,24,-75.527794,10.406342
62684,2019,Febrero,Italia,87,228,,315,-75.516486,10.446304
62685,2019,Febrero,Italia,12,40,,52,-74.77647900000001,10.886686
62686,2019,Febrero,Italia,0,2,,2,-74.232675,11.117206
62687,2019,Febrero,Italia,3,6,,9,-72.129595,11.360028999999999
62688,2019,Febrero,Italia,5,9,,14,-81.70216500000001,12.5862
62689,2019,Febrero,Italia,37,115,,152,-76.532004,3.451668
62690,2019,Febrero,Italia,940,2260,,3200,-74.140516,4.697157
62691,2019,Febrero,Italia,0,5,,5,-75.736374,4.815189
62692,2019,Febrero,Italia,81,318,,399,-75.42726,6.170465
62693,2019,Febrero,Italia,0,1,,1,-70.74025300000001,7.088728999999999
62694,2019,Febrero,Italia,2,1,,3,-73.181317,7.1280470000000005
62695,2019,Febrero,Italia,7,21,,28,-72.453013,7.819
62696,2019,Febrero,Italia,1,1,,2,-72.508188,7.927233
62697,2019,Febrero,Italia,4,5,,9,-72.409396,8.36068
62698,2019,Febrero,Italia,3,5,,8,-77.35002,8.63337
62699,2019,Febrero,Jamaica,0,2,,2,-77.35600000000001,0.81488
62700,2019,Febrero,Jamaica,9,8,,17,-75.516486,10.446304
62701,2019,Febrero,Jamaica,3,5,,8,-74.77647900000001,10.886686
62702,2019,Febrero,Jamaica,10,4,,14,-76.532004,3.451668
62703,2019,Febrero,Jamaica,29,57,,86,-74.140516,4.697157
62704,2019,Febrero,Jamaica,4,10,,14,-75.42726,6.170465
62705,2019,Febrero,Japón,1,0,,1,-69.941498,4.191162
62706,2019,Febrero,Japón,8,7,,15,-77.35600000000001,0.81488
62707,2019,Febrero,Japón,1,1,,2,-75.527794,10.406342
62708,2019,Febrero,Japón,14,18,,32,-75.516486,10.446304
62709,2019,Febrero,Japón,0,7,,7,-74.77647900000001,10.886686
62710,2019,Febrero,Japón,0,1,,1,-72.129595,11.360028999999999
62711,2019,Febrero,Japón,4,12,,16,-76.532004,3.451668
62712,2019,Febrero,Japón,227,512,,739,-74.140516,4.697157
62713,2019,Febrero,Japón,0,2,,2,-75.736374,4.815189
62714,2019,Febrero,Japón,35,50,,85,-75.42726,6.170465
62715,2019,Febrero,Jordania,0,3,,3,-77.35600000000001,0.81488
62716,2019,Febrero,Jordania,5,8,,13,-74.140516,4.697157
62717,2019,Febrero,Jordania,0,3,,3,-75.42726,6.170465
62718,2019,Febrero,Kazajistán,1,1,,2,-77.35600000000001,0.81488
62719,2019,Febrero,Kazajistán,3,1,,4,-74.140516,4.697157
62720,2019,Febrero,Kazajistán,3,2,,5,-75.42726,6.170465
62721,2019,Febrero,Kenia,2,0,,2,-75.516486,10.446304
62722,2019,Febrero,Kenia,1,0,,1,-76.532004,3.451668
62723,2019,Febrero,Kenia,3,9,,12,-74.140516,4.697157
62724,2019,Febrero,Kenia,0,2,,2,-75.42726,6.170465
62725,2019,Febrero,Kirguistán,1,0,,1,-74.140516,4.697157
62726,2019,Febrero,Kuwait,1,1,,2,-75.516486,10.446304
62727,2019,Febrero,Kuwait,7,0,,7,-74.140516,4.697157
62728,2019,Febrero,República de Kosovo,1,0,,1,-74.140516,4.697157
62729,2019,Febrero,Letonia,0,1,,1,-76.876446,0.33002
62730,2019,Febrero,Letonia,1,0,,1,-77.35600000000001,0.81488
62731,2019,Febrero,Letonia,2,1,,3,-75.516486,10.446304
62732,2019,Febrero,Letonia,0,4,,4,-76.532004,3.451668
62733,2019,Febrero,Letonia,11,19,,30,-74.140516,4.697157
62734,2019,Febrero,Letonia,1,2,,3,-75.42726,6.170465
62735,2019,Febrero,Letonia,0,1,,1,-75.68164200000001,9.402597
62736,2019,Febrero,Lituania,1,0,,1,-77.35600000000001,0.81488
62737,2019,Febrero,Lituania,5,9,,14,-75.516486,10.446304
62738,2019,Febrero,Lituania,3,9,,12,-76.532004,3.451668
62739,2019,Febrero,Lituania,25,33,,58,-74.140516,4.697157
62740,2019,Febrero,Lituania,3,8,,11,-75.42726,6.170465
62741,2019,Febrero,Líbano,0,1,,1,-77.35600000000001,0.81488
62742,2019,Febrero,Líbano,0,2,,2,-75.516486,10.446304
62743,2019,Febrero,Líbano,1,1,,2,-74.77647900000001,10.886686
62744,2019,Febrero,Líbano,0,1,,1,-72.129595,11.360028999999999
62745,2019,Febrero,Líbano,0,5,,5,-76.532004,3.451668
62746,2019,Febrero,Líbano,6,20,,26,-74.140516,4.697157
62747,2019,Febrero,Líbano,0,4,,4,-75.42726,6.170465
62748,2019,Febrero,Líbano,1,2,,3,-73.181317,7.1280470000000005
62749,2019,Febrero,Libia,1,3,,4,-74.140516,4.697157
62750,2019,Febrero,Liechtenstein,0,1,,1,-74.77647900000001,10.886686
62751,2019,Febrero,Liechtenstein,0,1,,1,-74.140516,4.697157
62752,2019,Febrero,Luxemburgo,1,0,,1,-77.35600000000001,0.81488
62753,2019,Febrero,Luxemburgo,0,1,,1,-75.516486,10.446304
62754,2019,Febrero,Luxemburgo,2,3,,5,-76.532004,3.451668
62755,2019,Febrero,Luxemburgo,16,18,,34,-74.140516,4.697157
62756,2019,Febrero,Luxemburgo,0,1,,1,-75.42726,6.170465
62757,2019,Febrero,Luxemburgo,1,0,,1,-72.453013,7.819
62758,2019,Febrero,Macedonia,0,1,,1,-77.35600000000001,0.81488
62759,2019,Febrero,Macedonia,2,1,,3,-75.516486,10.446304
62760,2019,Febrero,Macedonia,0,1,,1,-76.532004,3.451668
62761,2019,Febrero,Macedonia,6,11,,17,-74.140516,4.697157
62762,2019,Febrero,Madagascar,1,0,,1,-75.516486,10.446304
62763,2019,Febrero,Madagascar,0,1,,1,-74.140516,4.697157
62764,2019,Febrero,Madagascar,1,0,,1,-75.42726,6.170465
62765,2019,Febrero,Malasia,0,1,,1,-75.527794,10.406342
62766,2019,Febrero,Malasia,14,6,,20,-74.140516,4.697157
62767,2019,Febrero,Malasia,0,1,,1,-75.736374,4.815189
62768,2019,Febrero,Malasia,0,1,,1,-75.42726,6.170465
62769,2019,Febrero,Malawi,0,1,,1,-74.140516,4.697157
62770,2019,Febrero,Maldivas,0,1,,1,-76.532004,3.451668
62771,2019,Febrero,Malí,1,1,,2,-74.140516,4.697157
62772,2019,Febrero,Malta,1,1,,2,-75.527794,10.406342
62773,2019,Febrero,Malta,2,2,,4,-75.516486,10.446304
62774,2019,Febrero,Malta,5,12,,17,-74.140516,4.697157
62775,2019,Febrero,Malta,0,1,,1,-75.42726,6.170465
62776,2019,Febrero,Marruecos,0,1,,1,-75.516486,10.446304
62777,2019,Febrero,Marruecos,0,1,,1,-75.76635300000001,4.45285
62778,2019,Febrero,Marruecos,19,26,,45,-74.140516,4.697157
62779,2019,Febrero,Marruecos,4,2,,6,-75.42726,6.170465
62780,2019,Febrero,Mauricio,0,1,,1,-75.516486,10.446304
62781,2019,Febrero,Mauricio,1,1,,2,-74.140516,4.697157
62782,2019,Febrero,Mauritania,0,1,,1,-74.140516,4.697157
62783,2019,Febrero,México,0,1,,1,-69.941498,4.191162
62784,2019,Febrero,México,1,3,,4,-69.94143100000001,4.214082
62785,2019,Febrero,México,0,1,,1,-74.78366,0.18595699999999998
62786,2019,Febrero,México,3,1,,4,-76.876446,0.33002
62787,2019,Febrero,México,19,29,,48,-77.35600000000001,0.81488
62788,2019,Febrero,México,25,25,,50,-75.527794,10.406342
62789,2019,Febrero,México,340,449,,789,-75.516486,10.446304
62790,2019,Febrero,México,22,61,,83,-74.77647900000001,10.886686
62791,2019,Febrero,México,0,4,,4,-72.129595,11.360028999999999
62792,2019,Febrero,México,3,5,,8,-81.70216500000001,12.5862
62793,2019,Febrero,México,75,206,,281,-76.532004,3.451668
62794,2019,Febrero,México,2,2,,4,-75.76635300000001,4.45285
62795,2019,Febrero,México,3765,6950,,10715,-74.140516,4.697157
62796,2019,Febrero,México,6,15,,21,-75.736374,4.815189
62797,2019,Febrero,México,350,924,,1274,-75.42726,6.170465
62798,2019,Febrero,México,0,4,,4,-67.48402800000001,6.185536
62799,2019,Febrero,México,2,0,,2,-70.74025300000001,7.088728999999999
62800,2019,Febrero,México,5,12,,17,-73.181317,7.1280470000000005
62801,2019,Febrero,México,8,11,,19,-72.453013,7.819
62802,2019,Febrero,México,4,11,,15,-72.508188,7.927233
62803,2019,Febrero,México,1,2,,3,-72.409396,8.36068
62804,2019,Febrero,México,2,2,,4,-77.35002,8.63337
62805,2019,Febrero,República de Moldavia,1,0,,1,-77.35600000000001,0.81488
62806,2019,Febrero,República de Moldavia,1,0,,1,-75.516486,10.446304
62807,2019,Febrero,República de Moldavia,4,0,,4,-74.140516,4.697157
62808,2019,Febrero,Mónaco,1,0,,1,-75.516486,10.446304
62809,2019,Febrero,Mónaco,0,1,,1,-76.532004,3.451668
62810,2019,Febrero,Mongolia,1,1,,2,-75.516486,10.446304
62811,2019,Febrero,Montenegro,0,1,,1,-75.527794,10.406342
62812,2019,Febrero,Montenegro,0,3,,3,-75.516486,10.446304
62813,2019,Febrero,Montenegro,2,6,,8,-74.140516,4.697157
62814,2019,Febrero,Micronesia,1,0,,1,-75.516486,10.446304
62815,2019,Febrero,Myanmar,0,10,,10,-75.527794,10.406342
62816,2019,Febrero,Myanmar,1,17,,18,-75.516486,10.446304
62817,2019,Febrero,Myanmar,0,1,,1,-74.77647900000001,10.886686
62818,2019,Febrero,Myanmar,0,1,,1,-74.765343,10.970933
62819,2019,Febrero,Myanmar,0,8,,8,-75.68164200000001,9.402597
62820,2019,Febrero,Namibia,1,0,,1,-74.140516,4.697157
62821,2019,Febrero,Nepal,2,0,,2,-75.516486,10.446304
62822,2019,Febrero,Nepal,0,2,,2,-76.532004,3.451668
62823,2019,Febrero,Nepal,1,3,,4,-74.140516,4.697157
62824,2019,Febrero,Nepal,0,1,,1,-75.42726,6.170465
62825,2019,Febrero,Nicaragua,0,2,,2,-75.527794,10.406342
62826,2019,Febrero,Nicaragua,26,17,,43,-75.516486,10.446304
62827,2019,Febrero,Nicaragua,2,1,,3,-74.77647900000001,10.886686
62828,2019,Febrero,Nicaragua,3,10,,13,-81.703935,12.574411099999999
62829,2019,Febrero,Nicaragua,1,0,,1,-81.70216500000001,12.5862
62830,2019,Febrero,Nicaragua,13,14,,27,-76.532004,3.451668
62831,2019,Febrero,Nicaragua,88,107,,195,-74.140516,4.697157
62832,2019,Febrero,Nicaragua,5,5,,10,-75.736374,4.815189
62833,2019,Febrero,Nicaragua,21,19,,40,-75.42726,6.170465
62834,2019,Febrero,Nicaragua,2,6,,8,-73.181317,7.1280470000000005
62835,2019,Febrero,Nigeria,1,2,,3,-77.35600000000001,0.81488
62836,2019,Febrero,Nigeria,3,5,,8,-75.516486,10.446304
62837,2019,Febrero,Nigeria,0,1,,1,-74.77647900000001,10.886686
62838,2019,Febrero,Nigeria,1,1,,2,-76.532004,3.451668
62839,2019,Febrero,Nigeria,6,14,,20,-74.140516,4.697157
62840,2019,Febrero,Nigeria,0,1,,1,-75.42726,6.170465
62841,2019,Febrero,Níger,1,0,,1,-75.516486,10.446304
62842,2019,Febrero,Noruega,1,1,,2,-69.94143100000001,4.214082
62843,2019,Febrero,Noruega,10,4,,14,-77.35600000000001,0.81488
62844,2019,Febrero,Noruega,3,2,,5,-75.527794,10.406342
62845,2019,Febrero,Noruega,45,39,,84,-75.516486,10.446304
62846,2019,Febrero,Noruega,4,2,,6,-74.77647900000001,10.886686
62847,2019,Febrero,Noruega,1,3,,4,-74.213989,11.247722999999999
62848,2019,Febrero,Noruega,0,2,,2,-81.70216500000001,12.5862
62849,2019,Febrero,Noruega,6,10,,16,-76.532004,3.451668
62850,2019,Febrero,Noruega,146,189,,335,-74.140516,4.697157
62851,2019,Febrero,Noruega,12,15,,27,-75.42726,6.170465
62852,2019,Febrero,Noruega,0,1,,1,-73.181317,7.1280470000000005
62853,2019,Febrero,Noruega,2,2,,4,-77.35002,8.63337
62854,2019,Febrero,Nueva Zelanda,2,0,,2,-69.941498,4.191162
62855,2019,Febrero,Nueva Zelanda,2,0,,2,-76.876446,0.33002
62856,2019,Febrero,Nueva Zelanda,6,2,,8,-77.35600000000001,0.81488
62857,2019,Febrero,Nueva Zelanda,2,5,,7,-75.527794,10.406342
62858,2019,Febrero,Nueva Zelanda,6,12,,18,-75.516486,10.446304
62859,2019,Febrero,Nueva Zelanda,0,2,,2,-74.77647900000001,10.886686
62860,2019,Febrero,Nueva Zelanda,0,2,,2,-74.213989,11.247722999999999
62861,2019,Febrero,Nueva Zelanda,1,2,,3,-76.532004,3.451668
62862,2019,Febrero,Nueva Zelanda,44,64,,108,-74.140516,4.697157
62863,2019,Febrero,Nueva Zelanda,0,1,,1,-75.736374,4.815189
62864,2019,Febrero,Nueva Zelanda,4,15,,19,-75.42726,6.170465
62865,2019,Febrero,Nueva Zelanda,1,0,,1,-77.35002,8.63337
62866,2019,Febrero,Omán,0,1,,1,-75.516486,10.446304
62867,2019,Febrero,Omán,1,0,,1,-74.140516,4.697157
62868,2019,Febrero,Omán,0,1,,1,-77.35002,8.63337
62869,2019,Febrero,Países Bajos,5,5,,10,-69.941498,4.191162
62870,2019,Febrero,Países Bajos,3,5,,8,-69.94143100000001,4.214082
62871,2019,Febrero,Países Bajos,1,2,,3,-76.876446,0.33002
62872,2019,Febrero,Países Bajos,32,27,,59,-77.35600000000001,0.81488
62873,2019,Febrero,Países Bajos,26,32,,58,-75.527794,10.406342
62874,2019,Febrero,Países Bajos,327,281,,608,-75.516486,10.446304
62875,2019,Febrero,Países Bajos,11,17,,28,-74.77647900000001,10.886686
62876,2019,Febrero,Países Bajos,1,0,,1,-74.765343,10.970933
62877,2019,Febrero,Países Bajos,2,3,,5,-74.232675,11.117206
62878,2019,Febrero,Países Bajos,0,1,,1,-72.129595,11.360028999999999
62879,2019,Febrero,Países Bajos,3,8,,11,-81.703935,12.574411099999999
62880,2019,Febrero,Países Bajos,2,2,,4,-81.70216500000001,12.5862
62881,2019,Febrero,Países Bajos,65,72,,137,-76.532004,3.451668
62882,2019,Febrero,Países Bajos,0,1,,1,-67.927521,3.866713
62883,2019,Febrero,Países Bajos,0,1,,1,-75.76635300000001,4.45285
62884,2019,Febrero,Países Bajos,1675,2245,,3920,-74.140516,4.697157
62885,2019,Febrero,Países Bajos,2,3,,5,-75.736374,4.815189
62886,2019,Febrero,Países Bajos,147,211,,358,-75.42726,6.170465
62887,2019,Febrero,Países Bajos,0,2,,2,-67.48402800000001,6.185536
62888,2019,Febrero,Países Bajos,7,11,,18,-73.181317,7.1280470000000005
62889,2019,Febrero,Países Bajos,0,4,,4,-72.453013,7.819
62890,2019,Febrero,Países Bajos,1,2,,3,-72.508188,7.927233
62891,2019,Febrero,Países Bajos,0,4,,4,-72.409396,8.36068
62892,2019,Febrero,Países Bajos,7,9,,16,-77.35002,8.63337
62893,2019,Febrero,Pakistán,1,2,,3,-75.516486,10.446304
62894,2019,Febrero,Pakistán,6,10,,16,-74.140516,4.697157
62895,2019,Febrero,Pakistán,2,0,,2,-75.42726,6.170465
62896,2019,Febrero,Palau,1,1,,2,-74.140516,4.697157
62897,2019,Febrero,Panamá,0,1,,1,-76.876446,0.33002
62898,2019,Febrero,Panamá,3,6,,9,-77.35600000000001,0.81488
62899,2019,Febrero,Panamá,4,18,,22,-75.527794,10.406342
62900,2019,Febrero,Panamá,876,789,,1665,-75.516486,10.446304
62901,2019,Febrero,Panamá,110,143,,253,-74.77647900000001,10.886686
62902,2019,Febrero,Panamá,1,0,,1,-74.765343,10.970933
62903,2019,Febrero,Panamá,0,1,,1,-72.129595,11.360028999999999
62904,2019,Febrero,Panamá,69,47,,116,-81.70216500000001,12.5862
62905,2019,Febrero,Panamá,458,425,,883,-76.532004,3.451668
62906,2019,Febrero,Panamá,2234,2233,,4467,-74.140516,4.697157
62907,2019,Febrero,Panamá,84,89,,173,-75.736374,4.815189
62908,2019,Febrero,Panamá,2518,1934,,4452,-75.42726,6.170465
62909,2019,Febrero,Panamá,1,4,,5,-75.586989,6.2188349999999994
62910,2019,Febrero,Panamá,2,3,,5,-77.401154,6.222551999999999
62911,2019,Febrero,Panamá,3,3,,6,-77.762647,7.102626
62912,2019,Febrero,Panamá,35,26,,61,-73.181317,7.1280470000000005
62913,2019,Febrero,Panamá,1,6,,7,-72.453013,7.819
62914,2019,Febrero,Panamá,0,1,,1,-72.409396,8.36068
62915,2019,Febrero,Panamá,0,1,,1,-77.35002,8.63337
62916,2019,Febrero,Paraguay,1,2,,3,-77.35600000000001,0.81488
62917,2019,Febrero,Paraguay,2,0,,2,-75.527794,10.406342
62918,2019,Febrero,Paraguay,50,25,,75,-75.516486,10.446304
62919,2019,Febrero,Paraguay,2,2,,4,-74.77647900000001,10.886686
62920,2019,Febrero,Paraguay,26,18,,44,-81.70216500000001,12.5862
62921,2019,Febrero,Paraguay,14,12,,26,-76.532004,3.451668
62922,2019,Febrero,Paraguay,197,213,,410,-74.140516,4.697157
62923,2019,Febrero,Paraguay,2,1,,3,-75.736374,4.815189
62924,2019,Febrero,Paraguay,18,45,,63,-75.42726,6.170465
62925,2019,Febrero,Paraguay,0,3,,3,-72.453013,7.819
62926,2019,Febrero,Paraguay,0,7,,7,-72.508188,7.927233
62927,2019,Febrero,Perú,13,10,,23,-69.941498,4.191162
62928,2019,Febrero,Perú,109,101,,210,-69.94143100000001,4.214082
62929,2019,Febrero,Perú,0,13,,13,-76.876446,0.33002
62930,2019,Febrero,Perú,181,336,,517,-77.35600000000001,0.81488
62931,2019,Febrero,Perú,114,70,,184,-75.527794,10.406342
62932,2019,Febrero,Perú,1625,1148,,2773,-75.516486,10.446304
62933,2019,Febrero,Perú,25,35,,60,-74.77647900000001,10.886686
62934,2019,Febrero,Perú,2,0,,2,-74.232675,11.117206
62935,2019,Febrero,Perú,4,7,,11,-72.129595,11.360028999999999
62936,2019,Febrero,Perú,654,429,,1083,-81.70216500000001,12.5862
62937,2019,Febrero,Perú,609,547,,1156,-76.532004,3.451668
62938,2019,Febrero,Perú,0,1,,1,-67.927521,3.866713
62939,2019,Febrero,Perú,2,1,,3,-75.76635300000001,4.45285
62940,2019,Febrero,Perú,4886,5155,,10041,-74.140516,4.697157
62941,2019,Febrero,Perú,7,6,,13,-75.736374,4.815189
62942,2019,Febrero,Perú,1088,1240,,2328,-75.42726,6.170465
62943,2019,Febrero,Perú,2,8,,10,-70.74025300000001,7.088728999999999
62944,2019,Febrero,Perú,2,1,,3,-73.181317,7.1280470000000005
62945,2019,Febrero,Perú,69,92,,161,-72.453013,7.819
62946,2019,Febrero,Perú,7,9,,16,-72.409396,8.36068
62947,2019,Febrero,Perú,1,1,,2,-77.35002,8.63337
62948,2019,Febrero,Palestina,0,1,,1,-74.140516,4.697157
62949,2019,Febrero,Polonia,0,1,,1,-69.941498,4.191162
62950,2019,Febrero,Polonia,2,3,,5,-69.94143100000001,4.214082
62951,2019,Febrero,Polonia,2,0,,2,-76.876446,0.33002
62952,2019,Febrero,Polonia,5,7,,12,-77.35600000000001,0.81488
62953,2019,Febrero,Polonia,1,1,,2,-78.802679,18.00143
62954,2019,Febrero,Polonia,75,76,,151,-75.527794,10.406342
62955,2019,Febrero,Polonia,67,69,,136,-75.516486,10.446304
62956,2019,Febrero,Polonia,4,3,,7,-74.77647900000001,10.886686
62957,2019,Febrero,Polonia,1,0,,1,-74.765343,10.970933
62958,2019,Febrero,Polonia,1,1,,2,-81.703935,12.574411099999999
62959,2019,Febrero,Polonia,2,4,,6,-76.532004,3.451668
62960,2019,Febrero,Polonia,0,1,,1,-77.061029,3.8844260000000004
62961,2019,Febrero,Polonia,265,371,,636,-74.140516,4.697157
62962,2019,Febrero,Polonia,7,7,,14,-75.736374,4.815189
62963,2019,Febrero,Polonia,26,22,,48,-75.42726,6.170465
62964,2019,Febrero,Polonia,0,1,,1,-67.48402800000001,6.185536
62965,2019,Febrero,Polonia,4,1,,5,-77.35002,8.63337
62966,2019,Febrero,Polonia,0,1,,1,-75.68164200000001,9.402597
62967,2019,Febrero,Portugal,0,1,,1,-69.94143100000001,4.214082
62968,2019,Febrero,Portugal,1,0,,1,-76.876446,0.33002
62969,2019,Febrero,Portugal,7,13,,20,-77.35600000000001,0.81488
62970,2019,Febrero,Portugal,5,6,,11,-75.527794,10.406342
62971,2019,Febrero,Portugal,28,33,,61,-75.516486,10.446304
62972,2019,Febrero,Portugal,2,6,,8,-74.77647900000001,10.886686
62973,2019,Febrero,Portugal,0,3,,3,-72.129595,11.360028999999999
62974,2019,Febrero,Portugal,3,2,,5,-81.70216500000001,12.5862
62975,2019,Febrero,Portugal,3,17,,20,-76.532004,3.451668
62976,2019,Febrero,Portugal,230,484,,714,-74.140516,4.697157
62977,2019,Febrero,Portugal,0,1,,1,-75.736374,4.815189
62978,2019,Febrero,Portugal,16,51,,67,-75.42726,6.170465
62979,2019,Febrero,Portugal,4,10,,14,-72.453013,7.819
62980,2019,Febrero,Portugal,0,4,,4,-72.409396,8.36068
62981,2019,Febrero,Portugal,0,1,,1,-77.35002,8.63337
62982,2019,Febrero,Qatar,0,4,,4,-74.140516,4.697157
62983,2019,Febrero,Reino Unido de Gran Bretaña e Irlanda del Norte,6,3,,9,-69.941498,4.191162
62984,2019,Febrero,Reino Unido de Gran Bretaña e Irlanda del Norte,3,9,,12,-69.94143100000001,4.214082
62985,2019,Febrero,Reino Unido de Gran Bretaña e Irlanda del Norte,2,2,,4,-76.876446,0.33002
62986,2019,Febrero,Reino Unido de Gran Bretaña e Irlanda del Norte,50,74,,124,-77.35600000000001,0.81488
62987,2019,Febrero,Reino Unido de Gran Bretaña e Irlanda del Norte,62,75,,137,-75.527794,10.406342
62988,2019,Febrero,Reino Unido de Gran Bretaña e Irlanda del Norte,151,234,,385,-75.516486,10.446304
62989,2019,Febrero,Reino Unido de Gran Bretaña e Irlanda del Norte,9,27,,36,-74.77647900000001,10.886686
62990,2019,Febrero,Reino Unido de Gran Bretaña e Irlanda del Norte,1,6,,7,-74.232675,11.117206
62991,2019,Febrero,Reino Unido de Gran Bretaña e Irlanda del Norte,4,7,,11,-74.213989,11.247722999999999
62992,2019,Febrero,Reino Unido de Gran Bretaña e Irlanda del Norte,1,2,,3,-81.703935,12.574411099999999
62993,2019,Febrero,Reino Unido de Gran Bretaña e Irlanda del Norte,0,5,,5,-81.70216500000001,12.5862
62994,2019,Febrero,Reino Unido de Gran Bretaña e Irlanda del Norte,28,76,,104,-76.532004,3.451668
62995,2019,Febrero,Reino Unido de Gran Bretaña e Irlanda del Norte,1314,2342,,3656,-74.140516,4.697157
62996,2019,Febrero,Reino Unido de Gran Bretaña e Irlanda del Norte,1,4,,5,-75.736374,4.815189
62997,2019,Febrero,Reino Unido de Gran Bretaña e Irlanda del Norte,115,247,,362,-75.42726,6.170465
62998,2019,Febrero,Reino Unido de Gran Bretaña e Irlanda del Norte,1,0,,1,-67.48402800000001,6.185536
62999,2019,Febrero,Reino Unido de Gran Bretaña e Irlanda del Norte,2,3,,5,-72.453013,7.819
63000,2019,Febrero,Reino Unido de Gran Bretaña e Irlanda del Norte,1,4,,5,-72.508188,7.927233
63001,2019,Febrero,Reino Unido de Gran Bretaña e Irlanda del Norte,19,9,,28,-77.35002,8.63337
63002,2019,Febrero,República Dominicana,0,1,,1,-69.94143100000001,4.214082
63003,2019,Febrero,República Dominicana,4,14,,18,-77.35600000000001,0.81488
63004,2019,Febrero,República Dominicana,0,2,,2,-75.527794,10.406342
63005,2019,Febrero,República Dominicana,48,71,,119,-75.516486,10.446304
63006,2019,Febrero,República Dominicana,21,35,,56,-74.77647900000001,10.886686
63007,2019,Febrero,República Dominicana,0,1,,1,-74.765343,10.970933
63008,2019,Febrero,República Dominicana,1,0,,1,-74.232675,11.117206
63009,2019,Febrero,República Dominicana,0,2,,2,-74.213989,11.247722999999999
63010,2019,Febrero,República Dominicana,0,4,,4,-72.129595,11.360028999999999
63011,2019,Febrero,República Dominicana,0,1,,1,-81.70216500000001,12.5862
63012,2019,Febrero,República Dominicana,40,40,,80,-76.532004,3.451668
63013,2019,Febrero,República Dominicana,791,822,,1613,-74.140516,4.697157
63014,2019,Febrero,República Dominicana,1,4,,5,-75.736374,4.815189
63015,2019,Febrero,República Dominicana,81,110,,191,-75.42726,6.170465
63016,2019,Febrero,República Dominicana,3,6,,9,-72.453013,7.819
63017,2019,Febrero,República Dominicana,2,8,,10,-72.508188,7.927233
63018,2019,Febrero,Rumania,1,0,,1,-69.94143100000001,4.214082
63019,2019,Febrero,Rumania,3,1,,4,-75.527794,10.406342
63020,2019,Febrero,Rumania,9,13,,22,-75.516486,10.446304
63021,2019,Febrero,Rumania,1,2,,3,-74.77647900000001,10.886686
63022,2019,Febrero,Rumania,0,2,,2,-74.213989,11.247722999999999
63023,2019,Febrero,Rumania,7,10,,17,-76.532004,3.451668
63024,2019,Febrero,Rumania,139,147,,286,-74.140516,4.697157
63025,2019,Febrero,Rumania,1,0,,1,-75.736374,4.815189
63026,2019,Febrero,Rumania,16,15,,31,-75.42726,6.170465
63027,2019,Febrero,Rumania,2,0,,2,-77.35002,8.63337
63028,2019,Febrero,Federación de Rusia,1,0,,1,-69.94143100000001,4.214082
63029,2019,Febrero,Federación de Rusia,12,10,,22,-77.35600000000001,0.81488
63030,2019,Febrero,Federación de Rusia,1,10,,11,-75.527794,10.406342
63031,2019,Febrero,Federación de Rusia,15,14,,29,-75.516486,10.446304
63032,2019,Febrero,Federación de Rusia,3,3,,6,-74.77647900000001,10.886686
63033,2019,Febrero,Federación de Rusia,0,2,,2,-74.213989,11.247722999999999
63034,2019,Febrero,Federación de Rusia,1,0,,1,-72.129595,11.360028999999999
63035,2019,Febrero,Federación de Rusia,9,16,,25,-76.532004,3.451668
63036,2019,Febrero,Federación de Rusia,198,221,,419,-74.140516,4.697157
63037,2019,Febrero,Federación de Rusia,15,16,,31,-75.42726,6.170465
63038,2019,Febrero,Federación de Rusia,1,2,,3,-72.453013,7.819
63039,2019,Febrero,Federación de Rusia,1,0,,1,-72.409396,8.36068
63040,2019,Febrero,Federación de Rusia,0,2,,2,-75.68164200000001,9.402597
63041,2019,Febrero,Rwanda,0,2,,2,-74.140516,4.697157
63042,2019,Febrero,Rwanda,1,0,,1,-75.42726,6.170465
63043,2019,Febrero,San Cristóbal y Nevis,0,2,,2,-75.516486,10.446304
63044,2019,Febrero,San Cristóbal y Nevis,4,1,,5,-74.140516,4.697157
63045,2019,Febrero,San Cristóbal y Nevis,0,1,,1,-75.42726,6.170465
63046,2019,Febrero,San Marino,0,1,,1,-74.140516,4.697157
63047,2019,Febrero,San  Vicente y las Granadinas,1,0,,1,-75.516486,10.446304
63048,2019,Febrero,San  Vicente y las Granadinas,1,0,,1,-74.140516,4.697157
63049,2019,Febrero,San  Vicente y las Granadinas,0,1,,1,-75.42726,6.170465
63050,2019,Febrero,Santa Lucia,0,1,,1,-77.35600000000001,0.81488
63051,2019,Febrero,Santa Lucia,1,0,,1,-75.516486,10.446304
63052,2019,Febrero,Santa Lucia,0,2,,2,-76.532004,3.451668
63053,2019,Febrero,Santa Lucia,7,2,,9,-74.140516,4.697157
63054,2019,Febrero,Santa Lucia,0,1,,1,-72.453013,7.819
63055,2019,Febrero,Santa Sede/Ciudad del Vaticano,0,1,,1,-74.140516,4.697157
63056,2019,Febrero,Santo Tomé y Príncipe,1,0,,1,-75.42726,6.170465
63057,2019,Febrero,Senegal,1,1,,2,-75.516486,10.446304
63058,2019,Febrero,Senegal,1,0,,1,-74.77647900000001,10.886686
63059,2019,Febrero,Senegal,2,3,,5,-74.140516,4.697157
63060,2019,Febrero,Serbia,2,4,,6,-75.516486,10.446304
63061,2019,Febrero,Serbia,0,1,,1,-74.77647900000001,10.886686
63062,2019,Febrero,Serbia,3,0,,3,-76.532004,3.451668
63063,2019,Febrero,Serbia,19,46,,65,-74.140516,4.697157
63064,2019,Febrero,Serbia,1,5,,6,-75.42726,6.170465
63065,2019,Febrero,Sierra Leona,0,1,,1,-75.516486,10.446304
63066,2019,Febrero,Singapur,1,0,,1,-69.94143100000001,4.214082
63067,2019,Febrero,Singapur,4,2,,6,-75.516486,10.446304
63068,2019,Febrero,Singapur,0,1,,1,-74.77647900000001,10.886686
63069,2019,Febrero,Singapur,9,26,,35,-74.140516,4.697157
63070,2019,Febrero,Singapur,0,1,,1,-75.42726,6.170465
63071,2019,Febrero,Singapur,0,1,,1,-73.181317,7.1280470000000005
63072,2019,Febrero,República Árabe Siria,0,2,,2,-74.765343,10.970933
63073,2019,Febrero,República Árabe Siria,0,1,,1,-74.213989,11.247722999999999
63074,2019,Febrero,República Árabe Siria,0,3,,3,-74.140516,4.697157
63075,2019,Febrero,Somalia,0,1,,1,-75.42726,6.170465
63076,2019,Febrero,Sri Lanka,0,1,,1,-74.77647900000001,10.886686
63077,2019,Febrero,Sri Lanka,1,5,,6,-74.140516,4.697157
63078,2019,Febrero,Sudáfrica,0,1,,1,-77.35600000000001,0.81488
63079,2019,Febrero,Sudáfrica,1,6,,7,-75.527794,10.406342
63080,2019,Febrero,Sudáfrica,5,4,,9,-75.516486,10.446304
63081,2019,Febrero,Sudáfrica,1,2,,3,-74.77647900000001,10.886686
63082,2019,Febrero,Sudáfrica,0,1,,1,-74.213989,11.247722999999999
63083,2019,Febrero,Sudáfrica,0,2,,2,-76.532004,3.451668
63084,2019,Febrero,Sudáfrica,19,35,,54,-74.140516,4.697157
63085,2019,Febrero,Sudáfrica,2,2,,4,-75.42726,6.170465
63086,2019,Febrero,Sudáfrica,1,1,,2,-77.35002,8.63337
63087,2019,Febrero,Sudán,1,0,,1,-76.532004,3.451668
63088,2019,Febrero,Sudán,0,1,,1,-74.140516,4.697157
63089,2019,Febrero,Suecia,0,1,,1,-69.941498,4.191162
63090,2019,Febrero,Suecia,3,9,,12,-69.94143100000001,4.214082
63091,2019,Febrero,Suecia,0,1,,1,-76.876446,0.33002
63092,2019,Febrero,Suecia,15,15,,30,-77.35600000000001,0.81488
63093,2019,Febrero,Suecia,17,19,,36,-75.527794,10.406342
63094,2019,Febrero,Suecia,85,84,,169,-75.516486,10.446304
63095,2019,Febrero,Suecia,2,12,,14,-74.77647900000001,10.886686
63096,2019,Febrero,Suecia,0,1,,1,-74.232675,11.117206
63097,2019,Febrero,Suecia,4,8,,12,-74.213989,11.247722999999999
63098,2019,Febrero,Suecia,0,1,,1,-72.129595,11.360028999999999
63099,2019,Febrero,Suecia,3,3,,6,-81.70216500000001,12.5862
63100,2019,Febrero,Suecia,5,21,,26,-76.532004,3.451668
63101,2019,Febrero,Suecia,0,1,,1,-75.76635300000001,4.45285
63102,2019,Febrero,Suecia,302,395,,697,-74.140516,4.697157
63103,2019,Febrero,Suecia,5,3,,8,-75.736374,4.815189
63104,2019,Febrero,Suecia,28,55,,83,-75.42726,6.170465
63105,2019,Febrero,Suecia,0,1,,1,-72.453013,7.819
63106,2019,Febrero,Suecia,0,1,,1,-72.508188,7.927233
63107,2019,Febrero,Suecia,6,5,,11,-77.35002,8.63337
63108,2019,Febrero,Suiza,4,4,,8,-69.941498,4.191162
63109,2019,Febrero,Suiza,3,2,,5,-69.94143100000001,4.214082
63110,2019,Febrero,Suiza,1,2,,3,-76.876446,0.33002
63111,2019,Febrero,Suiza,24,32,,56,-77.35600000000001,0.81488
63112,2019,Febrero,Suiza,30,18,,48,-75.527794,10.406342
63113,2019,Febrero,Suiza,83,81,,164,-75.516486,10.446304
63114,2019,Febrero,Suiza,20,24,,44,-74.77647900000001,10.886686
63115,2019,Febrero,Suiza,1,2,,3,-74.213989,11.247722999999999
63116,2019,Febrero,Suiza,2,2,,4,-81.70216500000001,12.5862
63117,2019,Febrero,Suiza,39,57,,96,-76.532004,3.451668
63118,2019,Febrero,Suiza,716,921,,1637,-74.140516,4.697157
63119,2019,Febrero,Suiza,2,2,,4,-75.736374,4.815189
63120,2019,Febrero,Suiza,93,123,,216,-75.42726,6.170465
63121,2019,Febrero,Suiza,0,1,,1,-67.48402800000001,6.185536
63122,2019,Febrero,Suiza,2,0,,2,-72.453013,7.819
63123,2019,Febrero,Suiza,1,3,,4,-72.409396,8.36068
63124,2019,Febrero,Suiza,10,8,,18,-77.35002,8.63337
63125,2019,Febrero,Surinam,0,1,,1,-69.941498,4.191162
63126,2019,Febrero,Surinam,10,18,,28,-74.140516,4.697157
63127,2019,Febrero,Tailandia,0,1,,1,-75.527794,10.406342
63128,2019,Febrero,Tailandia,4,3,,7,-75.516486,10.446304
63129,2019,Febrero,Tailandia,1,1,,2,-76.532004,3.451668
63130,2019,Febrero,Tailandia,15,16,,31,-74.140516,4.697157
63131,2019,Febrero,Tailandia,1,0,,1,-75.42726,6.170465
63132,2019,Febrero,Tanzania,0,1,,1,-75.516486,10.446304
63133,2019,Febrero,Tanzania,3,0,,3,-74.140516,4.697157
63134,2019,Febrero,Togo,0,1,,1,-76.532004,3.451668
63135,2019,Febrero,Togo,0,2,,2,-74.140516,4.697157
63136,2019,Febrero,Trinidad y Tobago,0,1,,1,-76.876446,0.33002
63137,2019,Febrero,Trinidad y Tobago,2,13,,15,-75.516486,10.446304
63138,2019,Febrero,Trinidad y Tobago,1,4,,5,-74.77647900000001,10.886686
63139,2019,Febrero,Trinidad y Tobago,4,11,,15,-76.532004,3.451668
63140,2019,Febrero,Trinidad y Tobago,25,46,,71,-74.140516,4.697157
63141,2019,Febrero,Trinidad y Tobago,1,7,,8,-75.42726,6.170465
63142,2019,Febrero,Trinidad y Tobago,0,2,,2,-73.181317,7.1280470000000005
63143,2019,Febrero,Túnez,1,0,,1,-69.941498,4.191162
63144,2019,Febrero,Túnez,1,1,,2,-75.516486,10.446304
63145,2019,Febrero,Túnez,0,7,,7,-74.140516,4.697157
63146,2019,Febrero,Túnez,1,0,,1,-72.453013,7.819
63147,2019,Febrero,Turquía,0,1,,1,-69.94143100000001,4.214082
63148,2019,Febrero,Turquía,4,6,,10,-77.35600000000001,0.81488
63149,2019,Febrero,Turquía,1,1,,2,-75.527794,10.406342
63150,2019,Febrero,Turquía,6,13,,19,-75.516486,10.446304
63151,2019,Febrero,Turquía,0,1,,1,-74.77647900000001,10.886686
63152,2019,Febrero,Turquía,0,1,,1,-72.129595,11.360028999999999
63153,2019,Febrero,Turquía,0,1,,1,-81.70216500000001,12.5862
63154,2019,Febrero,Turquía,1,8,,9,-76.532004,3.451668
63155,2019,Febrero,Turquía,158,395,,553,-74.140516,4.697157
63156,2019,Febrero,Turquía,9,14,,23,-75.42726,6.170465
63157,2019,Febrero,Turkmenistán,0,1,,1,-74.140516,4.697157
63158,2019,Febrero,Ucrania,1,1,,2,-77.35600000000001,0.81488
63159,2019,Febrero,Ucrania,0,16,,16,-75.527794,10.406342
63160,2019,Febrero,Ucrania,4,6,,10,-75.516486,10.446304
63161,2019,Febrero,Ucrania,0,1,,1,-74.77647900000001,10.886686
63162,2019,Febrero,Ucrania,0,2,,2,-74.765343,10.970933
63163,2019,Febrero,Ucrania,1,6,,7,-76.532004,3.451668
63164,2019,Febrero,Ucrania,0,8,,8,-77.061029,3.8844260000000004
63165,2019,Febrero,Ucrania,23,34,,57,-74.140516,4.697157
63166,2019,Febrero,Ucrania,8,2,,10,-75.42726,6.170465
63167,2019,Febrero,Ucrania,0,1,,1,-75.68164200000001,9.402597
63168,2019,Febrero,Uganda,0,1,,1,-77.35600000000001,0.81488
63169,2019,Febrero,Uganda,1,0,,1,-75.516486,10.446304
63170,2019,Febrero,Uganda,1,0,,1,-76.532004,3.451668
63171,2019,Febrero,Uganda,0,2,,2,-74.140516,4.697157
63172,2019,Febrero,Uruguay,0,2,,2,-69.941498,4.191162
63173,2019,Febrero,Uruguay,0,1,,1,-69.94143100000001,4.214082
63174,2019,Febrero,Uruguay,7,9,,16,-77.35600000000001,0.81488
63175,2019,Febrero,Uruguay,62,40,,102,-75.527794,10.406342
63176,2019,Febrero,Uruguay,105,92,,197,-75.516486,10.446304
63177,2019,Febrero,Uruguay,3,4,,7,-74.77647900000001,10.886686
63178,2019,Febrero,Uruguay,1,3,,4,-72.129595,11.360028999999999
63179,2019,Febrero,Uruguay,18,13,,31,-81.70216500000001,12.5862
63180,2019,Febrero,Uruguay,28,47,,75,-76.532004,3.451668
63181,2019,Febrero,Uruguay,480,546,,1026,-74.140516,4.697157
63182,2019,Febrero,Uruguay,58,83,,141,-75.42726,6.170465
63183,2019,Febrero,Uruguay,0,1,,1,-70.74025300000001,7.088728999999999
63184,2019,Febrero,Uruguay,0,1,,1,-73.181317,7.1280470000000005
63185,2019,Febrero,Uruguay,0,4,,4,-72.453013,7.819
63186,2019,Febrero,Uruguay,0,1,,1,-72.409396,8.36068
63187,2019,Febrero,Uzbekistán,0,1,,1,-74.140516,4.697157
63188,2019,Febrero,Venezuela,2,6,,8,-69.941498,4.191162
63189,2019,Febrero,Venezuela,2,1,,3,-69.94143100000001,4.214082
63190,2019,Febrero,Venezuela,0,1,,1,-74.78366,0.18595699999999998
63191,2019,Febrero,Venezuela,49,67,,116,-76.876446,0.33002
63192,2019,Febrero,Venezuela,3526,3604,,7130,-77.35600000000001,0.81488
63193,2019,Febrero,Venezuela,1,0,,1,-78.802679,18.00143
63194,2019,Febrero,Venezuela,22,19,,41,-75.527794,10.406342
63195,2019,Febrero,Venezuela,246,289,,535,-75.516486,10.446304
63196,2019,Febrero,Venezuela,119,158,,277,-74.77647900000001,10.886686
63197,2019,Febrero,Venezuela,0,1,,1,-74.765343,10.970933
63198,2019,Febrero,Venezuela,3,8,,11,-74.232675,11.117206
63199,2019,Febrero,Venezuela,4402,4160,,8562,-72.129595,11.360028999999999
63200,2019,Febrero,Venezuela,0,1,,1,-71.983761,12.165168
63201,2019,Febrero,Venezuela,5,2,,7,-81.70216500000001,12.5862
63202,2019,Febrero,Venezuela,238,275,,513,-76.532004,3.451668
63203,2019,Febrero,Venezuela,23,17,,40,-67.927521,3.866713
63204,2019,Febrero,Venezuela,6000,5983,,11983,-74.140516,4.697157
63205,2019,Febrero,Venezuela,19,15,,34,-75.736374,4.815189
63206,2019,Febrero,Venezuela,781,790,,1571,-75.42726,6.170465
63207,2019,Febrero,Venezuela,39,30,,69,-67.48402800000001,6.185536
63208,2019,Febrero,Venezuela,662,603,,1265,-70.74025300000001,7.088728999999999
63209,2019,Febrero,Venezuela,12,12,,24,-73.181317,7.1280470000000005
63210,2019,Febrero,Venezuela,20665,17554,,38219,-72.453013,7.819
63211,2019,Febrero,Venezuela,18,40,,58,-72.508188,7.927233
63212,2019,Febrero,Venezuela,1636,1283,,2919,-72.409396,8.36068
63213,2019,Febrero,Vietnam,0,1,,1,-75.527794,10.406342
63214,2019,Febrero,Vietnam,0,1,,1,-75.516486,10.446304
63215,2019,Febrero,Vietnam,4,2,,6,-74.140516,4.697157
63216,2019,Febrero,Vietnam,0,1,,1,-75.42726,6.170465
63217,2019,Febrero,Islas Vírgenes Británicas/Territorio Británico de Ultramar,0,2,,2,-75.42726,6.170465
63218,2019,Febrero,República Árabe de Yemen,0,1,,1,-74.140516,4.697157
63219,2019,Febrero,Zambia,0,2,,2,-74.140516,4.697157
63220,2019,Febrero,Zambia,0,2,,2,-75.42726,6.170465
63221,2019,Febrero,Zimbabue,1,2,,3,-74.140516,4.697157
63222,2019,Febrero,Anguila/Territorio Británico de Ultramar,0,1,,1,-74.140516,4.697157
63223,2019,Febrero,Refugiado,2,4,,6,-74.140516,4.697157
63224,2019,Febrero,Desconocido,2,6,,8,-75.516486,10.446304
63225,2019,Febrero,Desconocido,4,1,,5,-76.532004,3.451668
63226,2019,Febrero,Desconocido,78,126,,204,-74.140516,4.697157
63227,2019,Febrero,Desconocido,1,2,,3,-75.42726,6.170465
63228,2019,Febrero,Desconocido,0,1,,1,-72.453013,7.819
63229,2019,Febrero,Desconocido,0,1,,1,-74.140516,4.697157
63230,2019,Marzo,Afganistán,1,0,,1,-75.516486,10.446304
63231,2019,Marzo,Afganistán,0,1,,1,-74.77647900000001,10.886686
63232,2019,Marzo,Afganistán,0,3,,3,-74.140516,4.697157
63233,2019,Marzo,Albania,0,2,,2,-77.35600000000001,0.81488
63234,2019,Marzo,Albania,0,1,,1,-75.516486,10.446304
63235,2019,Marzo,Albania,1,1,,2,-74.77647900000001,10.886686
63236,2019,Marzo,Albania,0,1,,1,-76.532004,3.451668
63237,2019,Marzo,Albania,2,30,,32,-74.140516,4.697157
63238,2019,Marzo,Albania,2,1,,3,-75.42726,6.170465
63239,2019,Marzo,Alemania,5,13,,18,-69.941498,4.191162
63240,2019,Marzo,Alemania,24,20,,44,-69.94143100000001,4.214082
63241,2019,Marzo,Alemania,5,9,,14,-76.876446,0.33002
63242,2019,Marzo,Alemania,1,0,,1,-77.84700600000001,0.8124359999999999
63243,2019,Marzo,Alemania,112,152,,264,-77.35600000000001,0.81488
63244,2019,Marzo,Alemania,68,72,,140,-75.527794,10.406342
63245,2019,Marzo,Alemania,153,229,,382,-75.516486,10.446304
63246,2019,Marzo,Alemania,23,44,,67,-74.77647900000001,10.886686
63247,2019,Marzo,Alemania,1,1,,2,-74.232675,11.117206
63248,2019,Marzo,Alemania,2,2,,4,-74.213989,11.247722999999999
63249,2019,Marzo,Alemania,3,1,,4,-72.129595,11.360028999999999
63250,2019,Marzo,Alemania,1,1,,2,-81.703935,12.574411099999999
63251,2019,Marzo,Alemania,5,7,,12,-81.70216500000001,12.5862
63252,2019,Marzo,Alemania,0,2,,2,-81.372937,13.338761300000002
63253,2019,Marzo,Alemania,75,100,,175,-76.532004,3.451668
63254,2019,Marzo,Alemania,3,2,,5,-75.76635300000001,4.45285
63255,2019,Marzo,Alemania,2888,3754,,6642,-74.140516,4.697157
63256,2019,Marzo,Alemania,7,13,,20,-75.736374,4.815189
63257,2019,Marzo,Alemania,184,306,,490,-75.42726,6.170465
63258,2019,Marzo,Alemania,0,1,,1,-67.48402800000001,6.185536
63259,2019,Marzo,Alemania,0,2,,2,-73.181317,7.1280470000000005
63260,2019,Marzo,Alemania,3,6,,9,-72.453013,7.819
63261,2019,Marzo,Alemania,17,18,,35,-77.35002,8.63337
63262,2019,Marzo,Alemania,0,4,,4,-75.68164200000001,9.402597
63263,2019,Marzo,Andorra,0,1,,1,-77.35600000000001,0.81488
63264,2019,Marzo,Andorra,9,9,,18,-74.140516,4.697157
63265,2019,Marzo,Andorra,0,1,,1,-75.42726,6.170465
63266,2019,Marzo,Angola,0,2,,2,-74.140516,4.697157
63267,2019,Marzo,Antigua y Barbuda,0,1,,1,-74.140516,4.697157
63268,2019,Marzo,Arabia Saudita,2,2,,4,-75.516486,10.446304
63269,2019,Marzo,Arabia Saudita,0,2,,2,-74.77647900000001,10.886686
63270,2019,Marzo,Arabia Saudita,7,11,,18,-74.140516,4.697157
63271,2019,Marzo,Arabia Saudita,0,2,,2,-75.42726,6.170465
63272,2019,Marzo,Argelia,1,0,,1,-75.516486,10.446304
63273,2019,Marzo,Argelia,1,1,,2,-76.532004,3.451668
63274,2019,Marzo,Argelia,2,3,,5,-74.140516,4.697157
63275,2019,Marzo,Argelia,0,1,,1,-75.42726,6.170465
63276,2019,Marzo,Argentina,6,4,,10,-69.941498,4.191162
63277,2019,Marzo,Argentina,2,6,,8,-69.94143100000001,4.214082
63278,2019,Marzo,Argentina,9,8,,17,-76.876446,0.33002
63279,2019,Marzo,Argentina,106,158,,264,-77.35600000000001,0.81488
63280,2019,Marzo,Argentina,394,279,,673,-75.527794,10.406342
63281,2019,Marzo,Argentina,2977,2295,,5272,-75.516486,10.446304
63282,2019,Marzo,Argentina,19,33,,52,-74.77647900000001,10.886686
63283,2019,Marzo,Argentina,0,1,,1,-74.232675,11.117206
63284,2019,Marzo,Argentina,2,6,,8,-72.129595,11.360028999999999
63285,2019,Marzo,Argentina,290,234,,524,-81.70216500000001,12.5862
63286,2019,Marzo,Argentina,136,172,,308,-76.532004,3.451668
63287,2019,Marzo,Argentina,1,0,,1,-75.76635300000001,4.45285
63288,2019,Marzo,Argentina,6106,7095,,13201,-74.140516,4.697157
63289,2019,Marzo,Argentina,6,17,,23,-75.736374,4.815189
63290,2019,Marzo,Argentina,340,494,,834,-75.42726,6.170465
63291,2019,Marzo,Argentina,1,1,,2,-70.74025300000001,7.088728999999999
63292,2019,Marzo,Argentina,0,4,,4,-73.181317,7.1280470000000005
63293,2019,Marzo,Argentina,1,3,,4,-72.453013,7.819
63294,2019,Marzo,Argentina,1,3,,4,-72.409396,8.36068
63295,2019,Marzo,Argentina,1,2,,3,-77.35002,8.63337
63296,2019,Marzo,Argentina,0,2,,2,-75.68164200000001,9.402597
63297,2019,Marzo,República de Armenia,1,0,,1,-75.516486,10.446304
63298,2019,Marzo,República de Armenia,1,1,,2,-74.140516,4.697157
63299,2019,Marzo,Australia,1,2,,3,-69.941498,4.191162
63300,2019,Marzo,Australia,3,3,,6,-69.94143100000001,4.214082
63301,2019,Marzo,Australia,0,1,,1,-76.876446,0.33002
63302,2019,Marzo,Australia,18,22,,40,-77.35600000000001,0.81488
63303,2019,Marzo,Australia,5,13,,18,-75.527794,10.406342
63304,2019,Marzo,Australia,53,69,,122,-75.516486,10.446304
63305,2019,Marzo,Australia,10,11,,21,-74.77647900000001,10.886686
63306,2019,Marzo,Australia,1,1,,2,-74.213989,11.247722999999999
63307,2019,Marzo,Australia,0,1,,1,-72.129595,11.360028999999999
63308,2019,Marzo,Australia,0,1,,1,-81.703935,12.574411099999999
63309,2019,Marzo,Australia,0,2,,2,-81.70216500000001,12.5862
63310,2019,Marzo,Australia,1,2,,3,-81.372937,13.338761300000002
63311,2019,Marzo,Australia,7,22,,29,-76.532004,3.451668
63312,2019,Marzo,Australia,309,549,,858,-74.140516,4.697157
63313,2019,Marzo,Australia,1,0,,1,-75.736374,4.815189
63314,2019,Marzo,Australia,31,83,,114,-75.42726,6.170465
63315,2019,Marzo,Australia,0,1,,1,-72.453013,7.819
63316,2019,Marzo,Australia,17,20,,37,-77.35002,8.63337
63317,2019,Marzo,Australia,1,0,,1,-75.68164200000001,9.402597
63318,2019,Marzo,Austria,1,1,,2,-69.941498,4.191162
63319,2019,Marzo,Austria,2,3,,5,-69.94143100000001,4.214082
63320,2019,Marzo,Austria,2,4,,6,-76.876446,0.33002
63321,2019,Marzo,Austria,8,5,,13,-77.35600000000001,0.81488
63322,2019,Marzo,Austria,5,6,,11,-75.527794,10.406342
63323,2019,Marzo,Austria,14,18,,32,-75.516486,10.446304
63324,2019,Marzo,Austria,3,5,,8,-74.77647900000001,10.886686
63325,2019,Marzo,Austria,1,1,,2,-81.703935,12.574411099999999
63326,2019,Marzo,Austria,7,7,,14,-76.532004,3.451668
63327,2019,Marzo,Austria,238,277,,515,-74.140516,4.697157
63328,2019,Marzo,Austria,14,29,,43,-75.42726,6.170465
63329,2019,Marzo,Austria,0,1,,1,-73.181317,7.1280470000000005
63330,2019,Marzo,Austria,1,1,,2,-72.453013,7.819
63331,2019,Marzo,Austria,0,1,,1,-72.409396,8.36068
63332,2019,Marzo,Austria,3,1,,4,-77.35002,8.63337
63333,2019,Marzo,Azerbaiyán,0,1,,1,-77.35600000000001,0.81488
63334,2019,Marzo,Azerbaiyán,3,9,,12,-74.140516,4.697157
63335,2019,Marzo,Bahamas,5,3,,8,-75.516486,10.446304
63336,2019,Marzo,Bahamas,0,1,,1,-74.77647900000001,10.886686
63337,2019,Marzo,Bahamas,1,0,,1,-76.532004,3.451668
63338,2019,Marzo,Bahamas,4,6,,10,-74.140516,4.697157
63339,2019,Marzo,Bahamas,5,6,,11,-75.42726,6.170465
63340,2019,Marzo,Bahréin,0,2,,2,-74.140516,4.697157
63341,2019,Marzo,Bangladesh,0,1,,1,-75.516486,10.446304
63342,2019,Marzo,Bangladesh,3,4,,7,-74.140516,4.697157
63343,2019,Marzo,Bangladesh,0,1,,1,-77.35002,8.63337
63344,2019,Marzo,Barbados,0,1,,1,-75.516486,10.446304
63345,2019,Marzo,Barbados,1,1,,2,-76.532004,3.451668
63346,2019,Marzo,Barbados,9,10,,19,-74.140516,4.697157
63347,2019,Marzo,Barbados,0,2,,2,-75.42726,6.170465
63348,2019,Marzo,República de Belarús,1,1,,2,-76.532004,3.451668
63349,2019,Marzo,República de Belarús,5,12,,17,-74.140516,4.697157
63350,2019,Marzo,República de Belarús,2,0,,2,-72.453013,7.819
63351,2019,Marzo,Bélgica,1,2,,3,-69.94143100000001,4.214082
63352,2019,Marzo,Bélgica,1,0,,1,-76.876446,0.33002
63353,2019,Marzo,Bélgica,20,19,,39,-77.35600000000001,0.81488
63354,2019,Marzo,Bélgica,5,4,,9,-75.527794,10.406342
63355,2019,Marzo,Bélgica,33,39,,72,-75.516486,10.446304
63356,2019,Marzo,Bélgica,10,16,,26,-74.77647900000001,10.886686
63357,2019,Marzo,Bélgica,0,6,,6,-74.213989,11.247722999999999
63358,2019,Marzo,Bélgica,1,1,,2,-81.372937,13.338761300000002
63359,2019,Marzo,Bélgica,6,19,,25,-76.532004,3.451668
63360,2019,Marzo,Bélgica,256,444,,700,-74.140516,4.697157
63361,2019,Marzo,Bélgica,3,1,,4,-75.736374,4.815189
63362,2019,Marzo,Bélgica,22,53,,75,-75.42726,6.170465
63363,2019,Marzo,Bélgica,0,1,,1,-77.35002,8.63337
63364,2019,Marzo,Belice,0,1,,1,-75.516486,10.446304
63365,2019,Marzo,Belice,1,4,,5,-76.532004,3.451668
63366,2019,Marzo,Belice,5,14,,19,-74.140516,4.697157
63367,2019,Marzo,Belice,6,1,,7,-75.42726,6.170465
63368,2019,Marzo,Benín,0,1,,1,-74.140516,4.697157
63369,2019,Marzo,Benín,2,1,,3,-75.42726,6.170465
63370,2019,Marzo,Bermudas/Territorio Británico de Ultramar,2,2,,4,-75.516486,10.446304
63371,2019,Marzo,Bermudas/Territorio Británico de Ultramar,0,1,,1,-76.532004,3.451668
63372,2019,Marzo,Bermudas/Territorio Británico de Ultramar,0,1,,1,-74.140516,4.697157
63373,2019,Marzo,Bermudas/Territorio Británico de Ultramar,0,5,,5,-75.42726,6.170465
63374,2019,Marzo,Bolivia,0,2,,2,-69.941498,4.191162
63375,2019,Marzo,Bolivia,1,1,,2,-69.94143100000001,4.214082
63376,2019,Marzo,Bolivia,11,67,,78,-77.35600000000001,0.81488
63377,2019,Marzo,Bolivia,54,50,,104,-75.527794,10.406342
63378,2019,Marzo,Bolivia,150,102,,252,-75.516486,10.446304
63379,2019,Marzo,Bolivia,1,2,,3,-74.77647900000001,10.886686
63380,2019,Marzo,Bolivia,0,1,,1,-72.129595,11.360028999999999
63381,2019,Marzo,Bolivia,13,14,,27,-81.70216500000001,12.5862
63382,2019,Marzo,Bolivia,33,42,,75,-76.532004,3.451668
63383,2019,Marzo,Bolivia,530,645,,1175,-74.140516,4.697157
63384,2019,Marzo,Bolivia,1,2,,3,-75.736374,4.815189
63385,2019,Marzo,Bolivia,39,93,,132,-75.42726,6.170465
63386,2019,Marzo,Bolivia,1,1,,2,-72.453013,7.819
63387,2019,Marzo,Bosnia y Herzegovina,0,1,,1,-75.527794,10.406342
63388,2019,Marzo,Bosnia y Herzegovina,1,0,,1,-81.70216500000001,12.5862
63389,2019,Marzo,Bosnia y Herzegovina,6,8,,14,-74.140516,4.697157
63390,2019,Marzo,Bosnia y Herzegovina,2,0,,2,-75.42726,6.170465
63391,2019,Marzo,Brasil,122,117,,239,-69.941498,4.191162
63392,2019,Marzo,Brasil,3,3,,6,-69.94143100000001,4.214082
63393,2019,Marzo,Brasil,15,28,,43,-77.35600000000001,0.81488
63394,2019,Marzo,Brasil,475,319,,794,-75.527794,10.406342
63395,2019,Marzo,Brasil,1118,753,,1871,-75.516486,10.446304
63396,2019,Marzo,Brasil,20,102,,122,-74.77647900000001,10.886686
63397,2019,Marzo,Brasil,2,2,,4,-72.129595,11.360028999999999
63398,2019,Marzo,Brasil,1,3,,4,-81.703935,12.574411099999999
63399,2019,Marzo,Brasil,444,346,,790,-81.70216500000001,12.5862
63400,2019,Marzo,Brasil,87,119,,206,-76.532004,3.451668
63401,2019,Marzo,Brasil,0,2,,2,-67.927521,3.866713
63402,2019,Marzo,Brasil,1,1,,2,-75.76635300000001,4.45285
63403,2019,Marzo,Brasil,5369,6266,,11635,-74.140516,4.697157
63404,2019,Marzo,Brasil,3,9,,12,-75.736374,4.815189
63405,2019,Marzo,Brasil,173,316,,489,-75.42726,6.170465
63406,2019,Marzo,Brasil,0,3,,3,-73.181317,7.1280470000000005
63407,2019,Marzo,Brasil,0,1,,1,-72.453013,7.819
63408,2019,Marzo,Brasil,0,2,,2,-72.409396,8.36068
63409,2019,Marzo,Brasil,0,4,,4,-77.35002,8.63337
63410,2019,Marzo,Bulgaria,0,1,,1,-77.35600000000001,0.81488
63411,2019,Marzo,Bulgaria,6,3,,9,-75.516486,10.446304
63412,2019,Marzo,Bulgaria,1,1,,2,-74.77647900000001,10.886686
63413,2019,Marzo,Bulgaria,1,1,,2,-76.532004,3.451668
63414,2019,Marzo,Bulgaria,26,39,,65,-74.140516,4.697157
63415,2019,Marzo,Bulgaria,0,1,,1,-75.736374,4.815189
63416,2019,Marzo,Bulgaria,4,10,,14,-75.42726,6.170465
63417,2019,Marzo,Burkina Faso,0,1,,1,-74.140516,4.697157
63418,2019,Marzo,Islas Caimán/Territorio Británico de Ultramar,1,0,,1,-75.516486,10.446304
63419,2019,Marzo,Islas Caimán/Territorio Británico de Ultramar,3,0,,3,-74.77647900000001,10.886686
63420,2019,Marzo,Islas Caimán/Territorio Británico de Ultramar,1,0,,1,-81.70216500000001,12.5862
63421,2019,Marzo,Islas Caimán/Territorio Británico de Ultramar,2,0,,2,-76.532004,3.451668
63422,2019,Marzo,Islas Caimán/Territorio Británico de Ultramar,0,1,,1,-74.140516,4.697157
63423,2019,Marzo,Islas Caimán/Territorio Británico de Ultramar,1,0,,1,-75.42726,6.170465
63424,2019,Marzo,Camboya,0,1,,1,-74.140516,4.697157
63425,2019,Marzo,Camerún,1,3,,4,-75.516486,10.446304
63426,2019,Marzo,Camerún,1,0,,1,-76.532004,3.451668
63427,2019,Marzo,Camerún,3,5,,8,-74.140516,4.697157
63428,2019,Marzo,Canadá,2,3,,5,-69.941498,4.191162
63429,2019,Marzo,Canadá,1,4,,5,-69.94143100000001,4.214082
63430,2019,Marzo,Canadá,1,1,,2,-76.876446,0.33002
63431,2019,Marzo,Canadá,14,29,,43,-77.35600000000001,0.81488
63432,2019,Marzo,Canadá,109,87,,196,-75.527794,10.406342
63433,2019,Marzo,Canadá,1339,1427,,2766,-75.516486,10.446304
63434,2019,Marzo,Canadá,42,44,,86,-74.77647900000001,10.886686
63435,2019,Marzo,Canadá,2,2,,4,-74.232675,11.117206
63436,2019,Marzo,Canadá,0,1,,1,-74.213989,11.247722999999999
63437,2019,Marzo,Canadá,1,1,,2,-72.129595,11.360028999999999
63438,2019,Marzo,Canadá,2,5,,7,-81.703935,12.574411099999999
63439,2019,Marzo,Canadá,269,234,,503,-81.70216500000001,12.5862
63440,2019,Marzo,Canadá,3,3,,6,-81.372937,13.338761300000002
63441,2019,Marzo,Canadá,115,134,,249,-76.532004,3.451668
63442,2019,Marzo,Canadá,2,1,,3,-75.76635300000001,4.45285
63443,2019,Marzo,Canadá,1805,2561,,4366,-74.140516,4.697157
63444,2019,Marzo,Canadá,9,17,,26,-75.736374,4.815189
63445,2019,Marzo,Canadá,242,494,,736,-75.42726,6.170465
63446,2019,Marzo,Canadá,3,9,,12,-73.181317,7.1280470000000005
63447,2019,Marzo,Canadá,0,1,,1,-72.453013,7.819
63448,2019,Marzo,Canadá,13,12,,25,-77.35002,8.63337
63449,2019,Marzo,Chad,0,1,,1,-74.140516,4.697157
63450,2019,Marzo,República Del Congo,0,1,,1,-74.140516,4.697157
63451,2019,Marzo,República Democrática del Congo,5,2,,7,-74.140516,4.697157
63452,2019,Marzo,República de Corea,1,3,,4,-69.941498,4.191162
63453,2019,Marzo,República de Corea,10,14,,24,-77.35600000000001,0.81488
63454,2019,Marzo,República de Corea,13,17,,30,-75.516486,10.446304
63455,2019,Marzo,República de Corea,1,4,,5,-74.77647900000001,10.886686
63456,2019,Marzo,República de Corea,0,1,,1,-74.213989,11.247722999999999
63457,2019,Marzo,República de Corea,3,5,,8,-76.532004,3.451668
63458,2019,Marzo,República de Corea,240,474,,714,-74.140516,4.697157
63459,2019,Marzo,República de Corea,13,38,,51,-75.42726,6.170465
63460,2019,Marzo,Costa de Marfil,1,1,,2,-74.140516,4.697157
63461,2019,Marzo,Costa de Marfil,0,3,,3,-75.42726,6.170465
63462,2019,Marzo,Costa Rica,0,3,,3,-69.94143100000001,4.214082
63463,2019,Marzo,Costa Rica,0,6,,6,-78.802679,18.00143
63464,2019,Marzo,Costa Rica,210,151,,361,-75.516486,10.446304
63465,2019,Marzo,Costa Rica,24,19,,43,-74.77647900000001,10.886686
63466,2019,Marzo,Costa Rica,0,4,,4,-72.129595,11.360028999999999
63467,2019,Marzo,Costa Rica,51,45,,96,-81.70216500000001,12.5862
63468,2019,Marzo,Costa Rica,38,61,,99,-76.532004,3.451668
63469,2019,Marzo,Costa Rica,1,0,,1,-75.76635300000001,4.45285
63470,2019,Marzo,Costa Rica,1008,1246,,2254,-74.140516,4.697157
63471,2019,Marzo,Costa Rica,2,9,,11,-75.736374,4.815189
63472,2019,Marzo,Costa Rica,106,170,,276,-75.42726,6.170465
63473,2019,Marzo,Costa Rica,1,3,,4,-73.181317,7.1280470000000005
63474,2019,Marzo,Costa Rica,0,3,,3,-72.409396,8.36068
63475,2019,Marzo,Croacia,0,1,,1,-77.35600000000001,0.81488
63476,2019,Marzo,Croacia,0,2,,2,-75.527794,10.406342
63477,2019,Marzo,Croacia,4,6,,10,-75.516486,10.446304
63478,2019,Marzo,Croacia,0,3,,3,-74.765343,10.970933
63479,2019,Marzo,Croacia,32,41,,73,-74.140516,4.697157
63480,2019,Marzo,Croacia,3,5,,8,-75.42726,6.170465
63481,2019,Marzo,Croacia,1,1,,2,-77.35002,8.63337
63482,2019,Marzo,Cuba,0,9,,9,-77.35600000000001,0.81488
63483,2019,Marzo,Cuba,0,11,,11,-78.802679,18.00143
63484,2019,Marzo,Cuba,12,18,,30,-75.516486,10.446304
63485,2019,Marzo,Cuba,7,22,,29,-74.77647900000001,10.886686
63486,2019,Marzo,Cuba,1,0,,1,-72.129595,11.360028999999999
63487,2019,Marzo,Cuba,29,29,,58,-76.532004,3.451668
63488,2019,Marzo,Cuba,0,1,,1,-75.76635300000001,4.45285
63489,2019,Marzo,Cuba,182,348,,530,-74.140516,4.697157
63490,2019,Marzo,Cuba,1,2,,3,-75.736374,4.815189
63491,2019,Marzo,Cuba,15,29,,44,-75.42726,6.170465
63492,2019,Marzo,Cuba,1,1,,2,-72.453013,7.819
63493,2019,Marzo,República Checa,0,1,,1,-69.94143100000001,4.214082
63494,2019,Marzo,República Checa,0,1,,1,-77.84700600000001,0.8124359999999999
63495,2019,Marzo,República Checa,3,8,,11,-77.35600000000001,0.81488
63496,2019,Marzo,República Checa,1,5,,6,-75.527794,10.406342
63497,2019,Marzo,República Checa,8,18,,26,-75.516486,10.446304
63498,2019,Marzo,República Checa,0,1,,1,-76.532004,3.451668
63499,2019,Marzo,República Checa,120,195,,315,-74.140516,4.697157
63500,2019,Marzo,República Checa,8,15,,23,-75.42726,6.170465
63501,2019,Marzo,República Checa,2,1,,3,-77.35002,8.63337
63502,2019,Marzo,Chile,1,0,,1,-69.941498,4.191162
63503,2019,Marzo,Chile,3,1,,4,-69.94143100000001,4.214082
63504,2019,Marzo,Chile,3,1,,4,-76.876446,0.33002
63505,2019,Marzo,Chile,42,77,,119,-77.35600000000001,0.81488
63506,2019,Marzo,Chile,273,182,,455,-75.527794,10.406342
63507,2019,Marzo,Chile,627,432,,1059,-75.516486,10.446304
63508,2019,Marzo,Chile,16,32,,48,-74.77647900000001,10.886686
63509,2019,Marzo,Chile,1,4,,5,-74.232675,11.117206
63510,2019,Marzo,Chile,0,5,,5,-74.213989,11.247722999999999
63511,2019,Marzo,Chile,2,3,,5,-72.129595,11.360028999999999
63512,2019,Marzo,Chile,345,261,,606,-81.70216500000001,12.5862
63513,2019,Marzo,Chile,125,174,,299,-76.532004,3.451668
63514,2019,Marzo,Chile,0,2,,2,-75.76635300000001,4.45285
63515,2019,Marzo,Chile,4080,4998,,9078,-74.140516,4.697157
63516,2019,Marzo,Chile,2,6,,8,-75.736374,4.815189
63517,2019,Marzo,Chile,88,207,,295,-75.42726,6.170465
63518,2019,Marzo,Chile,0,1,,1,-70.74025300000001,7.088728999999999
63519,2019,Marzo,Chile,8,13,,21,-72.453013,7.819
63520,2019,Marzo,Chile,0,2,,2,-72.409396,8.36068
63521,2019,Marzo,Chile,0,1,,1,-77.35002,8.63337
63522,2019,Marzo,China,2,1,,3,-69.941498,4.191162
63523,2019,Marzo,China,1,1,,2,-69.94143100000001,4.214082
63524,2019,Marzo,China,12,6,,18,-77.35600000000001,0.81488
63525,2019,Marzo,China,1,2,,3,-75.527794,10.406342
63526,2019,Marzo,China,51,26,,77,-75.516486,10.446304
63527,2019,Marzo,China,7,12,,19,-74.77647900000001,10.886686
63528,2019,Marzo,China,0,10,,10,-74.765343,10.970933
63529,2019,Marzo,China,9,16,,25,-76.532004,3.451668
63530,2019,Marzo,China,0,4,,4,-77.061029,3.8844260000000004
63531,2019,Marzo,China,525,1109,,1634,-74.140516,4.697157
63532,2019,Marzo,China,0,1,,1,-75.736374,4.815189
63533,2019,Marzo,China,65,124,,189,-75.42726,6.170465
63534,2019,Marzo,China,0,7,,7,-72.453013,7.819
63535,2019,Marzo,China,0,1,,1,-77.35002,8.63337
63536,2019,Marzo,Taiwán,0,1,,1,-69.94143100000001,4.214082
63537,2019,Marzo,Taiwán,1,2,,3,-77.35600000000001,0.81488
63538,2019,Marzo,Taiwán,3,1,,4,-75.527794,10.406342
63539,2019,Marzo,Taiwán,10,9,,19,-75.516486,10.446304
63540,2019,Marzo,Taiwán,1,1,,2,-74.77647900000001,10.886686
63541,2019,Marzo,Taiwán,0,1,,1,-81.70216500000001,12.5862
63542,2019,Marzo,Taiwán,1,3,,4,-76.532004,3.451668
63543,2019,Marzo,Taiwán,99,110,,209,-74.140516,4.697157
63544,2019,Marzo,Taiwán,7,13,,20,-75.42726,6.170465
63545,2019,Marzo,Chipre,2,0,,2,-75.516486,10.446304
63546,2019,Marzo,Chipre,5,20,,25,-74.140516,4.697157
63547,2019,Marzo,Dinamarca,0,3,,3,-76.876446,0.33002
63548,2019,Marzo,Dinamarca,10,5,,15,-77.35600000000001,0.81488
63549,2019,Marzo,Dinamarca,5,5,,10,-75.527794,10.406342
63550,2019,Marzo,Dinamarca,32,39,,71,-75.516486,10.446304
63551,2019,Marzo,Dinamarca,0,2,,2,-74.77647900000001,10.886686
63552,2019,Marzo,Dinamarca,5,9,,14,-74.213989,11.247722999999999
63553,2019,Marzo,Dinamarca,2,2,,4,-81.703935,12.574411099999999
63554,2019,Marzo,Dinamarca,1,0,,1,-81.70216500000001,12.5862
63555,2019,Marzo,Dinamarca,11,14,,25,-76.532004,3.451668
63556,2019,Marzo,Dinamarca,0,1,,1,-77.061029,3.8844260000000004
63557,2019,Marzo,Dinamarca,0,1,,1,-75.76635300000001,4.45285
63558,2019,Marzo,Dinamarca,199,262,,461,-74.140516,4.697157
63559,2019,Marzo,Dinamarca,0,1,,1,-75.736374,4.815189
63560,2019,Marzo,Dinamarca,8,26,,34,-75.42726,6.170465
63561,2019,Marzo,Dinamarca,0,1,,1,-77.35002,8.63337
63562,2019,Marzo,Dominica,0,1,,1,-76.532004,3.451668
63563,2019,Marzo,Dominica,1,5,,6,-74.140516,4.697157
63564,2019,Marzo,Dominica,0,1,,1,-75.736374,4.815189
63565,2019,Marzo,Dominica,0,1,,1,-75.42726,6.170465
63566,2019,Marzo,Ecuador,0,1,,1,-69.941498,4.191162
63567,2019,Marzo,Ecuador,0,3,,3,-69.94143100000001,4.214082
63568,2019,Marzo,Ecuador,0,1,,1,-74.78366,0.18595699999999998
63569,2019,Marzo,Ecuador,77,276,,353,-76.876446,0.33002
63570,2019,Marzo,Ecuador,0,1,,1,-77.84700600000001,0.8124359999999999
63571,2019,Marzo,Ecuador,1675,2130,,3805,-77.35600000000001,0.81488
63572,2019,Marzo,Ecuador,33,20,,53,-78.802679,18.00143
63573,2019,Marzo,Ecuador,53,48,,101,-75.527794,10.406342
63574,2019,Marzo,Ecuador,651,479,,1130,-75.516486,10.446304
63575,2019,Marzo,Ecuador,30,28,,58,-74.77647900000001,10.886686
63576,2019,Marzo,Ecuador,0,1,,1,-74.232675,11.117206
63577,2019,Marzo,Ecuador,4,5,,9,-72.129595,11.360028999999999
63578,2019,Marzo,Ecuador,32,25,,57,-81.70216500000001,12.5862
63579,2019,Marzo,Ecuador,758,769,,1527,-76.532004,3.451668
63580,2019,Marzo,Ecuador,0,2,,2,-67.927521,3.866713
63581,2019,Marzo,Ecuador,0,2,,2,-75.76635300000001,4.45285
63582,2019,Marzo,Ecuador,2826,3545,,6371,-74.140516,4.697157
63583,2019,Marzo,Ecuador,10,17,,27,-75.736374,4.815189
63584,2019,Marzo,Ecuador,59,102,,161,-75.42726,6.170465
63585,2019,Marzo,Ecuador,0,1,,1,-70.74025300000001,7.088728999999999
63586,2019,Marzo,Ecuador,1,3,,4,-73.181317,7.1280470000000005
63587,2019,Marzo,Ecuador,38,66,,104,-72.453013,7.819
63588,2019,Marzo,Ecuador,0,1,,1,-72.409396,8.36068
63589,2019,Marzo,Ecuador,1,0,,1,-77.35002,8.63337
63590,2019,Marzo,Egipto,0,1,,1,-72.129595,11.360028999999999
63591,2019,Marzo,Egipto,0,2,,2,-76.532004,3.451668
63592,2019,Marzo,Egipto,3,23,,26,-74.140516,4.697157
63593,2019,Marzo,El Salvador,0,1,,1,-77.35600000000001,0.81488
63594,2019,Marzo,El Salvador,1,2,,3,-75.527794,10.406342
63595,2019,Marzo,El Salvador,220,181,,401,-75.516486,10.446304
63596,2019,Marzo,El Salvador,2,5,,7,-74.77647900000001,10.886686
63597,2019,Marzo,El Salvador,1,2,,3,-81.70216500000001,12.5862
63598,2019,Marzo,El Salvador,80,100,,180,-76.532004,3.451668
63599,2019,Marzo,El Salvador,1,2,,3,-75.76635300000001,4.45285
63600,2019,Marzo,El Salvador,502,691,,1193,-74.140516,4.697157
63601,2019,Marzo,El Salvador,1,2,,3,-75.736374,4.815189
63602,2019,Marzo,El Salvador,33,48,,81,-75.42726,6.170465
63603,2019,Marzo,Emiratos Árabes,1,2,,3,-75.516486,10.446304
63604,2019,Marzo,Emiratos Árabes,7,55,,62,-74.140516,4.697157
63605,2019,Marzo,Emiratos Árabes,2,0,,2,-75.42726,6.170465
63606,2019,Marzo,España,0,3,,3,-69.941498,4.191162
63607,2019,Marzo,España,10,12,,22,-69.94143100000001,4.214082
63608,2019,Marzo,España,4,2,,6,-76.876446,0.33002
63609,2019,Marzo,España,37,45,,82,-77.35600000000001,0.81488
63610,2019,Marzo,España,0,1,,1,-78.802679,18.00143
63611,2019,Marzo,España,47,237,,284,-75.527794,10.406342
63612,2019,Marzo,España,138,183,,321,-75.516486,10.446304
63613,2019,Marzo,España,18,64,,82,-74.77647900000001,10.886686
63614,2019,Marzo,España,0,1,,1,-74.765343,10.970933
63615,2019,Marzo,España,0,2,,2,-74.232675,11.117206
63616,2019,Marzo,España,2,2,,4,-74.213989,11.247722999999999
63617,2019,Marzo,España,7,14,,21,-72.129595,11.360028999999999
63618,2019,Marzo,España,8,8,,16,-81.70216500000001,12.5862
63619,2019,Marzo,España,172,301,,473,-76.532004,3.451668
63620,2019,Marzo,España,1,0,,1,-75.76635300000001,4.45285
63621,2019,Marzo,España,2743,5859,,8602,-74.140516,4.697157
63622,2019,Marzo,España,2,17,,19,-75.736374,4.815189
63623,2019,Marzo,España,304,612,,916,-75.42726,6.170465
63624,2019,Marzo,España,0,1,,1,-73.181317,7.1280470000000005
63625,2019,Marzo,España,21,31,,52,-72.453013,7.819
63626,2019,Marzo,España,0,2,,2,-72.508188,7.927233
63627,2019,Marzo,España,4,8,,12,-72.409396,8.36068
63628,2019,Marzo,España,3,2,,5,-77.35002,8.63337
63629,2019,Marzo,Eritrea,1,2,,3,-74.140516,4.697157
63630,2019,Marzo,Eslovaquia,0,1,,1,-69.941498,4.191162
63631,2019,Marzo,Eslovaquia,1,1,,2,-77.35600000000001,0.81488
63632,2019,Marzo,Eslovaquia,2,2,,4,-75.527794,10.406342
63633,2019,Marzo,Eslovaquia,3,9,,12,-75.516486,10.446304
63634,2019,Marzo,Eslovaquia,0,2,,2,-76.532004,3.451668
63635,2019,Marzo,Eslovaquia,64,104,,168,-74.140516,4.697157
63636,2019,Marzo,Eslovaquia,6,6,,12,-75.42726,6.170465
63637,2019,Marzo,Eslovaquia,1,0,,1,-72.453013,7.819
63638,2019,Marzo,Eslovaquia,0,1,,1,-77.35002,8.63337
63639,2019,Marzo,Eslovenia,2,3,,5,-77.35600000000001,0.81488
63640,2019,Marzo,Eslovenia,0,2,,2,-75.527794,10.406342
63641,2019,Marzo,Eslovenia,1,1,,2,-75.516486,10.446304
63642,2019,Marzo,Eslovenia,0,1,,1,-76.532004,3.451668
63643,2019,Marzo,Eslovenia,27,44,,71,-74.140516,4.697157
63644,2019,Marzo,Eslovenia,1,2,,3,-75.42726,6.170465
63645,2019,Marzo,Estados Unidos de América,22,22,,44,-69.941498,4.191162
63646,2019,Marzo,Estados Unidos de América,7,19,,26,-69.94143100000001,4.214082
63647,2019,Marzo,Estados Unidos de América,1,4,,5,-76.876446,0.33002
63648,2019,Marzo,Estados Unidos de América,42,64,,106,-77.35600000000001,0.81488
63649,2019,Marzo,Estados Unidos de América,57,90,,147,-75.527794,10.406342
63650,2019,Marzo,Estados Unidos de América,7668,8750,,16418,-75.516486,10.446304
63651,2019,Marzo,Estados Unidos de América,826,1328,,2154,-74.77647900000001,10.886686
63652,2019,Marzo,Estados Unidos de América,1,1,,2,-74.765343,10.970933
63653,2019,Marzo,Estados Unidos de América,47,67,,114,-74.232675,11.117206
63654,2019,Marzo,Estados Unidos de América,5,6,,11,-74.213989,11.247722999999999
63655,2019,Marzo,Estados Unidos de América,15,17,,32,-72.129595,11.360028999999999
63656,2019,Marzo,Estados Unidos de América,23,24,,47,-81.703935,12.574411099999999
63657,2019,Marzo,Estados Unidos de América,76,48,,124,-81.70216500000001,12.5862
63658,2019,Marzo,Estados Unidos de América,2,5,,7,-81.372937,13.338761300000002
63659,2019,Marzo,Estados Unidos de América,1892,2424,,4316,-76.532004,3.451668
63660,2019,Marzo,Estados Unidos de América,161,244,,405,-75.76635300000001,4.45285
63661,2019,Marzo,Estados Unidos de América,12556,19434,,31990,-74.140516,4.697157
63662,2019,Marzo,Estados Unidos de América,291,460,,751,-75.736374,4.815189
63663,2019,Marzo,Estados Unidos de América,3791,8381,,12172,-75.42726,6.170465
63664,2019,Marzo,Estados Unidos de América,1,0,,1,-75.586989,6.2188349999999994
63665,2019,Marzo,Estados Unidos de América,34,76,,110,-73.181317,7.1280470000000005
63666,2019,Marzo,Estados Unidos de América,11,7,,18,-72.453013,7.819
63667,2019,Marzo,Estados Unidos de América,5,16,,21,-72.508188,7.927233
63668,2019,Marzo,Estados Unidos de América,3,4,,7,-72.409396,8.36068
63669,2019,Marzo,Estados Unidos de América,15,11,,26,-77.35002,8.63337
63670,2019,Marzo,Estonia,0,1,,1,-75.516486,10.446304
63671,2019,Marzo,Estonia,0,1,,1,-74.213989,11.247722999999999
63672,2019,Marzo,Estonia,0,1,,1,-76.532004,3.451668
63673,2019,Marzo,Estonia,24,36,,60,-74.140516,4.697157
63674,2019,Marzo,Estonia,2,3,,5,-75.42726,6.170465
63675,2019,Marzo,Etiopia,0,1,,1,-75.527794,10.406342
63676,2019,Marzo,Etiopia,0,1,,1,-75.516486,10.446304
63677,2019,Marzo,Etiopia,2,3,,5,-76.532004,3.451668
63678,2019,Marzo,Etiopia,2,34,,36,-74.140516,4.697157
63679,2019,Marzo,Etiopia,0,1,,1,-75.42726,6.170465
63680,2019,Marzo,Filipinas,1,0,,1,-77.35600000000001,0.81488
63681,2019,Marzo,Filipinas,2,54,,56,-75.527794,10.406342
63682,2019,Marzo,Filipinas,6,55,,61,-75.516486,10.446304
63683,2019,Marzo,Filipinas,1,5,,6,-74.77647900000001,10.886686
63684,2019,Marzo,Filipinas,1,24,,25,-74.765343,10.970933
63685,2019,Marzo,Filipinas,0,11,,11,-74.213989,11.247722999999999
63686,2019,Marzo,Filipinas,2,7,,9,-76.532004,3.451668
63687,2019,Marzo,Filipinas,0,11,,11,-77.061029,3.8844260000000004
63688,2019,Marzo,Filipinas,53,82,,135,-74.140516,4.697157
63689,2019,Marzo,Filipinas,4,7,,11,-75.42726,6.170465
63690,2019,Marzo,Filipinas,0,11,,11,-75.68164200000001,9.402597
63691,2019,Marzo,Finlandia,0,1,,1,-69.941498,4.191162
63692,2019,Marzo,Finlandia,0,1,,1,-69.94143100000001,4.214082
63693,2019,Marzo,Finlandia,3,2,,5,-77.35600000000001,0.81488
63694,2019,Marzo,Finlandia,1,0,,1,-75.527794,10.406342
63695,2019,Marzo,Finlandia,8,8,,16,-75.516486,10.446304
63696,2019,Marzo,Finlandia,1,2,,3,-74.77647900000001,10.886686
63697,2019,Marzo,Finlandia,1,3,,4,-76.532004,3.451668
63698,2019,Marzo,Finlandia,68,83,,151,-74.140516,4.697157
63699,2019,Marzo,Finlandia,0,1,,1,-75.736374,4.815189
63700,2019,Marzo,Finlandia,13,13,,26,-75.42726,6.170465
63701,2019,Marzo,Finlandia,1,0,,1,-77.35002,8.63337
63702,2019,Marzo,Francia,9,6,,15,-69.941498,4.191162
63703,2019,Marzo,Francia,15,25,,40,-69.94143100000001,4.214082
63704,2019,Marzo,Francia,7,7,,14,-76.876446,0.33002
63705,2019,Marzo,Francia,106,133,,239,-77.35600000000001,0.81488
63706,2019,Marzo,Francia,14,22,,36,-75.527794,10.406342
63707,2019,Marzo,Francia,232,367,,599,-75.516486,10.446304
63708,2019,Marzo,Francia,49,50,,99,-74.77647900000001,10.886686
63709,2019,Marzo,Francia,1,1,,2,-74.765343,10.970933
63710,2019,Marzo,Francia,1,0,,1,-74.232675,11.117206
63711,2019,Marzo,Francia,1,4,,5,-72.129595,11.360028999999999
63712,2019,Marzo,Francia,3,2,,5,-81.703935,12.574411099999999
63713,2019,Marzo,Francia,3,19,,22,-81.70216500000001,12.5862
63714,2019,Marzo,Francia,79,140,,219,-76.532004,3.451668
63715,2019,Marzo,Francia,2850,3721,,6571,-74.140516,4.697157
63716,2019,Marzo,Francia,12,14,,26,-75.736374,4.815189
63717,2019,Marzo,Francia,213,389,,602,-75.42726,6.170465
63718,2019,Marzo,Francia,1,6,,7,-73.181317,7.1280470000000005
63719,2019,Marzo,Francia,0,3,,3,-72.453013,7.819
63720,2019,Marzo,Francia,2,11,,13,-77.35002,8.63337
63721,2019,Marzo,Georgia,0,1,,1,-75.527794,10.406342
63722,2019,Marzo,Georgia,2,1,,3,-75.516486,10.446304
63723,2019,Marzo,Georgia,6,6,,12,-74.140516,4.697157
63724,2019,Marzo,Georgia,0,2,,2,-75.68164200000001,9.402597
63725,2019,Marzo,Ghana,0,1,,1,-77.35600000000001,0.81488
63726,2019,Marzo,Ghana,0,3,,3,-75.516486,10.446304
63727,2019,Marzo,Ghana,1,10,,11,-74.140516,4.697157
63728,2019,Marzo,Ghana,0,2,,2,-75.42726,6.170465
63729,2019,Marzo,Granada,1,0,,1,-75.516486,10.446304
63730,2019,Marzo,Granada,2,3,,5,-74.140516,4.697157
63731,2019,Marzo,Grecia,1,0,,1,-69.94143100000001,4.214082
63732,2019,Marzo,Grecia,2,2,,4,-77.35600000000001,0.81488
63733,2019,Marzo,Grecia,0,2,,2,-75.527794,10.406342
63734,2019,Marzo,Grecia,6,26,,32,-75.516486,10.446304
63735,2019,Marzo,Grecia,0,1,,1,-74.77647900000001,10.886686
63736,2019,Marzo,Grecia,0,3,,3,-76.532004,3.451668
63737,2019,Marzo,Grecia,34,76,,110,-74.140516,4.697157
63738,2019,Marzo,Grecia,0,16,,16,-75.42726,6.170465
63739,2019,Marzo,Grecia,0,2,,2,-75.68164200000001,9.402597
63740,2019,Marzo,Guatemala,0,1,,1,-76.876446,0.33002
63741,2019,Marzo,Guatemala,2,1,,3,-77.35600000000001,0.81488
63742,2019,Marzo,Guatemala,4,2,,6,-75.527794,10.406342
63743,2019,Marzo,Guatemala,177,191,,368,-75.516486,10.446304
63744,2019,Marzo,Guatemala,38,30,,68,-74.77647900000001,10.886686
63745,2019,Marzo,Guatemala,0,1,,1,-74.232675,11.117206
63746,2019,Marzo,Guatemala,0,2,,2,-72.129595,11.360028999999999
63747,2019,Marzo,Guatemala,6,4,,10,-81.70216500000001,12.5862
63748,2019,Marzo,Guatemala,25,53,,78,-76.532004,3.451668
63749,2019,Marzo,Guatemala,1,0,,1,-75.76635300000001,4.45285
63750,2019,Marzo,Guatemala,411,729,,1140,-74.140516,4.697157
63751,2019,Marzo,Guatemala,6,7,,13,-75.736374,4.815189
63752,2019,Marzo,Guatemala,51,101,,152,-75.42726,6.170465
63753,2019,Marzo,Guatemala,1,2,,3,-73.181317,7.1280470000000005
63754,2019,Marzo,Guatemala,0,6,,6,-72.508188,7.927233
63755,2019,Marzo,Guyana,0,1,,1,-77.35600000000001,0.81488
63756,2019,Marzo,Guyana,0,1,,1,-75.527794,10.406342
63757,2019,Marzo,Guyana,1,1,,2,-75.516486,10.446304
63758,2019,Marzo,Guyana,2,1,,3,-74.77647900000001,10.886686
63759,2019,Marzo,Guyana,0,1,,1,-81.70216500000001,12.5862
63760,2019,Marzo,Guyana,3,2,,5,-76.532004,3.451668
63761,2019,Marzo,Guyana,17,15,,32,-74.140516,4.697157
63762,2019,Marzo,Guyana,4,1,,5,-75.42726,6.170465
63763,2019,Marzo,Guinea,0,1,,1,-72.453013,7.819
63764,2019,Marzo,Guinea Bissau,2,0,,2,-74.140516,4.697157
63765,2019,Marzo,Haití,1,7,,8,-75.516486,10.446304
63766,2019,Marzo,Haití,1,1,,2,-76.532004,3.451668
63767,2019,Marzo,Haití,11,21,,32,-74.140516,4.697157
63768,2019,Marzo,Haití,3,4,,7,-75.42726,6.170465
63769,2019,Marzo,Honduras,2,1,,3,-77.35600000000001,0.81488
63770,2019,Marzo,Honduras,1,2,,3,-75.527794,10.406342
63771,2019,Marzo,Honduras,109,59,,168,-75.516486,10.446304
63772,2019,Marzo,Honduras,9,12,,21,-74.77647900000001,10.886686
63773,2019,Marzo,Honduras,0,1,,1,-74.765343,10.970933
63774,2019,Marzo,Honduras,46,40,,86,-76.532004,3.451668
63775,2019,Marzo,Honduras,0,1,,1,-75.76635300000001,4.45285
63776,2019,Marzo,Honduras,242,328,,570,-74.140516,4.697157
63777,2019,Marzo,Honduras,5,5,,10,-75.736374,4.815189
63778,2019,Marzo,Honduras,45,79,,124,-75.42726,6.170465
63779,2019,Marzo,Honduras,2,2,,4,-73.181317,7.1280470000000005
63780,2019,Marzo,Honduras,0,2,,2,-72.453013,7.819
63781,2019,Marzo,Honduras,3,8,,11,-72.508188,7.927233
63782,2019,Marzo,Honduras,0,1,,1,-77.35002,8.63337
63783,2019,Marzo,Hong Kong,1,1,,2,-75.516486,10.446304
63784,2019,Marzo,Hong Kong,1,0,,1,-76.532004,3.451668
63785,2019,Marzo,Hong Kong,23,14,,37,-74.140516,4.697157
63786,2019,Marzo,Hungría,0,1,,1,-69.941498,4.191162
63787,2019,Marzo,Hungría,0,1,,1,-69.94143100000001,4.214082
63788,2019,Marzo,Hungría,0,1,,1,-76.876446,0.33002
63789,2019,Marzo,Hungría,3,1,,4,-77.35600000000001,0.81488
63790,2019,Marzo,Hungría,2,2,,4,-75.527794,10.406342
63791,2019,Marzo,Hungría,17,14,,31,-75.516486,10.446304
63792,2019,Marzo,Hungría,1,1,,2,-74.77647900000001,10.886686
63793,2019,Marzo,Hungría,0,1,,1,-72.129595,11.360028999999999
63794,2019,Marzo,Hungría,0,1,,1,-76.532004,3.451668
63795,2019,Marzo,Hungría,46,64,,110,-74.140516,4.697157
63796,2019,Marzo,Hungría,6,18,,24,-75.42726,6.170465
63797,2019,Marzo,Hungría,0,1,,1,-73.181317,7.1280470000000005
63798,2019,Marzo,India,1,0,,1,-69.94143100000001,4.214082
63799,2019,Marzo,India,10,4,,14,-77.35600000000001,0.81488
63800,2019,Marzo,India,2,15,,17,-75.527794,10.406342
63801,2019,Marzo,India,22,66,,88,-75.516486,10.446304
63802,2019,Marzo,India,2,15,,17,-74.77647900000001,10.886686
63803,2019,Marzo,India,0,3,,3,-74.213989,11.247722999999999
63804,2019,Marzo,India,4,28,,32,-76.532004,3.451668
63805,2019,Marzo,India,0,2,,2,-77.061029,3.8844260000000004
63806,2019,Marzo,India,133,537,,670,-74.140516,4.697157
63807,2019,Marzo,India,1,0,,1,-75.736374,4.815189
63808,2019,Marzo,India,15,85,,100,-75.42726,6.170465
63809,2019,Marzo,India,0,5,,5,-73.181317,7.1280470000000005
63810,2019,Marzo,India,0,3,,3,-75.68164200000001,9.402597
63811,2019,Marzo,Indonesia,0,1,,1,-77.35600000000001,0.81488
63812,2019,Marzo,Indonesia,1,8,,9,-75.527794,10.406342
63813,2019,Marzo,Indonesia,5,2,,7,-75.516486,10.446304
63814,2019,Marzo,Indonesia,0,2,,2,-74.77647900000001,10.886686
63815,2019,Marzo,Indonesia,0,2,,2,-74.765343,10.970933
63816,2019,Marzo,Indonesia,2,5,,7,-76.532004,3.451668
63817,2019,Marzo,Indonesia,18,32,,50,-74.140516,4.697157
63818,2019,Marzo,Indonesia,2,2,,4,-75.42726,6.170465
63819,2019,Marzo,Iraq,0,1,,1,-75.516486,10.446304
63820,2019,Marzo,Iraq,0,2,,2,-74.140516,4.697157
63821,2019,Marzo,Irán,10,20,,30,-74.140516,4.697157
63822,2019,Marzo,Irán,0,1,,1,-75.42726,6.170465
63823,2019,Marzo,República de Irlanda,2,0,,2,-69.941498,4.191162
63824,2019,Marzo,República de Irlanda,9,10,,19,-77.35600000000001,0.81488
63825,2019,Marzo,República de Irlanda,7,4,,11,-75.527794,10.406342
63826,2019,Marzo,República de Irlanda,20,39,,59,-75.516486,10.446304
63827,2019,Marzo,República de Irlanda,2,3,,5,-74.77647900000001,10.886686
63828,2019,Marzo,República de Irlanda,1,0,,1,-72.129595,11.360028999999999
63829,2019,Marzo,República de Irlanda,2,10,,12,-76.532004,3.451668
63830,2019,Marzo,República de Irlanda,132,214,,346,-74.140516,4.697157
63831,2019,Marzo,República de Irlanda,13,38,,51,-75.42726,6.170465
63832,2019,Marzo,República de Irlanda,0,1,,1,-73.181317,7.1280470000000005
63833,2019,Marzo,República de Irlanda,5,6,,11,-77.35002,8.63337
63834,2019,Marzo,Islandia,0,1,,1,-75.527794,10.406342
63835,2019,Marzo,Islandia,1,3,,4,-75.516486,10.446304
63836,2019,Marzo,Islandia,0,2,,2,-76.532004,3.451668
63837,2019,Marzo,Islandia,15,22,,37,-74.140516,4.697157
63838,2019,Marzo,Islandia,1,4,,5,-75.42726,6.170465
63839,2019,Marzo,Islandia,1,1,,2,-77.35002,8.63337
63840,2019,Marzo,Israel,1,5,,6,-69.94143100000001,4.214082
63841,2019,Marzo,Israel,13,33,,46,-77.35600000000001,0.81488
63842,2019,Marzo,Israel,1,1,,2,-75.527794,10.406342
63843,2019,Marzo,Israel,21,53,,74,-75.516486,10.446304
63844,2019,Marzo,Israel,0,5,,5,-74.77647900000001,10.886686
63845,2019,Marzo,Israel,3,0,,3,-81.70216500000001,12.5862
63846,2019,Marzo,Israel,18,48,,66,-76.532004,3.451668
63847,2019,Marzo,Israel,139,514,,653,-74.140516,4.697157
63848,2019,Marzo,Israel,2,5,,7,-75.736374,4.815189
63849,2019,Marzo,Israel,47,113,,160,-75.42726,6.170465
63850,2019,Marzo,Israel,0,1,,1,-72.453013,7.819
63851,2019,Marzo,Italia,0,2,,2,-69.941498,4.191162
63852,2019,Marzo,Italia,2,7,,9,-69.94143100000001,4.214082
63853,2019,Marzo,Italia,2,2,,4,-76.876446,0.33002
63854,2019,Marzo,Italia,15,34,,49,-77.35600000000001,0.81488
63855,2019,Marzo,Italia,11,19,,30,-75.527794,10.406342
63856,2019,Marzo,Italia,105,216,,321,-75.516486,10.446304
63857,2019,Marzo,Italia,18,54,,72,-74.77647900000001,10.886686
63858,2019,Marzo,Italia,0,1,,1,-74.765343,10.970933
63859,2019,Marzo,Italia,3,1,,4,-74.232675,11.117206
63860,2019,Marzo,Italia,0,1,,1,-74.213989,11.247722999999999
63861,2019,Marzo,Italia,10,12,,22,-72.129595,11.360028999999999
63862,2019,Marzo,Italia,1,0,,1,-81.703935,12.574411099999999
63863,2019,Marzo,Italia,5,11,,16,-81.70216500000001,12.5862
63864,2019,Marzo,Italia,39,91,,130,-76.532004,3.451668
63865,2019,Marzo,Italia,0,3,,3,-77.061029,3.8844260000000004
63866,2019,Marzo,Italia,727,1914,,2641,-74.140516,4.697157
63867,2019,Marzo,Italia,0,8,,8,-75.736374,4.815189
63868,2019,Marzo,Italia,85,259,,344,-75.42726,6.170465
63869,2019,Marzo,Italia,4,3,,7,-67.48402800000001,6.185536
63870,2019,Marzo,Italia,0,2,,2,-70.74025300000001,7.088728999999999
63871,2019,Marzo,Italia,7,16,,23,-72.453013,7.819
63872,2019,Marzo,Italia,1,5,,6,-72.409396,8.36068
63873,2019,Marzo,Italia,1,4,,5,-77.35002,8.63337
63874,2019,Marzo,Italia,1,2,,3,-75.68164200000001,9.402597
63875,2019,Marzo,Jamaica,1,0,,1,-75.527794,10.406342
63876,2019,Marzo,Jamaica,9,9,,18,-75.516486,10.446304
63877,2019,Marzo,Jamaica,1,4,,5,-74.77647900000001,10.886686
63878,2019,Marzo,Jamaica,0,2,,2,-81.70216500000001,12.5862
63879,2019,Marzo,Jamaica,9,3,,12,-76.532004,3.451668
63880,2019,Marzo,Jamaica,24,25,,49,-74.140516,4.697157
63881,2019,Marzo,Jamaica,3,12,,15,-75.42726,6.170465
63882,2019,Marzo,Japón,0,4,,4,-69.941498,4.191162
63883,2019,Marzo,Japón,1,1,,2,-69.94143100000001,4.214082
63884,2019,Marzo,Japón,5,17,,22,-77.35600000000001,0.81488
63885,2019,Marzo,Japón,0,2,,2,-75.527794,10.406342
63886,2019,Marzo,Japón,18,29,,47,-75.516486,10.446304
63887,2019,Marzo,Japón,2,9,,11,-74.77647900000001,10.886686
63888,2019,Marzo,Japón,10,12,,22,-76.532004,3.451668
63889,2019,Marzo,Japón,189,468,,657,-74.140516,4.697157
63890,2019,Marzo,Japón,34,58,,92,-75.42726,6.170465
63891,2019,Marzo,Japón,0,2,,2,-77.35002,8.63337
63892,2019,Marzo,Jordania,0,1,,1,-75.516486,10.446304
63893,2019,Marzo,Jordania,0,1,,1,-76.532004,3.451668
63894,2019,Marzo,Jordania,3,15,,18,-74.140516,4.697157
63895,2019,Marzo,Kazajistán,1,1,,2,-75.516486,10.446304
63896,2019,Marzo,Kazajistán,8,4,,12,-74.140516,4.697157
63897,2019,Marzo,Kazajistán,0,1,,1,-75.42726,6.170465
63898,2019,Marzo,Kenia,1,0,,1,-75.516486,10.446304
63899,2019,Marzo,Kenia,7,12,,19,-74.140516,4.697157
63900,2019,Marzo,Kenia,0,1,,1,-75.42726,6.170465
63901,2019,Marzo,Kirguistán,3,4,,7,-74.140516,4.697157
63902,2019,Marzo,Kuwait,0,1,,1,-74.140516,4.697157
63903,2019,Marzo,República de Kosovo,1,3,,4,-74.140516,4.697157
63904,2019,Marzo,Letonia,0,2,,2,-77.35600000000001,0.81488
63905,2019,Marzo,Letonia,0,1,,1,-75.527794,10.406342
63906,2019,Marzo,Letonia,2,6,,8,-75.516486,10.446304
63907,2019,Marzo,Letonia,0,1,,1,-74.765343,10.970933
63908,2019,Marzo,Letonia,23,27,,50,-74.140516,4.697157
63909,2019,Marzo,Letonia,1,4,,5,-75.42726,6.170465
63910,2019,Marzo,Lituania,2,1,,3,-77.35600000000001,0.81488
63911,2019,Marzo,Lituania,0,1,,1,-75.527794,10.406342
63912,2019,Marzo,Lituania,3,4,,7,-75.516486,10.446304
63913,2019,Marzo,Lituania,0,1,,1,-74.77647900000001,10.886686
63914,2019,Marzo,Lituania,0,1,,1,-74.765343,10.970933
63915,2019,Marzo,Lituania,1,1,,2,-76.532004,3.451668
63916,2019,Marzo,Lituania,38,37,,75,-74.140516,4.697157
63917,2019,Marzo,Lituania,2,2,,4,-75.42726,6.170465
63918,2019,Marzo,Lituania,0,1,,1,-77.35002,8.63337
63919,2019,Marzo,Lituania,0,1,,1,-75.68164200000001,9.402597
63920,2019,Marzo,Líbano,1,0,,1,-75.516486,10.446304
63921,2019,Marzo,Líbano,0,2,,2,-74.77647900000001,10.886686
63922,2019,Marzo,Líbano,2,1,,3,-72.129595,11.360028999999999
63923,2019,Marzo,Líbano,0,1,,1,-81.70216500000001,12.5862
63924,2019,Marzo,Líbano,1,1,,2,-76.532004,3.451668
63925,2019,Marzo,Líbano,15,35,,50,-74.140516,4.697157
63926,2019,Marzo,Líbano,1,2,,3,-75.42726,6.170465
63927,2019,Marzo,Liberia,0,1,,1,-75.516486,10.446304
63928,2019,Marzo,Libia,0,2,,2,-74.140516,4.697157
63929,2019,Marzo,Liechtenstein,3,4,,7,-74.140516,4.697157
63930,2019,Marzo,Luxemburgo,0,1,,1,-69.94143100000001,4.214082
63931,2019,Marzo,Luxemburgo,2,0,,2,-77.35600000000001,0.81488
63932,2019,Marzo,Luxemburgo,0,3,,3,-75.516486,10.446304
63933,2019,Marzo,Luxemburgo,2,0,,2,-76.532004,3.451668
63934,2019,Marzo,Luxemburgo,5,10,,15,-74.140516,4.697157
63935,2019,Marzo,Luxemburgo,0,1,,1,-75.42726,6.170465
63936,2019,Marzo,Macedonia,1,3,,4,-75.516486,10.446304
63937,2019,Marzo,Macedonia,3,7,,10,-74.140516,4.697157
63938,2019,Marzo,Malasia,3,4,,7,-75.516486,10.446304
63939,2019,Marzo,Malasia,1,0,,1,-76.532004,3.451668
63940,2019,Marzo,Malasia,11,17,,28,-74.140516,4.697157
63941,2019,Marzo,Malasia,0,1,,1,-75.42726,6.170465
63942,2019,Marzo,Malta,1,1,,2,-77.35600000000001,0.81488
63943,2019,Marzo,Malta,4,8,,12,-74.140516,4.697157
63944,2019,Marzo,Marruecos,0,1,,1,-77.35600000000001,0.81488
63945,2019,Marzo,Marruecos,4,1,,5,-75.516486,10.446304
63946,2019,Marzo,Marruecos,0,1,,1,-74.77647900000001,10.886686
63947,2019,Marzo,Marruecos,19,29,,48,-74.140516,4.697157
63948,2019,Marzo,Marruecos,1,1,,2,-75.736374,4.815189
63949,2019,Marzo,Marruecos,1,2,,3,-75.42726,6.170465
63950,2019,Marzo,Islas Marshall,1,0,,1,-75.42726,6.170465
63951,2019,Marzo,Mauricio,0,1,,1,-75.516486,10.446304
63952,2019,Marzo,Mauricio,1,0,,1,-74.140516,4.697157
63953,2019,Marzo,México,0,2,,2,-69.941498,4.191162
63954,2019,Marzo,México,1,3,,4,-69.94143100000001,4.214082
63955,2019,Marzo,México,0,4,,4,-76.876446,0.33002
63956,2019,Marzo,México,15,22,,37,-77.35600000000001,0.81488
63957,2019,Marzo,México,0,3,,3,-78.802679,18.00143
63958,2019,Marzo,México,36,26,,62,-75.527794,10.406342
63959,2019,Marzo,México,518,631,,1149,-75.516486,10.446304
63960,2019,Marzo,México,36,81,,117,-74.77647900000001,10.886686
63961,2019,Marzo,México,4,3,,7,-72.129595,11.360028999999999
63962,2019,Marzo,México,2,3,,5,-81.70216500000001,12.5862
63963,2019,Marzo,México,120,214,,334,-76.532004,3.451668
63964,2019,Marzo,México,2,4,,6,-75.76635300000001,4.45285
63965,2019,Marzo,México,4377,7692,,12069,-74.140516,4.697157
63966,2019,Marzo,México,21,28,,49,-75.736374,4.815189
63967,2019,Marzo,México,382,1093,,1475,-75.42726,6.170465
63968,2019,Marzo,México,0,1,,1,-77.401154,6.222551999999999
63969,2019,Marzo,México,6,11,,17,-73.181317,7.1280470000000005
63970,2019,Marzo,México,3,11,,14,-72.453013,7.819
63971,2019,Marzo,México,1,1,,2,-77.35002,8.63337
63972,2019,Marzo,República de Moldavia,4,4,,8,-74.140516,4.697157
63973,2019,Marzo,República de Moldavia,0,1,,1,-75.42726,6.170465
63974,2019,Marzo,Mónaco,0,1,,1,-75.516486,10.446304
63975,2019,Marzo,Mónaco,1,1,,2,-74.140516,4.697157
63976,2019,Marzo,Mongolia,3,1,,4,-74.140516,4.697157
63977,2019,Marzo,Montenegro,1,5,,6,-74.140516,4.697157
63978,2019,Marzo,Montenegro,1,0,,1,-75.42726,6.170465
63979,2019,Marzo,Mozambique,0,1,,1,-74.140516,4.697157
63980,2019,Marzo,Myanmar,0,5,,5,-75.527794,10.406342
63981,2019,Marzo,Myanmar,0,4,,4,-75.516486,10.446304
63982,2019,Marzo,Myanmar,0,5,,5,-74.77647900000001,10.886686
63983,2019,Marzo,Myanmar,1,3,,4,-74.765343,10.970933
63984,2019,Marzo,Myanmar,3,5,,8,-74.140516,4.697157
63985,2019,Marzo,Namibia,1,0,,1,-74.765343,10.970933
63986,2019,Marzo,Nepal,0,6,,6,-75.516486,10.446304
63987,2019,Marzo,Nepal,0,4,,4,-74.140516,4.697157
63988,2019,Marzo,Nicaragua,0,2,,2,-75.527794,10.406342
63989,2019,Marzo,Nicaragua,51,33,,84,-75.516486,10.446304
63990,2019,Marzo,Nicaragua,7,6,,13,-74.77647900000001,10.886686
63991,2019,Marzo,Nicaragua,3,1,,4,-81.70216500000001,12.5862
63992,2019,Marzo,Nicaragua,10,24,,34,-76.532004,3.451668
63993,2019,Marzo,Nicaragua,1,0,,1,-75.76635300000001,4.45285
63994,2019,Marzo,Nicaragua,91,121,,212,-74.140516,4.697157
63995,2019,Marzo,Nicaragua,2,6,,8,-75.736374,4.815189
63996,2019,Marzo,Nicaragua,33,36,,69,-75.42726,6.170465
63997,2019,Marzo,Nicaragua,2,3,,5,-73.181317,7.1280470000000005
63998,2019,Marzo,Nigeria,1,2,,3,-75.516486,10.446304
63999,2019,Marzo,Nigeria,0,1,,1,-74.77647900000001,10.886686
64000,2019,Marzo,Nigeria,1,0,,1,-76.532004,3.451668
64001,2019,Marzo,Nigeria,5,9,,14,-74.140516,4.697157
64002,2019,Marzo,Nigeria,0,1,,1,-75.42726,6.170465
64003,2019,Marzo,Noruega,0,2,,2,-69.941498,4.191162
64004,2019,Marzo,Noruega,2,7,,9,-77.35600000000001,0.81488
64005,2019,Marzo,Noruega,1,3,,4,-75.527794,10.406342
64006,2019,Marzo,Noruega,8,28,,36,-75.516486,10.446304
64007,2019,Marzo,Noruega,3,3,,6,-74.77647900000001,10.886686
64008,2019,Marzo,Noruega,1,0,,1,-74.213989,11.247722999999999
64009,2019,Marzo,Noruega,0,1,,1,-72.129595,11.360028999999999
64010,2019,Marzo,Noruega,1,1,,2,-81.703935,12.574411099999999
64011,2019,Marzo,Noruega,8,18,,26,-76.532004,3.451668
64012,2019,Marzo,Noruega,94,151,,245,-74.140516,4.697157
64013,2019,Marzo,Noruega,0,1,,1,-75.736374,4.815189
64014,2019,Marzo,Noruega,7,20,,27,-75.42726,6.170465
64015,2019,Marzo,Nueva Zelanda,3,2,,5,-69.941498,4.191162
64016,2019,Marzo,Nueva Zelanda,2,2,,4,-69.94143100000001,4.214082
64017,2019,Marzo,Nueva Zelanda,2,2,,4,-77.35600000000001,0.81488
64018,2019,Marzo,Nueva Zelanda,2,2,,4,-75.527794,10.406342
64019,2019,Marzo,Nueva Zelanda,7,14,,21,-75.516486,10.446304
64020,2019,Marzo,Nueva Zelanda,1,1,,2,-74.77647900000001,10.886686
64021,2019,Marzo,Nueva Zelanda,5,3,,8,-74.213989,11.247722999999999
64022,2019,Marzo,Nueva Zelanda,0,1,,1,-81.372937,13.338761300000002
64023,2019,Marzo,Nueva Zelanda,0,3,,3,-76.532004,3.451668
64024,2019,Marzo,Nueva Zelanda,45,98,,143,-74.140516,4.697157
64025,2019,Marzo,Nueva Zelanda,4,13,,17,-75.42726,6.170465
64026,2019,Marzo,Nueva Zelanda,0,1,,1,-77.35002,8.63337
64027,2019,Marzo,Omán,0,4,,4,-74.140516,4.697157
64028,2019,Marzo,Países Bajos,3,5,,8,-69.941498,4.191162
64029,2019,Marzo,Países Bajos,2,5,,7,-69.94143100000001,4.214082
64030,2019,Marzo,Países Bajos,23,25,,48,-77.35600000000001,0.81488
64031,2019,Marzo,Países Bajos,19,26,,45,-75.527794,10.406342
64032,2019,Marzo,Países Bajos,299,306,,605,-75.516486,10.446304
64033,2019,Marzo,Países Bajos,13,27,,40,-74.77647900000001,10.886686
64034,2019,Marzo,Países Bajos,1,13,,14,-74.765343,10.970933
64035,2019,Marzo,Países Bajos,0,1,,1,-74.232675,11.117206
64036,2019,Marzo,Países Bajos,3,4,,7,-74.213989,11.247722999999999
64037,2019,Marzo,Países Bajos,1,0,,1,-72.129595,11.360028999999999
64038,2019,Marzo,Países Bajos,0,2,,2,-72.919186,11.52863
64039,2019,Marzo,Países Bajos,2,3,,5,-81.703935,12.574411099999999
64040,2019,Marzo,Países Bajos,1,0,,1,-81.70216500000001,12.5862
64041,2019,Marzo,Países Bajos,57,68,,125,-76.532004,3.451668
64042,2019,Marzo,Países Bajos,1690,2317,,4007,-74.140516,4.697157
64043,2019,Marzo,Países Bajos,1,6,,7,-75.736374,4.815189
64044,2019,Marzo,Países Bajos,116,195,,311,-75.42726,6.170465
64045,2019,Marzo,Países Bajos,0,1,,1,-75.586989,6.2188349999999994
64046,2019,Marzo,Países Bajos,11,13,,24,-73.181317,7.1280470000000005
64047,2019,Marzo,Países Bajos,0,1,,1,-72.453013,7.819
64048,2019,Marzo,Países Bajos,8,5,,13,-77.35002,8.63337
64049,2019,Marzo,Pakistán,0,1,,1,-77.35600000000001,0.81488
64050,2019,Marzo,Pakistán,2,6,,8,-75.516486,10.446304
64051,2019,Marzo,Pakistán,0,2,,2,-76.532004,3.451668
64052,2019,Marzo,Pakistán,3,23,,26,-74.140516,4.697157
64053,2019,Marzo,Pakistán,0,1,,1,-75.42726,6.170465
64054,2019,Marzo,Panamá,2,3,,5,-77.35600000000001,0.81488
64055,2019,Marzo,Panamá,0,1,,1,-78.802679,18.00143
64056,2019,Marzo,Panamá,2,13,,15,-75.527794,10.406342
64057,2019,Marzo,Panamá,643,582,,1225,-75.516486,10.446304
64058,2019,Marzo,Panamá,107,107,,214,-74.77647900000001,10.886686
64059,2019,Marzo,Panamá,2,1,,3,-72.129595,11.360028999999999
64060,2019,Marzo,Panamá,0,1,,1,-81.703935,12.574411099999999
64061,2019,Marzo,Panamá,56,55,,111,-81.70216500000001,12.5862
64062,2019,Marzo,Panamá,430,440,,870,-76.532004,3.451668
64063,2019,Marzo,Panamá,2427,2295,,4722,-74.140516,4.697157
64064,2019,Marzo,Panamá,62,63,,125,-75.736374,4.815189
64065,2019,Marzo,Panamá,2211,1875,,4086,-75.42726,6.170465
64066,2019,Marzo,Panamá,0,2,,2,-77.401154,6.222551999999999
64067,2019,Marzo,Panamá,0,1,,1,-70.74025300000001,7.088728999999999
64068,2019,Marzo,Panamá,5,2,,7,-77.762647,7.102626
64069,2019,Marzo,Panamá,16,11,,27,-73.181317,7.1280470000000005
64070,2019,Marzo,Panamá,1,0,,1,-72.453013,7.819
64071,2019,Marzo,Panamá,1,2,,3,-77.35002,8.63337
64072,2019,Marzo,Paraguay,1,0,,1,-77.35600000000001,0.81488
64073,2019,Marzo,Paraguay,3,1,,4,-75.527794,10.406342
64074,2019,Marzo,Paraguay,88,65,,153,-75.516486,10.446304
64075,2019,Marzo,Paraguay,1,5,,6,-74.77647900000001,10.886686
64076,2019,Marzo,Paraguay,45,35,,80,-81.70216500000001,12.5862
64077,2019,Marzo,Paraguay,5,6,,11,-76.532004,3.451668
64078,2019,Marzo,Paraguay,159,132,,291,-74.140516,4.697157
64079,2019,Marzo,Paraguay,19,21,,40,-75.42726,6.170465
64080,2019,Marzo,Paraguay,2,2,,4,-72.453013,7.819
64081,2019,Marzo,Perú,12,10,,22,-69.941498,4.191162
64082,2019,Marzo,Perú,38,71,,109,-69.94143100000001,4.214082
64083,2019,Marzo,Perú,4,6,,10,-74.78366,0.18595699999999998
64084,2019,Marzo,Perú,0,11,,11,-76.876446,0.33002
64085,2019,Marzo,Perú,105,236,,341,-77.35600000000001,0.81488
64086,2019,Marzo,Perú,67,43,,110,-75.527794,10.406342
64087,2019,Marzo,Perú,1146,741,,1887,-75.516486,10.446304
64088,2019,Marzo,Perú,8,34,,42,-74.77647900000001,10.886686
64089,2019,Marzo,Perú,0,1,,1,-74.232675,11.117206
64090,2019,Marzo,Perú,6,13,,19,-72.129595,11.360028999999999
64091,2019,Marzo,Perú,395,271,,666,-81.70216500000001,12.5862
64092,2019,Marzo,Perú,275,323,,598,-76.532004,3.451668
64093,2019,Marzo,Perú,0,2,,2,-75.76635300000001,4.45285
64094,2019,Marzo,Perú,3631,4268,,7899,-74.140516,4.697157
64095,2019,Marzo,Perú,5,12,,17,-75.736374,4.815189
64096,2019,Marzo,Perú,755,961,,1716,-75.42726,6.170465
64097,2019,Marzo,Perú,0,1,,1,-67.48402800000001,6.185536
64098,2019,Marzo,Perú,1,1,,2,-73.181317,7.1280470000000005
64099,2019,Marzo,Perú,69,90,,159,-72.453013,7.819
64100,2019,Marzo,Perú,3,4,,7,-72.409396,8.36068
64101,2019,Marzo,Palestina,0,1,,1,-74.77647900000001,10.886686
64102,2019,Marzo,Palestina,3,0,,3,-74.140516,4.697157
64103,2019,Marzo,Polonia,1,2,,3,-69.94143100000001,4.214082
64104,2019,Marzo,Polonia,12,11,,23,-77.35600000000001,0.81488
64105,2019,Marzo,Polonia,17,24,,41,-75.527794,10.406342
64106,2019,Marzo,Polonia,29,30,,59,-75.516486,10.446304
64107,2019,Marzo,Polonia,1,1,,2,-74.77647900000001,10.886686
64108,2019,Marzo,Polonia,1,0,,1,-74.213989,11.247722999999999
64109,2019,Marzo,Polonia,1,4,,5,-81.70216500000001,12.5862
64110,2019,Marzo,Polonia,4,3,,7,-76.532004,3.451668
64111,2019,Marzo,Polonia,259,338,,597,-74.140516,4.697157
64112,2019,Marzo,Polonia,2,1,,3,-75.736374,4.815189
64113,2019,Marzo,Polonia,19,24,,43,-75.42726,6.170465
64114,2019,Marzo,Polonia,1,0,,1,-77.35002,8.63337
64115,2019,Marzo,Portugal,0,1,,1,-69.941498,4.191162
64116,2019,Marzo,Portugal,1,4,,5,-69.94143100000001,4.214082
64117,2019,Marzo,Portugal,0,1,,1,-77.84700600000001,0.8124359999999999
64118,2019,Marzo,Portugal,7,9,,16,-77.35600000000001,0.81488
64119,2019,Marzo,Portugal,2,5,,7,-75.527794,10.406342
64120,2019,Marzo,Portugal,24,23,,47,-75.516486,10.446304
64121,2019,Marzo,Portugal,4,3,,7,-74.77647900000001,10.886686
64122,2019,Marzo,Portugal,0,2,,2,-72.129595,11.360028999999999
64123,2019,Marzo,Portugal,0,1,,1,-81.70216500000001,12.5862
64124,2019,Marzo,Portugal,0,4,,4,-81.372937,13.338761300000002
64125,2019,Marzo,Portugal,4,16,,20,-76.532004,3.451668
64126,2019,Marzo,Portugal,213,478,,691,-74.140516,4.697157
64127,2019,Marzo,Portugal,2,2,,4,-75.736374,4.815189
64128,2019,Marzo,Portugal,14,44,,58,-75.42726,6.170465
64129,2019,Marzo,Portugal,1,0,,1,-70.74025300000001,7.088728999999999
64130,2019,Marzo,Portugal,6,15,,21,-72.453013,7.819
64131,2019,Marzo,Qatar,0,2,,2,-74.140516,4.697157
64132,2019,Marzo,Qatar,0,1,,1,-75.42726,6.170465
64133,2019,Marzo,Reino Unido de Gran Bretaña e Irlanda del Norte,2,1,,3,-69.941498,4.191162
64134,2019,Marzo,Reino Unido de Gran Bretaña e Irlanda del Norte,9,9,,18,-69.94143100000001,4.214082
64135,2019,Marzo,Reino Unido de Gran Bretaña e Irlanda del Norte,0,1,,1,-76.876446,0.33002
64136,2019,Marzo,Reino Unido de Gran Bretaña e Irlanda del Norte,47,59,,106,-77.35600000000001,0.81488
64137,2019,Marzo,Reino Unido de Gran Bretaña e Irlanda del Norte,21,37,,58,-75.527794,10.406342
64138,2019,Marzo,Reino Unido de Gran Bretaña e Irlanda del Norte,144,219,,363,-75.516486,10.446304
64139,2019,Marzo,Reino Unido de Gran Bretaña e Irlanda del Norte,12,23,,35,-74.77647900000001,10.886686
64140,2019,Marzo,Reino Unido de Gran Bretaña e Irlanda del Norte,0,1,,1,-74.232675,11.117206
64141,2019,Marzo,Reino Unido de Gran Bretaña e Irlanda del Norte,1,5,,6,-74.213989,11.247722999999999
64142,2019,Marzo,Reino Unido de Gran Bretaña e Irlanda del Norte,0,2,,2,-72.129595,11.360028999999999
64143,2019,Marzo,Reino Unido de Gran Bretaña e Irlanda del Norte,20,20,,40,-81.703935,12.574411099999999
64144,2019,Marzo,Reino Unido de Gran Bretaña e Irlanda del Norte,0,1,,1,-81.70216500000001,12.5862
64145,2019,Marzo,Reino Unido de Gran Bretaña e Irlanda del Norte,0,1,,1,-81.372937,13.338761300000002
64146,2019,Marzo,Reino Unido de Gran Bretaña e Irlanda del Norte,30,56,,86,-76.532004,3.451668
64147,2019,Marzo,Reino Unido de Gran Bretaña e Irlanda del Norte,1,0,,1,-75.76635300000001,4.45285
64148,2019,Marzo,Reino Unido de Gran Bretaña e Irlanda del Norte,1282,2205,,3487,-74.140516,4.697157
64149,2019,Marzo,Reino Unido de Gran Bretaña e Irlanda del Norte,6,4,,10,-75.736374,4.815189
64150,2019,Marzo,Reino Unido de Gran Bretaña e Irlanda del Norte,111,278,,389,-75.42726,6.170465
64151,2019,Marzo,Reino Unido de Gran Bretaña e Irlanda del Norte,1,2,,3,-73.181317,7.1280470000000005
64152,2019,Marzo,Reino Unido de Gran Bretaña e Irlanda del Norte,17,22,,39,-77.35002,8.63337
64153,2019,Marzo,Reino Unido de Gran Bretaña e Irlanda del Norte,0,1,,1,-75.68164200000001,9.402597
64154,2019,Marzo,República Dominicana,7,14,,21,-77.35600000000001,0.81488
64155,2019,Marzo,República Dominicana,2,0,,2,-75.527794,10.406342
64156,2019,Marzo,República Dominicana,61,74,,135,-75.516486,10.446304
64157,2019,Marzo,República Dominicana,13,38,,51,-74.77647900000001,10.886686
64158,2019,Marzo,República Dominicana,1,0,,1,-74.232675,11.117206
64159,2019,Marzo,República Dominicana,1,6,,7,-72.129595,11.360028999999999
64160,2019,Marzo,República Dominicana,0,1,,1,-71.983761,12.165168
64161,2019,Marzo,República Dominicana,3,2,,5,-81.70216500000001,12.5862
64162,2019,Marzo,República Dominicana,39,68,,107,-76.532004,3.451668
64163,2019,Marzo,República Dominicana,1,0,,1,-75.76635300000001,4.45285
64164,2019,Marzo,República Dominicana,797,1081,,1878,-74.140516,4.697157
64165,2019,Marzo,República Dominicana,8,6,,14,-75.736374,4.815189
64166,2019,Marzo,República Dominicana,132,215,,347,-75.42726,6.170465
64167,2019,Marzo,República Dominicana,5,2,,7,-73.181317,7.1280470000000005
64168,2019,Marzo,República Dominicana,2,2,,4,-72.453013,7.819
64169,2019,Marzo,Rumania,0,1,,1,-69.941498,4.191162
64170,2019,Marzo,Rumania,1,0,,1,-69.94143100000001,4.214082
64171,2019,Marzo,Rumania,1,2,,3,-77.35600000000001,0.81488
64172,2019,Marzo,Rumania,2,4,,6,-75.527794,10.406342
64173,2019,Marzo,Rumania,7,20,,27,-75.516486,10.446304
64174,2019,Marzo,Rumania,1,2,,3,-74.77647900000001,10.886686
64175,2019,Marzo,Rumania,0,1,,1,-72.129595,11.360028999999999
64176,2019,Marzo,Rumania,1,1,,2,-81.70216500000001,12.5862
64177,2019,Marzo,Rumania,4,3,,7,-76.532004,3.451668
64178,2019,Marzo,Rumania,104,86,,190,-74.140516,4.697157
64179,2019,Marzo,Rumania,11,13,,24,-75.42726,6.170465
64180,2019,Marzo,Rumania,0,1,,1,-70.74025300000001,7.088728999999999
64181,2019,Marzo,Rumania,2,0,,2,-72.453013,7.819
64182,2019,Marzo,Federación de Rusia,1,0,,1,-69.941498,4.191162
64183,2019,Marzo,Federación de Rusia,8,12,,20,-77.35600000000001,0.81488
64184,2019,Marzo,Federación de Rusia,3,7,,10,-75.527794,10.406342
64185,2019,Marzo,Federación de Rusia,29,36,,65,-75.516486,10.446304
64186,2019,Marzo,Federación de Rusia,1,3,,4,-74.77647900000001,10.886686
64187,2019,Marzo,Federación de Rusia,0,2,,2,-74.765343,10.970933
64188,2019,Marzo,Federación de Rusia,6,3,,9,-76.532004,3.451668
64189,2019,Marzo,Federación de Rusia,178,214,,392,-74.140516,4.697157
64190,2019,Marzo,Federación de Rusia,1,0,,1,-75.736374,4.815189
64191,2019,Marzo,Federación de Rusia,20,16,,36,-75.42726,6.170465
64192,2019,Marzo,Federación de Rusia,1,12,,13,-75.68164200000001,9.402597
64193,2019,Marzo,Rwanda,1,0,,1,-76.532004,3.451668
64194,2019,Marzo,San Cristóbal y Nevis,2,0,,2,-75.516486,10.446304
64195,2019,Marzo,San Cristóbal y Nevis,1,2,,3,-74.140516,4.697157
64196,2019,Marzo,San Marino,1,1,,2,-74.140516,4.697157
64197,2019,Marzo,San Marino,0,1,,1,-75.42726,6.170465
64198,2019,Marzo,San  Vicente y las Granadinas,1,0,,1,-76.532004,3.451668
64199,2019,Marzo,San  Vicente y las Granadinas,2,2,,4,-74.140516,4.697157
64200,2019,Marzo,Santa Lucia,0,1,,1,-75.516486,10.446304
64201,2019,Marzo,Santa Lucia,1,0,,1,-74.77647900000001,10.886686
64202,2019,Marzo,Santa Lucia,1,1,,2,-76.532004,3.451668
64203,2019,Marzo,Santa Lucia,2,2,,4,-74.140516,4.697157
64204,2019,Marzo,Santa Lucia,0,1,,1,-75.42726,6.170465
64205,2019,Marzo,Senegal,0,1,,1,-75.516486,10.446304
64206,2019,Marzo,Senegal,2,0,,2,-74.140516,4.697157
64207,2019,Marzo,Serbia,10,7,,17,-75.516486,10.446304
64208,2019,Marzo,Serbia,0,3,,3,-76.532004,3.451668
64209,2019,Marzo,Serbia,23,39,,62,-74.140516,4.697157
64210,2019,Marzo,Serbia,2,9,,11,-75.42726,6.170465
64211,2019,Marzo,Sierra Leona,0,1,,1,-74.140516,4.697157
64212,2019,Marzo,Singapur,0,1,,1,-75.527794,10.406342
64213,2019,Marzo,Singapur,7,8,,15,-75.516486,10.446304
64214,2019,Marzo,Singapur,0,1,,1,-74.77647900000001,10.886686
64215,2019,Marzo,Singapur,1,1,,2,-76.532004,3.451668
64216,2019,Marzo,Singapur,34,40,,74,-74.140516,4.697157
64217,2019,Marzo,Singapur,1,1,,2,-75.736374,4.815189
64218,2019,Marzo,Singapur,3,6,,9,-75.42726,6.170465
64219,2019,Marzo,República Árabe Siria,0,1,,1,-76.532004,3.451668
64220,2019,Marzo,República Árabe Siria,1,4,,5,-74.140516,4.697157
64221,2019,Marzo,Sri Lanka,0,1,,1,-75.527794,10.406342
64222,2019,Marzo,Sri Lanka,0,1,,1,-75.516486,10.446304
64223,2019,Marzo,Sri Lanka,0,1,,1,-76.532004,3.451668
64224,2019,Marzo,Sri Lanka,1,8,,9,-74.140516,4.697157
64225,2019,Marzo,Sudáfrica,0,7,,7,-75.527794,10.406342
64226,2019,Marzo,Sudáfrica,3,4,,7,-75.516486,10.446304
64227,2019,Marzo,Sudáfrica,2,3,,5,-74.77647900000001,10.886686
64228,2019,Marzo,Sudáfrica,0,1,,1,-81.372937,13.338761300000002
64229,2019,Marzo,Sudáfrica,1,1,,2,-76.532004,3.451668
64230,2019,Marzo,Sudáfrica,18,40,,58,-74.140516,4.697157
64231,2019,Marzo,Sudáfrica,1,5,,6,-75.42726,6.170465
64232,2019,Marzo,Sudáfrica,1,1,,2,-77.35002,8.63337
64233,2019,Marzo,Sudán,0,1,,1,-76.532004,3.451668
64234,2019,Marzo,Sudán,0,1,,1,-74.140516,4.697157
64235,2019,Marzo,Suecia,1,0,,1,-69.941498,4.191162
64236,2019,Marzo,Suecia,0,1,,1,-69.94143100000001,4.214082
64237,2019,Marzo,Suecia,0,1,,1,-76.876446,0.33002
64238,2019,Marzo,Suecia,11,15,,26,-77.35600000000001,0.81488
64239,2019,Marzo,Suecia,15,10,,25,-75.527794,10.406342
64240,2019,Marzo,Suecia,32,55,,87,-75.516486,10.446304
64241,2019,Marzo,Suecia,6,5,,11,-74.77647900000001,10.886686
64242,2019,Marzo,Suecia,1,4,,5,-74.213989,11.247722999999999
64243,2019,Marzo,Suecia,1,1,,2,-81.703935,12.574411099999999
64244,2019,Marzo,Suecia,0,2,,2,-81.372937,13.338761300000002
64245,2019,Marzo,Suecia,8,13,,21,-76.532004,3.451668
64246,2019,Marzo,Suecia,181,280,,461,-74.140516,4.697157
64247,2019,Marzo,Suecia,0,1,,1,-75.736374,4.815189
64248,2019,Marzo,Suecia,27,52,,79,-75.42726,6.170465
64249,2019,Marzo,Suecia,1,0,,1,-73.181317,7.1280470000000005
64250,2019,Marzo,Suecia,1,2,,3,-72.409396,8.36068
64251,2019,Marzo,Suecia,3,3,,6,-77.35002,8.63337
64252,2019,Marzo,Suiza,1,3,,4,-69.941498,4.191162
64253,2019,Marzo,Suiza,3,4,,7,-69.94143100000001,4.214082
64254,2019,Marzo,Suiza,1,1,,2,-76.876446,0.33002
64255,2019,Marzo,Suiza,22,34,,56,-77.35600000000001,0.81488
64256,2019,Marzo,Suiza,19,17,,36,-75.527794,10.406342
64257,2019,Marzo,Suiza,39,51,,90,-75.516486,10.446304
64258,2019,Marzo,Suiza,3,11,,14,-74.77647900000001,10.886686
64259,2019,Marzo,Suiza,0,1,,1,-74.213989,11.247722999999999
64260,2019,Marzo,Suiza,1,3,,4,-81.70216500000001,12.5862
64261,2019,Marzo,Suiza,9,41,,50,-76.532004,3.451668
64262,2019,Marzo,Suiza,2,0,,2,-75.76635300000001,4.45285
64263,2019,Marzo,Suiza,519,679,,1198,-74.140516,4.697157
64264,2019,Marzo,Suiza,1,1,,2,-75.736374,4.815189
64265,2019,Marzo,Suiza,61,111,,172,-75.42726,6.170465
64266,2019,Marzo,Suiza,0,2,,2,-73.181317,7.1280470000000005
64267,2019,Marzo,Suiza,1,1,,2,-72.453013,7.819
64268,2019,Marzo,Suiza,3,3,,6,-77.35002,8.63337
64269,2019,Marzo,Suiza,1,0,,1,-75.68164200000001,9.402597
64270,2019,Marzo,Surinam,0,2,,2,-75.527794,10.406342
64271,2019,Marzo,Surinam,13,25,,38,-74.140516,4.697157
64272,2019,Marzo,Surinam,3,0,,3,-73.181317,7.1280470000000005
64273,2019,Marzo,Taiwán,2,1,,3,-74.140516,4.697157
64274,2019,Marzo,Tailandia,0,2,,2,-75.527794,10.406342
64275,2019,Marzo,Tailandia,1,1,,2,-75.516486,10.446304
64276,2019,Marzo,Tailandia,1,0,,1,-76.532004,3.451668
64277,2019,Marzo,Tailandia,25,24,,49,-74.140516,4.697157
64278,2019,Marzo,Tailandia,0,1,,1,-75.736374,4.815189
64279,2019,Marzo,Tailandia,1,0,,1,-75.42726,6.170465
64280,2019,Marzo,Tanzania,1,1,,2,-75.516486,10.446304
64281,2019,Marzo,Togo,0,1,,1,-74.140516,4.697157
64282,2019,Marzo,Trinidad y Tobago,1,1,,2,-77.35600000000001,0.81488
64283,2019,Marzo,Trinidad y Tobago,8,7,,15,-75.516486,10.446304
64284,2019,Marzo,Trinidad y Tobago,2,3,,5,-74.77647900000001,10.886686
64285,2019,Marzo,Trinidad y Tobago,0,1,,1,-81.70216500000001,12.5862
64286,2019,Marzo,Trinidad y Tobago,6,10,,16,-76.532004,3.451668
64287,2019,Marzo,Trinidad y Tobago,26,41,,67,-74.140516,4.697157
64288,2019,Marzo,Trinidad y Tobago,1,1,,2,-75.736374,4.815189
64289,2019,Marzo,Trinidad y Tobago,2,12,,14,-75.42726,6.170465
64290,2019,Marzo,Trinidad y Tobago,0,1,,1,-73.181317,7.1280470000000005
64291,2019,Marzo,Túnez,2,1,,3,-75.516486,10.446304
64292,2019,Marzo,Túnez,9,12,,21,-74.140516,4.697157
64293,2019,Marzo,Turquía,1,1,,2,-76.876446,0.33002
64294,2019,Marzo,Turquía,1,2,,3,-77.35600000000001,0.81488
64295,2019,Marzo,Turquía,0,2,,2,-75.527794,10.406342
64296,2019,Marzo,Turquía,24,14,,38,-75.516486,10.446304
64297,2019,Marzo,Turquía,1,5,,6,-74.77647900000001,10.886686
64298,2019,Marzo,Turquía,1,2,,3,-76.532004,3.451668
64299,2019,Marzo,Turquía,156,398,,554,-74.140516,4.697157
64300,2019,Marzo,Turquía,8,21,,29,-75.42726,6.170465
64301,2019,Marzo,Turquía,0,1,,1,-77.35002,8.63337
64302,2019,Marzo,Ucrania,1,1,,2,-77.35600000000001,0.81488
64303,2019,Marzo,Ucrania,1,8,,9,-75.527794,10.406342
64304,2019,Marzo,Ucrania,2,10,,12,-75.516486,10.446304
64305,2019,Marzo,Ucrania,0,4,,4,-74.77647900000001,10.886686
64306,2019,Marzo,Ucrania,0,5,,5,-74.765343,10.970933
64307,2019,Marzo,Ucrania,0,1,,1,-74.213989,11.247722999999999
64308,2019,Marzo,Ucrania,3,0,,3,-76.532004,3.451668
64309,2019,Marzo,Ucrania,31,24,,55,-74.140516,4.697157
64310,2019,Marzo,Ucrania,5,3,,8,-75.42726,6.170465
64311,2019,Marzo,Ucrania,0,3,,3,-75.68164200000001,9.402597
64312,2019,Marzo,Uganda,0,1,,1,-77.35600000000001,0.81488
64313,2019,Marzo,Uganda,0,1,,1,-76.532004,3.451668
64314,2019,Marzo,Uganda,3,3,,6,-74.140516,4.697157
64315,2019,Marzo,Uruguay,1,0,,1,-69.94143100000001,4.214082
64316,2019,Marzo,Uruguay,2,0,,2,-76.876446,0.33002
64317,2019,Marzo,Uruguay,9,20,,29,-77.35600000000001,0.81488
64318,2019,Marzo,Uruguay,11,12,,23,-75.527794,10.406342
64319,2019,Marzo,Uruguay,125,92,,217,-75.516486,10.446304
64320,2019,Marzo,Uruguay,2,10,,12,-74.77647900000001,10.886686
64321,2019,Marzo,Uruguay,0,1,,1,-74.232675,11.117206
64322,2019,Marzo,Uruguay,1,2,,3,-72.129595,11.360028999999999
64323,2019,Marzo,Uruguay,39,23,,62,-81.70216500000001,12.5862
64324,2019,Marzo,Uruguay,15,39,,54,-76.532004,3.451668
64325,2019,Marzo,Uruguay,207,380,,587,-74.140516,4.697157
64326,2019,Marzo,Uruguay,0,1,,1,-75.736374,4.815189
64327,2019,Marzo,Uruguay,70,105,,175,-75.42726,6.170465
64328,2019,Marzo,Uruguay,3,2,,5,-72.453013,7.819
64329,2019,Marzo,Uruguay,0,1,,1,-77.35002,8.63337
64330,2019,Marzo,Uzbekistán,2,0,,2,-74.140516,4.697157
64331,2019,Marzo,Venezuela,2,2,,4,-69.941498,4.191162
64332,2019,Marzo,Venezuela,4,4,,8,-69.94143100000001,4.214082
64333,2019,Marzo,Venezuela,58,64,,122,-76.876446,0.33002
64334,2019,Marzo,Venezuela,1,1,,2,-77.84700600000001,0.8124359999999999
64335,2019,Marzo,Venezuela,3262,3451,,6713,-77.35600000000001,0.81488
64336,2019,Marzo,Venezuela,0,16,,16,-78.802679,18.00143
64337,2019,Marzo,Venezuela,19,35,,54,-75.527794,10.406342
64338,2019,Marzo,Venezuela,251,336,,587,-75.516486,10.446304
64339,2019,Marzo,Venezuela,250,388,,638,-74.77647900000001,10.886686
64340,2019,Marzo,Venezuela,0,7,,7,-74.765343,10.970933
64341,2019,Marzo,Venezuela,40,95,,135,-74.232675,11.117206
64342,2019,Marzo,Venezuela,0,6,,6,-74.213989,11.247722999999999
64343,2019,Marzo,Venezuela,6165,5155,,11320,-72.129595,11.360028999999999
64344,2019,Marzo,Venezuela,0,2,,2,-71.983761,12.165168
64345,2019,Marzo,Venezuela,5,7,,12,-81.70216500000001,12.5862
64346,2019,Marzo,Venezuela,217,250,,467,-76.532004,3.451668
64347,2019,Marzo,Venezuela,6,7,,13,-67.927521,3.866713
64348,2019,Marzo,Venezuela,1,2,,3,-75.76635300000001,4.45285
64349,2019,Marzo,Venezuela,7513,7329,,14842,-74.140516,4.697157
64350,2019,Marzo,Venezuela,6,17,,23,-75.736374,4.815189
64351,2019,Marzo,Venezuela,934,1173,,2107,-75.42726,6.170465
64352,2019,Marzo,Venezuela,27,31,,58,-67.48402800000001,6.185536
64353,2019,Marzo,Venezuela,2,1,,3,-75.586989,6.2188349999999994
64354,2019,Marzo,Venezuela,349,311,,660,-70.74025300000001,7.088728999999999
64355,2019,Marzo,Venezuela,13,15,,28,-73.181317,7.1280470000000005
64356,2019,Marzo,Venezuela,19031,16212,,35243,-72.453013,7.819
64357,2019,Marzo,Venezuela,12,42,,54,-72.508188,7.927233
64358,2019,Marzo,Venezuela,1152,955,,2107,-72.409396,8.36068
64359,2019,Marzo,Vietnam,2,1,,3,-75.516486,10.446304
64360,2019,Marzo,Vietnam,1,0,,1,-76.532004,3.451668
64361,2019,Marzo,Vietnam,13,4,,17,-74.140516,4.697157
64362,2019,Marzo,República Árabe de Yemen,0,2,,2,-74.140516,4.697157
64363,2019,Marzo,Zambia,0,1,,1,-76.532004,3.451668
64364,2019,Marzo,Zambia,1,0,,1,-74.140516,4.697157
64365,2019,Marzo,Zambia,0,1,,1,-75.42726,6.170465
64366,2019,Marzo,Zimbabue,2,0,,2,-75.516486,10.446304
64367,2019,Marzo,Zimbabue,4,4,,8,-74.140516,4.697157
64368,2019,Marzo,Refugiado,0,1,,1,-75.516486,10.446304
64369,2019,Marzo,Refugiado,1,0,,1,-76.532004,3.451668
64370,2019,Marzo,Refugiado,4,6,,10,-74.140516,4.697157
64371,2019,Marzo,Refugiado,1,0,,1,-75.42726,6.170465
64372,2019,Marzo,Desconocido,1,0,,1,-76.876446,0.33002
64373,2019,Marzo,Desconocido,1,4,,5,-75.516486,10.446304
64374,2019,Marzo,Desconocido,1,0,,1,-74.77647900000001,10.886686
64375,2019,Marzo,Desconocido,0,2,,2,-76.532004,3.451668
64376,2019,Marzo,Desconocido,90,147,,237,-74.140516,4.697157
64377,2019,Marzo,Desconocido,0,3,,3,-75.42726,6.170465
64378,2019,Marzo,Desconocido,0,1,,1,-72.453013,7.819
64379,2019,Abril,Albania,1,2,,3,-75.516486,10.446304
64380,2019,Abril,Albania,1,0,,1,-74.77647900000001,10.886686
64381,2019,Abril,Albania,0,1,,1,-76.532004,3.451668
64382,2019,Abril,Albania,3,4,,7,-74.140516,4.697157
64383,2019,Abril,Alemania,9,5,,14,-69.941498,4.191162
64384,2019,Abril,Alemania,31,25,,56,-69.94143100000001,4.214082
64385,2019,Abril,Alemania,4,9,,13,-76.876446,0.33002
64386,2019,Abril,Alemania,87,79,,166,-77.35600000000001,0.81488
64387,2019,Abril,Alemania,40,35,,75,-75.527794,10.406342
64388,2019,Abril,Alemania,152,214,,366,-75.516486,10.446304
64389,2019,Abril,Alemania,13,26,,39,-74.77647900000001,10.886686
64390,2019,Abril,Alemania,1,0,,1,-74.232675,11.117206
64391,2019,Abril,Alemania,2,3,,5,-74.213989,11.247722999999999
64392,2019,Abril,Alemania,3,4,,7,-72.129595,11.360028999999999
64393,2019,Abril,Alemania,6,6,,12,-81.70216500000001,12.5862
64394,2019,Abril,Alemania,1,3,,4,-81.372937,13.338761300000002
64395,2019,Abril,Alemania,64,78,,142,-76.532004,3.451668
64396,2019,Abril,Alemania,2180,3069,,5249,-74.140516,4.697157
64397,2019,Abril,Alemania,2,5,,7,-75.736374,4.815189
64398,2019,Abril,Alemania,179,253,,432,-75.42726,6.170465
64399,2019,Abril,Alemania,1,0,,1,-73.181317,7.1280470000000005
64400,2019,Abril,Alemania,4,8,,12,-72.453013,7.819
64401,2019,Abril,Alemania,0,1,,1,-76.7333,8.06667
64402,2019,Abril,Alemania,2,2,,4,-72.409396,8.36068
64403,2019,Abril,Alemania,18,16,,34,-77.35002,8.63337
64404,2019,Abril,Andorra,10,14,,24,-74.140516,4.697157
64405,2019,Abril,Andorra,0,1,,1,-75.42726,6.170465
64406,2019,Abril,Angola,0,1,,1,-74.140516,4.697157
64407,2019,Abril,Angola,0,1,,1,-75.42726,6.170465
64408,2019,Abril,Antigua y Barbuda,1,1,,2,-75.516486,10.446304
64409,2019,Abril,Antigua y Barbuda,2,2,,4,-74.140516,4.697157
64410,2019,Abril,Antigua y Barbuda,0,1,,1,-75.736374,4.815189
64411,2019,Abril,Arabia Saudita,0,1,,1,-75.516486,10.446304
64412,2019,Abril,Arabia Saudita,0,4,,4,-74.140516,4.697157
64413,2019,Abril,Argelia,0,1,,1,-76.532004,3.451668
64414,2019,Abril,Argelia,2,3,,5,-74.140516,4.697157
64415,2019,Abril,Argelia,0,1,,1,-75.42726,6.170465
64416,2019,Abril,Argentina,4,5,,9,-69.941498,4.191162
64417,2019,Abril,Argentina,2,7,,9,-69.94143100000001,4.214082
64418,2019,Abril,Argentina,9,14,,23,-76.876446,0.33002
64419,2019,Abril,Argentina,91,134,,225,-77.35600000000001,0.81488
64420,2019,Abril,Argentina,316,210,,526,-75.527794,10.406342
64421,2019,Abril,Argentina,2055,1585,,3640,-75.516486,10.446304
64422,2019,Abril,Argentina,7,21,,28,-74.77647900000001,10.886686
64423,2019,Abril,Argentina,1,0,,1,-74.232675,11.117206
64424,2019,Abril,Argentina,1,2,,3,-72.129595,11.360028999999999
64425,2019,Abril,Argentina,167,121,,288,-81.70216500000001,12.5862
64426,2019,Abril,Argentina,131,211,,342,-76.532004,3.451668
64427,2019,Abril,Argentina,0,1,,1,-75.76635300000001,4.45285
64428,2019,Abril,Argentina,4687,5798,,10485,-74.140516,4.697157
64429,2019,Abril,Argentina,2,5,,7,-75.736374,4.815189
64430,2019,Abril,Argentina,200,353,,553,-75.42726,6.170465
64431,2019,Abril,Argentina,1,0,,1,-73.181317,7.1280470000000005
64432,2019,Abril,Argentina,1,6,,7,-72.453013,7.819
64433,2019,Abril,Argentina,2,1,,3,-72.409396,8.36068
64434,2019,Abril,Argentina,3,5,,8,-77.35002,8.63337
64435,2019,Abril,República de Armenia,0,1,,1,-75.516486,10.446304
64436,2019,Abril,República de Armenia,2,2,,4,-74.140516,4.697157
64437,2019,Abril,Aruba,1,0,,1,-74.140516,4.697157
64438,2019,Abril,Australia,0,1,,1,-69.941498,4.191162
64439,2019,Abril,Australia,5,2,,7,-69.94143100000001,4.214082
64440,2019,Abril,Australia,2,2,,4,-76.876446,0.33002
64441,2019,Abril,Australia,16,15,,31,-77.35600000000001,0.81488
64442,2019,Abril,Australia,12,16,,28,-75.527794,10.406342
64443,2019,Abril,Australia,48,57,,105,-75.516486,10.446304
64444,2019,Abril,Australia,7,13,,20,-74.77647900000001,10.886686
64445,2019,Abril,Australia,1,5,,6,-74.213989,11.247722999999999
64446,2019,Abril,Australia,24,32,,56,-76.532004,3.451668
64447,2019,Abril,Australia,344,549,,893,-74.140516,4.697157
64448,2019,Abril,Australia,1,4,,5,-75.736374,4.815189
64449,2019,Abril,Australia,56,119,,175,-75.42726,6.170465
64450,2019,Abril,Australia,0,1,,1,-73.181317,7.1280470000000005
64451,2019,Abril,Australia,0,1,,1,-72.453013,7.819
64452,2019,Abril,Australia,16,20,,36,-77.35002,8.63337
64453,2019,Abril,Austria,3,5,,8,-69.94143100000001,4.214082
64454,2019,Abril,Austria,1,2,,3,-76.876446,0.33002
64455,2019,Abril,Austria,14,8,,22,-77.35600000000001,0.81488
64456,2019,Abril,Austria,3,5,,8,-75.527794,10.406342
64457,2019,Abril,Austria,17,14,,31,-75.516486,10.446304
64458,2019,Abril,Austria,4,3,,7,-74.77647900000001,10.886686
64459,2019,Abril,Austria,0,2,,2,-81.70216500000001,12.5862
64460,2019,Abril,Austria,2,12,,14,-76.532004,3.451668
64461,2019,Abril,Austria,195,260,,455,-74.140516,4.697157
64462,2019,Abril,Austria,0,1,,1,-75.736374,4.815189
64463,2019,Abril,Austria,12,18,,30,-75.42726,6.170465
64464,2019,Abril,Austria,0,2,,2,-77.35002,8.63337
64465,2019,Abril,Azerbaiyán,0,3,,3,-75.516486,10.446304
64466,2019,Abril,Azerbaiyán,1,3,,4,-74.140516,4.697157
64467,2019,Abril,Azerbaiyán,0,1,,1,-75.42726,6.170465
64468,2019,Abril,Bahamas,6,3,,9,-75.516486,10.446304
64469,2019,Abril,Bahamas,0,1,,1,-74.77647900000001,10.886686
64470,2019,Abril,Bahamas,1,3,,4,-76.532004,3.451668
64471,2019,Abril,Bahamas,9,13,,22,-74.140516,4.697157
64472,2019,Abril,Bahamas,0,4,,4,-75.42726,6.170465
64473,2019,Abril,Bahamas,0,1,,1,-72.453013,7.819
64474,2019,Abril,Bahréin,0,1,,1,-74.140516,4.697157
64475,2019,Abril,Bangladesh,1,0,,1,-75.516486,10.446304
64476,2019,Abril,Bangladesh,0,1,,1,-77.061029,3.8844260000000004
64477,2019,Abril,Bangladesh,0,3,,3,-74.140516,4.697157
64478,2019,Abril,Bangladesh,0,2,,2,-75.68164200000001,9.402597
64479,2019,Abril,Barbados,5,1,,6,-75.516486,10.446304
64480,2019,Abril,Barbados,0,1,,1,-76.532004,3.451668
64481,2019,Abril,Barbados,9,15,,24,-74.140516,4.697157
64482,2019,Abril,Barbados,1,4,,5,-75.42726,6.170465
64483,2019,Abril,República de Belarús,0,1,,1,-75.516486,10.446304
64484,2019,Abril,República de Belarús,1,8,,9,-74.140516,4.697157
64485,2019,Abril,República de Belarús,0,1,,1,-75.42726,6.170465
64486,2019,Abril,República de Belarús,0,2,,2,-72.453013,7.819
64487,2019,Abril,Bélgica,2,2,,4,-69.941498,4.191162
64488,2019,Abril,Bélgica,3,2,,5,-69.94143100000001,4.214082
64489,2019,Abril,Bélgica,2,0,,2,-76.876446,0.33002
64490,2019,Abril,Bélgica,7,11,,18,-77.35600000000001,0.81488
64491,2019,Abril,Bélgica,0,3,,3,-75.527794,10.406342
64492,2019,Abril,Bélgica,41,48,,89,-75.516486,10.446304
64493,2019,Abril,Bélgica,5,9,,14,-74.77647900000001,10.886686
64494,2019,Abril,Bélgica,1,0,,1,-74.765343,10.970933
64495,2019,Abril,Bélgica,0,1,,1,-72.129595,11.360028999999999
64496,2019,Abril,Bélgica,0,3,,3,-81.70216500000001,12.5862
64497,2019,Abril,Bélgica,10,19,,29,-76.532004,3.451668
64498,2019,Abril,Bélgica,0,4,,4,-77.061029,3.8844260000000004
64499,2019,Abril,Bélgica,275,440,,715,-74.140516,4.697157
64500,2019,Abril,Bélgica,24,50,,74,-75.42726,6.170465
64501,2019,Abril,Bélgica,1,0,,1,-73.181317,7.1280470000000005
64502,2019,Abril,Bélgica,6,6,,12,-77.35002,8.63337
64503,2019,Abril,Belice,0,1,,1,-75.516486,10.446304
64504,2019,Abril,Belice,1,1,,2,-81.70216500000001,12.5862
64505,2019,Abril,Belice,3,1,,4,-76.532004,3.451668
64506,2019,Abril,Belice,8,10,,18,-74.140516,4.697157
64507,2019,Abril,Belice,2,7,,9,-75.42726,6.170465
64508,2019,Abril,Benín,1,0,,1,-74.77647900000001,10.886686
64509,2019,Abril,Bermudas/Territorio Británico de Ultramar,1,0,,1,-75.516486,10.446304
64510,2019,Abril,Bermudas/Territorio Británico de Ultramar,0,1,,1,-74.77647900000001,10.886686
64511,2019,Abril,Bermudas/Territorio Británico de Ultramar,0,1,,1,-74.140516,4.697157
64512,2019,Abril,Bermudas/Territorio Británico de Ultramar,1,4,,5,-75.42726,6.170465
64513,2019,Abril,Bolivia,1,3,,4,-69.941498,4.191162
64514,2019,Abril,Bolivia,0,2,,2,-69.94143100000001,4.214082
64515,2019,Abril,Bolivia,13,7,,20,-77.35600000000001,0.81488
64516,2019,Abril,Bolivia,23,15,,38,-75.527794,10.406342
64517,2019,Abril,Bolivia,137,112,,249,-75.516486,10.446304
64518,2019,Abril,Bolivia,3,8,,11,-74.77647900000001,10.886686
64519,2019,Abril,Bolivia,3,1,,4,-72.129595,11.360028999999999
64520,2019,Abril,Bolivia,13,11,,24,-81.70216500000001,12.5862
64521,2019,Abril,Bolivia,18,16,,34,-76.532004,3.451668
64522,2019,Abril,Bolivia,508,616,,1124,-74.140516,4.697157
64523,2019,Abril,Bolivia,1,0,,1,-75.736374,4.815189
64524,2019,Abril,Bolivia,17,31,,48,-75.42726,6.170465
64525,2019,Abril,Bolivia,0,1,,1,-72.453013,7.819
64526,2019,Abril,Bolivia,1,0,,1,-72.409396,8.36068
64527,2019,Abril,Bolivia,0,1,,1,-77.35002,8.63337
64528,2019,Abril,Bosnia y Herzegovina,0,1,,1,-75.527794,10.406342
64529,2019,Abril,Bosnia y Herzegovina,7,5,,12,-74.140516,4.697157
64530,2019,Abril,Bosnia y Herzegovina,0,2,,2,-75.42726,6.170465
64531,2019,Abril,Botsuana,0,1,,1,-74.140516,4.697157
64532,2019,Abril,Brasil,97,111,,208,-69.941498,4.191162
64533,2019,Abril,Brasil,6,6,,12,-69.94143100000001,4.214082
64534,2019,Abril,Brasil,0,4,,4,-76.876446,0.33002
64535,2019,Abril,Brasil,23,36,,59,-77.35600000000001,0.81488
64536,2019,Abril,Brasil,301,183,,484,-75.527794,10.406342
64537,2019,Abril,Brasil,824,598,,1422,-75.516486,10.446304
64538,2019,Abril,Brasil,14,25,,39,-74.77647900000001,10.886686
64539,2019,Abril,Brasil,2,3,,5,-72.129595,11.360028999999999
64540,2019,Abril,Brasil,330,260,,590,-81.70216500000001,12.5862
64541,2019,Abril,Brasil,105,156,,261,-76.532004,3.451668
64542,2019,Abril,Brasil,4130,5004,,9134,-74.140516,4.697157
64543,2019,Abril,Brasil,2,8,,10,-75.736374,4.815189
64544,2019,Abril,Brasil,138,235,,373,-75.42726,6.170465
64545,2019,Abril,Brasil,2,1,,3,-67.48402800000001,6.185536
64546,2019,Abril,Brasil,1,1,,2,-70.74025300000001,7.088728999999999
64547,2019,Abril,Brasil,1,3,,4,-73.181317,7.1280470000000005
64548,2019,Abril,Brasil,0,5,,5,-72.453013,7.819
64549,2019,Abril,Brasil,2,3,,5,-72.409396,8.36068
64550,2019,Abril,Brasil,1,1,,2,-77.35002,8.63337
64551,2019,Abril,Bulgaria,1,0,,1,-69.94143100000001,4.214082
64552,2019,Abril,Bulgaria,0,1,,1,-77.35600000000001,0.81488
64553,2019,Abril,Bulgaria,4,2,,6,-75.516486,10.446304
64554,2019,Abril,Bulgaria,0,1,,1,-74.77647900000001,10.886686
64555,2019,Abril,Bulgaria,1,3,,4,-76.532004,3.451668
64556,2019,Abril,Bulgaria,40,33,,73,-74.140516,4.697157
64557,2019,Abril,Bulgaria,1,0,,1,-75.736374,4.815189
64558,2019,Abril,Bulgaria,6,13,,19,-75.42726,6.170465
64559,2019,Abril,Islas Caimán/Territorio Británico de Ultramar,0,1,,1,-74.77647900000001,10.886686
64560,2019,Abril,Islas Caimán/Territorio Británico de Ultramar,1,0,,1,-76.532004,3.451668
64561,2019,Abril,Islas Caimán/Territorio Británico de Ultramar,0,1,,1,-74.140516,4.697157
64562,2019,Abril,Islas Caimán/Territorio Británico de Ultramar,0,1,,1,-75.42726,6.170465
64563,2019,Abril,Camboya,2,1,,3,-74.140516,4.697157
64564,2019,Abril,Camerún,1,0,,1,-75.516486,10.446304
64565,2019,Abril,Camerún,0,3,,3,-74.140516,4.697157
64566,2019,Abril,Canadá,5,3,,8,-69.941498,4.191162
64567,2019,Abril,Canadá,1,4,,5,-69.94143100000001,4.214082
64568,2019,Abril,Canadá,0,2,,2,-76.876446,0.33002
64569,2019,Abril,Canadá,20,12,,32,-77.35600000000001,0.81488
64570,2019,Abril,Canadá,53,45,,98,-75.527794,10.406342
64571,2019,Abril,Canadá,471,579,,1050,-75.516486,10.446304
64572,2019,Abril,Canadá,30,48,,78,-74.77647900000001,10.886686
64573,2019,Abril,Canadá,1,0,,1,-72.129595,11.360028999999999
64574,2019,Abril,Canadá,3,5,,8,-81.703935,12.574411099999999
64575,2019,Abril,Canadá,2,2,,4,-81.70216500000001,12.5862
64576,2019,Abril,Canadá,2,4,,6,-81.372937,13.338761300000002
64577,2019,Abril,Canadá,73,92,,165,-76.532004,3.451668
64578,2019,Abril,Canadá,2,1,,3,-75.76635300000001,4.45285
64579,2019,Abril,Canadá,1238,1984,,3222,-74.140516,4.697157
64580,2019,Abril,Canadá,7,6,,13,-75.736374,4.815189
64581,2019,Abril,Canadá,212,599,,811,-75.42726,6.170465
64582,2019,Abril,Canadá,3,6,,9,-73.181317,7.1280470000000005
64583,2019,Abril,Canadá,1,0,,1,-72.453013,7.819
64584,2019,Abril,Canadá,13,8,,21,-77.35002,8.63337
64585,2019,Abril,República Del Congo,0,1,,1,-74.140516,4.697157
64586,2019,Abril,República Democrática del Congo,1,2,,3,-74.140516,4.697157
64587,2019,Abril,República de Corea,1,0,,1,-69.941498,4.191162
64588,2019,Abril,República de Corea,2,0,,2,-69.94143100000001,4.214082
64589,2019,Abril,República de Corea,11,14,,25,-77.35600000000001,0.81488
64590,2019,Abril,República de Corea,0,1,,1,-75.527794,10.406342
64591,2019,Abril,República de Corea,5,6,,11,-75.516486,10.446304
64592,2019,Abril,República de Corea,0,3,,3,-74.77647900000001,10.886686
64593,2019,Abril,República de Corea,6,21,,27,-76.532004,3.451668
64594,2019,Abril,República de Corea,255,464,,719,-74.140516,4.697157
64595,2019,Abril,República de Corea,14,36,,50,-75.42726,6.170465
64596,2019,Abril,República de Corea,0,1,,1,-73.181317,7.1280470000000005
64597,2019,Abril,República de Corea,1,1,,2,-72.453013,7.819
64598,2019,Abril,República de Corea,1,0,,1,-77.35002,8.63337
64599,2019,Abril,Costa de Marfil,1,0,,1,-75.516486,10.446304
64600,2019,Abril,Costa de Marfil,1,2,,3,-74.140516,4.697157
64601,2019,Abril,Costa de Marfil,0,2,,2,-75.42726,6.170465
64602,2019,Abril,Costa Rica,1,0,,1,-69.941498,4.191162
64603,2019,Abril,Costa Rica,0,1,,1,-76.876446,0.33002
64604,2019,Abril,Costa Rica,2,4,,6,-77.35600000000001,0.81488
64605,2019,Abril,Costa Rica,8,7,,15,-75.527794,10.406342
64606,2019,Abril,Costa Rica,356,248,,604,-75.516486,10.446304
64607,2019,Abril,Costa Rica,42,32,,74,-74.77647900000001,10.886686
64608,2019,Abril,Costa Rica,0,4,,4,-74.232675,11.117206
64609,2019,Abril,Costa Rica,1,1,,2,-72.129595,11.360028999999999
64610,2019,Abril,Costa Rica,1,0,,1,-81.703935,12.574411099999999
64611,2019,Abril,Costa Rica,90,81,,171,-81.70216500000001,12.5862
64612,2019,Abril,Costa Rica,41,68,,109,-76.532004,3.451668
64613,2019,Abril,Costa Rica,1351,1518,,2869,-74.140516,4.697157
64614,2019,Abril,Costa Rica,11,22,,33,-75.736374,4.815189
64615,2019,Abril,Costa Rica,234,225,,459,-75.42726,6.170465
64616,2019,Abril,Costa Rica,0,4,,4,-73.181317,7.1280470000000005
64617,2019,Abril,Croacia,0,1,,1,-75.527794,10.406342
64618,2019,Abril,Croacia,3,6,,9,-75.516486,10.446304
64619,2019,Abril,Croacia,1,3,,4,-76.532004,3.451668
64620,2019,Abril,Croacia,14,48,,62,-74.140516,4.697157
64621,2019,Abril,Croacia,6,11,,17,-75.42726,6.170465
64622,2019,Abril,Croacia,0,1,,1,-75.68164200000001,9.402597
64623,2019,Abril,Cuba,2,0,,2,-69.941498,4.191162
64624,2019,Abril,Cuba,1,2,,3,-77.35600000000001,0.81488
64625,2019,Abril,Cuba,12,22,,34,-75.516486,10.446304
64626,2019,Abril,Cuba,14,28,,42,-74.77647900000001,10.886686
64627,2019,Abril,Cuba,0,2,,2,-72.129595,11.360028999999999
64628,2019,Abril,Cuba,13,22,,35,-76.532004,3.451668
64629,2019,Abril,Cuba,0,1,,1,-75.76635300000001,4.45285
64630,2019,Abril,Cuba,155,283,,438,-74.140516,4.697157
64631,2019,Abril,Cuba,2,1,,3,-75.736374,4.815189
64632,2019,Abril,Cuba,22,25,,47,-75.42726,6.170465
64633,2019,Abril,Cuba,1,3,,4,-73.181317,7.1280470000000005
64634,2019,Abril,Cuba,0,1,,1,-72.453013,7.819
64635,2019,Abril,República Checa,1,1,,2,-69.94143100000001,4.214082
64636,2019,Abril,República Checa,1,1,,2,-76.876446,0.33002
64637,2019,Abril,República Checa,1,4,,5,-77.35600000000001,0.81488
64638,2019,Abril,República Checa,0,1,,1,-75.527794,10.406342
64639,2019,Abril,República Checa,7,11,,18,-75.516486,10.446304
64640,2019,Abril,República Checa,1,1,,2,-74.77647900000001,10.886686
64641,2019,Abril,República Checa,2,1,,3,-76.532004,3.451668
64642,2019,Abril,República Checa,96,153,,249,-74.140516,4.697157
64643,2019,Abril,República Checa,5,3,,8,-75.42726,6.170465
64644,2019,Abril,República Checa,4,7,,11,-77.35002,8.63337
64645,2019,Abril,Chile,0,5,,5,-69.94143100000001,4.214082
64646,2019,Abril,Chile,2,2,,4,-76.876446,0.33002
64647,2019,Abril,Chile,36,51,,87,-77.35600000000001,0.81488
64648,2019,Abril,Chile,141,97,,238,-75.527794,10.406342
64649,2019,Abril,Chile,415,299,,714,-75.516486,10.446304
64650,2019,Abril,Chile,11,22,,33,-74.77647900000001,10.886686
64651,2019,Abril,Chile,4,8,,12,-72.129595,11.360028999999999
64652,2019,Abril,Chile,198,150,,348,-81.70216500000001,12.5862
64653,2019,Abril,Chile,84,148,,232,-76.532004,3.451668
64654,2019,Abril,Chile,1,0,,1,-75.76635300000001,4.45285
64655,2019,Abril,Chile,3519,4631,,8150,-74.140516,4.697157
64656,2019,Abril,Chile,7,7,,14,-75.736374,4.815189
64657,2019,Abril,Chile,66,177,,243,-75.42726,6.170465
64658,2019,Abril,Chile,0,2,,2,-73.181317,7.1280470000000005
64659,2019,Abril,Chile,9,25,,34,-72.453013,7.819
64660,2019,Abril,Chile,0,7,,7,-72.409396,8.36068
64661,2019,Abril,China,2,1,,3,-69.941498,4.191162
64662,2019,Abril,China,8,5,,13,-77.35600000000001,0.81488
64663,2019,Abril,China,0,5,,5,-75.527794,10.406342
64664,2019,Abril,China,16,27,,43,-75.516486,10.446304
64665,2019,Abril,China,5,15,,20,-74.77647900000001,10.886686
64666,2019,Abril,China,0,1,,1,-74.765343,10.970933
64667,2019,Abril,China,0,3,,3,-74.213989,11.247722999999999
64668,2019,Abril,China,1,0,,1,-72.129595,11.360028999999999
64669,2019,Abril,China,23,25,,48,-76.532004,3.451668
64670,2019,Abril,China,0,1,,1,-77.061029,3.8844260000000004
64671,2019,Abril,China,347,959,,1306,-74.140516,4.697157
64672,2019,Abril,China,4,1,,5,-75.736374,4.815189
64673,2019,Abril,China,55,105,,160,-75.42726,6.170465
64674,2019,Abril,China,1,1,,2,-67.48402800000001,6.185536
64675,2019,Abril,China,1,1,,2,-73.181317,7.1280470000000005
64676,2019,Abril,China,2,3,,5,-72.453013,7.819
64677,2019,Abril,China,0,2,,2,-75.68164200000001,9.402597
64678,2019,Abril,Taiwán,0,1,,1,-69.941498,4.191162
64679,2019,Abril,Taiwán,3,1,,4,-77.35600000000001,0.81488
64680,2019,Abril,Taiwán,4,2,,6,-75.516486,10.446304
64681,2019,Abril,Taiwán,2,5,,7,-74.77647900000001,10.886686
64682,2019,Abril,Taiwán,0,1,,1,-74.765343,10.970933
64683,2019,Abril,Taiwán,0,2,,2,-76.532004,3.451668
64684,2019,Abril,Taiwán,51,59,,110,-74.140516,4.697157
64685,2019,Abril,Taiwán,6,15,,21,-75.42726,6.170465
64686,2019,Abril,Chipre,1,0,,1,-77.35600000000001,0.81488
64687,2019,Abril,Chipre,1,1,,2,-75.516486,10.446304
64688,2019,Abril,Chipre,0,1,,1,-76.532004,3.451668
64689,2019,Abril,Chipre,7,6,,13,-74.140516,4.697157
64690,2019,Abril,Dinamarca,0,2,,2,-69.941498,4.191162
64691,2019,Abril,Dinamarca,0,2,,2,-76.876446,0.33002
64692,2019,Abril,Dinamarca,6,8,,14,-77.35600000000001,0.81488
64693,2019,Abril,Dinamarca,4,5,,9,-75.527794,10.406342
64694,2019,Abril,Dinamarca,14,25,,39,-75.516486,10.446304
64695,2019,Abril,Dinamarca,0,2,,2,-74.77647900000001,10.886686
64696,2019,Abril,Dinamarca,5,8,,13,-76.532004,3.451668
64697,2019,Abril,Dinamarca,100,165,,265,-74.140516,4.697157
64698,2019,Abril,Dinamarca,2,2,,4,-75.736374,4.815189
64699,2019,Abril,Dinamarca,15,30,,45,-75.42726,6.170465
64700,2019,Abril,Dinamarca,1,0,,1,-77.35002,8.63337
64701,2019,Abril,Dominica,0,1,,1,-75.516486,10.446304
64702,2019,Abril,Dominica,0,1,,1,-76.532004,3.451668
64703,2019,Abril,Dominica,2,3,,5,-74.140516,4.697157
64704,2019,Abril,Dominica,1,1,,2,-75.42726,6.170465
64705,2019,Abril,Ecuador,0,3,,3,-69.94143100000001,4.214082
64706,2019,Abril,Ecuador,0,1,,1,-74.78366,0.18595699999999998
64707,2019,Abril,Ecuador,81,293,,374,-76.876446,0.33002
64708,2019,Abril,Ecuador,10,11,,21,-77.84700600000001,0.8124359999999999
64709,2019,Abril,Ecuador,1336,2142,,3478,-77.35600000000001,0.81488
64710,2019,Abril,Ecuador,18,26,,44,-78.802679,18.00143
64711,2019,Abril,Ecuador,7,24,,31,-75.527794,10.406342
64712,2019,Abril,Ecuador,49,50,,99,-75.516486,10.446304
64713,2019,Abril,Ecuador,8,9,,17,-74.77647900000001,10.886686
64714,2019,Abril,Ecuador,11,7,,18,-72.129595,11.360028999999999
64715,2019,Abril,Ecuador,34,23,,57,-81.70216500000001,12.5862
64716,2019,Abril,Ecuador,449,487,,936,-76.532004,3.451668
64717,2019,Abril,Ecuador,1,2,,3,-67.927521,3.866713
64718,2019,Abril,Ecuador,0,2,,2,-75.76635300000001,4.45285
64719,2019,Abril,Ecuador,2755,3421,,6176,-74.140516,4.697157
64720,2019,Abril,Ecuador,3,4,,7,-75.736374,4.815189
64721,2019,Abril,Ecuador,51,86,,137,-75.42726,6.170465
64722,2019,Abril,Ecuador,1,0,,1,-70.74025300000001,7.088728999999999
64723,2019,Abril,Ecuador,2,3,,5,-73.181317,7.1280470000000005
64724,2019,Abril,Ecuador,48,59,,107,-72.453013,7.819
64725,2019,Abril,Ecuador,0,1,,1,-72.409396,8.36068
64726,2019,Abril,Ecuador,0,1,,1,-77.35002,8.63337
64727,2019,Abril,Egipto,2,2,,4,-75.516486,10.446304
64728,2019,Abril,Egipto,0,1,,1,-72.129595,11.360028999999999
64729,2019,Abril,Egipto,7,23,,30,-74.140516,4.697157
64730,2019,Abril,Egipto,0,1,,1,-75.42726,6.170465
64731,2019,Abril,Egipto,0,1,,1,-72.453013,7.819
64732,2019,Abril,El Salvador,2,0,,2,-69.94143100000001,4.214082
64733,2019,Abril,El Salvador,1,2,,3,-77.35600000000001,0.81488
64734,2019,Abril,El Salvador,0,1,,1,-75.527794,10.406342
64735,2019,Abril,El Salvador,152,125,,277,-75.516486,10.446304
64736,2019,Abril,El Salvador,6,3,,9,-74.77647900000001,10.886686
64737,2019,Abril,El Salvador,4,3,,7,-81.70216500000001,12.5862
64738,2019,Abril,El Salvador,97,123,,220,-76.532004,3.451668
64739,2019,Abril,El Salvador,679,694,,1373,-74.140516,4.697157
64740,2019,Abril,El Salvador,126,193,,319,-75.42726,6.170465
64741,2019,Abril,Emiratos Árabes,0,2,,2,-75.516486,10.446304
64742,2019,Abril,Emiratos Árabes,8,20,,28,-74.140516,4.697157
64743,2019,Abril,Emiratos Árabes,0,1,,1,-75.42726,6.170465
64744,2019,Abril,España,3,9,,12,-69.941498,4.191162
64745,2019,Abril,España,11,15,,26,-69.94143100000001,4.214082
64746,2019,Abril,España,4,4,,8,-76.876446,0.33002
64747,2019,Abril,España,0,1,,1,-77.84700600000001,0.8124359999999999
64748,2019,Abril,España,42,50,,92,-77.35600000000001,0.81488
64749,2019,Abril,España,14,31,,45,-75.527794,10.406342
64750,2019,Abril,España,114,194,,308,-75.516486,10.446304
64751,2019,Abril,España,24,52,,76,-74.77647900000001,10.886686
64752,2019,Abril,España,2,0,,2,-74.232675,11.117206
64753,2019,Abril,España,0,1,,1,-74.213989,11.247722999999999
64754,2019,Abril,España,9,13,,22,-72.129595,11.360028999999999
64755,2019,Abril,España,0,1,,1,-81.703935,12.574411099999999
64756,2019,Abril,España,7,4,,11,-81.70216500000001,12.5862
64757,2019,Abril,España,182,317,,499,-76.532004,3.451668
64758,2019,Abril,España,3637,5879,,9516,-74.140516,4.697157
64759,2019,Abril,España,5,11,,16,-75.736374,4.815189
64760,2019,Abril,España,352,688,,1040,-75.42726,6.170465
64761,2019,Abril,España,1,4,,5,-70.74025300000001,7.088728999999999
64762,2019,Abril,España,7,4,,11,-73.181317,7.1280470000000005
64763,2019,Abril,España,16,39,,55,-72.453013,7.819
64764,2019,Abril,España,0,1,,1,-72.508188,7.927233
64765,2019,Abril,España,5,6,,11,-72.409396,8.36068
64766,2019,Abril,España,2,2,,4,-77.35002,8.63337
64767,2019,Abril,Eslovaquia,1,1,,2,-76.876446,0.33002
64768,2019,Abril,Eslovaquia,2,1,,3,-77.35600000000001,0.81488
64769,2019,Abril,Eslovaquia,2,2,,4,-75.516486,10.446304
64770,2019,Abril,Eslovaquia,1,2,,3,-74.77647900000001,10.886686
64771,2019,Abril,Eslovaquia,1,0,,1,-76.532004,3.451668
64772,2019,Abril,Eslovaquia,59,72,,131,-74.140516,4.697157
64773,2019,Abril,Eslovaquia,5,8,,13,-75.42726,6.170465
64774,2019,Abril,Eslovaquia,0,1,,1,-77.35002,8.63337
64775,2019,Abril,Eslovenia,1,2,,3,-77.35600000000001,0.81488
64776,2019,Abril,Eslovenia,0,2,,2,-75.527794,10.406342
64777,2019,Abril,Eslovenia,0,1,,1,-75.516486,10.446304
64778,2019,Abril,Eslovenia,1,1,,2,-76.532004,3.451668
64779,2019,Abril,Eslovenia,15,48,,63,-74.140516,4.697157
64780,2019,Abril,Eslovenia,1,3,,4,-75.42726,6.170465
64781,2019,Abril,Eslovenia,1,0,,1,-72.409396,8.36068
64782,2019,Abril,Estados Unidos de América,4,9,,13,-69.941498,4.191162
64783,2019,Abril,Estados Unidos de América,18,21,,39,-69.94143100000001,4.214082
64784,2019,Abril,Estados Unidos de América,2,3,,5,-76.876446,0.33002
64785,2019,Abril,Estados Unidos de América,39,72,,111,-77.35600000000001,0.81488
64786,2019,Abril,Estados Unidos de América,77,101,,178,-75.527794,10.406342
64787,2019,Abril,Estados Unidos de América,3,10,,13,-73.247863,10.433608999999999
64788,2019,Abril,Estados Unidos de América,4848,6619,,11467,-75.516486,10.446304
64789,2019,Abril,Estados Unidos de América,593,989,,1582,-74.77647900000001,10.886686
64790,2019,Abril,Estados Unidos de América,7,14,,21,-74.232675,11.117206
64791,2019,Abril,Estados Unidos de América,1,6,,7,-74.213989,11.247722999999999
64792,2019,Abril,Estados Unidos de América,8,18,,26,-72.129595,11.360028999999999
64793,2019,Abril,Estados Unidos de América,5,10,,15,-81.703935,12.574411099999999
64794,2019,Abril,Estados Unidos de América,21,31,,52,-81.70216500000001,12.5862
64795,2019,Abril,Estados Unidos de América,4,14,,18,-81.372937,13.338761300000002
64796,2019,Abril,Estados Unidos de América,1414,1832,,3246,-76.532004,3.451668
64797,2019,Abril,Estados Unidos de América,89,157,,246,-75.76635300000001,4.45285
64798,2019,Abril,Estados Unidos de América,8662,14789,,23451,-74.140516,4.697157
64799,2019,Abril,Estados Unidos de América,154,308,,462,-75.736374,4.815189
64800,2019,Abril,Estados Unidos de América,2838,6927,,9765,-75.42726,6.170465
64801,2019,Abril,Estados Unidos de América,1,0,,1,-77.762647,7.102626
64802,2019,Abril,Estados Unidos de América,32,38,,70,-73.181317,7.1280470000000005
64803,2019,Abril,Estados Unidos de América,13,24,,37,-72.453013,7.819
64804,2019,Abril,Estados Unidos de América,20,55,,75,-72.508188,7.927233
64805,2019,Abril,Estados Unidos de América,1,2,,3,-72.409396,8.36068
64806,2019,Abril,Estados Unidos de América,4,4,,8,-77.35002,8.63337
64807,2019,Abril,Estados Unidos de América,0,1,,1,-75.68164200000001,9.402597
64808,2019,Abril,Estonia,0,1,,1,-69.94143100000001,4.214082
64809,2019,Abril,Estonia,3,0,,3,-77.35600000000001,0.81488
64810,2019,Abril,Estonia,2,0,,2,-75.516486,10.446304
64811,2019,Abril,Estonia,3,2,,5,-76.532004,3.451668
64812,2019,Abril,Estonia,7,12,,19,-74.140516,4.697157
64813,2019,Abril,Estonia,2,9,,11,-75.42726,6.170465
64814,2019,Abril,Etiopia,0,1,,1,-75.516486,10.446304
64815,2019,Abril,Etiopia,2,50,,52,-74.140516,4.697157
64816,2019,Abril,Etiopia,0,2,,2,-75.42726,6.170465
64817,2019,Abril,Filipinas,1,0,,1,-76.876446,0.33002
64818,2019,Abril,Filipinas,1,0,,1,-77.35600000000001,0.81488
64819,2019,Abril,Filipinas,1,60,,61,-75.527794,10.406342
64820,2019,Abril,Filipinas,5,85,,90,-75.516486,10.446304
64821,2019,Abril,Filipinas,0,32,,32,-74.77647900000001,10.886686
64822,2019,Abril,Filipinas,0,31,,31,-74.765343,10.970933
64823,2019,Abril,Filipinas,0,3,,3,-74.213989,11.247722999999999
64824,2019,Abril,Filipinas,2,8,,10,-76.532004,3.451668
64825,2019,Abril,Filipinas,0,4,,4,-77.061029,3.8844260000000004
64826,2019,Abril,Filipinas,41,45,,86,-74.140516,4.697157
64827,2019,Abril,Filipinas,1,0,,1,-75.736374,4.815189
64828,2019,Abril,Filipinas,3,7,,10,-75.42726,6.170465
64829,2019,Abril,Filipinas,0,3,,3,-75.68164200000001,9.402597
64830,2019,Abril,Finlandia,2,1,,3,-77.35600000000001,0.81488
64831,2019,Abril,Finlandia,8,9,,17,-75.516486,10.446304
64832,2019,Abril,Finlandia,1,8,,9,-76.532004,3.451668
64833,2019,Abril,Finlandia,37,54,,91,-74.140516,4.697157
64834,2019,Abril,Finlandia,0,1,,1,-75.736374,4.815189
64835,2019,Abril,Finlandia,4,12,,16,-75.42726,6.170465
64836,2019,Abril,Finlandia,0,1,,1,-77.35002,8.63337
64837,2019,Abril,Francia,17,5,,22,-69.941498,4.191162
64838,2019,Abril,Francia,25,25,,50,-69.94143100000001,4.214082
64839,2019,Abril,Francia,9,14,,23,-76.876446,0.33002
64840,2019,Abril,Francia,91,105,,196,-77.35600000000001,0.81488
64841,2019,Abril,Francia,18,24,,42,-75.527794,10.406342
64842,2019,Abril,Francia,175,261,,436,-75.516486,10.446304
64843,2019,Abril,Francia,18,25,,43,-74.77647900000001,10.886686
64844,2019,Abril,Francia,0,3,,3,-74.765343,10.970933
64845,2019,Abril,Francia,0,4,,4,-74.232675,11.117206
64846,2019,Abril,Francia,3,6,,9,-74.213989,11.247722999999999
64847,2019,Abril,Francia,2,4,,6,-72.129595,11.360028999999999
64848,2019,Abril,Francia,1,2,,3,-81.703935,12.574411099999999
64849,2019,Abril,Francia,1,3,,4,-81.70216500000001,12.5862
64850,2019,Abril,Francia,101,145,,246,-76.532004,3.451668
64851,2019,Abril,Francia,0,1,,1,-77.061029,3.8844260000000004
64852,2019,Abril,Francia,1,0,,1,-75.76635300000001,4.45285
64853,2019,Abril,Francia,2175,3057,,5232,-74.140516,4.697157
64854,2019,Abril,Francia,12,11,,23,-75.736374,4.815189
64855,2019,Abril,Francia,237,336,,573,-75.42726,6.170465
64856,2019,Abril,Francia,3,4,,7,-73.181317,7.1280470000000005
64857,2019,Abril,Francia,2,1,,3,-72.453013,7.819
64858,2019,Abril,Francia,0,1,,1,-72.409396,8.36068
64859,2019,Abril,Francia,6,11,,17,-77.35002,8.63337
64860,2019,Abril,Gambia,1,0,,1,-74.140516,4.697157
64861,2019,Abril,Georgia,0,15,,15,-75.527794,10.406342
64862,2019,Abril,Georgia,0,4,,4,-75.516486,10.446304
64863,2019,Abril,Georgia,7,9,,16,-74.140516,4.697157
64864,2019,Abril,Georgia,0,2,,2,-75.68164200000001,9.402597
64865,2019,Abril,Ghana,1,2,,3,-75.516486,10.446304
64866,2019,Abril,Ghana,0,4,,4,-74.140516,4.697157
64867,2019,Abril,Ghana,1,1,,2,-75.42726,6.170465
64868,2019,Abril,Gibraltar/Territorio Británico de Ultramar,0,1,,1,-74.140516,4.697157
64869,2019,Abril,Granada,0,1,,1,-74.232675,11.117206
64870,2019,Abril,Granada,2,1,,3,-76.532004,3.451668
64871,2019,Abril,Granada,1,3,,4,-74.140516,4.697157
64872,2019,Abril,Granada,0,1,,1,-75.42726,6.170465
64873,2019,Abril,Granada,0,1,,1,-72.453013,7.819
64874,2019,Abril,Grecia,1,0,,1,-77.35600000000001,0.81488
64875,2019,Abril,Grecia,0,1,,1,-75.527794,10.406342
64876,2019,Abril,Grecia,4,14,,18,-75.516486,10.446304
64877,2019,Abril,Grecia,4,5,,9,-76.532004,3.451668
64878,2019,Abril,Grecia,44,76,,120,-74.140516,4.697157
64879,2019,Abril,Grecia,2,3,,5,-75.42726,6.170465
64880,2019,Abril,Grecia,1,0,,1,-77.35002,8.63337
64881,2019,Abril,Grecia,0,2,,2,-75.68164200000001,9.402597
64882,2019,Abril,Guatemala,1,0,,1,-76.876446,0.33002
64883,2019,Abril,Guatemala,1,1,,2,-77.35600000000001,0.81488
64884,2019,Abril,Guatemala,12,8,,20,-75.527794,10.406342
64885,2019,Abril,Guatemala,206,189,,395,-75.516486,10.446304
64886,2019,Abril,Guatemala,7,15,,22,-74.77647900000001,10.886686
64887,2019,Abril,Guatemala,0,1,,1,-74.765343,10.970933
64888,2019,Abril,Guatemala,0,1,,1,-72.129595,11.360028999999999
64889,2019,Abril,Guatemala,17,9,,26,-81.70216500000001,12.5862
64890,2019,Abril,Guatemala,33,59,,92,-76.532004,3.451668
64891,2019,Abril,Guatemala,585,789,,1374,-74.140516,4.697157
64892,2019,Abril,Guatemala,6,10,,16,-75.736374,4.815189
64893,2019,Abril,Guatemala,72,136,,208,-75.42726,6.170465
64894,2019,Abril,Guatemala,0,6,,6,-73.181317,7.1280470000000005
64895,2019,Abril,Guatemala,0,1,,1,-77.35002,8.63337
64896,2019,Abril,Guyana,0,1,,1,-69.941498,4.191162
64897,2019,Abril,Guyana,0,1,,1,-76.876446,0.33002
64898,2019,Abril,Guyana,0,5,,5,-75.516486,10.446304
64899,2019,Abril,Guyana,15,15,,30,-74.140516,4.697157
64900,2019,Abril,Guyana,0,7,,7,-75.42726,6.170465
64901,2019,Abril,Guyana,0,1,,1,-72.453013,7.819
64902,2019,Abril,Guinea,0,1,,1,-74.140516,4.697157
64903,2019,Abril,Guayana Francesa/Departamento de Ultramar Francés,0,1,,1,-76.532004,3.451668
64904,2019,Abril,Guayana Francesa/Departamento de Ultramar Francés,0,1,,1,-74.140516,4.697157
64905,2019,Abril,Haití,2,2,,4,-75.516486,10.446304
64906,2019,Abril,Haití,1,2,,3,-74.77647900000001,10.886686
64907,2019,Abril,Haití,1,0,,1,-76.532004,3.451668
64908,2019,Abril,Haití,7,22,,29,-74.140516,4.697157
64909,2019,Abril,Haití,4,6,,10,-75.42726,6.170465
64910,2019,Abril,Honduras,1,0,,1,-69.941498,4.191162
64911,2019,Abril,Honduras,0,1,,1,-69.94143100000001,4.214082
64912,2019,Abril,Honduras,3,3,,6,-77.35600000000001,0.81488
64913,2019,Abril,Honduras,0,1,,1,-75.527794,10.406342
64914,2019,Abril,Honduras,156,126,,282,-75.516486,10.446304
64915,2019,Abril,Honduras,8,12,,20,-74.77647900000001,10.886686
64916,2019,Abril,Honduras,0,1,,1,-74.765343,10.970933
64917,2019,Abril,Honduras,0,2,,2,-81.703935,12.574411099999999
64918,2019,Abril,Honduras,0,2,,2,-81.372937,13.338761300000002
64919,2019,Abril,Honduras,64,43,,107,-76.532004,3.451668
64920,2019,Abril,Honduras,347,341,,688,-74.140516,4.697157
64921,2019,Abril,Honduras,8,5,,13,-75.736374,4.815189
64922,2019,Abril,Honduras,80,80,,160,-75.42726,6.170465
64923,2019,Abril,Honduras,0,4,,4,-73.181317,7.1280470000000005
64924,2019,Abril,Honduras,2,1,,3,-72.453013,7.819
64925,2019,Abril,Hong Kong,0,1,,1,-77.35600000000001,0.81488
64926,2019,Abril,Hong Kong,4,1,,5,-75.516486,10.446304
64927,2019,Abril,Hong Kong,21,16,,37,-74.140516,4.697157
64928,2019,Abril,Hong Kong,5,3,,8,-75.42726,6.170465
64929,2019,Abril,Hungría,4,1,,5,-77.35600000000001,0.81488
64930,2019,Abril,Hungría,2,1,,3,-75.527794,10.406342
64931,2019,Abril,Hungría,1,3,,4,-75.516486,10.446304
64932,2019,Abril,Hungría,1,0,,1,-74.77647900000001,10.886686
64933,2019,Abril,Hungría,1,1,,2,-76.532004,3.451668
64934,2019,Abril,Hungría,42,61,,103,-74.140516,4.697157
64935,2019,Abril,Hungría,4,6,,10,-75.42726,6.170465
64936,2019,Abril,India,0,3,,3,-77.35600000000001,0.81488
64937,2019,Abril,India,0,16,,16,-75.527794,10.406342
64938,2019,Abril,India,22,56,,78,-75.516486,10.446304
64939,2019,Abril,India,6,19,,25,-74.77647900000001,10.886686
64940,2019,Abril,India,0,5,,5,-74.213989,11.247722999999999
64941,2019,Abril,India,1,8,,9,-76.532004,3.451668
64942,2019,Abril,India,92,444,,536,-74.140516,4.697157
64943,2019,Abril,India,1,4,,5,-75.736374,4.815189
64944,2019,Abril,India,7,61,,68,-75.42726,6.170465
64945,2019,Abril,Indonesia,0,6,,6,-75.527794,10.406342
64946,2019,Abril,Indonesia,3,18,,21,-75.516486,10.446304
64947,2019,Abril,Indonesia,0,1,,1,-76.532004,3.451668
64948,2019,Abril,Indonesia,10,26,,36,-74.140516,4.697157
64949,2019,Abril,Indonesia,2,2,,4,-75.42726,6.170465
64950,2019,Abril,Iraq,0,3,,3,-74.140516,4.697157
64951,2019,Abril,Irán,0,2,,2,-75.516486,10.446304
64952,2019,Abril,Irán,0,1,,1,-74.77647900000001,10.886686
64953,2019,Abril,Irán,0,1,,1,-76.532004,3.451668
64954,2019,Abril,Irán,4,15,,19,-74.140516,4.697157
64955,2019,Abril,Irán,0,3,,3,-75.42726,6.170465
64956,2019,Abril,República de Irlanda,1,1,,2,-69.941498,4.191162
64957,2019,Abril,República de Irlanda,1,2,,3,-69.94143100000001,4.214082
64958,2019,Abril,República de Irlanda,10,17,,27,-77.35600000000001,0.81488
64959,2019,Abril,República de Irlanda,2,1,,3,-75.527794,10.406342
64960,2019,Abril,República de Irlanda,20,17,,37,-75.516486,10.446304
64961,2019,Abril,República de Irlanda,1,2,,3,-74.77647900000001,10.886686
64962,2019,Abril,República de Irlanda,0,1,,1,-74.232675,11.117206
64963,2019,Abril,República de Irlanda,1,2,,3,-74.213989,11.247722999999999
64964,2019,Abril,República de Irlanda,0,1,,1,-81.703935,12.574411099999999
64965,2019,Abril,República de Irlanda,1,5,,6,-76.532004,3.451668
64966,2019,Abril,República de Irlanda,118,184,,302,-74.140516,4.697157
64967,2019,Abril,República de Irlanda,8,31,,39,-75.42726,6.170465
64968,2019,Abril,República de Irlanda,8,7,,15,-77.35002,8.63337
64969,2019,Abril,Islandia,2,2,,4,-75.527794,10.406342
64970,2019,Abril,Islandia,3,1,,4,-75.516486,10.446304
64971,2019,Abril,Islandia,1,2,,3,-76.532004,3.451668
64972,2019,Abril,Islandia,8,6,,14,-74.140516,4.697157
64973,2019,Abril,Islandia,2,3,,5,-75.42726,6.170465
64974,2019,Abril,Israel,4,4,,8,-69.941498,4.191162
64975,2019,Abril,Israel,2,9,,11,-69.94143100000001,4.214082
64976,2019,Abril,Israel,0,2,,2,-76.876446,0.33002
64977,2019,Abril,Israel,7,44,,51,-77.35600000000001,0.81488
64978,2019,Abril,Israel,38,36,,74,-75.527794,10.406342
64979,2019,Abril,Israel,31,68,,99,-75.516486,10.446304
64980,2019,Abril,Israel,3,5,,8,-74.77647900000001,10.886686
64981,2019,Abril,Israel,1,2,,3,-81.70216500000001,12.5862
64982,2019,Abril,Israel,35,51,,86,-76.532004,3.451668
64983,2019,Abril,Israel,284,646,,930,-74.140516,4.697157
64984,2019,Abril,Israel,0,1,,1,-75.736374,4.815189
64985,2019,Abril,Israel,220,339,,559,-75.42726,6.170465
64986,2019,Abril,Italia,0,2,,2,-69.941498,4.191162
64987,2019,Abril,Italia,2,7,,9,-69.94143100000001,4.214082
64988,2019,Abril,Italia,1,2,,3,-76.876446,0.33002
64989,2019,Abril,Italia,10,13,,23,-77.35600000000001,0.81488
64990,2019,Abril,Italia,0,1,,1,-78.802679,18.00143
64991,2019,Abril,Italia,5,14,,19,-75.527794,10.406342
64992,2019,Abril,Italia,86,167,,253,-75.516486,10.446304
64993,2019,Abril,Italia,15,35,,50,-74.77647900000001,10.886686
64994,2019,Abril,Italia,1,0,,1,-74.765343,10.970933
64995,2019,Abril,Italia,0,1,,1,-74.232675,11.117206
64996,2019,Abril,Italia,1,2,,3,-74.213989,11.247722999999999
64997,2019,Abril,Italia,11,21,,32,-72.129595,11.360028999999999
64998,2019,Abril,Italia,1,1,,2,-81.703935,12.574411099999999
64999,2019,Abril,Italia,6,10,,16,-81.70216500000001,12.5862
65000,2019,Abril,Italia,0,2,,2,-81.372937,13.338761300000002
65001,2019,Abril,Italia,22,91,,113,-76.532004,3.451668
65002,2019,Abril,Italia,893,1768,,2661,-74.140516,4.697157
65003,2019,Abril,Italia,1,5,,6,-75.736374,4.815189
65004,2019,Abril,Italia,67,200,,267,-75.42726,6.170465
65005,2019,Abril,Italia,0,4,,4,-70.74025300000001,7.088728999999999
65006,2019,Abril,Italia,0,1,,1,-73.181317,7.1280470000000005
65007,2019,Abril,Italia,16,27,,43,-72.453013,7.819
65008,2019,Abril,Italia,4,4,,8,-72.409396,8.36068
65009,2019,Abril,Italia,2,6,,8,-77.35002,8.63337
65010,2019,Abril,Jamaica,10,8,,18,-75.516486,10.446304
65011,2019,Abril,Jamaica,2,5,,7,-74.77647900000001,10.886686
65012,2019,Abril,Jamaica,2,9,,11,-76.532004,3.451668
65013,2019,Abril,Jamaica,28,37,,65,-74.140516,4.697157
65014,2019,Abril,Jamaica,0,5,,5,-75.736374,4.815189
65015,2019,Abril,Jamaica,3,10,,13,-75.42726,6.170465
65016,2019,Abril,Japón,0,1,,1,-69.941498,4.191162
65017,2019,Abril,Japón,1,3,,4,-69.94143100000001,4.214082
65018,2019,Abril,Japón,0,1,,1,-76.876446,0.33002
65019,2019,Abril,Japón,6,12,,18,-77.35600000000001,0.81488
65020,2019,Abril,Japón,8,14,,22,-75.516486,10.446304
65021,2019,Abril,Japón,2,5,,7,-74.77647900000001,10.886686
65022,2019,Abril,Japón,0,1,,1,-81.70216500000001,12.5862
65023,2019,Abril,Japón,13,26,,39,-76.532004,3.451668
65024,2019,Abril,Japón,173,376,,549,-74.140516,4.697157
65025,2019,Abril,Japón,0,3,,3,-75.736374,4.815189
65026,2019,Abril,Japón,22,35,,57,-75.42726,6.170465
65027,2019,Abril,Japón,2,0,,2,-72.453013,7.819
65028,2019,Abril,Jordania,0,5,,5,-74.140516,4.697157
65029,2019,Abril,Jordania,0,1,,1,-75.42726,6.170465
65030,2019,Abril,Kazajistán,1,1,,2,-77.35600000000001,0.81488
65031,2019,Abril,Kazajistán,1,0,,1,-75.516486,10.446304
65032,2019,Abril,Kazajistán,8,5,,13,-74.140516,4.697157
65033,2019,Abril,Kenia,0,1,,1,-76.876446,0.33002
65034,2019,Abril,Kenia,1,2,,3,-75.516486,10.446304
65035,2019,Abril,Kenia,1,6,,7,-74.140516,4.697157
65036,2019,Abril,Kiribati,0,1,,1,-74.213989,11.247722999999999
65037,2019,Abril,Kuwait,0,5,,5,-75.516486,10.446304
65038,2019,Abril,Kuwait,0,5,,5,-74.140516,4.697157
65039,2019,Abril,República de Kosovo,0,1,,1,-74.140516,4.697157
65040,2019,Abril,República Democrática Popular  Lao,0,3,,3,-74.140516,4.697157
65041,2019,Abril,Letonia,0,1,,1,-69.94143100000001,4.214082
65042,2019,Abril,Letonia,0,1,,1,-77.35600000000001,0.81488
65043,2019,Abril,Letonia,0,2,,2,-75.527794,10.406342
65044,2019,Abril,Letonia,10,13,,23,-74.140516,4.697157
65045,2019,Abril,Letonia,1,0,,1,-75.42726,6.170465
65046,2019,Abril,Lituania,2,0,,2,-77.35600000000001,0.81488
65047,2019,Abril,Lituania,0,2,,2,-75.527794,10.406342
65048,2019,Abril,Lituania,0,2,,2,-75.516486,10.446304
65049,2019,Abril,Lituania,0,2,,2,-76.532004,3.451668
65050,2019,Abril,Lituania,28,21,,49,-74.140516,4.697157
65051,2019,Abril,Lituania,3,6,,9,-75.42726,6.170465
65052,2019,Abril,Líbano,0,1,,1,-77.35600000000001,0.81488
65053,2019,Abril,Líbano,0,1,,1,-75.516486,10.446304
65054,2019,Abril,Líbano,1,3,,4,-74.77647900000001,10.886686
65055,2019,Abril,Líbano,1,3,,4,-72.129595,11.360028999999999
65056,2019,Abril,Líbano,0,1,,1,-76.532004,3.451668
65057,2019,Abril,Líbano,18,30,,48,-74.140516,4.697157
65058,2019,Abril,Liechtenstein,0,1,,1,-75.516486,10.446304
65059,2019,Abril,Liechtenstein,3,1,,4,-74.140516,4.697157
65060,2019,Abril,Luxemburgo,1,0,,1,-69.94143100000001,4.214082
65061,2019,Abril,Luxemburgo,2,4,,6,-75.516486,10.446304
65062,2019,Abril,Luxemburgo,0,3,,3,-76.532004,3.451668
65063,2019,Abril,Luxemburgo,7,14,,21,-74.140516,4.697157
65064,2019,Abril,Luxemburgo,1,0,,1,-75.42726,6.170465
65065,2019,Abril,Macedonia,0,1,,1,-75.516486,10.446304
65066,2019,Abril,Macedonia,4,10,,14,-74.140516,4.697157
65067,2019,Abril,Macedonia,0,1,,1,-75.42726,6.170465
65068,2019,Abril,Madagascar,2,0,,2,-74.140516,4.697157
65069,2019,Abril,Malasia,0,1,,1,-69.941498,4.191162
65070,2019,Abril,Malasia,1,1,,2,-77.35600000000001,0.81488
65071,2019,Abril,Malasia,3,2,,5,-75.516486,10.446304
65072,2019,Abril,Malasia,0,1,,1,-74.77647900000001,10.886686
65073,2019,Abril,Malasia,10,13,,23,-74.140516,4.697157
65074,2019,Abril,Malasia,1,2,,3,-75.42726,6.170465
65075,2019,Abril,Malawi,0,1,,1,-74.140516,4.697157
65076,2019,Abril,Malta,0,1,,1,-77.35600000000001,0.81488
65077,2019,Abril,Malta,0,1,,1,-76.532004,3.451668
65078,2019,Abril,Malta,3,4,,7,-74.140516,4.697157
65079,2019,Abril,Malta,1,3,,4,-75.42726,6.170465
65080,2019,Abril,Marruecos,3,2,,5,-75.516486,10.446304
65081,2019,Abril,Marruecos,1,0,,1,-74.77647900000001,10.886686
65082,2019,Abril,Marruecos,11,17,,28,-74.140516,4.697157
65083,2019,Abril,Marruecos,1,0,,1,-75.736374,4.815189
65084,2019,Abril,Marruecos,1,0,,1,-75.42726,6.170465
65085,2019,Abril,Mauricio,2,2,,4,-75.516486,10.446304
65086,2019,Abril,Mauricio,1,1,,2,-74.140516,4.697157
65087,2019,Abril,Mauricio,0,1,,1,-75.42726,6.170465
65088,2019,Abril,México,2,0,,2,-69.941498,4.191162
65089,2019,Abril,México,2,1,,3,-69.94143100000001,4.214082
65090,2019,Abril,México,0,1,,1,-76.876446,0.33002
65091,2019,Abril,México,25,54,,79,-77.35600000000001,0.81488
65092,2019,Abril,México,38,31,,69,-75.527794,10.406342
65093,2019,Abril,México,341,494,,835,-75.516486,10.446304
65094,2019,Abril,México,54,83,,137,-74.77647900000001,10.886686
65095,2019,Abril,México,3,4,,7,-72.129595,11.360028999999999
65096,2019,Abril,México,0,2,,2,-81.703935,12.574411099999999
65097,2019,Abril,México,5,4,,9,-81.70216500000001,12.5862
65098,2019,Abril,México,99,198,,297,-76.532004,3.451668
65099,2019,Abril,México,1,1,,2,-75.76635300000001,4.45285
65100,2019,Abril,México,5703,8333,,14036,-74.140516,4.697157
65101,2019,Abril,México,14,15,,29,-75.736374,4.815189
65102,2019,Abril,México,559,1144,,1703,-75.42726,6.170465
65103,2019,Abril,México,6,20,,26,-73.181317,7.1280470000000005
65104,2019,Abril,México,6,7,,13,-72.453013,7.819
65105,2019,Abril,México,0,1,,1,-72.409396,8.36068
65106,2019,Abril,México,0,2,,2,-77.35002,8.63337
65107,2019,Abril,República de Moldavia,4,2,,6,-74.140516,4.697157
65108,2019,Abril,Mongolia,2,0,,2,-74.140516,4.697157
65109,2019,Abril,Montenegro,0,2,,2,-75.527794,10.406342
65110,2019,Abril,Montenegro,0,3,,3,-75.516486,10.446304
65111,2019,Abril,Montenegro,0,1,,1,-74.77647900000001,10.886686
65112,2019,Abril,Montenegro,1,2,,3,-74.140516,4.697157
65113,2019,Abril,Montenegro,0,1,,1,-75.42726,6.170465
65114,2019,Abril,Mozambique,1,1,,2,-74.140516,4.697157
65115,2019,Abril,Myanmar,0,9,,9,-75.527794,10.406342
65116,2019,Abril,Myanmar,0,9,,9,-75.516486,10.446304
65117,2019,Abril,Myanmar,0,1,,1,-74.140516,4.697157
65118,2019,Abril,Nepal,0,1,,1,-77.35600000000001,0.81488
65119,2019,Abril,Nepal,1,0,,1,-75.516486,10.446304
65120,2019,Abril,Nepal,2,2,,4,-74.140516,4.697157
65121,2019,Abril,Nicaragua,38,50,,88,-75.516486,10.446304
65122,2019,Abril,Nicaragua,0,2,,2,-74.77647900000001,10.886686
65123,2019,Abril,Nicaragua,0,1,,1,-74.232675,11.117206
65124,2019,Abril,Nicaragua,0,1,,1,-72.129595,11.360028999999999
65125,2019,Abril,Nicaragua,5,9,,14,-81.703935,12.574411099999999
65126,2019,Abril,Nicaragua,1,1,,2,-81.70216500000001,12.5862
65127,2019,Abril,Nicaragua,11,11,,22,-76.532004,3.451668
65128,2019,Abril,Nicaragua,86,130,,216,-74.140516,4.697157
65129,2019,Abril,Nicaragua,1,2,,3,-75.736374,4.815189
65130,2019,Abril,Nicaragua,15,22,,37,-75.42726,6.170465
65131,2019,Abril,Nicaragua,1,3,,4,-73.181317,7.1280470000000005
65132,2019,Abril,Nigeria,0,3,,3,-75.516486,10.446304
65133,2019,Abril,Nigeria,1,0,,1,-74.77647900000001,10.886686
65134,2019,Abril,Nigeria,8,18,,26,-74.140516,4.697157
65135,2019,Abril,Nigeria,1,3,,4,-75.42726,6.170465
65136,2019,Abril,Noruega,2,0,,2,-69.941498,4.191162
65137,2019,Abril,Noruega,2,4,,6,-69.94143100000001,4.214082
65138,2019,Abril,Noruega,1,0,,1,-76.876446,0.33002
65139,2019,Abril,Noruega,10,3,,13,-77.35600000000001,0.81488
65140,2019,Abril,Noruega,5,2,,7,-75.527794,10.406342
65141,2019,Abril,Noruega,22,36,,58,-75.516486,10.446304
65142,2019,Abril,Noruega,2,3,,5,-74.77647900000001,10.886686
65143,2019,Abril,Noruega,0,1,,1,-72.129595,11.360028999999999
65144,2019,Abril,Noruega,2,6,,8,-76.532004,3.451668
65145,2019,Abril,Noruega,120,185,,305,-74.140516,4.697157
65146,2019,Abril,Noruega,9,15,,24,-75.42726,6.170465
65147,2019,Abril,Noruega,2,0,,2,-77.35002,8.63337
65148,2019,Abril,Nueva Zelanda,1,0,,1,-69.941498,4.191162
65149,2019,Abril,Nueva Zelanda,0,2,,2,-69.94143100000001,4.214082
65150,2019,Abril,Nueva Zelanda,9,7,,16,-77.35600000000001,0.81488
65151,2019,Abril,Nueva Zelanda,2,9,,11,-75.527794,10.406342
65152,2019,Abril,Nueva Zelanda,8,9,,17,-75.516486,10.446304
65153,2019,Abril,Nueva Zelanda,3,3,,6,-74.77647900000001,10.886686
65154,2019,Abril,Nueva Zelanda,1,1,,2,-81.703935,12.574411099999999
65155,2019,Abril,Nueva Zelanda,0,1,,1,-81.70216500000001,12.5862
65156,2019,Abril,Nueva Zelanda,2,2,,4,-81.372937,13.338761300000002
65157,2019,Abril,Nueva Zelanda,2,1,,3,-76.532004,3.451668
65158,2019,Abril,Nueva Zelanda,57,102,,159,-74.140516,4.697157
65159,2019,Abril,Nueva Zelanda,11,19,,30,-75.42726,6.170465
65160,2019,Abril,Nueva Zelanda,2,3,,5,-77.35002,8.63337
65161,2019,Abril,Omán,0,2,,2,-74.140516,4.697157
65162,2019,Abril,Países Bajos,0,2,,2,-69.941498,4.191162
65163,2019,Abril,Países Bajos,3,6,,9,-69.94143100000001,4.214082
65164,2019,Abril,Países Bajos,1,2,,3,-76.876446,0.33002
65165,2019,Abril,Países Bajos,24,23,,47,-77.35600000000001,0.81488
65166,2019,Abril,Países Bajos,23,17,,40,-75.527794,10.406342
65167,2019,Abril,Países Bajos,285,275,,560,-75.516486,10.446304
65168,2019,Abril,Países Bajos,10,36,,46,-74.77647900000001,10.886686
65169,2019,Abril,Países Bajos,4,20,,24,-74.232675,11.117206
65170,2019,Abril,Países Bajos,1,4,,5,-74.213989,11.247722999999999
65171,2019,Abril,Países Bajos,3,4,,7,-72.129595,11.360028999999999
65172,2019,Abril,Países Bajos,2,1,,3,-81.70216500000001,12.5862
65173,2019,Abril,Países Bajos,1,1,,2,-81.372937,13.338761300000002
65174,2019,Abril,Países Bajos,49,64,,113,-76.532004,3.451668
65175,2019,Abril,Países Bajos,1826,2346,,4172,-74.140516,4.697157
65176,2019,Abril,Países Bajos,3,9,,12,-75.736374,4.815189
65177,2019,Abril,Países Bajos,182,263,,445,-75.42726,6.170465
65178,2019,Abril,Países Bajos,10,9,,19,-73.181317,7.1280470000000005
65179,2019,Abril,Países Bajos,0,4,,4,-72.453013,7.819
65180,2019,Abril,Países Bajos,1,0,,1,-72.409396,8.36068
65181,2019,Abril,Países Bajos,7,8,,15,-77.35002,8.63337
65182,2019,Abril,Pakistán,0,2,,2,-75.516486,10.446304
65183,2019,Abril,Pakistán,1,0,,1,-76.532004,3.451668
65184,2019,Abril,Pakistán,5,19,,24,-74.140516,4.697157
65185,2019,Abril,Pakistán,0,4,,4,-75.42726,6.170465
65186,2019,Abril,Pakistán,0,1,,1,-72.453013,7.819
65187,2019,Abril,Panamá,1,3,,4,-77.35600000000001,0.81488
65188,2019,Abril,Panamá,2,37,,39,-75.527794,10.406342
65189,2019,Abril,Panamá,1,0,,1,-73.247863,10.433608999999999
65190,2019,Abril,Panamá,471,522,,993,-75.516486,10.446304
65191,2019,Abril,Panamá,72,102,,174,-74.77647900000001,10.886686
65192,2019,Abril,Panamá,0,1,,1,-74.765343,10.970933
65193,2019,Abril,Panamá,1,0,,1,-72.129595,11.360028999999999
65194,2019,Abril,Panamá,21,30,,51,-81.70216500000001,12.5862
65195,2019,Abril,Panamá,380,407,,787,-76.532004,3.451668
65196,2019,Abril,Panamá,1714,1799,,3513,-74.140516,4.697157
65197,2019,Abril,Panamá,25,46,,71,-75.736374,4.815189
65198,2019,Abril,Panamá,1417,1344,,2761,-75.42726,6.170465
65199,2019,Abril,Panamá,1,2,,3,-77.762647,7.102626
65200,2019,Abril,Panamá,11,10,,21,-73.181317,7.1280470000000005
65201,2019,Abril,Panamá,1,3,,4,-72.453013,7.819
65202,2019,Abril,Panamá,2,1,,3,-77.35002,8.63337
65203,2019,Abril,Papúa Nueva Guinea,1,0,,1,-69.94143100000001,4.214082
65204,2019,Abril,Papúa Nueva Guinea,1,0,,1,-74.140516,4.697157
65205,2019,Abril,Paraguay,0,1,,1,-69.94143100000001,4.214082
65206,2019,Abril,Paraguay,1,1,,2,-75.527794,10.406342
65207,2019,Abril,Paraguay,90,68,,158,-75.516486,10.446304
65208,2019,Abril,Paraguay,2,2,,4,-74.77647900000001,10.886686
65209,2019,Abril,Paraguay,59,36,,95,-81.70216500000001,12.5862
65210,2019,Abril,Paraguay,18,72,,90,-76.532004,3.451668
65211,2019,Abril,Paraguay,168,201,,369,-74.140516,4.697157
65212,2019,Abril,Paraguay,3,2,,5,-75.736374,4.815189
65213,2019,Abril,Paraguay,23,14,,37,-75.42726,6.170465
65214,2019,Abril,Perú,7,5,,12,-69.941498,4.191162
65215,2019,Abril,Perú,53,66,,119,-69.94143100000001,4.214082
65216,2019,Abril,Perú,49,89,,138,-74.78366,0.18595699999999998
65217,2019,Abril,Perú,1,15,,16,-76.876446,0.33002
65218,2019,Abril,Perú,101,231,,332,-77.35600000000001,0.81488
65219,2019,Abril,Perú,46,35,,81,-75.527794,10.406342
65220,2019,Abril,Perú,1031,624,,1655,-75.516486,10.446304
65221,2019,Abril,Perú,8,14,,22,-74.77647900000001,10.886686
65222,2019,Abril,Perú,0,1,,1,-74.765343,10.970933
65223,2019,Abril,Perú,8,14,,22,-72.129595,11.360028999999999
65224,2019,Abril,Perú,0,3,,3,-81.703935,12.574411099999999
65225,2019,Abril,Perú,287,194,,481,-81.70216500000001,12.5862
65226,2019,Abril,Perú,308,346,,654,-76.532004,3.451668
65227,2019,Abril,Perú,0,2,,2,-75.76635300000001,4.45285
65228,2019,Abril,Perú,4062,4578,,8640,-74.140516,4.697157
65229,2019,Abril,Perú,3,10,,13,-75.736374,4.815189
65230,2019,Abril,Perú,762,1022,,1784,-75.42726,6.170465
65231,2019,Abril,Perú,1,2,,3,-67.48402800000001,6.185536
65232,2019,Abril,Perú,2,4,,6,-70.74025300000001,7.088728999999999
65233,2019,Abril,Perú,0,5,,5,-73.181317,7.1280470000000005
65234,2019,Abril,Perú,48,81,,129,-72.453013,7.819
65235,2019,Abril,Palestina,0,3,,3,-74.140516,4.697157
65236,2019,Abril,Polonia,0,1,,1,-69.941498,4.191162
65237,2019,Abril,Polonia,0,2,,2,-69.94143100000001,4.214082
65238,2019,Abril,Polonia,12,13,,25,-77.35600000000001,0.81488
65239,2019,Abril,Polonia,1,11,,12,-75.527794,10.406342
65240,2019,Abril,Polonia,28,35,,63,-75.516486,10.446304
65241,2019,Abril,Polonia,2,2,,4,-74.77647900000001,10.886686
65242,2019,Abril,Polonia,0,1,,1,-74.213989,11.247722999999999
65243,2019,Abril,Polonia,3,13,,16,-76.532004,3.451668
65244,2019,Abril,Polonia,0,4,,4,-77.061029,3.8844260000000004
65245,2019,Abril,Polonia,190,214,,404,-74.140516,4.697157
65246,2019,Abril,Polonia,14,15,,29,-75.42726,6.170465
65247,2019,Abril,Polonia,0,4,,4,-76.7333,8.06667
65248,2019,Abril,Polonia,0,1,,1,-77.35002,8.63337
65249,2019,Abril,Portugal,2,1,,3,-69.94143100000001,4.214082
65250,2019,Abril,Portugal,5,7,,12,-77.35600000000001,0.81488
65251,2019,Abril,Portugal,2,3,,5,-75.527794,10.406342
65252,2019,Abril,Portugal,36,38,,74,-75.516486,10.446304
65253,2019,Abril,Portugal,1,8,,9,-74.77647900000001,10.886686
65254,2019,Abril,Portugal,0,1,,1,-74.232675,11.117206
65255,2019,Abril,Portugal,0,1,,1,-74.213989,11.247722999999999
65256,2019,Abril,Portugal,3,2,,5,-72.129595,11.360028999999999
65257,2019,Abril,Portugal,3,3,,6,-81.70216500000001,12.5862
65258,2019,Abril,Portugal,8,21,,29,-76.532004,3.451668
65259,2019,Abril,Portugal,298,500,,798,-74.140516,4.697157
65260,2019,Abril,Portugal,6,6,,12,-75.736374,4.815189
65261,2019,Abril,Portugal,18,46,,64,-75.42726,6.170465
65262,2019,Abril,Portugal,0,1,,1,-70.74025300000001,7.088728999999999
65263,2019,Abril,Portugal,11,18,,29,-72.453013,7.819
65264,2019,Abril,Portugal,0,1,,1,-72.409396,8.36068
65265,2019,Abril,Qatar,0,2,,2,-74.140516,4.697157
65266,2019,Abril,Qatar,0,1,,1,-75.42726,6.170465
65267,2019,Abril,Reino Unido de Gran Bretaña e Irlanda del Norte,5,4,,9,-69.941498,4.191162
65268,2019,Abril,Reino Unido de Gran Bretaña e Irlanda del Norte,9,6,,15,-69.94143100000001,4.214082
65269,2019,Abril,Reino Unido de Gran Bretaña e Irlanda del Norte,61,80,,141,-77.35600000000001,0.81488
65270,2019,Abril,Reino Unido de Gran Bretaña e Irlanda del Norte,20,17,,37,-75.527794,10.406342
65271,2019,Abril,Reino Unido de Gran Bretaña e Irlanda del Norte,136,204,,340,-75.516486,10.446304
65272,2019,Abril,Reino Unido de Gran Bretaña e Irlanda del Norte,7,31,,38,-74.77647900000001,10.886686
65273,2019,Abril,Reino Unido de Gran Bretaña e Irlanda del Norte,0,3,,3,-74.232675,11.117206
65274,2019,Abril,Reino Unido de Gran Bretaña e Irlanda del Norte,2,1,,3,-74.213989,11.247722999999999
65275,2019,Abril,Reino Unido de Gran Bretaña e Irlanda del Norte,0,3,,3,-72.129595,11.360028999999999
65276,2019,Abril,Reino Unido de Gran Bretaña e Irlanda del Norte,2,3,,5,-81.703935,12.574411099999999
65277,2019,Abril,Reino Unido de Gran Bretaña e Irlanda del Norte,2,0,,2,-81.70216500000001,12.5862
65278,2019,Abril,Reino Unido de Gran Bretaña e Irlanda del Norte,1,6,,7,-81.372937,13.338761300000002
65279,2019,Abril,Reino Unido de Gran Bretaña e Irlanda del Norte,37,73,,110,-76.532004,3.451668
65280,2019,Abril,Reino Unido de Gran Bretaña e Irlanda del Norte,0,1,,1,-75.76635300000001,4.45285
65281,2019,Abril,Reino Unido de Gran Bretaña e Irlanda del Norte,1445,2390,,3835,-74.140516,4.697157
65282,2019,Abril,Reino Unido de Gran Bretaña e Irlanda del Norte,1,6,,7,-75.736374,4.815189
65283,2019,Abril,Reino Unido de Gran Bretaña e Irlanda del Norte,158,334,,492,-75.42726,6.170465
65284,2019,Abril,Reino Unido de Gran Bretaña e Irlanda del Norte,3,1,,4,-73.181317,7.1280470000000005
65285,2019,Abril,Reino Unido de Gran Bretaña e Irlanda del Norte,0,2,,2,-72.453013,7.819
65286,2019,Abril,Reino Unido de Gran Bretaña e Irlanda del Norte,0,1,,1,-72.409396,8.36068
65287,2019,Abril,Reino Unido de Gran Bretaña e Irlanda del Norte,39,30,,69,-77.35002,8.63337
65288,2019,Abril,República Dominicana,1,3,,4,-69.941498,4.191162
65289,2019,Abril,República Dominicana,2,0,,2,-69.94143100000001,4.214082
65290,2019,Abril,República Dominicana,5,15,,20,-77.35600000000001,0.81488
65291,2019,Abril,República Dominicana,0,1,,1,-78.802679,18.00143
65292,2019,Abril,República Dominicana,0,4,,4,-75.527794,10.406342
65293,2019,Abril,República Dominicana,70,78,,148,-75.516486,10.446304
65294,2019,Abril,República Dominicana,16,24,,40,-74.77647900000001,10.886686
65295,2019,Abril,República Dominicana,0,1,,1,-74.232675,11.117206
65296,2019,Abril,República Dominicana,0,2,,2,-72.129595,11.360028999999999
65297,2019,Abril,República Dominicana,39,27,,66,-76.532004,3.451668
65298,2019,Abril,República Dominicana,1709,1479,,3188,-74.140516,4.697157
65299,2019,Abril,República Dominicana,3,1,,4,-75.736374,4.815189
65300,2019,Abril,República Dominicana,109,114,,223,-75.42726,6.170465
65301,2019,Abril,República Dominicana,3,2,,5,-73.181317,7.1280470000000005
65302,2019,Abril,República Dominicana,3,7,,10,-72.453013,7.819
65303,2019,Abril,República Dominicana,0,1,,1,-72.409396,8.36068
65304,2019,Abril,República Dominicana,0,1,,1,-77.35002,8.63337
65305,2019,Abril,Rumania,0,2,,2,-69.94143100000001,4.214082
65306,2019,Abril,Rumania,0,2,,2,-77.35600000000001,0.81488
65307,2019,Abril,Rumania,1,5,,6,-75.527794,10.406342
65308,2019,Abril,Rumania,7,9,,16,-75.516486,10.446304
65309,2019,Abril,Rumania,0,3,,3,-74.77647900000001,10.886686
65310,2019,Abril,Rumania,0,8,,8,-74.765343,10.970933
65311,2019,Abril,Rumania,1,1,,2,-74.232675,11.117206
65312,2019,Abril,Rumania,0,1,,1,-74.213989,11.247722999999999
65313,2019,Abril,Rumania,0,1,,1,-72.129595,11.360028999999999
65314,2019,Abril,Rumania,0,2,,2,-76.532004,3.451668
65315,2019,Abril,Rumania,94,81,,175,-74.140516,4.697157
65316,2019,Abril,Rumania,9,11,,20,-75.42726,6.170465
65317,2019,Abril,Federación de Rusia,17,8,,25,-77.35600000000001,0.81488
65318,2019,Abril,Federación de Rusia,2,17,,19,-75.527794,10.406342
65319,2019,Abril,Federación de Rusia,16,26,,42,-75.516486,10.446304
65320,2019,Abril,Federación de Rusia,0,3,,3,-74.77647900000001,10.886686
65321,2019,Abril,Federación de Rusia,0,1,,1,-74.765343,10.970933
65322,2019,Abril,Federación de Rusia,1,0,,1,-74.232675,11.117206
65323,2019,Abril,Federación de Rusia,0,2,,2,-74.213989,11.247722999999999
65324,2019,Abril,Federación de Rusia,0,3,,3,-72.129595,11.360028999999999
65325,2019,Abril,Federación de Rusia,0,1,,1,-81.703935,12.574411099999999
65326,2019,Abril,Federación de Rusia,0,1,,1,-81.70216500000001,12.5862
65327,2019,Abril,Federación de Rusia,5,7,,12,-76.532004,3.451668
65328,2019,Abril,Federación de Rusia,0,5,,5,-77.061029,3.8844260000000004
65329,2019,Abril,Federación de Rusia,203,207,,410,-74.140516,4.697157
65330,2019,Abril,Federación de Rusia,1,0,,1,-75.736374,4.815189
65331,2019,Abril,Federación de Rusia,16,21,,37,-75.42726,6.170465
65332,2019,Abril,Federación de Rusia,0,2,,2,-73.181317,7.1280470000000005
65333,2019,Abril,Federación de Rusia,1,2,,3,-77.35002,8.63337
65334,2019,Abril,Federación de Rusia,0,4,,4,-75.68164200000001,9.402597
65335,2019,Abril,Rwanda,0,1,,1,-74.140516,4.697157
65336,2019,Abril,San Cristóbal y Nevis,0,1,,1,-74.140516,4.697157
65337,2019,Abril,San Cristóbal y Nevis,0,1,,1,-75.42726,6.170465
65338,2019,Abril,San Marino,0,3,,3,-74.140516,4.697157
65339,2019,Abril,San  Vicente y las Granadinas,0,1,,1,-75.516486,10.446304
65340,2019,Abril,San  Vicente y las Granadinas,0,2,,2,-81.70216500000001,12.5862
65341,2019,Abril,San  Vicente y las Granadinas,3,1,,4,-74.140516,4.697157
65342,2019,Abril,San  Vicente y las Granadinas,0,1,,1,-75.42726,6.170465
65343,2019,Abril,Santa Lucia,1,0,,1,-75.516486,10.446304
65344,2019,Abril,Santa Lucia,7,5,,12,-74.140516,4.697157
65345,2019,Abril,Santa Lucia,0,1,,1,-75.42726,6.170465
65346,2019,Abril,Santa Sede/Ciudad del Vaticano,0,1,,1,-74.140516,4.697157
65347,2019,Abril,Senegal,0,1,,1,-74.140516,4.697157
65348,2019,Abril,Serbia,1,1,,2,-77.35600000000001,0.81488
65349,2019,Abril,Serbia,1,2,,3,-75.527794,10.406342
65350,2019,Abril,Serbia,3,3,,6,-75.516486,10.446304
65351,2019,Abril,Serbia,1,3,,4,-76.532004,3.451668
65352,2019,Abril,Serbia,16,48,,64,-74.140516,4.697157
65353,2019,Abril,Serbia,1,3,,4,-75.42726,6.170465
65354,2019,Abril,Serbia,0,1,,1,-75.68164200000001,9.402597
65355,2019,Abril,Singapur,1,0,,1,-77.35600000000001,0.81488
65356,2019,Abril,Singapur,4,1,,5,-75.516486,10.446304
65357,2019,Abril,Singapur,0,4,,4,-76.532004,3.451668
65358,2019,Abril,Singapur,24,38,,62,-74.140516,4.697157
65359,2019,Abril,Singapur,1,3,,4,-75.42726,6.170465
65360,2019,Abril,Singapur,1,0,,1,-77.35002,8.63337
65361,2019,Abril,República Árabe Siria,0,1,,1,-74.77647900000001,10.886686
65362,2019,Abril,República Árabe Siria,0,4,,4,-74.140516,4.697157
65363,2019,Abril,República Árabe Siria,1,0,,1,-75.42726,6.170465
65364,2019,Abril,Sri Lanka,0,3,,3,-75.516486,10.446304
65365,2019,Abril,Sri Lanka,2,4,,6,-74.140516,4.697157
65366,2019,Abril,Sri Lanka,0,1,,1,-75.42726,6.170465
65367,2019,Abril,Sudáfrica,0,1,,1,-69.94143100000001,4.214082
65368,2019,Abril,Sudáfrica,1,6,,7,-75.527794,10.406342
65369,2019,Abril,Sudáfrica,4,6,,10,-75.516486,10.446304
65370,2019,Abril,Sudáfrica,4,5,,9,-74.77647900000001,10.886686
65371,2019,Abril,Sudáfrica,0,3,,3,-81.703935,12.574411099999999
65372,2019,Abril,Sudáfrica,1,1,,2,-76.532004,3.451668
65373,2019,Abril,Sudáfrica,16,29,,45,-74.140516,4.697157
65374,2019,Abril,Sudáfrica,0,2,,2,-75.42726,6.170465
65375,2019,Abril,Sudán,1,0,,1,-76.532004,3.451668
65376,2019,Abril,Sudán,1,0,,1,-75.42726,6.170465
65377,2019,Abril,Suecia,1,4,,5,-69.94143100000001,4.214082
65378,2019,Abril,Suecia,0,3,,3,-76.876446,0.33002
65379,2019,Abril,Suecia,16,7,,23,-77.35600000000001,0.81488
65380,2019,Abril,Suecia,12,6,,18,-75.527794,10.406342
65381,2019,Abril,Suecia,11,23,,34,-75.516486,10.446304
65382,2019,Abril,Suecia,5,6,,11,-74.77647900000001,10.886686
65383,2019,Abril,Suecia,3,5,,8,-74.213989,11.247722999999999
65384,2019,Abril,Suecia,0,1,,1,-72.129595,11.360028999999999
65385,2019,Abril,Suecia,2,11,,13,-76.532004,3.451668
65386,2019,Abril,Suecia,153,255,,408,-74.140516,4.697157
65387,2019,Abril,Suecia,1,1,,2,-75.736374,4.815189
65388,2019,Abril,Suecia,19,30,,49,-75.42726,6.170465
65389,2019,Abril,Suecia,1,5,,6,-77.35002,8.63337
65390,2019,Abril,Suiza,4,3,,7,-69.941498,4.191162
65391,2019,Abril,Suiza,8,4,,12,-69.94143100000001,4.214082
65392,2019,Abril,Suiza,5,3,,8,-76.876446,0.33002
65393,2019,Abril,Suiza,23,17,,40,-77.35600000000001,0.81488
65394,2019,Abril,Suiza,19,20,,39,-75.527794,10.406342
65395,2019,Abril,Suiza,76,63,,139,-75.516486,10.446304
65396,2019,Abril,Suiza,6,5,,11,-74.77647900000001,10.886686
65397,2019,Abril,Suiza,0,1,,1,-74.213989,11.247722999999999
65398,2019,Abril,Suiza,2,1,,3,-81.70216500000001,12.5862
65399,2019,Abril,Suiza,49,71,,120,-76.532004,3.451668
65400,2019,Abril,Suiza,2,3,,5,-75.76635300000001,4.45285
65401,2019,Abril,Suiza,562,727,,1289,-74.140516,4.697157
65402,2019,Abril,Suiza,1,8,,9,-75.736374,4.815189
65403,2019,Abril,Suiza,49,84,,133,-75.42726,6.170465
65404,2019,Abril,Suiza,1,0,,1,-73.181317,7.1280470000000005
65405,2019,Abril,Suiza,2,2,,4,-72.453013,7.819
65406,2019,Abril,Suiza,5,4,,9,-77.35002,8.63337
65407,2019,Abril,Surinam,0,2,,2,-75.516486,10.446304
65408,2019,Abril,Surinam,17,8,,25,-74.140516,4.697157
65409,2019,Abril,Surinam,0,9,,9,-75.42726,6.170465
65410,2019,Abril,Surinam,0,2,,2,-73.181317,7.1280470000000005
65411,2019,Abril,Taiwán,3,1,,4,-74.140516,4.697157
65412,2019,Abril,Tailandia,6,2,,8,-75.516486,10.446304
65413,2019,Abril,Tailandia,2,0,,2,-76.532004,3.451668
65414,2019,Abril,Tailandia,21,16,,37,-74.140516,4.697157
65415,2019,Abril,Tailandia,1,3,,4,-75.42726,6.170465
65416,2019,Abril,Tanzania,2,0,,2,-74.140516,4.697157
65417,2019,Abril,Togo,0,1,,1,-74.77647900000001,10.886686
65418,2019,Abril,Trinidad y Tobago,1,0,,1,-75.527794,10.406342
65419,2019,Abril,Trinidad y Tobago,3,5,,8,-75.516486,10.446304
65420,2019,Abril,Trinidad y Tobago,1,4,,5,-74.77647900000001,10.886686
65421,2019,Abril,Trinidad y Tobago,0,3,,3,-76.532004,3.451668
65422,2019,Abril,Trinidad y Tobago,30,48,,78,-74.140516,4.697157
65423,2019,Abril,Trinidad y Tobago,0,1,,1,-75.736374,4.815189
65424,2019,Abril,Trinidad y Tobago,9,10,,19,-75.42726,6.170465
65425,2019,Abril,Trinidad y Tobago,0,3,,3,-73.181317,7.1280470000000005
65426,2019,Abril,Trinidad y Tobago,0,1,,1,-72.453013,7.819
65427,2019,Abril,Trinidad y Tobago,1,1,,2,-72.508188,7.927233
65428,2019,Abril,Túnez,0,1,,1,-77.35600000000001,0.81488
65429,2019,Abril,Túnez,0,3,,3,-75.516486,10.446304
65430,2019,Abril,Túnez,1,0,,1,-76.532004,3.451668
65431,2019,Abril,Túnez,5,4,,9,-74.140516,4.697157
65432,2019,Abril,Turquía,1,1,,2,-69.94143100000001,4.214082
65433,2019,Abril,Turquía,1,3,,4,-77.35600000000001,0.81488
65434,2019,Abril,Turquía,0,1,,1,-75.527794,10.406342
65435,2019,Abril,Turquía,7,5,,12,-75.516486,10.446304
65436,2019,Abril,Turquía,3,6,,9,-76.532004,3.451668
65437,2019,Abril,Turquía,149,297,,446,-74.140516,4.697157
65438,2019,Abril,Turquía,7,12,,19,-75.42726,6.170465
65439,2019,Abril,Ucrania,1,2,,3,-77.35600000000001,0.81488
65440,2019,Abril,Ucrania,2,9,,11,-75.527794,10.406342
65441,2019,Abril,Ucrania,3,11,,14,-75.516486,10.446304
65442,2019,Abril,Ucrania,0,7,,7,-74.77647900000001,10.886686
65443,2019,Abril,Ucrania,0,1,,1,-74.765343,10.970933
65444,2019,Abril,Ucrania,0,2,,2,-74.213989,11.247722999999999
65445,2019,Abril,Ucrania,1,1,,2,-81.703935,12.574411099999999
65446,2019,Abril,Ucrania,0,4,,4,-76.532004,3.451668
65447,2019,Abril,Ucrania,0,1,,1,-77.061029,3.8844260000000004
65448,2019,Abril,Ucrania,23,15,,38,-74.140516,4.697157
65449,2019,Abril,Ucrania,4,3,,7,-75.42726,6.170465
65450,2019,Abril,Ucrania,1,0,,1,-77.35002,8.63337
65451,2019,Abril,Ucrania,0,3,,3,-75.68164200000001,9.402597
65452,2019,Abril,Uganda,2,3,,5,-74.140516,4.697157
65453,2019,Abril,Uruguay,0,1,,1,-69.941498,4.191162
65454,2019,Abril,Uruguay,0,4,,4,-69.94143100000001,4.214082
65455,2019,Abril,Uruguay,1,4,,5,-76.876446,0.33002
65456,2019,Abril,Uruguay,3,8,,11,-77.35600000000001,0.81488
65457,2019,Abril,Uruguay,24,24,,48,-75.527794,10.406342
65458,2019,Abril,Uruguay,164,146,,310,-75.516486,10.446304
65459,2019,Abril,Uruguay,3,11,,14,-74.77647900000001,10.886686
65460,2019,Abril,Uruguay,5,2,,7,-72.129595,11.360028999999999
65461,2019,Abril,Uruguay,28,24,,52,-81.70216500000001,12.5862
65462,2019,Abril,Uruguay,43,65,,108,-76.532004,3.451668
65463,2019,Abril,Uruguay,319,411,,730,-74.140516,4.697157
65464,2019,Abril,Uruguay,0,1,,1,-75.736374,4.815189
65465,2019,Abril,Uruguay,39,66,,105,-75.42726,6.170465
65466,2019,Abril,Uruguay,0,2,,2,-70.74025300000001,7.088728999999999
65467,2019,Abril,Uruguay,0,1,,1,-73.181317,7.1280470000000005
65468,2019,Abril,Uruguay,3,9,,12,-72.453013,7.819
65469,2019,Abril,Uzbekistán,1,1,,2,-76.532004,3.451668
65470,2019,Abril,Uzbekistán,0,1,,1,-75.42726,6.170465
65471,2019,Abril,Venezuela,3,4,,7,-69.941498,4.191162
65472,2019,Abril,Venezuela,5,8,,13,-69.94143100000001,4.214082
65473,2019,Abril,Venezuela,0,2,,2,-74.78366,0.18595699999999998
65474,2019,Abril,Venezuela,131,118,,249,-76.876446,0.33002
65475,2019,Abril,Venezuela,3330,3554,,6884,-77.35600000000001,0.81488
65476,2019,Abril,Venezuela,4,9,,13,-78.802679,18.00143
65477,2019,Abril,Venezuela,22,17,,39,-75.527794,10.406342
65478,2019,Abril,Venezuela,10,36,,46,-73.247863,10.433608999999999
65479,2019,Abril,Venezuela,205,271,,476,-75.516486,10.446304
65480,2019,Abril,Venezuela,270,329,,599,-74.77647900000001,10.886686
65481,2019,Abril,Venezuela,0,5,,5,-74.765343,10.970933
65482,2019,Abril,Venezuela,23,63,,86,-74.232675,11.117206
65483,2019,Abril,Venezuela,9801,8584,,18385,-72.129595,11.360028999999999
65484,2019,Abril,Venezuela,0,1,,1,-71.983761,12.165168
65485,2019,Abril,Venezuela,0,1,,1,-81.703935,12.574411099999999
65486,2019,Abril,Venezuela,4,3,,7,-81.70216500000001,12.5862
65487,2019,Abril,Venezuela,243,225,,468,-76.532004,3.451668
65488,2019,Abril,Venezuela,21,10,,31,-67.927521,3.866713
65489,2019,Abril,Venezuela,1,0,,1,-75.76635300000001,4.45285
65490,2019,Abril,Venezuela,7563,7510,,15073,-74.140516,4.697157
65491,2019,Abril,Venezuela,7,14,,21,-75.736374,4.815189
65492,2019,Abril,Venezuela,1009,951,,1960,-75.42726,6.170465
65493,2019,Abril,Venezuela,43,37,,80,-67.48402800000001,6.185536
65494,2019,Abril,Venezuela,517,465,,982,-70.74025300000001,7.088728999999999
65495,2019,Abril,Venezuela,13,4,,17,-73.181317,7.1280470000000005
65496,2019,Abril,Venezuela,27906,24989,,52895,-72.453013,7.819
65497,2019,Abril,Venezuela,15,30,,45,-72.508188,7.927233
65498,2019,Abril,Venezuela,1239,1001,,2240,-72.409396,8.36068
65499,2019,Abril,Vietnam,0,1,,1,-72.129595,11.360028999999999
65500,2019,Abril,Vietnam,7,2,,9,-74.140516,4.697157
65501,2019,Abril,Vietnam,1,1,,2,-75.42726,6.170465
65502,2019,Abril,República Árabe de Yemen,0,2,,2,-75.516486,10.446304
65503,2019,Abril,República Árabe de Yemen,0,1,,1,-74.140516,4.697157
65504,2019,Abril,Zambia,0,1,,1,-75.42726,6.170465
65505,2019,Abril,Zimbabue,1,2,,3,-74.140516,4.697157
65506,2019,Abril,Islas Turcas y Caicos/Territorio Británico de Ultramar,2,0,,2,-75.516486,10.446304
65507,2019,Abril,Refugiado,0,1,,1,-74.140516,4.697157
65508,2019,Abril,Desconocido,0,4,,4,-75.516486,10.446304
65509,2019,Abril,Desconocido,2,1,,3,-76.532004,3.451668
65510,2019,Abril,Desconocido,89,158,,247,-74.140516,4.697157
65511,2019,Abril,Desconocido,2,3,,5,-75.42726,6.170465
65512,2019,Mayo,Afganistán,0,2,,2,-74.140516,4.697157
65513,2019,Mayo,Afganistán,0,1,,1,-75.42726,6.170465
65514,2019,Mayo,Albania,0,2,,2,-76.532004,3.451668
65515,2019,Mayo,Albania,7,7,,14,-74.140516,4.697157
65516,2019,Mayo,Albania,1,2,,3,-75.42726,6.170465
65517,2019,Mayo,Alemania,7,12,,19,-69.941498,4.191162
65518,2019,Mayo,Alemania,15,21,,36,-69.94143100000001,4.214082
65519,2019,Mayo,Alemania,5,9,,14,-76.876446,0.33002
65520,2019,Mayo,Alemania,95,106,,201,-77.35600000000001,0.81488
65521,2019,Mayo,Alemania,32,22,,54,-75.527794,10.406342
65522,2019,Mayo,Alemania,85,119,,204,-75.516486,10.446304
65523,2019,Mayo,Alemania,10,23,,33,-74.77647900000001,10.886686
65524,2019,Mayo,Alemania,0,2,,2,-74.213989,11.247722999999999
65525,2019,Mayo,Alemania,2,2,,4,-72.129595,11.360028999999999
65526,2019,Mayo,Alemania,4,5,,9,-81.70216500000001,12.5862
65527,2019,Mayo,Alemania,4,4,,8,-81.372937,13.338761300000002
65528,2019,Mayo,Alemania,51,89,,140,-76.532004,3.451668
65529,2019,Mayo,Alemania,0,2,,2,-77.061029,3.8844260000000004
65530,2019,Mayo,Alemania,1349,2149,,3498,-74.140516,4.697157
65531,2019,Mayo,Alemania,9,7,,16,-75.736374,4.815189
65532,2019,Mayo,Alemania,147,260,,407,-75.42726,6.170465
65533,2019,Mayo,Alemania,0,1,,1,-73.181317,7.1280470000000005
65534,2019,Mayo,Alemania,3,4,,7,-72.453013,7.819
65535,2019,Mayo,Alemania,11,10,,21,-77.35002,8.63337
65536,2019,Mayo,Andorra,2,7,,9,-74.140516,4.697157
65537,2019,Mayo,Angola,1,1,,2,-75.516486,10.446304
65538,2019,Mayo,Angola,0,7,,7,-74.140516,4.697157
65539,2019,Mayo,Antigua y Barbuda,0,1,,1,-75.516486,10.446304
65540,2019,Mayo,Antigua y Barbuda,1,1,,2,-74.77647900000001,10.886686
65541,2019,Mayo,Antigua y Barbuda,2,2,,4,-74.140516,4.697157
65542,2019,Mayo,Países Bajos,0,1,,1,-74.140516,4.697157
65543,2019,Mayo,Arabia Saudita,1,4,,5,-74.140516,4.697157
65544,2019,Mayo,Arabia Saudita,0,3,,3,-75.42726,6.170465
65545,2019,Mayo,Argelia,3,2,,5,-74.140516,4.697157
65546,2019,Mayo,Argentina,6,4,,10,-69.941498,4.191162
65547,2019,Mayo,Argentina,18,19,,37,-69.94143100000001,4.214082
65548,2019,Mayo,Argentina,12,15,,27,-76.876446,0.33002
65549,2019,Mayo,Argentina,91,151,,242,-77.35600000000001,0.81488
65550,2019,Mayo,Argentina,525,291,,816,-75.527794,10.406342
65551,2019,Mayo,Argentina,1756,1280,,3036,-75.516486,10.446304
65552,2019,Mayo,Argentina,16,48,,64,-74.77647900000001,10.886686
65553,2019,Mayo,Argentina,2,13,,15,-72.129595,11.360028999999999
65554,2019,Mayo,Argentina,0,5,,5,-81.703935,12.574411099999999
65555,2019,Mayo,Argentina,159,124,,283,-81.70216500000001,12.5862
65556,2019,Mayo,Argentina,91,156,,247,-76.532004,3.451668
65557,2019,Mayo,Argentina,4330,5631,,9961,-74.140516,4.697157
65558,2019,Mayo,Argentina,2,14,,16,-75.736374,4.815189
65559,2019,Mayo,Argentina,173,485,,658,-75.42726,6.170465
65560,2019,Mayo,Argentina,1,0,,1,-70.74025300000001,7.088728999999999
65561,2019,Mayo,Argentina,2,4,,6,-73.181317,7.1280470000000005
65562,2019,Mayo,Argentina,3,6,,9,-72.453013,7.819
65563,2019,Mayo,Argentina,2,0,,2,-72.409396,8.36068
65564,2019,Mayo,Argentina,0,1,,1,-77.35002,8.63337
65565,2019,Mayo,República de Armenia,2,1,,3,-74.140516,4.697157
65566,2019,Mayo,República de Armenia,0,1,,1,-75.42726,6.170465
65567,2019,Mayo,Australia,1,0,,1,-69.941498,4.191162
65568,2019,Mayo,Australia,0,6,,6,-69.94143100000001,4.214082
65569,2019,Mayo,Australia,0,1,,1,-76.876446,0.33002
65570,2019,Mayo,Australia,18,15,,33,-77.35600000000001,0.81488
65571,2019,Mayo,Australia,11,14,,25,-75.527794,10.406342
65572,2019,Mayo,Australia,35,45,,80,-75.516486,10.446304
65573,2019,Mayo,Australia,1,15,,16,-74.77647900000001,10.886686
65574,2019,Mayo,Australia,2,0,,2,-81.70216500000001,12.5862
65575,2019,Mayo,Australia,5,17,,22,-76.532004,3.451668
65576,2019,Mayo,Australia,296,521,,817,-74.140516,4.697157
65577,2019,Mayo,Australia,0,2,,2,-75.736374,4.815189
65578,2019,Mayo,Australia,43,78,,121,-75.42726,6.170465
65579,2019,Mayo,Australia,0,1,,1,-73.181317,7.1280470000000005
65580,2019,Mayo,Australia,13,13,,26,-77.35002,8.63337
65581,2019,Mayo,Austria,1,1,,2,-69.941498,4.191162
65582,2019,Mayo,Austria,1,0,,1,-76.876446,0.33002
65583,2019,Mayo,Austria,4,8,,12,-77.35600000000001,0.81488
65584,2019,Mayo,Austria,2,6,,8,-75.527794,10.406342
65585,2019,Mayo,Austria,9,12,,21,-75.516486,10.446304
65586,2019,Mayo,Austria,1,3,,4,-74.77647900000001,10.886686
65587,2019,Mayo,Austria,0,1,,1,-72.129595,11.360028999999999
65588,2019,Mayo,Austria,5,13,,18,-76.532004,3.451668
65589,2019,Mayo,Austria,116,218,,334,-74.140516,4.697157
65590,2019,Mayo,Austria,0,1,,1,-75.736374,4.815189
65591,2019,Mayo,Austria,9,32,,41,-75.42726,6.170465
65592,2019,Mayo,Austria,0,1,,1,-77.35002,8.63337
65593,2019,Mayo,Azerbaiyán,0,1,,1,-77.35600000000001,0.81488
65594,2019,Mayo,Azerbaiyán,0,1,,1,-75.516486,10.446304
65595,2019,Mayo,Azerbaiyán,1,0,,1,-76.532004,3.451668
65596,2019,Mayo,Azerbaiyán,1,10,,11,-74.140516,4.697157
65597,2019,Mayo,Azerbaiyán,1,1,,2,-75.42726,6.170465
65598,2019,Mayo,Bahamas,1,0,,1,-77.35600000000001,0.81488
65599,2019,Mayo,Bahamas,1,3,,4,-75.516486,10.446304
65600,2019,Mayo,Bahamas,1,1,,2,-76.532004,3.451668
65601,2019,Mayo,Bahamas,16,14,,30,-74.140516,4.697157
65602,2019,Mayo,Bahamas,0,6,,6,-75.42726,6.170465
65603,2019,Mayo,Bahréin,0,1,,1,-75.516486,10.446304
65604,2019,Mayo,Bahréin,0,2,,2,-74.140516,4.697157
65605,2019,Mayo,Bangladesh,0,1,,1,-74.140516,4.697157
65606,2019,Mayo,Barbados,4,3,,7,-75.516486,10.446304
65607,2019,Mayo,Barbados,1,3,,4,-74.77647900000001,10.886686
65608,2019,Mayo,Barbados,0,1,,1,-76.532004,3.451668
65609,2019,Mayo,Barbados,6,10,,16,-74.140516,4.697157
65610,2019,Mayo,Barbados,1,0,,1,-75.42726,6.170465
65611,2019,Mayo,República de Belarús,3,8,,11,-74.140516,4.697157
65612,2019,Mayo,República de Belarús,0,2,,2,-72.453013,7.819
65613,2019,Mayo,Bélgica,2,1,,3,-69.94143100000001,4.214082
65614,2019,Mayo,Bélgica,0,1,,1,-76.876446,0.33002
65615,2019,Mayo,Bélgica,12,19,,31,-77.35600000000001,0.81488
65616,2019,Mayo,Bélgica,4,3,,7,-75.527794,10.406342
65617,2019,Mayo,Bélgica,16,23,,39,-75.516486,10.446304
65618,2019,Mayo,Bélgica,2,4,,6,-74.77647900000001,10.886686
65619,2019,Mayo,Bélgica,9,17,,26,-76.532004,3.451668
65620,2019,Mayo,Bélgica,166,333,,499,-74.140516,4.697157
65621,2019,Mayo,Bélgica,0,1,,1,-75.736374,4.815189
65622,2019,Mayo,Bélgica,25,43,,68,-75.42726,6.170465
65623,2019,Mayo,Bélgica,0,1,,1,-73.181317,7.1280470000000005
65624,2019,Mayo,Bélgica,1,1,,2,-77.35002,8.63337
65625,2019,Mayo,Belice,1,0,,1,-69.94143100000001,4.214082
65626,2019,Mayo,Belice,1,1,,2,-75.516486,10.446304
65627,2019,Mayo,Belice,0,2,,2,-81.703935,12.574411099999999
65628,2019,Mayo,Belice,1,0,,1,-81.70216500000001,12.5862
65629,2019,Mayo,Belice,2,3,,5,-76.532004,3.451668
65630,2019,Mayo,Belice,15,14,,29,-74.140516,4.697157
65631,2019,Mayo,Belice,8,11,,19,-75.42726,6.170465
65632,2019,Mayo,Bermudas/Territorio Británico de Ultramar,0,1,,1,-75.516486,10.446304
65633,2019,Mayo,Bermudas/Territorio Británico de Ultramar,1,3,,4,-74.140516,4.697157
65634,2019,Mayo,Bermudas/Territorio Británico de Ultramar,0,3,,3,-75.42726,6.170465
65635,2019,Mayo,Bolivia,0,3,,3,-69.941498,4.191162
65636,2019,Mayo,Bolivia,1,0,,1,-69.94143100000001,4.214082
65637,2019,Mayo,Bolivia,11,22,,33,-77.35600000000001,0.81488
65638,2019,Mayo,Bolivia,21,10,,31,-75.527794,10.406342
65639,2019,Mayo,Bolivia,92,75,,167,-75.516486,10.446304
65640,2019,Mayo,Bolivia,1,3,,4,-74.77647900000001,10.886686
65641,2019,Mayo,Bolivia,22,5,,27,-81.70216500000001,12.5862
65642,2019,Mayo,Bolivia,15,27,,42,-76.532004,3.451668
65643,2019,Mayo,Bolivia,641,736,,1377,-74.140516,4.697157
65644,2019,Mayo,Bolivia,39,42,,81,-75.42726,6.170465
65645,2019,Mayo,Bolivia,1,0,,1,-73.181317,7.1280470000000005
65646,2019,Mayo,Bolivia,1,0,,1,-72.453013,7.819
65647,2019,Mayo,Bolivia,1,0,,1,-72.409396,8.36068
65648,2019,Mayo,Bolivia,1,0,,1,-77.35002,8.63337
65649,2019,Mayo,Bosnia y Herzegovina,2,1,,3,-75.516486,10.446304
65650,2019,Mayo,Bosnia y Herzegovina,7,6,,13,-74.140516,4.697157
65651,2019,Mayo,Botsuana,3,1,,4,-74.140516,4.697157
65652,2019,Mayo,Brasil,137,117,,254,-69.941498,4.191162
65653,2019,Mayo,Brasil,6,6,,12,-69.94143100000001,4.214082
65654,2019,Mayo,Brasil,0,1,,1,-76.876446,0.33002
65655,2019,Mayo,Brasil,23,28,,51,-77.35600000000001,0.81488
65656,2019,Mayo,Brasil,405,276,,681,-75.527794,10.406342
65657,2019,Mayo,Brasil,648,494,,1142,-75.516486,10.446304
65658,2019,Mayo,Brasil,20,43,,63,-74.77647900000001,10.886686
65659,2019,Mayo,Brasil,2,1,,3,-74.213989,11.247722999999999
65660,2019,Mayo,Brasil,2,5,,7,-72.129595,11.360028999999999
65661,2019,Mayo,Brasil,199,157,,356,-81.70216500000001,12.5862
65662,2019,Mayo,Brasil,2,2,,4,-81.372937,13.338761300000002
65663,2019,Mayo,Brasil,100,170,,270,-76.532004,3.451668
65664,2019,Mayo,Brasil,1,2,,3,-67.927521,3.866713
65665,2019,Mayo,Brasil,4329,5556,,9885,-74.140516,4.697157
65666,2019,Mayo,Brasil,1,17,,18,-75.736374,4.815189
65667,2019,Mayo,Brasil,138,336,,474,-75.42726,6.170465
65668,2019,Mayo,Brasil,2,3,,5,-67.48402800000001,6.185536
65669,2019,Mayo,Brasil,1,1,,2,-73.181317,7.1280470000000005
65670,2019,Mayo,Brasil,2,1,,3,-72.453013,7.819
65671,2019,Mayo,Brasil,2,0,,2,-72.409396,8.36068
65672,2019,Mayo,Brunei Darussalam,1,0,,1,-75.516486,10.446304
65673,2019,Mayo,Bulgaria,1,0,,1,-77.35600000000001,0.81488
65674,2019,Mayo,Bulgaria,0,2,,2,-75.527794,10.406342
65675,2019,Mayo,Bulgaria,4,4,,8,-75.516486,10.446304
65676,2019,Mayo,Bulgaria,0,1,,1,-76.532004,3.451668
65677,2019,Mayo,Bulgaria,0,1,,1,-77.061029,3.8844260000000004
65678,2019,Mayo,Bulgaria,25,31,,56,-74.140516,4.697157
65679,2019,Mayo,Bulgaria,4,6,,10,-75.42726,6.170465
65680,2019,Mayo,Bulgaria,0,1,,1,-72.409396,8.36068
65681,2019,Mayo,Burkina Faso,0,1,,1,-74.140516,4.697157
65682,2019,Mayo,Islas Caimán/Territorio Británico de Ultramar,1,0,,1,-74.140516,4.697157
65683,2019,Mayo,Camerún,1,0,,1,-75.516486,10.446304
65684,2019,Mayo,Camerún,2,3,,5,-74.140516,4.697157
65685,2019,Mayo,Guernsey,0,1,,1,-74.77647900000001,10.886686
65686,2019,Mayo,Canadá,1,0,,1,-69.941498,4.191162
65687,2019,Mayo,Canadá,1,0,,1,-69.94143100000001,4.214082
65688,2019,Mayo,Canadá,8,16,,24,-77.35600000000001,0.81488
65689,2019,Mayo,Canadá,8,7,,15,-75.527794,10.406342
65690,2019,Mayo,Canadá,178,320,,498,-75.516486,10.446304
65691,2019,Mayo,Canadá,15,29,,44,-74.77647900000001,10.886686
65692,2019,Mayo,Canadá,0,2,,2,-72.129595,11.360028999999999
65693,2019,Mayo,Canadá,0,2,,2,-81.703935,12.574411099999999
65694,2019,Mayo,Canadá,5,5,,10,-81.70216500000001,12.5862
65695,2019,Mayo,Canadá,0,3,,3,-81.372937,13.338761300000002
65696,2019,Mayo,Canadá,73,81,,154,-76.532004,3.451668
65697,2019,Mayo,Canadá,0,1,,1,-77.061029,3.8844260000000004
65698,2019,Mayo,Canadá,1384,2177,,3561,-74.140516,4.697157
65699,2019,Mayo,Canadá,8,13,,21,-75.736374,4.815189
65700,2019,Mayo,Canadá,171,460,,631,-75.42726,6.170465
65701,2019,Mayo,Canadá,1,4,,5,-73.181317,7.1280470000000005
65702,2019,Mayo,Canadá,0,1,,1,-72.453013,7.819
65703,2019,Mayo,Canadá,3,4,,7,-77.35002,8.63337
65704,2019,Mayo,Chad,1,0,,1,-74.140516,4.697157
65705,2019,Mayo,República Del Congo,0,3,,3,-74.140516,4.697157
65706,2019,Mayo,República Democrática del Congo,0,7,,7,-74.140516,4.697157
65707,2019,Mayo,República de Corea,3,3,,6,-69.94143100000001,4.214082
65708,2019,Mayo,República de Corea,16,9,,25,-77.35600000000001,0.81488
65709,2019,Mayo,República de Corea,1,0,,1,-75.527794,10.406342
65710,2019,Mayo,República de Corea,6,19,,25,-75.516486,10.446304
65711,2019,Mayo,República de Corea,2,4,,6,-74.77647900000001,10.886686
65712,2019,Mayo,República de Corea,0,5,,5,-74.213989,11.247722999999999
65713,2019,Mayo,República de Corea,0,1,,1,-81.70216500000001,12.5862
65714,2019,Mayo,República de Corea,11,6,,17,-76.532004,3.451668
65715,2019,Mayo,República de Corea,182,489,,671,-74.140516,4.697157
65716,2019,Mayo,República de Corea,24,52,,76,-75.42726,6.170465
65717,2019,Mayo,Costa de Marfil,1,0,,1,-75.516486,10.446304
65718,2019,Mayo,Costa de Marfil,2,1,,3,-74.140516,4.697157
65719,2019,Mayo,Costa Rica,1,0,,1,-69.941498,4.191162
65720,2019,Mayo,Costa Rica,4,2,,6,-77.35600000000001,0.81488
65721,2019,Mayo,Costa Rica,0,5,,5,-78.802679,18.00143
65722,2019,Mayo,Costa Rica,4,4,,8,-75.527794,10.406342
65723,2019,Mayo,Costa Rica,154,162,,316,-75.516486,10.446304
65724,2019,Mayo,Costa Rica,13,32,,45,-74.77647900000001,10.886686
65725,2019,Mayo,Costa Rica,0,2,,2,-74.213989,11.247722999999999
65726,2019,Mayo,Costa Rica,1,0,,1,-72.129595,11.360028999999999
65727,2019,Mayo,Costa Rica,190,142,,332,-81.70216500000001,12.5862
65728,2019,Mayo,Costa Rica,53,83,,136,-76.532004,3.451668
65729,2019,Mayo,Costa Rica,0,2,,2,-77.061029,3.8844260000000004
65730,2019,Mayo,Costa Rica,0,1,,1,-75.76635300000001,4.45285
65731,2019,Mayo,Costa Rica,1089,1502,,2591,-74.140516,4.697157
65732,2019,Mayo,Costa Rica,3,17,,20,-75.736374,4.815189
65733,2019,Mayo,Costa Rica,135,285,,420,-75.42726,6.170465
65734,2019,Mayo,Costa Rica,0,1,,1,-73.181317,7.1280470000000005
65735,2019,Mayo,Costa Rica,2,2,,4,-72.453013,7.819
65736,2019,Mayo,Costa Rica,0,1,,1,-72.409396,8.36068
65737,2019,Mayo,Croacia,0,1,,1,-69.941498,4.191162
65738,2019,Mayo,Croacia,0,1,,1,-69.94143100000001,4.214082
65739,2019,Mayo,Croacia,0,1,,1,-77.35600000000001,0.81488
65740,2019,Mayo,Croacia,0,2,,2,-75.527794,10.406342
65741,2019,Mayo,Croacia,2,10,,12,-75.516486,10.446304
65742,2019,Mayo,Croacia,0,1,,1,-72.129595,11.360028999999999
65743,2019,Mayo,Croacia,1,1,,2,-76.532004,3.451668
65744,2019,Mayo,Croacia,17,31,,48,-74.140516,4.697157
65745,2019,Mayo,Croacia,4,4,,8,-75.42726,6.170465
65746,2019,Mayo,Cuba,0,1,,1,-69.941498,4.191162
65747,2019,Mayo,Cuba,0,1,,1,-77.35600000000001,0.81488
65748,2019,Mayo,Cuba,15,13,,28,-75.516486,10.446304
65749,2019,Mayo,Cuba,22,45,,67,-74.77647900000001,10.886686
65750,2019,Mayo,Cuba,1,1,,2,-72.129595,11.360028999999999
65751,2019,Mayo,Cuba,0,1,,1,-81.70216500000001,12.5862
65752,2019,Mayo,Cuba,27,35,,62,-76.532004,3.451668
65753,2019,Mayo,Cuba,187,339,,526,-74.140516,4.697157
65754,2019,Mayo,Cuba,0,5,,5,-75.736374,4.815189
65755,2019,Mayo,Cuba,11,26,,37,-75.42726,6.170465
65756,2019,Mayo,Cuba,0,1,,1,-67.48402800000001,6.185536
65757,2019,Mayo,Cuba,1,5,,6,-73.181317,7.1280470000000005
65758,2019,Mayo,República Checa,1,1,,2,-69.94143100000001,4.214082
65759,2019,Mayo,República Checa,7,13,,20,-77.35600000000001,0.81488
65760,2019,Mayo,República Checa,3,10,,13,-75.516486,10.446304
65761,2019,Mayo,República Checa,0,1,,1,-74.77647900000001,10.886686
65762,2019,Mayo,República Checa,2,1,,3,-76.532004,3.451668
65763,2019,Mayo,República Checa,33,72,,105,-74.140516,4.697157
65764,2019,Mayo,República Checa,0,7,,7,-75.42726,6.170465
65765,2019,Mayo,Chile,0,1,,1,-69.941498,4.191162
65766,2019,Mayo,Chile,1,3,,4,-69.94143100000001,4.214082
65767,2019,Mayo,Chile,0,3,,3,-76.876446,0.33002
65768,2019,Mayo,Chile,34,52,,86,-77.35600000000001,0.81488
65769,2019,Mayo,Chile,176,119,,295,-75.527794,10.406342
65770,2019,Mayo,Chile,367,292,,659,-75.516486,10.446304
65771,2019,Mayo,Chile,9,13,,22,-74.77647900000001,10.886686
65772,2019,Mayo,Chile,0,2,,2,-74.232675,11.117206
65773,2019,Mayo,Chile,2,4,,6,-72.129595,11.360028999999999
65774,2019,Mayo,Chile,179,113,,292,-81.70216500000001,12.5862
65775,2019,Mayo,Chile,100,161,,261,-76.532004,3.451668
65776,2019,Mayo,Chile,1,0,,1,-75.76635300000001,4.45285
65777,2019,Mayo,Chile,3951,5036,,8987,-74.140516,4.697157
65778,2019,Mayo,Chile,3,14,,17,-75.736374,4.815189
65779,2019,Mayo,Chile,72,190,,262,-75.42726,6.170465
65780,2019,Mayo,Chile,0,1,,1,-67.48402800000001,6.185536
65781,2019,Mayo,Chile,3,1,,4,-73.181317,7.1280470000000005
65782,2019,Mayo,Chile,5,20,,25,-72.453013,7.819
65783,2019,Mayo,Chile,1,3,,4,-72.409396,8.36068
65784,2019,Mayo,China,3,8,,11,-77.35600000000001,0.81488
65785,2019,Mayo,China,1,2,,3,-75.527794,10.406342
65786,2019,Mayo,China,35,19,,54,-75.516486,10.446304
65787,2019,Mayo,China,3,23,,26,-74.77647900000001,10.886686
65788,2019,Mayo,China,0,5,,5,-74.765343,10.970933
65789,2019,Mayo,China,0,3,,3,-74.213989,11.247722999999999
65790,2019,Mayo,China,13,30,,43,-76.532004,3.451668
65791,2019,Mayo,China,0,3,,3,-77.061029,3.8844260000000004
65792,2019,Mayo,China,466,1042,,1508,-74.140516,4.697157
65793,2019,Mayo,China,1,1,,2,-75.736374,4.815189
65794,2019,Mayo,China,46,95,,141,-75.42726,6.170465
65795,2019,Mayo,China,1,4,,5,-72.453013,7.819
65796,2019,Mayo,China,1,0,,1,-77.35002,8.63337
65797,2019,Mayo,Taiwán,1,0,,1,-69.94143100000001,4.214082
65798,2019,Mayo,Taiwán,2,0,,2,-77.35600000000001,0.81488
65799,2019,Mayo,Taiwán,5,4,,9,-75.516486,10.446304
65800,2019,Mayo,Taiwán,0,1,,1,-74.77647900000001,10.886686
65801,2019,Mayo,Taiwán,2,5,,7,-76.532004,3.451668
65802,2019,Mayo,Taiwán,66,96,,162,-74.140516,4.697157
65803,2019,Mayo,Taiwán,0,1,,1,-75.736374,4.815189
65804,2019,Mayo,Taiwán,10,9,,19,-75.42726,6.170465
65805,2019,Mayo,Chipre,1,0,,1,-77.35600000000001,0.81488
65806,2019,Mayo,Chipre,1,1,,2,-75.516486,10.446304
65807,2019,Mayo,Chipre,1,0,,1,-76.532004,3.451668
65808,2019,Mayo,Chipre,3,5,,8,-74.140516,4.697157
65809,2019,Mayo,Chipre,0,1,,1,-75.42726,6.170465
65810,2019,Mayo,Dinamarca,0,1,,1,-69.941498,4.191162
65811,2019,Mayo,Dinamarca,1,1,,2,-69.94143100000001,4.214082
65812,2019,Mayo,Dinamarca,3,0,,3,-76.876446,0.33002
65813,2019,Mayo,Dinamarca,5,5,,10,-77.35600000000001,0.81488
65814,2019,Mayo,Dinamarca,3,7,,10,-75.527794,10.406342
65815,2019,Mayo,Dinamarca,7,14,,21,-75.516486,10.446304
65816,2019,Mayo,Dinamarca,0,2,,2,-74.77647900000001,10.886686
65817,2019,Mayo,Dinamarca,1,2,,3,-74.213989,11.247722999999999
65818,2019,Mayo,Dinamarca,0,1,,1,-81.70216500000001,12.5862
65819,2019,Mayo,Dinamarca,1,17,,18,-76.532004,3.451668
65820,2019,Mayo,Dinamarca,62,119,,181,-74.140516,4.697157
65821,2019,Mayo,Dinamarca,8,32,,40,-75.42726,6.170465
65822,2019,Mayo,Dinamarca,0,1,,1,-73.181317,7.1280470000000005
65823,2019,Mayo,Dominica,0,1,,1,-75.516486,10.446304
65824,2019,Mayo,Dominica,1,2,,3,-76.532004,3.451668
65825,2019,Mayo,Dominica,4,2,,6,-74.140516,4.697157
65826,2019,Mayo,Dominica,0,3,,3,-75.42726,6.170465
65827,2019,Mayo,Ecuador,0,10,,10,-69.94143100000001,4.214082
65828,2019,Mayo,Ecuador,76,229,,305,-76.876446,0.33002
65829,2019,Mayo,Ecuador,4,0,,4,-77.84700600000001,0.8124359999999999
65830,2019,Mayo,Ecuador,1398,2112,,3510,-77.35600000000001,0.81488
65831,2019,Mayo,Ecuador,9,15,,24,-78.802679,18.00143
65832,2019,Mayo,Ecuador,6,10,,16,-75.527794,10.406342
65833,2019,Mayo,Ecuador,66,78,,144,-75.516486,10.446304
65834,2019,Mayo,Ecuador,9,19,,28,-74.77647900000001,10.886686
65835,2019,Mayo,Ecuador,4,10,,14,-72.129595,11.360028999999999
65836,2019,Mayo,Ecuador,9,14,,23,-81.70216500000001,12.5862
65837,2019,Mayo,Ecuador,461,461,,922,-76.532004,3.451668
65838,2019,Mayo,Ecuador,1,3,,4,-67.927521,3.866713
65839,2019,Mayo,Ecuador,0,1,,1,-75.76635300000001,4.45285
65840,2019,Mayo,Ecuador,2814,3664,,6478,-74.140516,4.697157
65841,2019,Mayo,Ecuador,3,1,,4,-75.736374,4.815189
65842,2019,Mayo,Ecuador,58,94,,152,-75.42726,6.170465
65843,2019,Mayo,Ecuador,0,1,,1,-73.181317,7.1280470000000005
65844,2019,Mayo,Ecuador,46,52,,98,-72.453013,7.819
65845,2019,Mayo,Ecuador,1,3,,4,-72.409396,8.36068
65846,2019,Mayo,Egipto,0,3,,3,-75.516486,10.446304
65847,2019,Mayo,Egipto,5,17,,22,-74.140516,4.697157
65848,2019,Mayo,El Salvador,1,1,,2,-77.35600000000001,0.81488
65849,2019,Mayo,El Salvador,0,1,,1,-75.527794,10.406342
65850,2019,Mayo,El Salvador,314,273,,587,-75.516486,10.446304
65851,2019,Mayo,El Salvador,5,5,,10,-74.77647900000001,10.886686
65852,2019,Mayo,El Salvador,1,2,,3,-81.70216500000001,12.5862
65853,2019,Mayo,El Salvador,57,60,,117,-76.532004,3.451668
65854,2019,Mayo,El Salvador,2,0,,2,-75.76635300000001,4.45285
65855,2019,Mayo,El Salvador,589,785,,1374,-74.140516,4.697157
65856,2019,Mayo,El Salvador,1,5,,6,-75.736374,4.815189
65857,2019,Mayo,El Salvador,82,136,,218,-75.42726,6.170465
65858,2019,Mayo,El Salvador,0,1,,1,-72.453013,7.819
65859,2019,Mayo,Emiratos Árabes,1,5,,6,-74.140516,4.697157
65860,2019,Mayo,Emiratos Árabes,0,2,,2,-75.42726,6.170465
65861,2019,Mayo,España,3,6,,9,-69.941498,4.191162
65862,2019,Mayo,España,4,16,,20,-69.94143100000001,4.214082
65863,2019,Mayo,España,5,5,,10,-76.876446,0.33002
65864,2019,Mayo,España,24,56,,80,-77.35600000000001,0.81488
65865,2019,Mayo,España,2,0,,2,-78.802679,18.00143
65866,2019,Mayo,España,8,18,,26,-75.527794,10.406342
65867,2019,Mayo,España,86,128,,214,-75.516486,10.446304
65868,2019,Mayo,España,6,32,,38,-74.77647900000001,10.886686
65869,2019,Mayo,España,0,1,,1,-74.765343,10.970933
65870,2019,Mayo,España,1,0,,1,-74.213989,11.247722999999999
65871,2019,Mayo,España,11,16,,27,-72.129595,11.360028999999999
65872,2019,Mayo,España,2,2,,4,-81.703935,12.574411099999999
65873,2019,Mayo,España,11,7,,18,-81.70216500000001,12.5862
65874,2019,Mayo,España,1,0,,1,-81.372937,13.338761300000002
65875,2019,Mayo,España,155,310,,465,-76.532004,3.451668
65876,2019,Mayo,España,0,1,,1,-75.76635300000001,4.45285
65877,2019,Mayo,España,2454,5635,,8089,-74.140516,4.697157
65878,2019,Mayo,España,6,19,,25,-75.736374,4.815189
65879,2019,Mayo,España,281,592,,873,-75.42726,6.170465
65880,2019,Mayo,España,1,1,,2,-70.74025300000001,7.088728999999999
65881,2019,Mayo,España,1,2,,3,-73.181317,7.1280470000000005
65882,2019,Mayo,España,26,51,,77,-72.453013,7.819
65883,2019,Mayo,España,5,8,,13,-72.409396,8.36068
65884,2019,Mayo,España,1,2,,3,-77.35002,8.63337
65885,2019,Mayo,Eslovaquia,0,2,,2,-77.35600000000001,0.81488
65886,2019,Mayo,Eslovaquia,5,4,,9,-75.516486,10.446304
65887,2019,Mayo,Eslovaquia,0,1,,1,-72.129595,11.360028999999999
65888,2019,Mayo,Eslovaquia,33,46,,79,-74.140516,4.697157
65889,2019,Mayo,Eslovaquia,0,1,,1,-75.736374,4.815189
65890,2019,Mayo,Eslovaquia,2,1,,3,-75.42726,6.170465
65891,2019,Mayo,Eslovenia,0,1,,1,-75.516486,10.446304
65892,2019,Mayo,Eslovenia,0,1,,1,-74.77647900000001,10.886686
65893,2019,Mayo,Eslovenia,14,19,,33,-74.140516,4.697157
65894,2019,Mayo,Eslovenia,2,5,,7,-75.42726,6.170465
65895,2019,Mayo,Estados Unidos de América,15,22,,37,-69.941498,4.191162
65896,2019,Mayo,Estados Unidos de América,29,24,,53,-69.94143100000001,4.214082
65897,2019,Mayo,Estados Unidos de América,0,2,,2,-76.876446,0.33002
65898,2019,Mayo,Estados Unidos de América,34,60,,94,-77.35600000000001,0.81488
65899,2019,Mayo,Estados Unidos de América,27,55,,82,-75.527794,10.406342
65900,2019,Mayo,Estados Unidos de América,4995,7001,,11996,-75.516486,10.446304
65901,2019,Mayo,Estados Unidos de América,619,1081,,1700,-74.77647900000001,10.886686
65902,2019,Mayo,Estados Unidos de América,0,1,,1,-74.765343,10.970933
65903,2019,Mayo,Estados Unidos de América,8,8,,16,-72.129595,11.360028999999999
65904,2019,Mayo,Estados Unidos de América,0,8,,8,-81.703935,12.574411099999999
65905,2019,Mayo,Estados Unidos de América,37,46,,83,-81.70216500000001,12.5862
65906,2019,Mayo,Estados Unidos de América,2,10,,12,-81.372937,13.338761300000002
65907,2019,Mayo,Estados Unidos de América,1767,2446,,4213,-76.532004,3.451668
65908,2019,Mayo,Estados Unidos de América,180,226,,406,-75.76635300000001,4.45285
65909,2019,Mayo,Estados Unidos de América,10295,17583,,27878,-74.140516,4.697157
65910,2019,Mayo,Estados Unidos de América,255,386,,641,-75.736374,4.815189
65911,2019,Mayo,Estados Unidos de América,3608,8797,,12405,-75.42726,6.170465
65912,2019,Mayo,Estados Unidos de América,1,0,,1,-67.48402800000001,6.185536
65913,2019,Mayo,Estados Unidos de América,0,2,,2,-75.586989,6.2188349999999994
65914,2019,Mayo,Estados Unidos de América,1,0,,1,-70.74025300000001,7.088728999999999
65915,2019,Mayo,Estados Unidos de América,27,64,,91,-73.181317,7.1280470000000005
65916,2019,Mayo,Estados Unidos de América,10,13,,23,-72.453013,7.819
65917,2019,Mayo,Estados Unidos de América,0,1,,1,-72.508188,7.927233
65918,2019,Mayo,Estados Unidos de América,3,4,,7,-72.409396,8.36068
65919,2019,Mayo,Estados Unidos de América,6,4,,10,-77.35002,8.63337
65920,2019,Mayo,Estonia,1,3,,4,-77.35600000000001,0.81488
65921,2019,Mayo,Estonia,0,1,,1,-75.527794,10.406342
65922,2019,Mayo,Estonia,3,3,,6,-75.516486,10.446304
65923,2019,Mayo,Estonia,7,5,,12,-76.532004,3.451668
65924,2019,Mayo,Estonia,14,15,,29,-74.140516,4.697157
65925,2019,Mayo,Estonia,3,5,,8,-75.42726,6.170465
65926,2019,Mayo,Etiopia,0,1,,1,-75.527794,10.406342
65927,2019,Mayo,Etiopia,0,1,,1,-75.516486,10.446304
65928,2019,Mayo,Etiopia,2,61,,63,-74.140516,4.697157
65929,2019,Mayo,Etiopia,1,1,,2,-75.42726,6.170465
65930,2019,Mayo,Islas Fiji,2,0,,2,-74.140516,4.697157
65931,2019,Mayo,Islas Fiji,0,5,,5,-75.42726,6.170465
65932,2019,Mayo,Filipinas,1,38,,39,-75.527794,10.406342
65933,2019,Mayo,Filipinas,7,47,,54,-75.516486,10.446304
65934,2019,Mayo,Filipinas,0,23,,23,-74.77647900000001,10.886686
65935,2019,Mayo,Filipinas,0,20,,20,-74.765343,10.970933
65936,2019,Mayo,Filipinas,0,7,,7,-74.213989,11.247722999999999
65937,2019,Mayo,Filipinas,1,20,,21,-76.532004,3.451668
65938,2019,Mayo,Filipinas,0,14,,14,-77.061029,3.8844260000000004
65939,2019,Mayo,Filipinas,49,54,,103,-74.140516,4.697157
65940,2019,Mayo,Filipinas,2,6,,8,-75.42726,6.170465
65941,2019,Mayo,Filipinas,0,1,,1,-76.7333,8.06667
65942,2019,Mayo,Finlandia,1,0,,1,-69.94143100000001,4.214082
65943,2019,Mayo,Finlandia,3,6,,9,-77.35600000000001,0.81488
65944,2019,Mayo,Finlandia,3,6,,9,-75.516486,10.446304
65945,2019,Mayo,Finlandia,3,6,,9,-76.532004,3.451668
65946,2019,Mayo,Finlandia,34,44,,78,-74.140516,4.697157
65947,2019,Mayo,Finlandia,4,8,,12,-75.42726,6.170465
65948,2019,Mayo,Francia,3,3,,6,-69.941498,4.191162
65949,2019,Mayo,Francia,31,37,,68,-69.94143100000001,4.214082
65950,2019,Mayo,Francia,6,11,,17,-76.876446,0.33002
65951,2019,Mayo,Francia,124,138,,262,-77.35600000000001,0.81488
65952,2019,Mayo,Francia,10,24,,34,-75.527794,10.406342
65953,2019,Mayo,Francia,265,321,,586,-75.516486,10.446304
65954,2019,Mayo,Francia,2,11,,13,-74.77647900000001,10.886686
65955,2019,Mayo,Francia,5,7,,12,-74.213989,11.247722999999999
65956,2019,Mayo,Francia,2,0,,2,-72.129595,11.360028999999999
65957,2019,Mayo,Francia,3,1,,4,-81.703935,12.574411099999999
65958,2019,Mayo,Francia,2,3,,5,-81.70216500000001,12.5862
65959,2019,Mayo,Francia,1,0,,1,-81.372937,13.338761300000002
65960,2019,Mayo,Francia,60,88,,148,-76.532004,3.451668
65961,2019,Mayo,Francia,0,1,,1,-77.061029,3.8844260000000004
65962,2019,Mayo,Francia,1410,2415,,3825,-74.140516,4.697157
65963,2019,Mayo,Francia,12,21,,33,-75.736374,4.815189
65964,2019,Mayo,Francia,161,296,,457,-75.42726,6.170465
65965,2019,Mayo,Francia,0,1,,1,-67.48402800000001,6.185536
65966,2019,Mayo,Francia,1,3,,4,-77.401154,6.222551999999999
65967,2019,Mayo,Francia,0,4,,4,-73.181317,7.1280470000000005
65968,2019,Mayo,Francia,0,2,,2,-72.453013,7.819
65969,2019,Mayo,Francia,0,1,,1,-72.409396,8.36068
65970,2019,Mayo,Francia,6,10,,16,-77.35002,8.63337
65971,2019,Mayo,Gambia,0,1,,1,-75.516486,10.446304
65972,2019,Mayo,Georgia,1,2,,3,-75.516486,10.446304
65973,2019,Mayo,Georgia,6,7,,13,-74.140516,4.697157
65974,2019,Mayo,Georgia,0,2,,2,-75.68164200000001,9.402597
65975,2019,Mayo,Ghana,3,2,,5,-76.532004,3.451668
65976,2019,Mayo,Ghana,1,7,,8,-74.140516,4.697157
65977,2019,Mayo,Ghana,1,0,,1,-75.42726,6.170465
65978,2019,Mayo,Gibraltar/Territorio Británico de Ultramar,0,1,,1,-74.140516,4.697157
65979,2019,Mayo,Granada,0,1,,1,-75.516486,10.446304
65980,2019,Mayo,Granada,0,1,,1,-74.140516,4.697157
65981,2019,Mayo,Granada,0,1,,1,-75.42726,6.170465
65982,2019,Mayo,Grecia,0,2,,2,-76.876446,0.33002
65983,2019,Mayo,Grecia,5,14,,19,-75.516486,10.446304
65984,2019,Mayo,Grecia,1,1,,2,-74.77647900000001,10.886686
65985,2019,Mayo,Grecia,0,1,,1,-74.213989,11.247722999999999
65986,2019,Mayo,Grecia,4,4,,8,-76.532004,3.451668
65987,2019,Mayo,Grecia,27,60,,87,-74.140516,4.697157
65988,2019,Mayo,Grecia,0,3,,3,-75.42726,6.170465
65989,2019,Mayo,Grecia,1,1,,2,-72.453013,7.819
65990,2019,Mayo,Guatemala,1,6,,7,-77.35600000000001,0.81488
65991,2019,Mayo,Guatemala,0,2,,2,-75.527794,10.406342
65992,2019,Mayo,Guatemala,106,123,,229,-75.516486,10.446304
65993,2019,Mayo,Guatemala,10,19,,29,-74.77647900000001,10.886686
65994,2019,Mayo,Guatemala,0,1,,1,-74.765343,10.970933
65995,2019,Mayo,Guatemala,1,1,,2,-81.70216500000001,12.5862
65996,2019,Mayo,Guatemala,44,69,,113,-76.532004,3.451668
65997,2019,Mayo,Guatemala,405,751,,1156,-74.140516,4.697157
65998,2019,Mayo,Guatemala,4,22,,26,-75.736374,4.815189
65999,2019,Mayo,Guatemala,38,143,,181,-75.42726,6.170465
66000,2019,Mayo,Guatemala,2,1,,3,-73.181317,7.1280470000000005
66001,2019,Mayo,Guatemala,1,0,,1,-72.453013,7.819
66002,2019,Mayo,Guyana,0,1,,1,-75.516486,10.446304
66003,2019,Mayo,Guyana,3,2,,5,-74.77647900000001,10.886686
66004,2019,Mayo,Guyana,0,1,,1,-72.129595,11.360028999999999
66005,2019,Mayo,Guyana,1,0,,1,-81.70216500000001,12.5862
66006,2019,Mayo,Guyana,1,0,,1,-76.532004,3.451668
66007,2019,Mayo,Guyana,18,21,,39,-74.140516,4.697157
66008,2019,Mayo,Guyana,0,2,,2,-75.42726,6.170465
66009,2019,Mayo,Guyana,1,0,,1,-73.181317,7.1280470000000005
66010,2019,Mayo,Guinea,0,2,,2,-74.140516,4.697157
66011,2019,Mayo,Guinea Ecuatorial,1,1,,2,-74.140516,4.697157
66012,2019,Mayo,Haití,6,6,,12,-75.516486,10.446304
66013,2019,Mayo,Haití,3,2,,5,-76.532004,3.451668
66014,2019,Mayo,Haití,12,34,,46,-74.140516,4.697157
66015,2019,Mayo,Haití,2,1,,3,-75.736374,4.815189
66016,2019,Mayo,Haití,0,5,,5,-75.42726,6.170465
66017,2019,Mayo,Honduras,1,5,,6,-77.35600000000001,0.81488
66018,2019,Mayo,Honduras,0,14,,14,-75.527794,10.406342
66019,2019,Mayo,Honduras,65,61,,126,-75.516486,10.446304
66020,2019,Mayo,Honduras,5,7,,12,-74.77647900000001,10.886686
66021,2019,Mayo,Honduras,0,2,,2,-74.765343,10.970933
66022,2019,Mayo,Honduras,2,2,,4,-81.70216500000001,12.5862
66023,2019,Mayo,Honduras,42,34,,76,-76.532004,3.451668
66024,2019,Mayo,Honduras,1,2,,3,-75.76635300000001,4.45285
66025,2019,Mayo,Honduras,304,395,,699,-74.140516,4.697157
66026,2019,Mayo,Honduras,0,2,,2,-75.736374,4.815189
66027,2019,Mayo,Honduras,56,83,,139,-75.42726,6.170465
66028,2019,Mayo,Honduras,3,5,,8,-73.181317,7.1280470000000005
66029,2019,Mayo,Honduras,0,1,,1,-72.453013,7.819
66030,2019,Mayo,Hong Kong,3,1,,4,-77.35600000000001,0.81488
66031,2019,Mayo,Hong Kong,8,10,,18,-74.140516,4.697157
66032,2019,Mayo,Hong Kong,0,2,,2,-75.42726,6.170465
66033,2019,Mayo,Hungría,1,3,,4,-69.94143100000001,4.214082
66034,2019,Mayo,Hungría,2,6,,8,-77.35600000000001,0.81488
66035,2019,Mayo,Hungría,1,3,,4,-75.516486,10.446304
66036,2019,Mayo,Hungría,1,4,,5,-76.532004,3.451668
66037,2019,Mayo,Hungría,30,58,,88,-74.140516,4.697157
66038,2019,Mayo,Hungría,2,2,,4,-75.42726,6.170465
66039,2019,Mayo,Hungría,2,0,,2,-77.35002,8.63337
66040,2019,Mayo,India,0,4,,4,-77.35600000000001,0.81488
66041,2019,Mayo,India,2,14,,16,-75.527794,10.406342
66042,2019,Mayo,India,24,69,,93,-75.516486,10.446304
66043,2019,Mayo,India,1,23,,24,-74.77647900000001,10.886686
66044,2019,Mayo,India,0,12,,12,-74.765343,10.970933
66045,2019,Mayo,India,0,4,,4,-74.213989,11.247722999999999
66046,2019,Mayo,India,5,17,,22,-76.532004,3.451668
66047,2019,Mayo,India,0,1,,1,-77.061029,3.8844260000000004
66048,2019,Mayo,India,104,485,,589,-74.140516,4.697157
66049,2019,Mayo,India,0,1,,1,-75.736374,4.815189
66050,2019,Mayo,India,15,109,,124,-75.42726,6.170465
66051,2019,Mayo,India,0,1,,1,-73.181317,7.1280470000000005
66052,2019,Mayo,India,1,0,,1,-77.35002,8.63337
66053,2019,Mayo,India,0,4,,4,-75.68164200000001,9.402597
66054,2019,Mayo,Indonesia,0,1,,1,-75.527794,10.406342
66055,2019,Mayo,Indonesia,2,1,,3,-75.516486,10.446304
66056,2019,Mayo,Indonesia,33,42,,75,-74.140516,4.697157
66057,2019,Mayo,Indonesia,0,7,,7,-75.42726,6.170465
66058,2019,Mayo,Irán,1,1,,2,-69.94143100000001,4.214082
66059,2019,Mayo,Irán,1,1,,2,-77.35600000000001,0.81488
66060,2019,Mayo,Irán,6,17,,23,-74.140516,4.697157
66061,2019,Mayo,República de Irlanda,2,1,,3,-69.94143100000001,4.214082
66062,2019,Mayo,República de Irlanda,22,20,,42,-77.35600000000001,0.81488
66063,2019,Mayo,República de Irlanda,8,6,,14,-75.527794,10.406342
66064,2019,Mayo,República de Irlanda,18,22,,40,-75.516486,10.446304
66065,2019,Mayo,República de Irlanda,3,1,,4,-74.77647900000001,10.886686
66066,2019,Mayo,República de Irlanda,1,0,,1,-81.703935,12.574411099999999
66067,2019,Mayo,República de Irlanda,1,0,,1,-81.372937,13.338761300000002
66068,2019,Mayo,República de Irlanda,4,8,,12,-76.532004,3.451668
66069,2019,Mayo,República de Irlanda,111,202,,313,-74.140516,4.697157
66070,2019,Mayo,República de Irlanda,15,49,,64,-75.42726,6.170465
66071,2019,Mayo,República de Irlanda,23,8,,31,-77.35002,8.63337
66072,2019,Mayo,Islandia,1,3,,4,-75.516486,10.446304
66073,2019,Mayo,Islandia,0,2,,2,-76.532004,3.451668
66074,2019,Mayo,Islandia,4,5,,9,-74.140516,4.697157
66075,2019,Mayo,Islandia,0,1,,1,-75.736374,4.815189
66076,2019,Mayo,Islandia,0,3,,3,-75.42726,6.170465
66077,2019,Mayo,Israel,3,12,,15,-69.94143100000001,4.214082
66078,2019,Mayo,Israel,0,1,,1,-76.876446,0.33002
66079,2019,Mayo,Israel,85,176,,261,-77.35600000000001,0.81488
66080,2019,Mayo,Israel,40,52,,92,-75.527794,10.406342
66081,2019,Mayo,Israel,25,57,,82,-75.516486,10.446304
66082,2019,Mayo,Israel,0,3,,3,-74.77647900000001,10.886686
66083,2019,Mayo,Israel,0,1,,1,-72.129595,11.360028999999999
66084,2019,Mayo,Israel,4,4,,8,-81.70216500000001,12.5862
66085,2019,Mayo,Israel,55,73,,128,-76.532004,3.451668
66086,2019,Mayo,Israel,245,662,,907,-74.140516,4.697157
66087,2019,Mayo,Israel,0,2,,2,-75.736374,4.815189
66088,2019,Mayo,Israel,288,445,,733,-75.42726,6.170465
66089,2019,Mayo,Israel,0,1,,1,-72.453013,7.819
66090,2019,Mayo,Israel,1,1,,2,-77.35002,8.63337
66091,2019,Mayo,Italia,0,1,,1,-69.941498,4.191162
66092,2019,Mayo,Italia,3,6,,9,-69.94143100000001,4.214082
66093,2019,Mayo,Italia,1,4,,5,-76.876446,0.33002
66094,2019,Mayo,Italia,17,19,,36,-77.35600000000001,0.81488
66095,2019,Mayo,Italia,7,11,,18,-75.527794,10.406342
66096,2019,Mayo,Italia,71,147,,218,-75.516486,10.446304
66097,2019,Mayo,Italia,13,40,,53,-74.77647900000001,10.886686
66098,2019,Mayo,Italia,0,1,,1,-74.232675,11.117206
66099,2019,Mayo,Italia,8,15,,23,-72.129595,11.360028999999999
66100,2019,Mayo,Italia,2,3,,5,-81.70216500000001,12.5862
66101,2019,Mayo,Italia,46,104,,150,-76.532004,3.451668
66102,2019,Mayo,Italia,638,1736,,2374,-74.140516,4.697157
66103,2019,Mayo,Italia,1,6,,7,-75.736374,4.815189
66104,2019,Mayo,Italia,87,231,,318,-75.42726,6.170465
66105,2019,Mayo,Italia,1,0,,1,-70.74025300000001,7.088728999999999
66106,2019,Mayo,Italia,0,2,,2,-73.181317,7.1280470000000005
66107,2019,Mayo,Italia,19,31,,50,-72.453013,7.819
66108,2019,Mayo,Italia,4,6,,10,-72.409396,8.36068
66109,2019,Mayo,Italia,0,6,,6,-77.35002,8.63337
66110,2019,Mayo,Jamaica,22,17,,39,-75.516486,10.446304
66111,2019,Mayo,Jamaica,1,4,,5,-74.77647900000001,10.886686
66112,2019,Mayo,Jamaica,1,1,,2,-81.70216500000001,12.5862
66113,2019,Mayo,Jamaica,3,7,,10,-76.532004,3.451668
66114,2019,Mayo,Jamaica,24,42,,66,-74.140516,4.697157
66115,2019,Mayo,Jamaica,2,3,,5,-75.736374,4.815189
66116,2019,Mayo,Jamaica,6,8,,14,-75.42726,6.170465
66117,2019,Mayo,Islas Salomón,0,1,,1,-72.453013,7.819
66118,2019,Mayo,Japón,1,0,,1,-69.941498,4.191162
66119,2019,Mayo,Japón,1,1,,2,-69.94143100000001,4.214082
66120,2019,Mayo,Japón,13,12,,25,-77.35600000000001,0.81488
66121,2019,Mayo,Japón,2,0,,2,-75.527794,10.406342
66122,2019,Mayo,Japón,12,30,,42,-75.516486,10.446304
66123,2019,Mayo,Japón,2,8,,10,-74.77647900000001,10.886686
66124,2019,Mayo,Japón,0,1,,1,-81.70216500000001,12.5862
66125,2019,Mayo,Japón,8,25,,33,-76.532004,3.451668
66126,2019,Mayo,Japón,147,389,,536,-74.140516,4.697157
66127,2019,Mayo,Japón,1,2,,3,-75.736374,4.815189
66128,2019,Mayo,Japón,15,49,,64,-75.42726,6.170465
66129,2019,Mayo,Japón,0,1,,1,-72.409396,8.36068
66130,2019,Mayo,Japón,0,4,,4,-77.35002,8.63337
66131,2019,Mayo,Jordania,0,1,,1,-75.516486,10.446304
66132,2019,Mayo,Jordania,0,4,,4,-74.140516,4.697157
66133,2019,Mayo,Jordania,0,2,,2,-75.42726,6.170465
66134,2019,Mayo,Kazajistán,0,2,,2,-76.532004,3.451668
66135,2019,Mayo,Kazajistán,5,8,,13,-74.140516,4.697157
66136,2019,Mayo,Kenia,3,4,,7,-75.516486,10.446304
66137,2019,Mayo,Kenia,0,2,,2,-76.532004,3.451668
66138,2019,Mayo,Kenia,5,11,,16,-74.140516,4.697157
66139,2019,Mayo,Kenia,0,3,,3,-75.42726,6.170465
66140,2019,Mayo,Kuwait,2,1,,3,-74.77647900000001,10.886686
66141,2019,Mayo,Kuwait,0,2,,2,-74.140516,4.697157
66142,2019,Mayo,República de Kosovo,2,0,,2,-74.140516,4.697157
66143,2019,Mayo,República Democrática Popular  Lao,0,2,,2,-74.140516,4.697157
66144,2019,Mayo,Lesoto,1,0,,1,-75.42726,6.170465
66145,2019,Mayo,Letonia,0,2,,2,-75.516486,10.446304
66146,2019,Mayo,Letonia,0,1,,1,-74.765343,10.970933
66147,2019,Mayo,Letonia,1,1,,2,-76.532004,3.451668
66148,2019,Mayo,Letonia,4,9,,13,-74.140516,4.697157
66149,2019,Mayo,Letonia,2,0,,2,-75.42726,6.170465
66150,2019,Mayo,Letonia,1,1,,2,-75.68164200000001,9.402597
66151,2019,Mayo,Lituania,1,0,,1,-69.94143100000001,4.214082
66152,2019,Mayo,Lituania,3,2,,5,-77.35600000000001,0.81488
66153,2019,Mayo,Lituania,1,2,,3,-75.516486,10.446304
66154,2019,Mayo,Lituania,0,1,,1,-74.213989,11.247722999999999
66155,2019,Mayo,Lituania,1,0,,1,-76.532004,3.451668
66156,2019,Mayo,Lituania,13,27,,40,-74.140516,4.697157
66157,2019,Mayo,Lituania,2,10,,12,-75.42726,6.170465
66158,2019,Mayo,Lituania,0,1,,1,-77.35002,8.63337
66159,2019,Mayo,Líbano,2,4,,6,-75.516486,10.446304
66160,2019,Mayo,Líbano,2,4,,6,-74.77647900000001,10.886686
66161,2019,Mayo,Líbano,0,1,,1,-72.129595,11.360028999999999
66162,2019,Mayo,Líbano,0,1,,1,-76.532004,3.451668
66163,2019,Mayo,Líbano,8,18,,26,-74.140516,4.697157
66164,2019,Mayo,Líbano,0,6,,6,-75.42726,6.170465
66165,2019,Mayo,Liberia,1,0,,1,-75.516486,10.446304
66166,2019,Mayo,Libia,0,1,,1,-74.140516,4.697157
66167,2019,Mayo,Liechtenstein,1,2,,3,-74.140516,4.697157
66168,2019,Mayo,Luxemburgo,0,1,,1,-75.516486,10.446304
66169,2019,Mayo,Luxemburgo,1,1,,2,-76.532004,3.451668
66170,2019,Mayo,Luxemburgo,6,14,,20,-74.140516,4.697157
66171,2019,Mayo,Luxemburgo,1,0,,1,-77.35002,8.63337
66172,2019,Mayo,Macedonia,2,17,,19,-74.140516,4.697157
66173,2019,Mayo,Madagascar,0,1,,1,-74.140516,4.697157
66174,2019,Mayo,Malasia,0,1,,1,-77.35600000000001,0.81488
66175,2019,Mayo,Malasia,4,1,,5,-75.516486,10.446304
66176,2019,Mayo,Malasia,19,21,,40,-74.140516,4.697157
66177,2019,Mayo,Malasia,1,7,,8,-75.42726,6.170465
66178,2019,Mayo,Malta,1,2,,3,-75.516486,10.446304
66179,2019,Mayo,Malta,0,1,,1,-76.532004,3.451668
66180,2019,Mayo,Malta,1,9,,10,-74.140516,4.697157
66181,2019,Mayo,Malta,0,1,,1,-75.42726,6.170465
66182,2019,Mayo,Malta,1,1,,2,-77.35002,8.63337
66183,2019,Mayo,Marruecos,0,2,,2,-75.516486,10.446304
66184,2019,Mayo,Marruecos,1,0,,1,-74.77647900000001,10.886686
66185,2019,Mayo,Marruecos,0,1,,1,-76.532004,3.451668
66186,2019,Mayo,Marruecos,16,12,,28,-74.140516,4.697157
66187,2019,Mayo,Marruecos,1,0,,1,-75.42726,6.170465
66188,2019,Mayo,Mauricio,1,5,,6,-74.140516,4.697157
66189,2019,Mayo,México,0,4,,4,-69.941498,4.191162
66190,2019,Mayo,México,3,3,,6,-69.94143100000001,4.214082
66191,2019,Mayo,México,0,2,,2,-76.876446,0.33002
66192,2019,Mayo,México,23,28,,51,-77.35600000000001,0.81488
66193,2019,Mayo,México,0,5,,5,-78.802679,18.00143
66194,2019,Mayo,México,16,15,,31,-75.527794,10.406342
66195,2019,Mayo,México,358,505,,863,-75.516486,10.446304
66196,2019,Mayo,México,40,69,,109,-74.77647900000001,10.886686
66197,2019,Mayo,México,1,3,,4,-72.129595,11.360028999999999
66198,2019,Mayo,México,2,2,,4,-81.70216500000001,12.5862
66199,2019,Mayo,México,109,246,,355,-76.532004,3.451668
66200,2019,Mayo,México,2,4,,6,-75.76635300000001,4.45285
66201,2019,Mayo,México,4918,8004,,12922,-74.140516,4.697157
66202,2019,Mayo,México,6,21,,27,-75.736374,4.815189
66203,2019,Mayo,México,459,1210,,1669,-75.42726,6.170465
66204,2019,Mayo,México,1,6,,7,-73.181317,7.1280470000000005
66205,2019,Mayo,México,3,4,,7,-72.453013,7.819
66206,2019,Mayo,México,0,2,,2,-72.409396,8.36068
66207,2019,Mayo,República de Moldavia,4,0,,4,-74.140516,4.697157
66208,2019,Mayo,Mongolia,1,4,,5,-74.140516,4.697157
66209,2019,Mayo,Montenegro,0,1,,1,-75.527794,10.406342
66210,2019,Mayo,Montenegro,1,1,,2,-75.516486,10.446304
66211,2019,Mayo,Montenegro,0,1,,1,-74.77647900000001,10.886686
66212,2019,Mayo,Montenegro,0,1,,1,-76.532004,3.451668
66213,2019,Mayo,Montenegro,0,2,,2,-74.140516,4.697157
66214,2019,Mayo,Montenegro,0,1,,1,-75.42726,6.170465
66215,2019,Mayo,Mozambique,1,4,,5,-74.140516,4.697157
66216,2019,Mayo,Myanmar,0,1,,1,-75.527794,10.406342
66217,2019,Mayo,Nepal,0,1,,1,-77.35600000000001,0.81488
66218,2019,Mayo,Nepal,0,1,,1,-75.516486,10.446304
66219,2019,Mayo,Nepal,1,2,,3,-74.140516,4.697157
66220,2019,Mayo,Nicaragua,0,1,,1,-77.35600000000001,0.81488
66221,2019,Mayo,Nicaragua,23,24,,47,-75.516486,10.446304
66222,2019,Mayo,Nicaragua,5,4,,9,-74.77647900000001,10.886686
66223,2019,Mayo,Nicaragua,2,2,,4,-81.70216500000001,12.5862
66224,2019,Mayo,Nicaragua,13,22,,35,-76.532004,3.451668
66225,2019,Mayo,Nicaragua,1,1,,2,-75.76635300000001,4.45285
66226,2019,Mayo,Nicaragua,78,116,,194,-74.140516,4.697157
66227,2019,Mayo,Nicaragua,2,1,,3,-75.736374,4.815189
66228,2019,Mayo,Nicaragua,13,26,,39,-75.42726,6.170465
66229,2019,Mayo,Nicaragua,1,1,,2,-73.181317,7.1280470000000005
66230,2019,Mayo,Nigeria,0,4,,4,-75.516486,10.446304
66231,2019,Mayo,Nigeria,3,15,,18,-74.140516,4.697157
66232,2019,Mayo,Nigeria,1,5,,6,-75.42726,6.170465
66233,2019,Mayo,Noruega,1,1,,2,-69.941498,4.191162
66234,2019,Mayo,Noruega,0,3,,3,-69.94143100000001,4.214082
66235,2019,Mayo,Noruega,5,2,,7,-77.35600000000001,0.81488
66236,2019,Mayo,Noruega,2,0,,2,-75.527794,10.406342
66237,2019,Mayo,Noruega,8,14,,22,-75.516486,10.446304
66238,2019,Mayo,Noruega,0,1,,1,-74.77647900000001,10.886686
66239,2019,Mayo,Noruega,0,3,,3,-72.129595,11.360028999999999
66240,2019,Mayo,Noruega,2,2,,4,-81.70216500000001,12.5862
66241,2019,Mayo,Noruega,3,8,,11,-76.532004,3.451668
66242,2019,Mayo,Noruega,65,91,,156,-74.140516,4.697157
66243,2019,Mayo,Noruega,0,1,,1,-75.736374,4.815189
66244,2019,Mayo,Noruega,7,11,,18,-75.42726,6.170465
66245,2019,Mayo,Noruega,2,2,,4,-77.35002,8.63337
66246,2019,Mayo,Nueva Zelanda,3,2,,5,-69.94143100000001,4.214082
66247,2019,Mayo,Nueva Zelanda,10,10,,20,-77.35600000000001,0.81488
66248,2019,Mayo,Nueva Zelanda,4,6,,10,-75.527794,10.406342
66249,2019,Mayo,Nueva Zelanda,6,18,,24,-75.516486,10.446304
66250,2019,Mayo,Nueva Zelanda,0,2,,2,-74.77647900000001,10.886686
66251,2019,Mayo,Nueva Zelanda,1,1,,2,-74.213989,11.247722999999999
66252,2019,Mayo,Nueva Zelanda,1,8,,9,-76.532004,3.451668
66253,2019,Mayo,Nueva Zelanda,60,80,,140,-74.140516,4.697157
66254,2019,Mayo,Nueva Zelanda,10,14,,24,-75.42726,6.170465
66255,2019,Mayo,Nueva Zelanda,4,2,,6,-77.35002,8.63337
66256,2019,Mayo,Omán,1,0,,1,-75.42726,6.170465
66257,2019,Mayo,Países Bajos,2,2,,4,-69.941498,4.191162
66258,2019,Mayo,Países Bajos,6,7,,13,-69.94143100000001,4.214082
66259,2019,Mayo,Países Bajos,1,1,,2,-76.876446,0.33002
66260,2019,Mayo,Países Bajos,39,32,,71,-77.35600000000001,0.81488
66261,2019,Mayo,Países Bajos,17,17,,34,-75.527794,10.406342
66262,2019,Mayo,Países Bajos,275,182,,457,-75.516486,10.446304
66263,2019,Mayo,Países Bajos,12,14,,26,-74.77647900000001,10.886686
66264,2019,Mayo,Países Bajos,1,9,,10,-72.129595,11.360028999999999
66265,2019,Mayo,Países Bajos,0,2,,2,-72.919186,11.52863
66266,2019,Mayo,Países Bajos,0,2,,2,-81.70216500000001,12.5862
66267,2019,Mayo,Países Bajos,0,5,,5,-81.372937,13.338761300000002
66268,2019,Mayo,Países Bajos,55,84,,139,-76.532004,3.451668
66269,2019,Mayo,Países Bajos,1508,2066,,3574,-74.140516,4.697157
66270,2019,Mayo,Países Bajos,1,6,,7,-75.736374,4.815189
66271,2019,Mayo,Países Bajos,121,215,,336,-75.42726,6.170465
66272,2019,Mayo,Países Bajos,4,8,,12,-73.181317,7.1280470000000005
66273,2019,Mayo,Países Bajos,1,5,,6,-72.453013,7.819
66274,2019,Mayo,Países Bajos,6,11,,17,-77.35002,8.63337
66275,2019,Mayo,Pakistán,6,16,,22,-74.140516,4.697157
66276,2019,Mayo,Pakistán,1,2,,3,-75.42726,6.170465
66277,2019,Mayo,Panamá,1,0,,1,-77.35600000000001,0.81488
66278,2019,Mayo,Panamá,0,1,,1,-78.802679,18.00143
66279,2019,Mayo,Panamá,1,16,,17,-75.527794,10.406342
66280,2019,Mayo,Panamá,465,472,,937,-75.516486,10.446304
66281,2019,Mayo,Panamá,134,163,,297,-74.77647900000001,10.886686
66282,2019,Mayo,Panamá,0,1,,1,-74.765343,10.970933
66283,2019,Mayo,Panamá,0,3,,3,-74.213989,11.247722999999999
66284,2019,Mayo,Panamá,0,2,,2,-72.129595,11.360028999999999
66285,2019,Mayo,Panamá,32,34,,66,-81.70216500000001,12.5862
66286,2019,Mayo,Panamá,342,409,,751,-76.532004,3.451668
66287,2019,Mayo,Panamá,2,1,,3,-75.76635300000001,4.45285
66288,2019,Mayo,Panamá,1520,1835,,3355,-74.140516,4.697157
66289,2019,Mayo,Panamá,18,34,,52,-75.736374,4.815189
66290,2019,Mayo,Panamá,1482,1450,,2932,-75.42726,6.170465
66291,2019,Mayo,Panamá,1,1,,2,-77.762647,7.102626
66292,2019,Mayo,Panamá,17,10,,27,-73.181317,7.1280470000000005
66293,2019,Mayo,Panamá,2,3,,5,-72.453013,7.819
66294,2019,Mayo,Panamá,4,4,,8,-77.35002,8.63337
66295,2019,Mayo,Papúa Nueva Guinea,1,0,,1,-69.94143100000001,4.214082
66296,2019,Mayo,Papúa Nueva Guinea,0,1,,1,-74.140516,4.697157
66297,2019,Mayo,Paraguay,3,9,,12,-69.941498,4.191162
66298,2019,Mayo,Paraguay,2,4,,6,-77.35600000000001,0.81488
66299,2019,Mayo,Paraguay,3,4,,7,-75.527794,10.406342
66300,2019,Mayo,Paraguay,100,33,,133,-75.516486,10.446304
66301,2019,Mayo,Paraguay,4,0,,4,-74.77647900000001,10.886686
66302,2019,Mayo,Paraguay,0,1,,1,-72.129595,11.360028999999999
66303,2019,Mayo,Paraguay,41,32,,73,-81.70216500000001,12.5862
66304,2019,Mayo,Paraguay,18,13,,31,-76.532004,3.451668
66305,2019,Mayo,Paraguay,197,234,,431,-74.140516,4.697157
66306,2019,Mayo,Paraguay,2,1,,3,-75.736374,4.815189
66307,2019,Mayo,Paraguay,29,47,,76,-75.42726,6.170465
66308,2019,Mayo,Paraguay,0,1,,1,-72.453013,7.819
66309,2019,Mayo,Perú,5,7,,12,-69.941498,4.191162
66310,2019,Mayo,Perú,61,58,,119,-69.94143100000001,4.214082
66311,2019,Mayo,Perú,19,47,,66,-74.78366,0.18595699999999998
66312,2019,Mayo,Perú,2,19,,21,-76.876446,0.33002
66313,2019,Mayo,Perú,96,250,,346,-77.35600000000001,0.81488
66314,2019,Mayo,Perú,26,30,,56,-75.527794,10.406342
66315,2019,Mayo,Perú,1184,740,,1924,-75.516486,10.446304
66316,2019,Mayo,Perú,11,32,,43,-74.77647900000001,10.886686
66317,2019,Mayo,Perú,3,12,,15,-72.129595,11.360028999999999
66318,2019,Mayo,Perú,407,277,,684,-81.70216500000001,12.5862
66319,2019,Mayo,Perú,331,393,,724,-76.532004,3.451668
66320,2019,Mayo,Perú,0,2,,2,-75.76635300000001,4.45285
66321,2019,Mayo,Perú,4170,4729,,8899,-74.140516,4.697157
66322,2019,Mayo,Perú,4,7,,11,-75.736374,4.815189
66323,2019,Mayo,Perú,804,1113,,1917,-75.42726,6.170465
66324,2019,Mayo,Perú,1,0,,1,-70.74025300000001,7.088728999999999
66325,2019,Mayo,Perú,0,2,,2,-73.181317,7.1280470000000005
66326,2019,Mayo,Perú,48,83,,131,-72.453013,7.819
66327,2019,Mayo,Perú,0,1,,1,-72.409396,8.36068
66328,2019,Mayo,Palestina,0,2,,2,-74.140516,4.697157
66329,2019,Mayo,Polonia,1,0,,1,-69.94143100000001,4.214082
66330,2019,Mayo,Polonia,8,13,,21,-77.35600000000001,0.81488
66331,2019,Mayo,Polonia,2,7,,9,-75.527794,10.406342
66332,2019,Mayo,Polonia,11,23,,34,-75.516486,10.446304
66333,2019,Mayo,Polonia,1,1,,2,-74.77647900000001,10.886686
66334,2019,Mayo,Polonia,3,1,,4,-74.213989,11.247722999999999
66335,2019,Mayo,Polonia,4,5,,9,-76.532004,3.451668
66336,2019,Mayo,Polonia,146,170,,316,-74.140516,4.697157
66337,2019,Mayo,Polonia,16,24,,40,-75.42726,6.170465
66338,2019,Mayo,Polonia,1,1,,2,-77.35002,8.63337
66339,2019,Mayo,Portugal,1,1,,2,-69.94143100000001,4.214082
66340,2019,Mayo,Portugal,1,7,,8,-77.35600000000001,0.81488
66341,2019,Mayo,Portugal,1,1,,2,-75.527794,10.406342
66342,2019,Mayo,Portugal,16,23,,39,-75.516486,10.446304
66343,2019,Mayo,Portugal,1,5,,6,-74.77647900000001,10.886686
66344,2019,Mayo,Portugal,5,5,,10,-72.129595,11.360028999999999
66345,2019,Mayo,Portugal,1,2,,3,-81.70216500000001,12.5862
66346,2019,Mayo,Portugal,9,12,,21,-76.532004,3.451668
66347,2019,Mayo,Portugal,208,465,,673,-74.140516,4.697157
66348,2019,Mayo,Portugal,0,3,,3,-75.736374,4.815189
66349,2019,Mayo,Portugal,12,49,,61,-75.42726,6.170465
66350,2019,Mayo,Portugal,6,11,,17,-72.453013,7.819
66351,2019,Mayo,Portugal,1,1,,2,-72.409396,8.36068
66352,2019,Mayo,Qatar,0,1,,1,-74.140516,4.697157
66353,2019,Mayo,Qatar,0,1,,1,-75.736374,4.815189
66354,2019,Mayo,Qatar,0,1,,1,-75.42726,6.170465
66355,2019,Mayo,Reino Unido de Gran Bretaña e Irlanda del Norte,3,4,,7,-69.941498,4.191162
66356,2019,Mayo,Reino Unido de Gran Bretaña e Irlanda del Norte,9,13,,22,-69.94143100000001,4.214082
66357,2019,Mayo,Reino Unido de Gran Bretaña e Irlanda del Norte,3,4,,7,-76.876446,0.33002
66358,2019,Mayo,Reino Unido de Gran Bretaña e Irlanda del Norte,77,93,,170,-77.35600000000001,0.81488
66359,2019,Mayo,Reino Unido de Gran Bretaña e Irlanda del Norte,17,18,,35,-75.527794,10.406342
66360,2019,Mayo,Reino Unido de Gran Bretaña e Irlanda del Norte,117,157,,274,-75.516486,10.446304
66361,2019,Mayo,Reino Unido de Gran Bretaña e Irlanda del Norte,8,19,,27,-74.77647900000001,10.886686
66362,2019,Mayo,Reino Unido de Gran Bretaña e Irlanda del Norte,0,3,,3,-74.765343,10.970933
66363,2019,Mayo,Reino Unido de Gran Bretaña e Irlanda del Norte,1,1,,2,-72.129595,11.360028999999999
66364,2019,Mayo,Reino Unido de Gran Bretaña e Irlanda del Norte,1,1,,2,-81.703935,12.574411099999999
66365,2019,Mayo,Reino Unido de Gran Bretaña e Irlanda del Norte,0,3,,3,-81.70216500000001,12.5862
66366,2019,Mayo,Reino Unido de Gran Bretaña e Irlanda del Norte,1,1,,2,-81.372937,13.338761300000002
66367,2019,Mayo,Reino Unido de Gran Bretaña e Irlanda del Norte,34,62,,96,-76.532004,3.451668
66368,2019,Mayo,Reino Unido de Gran Bretaña e Irlanda del Norte,1019,2001,,3020,-74.140516,4.697157
66369,2019,Mayo,Reino Unido de Gran Bretaña e Irlanda del Norte,0,4,,4,-75.736374,4.815189
66370,2019,Mayo,Reino Unido de Gran Bretaña e Irlanda del Norte,139,310,,449,-75.42726,6.170465
66371,2019,Mayo,Reino Unido de Gran Bretaña e Irlanda del Norte,33,32,,65,-77.35002,8.63337
66372,2019,Mayo,República Dominicana,0,1,,1,-69.94143100000001,4.214082
66373,2019,Mayo,República Dominicana,0,2,,2,-76.876446,0.33002
66374,2019,Mayo,República Dominicana,4,12,,16,-77.35600000000001,0.81488
66375,2019,Mayo,República Dominicana,94,123,,217,-75.516486,10.446304
66376,2019,Mayo,República Dominicana,14,51,,65,-74.77647900000001,10.886686
66377,2019,Mayo,República Dominicana,0,2,,2,-74.213989,11.247722999999999
66378,2019,Mayo,República Dominicana,0,3,,3,-72.129595,11.360028999999999
66379,2019,Mayo,República Dominicana,40,38,,78,-76.532004,3.451668
66380,2019,Mayo,República Dominicana,2,1,,3,-75.76635300000001,4.45285
66381,2019,Mayo,República Dominicana,1125,1240,,2365,-74.140516,4.697157
66382,2019,Mayo,República Dominicana,5,3,,8,-75.736374,4.815189
66383,2019,Mayo,República Dominicana,83,185,,268,-75.42726,6.170465
66384,2019,Mayo,República Dominicana,0,2,,2,-72.453013,7.819
66385,2019,Mayo,Desconocido,0,1,,1,-74.140516,4.697157
66386,2019,Mayo,Rumania,4,2,,6,-77.35600000000001,0.81488
66387,2019,Mayo,Rumania,2,3,,5,-75.527794,10.406342
66388,2019,Mayo,Rumania,8,16,,24,-75.516486,10.446304
66389,2019,Mayo,Rumania,0,1,,1,-74.77647900000001,10.886686
66390,2019,Mayo,Rumania,2,3,,5,-76.532004,3.451668
66391,2019,Mayo,Rumania,69,69,,138,-74.140516,4.697157
66392,2019,Mayo,Rumania,1,0,,1,-75.736374,4.815189
66393,2019,Mayo,Rumania,9,10,,19,-75.42726,6.170465
66394,2019,Mayo,Federación de Rusia,1,0,,1,-76.876446,0.33002
66395,2019,Mayo,Federación de Rusia,3,5,,8,-77.35600000000001,0.81488
66396,2019,Mayo,Federación de Rusia,1,9,,10,-75.527794,10.406342
66397,2019,Mayo,Federación de Rusia,22,18,,40,-75.516486,10.446304
66398,2019,Mayo,Federación de Rusia,1,3,,4,-74.77647900000001,10.886686
66399,2019,Mayo,Federación de Rusia,0,7,,7,-74.213989,11.247722999999999
66400,2019,Mayo,Federación de Rusia,2,0,,2,-72.129595,11.360028999999999
66401,2019,Mayo,Federación de Rusia,6,11,,17,-76.532004,3.451668
66402,2019,Mayo,Federación de Rusia,168,200,,368,-74.140516,4.697157
66403,2019,Mayo,Federación de Rusia,11,10,,21,-75.42726,6.170465
66404,2019,Mayo,Federación de Rusia,0,1,,1,-73.181317,7.1280470000000005
66405,2019,Mayo,Federación de Rusia,0,2,,2,-75.68164200000001,9.402597
66406,2019,Mayo,San Cristóbal y Nevis,1,0,,1,-75.516486,10.446304
66407,2019,Mayo,San Cristóbal y Nevis,1,0,,1,-74.140516,4.697157
66408,2019,Mayo,San Cristóbal y Nevis,0,1,,1,-75.42726,6.170465
66409,2019,Mayo,San Marino,0,1,,1,-74.140516,4.697157
66410,2019,Mayo,San  Vicente y las Granadinas,0,2,,2,-75.516486,10.446304
66411,2019,Mayo,San  Vicente y las Granadinas,1,1,,2,-74.140516,4.697157
66412,2019,Mayo,Santa Lucia,0,3,,3,-75.516486,10.446304
66413,2019,Mayo,Santa Lucia,0,1,,1,-74.77647900000001,10.886686
66414,2019,Mayo,Santa Lucia,4,2,,6,-74.140516,4.697157
66415,2019,Mayo,Santa Lucia,1,1,,2,-73.181317,7.1280470000000005
66416,2019,Mayo,Santa Sede/Ciudad del Vaticano,0,1,,1,-74.140516,4.697157
66417,2019,Mayo,Senegal,1,1,,2,-74.140516,4.697157
66418,2019,Mayo,Serbia,1,0,,1,-77.35600000000001,0.81488
66419,2019,Mayo,Serbia,2,2,,4,-75.516486,10.446304
66420,2019,Mayo,Serbia,1,2,,3,-76.532004,3.451668
66421,2019,Mayo,Serbia,8,22,,30,-74.140516,4.697157
66422,2019,Mayo,Serbia,1,1,,2,-75.42726,6.170465
66423,2019,Mayo,Singapur,1,0,,1,-69.94143100000001,4.214082
66424,2019,Mayo,Singapur,1,0,,1,-77.35600000000001,0.81488
66425,2019,Mayo,Singapur,4,7,,11,-75.516486,10.446304
66426,2019,Mayo,Singapur,19,38,,57,-74.140516,4.697157
66427,2019,Mayo,Singapur,2,5,,7,-75.42726,6.170465
66428,2019,Mayo,República Árabe Siria,1,0,,1,-72.129595,11.360028999999999
66429,2019,Mayo,República Árabe Siria,0,2,,2,-74.140516,4.697157
66430,2019,Mayo,República Árabe Siria,0,1,,1,-75.42726,6.170465
66431,2019,Mayo,Sri Lanka,0,1,,1,-75.516486,10.446304
66432,2019,Mayo,Sri Lanka,0,1,,1,-76.532004,3.451668
66433,2019,Mayo,Sri Lanka,1,1,,2,-74.140516,4.697157
66434,2019,Mayo,Sri Lanka,0,1,,1,-75.42726,6.170465
66435,2019,Mayo,Sudáfrica,0,5,,5,-75.527794,10.406342
66436,2019,Mayo,Sudáfrica,2,5,,7,-75.516486,10.446304
66437,2019,Mayo,Sudáfrica,0,2,,2,-74.77647900000001,10.886686
66438,2019,Mayo,Sudáfrica,0,3,,3,-76.532004,3.451668
66439,2019,Mayo,Sudáfrica,15,33,,48,-74.140516,4.697157
66440,2019,Mayo,Sudáfrica,2,3,,5,-75.42726,6.170465
66441,2019,Mayo,Sudán,1,1,,2,-74.140516,4.697157
66442,2019,Mayo,Suecia,0,1,,1,-69.941498,4.191162
66443,2019,Mayo,Suecia,1,0,,1,-69.94143100000001,4.214082
66444,2019,Mayo,Suecia,1,1,,2,-76.876446,0.33002
66445,2019,Mayo,Suecia,8,9,,17,-77.35600000000001,0.81488
66446,2019,Mayo,Suecia,7,9,,16,-75.527794,10.406342
66447,2019,Mayo,Suecia,8,21,,29,-75.516486,10.446304
66448,2019,Mayo,Suecia,2,1,,3,-74.77647900000001,10.886686
66449,2019,Mayo,Suecia,0,1,,1,-74.213989,11.247722999999999
66450,2019,Mayo,Suecia,3,9,,12,-76.532004,3.451668
66451,2019,Mayo,Suecia,100,178,,278,-74.140516,4.697157
66452,2019,Mayo,Suecia,12,19,,31,-75.42726,6.170465
66453,2019,Mayo,Suecia,2,0,,2,-73.181317,7.1280470000000005
66454,2019,Mayo,Suecia,0,1,,1,-77.35002,8.63337
66455,2019,Mayo,Suiza,2,2,,4,-69.94143100000001,4.214082
66456,2019,Mayo,Suiza,1,1,,2,-76.876446,0.33002
66457,2019,Mayo,Suiza,41,32,,73,-77.35600000000001,0.81488
66458,2019,Mayo,Suiza,18,17,,35,-75.527794,10.406342
66459,2019,Mayo,Suiza,41,45,,86,-75.516486,10.446304
66460,2019,Mayo,Suiza,2,5,,7,-74.77647900000001,10.886686
66461,2019,Mayo,Suiza,0,1,,1,-74.213989,11.247722999999999
66462,2019,Mayo,Suiza,2,5,,7,-81.70216500000001,12.5862
66463,2019,Mayo,Suiza,0,2,,2,-81.372937,13.338761300000002
66464,2019,Mayo,Suiza,33,48,,81,-76.532004,3.451668
66465,2019,Mayo,Suiza,1,0,,1,-75.76635300000001,4.45285
66466,2019,Mayo,Suiza,290,511,,801,-74.140516,4.697157
66467,2019,Mayo,Suiza,0,2,,2,-75.736374,4.815189
66468,2019,Mayo,Suiza,41,84,,125,-75.42726,6.170465
66469,2019,Mayo,Suiza,3,3,,6,-77.35002,8.63337
66470,2019,Mayo,Surinam,0,2,,2,-75.516486,10.446304
66471,2019,Mayo,Surinam,19,33,,52,-74.140516,4.697157
66472,2019,Mayo,Surinam,2,5,,7,-75.42726,6.170465
66473,2019,Mayo,Surinam,0,3,,3,-73.181317,7.1280470000000005
66474,2019,Mayo,Taiwán,1,0,,1,-74.140516,4.697157
66475,2019,Mayo,Tailandia,1,1,,2,-77.35600000000001,0.81488
66476,2019,Mayo,Tailandia,1,3,,4,-75.516486,10.446304
66477,2019,Mayo,Tailandia,1,0,,1,-74.77647900000001,10.886686
66478,2019,Mayo,Tailandia,16,8,,24,-74.140516,4.697157
66479,2019,Mayo,Tailandia,2,3,,5,-75.42726,6.170465
66480,2019,Mayo,Tanzania,1,0,,1,-76.532004,3.451668
66481,2019,Mayo,Tanzania,3,4,,7,-74.140516,4.697157
66482,2019,Mayo,Trinidad y Tobago,0,1,,1,-69.94143100000001,4.214082
66483,2019,Mayo,Trinidad y Tobago,0,1,,1,-76.876446,0.33002
66484,2019,Mayo,Trinidad y Tobago,6,12,,18,-75.516486,10.446304
66485,2019,Mayo,Trinidad y Tobago,6,7,,13,-74.77647900000001,10.886686
66486,2019,Mayo,Trinidad y Tobago,1,1,,2,-81.70216500000001,12.5862
66487,2019,Mayo,Trinidad y Tobago,6,13,,19,-76.532004,3.451668
66488,2019,Mayo,Trinidad y Tobago,29,64,,93,-74.140516,4.697157
66489,2019,Mayo,Trinidad y Tobago,4,18,,22,-75.42726,6.170465
66490,2019,Mayo,Túnez,2,3,,5,-74.140516,4.697157
66491,2019,Mayo,Túnez,0,1,,1,-75.42726,6.170465
66492,2019,Mayo,Turquía,2,3,,5,-77.35600000000001,0.81488
66493,2019,Mayo,Turquía,0,2,,2,-75.527794,10.406342
66494,2019,Mayo,Turquía,6,12,,18,-75.516486,10.446304
66495,2019,Mayo,Turquía,2,6,,8,-76.532004,3.451668
66496,2019,Mayo,Turquía,141,350,,491,-74.140516,4.697157
66497,2019,Mayo,Turquía,1,15,,16,-75.42726,6.170465
66498,2019,Mayo,Ucrania,0,1,,1,-77.35600000000001,0.81488
66499,2019,Mayo,Ucrania,1,10,,11,-75.527794,10.406342
66500,2019,Mayo,Ucrania,0,14,,14,-75.516486,10.446304
66501,2019,Mayo,Ucrania,0,4,,4,-74.77647900000001,10.886686
66502,2019,Mayo,Ucrania,0,4,,4,-74.765343,10.970933
66503,2019,Mayo,Ucrania,0,4,,4,-74.213989,11.247722999999999
66504,2019,Mayo,Ucrania,0,12,,12,-76.532004,3.451668
66505,2019,Mayo,Ucrania,0,7,,7,-77.061029,3.8844260000000004
66506,2019,Mayo,Ucrania,35,28,,63,-74.140516,4.697157
66507,2019,Mayo,Ucrania,0,1,,1,-75.736374,4.815189
66508,2019,Mayo,Ucrania,3,4,,7,-75.42726,6.170465
66509,2019,Mayo,Ucrania,0,3,,3,-75.68164200000001,9.402597
66510,2019,Mayo,Uganda,0,1,,1,-75.516486,10.446304
66511,2019,Mayo,Uganda,1,1,,2,-74.140516,4.697157
66512,2019,Mayo,Uruguay,1,0,,1,-69.941498,4.191162
66513,2019,Mayo,Uruguay,0,1,,1,-69.94143100000001,4.214082
66514,2019,Mayo,Uruguay,2,2,,4,-76.876446,0.33002
66515,2019,Mayo,Uruguay,5,16,,21,-77.35600000000001,0.81488
66516,2019,Mayo,Uruguay,106,35,,141,-75.527794,10.406342
66517,2019,Mayo,Uruguay,124,91,,215,-75.516486,10.446304
66518,2019,Mayo,Uruguay,4,11,,15,-74.77647900000001,10.886686
66519,2019,Mayo,Uruguay,21,18,,39,-81.70216500000001,12.5862
66520,2019,Mayo,Uruguay,21,97,,118,-76.532004,3.451668
66521,2019,Mayo,Uruguay,0,1,,1,-75.76635300000001,4.45285
66522,2019,Mayo,Uruguay,403,467,,870,-74.140516,4.697157
66523,2019,Mayo,Uruguay,0,4,,4,-75.736374,4.815189
66524,2019,Mayo,Uruguay,79,125,,204,-75.42726,6.170465
66525,2019,Mayo,Uruguay,2,4,,6,-72.453013,7.819
66526,2019,Mayo,Uruguay,0,1,,1,-72.409396,8.36068
66527,2019,Mayo,Uzbekistán,0,2,,2,-75.42726,6.170465
66528,2019,Mayo,Vanuatu,0,1,,1,-74.140516,4.697157
66529,2019,Mayo,Venezuela,4,7,,11,-69.941498,4.191162
66530,2019,Mayo,Venezuela,5,4,,9,-69.94143100000001,4.214082
66531,2019,Mayo,Venezuela,66,78,,144,-76.876446,0.33002
66532,2019,Mayo,Venezuela,3618,3863,,7481,-77.35600000000001,0.81488
66533,2019,Mayo,Venezuela,3,18,,21,-78.802679,18.00143
66534,2019,Mayo,Venezuela,11,20,,31,-75.527794,10.406342
66535,2019,Mayo,Venezuela,229,222,,451,-75.516486,10.446304
66536,2019,Mayo,Venezuela,249,328,,577,-74.77647900000001,10.886686
66537,2019,Mayo,Venezuela,12,44,,56,-74.232675,11.117206
66538,2019,Mayo,Venezuela,0,2,,2,-74.213989,11.247722999999999
66539,2019,Mayo,Venezuela,8727,7879,,16606,-72.129595,11.360028999999999
66540,2019,Mayo,Venezuela,0,1,,1,-72.919186,11.52863
66541,2019,Mayo,Venezuela,2,3,,5,-81.70216500000001,12.5862
66542,2019,Mayo,Venezuela,0,1,,1,-81.372937,13.338761300000002
66543,2019,Mayo,Venezuela,213,234,,447,-76.532004,3.451668
66544,2019,Mayo,Venezuela,43,21,,64,-67.927521,3.866713
66545,2019,Mayo,Venezuela,3,1,,4,-75.76635300000001,4.45285
66546,2019,Mayo,Venezuela,8546,8266,,16812,-74.140516,4.697157
66547,2019,Mayo,Venezuela,9,20,,29,-75.736374,4.815189
66548,2019,Mayo,Venezuela,1529,1685,,3214,-75.42726,6.170465
66549,2019,Mayo,Venezuela,39,55,,94,-67.48402800000001,6.185536
66550,2019,Mayo,Venezuela,471,434,,905,-70.74025300000001,7.088728999999999
66551,2019,Mayo,Venezuela,9,7,,16,-73.181317,7.1280470000000005
66552,2019,Mayo,Venezuela,29767,28185,,57952,-72.453013,7.819
66553,2019,Mayo,Venezuela,8,18,,26,-72.508188,7.927233
66554,2019,Mayo,Venezuela,1251,1066,,2317,-72.409396,8.36068
66555,2019,Mayo,Vietnam,0,3,,3,-75.527794,10.406342
66556,2019,Mayo,Vietnam,0,3,,3,-75.516486,10.446304
66557,2019,Mayo,Vietnam,0,6,,6,-74.77647900000001,10.886686
66558,2019,Mayo,Vietnam,0,6,,6,-74.765343,10.970933
66559,2019,Mayo,Vietnam,19,18,,37,-74.140516,4.697157
66560,2019,Mayo,Vietnam,1,2,,3,-75.42726,6.170465
66561,2019,Mayo,República Árabe de Yemen,0,2,,2,-74.140516,4.697157
66562,2019,Mayo,Zambia,2,1,,3,-75.516486,10.446304
66563,2019,Mayo,Zimbabue,0,1,,1,-75.516486,10.446304
66564,2019,Mayo,Zimbabue,1,0,,1,-76.532004,3.451668
66565,2019,Mayo,Zimbabue,3,2,,5,-74.140516,4.697157
66566,2019,Mayo,Zimbabue,1,0,,1,-75.42726,6.170465
66567,2019,Mayo,Desconocido,3,2,,5,-75.516486,10.446304
66568,2019,Mayo,Desconocido,2,0,,2,-74.77647900000001,10.886686
66569,2019,Mayo,Desconocido,0,1,,1,-81.70216500000001,12.5862
66570,2019,Mayo,Desconocido,2,4,,6,-76.532004,3.451668
66571,2019,Mayo,Desconocido,103,157,,260,-74.140516,4.697157
66572,2019,Mayo,Desconocido,3,8,,11,-75.42726,6.170465
66573,2019,Junio,Afganistán,1,1,,2,-74.140516,4.697157
66574,2019,Junio,Albania,0,1,,1,-78.802679,18.00143
66575,2019,Junio,Albania,0,2,,2,-76.532004,3.451668
66576,2019,Junio,Albania,2,13,,15,-74.140516,4.697157
66577,2019,Junio,Albania,2,1,,3,-75.42726,6.170465
66578,2019,Junio,Alemania,3,3,,6,-69.941498,4.191162
66579,2019,Junio,Alemania,24,24,,48,-69.94143100000001,4.214082
66580,2019,Junio,Alemania,11,12,,23,-76.876446,0.33002
66581,2019,Junio,Alemania,97,122,,219,-77.35600000000001,0.81488
66582,2019,Junio,Alemania,26,37,,63,-75.527794,10.406342
66583,2019,Junio,Alemania,94,139,,233,-75.516486,10.446304
66584,2019,Junio,Alemania,20,29,,49,-74.77647900000001,10.886686
66585,2019,Junio,Alemania,0,2,,2,-72.129595,11.360028999999999
66586,2019,Junio,Alemania,5,2,,7,-81.70216500000001,12.5862
66587,2019,Junio,Alemania,0,5,,5,-81.372937,13.338761300000002
66588,2019,Junio,Alemania,61,67,,128,-76.532004,3.451668
66589,2019,Junio,Alemania,1590,2274,,3864,-74.140516,4.697157
66590,2019,Junio,Alemania,0,1,,1,-75.736374,4.815189
66591,2019,Junio,Alemania,144,273,,417,-75.42726,6.170465
66592,2019,Junio,Alemania,4,2,,6,-72.453013,7.819
66593,2019,Junio,Alemania,11,14,,25,-77.35002,8.63337
66594,2019,Junio,Andorra,0,1,,1,-75.516486,10.446304
66595,2019,Junio,Andorra,3,13,,16,-74.140516,4.697157
66596,2019,Junio,Andorra,0,2,,2,-75.42726,6.170465
66597,2019,Junio,Angola,0,1,,1,-74.140516,4.697157
66598,2019,Junio,Antigua y Barbuda,0,2,,2,-74.77647900000001,10.886686
66599,2019,Junio,Antigua y Barbuda,2,2,,4,-74.140516,4.697157
66600,2019,Junio,Antigua y Barbuda,1,5,,6,-75.42726,6.170465
66601,2019,Junio,Arabia Saudita,0,2,,2,-75.516486,10.446304
66602,2019,Junio,Arabia Saudita,0,1,,1,-76.532004,3.451668
66603,2019,Junio,Arabia Saudita,0,16,,16,-74.140516,4.697157
66604,2019,Junio,Arabia Saudita,0,1,,1,-75.42726,6.170465
66605,2019,Junio,Argelia,1,0,,1,-76.532004,3.451668
66606,2019,Junio,Argelia,1,4,,5,-74.140516,4.697157
66607,2019,Junio,Argentina,2,5,,7,-69.941498,4.191162
66608,2019,Junio,Argentina,8,6,,14,-69.94143100000001,4.214082
66609,2019,Junio,Argentina,7,18,,25,-76.876446,0.33002
66610,2019,Junio,Argentina,78,148,,226,-77.35600000000001,0.81488
66611,2019,Junio,Argentina,345,202,,547,-75.527794,10.406342
66612,2019,Junio,Argentina,1523,1190,,2713,-75.516486,10.446304
66613,2019,Junio,Argentina,9,32,,41,-74.77647900000001,10.886686
66614,2019,Junio,Argentina,0,1,,1,-74.213989,11.247722999999999
66615,2019,Junio,Argentina,8,10,,18,-72.129595,11.360028999999999
66616,2019,Junio,Argentina,209,150,,359,-81.70216500000001,12.5862
66617,2019,Junio,Argentina,102,156,,258,-76.532004,3.451668
66618,2019,Junio,Argentina,1,2,,3,-75.76635300000001,4.45285
66619,2019,Junio,Argentina,3684,5092,,8776,-74.140516,4.697157
66620,2019,Junio,Argentina,6,7,,13,-75.736374,4.815189
66621,2019,Junio,Argentina,211,437,,648,-75.42726,6.170465
66622,2019,Junio,Argentina,0,1,,1,-70.74025300000001,7.088728999999999
66623,2019,Junio,Argentina,0,1,,1,-73.181317,7.1280470000000005
66624,2019,Junio,Argentina,3,5,,8,-72.453013,7.819
66625,2019,Junio,Argentina,0,1,,1,-72.409396,8.36068
66626,2019,Junio,Argentina,0,1,,1,-77.35002,8.63337
66627,2019,Junio,República de Armenia,2,1,,3,-75.516486,10.446304
66628,2019,Junio,República de Armenia,1,2,,3,-74.140516,4.697157
66629,2019,Junio,República de Armenia,0,2,,2,-75.42726,6.170465
66630,2019,Junio,Australia,2,0,,2,-69.941498,4.191162
66631,2019,Junio,Australia,2,3,,5,-69.94143100000001,4.214082
66632,2019,Junio,Australia,19,29,,48,-77.35600000000001,0.81488
66633,2019,Junio,Australia,14,16,,30,-75.527794,10.406342
66634,2019,Junio,Australia,53,64,,117,-75.516486,10.446304
66635,2019,Junio,Australia,4,13,,17,-74.77647900000001,10.886686
66636,2019,Junio,Australia,0,1,,1,-72.129595,11.360028999999999
66637,2019,Junio,Australia,1,2,,3,-81.70216500000001,12.5862
66638,2019,Junio,Australia,9,24,,33,-76.532004,3.451668
66639,2019,Junio,Australia,0,1,,1,-75.76635300000001,4.45285
66640,2019,Junio,Australia,334,581,,915,-74.140516,4.697157
66641,2019,Junio,Australia,2,0,,2,-75.736374,4.815189
66642,2019,Junio,Australia,56,77,,133,-75.42726,6.170465
66643,2019,Junio,Australia,0,1,,1,-72.453013,7.819
66644,2019,Junio,Australia,0,1,,1,-72.409396,8.36068
66645,2019,Junio,Australia,11,12,,23,-77.35002,8.63337
66646,2019,Junio,Austria,3,1,,4,-69.94143100000001,4.214082
66647,2019,Junio,Austria,13,12,,25,-77.35600000000001,0.81488
66648,2019,Junio,Austria,1,4,,5,-75.527794,10.406342
66649,2019,Junio,Austria,6,12,,18,-75.516486,10.446304
66650,2019,Junio,Austria,0,2,,2,-74.77647900000001,10.886686
66651,2019,Junio,Austria,2,4,,6,-76.532004,3.451668
66652,2019,Junio,Austria,125,229,,354,-74.140516,4.697157
66653,2019,Junio,Austria,0,2,,2,-75.736374,4.815189
66654,2019,Junio,Austria,11,24,,35,-75.42726,6.170465
66655,2019,Junio,Azerbaiyán,0,1,,1,-74.140516,4.697157
66656,2019,Junio,Bahamas,12,5,,17,-75.516486,10.446304
66657,2019,Junio,Bahamas,1,4,,5,-74.77647900000001,10.886686
66658,2019,Junio,Bahamas,0,5,,5,-76.532004,3.451668
66659,2019,Junio,Bahamas,6,18,,24,-74.140516,4.697157
66660,2019,Junio,Bahamas,5,9,,14,-75.42726,6.170465
66661,2019,Junio,Bahréin,1,1,,2,-74.77647900000001,10.886686
66662,2019,Junio,Bahréin,0,3,,3,-74.140516,4.697157
66663,2019,Junio,Bangladesh,0,1,,1,-75.516486,10.446304
66664,2019,Junio,Bangladesh,1,4,,5,-74.140516,4.697157
66665,2019,Junio,Bangladesh,1,0,,1,-75.42726,6.170465
66666,2019,Junio,Barbados,1,1,,2,-75.527794,10.406342
66667,2019,Junio,Barbados,2,2,,4,-75.516486,10.446304
66668,2019,Junio,Barbados,2,0,,2,-74.77647900000001,10.886686
66669,2019,Junio,Barbados,16,10,,26,-74.140516,4.697157
66670,2019,Junio,Barbados,1,6,,7,-75.42726,6.170465
66671,2019,Junio,República de Belarús,0,1,,1,-76.532004,3.451668
66672,2019,Junio,República de Belarús,0,1,,1,-77.061029,3.8844260000000004
66673,2019,Junio,República de Belarús,1,5,,6,-74.140516,4.697157
66674,2019,Junio,República de Belarús,1,0,,1,-75.42726,6.170465
66675,2019,Junio,Bélgica,0,9,,9,-69.94143100000001,4.214082
66676,2019,Junio,Bélgica,18,22,,40,-77.35600000000001,0.81488
66677,2019,Junio,Bélgica,2,1,,3,-75.527794,10.406342
66678,2019,Junio,Bélgica,33,46,,79,-75.516486,10.446304
66679,2019,Junio,Bélgica,3,5,,8,-74.77647900000001,10.886686
66680,2019,Junio,Bélgica,0,1,,1,-72.129595,11.360028999999999
66681,2019,Junio,Bélgica,0,1,,1,-81.70216500000001,12.5862
66682,2019,Junio,Bélgica,16,24,,40,-76.532004,3.451668
66683,2019,Junio,Bélgica,356,484,,840,-74.140516,4.697157
66684,2019,Junio,Bélgica,40,73,,113,-75.42726,6.170465
66685,2019,Junio,Bélgica,1,0,,1,-73.181317,7.1280470000000005
66686,2019,Junio,Belice,3,2,,5,-75.516486,10.446304
66687,2019,Junio,Belice,0,1,,1,-74.77647900000001,10.886686
66688,2019,Junio,Belice,0,2,,2,-76.532004,3.451668
66689,2019,Junio,Belice,12,16,,28,-74.140516,4.697157
66690,2019,Junio,Belice,4,7,,11,-75.42726,6.170465
66691,2019,Junio,Benín,0,1,,1,-75.527794,10.406342
66692,2019,Junio,Bermudas/Territorio Británico de Ultramar,0,2,,2,-74.140516,4.697157
66693,2019,Junio,Bermudas/Territorio Británico de Ultramar,0,2,,2,-75.42726,6.170465
66694,2019,Junio,Bolivia,0,2,,2,-69.941498,4.191162
66695,2019,Junio,Bolivia,11,10,,21,-77.35600000000001,0.81488
66696,2019,Junio,Bolivia,12,14,,26,-75.527794,10.406342
66697,2019,Junio,Bolivia,81,67,,148,-75.516486,10.446304
66698,2019,Junio,Bolivia,2,1,,3,-74.77647900000001,10.886686
66699,2019,Junio,Bolivia,1,4,,5,-72.129595,11.360028999999999
66700,2019,Junio,Bolivia,31,16,,47,-81.70216500000001,12.5862
66701,2019,Junio,Bolivia,13,20,,33,-76.532004,3.451668
66702,2019,Junio,Bolivia,832,817,,1649,-74.140516,4.697157
66703,2019,Junio,Bolivia,43,39,,82,-75.42726,6.170465
66704,2019,Junio,Bolivia,1,0,,1,-77.35002,8.63337
66705,2019,Junio,Bosnia y Herzegovina,8,1,,9,-74.140516,4.697157
66706,2019,Junio,Botsuana,1,0,,1,-74.140516,4.697157
66707,2019,Junio,Brasil,156,160,,316,-69.941498,4.191162
66708,2019,Junio,Brasil,1,8,,9,-69.94143100000001,4.214082
66709,2019,Junio,Brasil,0,1,,1,-76.876446,0.33002
66710,2019,Junio,Brasil,21,37,,58,-77.35600000000001,0.81488
66711,2019,Junio,Brasil,230,157,,387,-75.527794,10.406342
66712,2019,Junio,Brasil,509,372,,881,-75.516486,10.446304
66713,2019,Junio,Brasil,13,25,,38,-74.77647900000001,10.886686
66714,2019,Junio,Brasil,1,3,,4,-72.129595,11.360028999999999
66715,2019,Junio,Brasil,221,169,,390,-81.70216500000001,12.5862
66716,2019,Junio,Brasil,56,114,,170,-76.532004,3.451668
66717,2019,Junio,Brasil,1,6,,7,-67.927521,3.866713
66718,2019,Junio,Brasil,1,1,,2,-75.76635300000001,4.45285
66719,2019,Junio,Brasil,3501,4581,,8082,-74.140516,4.697157
66720,2019,Junio,Brasil,6,9,,15,-75.736374,4.815189
66721,2019,Junio,Brasil,148,266,,414,-75.42726,6.170465
66722,2019,Junio,Brasil,1,0,,1,-67.48402800000001,6.185536
66723,2019,Junio,Brasil,0,1,,1,-70.74025300000001,7.088728999999999
66724,2019,Junio,Brasil,0,1,,1,-73.181317,7.1280470000000005
66725,2019,Junio,Brasil,0,3,,3,-72.453013,7.819
66726,2019,Junio,Brasil,0,12,,12,-72.508188,7.927233
66727,2019,Junio,Brasil,0,2,,2,-72.409396,8.36068
66728,2019,Junio,Brasil,1,1,,2,-77.35002,8.63337
66729,2019,Junio,Brunei Darussalam,1,1,,2,-74.140516,4.697157
66730,2019,Junio,Bulgaria,1,2,,3,-77.35600000000001,0.81488
66731,2019,Junio,Bulgaria,1,2,,3,-75.516486,10.446304
66732,2019,Junio,Bulgaria,1,3,,4,-76.532004,3.451668
66733,2019,Junio,Bulgaria,27,15,,42,-74.140516,4.697157
66734,2019,Junio,Bulgaria,0,1,,1,-75.736374,4.815189
66735,2019,Junio,Bulgaria,4,12,,16,-75.42726,6.170465
66736,2019,Junio,Bulgaria,0,1,,1,-77.35002,8.63337
66737,2019,Junio,Burkina Faso,0,1,,1,-74.140516,4.697157
66738,2019,Junio,Cabo Verde,0,1,,1,-75.42726,6.170465
66739,2019,Junio,Islas Caimán/Territorio Británico de Ultramar,1,1,,2,-75.516486,10.446304
66740,2019,Junio,Islas Caimán/Territorio Británico de Ultramar,1,0,,1,-81.70216500000001,12.5862
66741,2019,Junio,Islas Caimán/Territorio Británico de Ultramar,0,3,,3,-74.140516,4.697157
66742,2019,Junio,Islas Caimán/Territorio Británico de Ultramar,0,1,,1,-75.42726,6.170465
66743,2019,Junio,Camboya,1,1,,2,-74.140516,4.697157
66744,2019,Junio,Camerún,0,1,,1,-75.527794,10.406342
66745,2019,Junio,Camerún,0,1,,1,-74.140516,4.697157
66746,2019,Junio,Canadá,1,1,,2,-69.941498,4.191162
66747,2019,Junio,Canadá,1,2,,3,-69.94143100000001,4.214082
66748,2019,Junio,Canadá,13,13,,26,-77.35600000000001,0.81488
66749,2019,Junio,Canadá,1,2,,3,-75.527794,10.406342
66750,2019,Junio,Canadá,142,191,,333,-75.516486,10.446304
66751,2019,Junio,Canadá,37,54,,91,-74.77647900000001,10.886686
66752,2019,Junio,Canadá,1,1,,2,-74.213989,11.247722999999999
66753,2019,Junio,Canadá,0,1,,1,-72.129595,11.360028999999999
66754,2019,Junio,Canadá,1,1,,2,-81.70216500000001,12.5862
66755,2019,Junio,Canadá,50,88,,138,-76.532004,3.451668
66756,2019,Junio,Canadá,4,2,,6,-75.76635300000001,4.45285
66757,2019,Junio,Canadá,1192,1967,,3159,-74.140516,4.697157
66758,2019,Junio,Canadá,9,8,,17,-75.736374,4.815189
66759,2019,Junio,Canadá,236,491,,727,-75.42726,6.170465
66760,2019,Junio,Canadá,1,4,,5,-73.181317,7.1280470000000005
66761,2019,Junio,Canadá,3,3,,6,-72.453013,7.819
66762,2019,Junio,Canadá,3,3,,6,-77.35002,8.63337
66763,2019,Junio,Comoras,0,1,,1,-75.42726,6.170465
66764,2019,Junio,República Democrática del Congo,0,1,,1,-75.527794,10.406342
66765,2019,Junio,República Democrática del Congo,2,2,,4,-74.140516,4.697157
66766,2019,Junio,República Democrática del Congo,1,0,,1,-75.42726,6.170465
66767,2019,Junio,República de Corea,19,13,,32,-77.35600000000001,0.81488
66768,2019,Junio,República de Corea,1,0,,1,-75.527794,10.406342
66769,2019,Junio,República de Corea,19,11,,30,-75.516486,10.446304
66770,2019,Junio,República de Corea,0,5,,5,-74.77647900000001,10.886686
66771,2019,Junio,República de Corea,1,4,,5,-76.532004,3.451668
66772,2019,Junio,República de Corea,171,374,,545,-74.140516,4.697157
66773,2019,Junio,República de Corea,16,45,,61,-75.42726,6.170465
66774,2019,Junio,Costa de Marfil,1,0,,1,-75.527794,10.406342
66775,2019,Junio,Costa de Marfil,0,1,,1,-74.140516,4.697157
66776,2019,Junio,Costa Rica,2,0,,2,-76.876446,0.33002
66777,2019,Junio,Costa Rica,1,2,,3,-77.35600000000001,0.81488
66778,2019,Junio,Costa Rica,0,3,,3,-78.802679,18.00143
66779,2019,Junio,Costa Rica,1,2,,3,-75.527794,10.406342
66780,2019,Junio,Costa Rica,161,122,,283,-75.516486,10.446304
66781,2019,Junio,Costa Rica,15,32,,47,-74.77647900000001,10.886686
66782,2019,Junio,Costa Rica,0,2,,2,-74.232675,11.117206
66783,2019,Junio,Costa Rica,2,0,,2,-72.129595,11.360028999999999
66784,2019,Junio,Costa Rica,0,1,,1,-81.703935,12.574411099999999
66785,2019,Junio,Costa Rica,107,85,,192,-81.70216500000001,12.5862
66786,2019,Junio,Costa Rica,27,42,,69,-76.532004,3.451668
66787,2019,Junio,Costa Rica,1,1,,2,-75.76635300000001,4.45285
66788,2019,Junio,Costa Rica,1272,1451,,2723,-74.140516,4.697157
66789,2019,Junio,Costa Rica,5,9,,14,-75.736374,4.815189
66790,2019,Junio,Costa Rica,98,147,,245,-75.42726,6.170465
66791,2019,Junio,Costa Rica,0,3,,3,-72.453013,7.819
66792,2019,Junio,Costa Rica,0,1,,1,-77.35002,8.63337
66793,2019,Junio,Croacia,1,0,,1,-77.35600000000001,0.81488
66794,2019,Junio,Croacia,0,1,,1,-75.527794,10.406342
66795,2019,Junio,Croacia,0,2,,2,-75.516486,10.446304
66796,2019,Junio,Croacia,0,1,,1,-76.532004,3.451668
66797,2019,Junio,Croacia,0,1,,1,-77.061029,3.8844260000000004
66798,2019,Junio,Croacia,11,34,,45,-74.140516,4.697157
66799,2019,Junio,Croacia,1,0,,1,-75.736374,4.815189
66800,2019,Junio,Croacia,6,8,,14,-75.42726,6.170465
66801,2019,Junio,Cuba,1,2,,3,-69.941498,4.191162
66802,2019,Junio,Cuba,0,1,,1,-75.527794,10.406342
66803,2019,Junio,Cuba,14,15,,29,-75.516486,10.446304
66804,2019,Junio,Cuba,8,18,,26,-74.77647900000001,10.886686
66805,2019,Junio,Cuba,17,17,,34,-76.532004,3.451668
66806,2019,Junio,Cuba,0,2,,2,-75.76635300000001,4.45285
66807,2019,Junio,Cuba,198,319,,517,-74.140516,4.697157
66808,2019,Junio,Cuba,1,1,,2,-75.736374,4.815189
66809,2019,Junio,Cuba,20,24,,44,-75.42726,6.170465
66810,2019,Junio,Cuba,0,1,,1,-70.74025300000001,7.088728999999999
66811,2019,Junio,Cuba,2,2,,4,-73.181317,7.1280470000000005
66812,2019,Junio,Cuba,0,1,,1,-72.453013,7.819
66813,2019,Junio,República Checa,1,2,,3,-69.94143100000001,4.214082
66814,2019,Junio,República Checa,3,5,,8,-77.35600000000001,0.81488
66815,2019,Junio,República Checa,7,6,,13,-75.516486,10.446304
66816,2019,Junio,República Checa,0,1,,1,-74.77647900000001,10.886686
66817,2019,Junio,República Checa,0,1,,1,-72.129595,11.360028999999999
66818,2019,Junio,República Checa,0,14,,14,-76.532004,3.451668
66819,2019,Junio,República Checa,44,90,,134,-74.140516,4.697157
66820,2019,Junio,República Checa,4,7,,11,-75.42726,6.170465
66821,2019,Junio,Chile,0,1,,1,-69.941498,4.191162
66822,2019,Junio,Chile,3,3,,6,-69.94143100000001,4.214082
66823,2019,Junio,Chile,0,5,,5,-76.876446,0.33002
66824,2019,Junio,Chile,23,56,,79,-77.35600000000001,0.81488
66825,2019,Junio,Chile,100,72,,172,-75.527794,10.406342
66826,2019,Junio,Chile,315,254,,569,-75.516486,10.446304
66827,2019,Junio,Chile,7,22,,29,-74.77647900000001,10.886686
66828,2019,Junio,Chile,1,6,,7,-72.129595,11.360028999999999
66829,2019,Junio,Chile,84,60,,144,-81.70216500000001,12.5862
66830,2019,Junio,Chile,0,2,,2,-81.372937,13.338761300000002
66831,2019,Junio,Chile,89,134,,223,-76.532004,3.451668
66832,2019,Junio,Chile,3339,4685,,8024,-74.140516,4.697157
66833,2019,Junio,Chile,2,4,,6,-75.736374,4.815189
66834,2019,Junio,Chile,76,175,,251,-75.42726,6.170465
66835,2019,Junio,Chile,0,1,,1,-73.181317,7.1280470000000005
66836,2019,Junio,Chile,6,17,,23,-72.453013,7.819
66837,2019,Junio,Chile,0,1,,1,-72.409396,8.36068
66838,2019,Junio,China,2,0,,2,-69.941498,4.191162
66839,2019,Junio,China,1,0,,1,-69.94143100000001,4.214082
66840,2019,Junio,China,3,12,,15,-77.35600000000001,0.81488
66841,2019,Junio,China,10,26,,36,-75.516486,10.446304
66842,2019,Junio,China,9,22,,31,-74.77647900000001,10.886686
66843,2019,Junio,China,0,2,,2,-74.765343,10.970933
66844,2019,Junio,China,1,0,,1,-81.703935,12.574411099999999
66845,2019,Junio,China,1,0,,1,-81.70216500000001,12.5862
66846,2019,Junio,China,8,25,,33,-76.532004,3.451668
66847,2019,Junio,China,0,1,,1,-77.061029,3.8844260000000004
66848,2019,Junio,China,0,2,,2,-75.76635300000001,4.45285
66849,2019,Junio,China,494,992,,1486,-74.140516,4.697157
66850,2019,Junio,China,1,1,,2,-75.736374,4.815189
66851,2019,Junio,China,43,67,,110,-75.42726,6.170465
66852,2019,Junio,China,4,3,,7,-73.181317,7.1280470000000005
66853,2019,Junio,China,3,4,,7,-72.453013,7.819
66854,2019,Junio,China,0,1,,1,-72.508188,7.927233
66855,2019,Junio,China,1,1,,2,-72.409396,8.36068
66856,2019,Junio,Taiwán,2,1,,3,-77.35600000000001,0.81488
66857,2019,Junio,Taiwán,4,3,,7,-75.516486,10.446304
66858,2019,Junio,Taiwán,0,2,,2,-74.77647900000001,10.886686
66859,2019,Junio,Taiwán,1,3,,4,-76.532004,3.451668
66860,2019,Junio,Taiwán,70,83,,153,-74.140516,4.697157
66861,2019,Junio,Taiwán,2,8,,10,-75.42726,6.170465
66862,2019,Junio,Taiwán,2,1,,3,-72.453013,7.819
66863,2019,Junio,Taiwán,1,0,,1,-77.35002,8.63337
66864,2019,Junio,Chipre,0,1,,1,-74.77647900000001,10.886686
66865,2019,Junio,Chipre,0,1,,1,-76.532004,3.451668
66866,2019,Junio,Chipre,6,9,,15,-74.140516,4.697157
66867,2019,Junio,Chipre,0,3,,3,-75.42726,6.170465
66868,2019,Junio,Dinamarca,0,1,,1,-76.876446,0.33002
66869,2019,Junio,Dinamarca,5,8,,13,-77.35600000000001,0.81488
66870,2019,Junio,Dinamarca,1,2,,3,-75.527794,10.406342
66871,2019,Junio,Dinamarca,10,20,,30,-75.516486,10.446304
66872,2019,Junio,Dinamarca,0,2,,2,-74.77647900000001,10.886686
66873,2019,Junio,Dinamarca,4,6,,10,-76.532004,3.451668
66874,2019,Junio,Dinamarca,106,142,,248,-74.140516,4.697157
66875,2019,Junio,Dinamarca,3,5,,8,-75.736374,4.815189
66876,2019,Junio,Dinamarca,8,20,,28,-75.42726,6.170465
66877,2019,Junio,Dinamarca,2,0,,2,-77.35002,8.63337
66878,2019,Junio,Dominica,1,0,,1,-75.516486,10.446304
66879,2019,Junio,Dominica,1,0,,1,-74.77647900000001,10.886686
66880,2019,Junio,Dominica,2,2,,4,-76.532004,3.451668
66881,2019,Junio,Dominica,4,2,,6,-74.140516,4.697157
66882,2019,Junio,Dominica,2,0,,2,-75.42726,6.170465
66883,2019,Junio,Ecuador,0,4,,4,-69.941498,4.191162
66884,2019,Junio,Ecuador,0,3,,3,-69.94143100000001,4.214082
66885,2019,Junio,Ecuador,1,2,,3,-74.78366,0.18595699999999998
66886,2019,Junio,Ecuador,61,218,,279,-76.876446,0.33002
66887,2019,Junio,Ecuador,6,7,,13,-77.84700600000001,0.8124359999999999
66888,2019,Junio,Ecuador,1266,2029,,3295,-77.35600000000001,0.81488
66889,2019,Junio,Ecuador,16,54,,70,-78.802679,18.00143
66890,2019,Junio,Ecuador,15,43,,58,-75.527794,10.406342
66891,2019,Junio,Ecuador,64,56,,120,-75.516486,10.446304
66892,2019,Junio,Ecuador,3,4,,7,-74.77647900000001,10.886686
66893,2019,Junio,Ecuador,0,1,,1,-74.232675,11.117206
66894,2019,Junio,Ecuador,6,8,,14,-72.129595,11.360028999999999
66895,2019,Junio,Ecuador,11,8,,19,-81.70216500000001,12.5862
66896,2019,Junio,Ecuador,245,355,,600,-76.532004,3.451668
66897,2019,Junio,Ecuador,0,4,,4,-75.76635300000001,4.45285
66898,2019,Junio,Ecuador,2344,3191,,5535,-74.140516,4.697157
66899,2019,Junio,Ecuador,1,3,,4,-75.736374,4.815189
66900,2019,Junio,Ecuador,53,76,,129,-75.42726,6.170465
66901,2019,Junio,Ecuador,2,0,,2,-70.74025300000001,7.088728999999999
66902,2019,Junio,Ecuador,1,0,,1,-73.181317,7.1280470000000005
66903,2019,Junio,Ecuador,40,60,,100,-72.453013,7.819
66904,2019,Junio,Ecuador,1,4,,5,-72.409396,8.36068
66905,2019,Junio,Egipto,0,1,,1,-75.527794,10.406342
66906,2019,Junio,Egipto,0,1,,1,-75.516486,10.446304
66907,2019,Junio,Egipto,0,1,,1,-75.76635300000001,4.45285
66908,2019,Junio,Egipto,10,26,,36,-74.140516,4.697157
66909,2019,Junio,Egipto,5,7,,12,-75.42726,6.170465
66910,2019,Junio,El Salvador,3,2,,5,-77.35600000000001,0.81488
66911,2019,Junio,El Salvador,0,4,,4,-75.527794,10.406342
66912,2019,Junio,El Salvador,26,37,,63,-75.516486,10.446304
66913,2019,Junio,El Salvador,2,7,,9,-74.77647900000001,10.886686
66914,2019,Junio,El Salvador,0,1,,1,-72.129595,11.360028999999999
66915,2019,Junio,El Salvador,7,3,,10,-81.70216500000001,12.5862
66916,2019,Junio,El Salvador,2,9,,11,-76.532004,3.451668
66917,2019,Junio,El Salvador,476,614,,1090,-74.140516,4.697157
66918,2019,Junio,El Salvador,1,1,,2,-75.736374,4.815189
66919,2019,Junio,El Salvador,102,95,,197,-75.42726,6.170465
66920,2019,Junio,El Salvador,0,1,,1,-73.181317,7.1280470000000005
66921,2019,Junio,El Salvador,1,1,,2,-72.453013,7.819
66922,2019,Junio,Emiratos Árabes,1,1,,2,-75.516486,10.446304
66923,2019,Junio,Emiratos Árabes,0,2,,2,-76.532004,3.451668
66924,2019,Junio,Emiratos Árabes,4,11,,15,-74.140516,4.697157
66925,2019,Junio,Emiratos Árabes,0,1,,1,-75.42726,6.170465
66926,2019,Junio,España,4,1,,5,-69.941498,4.191162
66927,2019,Junio,España,8,9,,17,-69.94143100000001,4.214082
66928,2019,Junio,España,2,0,,2,-76.876446,0.33002
66929,2019,Junio,España,39,49,,88,-77.35600000000001,0.81488
66930,2019,Junio,España,0,1,,1,-78.802679,18.00143
66931,2019,Junio,España,12,13,,25,-75.527794,10.406342
66932,2019,Junio,España,107,164,,271,-75.516486,10.446304
66933,2019,Junio,España,7,45,,52,-74.77647900000001,10.886686
66934,2019,Junio,España,2,2,,4,-74.765343,10.970933
66935,2019,Junio,España,0,2,,2,-74.232675,11.117206
66936,2019,Junio,España,1,6,,7,-74.213989,11.247722999999999
66937,2019,Junio,España,6,17,,23,-72.129595,11.360028999999999
66938,2019,Junio,España,2,2,,4,-81.703935,12.574411099999999
66939,2019,Junio,España,6,8,,14,-81.70216500000001,12.5862
66940,2019,Junio,España,308,439,,747,-76.532004,3.451668
66941,2019,Junio,España,1,0,,1,-75.76635300000001,4.45285
66942,2019,Junio,España,2677,5168,,7845,-74.140516,4.697157
66943,2019,Junio,España,5,9,,14,-75.736374,4.815189
66944,2019,Junio,España,553,947,,1500,-75.42726,6.170465
66945,2019,Junio,España,0,1,,1,-67.48402800000001,6.185536
66946,2019,Junio,España,1,2,,3,-70.74025300000001,7.088728999999999
66947,2019,Junio,España,2,1,,3,-73.181317,7.1280470000000005
66948,2019,Junio,España,24,49,,73,-72.453013,7.819
66949,2019,Junio,España,5,5,,10,-72.409396,8.36068
66950,2019,Junio,España,0,2,,2,-77.35002,8.63337
66951,2019,Junio,Eslovaquia,0,2,,2,-77.35600000000001,0.81488
66952,2019,Junio,Eslovaquia,5,5,,10,-75.516486,10.446304
66953,2019,Junio,Eslovaquia,1,0,,1,-76.532004,3.451668
66954,2019,Junio,Eslovaquia,30,19,,49,-74.140516,4.697157
66955,2019,Junio,Eslovaquia,3,2,,5,-75.42726,6.170465
66956,2019,Junio,Eslovenia,0,1,,1,-69.94143100000001,4.214082
66957,2019,Junio,Eslovenia,0,1,,1,-77.35600000000001,0.81488
66958,2019,Junio,Eslovenia,1,0,,1,-75.516486,10.446304
66959,2019,Junio,Eslovenia,1,0,,1,-74.77647900000001,10.886686
66960,2019,Junio,Eslovenia,10,13,,23,-74.140516,4.697157
66961,2019,Junio,Eslovenia,4,6,,10,-75.42726,6.170465
66962,2019,Junio,Estados Unidos de América,18,31,,49,-69.941498,4.191162
66963,2019,Junio,Estados Unidos de América,14,20,,34,-69.94143100000001,4.214082
66964,2019,Junio,Estados Unidos de América,1,5,,6,-76.876446,0.33002
66965,2019,Junio,Estados Unidos de América,39,66,,105,-77.35600000000001,0.81488
66966,2019,Junio,Estados Unidos de América,31,78,,109,-75.527794,10.406342
66967,2019,Junio,Estados Unidos de América,5622,7095,,12717,-75.516486,10.446304
66968,2019,Junio,Estados Unidos de América,1041,1459,,2500,-74.77647900000001,10.886686
66969,2019,Junio,Estados Unidos de América,7,9,,16,-74.232675,11.117206
66970,2019,Junio,Estados Unidos de América,1,6,,7,-74.213989,11.247722999999999
66971,2019,Junio,Estados Unidos de América,9,16,,25,-72.129595,11.360028999999999
66972,2019,Junio,Estados Unidos de América,4,6,,10,-72.919186,11.52863
66973,2019,Junio,Estados Unidos de América,1,4,,5,-81.703935,12.574411099999999
66974,2019,Junio,Estados Unidos de América,75,72,,147,-81.70216500000001,12.5862
66975,2019,Junio,Estados Unidos de América,2,3,,5,-81.372937,13.338761300000002
66976,2019,Junio,Estados Unidos de América,2445,2933,,5378,-76.532004,3.451668
66977,2019,Junio,Estados Unidos de América,287,358,,645,-75.76635300000001,4.45285
66978,2019,Junio,Estados Unidos de América,13761,19588,,33349,-74.140516,4.697157
66979,2019,Junio,Estados Unidos de América,440,511,,951,-75.736374,4.815189
66980,2019,Junio,Estados Unidos de América,5069,9166,,14235,-75.42726,6.170465
66981,2019,Junio,Estados Unidos de América,1,1,,2,-67.48402800000001,6.185536
66982,2019,Junio,Estados Unidos de América,0,2,,2,-75.586989,6.2188349999999994
66983,2019,Junio,Estados Unidos de América,1,0,,1,-70.74025300000001,7.088728999999999
66984,2019,Junio,Estados Unidos de América,77,83,,160,-73.181317,7.1280470000000005
66985,2019,Junio,Estados Unidos de América,11,13,,24,-72.453013,7.819
66986,2019,Junio,Estados Unidos de América,0,1,,1,-72.409396,8.36068
66987,2019,Junio,Estados Unidos de América,5,12,,17,-77.35002,8.63337
66988,2019,Junio,Estados Unidos de América,1,0,,1,-75.68164200000001,9.402597
66989,2019,Junio,Estonia,1,0,,1,-69.94143100000001,4.214082
66990,2019,Junio,Estonia,1,1,,2,-77.35600000000001,0.81488
66991,2019,Junio,Estonia,4,9,,13,-74.140516,4.697157
66992,2019,Junio,Estonia,6,6,,12,-75.42726,6.170465
66993,2019,Junio,Etiopia,2,53,,55,-74.140516,4.697157
66994,2019,Junio,Islas Fiji,1,0,,1,-75.516486,10.446304
66995,2019,Junio,Islas Fiji,0,1,,1,-74.140516,4.697157
66996,2019,Junio,Filipinas,3,2,,5,-77.35600000000001,0.81488
66997,2019,Junio,Filipinas,2,40,,42,-75.527794,10.406342
66998,2019,Junio,Filipinas,7,50,,57,-75.516486,10.446304
66999,2019,Junio,Filipinas,1,19,,20,-74.77647900000001,10.886686
67000,2019,Junio,Filipinas,0,27,,27,-74.765343,10.970933
67001,2019,Junio,Filipinas,0,3,,3,-74.213989,11.247722999999999
67002,2019,Junio,Filipinas,1,13,,14,-76.532004,3.451668
67003,2019,Junio,Filipinas,0,12,,12,-77.061029,3.8844260000000004
67004,2019,Junio,Filipinas,65,63,,128,-74.140516,4.697157
67005,2019,Junio,Filipinas,1,0,,1,-75.736374,4.815189
67006,2019,Junio,Filipinas,4,4,,8,-75.42726,6.170465
67007,2019,Junio,Filipinas,0,11,,11,-75.68164200000001,9.402597
67008,2019,Junio,Finlandia,4,2,,6,-77.35600000000001,0.81488
67009,2019,Junio,Finlandia,1,0,,1,-75.527794,10.406342
67010,2019,Junio,Finlandia,4,2,,6,-75.516486,10.446304
67011,2019,Junio,Finlandia,0,1,,1,-72.129595,11.360028999999999
67012,2019,Junio,Finlandia,0,1,,1,-81.70216500000001,12.5862
67013,2019,Junio,Finlandia,3,8,,11,-76.532004,3.451668
67014,2019,Junio,Finlandia,51,61,,112,-74.140516,4.697157
67015,2019,Junio,Finlandia,6,7,,13,-75.42726,6.170465
67016,2019,Junio,Francia,4,4,,8,-69.941498,4.191162
67017,2019,Junio,Francia,22,31,,53,-69.94143100000001,4.214082
67018,2019,Junio,Francia,7,4,,11,-76.876446,0.33002
67019,2019,Junio,Francia,165,180,,345,-77.35600000000001,0.81488
67020,2019,Junio,Francia,90,479,,569,-75.527794,10.406342
67021,2019,Junio,Francia,120,144,,264,-75.516486,10.446304
67022,2019,Junio,Francia,12,16,,28,-74.77647900000001,10.886686
67023,2019,Junio,Francia,0,3,,3,-74.232675,11.117206
67024,2019,Junio,Francia,0,1,,1,-74.213989,11.247722999999999
67025,2019,Junio,Francia,1,1,,2,-72.129595,11.360028999999999
67026,2019,Junio,Francia,1,1,,2,-81.70216500000001,12.5862
67027,2019,Junio,Francia,1,1,,2,-81.372937,13.338761300000002
67028,2019,Junio,Francia,47,88,,135,-76.532004,3.451668
67029,2019,Junio,Francia,1485,2308,,3793,-74.140516,4.697157
67030,2019,Junio,Francia,5,12,,17,-75.736374,4.815189
67031,2019,Junio,Francia,198,368,,566,-75.42726,6.170465
67032,2019,Junio,Francia,4,9,,13,-72.453013,7.819
67033,2019,Junio,Francia,5,6,,11,-77.35002,8.63337
67034,2019,Junio,Gambia,0,1,,1,-74.140516,4.697157
67035,2019,Junio,Georgia,0,1,,1,-75.527794,10.406342
67036,2019,Junio,Georgia,0,2,,2,-75.516486,10.446304
67037,2019,Junio,Georgia,3,2,,5,-74.140516,4.697157
67038,2019,Junio,Georgia,0,2,,2,-75.42726,6.170465
67039,2019,Junio,Georgia,0,2,,2,-75.68164200000001,9.402597
67040,2019,Junio,Ghana,0,6,,6,-75.516486,10.446304
67041,2019,Junio,Ghana,2,1,,3,-76.532004,3.451668
67042,2019,Junio,Ghana,2,7,,9,-74.140516,4.697157
67043,2019,Junio,Granada,0,1,,1,-75.516486,10.446304
67044,2019,Junio,Granada,0,1,,1,-76.532004,3.451668
67045,2019,Junio,Granada,3,5,,8,-74.140516,4.697157
67046,2019,Junio,Granada,3,1,,4,-75.42726,6.170465
67047,2019,Junio,Grecia,1,0,,1,-69.94143100000001,4.214082
67048,2019,Junio,Grecia,0,9,,9,-75.527794,10.406342
67049,2019,Junio,Grecia,2,10,,12,-75.516486,10.446304
67050,2019,Junio,Grecia,0,2,,2,-74.77647900000001,10.886686
67051,2019,Junio,Grecia,0,1,,1,-76.532004,3.451668
67052,2019,Junio,Grecia,21,71,,92,-74.140516,4.697157
67053,2019,Junio,Grecia,3,7,,10,-75.42726,6.170465
67054,2019,Junio,Grecia,0,2,,2,-75.68164200000001,9.402597
67055,2019,Junio,Guatemala,1,3,,4,-77.35600000000001,0.81488
67056,2019,Junio,Guatemala,1,1,,2,-75.527794,10.406342
67057,2019,Junio,Guatemala,125,141,,266,-75.516486,10.446304
67058,2019,Junio,Guatemala,7,8,,15,-74.77647900000001,10.886686
67059,2019,Junio,Guatemala,0,1,,1,-74.765343,10.970933
67060,2019,Junio,Guatemala,0,1,,1,-72.129595,11.360028999999999
67061,2019,Junio,Guatemala,7,7,,14,-81.70216500000001,12.5862
67062,2019,Junio,Guatemala,13,26,,39,-76.532004,3.451668
67063,2019,Junio,Guatemala,0,1,,1,-75.76635300000001,4.45285
67064,2019,Junio,Guatemala,593,862,,1455,-74.140516,4.697157
67065,2019,Junio,Guatemala,1,4,,5,-75.736374,4.815189
67066,2019,Junio,Guatemala,86,123,,209,-75.42726,6.170465
67067,2019,Junio,Guatemala,0,1,,1,-77.762647,7.102626
67068,2019,Junio,Guatemala,1,1,,2,-73.181317,7.1280470000000005
67069,2019,Junio,Guatemala,1,1,,2,-72.453013,7.819
67070,2019,Junio,Guatemala,1,0,,1,-77.35002,8.63337
67071,2019,Junio,Guyana,2,2,,4,-75.516486,10.446304
67072,2019,Junio,Guyana,1,0,,1,-74.77647900000001,10.886686
67073,2019,Junio,Guyana,1,0,,1,-81.70216500000001,12.5862
67074,2019,Junio,Guyana,0,1,,1,-76.532004,3.451668
67075,2019,Junio,Guyana,10,8,,18,-74.140516,4.697157
67076,2019,Junio,Guyana,4,2,,6,-75.42726,6.170465
67077,2019,Junio,Guyana,1,1,,2,-73.181317,7.1280470000000005
67078,2019,Junio,Guyana,1,0,,1,-72.453013,7.819
67079,2019,Junio,Guinea,0,1,,1,-75.42726,6.170465
67080,2019,Junio,Guinea Ecuatorial,0,1,,1,-74.140516,4.697157
67081,2019,Junio,Guinea Ecuatorial,1,0,,1,-75.42726,6.170465
67082,2019,Junio,Guinea Bissau,1,0,,1,-74.140516,4.697157
67083,2019,Junio,Haití,3,4,,7,-75.516486,10.446304
67084,2019,Junio,Haití,0,1,,1,-74.77647900000001,10.886686
67085,2019,Junio,Haití,1,2,,3,-76.532004,3.451668
67086,2019,Junio,Haití,0,1,,1,-75.76635300000001,4.45285
67087,2019,Junio,Haití,12,15,,27,-74.140516,4.697157
67088,2019,Junio,Haití,1,9,,10,-75.42726,6.170465
67089,2019,Junio,Honduras,3,2,,5,-77.35600000000001,0.81488
67090,2019,Junio,Honduras,1,0,,1,-75.527794,10.406342
67091,2019,Junio,Honduras,41,40,,81,-75.516486,10.446304
67092,2019,Junio,Honduras,4,6,,10,-74.77647900000001,10.886686
67093,2019,Junio,Honduras,0,50,,50,-81.703935,12.574411099999999
67094,2019,Junio,Honduras,17,25,,42,-76.532004,3.451668
67095,2019,Junio,Honduras,0,1,,1,-77.061029,3.8844260000000004
67096,2019,Junio,Honduras,230,277,,507,-74.140516,4.697157
67097,2019,Junio,Honduras,84,89,,173,-75.42726,6.170465
67098,2019,Junio,Honduras,0,2,,2,-77.762647,7.102626
67099,2019,Junio,Honduras,1,0,,1,-72.453013,7.819
67100,2019,Junio,Hong Kong,1,0,,1,-69.94143100000001,4.214082
67101,2019,Junio,Hong Kong,3,1,,4,-75.516486,10.446304
67102,2019,Junio,Hong Kong,10,12,,22,-74.140516,4.697157
67103,2019,Junio,Hong Kong,2,2,,4,-75.42726,6.170465
67104,2019,Junio,Hungría,2,2,,4,-77.35600000000001,0.81488
67105,2019,Junio,Hungría,1,1,,2,-75.516486,10.446304
67106,2019,Junio,Hungría,1,1,,2,-74.77647900000001,10.886686
67107,2019,Junio,Hungría,0,1,,1,-76.532004,3.451668
67108,2019,Junio,Hungría,31,38,,69,-74.140516,4.697157
67109,2019,Junio,Hungría,13,13,,26,-75.42726,6.170465
67110,2019,Junio,Hungría,0,1,,1,-72.453013,7.819
67111,2019,Junio,India,1,5,,6,-77.35600000000001,0.81488
67112,2019,Junio,India,0,11,,11,-75.527794,10.406342
67113,2019,Junio,India,10,65,,75,-75.516486,10.446304
67114,2019,Junio,India,4,17,,21,-74.77647900000001,10.886686
67115,2019,Junio,India,0,1,,1,-74.765343,10.970933
67116,2019,Junio,India,0,6,,6,-74.213989,11.247722999999999
67117,2019,Junio,India,0,1,,1,-72.129595,11.360028999999999
67118,2019,Junio,India,1,15,,16,-76.532004,3.451668
67119,2019,Junio,India,0,2,,2,-77.061029,3.8844260000000004
67120,2019,Junio,India,84,402,,486,-74.140516,4.697157
67121,2019,Junio,India,12,76,,88,-75.42726,6.170465
67122,2019,Junio,India,0,1,,1,-73.181317,7.1280470000000005
67123,2019,Junio,India,0,5,,5,-75.68164200000001,9.402597
67124,2019,Junio,Indonesia,2,0,,2,-77.35600000000001,0.81488
67125,2019,Junio,Indonesia,1,2,,3,-75.516486,10.446304
67126,2019,Junio,Indonesia,0,1,,1,-74.77647900000001,10.886686
67127,2019,Junio,Indonesia,0,2,,2,-76.532004,3.451668
67128,2019,Junio,Indonesia,21,29,,50,-74.140516,4.697157
67129,2019,Junio,Indonesia,4,3,,7,-75.42726,6.170465
67130,2019,Junio,Iraq,1,1,,2,-74.140516,4.697157
67131,2019,Junio,Irán,0,2,,2,-75.516486,10.446304
67132,2019,Junio,Irán,6,12,,18,-74.140516,4.697157
67133,2019,Junio,Irán,1,1,,2,-75.42726,6.170465
67134,2019,Junio,República de Irlanda,0,4,,4,-69.94143100000001,4.214082
67135,2019,Junio,República de Irlanda,9,10,,19,-77.35600000000001,0.81488
67136,2019,Junio,República de Irlanda,3,2,,5,-75.527794,10.406342
67137,2019,Junio,República de Irlanda,17,31,,48,-75.516486,10.446304
67138,2019,Junio,República de Irlanda,4,3,,7,-74.77647900000001,10.886686
67139,2019,Junio,República de Irlanda,2,0,,2,-81.70216500000001,12.5862
67140,2019,Junio,República de Irlanda,2,7,,9,-76.532004,3.451668
67141,2019,Junio,República de Irlanda,130,241,,371,-74.140516,4.697157
67142,2019,Junio,República de Irlanda,28,58,,86,-75.42726,6.170465
67143,2019,Junio,República de Irlanda,1,0,,1,-73.181317,7.1280470000000005
67144,2019,Junio,República de Irlanda,0,1,,1,-72.453013,7.819
67145,2019,Junio,República de Irlanda,8,10,,18,-77.35002,8.63337
67146,2019,Junio,Islandia,0,1,,1,-75.516486,10.446304
67147,2019,Junio,Islandia,5,7,,12,-74.140516,4.697157
67148,2019,Junio,Islandia,0,3,,3,-75.42726,6.170465
67149,2019,Junio,Islandia,2,1,,3,-73.181317,7.1280470000000005
67150,2019,Junio,Israel,2,4,,6,-69.941498,4.191162
67151,2019,Junio,Israel,0,1,,1,-69.94143100000001,4.214082
67152,2019,Junio,Israel,0,1,,1,-76.876446,0.33002
67153,2019,Junio,Israel,50,105,,155,-77.35600000000001,0.81488
67154,2019,Junio,Israel,52,49,,101,-75.527794,10.406342
67155,2019,Junio,Israel,18,52,,70,-75.516486,10.446304
67156,2019,Junio,Israel,0,6,,6,-74.77647900000001,10.886686
67157,2019,Junio,Israel,2,8,,10,-81.70216500000001,12.5862
67158,2019,Junio,Israel,13,20,,33,-76.532004,3.451668
67159,2019,Junio,Israel,192,465,,657,-74.140516,4.697157
67160,2019,Junio,Israel,102,185,,287,-75.42726,6.170465
67161,2019,Junio,Italia,1,2,,3,-69.941498,4.191162
67162,2019,Junio,Italia,4,5,,9,-69.94143100000001,4.214082
67163,2019,Junio,Italia,1,5,,6,-76.876446,0.33002
67164,2019,Junio,Italia,14,25,,39,-77.35600000000001,0.81488
67165,2019,Junio,Italia,1,10,,11,-75.527794,10.406342
67166,2019,Junio,Italia,103,164,,267,-75.516486,10.446304
67167,2019,Junio,Italia,18,43,,61,-74.77647900000001,10.886686
67168,2019,Junio,Italia,0,1,,1,-74.232675,11.117206
67169,2019,Junio,Italia,18,15,,33,-72.129595,11.360028999999999
67170,2019,Junio,Italia,8,3,,11,-81.70216500000001,12.5862
67171,2019,Junio,Italia,45,100,,145,-76.532004,3.451668
67172,2019,Junio,Italia,0,1,,1,-75.76635300000001,4.45285
67173,2019,Junio,Italia,705,1586,,2291,-74.140516,4.697157
67174,2019,Junio,Italia,1,12,,13,-75.736374,4.815189
67175,2019,Junio,Italia,130,264,,394,-75.42726,6.170465
67176,2019,Junio,Italia,1,1,,2,-73.181317,7.1280470000000005
67177,2019,Junio,Italia,16,29,,45,-72.453013,7.819
67178,2019,Junio,Italia,6,2,,8,-72.409396,8.36068
67179,2019,Junio,Italia,0,1,,1,-77.35002,8.63337
67180,2019,Junio,Jamaica,13,14,,27,-75.516486,10.446304
67181,2019,Junio,Jamaica,3,5,,8,-74.77647900000001,10.886686
67182,2019,Junio,Jamaica,0,5,,5,-81.70216500000001,12.5862
67183,2019,Junio,Jamaica,6,6,,12,-76.532004,3.451668
67184,2019,Junio,Jamaica,27,29,,56,-74.140516,4.697157
67185,2019,Junio,Jamaica,0,3,,3,-75.736374,4.815189
67186,2019,Junio,Jamaica,8,17,,25,-75.42726,6.170465
67187,2019,Junio,Jamaica,0,1,,1,-72.453013,7.819
67188,2019,Junio,Japón,2,1,,3,-69.94143100000001,4.214082
67189,2019,Junio,Japón,3,8,,11,-77.35600000000001,0.81488
67190,2019,Junio,Japón,0,1,,1,-75.527794,10.406342
67191,2019,Junio,Japón,7,16,,23,-75.516486,10.446304
67192,2019,Junio,Japón,1,2,,3,-74.77647900000001,10.886686
67193,2019,Junio,Japón,1,0,,1,-74.232675,11.117206
67194,2019,Junio,Japón,11,12,,23,-76.532004,3.451668
67195,2019,Junio,Japón,0,1,,1,-77.061029,3.8844260000000004
67196,2019,Junio,Japón,1,0,,1,-75.76635300000001,4.45285
67197,2019,Junio,Japón,111,420,,531,-74.140516,4.697157
67198,2019,Junio,Japón,29,39,,68,-75.42726,6.170465
67199,2019,Junio,Japón,0,1,,1,-72.453013,7.819
67200,2019,Junio,Japón,0,1,,1,-77.35002,8.63337
67201,2019,Junio,Jordania,0,1,,1,-75.516486,10.446304
67202,2019,Junio,Jordania,3,6,,9,-74.140516,4.697157
67203,2019,Junio,Jordania,1,0,,1,-75.42726,6.170465
67204,2019,Junio,Kazajistán,4,4,,8,-74.140516,4.697157
67205,2019,Junio,Kazajistán,1,1,,2,-75.42726,6.170465
67206,2019,Junio,Kenia,1,3,,4,-75.516486,10.446304
67207,2019,Junio,Kenia,1,0,,1,-76.532004,3.451668
67208,2019,Junio,Kenia,6,12,,18,-74.140516,4.697157
67209,2019,Junio,Kenia,2,1,,3,-75.42726,6.170465
67210,2019,Junio,Kiribati,0,1,,1,-77.061029,3.8844260000000004
67211,2019,Junio,Kirguistán,1,0,,1,-75.516486,10.446304
67212,2019,Junio,Kuwait,0,6,,6,-75.516486,10.446304
67213,2019,Junio,Kuwait,0,1,,1,-74.77647900000001,10.886686
67214,2019,Junio,Kuwait,0,6,,6,-74.140516,4.697157
67215,2019,Junio,Kuwait,0,1,,1,-75.42726,6.170465
67216,2019,Junio,República de Kosovo,0,2,,2,-74.140516,4.697157
67217,2019,Junio,República de Kosovo,0,1,,1,-75.42726,6.170465
67218,2019,Junio,República Democrática Popular  Lao,0,1,,1,-75.516486,10.446304
67219,2019,Junio,Letonia,0,5,,5,-75.527794,10.406342
67220,2019,Junio,Letonia,1,2,,3,-75.516486,10.446304
67221,2019,Junio,Letonia,0,1,,1,-74.77647900000001,10.886686
67222,2019,Junio,Letonia,0,2,,2,-74.765343,10.970933
67223,2019,Junio,Letonia,1,0,,1,-76.532004,3.451668
67224,2019,Junio,Letonia,0,1,,1,-77.061029,3.8844260000000004
67225,2019,Junio,Letonia,7,11,,18,-74.140516,4.697157
67226,2019,Junio,Letonia,1,1,,2,-75.42726,6.170465
67227,2019,Junio,Letonia,0,1,,1,-72.409396,8.36068
67228,2019,Junio,Lituania,4,0,,4,-77.35600000000001,0.81488
67229,2019,Junio,Lituania,5,4,,9,-75.516486,10.446304
67230,2019,Junio,Lituania,1,2,,3,-76.532004,3.451668
67231,2019,Junio,Lituania,27,18,,45,-74.140516,4.697157
67232,2019,Junio,Lituania,5,9,,14,-75.42726,6.170465
67233,2019,Junio,Lituania,1,0,,1,-77.35002,8.63337
67234,2019,Junio,Líbano,0,2,,2,-75.527794,10.406342
67235,2019,Junio,Líbano,0,1,,1,-75.516486,10.446304
67236,2019,Junio,Líbano,5,1,,6,-74.77647900000001,10.886686
67237,2019,Junio,Líbano,0,1,,1,-72.129595,11.360028999999999
67238,2019,Junio,Líbano,1,2,,3,-76.532004,3.451668
67239,2019,Junio,Líbano,13,31,,44,-74.140516,4.697157
67240,2019,Junio,Líbano,0,1,,1,-75.736374,4.815189
67241,2019,Junio,Líbano,0,4,,4,-75.42726,6.170465
67242,2019,Junio,Líbano,1,1,,2,-73.181317,7.1280470000000005
67243,2019,Junio,Liberia,0,1,,1,-74.140516,4.697157
67244,2019,Junio,Liberia,0,1,,1,-75.42726,6.170465
67245,2019,Junio,Liechtenstein,1,0,,1,-75.516486,10.446304
67246,2019,Junio,Liechtenstein,2,1,,3,-74.140516,4.697157
67247,2019,Junio,Liechtenstein,0,1,,1,-75.42726,6.170465
67248,2019,Junio,Luxemburgo,2,1,,3,-75.516486,10.446304
67249,2019,Junio,Luxemburgo,0,1,,1,-74.77647900000001,10.886686
67250,2019,Junio,Luxemburgo,8,11,,19,-74.140516,4.697157
67251,2019,Junio,Luxemburgo,2,1,,3,-75.42726,6.170465
67252,2019,Junio,Macedonia,0,3,,3,-74.140516,4.697157
67253,2019,Junio,Madagascar,1,1,,2,-74.140516,4.697157
67254,2019,Junio,Madagascar,3,0,,3,-75.42726,6.170465
67255,2019,Junio,Malasia,1,0,,1,-77.35600000000001,0.81488
67256,2019,Junio,Malasia,2,5,,7,-75.516486,10.446304
67257,2019,Junio,Malasia,0,1,,1,-76.532004,3.451668
67258,2019,Junio,Malasia,8,13,,21,-74.140516,4.697157
67259,2019,Junio,Malasia,1,2,,3,-75.42726,6.170465
67260,2019,Junio,Malasia,0,1,,1,-75.68164200000001,9.402597
67261,2019,Junio,Malawi,0,1,,1,-74.140516,4.697157
67262,2019,Junio,Malta,3,8,,11,-74.140516,4.697157
67263,2019,Junio,Malta,0,3,,3,-75.42726,6.170465
67264,2019,Junio,Marruecos,0,2,,2,-75.527794,10.406342
67265,2019,Junio,Marruecos,0,2,,2,-75.516486,10.446304
67266,2019,Junio,Marruecos,2,1,,3,-76.532004,3.451668
67267,2019,Junio,Marruecos,6,22,,28,-74.140516,4.697157
67268,2019,Junio,Marruecos,2,1,,3,-75.42726,6.170465
67269,2019,Junio,Mauricio,0,5,,5,-74.140516,4.697157
67270,2019,Junio,Mauricio,2,1,,3,-75.42726,6.170465
67271,2019,Junio,Mauritania,0,1,,1,-74.140516,4.697157
67272,2019,Junio,México,1,1,,2,-69.941498,4.191162
67273,2019,Junio,México,2,3,,5,-69.94143100000001,4.214082
67274,2019,Junio,México,1,2,,3,-76.876446,0.33002
67275,2019,Junio,México,35,43,,78,-77.35600000000001,0.81488
67276,2019,Junio,México,0,1,,1,-78.802679,18.00143
67277,2019,Junio,México,17,27,,44,-75.527794,10.406342
67278,2019,Junio,México,220,402,,622,-75.516486,10.446304
67279,2019,Junio,México,31,81,,112,-74.77647900000001,10.886686
67280,2019,Junio,México,1,5,,6,-72.129595,11.360028999999999
67281,2019,Junio,México,4,3,,7,-81.70216500000001,12.5862
67282,2019,Junio,México,63,161,,224,-76.532004,3.451668
67283,2019,Junio,México,4,0,,4,-75.76635300000001,4.45285
67284,2019,Junio,México,4840,7349,,12189,-74.140516,4.697157
67285,2019,Junio,México,13,17,,30,-75.736374,4.815189
67286,2019,Junio,México,1139,1971,,3110,-75.42726,6.170465
67287,2019,Junio,México,6,14,,20,-73.181317,7.1280470000000005
67288,2019,Junio,México,0,16,,16,-72.453013,7.819
67289,2019,Junio,México,0,3,,3,-72.409396,8.36068
67290,2019,Junio,México,0,1,,1,-77.35002,8.63337
67291,2019,Junio,República de Moldavia,6,1,,7,-74.140516,4.697157
67292,2019,Junio,Mónaco,0,2,,2,-75.516486,10.446304
67293,2019,Junio,Mongolia,0,2,,2,-75.516486,10.446304
67294,2019,Junio,Mongolia,1,4,,5,-74.140516,4.697157
67295,2019,Junio,Montenegro,1,3,,4,-74.140516,4.697157
67296,2019,Junio,Mozambique,1,0,,1,-74.77647900000001,10.886686
67297,2019,Junio,Myanmar,2,1,,3,-74.140516,4.697157
67298,2019,Junio,Namibia,0,1,,1,-76.532004,3.451668
67299,2019,Junio,Nepal,1,2,,3,-74.140516,4.697157
67300,2019,Junio,Nicaragua,1,0,,1,-69.941498,4.191162
67301,2019,Junio,Nicaragua,0,1,,1,-78.802679,18.00143
67302,2019,Junio,Nicaragua,22,33,,55,-75.516486,10.446304
67303,2019,Junio,Nicaragua,0,8,,8,-74.77647900000001,10.886686
67304,2019,Junio,Nicaragua,0,1,,1,-72.129595,11.360028999999999
67305,2019,Junio,Nicaragua,7,4,,11,-81.703935,12.574411099999999
67306,2019,Junio,Nicaragua,8,4,,12,-81.70216500000001,12.5862
67307,2019,Junio,Nicaragua,13,16,,29,-76.532004,3.451668
67308,2019,Junio,Nicaragua,94,103,,197,-74.140516,4.697157
67309,2019,Junio,Nicaragua,1,3,,4,-75.736374,4.815189
67310,2019,Junio,Nicaragua,39,36,,75,-75.42726,6.170465
67311,2019,Junio,Nicaragua,2,1,,3,-73.181317,7.1280470000000005
67312,2019,Junio,Nigeria,0,6,,6,-75.516486,10.446304
67313,2019,Junio,Nigeria,0,1,,1,-74.77647900000001,10.886686
67314,2019,Junio,Nigeria,1,0,,1,-76.532004,3.451668
67315,2019,Junio,Nigeria,1,9,,10,-74.140516,4.697157
67316,2019,Junio,Nigeria,0,2,,2,-75.42726,6.170465
67317,2019,Junio,Noruega,1,0,,1,-69.94143100000001,4.214082
67318,2019,Junio,Noruega,4,2,,6,-77.35600000000001,0.81488
67319,2019,Junio,Noruega,1,0,,1,-75.527794,10.406342
67320,2019,Junio,Noruega,16,28,,44,-75.516486,10.446304
67321,2019,Junio,Noruega,1,9,,10,-74.77647900000001,10.886686
67322,2019,Junio,Noruega,1,1,,2,-74.765343,10.970933
67323,2019,Junio,Noruega,0,1,,1,-72.129595,11.360028999999999
67324,2019,Junio,Noruega,11,20,,31,-76.532004,3.451668
67325,2019,Junio,Noruega,191,219,,410,-74.140516,4.697157
67326,2019,Junio,Noruega,4,2,,6,-75.736374,4.815189
67327,2019,Junio,Noruega,21,29,,50,-75.42726,6.170465
67328,2019,Junio,Noruega,0,1,,1,-73.181317,7.1280470000000005
67329,2019,Junio,Nueva Zelanda,1,2,,3,-69.94143100000001,4.214082
67330,2019,Junio,Nueva Zelanda,10,15,,25,-77.35600000000001,0.81488
67331,2019,Junio,Nueva Zelanda,5,8,,13,-75.527794,10.406342
67332,2019,Junio,Nueva Zelanda,13,13,,26,-75.516486,10.446304
67333,2019,Junio,Nueva Zelanda,2,5,,7,-74.77647900000001,10.886686
67334,2019,Junio,Nueva Zelanda,0,1,,1,-72.129595,11.360028999999999
67335,2019,Junio,Nueva Zelanda,0,4,,4,-76.532004,3.451668
67336,2019,Junio,Nueva Zelanda,63,115,,178,-74.140516,4.697157
67337,2019,Junio,Nueva Zelanda,12,20,,32,-75.42726,6.170465
67338,2019,Junio,Nueva Zelanda,0,1,,1,-73.181317,7.1280470000000005
67339,2019,Junio,Nueva Zelanda,1,0,,1,-77.35002,8.63337
67340,2019,Junio,Países Bajos,2,0,,2,-69.941498,4.191162
67341,2019,Junio,Países Bajos,6,14,,20,-69.94143100000001,4.214082
67342,2019,Junio,Países Bajos,1,1,,2,-76.876446,0.33002
67343,2019,Junio,Países Bajos,36,38,,74,-77.35600000000001,0.81488
67344,2019,Junio,Países Bajos,26,12,,38,-75.527794,10.406342
67345,2019,Junio,Países Bajos,234,228,,462,-75.516486,10.446304
67346,2019,Junio,Países Bajos,12,35,,47,-74.77647900000001,10.886686
67347,2019,Junio,Países Bajos,0,2,,2,-74.232675,11.117206
67348,2019,Junio,Países Bajos,2,6,,8,-72.129595,11.360028999999999
67349,2019,Junio,Países Bajos,0,1,,1,-72.919186,11.52863
67350,2019,Junio,Países Bajos,0,3,,3,-81.70216500000001,12.5862
67351,2019,Junio,Países Bajos,68,70,,138,-76.532004,3.451668
67352,2019,Junio,Países Bajos,1537,2084,,3621,-74.140516,4.697157
67353,2019,Junio,Países Bajos,0,4,,4,-75.736374,4.815189
67354,2019,Junio,Países Bajos,131,218,,349,-75.42726,6.170465
67355,2019,Junio,Países Bajos,2,0,,2,-67.48402800000001,6.185536
67356,2019,Junio,Países Bajos,13,12,,25,-73.181317,7.1280470000000005
67357,2019,Junio,Países Bajos,1,5,,6,-72.453013,7.819
67358,2019,Junio,Países Bajos,1,1,,2,-72.508188,7.927233
67359,2019,Junio,Países Bajos,0,2,,2,-72.409396,8.36068
67360,2019,Junio,Países Bajos,5,4,,9,-77.35002,8.63337
67361,2019,Junio,Pakistán,0,1,,1,-75.516486,10.446304
67362,2019,Junio,Pakistán,3,13,,16,-74.140516,4.697157
67363,2019,Junio,Pakistán,0,4,,4,-75.42726,6.170465
67364,2019,Junio,Panamá,6,2,,8,-77.35600000000001,0.81488
67365,2019,Junio,Panamá,0,10,,10,-75.527794,10.406342
67366,2019,Junio,Panamá,526,438,,964,-75.516486,10.446304
67367,2019,Junio,Panamá,110,130,,240,-74.77647900000001,10.886686
67368,2019,Junio,Panamá,0,2,,2,-72.129595,11.360028999999999
67369,2019,Junio,Panamá,57,56,,113,-81.70216500000001,12.5862
67370,2019,Junio,Panamá,352,450,,802,-76.532004,3.451668
67371,2019,Junio,Panamá,1696,1902,,3598,-74.140516,4.697157
67372,2019,Junio,Panamá,31,37,,68,-75.736374,4.815189
67373,2019,Junio,Panamá,1889,1524,,3413,-75.42726,6.170465
67374,2019,Junio,Panamá,1,2,,3,-77.762647,7.102626
67375,2019,Junio,Panamá,22,19,,41,-73.181317,7.1280470000000005
67376,2019,Junio,Panamá,2,2,,4,-72.453013,7.819
67377,2019,Junio,Panamá,2,2,,4,-77.35002,8.63337
67378,2019,Junio,Paraguay,2,5,,7,-77.35600000000001,0.81488
67379,2019,Junio,Paraguay,1,1,,2,-75.527794,10.406342
67380,2019,Junio,Paraguay,45,30,,75,-75.516486,10.446304
67381,2019,Junio,Paraguay,0,2,,2,-74.77647900000001,10.886686
67382,2019,Junio,Paraguay,9,9,,18,-81.70216500000001,12.5862
67383,2019,Junio,Paraguay,8,11,,19,-76.532004,3.451668
67384,2019,Junio,Paraguay,177,186,,363,-74.140516,4.697157
67385,2019,Junio,Paraguay,33,49,,82,-75.42726,6.170465
67386,2019,Junio,Perú,9,6,,15,-69.941498,4.191162
67387,2019,Junio,Perú,47,47,,94,-69.94143100000001,4.214082
67388,2019,Junio,Perú,19,65,,84,-74.78366,0.18595699999999998
67389,2019,Junio,Perú,5,9,,14,-76.876446,0.33002
67390,2019,Junio,Perú,146,279,,425,-77.35600000000001,0.81488
67391,2019,Junio,Perú,15,26,,41,-75.527794,10.406342
67392,2019,Junio,Perú,1270,766,,2036,-75.516486,10.446304
67393,2019,Junio,Perú,4,19,,23,-74.77647900000001,10.886686
67394,2019,Junio,Perú,3,18,,21,-72.129595,11.360028999999999
67395,2019,Junio,Perú,198,140,,338,-81.70216500000001,12.5862
67396,2019,Junio,Perú,200,290,,490,-76.532004,3.451668
67397,2019,Junio,Perú,2,2,,4,-75.76635300000001,4.45285
67398,2019,Junio,Perú,2957,3819,,6776,-74.140516,4.697157
67399,2019,Junio,Perú,2,4,,6,-75.736374,4.815189
67400,2019,Junio,Perú,562,840,,1402,-75.42726,6.170465
67401,2019,Junio,Perú,0,1,,1,-70.74025300000001,7.088728999999999
67402,2019,Junio,Perú,0,1,,1,-77.762647,7.102626
67403,2019,Junio,Perú,0,2,,2,-73.181317,7.1280470000000005
67404,2019,Junio,Perú,54,70,,124,-72.453013,7.819
67405,2019,Junio,Perú,4,4,,8,-72.409396,8.36068
67406,2019,Junio,Perú,0,1,,1,-77.35002,8.63337
67407,2019,Junio,Palestina,2,0,,2,-74.140516,4.697157
67408,2019,Junio,Palestina,0,1,,1,-75.42726,6.170465
67409,2019,Junio,Polonia,1,1,,2,-69.941498,4.191162
67410,2019,Junio,Polonia,1,0,,1,-69.94143100000001,4.214082
67411,2019,Junio,Polonia,0,2,,2,-76.876446,0.33002
67412,2019,Junio,Polonia,3,8,,11,-77.35600000000001,0.81488
67413,2019,Junio,Polonia,0,7,,7,-75.527794,10.406342
67414,2019,Junio,Polonia,11,11,,22,-75.516486,10.446304
67415,2019,Junio,Polonia,2,1,,3,-74.77647900000001,10.886686
67416,2019,Junio,Polonia,0,1,,1,-74.213989,11.247722999999999
67417,2019,Junio,Polonia,1,7,,8,-76.532004,3.451668
67418,2019,Junio,Polonia,120,162,,282,-74.140516,4.697157
67419,2019,Junio,Polonia,30,30,,60,-75.42726,6.170465
67420,2019,Junio,Polonia,0,1,,1,-72.409396,8.36068
67421,2019,Junio,Polonia,1,3,,4,-77.35002,8.63337
67422,2019,Junio,Portugal,2,3,,5,-69.94143100000001,4.214082
67423,2019,Junio,Portugal,10,7,,17,-77.35600000000001,0.81488
67424,2019,Junio,Portugal,4,5,,9,-75.527794,10.406342
67425,2019,Junio,Portugal,10,27,,37,-75.516486,10.446304
67426,2019,Junio,Portugal,3,13,,16,-74.77647900000001,10.886686
67427,2019,Junio,Portugal,3,4,,7,-72.129595,11.360028999999999
67428,2019,Junio,Portugal,1,0,,1,-81.70216500000001,12.5862
67429,2019,Junio,Portugal,9,15,,24,-76.532004,3.451668
67430,2019,Junio,Portugal,234,428,,662,-74.140516,4.697157
67431,2019,Junio,Portugal,2,3,,5,-75.736374,4.815189
67432,2019,Junio,Portugal,31,57,,88,-75.42726,6.170465
67433,2019,Junio,Portugal,0,1,,1,-67.48402800000001,6.185536
67434,2019,Junio,Portugal,8,10,,18,-72.453013,7.819
67435,2019,Junio,Portugal,0,1,,1,-72.409396,8.36068
67436,2019,Junio,Portugal,0,2,,2,-77.35002,8.63337
67437,2019,Junio,Qatar,0,2,,2,-75.516486,10.446304
67438,2019,Junio,Qatar,1,2,,3,-74.140516,4.697157
67439,2019,Junio,Reino Unido de Gran Bretaña e Irlanda del Norte,3,6,,9,-69.941498,4.191162
67440,2019,Junio,Reino Unido de Gran Bretaña e Irlanda del Norte,6,9,,15,-69.94143100000001,4.214082
67441,2019,Junio,Reino Unido de Gran Bretaña e Irlanda del Norte,5,5,,10,-76.876446,0.33002
67442,2019,Junio,Reino Unido de Gran Bretaña e Irlanda del Norte,108,120,,228,-77.35600000000001,0.81488
67443,2019,Junio,Reino Unido de Gran Bretaña e Irlanda del Norte,10,9,,19,-75.527794,10.406342
67444,2019,Junio,Reino Unido de Gran Bretaña e Irlanda del Norte,115,167,,282,-75.516486,10.446304
67445,2019,Junio,Reino Unido de Gran Bretaña e Irlanda del Norte,12,13,,25,-74.77647900000001,10.886686
67446,2019,Junio,Reino Unido de Gran Bretaña e Irlanda del Norte,0,6,,6,-81.70216500000001,12.5862
67447,2019,Junio,Reino Unido de Gran Bretaña e Irlanda del Norte,35,55,,90,-76.532004,3.451668
67448,2019,Junio,Reino Unido de Gran Bretaña e Irlanda del Norte,1,1,,2,-75.76635300000001,4.45285
67449,2019,Junio,Reino Unido de Gran Bretaña e Irlanda del Norte,997,1894,,2891,-74.140516,4.697157
67450,2019,Junio,Reino Unido de Gran Bretaña e Irlanda del Norte,0,10,,10,-75.736374,4.815189
67451,2019,Junio,Reino Unido de Gran Bretaña e Irlanda del Norte,176,310,,486,-75.42726,6.170465
67452,2019,Junio,Reino Unido de Gran Bretaña e Irlanda del Norte,1,0,,1,-67.48402800000001,6.185536
67453,2019,Junio,Reino Unido de Gran Bretaña e Irlanda del Norte,0,1,,1,-73.181317,7.1280470000000005
67454,2019,Junio,Reino Unido de Gran Bretaña e Irlanda del Norte,1,3,,4,-72.453013,7.819
67455,2019,Junio,Reino Unido de Gran Bretaña e Irlanda del Norte,29,22,,51,-77.35002,8.63337
67456,2019,Junio,República Dominicana,0,1,,1,-69.941498,4.191162
67457,2019,Junio,República Dominicana,5,15,,20,-77.35600000000001,0.81488
67458,2019,Junio,República Dominicana,18,20,,38,-75.527794,10.406342
67459,2019,Junio,República Dominicana,58,71,,129,-75.516486,10.446304
67460,2019,Junio,República Dominicana,19,42,,61,-74.77647900000001,10.886686
67461,2019,Junio,República Dominicana,0,1,,1,-74.232675,11.117206
67462,2019,Junio,República Dominicana,3,1,,4,-72.129595,11.360028999999999
67463,2019,Junio,República Dominicana,0,2,,2,-81.70216500000001,12.5862
67464,2019,Junio,República Dominicana,27,33,,60,-76.532004,3.451668
67465,2019,Junio,República Dominicana,0,2,,2,-75.76635300000001,4.45285
67466,2019,Junio,República Dominicana,925,1010,,1935,-74.140516,4.697157
67467,2019,Junio,República Dominicana,0,1,,1,-75.736374,4.815189
67468,2019,Junio,República Dominicana,92,132,,224,-75.42726,6.170465
67469,2019,Junio,República Dominicana,5,1,,6,-73.181317,7.1280470000000005
67470,2019,Junio,República Dominicana,2,1,,3,-72.453013,7.819
67471,2019,Junio,República Dominicana,0,1,,1,-72.409396,8.36068
67472,2019,Junio,Rumania,2,3,,5,-77.35600000000001,0.81488
67473,2019,Junio,Rumania,1,5,,6,-75.527794,10.406342
67474,2019,Junio,Rumania,3,13,,16,-75.516486,10.446304
67475,2019,Junio,Rumania,1,2,,3,-74.77647900000001,10.886686
67476,2019,Junio,Rumania,0,2,,2,-74.213989,11.247722999999999
67477,2019,Junio,Rumania,1,2,,3,-76.532004,3.451668
67478,2019,Junio,Rumania,0,1,,1,-77.061029,3.8844260000000004
67479,2019,Junio,Rumania,62,61,,123,-74.140516,4.697157
67480,2019,Junio,Rumania,14,11,,25,-75.42726,6.170465
67481,2019,Junio,Federación de Rusia,0,2,,2,-69.941498,4.191162
67482,2019,Junio,Federación de Rusia,1,0,,1,-69.94143100000001,4.214082
67483,2019,Junio,Federación de Rusia,1,0,,1,-76.876446,0.33002
67484,2019,Junio,Federación de Rusia,2,2,,4,-77.35600000000001,0.81488
67485,2019,Junio,Federación de Rusia,0,3,,3,-75.527794,10.406342
67486,2019,Junio,Federación de Rusia,14,14,,28,-75.516486,10.446304
67487,2019,Junio,Federación de Rusia,1,0,,1,-74.77647900000001,10.886686
67488,2019,Junio,Federación de Rusia,0,1,,1,-74.213989,11.247722999999999
67489,2019,Junio,Federación de Rusia,0,1,,1,-72.129595,11.360028999999999
67490,2019,Junio,Federación de Rusia,7,9,,16,-76.532004,3.451668
67491,2019,Junio,Federación de Rusia,0,5,,5,-77.061029,3.8844260000000004
67492,2019,Junio,Federación de Rusia,133,164,,297,-74.140516,4.697157
67493,2019,Junio,Federación de Rusia,1,0,,1,-75.736374,4.815189
67494,2019,Junio,Federación de Rusia,20,18,,38,-75.42726,6.170465
67495,2019,Junio,Federación de Rusia,1,0,,1,-72.453013,7.819
67496,2019,Junio,Federación de Rusia,0,1,,1,-77.35002,8.63337
67497,2019,Junio,Rwanda,0,1,,1,-74.140516,4.697157
67498,2019,Junio,San Cristóbal y Nevis,1,1,,2,-75.516486,10.446304
67499,2019,Junio,San Cristóbal y Nevis,0,2,,2,-81.70216500000001,12.5862
67500,2019,Junio,San Cristóbal y Nevis,3,3,,6,-74.140516,4.697157
67501,2019,Junio,San Cristóbal y Nevis,1,0,,1,-75.42726,6.170465
67502,2019,Junio,San  Vicente y las Granadinas,1,1,,2,-81.70216500000001,12.5862
67503,2019,Junio,San  Vicente y las Granadinas,1,0,,1,-76.532004,3.451668
67504,2019,Junio,San  Vicente y las Granadinas,0,4,,4,-74.140516,4.697157
67505,2019,Junio,San  Vicente y las Granadinas,2,3,,5,-75.42726,6.170465
67506,2019,Junio,Santa Lucia,0,1,,1,-75.516486,10.446304
67507,2019,Junio,Santa Lucia,1,1,,2,-76.532004,3.451668
67508,2019,Junio,Santa Lucia,3,1,,4,-74.140516,4.697157
67509,2019,Junio,Santa Lucia,6,1,,7,-75.42726,6.170465
67510,2019,Junio,Santa Lucia,2,1,,3,-73.181317,7.1280470000000005
67511,2019,Junio,Santa Sede/Ciudad del Vaticano,0,3,,3,-74.140516,4.697157
67512,2019,Junio,Santa Sede/Ciudad del Vaticano,0,1,,1,-75.42726,6.170465
67513,2019,Junio,Senegal,0,1,,1,-76.532004,3.451668
67514,2019,Junio,Senegal,1,8,,9,-74.140516,4.697157
67515,2019,Junio,Serbia,0,1,,1,-76.876446,0.33002
67516,2019,Junio,Serbia,3,3,,6,-75.516486,10.446304
67517,2019,Junio,Serbia,0,1,,1,-81.70216500000001,12.5862
67518,2019,Junio,Serbia,1,1,,2,-76.532004,3.451668
67519,2019,Junio,Serbia,11,33,,44,-74.140516,4.697157
67520,2019,Junio,Serbia,5,10,,15,-75.42726,6.170465
67521,2019,Junio,Singapur,3,2,,5,-75.516486,10.446304
67522,2019,Junio,Singapur,1,1,,2,-76.532004,3.451668
67523,2019,Junio,Singapur,21,37,,58,-74.140516,4.697157
67524,2019,Junio,Singapur,2,0,,2,-75.42726,6.170465
67525,2019,Junio,República Árabe Siria,0,4,,4,-74.140516,4.697157
67526,2019,Junio,República Árabe Siria,0,1,,1,-75.42726,6.170465
67527,2019,Junio,Sri Lanka,0,1,,1,-77.35600000000001,0.81488
67528,2019,Junio,Sri Lanka,0,1,,1,-75.527794,10.406342
67529,2019,Junio,Sri Lanka,0,1,,1,-76.532004,3.451668
67530,2019,Junio,Sri Lanka,1,0,,1,-74.140516,4.697157
67531,2019,Junio,Sudáfrica,0,1,,1,-69.94143100000001,4.214082
67532,2019,Junio,Sudáfrica,1,1,,2,-77.35600000000001,0.81488
67533,2019,Junio,Sudáfrica,0,1,,1,-75.527794,10.406342
67534,2019,Junio,Sudáfrica,4,4,,8,-75.516486,10.446304
67535,2019,Junio,Sudáfrica,35,50,,85,-74.140516,4.697157
67536,2019,Junio,Sudáfrica,3,1,,4,-75.42726,6.170465
67537,2019,Junio,Sudáfrica,0,2,,2,-72.453013,7.819
67538,2019,Junio,Sudán,1,1,,2,-74.140516,4.697157
67539,2019,Junio,Suecia,0,1,,1,-69.941498,4.191162
67540,2019,Junio,Suecia,6,8,,14,-77.35600000000001,0.81488
67541,2019,Junio,Suecia,4,4,,8,-75.527794,10.406342
67542,2019,Junio,Suecia,19,27,,46,-75.516486,10.446304
67543,2019,Junio,Suecia,5,6,,11,-74.77647900000001,10.886686
67544,2019,Junio,Suecia,0,2,,2,-74.213989,11.247722999999999
67545,2019,Junio,Suecia,4,12,,16,-76.532004,3.451668
67546,2019,Junio,Suecia,216,260,,476,-74.140516,4.697157
67547,2019,Junio,Suecia,1,5,,6,-75.736374,4.815189
67548,2019,Junio,Suecia,32,55,,87,-75.42726,6.170465
67549,2019,Junio,Suecia,1,0,,1,-77.35002,8.63337
67550,2019,Junio,Suiza,9,2,,11,-69.94143100000001,4.214082
67551,2019,Junio,Suiza,3,1,,4,-76.876446,0.33002
67552,2019,Junio,Suiza,34,33,,67,-77.35600000000001,0.81488
67553,2019,Junio,Suiza,13,14,,27,-75.527794,10.406342
67554,2019,Junio,Suiza,50,66,,116,-75.516486,10.446304
67555,2019,Junio,Suiza,3,10,,13,-74.77647900000001,10.886686
67556,2019,Junio,Suiza,1,0,,1,-74.213989,11.247722999999999
67557,2019,Junio,Suiza,0,1,,1,-72.129595,11.360028999999999
67558,2019,Junio,Suiza,0,1,,1,-81.703935,12.574411099999999
67559,2019,Junio,Suiza,0,1,,1,-81.70216500000001,12.5862
67560,2019,Junio,Suiza,28,33,,61,-76.532004,3.451668
67561,2019,Junio,Suiza,1,1,,2,-75.76635300000001,4.45285
67562,2019,Junio,Suiza,354,545,,899,-74.140516,4.697157
67563,2019,Junio,Suiza,1,2,,3,-75.736374,4.815189
67564,2019,Junio,Suiza,50,77,,127,-75.42726,6.170465
67565,2019,Junio,Suiza,0,1,,1,-72.453013,7.819
67566,2019,Junio,Suiza,1,0,,1,-72.409396,8.36068
67567,2019,Junio,Suiza,1,2,,3,-77.35002,8.63337
67568,2019,Junio,Surinam,2,1,,3,-75.516486,10.446304
67569,2019,Junio,Surinam,15,24,,39,-74.140516,4.697157
67570,2019,Junio,Surinam,4,1,,5,-75.42726,6.170465
67571,2019,Junio,Taiwán,0,1,,1,-74.140516,4.697157
67572,2019,Junio,República de Tayikistán,0,1,,1,-77.35600000000001,0.81488
67573,2019,Junio,República de Tayikistán,0,1,,1,-74.140516,4.697157
67574,2019,Junio,Tailandia,3,0,,3,-77.35600000000001,0.81488
67575,2019,Junio,Tailandia,3,3,,6,-75.516486,10.446304
67576,2019,Junio,Tailandia,14,10,,24,-74.140516,4.697157
67577,2019,Junio,Tailandia,0,1,,1,-75.42726,6.170465
67578,2019,Junio,Tanzania,0,1,,1,-75.516486,10.446304
67579,2019,Junio,Tanzania,1,0,,1,-76.532004,3.451668
67580,2019,Junio,Tanzania,0,1,,1,-74.140516,4.697157
67581,2019,Junio,Tanzania,0,1,,1,-75.42726,6.170465
67582,2019,Junio,Togo,0,2,,2,-75.527794,10.406342
67583,2019,Junio,Togo,0,1,,1,-74.140516,4.697157
67584,2019,Junio,Trinidad y Tobago,6,7,,13,-75.516486,10.446304
67585,2019,Junio,Trinidad y Tobago,5,1,,6,-74.77647900000001,10.886686
67586,2019,Junio,Trinidad y Tobago,5,8,,13,-76.532004,3.451668
67587,2019,Junio,Trinidad y Tobago,49,48,,97,-74.140516,4.697157
67588,2019,Junio,Trinidad y Tobago,0,1,,1,-75.736374,4.815189
67589,2019,Junio,Trinidad y Tobago,7,14,,21,-75.42726,6.170465
67590,2019,Junio,Trinidad y Tobago,2,3,,5,-73.181317,7.1280470000000005
67591,2019,Junio,Trinidad y Tobago,0,1,,1,-72.453013,7.819
67592,2019,Junio,Túnez,0,1,,1,-75.527794,10.406342
67593,2019,Junio,Túnez,0,1,,1,-72.129595,11.360028999999999
67594,2019,Junio,Túnez,5,3,,8,-74.140516,4.697157
67595,2019,Junio,Turquía,0,1,,1,-77.35600000000001,0.81488
67596,2019,Junio,Turquía,0,4,,4,-75.527794,10.406342
67597,2019,Junio,Turquía,9,13,,22,-75.516486,10.446304
67598,2019,Junio,Turquía,0,3,,3,-74.77647900000001,10.886686
67599,2019,Junio,Turquía,0,1,,1,-74.213989,11.247722999999999
67600,2019,Junio,Turquía,0,3,,3,-76.532004,3.451668
67601,2019,Junio,Turquía,179,368,,547,-74.140516,4.697157
67602,2019,Junio,Turquía,7,14,,21,-75.42726,6.170465
67603,2019,Junio,Turquía,0,1,,1,-73.181317,7.1280470000000005
67604,2019,Junio,Turquía,0,1,,1,-77.35002,8.63337
67605,2019,Junio,Ucrania,1,0,,1,-69.94143100000001,4.214082
67606,2019,Junio,Ucrania,2,2,,4,-77.35600000000001,0.81488
67607,2019,Junio,Ucrania,0,5,,5,-75.527794,10.406342
67608,2019,Junio,Ucrania,1,4,,5,-75.516486,10.446304
67609,2019,Junio,Ucrania,0,2,,2,-74.77647900000001,10.886686
67610,2019,Junio,Ucrania,0,1,,1,-74.765343,10.970933
67611,2019,Junio,Ucrania,0,3,,3,-74.213989,11.247722999999999
67612,2019,Junio,Ucrania,0,4,,4,-77.061029,3.8844260000000004
67613,2019,Junio,Ucrania,31,34,,65,-74.140516,4.697157
67614,2019,Junio,Ucrania,4,6,,10,-75.42726,6.170465
67615,2019,Junio,Ucrania,0,1,,1,-75.68164200000001,9.402597
67616,2019,Junio,Uganda,0,1,,1,-77.35600000000001,0.81488
67617,2019,Junio,Uganda,0,1,,1,-75.516486,10.446304
67618,2019,Junio,Uganda,0,3,,3,-74.140516,4.697157
67619,2019,Junio,Uganda,2,0,,2,-75.42726,6.170465
67620,2019,Junio,Uruguay,1,2,,3,-69.94143100000001,4.214082
67621,2019,Junio,Uruguay,4,1,,5,-76.876446,0.33002
67622,2019,Junio,Uruguay,1,11,,12,-77.35600000000001,0.81488
67623,2019,Junio,Uruguay,23,8,,31,-75.527794,10.406342
67624,2019,Junio,Uruguay,137,91,,228,-75.516486,10.446304
67625,2019,Junio,Uruguay,1,10,,11,-74.77647900000001,10.886686
67626,2019,Junio,Uruguay,53,45,,98,-81.70216500000001,12.5862
67627,2019,Junio,Uruguay,10,31,,41,-76.532004,3.451668
67628,2019,Junio,Uruguay,0,2,,2,-75.76635300000001,4.45285
67629,2019,Junio,Uruguay,404,531,,935,-74.140516,4.697157
67630,2019,Junio,Uruguay,1,0,,1,-75.736374,4.815189
67631,2019,Junio,Uruguay,97,135,,232,-75.42726,6.170465
67632,2019,Junio,Uruguay,2,5,,7,-72.453013,7.819
67633,2019,Junio,Venezuela,4,3,,7,-69.941498,4.191162
67634,2019,Junio,Venezuela,6,3,,9,-69.94143100000001,4.214082
67635,2019,Junio,Venezuela,81,73,,154,-76.876446,0.33002
67636,2019,Junio,Venezuela,3555,3698,,7253,-77.35600000000001,0.81488
67637,2019,Junio,Venezuela,2,20,,22,-78.802679,18.00143
67638,2019,Junio,Venezuela,17,42,,59,-75.527794,10.406342
67639,2019,Junio,Venezuela,199,219,,418,-75.516486,10.446304
67640,2019,Junio,Venezuela,291,405,,696,-74.77647900000001,10.886686
67641,2019,Junio,Venezuela,16,27,,43,-74.232675,11.117206
67642,2019,Junio,Venezuela,7884,7359,,15243,-72.129595,11.360028999999999
67643,2019,Junio,Venezuela,0,2,,2,-72.919186,11.52863
67644,2019,Junio,Venezuela,3,2,,5,-81.70216500000001,12.5862
67645,2019,Junio,Venezuela,206,224,,430,-76.532004,3.451668
67646,2019,Junio,Venezuela,21,19,,40,-67.927521,3.866713
67647,2019,Junio,Venezuela,2,2,,4,-75.76635300000001,4.45285
67648,2019,Junio,Venezuela,7900,7827,,15727,-74.140516,4.697157
67649,2019,Junio,Venezuela,7,20,,27,-75.736374,4.815189
67650,2019,Junio,Venezuela,1515,1474,,2989,-75.42726,6.170465
67651,2019,Junio,Venezuela,38,28,,66,-67.48402800000001,6.185536
67652,2019,Junio,Venezuela,700,690,,1390,-70.74025300000001,7.088728999999999
67653,2019,Junio,Venezuela,9,13,,22,-73.181317,7.1280470000000005
67654,2019,Junio,Venezuela,29976,26826,,56802,-72.453013,7.819
67655,2019,Junio,Venezuela,12,28,,40,-72.508188,7.927233
67656,2019,Junio,Venezuela,1904,1597,,3501,-72.409396,8.36068
67657,2019,Junio,Venezuela,1,0,,1,-77.35002,8.63337
67658,2019,Junio,Vietnam,5,2,,7,-74.140516,4.697157
67659,2019,Junio,Vietnam,5,4,,9,-75.42726,6.170465
67660,2019,Junio,República Árabe de Yemen,2,3,,5,-74.140516,4.697157
67661,2019,Junio,Zambia,0,1,,1,-74.140516,4.697157
67662,2019,Junio,Zimbabue,1,2,,3,-74.140516,4.697157
67663,2019,Junio,Zimbabue,0,1,,1,-75.42726,6.170465
67664,2019,Junio,Desconocido,5,4,,9,-75.516486,10.446304
67665,2019,Junio,Desconocido,0,1,,1,-74.77647900000001,10.886686
67666,2019,Julio,Desconocido,101,163,,264,-74.140516,4.697157
67667,2019,Julio,Desconocido,7,15,,22,-75.42726,6.170465
67668,2019,Julio,Desconocido,1,0,,1,-72.453013,7.819
