Año,Mes,Nacionalidad,Femenino,Masculino,Indefinido,Total,Nueva columna georreferenciada
2012,Enero,Islas Alboran y Perejil,1,0,,1,POINT (4697157 -74140516)
2012,Enero,Albania,1,2,,3,POINT (4697157 -74140516)
2012,Enero,Alemania,11,16,,27,POINT (-4191162 -69941498)
2012,Enero,Alemania,1,1,,2,POINT (0.33002 -76876446)
2012,Enero,Alemania,63,102,,165,POINT (0.81488 -77356)
2012,Enero,Alemania,22,23,,45,POINT (10406342 -75527794)
2012,Enero,Alemania,27,48,,75,POINT (10446304 -75516486)
2012,Enero,Alemania,7,4,,11,POINT (10886686 -74776479)
2012,Enero,Alemania,1,1,,2,POINT (11247723 -74213989)
2012,Enero,Alemania,8,21,,29,POINT (11360029 -72129595)
2012,Enero,Alemania,6,7,,13,POINT (125862 -81702165)
2012,Enero,Alemania,1,1,,2,POINT (133387613 -81372937)
2012,Enero,Alemania,25,49,,74,POINT (3451668 -76532004)
2012,Enero,Alemania,0,1,,1,POINT (3884426 -77061029)
2012,Enero,Alemania,1182,2025,,3207,POINT (4697157 -74140516)
2012,Enero,Alemania,30,97,,127,POINT (6170465 -7542726)
2012,Enero,Alemania,1,0,,1,POINT (6185536 -67484028)
2012,Enero,Alemania,0,2,,2,POINT (7128047 -73181317)
2012,Enero,Alemania,3,15,,18,POINT (7819 -72453013)
2012,Enero,Alemania,0,1,,1,POINT (7927233 -72508188)
2012,Enero,Alemania,8,25,,33,POINT (863337 -7735002)
2012,Enero,Andorra,6,11,,17,POINT (4697157 -74140516)
2012,Enero,Angola,1,1,,2,POINT (4697157 -74140516)
2012,Enero,Antigua y Barbuda,1,1,,2,POINT (10446304 -75516486)
2012,Enero,Países Bajos,1,2,,3,POINT (6170465 -7542726)
2012,Enero,Argelia,3,2,,5,POINT (4697157 -74140516)
2012,Enero,Argelia,0,2,,2,POINT (6170465 -7542726)
2012,Enero,Argentina,6,15,,21,POINT (-4191162 -69941498)
2012,Enero,Argentina,0,1,,1,POINT (0.33002 -76876446)
2012,Enero,Argentina,254,355,,609,POINT (0.81488 -77356)
2012,Enero,Argentina,1,0,,1,POINT (1800143 -78802679)
2012,Enero,Argentina,93,68,,161,POINT (10406342 -75527794)
2012,Enero,Argentina,568,412,,980,POINT (10446304 -75516486)
2012,Enero,Argentina,23,35,,58,POINT (10886686 -74776479)
2012,Enero,Argentina,0,1,,1,POINT (11247723 -74213989)
2012,Enero,Argentina,65,70,,135,POINT (11360029 -72129595)
2012,Enero,Argentina,1,1,,2,POINT (1152863 -72919186)
2012,Enero,Argentina,186,128,,314,POINT (125862 -81702165)
2012,Enero,Argentina,48,61,,109,POINT (3451668 -76532004)
2012,Enero,Argentina,4315,4691,,9006,POINT (4697157 -74140516)
2012,Enero,Argentina,4,7,,11,POINT (4815189 -75736374)
2012,Enero,Argentina,94,155,,249,POINT (6170465 -7542726)
2012,Enero,Argentina,0,1,,1,POINT (7088729 -70740253)
2012,Enero,Argentina,0,3,,3,POINT (7128047 -73181317)
2012,Enero,Argentina,25,50,,75,POINT (7819 -72453013)
2012,Enero,Argentina,1,1,,2,POINT (7927233 -72508188)
2012,Enero,Argentina,12,27,,39,POINT (863337 -7735002)
2012,Enero,Aruba,0,1,,1,POINT (3451668 -76532004)
2012,Enero,Aruba,0,1,,1,POINT (4697157 -74140516)
2012,Enero,Australia,4,14,,18,POINT (-4191162 -69941498)
2012,Enero,Australia,29,58,,87,POINT (0.81488 -77356)
2012,Enero,Australia,14,30,,44,POINT (10406342 -75527794)
2012,Enero,Australia,31,51,,82,POINT (10446304 -75516486)
2012,Enero,Australia,3,7,,10,POINT (10886686 -74776479)
2012,Enero,Australia,1,2,,3,POINT (11247723 -74213989)
2012,Enero,Australia,4,6,,10,POINT (11360029 -72129595)
2012,Enero,Australia,0,1,,1,POINT (125862 -81702165)
2012,Enero,Australia,3,1,,4,POINT (133387613 -81372937)
2012,Enero,Australia,11,21,,32,POINT (3451668 -76532004)
2012,Enero,Australia,0,1,,1,POINT (445285 -75766353)
2012,Enero,Australia,241,400,,641,POINT (4697157 -74140516)
2012,Enero,Australia,1,1,,2,POINT (4815189 -75736374)
2012,Enero,Australia,30,70,,100,POINT (6170465 -7542726)
2012,Enero,Australia,0,1,,1,POINT (6185536 -67484028)
2012,Enero,Australia,1,4,,5,POINT (7819 -72453013)
2012,Enero,Australia,1,1,,2,POINT (7927233 -72508188)
2012,Enero,Australia,5,9,,14,POINT (863337 -7735002)
2012,Enero,Austria,4,6,,10,POINT (-4191162 -69941498)
2012,Enero,Austria,3,7,,10,POINT (0.81488 -77356)
2012,Enero,Austria,4,4,,8,POINT (10406342 -75527794)
2012,Enero,Austria,6,4,,10,POINT (10446304 -75516486)
2012,Enero,Austria,1,1,,2,POINT (10886686 -74776479)
2012,Enero,Austria,0,2,,2,POINT (11360029 -72129595)
2012,Enero,Austria,3,7,,10,POINT (3451668 -76532004)
2012,Enero,Austria,124,284,,408,POINT (4697157 -74140516)
2012,Enero,Austria,6,8,,14,POINT (6170465 -7542726)
2012,Enero,Austria,0,1,,1,POINT (6222552 -77401154)
2012,Enero,Austria,0,1,,1,POINT (7819 -72453013)
2012,Enero,Austria,0,3,,3,POINT (863337 -7735002)
2012,Enero,Azerbaiyán,0,1,,1,POINT (0.81488 -77356)
2012,Enero,Azerbaiyán,1,1,,2,POINT (4697157 -74140516)
2012,Enero,Bahamas,2,3,,5,POINT (4697157 -74140516)
2012,Enero,Bahamas,0,2,,2,POINT (6170465 -7542726)
2012,Enero,Bahréin,0,1,,1,POINT (4697157 -74140516)
2012,Enero,Bangladesh,0,1,,1,POINT (4697157 -74140516)
2012,Enero,Barbados,1,0,,1,POINT (10446304 -75516486)
2012,Enero,Barbados,2,3,,5,POINT (4697157 -74140516)
2012,Enero,República de Belarús,0,1,,1,POINT (10446304 -75516486)
2012,Enero,República de Belarús,1,1,,2,POINT (4697157 -74140516)
2012,Enero,Bélgica,2,3,,5,POINT (-4191162 -69941498)
2012,Enero,Bélgica,1,1,,2,POINT (0.33002 -76876446)
2012,Enero,Bélgica,14,14,,28,POINT (0.81488 -77356)
2012,Enero,Bélgica,1,2,,3,POINT (10406342 -75527794)
2012,Enero,Bélgica,2,8,,10,POINT (10446304 -75516486)
2012,Enero,Bélgica,0,3,,3,POINT (10886686 -74776479)
2012,Enero,Bélgica,0,3,,3,POINT (11360029 -72129595)
2012,Enero,Bélgica,0,2,,2,POINT (133387613 -81372937)
2012,Enero,Bélgica,7,23,,30,POINT (3451668 -76532004)
2012,Enero,Bélgica,137,304,,441,POINT (4697157 -74140516)
2012,Enero,Bélgica,4,11,,15,POINT (6170465 -7542726)
2012,Enero,Bélgica,0,1,,1,POINT (6185536 -67484028)
2012,Enero,Bélgica,4,3,,7,POINT (7819 -72453013)
2012,Enero,Bélgica,0,2,,2,POINT (863337 -7735002)
2012,Enero,Belice,3,0,,3,POINT (11360029 -72129595)
2012,Enero,Belice,0,1,,1,POINT (3451668 -76532004)
2012,Enero,Belice,5,7,,12,POINT (4697157 -74140516)
2012,Enero,Belice,0,2,,2,POINT (6170465 -7542726)
2012,Enero,Belice,1,1,,2,POINT (7128047 -73181317)
2012,Enero,Bermudas/Territorio Británico de Ultramar,0,2,,2,POINT (3451668 -76532004)
2012,Enero,Bolivia,19,25,,44,POINT (0.81488 -77356)
2012,Enero,Bolivia,4,3,,7,POINT (10406342 -75527794)
2012,Enero,Bolivia,6,15,,21,POINT (10446304 -75516486)
2012,Enero,Bolivia,0,1,,1,POINT (10886686 -74776479)
2012,Enero,Bolivia,8,10,,18,POINT (125862 -81702165)
2012,Enero,Bolivia,20,18,,38,POINT (3451668 -76532004)
2012,Enero,Bolivia,330,416,,746,POINT (4697157 -74140516)
2012,Enero,Bolivia,0,2,,2,POINT (4815189 -75736374)
2012,Enero,Bolivia,16,19,,35,POINT (6170465 -7542726)
2012,Enero,Bolivia,1,3,,4,POINT (7819 -72453013)
2012,Enero,Bosnia y Herzegovina,0,1,,1,POINT (4697157 -74140516)
2012,Enero,Botsuana,0,1,,1,POINT (4697157 -74140516)
2012,Enero,Brasil,94,111,,205,POINT (-4191162 -69941498)
2012,Enero,Brasil,0,1,,1,POINT (0.33002 -76876446)
2012,Enero,Brasil,17,35,,52,POINT (0.81488 -77356)
2012,Enero,Brasil,51,39,,90,POINT (10406342 -75527794)
2012,Enero,Brasil,82,90,,172,POINT (10446304 -75516486)
2012,Enero,Brasil,8,23,,31,POINT (10886686 -74776479)
2012,Enero,Brasil,21,27,,48,POINT (11360029 -72129595)
2012,Enero,Brasil,6,15,,21,POINT (125862 -81702165)
2012,Enero,Brasil,26,50,,76,POINT (3451668 -76532004)
2012,Enero,Brasil,0,1,,1,POINT (445285 -75766353)
2012,Enero,Brasil,3820,4946,,8766,POINT (4697157 -74140516)
2012,Enero,Brasil,22,114,,136,POINT (4815189 -75736374)
2012,Enero,Brasil,60,93,,153,POINT (6170465 -7542726)
2012,Enero,Brasil,1,1,,2,POINT (6185536 -67484028)
2012,Enero,Brasil,3,4,,7,POINT (7088729 -70740253)
2012,Enero,Brasil,1,1,,2,POINT (7128047 -73181317)
2012,Enero,Brasil,19,25,,44,POINT (7819 -72453013)
2012,Enero,Brasil,0,2,,2,POINT (7927233 -72508188)
2012,Enero,Brasil,0,1,,1,POINT (863337 -7735002)
2012,Enero,Bulgaria,1,3,,4,POINT (10446304 -75516486)
2012,Enero,Bulgaria,0,1,,1,POINT (11247723 -74213989)
2012,Enero,Bulgaria,1,1,,2,POINT (3451668 -76532004)
2012,Enero,Bulgaria,6,8,,14,POINT (4697157 -74140516)
2012,Enero,Burkina Faso,1,0,,1,POINT (4697157 -74140516)
2012,Enero,Islas Caimán/Territorio Británico de Ultramar,0,6,,6,POINT (125862 -81702165)
2012,Enero,Islas Caimán/Territorio Británico de Ultramar,1,1,,2,POINT (3451668 -76532004)
2012,Enero,Islas Caimán/Territorio Británico de Ultramar,1,1,,2,POINT (4697157 -74140516)
2012,Enero,Camerún,1,2,,3,POINT (4697157 -74140516)
2012,Enero,Canadá,7,14,,21,POINT (-4191162 -69941498)
2012,Enero,Canadá,23,41,,64,POINT (0.81488 -77356)
2012,Enero,Canadá,8,19,,27,POINT (10406342 -75527794)
2012,Enero,Canadá,1237,1252,,2489,POINT (10446304 -75516486)
2012,Enero,Canadá,5,16,,21,POINT (10886686 -74776479)
2012,Enero,Canadá,1,0,,1,POINT (11247723 -74213989)
2012,Enero,Canadá,6,7,,13,POINT (11360029 -72129595)
2012,Enero,Canadá,2,3,,5,POINT (125744111 -81703935)
2012,Enero,Canadá,600,568,,1168,POINT (125862 -81702165)
2012,Enero,Canadá,0,1,,1,POINT (133387613 -81372937)
2012,Enero,Canadá,42,52,,94,POINT (3451668 -76532004)
2012,Enero,Canadá,8,15,,23,POINT (445285 -75766353)
2012,Enero,Canadá,730,1402,,2132,POINT (4697157 -74140516)
2012,Enero,Canadá,4,6,,10,POINT (4815189 -75736374)
2012,Enero,Canadá,102,215,,317,POINT (6170465 -7542726)
2012,Enero,Canadá,1,4,,5,POINT (7128047 -73181317)
2012,Enero,Canadá,5,9,,14,POINT (7819 -72453013)
2012,Enero,Canadá,1,7,,8,POINT (7927233 -72508188)
2012,Enero,Canadá,3,13,,16,POINT (863337 -7735002)
2012,Enero,Chad,0,2,,2,POINT (4697157 -74140516)
2012,Enero,España,1,0,,1,POINT (0.33002 -76876446)
2012,Enero,España,14,27,,41,POINT (0.81488 -77356)
2012,Enero,España,10,14,,24,POINT (10446304 -75516486)
2012,Enero,España,3,11,,14,POINT (10886686 -74776479)
2012,Enero,España,0,1,,1,POINT (11247723 -74213989)
2012,Enero,España,0,1,,1,POINT (11360029 -72129595)
2012,Enero,España,0,1,,1,POINT (125744111 -81703935)
2012,Enero,España,4,4,,8,POINT (125862 -81702165)
2012,Enero,España,56,120,,176,POINT (3451668 -76532004)
2012,Enero,España,1,0,,1,POINT (445285 -75766353)
2012,Enero,España,192,397,,589,POINT (4697157 -74140516)
2012,Enero,España,3,3,,6,POINT (4815189 -75736374)
2012,Enero,España,32,65,,97,POINT (6170465 -7542726)
2012,Enero,España,1,0,,1,POINT (7088729 -70740253)
2012,Enero,España,3,1,,4,POINT (7819 -72453013)
2012,Enero,España,1,3,,4,POINT (7927233 -72508188)
2012,Enero,República Democrática del Congo,0,1,,1,POINT (3451668 -76532004)
2012,Enero,República Democrática del Congo,0,2,,2,POINT (4697157 -74140516)
2012,Enero,República de Corea,4,5,,9,POINT (0.81488 -77356)
2012,Enero,República de Corea,2,2,,4,POINT (10406342 -75527794)
2012,Enero,República de Corea,4,19,,23,POINT (10446304 -75516486)
2012,Enero,República de Corea,0,1,,1,POINT (10886686 -74776479)
2012,Enero,República de Corea,0,6,,6,POINT (3451668 -76532004)
2012,Enero,República de Corea,126,290,,416,POINT (4697157 -74140516)
2012,Enero,República de Corea,9,15,,24,POINT (6170465 -7542726)
2012,Enero,República de Corea,0,1,,1,POINT (7819 -72453013)
2012,Enero,República de Corea,0,1,,1,POINT (7927233 -72508188)
2012,Enero,República de Corea,0,4,,4,POINT (863337 -7735002)
2012,Enero,Costa de Marfil,1,1,,2,POINT (4697157 -74140516)
2012,Enero,Costa Rica,6,12,,18,POINT (0.81488 -77356)
2012,Enero,Costa Rica,0,1,,1,POINT (10406342 -75527794)
2012,Enero,Costa Rica,48,48,,96,POINT (10446304 -75516486)
2012,Enero,Costa Rica,20,21,,41,POINT (10886686 -74776479)
2012,Enero,Costa Rica,0,2,,2,POINT (11247723 -74213989)
2012,Enero,Costa Rica,0,2,,2,POINT (11360029 -72129595)
2012,Enero,Costa Rica,432,342,,774,POINT (125862 -81702165)
2012,Enero,Costa Rica,26,46,,72,POINT (3451668 -76532004)
2012,Enero,Costa Rica,307,480,,787,POINT (4697157 -74140516)
2012,Enero,Costa Rica,1,6,,7,POINT (4815189 -75736374)
2012,Enero,Costa Rica,115,132,,247,POINT (6170465 -7542726)
2012,Enero,Costa Rica,3,4,,7,POINT (7128047 -73181317)
2012,Enero,Costa Rica,1,7,,8,POINT (7819 -72453013)
2012,Enero,Costa Rica,1,2,,3,POINT (7927233 -72508188)
2012,Enero,Costa Rica,0,2,,2,POINT (863337 -7735002)
2012,Enero,Croacia,0,2,,2,POINT (0.81488 -77356)
2012,Enero,Croacia,0,1,,1,POINT (10406342 -75527794)
2012,Enero,Croacia,2,0,,2,POINT (10446304 -75516486)
2012,Enero,Croacia,1,0,,1,POINT (3451668 -76532004)
2012,Enero,Croacia,7,14,,21,POINT (4697157 -74140516)
2012,Enero,Croacia,1,0,,1,POINT (6170465 -7542726)
2012,Enero,Croacia,0,1,,1,POINT (7927233 -72508188)
2012,Enero,Cuba,1,2,,3,POINT (0.81488 -77356)
2012,Enero,Cuba,14,18,,32,POINT (10446304 -75516486)
2012,Enero,Cuba,6,6,,12,POINT (10886686 -74776479)
2012,Enero,Cuba,1,3,,4,POINT (11360029 -72129595)
2012,Enero,Cuba,1,0,,1,POINT (125862 -81702165)
2012,Enero,Cuba,30,37,,67,POINT (3451668 -76532004)
2012,Enero,Cuba,0,1,,1,POINT (445285 -75766353)
2012,Enero,Cuba,104,174,,278,POINT (4697157 -74140516)
2012,Enero,Cuba,0,2,,2,POINT (4815189 -75736374)
2012,Enero,Cuba,13,14,,27,POINT (6170465 -7542726)
2012,Enero,Cuba,0,3,,3,POINT (7128047 -73181317)
2012,Enero,Cuba,0,11,,11,POINT (7819 -72453013)
2012,Enero,Cuba,2,11,,13,POINT (7927233 -72508188)
2012,Enero,Curazao,0,1,,1,POINT (4697157 -74140516)
2012,Enero,Curazao,1,0,,1,POINT (6170465 -7542726)
2012,Enero,República Checa,0,2,,2,POINT (-4191162 -69941498)
2012,Enero,República Checa,1,4,,5,POINT (0.81488 -77356)
2012,Enero,República Checa,1,7,,8,POINT (10446304 -75516486)
2012,Enero,República Checa,1,2,,3,POINT (11360029 -72129595)
2012,Enero,República Checa,1,0,,1,POINT (3451668 -76532004)
2012,Enero,República Checa,40,50,,90,POINT (4697157 -74140516)
2012,Enero,República Checa,2,3,,5,POINT (6170465 -7542726)
2012,Enero,República Checa,1,4,,5,POINT (7819 -72453013)
2012,Enero,República Checa,0,1,,1,POINT (863337 -7735002)
2012,Enero,Chile,2,3,,5,POINT (-4191162 -69941498)
2012,Enero,Chile,2,2,,4,POINT (0.33002 -76876446)
2012,Enero,Chile,69,97,,166,POINT (0.81488 -77356)
2012,Enero,Chile,59,36,,95,POINT (10406342 -75527794)
2012,Enero,Chile,53,58,,111,POINT (10446304 -75516486)
2012,Enero,Chile,2,19,,21,POINT (10886686 -74776479)
2012,Enero,Chile,9,9,,18,POINT (11360029 -72129595)
2012,Enero,Chile,3,2,,5,POINT (125744111 -81703935)
2012,Enero,Chile,38,28,,66,POINT (125862 -81702165)
2012,Enero,Chile,33,53,,86,POINT (3451668 -76532004)
2012,Enero,Chile,1889,2816,,4705,POINT (4697157 -74140516)
2012,Enero,Chile,0,3,,3,POINT (4815189 -75736374)
2012,Enero,Chile,71,122,,193,POINT (6170465 -7542726)
2012,Enero,Chile,0,1,,1,POINT (7088729 -70740253)
2012,Enero,Chile,0,2,,2,POINT (7128047 -73181317)
2012,Enero,Chile,19,26,,45,POINT (7819 -72453013)
2012,Enero,Chile,0,1,,1,POINT (7927233 -72508188)
2012,Enero,Chile,2,0,,2,POINT (863337 -7735002)
2012,Enero,China,0,2,,2,POINT (-4191162 -69941498)
2012,Enero,China,3,2,,5,POINT (0.81488 -77356)
2012,Enero,China,0,1,,1,POINT (10406342 -75527794)
2012,Enero,China,2,0,,2,POINT (10446304 -75516486)
2012,Enero,China,1,0,,1,POINT (10886686 -74776479)
2012,Enero,China,1,1,,2,POINT (125862 -81702165)
2012,Enero,China,1,9,,10,POINT (3451668 -76532004)
2012,Enero,China,97,237,,334,POINT (4697157 -74140516)
2012,Enero,China,7,10,,17,POINT (6170465 -7542726)
2012,Enero,China,1,0,,1,POINT (7819 -72453013)
2012,Enero,China,0,2,,2,POINT (863337 -7735002)
2012,Enero,Taiwán,1,1,,2,POINT (0.81488 -77356)
2012,Enero,Taiwán,2,3,,5,POINT (10446304 -75516486)
2012,Enero,Taiwán,0,2,,2,POINT (10886686 -74776479)
2012,Enero,Taiwán,2,1,,3,POINT (3451668 -76532004)
2012,Enero,Taiwán,29,28,,57,POINT (4697157 -74140516)
2012,Enero,Taiwán,0,1,,1,POINT (4815189 -75736374)
2012,Enero,Taiwán,5,3,,8,POINT (6170465 -7542726)
2012,Enero,Taiwán,2,1,,3,POINT (7128047 -73181317)
2012,Enero,Taiwán,1,0,,1,POINT (7819 -72453013)
2012,Enero,Chipre,1,2,,3,POINT (4697157 -74140516)
2012,Enero,Dinamarca,5,4,,9,POINT (0.81488 -77356)
2012,Enero,Dinamarca,3,4,,7,POINT (10406342 -75527794)
2012,Enero,Dinamarca,3,5,,8,POINT (10446304 -75516486)
2012,Enero,Dinamarca,0,2,,2,POINT (10886686 -74776479)
2012,Enero,Dinamarca,1,1,,2,POINT (11360029 -72129595)
2012,Enero,Dinamarca,1,14,,15,POINT (3451668 -76532004)
2012,Enero,Dinamarca,56,133,,189,POINT (4697157 -74140516)
2012,Enero,Dinamarca,0,1,,1,POINT (4815189 -75736374)
2012,Enero,Dinamarca,3,5,,8,POINT (6170465 -7542726)
2012,Enero,Dinamarca,0,2,,2,POINT (7819 -72453013)
2012,Enero,Dominica,1,5,,6,POINT (4697157 -74140516)
2012,Enero,Ecuador,0,1,,1,POINT (-4191162 -69941498)
2012,Enero,Ecuador,12,43,,55,POINT (0.33002 -76876446)
2012,Enero,Ecuador,796,1307,,2103,POINT (0.81488 -77356)
2012,Enero,Ecuador,3,3,,6,POINT (1800143 -78802679)
2012,Enero,Ecuador,8,48,,56,POINT (10406342 -75527794)
2012,Enero,Ecuador,7,14,,21,POINT (10446304 -75516486)
2012,Enero,Ecuador,4,9,,13,POINT (10886686 -74776479)
2012,Enero,Ecuador,12,11,,23,POINT (11360029 -72129595)
2012,Enero,Ecuador,1,2,,3,POINT (125862 -81702165)
2012,Enero,Ecuador,262,352,,614,POINT (3451668 -76532004)
2012,Enero,Ecuador,1,1,,2,POINT (445285 -75766353)
2012,Enero,Ecuador,1462,2292,,3754,POINT (4697157 -74140516)
2012,Enero,Ecuador,1,5,,6,POINT (4815189 -75736374)
2012,Enero,Ecuador,375,617,,992,POINT (6170465 -7542726)
2012,Enero,Ecuador,0,1,,1,POINT (7088729 -70740253)
2012,Enero,Ecuador,119,187,,306,POINT (7819 -72453013)
2012,Enero,Ecuador,5,1,,6,POINT (7927233 -72508188)
2012,Enero,Egipto,0,9,,9,POINT (4697157 -74140516)
2012,Enero,El Salvador,0,1,,1,POINT (0.81488 -77356)
2012,Enero,El Salvador,1,0,,1,POINT (10406342 -75527794)
2012,Enero,El Salvador,4,7,,11,POINT (10446304 -75516486)
2012,Enero,El Salvador,1,4,,5,POINT (10886686 -74776479)
2012,Enero,El Salvador,1,0,,1,POINT (11360029 -72129595)
2012,Enero,El Salvador,1,2,,3,POINT (125862 -81702165)
2012,Enero,El Salvador,9,13,,22,POINT (3451668 -76532004)
2012,Enero,El Salvador,0,1,,1,POINT (3884426 -77061029)
2012,Enero,El Salvador,342,474,,816,POINT (4697157 -74140516)
2012,Enero,El Salvador,0,5,,5,POINT (4815189 -75736374)
2012,Enero,El Salvador,12,35,,47,POINT (6170465 -7542726)
2012,Enero,El Salvador,0,1,,1,POINT (6222552 -77401154)
2012,Enero,El Salvador,0,6,,6,POINT (7128047 -73181317)
2012,Enero,El Salvador,2,5,,7,POINT (7819 -72453013)
2012,Enero,España,1,3,,4,POINT (-4191162 -69941498)
2012,Enero,España,10,18,,28,POINT (0.81488 -77356)
2012,Enero,España,8,10,,18,POINT (10406342 -75527794)
2012,Enero,España,21,50,,71,POINT (10446304 -75516486)
2012,Enero,España,0,10,,10,POINT (10886686 -74776479)
2012,Enero,España,4,13,,17,POINT (11360029 -72129595)
2012,Enero,España,0,1,,1,POINT (125744111 -81703935)
2012,Enero,España,10,6,,16,POINT (125862 -81702165)
2012,Enero,España,168,288,,456,POINT (3451668 -76532004)
2012,Enero,España,2,2,,4,POINT (445285 -75766353)
2012,Enero,España,1722,3810,,5532,POINT (4697157 -74140516)
2012,Enero,España,0,2,,2,POINT (4815189 -75736374)
2012,Enero,España,89,229,,318,POINT (6170465 -7542726)
2012,Enero,España,0,5,,5,POINT (7088729 -70740253)
2012,Enero,España,1,1,,2,POINT (7128047 -73181317)
2012,Enero,España,19,65,,84,POINT (7819 -72453013)
2012,Enero,España,2,1,,3,POINT (7927233 -72508188)
2012,Enero,España,3,3,,6,POINT (863337 -7735002)
2012,Enero,Eslovaquia,0,4,,4,POINT (0.81488 -77356)
2012,Enero,Eslovaquia,12,24,,36,POINT (4697157 -74140516)
2012,Enero,Eslovaquia,4,9,,13,POINT (7819 -72453013)
2012,Enero,Eslovenia,3,3,,6,POINT (0.81488 -77356)
2012,Enero,Eslovenia,0,2,,2,POINT (10406342 -75527794)
2012,Enero,Eslovenia,1,1,,2,POINT (10446304 -75516486)
2012,Enero,Eslovenia,1,0,,1,POINT (3451668 -76532004)
2012,Enero,Eslovenia,28,37,,65,POINT (4697157 -74140516)
2012,Enero,Estados Unidos de América,6,18,,24,POINT (-4191162 -69941498)
2012,Enero,Estados Unidos de América,41,94,,135,POINT (0.81488 -77356)
2012,Enero,Estados Unidos de América,35,52,,87,POINT (10406342 -75527794)
2012,Enero,Estados Unidos de América,710,1595,,2305,POINT (10446304 -75516486)
2012,Enero,Estados Unidos de América,232,486,,718,POINT (10886686 -74776479)
2012,Enero,Estados Unidos de América,2,15,,17,POINT (11117206 -74232675)
2012,Enero,Estados Unidos de América,9,13,,22,POINT (11247723 -74213989)
2012,Enero,Estados Unidos de América,13,19,,32,POINT (11360029 -72129595)
2012,Enero,Estados Unidos de América,1,9,,10,POINT (125744111 -81703935)
2012,Enero,Estados Unidos de América,8,27,,35,POINT (125862 -81702165)
2012,Enero,Estados Unidos de América,4,6,,10,POINT (133387613 -81372937)
2012,Enero,Estados Unidos de América,504,931,,1435,POINT (3451668 -76532004)
2012,Enero,Estados Unidos de América,49,101,,150,POINT (445285 -75766353)
2012,Enero,Estados Unidos de América,4376,9251,,13627,POINT (4697157 -74140516)
2012,Enero,Estados Unidos de América,61,96,,157,POINT (4815189 -75736374)
2012,Enero,Estados Unidos de América,748,1921,,2669,POINT (6170465 -7542726)
2012,Enero,Estados Unidos de América,0,1,,1,POINT (6222552 -77401154)
2012,Enero,Estados Unidos de América,1,0,,1,POINT (7088729 -70740253)
2012,Enero,Estados Unidos de América,25,39,,64,POINT (7128047 -73181317)
2012,Enero,Estados Unidos de América,38,73,,111,POINT (7819 -72453013)
2012,Enero,Estados Unidos de América,17,30,,47,POINT (7927233 -72508188)
2012,Enero,Estados Unidos de América,9,21,,30,POINT (863337 -7735002)
2012,Enero,Estonia,1,1,,2,POINT (10406342 -75527794)
2012,Enero,Estonia,3,5,,8,POINT (10446304 -75516486)
2012,Enero,Estonia,0,1,,1,POINT (3451668 -76532004)
2012,Enero,Estonia,6,7,,13,POINT (4697157 -74140516)
2012,Enero,Etiopia,0,2,,2,POINT (4697157 -74140516)
2012,Enero,Filipinas,1,40,,41,POINT (10406342 -75527794)
2012,Enero,Filipinas,2,6,,8,POINT (10446304 -75516486)
2012,Enero,Filipinas,0,6,,6,POINT (10886686 -74776479)
2012,Enero,Filipinas,0,3,,3,POINT (11247723 -74213989)
2012,Enero,Filipinas,0,1,,1,POINT (3451668 -76532004)
2012,Enero,Filipinas,0,17,,17,POINT (3884426 -77061029)
2012,Enero,Filipinas,19,69,,88,POINT (4697157 -74140516)
2012,Enero,Filipinas,5,3,,8,POINT (6170465 -7542726)
2012,Enero,Filipinas,0,1,,1,POINT (7927233 -72508188)
2012,Enero,Filipinas,1,0,,1,POINT (863337 -7735002)
2012,Enero,Finlandia,1,1,,2,POINT (-4191162 -69941498)
2012,Enero,Finlandia,5,8,,13,POINT (0.81488 -77356)
2012,Enero,Finlandia,1,1,,2,POINT (10406342 -75527794)
2012,Enero,Finlandia,214,186,,400,POINT (10446304 -75516486)
2012,Enero,Finlandia,0,4,,4,POINT (11360029 -72129595)
2012,Enero,Finlandia,0,1,,1,POINT (3451668 -76532004)
2012,Enero,Finlandia,48,85,,133,POINT (4697157 -74140516)
2012,Enero,Finlandia,0,1,,1,POINT (6170465 -7542726)
2012,Enero,Finlandia,0,2,,2,POINT (7819 -72453013)
2012,Enero,Finlandia,1,0,,1,POINT (863337 -7735002)
2012,Enero,Francia,4,11,,15,POINT (-4191162 -69941498)
2012,Enero,Francia,34,73,,107,POINT (0.81488 -77356)
2012,Enero,Francia,7,21,,28,POINT (10406342 -75527794)
2012,Enero,Francia,22,41,,63,POINT (10446304 -75516486)
2012,Enero,Francia,2,7,,9,POINT (10886686 -74776479)
2012,Enero,Francia,3,5,,8,POINT (11247723 -74213989)
2012,Enero,Francia,21,29,,50,POINT (11360029 -72129595)
2012,Enero,Francia,5,4,,9,POINT (125862 -81702165)
2012,Enero,Francia,4,2,,6,POINT (133387613 -81372937)
2012,Enero,Francia,43,80,,123,POINT (3451668 -76532004)
2012,Enero,Francia,0,1,,1,POINT (445285 -75766353)
2012,Enero,Francia,1135,1758,,2893,POINT (4697157 -74140516)
2012,Enero,Francia,3,3,,6,POINT (4815189 -75736374)
2012,Enero,Francia,14,38,,52,POINT (6170465 -7542726)
2012,Enero,Francia,0,1,,1,POINT (7088729 -70740253)
2012,Enero,Francia,1,2,,3,POINT (7128047 -73181317)
2012,Enero,Francia,14,28,,42,POINT (7819 -72453013)
2012,Enero,Francia,1,1,,2,POINT (7927233 -72508188)
2012,Enero,Francia,6,12,,18,POINT (863337 -7735002)
2012,Enero,Gabón,0,1,,1,POINT (4697157 -74140516)
2012,Enero,Georgia,1,0,,1,POINT (4697157 -74140516)
2012,Enero,Ghana,0,1,,1,POINT (11360029 -72129595)
2012,Enero,Ghana,0,2,,2,POINT (4697157 -74140516)
2012,Enero,Ghana,0,2,,2,POINT (7927233 -72508188)
2012,Enero,Granada,0,1,,1,POINT (4697157 -74140516)
2012,Enero,Grecia,2,3,,5,POINT (-4191162 -69941498)
2012,Enero,Grecia,0,1,,1,POINT (0.81488 -77356)
2012,Enero,Grecia,0,1,,1,POINT (10406342 -75527794)
2012,Enero,Grecia,0,2,,2,POINT (10446304 -75516486)
2012,Enero,Grecia,0,1,,1,POINT (10886686 -74776479)
2012,Enero,Grecia,0,2,,2,POINT (3451668 -76532004)
2012,Enero,Grecia,10,76,,86,POINT (4697157 -74140516)
2012,Enero,Grecia,0,4,,4,POINT (6170465 -7542726)
2012,Enero,Grecia,1,1,,2,POINT (7819 -72453013)
2012,Enero,Grecia,0,1,,1,POINT (7927233 -72508188)
2012,Enero,Grecia,0,5,,5,POINT (9402597 -75681642)
2012,Enero,Guatemala,0,1,,1,POINT (0.81488 -77356)
2012,Enero,Guatemala,8,15,,23,POINT (10446304 -75516486)
2012,Enero,Guatemala,13,7,,20,POINT (10886686 -74776479)
2012,Enero,Guatemala,0,1,,1,POINT (11360029 -72129595)
2012,Enero,Guatemala,4,5,,9,POINT (125862 -81702165)
2012,Enero,Guatemala,7,35,,42,POINT (3451668 -76532004)
2012,Enero,Guatemala,142,261,,403,POINT (4697157 -74140516)
2012,Enero,Guatemala,2,4,,6,POINT (4815189 -75736374)
2012,Enero,Guatemala,27,62,,89,POINT (6170465 -7542726)
2012,Enero,Guatemala,2,2,,4,POINT (7128047 -73181317)
2012,Enero,Guatemala,2,7,,9,POINT (7819 -72453013)
2012,Enero,Guatemala,1,5,,6,POINT (7927233 -72508188)
2012,Enero,Guatemala,1,0,,1,POINT (863337 -7735002)
2012,Enero,Guyana,1,0,,1,POINT (10446304 -75516486)
2012,Enero,Guyana,2,2,,4,POINT (4697157 -74140516)
2012,Enero,Guinea,1,0,,1,POINT (3451668 -76532004)
2012,Enero,Guinea Ecuatorial,0,1,,1,POINT (4697157 -74140516)
2012,Enero,Guayana Francesa/Departamento de Ultramar Francés,0,1,,1,POINT (4697157 -74140516)
2012,Enero,Haití,2,1,,3,POINT (10446304 -75516486)
2012,Enero,Haití,5,16,,21,POINT (4697157 -74140516)
2012,Enero,Haití,0,7,,7,POINT (6170465 -7542726)
2012,Enero,Honduras,1,0,,1,POINT (0.81488 -77356)
2012,Enero,Honduras,0,1,,1,POINT (10406342 -75527794)
2012,Enero,Honduras,1,14,,15,POINT (10446304 -75516486)
2012,Enero,Honduras,4,8,,12,POINT (10886686 -74776479)
2012,Enero,Honduras,0,10,,10,POINT (125744111 -81703935)
2012,Enero,Honduras,9,11,,20,POINT (3451668 -76532004)
2012,Enero,Honduras,1,0,,1,POINT (445285 -75766353)
2012,Enero,Honduras,96,141,,237,POINT (4697157 -74140516)
2012,Enero,Honduras,0,1,,1,POINT (4815189 -75736374)
2012,Enero,Honduras,14,27,,41,POINT (6170465 -7542726)
2012,Enero,Honduras,0,3,,3,POINT (7128047 -73181317)
2012,Enero,Honduras,1,2,,3,POINT (7819 -72453013)
2012,Enero,Honduras,0,1,,1,POINT (7927233 -72508188)
2012,Enero,Hungría,0,2,,2,POINT (0.81488 -77356)
2012,Enero,Hungría,2,1,,3,POINT (10446304 -75516486)
2012,Enero,Hungría,0,2,,2,POINT (11247723 -74213989)
2012,Enero,Hungría,0,1,,1,POINT (125862 -81702165)
2012,Enero,Hungría,1,1,,2,POINT (3451668 -76532004)
2012,Enero,Hungría,39,50,,89,POINT (4697157 -74140516)
2012,Enero,Hungría,0,1,,1,POINT (6170465 -7542726)
2012,Enero,Hungría,0,1,,1,POINT (7819 -72453013)
2012,Enero,Hungría,1,0,,1,POINT (863337 -7735002)
2012,Enero,India,8,1,,9,POINT (0.81488 -77356)
2012,Enero,India,0,1,,1,POINT (10406342 -75527794)
2012,Enero,India,2,3,,5,POINT (10446304 -75516486)
2012,Enero,India,0,3,,3,POINT (10886686 -74776479)
2012,Enero,India,0,1,,1,POINT (11247723 -74213989)
2012,Enero,India,0,1,,1,POINT (125862 -81702165)
2012,Enero,India,2,13,,15,POINT (3451668 -76532004)
2012,Enero,India,0,5,,5,POINT (3884426 -77061029)
2012,Enero,India,26,187,,213,POINT (4697157 -74140516)
2012,Enero,India,0,1,,1,POINT (4815189 -75736374)
2012,Enero,India,3,23,,26,POINT (6170465 -7542726)
2012,Enero,Indonesia,0,2,,2,POINT (10406342 -75527794)
2012,Enero,Indonesia,0,1,,1,POINT (10446304 -75516486)
2012,Enero,Indonesia,17,13,,30,POINT (4697157 -74140516)
2012,Enero,Irán,3,13,,16,POINT (4697157 -74140516)
2012,Enero,Irán,0,1,,1,POINT (7819 -72453013)
2012,Enero,República de Irlanda,2,4,,6,POINT (-4191162 -69941498)
2012,Enero,República de Irlanda,9,20,,29,POINT (0.81488 -77356)
2012,Enero,República de Irlanda,1,7,,8,POINT (10446304 -75516486)
2012,Enero,República de Irlanda,0,3,,3,POINT (11360029 -72129595)
2012,Enero,República de Irlanda,0,3,,3,POINT (3451668 -76532004)
2012,Enero,República de Irlanda,0,1,,1,POINT (3884426 -77061029)
2012,Enero,República de Irlanda,44,100,,144,POINT (4697157 -74140516)
2012,Enero,República de Irlanda,6,17,,23,POINT (6170465 -7542726)
2012,Enero,República de Irlanda,0,2,,2,POINT (7819 -72453013)
2012,Enero,República de Irlanda,1,5,,6,POINT (863337 -7735002)
2012,Enero,Islandia,0,1,,1,POINT (0.81488 -77356)
2012,Enero,Islandia,0,1,,1,POINT (3451668 -76532004)
2012,Enero,Islandia,9,4,,13,POINT (4697157 -74140516)
2012,Enero,Isla de Man,21,45,,66,POINT (0.81488 -77356)
2012,Enero,Isla de Man,1,6,,7,POINT (10446304 -75516486)
2012,Enero,Isla de Man,6,11,,17,POINT (10886686 -74776479)
2012,Enero,Isla de Man,1,0,,1,POINT (11360029 -72129595)
2012,Enero,Isla de Man,12,13,,25,POINT (3451668 -76532004)
2012,Enero,Isla de Man,40,111,,151,POINT (4697157 -74140516)
2012,Enero,Isla de Man,6,15,,21,POINT (6170465 -7542726)
2012,Enero,Isla de Man,0,2,,2,POINT (7819 -72453013)
2012,Enero,Isla de Man,1,3,,4,POINT (7927233 -72508188)
2012,Enero,Isla Johnston,0,1,,1,POINT (10886686 -74776479)
2012,Enero,Isla Johnston,0,1,,1,POINT (4697157 -74140516)
2012,Enero,Israel,17,11,,28,POINT (-4191162 -69941498)
2012,Enero,Israel,6,11,,17,POINT (0.81488 -77356)
2012,Enero,Israel,1,21,,22,POINT (10446304 -75516486)
2012,Enero,Israel,0,5,,5,POINT (10886686 -74776479)
2012,Enero,Israel,0,3,,3,POINT (125862 -81702165)
2012,Enero,Israel,4,8,,12,POINT (3451668 -76532004)
2012,Enero,Israel,69,371,,440,POINT (4697157 -74140516)
2012,Enero,Israel,2,29,,31,POINT (6170465 -7542726)
2012,Enero,Islas Aland/Provincia de Finlandia,1,0,,1,POINT (4697157 -74140516)
2012,Enero,Isla Wake,0,1,,1,POINT (3451668 -76532004)
2012,Enero,Italia,1,5,,6,POINT (-4191162 -69941498)
2012,Enero,Italia,1,1,,2,POINT (0.33002 -76876446)
2012,Enero,Italia,11,32,,43,POINT (0.81488 -77356)
2012,Enero,Italia,6,20,,26,POINT (10406342 -75527794)
2012,Enero,Italia,27,96,,123,POINT (10446304 -75516486)
2012,Enero,Italia,0,14,,14,POINT (10886686 -74776479)
2012,Enero,Italia,1,3,,4,POINT (11247723 -74213989)
2012,Enero,Italia,5,19,,24,POINT (11360029 -72129595)
2012,Enero,Italia,8,16,,24,POINT (125862 -81702165)
2012,Enero,Italia,26,89,,115,POINT (3451668 -76532004)
2012,Enero,Italia,598,1976,,2574,POINT (4697157 -74140516)
2012,Enero,Italia,0,4,,4,POINT (4815189 -75736374)
2012,Enero,Italia,32,102,,134,POINT (6170465 -7542726)
2012,Enero,Italia,0,1,,1,POINT (7088729 -70740253)
2012,Enero,Italia,1,3,,4,POINT (7128047 -73181317)
2012,Enero,Italia,6,31,,37,POINT (7819 -72453013)
2012,Enero,Italia,1,14,,15,POINT (7927233 -72508188)
2012,Enero,Italia,2,5,,7,POINT (863337 -7735002)
2012,Enero,Islas del Canal,0,1,,1,POINT (4697157 -74140516)
2012,Enero,Jamaica,3,1,,4,POINT (10446304 -75516486)
2012,Enero,Jamaica,1,1,,2,POINT (10886686 -74776479)
2012,Enero,Jamaica,0,1,,1,POINT (125862 -81702165)
2012,Enero,Jamaica,2,2,,4,POINT (3451668 -76532004)
2012,Enero,Jamaica,15,16,,31,POINT (4697157 -74140516)
2012,Enero,Jamaica,1,2,,3,POINT (6170465 -7542726)
2012,Enero,Jamaica,0,1,,1,POINT (7819 -72453013)
2012,Enero,Islas Marianas del Norte,0,1,,1,POINT (4697157 -74140516)
2012,Enero,Japón,0,2,,2,POINT (-4191162 -69941498)
2012,Enero,Japón,3,7,,10,POINT (0.81488 -77356)
2012,Enero,Japón,1,2,,3,POINT (10406342 -75527794)
2012,Enero,Japón,1,7,,8,POINT (10446304 -75516486)
2012,Enero,Japón,6,10,,16,POINT (3451668 -76532004)
2012,Enero,Japón,133,426,,559,POINT (4697157 -74140516)
2012,Enero,Japón,3,26,,29,POINT (6170465 -7542726)
2012,Enero,Japón,3,9,,12,POINT (7819 -72453013)
2012,Enero,Japón,0,1,,1,POINT (7927233 -72508188)
2012,Enero,Japón,0,3,,3,POINT (863337 -7735002)
2012,Enero,Jordania,0,1,,1,POINT (0.81488 -77356)
2012,Enero,Jordania,1,0,,1,POINT (4697157 -74140516)
2012,Enero,Kazajistán,1,1,,2,POINT (4697157 -74140516)
2012,Enero,Kenia,0,1,,1,POINT (0.81488 -77356)
2012,Enero,Kenia,7,13,,20,POINT (4697157 -74140516)
2012,Enero,Kuwait,0,1,,1,POINT (4697157 -74140516)
2012,Enero,Letonia,2,0,,2,POINT (0.81488 -77356)
2012,Enero,Letonia,10,8,,18,POINT (4697157 -74140516)
2012,Enero,Lituania,1,0,,1,POINT (10446304 -75516486)
2012,Enero,Lituania,1,0,,1,POINT (11360029 -72129595)
2012,Enero,Lituania,2,1,,3,POINT (3451668 -76532004)
2012,Enero,Lituania,3,7,,10,POINT (4697157 -74140516)
2012,Enero,Líbano,1,0,,1,POINT (10446304 -75516486)
2012,Enero,Líbano,3,7,,10,POINT (10886686 -74776479)
2012,Enero,Líbano,1,5,,6,POINT (11360029 -72129595)
2012,Enero,Líbano,0,1,,1,POINT (3451668 -76532004)
2012,Enero,Líbano,9,26,,35,POINT (4697157 -74140516)
2012,Enero,Libia,0,1,,1,POINT (6170465 -7542726)
2012,Enero,Liechtenstein,0,1,,1,POINT (0.81488 -77356)
2012,Enero,Liechtenstein,0,1,,1,POINT (3451668 -76532004)
2012,Enero,Liechtenstein,1,2,,3,POINT (4697157 -74140516)
2012,Enero,Luxemburgo,1,9,,10,POINT (4697157 -74140516)
2012,Enero,Macedonia,0,1,,1,POINT (4697157 -74140516)
2012,Enero,Malasia,3,2,,5,POINT (10446304 -75516486)
2012,Enero,Malasia,0,1,,1,POINT (3451668 -76532004)
2012,Enero,Malasia,9,13,,22,POINT (4697157 -74140516)
2012,Enero,Malasia,1,1,,2,POINT (6170465 -7542726)
2012,Enero,Malta,2,0,,2,POINT (0.81488 -77356)
2012,Enero,Malta,0,3,,3,POINT (6170465 -7542726)
2012,Enero,Marruecos,2,6,,8,POINT (4697157 -74140516)
2012,Enero,Mauricio,1,2,,3,POINT (4697157 -74140516)
2012,Enero,México,0,1,,1,POINT (-4191162 -69941498)
2012,Enero,México,14,16,,30,POINT (0.81488 -77356)
2012,Enero,México,9,11,,20,POINT (10406342 -75527794)
2012,Enero,México,55,95,,150,POINT (10446304 -75516486)
2012,Enero,México,19,32,,51,POINT (10886686 -74776479)
2012,Enero,México,3,6,,9,POINT (11360029 -72129595)
2012,Enero,México,0,4,,4,POINT (125744111 -81703935)
2012,Enero,México,0,2,,2,POINT (125862 -81702165)
2012,Enero,México,42,105,,147,POINT (3451668 -76532004)
2012,Enero,México,1699,3555,,5254,POINT (4697157 -74140516)
2012,Enero,México,2,17,,19,POINT (4815189 -75736374)
2012,Enero,México,84,272,,356,POINT (6170465 -7542726)
2012,Enero,México,0,1,,1,POINT (6185536 -67484028)
2012,Enero,México,2,2,,4,POINT (7128047 -73181317)
2012,Enero,México,25,56,,81,POINT (7819 -72453013)
2012,Enero,México,3,20,,23,POINT (7927233 -72508188)
2012,Enero,México,2,2,,4,POINT (863337 -7735002)
2012,Enero,República de Moldavia,1,0,,1,POINT (10446304 -75516486)
2012,Enero,República de Moldavia,2,0,,2,POINT (4697157 -74140516)
2012,Enero,Mónaco,1,0,,1,POINT (0.81488 -77356)
2012,Enero,Mónaco,0,1,,1,POINT (4697157 -74140516)
2012,Enero,Myanmar,1,0,,1,POINT (4697157 -74140516)
2012,Enero,Namibia,0,1,,1,POINT (4697157 -74140516)
2012,Enero,Nepal,0,1,,1,POINT (10446304 -75516486)
2012,Enero,Nepal,0,3,,3,POINT (4697157 -74140516)
2012,Enero,Nicaragua,2,2,,4,POINT (10446304 -75516486)
2012,Enero,Nicaragua,0,2,,2,POINT (10886686 -74776479)
2012,Enero,Nicaragua,0,2,,2,POINT (125744111 -81703935)
2012,Enero,Nicaragua,1,1,,2,POINT (125862 -81702165)
2012,Enero,Nicaragua,10,4,,14,POINT (3451668 -76532004)
2012,Enero,Nicaragua,42,55,,97,POINT (4697157 -74140516)
2012,Enero,Nicaragua,0,1,,1,POINT (4815189 -75736374)
2012,Enero,Nicaragua,4,7,,11,POINT (6170465 -7542726)
2012,Enero,Nicaragua,0,1,,1,POINT (7128047 -73181317)
2012,Enero,Nigeria,0,1,,1,POINT (10446304 -75516486)
2012,Enero,Nigeria,0,2,,2,POINT (3451668 -76532004)
2012,Enero,Nigeria,2,10,,12,POINT (4697157 -74140516)
2012,Enero,Nigeria,0,2,,2,POINT (6170465 -7542726)
2012,Enero,Noruega,1,0,,1,POINT (-4191162 -69941498)
2012,Enero,Noruega,3,2,,5,POINT (0.81488 -77356)
2012,Enero,Noruega,1,2,,3,POINT (10406342 -75527794)
2012,Enero,Noruega,4,11,,15,POINT (10446304 -75516486)
2012,Enero,Noruega,0,4,,4,POINT (10886686 -74776479)
2012,Enero,Noruega,5,4,,9,POINT (11247723 -74213989)
2012,Enero,Noruega,1,2,,3,POINT (11360029 -72129595)
2012,Enero,Noruega,7,6,,13,POINT (3451668 -76532004)
2012,Enero,Noruega,59,138,,197,POINT (4697157 -74140516)
2012,Enero,Noruega,4,8,,12,POINT (6170465 -7542726)
2012,Enero,Noruega,1,0,,1,POINT (7128047 -73181317)
2012,Enero,Noruega,1,2,,3,POINT (7819 -72453013)
2012,Enero,Noruega,2,3,,5,POINT (863337 -7735002)
2012,Enero,Nueva Zelanda,1,2,,3,POINT (-4191162 -69941498)
2012,Enero,Nueva Zelanda,4,6,,10,POINT (0.81488 -77356)
2012,Enero,Nueva Zelanda,4,9,,13,POINT (10446304 -75516486)
2012,Enero,Nueva Zelanda,0,1,,1,POINT (10886686 -74776479)
2012,Enero,Nueva Zelanda,3,1,,4,POINT (3451668 -76532004)
2012,Enero,Nueva Zelanda,24,40,,64,POINT (4697157 -74140516)
2012,Enero,Nueva Zelanda,0,1,,1,POINT (4815189 -75736374)
2012,Enero,Nueva Zelanda,4,9,,13,POINT (6170465 -7542726)
2012,Enero,Nueva Zelanda,0,1,,1,POINT (7819 -72453013)
2012,Enero,Nueva Zelanda,0,1,,1,POINT (863337 -7735002)
2012,Enero,Nueva Zelanda,4,8,,12,POINT (10406342 -75527794)
2012,Enero,Nueva Zelanda,1,0,,1,POINT (10446304 -75516486)
2012,Enero,Nueva Zelanda,0,4,,4,POINT (4697157 -74140516)
2012,Enero,Nueva Zelanda,2,3,,5,POINT (863337 -7735002)
2012,Enero,Países Bajos,23,29,,52,POINT (0.81488 -77356)
2012,Enero,Países Bajos,2,14,,16,POINT (10446304 -75516486)
2012,Enero,Países Bajos,1,7,,8,POINT (10886686 -74776479)
2012,Enero,Países Bajos,1,7,,8,POINT (11360029 -72129595)
2012,Enero,Países Bajos,14,28,,42,POINT (1152863 -72919186)
2012,Enero,Países Bajos,7,14,,21,POINT (3451668 -76532004)
2012,Enero,Países Bajos,122,198,,320,POINT (4697157 -74140516)
2012,Enero,Países Bajos,150,173,,323,POINT (6170465 -7542726)
2012,Enero,Países Bajos,0,1,,1,POINT (7927233 -72508188)
2012,Enero,Pakistán,1,0,,1,POINT (10446304 -75516486)
2012,Enero,Pakistán,0,1,,1,POINT (3451668 -76532004)
2012,Enero,Pakistán,0,17,,17,POINT (4697157 -74140516)
2012,Enero,Pakistán,0,1,,1,POINT (6170465 -7542726)
2012,Enero,Panamá,0,2,,2,POINT (0.81488 -77356)
2012,Enero,Panamá,0,3,,3,POINT (10406342 -75527794)
2012,Enero,Panamá,106,149,,255,POINT (10446304 -75516486)
2012,Enero,Panamá,61,93,,154,POINT (10886686 -74776479)
2012,Enero,Panamá,0,1,,1,POINT (10970933 -74765343)
2012,Enero,Panamá,1,3,,4,POINT (11360029 -72129595)
2012,Enero,Panamá,0,4,,4,POINT (125744111 -81703935)
2012,Enero,Panamá,43,37,,80,POINT (125862 -81702165)
2012,Enero,Panamá,85,118,,203,POINT (3451668 -76532004)
2012,Enero,Panamá,0,1,,1,POINT (445285 -75766353)
2012,Enero,Panamá,469,681,,1150,POINT (4697157 -74140516)
2012,Enero,Panamá,49,76,,125,POINT (4815189 -75736374)
2012,Enero,Panamá,127,224,,351,POINT (6170465 -7542726)
2012,Enero,Panamá,2,1,,3,POINT (6222552 -77401154)
2012,Enero,Panamá,10,5,,15,POINT (7128047 -73181317)
2012,Enero,Panamá,5,15,,20,POINT (7819 -72453013)
2012,Enero,Panamá,6,10,,16,POINT (7927233 -72508188)
2012,Enero,Panamá,6,7,,13,POINT (863337 -7735002)
2012,Enero,Paraguay,2,2,,4,POINT (0.81488 -77356)
2012,Enero,Paraguay,4,9,,13,POINT (10446304 -75516486)
2012,Enero,Paraguay,1,0,,1,POINT (11360029 -72129595)
2012,Enero,Paraguay,15,5,,20,POINT (125862 -81702165)
2012,Enero,Paraguay,8,5,,13,POINT (3451668 -76532004)
2012,Enero,Paraguay,81,100,,181,POINT (4697157 -74140516)
2012,Enero,Paraguay,0,4,,4,POINT (6170465 -7542726)
2012,Enero,Paraguay,0,2,,2,POINT (7819 -72453013)
2012,Enero,Perú,28,21,,49,POINT (-4191162 -69941498)
2012,Enero,Perú,0,2,,2,POINT (0.33002 -76876446)
2012,Enero,Perú,288,499,,787,POINT (0.81488 -77356)
2012,Enero,Perú,0,2,,2,POINT (1800143 -78802679)
2012,Enero,Perú,17,24,,41,POINT (10406342 -75527794)
2012,Enero,Perú,120,108,,228,POINT (10446304 -75516486)
2012,Enero,Perú,13,18,,31,POINT (10886686 -74776479)
2012,Enero,Perú,2,12,,14,POINT (11360029 -72129595)
2012,Enero,Perú,149,123,,272,POINT (125862 -81702165)
2012,Enero,Perú,83,124,,207,POINT (3451668 -76532004)
2012,Enero,Perú,1672,2545,,4217,POINT (4697157 -74140516)
2012,Enero,Perú,4,4,,8,POINT (4815189 -75736374)
2012,Enero,Perú,182,358,,540,POINT (6170465 -7542726)
2012,Enero,Perú,0,1,,1,POINT (7088729 -70740253)
2012,Enero,Perú,1,4,,5,POINT (7128047 -73181317)
2012,Enero,Perú,66,108,,174,POINT (7819 -72453013)
2012,Enero,Perú,2,1,,3,POINT (7927233 -72508188)
2012,Enero,Palestina,1,0,,1,POINT (0.81488 -77356)
2012,Enero,Palestina,1,3,,4,POINT (4697157 -74140516)
2012,Enero,Polonia,0,4,,4,POINT (-4191162 -69941498)
2012,Enero,Polonia,2,7,,9,POINT (0.81488 -77356)
2012,Enero,Polonia,2,7,,9,POINT (10406342 -75527794)
2012,Enero,Polonia,8,12,,20,POINT (10446304 -75516486)
2012,Enero,Polonia,1,2,,3,POINT (10886686 -74776479)
2012,Enero,Polonia,0,2,,2,POINT (10970933 -74765343)
2012,Enero,Polonia,0,1,,1,POINT (11247723 -74213989)
2012,Enero,Polonia,0,2,,2,POINT (11360029 -72129595)
2012,Enero,Polonia,4,3,,7,POINT (3451668 -76532004)
2012,Enero,Polonia,86,123,,209,POINT (4697157 -74140516)
2012,Enero,Polonia,0,1,,1,POINT (4815189 -75736374)
2012,Enero,Polonia,2,2,,4,POINT (6170465 -7542726)
2012,Enero,Polonia,3,1,,4,POINT (7819 -72453013)
2012,Enero,Polonia,2,0,,2,POINT (863337 -7735002)
2012,Enero,Portugal,1,3,,4,POINT (0.81488 -77356)
2012,Enero,Portugal,1,4,,5,POINT (10406342 -75527794)
2012,Enero,Portugal,1,1,,2,POINT (10446304 -75516486)
2012,Enero,Portugal,4,7,,11,POINT (11360029 -72129595)
2012,Enero,Portugal,0,1,,1,POINT (125862 -81702165)
2012,Enero,Portugal,0,8,,8,POINT (3451668 -76532004)
2012,Enero,Portugal,82,241,,323,POINT (4697157 -74140516)
2012,Enero,Portugal,5,23,,28,POINT (6170465 -7542726)
2012,Enero,Portugal,2,6,,8,POINT (7819 -72453013)
2012,Enero,Portugal,0,1,,1,POINT (863337 -7735002)
2012,Enero,Puerto Rico/Territorio de Estados Unidos,0,1,,1,POINT (10446304 -75516486)
2012,Enero,Reino Unido de Gran Bretaña e Irlanda del Norte,4,9,,13,POINT (-4191162 -69941498)
2012,Enero,Reino Unido de Gran Bretaña e Irlanda del Norte,1,19,,20,POINT (0.81488 -77356)
2012,Enero,Reino Unido de Gran Bretaña e Irlanda del Norte,25,35,,60,POINT (10446304 -75516486)
2012,Enero,Reino Unido de Gran Bretaña e Irlanda del Norte,0,1,,1,POINT (10886686 -74776479)
2012,Enero,Reino Unido de Gran Bretaña e Irlanda del Norte,2,6,,8,POINT (11360029 -72129595)
2012,Enero,Reino Unido de Gran Bretaña e Irlanda del Norte,1,1,,2,POINT (1152863 -72919186)
2012,Enero,Reino Unido de Gran Bretaña e Irlanda del Norte,6,20,,26,POINT (3451668 -76532004)
2012,Enero,Reino Unido de Gran Bretaña e Irlanda del Norte,182,432,,614,POINT (4697157 -74140516)
2012,Enero,Reino Unido de Gran Bretaña e Irlanda del Norte,9,20,,29,POINT (6170465 -7542726)
2012,Enero,Reino Unido de Gran Bretaña e Irlanda del Norte,1,7,,8,POINT (7819 -72453013)
2012,Enero,Reino Unido de Gran Bretaña e Irlanda del Norte,1,2,,3,POINT (863337 -7735002)
2012,Enero,República de Belarús,4,3,,7,POINT (4697157 -74140516)
2012,Enero,República Dominicana,0,4,,4,POINT (0.81488 -77356)
2012,Enero,República Dominicana,0,7,,7,POINT (10406342 -75527794)
2012,Enero,República Dominicana,13,45,,58,POINT (10446304 -75516486)
2012,Enero,República Dominicana,5,39,,44,POINT (10886686 -74776479)
2012,Enero,República Dominicana,1,5,,6,POINT (11360029 -72129595)
2012,Enero,República Dominicana,23,17,,40,POINT (3451668 -76532004)
2012,Enero,República Dominicana,0,1,,1,POINT (445285 -75766353)
2012,Enero,República Dominicana,154,234,,388,POINT (4697157 -74140516)
2012,Enero,República Dominicana,2,2,,4,POINT (4815189 -75736374)
2012,Enero,República Dominicana,30,49,,79,POINT (6170465 -7542726)
2012,Enero,República Dominicana,0,1,,1,POINT (7088729 -70740253)
2012,Enero,República Dominicana,5,5,,10,POINT (7128047 -73181317)
2012,Enero,República Dominicana,0,4,,4,POINT (7819 -72453013)
2012,Enero,República Dominicana,4,17,,21,POINT (7927233 -72508188)
2012,Enero,República Checa,0,1,,1,POINT (10406342 -75527794)
2012,Enero,República Checa,6,7,,13,POINT (4697157 -74140516)
2012,Enero,República Checa,0,1,,1,POINT (6222552 -77401154)
2012,Enero,República Checa,1,0,,1,POINT (7819 -72453013)
2012,Enero,República Democrática Popular de Corea,1,1,,2,POINT (4697157 -74140516)
2012,Enero,Rumania,0,2,,2,POINT (0.81488 -77356)
2012,Enero,Rumania,0,2,,2,POINT (10406342 -75527794)
2012,Enero,Rumania,2,5,,7,POINT (10446304 -75516486)
2012,Enero,Rumania,0,1,,1,POINT (11360029 -72129595)
2012,Enero,Rumania,4,1,,5,POINT (3451668 -76532004)
2012,Enero,Rumania,25,49,,74,POINT (4697157 -74140516)
2012,Enero,Rumania,0,1,,1,POINT (4815189 -75736374)
2012,Enero,Rumania,0,2,,2,POINT (6170465 -7542726)
2012,Enero,Rumania,0,2,,2,POINT (863337 -7735002)
2012,Enero,Federación de Rusia,2,11,,13,POINT (0.81488 -77356)
2012,Enero,Federación de Rusia,5,6,,11,POINT (10446304 -75516486)
2012,Enero,Federación de Rusia,1,1,,2,POINT (11360029 -72129595)
2012,Enero,Federación de Rusia,5,6,,11,POINT (3451668 -76532004)
2012,Enero,Federación de Rusia,0,2,,2,POINT (3884426 -77061029)
2012,Enero,Federación de Rusia,112,135,,247,POINT (4697157 -74140516)
2012,Enero,Federación de Rusia,1,0,,1,POINT (4815189 -75736374)
2012,Enero,Federación de Rusia,2,4,,6,POINT (6170465 -7542726)
2012,Enero,Federación de Rusia,1,0,,1,POINT (7128047 -73181317)
2012,Enero,Rwanda,1,1,,2,POINT (4697157 -74140516)
2012,Enero,San Marino,0,1,,1,POINT (-4191162 -69941498)
2012,Enero,San Marino,0,2,,2,POINT (4697157 -74140516)
2012,Enero,San  Vicente y las Granadinas,0,1,,1,POINT (10446304 -75516486)
2012,Enero,San  Vicente y las Granadinas,0,1,,1,POINT (125862 -81702165)
2012,Enero,Santa Lucia,1,0,,1,POINT (10446304 -75516486)
2012,Enero,Santa Lucia,0,2,,2,POINT (4697157 -74140516)
2012,Enero,Santa Lucia,1,1,,2,POINT (7128047 -73181317)
2012,Enero,Santa Sede/Ciudad del Vaticano,0,2,,2,POINT (4697157 -74140516)
2012,Enero,Santo Tomé y Príncipe,0,1,,1,POINT (-4191162 -69941498)
2012,Enero,Senegal,1,0,,1,POINT (4697157 -74140516)
2012,Enero,Serbia,0,1,,1,POINT (0.81488 -77356)
2012,Enero,Serbia,0,2,,2,POINT (10446304 -75516486)
2012,Enero,Serbia,2,4,,6,POINT (4697157 -74140516)
2012,Enero,Sierra Leona,0,1,,1,POINT (4697157 -74140516)
2012,Enero,Singapur,0,1,,1,POINT (0.81488 -77356)
2012,Enero,Singapur,0,2,,2,POINT (10446304 -75516486)
2012,Enero,Singapur,9,12,,21,POINT (4697157 -74140516)
2012,Enero,Singapur,0,1,,1,POINT (6170465 -7542726)
2012,Enero,República Árabe Siria,1,4,,5,POINT (4697157 -74140516)
2012,Enero,República Árabe Siria,0,1,,1,POINT (6170465 -7542726)
2012,Enero,Sri Lanka,0,2,,2,POINT (4697157 -74140516)
2012,Enero,Sudáfrica,0,2,,2,POINT (0.81488 -77356)
2012,Enero,Sudáfrica,0,1,,1,POINT (10406342 -75527794)
2012,Enero,Sudáfrica,0,3,,3,POINT (10886686 -74776479)
2012,Enero,Sudáfrica,0,1,,1,POINT (3451668 -76532004)
2012,Enero,Sudáfrica,29,75,,104,POINT (4697157 -74140516)
2012,Enero,Sudáfrica,1,1,,2,POINT (6170465 -7542726)
2012,Enero,Sudáfrica,0,1,,1,POINT (863337 -7735002)
2012,Enero,Sudán,2,2,,4,POINT (4697157 -74140516)
2012,Enero,Suecia,1,4,,5,POINT (-4191162 -69941498)
2012,Enero,Suecia,9,10,,19,POINT (0.81488 -77356)
2012,Enero,Suecia,4,10,,14,POINT (10406342 -75527794)
2012,Enero,Suecia,12,22,,34,POINT (10446304 -75516486)
2012,Enero,Suecia,0,1,,1,POINT (10886686 -74776479)
2012,Enero,Suecia,2,8,,10,POINT (11360029 -72129595)
2012,Enero,Suecia,12,13,,25,POINT (3451668 -76532004)
2012,Enero,Suecia,191,298,,489,POINT (4697157 -74140516)
2012,Enero,Suecia,7,14,,21,POINT (6170465 -7542726)
2012,Enero,Suecia,4,3,,7,POINT (7819 -72453013)
2012,Enero,Suecia,1,0,,1,POINT (7927233 -72508188)
2012,Enero,Suecia,2,6,,8,POINT (863337 -7735002)
2012,Enero,Suiza,1,5,,6,POINT (-4191162 -69941498)
2012,Enero,Suiza,12,30,,42,POINT (0.81488 -77356)
2012,Enero,Suiza,11,16,,27,POINT (10406342 -75527794)
2012,Enero,Suiza,14,18,,32,POINT (10446304 -75516486)
2012,Enero,Suiza,2,7,,9,POINT (10886686 -74776479)
2012,Enero,Suiza,1,2,,3,POINT (11247723 -74213989)
2012,Enero,Suiza,5,9,,14,POINT (11360029 -72129595)
2012,Enero,Suiza,1,1,,2,POINT (125862 -81702165)
2012,Enero,Suiza,18,30,,48,POINT (3451668 -76532004)
2012,Enero,Suiza,317,483,,800,POINT (4697157 -74140516)
2012,Enero,Suiza,20,54,,74,POINT (6170465 -7542726)
2012,Enero,Suiza,1,8,,9,POINT (7819 -72453013)
2012,Enero,Suiza,5,4,,9,POINT (863337 -7735002)
2012,Enero,Surinam,0,3,,3,POINT (3451668 -76532004)
2012,Enero,Surinam,16,14,,30,POINT (4697157 -74140516)
2012,Enero,Surinam,0,3,,3,POINT (6170465 -7542726)
2012,Enero,Taiwán,5,6,,11,POINT (4697157 -74140516)
2012,Enero,Tailandia,4,3,,7,POINT (4697157 -74140516)
2012,Enero,Tailandia,1,0,,1,POINT (6170465 -7542726)
2012,Enero,Territorio Antártico Británico/Territorio Británico de Ultramar,1,7,,8,POINT (4697157 -74140516)
2012,Enero,Tanzania,1,2,,3,POINT (4697157 -74140516)
2012,Enero,República Democrática de Timor Oriental,0,1,,1,POINT (4697157 -74140516)
2012,Enero,Togo,0,1,,1,POINT (4697157 -74140516)
2012,Enero,Trinidad y Tobago,0,7,,7,POINT (10446304 -75516486)
2012,Enero,Trinidad y Tobago,0,3,,3,POINT (10886686 -74776479)
2012,Enero,Trinidad y Tobago,0,1,,1,POINT (11360029 -72129595)
2012,Enero,Trinidad y Tobago,2,4,,6,POINT (3451668 -76532004)
2012,Enero,Trinidad y Tobago,21,37,,58,POINT (4697157 -74140516)
2012,Enero,Trinidad y Tobago,0,1,,1,POINT (4815189 -75736374)
2012,Enero,Trinidad y Tobago,0,3,,3,POINT (6170465 -7542726)
2012,Enero,Trinidad y Tobago,0,3,,3,POINT (7128047 -73181317)
2012,Enero,Trinidad y Tobago,0,1,,1,POINT (7819 -72453013)
2012,Enero,Túnez,0,2,,2,POINT (4697157 -74140516)
2012,Enero,Turquía,3,5,,8,POINT (0.81488 -77356)
2012,Enero,Turquía,0,2,,2,POINT (10406342 -75527794)
2012,Enero,Turquía,1,7,,8,POINT (10446304 -75516486)
2012,Enero,Turquía,1,1,,2,POINT (3451668 -76532004)
2012,Enero,Turquía,16,90,,106,POINT (4697157 -74140516)
2012,Enero,Turquía,5,8,,13,POINT (6170465 -7542726)
2012,Enero,Turquía,0,2,,2,POINT (7819 -72453013)
2012,Enero,Turkmenistán,1,0,,1,POINT (4697157 -74140516)
2012,Enero,Ucrania,0,1,,1,POINT (10406342 -75527794)
2012,Enero,Ucrania,0,1,,1,POINT (3451668 -76532004)
2012,Enero,Ucrania,0,1,,1,POINT (3884426 -77061029)
2012,Enero,Ucrania,30,25,,55,POINT (4697157 -74140516)
2012,Enero,Ucrania,1,1,,2,POINT (6170465 -7542726)
2012,Enero,Ucrania,0,1,,1,POINT (863337 -7735002)
2012,Enero,Uganda,2,7,,9,POINT (4697157 -74140516)
2012,Enero,Federación de Rusia,1,3,,4,POINT (-4191162 -69941498)
2012,Enero,Federación de Rusia,1,0,,1,POINT (10406342 -75527794)
2012,Enero,Federación de Rusia,3,1,,4,POINT (10446304 -75516486)
2012,Enero,Federación de Rusia,1,1,,2,POINT (11360029 -72129595)
2012,Enero,Federación de Rusia,4,0,,4,POINT (125862 -81702165)
2012,Enero,Federación de Rusia,0,1,,1,POINT (3451668 -76532004)
2012,Enero,Federación de Rusia,148,223,,371,POINT (4697157 -74140516)
2012,Enero,Federación de Rusia,1,2,,3,POINT (6170465 -7542726)
2012,Enero,Federación de Rusia,8,8,,16,POINT (7819 -72453013)
2012,Enero,Federación de Rusia,0,1,,1,POINT (9402597 -75681642)
2012,Enero,Uruguay,7,6,,13,POINT (0.81488 -77356)
2012,Enero,Uruguay,3,1,,4,POINT (10406342 -75527794)
2012,Enero,Uruguay,92,58,,150,POINT (10446304 -75516486)
2012,Enero,Uruguay,6,8,,14,POINT (10886686 -74776479)
2012,Enero,Uruguay,1,3,,4,POINT (11360029 -72129595)
2012,Enero,Uruguay,50,43,,93,POINT (125862 -81702165)
2012,Enero,Uruguay,13,20,,33,POINT (3451668 -76532004)
2012,Enero,Uruguay,116,220,,336,POINT (4697157 -74140516)
2012,Enero,Uruguay,0,6,,6,POINT (4815189 -75736374)
2012,Enero,Uruguay,11,28,,39,POINT (6170465 -7542726)
2012,Enero,Uruguay,0,1,,1,POINT (7128047 -73181317)
2012,Enero,Uruguay,1,8,,9,POINT (7819 -72453013)
2012,Enero,Uruguay,1,1,,2,POINT (863337 -7735002)
2012,Enero,Uzbekistán,0,1,,1,POINT (3451668 -76532004)
2012,Enero,Venezuela,297,339,,636,POINT (0.81488 -77356)
2012,Enero,Venezuela,7,12,,19,POINT (10406342 -75527794)
2012,Enero,Venezuela,76,133,,209,POINT (10446304 -75516486)
2012,Enero,Venezuela,55,70,,125,POINT (10886686 -74776479)
2012,Enero,Venezuela,0,4,,4,POINT (11117206 -74232675)
2012,Enero,Venezuela,1265,1721,,2986,POINT (11360029 -72129595)
2012,Enero,Venezuela,1,0,,1,POINT (1152863 -72919186)
2012,Enero,Venezuela,13,13,,26,POINT (125862 -81702165)
2012,Enero,Venezuela,53,58,,111,POINT (3451668 -76532004)
2012,Enero,Venezuela,5306,6178,,11484,POINT (4697157 -74140516)
2012,Enero,Venezuela,7,24,,31,POINT (4815189 -75736374)
2012,Enero,Venezuela,362,421,,783,POINT (6170465 -7542726)
2012,Enero,Venezuela,5,3,,8,POINT (6185536 -67484028)
2012,Enero,Venezuela,67,81,,148,POINT (7088729 -70740253)
2012,Enero,Venezuela,3,1,,4,POINT (7128047 -73181317)
2012,Enero,Venezuela,1767,1997,,3764,POINT (7819 -72453013)
2012,Enero,Venezuela,431,487,,918,POINT (7927233 -72508188)
2012,Enero,Venezuela,1,1,,2,POINT (863337 -7735002)
2012,Enero,Vietnam,1,1,,2,POINT (4697157 -74140516)
2012,Enero,Yugoslavia,1,3,,4,POINT (4697157 -74140516)
2012,Enero,Zimbabue,0,1,,1,POINT (3451668 -76532004)
2012,Enero,Zimbabue,0,1,,1,POINT (4697157 -74140516)
2012,Enero,Reino Unido de Gran Bretaña e Irlanda del Norte,4,12,,16,POINT (0.81488 -77356)
2012,Enero,Reino Unido de Gran Bretaña e Irlanda del Norte,14,29,,43,POINT (10406342 -75527794)
2012,Enero,Reino Unido de Gran Bretaña e Irlanda del Norte,19,34,,53,POINT (10446304 -75516486)
2012,Enero,Reino Unido de Gran Bretaña e Irlanda del Norte,1,2,,3,POINT (10886686 -74776479)
2012,Enero,Reino Unido de Gran Bretaña e Irlanda del Norte,2,3,,5,POINT (11247723 -74213989)
2012,Enero,Reino Unido de Gran Bretaña e Irlanda del Norte,1,4,,5,POINT (11360029 -72129595)
2012,Enero,Reino Unido de Gran Bretaña e Irlanda del Norte,0,1,,1,POINT (133387613 -81372937)
2012,Enero,Reino Unido de Gran Bretaña e Irlanda del Norte,5,24,,29,POINT (3451668 -76532004)
2012,Enero,Reino Unido de Gran Bretaña e Irlanda del Norte,302,742,,1044,POINT (4697157 -74140516)
2012,Enero,Reino Unido de Gran Bretaña e Irlanda del Norte,9,47,,56,POINT (6170465 -7542726)
2012,Enero,Reino Unido de Gran Bretaña e Irlanda del Norte,4,11,,15,POINT (7819 -72453013)
2012,Enero,Reino Unido de Gran Bretaña e Irlanda del Norte,3,4,,7,POINT (863337 -7735002)
2012,Enero,Reino Unido de Gran Bretaña e Irlanda del Norte,0,1,,1,POINT (9402597 -75681642)
2012,Enero,Países Bajos,6,10,,16,POINT (-4191162 -69941498)
2012,Enero,Países Bajos,0,1,,1,POINT (0.33002 -76876446)
2012,Enero,Países Bajos,49,113,,162,POINT (0.81488 -77356)
2012,Enero,Países Bajos,7,11,,18,POINT (10406342 -75527794)
2012,Enero,Países Bajos,10,32,,42,POINT (10446304 -75516486)
2012,Enero,Países Bajos,1,0,,1,POINT (10886686 -74776479)
2012,Enero,Países Bajos,1,1,,2,POINT (11247723 -74213989)
2012,Enero,Países Bajos,2,5,,7,POINT (11360029 -72129595)
2012,Enero,Países Bajos,1,0,,1,POINT (125862 -81702165)
2012,Enero,Países Bajos,8,22,,30,POINT (3451668 -76532004)
2012,Enero,Países Bajos,365,698,,1063,POINT (4697157 -74140516)
2012,Enero,Países Bajos,19,36,,55,POINT (6170465 -7542726)
2012,Enero,Países Bajos,0,2,,2,POINT (7128047 -73181317)
2012,Enero,Países Bajos,3,12,,15,POINT (7819 -72453013)
2012,Enero,Países Bajos,5,2,,7,POINT (863337 -7735002)
2012,Enero,Desconocido,0,1,,1,POINT (4697157 -74140516)
2012,Enero,Eslovenia,2,0,,2,POINT (4697157 -74140516)
2012,Enero,Lituania,0,1,,1,POINT (3451668 -76532004)
2012,Enero,Lituania,0,3,,3,POINT (4697157 -74140516)
2012,Enero,Reino Unido de Gran Bretaña e Irlanda del Norte,2,0,,2,POINT (11247723 -74213989)
2012,Enero,Reino Unido de Gran Bretaña e Irlanda del Norte,0,1,,1,POINT (3451668 -76532004)
2012,Enero,Reino Unido de Gran Bretaña e Irlanda del Norte,0,1,,1,POINT (3451668 -76532004)
2012,Enero,Reino Unido de Gran Bretaña e Irlanda del Norte,2,7,,9,POINT (4697157 -74140516)
2012,Enero,Reino Unido de Gran Bretaña e Irlanda del Norte,3,7,,10,POINT (10406342 -75527794)
2012,Enero,Reino Unido de Gran Bretaña e Irlanda del Norte,0,2,,2,POINT (10446304 -75516486)
2012,Enero,Reino Unido de Gran Bretaña e Irlanda del Norte,0,1,,1,POINT (3451668 -76532004)
2012,Enero,Reino Unido de Gran Bretaña e Irlanda del Norte,0,17,,17,POINT (4697157 -74140516)
2012,Enero,Letonia,1,0,,1,POINT (10446304 -75516486)
2012,Enero,Letonia,0,1,,1,POINT (4697157 -74140516)
2012,Enero,Letonia,0,1,,1,POINT (9402597 -75681642)
2012,Enero,República CentroÁfricana,0,1,,1,POINT (4697157 -74140516)
2012,Febrero,Albania,0,1,,1,POINT (4697157 -74140516)
2012,Febrero,Alemania,10,13,,23,POINT (-4191162 -69941498)
2012,Febrero,Alemania,1,0,,1,POINT (0.33002 -76876446)
2012,Febrero,Alemania,54,80,,134,POINT (0.81488 -77356)
2012,Febrero,Alemania,20,36,,56,POINT (10406342 -75527794)
2012,Febrero,Alemania,26,52,,78,POINT (10446304 -75516486)
2012,Febrero,Alemania,6,15,,21,POINT (10886686 -74776479)
2012,Febrero,Alemania,0,1,,1,POINT (10970933 -74765343)
2012,Febrero,Alemania,1,3,,4,POINT (11247723 -74213989)
2012,Febrero,Alemania,11,18,,29,POINT (11360029 -72129595)
2012,Febrero,Alemania,1,1,,2,POINT (125744111 -81703935)
2012,Febrero,Alemania,4,7,,11,POINT (125862 -81702165)
2012,Febrero,Alemania,2,5,,7,POINT (133387613 -81372937)
2012,Febrero,Alemania,31,60,,91,POINT (3451668 -76532004)
2012,Febrero,Alemania,0,2,,2,POINT (445285 -75766353)
2012,Febrero,Alemania,1259,2083,,3342,POINT (4697157 -74140516)
2012,Febrero,Alemania,38,67,,105,POINT (6170465 -7542726)
2012,Febrero,Alemania,0,1,,1,POINT (7128047 -73181317)
2012,Febrero,Alemania,13,10,,23,POINT (7819 -72453013)
2012,Febrero,Alemania,6,19,,25,POINT (863337 -7735002)
2012,Febrero,Andorra,1,4,,5,POINT (4697157 -74140516)
2012,Febrero,Angola,1,0,,1,POINT (3451668 -76532004)
2012,Febrero,Angola,3,0,,3,POINT (4697157 -74140516)
2012,Febrero,Antigua y Barbuda,0,1,,1,POINT (10446304 -75516486)
2012,Febrero,Antigua y Barbuda,1,1,,2,POINT (4697157 -74140516)
2012,Febrero,Arabia Saudita,0,1,,1,POINT (4697157 -74140516)
2012,Febrero,Arabia Saudita,0,1,,1,POINT (4697157 -74140516)
2012,Febrero,Arabia Saudita,0,1,,1,POINT (6170465 -7542726)
2012,Febrero,Argelia,0,2,,2,POINT (4697157 -74140516)
2012,Febrero,Argentina,8,12,,20,POINT (-4191162 -69941498)
2012,Febrero,Argentina,1,0,,1,POINT (0.33002 -76876446)
2012,Febrero,Argentina,101,156,,257,POINT (0.81488 -77356)
2012,Febrero,Argentina,1,3,,4,POINT (1800143 -78802679)
2012,Febrero,Argentina,130,99,,229,POINT (10406342 -75527794)
2012,Febrero,Argentina,475,353,,828,POINT (10446304 -75516486)
2012,Febrero,Argentina,11,30,,41,POINT (10886686 -74776479)
2012,Febrero,Argentina,26,34,,60,POINT (11360029 -72129595)
2012,Febrero,Argentina,207,150,,357,POINT (125862 -81702165)
2012,Febrero,Argentina,27,69,,96,POINT (3451668 -76532004)
2012,Febrero,Argentina,3266,4563,,7829,POINT (4697157 -74140516)
2012,Febrero,Argentina,1,3,,4,POINT (4815189 -75736374)
2012,Febrero,Argentina,72,171,,243,POINT (6170465 -7542726)
2012,Febrero,Argentina,0,1,,1,POINT (6185536 -67484028)
2012,Febrero,Argentina,0,1,,1,POINT (7128047 -73181317)
2012,Febrero,Argentina,33,65,,98,POINT (7819 -72453013)
2012,Febrero,Argentina,0,3,,3,POINT (7927233 -72508188)
2012,Febrero,Argentina,5,15,,20,POINT (863337 -7735002)
2012,Febrero,República de Armenia,0,5,,5,POINT (4697157 -74140516)
2012,Febrero,Aruba,0,1,,1,POINT (4697157 -74140516)
2012,Febrero,Aruba,0,1,,1,POINT (6170465 -7542726)
2012,Febrero,Australia,3,4,,7,POINT (-4191162 -69941498)
2012,Febrero,Australia,14,33,,47,POINT (0.81488 -77356)
2012,Febrero,Australia,17,22,,39,POINT (10406342 -75527794)
2012,Febrero,Australia,23,33,,56,POINT (10446304 -75516486)
2012,Febrero,Australia,7,19,,26,POINT (10886686 -74776479)
2012,Febrero,Australia,1,6,,7,POINT (11360029 -72129595)
2012,Febrero,Australia,4,18,,22,POINT (3451668 -76532004)
2012,Febrero,Australia,0,1,,1,POINT (445285 -75766353)
2012,Febrero,Australia,188,360,,548,POINT (4697157 -74140516)
2012,Febrero,Australia,1,1,,2,POINT (4815189 -75736374)
2012,Febrero,Australia,22,46,,68,POINT (6170465 -7542726)
2012,Febrero,Australia,3,1,,4,POINT (7819 -72453013)
2012,Febrero,Australia,8,9,,17,POINT (863337 -7735002)
2012,Febrero,Australia,3,4,,7,POINT (-4191162 -69941498)
2012,Febrero,Australia,12,11,,23,POINT (0.81488 -77356)
2012,Febrero,Australia,2,2,,4,POINT (10406342 -75527794)
2012,Febrero,Australia,2,5,,7,POINT (10446304 -75516486)
2012,Febrero,Australia,0,2,,2,POINT (10886686 -74776479)
2012,Febrero,Australia,3,0,,3,POINT (11360029 -72129595)
2012,Febrero,Australia,2,2,,4,POINT (125862 -81702165)
2012,Febrero,Australia,3,4,,7,POINT (3451668 -76532004)
2012,Febrero,Australia,123,235,,358,POINT (4697157 -74140516)
2012,Febrero,Australia,5,11,,16,POINT (6170465 -7542726)
2012,Febrero,Australia,2,4,,6,POINT (7819 -72453013)
2012,Febrero,Australia,0,1,,1,POINT (7927233 -72508188)
2012,Febrero,Australia,3,5,,8,POINT (863337 -7735002)
2012,Febrero,Azerbaiyán,1,0,,1,POINT (3451668 -76532004)
2012,Febrero,Azerbaiyán,1,0,,1,POINT (4697157 -74140516)
2012,Febrero,Bahamas,1,4,,5,POINT (10446304 -75516486)
2012,Febrero,Bahamas,0,1,,1,POINT (10886686 -74776479)
2012,Febrero,Bahamas,5,12,,17,POINT (4697157 -74140516)
2012,Febrero,Bahréin,1,0,,1,POINT (4697157 -74140516)
2012,Febrero,Bangladesh,0,3,,3,POINT (4697157 -74140516)
2012,Febrero,Barbados,1,1,,2,POINT (10446304 -75516486)
2012,Febrero,Barbados,4,2,,6,POINT (4697157 -74140516)
2012,Febrero,Barbados,0,1,,1,POINT (6170465 -7542726)
2012,Febrero,República de Belarús,1,0,,1,POINT (10406342 -75527794)
2012,Febrero,República de Belarús,1,1,,2,POINT (4697157 -74140516)
2012,Febrero,Bélgica,0,1,,1,POINT (0.33002 -76876446)
2012,Febrero,Bélgica,4,5,,9,POINT (0.81488 -77356)
2012,Febrero,Bélgica,3,3,,6,POINT (10406342 -75527794)
2012,Febrero,Bélgica,16,21,,37,POINT (10446304 -75516486)
2012,Febrero,Bélgica,1,2,,3,POINT (10886686 -74776479)
2012,Febrero,Bélgica,2,3,,5,POINT (11247723 -74213989)
2012,Febrero,Bélgica,1,2,,3,POINT (11360029 -72129595)
2012,Febrero,Bélgica,0,2,,2,POINT (125862 -81702165)
2012,Febrero,Bélgica,2,13,,15,POINT (3451668 -76532004)
2012,Febrero,Bélgica,0,13,,13,POINT (3884426 -77061029)
2012,Febrero,Bélgica,102,290,,392,POINT (4697157 -74140516)
2012,Febrero,Bélgica,7,14,,21,POINT (6170465 -7542726)
2012,Febrero,Bélgica,0,1,,1,POINT (7128047 -73181317)
2012,Febrero,Bélgica,3,1,,4,POINT (7819 -72453013)
2012,Febrero,Bélgica,2,0,,2,POINT (863337 -7735002)
2012,Febrero,Belice,0,1,,1,POINT (10446304 -75516486)
2012,Febrero,Belice,1,1,,2,POINT (10886686 -74776479)
2012,Febrero,Belice,1,4,,5,POINT (4697157 -74140516)
2012,Febrero,Belice,0,1,,1,POINT (4815189 -75736374)
2012,Febrero,Benín,2,2,,4,POINT (4697157 -74140516)
2012,Febrero,Bolivia,0,1,,1,POINT (-4191162 -69941498)
2012,Febrero,Bolivia,13,16,,29,POINT (0.81488 -77356)
2012,Febrero,Bolivia,1,0,,1,POINT (10406342 -75527794)
2012,Febrero,Bolivia,10,13,,23,POINT (10446304 -75516486)
2012,Febrero,Bolivia,2,5,,7,POINT (10886686 -74776479)
2012,Febrero,Bolivia,0,1,,1,POINT (11360029 -72129595)
2012,Febrero,Bolivia,10,8,,18,POINT (125862 -81702165)
2012,Febrero,Bolivia,13,5,,18,POINT (3451668 -76532004)
2012,Febrero,Bolivia,217,371,,588,POINT (4697157 -74140516)
2012,Febrero,Bolivia,0,3,,3,POINT (4815189 -75736374)
2012,Febrero,Bolivia,36,47,,83,POINT (6170465 -7542726)
2012,Febrero,Bolivia,1,3,,4,POINT (7819 -72453013)
2012,Febrero,Bosnia y Herzegovina,0,2,,2,POINT (4697157 -74140516)
2012,Febrero,Bosnia y Herzegovina,0,1,,1,POINT (7927233 -72508188)
2012,Febrero,Brasil,84,97,,181,POINT (-4191162 -69941498)
2012,Febrero,Brasil,11,31,,42,POINT (0.81488 -77356)
2012,Febrero,Brasil,0,1,,1,POINT (1800143 -78802679)
2012,Febrero,Brasil,83,67,,150,POINT (10406342 -75527794)
2012,Febrero,Brasil,110,101,,211,POINT (10446304 -75516486)
2012,Febrero,Brasil,8,22,,30,POINT (10886686 -74776479)
2012,Febrero,Brasil,8,8,,16,POINT (11360029 -72129595)
2012,Febrero,Brasil,60,42,,102,POINT (125862 -81702165)
2012,Febrero,Brasil,19,44,,63,POINT (3451668 -76532004)
2012,Febrero,Brasil,2919,3973,,6892,POINT (4697157 -74140516)
2012,Febrero,Brasil,4,4,,8,POINT (4815189 -75736374)
2012,Febrero,Brasil,18,72,,90,POINT (6170465 -7542726)
2012,Febrero,Brasil,0,3,,3,POINT (6185536 -67484028)
2012,Febrero,Brasil,1,20,,21,POINT (7819 -72453013)
2012,Febrero,Brasil,0,16,,16,POINT (7927233 -72508188)
2012,Febrero,Brasil,1,1,,2,POINT (863337 -7735002)
2012,Febrero,Bulgaria,1,0,,1,POINT (3451668 -76532004)
2012,Febrero,Bulgaria,4,7,,11,POINT (4697157 -74140516)
2012,Febrero,Bulgaria,2,1,,3,POINT (6170465 -7542726)
2012,Febrero,Burundi,0,1,,1,POINT (6170465 -7542726)
2012,Febrero,Islas Caimán/Territorio Británico de Ultramar,1,0,,1,POINT (4697157 -74140516)
2012,Febrero,Camboya,0,2,,2,POINT (4697157 -74140516)
2012,Febrero,Camerún,1,2,,3,POINT (4697157 -74140516)
2012,Febrero,Canadá,3,7,,10,POINT (-4191162 -69941498)
2012,Febrero,Canadá,21,30,,51,POINT (0.81488 -77356)
2012,Febrero,Canadá,21,31,,52,POINT (10406342 -75527794)
2012,Febrero,Canadá,1170,1142,,2312,POINT (10446304 -75516486)
2012,Febrero,Canadá,12,26,,38,POINT (10886686 -74776479)
2012,Febrero,Canadá,2,8,,10,POINT (11360029 -72129595)
2012,Febrero,Canadá,446,456,,902,POINT (125862 -81702165)
2012,Febrero,Canadá,2,3,,5,POINT (133387613 -81372937)
2012,Febrero,Canadá,20,42,,62,POINT (3451668 -76532004)
2012,Febrero,Canadá,5,8,,13,POINT (445285 -75766353)
2012,Febrero,Canadá,725,1389,,2114,POINT (4697157 -74140516)
2012,Febrero,Canadá,2,4,,6,POINT (4815189 -75736374)
2012,Febrero,Canadá,54,143,,197,POINT (6170465 -7542726)
2012,Febrero,Canadá,1,1,,2,POINT (7128047 -73181317)
2012,Febrero,Canadá,1,9,,10,POINT (7819 -72453013)
2012,Febrero,Canadá,1,1,,2,POINT (7927233 -72508188)
2012,Febrero,Canadá,3,7,,10,POINT (863337 -7735002)
2012,Febrero,España,9,27,,36,POINT (0.81488 -77356)
2012,Febrero,España,2,6,,8,POINT (10406342 -75527794)
2012,Febrero,España,10,18,,28,POINT (10446304 -75516486)
2012,Febrero,España,6,19,,25,POINT (10886686 -74776479)
2012,Febrero,España,0,1,,1,POINT (11360029 -72129595)
2012,Febrero,España,8,4,,12,POINT (125862 -81702165)
2012,Febrero,España,61,141,,202,POINT (3451668 -76532004)
2012,Febrero,España,0,1,,1,POINT (445285 -75766353)
2012,Febrero,España,147,421,,568,POINT (4697157 -74140516)
2012,Febrero,España,26,91,,117,POINT (6170465 -7542726)
2012,Febrero,España,1,1,,2,POINT (7927233 -72508188)
2012,Febrero,República Democrática del Congo,3,1,,4,POINT (4697157 -74140516)
2012,Febrero,República de Corea,2,0,,2,POINT (-4191162 -69941498)
2012,Febrero,República de Corea,8,5,,13,POINT (0.81488 -77356)
2012,Febrero,República de Corea,2,3,,5,POINT (10446304 -75516486)
2012,Febrero,República de Corea,2,3,,5,POINT (10886686 -74776479)
2012,Febrero,República de Corea,0,1,,1,POINT (10970933 -74765343)
2012,Febrero,República de Corea,0,1,,1,POINT (125862 -81702165)
2012,Febrero,República de Corea,1,2,,3,POINT (3451668 -76532004)
2012,Febrero,República de Corea,100,417,,517,POINT (4697157 -74140516)
2012,Febrero,República de Corea,0,11,,11,POINT (6170465 -7542726)
2012,Febrero,República de Corea,0,2,,2,POINT (7819 -72453013)
2012,Febrero,República de Corea,0,2,,2,POINT (863337 -7735002)
2012,Febrero,Costa de Marfil,1,0,,1,POINT (4697157 -74140516)
2012,Febrero,Costa Rica,3,1,,4,POINT (0.81488 -77356)
2012,Febrero,Costa Rica,26,31,,57,POINT (10446304 -75516486)
2012,Febrero,Costa Rica,16,26,,42,POINT (10886686 -74776479)
2012,Febrero,Costa Rica,0,1,,1,POINT (11360029 -72129595)
2012,Febrero,Costa Rica,0,1,,1,POINT (125744111 -81703935)
2012,Febrero,Costa Rica,290,248,,538,POINT (125862 -81702165)
2012,Febrero,Costa Rica,18,39,,57,POINT (3451668 -76532004)
2012,Febrero,Costa Rica,271,530,,801,POINT (4697157 -74140516)
2012,Febrero,Costa Rica,2,3,,5,POINT (4815189 -75736374)
2012,Febrero,Costa Rica,72,99,,171,POINT (6170465 -7542726)
2012,Febrero,Costa Rica,1,0,,1,POINT (7128047 -73181317)
2012,Febrero,Costa Rica,3,2,,5,POINT (7819 -72453013)
2012,Febrero,Costa Rica,1,0,,1,POINT (863337 -7735002)
2012,Febrero,Croacia,1,3,,4,POINT (10406342 -75527794)
2012,Febrero,Croacia,0,4,,4,POINT (10446304 -75516486)
2012,Febrero,Croacia,0,1,,1,POINT (10970933 -74765343)
2012,Febrero,Croacia,0,3,,3,POINT (3884426 -77061029)
2012,Febrero,Croacia,4,26,,30,POINT (4697157 -74140516)
2012,Febrero,Croacia,0,1,,1,POINT (6170465 -7542726)
2012,Febrero,Croacia,0,1,,1,POINT (7819 -72453013)
2012,Febrero,Cuba,0,1,,1,POINT (-4191162 -69941498)
2012,Febrero,Cuba,0,6,,6,POINT (0.81488 -77356)
2012,Febrero,Cuba,1,1,,2,POINT (10406342 -75527794)
2012,Febrero,Cuba,10,14,,24,POINT (10446304 -75516486)
2012,Febrero,Cuba,3,16,,19,POINT (10886686 -74776479)
2012,Febrero,Cuba,0,1,,1,POINT (11360029 -72129595)
2012,Febrero,Cuba,1,0,,1,POINT (125862 -81702165)
2012,Febrero,Cuba,10,22,,32,POINT (3451668 -76532004)
2012,Febrero,Cuba,0,4,,4,POINT (445285 -75766353)
2012,Febrero,Cuba,65,156,,221,POINT (4697157 -74140516)
2012,Febrero,Cuba,0,1,,1,POINT (4815189 -75736374)
2012,Febrero,Cuba,7,16,,23,POINT (6170465 -7542726)
2012,Febrero,Cuba,1,0,,1,POINT (7128047 -73181317)
2012,Febrero,Cuba,1,1,,2,POINT (7819 -72453013)
2012,Febrero,Curazao,0,2,,2,POINT (4697157 -74140516)
2012,Febrero,Curazao,1,1,,2,POINT (6170465 -7542726)
2012,Febrero,República Checa,4,9,,13,POINT (0.81488 -77356)
2012,Febrero,República Checa,0,2,,2,POINT (10446304 -75516486)
2012,Febrero,República Checa,3,0,,3,POINT (11360029 -72129595)
2012,Febrero,República Checa,0,1,,1,POINT (3451668 -76532004)
2012,Febrero,República Checa,26,48,,74,POINT (4697157 -74140516)
2012,Febrero,República Checa,0,1,,1,POINT (6170465 -7542726)
2012,Febrero,Chile,8,3,,11,POINT (-4191162 -69941498)
2012,Febrero,Chile,1,2,,3,POINT (0.33002 -76876446)
2012,Febrero,Chile,71,106,,177,POINT (0.81488 -77356)
2012,Febrero,Chile,114,103,,217,POINT (10406342 -75527794)
2012,Febrero,Chile,136,97,,233,POINT (10446304 -75516486)
2012,Febrero,Chile,5,15,,20,POINT (10886686 -74776479)
2012,Febrero,Chile,1,1,,2,POINT (11247723 -74213989)
2012,Febrero,Chile,8,10,,18,POINT (11360029 -72129595)
2012,Febrero,Chile,37,32,,69,POINT (125862 -81702165)
2012,Febrero,Chile,24,37,,61,POINT (3451668 -76532004)
2012,Febrero,Chile,3105,3731,,6836,POINT (4697157 -74140516)
2012,Febrero,Chile,107,123,,230,POINT (6170465 -7542726)
2012,Febrero,Chile,0,2,,2,POINT (7128047 -73181317)
2012,Febrero,Chile,7,15,,22,POINT (7819 -72453013)
2012,Febrero,Chile,0,2,,2,POINT (7927233 -72508188)
2012,Febrero,Chile,1,2,,3,POINT (863337 -7735002)
2012,Febrero,China,2,4,,6,POINT (0.81488 -77356)
2012,Febrero,China,2,9,,11,POINT (10446304 -75516486)
2012,Febrero,China,0,1,,1,POINT (10886686 -74776479)
2012,Febrero,China,2,1,,3,POINT (11360029 -72129595)
2012,Febrero,China,2,6,,8,POINT (3451668 -76532004)
2012,Febrero,China,140,443,,583,POINT (4697157 -74140516)
2012,Febrero,China,0,2,,2,POINT (4815189 -75736374)
2012,Febrero,China,1,4,,5,POINT (6170465 -7542726)
2012,Febrero,China,1,0,,1,POINT (7819 -72453013)
2012,Febrero,China,1,0,,1,POINT (7927233 -72508188)
2012,Febrero,Taiwán,0,1,,1,POINT (0.81488 -77356)
2012,Febrero,Taiwán,4,2,,6,POINT (10446304 -75516486)
2012,Febrero,Taiwán,0,2,,2,POINT (10886686 -74776479)
2012,Febrero,Taiwán,1,0,,1,POINT (11360029 -72129595)
2012,Febrero,Taiwán,0,3,,3,POINT (3451668 -76532004)
2012,Febrero,Taiwán,24,50,,74,POINT (4697157 -74140516)
2012,Febrero,Taiwán,3,11,,14,POINT (6170465 -7542726)
2012,Febrero,Taiwán,1,0,,1,POINT (7927233 -72508188)
2012,Febrero,Chipre,0,1,,1,POINT (4697157 -74140516)
2012,Febrero,Dinamarca,1,1,,2,POINT (-4191162 -69941498)
2012,Febrero,Dinamarca,6,3,,9,POINT (0.81488 -77356)
2012,Febrero,Dinamarca,0,6,,6,POINT (10406342 -75527794)
2012,Febrero,Dinamarca,2,5,,7,POINT (10446304 -75516486)
2012,Febrero,Dinamarca,0,2,,2,POINT (10886686 -74776479)
2012,Febrero,Dinamarca,1,1,,2,POINT (11360029 -72129595)
2012,Febrero,Dinamarca,1,0,,1,POINT (3451668 -76532004)
2012,Febrero,Dinamarca,44,131,,175,POINT (4697157 -74140516)
2012,Febrero,Dinamarca,2,4,,6,POINT (6170465 -7542726)
2012,Febrero,Dinamarca,1,3,,4,POINT (7819 -72453013)
2012,Febrero,República de Yibuti,0,1,,1,POINT (4697157 -74140516)
2012,Febrero,Dominica,0,1,,1,POINT (0.81488 -77356)
2012,Febrero,Dominica,1,0,,1,POINT (10886686 -74776479)
2012,Febrero,Dominica,4,4,,8,POINT (4697157 -74140516)
2012,Febrero,Ecuador,0,3,,3,POINT (-4191162 -69941498)
2012,Febrero,Ecuador,8,37,,45,POINT (0.33002 -76876446)
2012,Febrero,Ecuador,1228,1269,,2497,POINT (0.81488 -77356)
2012,Febrero,Ecuador,2,2,,4,POINT (1800143 -78802679)
2012,Febrero,Ecuador,9,13,,22,POINT (10406342 -75527794)
2012,Febrero,Ecuador,12,15,,27,POINT (10446304 -75516486)
2012,Febrero,Ecuador,8,24,,32,POINT (10886686 -74776479)
2012,Febrero,Ecuador,0,9,,9,POINT (11360029 -72129595)
2012,Febrero,Ecuador,19,12,,31,POINT (125862 -81702165)
2012,Febrero,Ecuador,354,419,,773,POINT (3451668 -76532004)
2012,Febrero,Ecuador,0,2,,2,POINT (445285 -75766353)
2012,Febrero,Ecuador,1853,2907,,4760,POINT (4697157 -74140516)
2012,Febrero,Ecuador,0,3,,3,POINT (4815189 -75736374)
2012,Febrero,Ecuador,413,498,,911,POINT (6170465 -7542726)
2012,Febrero,Ecuador,0,1,,1,POINT (6222552 -77401154)
2012,Febrero,Ecuador,0,1,,1,POINT (7088729 -70740253)
2012,Febrero,Ecuador,129,161,,290,POINT (7819 -72453013)
2012,Febrero,Ecuador,1,3,,4,POINT (7927233 -72508188)
2012,Febrero,Egipto,5,19,,24,POINT (4697157 -74140516)
2012,Febrero,El Salvador,1,1,,2,POINT (0.81488 -77356)
2012,Febrero,El Salvador,5,8,,13,POINT (10446304 -75516486)
2012,Febrero,El Salvador,7,8,,15,POINT (10886686 -74776479)
2012,Febrero,El Salvador,3,16,,19,POINT (3451668 -76532004)
2012,Febrero,El Salvador,408,586,,994,POINT (4697157 -74140516)
2012,Febrero,El Salvador,12,27,,39,POINT (6170465 -7542726)
2012,Febrero,El Salvador,1,1,,2,POINT (7819 -72453013)
2012,Febrero,Emiratos Árabes,1,3,,4,POINT (4697157 -74140516)
2012,Febrero,España,6,1,,7,POINT (-4191162 -69941498)
2012,Febrero,España,13,23,,36,POINT (0.81488 -77356)
2012,Febrero,España,15,25,,40,POINT (10406342 -75527794)
2012,Febrero,España,35,52,,87,POINT (10446304 -75516486)
2012,Febrero,España,0,5,,5,POINT (10886686 -74776479)
2012,Febrero,España,1,1,,2,POINT (10970933 -74765343)
2012,Febrero,España,3,11,,14,POINT (11360029 -72129595)
2012,Febrero,España,3,4,,7,POINT (125862 -81702165)
2012,Febrero,España,137,296,,433,POINT (3451668 -76532004)
2012,Febrero,España,0,1,,1,POINT (445285 -75766353)
2012,Febrero,España,1520,3829,,5349,POINT (4697157 -74140516)
2012,Febrero,España,1,5,,6,POINT (4815189 -75736374)
2012,Febrero,España,66,197,,263,POINT (6170465 -7542726)
2012,Febrero,España,0,1,,1,POINT (6185536 -67484028)
2012,Febrero,España,1,0,,1,POINT (7088729 -70740253)
2012,Febrero,España,0,1,,1,POINT (7128047 -73181317)
2012,Febrero,España,14,51,,65,POINT (7819 -72453013)
2012,Febrero,España,2,2,,4,POINT (7927233 -72508188)
2012,Febrero,España,1,2,,3,POINT (863337 -7735002)
2012,Febrero,Eslovaquia,0,1,,1,POINT (0.81488 -77356)
2012,Febrero,Eslovaquia,0,1,,1,POINT (10446304 -75516486)
2012,Febrero,Eslovaquia,3,0,,3,POINT (10886686 -74776479)
2012,Febrero,Eslovaquia,1,0,,1,POINT (11247723 -74213989)
2012,Febrero,Eslovaquia,0,3,,3,POINT (11360029 -72129595)
2012,Febrero,Eslovaquia,12,11,,23,POINT (4697157 -74140516)
2012,Febrero,Eslovaquia,3,1,,4,POINT (6170465 -7542726)
2012,Febrero,Eslovaquia,1,1,,2,POINT (7819 -72453013)
2012,Febrero,Eslovenia,2,1,,3,POINT (0.81488 -77356)
2012,Febrero,Eslovenia,1,0,,1,POINT (10886686 -74776479)
2012,Febrero,Eslovenia,2,0,,2,POINT (11360029 -72129595)
2012,Febrero,Eslovenia,1,1,,2,POINT (3451668 -76532004)
2012,Febrero,Eslovenia,13,24,,37,POINT (4697157 -74140516)
2012,Febrero,Eslovenia,0,1,,1,POINT (6170465 -7542726)
2012,Febrero,Estados Unidos de América,12,14,,26,POINT (-4191162 -69941498)
2012,Febrero,Estados Unidos de América,30,79,,109,POINT (0.81488 -77356)
2012,Febrero,Estados Unidos de América,42,62,,104,POINT (10406342 -75527794)
2012,Febrero,Estados Unidos de América,947,1711,,2658,POINT (10446304 -75516486)
2012,Febrero,Estados Unidos de América,489,815,,1304,POINT (10886686 -74776479)
2012,Febrero,Estados Unidos de América,2,12,,14,POINT (11247723 -74213989)
2012,Febrero,Estados Unidos de América,5,8,,13,POINT (11360029 -72129595)
2012,Febrero,Estados Unidos de América,0,1,,1,POINT (1152863 -72919186)
2012,Febrero,Estados Unidos de América,6,24,,30,POINT (125744111 -81703935)
2012,Febrero,Estados Unidos de América,23,27,,50,POINT (125862 -81702165)
2012,Febrero,Estados Unidos de América,2,6,,8,POINT (133387613 -81372937)
2012,Febrero,Estados Unidos de América,565,922,,1487,POINT (3451668 -76532004)
2012,Febrero,Estados Unidos de América,73,111,,184,POINT (445285 -75766353)
2012,Febrero,Estados Unidos de América,5161,10995,,16156,POINT (4697157 -74140516)
2012,Febrero,Estados Unidos de América,47,76,,123,POINT (4815189 -75736374)
2012,Febrero,Estados Unidos de América,791,2192,,2983,POINT (6170465 -7542726)
2012,Febrero,Estados Unidos de América,1,1,,2,POINT (6185536 -67484028)
2012,Febrero,Estados Unidos de América,10,15,,25,POINT (7128047 -73181317)
2012,Febrero,Estados Unidos de América,18,41,,59,POINT (7819 -72453013)
2012,Febrero,Estados Unidos de América,7,12,,19,POINT (7927233 -72508188)
2012,Febrero,Estados Unidos de América,9,9,,18,POINT (863337 -7735002)
2012,Febrero,Estonia,2,0,,2,POINT (0.81488 -77356)
2012,Febrero,Estonia,5,3,,8,POINT (10446304 -75516486)
2012,Febrero,Estonia,3,1,,4,POINT (10886686 -74776479)
2012,Febrero,Estonia,0,1,,1,POINT (11360029 -72129595)
2012,Febrero,Estonia,1,3,,4,POINT (3451668 -76532004)
2012,Febrero,Estonia,11,11,,22,POINT (4697157 -74140516)
2012,Febrero,Estonia,2,1,,3,POINT (7819 -72453013)
2012,Febrero,Etiopia,0,3,,3,POINT (4697157 -74140516)
2012,Febrero,Filipinas,1,46,,47,POINT (10406342 -75527794)
2012,Febrero,Filipinas,1,5,,6,POINT (10446304 -75516486)
2012,Febrero,Filipinas,0,3,,3,POINT (10886686 -74776479)
2012,Febrero,Filipinas,0,7,,7,POINT (10970933 -74765343)
2012,Febrero,Filipinas,0,12,,12,POINT (11247723 -74213989)
2012,Febrero,Filipinas,1,0,,1,POINT (125862 -81702165)
2012,Febrero,Filipinas,0,25,,25,POINT (3451668 -76532004)
2012,Febrero,Filipinas,0,37,,37,POINT (3884426 -77061029)
2012,Febrero,Filipinas,16,70,,86,POINT (4697157 -74140516)
2012,Febrero,Filipinas,2,2,,4,POINT (6170465 -7542726)
2012,Febrero,Filipinas,0,1,,1,POINT (7927233 -72508188)
2012,Febrero,Filipinas,0,8,,8,POINT (9402597 -75681642)
2012,Febrero,Finlandia,1,1,,2,POINT (-4191162 -69941498)
2012,Febrero,Finlandia,4,4,,8,POINT (0.81488 -77356)
2012,Febrero,Finlandia,3,0,,3,POINT (10406342 -75527794)
2012,Febrero,Finlandia,157,146,,303,POINT (10446304 -75516486)
2012,Febrero,Finlandia,0,1,,1,POINT (11360029 -72129595)
2012,Febrero,Finlandia,2,3,,5,POINT (3451668 -76532004)
2012,Febrero,Finlandia,61,92,,153,POINT (4697157 -74140516)
2012,Febrero,Finlandia,1,4,,5,POINT (6170465 -7542726)
2012,Febrero,Finlandia,0,1,,1,POINT (7819 -72453013)
2012,Febrero,Francia,7,9,,16,POINT (-4191162 -69941498)
2012,Febrero,Francia,1,3,,4,POINT (0.33002 -76876446)
2012,Febrero,Francia,38,79,,117,POINT (0.81488 -77356)
2012,Febrero,Francia,16,13,,29,POINT (10406342 -75527794)
2012,Febrero,Francia,18,43,,61,POINT (10446304 -75516486)
2012,Febrero,Francia,6,10,,16,POINT (10886686 -74776479)
2012,Febrero,Francia,1,1,,2,POINT (11247723 -74213989)
2012,Febrero,Francia,9,9,,18,POINT (11360029 -72129595)
2012,Febrero,Francia,3,3,,6,POINT (125744111 -81703935)
2012,Febrero,Francia,1,3,,4,POINT (125862 -81702165)
2012,Febrero,Francia,1,2,,3,POINT (133387613 -81372937)
2012,Febrero,Francia,25,60,,85,POINT (3451668 -76532004)
2012,Febrero,Francia,0,1,,1,POINT (3884426 -77061029)
2012,Febrero,Francia,1094,1768,,2862,POINT (4697157 -74140516)
2012,Febrero,Francia,0,1,,1,POINT (4815189 -75736374)
2012,Febrero,Francia,24,67,,91,POINT (6170465 -7542726)
2012,Febrero,Francia,0,3,,3,POINT (7088729 -70740253)
2012,Febrero,Francia,6,22,,28,POINT (7819 -72453013)
2012,Febrero,Francia,2,4,,6,POINT (7927233 -72508188)
2012,Febrero,Francia,4,7,,11,POINT (863337 -7735002)
2012,Febrero,Gabón,0,1,,1,POINT (4697157 -74140516)
2012,Febrero,Gambia,0,1,,1,POINT (7819 -72453013)
2012,Febrero,Ghana,0,2,,2,POINT (10446304 -75516486)
2012,Febrero,Ghana,0,1,,1,POINT (10886686 -74776479)
2012,Febrero,Ghana,2,1,,3,POINT (4697157 -74140516)
2012,Febrero,Ghana,0,2,,2,POINT (7819 -72453013)
2012,Febrero,Granada,1,0,,1,POINT (10446304 -75516486)
2012,Febrero,Granada,0,2,,2,POINT (4697157 -74140516)
2012,Febrero,Grecia,0,4,,4,POINT (10406342 -75527794)
2012,Febrero,Grecia,1,2,,3,POINT (10446304 -75516486)
2012,Febrero,Grecia,2,3,,5,POINT (10886686 -74776479)
2012,Febrero,Grecia,1,2,,3,POINT (11247723 -74213989)
2012,Febrero,Grecia,2,1,,3,POINT (3451668 -76532004)
2012,Febrero,Grecia,0,1,,1,POINT (3884426 -77061029)
2012,Febrero,Grecia,26,63,,89,POINT (4697157 -74140516)
2012,Febrero,Grecia,0,4,,4,POINT (6170465 -7542726)
2012,Febrero,Grecia,1,0,,1,POINT (7819 -72453013)
2012,Febrero,Guatemala,1,0,,1,POINT (0.33002 -76876446)
2012,Febrero,Guatemala,2,3,,5,POINT (0.81488 -77356)
2012,Febrero,Guatemala,1,5,,6,POINT (10406342 -75527794)
2012,Febrero,Guatemala,25,54,,79,POINT (10446304 -75516486)
2012,Febrero,Guatemala,3,18,,21,POINT (10886686 -74776479)
2012,Febrero,Guatemala,0,1,,1,POINT (125862 -81702165)
2012,Febrero,Guatemala,0,1,,1,POINT (133387613 -81372937)
2012,Febrero,Guatemala,6,31,,37,POINT (3451668 -76532004)
2012,Febrero,Guatemala,111,354,,465,POINT (4697157 -74140516)
2012,Febrero,Guatemala,0,4,,4,POINT (4815189 -75736374)
2012,Febrero,Guatemala,22,44,,66,POINT (6170465 -7542726)
2012,Febrero,Guatemala,0,1,,1,POINT (7128047 -73181317)
2012,Febrero,Guatemala,4,5,,9,POINT (7819 -72453013)
2012,Febrero,Guatemala,2,2,,4,POINT (7927233 -72508188)
2012,Febrero,Guyana,0,2,,2,POINT (0.81488 -77356)
2012,Febrero,Guyana,0,1,,1,POINT (10406342 -75527794)
2012,Febrero,Guyana,0,1,,1,POINT (10446304 -75516486)
2012,Febrero,Guyana,2,7,,9,POINT (4697157 -74140516)
2012,Febrero,Guyana,0,1,,1,POINT (6170465 -7542726)
2012,Febrero,Haití,0,1,,1,POINT (-4191162 -69941498)
2012,Febrero,Haití,0,1,,1,POINT (10406342 -75527794)
2012,Febrero,Haití,0,1,,1,POINT (10446304 -75516486)
2012,Febrero,Haití,1,1,,2,POINT (3451668 -76532004)
2012,Febrero,Haití,0,11,,11,POINT (4697157 -74140516)
2012,Febrero,Haití,0,1,,1,POINT (6170465 -7542726)
2012,Febrero,Honduras,2,3,,5,POINT (0.81488 -77356)
2012,Febrero,Honduras,0,3,,3,POINT (10406342 -75527794)
2012,Febrero,Honduras,7,12,,19,POINT (10446304 -75516486)
2012,Febrero,Honduras,2,9,,11,POINT (10886686 -74776479)
2012,Febrero,Honduras,0,1,,1,POINT (125862 -81702165)
2012,Febrero,Honduras,5,13,,18,POINT (3451668 -76532004)
2012,Febrero,Honduras,0,1,,1,POINT (3884426 -77061029)
2012,Febrero,Honduras,1,0,,1,POINT (445285 -75766353)
2012,Febrero,Honduras,115,171,,286,POINT (4697157 -74140516)
2012,Febrero,Honduras,1,1,,2,POINT (4815189 -75736374)
2012,Febrero,Honduras,14,23,,37,POINT (6170465 -7542726)
2012,Febrero,Honduras,0,1,,1,POINT (863337 -7735002)
2012,Febrero,Hungría,5,8,,13,POINT (0.81488 -77356)
2012,Febrero,Hungría,1,1,,2,POINT (10446304 -75516486)
2012,Febrero,Hungría,0,1,,1,POINT (11360029 -72129595)
2012,Febrero,Hungría,1,1,,2,POINT (3451668 -76532004)
2012,Febrero,Hungría,33,31,,64,POINT (4697157 -74140516)
2012,Febrero,Hungría,1,2,,3,POINT (6170465 -7542726)
2012,Febrero,Hungría,1,1,,2,POINT (7819 -72453013)
2012,Febrero,India,0,2,,2,POINT (0.81488 -77356)
2012,Febrero,India,2,4,,6,POINT (10446304 -75516486)
2012,Febrero,India,1,2,,3,POINT (10886686 -74776479)
2012,Febrero,India,0,1,,1,POINT (1152863 -72919186)
2012,Febrero,India,0,1,,1,POINT (125862 -81702165)
2012,Febrero,India,0,15,,15,POINT (3451668 -76532004)
2012,Febrero,India,0,4,,4,POINT (3884426 -77061029)
2012,Febrero,India,23,284,,307,POINT (4697157 -74140516)
2012,Febrero,India,0,3,,3,POINT (4815189 -75736374)
2012,Febrero,India,0,26,,26,POINT (6170465 -7542726)
2012,Febrero,Indonesia,0,1,,1,POINT (10406342 -75527794)
2012,Febrero,Indonesia,0,3,,3,POINT (11247723 -74213989)
2012,Febrero,Indonesia,1,1,,2,POINT (3451668 -76532004)
2012,Febrero,Indonesia,0,1,,1,POINT (3884426 -77061029)
2012,Febrero,Indonesia,7,15,,22,POINT (4697157 -74140516)
2012,Febrero,Indonesia,1,1,,2,POINT (6170465 -7542726)
2012,Febrero,Irán,4,15,,19,POINT (4697157 -74140516)
2012,Febrero,Irán,0,1,,1,POINT (6170465 -7542726)
2012,Febrero,República de Irlanda,1,1,,2,POINT (-4191162 -69941498)
2012,Febrero,República de Irlanda,15,16,,31,POINT (0.81488 -77356)
2012,Febrero,República de Irlanda,3,7,,10,POINT (10446304 -75516486)
2012,Febrero,República de Irlanda,1,0,,1,POINT (11360029 -72129595)
2012,Febrero,República de Irlanda,0,2,,2,POINT (3451668 -76532004)
2012,Febrero,República de Irlanda,33,80,,113,POINT (4697157 -74140516)
2012,Febrero,República de Irlanda,2,5,,7,POINT (6170465 -7542726)
2012,Febrero,República de Irlanda,1,1,,2,POINT (863337 -7735002)
2012,Febrero,Islandia,2,3,,5,POINT (0.81488 -77356)
2012,Febrero,Islandia,0,1,,1,POINT (10886686 -74776479)
2012,Febrero,Islandia,0,1,,1,POINT (3451668 -76532004)
2012,Febrero,Islandia,6,8,,14,POINT (4697157 -74140516)
2012,Febrero,Islandia,1,0,,1,POINT (6170465 -7542726)
2012,Febrero,Isla de Man,13,34,,47,POINT (0.81488 -77356)
2012,Febrero,Isla de Man,6,14,,20,POINT (10446304 -75516486)
2012,Febrero,Isla de Man,5,8,,13,POINT (10886686 -74776479)
2012,Febrero,Isla de Man,6,20,,26,POINT (3451668 -76532004)
2012,Febrero,Isla de Man,0,1,,1,POINT (3884426 -77061029)
2012,Febrero,Isla de Man,28,117,,145,POINT (4697157 -74140516)
2012,Febrero,Isla de Man,6,23,,29,POINT (6170465 -7542726)
2012,Febrero,Isla de Man,1,1,,2,POINT (7128047 -73181317)
2012,Febrero,Isla Johnston,1,0,,1,POINT (10446304 -75516486)
2012,Febrero,Isla Johnston,1,1,,2,POINT (4697157 -74140516)
2012,Febrero,Israel,32,28,,60,POINT (-4191162 -69941498)
2012,Febrero,Israel,2,3,,5,POINT (0.81488 -77356)
2012,Febrero,Israel,1,6,,7,POINT (10406342 -75527794)
2012,Febrero,Israel,5,23,,28,POINT (10446304 -75516486)
2012,Febrero,Israel,0,2,,2,POINT (10886686 -74776479)
2012,Febrero,Israel,0,1,,1,POINT (125862 -81702165)
2012,Febrero,Israel,3,13,,16,POINT (3451668 -76532004)
2012,Febrero,Israel,76,452,,528,POINT (4697157 -74140516)
2012,Febrero,Israel,7,43,,50,POINT (6170465 -7542726)
2012,Febrero,Israel,0,1,,1,POINT (7128047 -73181317)
2012,Febrero,Israel,1,0,,1,POINT (7819 -72453013)
2012,Febrero,Israel,0,1,,1,POINT (7927233 -72508188)
2012,Febrero,Israel,1,0,,1,POINT (863337 -7735002)
2012,Febrero,Islas Aland/Provincia de Finlandia,0,1,,1,POINT (10446304 -75516486)
2012,Febrero,Isla Wake,1,0,,1,POINT (4697157 -74140516)
2012,Febrero,Italia,2,7,,9,POINT (-4191162 -69941498)
2012,Febrero,Italia,0,1,,1,POINT (0.33002 -76876446)
2012,Febrero,Italia,7,23,,30,POINT (0.81488 -77356)
2012,Febrero,Italia,21,22,,43,POINT (10406342 -75527794)
2012,Febrero,Italia,50,63,,113,POINT (10446304 -75516486)
2012,Febrero,Italia,4,12,,16,POINT (10886686 -74776479)
2012,Febrero,Italia,3,18,,21,POINT (11360029 -72129595)
2012,Febrero,Italia,9,14,,23,POINT (125862 -81702165)
2012,Febrero,Italia,18,67,,85,POINT (3451668 -76532004)
2012,Febrero,Italia,1,0,,1,POINT (445285 -75766353)
2012,Febrero,Italia,476,1660,,2136,POINT (4697157 -74140516)
2012,Febrero,Italia,0,1,,1,POINT (4815189 -75736374)
2012,Febrero,Italia,25,80,,105,POINT (6170465 -7542726)
2012,Febrero,Italia,0,3,,3,POINT (7128047 -73181317)
2012,Febrero,Italia,4,49,,53,POINT (7819 -72453013)
2012,Febrero,Italia,1,5,,6,POINT (7927233 -72508188)
2012,Febrero,Italia,0,4,,4,POINT (863337 -7735002)
2012,Febrero,Jamaica,3,6,,9,POINT (10446304 -75516486)
2012,Febrero,Jamaica,0,1,,1,POINT (10886686 -74776479)
2012,Febrero,Jamaica,0,1,,1,POINT (125862 -81702165)
2012,Febrero,Jamaica,1,3,,4,POINT (3451668 -76532004)
2012,Febrero,Jamaica,8,11,,19,POINT (4697157 -74140516)
2012,Febrero,Jamaica,1,4,,5,POINT (6170465 -7542726)
2012,Febrero,Jamaica,1,0,,1,POINT (7819 -72453013)
2012,Febrero,Islas Salomón,1,0,,1,POINT (4697157 -74140516)
2012,Febrero,Papúa Occidental,1,0,,1,POINT (4697157 -74140516)
2012,Febrero,Japón,6,5,,11,POINT (-4191162 -69941498)
2012,Febrero,Japón,7,10,,17,POINT (0.81488 -77356)
2012,Febrero,Japón,24,11,,35,POINT (10406342 -75527794)
2012,Febrero,Japón,13,12,,25,POINT (10446304 -75516486)
2012,Febrero,Japón,3,3,,6,POINT (10886686 -74776479)
2012,Febrero,Japón,0,1,,1,POINT (11360029 -72129595)
2012,Febrero,Japón,0,12,,12,POINT (3451668 -76532004)
2012,Febrero,Japón,1,0,,1,POINT (445285 -75766353)
2012,Febrero,Japón,122,417,,539,POINT (4697157 -74140516)
2012,Febrero,Japón,0,1,,1,POINT (4815189 -75736374)
2012,Febrero,Japón,8,25,,33,POINT (6170465 -7542726)
2012,Febrero,Japón,0,1,,1,POINT (7819 -72453013)
2012,Febrero,Japón,0,1,,1,POINT (7927233 -72508188)
2012,Febrero,Japón,2,1,,3,POINT (863337 -7735002)
2012,Febrero,Jordania,1,0,,1,POINT (3451668 -76532004)
2012,Febrero,Jordania,1,4,,5,POINT (4697157 -74140516)
2012,Febrero,Kazajistán,1,0,,1,POINT (3451668 -76532004)
2012,Febrero,Kazajistán,3,1,,4,POINT (4697157 -74140516)
2012,Febrero,Kenia,0,1,,1,POINT (0.81488 -77356)
2012,Febrero,Kenia,0,1,,1,POINT (11360029 -72129595)
2012,Febrero,Kenia,0,12,,12,POINT (4697157 -74140516)
2012,Febrero,Kenia,0,2,,2,POINT (7819 -72453013)
2012,Febrero,Kirguistán,0,1,,1,POINT (4697157 -74140516)
2012,Febrero,Kuwait,1,0,,1,POINT (4697157 -74140516)
2012,Febrero,República de Kosovo,1,0,,1,POINT (4697157 -74140516)
2012,Febrero,Lesoto,0,1,,1,POINT (4697157 -74140516)
2012,Febrero,Letonia,0,1,,1,POINT (3884426 -77061029)
2012,Febrero,Letonia,6,2,,8,POINT (4697157 -74140516)
2012,Febrero,Lituania,0,1,,1,POINT (0.81488 -77356)
2012,Febrero,Lituania,0,1,,1,POINT (10406342 -75527794)
2012,Febrero,Lituania,0,1,,1,POINT (10446304 -75516486)
2012,Febrero,Lituania,0,1,,1,POINT (11360029 -72129595)
2012,Febrero,Lituania,0,1,,1,POINT (3451668 -76532004)
2012,Febrero,Lituania,9,7,,16,POINT (4697157 -74140516)
2012,Febrero,Lituania,1,1,,2,POINT (6170465 -7542726)
2012,Febrero,Lituania,0,1,,1,POINT (7819 -72453013)
2012,Febrero,Líbano,1,1,,2,POINT (10886686 -74776479)
2012,Febrero,Líbano,5,4,,9,POINT (11360029 -72129595)
2012,Febrero,Líbano,0,1,,1,POINT (3451668 -76532004)
2012,Febrero,Líbano,14,30,,44,POINT (4697157 -74140516)
2012,Febrero,Líbano,0,1,,1,POINT (7128047 -73181317)
2012,Febrero,Líbano,0,1,,1,POINT (7927233 -72508188)
2012,Febrero,Liechtenstein,0,2,,2,POINT (0.81488 -77356)
2012,Febrero,Liechtenstein,1,2,,3,POINT (4697157 -74140516)
2012,Febrero,Luxemburgo,4,12,,16,POINT (4697157 -74140516)
2012,Febrero,Luxemburgo,0,1,,1,POINT (863337 -7735002)
2012,Febrero,Macedonia,1,0,,1,POINT (4697157 -74140516)
2012,Febrero,Madagascar,1,0,,1,POINT (4697157 -74140516)
2012,Febrero,Malasia,9,26,,35,POINT (4697157 -74140516)
2012,Febrero,Malta,1,2,,3,POINT (4697157 -74140516)
2012,Febrero,Marruecos,1,7,,8,POINT (4697157 -74140516)
2012,Febrero,Mauricio,1,0,,1,POINT (4697157 -74140516)
2012,Febrero,México,0,1,,1,POINT (-4191162 -69941498)
2012,Febrero,México,1,0,,1,POINT (0.33002 -76876446)
2012,Febrero,México,6,12,,18,POINT (0.81488 -77356)
2012,Febrero,México,10,9,,19,POINT (10406342 -75527794)
2012,Febrero,México,66,108,,174,POINT (10446304 -75516486)
2012,Febrero,México,10,36,,46,POINT (10886686 -74776479)
2012,Febrero,México,1,2,,3,POINT (11360029 -72129595)
2012,Febrero,México,0,2,,2,POINT (125744111 -81703935)
2012,Febrero,México,6,6,,12,POINT (125862 -81702165)
2012,Febrero,México,26,103,,129,POINT (3451668 -76532004)
2012,Febrero,México,0,1,,1,POINT (445285 -75766353)
2012,Febrero,México,1468,3844,,5312,POINT (4697157 -74140516)
2012,Febrero,México,3,16,,19,POINT (4815189 -75736374)
2012,Febrero,México,81,209,,290,POINT (6170465 -7542726)
2012,Febrero,México,4,2,,6,POINT (7128047 -73181317)
2012,Febrero,México,9,31,,40,POINT (7819 -72453013)
2012,Febrero,México,1,5,,6,POINT (7927233 -72508188)
2012,Febrero,México,0,1,,1,POINT (863337 -7735002)
2012,Febrero,República de Moldavia,2,0,,2,POINT (4697157 -74140516)
2012,Febrero,Mongolia,1,0,,1,POINT (4697157 -74140516)
2012,Febrero,Mozambique,0,1,,1,POINT (4697157 -74140516)
2012,Febrero,Myanmar,0,1,,1,POINT (3884426 -77061029)
2012,Febrero,Myanmar,1,0,,1,POINT (4697157 -74140516)
2012,Febrero,Nicaragua,9,8,,17,POINT (10446304 -75516486)
2012,Febrero,Nicaragua,1,3,,4,POINT (10886686 -74776479)
2012,Febrero,Nicaragua,1,4,,5,POINT (3451668 -76532004)
2012,Febrero,Nicaragua,1,0,,1,POINT (445285 -75766353)
2012,Febrero,Nicaragua,52,47,,99,POINT (4697157 -74140516)
2012,Febrero,Nicaragua,8,6,,14,POINT (6170465 -7542726)
2012,Febrero,Nicaragua,0,1,,1,POINT (7927233 -72508188)
2012,Febrero,Nigeria,1,1,,2,POINT (10446304 -75516486)
2012,Febrero,Nigeria,2,5,,7,POINT (4697157 -74140516)
2012,Febrero,Noruega,6,8,,14,POINT (0.81488 -77356)
2012,Febrero,Noruega,4,5,,9,POINT (10406342 -75527794)
2012,Febrero,Noruega,7,10,,17,POINT (10446304 -75516486)
2012,Febrero,Noruega,0,2,,2,POINT (10886686 -74776479)
2012,Febrero,Noruega,1,0,,1,POINT (11360029 -72129595)
2012,Febrero,Noruega,2,6,,8,POINT (3451668 -76532004)
2012,Febrero,Noruega,91,150,,241,POINT (4697157 -74140516)
2012,Febrero,Noruega,8,18,,26,POINT (6170465 -7542726)
2012,Febrero,Noruega,0,1,,1,POINT (7819 -72453013)
2012,Febrero,Noruega,1,1,,2,POINT (7927233 -72508188)
2012,Febrero,Nueva Zelanda,5,4,,9,POINT (0.81488 -77356)
2012,Febrero,Nueva Zelanda,2,4,,6,POINT (10446304 -75516486)
2012,Febrero,Nueva Zelanda,0,2,,2,POINT (10886686 -74776479)
2012,Febrero,Nueva Zelanda,1,0,,1,POINT (11360029 -72129595)
2012,Febrero,Nueva Zelanda,1,0,,1,POINT (3451668 -76532004)
2012,Febrero,Nueva Zelanda,20,68,,88,POINT (4697157 -74140516)
2012,Febrero,Nueva Zelanda,0,1,,1,POINT (4815189 -75736374)
2012,Febrero,Nueva Zelanda,0,6,,6,POINT (6170465 -7542726)
2012,Febrero,Nueva Zelanda,0,1,,1,POINT (7819 -72453013)
2012,Febrero,Nueva Zelanda,0,1,,1,POINT (863337 -7735002)
2012,Febrero,Papúa Nueva Guinea,0,1,,1,POINT (4697157 -74140516)
2012,Febrero,Nueva Zelanda,4,8,,12,POINT (10406342 -75527794)
2012,Febrero,Nueva Zelanda,0,1,,1,POINT (125744111 -81703935)
2012,Febrero,Nueva Zelanda,2,5,,7,POINT (4697157 -74140516)
2012,Febrero,Nueva Zelanda,1,0,,1,POINT (863337 -7735002)
2012,Febrero,Países Bajos,21,18,,39,POINT (0.81488 -77356)
2012,Febrero,Países Bajos,1,15,,16,POINT (10446304 -75516486)
2012,Febrero,Países Bajos,5,16,,21,POINT (10886686 -74776479)
2012,Febrero,Países Bajos,0,6,,6,POINT (11360029 -72129595)
2012,Febrero,Países Bajos,16,31,,47,POINT (1152863 -72919186)
2012,Febrero,Países Bajos,11,22,,33,POINT (3451668 -76532004)
2012,Febrero,Países Bajos,0,2,,2,POINT (3884426 -77061029)
2012,Febrero,Países Bajos,143,227,,370,POINT (4697157 -74140516)
2012,Febrero,Países Bajos,1,2,,3,POINT (4815189 -75736374)
2012,Febrero,Países Bajos,113,163,,276,POINT (6170465 -7542726)
2012,Febrero,Países Bajos,1,0,,1,POINT (7819 -72453013)
2012,Febrero,Países Bajos,1,0,,1,POINT (7927233 -72508188)
2012,Febrero,Pakistán,0,1,,1,POINT (0.81488 -77356)
2012,Febrero,Pakistán,0,1,,1,POINT (10446304 -75516486)
2012,Febrero,Pakistán,0,6,,6,POINT (4697157 -74140516)
2012,Febrero,Pakistán,0,1,,1,POINT (6170465 -7542726)
2012,Febrero,Panamá,0,5,,5,POINT (10406342 -75527794)
2012,Febrero,Panamá,120,167,,287,POINT (10446304 -75516486)
2012,Febrero,Panamá,73,118,,191,POINT (10886686 -74776479)
2012,Febrero,Panamá,0,3,,3,POINT (125744111 -81703935)
2012,Febrero,Panamá,60,55,,115,POINT (125862 -81702165)
2012,Febrero,Panamá,73,94,,167,POINT (3451668 -76532004)
2012,Febrero,Panamá,0,2,,2,POINT (3884426 -77061029)
2012,Febrero,Panamá,512,722,,1234,POINT (4697157 -74140516)
2012,Febrero,Panamá,56,82,,138,POINT (4815189 -75736374)
2012,Febrero,Panamá,132,258,,390,POINT (6170465 -7542726)
2012,Febrero,Panamá,1,2,,3,POINT (6222552 -77401154)
2012,Febrero,Panamá,11,6,,17,POINT (7128047 -73181317)
2012,Febrero,Panamá,1,2,,3,POINT (7819 -72453013)
2012,Febrero,Panamá,4,7,,11,POINT (7927233 -72508188)
2012,Febrero,Panamá,2,10,,12,POINT (863337 -7735002)
2012,Febrero,Paraguay,2,0,,2,POINT (0.81488 -77356)
2012,Febrero,Paraguay,2,2,,4,POINT (10406342 -75527794)
2012,Febrero,Paraguay,3,0,,3,POINT (10446304 -75516486)
2012,Febrero,Paraguay,0,1,,1,POINT (10886686 -74776479)
2012,Febrero,Paraguay,18,13,,31,POINT (125862 -81702165)
2012,Febrero,Paraguay,2,8,,10,POINT (3451668 -76532004)
2012,Febrero,Paraguay,66,96,,162,POINT (4697157 -74140516)
2012,Febrero,Paraguay,7,6,,13,POINT (6170465 -7542726)
2012,Febrero,Paraguay,1,2,,3,POINT (7819 -72453013)
2012,Febrero,Perú,30,23,,53,POINT (-4191162 -69941498)
2012,Febrero,Perú,3,2,,5,POINT (0.33002 -76876446)
2012,Febrero,Perú,218,382,,600,POINT (0.81488 -77356)
2012,Febrero,Perú,161,93,,254,POINT (10406342 -75527794)
2012,Febrero,Perú,226,185,,411,POINT (10446304 -75516486)
2012,Febrero,Perú,8,22,,30,POINT (10886686 -74776479)
2012,Febrero,Perú,0,1,,1,POINT (11247723 -74213989)
2012,Febrero,Perú,5,7,,12,POINT (11360029 -72129595)
2012,Febrero,Perú,0,1,,1,POINT (1152863 -72919186)
2012,Febrero,Perú,287,207,,494,POINT (125862 -81702165)
2012,Febrero,Perú,62,88,,150,POINT (3451668 -76532004)
2012,Febrero,Perú,0,1,,1,POINT (3884426 -77061029)
2012,Febrero,Perú,2539,3289,,5828,POINT (4697157 -74140516)
2012,Febrero,Perú,0,3,,3,POINT (4815189 -75736374)
2012,Febrero,Perú,136,257,,393,POINT (6170465 -7542726)
2012,Febrero,Perú,39,75,,114,POINT (7819 -72453013)
2012,Febrero,Perú,1,1,,2,POINT (7927233 -72508188)
2012,Febrero,Perú,0,1,,1,POINT (863337 -7735002)
2012,Febrero,Palestina,0,1,,1,POINT (10446304 -75516486)
2012,Febrero,Palestina,0,2,,2,POINT (4697157 -74140516)
2012,Febrero,Polonia,1,1,,2,POINT (-4191162 -69941498)
2012,Febrero,Polonia,12,21,,33,POINT (0.81488 -77356)
2012,Febrero,Polonia,1,0,,1,POINT (1800143 -78802679)
2012,Febrero,Polonia,5,18,,23,POINT (10406342 -75527794)
2012,Febrero,Polonia,2,8,,10,POINT (10446304 -75516486)
2012,Febrero,Polonia,0,2,,2,POINT (10886686 -74776479)
2012,Febrero,Polonia,1,13,,14,POINT (10970933 -74765343)
2012,Febrero,Polonia,1,6,,7,POINT (11247723 -74213989)
2012,Febrero,Polonia,2,4,,6,POINT (11360029 -72129595)
2012,Febrero,Polonia,1,1,,2,POINT (3451668 -76532004)
2012,Febrero,Polonia,0,1,,1,POINT (3884426 -77061029)
2012,Febrero,Polonia,82,154,,236,POINT (4697157 -74140516)
2012,Febrero,Polonia,0,3,,3,POINT (6170465 -7542726)
2012,Febrero,Polonia,1,0,,1,POINT (7128047 -73181317)
2012,Febrero,Polonia,1,2,,3,POINT (7819 -72453013)
2012,Febrero,Polonia,1,1,,2,POINT (863337 -7735002)
2012,Febrero,Portugal,0,4,,4,POINT (-4191162 -69941498)
2012,Febrero,Portugal,2,5,,7,POINT (0.81488 -77356)
2012,Febrero,Portugal,1,1,,2,POINT (10406342 -75527794)
2012,Febrero,Portugal,1,6,,7,POINT (10446304 -75516486)
2012,Febrero,Portugal,3,1,,4,POINT (10886686 -74776479)
2012,Febrero,Portugal,2,3,,5,POINT (11360029 -72129595)
2012,Febrero,Portugal,1,12,,13,POINT (3451668 -76532004)
2012,Febrero,Portugal,74,222,,296,POINT (4697157 -74140516)
2012,Febrero,Portugal,1,10,,11,POINT (6170465 -7542726)
2012,Febrero,Portugal,1,7,,8,POINT (7819 -72453013)
2012,Febrero,Puerto Rico/Territorio de Estados Unidos,0,1,,1,POINT (10446304 -75516486)
2012,Febrero,Puerto Rico/Territorio de Estados Unidos,0,2,,2,POINT (3451668 -76532004)
2012,Febrero,Reino Unido de Gran Bretaña e Irlanda del Norte,2,5,,7,POINT (-4191162 -69941498)
2012,Febrero,Reino Unido de Gran Bretaña e Irlanda del Norte,3,6,,9,POINT (0.81488 -77356)
2012,Febrero,Reino Unido de Gran Bretaña e Irlanda del Norte,15,24,,39,POINT (10446304 -75516486)
2012,Febrero,Reino Unido de Gran Bretaña e Irlanda del Norte,2,5,,7,POINT (11360029 -72129595)
2012,Febrero,Reino Unido de Gran Bretaña e Irlanda del Norte,4,15,,19,POINT (3451668 -76532004)
2012,Febrero,Reino Unido de Gran Bretaña e Irlanda del Norte,163,438,,601,POINT (4697157 -74140516)
2012,Febrero,Reino Unido de Gran Bretaña e Irlanda del Norte,5,20,,25,POINT (6170465 -7542726)
2012,Febrero,Reino Unido de Gran Bretaña e Irlanda del Norte,0,2,,2,POINT (7128047 -73181317)
2012,Febrero,Reino Unido de Gran Bretaña e Irlanda del Norte,1,1,,2,POINT (7819 -72453013)
2012,Febrero,Reino Unido de Gran Bretaña e Irlanda del Norte,0,1,,1,POINT (7927233 -72508188)
2012,Febrero,Reino Unido de Gran Bretaña e Irlanda del Norte,4,2,,6,POINT (863337 -7735002)
2012,Febrero,República de Belarús,3,0,,3,POINT (4697157 -74140516)
2012,Febrero,República Dominicana,0,2,,2,POINT (-4191162 -69941498)
2012,Febrero,República Dominicana,0,4,,4,POINT (0.81488 -77356)
2012,Febrero,República Dominicana,1,4,,5,POINT (10406342 -75527794)
2012,Febrero,República Dominicana,21,34,,55,POINT (10446304 -75516486)
2012,Febrero,República Dominicana,11,42,,53,POINT (10886686 -74776479)
2012,Febrero,República Dominicana,0,6,,6,POINT (11360029 -72129595)
2012,Febrero,República Dominicana,6,22,,28,POINT (3451668 -76532004)
2012,Febrero,República Dominicana,198,333,,531,POINT (4697157 -74140516)
2012,Febrero,República Dominicana,1,5,,6,POINT (4815189 -75736374)
2012,Febrero,República Dominicana,23,40,,63,POINT (6170465 -7542726)
2012,Febrero,República Dominicana,1,0,,1,POINT (7128047 -73181317)
2012,Febrero,República Dominicana,2,3,,5,POINT (7819 -72453013)
2012,Febrero,República Dominicana,4,4,,8,POINT (7927233 -72508188)
2012,Febrero,República Checa,0,1,,1,POINT (1800143 -78802679)
2012,Febrero,República Checa,2,3,,5,POINT (4697157 -74140516)
2012,Febrero,República Checa,0,1,,1,POINT (7819 -72453013)
2012,Febrero,Rumania,0,1,,1,POINT (1800143 -78802679)
2012,Febrero,Rumania,0,4,,4,POINT (10406342 -75527794)
2012,Febrero,Rumania,0,1,,1,POINT (10446304 -75516486)
2012,Febrero,Rumania,1,1,,2,POINT (10886686 -74776479)
2012,Febrero,Rumania,0,1,,1,POINT (125862 -81702165)
2012,Febrero,Rumania,1,1,,2,POINT (3451668 -76532004)
2012,Febrero,Rumania,37,50,,87,POINT (4697157 -74140516)
2012,Febrero,Rumania,1,0,,1,POINT (6170465 -7542726)
2012,Febrero,Federación de Rusia,0,1,,1,POINT (-4191162 -69941498)
2012,Febrero,Federación de Rusia,17,14,,31,POINT (0.81488 -77356)
2012,Febrero,Federación de Rusia,3,1,,4,POINT (10406342 -75527794)
2012,Febrero,Federación de Rusia,5,2,,7,POINT (10446304 -75516486)
2012,Febrero,Federación de Rusia,1,0,,1,POINT (10886686 -74776479)
2012,Febrero,Federación de Rusia,0,1,,1,POINT (11360029 -72129595)
2012,Febrero,Federación de Rusia,1,1,,2,POINT (3451668 -76532004)
2012,Febrero,Federación de Rusia,53,76,,129,POINT (4697157 -74140516)
2012,Febrero,Federación de Rusia,1,0,,1,POINT (6170465 -7542726)
2012,Febrero,Federación de Rusia,0,2,,2,POINT (863337 -7735002)
2012,Febrero,Rwanda,0,1,,1,POINT (4697157 -74140516)
2012,Febrero,San Cristóbal y Nevis,1,1,,2,POINT (4697157 -74140516)
2012,Febrero,San Cristóbal y Nevis,0,1,,1,POINT (6170465 -7542726)
2012,Febrero,Samoa Occidental,1,0,,1,POINT (4697157 -74140516)
2012,Febrero,San Marino,0,1,,1,POINT (-4191162 -69941498)
2012,Febrero,San Marino,0,1,,1,POINT (4815189 -75736374)
2012,Febrero,San  Vicente y las Granadinas,2,1,,3,POINT (4697157 -74140516)
2012,Febrero,Santa Lucia,0,1,,1,POINT (10886686 -74776479)
2012,Febrero,Santa Lucia,2,2,,4,POINT (4697157 -74140516)
2012,Febrero,Senegal,1,0,,1,POINT (4697157 -74140516)
2012,Febrero,Serbia,1,1,,2,POINT (10406342 -75527794)
2012,Febrero,Serbia,7,7,,14,POINT (4697157 -74140516)
2012,Febrero,Serbia,0,1,,1,POINT (6170465 -7542726)
2012,Febrero,Singapur,1,14,,15,POINT (4697157 -74140516)
2012,Febrero,Singapur,0,1,,1,POINT (6170465 -7542726)
2012,Febrero,República Árabe Siria,0,1,,1,POINT (11360029 -72129595)
2012,Febrero,Sri Lanka,0,3,,3,POINT (4697157 -74140516)
2012,Febrero,Sudáfrica,1,2,,3,POINT (-4191162 -69941498)
2012,Febrero,Sudáfrica,0,4,,4,POINT (0.81488 -77356)
2012,Febrero,Sudáfrica,0,3,,3,POINT (10406342 -75527794)
2012,Febrero,Sudáfrica,0,4,,4,POINT (10446304 -75516486)
2012,Febrero,Sudáfrica,0,1,,1,POINT (10886686 -74776479)
2012,Febrero,Sudáfrica,1,0,,1,POINT (11360029 -72129595)
2012,Febrero,Sudáfrica,0,1,,1,POINT (125744111 -81703935)
2012,Febrero,Sudáfrica,12,65,,77,POINT (4697157 -74140516)
2012,Febrero,Sudáfrica,1,0,,1,POINT (6170465 -7542726)
2012,Febrero,Sudáfrica,0,1,,1,POINT (7819 -72453013)
2012,Febrero,Sudáfrica,1,1,,2,POINT (863337 -7735002)
2012,Febrero,Sudán,0,2,,2,POINT (4697157 -74140516)
2012,Febrero,Suecia,13,16,,29,POINT (-4191162 -69941498)
2012,Febrero,Suecia,17,10,,27,POINT (0.81488 -77356)
2012,Febrero,Suecia,4,3,,7,POINT (10406342 -75527794)
2012,Febrero,Suecia,6,11,,17,POINT (10446304 -75516486)
2012,Febrero,Suecia,0,2,,2,POINT (10886686 -74776479)
2012,Febrero,Suecia,0,1,,1,POINT (11247723 -74213989)
2012,Febrero,Suecia,2,4,,6,POINT (11360029 -72129595)
2012,Febrero,Suecia,1,1,,2,POINT (125744111 -81703935)
2012,Febrero,Suecia,1,0,,1,POINT (133387613 -81372937)
2012,Febrero,Suecia,3,5,,8,POINT (3451668 -76532004)
2012,Febrero,Suecia,180,244,,424,POINT (4697157 -74140516)
2012,Febrero,Suecia,7,8,,15,POINT (6170465 -7542726)
2012,Febrero,Suecia,3,2,,5,POINT (7819 -72453013)
2012,Febrero,Suecia,1,1,,2,POINT (863337 -7735002)
2012,Febrero,Suiza,3,2,,5,POINT (-4191162 -69941498)
2012,Febrero,Suiza,0,1,,1,POINT (0.33002 -76876446)
2012,Febrero,Suiza,40,41,,81,POINT (0.81488 -77356)
2012,Febrero,Suiza,2,8,,10,POINT (10406342 -75527794)
2012,Febrero,Suiza,23,13,,36,POINT (10446304 -75516486)
2012,Febrero,Suiza,2,4,,6,POINT (10886686 -74776479)
2012,Febrero,Suiza,2,3,,5,POINT (11360029 -72129595)
2012,Febrero,Suiza,0,2,,2,POINT (125744111 -81703935)
2012,Febrero,Suiza,1,1,,2,POINT (125862 -81702165)
2012,Febrero,Suiza,21,27,,48,POINT (3451668 -76532004)
2012,Febrero,Suiza,275,508,,783,POINT (4697157 -74140516)
2012,Febrero,Suiza,20,41,,61,POINT (6170465 -7542726)
2012,Febrero,Suiza,1,4,,5,POINT (7819 -72453013)
2012,Febrero,Suiza,2,8,,10,POINT (863337 -7735002)
2012,Febrero,Surinam,4,1,,5,POINT (10446304 -75516486)
2012,Febrero,Surinam,7,11,,18,POINT (4697157 -74140516)
2012,Febrero,Surinam,2,2,,4,POINT (6170465 -7542726)
2012,Febrero,Taiwán,10,1,,11,POINT (10406342 -75527794)
2012,Febrero,Taiwán,1,4,,5,POINT (4697157 -74140516)
2012,Febrero,Taiwán,2,2,,4,POINT (7819 -72453013)
2012,Febrero,Tailandia,4,1,,5,POINT (4697157 -74140516)
2012,Febrero,Tailandia,0,1,,1,POINT (6170465 -7542726)
2012,Febrero,Tíbet/Región Autónoma de China,0,1,,1,POINT (4697157 -74140516)
2012,Febrero,Territorio Antártico Británico/Territorio Británico de Ultramar,0,1,,1,POINT (0.81488 -77356)
2012,Febrero,Territorio Antártico Británico/Territorio Británico de Ultramar,1,4,,5,POINT (4697157 -74140516)
2012,Febrero,Territorio Antártico Británico/Territorio Británico de Ultramar,0,1,,1,POINT (6170465 -7542726)
2012,Febrero,Tanzania,2,5,,7,POINT (4697157 -74140516)
2012,Febrero,Trinidad y Tobago,0,1,,1,POINT (10406342 -75527794)
2012,Febrero,Trinidad y Tobago,1,8,,9,POINT (10446304 -75516486)
2012,Febrero,Trinidad y Tobago,0,2,,2,POINT (10886686 -74776479)
2012,Febrero,Trinidad y Tobago,0,1,,1,POINT (125862 -81702165)
2012,Febrero,Trinidad y Tobago,1,3,,4,POINT (3451668 -76532004)
2012,Febrero,Trinidad y Tobago,13,27,,40,POINT (4697157 -74140516)
2012,Febrero,Trinidad y Tobago,0,2,,2,POINT (4815189 -75736374)
2012,Febrero,Trinidad y Tobago,4,3,,7,POINT (6170465 -7542726)
2012,Febrero,Trinidad y Tobago,1,2,,3,POINT (7128047 -73181317)
2012,Febrero,Trinidad y Tobago,0,2,,2,POINT (7819 -72453013)
2012,Febrero,Túnez,0,1,,1,POINT (10406342 -75527794)
2012,Febrero,Turquía,0,5,,5,POINT (0.81488 -77356)
2012,Febrero,Turquía,2,4,,6,POINT (10446304 -75516486)
2012,Febrero,Turquía,0,5,,5,POINT (3451668 -76532004)
2012,Febrero,Turquía,23,63,,86,POINT (4697157 -74140516)
2012,Febrero,Turquía,0,3,,3,POINT (6170465 -7542726)
2012,Febrero,Turquía,0,4,,4,POINT (7819 -72453013)
2012,Febrero,Ucrania,6,10,,16,POINT (0.81488 -77356)
2012,Febrero,Ucrania,1,0,,1,POINT (3451668 -76532004)
2012,Febrero,Ucrania,0,3,,3,POINT (3884426 -77061029)
2012,Febrero,Ucrania,10,12,,22,POINT (4697157 -74140516)
2012,Febrero,Ucrania,1,1,,2,POINT (6170465 -7542726)
2012,Febrero,Ucrania,3,4,,7,POINT (7819 -72453013)
2012,Febrero,Uganda,0,1,,1,POINT (3451668 -76532004)
2012,Febrero,Uganda,0,3,,3,POINT (4697157 -74140516)
2012,Febrero,Federación de Rusia,4,4,,8,POINT (10406342 -75527794)
2012,Febrero,Federación de Rusia,1,1,,2,POINT (10446304 -75516486)
2012,Febrero,Federación de Rusia,0,1,,1,POINT (11247723 -74213989)
2012,Febrero,Federación de Rusia,2,3,,5,POINT (11360029 -72129595)
2012,Febrero,Federación de Rusia,99,131,,230,POINT (4697157 -74140516)
2012,Febrero,Federación de Rusia,1,3,,4,POINT (6170465 -7542726)
2012,Febrero,Federación de Rusia,12,8,,20,POINT (7819 -72453013)
2012,Febrero,Uruguay,0,1,,1,POINT (0.33002 -76876446)
2012,Febrero,Uruguay,3,8,,11,POINT (0.81488 -77356)
2012,Febrero,Uruguay,12,11,,23,POINT (10406342 -75527794)
2012,Febrero,Uruguay,115,75,,190,POINT (10446304 -75516486)
2012,Febrero,Uruguay,4,8,,12,POINT (10886686 -74776479)
2012,Febrero,Uruguay,0,1,,1,POINT (11360029 -72129595)
2012,Febrero,Uruguay,94,73,,167,POINT (125862 -81702165)
2012,Febrero,Uruguay,7,15,,22,POINT (3451668 -76532004)
2012,Febrero,Uruguay,113,249,,362,POINT (4697157 -74140516)
2012,Febrero,Uruguay,1,2,,3,POINT (4815189 -75736374)
2012,Febrero,Uruguay,5,33,,38,POINT (6170465 -7542726)
2012,Febrero,Uruguay,1,1,,2,POINT (7128047 -73181317)
2012,Febrero,Uruguay,3,6,,9,POINT (7819 -72453013)
2012,Febrero,Uruguay,0,1,,1,POINT (7927233 -72508188)
2012,Febrero,Uruguay,0,1,,1,POINT (863337 -7735002)
2012,Febrero,Venezuela,0,3,,3,POINT (-4191162 -69941498)
2012,Febrero,Venezuela,95,123,,218,POINT (0.81488 -77356)
2012,Febrero,Venezuela,9,15,,24,POINT (10406342 -75527794)
2012,Febrero,Venezuela,81,113,,194,POINT (10446304 -75516486)
2012,Febrero,Venezuela,82,116,,198,POINT (10886686 -74776479)
2012,Febrero,Venezuela,0,1,,1,POINT (10970933 -74765343)
2012,Febrero,Venezuela,0,4,,4,POINT (11117206 -74232675)
2012,Febrero,Venezuela,0,3,,3,POINT (11247723 -74213989)
2012,Febrero,Venezuela,1852,2260,,4112,POINT (11360029 -72129595)
2012,Febrero,Venezuela,3,2,,5,POINT (1152863 -72919186)
2012,Febrero,Venezuela,9,13,,22,POINT (125862 -81702165)
2012,Febrero,Venezuela,49,60,,109,POINT (3451668 -76532004)
2012,Febrero,Venezuela,0,2,,2,POINT (445285 -75766353)
2012,Febrero,Venezuela,4326,5705,,10031,POINT (4697157 -74140516)
2012,Febrero,Venezuela,2,15,,17,POINT (4815189 -75736374)
2012,Febrero,Venezuela,294,336,,630,POINT (6170465 -7542726)
2012,Febrero,Venezuela,4,6,,10,POINT (6185536 -67484028)
2012,Febrero,Venezuela,27,45,,72,POINT (7088729 -70740253)
2012,Febrero,Venezuela,6,10,,16,POINT (7128047 -73181317)
2012,Febrero,Venezuela,1318,1520,,2838,POINT (7819 -72453013)
2012,Febrero,Venezuela,325,382,,707,POINT (7927233 -72508188)
2012,Febrero,Venezuela,7,4,,11,POINT (863337 -7735002)
2012,Febrero,Vietnam,1,0,,1,POINT (10446304 -75516486)
2012,Febrero,Vietnam,2,1,,3,POINT (4697157 -74140516)
2012,Febrero,Vietnam,1,0,,1,POINT (6170465 -7542726)
2012,Febrero,Yugoslavia,0,1,,1,POINT (6170465 -7542726)
2012,Febrero,Zambia,1,3,,4,POINT (4697157 -74140516)
2012,Febrero,Zimbabue,1,1,,2,POINT (4697157 -74140516)
2012,Febrero,Reino Unido de Gran Bretaña e Irlanda del Norte,4,6,,10,POINT (-4191162 -69941498)
2012,Febrero,Reino Unido de Gran Bretaña e Irlanda del Norte,1,11,,12,POINT (0.81488 -77356)
2012,Febrero,Reino Unido de Gran Bretaña e Irlanda del Norte,15,15,,30,POINT (10406342 -75527794)
2012,Febrero,Reino Unido de Gran Bretaña e Irlanda del Norte,14,26,,40,POINT (10446304 -75516486)
2012,Febrero,Reino Unido de Gran Bretaña e Irlanda del Norte,2,1,,3,POINT (10886686 -74776479)
2012,Febrero,Reino Unido de Gran Bretaña e Irlanda del Norte,0,2,,2,POINT (11247723 -74213989)
2012,Febrero,Reino Unido de Gran Bretaña e Irlanda del Norte,1,6,,7,POINT (11360029 -72129595)
2012,Febrero,Reino Unido de Gran Bretaña e Irlanda del Norte,1,0,,1,POINT (125744111 -81703935)
2012,Febrero,Reino Unido de Gran Bretaña e Irlanda del Norte,1,3,,4,POINT (125862 -81702165)
2012,Febrero,Reino Unido de Gran Bretaña e Irlanda del Norte,6,18,,24,POINT (3451668 -76532004)
2012,Febrero,Reino Unido de Gran Bretaña e Irlanda del Norte,257,612,,869,POINT (4697157 -74140516)
2012,Febrero,Reino Unido de Gran Bretaña e Irlanda del Norte,13,29,,42,POINT (6170465 -7542726)
2012,Febrero,Reino Unido de Gran Bretaña e Irlanda del Norte,3,8,,11,POINT (7819 -72453013)
2012,Febrero,Reino Unido de Gran Bretaña e Irlanda del Norte,1,6,,7,POINT (863337 -7735002)
2012,Febrero,Países Bajos,3,4,,7,POINT (-4191162 -69941498)
2012,Febrero,Países Bajos,4,7,,11,POINT (0.81488 -77356)
2012,Febrero,Países Bajos,8,13,,21,POINT (10406342 -75527794)
2012,Febrero,Países Bajos,9,28,,37,POINT (10446304 -75516486)
2012,Febrero,Países Bajos,1,2,,3,POINT (10886686 -74776479)
2012,Febrero,Países Bajos,1,4,,5,POINT (11360029 -72129595)
2012,Febrero,Países Bajos,1,0,,1,POINT (1152863 -72919186)
2012,Febrero,Países Bajos,1,1,,2,POINT (125862 -81702165)
2012,Febrero,Países Bajos,19,35,,54,POINT (3451668 -76532004)
2012,Febrero,Países Bajos,0,2,,2,POINT (3884426 -77061029)
2012,Febrero,Países Bajos,407,720,,1127,POINT (4697157 -74140516)
2012,Febrero,Países Bajos,47,61,,108,POINT (6170465 -7542726)
2012,Febrero,Países Bajos,0,1,,1,POINT (6185536 -67484028)
2012,Febrero,Países Bajos,2,10,,12,POINT (7819 -72453013)
2012,Febrero,Países Bajos,2,2,,4,POINT (7927233 -72508188)
2012,Febrero,Países Bajos,0,5,,5,POINT (863337 -7735002)
2012,Febrero,Eslovenia,0,2,,2,POINT (4697157 -74140516)
2012,Febrero,Lituania,6,1,,7,POINT (4697157 -74140516)
2012,Febrero,Reino Unido de Gran Bretaña e Irlanda del Norte,0,1,,1,POINT (11247723 -74213989)
2012,Febrero,Reino Unido de Gran Bretaña e Irlanda del Norte,0,1,,1,POINT (0.81488 -77356)
2012,Febrero,Reino Unido de Gran Bretaña e Irlanda del Norte,3,8,,11,POINT (4697157 -74140516)
2012,Febrero,Reino Unido de Gran Bretaña e Irlanda del Norte,1,0,,1,POINT (0.81488 -77356)
2012,Febrero,Reino Unido de Gran Bretaña e Irlanda del Norte,3,3,,6,POINT (10406342 -75527794)
2012,Febrero,Reino Unido de Gran Bretaña e Irlanda del Norte,1,2,,3,POINT (10446304 -75516486)
2012,Febrero,Reino Unido de Gran Bretaña e Irlanda del Norte,4,8,,12,POINT (4697157 -74140516)
2012,Febrero,Reino Unido de Gran Bretaña e Irlanda del Norte,0,1,,1,POINT (6170465 -7542726)
2012,Febrero,Reino Unido de Gran Bretaña e Irlanda del Norte,1,0,,1,POINT (863337 -7735002)
2012,Febrero,Letonia,0,1,,1,POINT (6170465 -7542726)
2012,Febrero,Marruecos,0,2,,2,POINT (4697157 -74140516)
2012,Febrero,República CentroÁfricana,1,1,,2,POINT (4697157 -74140516)
2012,Febrero,Desconocido,0,1,,1,POINT (4697157 -74140516)
2012,Marzo,Albania,1,0,,1,POINT (4697157 -74140516)
2012,Marzo,Alemania,11,19,,30,POINT (-4191162 -69941498)
2012,Marzo,Alemania,1,0,,1,POINT (0.33002 -76876446)
2012,Marzo,Alemania,62,69,,131,POINT (0.81488 -77356)
2012,Marzo,Alemania,0,1,,1,POINT (1800143 -78802679)
2012,Marzo,Alemania,22,21,,43,POINT (10406342 -75527794)
2012,Marzo,Alemania,20,41,,61,POINT (10446304 -75516486)
2012,Marzo,Alemania,5,17,,22,POINT (10886686 -74776479)
2012,Marzo,Alemania,0,1,,1,POINT (10970933 -74765343)
2012,Marzo,Alemania,5,7,,12,POINT (11360029 -72129595)
2012,Marzo,Alemania,5,3,,8,POINT (125862 -81702165)
2012,Marzo,Alemania,1,1,,2,POINT (133387613 -81372937)
2012,Marzo,Alemania,25,46,,71,POINT (3451668 -76532004)
2012,Marzo,Alemania,0,1,,1,POINT (445285 -75766353)
2012,Marzo,Alemania,1411,2262,,3673,POINT (4697157 -74140516)
2012,Marzo,Alemania,1,3,,4,POINT (4815189 -75736374)
2012,Marzo,Alemania,24,62,,86,POINT (6170465 -7542726)
2012,Marzo,Alemania,1,0,,1,POINT (6185536 -67484028)
2012,Marzo,Alemania,5,20,,25,POINT (7819 -72453013)
2012,Marzo,Alemania,5,12,,17,POINT (863337 -7735002)
2012,Marzo,Andorra,0,1,,1,POINT (3451668 -76532004)
2012,Marzo,Andorra,1,8,,9,POINT (4697157 -74140516)
2012,Marzo,Andorra,0,1,,1,POINT (6170465 -7542726)
2012,Marzo,Angola,0,2,,2,POINT (10886686 -74776479)
2012,Marzo,Angola,1,0,,1,POINT (4697157 -74140516)
2012,Marzo,Antigua y Barbuda,2,1,,3,POINT (4697157 -74140516)
2012,Marzo,Países Bajos,4,2,,6,POINT (4697157 -74140516)
2012,Marzo,Países Bajos,2,8,,10,POINT (6170465 -7542726)
2012,Marzo,Arabia Saudita,0,2,,2,POINT (4697157 -74140516)
2012,Marzo,Arabia Saudita,1,1,,2,POINT (4697157 -74140516)
2012,Marzo,Argelia,0,1,,1,POINT (4697157 -74140516)
2012,Marzo,Argentina,1,4,,5,POINT (-4191162 -69941498)
2012,Marzo,Argentina,2,1,,3,POINT (0.33002 -76876446)
2012,Marzo,Argentina,73,134,,207,POINT (0.81488 -77356)
2012,Marzo,Argentina,0,1,,1,POINT (1800143 -78802679)
2012,Marzo,Argentina,32,31,,63,POINT (10406342 -75527794)
2012,Marzo,Argentina,656,482,,1138,POINT (10446304 -75516486)
2012,Marzo,Argentina,17,43,,60,POINT (10886686 -74776479)
2012,Marzo,Argentina,19,35,,54,POINT (11360029 -72129595)
2012,Marzo,Argentina,391,273,,664,POINT (125862 -81702165)
2012,Marzo,Argentina,44,72,,116,POINT (3451668 -76532004)
2012,Marzo,Argentina,0,1,,1,POINT (3884426 -77061029)
2012,Marzo,Argentina,1,0,,1,POINT (445285 -75766353)
2012,Marzo,Argentina,3155,4509,,7664,POINT (4697157 -74140516)
2012,Marzo,Argentina,0,4,,4,POINT (4815189 -75736374)
2012,Marzo,Argentina,64,214,,278,POINT (6170465 -7542726)
2012,Marzo,Argentina,0,1,,1,POINT (7128047 -73181317)
2012,Marzo,Argentina,14,49,,63,POINT (7819 -72453013)
2012,Marzo,Argentina,1,0,,1,POINT (7927233 -72508188)
2012,Marzo,Argentina,2,9,,11,POINT (863337 -7735002)
2012,Marzo,República de Armenia,0,2,,2,POINT (4697157 -74140516)
2012,Marzo,Aruba,4,3,,7,POINT (4697157 -74140516)
2012,Marzo,Aruba,0,1,,1,POINT (6170465 -7542726)
2012,Marzo,Australia,9,16,,25,POINT (-4191162 -69941498)
2012,Marzo,Australia,14,18,,32,POINT (0.81488 -77356)
2012,Marzo,Australia,1,0,,1,POINT (1800143 -78802679)
2012,Marzo,Australia,18,21,,39,POINT (10406342 -75527794)
2012,Marzo,Australia,29,48,,77,POINT (10446304 -75516486)
2012,Marzo,Australia,5,14,,19,POINT (10886686 -74776479)
2012,Marzo,Australia,5,7,,12,POINT (11360029 -72129595)
2012,Marzo,Australia,11,22,,33,POINT (3451668 -76532004)
2012,Marzo,Australia,1,0,,1,POINT (445285 -75766353)
2012,Marzo,Australia,179,341,,520,POINT (4697157 -74140516)
2012,Marzo,Australia,0,1,,1,POINT (4815189 -75736374)
2012,Marzo,Australia,10,42,,52,POINT (6170465 -7542726)
2012,Marzo,Australia,0,2,,2,POINT (7819 -72453013)
2012,Marzo,Australia,4,6,,10,POINT (863337 -7735002)
2012,Marzo,Austria,0,1,,1,POINT (-4191162 -69941498)
2012,Marzo,Austria,5,9,,14,POINT (0.81488 -77356)
2012,Marzo,Austria,4,3,,7,POINT (10406342 -75527794)
2012,Marzo,Austria,2,1,,3,POINT (10446304 -75516486)
2012,Marzo,Austria,2,5,,7,POINT (10886686 -74776479)
2012,Marzo,Austria,2,3,,5,POINT (11360029 -72129595)
2012,Marzo,Austria,2,3,,5,POINT (3451668 -76532004)
2012,Marzo,Austria,98,182,,280,POINT (4697157 -74140516)
2012,Marzo,Austria,2,16,,18,POINT (6170465 -7542726)
2012,Marzo,Austria,0,1,,1,POINT (7819 -72453013)
2012,Marzo,Austria,0,2,,2,POINT (863337 -7735002)
2012,Marzo,Azerbaiyán,1,2,,3,POINT (4697157 -74140516)
2012,Marzo,Bahamas,0,4,,4,POINT (10446304 -75516486)
2012,Marzo,Bahamas,0,3,,3,POINT (10886686 -74776479)
2012,Marzo,Bahamas,0,1,,1,POINT (3451668 -76532004)
2012,Marzo,Bahamas,2,4,,6,POINT (4697157 -74140516)
2012,Marzo,Bahamas,0,4,,4,POINT (6170465 -7542726)
2012,Marzo,Bahréin,0,1,,1,POINT (4697157 -74140516)
2012,Marzo,Bangladesh,2,0,,2,POINT (10446304 -75516486)
2012,Marzo,Bangladesh,0,1,,1,POINT (4697157 -74140516)
2012,Marzo,Barbados,1,1,,2,POINT (10886686 -74776479)
2012,Marzo,Barbados,3,5,,8,POINT (4697157 -74140516)
2012,Marzo,Barbados,0,1,,1,POINT (6170465 -7542726)
2012,Marzo,República de Belarús,2,0,,2,POINT (4697157 -74140516)
2012,Marzo,Bélgica,0,2,,2,POINT (-4191162 -69941498)
2012,Marzo,Bélgica,12,19,,31,POINT (0.81488 -77356)
2012,Marzo,Bélgica,1,1,,2,POINT (10406342 -75527794)
2012,Marzo,Bélgica,4,9,,13,POINT (10446304 -75516486)
2012,Marzo,Bélgica,0,3,,3,POINT (10886686 -74776479)
2012,Marzo,Bélgica,1,1,,2,POINT (11360029 -72129595)
2012,Marzo,Bélgica,2,10,,12,POINT (3451668 -76532004)
2012,Marzo,Bélgica,112,299,,411,POINT (4697157 -74140516)
2012,Marzo,Bélgica,5,5,,10,POINT (6170465 -7542726)
2012,Marzo,Bélgica,0,3,,3,POINT (7819 -72453013)
2012,Marzo,Bélgica,0,1,,1,POINT (7927233 -72508188)
2012,Marzo,Bélgica,1,1,,2,POINT (863337 -7735002)
2012,Marzo,Belice,0,1,,1,POINT (11360029 -72129595)
2012,Marzo,Belice,3,5,,8,POINT (4697157 -74140516)
2012,Marzo,Belice,0,3,,3,POINT (6170465 -7542726)
2012,Marzo,Benín,0,1,,1,POINT (4697157 -74140516)
2012,Marzo,Bermudas/Territorio Británico de Ultramar,0,2,,2,POINT (10446304 -75516486)
2012,Marzo,Bermudas/Territorio Británico de Ultramar,0,4,,4,POINT (4697157 -74140516)
2012,Marzo,Bolivia,0,1,,1,POINT (-4191162 -69941498)
2012,Marzo,Bolivia,1,0,,1,POINT (0.33002 -76876446)
2012,Marzo,Bolivia,17,14,,31,POINT (0.81488 -77356)
2012,Marzo,Bolivia,8,1,,9,POINT (10406342 -75527794)
2012,Marzo,Bolivia,54,11,,65,POINT (10446304 -75516486)
2012,Marzo,Bolivia,23,14,,37,POINT (10886686 -74776479)
2012,Marzo,Bolivia,10,12,,22,POINT (3451668 -76532004)
2012,Marzo,Bolivia,259,411,,670,POINT (4697157 -74140516)
2012,Marzo,Bolivia,0,1,,1,POINT (4815189 -75736374)
2012,Marzo,Bolivia,10,19,,29,POINT (6170465 -7542726)
2012,Marzo,Bolivia,0,4,,4,POINT (7819 -72453013)
2012,Marzo,Bosnia y Herzegovina,0,2,,2,POINT (4697157 -74140516)
2012,Marzo,Brasil,37,50,,87,POINT (-4191162 -69941498)
2012,Marzo,Brasil,1,0,,1,POINT (0.33002 -76876446)
2012,Marzo,Brasil,8,17,,25,POINT (0.81488 -77356)
2012,Marzo,Brasil,33,31,,64,POINT (10406342 -75527794)
2012,Marzo,Brasil,68,65,,133,POINT (10446304 -75516486)
2012,Marzo,Brasil,9,15,,24,POINT (10886686 -74776479)
2012,Marzo,Brasil,11,13,,24,POINT (11360029 -72129595)
2012,Marzo,Brasil,39,28,,67,POINT (125862 -81702165)
2012,Marzo,Brasil,18,54,,72,POINT (3451668 -76532004)
2012,Marzo,Brasil,1960,3649,,5609,POINT (4697157 -74140516)
2012,Marzo,Brasil,3,3,,6,POINT (4815189 -75736374)
2012,Marzo,Brasil,34,106,,140,POINT (6170465 -7542726)
2012,Marzo,Brasil,0,1,,1,POINT (6185536 -67484028)
2012,Marzo,Brasil,0,1,,1,POINT (7128047 -73181317)
2012,Marzo,Brasil,8,21,,29,POINT (7819 -72453013)
2012,Marzo,Brasil,0,3,,3,POINT (7927233 -72508188)
2012,Marzo,Brasil,0,1,,1,POINT (863337 -7735002)
2012,Marzo,Bulgaria,1,2,,3,POINT (10446304 -75516486)
2012,Marzo,Bulgaria,0,1,,1,POINT (3884426 -77061029)
2012,Marzo,Bulgaria,1,8,,9,POINT (4697157 -74140516)
2012,Marzo,Islas Caimán/Territorio Británico de Ultramar,0,1,,1,POINT (10446304 -75516486)
2012,Marzo,Islas Caimán/Territorio Británico de Ultramar,0,1,,1,POINT (3451668 -76532004)
2012,Marzo,Islas Caimán/Territorio Británico de Ultramar,1,0,,1,POINT (6170465 -7542726)
2012,Marzo,Camboya,1,2,,3,POINT (4697157 -74140516)
2012,Marzo,Camerún,0,3,,3,POINT (4697157 -74140516)
2012,Marzo,Camerún,0,1,,1,POINT (6170465 -7542726)
2012,Marzo,Canadá,4,9,,13,POINT (-4191162 -69941498)
2012,Marzo,Canadá,28,25,,53,POINT (0.81488 -77356)
2012,Marzo,Canadá,17,23,,40,POINT (10406342 -75527794)
2012,Marzo,Canadá,1270,1179,,2449,POINT (10446304 -75516486)
2012,Marzo,Canadá,14,18,,32,POINT (10886686 -74776479)
2012,Marzo,Canadá,2,7,,9,POINT (11360029 -72129595)
2012,Marzo,Canadá,1,1,,2,POINT (1152863 -72919186)
2012,Marzo,Canadá,1,1,,2,POINT (125744111 -81703935)
2012,Marzo,Canadá,524,440,,964,POINT (125862 -81702165)
2012,Marzo,Canadá,2,2,,4,POINT (133387613 -81372937)
2012,Marzo,Canadá,30,50,,80,POINT (3451668 -76532004)
2012,Marzo,Canadá,3,4,,7,POINT (445285 -75766353)
2012,Marzo,Canadá,622,1320,,1942,POINT (4697157 -74140516)
2012,Marzo,Canadá,2,1,,3,POINT (4815189 -75736374)
2012,Marzo,Canadá,72,167,,239,POINT (6170465 -7542726)
2012,Marzo,Canadá,0,1,,1,POINT (6185536 -67484028)
2012,Marzo,Canadá,0,3,,3,POINT (7128047 -73181317)
2012,Marzo,Canadá,4,16,,20,POINT (7819 -72453013)
2012,Marzo,Canadá,1,0,,1,POINT (7927233 -72508188)
2012,Marzo,Canadá,0,7,,7,POINT (863337 -7735002)
2012,Marzo,España,11,38,,49,POINT (0.81488 -77356)
2012,Marzo,España,1,2,,3,POINT (10406342 -75527794)
2012,Marzo,España,8,18,,26,POINT (10446304 -75516486)
2012,Marzo,España,5,15,,20,POINT (10886686 -74776479)
2012,Marzo,España,0,1,,1,POINT (11247723 -74213989)
2012,Marzo,España,0,2,,2,POINT (11360029 -72129595)
2012,Marzo,España,3,10,,13,POINT (125862 -81702165)
2012,Marzo,España,42,65,,107,POINT (3451668 -76532004)
2012,Marzo,España,0,2,,2,POINT (445285 -75766353)
2012,Marzo,España,131,390,,521,POINT (4697157 -74140516)
2012,Marzo,España,1,5,,6,POINT (4815189 -75736374)
2012,Marzo,España,35,85,,120,POINT (6170465 -7542726)
2012,Marzo,España,1,0,,1,POINT (7128047 -73181317)
2012,Marzo,España,1,0,,1,POINT (7819 -72453013)
2012,Marzo,España,0,1,,1,POINT (7927233 -72508188)
2012,Marzo,República Democrática del Congo,1,6,,7,POINT (4697157 -74140516)
2012,Marzo,República Democrática del Congo,2,0,,2,POINT (6170465 -7542726)
2012,Marzo,República de Corea,0,3,,3,POINT (-4191162 -69941498)
2012,Marzo,República de Corea,6,11,,17,POINT (0.81488 -77356)
2012,Marzo,República de Corea,1,12,,13,POINT (10446304 -75516486)
2012,Marzo,República de Corea,2,4,,6,POINT (10886686 -74776479)
2012,Marzo,República de Corea,1,8,,9,POINT (3451668 -76532004)
2012,Marzo,República de Corea,0,2,,2,POINT (3884426 -77061029)
2012,Marzo,República de Corea,104,443,,547,POINT (4697157 -74140516)
2012,Marzo,República de Corea,1,14,,15,POINT (6170465 -7542726)
2012,Marzo,República de Corea,2,0,,2,POINT (7819 -72453013)
2012,Marzo,Costa de Marfil,0,2,,2,POINT (4697157 -74140516)
2012,Marzo,Costa Rica,0,4,,4,POINT (0.81488 -77356)
2012,Marzo,Costa Rica,0,1,,1,POINT (10406342 -75527794)
2012,Marzo,Costa Rica,34,27,,61,POINT (10446304 -75516486)
2012,Marzo,Costa Rica,8,24,,32,POINT (10886686 -74776479)
2012,Marzo,Costa Rica,1,0,,1,POINT (125744111 -81703935)
2012,Marzo,Costa Rica,269,203,,472,POINT (125862 -81702165)
2012,Marzo,Costa Rica,16,45,,61,POINT (3451668 -76532004)
2012,Marzo,Costa Rica,1,0,,1,POINT (445285 -75766353)
2012,Marzo,Costa Rica,399,658,,1057,POINT (4697157 -74140516)
2012,Marzo,Costa Rica,2,4,,6,POINT (4815189 -75736374)
2012,Marzo,Costa Rica,75,120,,195,POINT (6170465 -7542726)
2012,Marzo,Costa Rica,5,0,,5,POINT (7128047 -73181317)
2012,Marzo,Costa Rica,0,1,,1,POINT (7819 -72453013)
2012,Marzo,Costa Rica,2,0,,2,POINT (7927233 -72508188)
2012,Marzo,Costa Rica,0,2,,2,POINT (863337 -7735002)
2012,Marzo,Croacia,1,0,,1,POINT (0.81488 -77356)
2012,Marzo,Croacia,0,11,,11,POINT (10406342 -75527794)
2012,Marzo,Croacia,0,4,,4,POINT (10446304 -75516486)
2012,Marzo,Croacia,0,1,,1,POINT (10886686 -74776479)
2012,Marzo,Croacia,0,5,,5,POINT (10970933 -74765343)
2012,Marzo,Croacia,2,3,,5,POINT (11360029 -72129595)
2012,Marzo,Croacia,0,1,,1,POINT (3451668 -76532004)
2012,Marzo,Croacia,5,35,,40,POINT (4697157 -74140516)
2012,Marzo,Croacia,0,2,,2,POINT (6170465 -7542726)
2012,Marzo,Cuba,1,0,,1,POINT (-4191162 -69941498)
2012,Marzo,Cuba,0,4,,4,POINT (0.81488 -77356)
2012,Marzo,Cuba,12,19,,31,POINT (10446304 -75516486)
2012,Marzo,Cuba,3,9,,12,POINT (10886686 -74776479)
2012,Marzo,Cuba,8,20,,28,POINT (3451668 -76532004)
2012,Marzo,Cuba,1,2,,3,POINT (445285 -75766353)
2012,Marzo,Cuba,69,133,,202,POINT (4697157 -74140516)
2012,Marzo,Cuba,9,25,,34,POINT (6170465 -7542726)
2012,Marzo,Cuba,0,4,,4,POINT (7128047 -73181317)
2012,Marzo,Cuba,0,2,,2,POINT (7819 -72453013)
2012,Marzo,Curazao,1,1,,2,POINT (4697157 -74140516)
2012,Marzo,Curazao,4,3,,7,POINT (6170465 -7542726)
2012,Marzo,República Checa,3,1,,4,POINT (0.81488 -77356)
2012,Marzo,República Checa,1,2,,3,POINT (10446304 -75516486)
2012,Marzo,República Checa,39,65,,104,POINT (4697157 -74140516)
2012,Marzo,Chile,4,2,,6,POINT (-4191162 -69941498)
2012,Marzo,Chile,21,55,,76,POINT (0.81488 -77356)
2012,Marzo,Chile,1,2,,3,POINT (1800143 -78802679)
2012,Marzo,Chile,30,35,,65,POINT (10406342 -75527794)
2012,Marzo,Chile,171,133,,304,POINT (10446304 -75516486)
2012,Marzo,Chile,8,28,,36,POINT (10886686 -74776479)
2012,Marzo,Chile,4,6,,10,POINT (11360029 -72129595)
2012,Marzo,Chile,78,55,,133,POINT (125862 -81702165)
2012,Marzo,Chile,34,48,,82,POINT (3451668 -76532004)
2012,Marzo,Chile,0,1,,1,POINT (3884426 -77061029)
2012,Marzo,Chile,2047,3189,,5236,POINT (4697157 -74140516)
2012,Marzo,Chile,0,1,,1,POINT (4815189 -75736374)
2012,Marzo,Chile,48,114,,162,POINT (6170465 -7542726)
2012,Marzo,Chile,11,16,,27,POINT (7819 -72453013)
2012,Marzo,Chile,2,2,,4,POINT (863337 -7735002)
2012,Marzo,China,1,1,,2,POINT (0.81488 -77356)
2012,Marzo,China,0,1,,1,POINT (10406342 -75527794)
2012,Marzo,China,10,4,,14,POINT (10446304 -75516486)
2012,Marzo,China,0,1,,1,POINT (10886686 -74776479)
2012,Marzo,China,0,1,,1,POINT (10970933 -74765343)
2012,Marzo,China,0,2,,2,POINT (11360029 -72129595)
2012,Marzo,China,1,7,,8,POINT (3451668 -76532004)
2012,Marzo,China,149,449,,598,POINT (4697157 -74140516)
2012,Marzo,China,0,2,,2,POINT (4815189 -75736374)
2012,Marzo,China,6,13,,19,POINT (6170465 -7542726)
2012,Marzo,China,0,1,,1,POINT (7128047 -73181317)
2012,Marzo,China,0,2,,2,POINT (7819 -72453013)
2012,Marzo,China,1,0,,1,POINT (863337 -7735002)
2012,Marzo,Taiwán,1,8,,9,POINT (10446304 -75516486)
2012,Marzo,Taiwán,0,2,,2,POINT (10886686 -74776479)
2012,Marzo,Taiwán,2,3,,5,POINT (3451668 -76532004)
2012,Marzo,Taiwán,13,34,,47,POINT (4697157 -74140516)
2012,Marzo,Taiwán,0,1,,1,POINT (4815189 -75736374)
2012,Marzo,Taiwán,4,9,,13,POINT (6170465 -7542726)
2012,Marzo,Taiwán,2,1,,3,POINT (7819 -72453013)
2012,Marzo,Chipre,0,1,,1,POINT (-4191162 -69941498)
2012,Marzo,Chipre,0,4,,4,POINT (4697157 -74140516)
2012,Marzo,Dinamarca,3,3,,6,POINT (0.81488 -77356)
2012,Marzo,Dinamarca,5,2,,7,POINT (10406342 -75527794)
2012,Marzo,Dinamarca,2,8,,10,POINT (10446304 -75516486)
2012,Marzo,Dinamarca,0,5,,5,POINT (10886686 -74776479)
2012,Marzo,Dinamarca,0,1,,1,POINT (11360029 -72129595)
2012,Marzo,Dinamarca,0,2,,2,POINT (133387613 -81372937)
2012,Marzo,Dinamarca,1,4,,5,POINT (3451668 -76532004)
2012,Marzo,Dinamarca,62,151,,213,POINT (4697157 -74140516)
2012,Marzo,Dinamarca,2,10,,12,POINT (6170465 -7542726)
2012,Marzo,Dinamarca,0,1,,1,POINT (7819 -72453013)
2012,Marzo,Dinamarca,1,1,,2,POINT (863337 -7735002)
2012,Marzo,Dominica,0,2,,2,POINT (10406342 -75527794)
2012,Marzo,Dominica,0,1,,1,POINT (3451668 -76532004)
2012,Marzo,Dominica,1,6,,7,POINT (4697157 -74140516)
2012,Marzo,Dominica,0,1,,1,POINT (4815189 -75736374)
2012,Marzo,Ecuador,0,2,,2,POINT (-4191162 -69941498)
2012,Marzo,Ecuador,13,49,,62,POINT (0.33002 -76876446)
2012,Marzo,Ecuador,1048,1554,,2602,POINT (0.81488 -77356)
2012,Marzo,Ecuador,0,1,,1,POINT (1800143 -78802679)
2012,Marzo,Ecuador,6,14,,20,POINT (10406342 -75527794)
2012,Marzo,Ecuador,10,11,,21,POINT (10446304 -75516486)
2012,Marzo,Ecuador,8,8,,16,POINT (10886686 -74776479)
2012,Marzo,Ecuador,3,6,,9,POINT (11360029 -72129595)
2012,Marzo,Ecuador,43,28,,71,POINT (125862 -81702165)
2012,Marzo,Ecuador,311,379,,690,POINT (3451668 -76532004)
2012,Marzo,Ecuador,1775,2908,,4683,POINT (4697157 -74140516)
2012,Marzo,Ecuador,1,2,,3,POINT (4815189 -75736374)
2012,Marzo,Ecuador,300,469,,769,POINT (6170465 -7542726)
2012,Marzo,Ecuador,0,1,,1,POINT (7088729 -70740253)
2012,Marzo,Ecuador,107,124,,231,POINT (7819 -72453013)
2012,Marzo,Ecuador,0,2,,2,POINT (7927233 -72508188)
2012,Marzo,Egipto,0,1,,1,POINT (3451668 -76532004)
2012,Marzo,Egipto,4,12,,16,POINT (4697157 -74140516)
2012,Marzo,El Salvador,2,0,,2,POINT (0.81488 -77356)
2012,Marzo,El Salvador,7,6,,13,POINT (10446304 -75516486)
2012,Marzo,El Salvador,4,2,,6,POINT (10886686 -74776479)
2012,Marzo,El Salvador,2,1,,3,POINT (125862 -81702165)
2012,Marzo,El Salvador,14,19,,33,POINT (3451668 -76532004)
2012,Marzo,El Salvador,373,518,,891,POINT (4697157 -74140516)
2012,Marzo,El Salvador,22,32,,54,POINT (6170465 -7542726)
2012,Marzo,Emiratos Árabes,1,24,,25,POINT (4697157 -74140516)
2012,Marzo,España,3,4,,7,POINT (-4191162 -69941498)
2012,Marzo,España,1,0,,1,POINT (0.33002 -76876446)
2012,Marzo,España,8,22,,30,POINT (0.81488 -77356)
2012,Marzo,España,10,8,,18,POINT (10406342 -75527794)
2012,Marzo,España,17,50,,67,POINT (10446304 -75516486)
2012,Marzo,España,5,11,,16,POINT (10886686 -74776479)
2012,Marzo,España,3,8,,11,POINT (11360029 -72129595)
2012,Marzo,España,1,1,,2,POINT (125744111 -81703935)
2012,Marzo,España,6,5,,11,POINT (125862 -81702165)
2012,Marzo,España,0,3,,3,POINT (133387613 -81372937)
2012,Marzo,España,107,220,,327,POINT (3451668 -76532004)
2012,Marzo,España,1780,4207,,5987,POINT (4697157 -74140516)
2012,Marzo,España,0,3,,3,POINT (4815189 -75736374)
2012,Marzo,España,68,166,,234,POINT (6170465 -7542726)
2012,Marzo,España,1,0,,1,POINT (6185536 -67484028)
2012,Marzo,España,1,0,,1,POINT (7088729 -70740253)
2012,Marzo,España,14,36,,50,POINT (7819 -72453013)
2012,Marzo,España,3,0,,3,POINT (7927233 -72508188)
2012,Marzo,España,1,6,,7,POINT (863337 -7735002)
2012,Marzo,Eslovaquia,1,0,,1,POINT (0.81488 -77356)
2012,Marzo,Eslovaquia,0,1,,1,POINT (1800143 -78802679)
2012,Marzo,Eslovaquia,1,0,,1,POINT (10446304 -75516486)
2012,Marzo,Eslovaquia,3,0,,3,POINT (133387613 -81372937)
2012,Marzo,Eslovaquia,2,1,,3,POINT (3451668 -76532004)
2012,Marzo,Eslovaquia,17,10,,27,POINT (4697157 -74140516)
2012,Marzo,Eslovaquia,0,1,,1,POINT (6170465 -7542726)
2012,Marzo,Eslovaquia,1,3,,4,POINT (7819 -72453013)
2012,Marzo,Eslovenia,1,0,,1,POINT (-4191162 -69941498)
2012,Marzo,Eslovenia,0,2,,2,POINT (0.81488 -77356)
2012,Marzo,Eslovenia,0,1,,1,POINT (10406342 -75527794)
2012,Marzo,Eslovenia,1,0,,1,POINT (11360029 -72129595)
2012,Marzo,Eslovenia,0,3,,3,POINT (3451668 -76532004)
2012,Marzo,Eslovenia,15,30,,45,POINT (4697157 -74140516)
2012,Marzo,Estados Unidos de América,10,27,,37,POINT (-4191162 -69941498)
2012,Marzo,Estados Unidos de América,38,85,,123,POINT (0.81488 -77356)
2012,Marzo,Estados Unidos de América,1,0,,1,POINT (1800143 -78802679)
2012,Marzo,Estados Unidos de América,26,76,,102,POINT (10406342 -75527794)
2012,Marzo,Estados Unidos de América,977,1912,,2889,POINT (10446304 -75516486)
2012,Marzo,Estados Unidos de América,438,593,,1031,POINT (10886686 -74776479)
2012,Marzo,Estados Unidos de América,0,3,,3,POINT (10970933 -74765343)
2012,Marzo,Estados Unidos de América,2,7,,9,POINT (11247723 -74213989)
2012,Marzo,Estados Unidos de América,12,19,,31,POINT (11360029 -72129595)
2012,Marzo,Estados Unidos de América,0,1,,1,POINT (1152863 -72919186)
2012,Marzo,Estados Unidos de América,14,20,,34,POINT (125744111 -81703935)
2012,Marzo,Estados Unidos de América,16,40,,56,POINT (125862 -81702165)
2012,Marzo,Estados Unidos de América,6,17,,23,POINT (133387613 -81372937)
2012,Marzo,Estados Unidos de América,813,1194,,2007,POINT (3451668 -76532004)
2012,Marzo,Estados Unidos de América,109,150,,259,POINT (445285 -75766353)
2012,Marzo,Estados Unidos de América,5878,11611,,17489,POINT (4697157 -74140516)
2012,Marzo,Estados Unidos de América,46,67,,113,POINT (4815189 -75736374)
2012,Marzo,Estados Unidos de América,889,2311,,3200,POINT (6170465 -7542726)
2012,Marzo,Estados Unidos de América,0,1,,1,POINT (6185536 -67484028)
2012,Marzo,Estados Unidos de América,15,32,,47,POINT (7128047 -73181317)
2012,Marzo,Estados Unidos de América,25,39,,64,POINT (7819 -72453013)
2012,Marzo,Estados Unidos de América,10,21,,31,POINT (7927233 -72508188)
2012,Marzo,Estados Unidos de América,6,17,,23,POINT (863337 -7735002)
2012,Marzo,Estonia,1,0,,1,POINT (10406342 -75527794)
2012,Marzo,Estonia,4,2,,6,POINT (10446304 -75516486)
2012,Marzo,Estonia,1,1,,2,POINT (11360029 -72129595)
2012,Marzo,Estonia,18,18,,36,POINT (4697157 -74140516)
2012,Marzo,Etiopia,2,7,,9,POINT (4697157 -74140516)
2012,Marzo,Filipinas,1,19,,20,POINT (10406342 -75527794)
2012,Marzo,Filipinas,0,7,,7,POINT (10446304 -75516486)
2012,Marzo,Filipinas,0,7,,7,POINT (10886686 -74776479)
2012,Marzo,Filipinas,0,22,,22,POINT (10970933 -74765343)
2012,Marzo,Filipinas,0,21,,21,POINT (11247723 -74213989)
2012,Marzo,Filipinas,3,1,,4,POINT (3451668 -76532004)
2012,Marzo,Filipinas,0,14,,14,POINT (3884426 -77061029)
2012,Marzo,Filipinas,12,86,,98,POINT (4697157 -74140516)
2012,Marzo,Filipinas,5,1,,6,POINT (6170465 -7542726)
2012,Marzo,Filipinas,0,6,,6,POINT (9402597 -75681642)
2012,Marzo,Finlandia,0,1,,1,POINT (-4191162 -69941498)
2012,Marzo,Finlandia,3,2,,5,POINT (0.81488 -77356)
2012,Marzo,Finlandia,93,83,,176,POINT (10446304 -75516486)
2012,Marzo,Finlandia,0,1,,1,POINT (11360029 -72129595)
2012,Marzo,Finlandia,1,1,,2,POINT (3451668 -76532004)
2012,Marzo,Finlandia,1,0,,1,POINT (445285 -75766353)
2012,Marzo,Finlandia,45,65,,110,POINT (4697157 -74140516)
2012,Marzo,Finlandia,5,6,,11,POINT (6170465 -7542726)
2012,Marzo,Finlandia,1,2,,3,POINT (7819 -72453013)
2012,Marzo,Francia,4,6,,10,POINT (-4191162 -69941498)
2012,Marzo,Francia,1,1,,2,POINT (0.33002 -76876446)
2012,Marzo,Francia,37,66,,103,POINT (0.81488 -77356)
2012,Marzo,Francia,9,29,,38,POINT (10406342 -75527794)
2012,Marzo,Francia,28,40,,68,POINT (10446304 -75516486)
2012,Marzo,Francia,4,16,,20,POINT (10886686 -74776479)
2012,Marzo,Francia,0,1,,1,POINT (10970933 -74765343)
2012,Marzo,Francia,1,2,,3,POINT (11247723 -74213989)
2012,Marzo,Francia,7,14,,21,POINT (11360029 -72129595)
2012,Marzo,Francia,2,7,,9,POINT (125862 -81702165)
2012,Marzo,Francia,6,7,,13,POINT (133387613 -81372937)
2012,Marzo,Francia,12,58,,70,POINT (3451668 -76532004)
2012,Marzo,Francia,0,1,,1,POINT (3884426 -77061029)
2012,Marzo,Francia,825,1680,,2505,POINT (4697157 -74140516)
2012,Marzo,Francia,1,5,,6,POINT (4815189 -75736374)
2012,Marzo,Francia,22,46,,68,POINT (6170465 -7542726)
2012,Marzo,Francia,0,1,,1,POINT (7088729 -70740253)
2012,Marzo,Francia,5,11,,16,POINT (7819 -72453013)
2012,Marzo,Francia,1,3,,4,POINT (7927233 -72508188)
2012,Marzo,Francia,7,22,,29,POINT (863337 -7735002)
2012,Marzo,Georgia,9,16,,25,POINT (4697157 -74140516)
2012,Marzo,Ghana,2,3,,5,POINT (4697157 -74140516)
2012,Marzo,Grecia,0,1,,1,POINT (0.81488 -77356)
2012,Marzo,Grecia,0,4,,4,POINT (10406342 -75527794)
2012,Marzo,Grecia,0,1,,1,POINT (11247723 -74213989)
2012,Marzo,Grecia,1,1,,2,POINT (3451668 -76532004)
2012,Marzo,Grecia,0,1,,1,POINT (3884426 -77061029)
2012,Marzo,Grecia,20,51,,71,POINT (4697157 -74140516)
2012,Marzo,Grecia,2,8,,10,POINT (6170465 -7542726)
2012,Marzo,Grecia,0,2,,2,POINT (7819 -72453013)
2012,Marzo,Grecia,0,1,,1,POINT (7927233 -72508188)
2012,Marzo,Grecia,0,1,,1,POINT (9402597 -75681642)
2012,Marzo,Guatemala,1,2,,3,POINT (0.81488 -77356)
2012,Marzo,Guatemala,0,3,,3,POINT (10406342 -75527794)
2012,Marzo,Guatemala,31,33,,64,POINT (10446304 -75516486)
2012,Marzo,Guatemala,13,21,,34,POINT (10886686 -74776479)
2012,Marzo,Guatemala,0,1,,1,POINT (11360029 -72129595)
2012,Marzo,Guatemala,0,1,,1,POINT (125744111 -81703935)
2012,Marzo,Guatemala,13,32,,45,POINT (125862 -81702165)
2012,Marzo,Guatemala,14,44,,58,POINT (3451668 -76532004)
2012,Marzo,Guatemala,152,353,,505,POINT (4697157 -74140516)
2012,Marzo,Guatemala,4,6,,10,POINT (4815189 -75736374)
2012,Marzo,Guatemala,36,86,,122,POINT (6170465 -7542726)
2012,Marzo,Guatemala,1,0,,1,POINT (7088729 -70740253)
2012,Marzo,Guatemala,1,1,,2,POINT (7128047 -73181317)
2012,Marzo,Guatemala,2,5,,7,POINT (7819 -72453013)
2012,Marzo,Guatemala,1,0,,1,POINT (7927233 -72508188)
2012,Marzo,Guatemala,1,3,,4,POINT (863337 -7735002)
2012,Marzo,Guyana,0,1,,1,POINT (0.81488 -77356)
2012,Marzo,Guyana,0,1,,1,POINT (10406342 -75527794)
2012,Marzo,Guyana,0,9,,9,POINT (10886686 -74776479)
2012,Marzo,Guyana,0,7,,7,POINT (10970933 -74765343)
2012,Marzo,Guyana,0,1,,1,POINT (3451668 -76532004)
2012,Marzo,Guyana,3,6,,9,POINT (4697157 -74140516)
2012,Marzo,Guyana,0,2,,2,POINT (6170465 -7542726)
2012,Marzo,Guinea Ecuatorial,1,0,,1,POINT (4697157 -74140516)
2012,Marzo,Guinea Bissau,0,1,,1,POINT (4697157 -74140516)
2012,Marzo,Haití,1,1,,2,POINT (10446304 -75516486)
2012,Marzo,Haití,1,2,,3,POINT (10886686 -74776479)
2012,Marzo,Haití,0,1,,1,POINT (3451668 -76532004)
2012,Marzo,Haití,5,24,,29,POINT (4697157 -74140516)
2012,Marzo,Haití,1,3,,4,POINT (6170465 -7542726)
2012,Marzo,Honduras,2,0,,2,POINT (0.81488 -77356)
2012,Marzo,Honduras,1,16,,17,POINT (10406342 -75527794)
2012,Marzo,Honduras,9,12,,21,POINT (10446304 -75516486)
2012,Marzo,Honduras,11,15,,26,POINT (10886686 -74776479)
2012,Marzo,Honduras,0,5,,5,POINT (125744111 -81703935)
2012,Marzo,Honduras,1,1,,2,POINT (125862 -81702165)
2012,Marzo,Honduras,13,12,,25,POINT (3451668 -76532004)
2012,Marzo,Honduras,0,1,,1,POINT (445285 -75766353)
2012,Marzo,Honduras,134,181,,315,POINT (4697157 -74140516)
2012,Marzo,Honduras,1,1,,2,POINT (4815189 -75736374)
2012,Marzo,Honduras,17,21,,38,POINT (6170465 -7542726)
2012,Marzo,Honduras,1,0,,1,POINT (7819 -72453013)
2012,Marzo,Honduras,0,1,,1,POINT (863337 -7735002)
2012,Marzo,Hungría,2,0,,2,POINT (-4191162 -69941498)
2012,Marzo,Hungría,0,2,,2,POINT (0.81488 -77356)
2012,Marzo,Hungría,0,2,,2,POINT (10406342 -75527794)
2012,Marzo,Hungría,3,1,,4,POINT (10446304 -75516486)
2012,Marzo,Hungría,0,2,,2,POINT (11360029 -72129595)
2012,Marzo,Hungría,1,2,,3,POINT (3451668 -76532004)
2012,Marzo,Hungría,21,28,,49,POINT (4697157 -74140516)
2012,Marzo,Hungría,1,0,,1,POINT (6170465 -7542726)
2012,Marzo,Hungría,0,2,,2,POINT (7819 -72453013)
2012,Marzo,India,2,4,,6,POINT (0.81488 -77356)
2012,Marzo,India,1,3,,4,POINT (10446304 -75516486)
2012,Marzo,India,2,4,,6,POINT (10886686 -74776479)
2012,Marzo,India,0,1,,1,POINT (125862 -81702165)
2012,Marzo,India,2,2,,4,POINT (3451668 -76532004)
2012,Marzo,India,43,230,,273,POINT (4697157 -74140516)
2012,Marzo,India,5,30,,35,POINT (6170465 -7542726)
2012,Marzo,India,0,1,,1,POINT (7128047 -73181317)
2012,Marzo,Indonesia,1,20,,21,POINT (10406342 -75527794)
2012,Marzo,Indonesia,1,0,,1,POINT (10446304 -75516486)
2012,Marzo,Indonesia,0,1,,1,POINT (10970933 -74765343)
2012,Marzo,Indonesia,1,0,,1,POINT (3451668 -76532004)
2012,Marzo,Indonesia,5,22,,27,POINT (4697157 -74140516)
2012,Marzo,Indonesia,1,1,,2,POINT (6170465 -7542726)
2012,Marzo,Iraq,0,2,,2,POINT (4697157 -74140516)
2012,Marzo,Irán,6,16,,22,POINT (4697157 -74140516)
2012,Marzo,República de Irlanda,0,1,,1,POINT (-4191162 -69941498)
2012,Marzo,República de Irlanda,9,11,,20,POINT (0.81488 -77356)
2012,Marzo,República de Irlanda,1,4,,5,POINT (10446304 -75516486)
2012,Marzo,República de Irlanda,1,1,,2,POINT (11360029 -72129595)
2012,Marzo,República de Irlanda,0,3,,3,POINT (3451668 -76532004)
2012,Marzo,República de Irlanda,44,111,,155,POINT (4697157 -74140516)
2012,Marzo,República de Irlanda,0,2,,2,POINT (4815189 -75736374)
2012,Marzo,República de Irlanda,2,4,,6,POINT (6170465 -7542726)
2012,Marzo,República de Irlanda,0,4,,4,POINT (7819 -72453013)
2012,Marzo,República de Irlanda,0,3,,3,POINT (863337 -7735002)
2012,Marzo,Islandia,2,0,,2,POINT (0.81488 -77356)
2012,Marzo,Islandia,1,0,,1,POINT (133387613 -81372937)
2012,Marzo,Islandia,3,3,,6,POINT (4697157 -74140516)
2012,Marzo,Islandia,1,1,,2,POINT (6170465 -7542726)
2012,Marzo,Isla de Man,28,45,,73,POINT (0.81488 -77356)
2012,Marzo,Isla de Man,11,22,,33,POINT (10446304 -75516486)
2012,Marzo,Isla de Man,1,38,,39,POINT (10886686 -74776479)
2012,Marzo,Isla de Man,0,1,,1,POINT (11360029 -72129595)
2012,Marzo,Isla de Man,7,20,,27,POINT (3451668 -76532004)
2012,Marzo,Isla de Man,0,2,,2,POINT (445285 -75766353)
2012,Marzo,Isla de Man,55,124,,179,POINT (4697157 -74140516)
2012,Marzo,Isla de Man,0,1,,1,POINT (4815189 -75736374)
2012,Marzo,Isla de Man,8,31,,39,POINT (6170465 -7542726)
2012,Marzo,Isla Johnston,0,1,,1,POINT (3451668 -76532004)
2012,Marzo,Israel,1,0,,1,POINT (-4191162 -69941498)
2012,Marzo,Israel,3,9,,12,POINT (0.81488 -77356)
2012,Marzo,Israel,3,29,,32,POINT (10446304 -75516486)
2012,Marzo,Israel,0,4,,4,POINT (10886686 -74776479)
2012,Marzo,Israel,2,0,,2,POINT (125862 -81702165)
2012,Marzo,Israel,1,5,,6,POINT (3451668 -76532004)
2012,Marzo,Israel,89,445,,534,POINT (4697157 -74140516)
2012,Marzo,Israel,1,53,,54,POINT (6170465 -7542726)
2012,Marzo,Israel,0,2,,2,POINT (7927233 -72508188)
2012,Marzo,Israel,1,1,,2,POINT (863337 -7735002)
2012,Marzo,Islas Aland/Provincia de Finlandia,0,1,,1,POINT (4697157 -74140516)
2012,Marzo,Italia,0,4,,4,POINT (-4191162 -69941498)
2012,Marzo,Italia,9,18,,27,POINT (0.81488 -77356)
2012,Marzo,Italia,3,4,,7,POINT (10406342 -75527794)
2012,Marzo,Italia,104,194,,298,POINT (10446304 -75516486)
2012,Marzo,Italia,3,20,,23,POINT (10886686 -74776479)
2012,Marzo,Italia,3,16,,19,POINT (11360029 -72129595)
2012,Marzo,Italia,10,20,,30,POINT (125862 -81702165)
2012,Marzo,Italia,1,2,,3,POINT (133387613 -81372937)
2012,Marzo,Italia,14,68,,82,POINT (3451668 -76532004)
2012,Marzo,Italia,360,1654,,2014,POINT (4697157 -74140516)
2012,Marzo,Italia,0,3,,3,POINT (4815189 -75736374)
2012,Marzo,Italia,18,82,,100,POINT (6170465 -7542726)
2012,Marzo,Italia,0,1,,1,POINT (6185536 -67484028)
2012,Marzo,Italia,4,25,,29,POINT (7819 -72453013)
2012,Marzo,Italia,1,4,,5,POINT (7927233 -72508188)
2012,Marzo,Italia,0,1,,1,POINT (863337 -7735002)
2012,Marzo,Islas del Canal,1,1,,2,POINT (4697157 -74140516)
2012,Marzo,Jamaica,0,1,,1,POINT (10406342 -75527794)
2012,Marzo,Jamaica,2,4,,6,POINT (10446304 -75516486)
2012,Marzo,Jamaica,1,0,,1,POINT (125862 -81702165)
2012,Marzo,Jamaica,1,2,,3,POINT (3451668 -76532004)
2012,Marzo,Jamaica,4,18,,22,POINT (4697157 -74140516)
2012,Marzo,Jamaica,2,4,,6,POINT (6170465 -7542726)
2012,Marzo,Japón,8,24,,32,POINT (0.81488 -77356)
2012,Marzo,Japón,0,9,,9,POINT (10406342 -75527794)
2012,Marzo,Japón,1,7,,8,POINT (10446304 -75516486)
2012,Marzo,Japón,1,2,,3,POINT (10886686 -74776479)
2012,Marzo,Japón,1,1,,2,POINT (11360029 -72129595)
2012,Marzo,Japón,3,25,,28,POINT (3451668 -76532004)
2012,Marzo,Japón,235,479,,714,POINT (4697157 -74140516)
2012,Marzo,Japón,1,0,,1,POINT (4815189 -75736374)
2012,Marzo,Japón,4,16,,20,POINT (6170465 -7542726)
2012,Marzo,Japón,0,1,,1,POINT (6185536 -67484028)
2012,Marzo,Japón,1,3,,4,POINT (7819 -72453013)
2012,Marzo,Japón,0,3,,3,POINT (7927233 -72508188)
2012,Marzo,Japón,0,1,,1,POINT (863337 -7735002)
2012,Marzo,Jordania,3,7,,10,POINT (4697157 -74140516)
2012,Marzo,Jordania,0,2,,2,POINT (6170465 -7542726)
2012,Marzo,Kazajistán,1,0,,1,POINT (0.81488 -77356)
2012,Marzo,Kazajistán,1,3,,4,POINT (4697157 -74140516)
2012,Marzo,Kenia,1,0,,1,POINT (0.81488 -77356)
2012,Marzo,Kenia,3,8,,11,POINT (4697157 -74140516)
2012,Marzo,Kenia,0,1,,1,POINT (7819 -72453013)
2012,Marzo,Kirguistán,0,1,,1,POINT (4697157 -74140516)
2012,Marzo,Kuwait,0,3,,3,POINT (10886686 -74776479)
2012,Marzo,República de Kosovo,6,14,,20,POINT (4697157 -74140516)
2012,Marzo,Letonia,1,0,,1,POINT (0.81488 -77356)
2012,Marzo,Letonia,0,3,,3,POINT (10406342 -75527794)
2012,Marzo,Letonia,0,1,,1,POINT (10446304 -75516486)
2012,Marzo,Letonia,5,9,,14,POINT (4697157 -74140516)
2012,Marzo,Letonia,1,0,,1,POINT (6170465 -7542726)
2012,Marzo,Lituania,1,0,,1,POINT (0.81488 -77356)
2012,Marzo,Lituania,1,0,,1,POINT (10446304 -75516486)
2012,Marzo,Lituania,4,12,,16,POINT (4697157 -74140516)
2012,Marzo,Lituania,1,0,,1,POINT (6170465 -7542726)
2012,Marzo,Líbano,1,8,,9,POINT (10886686 -74776479)
2012,Marzo,Líbano,5,5,,10,POINT (11360029 -72129595)
2012,Marzo,Líbano,0,1,,1,POINT (3451668 -76532004)
2012,Marzo,Líbano,10,31,,41,POINT (4697157 -74140516)
2012,Marzo,Liberia,0,1,,1,POINT (4697157 -74140516)
2012,Marzo,Liechtenstein,1,0,,1,POINT (11360029 -72129595)
2012,Marzo,Liechtenstein,2,3,,5,POINT (4697157 -74140516)
2012,Marzo,Liechtenstein,1,0,,1,POINT (6170465 -7542726)
2012,Marzo,Luxemburgo,0,2,,2,POINT (0.81488 -77356)
2012,Marzo,Luxemburgo,0,1,,1,POINT (10406342 -75527794)
2012,Marzo,Luxemburgo,8,17,,25,POINT (4697157 -74140516)
2012,Marzo,Macedonia,1,4,,5,POINT (4697157 -74140516)
2012,Marzo,Madagascar,0,2,,2,POINT (4697157 -74140516)
2012,Marzo,Malasia,1,0,,1,POINT (-4191162 -69941498)
2012,Marzo,Malasia,1,0,,1,POINT (0.81488 -77356)
2012,Marzo,Malasia,0,1,,1,POINT (10446304 -75516486)
2012,Marzo,Malasia,1,1,,2,POINT (3451668 -76532004)
2012,Marzo,Malasia,4,20,,24,POINT (4697157 -74140516)
2012,Marzo,Malawi,2,0,,2,POINT (4697157 -74140516)
2012,Marzo,Malta,0,1,,1,POINT (-4191162 -69941498)
2012,Marzo,Malta,1,0,,1,POINT (10446304 -75516486)
2012,Marzo,Malta,0,1,,1,POINT (3451668 -76532004)
2012,Marzo,Malta,0,4,,4,POINT (4697157 -74140516)
2012,Marzo,Marruecos,1,0,,1,POINT (3451668 -76532004)
2012,Marzo,Marruecos,5,9,,14,POINT (4697157 -74140516)
2012,Marzo,Marruecos,0,1,,1,POINT (6170465 -7542726)
2012,Marzo,Mauricio,0,1,,1,POINT (4697157 -74140516)
2012,Marzo,México,0,1,,1,POINT (-4191162 -69941498)
2012,Marzo,México,1,0,,1,POINT (0.33002 -76876446)
2012,Marzo,México,8,9,,17,POINT (0.81488 -77356)
2012,Marzo,México,11,19,,30,POINT (10406342 -75527794)
2012,Marzo,México,69,103,,172,POINT (10446304 -75516486)
2012,Marzo,México,18,49,,67,POINT (10886686 -74776479)
2012,Marzo,México,3,8,,11,POINT (11360029 -72129595)
2012,Marzo,México,0,2,,2,POINT (125744111 -81703935)
2012,Marzo,México,2,3,,5,POINT (125862 -81702165)
2012,Marzo,México,44,91,,135,POINT (3451668 -76532004)
2012,Marzo,México,0,1,,1,POINT (3884426 -77061029)
2012,Marzo,México,1,2,,3,POINT (445285 -75766353)
2012,Marzo,México,1685,4074,,5759,POINT (4697157 -74140516)
2012,Marzo,México,3,9,,12,POINT (4815189 -75736374)
2012,Marzo,México,86,281,,367,POINT (6170465 -7542726)
2012,Marzo,México,1,2,,3,POINT (7128047 -73181317)
2012,Marzo,México,6,27,,33,POINT (7819 -72453013)
2012,Marzo,México,3,3,,6,POINT (7927233 -72508188)
2012,Marzo,México,1,6,,7,POINT (863337 -7735002)
2012,Marzo,República de Moldavia,2,0,,2,POINT (4697157 -74140516)
2012,Marzo,Mónaco,0,1,,1,POINT (10886686 -74776479)
2012,Marzo,Mozambique,1,1,,2,POINT (4697157 -74140516)
2012,Marzo,Myanmar,1,0,,1,POINT (4697157 -74140516)
2012,Marzo,Namibia,0,1,,1,POINT (4697157 -74140516)
2012,Marzo,Nepal,0,2,,2,POINT (0.81488 -77356)
2012,Marzo,Nepal,0,1,,1,POINT (4697157 -74140516)
2012,Marzo,Nepal,0,1,,1,POINT (6170465 -7542726)
2012,Marzo,Nicaragua,8,8,,16,POINT (10446304 -75516486)
2012,Marzo,Nicaragua,2,2,,4,POINT (10886686 -74776479)
2012,Marzo,Nicaragua,1,2,,3,POINT (125862 -81702165)
2012,Marzo,Nicaragua,2,9,,11,POINT (3451668 -76532004)
2012,Marzo,Nicaragua,38,64,,102,POINT (4697157 -74140516)
2012,Marzo,Nicaragua,0,1,,1,POINT (4815189 -75736374)
2012,Marzo,Nicaragua,9,10,,19,POINT (6170465 -7542726)
2012,Marzo,Nicaragua,1,0,,1,POINT (7128047 -73181317)
2012,Marzo,Nigeria,2,5,,7,POINT (4697157 -74140516)
2012,Marzo,Noruega,7,2,,9,POINT (0.81488 -77356)
2012,Marzo,Noruega,1,9,,10,POINT (10406342 -75527794)
2012,Marzo,Noruega,2,7,,9,POINT (10446304 -75516486)
2012,Marzo,Noruega,0,1,,1,POINT (10886686 -74776479)
2012,Marzo,Noruega,0,2,,2,POINT (10970933 -74765343)
2012,Marzo,Noruega,3,3,,6,POINT (11247723 -74213989)
2012,Marzo,Noruega,0,2,,2,POINT (11360029 -72129595)
2012,Marzo,Noruega,3,8,,11,POINT (3451668 -76532004)
2012,Marzo,Noruega,72,126,,198,POINT (4697157 -74140516)
2012,Marzo,Noruega,5,8,,13,POINT (6170465 -7542726)
2012,Marzo,Noruega,1,3,,4,POINT (7128047 -73181317)
2012,Marzo,Noruega,0,1,,1,POINT (7819 -72453013)
2012,Marzo,Noruega,0,1,,1,POINT (7927233 -72508188)
2012,Marzo,Noruega,0,3,,3,POINT (863337 -7735002)
2012,Marzo,Nueva Caledonia/Territorio francés,0,1,,1,POINT (10406342 -75527794)
2012,Marzo,Nueva Zelanda,4,7,,11,POINT (0.81488 -77356)
2012,Marzo,Nueva Zelanda,3,7,,10,POINT (10446304 -75516486)
2012,Marzo,Nueva Zelanda,0,1,,1,POINT (10886686 -74776479)
2012,Marzo,Nueva Zelanda,0,4,,4,POINT (3451668 -76532004)
2012,Marzo,Nueva Zelanda,33,51,,84,POINT (4697157 -74140516)
2012,Marzo,Nueva Zelanda,0,1,,1,POINT (4815189 -75736374)
2012,Marzo,Nueva Zelanda,1,6,,7,POINT (6170465 -7542726)
2012,Marzo,Nueva Zelanda,1,1,,2,POINT (7819 -72453013)
2012,Marzo,Omán,0,1,,1,POINT (4697157 -74140516)
2012,Marzo,Nueva Zelanda,1,4,,5,POINT (-4191162 -69941498)
2012,Marzo,Nueva Zelanda,1,1,,2,POINT (0.81488 -77356)
2012,Marzo,Nueva Zelanda,2,5,,7,POINT (10406342 -75527794)
2012,Marzo,Nueva Zelanda,1,0,,1,POINT (11247723 -74213989)
2012,Marzo,Nueva Zelanda,2,5,,7,POINT (4697157 -74140516)
2012,Marzo,Nueva Zelanda,0,1,,1,POINT (6170465 -7542726)
2012,Marzo,Nueva Zelanda,0,1,,1,POINT (7819 -72453013)
2012,Marzo,Nueva Zelanda,0,2,,2,POINT (863337 -7735002)
2012,Marzo,Omán,0,1,,1,POINT (4697157 -74140516)
2012,Marzo,Países Bajos,23,20,,43,POINT (0.81488 -77356)
2012,Marzo,Países Bajos,0,1,,1,POINT (10406342 -75527794)
2012,Marzo,Países Bajos,4,16,,20,POINT (10446304 -75516486)
2012,Marzo,Países Bajos,7,8,,15,POINT (10886686 -74776479)
2012,Marzo,Países Bajos,1,3,,4,POINT (11360029 -72129595)
2012,Marzo,Países Bajos,23,23,,46,POINT (1152863 -72919186)
2012,Marzo,Países Bajos,0,1,,1,POINT (125862 -81702165)
2012,Marzo,Países Bajos,7,15,,22,POINT (3451668 -76532004)
2012,Marzo,Países Bajos,158,262,,420,POINT (4697157 -74140516)
2012,Marzo,Países Bajos,0,1,,1,POINT (4815189 -75736374)
2012,Marzo,Países Bajos,129,159,,288,POINT (6170465 -7542726)
2012,Marzo,Países Bajos,1,2,,3,POINT (7128047 -73181317)
2012,Marzo,Pakistán,0,1,,1,POINT (10446304 -75516486)
2012,Marzo,Pakistán,1,25,,26,POINT (4697157 -74140516)
2012,Marzo,Pakistán,1,0,,1,POINT (6170465 -7542726)
2012,Marzo,Panamá,0,1,,1,POINT (0.81488 -77356)
2012,Marzo,Panamá,3,42,,45,POINT (10406342 -75527794)
2012,Marzo,Panamá,59,114,,173,POINT (10446304 -75516486)
2012,Marzo,Panamá,54,93,,147,POINT (10886686 -74776479)
2012,Marzo,Panamá,0,5,,5,POINT (125744111 -81703935)
2012,Marzo,Panamá,23,32,,55,POINT (125862 -81702165)
2012,Marzo,Panamá,57,109,,166,POINT (3451668 -76532004)
2012,Marzo,Panamá,467,851,,1318,POINT (4697157 -74140516)
2012,Marzo,Panamá,31,52,,83,POINT (4815189 -75736374)
2012,Marzo,Panamá,110,222,,332,POINT (6170465 -7542726)
2012,Marzo,Panamá,1,1,,2,POINT (6222552 -77401154)
2012,Marzo,Panamá,8,12,,20,POINT (7128047 -73181317)
2012,Marzo,Panamá,0,4,,4,POINT (7819 -72453013)
2012,Marzo,Panamá,7,19,,26,POINT (7927233 -72508188)
2012,Marzo,Panamá,1,7,,8,POINT (863337 -7735002)
2012,Marzo,Paraguay,4,6,,10,POINT (10446304 -75516486)
2012,Marzo,Paraguay,0,4,,4,POINT (10886686 -74776479)
2012,Marzo,Paraguay,1,1,,2,POINT (125862 -81702165)
2012,Marzo,Paraguay,4,6,,10,POINT (3451668 -76532004)
2012,Marzo,Paraguay,45,59,,104,POINT (4697157 -74140516)
2012,Marzo,Paraguay,5,6,,11,POINT (6170465 -7542726)
2012,Marzo,Paraguay,0,22,,22,POINT (7819 -72453013)
2012,Marzo,Perú,19,31,,50,POINT (-4191162 -69941498)
2012,Marzo,Perú,2,3,,5,POINT (0.33002 -76876446)
2012,Marzo,Perú,157,382,,539,POINT (0.81488 -77356)
2012,Marzo,Perú,20,14,,34,POINT (10406342 -75527794)
2012,Marzo,Perú,127,89,,216,POINT (10446304 -75516486)
2012,Marzo,Perú,16,25,,41,POINT (10886686 -74776479)
2012,Marzo,Perú,0,1,,1,POINT (10970933 -74765343)
2012,Marzo,Perú,2,6,,8,POINT (11360029 -72129595)
2012,Marzo,Perú,212,163,,375,POINT (125862 -81702165)
2012,Marzo,Perú,94,153,,247,POINT (3451668 -76532004)
2012,Marzo,Perú,0,1,,1,POINT (445285 -75766353)
2012,Marzo,Perú,2407,3451,,5858,POINT (4697157 -74140516)
2012,Marzo,Perú,0,8,,8,POINT (4815189 -75736374)
2012,Marzo,Perú,120,343,,463,POINT (6170465 -7542726)
2012,Marzo,Perú,1,0,,1,POINT (6185536 -67484028)
2012,Marzo,Perú,0,1,,1,POINT (7088729 -70740253)
2012,Marzo,Perú,4,8,,12,POINT (7128047 -73181317)
2012,Marzo,Perú,43,65,,108,POINT (7819 -72453013)
2012,Marzo,Perú,3,2,,5,POINT (7927233 -72508188)
2012,Marzo,Perú,1,0,,1,POINT (863337 -7735002)
2012,Marzo,Perú,0,1,,1,POINT (9402597 -75681642)
2012,Marzo,Palestina,0,2,,2,POINT (4697157 -74140516)
2012,Marzo,Palestina,0,1,,1,POINT (6170465 -7542726)
2012,Marzo,Polonia,0,3,,3,POINT (-4191162 -69941498)
2012,Marzo,Polonia,6,6,,12,POINT (0.81488 -77356)
2012,Marzo,Polonia,5,14,,19,POINT (10406342 -75527794)
2012,Marzo,Polonia,4,1,,5,POINT (10446304 -75516486)
2012,Marzo,Polonia,1,1,,2,POINT (10886686 -74776479)
2012,Marzo,Polonia,0,6,,6,POINT (10970933 -74765343)
2012,Marzo,Polonia,0,9,,9,POINT (11247723 -74213989)
2012,Marzo,Polonia,3,1,,4,POINT (11360029 -72129595)
2012,Marzo,Polonia,1,2,,3,POINT (3451668 -76532004)
2012,Marzo,Polonia,0,1,,1,POINT (3884426 -77061029)
2012,Marzo,Polonia,79,142,,221,POINT (4697157 -74140516)
2012,Marzo,Polonia,1,2,,3,POINT (6170465 -7542726)
2012,Marzo,Polonia,0,1,,1,POINT (863337 -7735002)
2012,Marzo,Portugal,0,1,,1,POINT (-4191162 -69941498)
2012,Marzo,Portugal,1,1,,2,POINT (0.33002 -76876446)
2012,Marzo,Portugal,2,3,,5,POINT (0.81488 -77356)
2012,Marzo,Portugal,0,2,,2,POINT (10406342 -75527794)
2012,Marzo,Portugal,4,7,,11,POINT (10446304 -75516486)
2012,Marzo,Portugal,0,2,,2,POINT (10886686 -74776479)
2012,Marzo,Portugal,1,3,,4,POINT (11360029 -72129595)
2012,Marzo,Portugal,0,5,,5,POINT (3451668 -76532004)
2012,Marzo,Portugal,77,245,,322,POINT (4697157 -74140516)
2012,Marzo,Portugal,4,5,,9,POINT (6170465 -7542726)
2012,Marzo,Portugal,2,3,,5,POINT (7819 -72453013)
2012,Marzo,Portugal,1,1,,2,POINT (7927233 -72508188)
2012,Marzo,Puerto Rico/Territorio de Estados Unidos,2,2,,4,POINT (10446304 -75516486)
2012,Marzo,Puerto Rico/Territorio de Estados Unidos,0,2,,2,POINT (6170465 -7542726)
2012,Marzo,Reino Unido de Gran Bretaña e Irlanda del Norte,12,15,,27,POINT (-4191162 -69941498)
2012,Marzo,Reino Unido de Gran Bretaña e Irlanda del Norte,0,5,,5,POINT (0.81488 -77356)
2012,Marzo,Reino Unido de Gran Bretaña e Irlanda del Norte,24,32,,56,POINT (10446304 -75516486)
2012,Marzo,Reino Unido de Gran Bretaña e Irlanda del Norte,0,1,,1,POINT (10886686 -74776479)
2012,Marzo,Reino Unido de Gran Bretaña e Irlanda del Norte,5,5,,10,POINT (11360029 -72129595)
2012,Marzo,Reino Unido de Gran Bretaña e Irlanda del Norte,4,16,,20,POINT (3451668 -76532004)
2012,Marzo,Reino Unido de Gran Bretaña e Irlanda del Norte,225,482,,707,POINT (4697157 -74140516)
2012,Marzo,Reino Unido de Gran Bretaña e Irlanda del Norte,8,29,,37,POINT (6170465 -7542726)
2012,Marzo,Reino Unido de Gran Bretaña e Irlanda del Norte,1,1,,2,POINT (7128047 -73181317)
2012,Marzo,Reino Unido de Gran Bretaña e Irlanda del Norte,1,1,,2,POINT (7819 -72453013)
2012,Marzo,Reino Unido de Gran Bretaña e Irlanda del Norte,0,2,,2,POINT (7927233 -72508188)
2012,Marzo,Reino Unido de Gran Bretaña e Irlanda del Norte,0,4,,4,POINT (863337 -7735002)
2012,Marzo,Reino Unido de Gran Bretaña e Irlanda del Norte,0,1,,1,POINT (9402597 -75681642)
2012,Marzo,República de Belarús,2,0,,2,POINT (4697157 -74140516)
2012,Marzo,República Dominicana,2,2,,4,POINT (0.81488 -77356)
2012,Marzo,República Dominicana,0,2,,2,POINT (10406342 -75527794)
2012,Marzo,República Dominicana,9,18,,27,POINT (10446304 -75516486)
2012,Marzo,República Dominicana,32,19,,51,POINT (10886686 -74776479)
2012,Marzo,República Dominicana,0,1,,1,POINT (11360029 -72129595)
2012,Marzo,República Dominicana,21,39,,60,POINT (3451668 -76532004)
2012,Marzo,República Dominicana,207,325,,532,POINT (4697157 -74140516)
2012,Marzo,República Dominicana,2,2,,4,POINT (4815189 -75736374)
2012,Marzo,República Dominicana,44,48,,92,POINT (6170465 -7542726)
2012,Marzo,República Dominicana,1,2,,3,POINT (7128047 -73181317)
2012,Marzo,República Dominicana,1,4,,5,POINT (7819 -72453013)
2012,Marzo,República Dominicana,1,0,,1,POINT (7927233 -72508188)
2012,Marzo,República Checa,0,1,,1,POINT (0.81488 -77356)
2012,Marzo,República Checa,4,4,,8,POINT (4697157 -74140516)
2012,Marzo,Rumania,1,4,,5,POINT (10406342 -75527794)
2012,Marzo,Rumania,2,7,,9,POINT (10446304 -75516486)
2012,Marzo,Rumania,0,1,,1,POINT (3451668 -76532004)
2012,Marzo,Rumania,41,79,,120,POINT (4697157 -74140516)
2012,Marzo,Rumania,2,2,,4,POINT (6170465 -7542726)
2012,Marzo,Rumania,0,1,,1,POINT (7819 -72453013)
2012,Marzo,Rumania,0,1,,1,POINT (7927233 -72508188)
2012,Marzo,Federación de Rusia,9,10,,19,POINT (0.81488 -77356)
2012,Marzo,Federación de Rusia,2,2,,4,POINT (10446304 -75516486)
2012,Marzo,Federación de Rusia,0,2,,2,POINT (10970933 -74765343)
2012,Marzo,Federación de Rusia,0,1,,1,POINT (11360029 -72129595)
2012,Marzo,Federación de Rusia,3,1,,4,POINT (3451668 -76532004)
2012,Marzo,Federación de Rusia,0,2,,2,POINT (3884426 -77061029)
2012,Marzo,Federación de Rusia,49,56,,105,POINT (4697157 -74140516)
2012,Marzo,Federación de Rusia,1,0,,1,POINT (4815189 -75736374)
2012,Marzo,Federación de Rusia,2,5,,7,POINT (6170465 -7542726)
2012,Marzo,Federación de Rusia,3,1,,4,POINT (7819 -72453013)
2012,Marzo,San Cristóbal y Nevis,0,1,,1,POINT (10446304 -75516486)
2012,Marzo,San Cristóbal y Nevis,0,1,,1,POINT (4697157 -74140516)
2012,Marzo,San Marino,0,1,,1,POINT (11360029 -72129595)
2012,Marzo,San  Vicente y las Granadinas,0,1,,1,POINT (10446304 -75516486)
2012,Marzo,San  Vicente y las Granadinas,1,1,,2,POINT (6170465 -7542726)
2012,Marzo,Santa Lucia,0,2,,2,POINT (10406342 -75527794)
2012,Marzo,Santa Lucia,1,2,,3,POINT (10446304 -75516486)
2012,Marzo,Santa Lucia,0,1,,1,POINT (10886686 -74776479)
2012,Marzo,Santa Lucia,2,2,,4,POINT (4697157 -74140516)
2012,Marzo,Santa Lucia,2,4,,6,POINT (7128047 -73181317)
2012,Marzo,Santa Sede/Ciudad del Vaticano,0,1,,1,POINT (4697157 -74140516)
2012,Marzo,Senegal,1,2,,3,POINT (4697157 -74140516)
2012,Marzo,Serbia,1,0,,1,POINT (0.81488 -77356)
2012,Marzo,Serbia,0,1,,1,POINT (10446304 -75516486)
2012,Marzo,Serbia,0,1,,1,POINT (11360029 -72129595)
2012,Marzo,Serbia,1,1,,2,POINT (3451668 -76532004)
2012,Marzo,Serbia,14,17,,31,POINT (4697157 -74140516)
2012,Marzo,Sierra Leona,0,1,,1,POINT (4697157 -74140516)
2012,Marzo,Singapur,2,0,,2,POINT (10446304 -75516486)
2012,Marzo,Singapur,10,17,,27,POINT (4697157 -74140516)
2012,Marzo,Singapur,1,0,,1,POINT (6170465 -7542726)
2012,Marzo,República Árabe Siria,0,1,,1,POINT (3451668 -76532004)
2012,Marzo,República Árabe Siria,1,2,,3,POINT (4697157 -74140516)
2012,Marzo,República Árabe Siria,0,1,,1,POINT (6170465 -7542726)
2012,Marzo,Sri Lanka,0,1,,1,POINT (4697157 -74140516)
2012,Marzo,Sudáfrica,3,2,,5,POINT (0.81488 -77356)
2012,Marzo,Sudáfrica,1,2,,3,POINT (1800143 -78802679)
2012,Marzo,Sudáfrica,1,0,,1,POINT (10406342 -75527794)
2012,Marzo,Sudáfrica,0,3,,3,POINT (10446304 -75516486)
2012,Marzo,Sudáfrica,0,3,,3,POINT (10886686 -74776479)
2012,Marzo,Sudáfrica,1,3,,4,POINT (11360029 -72129595)
2012,Marzo,Sudáfrica,0,2,,2,POINT (3451668 -76532004)
2012,Marzo,Sudáfrica,33,76,,109,POINT (4697157 -74140516)
2012,Marzo,Sudán,0,1,,1,POINT (4697157 -74140516)
2012,Marzo,Suecia,0,5,,5,POINT (-4191162 -69941498)
2012,Marzo,Suecia,11,17,,28,POINT (0.81488 -77356)
2012,Marzo,Suecia,5,13,,18,POINT (10406342 -75527794)
2012,Marzo,Suecia,6,8,,14,POINT (10446304 -75516486)
2012,Marzo,Suecia,2,8,,10,POINT (10886686 -74776479)
2012,Marzo,Suecia,0,2,,2,POINT (11247723 -74213989)
2012,Marzo,Suecia,1,4,,5,POINT (11360029 -72129595)
2012,Marzo,Suecia,0,1,,1,POINT (125744111 -81703935)
2012,Marzo,Suecia,1,0,,1,POINT (125862 -81702165)
2012,Marzo,Suecia,8,10,,18,POINT (3451668 -76532004)
2012,Marzo,Suecia,136,234,,370,POINT (4697157 -74140516)
2012,Marzo,Suecia,5,15,,20,POINT (6170465 -7542726)
2012,Marzo,Suecia,0,3,,3,POINT (6222552 -77401154)
2012,Marzo,Suecia,2,5,,7,POINT (7819 -72453013)
2012,Marzo,Suecia,0,2,,2,POINT (863337 -7735002)
2012,Marzo,Suiza,3,7,,10,POINT (-4191162 -69941498)
2012,Marzo,Suiza,0,1,,1,POINT (0.33002 -76876446)
2012,Marzo,Suiza,21,29,,50,POINT (0.81488 -77356)
2012,Marzo,Suiza,11,12,,23,POINT (10406342 -75527794)
2012,Marzo,Suiza,18,17,,35,POINT (10446304 -75516486)
2012,Marzo,Suiza,2,4,,6,POINT (10886686 -74776479)
2012,Marzo,Suiza,0,5,,5,POINT (11360029 -72129595)
2012,Marzo,Suiza,1,1,,2,POINT (125862 -81702165)
2012,Marzo,Suiza,10,29,,39,POINT (3451668 -76532004)
2012,Marzo,Suiza,244,499,,743,POINT (4697157 -74140516)
2012,Marzo,Suiza,14,33,,47,POINT (6170465 -7542726)
2012,Marzo,Suiza,0,1,,1,POINT (7128047 -73181317)
2012,Marzo,Suiza,3,6,,9,POINT (7819 -72453013)
2012,Marzo,Suiza,2,2,,4,POINT (863337 -7735002)
2012,Marzo,Surinam,6,17,,23,POINT (4697157 -74140516)
2012,Marzo,Surinam,0,2,,2,POINT (6170465 -7542726)
2012,Marzo,Suazilandia,1,0,,1,POINT (4697157 -74140516)
2012,Marzo,Taiwán,1,0,,1,POINT (4697157 -74140516)
2012,Marzo,Taiwán,0,3,,3,POINT (7819 -72453013)
2012,Marzo,Tailandia,1,1,,2,POINT (10886686 -74776479)
2012,Marzo,Tailandia,4,1,,5,POINT (4697157 -74140516)
2012,Marzo,Territorio Antártico Británico/Territorio Británico de Ultramar,1,4,,5,POINT (4697157 -74140516)
2012,Marzo,Tanzania,2,1,,3,POINT (4697157 -74140516)
2012,Marzo,República de Tayikistán,1,0,,1,POINT (4697157 -74140516)
2012,Marzo,Togo,0,1,,1,POINT (4697157 -74140516)
2012,Marzo,Trinidad y Tobago,1,0,,1,POINT (10406342 -75527794)
2012,Marzo,Trinidad y Tobago,5,44,,49,POINT (10446304 -75516486)
2012,Marzo,Trinidad y Tobago,0,2,,2,POINT (10886686 -74776479)
2012,Marzo,Trinidad y Tobago,1,2,,3,POINT (11360029 -72129595)
2012,Marzo,Trinidad y Tobago,1,2,,3,POINT (125862 -81702165)
2012,Marzo,Trinidad y Tobago,3,4,,7,POINT (3451668 -76532004)
2012,Marzo,Trinidad y Tobago,16,45,,61,POINT (4697157 -74140516)
2012,Marzo,Trinidad y Tobago,0,2,,2,POINT (4815189 -75736374)
2012,Marzo,Trinidad y Tobago,0,4,,4,POINT (6170465 -7542726)
2012,Marzo,Trinidad y Tobago,0,1,,1,POINT (7128047 -73181317)
2012,Marzo,Túnez,0,1,,1,POINT (3451668 -76532004)
2012,Marzo,Túnez,1,5,,6,POINT (4697157 -74140516)
2012,Marzo,Turquía,1,1,,2,POINT (0.81488 -77356)
2012,Marzo,Turquía,2,4,,6,POINT (10406342 -75527794)
2012,Marzo,Turquía,3,13,,16,POINT (10446304 -75516486)
2012,Marzo,Turquía,0,1,,1,POINT (3451668 -76532004)
2012,Marzo,Turquía,15,71,,86,POINT (4697157 -74140516)
2012,Marzo,Turquía,1,3,,4,POINT (6170465 -7542726)
2012,Marzo,Turquía,0,1,,1,POINT (7128047 -73181317)
2012,Marzo,Turquía,0,1,,1,POINT (7927233 -72508188)
2012,Marzo,Ucrania,0,1,,1,POINT (10406342 -75527794)
2012,Marzo,Ucrania,2,0,,2,POINT (10446304 -75516486)
2012,Marzo,Ucrania,1,11,,12,POINT (10970933 -74765343)
2012,Marzo,Ucrania,1,0,,1,POINT (11360029 -72129595)
2012,Marzo,Ucrania,23,14,,37,POINT (4697157 -74140516)
2012,Marzo,Ucrania,2,4,,6,POINT (7819 -72453013)
2012,Marzo,Uganda,1,4,,5,POINT (4697157 -74140516)
2012,Marzo,Federación de Rusia,2,4,,6,POINT (-4191162 -69941498)
2012,Marzo,Federación de Rusia,0,3,,3,POINT (10406342 -75527794)
2012,Marzo,Federación de Rusia,1,1,,2,POINT (10446304 -75516486)
2012,Marzo,Federación de Rusia,0,9,,9,POINT (10970933 -74765343)
2012,Marzo,Federación de Rusia,0,1,,1,POINT (11247723 -74213989)
2012,Marzo,Federación de Rusia,0,2,,2,POINT (11360029 -72129595)
2012,Marzo,Federación de Rusia,2,0,,2,POINT (3451668 -76532004)
2012,Marzo,Federación de Rusia,88,133,,221,POINT (4697157 -74140516)
2012,Marzo,Federación de Rusia,4,3,,7,POINT (6170465 -7542726)
2012,Marzo,Federación de Rusia,10,13,,23,POINT (7819 -72453013)
2012,Marzo,Uruguay,0,6,,6,POINT (0.81488 -77356)
2012,Marzo,Uruguay,0,1,,1,POINT (10406342 -75527794)
2012,Marzo,Uruguay,124,83,,207,POINT (10446304 -75516486)
2012,Marzo,Uruguay,0,5,,5,POINT (10886686 -74776479)
2012,Marzo,Uruguay,1,0,,1,POINT (11360029 -72129595)
2012,Marzo,Uruguay,84,84,,168,POINT (125862 -81702165)
2012,Marzo,Uruguay,5,14,,19,POINT (3451668 -76532004)
2012,Marzo,Uruguay,115,260,,375,POINT (4697157 -74140516)
2012,Marzo,Uruguay,0,2,,2,POINT (4815189 -75736374)
2012,Marzo,Uruguay,6,33,,39,POINT (6170465 -7542726)
2012,Marzo,Uruguay,0,3,,3,POINT (7819 -72453013)
2012,Marzo,Uruguay,0,1,,1,POINT (7927233 -72508188)
2012,Marzo,Uzbekistán,1,0,,1,POINT (10886686 -74776479)
2012,Marzo,Uzbekistán,1,0,,1,POINT (4697157 -74140516)
2012,Marzo,Venezuela,48,89,,137,POINT (0.81488 -77356)
2012,Marzo,Venezuela,17,9,,26,POINT (10406342 -75527794)
2012,Marzo,Venezuela,64,123,,187,POINT (10446304 -75516486)
2012,Marzo,Venezuela,116,137,,253,POINT (10886686 -74776479)
2012,Marzo,Venezuela,0,4,,4,POINT (11117206 -74232675)
2012,Marzo,Venezuela,1251,1720,,2971,POINT (11360029 -72129595)
2012,Marzo,Venezuela,2,1,,3,POINT (1152863 -72919186)
2012,Marzo,Venezuela,0,1,,1,POINT (125744111 -81703935)
2012,Marzo,Venezuela,8,7,,15,POINT (125862 -81702165)
2012,Marzo,Venezuela,35,51,,86,POINT (3451668 -76532004)
2012,Marzo,Venezuela,1,2,,3,POINT (445285 -75766353)
2012,Marzo,Venezuela,4184,5545,,9729,POINT (4697157 -74140516)
2012,Marzo,Venezuela,2,21,,23,POINT (4815189 -75736374)
2012,Marzo,Venezuela,321,396,,717,POINT (6170465 -7542726)
2012,Marzo,Venezuela,13,14,,27,POINT (6185536 -67484028)
2012,Marzo,Venezuela,41,82,,123,POINT (7088729 -70740253)
2012,Marzo,Venezuela,8,17,,25,POINT (7128047 -73181317)
2012,Marzo,Venezuela,1299,1506,,2805,POINT (7819 -72453013)
2012,Marzo,Venezuela,256,300,,556,POINT (7927233 -72508188)
2012,Marzo,Venezuela,0,1,,1,POINT (863337 -7735002)
2012,Marzo,Vietnam,2,2,,4,POINT (4697157 -74140516)
2012,Marzo,Yugoslavia,1,0,,1,POINT (4697157 -74140516)
2012,Marzo,Zambia,0,1,,1,POINT (4697157 -74140516)
2012,Marzo,Zimbabue,1,0,,1,POINT (3451668 -76532004)
2012,Marzo,Zimbabue,0,3,,3,POINT (4697157 -74140516)
2012,Marzo,Reino Unido de Gran Bretaña e Irlanda del Norte,3,2,,5,POINT (-4191162 -69941498)
2012,Marzo,Reino Unido de Gran Bretaña e Irlanda del Norte,9,16,,25,POINT (0.81488 -77356)
2012,Marzo,Reino Unido de Gran Bretaña e Irlanda del Norte,14,35,,49,POINT (10406342 -75527794)
2012,Marzo,Reino Unido de Gran Bretaña e Irlanda del Norte,15,21,,36,POINT (10446304 -75516486)
2012,Marzo,Reino Unido de Gran Bretaña e Irlanda del Norte,1,7,,8,POINT (10886686 -74776479)
2012,Marzo,Reino Unido de Gran Bretaña e Irlanda del Norte,0,7,,7,POINT (10970933 -74765343)
2012,Marzo,Reino Unido de Gran Bretaña e Irlanda del Norte,4,7,,11,POINT (11247723 -74213989)
2012,Marzo,Reino Unido de Gran Bretaña e Irlanda del Norte,1,2,,3,POINT (11360029 -72129595)
2012,Marzo,Reino Unido de Gran Bretaña e Irlanda del Norte,0,1,,1,POINT (125862 -81702165)
2012,Marzo,Reino Unido de Gran Bretaña e Irlanda del Norte,0,1,,1,POINT (133387613 -81372937)
2012,Marzo,Reino Unido de Gran Bretaña e Irlanda del Norte,5,17,,22,POINT (3451668 -76532004)
2012,Marzo,Reino Unido de Gran Bretaña e Irlanda del Norte,272,707,,979,POINT (4697157 -74140516)
2012,Marzo,Reino Unido de Gran Bretaña e Irlanda del Norte,1,2,,3,POINT (4815189 -75736374)
2012,Marzo,Reino Unido de Gran Bretaña e Irlanda del Norte,8,19,,27,POINT (6170465 -7542726)
2012,Marzo,Reino Unido de Gran Bretaña e Irlanda del Norte,0,1,,1,POINT (6185536 -67484028)
2012,Marzo,Reino Unido de Gran Bretaña e Irlanda del Norte,2,7,,9,POINT (7819 -72453013)
2012,Marzo,Reino Unido de Gran Bretaña e Irlanda del Norte,1,1,,2,POINT (7927233 -72508188)
2012,Marzo,Reino Unido de Gran Bretaña e Irlanda del Norte,1,1,,2,POINT (863337 -7735002)
2012,Marzo,Países Bajos,2,5,,7,POINT (-4191162 -69941498)
2012,Marzo,Países Bajos,0,1,,1,POINT (0.33002 -76876446)
2012,Marzo,Países Bajos,2,4,,6,POINT (0.81488 -77356)
2012,Marzo,Países Bajos,0,2,,2,POINT (1800143 -78802679)
2012,Marzo,Países Bajos,5,13,,18,POINT (10406342 -75527794)
2012,Marzo,Países Bajos,7,35,,42,POINT (10446304 -75516486)
2012,Marzo,Países Bajos,1,6,,7,POINT (10886686 -74776479)
2012,Marzo,Países Bajos,1,2,,3,POINT (11247723 -74213989)
2012,Marzo,Países Bajos,1,3,,4,POINT (11360029 -72129595)
2012,Marzo,Países Bajos,1,1,,2,POINT (125744111 -81703935)
2012,Marzo,Países Bajos,1,2,,3,POINT (133387613 -81372937)
2012,Marzo,Países Bajos,7,46,,53,POINT (3451668 -76532004)
2012,Marzo,Países Bajos,383,739,,1122,POINT (4697157 -74140516)
2012,Marzo,Países Bajos,0,1,,1,POINT (4815189 -75736374)
2012,Marzo,Países Bajos,35,43,,78,POINT (6170465 -7542726)
2012,Marzo,Países Bajos,5,3,,8,POINT (7128047 -73181317)
2012,Marzo,Países Bajos,5,8,,13,POINT (7819 -72453013)
2012,Marzo,Países Bajos,1,3,,4,POINT (863337 -7735002)
2012,Marzo,Lituania,0,2,,2,POINT (10406342 -75527794)
2012,Marzo,Lituania,1,0,,1,POINT (3451668 -76532004)
2012,Marzo,Lituania,1,0,,1,POINT (4697157 -74140516)
2012,Marzo,Lituania,1,0,,1,POINT (863337 -7735002)
2012,Marzo,Reino Unido de Gran Bretaña e Irlanda del Norte,0,1,,1,POINT (11247723 -74213989)
2012,Marzo,Reino Unido de Gran Bretaña e Irlanda del Norte,0,4,,4,POINT (4697157 -74140516)
2012,Marzo,Reino Unido de Gran Bretaña e Irlanda del Norte,1,0,,1,POINT (-4191162 -69941498)
2012,Marzo,Reino Unido de Gran Bretaña e Irlanda del Norte,5,7,,12,POINT (10406342 -75527794)
2012,Marzo,Reino Unido de Gran Bretaña e Irlanda del Norte,5,6,,11,POINT (4697157 -74140516)
2012,Marzo,Reino Unido de Gran Bretaña e Irlanda del Norte,0,1,,1,POINT (6170465 -7542726)
2012,Marzo,Letonia,1,0,,1,POINT (10446304 -75516486)
2012,Marzo,Letonia,0,1,,1,POINT (10970933 -74765343)
2012,Marzo,Letonia,0,3,,3,POINT (4697157 -74140516)
2012,Marzo,República CentroÁfricana,0,4,,4,POINT (4697157 -74140516)
2012,Abril,Albania,3,4,,7,POINT (4697157 -74140516)
2012,Abril,Alemania,9,17,,26,POINT (-4191162 -69941498)
2012,Abril,Alemania,1,2,,3,POINT (0.33002 -76876446)
2012,Abril,Alemania,50,47,,97,POINT (0.81488 -77356)
2012,Abril,Alemania,19,32,,51,POINT (10406342 -75527794)
2012,Abril,Alemania,17,32,,49,POINT (10446304 -75516486)
2012,Abril,Alemania,2,11,,13,POINT (10886686 -74776479)
2012,Abril,Alemania,2,4,,6,POINT (11247723 -74213989)
2012,Abril,Alemania,1,11,,12,POINT (11360029 -72129595)
2012,Abril,Alemania,2,2,,4,POINT (125862 -81702165)
2012,Abril,Alemania,1,1,,2,POINT (133387613 -81372937)
2012,Abril,Alemania,33,49,,82,POINT (3451668 -76532004)
2012,Abril,Alemania,0,1,,1,POINT (445285 -75766353)
2012,Abril,Alemania,761,1443,,2204,POINT (4697157 -74140516)
2012,Abril,Alemania,1,0,,1,POINT (4815189 -75736374)
2012,Abril,Alemania,27,75,,102,POINT (6170465 -7542726)
2012,Abril,Alemania,8,14,,22,POINT (7819 -72453013)
2012,Abril,Alemania,0,1,,1,POINT (7927233 -72508188)
2012,Abril,Alemania,9,6,,15,POINT (863337 -7735002)
2012,Abril,Andorra,0,1,,1,POINT (3451668 -76532004)
2012,Abril,Andorra,1,6,,7,POINT (4697157 -74140516)
2012,Abril,Angola,0,1,,1,POINT (10446304 -75516486)
2012,Abril,Angola,0,1,,1,POINT (4697157 -74140516)
2012,Abril,Antigua y Barbuda,2,1,,3,POINT (10446304 -75516486)
2012,Abril,Antigua y Barbuda,0,1,,1,POINT (3451668 -76532004)
2012,Abril,Países Bajos,0,1,,1,POINT (4697157 -74140516)
2012,Abril,Países Bajos,1,1,,2,POINT (6170465 -7542726)
2012,Abril,Arabia Saudita,0,3,,3,POINT (4697157 -74140516)
2012,Abril,Arabia Saudita,0,2,,2,POINT (6170465 -7542726)
2012,Abril,Argelia,1,3,,4,POINT (4697157 -74140516)
2012,Abril,Argentina,2,3,,5,POINT (-4191162 -69941498)
2012,Abril,Argentina,1,2,,3,POINT (0.33002 -76876446)
2012,Abril,Argentina,69,101,,170,POINT (0.81488 -77356)
2012,Abril,Argentina,10,9,,19,POINT (10406342 -75527794)
2012,Abril,Argentina,608,408,,1016,POINT (10446304 -75516486)
2012,Abril,Argentina,16,20,,36,POINT (10886686 -74776479)
2012,Abril,Argentina,7,26,,33,POINT (11360029 -72129595)
2012,Abril,Argentina,1,1,,2,POINT (1152863 -72919186)
2012,Abril,Argentina,222,172,,394,POINT (125862 -81702165)
2012,Abril,Argentina,30,65,,95,POINT (3451668 -76532004)
2012,Abril,Argentina,3056,4330,,7386,POINT (4697157 -74140516)
2012,Abril,Argentina,0,4,,4,POINT (4815189 -75736374)
2012,Abril,Argentina,53,185,,238,POINT (6170465 -7542726)
2012,Abril,Argentina,0,2,,2,POINT (7088729 -70740253)
2012,Abril,Argentina,2,0,,2,POINT (7128047 -73181317)
2012,Abril,Argentina,15,39,,54,POINT (7819 -72453013)
2012,Abril,Argentina,2,6,,8,POINT (7927233 -72508188)
2012,Abril,Argentina,1,7,,8,POINT (863337 -7735002)
2012,Abril,República de Armenia,1,1,,2,POINT (4697157 -74140516)
2012,Abril,Aruba,0,2,,2,POINT (1152863 -72919186)
2012,Abril,Aruba,1,0,,1,POINT (6170465 -7542726)
2012,Abril,Australia,12,7,,19,POINT (-4191162 -69941498)
2012,Abril,Australia,31,54,,85,POINT (0.81488 -77356)
2012,Abril,Australia,19,30,,49,POINT (10406342 -75527794)
2012,Abril,Australia,21,19,,40,POINT (10446304 -75516486)
2012,Abril,Australia,4,5,,9,POINT (10886686 -74776479)
2012,Abril,Australia,6,6,,12,POINT (11360029 -72129595)
2012,Abril,Australia,0,1,,1,POINT (125744111 -81703935)
2012,Abril,Australia,2,15,,17,POINT (3451668 -76532004)
2012,Abril,Australia,150,320,,470,POINT (4697157 -74140516)
2012,Abril,Australia,28,39,,67,POINT (6170465 -7542726)
2012,Abril,Australia,2,1,,3,POINT (7128047 -73181317)
2012,Abril,Australia,5,2,,7,POINT (7819 -72453013)
2012,Abril,Australia,0,2,,2,POINT (863337 -7735002)
2012,Abril,Austria,4,12,,16,POINT (0.81488 -77356)
2012,Abril,Austria,1,6,,7,POINT (10406342 -75527794)
2012,Abril,Austria,4,3,,7,POINT (10446304 -75516486)
2012,Abril,Austria,1,0,,1,POINT (10886686 -74776479)
2012,Abril,Austria,0,1,,1,POINT (11247723 -74213989)
2012,Abril,Austria,1,1,,2,POINT (11360029 -72129595)
2012,Abril,Austria,1,1,,2,POINT (125744111 -81703935)
2012,Abril,Austria,6,6,,12,POINT (3451668 -76532004)
2012,Abril,Austria,70,153,,223,POINT (4697157 -74140516)
2012,Abril,Austria,1,10,,11,POINT (6170465 -7542726)
2012,Abril,Austria,0,1,,1,POINT (863337 -7735002)
2012,Abril,Azerbaiyán,1,0,,1,POINT (0.81488 -77356)
2012,Abril,Azerbaiyán,0,2,,2,POINT (4697157 -74140516)
2012,Abril,Bahamas,1,4,,5,POINT (10446304 -75516486)
2012,Abril,Bahamas,0,1,,1,POINT (10886686 -74776479)
2012,Abril,Bahamas,0,2,,2,POINT (3451668 -76532004)
2012,Abril,Bahamas,2,8,,10,POINT (4697157 -74140516)
2012,Abril,Bangladesh,0,3,,3,POINT (4697157 -74140516)
2012,Abril,Barbados,3,2,,5,POINT (10446304 -75516486)
2012,Abril,Barbados,1,1,,2,POINT (3451668 -76532004)
2012,Abril,Barbados,2,5,,7,POINT (4697157 -74140516)
2012,Abril,Barbados,5,3,,8,POINT (6170465 -7542726)
2012,Abril,Barbados,1,1,,2,POINT (7128047 -73181317)
2012,Abril,República de Belarús,0,2,,2,POINT (4697157 -74140516)
2012,Abril,Bélgica,1,3,,4,POINT (-4191162 -69941498)
2012,Abril,Bélgica,3,5,,8,POINT (0.81488 -77356)
2012,Abril,Bélgica,5,2,,7,POINT (10406342 -75527794)
2012,Abril,Bélgica,3,4,,7,POINT (10446304 -75516486)
2012,Abril,Bélgica,3,5,,8,POINT (10886686 -74776479)
2012,Abril,Bélgica,0,8,,8,POINT (11247723 -74213989)
2012,Abril,Bélgica,0,1,,1,POINT (11360029 -72129595)
2012,Abril,Bélgica,3,10,,13,POINT (3451668 -76532004)
2012,Abril,Bélgica,78,241,,319,POINT (4697157 -74140516)
2012,Abril,Bélgica,4,11,,15,POINT (6170465 -7542726)
2012,Abril,Bélgica,1,2,,3,POINT (7819 -72453013)
2012,Abril,Belice,0,1,,1,POINT (10406342 -75527794)
2012,Abril,Belice,1,1,,2,POINT (10446304 -75516486)
2012,Abril,Belice,0,1,,1,POINT (10886686 -74776479)
2012,Abril,Belice,0,1,,1,POINT (133387613 -81372937)
2012,Abril,Belice,4,8,,12,POINT (4697157 -74140516)
2012,Abril,Belice,0,1,,1,POINT (6170465 -7542726)
2012,Abril,Bolivia,0,1,,1,POINT (0.33002 -76876446)
2012,Abril,Bolivia,6,7,,13,POINT (0.81488 -77356)
2012,Abril,Bolivia,32,74,,106,POINT (10446304 -75516486)
2012,Abril,Bolivia,2,1,,3,POINT (10886686 -74776479)
2012,Abril,Bolivia,1,1,,2,POINT (125862 -81702165)
2012,Abril,Bolivia,5,4,,9,POINT (3451668 -76532004)
2012,Abril,Bolivia,269,351,,620,POINT (4697157 -74140516)
2012,Abril,Bolivia,0,3,,3,POINT (4815189 -75736374)
2012,Abril,Bolivia,10,24,,34,POINT (6170465 -7542726)
2012,Abril,Bolivia,0,3,,3,POINT (7819 -72453013)
2012,Abril,Bosnia y Herzegovina,0,1,,1,POINT (10446304 -75516486)
2012,Abril,Bosnia y Herzegovina,0,1,,1,POINT (3451668 -76532004)
2012,Abril,Brasil,42,64,,106,POINT (-4191162 -69941498)
2012,Abril,Brasil,0,1,,1,POINT (0.33002 -76876446)
2012,Abril,Brasil,9,16,,25,POINT (0.81488 -77356)
2012,Abril,Brasil,10,16,,26,POINT (10406342 -75527794)
2012,Abril,Brasil,84,128,,212,POINT (10446304 -75516486)
2012,Abril,Brasil,10,20,,30,POINT (10886686 -74776479)
2012,Abril,Brasil,1,0,,1,POINT (10970933 -74765343)
2012,Abril,Brasil,3,10,,13,POINT (11360029 -72129595)
2012,Abril,Brasil,24,13,,37,POINT (125862 -81702165)
2012,Abril,Brasil,1,0,,1,POINT (133387613 -81372937)
2012,Abril,Brasil,7,33,,40,POINT (3451668 -76532004)
2012,Abril,Brasil,2604,3919,,6523,POINT (4697157 -74140516)
2012,Abril,Brasil,3,5,,8,POINT (4815189 -75736374)
2012,Abril,Brasil,26,64,,90,POINT (6170465 -7542726)
2012,Abril,Brasil,5,2,,7,POINT (7088729 -70740253)
2012,Abril,Brasil,7,21,,28,POINT (7819 -72453013)
2012,Abril,Brasil,1,3,,4,POINT (7927233 -72508188)
2012,Abril,Bulgaria,0,1,,1,POINT (10446304 -75516486)
2012,Abril,Bulgaria,1,0,,1,POINT (10886686 -74776479)
2012,Abril,Bulgaria,2,0,,2,POINT (3451668 -76532004)
2012,Abril,Bulgaria,3,6,,9,POINT (4697157 -74140516)
2012,Abril,Bulgaria,1,2,,3,POINT (6170465 -7542726)
2012,Abril,Bulgaria,1,0,,1,POINT (7927233 -72508188)
2012,Abril,Burkina Faso,0,1,,1,POINT (4697157 -74140516)
2012,Abril,Islas Caimán/Territorio Británico de Ultramar,0,1,,1,POINT (10446304 -75516486)
2012,Abril,Islas Caimán/Territorio Británico de Ultramar,0,1,,1,POINT (125862 -81702165)
2012,Abril,Camerún,0,2,,2,POINT (4697157 -74140516)
2012,Abril,Canadá,6,9,,15,POINT (-4191162 -69941498)
2012,Abril,Canadá,29,19,,48,POINT (0.81488 -77356)
2012,Abril,Canadá,5,19,,24,POINT (10406342 -75527794)
2012,Abril,Canadá,198,276,,474,POINT (10446304 -75516486)
2012,Abril,Canadá,8,30,,38,POINT (10886686 -74776479)
2012,Abril,Canadá,1,1,,2,POINT (10970933 -74765343)
2012,Abril,Canadá,5,2,,7,POINT (11247723 -74213989)
2012,Abril,Canadá,3,10,,13,POINT (11360029 -72129595)
2012,Abril,Canadá,0,1,,1,POINT (125744111 -81703935)
2012,Abril,Canadá,156,134,,290,POINT (125862 -81702165)
2012,Abril,Canadá,4,1,,5,POINT (133387613 -81372937)
2012,Abril,Canadá,25,43,,68,POINT (3451668 -76532004)
2012,Abril,Canadá,0,2,,2,POINT (445285 -75766353)
2012,Abril,Canadá,528,1181,,1709,POINT (4697157 -74140516)
2012,Abril,Canadá,2,9,,11,POINT (4815189 -75736374)
2012,Abril,Canadá,58,127,,185,POINT (6170465 -7542726)
2012,Abril,Canadá,3,9,,12,POINT (7819 -72453013)
2012,Abril,Canadá,0,2,,2,POINT (7927233 -72508188)
2012,Abril,Canadá,1,3,,4,POINT (863337 -7735002)
2012,Abril,España,10,19,,29,POINT (0.81488 -77356)
2012,Abril,España,4,11,,15,POINT (10446304 -75516486)
2012,Abril,España,7,18,,25,POINT (10886686 -74776479)
2012,Abril,España,0,1,,1,POINT (11247723 -74213989)
2012,Abril,España,3,1,,4,POINT (11360029 -72129595)
2012,Abril,España,1,3,,4,POINT (125744111 -81703935)
2012,Abril,España,1,4,,5,POINT (125862 -81702165)
2012,Abril,España,48,67,,115,POINT (3451668 -76532004)
2012,Abril,España,0,1,,1,POINT (445285 -75766353)
2012,Abril,España,170,408,,578,POINT (4697157 -74140516)
2012,Abril,España,1,3,,4,POINT (4815189 -75736374)
2012,Abril,España,30,98,,128,POINT (6170465 -7542726)
2012,Abril,España,1,0,,1,POINT (6222552 -77401154)
2012,Abril,España,1,2,,3,POINT (7088729 -70740253)
2012,Abril,España,0,2,,2,POINT (7927233 -72508188)
2012,Abril,República Democrática del Congo,1,1,,2,POINT (4697157 -74140516)
2012,Abril,República de Corea,7,7,,14,POINT (0.81488 -77356)
2012,Abril,República de Corea,9,13,,22,POINT (10446304 -75516486)
2012,Abril,República de Corea,1,6,,7,POINT (10886686 -74776479)
2012,Abril,República de Corea,0,3,,3,POINT (125862 -81702165)
2012,Abril,República de Corea,0,1,,1,POINT (3451668 -76532004)
2012,Abril,República de Corea,160,387,,547,POINT (4697157 -74140516)
2012,Abril,República de Corea,0,4,,4,POINT (4815189 -75736374)
2012,Abril,República de Corea,7,20,,27,POINT (6170465 -7542726)
2012,Abril,República de Corea,1,1,,2,POINT (7819 -72453013)
2012,Abril,República de Corea,1,2,,3,POINT (863337 -7735002)
2012,Abril,Costa de Marfil,0,1,,1,POINT (3451668 -76532004)
2012,Abril,Costa de Marfil,0,1,,1,POINT (4697157 -74140516)
2012,Abril,Costa Rica,2,4,,6,POINT (0.81488 -77356)
2012,Abril,Costa Rica,60,44,,104,POINT (10446304 -75516486)
2012,Abril,Costa Rica,18,23,,41,POINT (10886686 -74776479)
2012,Abril,Costa Rica,0,1,,1,POINT (11360029 -72129595)
2012,Abril,Costa Rica,1,4,,5,POINT (125744111 -81703935)
2012,Abril,Costa Rica,301,213,,514,POINT (125862 -81702165)
2012,Abril,Costa Rica,17,32,,49,POINT (3451668 -76532004)
2012,Abril,Costa Rica,382,673,,1055,POINT (4697157 -74140516)
2012,Abril,Costa Rica,4,5,,9,POINT (4815189 -75736374)
2012,Abril,Costa Rica,68,100,,168,POINT (6170465 -7542726)
2012,Abril,Costa Rica,0,3,,3,POINT (7128047 -73181317)
2012,Abril,Costa Rica,5,4,,9,POINT (7819 -72453013)
2012,Abril,Croacia,0,2,,2,POINT (10446304 -75516486)
2012,Abril,Croacia,0,15,,15,POINT (11247723 -74213989)
2012,Abril,Croacia,0,1,,1,POINT (3884426 -77061029)
2012,Abril,Croacia,6,24,,30,POINT (4697157 -74140516)
2012,Abril,Croacia,0,3,,3,POINT (6170465 -7542726)
2012,Abril,Cuba,0,1,,1,POINT (-4191162 -69941498)
2012,Abril,Cuba,2,6,,8,POINT (0.81488 -77356)
2012,Abril,Cuba,1,1,,2,POINT (10406342 -75527794)
2012,Abril,Cuba,6,17,,23,POINT (10446304 -75516486)
2012,Abril,Cuba,1,3,,4,POINT (10886686 -74776479)
2012,Abril,Cuba,10,41,,51,POINT (3451668 -76532004)
2012,Abril,Cuba,87,157,,244,POINT (4697157 -74140516)
2012,Abril,Cuba,13,31,,44,POINT (6170465 -7542726)
2012,Abril,Cuba,2,1,,3,POINT (7128047 -73181317)
2012,Abril,Cuba,0,1,,1,POINT (7927233 -72508188)
2012,Abril,Curazao,0,1,,1,POINT (11360029 -72129595)
2012,Abril,Curazao,0,1,,1,POINT (3451668 -76532004)
2012,Abril,Curazao,1,4,,5,POINT (4697157 -74140516)
2012,Abril,República Checa,5,4,,9,POINT (0.81488 -77356)
2012,Abril,República Checa,3,0,,3,POINT (11360029 -72129595)
2012,Abril,República Checa,1,0,,1,POINT (3451668 -76532004)
2012,Abril,República Checa,15,20,,35,POINT (4697157 -74140516)
2012,Abril,República Checa,0,1,,1,POINT (7088729 -70740253)
2012,Abril,República Checa,1,2,,3,POINT (7819 -72453013)
2012,Abril,Chile,0,4,,4,POINT (-4191162 -69941498)
2012,Abril,Chile,13,37,,50,POINT (0.81488 -77356)
2012,Abril,Chile,7,8,,15,POINT (10406342 -75527794)
2012,Abril,Chile,83,106,,189,POINT (10446304 -75516486)
2012,Abril,Chile,3,37,,40,POINT (10886686 -74776479)
2012,Abril,Chile,2,2,,4,POINT (11360029 -72129595)
2012,Abril,Chile,52,33,,85,POINT (125862 -81702165)
2012,Abril,Chile,19,34,,53,POINT (3451668 -76532004)
2012,Abril,Chile,2029,3115,,5144,POINT (4697157 -74140516)
2012,Abril,Chile,3,1,,4,POINT (4815189 -75736374)
2012,Abril,Chile,38,89,,127,POINT (6170465 -7542726)
2012,Abril,Chile,0,1,,1,POINT (7128047 -73181317)
2012,Abril,Chile,5,16,,21,POINT (7819 -72453013)
2012,Abril,Chile,0,1,,1,POINT (863337 -7735002)
2012,Abril,China,6,5,,11,POINT (0.81488 -77356)
2012,Abril,China,0,3,,3,POINT (10406342 -75527794)
2012,Abril,China,5,9,,14,POINT (10446304 -75516486)
2012,Abril,China,0,2,,2,POINT (10886686 -74776479)
2012,Abril,China,0,3,,3,POINT (11360029 -72129595)
2012,Abril,China,1,1,,2,POINT (125862 -81702165)
2012,Abril,China,1,4,,5,POINT (3451668 -76532004)
2012,Abril,China,147,509,,656,POINT (4697157 -74140516)
2012,Abril,China,1,0,,1,POINT (4815189 -75736374)
2012,Abril,China,7,12,,19,POINT (6170465 -7542726)
2012,Abril,China,1,2,,3,POINT (7819 -72453013)
2012,Abril,Taiwán,2,1,,3,POINT (0.81488 -77356)
2012,Abril,Taiwán,1,2,,3,POINT (10446304 -75516486)
2012,Abril,Taiwán,1,2,,3,POINT (10886686 -74776479)
2012,Abril,Taiwán,1,2,,3,POINT (3451668 -76532004)
2012,Abril,Taiwán,41,73,,114,POINT (4697157 -74140516)
2012,Abril,Taiwán,1,11,,12,POINT (6170465 -7542726)
2012,Abril,Taiwán,3,2,,5,POINT (7819 -72453013)
2012,Abril,Chipre,0,1,,1,POINT (10406342 -75527794)
2012,Abril,Chipre,3,2,,5,POINT (4697157 -74140516)
2012,Abril,Dinamarca,0,2,,2,POINT (-4191162 -69941498)
2012,Abril,Dinamarca,0,12,,12,POINT (0.81488 -77356)
2012,Abril,Dinamarca,0,2,,2,POINT (10406342 -75527794)
2012,Abril,Dinamarca,1,4,,5,POINT (10446304 -75516486)
2012,Abril,Dinamarca,1,0,,1,POINT (10886686 -74776479)
2012,Abril,Dinamarca,0,1,,1,POINT (11247723 -74213989)
2012,Abril,Dinamarca,0,3,,3,POINT (11360029 -72129595)
2012,Abril,Dinamarca,1,8,,9,POINT (3451668 -76532004)
2012,Abril,Dinamarca,53,108,,161,POINT (4697157 -74140516)
2012,Abril,Dinamarca,5,11,,16,POINT (6170465 -7542726)
2012,Abril,Dominica,3,4,,7,POINT (10446304 -75516486)
2012,Abril,Dominica,0,1,,1,POINT (125744111 -81703935)
2012,Abril,Dominica,1,5,,6,POINT (4697157 -74140516)
2012,Abril,Dominica,0,1,,1,POINT (6170465 -7542726)
2012,Abril,Dominica,0,1,,1,POINT (7819 -72453013)
2012,Abril,Ecuador,0,1,,1,POINT (-4191162 -69941498)
2012,Abril,Ecuador,15,36,,51,POINT (0.33002 -76876446)
2012,Abril,Ecuador,851,1289,,2140,POINT (0.81488 -77356)
2012,Abril,Ecuador,0,43,,43,POINT (1800143 -78802679)
2012,Abril,Ecuador,2,11,,13,POINT (10406342 -75527794)
2012,Abril,Ecuador,6,13,,19,POINT (10446304 -75516486)
2012,Abril,Ecuador,1,11,,12,POINT (10886686 -74776479)
2012,Abril,Ecuador,8,11,,19,POINT (11360029 -72129595)
2012,Abril,Ecuador,7,8,,15,POINT (125862 -81702165)
2012,Abril,Ecuador,263,306,,569,POINT (3451668 -76532004)
2012,Abril,Ecuador,1617,2386,,4003,POINT (4697157 -74140516)
2012,Abril,Ecuador,2,1,,3,POINT (4815189 -75736374)
2012,Abril,Ecuador,435,553,,988,POINT (6170465 -7542726)
2012,Abril,Ecuador,117,132,,249,POINT (7819 -72453013)
2012,Abril,Ecuador,0,2,,2,POINT (7927233 -72508188)
2012,Abril,Ecuador,0,1,,1,POINT (863337 -7735002)
2012,Abril,Egipto,0,1,,1,POINT (10886686 -74776479)
2012,Abril,Egipto,4,16,,20,POINT (4697157 -74140516)
2012,Abril,El Salvador,0,1,,1,POINT (0.81488 -77356)
2012,Abril,El Salvador,12,31,,43,POINT (10446304 -75516486)
2012,Abril,El Salvador,3,1,,4,POINT (10886686 -74776479)
2012,Abril,El Salvador,1,7,,8,POINT (3451668 -76532004)
2012,Abril,El Salvador,374,563,,937,POINT (4697157 -74140516)
2012,Abril,El Salvador,12,23,,35,POINT (6170465 -7542726)
2012,Abril,El Salvador,1,1,,2,POINT (7819 -72453013)
2012,Abril,El Salvador,1,0,,1,POINT (7927233 -72508188)
2012,Abril,Emiratos Árabes,0,7,,7,POINT (4697157 -74140516)
2012,Abril,España,1,5,,6,POINT (-4191162 -69941498)
2012,Abril,España,9,18,,27,POINT (0.81488 -77356)
2012,Abril,España,0,1,,1,POINT (1800143 -78802679)
2012,Abril,España,4,7,,11,POINT (10406342 -75527794)
2012,Abril,España,44,49,,93,POINT (10446304 -75516486)
2012,Abril,España,7,10,,17,POINT (10886686 -74776479)
2012,Abril,España,8,12,,20,POINT (11360029 -72129595)
2012,Abril,España,4,6,,10,POINT (125862 -81702165)
2012,Abril,España,1,0,,1,POINT (133387613 -81372937)
2012,Abril,España,120,254,,374,POINT (3451668 -76532004)
2012,Abril,España,1507,3596,,5103,POINT (4697157 -74140516)
2012,Abril,España,1,9,,10,POINT (4815189 -75736374)
2012,Abril,España,51,160,,211,POINT (6170465 -7542726)
2012,Abril,España,1,1,,2,POINT (7088729 -70740253)
2012,Abril,España,0,1,,1,POINT (7128047 -73181317)
2012,Abril,España,16,24,,40,POINT (7819 -72453013)
2012,Abril,España,4,6,,10,POINT (7927233 -72508188)
2012,Abril,España,0,6,,6,POINT (863337 -7735002)
2012,Abril,Eslovaquia,1,1,,2,POINT (-4191162 -69941498)
2012,Abril,Eslovaquia,0,2,,2,POINT (0.81488 -77356)
2012,Abril,Eslovaquia,1,1,,2,POINT (10446304 -75516486)
2012,Abril,Eslovaquia,1,1,,2,POINT (11360029 -72129595)
2012,Abril,Eslovaquia,16,27,,43,POINT (4697157 -74140516)
2012,Abril,Eslovenia,0,3,,3,POINT (10406342 -75527794)
2012,Abril,Eslovenia,0,1,,1,POINT (10886686 -74776479)
2012,Abril,Eslovenia,1,0,,1,POINT (3451668 -76532004)
2012,Abril,Eslovenia,7,33,,40,POINT (4697157 -74140516)
2012,Abril,Eslovenia,0,1,,1,POINT (6170465 -7542726)
2012,Abril,Eslovenia,1,1,,2,POINT (7819 -72453013)
2012,Abril,Estados Unidos de América,14,16,,30,POINT (-4191162 -69941498)
2012,Abril,Estados Unidos de América,0,1,,1,POINT (0.33002 -76876446)
2012,Abril,Estados Unidos de América,49,94,,143,POINT (0.81488 -77356)
2012,Abril,Estados Unidos de América,20,55,,75,POINT (10406342 -75527794)
2012,Abril,Estados Unidos de América,1,6,,7,POINT (10433609 -73247863)
2012,Abril,Estados Unidos de América,753,1903,,2656,POINT (10446304 -75516486)
2012,Abril,Estados Unidos de América,286,615,,901,POINT (10886686 -74776479)
2012,Abril,Estados Unidos de América,0,17,,17,POINT (10970933 -74765343)
2012,Abril,Estados Unidos de América,0,3,,3,POINT (11117206 -74232675)
2012,Abril,Estados Unidos de América,3,4,,7,POINT (11247723 -74213989)
2012,Abril,Estados Unidos de América,12,11,,23,POINT (11360029 -72129595)
2012,Abril,Estados Unidos de América,0,1,,1,POINT (1152863 -72919186)
2012,Abril,Estados Unidos de América,3,18,,21,POINT (125744111 -81703935)
2012,Abril,Estados Unidos de América,20,21,,41,POINT (125862 -81702165)
2012,Abril,Estados Unidos de América,10,15,,25,POINT (133387613 -81372937)
2012,Abril,Estados Unidos de América,551,1010,,1561,POINT (3451668 -76532004)
2012,Abril,Estados Unidos de América,65,123,,188,POINT (445285 -75766353)
2012,Abril,Estados Unidos de América,4657,9816,,14473,POINT (4697157 -74140516)
2012,Abril,Estados Unidos de América,38,68,,106,POINT (4815189 -75736374)
2012,Abril,Estados Unidos de América,721,1994,,2715,POINT (6170465 -7542726)
2012,Abril,Estados Unidos de América,0,1,,1,POINT (6185536 -67484028)
2012,Abril,Estados Unidos de América,1,0,,1,POINT (6222552 -77401154)
2012,Abril,Estados Unidos de América,9,22,,31,POINT (7128047 -73181317)
2012,Abril,Estados Unidos de América,19,41,,60,POINT (7819 -72453013)
2012,Abril,Estados Unidos de América,7,14,,21,POINT (7927233 -72508188)
2012,Abril,Estados Unidos de América,6,10,,16,POINT (863337 -7735002)
2012,Abril,Estonia,0,1,,1,POINT (0.81488 -77356)
2012,Abril,Estonia,1,0,,1,POINT (3451668 -76532004)
2012,Abril,Estonia,4,4,,8,POINT (4697157 -74140516)
2012,Abril,Etiopia,0,3,,3,POINT (4697157 -74140516)
2012,Abril,Filipinas,0,1,,1,POINT (0.81488 -77356)
2012,Abril,Filipinas,0,26,,26,POINT (10406342 -75527794)
2012,Abril,Filipinas,3,7,,10,POINT (10446304 -75516486)
2012,Abril,Filipinas,0,6,,6,POINT (10886686 -74776479)
2012,Abril,Filipinas,0,9,,9,POINT (10970933 -74765343)
2012,Abril,Filipinas,0,15,,15,POINT (11247723 -74213989)
2012,Abril,Filipinas,1,9,,10,POINT (3451668 -76532004)
2012,Abril,Filipinas,0,6,,6,POINT (3884426 -77061029)
2012,Abril,Filipinas,12,44,,56,POINT (4697157 -74140516)
2012,Abril,Filipinas,0,2,,2,POINT (6170465 -7542726)
2012,Abril,Filipinas,0,2,,2,POINT (9402597 -75681642)
2012,Abril,Finlandia,4,0,,4,POINT (-4191162 -69941498)
2012,Abril,Finlandia,2,5,,7,POINT (0.81488 -77356)
2012,Abril,Finlandia,1,1,,2,POINT (10406342 -75527794)
2012,Abril,Finlandia,1,2,,3,POINT (10446304 -75516486)
2012,Abril,Finlandia,1,2,,3,POINT (11360029 -72129595)
2012,Abril,Finlandia,1,6,,7,POINT (3451668 -76532004)
2012,Abril,Finlandia,27,56,,83,POINT (4697157 -74140516)
2012,Abril,Finlandia,4,6,,10,POINT (6170465 -7542726)
2012,Abril,Francia,9,8,,17,POINT (-4191162 -69941498)
2012,Abril,Francia,1,1,,2,POINT (0.33002 -76876446)
2012,Abril,Francia,54,73,,127,POINT (0.81488 -77356)
2012,Abril,Francia,12,34,,46,POINT (10406342 -75527794)
2012,Abril,Francia,32,38,,70,POINT (10446304 -75516486)
2012,Abril,Francia,1,13,,14,POINT (10886686 -74776479)
2012,Abril,Francia,4,12,,16,POINT (11247723 -74213989)
2012,Abril,Francia,5,12,,17,POINT (11360029 -72129595)
2012,Abril,Francia,1,2,,3,POINT (125862 -81702165)
2012,Abril,Francia,3,5,,8,POINT (133387613 -81372937)
2012,Abril,Francia,16,42,,58,POINT (3451668 -76532004)
2012,Abril,Francia,849,1582,,2431,POINT (4697157 -74140516)
2012,Abril,Francia,0,4,,4,POINT (4815189 -75736374)
2012,Abril,Francia,19,66,,85,POINT (6170465 -7542726)
2012,Abril,Francia,3,3,,6,POINT (7128047 -73181317)
2012,Abril,Francia,9,13,,22,POINT (7819 -72453013)
2012,Abril,Francia,2,3,,5,POINT (7927233 -72508188)
2012,Abril,Francia,7,6,,13,POINT (863337 -7735002)
2012,Abril,Georgia,0,1,,1,POINT (4697157 -74140516)
2012,Abril,Granada,1,5,,6,POINT (10446304 -75516486)
2012,Abril,Granada,1,0,,1,POINT (125744111 -81703935)
2012,Abril,Granada,1,2,,3,POINT (4697157 -74140516)
2012,Abril,Granada,0,1,,1,POINT (6170465 -7542726)
2012,Abril,Grecia,0,2,,2,POINT (10406342 -75527794)
2012,Abril,Grecia,2,2,,4,POINT (10446304 -75516486)
2012,Abril,Grecia,0,1,,1,POINT (11360029 -72129595)
2012,Abril,Grecia,0,3,,3,POINT (3451668 -76532004)
2012,Abril,Grecia,6,34,,40,POINT (4697157 -74140516)
2012,Abril,Grecia,0,4,,4,POINT (6170465 -7542726)
2012,Abril,Grecia,0,1,,1,POINT (7819 -72453013)
2012,Abril,Grecia,0,4,,4,POINT (9402597 -75681642)
2012,Abril,Guatemala,2,3,,5,POINT (0.81488 -77356)
2012,Abril,Guatemala,33,94,,127,POINT (10446304 -75516486)
2012,Abril,Guatemala,2,12,,14,POINT (10886686 -74776479)
2012,Abril,Guatemala,0,1,,1,POINT (11360029 -72129595)
2012,Abril,Guatemala,11,11,,22,POINT (125862 -81702165)
2012,Abril,Guatemala,4,35,,39,POINT (3451668 -76532004)
2012,Abril,Guatemala,154,292,,446,POINT (4697157 -74140516)
2012,Abril,Guatemala,2,2,,4,POINT (4815189 -75736374)
2012,Abril,Guatemala,19,62,,81,POINT (6170465 -7542726)
2012,Abril,Guatemala,5,7,,12,POINT (7819 -72453013)
2012,Abril,Guatemala,0,1,,1,POINT (863337 -7735002)
2012,Abril,Guyana,1,3,,4,POINT (10446304 -75516486)
2012,Abril,Guyana,1,0,,1,POINT (10886686 -74776479)
2012,Abril,Guyana,3,10,,13,POINT (4697157 -74140516)
2012,Abril,Guyana,0,1,,1,POINT (4815189 -75736374)
2012,Abril,Guyana,1,1,,2,POINT (6170465 -7542726)
2012,Abril,Guinea,1,1,,2,POINT (4697157 -74140516)
2012,Abril,Guayana Francesa/Departamento de Ultramar Francés,0,1,,1,POINT (10886686 -74776479)
2012,Abril,Haití,0,1,,1,POINT (-4191162 -69941498)
2012,Abril,Haití,3,7,,10,POINT (10446304 -75516486)
2012,Abril,Haití,1,1,,2,POINT (3451668 -76532004)
2012,Abril,Haití,4,17,,21,POINT (4697157 -74140516)
2012,Abril,Haití,0,1,,1,POINT (6170465 -7542726)
2012,Abril,Honduras,0,1,,1,POINT (-4191162 -69941498)
2012,Abril,Honduras,4,4,,8,POINT (0.81488 -77356)
2012,Abril,Honduras,12,33,,45,POINT (10446304 -75516486)
2012,Abril,Honduras,0,5,,5,POINT (10886686 -74776479)
2012,Abril,Honduras,0,2,,2,POINT (10970933 -74765343)
2012,Abril,Honduras,0,7,,7,POINT (125744111 -81703935)
2012,Abril,Honduras,0,1,,1,POINT (125862 -81702165)
2012,Abril,Honduras,8,11,,19,POINT (3451668 -76532004)
2012,Abril,Honduras,117,180,,297,POINT (4697157 -74140516)
2012,Abril,Honduras,0,1,,1,POINT (4815189 -75736374)
2012,Abril,Honduras,20,17,,37,POINT (6170465 -7542726)
2012,Abril,Honduras,2,0,,2,POINT (7819 -72453013)
2012,Abril,Hungría,0,1,,1,POINT (-4191162 -69941498)
2012,Abril,Hungría,1,2,,3,POINT (0.81488 -77356)
2012,Abril,Hungría,2,1,,3,POINT (10446304 -75516486)
2012,Abril,Hungría,0,2,,2,POINT (3451668 -76532004)
2012,Abril,Hungría,7,19,,26,POINT (4697157 -74140516)
2012,Abril,Hungría,1,1,,2,POINT (6170465 -7542726)
2012,Abril,India,0,1,,1,POINT (0.81488 -77356)
2012,Abril,India,0,1,,1,POINT (10406342 -75527794)
2012,Abril,India,1,2,,3,POINT (10446304 -75516486)
2012,Abril,India,0,1,,1,POINT (10886686 -74776479)
2012,Abril,India,1,10,,11,POINT (3451668 -76532004)
2012,Abril,India,34,207,,241,POINT (4697157 -74140516)
2012,Abril,India,1,19,,20,POINT (6170465 -7542726)
2012,Abril,Indonesia,0,41,,41,POINT (10406342 -75527794)
2012,Abril,Indonesia,0,18,,18,POINT (11247723 -74213989)
2012,Abril,Indonesia,1,2,,3,POINT (3451668 -76532004)
2012,Abril,Indonesia,4,25,,29,POINT (4697157 -74140516)
2012,Abril,Indonesia,2,1,,3,POINT (6170465 -7542726)
2012,Abril,Irán,0,1,,1,POINT (0.81488 -77356)
2012,Abril,Irán,2,13,,15,POINT (4697157 -74140516)
2012,Abril,República de Irlanda,1,1,,2,POINT (-4191162 -69941498)
2012,Abril,República de Irlanda,14,16,,30,POINT (0.81488 -77356)
2012,Abril,República de Irlanda,7,7,,14,POINT (10446304 -75516486)
2012,Abril,República de Irlanda,1,0,,1,POINT (10886686 -74776479)
2012,Abril,República de Irlanda,1,1,,2,POINT (133387613 -81372937)
2012,Abril,República de Irlanda,0,4,,4,POINT (3451668 -76532004)
2012,Abril,República de Irlanda,24,77,,101,POINT (4697157 -74140516)
2012,Abril,República de Irlanda,2,11,,13,POINT (6170465 -7542726)
2012,Abril,República de Irlanda,1,1,,2,POINT (7819 -72453013)
2012,Abril,Islandia,0,1,,1,POINT (0.81488 -77356)
2012,Abril,Islandia,4,2,,6,POINT (4697157 -74140516)
2012,Abril,Isla de Man,23,40,,63,POINT (0.81488 -77356)
2012,Abril,Isla de Man,7,13,,20,POINT (10446304 -75516486)
2012,Abril,Isla de Man,0,11,,11,POINT (10886686 -74776479)
2012,Abril,Isla de Man,3,0,,3,POINT (11360029 -72129595)
2012,Abril,Isla de Man,8,20,,28,POINT (3451668 -76532004)
2012,Abril,Isla de Man,0,1,,1,POINT (445285 -75766353)
2012,Abril,Isla de Man,44,120,,164,POINT (4697157 -74140516)
2012,Abril,Isla de Man,6,34,,40,POINT (6170465 -7542726)
2012,Abril,Isla de Man,0,1,,1,POINT (7819 -72453013)
2012,Abril,Isla Johnston,0,2,,2,POINT (4697157 -74140516)
2012,Abril,Israel,3,8,,11,POINT (-4191162 -69941498)
2012,Abril,Israel,8,15,,23,POINT (0.81488 -77356)
2012,Abril,Israel,1,0,,1,POINT (10406342 -75527794)
2012,Abril,Israel,0,12,,12,POINT (10446304 -75516486)
2012,Abril,Israel,0,1,,1,POINT (10886686 -74776479)
2012,Abril,Israel,0,1,,1,POINT (125862 -81702165)
2012,Abril,Israel,3,9,,12,POINT (3451668 -76532004)
2012,Abril,Israel,106,512,,618,POINT (4697157 -74140516)
2012,Abril,Israel,2,85,,87,POINT (6170465 -7542726)
2012,Abril,Israel,0,1,,1,POINT (863337 -7735002)
2012,Abril,Islas Aland/Provincia de Finlandia,0,1,,1,POINT (4697157 -74140516)
2012,Abril,Italia,5,4,,9,POINT (-4191162 -69941498)
2012,Abril,Italia,8,21,,29,POINT (0.81488 -77356)
2012,Abril,Italia,1,1,,2,POINT (1800143 -78802679)
2012,Abril,Italia,5,7,,12,POINT (10406342 -75527794)
2012,Abril,Italia,21,67,,88,POINT (10446304 -75516486)
2012,Abril,Italia,2,12,,14,POINT (10886686 -74776479)
2012,Abril,Italia,0,5,,5,POINT (11247723 -74213989)
2012,Abril,Italia,1,8,,9,POINT (11360029 -72129595)
2012,Abril,Italia,4,8,,12,POINT (125862 -81702165)
2012,Abril,Italia,8,61,,69,POINT (3451668 -76532004)
2012,Abril,Italia,345,1294,,1639,POINT (4697157 -74140516)
2012,Abril,Italia,0,1,,1,POINT (4815189 -75736374)
2012,Abril,Italia,8,69,,77,POINT (6170465 -7542726)
2012,Abril,Italia,0,3,,3,POINT (7088729 -70740253)
2012,Abril,Italia,2,2,,4,POINT (7128047 -73181317)
2012,Abril,Italia,4,27,,31,POINT (7819 -72453013)
2012,Abril,Italia,1,2,,3,POINT (7927233 -72508188)
2012,Abril,Italia,0,3,,3,POINT (863337 -7735002)
2012,Abril,Jamaica,1,1,,2,POINT (0.81488 -77356)
2012,Abril,Jamaica,7,7,,14,POINT (10446304 -75516486)
2012,Abril,Jamaica,0,3,,3,POINT (10886686 -74776479)
2012,Abril,Jamaica,0,1,,1,POINT (125862 -81702165)
2012,Abril,Jamaica,0,2,,2,POINT (3451668 -76532004)
2012,Abril,Jamaica,10,16,,26,POINT (4697157 -74140516)
2012,Abril,Jamaica,2,6,,8,POINT (6170465 -7542726)
2012,Abril,Jamaica,0,1,,1,POINT (7819 -72453013)
2012,Abril,Jamaica,1,0,,1,POINT (7927233 -72508188)
2012,Abril,Japón,0,2,,2,POINT (-4191162 -69941498)
2012,Abril,Japón,11,20,,31,POINT (0.81488 -77356)
2012,Abril,Japón,2,4,,6,POINT (10406342 -75527794)
2012,Abril,Japón,11,16,,27,POINT (10446304 -75516486)
2012,Abril,Japón,0,2,,2,POINT (10886686 -74776479)
2012,Abril,Japón,0,1,,1,POINT (11360029 -72129595)
2012,Abril,Japón,1,1,,2,POINT (125862 -81702165)
2012,Abril,Japón,4,15,,19,POINT (3451668 -76532004)
2012,Abril,Japón,106,360,,466,POINT (4697157 -74140516)
2012,Abril,Japón,1,0,,1,POINT (4815189 -75736374)
2012,Abril,Japón,3,20,,23,POINT (6170465 -7542726)
2012,Abril,Japón,2,6,,8,POINT (7819 -72453013)
2012,Abril,Japón,1,0,,1,POINT (7927233 -72508188)
2012,Abril,Japón,0,2,,2,POINT (863337 -7735002)
2012,Abril,Jordania,1,1,,2,POINT (10446304 -75516486)
2012,Abril,Jordania,1,0,,1,POINT (4697157 -74140516)
2012,Abril,Kazajistán,2,3,,5,POINT (4697157 -74140516)
2012,Abril,Kenia,0,8,,8,POINT (4697157 -74140516)
2012,Abril,Kirguistán,0,1,,1,POINT (4697157 -74140516)
2012,Abril,Kuwait,0,1,,1,POINT (4697157 -74140516)
2012,Abril,República de Kosovo,1,0,,1,POINT (4697157 -74140516)
2012,Abril,Letonia,1,0,,1,POINT (0.81488 -77356)
2012,Abril,Letonia,1,1,,2,POINT (10446304 -75516486)
2012,Abril,Letonia,1,5,,6,POINT (4697157 -74140516)
2012,Abril,Lituania,1,4,,5,POINT (0.81488 -77356)
2012,Abril,Lituania,4,9,,13,POINT (4697157 -74140516)
2012,Abril,Líbano,0,1,,1,POINT (10446304 -75516486)
2012,Abril,Líbano,2,1,,3,POINT (10886686 -74776479)
2012,Abril,Líbano,7,5,,12,POINT (11360029 -72129595)
2012,Abril,Líbano,0,1,,1,POINT (3451668 -76532004)
2012,Abril,Líbano,9,26,,35,POINT (4697157 -74140516)
2012,Abril,Líbano,1,0,,1,POINT (6170465 -7542726)
2012,Abril,Liechtenstein,2,3,,5,POINT (4697157 -74140516)
2012,Abril,Luxemburgo,4,9,,13,POINT (4697157 -74140516)
2012,Abril,Macedonia,1,1,,2,POINT (4697157 -74140516)
2012,Abril,Madagascar,1,0,,1,POINT (10446304 -75516486)
2012,Abril,Malasia,3,1,,4,POINT (0.81488 -77356)
2012,Abril,Malasia,4,21,,25,POINT (4697157 -74140516)
2012,Abril,Malawi,0,1,,1,POINT (4697157 -74140516)
2012,Abril,Malta,0,5,,5,POINT (4697157 -74140516)
2012,Abril,Marruecos,3,6,,9,POINT (4697157 -74140516)
2012,Abril,Marruecos,1,0,,1,POINT (6170465 -7542726)
2012,Abril,Mauricio,0,1,,1,POINT (4697157 -74140516)
2012,Abril,México,1,2,,3,POINT (-4191162 -69941498)
2012,Abril,México,2,0,,2,POINT (0.33002 -76876446)
2012,Abril,México,9,12,,21,POINT (0.81488 -77356)
2012,Abril,México,4,14,,18,POINT (10406342 -75527794)
2012,Abril,México,172,283,,455,POINT (10446304 -75516486)
2012,Abril,México,13,50,,63,POINT (10886686 -74776479)
2012,Abril,México,4,2,,6,POINT (11360029 -72129595)
2012,Abril,México,0,5,,5,POINT (125744111 -81703935)
2012,Abril,México,1,4,,5,POINT (125862 -81702165)
2012,Abril,México,27,86,,113,POINT (3451668 -76532004)
2012,Abril,México,1,1,,2,POINT (445285 -75766353)
2012,Abril,México,1726,3970,,5696,POINT (4697157 -74140516)
2012,Abril,México,4,7,,11,POINT (4815189 -75736374)
2012,Abril,México,75,205,,280,POINT (6170465 -7542726)
2012,Abril,México,0,2,,2,POINT (7088729 -70740253)
2012,Abril,México,3,8,,11,POINT (7128047 -73181317)
2012,Abril,México,14,30,,44,POINT (7819 -72453013)
2012,Abril,México,5,15,,20,POINT (7927233 -72508188)
2012,Abril,México,0,2,,2,POINT (863337 -7735002)
2012,Abril,Mónaco,1,1,,2,POINT (4697157 -74140516)
2012,Abril,Montenegro,0,1,,1,POINT (4697157 -74140516)
2012,Abril,Mozambique,1,1,,2,POINT (4697157 -74140516)
2012,Abril,Namibia,1,1,,2,POINT (4697157 -74140516)
2012,Abril,Nepal,0,2,,2,POINT (0.81488 -77356)
2012,Abril,Nepal,1,1,,2,POINT (4697157 -74140516)
2012,Abril,Nicaragua,0,3,,3,POINT (10406342 -75527794)
2012,Abril,Nicaragua,7,15,,22,POINT (10446304 -75516486)
2012,Abril,Nicaragua,1,2,,3,POINT (10886686 -74776479)
2012,Abril,Nicaragua,0,1,,1,POINT (125862 -81702165)
2012,Abril,Nicaragua,4,3,,7,POINT (3451668 -76532004)
2012,Abril,Nicaragua,39,64,,103,POINT (4697157 -74140516)
2012,Abril,Nicaragua,1,0,,1,POINT (4815189 -75736374)
2012,Abril,Nicaragua,3,8,,11,POINT (6170465 -7542726)
2012,Abril,Nicaragua,1,0,,1,POINT (7819 -72453013)
2012,Abril,Nigeria,0,1,,1,POINT (10446304 -75516486)
2012,Abril,Nigeria,0,6,,6,POINT (4697157 -74140516)
2012,Abril,Níger,0,1,,1,POINT (10406342 -75527794)
2012,Abril,Noruega,1,3,,4,POINT (-4191162 -69941498)
2012,Abril,Noruega,1,8,,9,POINT (0.81488 -77356)
2012,Abril,Noruega,1,6,,7,POINT (10406342 -75527794)
2012,Abril,Noruega,3,9,,12,POINT (10446304 -75516486)
2012,Abril,Noruega,0,1,,1,POINT (10886686 -74776479)
2012,Abril,Noruega,1,1,,2,POINT (11360029 -72129595)
2012,Abril,Noruega,6,6,,12,POINT (125862 -81702165)
2012,Abril,Noruega,1,1,,2,POINT (133387613 -81372937)
2012,Abril,Noruega,2,3,,5,POINT (3451668 -76532004)
2012,Abril,Noruega,41,80,,121,POINT (4697157 -74140516)
2012,Abril,Noruega,4,8,,12,POINT (6170465 -7542726)
2012,Abril,Noruega,0,1,,1,POINT (7128047 -73181317)
2012,Abril,Noruega,0,1,,1,POINT (7927233 -72508188)
2012,Abril,Nueva Zelanda,1,0,,1,POINT (-4191162 -69941498)
2012,Abril,Nueva Zelanda,13,8,,21,POINT (0.81488 -77356)
2012,Abril,Nueva Zelanda,4,4,,8,POINT (10446304 -75516486)
2012,Abril,Nueva Zelanda,0,2,,2,POINT (10886686 -74776479)
2012,Abril,Nueva Zelanda,1,1,,2,POINT (11360029 -72129595)
2012,Abril,Nueva Zelanda,0,2,,2,POINT (3451668 -76532004)
2012,Abril,Nueva Zelanda,22,47,,69,POINT (4697157 -74140516)
2012,Abril,Nueva Zelanda,3,7,,10,POINT (6170465 -7542726)
2012,Abril,Nueva Zelanda,2,1,,3,POINT (7819 -72453013)
2012,Abril,Nueva Zelanda,0,1,,1,POINT (-4191162 -69941498)
2012,Abril,Nueva Zelanda,3,2,,5,POINT (10406342 -75527794)
2012,Abril,Nueva Zelanda,1,4,,5,POINT (11247723 -74213989)
2012,Abril,Nueva Zelanda,0,1,,1,POINT (3451668 -76532004)
2012,Abril,Nueva Zelanda,2,7,,9,POINT (4697157 -74140516)
2012,Abril,Nueva Zelanda,1,0,,1,POINT (7819 -72453013)
2012,Abril,Nueva Zelanda,0,1,,1,POINT (863337 -7735002)
2012,Abril,Países Bajos,14,6,,20,POINT (0.81488 -77356)
2012,Abril,Países Bajos,2,16,,18,POINT (10446304 -75516486)
2012,Abril,Países Bajos,0,6,,6,POINT (10886686 -74776479)
2012,Abril,Países Bajos,21,37,,58,POINT (1152863 -72919186)
2012,Abril,Países Bajos,1,0,,1,POINT (125862 -81702165)
2012,Abril,Países Bajos,8,15,,23,POINT (3451668 -76532004)
2012,Abril,Países Bajos,144,246,,390,POINT (4697157 -74140516)
2012,Abril,Países Bajos,1,0,,1,POINT (4815189 -75736374)
2012,Abril,Países Bajos,197,230,,427,POINT (6170465 -7542726)
2012,Abril,Países Bajos,6,4,,10,POINT (7128047 -73181317)
2012,Abril,Pakistán,6,17,,23,POINT (4697157 -74140516)
2012,Abril,Panamá,0,1,,1,POINT (0.81488 -77356)
2012,Abril,Panamá,0,10,,10,POINT (10406342 -75527794)
2012,Abril,Panamá,64,159,,223,POINT (10446304 -75516486)
2012,Abril,Panamá,37,97,,134,POINT (10886686 -74776479)
2012,Abril,Panamá,2,3,,5,POINT (11360029 -72129595)
2012,Abril,Panamá,1,7,,8,POINT (125744111 -81703935)
2012,Abril,Panamá,34,43,,77,POINT (125862 -81702165)
2012,Abril,Panamá,72,106,,178,POINT (3451668 -76532004)
2012,Abril,Panamá,459,685,,1144,POINT (4697157 -74140516)
2012,Abril,Panamá,46,72,,118,POINT (4815189 -75736374)
2012,Abril,Panamá,75,237,,312,POINT (6170465 -7542726)
2012,Abril,Panamá,2,1,,3,POINT (6222552 -77401154)
2012,Abril,Panamá,3,5,,8,POINT (7128047 -73181317)
2012,Abril,Panamá,4,4,,8,POINT (7819 -72453013)
2012,Abril,Panamá,7,11,,18,POINT (7927233 -72508188)
2012,Abril,Panamá,1,3,,4,POINT (863337 -7735002)
2012,Abril,Paraguay,1,3,,4,POINT (-4191162 -69941498)
2012,Abril,Paraguay,0,1,,1,POINT (0.81488 -77356)
2012,Abril,Paraguay,9,12,,21,POINT (10446304 -75516486)
2012,Abril,Paraguay,0,1,,1,POINT (10886686 -74776479)
2012,Abril,Paraguay,1,2,,3,POINT (11360029 -72129595)
2012,Abril,Paraguay,1,0,,1,POINT (125862 -81702165)
2012,Abril,Paraguay,8,0,,8,POINT (3451668 -76532004)
2012,Abril,Paraguay,65,69,,134,POINT (4697157 -74140516)
2012,Abril,Paraguay,0,1,,1,POINT (4815189 -75736374)
2012,Abril,Paraguay,12,8,,20,POINT (6170465 -7542726)
2012,Abril,Paraguay,1,0,,1,POINT (7088729 -70740253)
2012,Abril,Paraguay,0,1,,1,POINT (7819 -72453013)
2012,Abril,Paraguay,0,2,,2,POINT (7927233 -72508188)
2012,Abril,Perú,23,23,,46,POINT (-4191162 -69941498)
2012,Abril,Perú,0,1,,1,POINT (0.33002 -76876446)
2012,Abril,Perú,95,277,,372,POINT (0.81488 -77356)
2012,Abril,Perú,1,1,,2,POINT (1800143 -78802679)
2012,Abril,Perú,1,4,,5,POINT (10406342 -75527794)
2012,Abril,Perú,165,150,,315,POINT (10446304 -75516486)
2012,Abril,Perú,10,9,,19,POINT (10886686 -74776479)
2012,Abril,Perú,0,2,,2,POINT (10970933 -74765343)
2012,Abril,Perú,2,9,,11,POINT (11360029 -72129595)
2012,Abril,Perú,247,177,,424,POINT (125862 -81702165)
2012,Abril,Perú,67,105,,172,POINT (3451668 -76532004)
2012,Abril,Perú,2084,2868,,4952,POINT (4697157 -74140516)
2012,Abril,Perú,2,2,,4,POINT (4815189 -75736374)
2012,Abril,Perú,148,261,,409,POINT (6170465 -7542726)
2012,Abril,Perú,1,2,,3,POINT (6222552 -77401154)
2012,Abril,Perú,0,5,,5,POINT (7128047 -73181317)
2012,Abril,Perú,26,55,,81,POINT (7819 -72453013)
2012,Abril,Perú,0,3,,3,POINT (7927233 -72508188)
2012,Abril,Perú,1,2,,3,POINT (863337 -7735002)
2012,Abril,Palestina,1,0,,1,POINT (0.81488 -77356)
2012,Abril,Palestina,0,2,,2,POINT (4697157 -74140516)
2012,Abril,Polonia,3,0,,3,POINT (-4191162 -69941498)
2012,Abril,Polonia,1,10,,11,POINT (0.81488 -77356)
2012,Abril,Polonia,4,5,,9,POINT (1800143 -78802679)
2012,Abril,Polonia,3,14,,17,POINT (10406342 -75527794)
2012,Abril,Polonia,0,3,,3,POINT (10446304 -75516486)
2012,Abril,Polonia,0,1,,1,POINT (10886686 -74776479)
2012,Abril,Polonia,0,2,,2,POINT (10970933 -74765343)
2012,Abril,Polonia,0,4,,4,POINT (11247723 -74213989)
2012,Abril,Polonia,5,0,,5,POINT (11360029 -72129595)
2012,Abril,Polonia,1,2,,3,POINT (3451668 -76532004)
2012,Abril,Polonia,53,108,,161,POINT (4697157 -74140516)
2012,Abril,Polonia,1,10,,11,POINT (6170465 -7542726)
2012,Abril,Polonia,1,2,,3,POINT (7819 -72453013)
2012,Abril,Polonia,2,0,,2,POINT (863337 -7735002)
2012,Abril,Portugal,0,3,,3,POINT (0.81488 -77356)
2012,Abril,Portugal,0,3,,3,POINT (10406342 -75527794)
2012,Abril,Portugal,13,11,,24,POINT (10446304 -75516486)
2012,Abril,Portugal,0,2,,2,POINT (10886686 -74776479)
2012,Abril,Portugal,2,3,,5,POINT (11360029 -72129595)
2012,Abril,Portugal,1,6,,7,POINT (3451668 -76532004)
2012,Abril,Portugal,63,235,,298,POINT (4697157 -74140516)
2012,Abril,Portugal,2,7,,9,POINT (6170465 -7542726)
2012,Abril,Portugal,0,1,,1,POINT (7819 -72453013)
2012,Abril,Portugal,0,1,,1,POINT (863337 -7735002)
2012,Abril,Puerto Rico/Territorio de Estados Unidos,0,1,,1,POINT (10446304 -75516486)
2012,Abril,Puerto Rico/Territorio de Estados Unidos,0,2,,2,POINT (3451668 -76532004)
2012,Abril,Puerto Rico/Territorio de Estados Unidos,0,1,,1,POINT (4697157 -74140516)
2012,Abril,Puerto Rico/Territorio de Estados Unidos,0,1,,1,POINT (6170465 -7542726)
2012,Abril,Reino Unido de Gran Bretaña e Irlanda del Norte,8,13,,21,POINT (-4191162 -69941498)
2012,Abril,Reino Unido de Gran Bretaña e Irlanda del Norte,15,20,,35,POINT (0.81488 -77356)
2012,Abril,Reino Unido de Gran Bretaña e Irlanda del Norte,1,14,,15,POINT (10446304 -75516486)
2012,Abril,Reino Unido de Gran Bretaña e Irlanda del Norte,1,3,,4,POINT (10886686 -74776479)
2012,Abril,Reino Unido de Gran Bretaña e Irlanda del Norte,3,8,,11,POINT (11360029 -72129595)
2012,Abril,Reino Unido de Gran Bretaña e Irlanda del Norte,0,1,,1,POINT (125862 -81702165)
2012,Abril,Reino Unido de Gran Bretaña e Irlanda del Norte,1,2,,3,POINT (133387613 -81372937)
2012,Abril,Reino Unido de Gran Bretaña e Irlanda del Norte,2,13,,15,POINT (3451668 -76532004)
2012,Abril,Reino Unido de Gran Bretaña e Irlanda del Norte,141,397,,538,POINT (4697157 -74140516)
2012,Abril,Reino Unido de Gran Bretaña e Irlanda del Norte,7,24,,31,POINT (6170465 -7542726)
2012,Abril,Reino Unido de Gran Bretaña e Irlanda del Norte,3,6,,9,POINT (7819 -72453013)
2012,Abril,Reino Unido de Gran Bretaña e Irlanda del Norte,0,1,,1,POINT (7927233 -72508188)
2012,Abril,Reino Unido de Gran Bretaña e Irlanda del Norte,2,7,,9,POINT (863337 -7735002)
2012,Abril,República de Belarús,0,1,,1,POINT (3451668 -76532004)
2012,Abril,República de Belarús,1,0,,1,POINT (4697157 -74140516)
2012,Abril,República Dominicana,3,5,,8,POINT (0.81488 -77356)
2012,Abril,República Dominicana,28,54,,82,POINT (10446304 -75516486)
2012,Abril,República Dominicana,13,32,,45,POINT (10886686 -74776479)
2012,Abril,República Dominicana,3,4,,7,POINT (11360029 -72129595)
2012,Abril,República Dominicana,1,4,,5,POINT (1152863 -72919186)
2012,Abril,República Dominicana,0,3,,3,POINT (125862 -81702165)
2012,Abril,República Dominicana,17,25,,42,POINT (3451668 -76532004)
2012,Abril,República Dominicana,2,0,,2,POINT (445285 -75766353)
2012,Abril,República Dominicana,215,270,,485,POINT (4697157 -74140516)
2012,Abril,República Dominicana,0,3,,3,POINT (4815189 -75736374)
2012,Abril,República Dominicana,17,31,,48,POINT (6170465 -7542726)
2012,Abril,República Dominicana,1,2,,3,POINT (7128047 -73181317)
2012,Abril,República Dominicana,0,1,,1,POINT (7819 -72453013)
2012,Abril,República Dominicana,1,1,,2,POINT (7927233 -72508188)
2012,Abril,República Checa,1,0,,1,POINT (-4191162 -69941498)
2012,Abril,República Checa,2,0,,2,POINT (10406342 -75527794)
2012,Abril,República Checa,1,0,,1,POINT (10446304 -75516486)
2012,Abril,República Checa,2,4,,6,POINT (4697157 -74140516)
2012,Abril,Rumania,1,2,,3,POINT (-4191162 -69941498)
2012,Abril,Rumania,2,0,,2,POINT (0.81488 -77356)
2012,Abril,Rumania,1,7,,8,POINT (10406342 -75527794)
2012,Abril,Rumania,1,0,,1,POINT (10446304 -75516486)
2012,Abril,Rumania,0,1,,1,POINT (11360029 -72129595)
2012,Abril,Rumania,1,0,,1,POINT (3451668 -76532004)
2012,Abril,Rumania,38,68,,106,POINT (4697157 -74140516)
2012,Abril,Rumania,2,1,,3,POINT (6170465 -7542726)
2012,Abril,Federación de Rusia,9,11,,20,POINT (0.81488 -77356)
2012,Abril,Federación de Rusia,0,1,,1,POINT (10406342 -75527794)
2012,Abril,Federación de Rusia,2,0,,2,POINT (10446304 -75516486)
2012,Abril,Federación de Rusia,1,1,,2,POINT (10886686 -74776479)
2012,Abril,Federación de Rusia,0,1,,1,POINT (11360029 -72129595)
2012,Abril,Federación de Rusia,4,3,,7,POINT (3451668 -76532004)
2012,Abril,Federación de Rusia,33,70,,103,POINT (4697157 -74140516)
2012,Abril,Federación de Rusia,2,2,,4,POINT (6170465 -7542726)
2012,Abril,Federación de Rusia,0,1,,1,POINT (7128047 -73181317)
2012,Abril,Federación de Rusia,1,0,,1,POINT (7819 -72453013)
2012,Abril,San Cristóbal y Nevis,2,2,,4,POINT (10446304 -75516486)
2012,Abril,San Cristóbal y Nevis,0,1,,1,POINT (6170465 -7542726)
2012,Abril,San Marino,0,1,,1,POINT (-4191162 -69941498)
2012,Abril,San Marino,1,1,,2,POINT (4697157 -74140516)
2012,Abril,San Marino,0,1,,1,POINT (6170465 -7542726)
2012,Abril,San  Vicente y las Granadinas,1,3,,4,POINT (10446304 -75516486)
2012,Abril,San  Vicente y las Granadinas,0,1,,1,POINT (3451668 -76532004)
2012,Abril,San  Vicente y las Granadinas,1,0,,1,POINT (4697157 -74140516)
2012,Abril,Santa Lucia,1,2,,3,POINT (10446304 -75516486)
2012,Abril,Santa Lucia,2,3,,5,POINT (4697157 -74140516)
2012,Abril,Santa Lucia,1,2,,3,POINT (7128047 -73181317)
2012,Abril,Santa Sede/Ciudad del Vaticano,1,0,,1,POINT (4697157 -74140516)
2012,Abril,Senegal,0,1,,1,POINT (4697157 -74140516)
2012,Abril,Serbia,1,4,,5,POINT (4697157 -74140516)
2012,Abril,Serbia,0,1,,1,POINT (6170465 -7542726)
2012,Abril,Singapur,0,1,,1,POINT (-4191162 -69941498)
2012,Abril,Singapur,0,1,,1,POINT (0.81488 -77356)
2012,Abril,Singapur,7,13,,20,POINT (4697157 -74140516)
2012,Abril,Singapur,0,2,,2,POINT (6170465 -7542726)
2012,Abril,República Árabe Siria,0,1,,1,POINT (11360029 -72129595)
2012,Abril,República Árabe Siria,0,2,,2,POINT (4697157 -74140516)
2012,Abril,Sri Lanka,0,2,,2,POINT (4697157 -74140516)
2012,Abril,Sudáfrica,1,0,,1,POINT (0.81488 -77356)
2012,Abril,Sudáfrica,2,2,,4,POINT (10406342 -75527794)
2012,Abril,Sudáfrica,0,2,,2,POINT (10446304 -75516486)
2012,Abril,Sudáfrica,0,3,,3,POINT (10970933 -74765343)
2012,Abril,Sudáfrica,0,1,,1,POINT (11247723 -74213989)
2012,Abril,Sudáfrica,0,1,,1,POINT (11360029 -72129595)
2012,Abril,Sudáfrica,15,64,,79,POINT (4697157 -74140516)
2012,Abril,Sudáfrica,2,1,,3,POINT (6170465 -7542726)
2012,Abril,Sudán,2,6,,8,POINT (4697157 -74140516)
2012,Abril,Suecia,1,0,,1,POINT (-4191162 -69941498)
2012,Abril,Suecia,25,20,,45,POINT (0.81488 -77356)
2012,Abril,Suecia,5,11,,16,POINT (10406342 -75527794)
2012,Abril,Suecia,7,14,,21,POINT (10446304 -75516486)
2012,Abril,Suecia,0,2,,2,POINT (10886686 -74776479)
2012,Abril,Suecia,1,0,,1,POINT (133387613 -81372937)
2012,Abril,Suecia,9,11,,20,POINT (3451668 -76532004)
2012,Abril,Suecia,114,187,,301,POINT (4697157 -74140516)
2012,Abril,Suecia,5,7,,12,POINT (6170465 -7542726)
2012,Abril,Suecia,2,4,,6,POINT (7819 -72453013)
2012,Abril,Suecia,0,1,,1,POINT (7927233 -72508188)
2012,Abril,Suecia,3,0,,3,POINT (863337 -7735002)
2012,Abril,Suiza,8,9,,17,POINT (-4191162 -69941498)
2012,Abril,Suiza,15,33,,48,POINT (0.81488 -77356)
2012,Abril,Suiza,4,9,,13,POINT (10406342 -75527794)
2012,Abril,Suiza,8,15,,23,POINT (10446304 -75516486)
2012,Abril,Suiza,3,3,,6,POINT (10886686 -74776479)
2012,Abril,Suiza,3,5,,8,POINT (11360029 -72129595)
2012,Abril,Suiza,1,1,,2,POINT (125862 -81702165)
2012,Abril,Suiza,2,2,,4,POINT (133387613 -81372937)
2012,Abril,Suiza,9,22,,31,POINT (3451668 -76532004)
2012,Abril,Suiza,234,432,,666,POINT (4697157 -74140516)
2012,Abril,Suiza,15,35,,50,POINT (6170465 -7542726)
2012,Abril,Suiza,1,1,,2,POINT (7128047 -73181317)
2012,Abril,Suiza,2,1,,3,POINT (7819 -72453013)
2012,Abril,Suiza,0,1,,1,POINT (863337 -7735002)
2012,Abril,Surinam,1,0,,1,POINT (10406342 -75527794)
2012,Abril,Surinam,5,13,,18,POINT (10446304 -75516486)
2012,Abril,Surinam,28,23,,51,POINT (4697157 -74140516)
2012,Abril,Surinam,0,3,,3,POINT (6170465 -7542726)
2012,Abril,Taiwán,0,1,,1,POINT (10406342 -75527794)
2012,Abril,Taiwán,0,1,,1,POINT (10446304 -75516486)
2012,Abril,Taiwán,2,2,,4,POINT (4697157 -74140516)
2012,Abril,Taiwán,0,1,,1,POINT (4815189 -75736374)
2012,Abril,Tailandia,1,0,,1,POINT (3451668 -76532004)
2012,Abril,Tailandia,2,5,,7,POINT (4697157 -74140516)
2012,Abril,Tailandia,0,1,,1,POINT (6170465 -7542726)
2012,Abril,Territorio Antártico Británico/Territorio Británico de Ultramar,0,4,,4,POINT (4697157 -74140516)
2012,Abril,Tanzania,0,1,,1,POINT (4697157 -74140516)
2012,Abril,Trinidad y Tobago,5,37,,42,POINT (10446304 -75516486)
2012,Abril,Trinidad y Tobago,0,7,,7,POINT (10886686 -74776479)
2012,Abril,Trinidad y Tobago,0,1,,1,POINT (125862 -81702165)
2012,Abril,Trinidad y Tobago,0,2,,2,POINT (3451668 -76532004)
2012,Abril,Trinidad y Tobago,15,53,,68,POINT (4697157 -74140516)
2012,Abril,Trinidad y Tobago,6,3,,9,POINT (4815189 -75736374)
2012,Abril,Trinidad y Tobago,0,18,,18,POINT (6170465 -7542726)
2012,Abril,Trinidad y Tobago,0,1,,1,POINT (7128047 -73181317)
2012,Abril,Túnez,0,1,,1,POINT (3451668 -76532004)
2012,Abril,Túnez,0,4,,4,POINT (4697157 -74140516)
2012,Abril,Turquía,0,2,,2,POINT (0.81488 -77356)
2012,Abril,Turquía,3,3,,6,POINT (10446304 -75516486)
2012,Abril,Turquía,0,1,,1,POINT (10970933 -74765343)
2012,Abril,Turquía,1,1,,2,POINT (3451668 -76532004)
2012,Abril,Turquía,9,32,,41,POINT (4697157 -74140516)
2012,Abril,Turquía,0,3,,3,POINT (6170465 -7542726)
2012,Abril,Turquía,0,3,,3,POINT (7819 -72453013)
2012,Abril,Turquía,0,1,,1,POINT (863337 -7735002)
2012,Abril,Ucrania,0,1,,1,POINT (0.81488 -77356)
2012,Abril,Ucrania,1,0,,1,POINT (3451668 -76532004)
2012,Abril,Ucrania,13,8,,21,POINT (4697157 -74140516)
2012,Abril,Ucrania,0,2,,2,POINT (6170465 -7542726)
2012,Abril,Ucrania,11,15,,26,POINT (7819 -72453013)
2012,Abril,Uganda,1,1,,2,POINT (4697157 -74140516)
2012,Abril,Uganda,0,1,,1,POINT (6170465 -7542726)
2012,Abril,Federación de Rusia,1,1,,2,POINT (-4191162 -69941498)
2012,Abril,Federación de Rusia,1,2,,3,POINT (0.81488 -77356)
2012,Abril,Federación de Rusia,0,2,,2,POINT (10406342 -75527794)
2012,Abril,Federación de Rusia,4,2,,6,POINT (10446304 -75516486)
2012,Abril,Federación de Rusia,0,1,,1,POINT (10970933 -74765343)
2012,Abril,Federación de Rusia,0,9,,9,POINT (11247723 -74213989)
2012,Abril,Federación de Rusia,1,1,,2,POINT (125862 -81702165)
2012,Abril,Federación de Rusia,1,0,,1,POINT (3451668 -76532004)
2012,Abril,Federación de Rusia,94,142,,236,POINT (4697157 -74140516)
2012,Abril,Federación de Rusia,2,1,,3,POINT (6170465 -7542726)
2012,Abril,Federación de Rusia,6,3,,9,POINT (7819 -72453013)
2012,Abril,Federación de Rusia,0,1,,1,POINT (9402597 -75681642)
2012,Abril,Uruguay,1,8,,9,POINT (0.81488 -77356)
2012,Abril,Uruguay,1,1,,2,POINT (10406342 -75527794)
2012,Abril,Uruguay,132,106,,238,POINT (10446304 -75516486)
2012,Abril,Uruguay,2,11,,13,POINT (10886686 -74776479)
2012,Abril,Uruguay,0,1,,1,POINT (1152863 -72919186)
2012,Abril,Uruguay,65,55,,120,POINT (125862 -81702165)
2012,Abril,Uruguay,6,17,,23,POINT (3451668 -76532004)
2012,Abril,Uruguay,117,258,,375,POINT (4697157 -74140516)
2012,Abril,Uruguay,0,1,,1,POINT (4815189 -75736374)
2012,Abril,Uruguay,12,71,,83,POINT (6170465 -7542726)
2012,Abril,Uruguay,1,5,,6,POINT (7819 -72453013)
2012,Abril,Uruguay,0,2,,2,POINT (7927233 -72508188)
2012,Abril,Venezuela,50,94,,144,POINT (0.81488 -77356)
2012,Abril,Venezuela,0,1,,1,POINT (1800143 -78802679)
2012,Abril,Venezuela,7,20,,27,POINT (10406342 -75527794)
2012,Abril,Venezuela,0,14,,14,POINT (10433609 -73247863)
2012,Abril,Venezuela,112,222,,334,POINT (10446304 -75516486)
2012,Abril,Venezuela,35,53,,88,POINT (10886686 -74776479)
2012,Abril,Venezuela,1,2,,3,POINT (11117206 -74232675)
2012,Abril,Venezuela,0,3,,3,POINT (11247723 -74213989)
2012,Abril,Venezuela,2051,2483,,4534,POINT (11360029 -72129595)
2012,Abril,Venezuela,7,6,,13,POINT (1152863 -72919186)
2012,Abril,Venezuela,8,8,,16,POINT (125862 -81702165)
2012,Abril,Venezuela,51,58,,109,POINT (3451668 -76532004)
2012,Abril,Venezuela,1,1,,2,POINT (445285 -75766353)
2012,Abril,Venezuela,5067,5746,,10813,POINT (4697157 -74140516)
2012,Abril,Venezuela,1,17,,18,POINT (4815189 -75736374)
2012,Abril,Venezuela,243,312,,555,POINT (6170465 -7542726)
2012,Abril,Venezuela,28,45,,73,POINT (6185536 -67484028)
2012,Abril,Venezuela,47,47,,94,POINT (7088729 -70740253)
2012,Abril,Venezuela,5,6,,11,POINT (7128047 -73181317)
2012,Abril,Venezuela,1276,1365,,2641,POINT (7819 -72453013)
2012,Abril,Venezuela,225,220,,445,POINT (7927233 -72508188)
2012,Abril,Venezuela,0,1,,1,POINT (863337 -7735002)
2012,Abril,Vietnam,0,17,,17,POINT (10406342 -75527794)
2012,Abril,República Árabe de Yemen,0,1,,1,POINT (4697157 -74140516)
2012,Abril,Yugoslavia,1,0,,1,POINT (4697157 -74140516)
2012,Abril,Reino Unido de Gran Bretaña e Irlanda del Norte,1,2,,3,POINT (-4191162 -69941498)
2012,Abril,Reino Unido de Gran Bretaña e Irlanda del Norte,14,24,,38,POINT (0.81488 -77356)
2012,Abril,Reino Unido de Gran Bretaña e Irlanda del Norte,19,27,,46,POINT (10406342 -75527794)
2012,Abril,Reino Unido de Gran Bretaña e Irlanda del Norte,3,15,,18,POINT (10446304 -75516486)
2012,Abril,Reino Unido de Gran Bretaña e Irlanda del Norte,1,1,,2,POINT (10886686 -74776479)
2012,Abril,Reino Unido de Gran Bretaña e Irlanda del Norte,2,1,,3,POINT (11247723 -74213989)
2012,Abril,Reino Unido de Gran Bretaña e Irlanda del Norte,4,6,,10,POINT (11360029 -72129595)
2012,Abril,Reino Unido de Gran Bretaña e Irlanda del Norte,0,1,,1,POINT (125862 -81702165)
2012,Abril,Reino Unido de Gran Bretaña e Irlanda del Norte,10,17,,27,POINT (3451668 -76532004)
2012,Abril,Reino Unido de Gran Bretaña e Irlanda del Norte,222,644,,866,POINT (4697157 -74140516)
2012,Abril,Reino Unido de Gran Bretaña e Irlanda del Norte,8,25,,33,POINT (6170465 -7542726)
2012,Abril,Reino Unido de Gran Bretaña e Irlanda del Norte,3,6,,9,POINT (7819 -72453013)
2012,Abril,Reino Unido de Gran Bretaña e Irlanda del Norte,0,3,,3,POINT (863337 -7735002)
2012,Abril,Países Bajos,0,1,,1,POINT (0.33002 -76876446)
2012,Abril,Países Bajos,10,16,,26,POINT (0.81488 -77356)
2012,Abril,Países Bajos,2,4,,6,POINT (10406342 -75527794)
2012,Abril,Países Bajos,4,20,,24,POINT (10446304 -75516486)
2012,Abril,Países Bajos,3,3,,6,POINT (10886686 -74776479)
2012,Abril,Países Bajos,1,11,,12,POINT (11247723 -74213989)
2012,Abril,Países Bajos,4,7,,11,POINT (11360029 -72129595)
2012,Abril,Países Bajos,2,1,,3,POINT (1152863 -72919186)
2012,Abril,Países Bajos,1,1,,2,POINT (125862 -81702165)
2012,Abril,Países Bajos,0,2,,2,POINT (133387613 -81372937)
2012,Abril,Países Bajos,11,29,,40,POINT (3451668 -76532004)
2012,Abril,Países Bajos,1,0,,1,POINT (445285 -75766353)
2012,Abril,Países Bajos,381,708,,1089,POINT (4697157 -74140516)
2012,Abril,Países Bajos,1,0,,1,POINT (4815189 -75736374)
2012,Abril,Países Bajos,31,60,,91,POINT (6170465 -7542726)
2012,Abril,Países Bajos,4,5,,9,POINT (7128047 -73181317)
2012,Abril,Países Bajos,3,4,,7,POINT (7819 -72453013)
2012,Abril,Países Bajos,1,1,,2,POINT (7927233 -72508188)
2012,Abril,Países Bajos,0,1,,1,POINT (863337 -7735002)
2012,Abril,Lituania,1,0,,1,POINT (10406342 -75527794)
2012,Abril,Lituania,5,3,,8,POINT (4697157 -74140516)
2012,Abril,Reino Unido de Gran Bretaña e Irlanda del Norte,0,1,,1,POINT (0.81488 -77356)
2012,Abril,Reino Unido de Gran Bretaña e Irlanda del Norte,0,4,,4,POINT (11247723 -74213989)
2012,Abril,Reino Unido de Gran Bretaña e Irlanda del Norte,1,0,,1,POINT (0.81488 -77356)
2012,Abril,Reino Unido de Gran Bretaña e Irlanda del Norte,1,1,,2,POINT (4697157 -74140516)
2012,Abril,Reino Unido de Gran Bretaña e Irlanda del Norte,0,1,,1,POINT (-4191162 -69941498)
2012,Abril,Reino Unido de Gran Bretaña e Irlanda del Norte,4,3,,7,POINT (10406342 -75527794)
2012,Abril,Reino Unido de Gran Bretaña e Irlanda del Norte,1,0,,1,POINT (11247723 -74213989)
2012,Abril,Reino Unido de Gran Bretaña e Irlanda del Norte,3,10,,13,POINT (4697157 -74140516)
2012,Abril,Reino Unido de Gran Bretaña e Irlanda del Norte,0,1,,1,POINT (6170465 -7542726)
2012,Abril,Reino Unido de Gran Bretaña e Irlanda del Norte,1,0,,1,POINT (863337 -7735002)
2012,Abril,Letonia,1,0,,1,POINT (4697157 -74140516)
2012,Mayo,Afganistán,0,1,,1,POINT (4697157 -74140516)
2012,Mayo,Albania,1,1,,2,POINT (4697157 -74140516)
2012,Mayo,Alemania,11,10,,21,POINT (-4191162 -69941498)
2012,Mayo,Alemania,45,63,,108,POINT (0.81488 -77356)
2012,Mayo,Alemania,20,28,,48,POINT (10406342 -75527794)
2012,Mayo,Alemania,13,24,,37,POINT (10446304 -75516486)
2012,Mayo,Alemania,1,7,,8,POINT (10886686 -74776479)
2012,Mayo,Alemania,7,9,,16,POINT (11360029 -72129595)
2012,Mayo,Alemania,0,1,,1,POINT (125744111 -81703935)
2012,Mayo,Alemania,5,4,,9,POINT (125862 -81702165)
2012,Mayo,Alemania,4,3,,7,POINT (133387613 -81372937)
2012,Mayo,Alemania,22,35,,57,POINT (3451668 -76532004)
2012,Mayo,Alemania,790,1488,,2278,POINT (4697157 -74140516)
2012,Mayo,Alemania,23,55,,78,POINT (6170465 -7542726)
2012,Mayo,Alemania,1,0,,1,POINT (7128047 -73181317)
2012,Mayo,Alemania,8,12,,20,POINT (7819 -72453013)
2012,Mayo,Alemania,4,5,,9,POINT (863337 -7735002)
2012,Mayo,Andorra,1,9,,10,POINT (4697157 -74140516)
2012,Mayo,Angola,0,1,,1,POINT (10446304 -75516486)
2012,Mayo,Angola,0,2,,2,POINT (4697157 -74140516)
2012,Mayo,Países Bajos,2,2,,4,POINT (6170465 -7542726)
2012,Mayo,Arabia Saudita,0,3,,3,POINT (4697157 -74140516)
2012,Mayo,Argelia,1,4,,5,POINT (4697157 -74140516)
2012,Mayo,Argentina,4,5,,9,POINT (-4191162 -69941498)
2012,Mayo,Argentina,4,3,,7,POINT (0.33002 -76876446)
2012,Mayo,Argentina,52,110,,162,POINT (0.81488 -77356)
2012,Mayo,Argentina,3,8,,11,POINT (10406342 -75527794)
2012,Mayo,Argentina,664,451,,1115,POINT (10446304 -75516486)
2012,Mayo,Argentina,5,22,,27,POINT (10886686 -74776479)
2012,Mayo,Argentina,19,33,,52,POINT (11360029 -72129595)
2012,Mayo,Argentina,215,167,,382,POINT (125862 -81702165)
2012,Mayo,Argentina,24,60,,84,POINT (3451668 -76532004)
2012,Mayo,Argentina,0,1,,1,POINT (445285 -75766353)
2012,Mayo,Argentina,2443,3857,,6300,POINT (4697157 -74140516)
2012,Mayo,Argentina,4,8,,12,POINT (4815189 -75736374)
2012,Mayo,Argentina,45,185,,230,POINT (6170465 -7542726)
2012,Mayo,Argentina,0,2,,2,POINT (6222552 -77401154)
2012,Mayo,Argentina,2,2,,4,POINT (7128047 -73181317)
2012,Mayo,Argentina,19,19,,38,POINT (7819 -72453013)
2012,Mayo,Argentina,2,1,,3,POINT (7927233 -72508188)
2012,Mayo,Argentina,2,8,,10,POINT (863337 -7735002)
2012,Mayo,Aruba,1,3,,4,POINT (4697157 -74140516)
2012,Mayo,Aruba,0,1,,1,POINT (6170465 -7542726)
2012,Mayo,Australia,7,8,,15,POINT (-4191162 -69941498)
2012,Mayo,Australia,36,67,,103,POINT (0.81488 -77356)
2012,Mayo,Australia,14,26,,40,POINT (10406342 -75527794)
2012,Mayo,Australia,11,19,,30,POINT (10446304 -75516486)
2012,Mayo,Australia,4,13,,17,POINT (10886686 -74776479)
2012,Mayo,Australia,0,1,,1,POINT (11360029 -72129595)
2012,Mayo,Australia,3,12,,15,POINT (3451668 -76532004)
2012,Mayo,Australia,1,1,,2,POINT (445285 -75766353)
2012,Mayo,Australia,192,346,,538,POINT (4697157 -74140516)
2012,Mayo,Australia,5,46,,51,POINT (6170465 -7542726)
2012,Mayo,Australia,1,4,,5,POINT (7819 -72453013)
2012,Mayo,Australia,0,2,,2,POINT (7927233 -72508188)
2012,Mayo,Australia,1,2,,3,POINT (863337 -7735002)
2012,Mayo,Austria,2,5,,7,POINT (-4191162 -69941498)
2012,Mayo,Austria,9,8,,17,POINT (0.81488 -77356)
2012,Mayo,Austria,1,0,,1,POINT (10406342 -75527794)
2012,Mayo,Austria,0,1,,1,POINT (10446304 -75516486)
2012,Mayo,Austria,0,2,,2,POINT (10886686 -74776479)
2012,Mayo,Austria,4,4,,8,POINT (11360029 -72129595)
2012,Mayo,Austria,0,1,,1,POINT (125744111 -81703935)
2012,Mayo,Austria,0,3,,3,POINT (3451668 -76532004)
2012,Mayo,Austria,57,147,,204,POINT (4697157 -74140516)
2012,Mayo,Austria,5,7,,12,POINT (6170465 -7542726)
2012,Mayo,Austria,0,1,,1,POINT (7088729 -70740253)
2012,Mayo,Austria,1,1,,2,POINT (7819 -72453013)
2012,Mayo,Austria,1,1,,2,POINT (863337 -7735002)
2012,Mayo,Bahamas,0,1,,1,POINT (10446304 -75516486)
2012,Mayo,Bahamas,0,4,,4,POINT (3451668 -76532004)
2012,Mayo,Bahamas,3,8,,11,POINT (4697157 -74140516)
2012,Mayo,Bahamas,0,3,,3,POINT (6170465 -7542726)
2012,Mayo,Bangladesh,1,0,,1,POINT (0.81488 -77356)
2012,Mayo,Barbados,0,1,,1,POINT (3451668 -76532004)
2012,Mayo,Barbados,2,3,,5,POINT (4697157 -74140516)
2012,Mayo,Barbados,0,2,,2,POINT (7128047 -73181317)
2012,Mayo,República de Belarús,0,3,,3,POINT (4697157 -74140516)
2012,Mayo,Bélgica,10,9,,19,POINT (0.81488 -77356)
2012,Mayo,Bélgica,0,1,,1,POINT (1800143 -78802679)
2012,Mayo,Bélgica,1,2,,3,POINT (10406342 -75527794)
2012,Mayo,Bélgica,0,9,,9,POINT (10446304 -75516486)
2012,Mayo,Bélgica,0,2,,2,POINT (10886686 -74776479)
2012,Mayo,Bélgica,1,0,,1,POINT (133387613 -81372937)
2012,Mayo,Bélgica,2,6,,8,POINT (3451668 -76532004)
2012,Mayo,Bélgica,61,220,,281,POINT (4697157 -74140516)
2012,Mayo,Bélgica,3,15,,18,POINT (6170465 -7542726)
2012,Mayo,Bélgica,1,0,,1,POINT (7819 -72453013)
2012,Mayo,Belice,0,1,,1,POINT (11360029 -72129595)
2012,Mayo,Belice,1,0,,1,POINT (3451668 -76532004)
2012,Mayo,Belice,1,3,,4,POINT (4697157 -74140516)
2012,Mayo,Belice,0,1,,1,POINT (6170465 -7542726)
2012,Mayo,Benín,2,0,,2,POINT (4697157 -74140516)
2012,Mayo,Bermudas/Territorio Británico de Ultramar,0,1,,1,POINT (4697157 -74140516)
2012,Mayo,Bolivia,1,0,,1,POINT (0.33002 -76876446)
2012,Mayo,Bolivia,10,10,,20,POINT (0.81488 -77356)
2012,Mayo,Bolivia,11,15,,26,POINT (10446304 -75516486)
2012,Mayo,Bolivia,7,2,,9,POINT (10886686 -74776479)
2012,Mayo,Bolivia,2,3,,5,POINT (125862 -81702165)
2012,Mayo,Bolivia,5,6,,11,POINT (3451668 -76532004)
2012,Mayo,Bolivia,259,377,,636,POINT (4697157 -74140516)
2012,Mayo,Bolivia,0,1,,1,POINT (4815189 -75736374)
2012,Mayo,Bolivia,12,35,,47,POINT (6170465 -7542726)
2012,Mayo,Bolivia,0,1,,1,POINT (7128047 -73181317)
2012,Mayo,Bosnia y Herzegovina,1,1,,2,POINT (4697157 -74140516)
2012,Mayo,Botsuana,0,1,,1,POINT (4697157 -74140516)
2012,Mayo,Brasil,50,36,,86,POINT (-4191162 -69941498)
2012,Mayo,Brasil,0,1,,1,POINT (0.33002 -76876446)
2012,Mayo,Brasil,10,19,,29,POINT (0.81488 -77356)
2012,Mayo,Brasil,145,122,,267,POINT (10446304 -75516486)
2012,Mayo,Brasil,7,23,,30,POINT (10886686 -74776479)
2012,Mayo,Brasil,0,1,,1,POINT (11247723 -74213989)
2012,Mayo,Brasil,1,13,,14,POINT (11360029 -72129595)
2012,Mayo,Brasil,2,1,,3,POINT (1152863 -72919186)
2012,Mayo,Brasil,17,15,,32,POINT (125862 -81702165)
2012,Mayo,Brasil,16,40,,56,POINT (3451668 -76532004)
2012,Mayo,Brasil,2286,3934,,6220,POINT (4697157 -74140516)
2012,Mayo,Brasil,1,1,,2,POINT (4815189 -75736374)
2012,Mayo,Brasil,62,101,,163,POINT (6170465 -7542726)
2012,Mayo,Brasil,1,1,,2,POINT (6185536 -67484028)
2012,Mayo,Brasil,0,1,,1,POINT (7088729 -70740253)
2012,Mayo,Brasil,0,1,,1,POINT (7128047 -73181317)
2012,Mayo,Brasil,2,12,,14,POINT (7819 -72453013)
2012,Mayo,Brasil,0,2,,2,POINT (7927233 -72508188)
2012,Mayo,Brasil,1,1,,2,POINT (863337 -7735002)
2012,Mayo,Bulgaria,2,0,,2,POINT (3451668 -76532004)
2012,Mayo,Bulgaria,4,8,,12,POINT (4697157 -74140516)
2012,Mayo,Bulgaria,0,2,,2,POINT (6170465 -7542726)
2012,Mayo,Bulgaria,2,0,,2,POINT (7819 -72453013)
2012,Mayo,Burkina Faso,0,1,,1,POINT (4697157 -74140516)
2012,Mayo,Cabo Verde,0,1,,1,POINT (4697157 -74140516)
2012,Mayo,Islas Caimán/Territorio Británico de Ultramar,0,1,,1,POINT (10446304 -75516486)
2012,Mayo,Islas Caimán/Territorio Británico de Ultramar,2,0,,2,POINT (10886686 -74776479)
2012,Mayo,Islas Caimán/Territorio Británico de Ultramar,1,0,,1,POINT (125862 -81702165)
2012,Mayo,Camboya,0,1,,1,POINT (4697157 -74140516)
2012,Mayo,Camerún,0,2,,2,POINT (4697157 -74140516)
2012,Mayo,Canadá,2,5,,7,POINT (-4191162 -69941498)
2012,Mayo,Canadá,23,28,,51,POINT (0.81488 -77356)
2012,Mayo,Canadá,7,16,,23,POINT (10406342 -75527794)
2012,Mayo,Canadá,30,65,,95,POINT (10446304 -75516486)
2012,Mayo,Canadá,8,25,,33,POINT (10886686 -74776479)
2012,Mayo,Canadá,2,3,,5,POINT (11247723 -74213989)
2012,Mayo,Canadá,0,4,,4,POINT (11360029 -72129595)
2012,Mayo,Canadá,0,1,,1,POINT (1152863 -72919186)
2012,Mayo,Canadá,2,5,,7,POINT (125862 -81702165)
2012,Mayo,Canadá,5,3,,8,POINT (133387613 -81372937)
2012,Mayo,Canadá,28,43,,71,POINT (3451668 -76532004)
2012,Mayo,Canadá,525,1211,,1736,POINT (4697157 -74140516)
2012,Mayo,Canadá,0,2,,2,POINT (4815189 -75736374)
2012,Mayo,Canadá,59,157,,216,POINT (6170465 -7542726)
2012,Mayo,Canadá,0,4,,4,POINT (7128047 -73181317)
2012,Mayo,Canadá,2,5,,7,POINT (7819 -72453013)
2012,Mayo,Canadá,0,1,,1,POINT (7927233 -72508188)
2012,Mayo,Canadá,0,3,,3,POINT (863337 -7735002)
2012,Mayo,España,0,5,,5,POINT (0.33002 -76876446)
2012,Mayo,España,7,11,,18,POINT (0.81488 -77356)
2012,Mayo,España,5,9,,14,POINT (10446304 -75516486)
2012,Mayo,España,4,17,,21,POINT (10886686 -74776479)
2012,Mayo,España,0,1,,1,POINT (11247723 -74213989)
2012,Mayo,España,0,2,,2,POINT (125862 -81702165)
2012,Mayo,España,29,64,,93,POINT (3451668 -76532004)
2012,Mayo,España,0,1,,1,POINT (445285 -75766353)
2012,Mayo,España,123,380,,503,POINT (4697157 -74140516)
2012,Mayo,España,2,6,,8,POINT (4815189 -75736374)
2012,Mayo,España,35,87,,122,POINT (6170465 -7542726)
2012,Mayo,España,1,1,,2,POINT (7128047 -73181317)
2012,Mayo,España,1,5,,6,POINT (7927233 -72508188)
2012,Mayo,República Democrática del Congo,1,1,,2,POINT (4697157 -74140516)
2012,Mayo,República de Corea,0,1,,1,POINT (-4191162 -69941498)
2012,Mayo,República de Corea,7,8,,15,POINT (0.81488 -77356)
2012,Mayo,República de Corea,1,1,,2,POINT (10446304 -75516486)
2012,Mayo,República de Corea,0,2,,2,POINT (11360029 -72129595)
2012,Mayo,República de Corea,1,7,,8,POINT (3451668 -76532004)
2012,Mayo,República de Corea,142,372,,514,POINT (4697157 -74140516)
2012,Mayo,República de Corea,0,1,,1,POINT (4815189 -75736374)
2012,Mayo,República de Corea,6,18,,24,POINT (6170465 -7542726)
2012,Mayo,República de Corea,2,2,,4,POINT (6185536 -67484028)
2012,Mayo,República de Corea,1,2,,3,POINT (7819 -72453013)
2012,Mayo,República de Corea,0,1,,1,POINT (863337 -7735002)
2012,Mayo,Costa de Marfil,0,2,,2,POINT (4697157 -74140516)
2012,Mayo,Costa de Marfil,0,1,,1,POINT (7819 -72453013)
2012,Mayo,Costa Rica,1,2,,3,POINT (0.81488 -77356)
2012,Mayo,Costa Rica,0,1,,1,POINT (10406342 -75527794)
2012,Mayo,Costa Rica,43,42,,85,POINT (10446304 -75516486)
2012,Mayo,Costa Rica,7,22,,29,POINT (10886686 -74776479)
2012,Mayo,Costa Rica,0,1,,1,POINT (125744111 -81703935)
2012,Mayo,Costa Rica,212,152,,364,POINT (125862 -81702165)
2012,Mayo,Costa Rica,12,32,,44,POINT (3451668 -76532004)
2012,Mayo,Costa Rica,315,549,,864,POINT (4697157 -74140516)
2012,Mayo,Costa Rica,3,4,,7,POINT (4815189 -75736374)
2012,Mayo,Costa Rica,46,111,,157,POINT (6170465 -7542726)
2012,Mayo,Costa Rica,0,1,,1,POINT (6222552 -77401154)
2012,Mayo,Costa Rica,1,2,,3,POINT (7128047 -73181317)
2012,Mayo,Costa Rica,1,4,,5,POINT (7819 -72453013)
2012,Mayo,Costa Rica,0,1,,1,POINT (863337 -7735002)
2012,Mayo,Croacia,0,1,,1,POINT (0.81488 -77356)
2012,Mayo,Croacia,0,1,,1,POINT (10406342 -75527794)
2012,Mayo,Croacia,1,4,,5,POINT (10446304 -75516486)
2012,Mayo,Croacia,0,1,,1,POINT (11360029 -72129595)
2012,Mayo,Croacia,4,27,,31,POINT (4697157 -74140516)
2012,Mayo,Croacia,0,1,,1,POINT (7819 -72453013)
2012,Mayo,Cuba,0,4,,4,POINT (0.81488 -77356)
2012,Mayo,Cuba,6,8,,14,POINT (10446304 -75516486)
2012,Mayo,Cuba,1,10,,11,POINT (10886686 -74776479)
2012,Mayo,Cuba,1,1,,2,POINT (11360029 -72129595)
2012,Mayo,Cuba,0,1,,1,POINT (125862 -81702165)
2012,Mayo,Cuba,15,55,,70,POINT (3451668 -76532004)
2012,Mayo,Cuba,0,1,,1,POINT (445285 -75766353)
2012,Mayo,Cuba,60,132,,192,POINT (4697157 -74140516)
2012,Mayo,Cuba,1,2,,3,POINT (4815189 -75736374)
2012,Mayo,Cuba,7,25,,32,POINT (6170465 -7542726)
2012,Mayo,Cuba,0,1,,1,POINT (7819 -72453013)
2012,Mayo,Curazao,1,0,,1,POINT (4697157 -74140516)
2012,Mayo,Curazao,2,4,,6,POINT (6170465 -7542726)
2012,Mayo,República Checa,2,2,,4,POINT (-4191162 -69941498)
2012,Mayo,República Checa,3,7,,10,POINT (0.81488 -77356)
2012,Mayo,República Checa,2,2,,4,POINT (10446304 -75516486)
2012,Mayo,República Checa,17,31,,48,POINT (4697157 -74140516)
2012,Mayo,República Checa,1,2,,3,POINT (6170465 -7542726)
2012,Mayo,República Checa,0,1,,1,POINT (7819 -72453013)
2012,Mayo,Chile,1,1,,2,POINT (-4191162 -69941498)
2012,Mayo,Chile,1,0,,1,POINT (0.33002 -76876446)
2012,Mayo,Chile,20,38,,58,POINT (0.81488 -77356)
2012,Mayo,Chile,0,1,,1,POINT (1800143 -78802679)
2012,Mayo,Chile,84,71,,155,POINT (10446304 -75516486)
2012,Mayo,Chile,4,9,,13,POINT (10886686 -74776479)
2012,Mayo,Chile,7,11,,18,POINT (11360029 -72129595)
2012,Mayo,Chile,52,34,,86,POINT (125862 -81702165)
2012,Mayo,Chile,18,38,,56,POINT (3451668 -76532004)
2012,Mayo,Chile,0,1,,1,POINT (445285 -75766353)
2012,Mayo,Chile,2270,3367,,5637,POINT (4697157 -74140516)
2012,Mayo,Chile,0,1,,1,POINT (4815189 -75736374)
2012,Mayo,Chile,44,128,,172,POINT (6170465 -7542726)
2012,Mayo,Chile,1,0,,1,POINT (7128047 -73181317)
2012,Mayo,Chile,7,15,,22,POINT (7819 -72453013)
2012,Mayo,Chile,0,2,,2,POINT (7927233 -72508188)
2012,Mayo,Chile,0,1,,1,POINT (863337 -7735002)
2012,Mayo,China,0,5,,5,POINT (0.81488 -77356)
2012,Mayo,China,2,2,,4,POINT (10446304 -75516486)
2012,Mayo,China,1,2,,3,POINT (10886686 -74776479)
2012,Mayo,China,2,0,,2,POINT (11360029 -72129595)
2012,Mayo,China,3,6,,9,POINT (3451668 -76532004)
2012,Mayo,China,0,2,,2,POINT (3884426 -77061029)
2012,Mayo,China,166,560,,726,POINT (4697157 -74140516)
2012,Mayo,China,8,11,,19,POINT (6170465 -7542726)
2012,Mayo,China,0,1,,1,POINT (7819 -72453013)
2012,Mayo,China,0,1,,1,POINT (7927233 -72508188)
2012,Mayo,Taiwán,1,0,,1,POINT (-4191162 -69941498)
2012,Mayo,Taiwán,2,1,,3,POINT (0.81488 -77356)
2012,Mayo,Taiwán,2,1,,3,POINT (10446304 -75516486)
2012,Mayo,Taiwán,1,3,,4,POINT (10886686 -74776479)
2012,Mayo,Taiwán,1,1,,2,POINT (11360029 -72129595)
2012,Mayo,Taiwán,2,4,,6,POINT (3451668 -76532004)
2012,Mayo,Taiwán,0,1,,1,POINT (3884426 -77061029)
2012,Mayo,Taiwán,41,59,,100,POINT (4697157 -74140516)
2012,Mayo,Taiwán,1,0,,1,POINT (4815189 -75736374)
2012,Mayo,Taiwán,4,6,,10,POINT (6170465 -7542726)
2012,Mayo,Taiwán,1,1,,2,POINT (7819 -72453013)
2012,Mayo,Chipre,1,0,,1,POINT (0.81488 -77356)
2012,Mayo,Chipre,2,3,,5,POINT (4697157 -74140516)
2012,Mayo,Dinamarca,1,0,,1,POINT (-4191162 -69941498)
2012,Mayo,Dinamarca,5,6,,11,POINT (0.81488 -77356)
2012,Mayo,Dinamarca,1,6,,7,POINT (10406342 -75527794)
2012,Mayo,Dinamarca,0,2,,2,POINT (10446304 -75516486)
2012,Mayo,Dinamarca,0,1,,1,POINT (11247723 -74213989)
2012,Mayo,Dinamarca,1,3,,4,POINT (3451668 -76532004)
2012,Mayo,Dinamarca,48,79,,127,POINT (4697157 -74140516)
2012,Mayo,Dinamarca,2,5,,7,POINT (6170465 -7542726)
2012,Mayo,Dinamarca,0,1,,1,POINT (863337 -7735002)
2012,Mayo,Dominica,0,1,,1,POINT (11247723 -74213989)
2012,Mayo,Dominica,3,2,,5,POINT (4697157 -74140516)
2012,Mayo,Dominica,0,1,,1,POINT (6170465 -7542726)
2012,Mayo,Dominica,0,1,,1,POINT (7819 -72453013)
2012,Mayo,Ecuador,0,1,,1,POINT (-4191162 -69941498)
2012,Mayo,Ecuador,9,54,,63,POINT (0.33002 -76876446)
2012,Mayo,Ecuador,623,1165,,1788,POINT (0.81488 -77356)
2012,Mayo,Ecuador,1,8,,9,POINT (1397318 -77290564)
2012,Mayo,Ecuador,1,56,,57,POINT (1800143 -78802679)
2012,Mayo,Ecuador,0,4,,4,POINT (10406342 -75527794)
2012,Mayo,Ecuador,14,30,,44,POINT (10446304 -75516486)
2012,Mayo,Ecuador,4,10,,14,POINT (10886686 -74776479)
2012,Mayo,Ecuador,2,8,,10,POINT (11360029 -72129595)
2012,Mayo,Ecuador,42,36,,78,POINT (125862 -81702165)
2012,Mayo,Ecuador,240,312,,552,POINT (3451668 -76532004)
2012,Mayo,Ecuador,1595,2738,,4333,POINT (4697157 -74140516)
2012,Mayo,Ecuador,1,1,,2,POINT (4815189 -75736374)
2012,Mayo,Ecuador,407,535,,942,POINT (6170465 -7542726)
2012,Mayo,Ecuador,0,1,,1,POINT (6185536 -67484028)
2012,Mayo,Ecuador,2,2,,4,POINT (7128047 -73181317)
2012,Mayo,Ecuador,88,135,,223,POINT (7819 -72453013)
2012,Mayo,Ecuador,1,3,,4,POINT (7927233 -72508188)
2012,Mayo,Egipto,0,1,,1,POINT (10446304 -75516486)
2012,Mayo,Egipto,6,17,,23,POINT (4697157 -74140516)
2012,Mayo,Egipto,0,1,,1,POINT (6170465 -7542726)
2012,Mayo,El Salvador,3,11,,14,POINT (10446304 -75516486)
2012,Mayo,El Salvador,1,2,,3,POINT (10886686 -74776479)
2012,Mayo,El Salvador,2,2,,4,POINT (125862 -81702165)
2012,Mayo,El Salvador,2,11,,13,POINT (3451668 -76532004)
2012,Mayo,El Salvador,319,538,,857,POINT (4697157 -74140516)
2012,Mayo,El Salvador,19,42,,61,POINT (6170465 -7542726)
2012,Mayo,El Salvador,0,1,,1,POINT (863337 -7735002)
2012,Mayo,Emiratos Árabes,2,9,,11,POINT (4697157 -74140516)
2012,Mayo,España,0,6,,6,POINT (-4191162 -69941498)
2012,Mayo,España,16,36,,52,POINT (0.81488 -77356)
2012,Mayo,España,6,7,,13,POINT (10406342 -75527794)
2012,Mayo,España,33,70,,103,POINT (10446304 -75516486)
2012,Mayo,España,5,7,,12,POINT (10886686 -74776479)
2012,Mayo,España,1,4,,5,POINT (11360029 -72129595)
2012,Mayo,España,7,6,,13,POINT (125862 -81702165)
2012,Mayo,España,1,2,,3,POINT (133387613 -81372937)
2012,Mayo,España,97,224,,321,POINT (3451668 -76532004)
2012,Mayo,España,2,0,,2,POINT (445285 -75766353)
2012,Mayo,España,1397,3852,,5249,POINT (4697157 -74140516)
2012,Mayo,España,0,4,,4,POINT (4815189 -75736374)
2012,Mayo,España,70,182,,252,POINT (6170465 -7542726)
2012,Mayo,España,1,0,,1,POINT (6222552 -77401154)
2012,Mayo,España,1,0,,1,POINT (7088729 -70740253)
2012,Mayo,España,11,35,,46,POINT (7819 -72453013)
2012,Mayo,España,1,6,,7,POINT (7927233 -72508188)
2012,Mayo,España,3,4,,7,POINT (863337 -7735002)
2012,Mayo,Eslovaquia,1,0,,1,POINT (-4191162 -69941498)
2012,Mayo,Eslovaquia,1,0,,1,POINT (0.81488 -77356)
2012,Mayo,Eslovaquia,1,1,,2,POINT (10406342 -75527794)
2012,Mayo,Eslovaquia,0,1,,1,POINT (10446304 -75516486)
2012,Mayo,Eslovaquia,11,6,,17,POINT (4697157 -74140516)
2012,Mayo,Eslovaquia,0,1,,1,POINT (4815189 -75736374)
2012,Mayo,Eslovaquia,0,1,,1,POINT (6170465 -7542726)
2012,Mayo,Eslovaquia,1,1,,2,POINT (7819 -72453013)
2012,Mayo,Eslovenia,0,1,,1,POINT (0.81488 -77356)
2012,Mayo,Eslovenia,0,2,,2,POINT (10406342 -75527794)
2012,Mayo,Eslovenia,1,1,,2,POINT (10446304 -75516486)
2012,Mayo,Eslovenia,0,1,,1,POINT (11360029 -72129595)
2012,Mayo,Eslovenia,3,17,,20,POINT (4697157 -74140516)
2012,Mayo,Eslovenia,0,2,,2,POINT (6170465 -7542726)
2012,Mayo,Estados Unidos de América,10,13,,23,POINT (-4191162 -69941498)
2012,Mayo,Estados Unidos de América,56,78,,134,POINT (0.81488 -77356)
2012,Mayo,Estados Unidos de América,1,0,,1,POINT (1800143 -78802679)
2012,Mayo,Estados Unidos de América,21,46,,67,POINT (10406342 -75527794)
2012,Mayo,Estados Unidos de América,663,1399,,2062,POINT (10446304 -75516486)
2012,Mayo,Estados Unidos de América,339,523,,862,POINT (10886686 -74776479)
2012,Mayo,Estados Unidos de América,1,7,,8,POINT (11117206 -74232675)
2012,Mayo,Estados Unidos de América,4,6,,10,POINT (11247723 -74213989)
2012,Mayo,Estados Unidos de América,6,11,,17,POINT (11360029 -72129595)
2012,Mayo,Estados Unidos de América,3,17,,20,POINT (125744111 -81703935)
2012,Mayo,Estados Unidos de América,9,12,,21,POINT (125862 -81702165)
2012,Mayo,Estados Unidos de América,13,14,,27,POINT (133387613 -81372937)
2012,Mayo,Estados Unidos de América,756,1236,,1992,POINT (3451668 -76532004)
2012,Mayo,Estados Unidos de América,94,143,,237,POINT (445285 -75766353)
2012,Mayo,Estados Unidos de América,5784,11385,,17169,POINT (4697157 -74140516)
2012,Mayo,Estados Unidos de América,43,70,,113,POINT (4815189 -75736374)
2012,Mayo,Estados Unidos de América,909,2338,,3247,POINT (6170465 -7542726)
2012,Mayo,Estados Unidos de América,1,1,,2,POINT (7088729 -70740253)
2012,Mayo,Estados Unidos de América,20,27,,47,POINT (7128047 -73181317)
2012,Mayo,Estados Unidos de América,20,23,,43,POINT (7819 -72453013)
2012,Mayo,Estados Unidos de América,13,20,,33,POINT (7927233 -72508188)
2012,Mayo,Estados Unidos de América,2,3,,5,POINT (863337 -7735002)
2012,Mayo,Estonia,0,2,,2,POINT (10406342 -75527794)
2012,Mayo,Estonia,0,1,,1,POINT (10446304 -75516486)
2012,Mayo,Estonia,0,1,,1,POINT (3884426 -77061029)
2012,Mayo,Estonia,3,4,,7,POINT (4697157 -74140516)
2012,Mayo,Estonia,1,0,,1,POINT (6170465 -7542726)
2012,Mayo,Etiopia,1,0,,1,POINT (3451668 -76532004)
2012,Mayo,Etiopia,1,0,,1,POINT (4697157 -74140516)
2012,Mayo,Islas Fiji,1,0,,1,POINT (4697157 -74140516)
2012,Mayo,Filipinas,1,1,,2,POINT (0.81488 -77356)
2012,Mayo,Filipinas,2,23,,25,POINT (10406342 -75527794)
2012,Mayo,Filipinas,3,6,,9,POINT (10446304 -75516486)
2012,Mayo,Filipinas,0,3,,3,POINT (10886686 -74776479)
2012,Mayo,Filipinas,0,13,,13,POINT (10970933 -74765343)
2012,Mayo,Filipinas,0,13,,13,POINT (11247723 -74213989)
2012,Mayo,Filipinas,0,3,,3,POINT (3451668 -76532004)
2012,Mayo,Filipinas,0,2,,2,POINT (3884426 -77061029)
2012,Mayo,Filipinas,15,76,,91,POINT (4697157 -74140516)
2012,Mayo,Filipinas,0,1,,1,POINT (6170465 -7542726)
2012,Mayo,Filipinas,1,0,,1,POINT (7927233 -72508188)
2012,Mayo,Finlandia,0,1,,1,POINT (-4191162 -69941498)
2012,Mayo,Finlandia,2,4,,6,POINT (0.81488 -77356)
2012,Mayo,Finlandia,1,1,,2,POINT (10406342 -75527794)
2012,Mayo,Finlandia,2,0,,2,POINT (10446304 -75516486)
2012,Mayo,Finlandia,2,1,,3,POINT (3451668 -76532004)
2012,Mayo,Finlandia,37,60,,97,POINT (4697157 -74140516)
2012,Mayo,Finlandia,4,3,,7,POINT (6170465 -7542726)
2012,Mayo,Finlandia,2,0,,2,POINT (863337 -7735002)
2012,Mayo,Francia,3,9,,12,POINT (-4191162 -69941498)
2012,Mayo,Francia,51,63,,114,POINT (0.81488 -77356)
2012,Mayo,Francia,6,22,,28,POINT (10406342 -75527794)
2012,Mayo,Francia,17,52,,69,POINT (10446304 -75516486)
2012,Mayo,Francia,3,3,,6,POINT (10886686 -74776479)
2012,Mayo,Francia,4,1,,5,POINT (11247723 -74213989)
2012,Mayo,Francia,4,13,,17,POINT (11360029 -72129595)
2012,Mayo,Francia,0,2,,2,POINT (125744111 -81703935)
2012,Mayo,Francia,1,3,,4,POINT (125862 -81702165)
2012,Mayo,Francia,3,2,,5,POINT (133387613 -81372937)
2012,Mayo,Francia,23,46,,69,POINT (3451668 -76532004)
2012,Mayo,Francia,0,1,,1,POINT (445285 -75766353)
2012,Mayo,Francia,648,1377,,2025,POINT (4697157 -74140516)
2012,Mayo,Francia,4,2,,6,POINT (4815189 -75736374)
2012,Mayo,Francia,22,69,,91,POINT (6170465 -7542726)
2012,Mayo,Francia,0,1,,1,POINT (7088729 -70740253)
2012,Mayo,Francia,0,1,,1,POINT (7128047 -73181317)
2012,Mayo,Francia,2,13,,15,POINT (7819 -72453013)
2012,Mayo,Francia,1,6,,7,POINT (863337 -7735002)
2012,Mayo,Gabón,0,1,,1,POINT (4697157 -74140516)
2012,Mayo,Georgia,1,0,,1,POINT (3451668 -76532004)
2012,Mayo,Georgia,1,2,,3,POINT (4697157 -74140516)
2012,Mayo,Ghana,0,1,,1,POINT (3451668 -76532004)
2012,Mayo,Ghana,2,6,,8,POINT (4697157 -74140516)
2012,Mayo,Ghana,0,4,,4,POINT (7819 -72453013)
2012,Mayo,Granada,1,0,,1,POINT (4697157 -74140516)
2012,Mayo,Grecia,1,1,,2,POINT (0.81488 -77356)
2012,Mayo,Grecia,1,2,,3,POINT (10406342 -75527794)
2012,Mayo,Grecia,0,2,,2,POINT (10446304 -75516486)
2012,Mayo,Grecia,0,1,,1,POINT (11360029 -72129595)
2012,Mayo,Grecia,2,2,,4,POINT (3451668 -76532004)
2012,Mayo,Grecia,9,35,,44,POINT (4697157 -74140516)
2012,Mayo,Grecia,0,4,,4,POINT (6170465 -7542726)
2012,Mayo,Grecia,0,1,,1,POINT (7819 -72453013)
2012,Mayo,Grecia,0,1,,1,POINT (9402597 -75681642)
2012,Mayo,Guatemala,1,2,,3,POINT (0.81488 -77356)
2012,Mayo,Guatemala,1,6,,7,POINT (10406342 -75527794)
2012,Mayo,Guatemala,29,59,,88,POINT (10446304 -75516486)
2012,Mayo,Guatemala,3,9,,12,POINT (10886686 -74776479)
2012,Mayo,Guatemala,0,1,,1,POINT (11360029 -72129595)
2012,Mayo,Guatemala,2,0,,2,POINT (125862 -81702165)
2012,Mayo,Guatemala,5,34,,39,POINT (3451668 -76532004)
2012,Mayo,Guatemala,0,1,,1,POINT (445285 -75766353)
2012,Mayo,Guatemala,167,331,,498,POINT (4697157 -74140516)
2012,Mayo,Guatemala,1,8,,9,POINT (4815189 -75736374)
2012,Mayo,Guatemala,22,67,,89,POINT (6170465 -7542726)
2012,Mayo,Guatemala,0,2,,2,POINT (6185536 -67484028)
2012,Mayo,Guatemala,2,3,,5,POINT (7819 -72453013)
2012,Mayo,Guatemala,0,1,,1,POINT (7927233 -72508188)
2012,Mayo,Guyana,0,1,,1,POINT (0.81488 -77356)
2012,Mayo,Guyana,1,2,,3,POINT (10446304 -75516486)
2012,Mayo,Guyana,0,1,,1,POINT (10886686 -74776479)
2012,Mayo,Guyana,0,1,,1,POINT (3451668 -76532004)
2012,Mayo,Guyana,5,28,,33,POINT (4697157 -74140516)
2012,Mayo,Guyana,0,1,,1,POINT (6170465 -7542726)
2012,Mayo,Guinea,0,1,,1,POINT (6170465 -7542726)
2012,Mayo,Guinea Ecuatorial,1,0,,1,POINT (4697157 -74140516)
2012,Mayo,Guayana Francesa/Departamento de Ultramar Francés,0,1,,1,POINT (10406342 -75527794)
2012,Mayo,Guayana Francesa/Departamento de Ultramar Francés,0,2,,2,POINT (4697157 -74140516)
2012,Mayo,Haití,0,6,,6,POINT (10446304 -75516486)
2012,Mayo,Haití,1,0,,1,POINT (10886686 -74776479)
2012,Mayo,Haití,0,7,,7,POINT (4697157 -74140516)
2012,Mayo,Haití,0,2,,2,POINT (6170465 -7542726)
2012,Mayo,Honduras,0,1,,1,POINT (0.81488 -77356)
2012,Mayo,Honduras,0,3,,3,POINT (10406342 -75527794)
2012,Mayo,Honduras,10,19,,29,POINT (10446304 -75516486)
2012,Mayo,Honduras,4,10,,14,POINT (10886686 -74776479)
2012,Mayo,Honduras,0,7,,7,POINT (133387613 -81372937)
2012,Mayo,Honduras,7,9,,16,POINT (3451668 -76532004)
2012,Mayo,Honduras,109,160,,269,POINT (4697157 -74140516)
2012,Mayo,Honduras,1,0,,1,POINT (4815189 -75736374)
2012,Mayo,Honduras,10,33,,43,POINT (6170465 -7542726)
2012,Mayo,Honduras,0,1,,1,POINT (7128047 -73181317)
2012,Mayo,Honduras,1,0,,1,POINT (7819 -72453013)
2012,Mayo,Honduras,1,0,,1,POINT (7927233 -72508188)
2012,Mayo,Hong Kong,0,1,,1,POINT (4697157 -74140516)
2012,Mayo,Hungría,1,2,,3,POINT (0.81488 -77356)
2012,Mayo,Hungría,1,1,,2,POINT (10406342 -75527794)
2012,Mayo,Hungría,1,0,,1,POINT (10446304 -75516486)
2012,Mayo,Hungría,13,24,,37,POINT (4697157 -74140516)
2012,Mayo,Hungría,2,0,,2,POINT (6170465 -7542726)
2012,Mayo,Hungría,1,0,,1,POINT (7819 -72453013)
2012,Mayo,India,4,0,,4,POINT (0.81488 -77356)
2012,Mayo,India,0,1,,1,POINT (10406342 -75527794)
2012,Mayo,India,1,4,,5,POINT (10446304 -75516486)
2012,Mayo,India,0,1,,1,POINT (10886686 -74776479)
2012,Mayo,India,0,3,,3,POINT (125862 -81702165)
2012,Mayo,India,0,9,,9,POINT (3451668 -76532004)
2012,Mayo,India,47,256,,303,POINT (4697157 -74140516)
2012,Mayo,India,0,1,,1,POINT (4815189 -75736374)
2012,Mayo,India,5,24,,29,POINT (6170465 -7542726)
2012,Mayo,India,0,2,,2,POINT (7927233 -72508188)
2012,Mayo,Indonesia,1,1,,2,POINT (3451668 -76532004)
2012,Mayo,Indonesia,8,15,,23,POINT (4697157 -74140516)
2012,Mayo,Indonesia,1,0,,1,POINT (6170465 -7542726)
2012,Mayo,Iraq,0,1,,1,POINT (4697157 -74140516)
2012,Mayo,Irán,2,21,,23,POINT (4697157 -74140516)
2012,Mayo,Irán,1,0,,1,POINT (7927233 -72508188)
2012,Mayo,República de Irlanda,1,1,,2,POINT (-4191162 -69941498)
2012,Mayo,República de Irlanda,13,9,,22,POINT (0.81488 -77356)
2012,Mayo,República de Irlanda,2,8,,10,POINT (10446304 -75516486)
2012,Mayo,República de Irlanda,0,1,,1,POINT (11360029 -72129595)
2012,Mayo,República de Irlanda,1,6,,7,POINT (3451668 -76532004)
2012,Mayo,República de Irlanda,39,89,,128,POINT (4697157 -74140516)
2012,Mayo,República de Irlanda,2,11,,13,POINT (6170465 -7542726)
2012,Mayo,República de Irlanda,1,1,,2,POINT (7819 -72453013)
2012,Mayo,Islandia,3,0,,3,POINT (0.81488 -77356)
2012,Mayo,Islandia,5,5,,10,POINT (4697157 -74140516)
2012,Mayo,Islandia,0,1,,1,POINT (6170465 -7542726)
2012,Mayo,Isla de Man,22,32,,54,POINT (0.81488 -77356)
2012,Mayo,Isla de Man,0,1,,1,POINT (10406342 -75527794)
2012,Mayo,Isla de Man,3,6,,9,POINT (10446304 -75516486)
2012,Mayo,Isla de Man,2,2,,4,POINT (10886686 -74776479)
2012,Mayo,Isla de Man,0,3,,3,POINT (11360029 -72129595)
2012,Mayo,Isla de Man,5,13,,18,POINT (3451668 -76532004)
2012,Mayo,Isla de Man,1,1,,2,POINT (445285 -75766353)
2012,Mayo,Isla de Man,48,107,,155,POINT (4697157 -74140516)
2012,Mayo,Isla de Man,12,23,,35,POINT (6170465 -7542726)
2012,Mayo,Isla de Man,0,1,,1,POINT (7927233 -72508188)
2012,Mayo,Isla Johnston,0,2,,2,POINT (4697157 -74140516)
2012,Mayo,Israel,1,3,,4,POINT (-4191162 -69941498)
2012,Mayo,Israel,18,60,,78,POINT (0.81488 -77356)
2012,Mayo,Israel,0,1,,1,POINT (10406342 -75527794)
2012,Mayo,Israel,1,19,,20,POINT (10446304 -75516486)
2012,Mayo,Israel,0,3,,3,POINT (10886686 -74776479)
2012,Mayo,Israel,10,17,,27,POINT (3451668 -76532004)
2012,Mayo,Israel,124,594,,718,POINT (4697157 -74140516)
2012,Mayo,Israel,5,48,,53,POINT (6170465 -7542726)
2012,Mayo,Israel,0,4,,4,POINT (7927233 -72508188)
2012,Mayo,Israel,1,1,,2,POINT (863337 -7735002)
2012,Mayo,Italia,1,4,,5,POINT (-4191162 -69941498)
2012,Mayo,Italia,13,13,,26,POINT (0.81488 -77356)
2012,Mayo,Italia,0,1,,1,POINT (1800143 -78802679)
2012,Mayo,Italia,0,4,,4,POINT (10406342 -75527794)
2012,Mayo,Italia,29,30,,59,POINT (10446304 -75516486)
2012,Mayo,Italia,1,10,,11,POINT (10886686 -74776479)
2012,Mayo,Italia,1,4,,5,POINT (11360029 -72129595)
2012,Mayo,Italia,0,2,,2,POINT (125744111 -81703935)
2012,Mayo,Italia,5,5,,10,POINT (125862 -81702165)
2012,Mayo,Italia,19,49,,68,POINT (3451668 -76532004)
2012,Mayo,Italia,333,1305,,1638,POINT (4697157 -74140516)
2012,Mayo,Italia,25,60,,85,POINT (6170465 -7542726)
2012,Mayo,Italia,0,1,,1,POINT (7128047 -73181317)
2012,Mayo,Italia,6,24,,30,POINT (7819 -72453013)
2012,Mayo,Italia,1,2,,3,POINT (7927233 -72508188)
2012,Mayo,Italia,1,5,,6,POINT (863337 -7735002)
2012,Mayo,Jamaica,2,1,,3,POINT (10446304 -75516486)
2012,Mayo,Jamaica,0,1,,1,POINT (10886686 -74776479)
2012,Mayo,Jamaica,1,2,,3,POINT (3451668 -76532004)
2012,Mayo,Jamaica,8,20,,28,POINT (4697157 -74140516)
2012,Mayo,Jamaica,0,9,,9,POINT (6170465 -7542726)
2012,Mayo,Japón,1,0,,1,POINT (-4191162 -69941498)
2012,Mayo,Japón,12,21,,33,POINT (0.81488 -77356)
2012,Mayo,Japón,1,2,,3,POINT (10406342 -75527794)
2012,Mayo,Japón,7,17,,24,POINT (10446304 -75516486)
2012,Mayo,Japón,1,3,,4,POINT (10886686 -74776479)
2012,Mayo,Japón,1,1,,2,POINT (11360029 -72129595)
2012,Mayo,Japón,6,23,,29,POINT (3451668 -76532004)
2012,Mayo,Japón,128,404,,532,POINT (4697157 -74140516)
2012,Mayo,Japón,3,24,,27,POINT (6170465 -7542726)
2012,Mayo,Japón,4,3,,7,POINT (7819 -72453013)
2012,Mayo,Jordania,2,0,,2,POINT (10446304 -75516486)
2012,Mayo,Jordania,1,6,,7,POINT (4697157 -74140516)
2012,Mayo,Jordania,0,1,,1,POINT (6170465 -7542726)
2012,Mayo,Kazajistán,1,1,,2,POINT (10446304 -75516486)
2012,Mayo,Kazajistán,4,2,,6,POINT (4697157 -74140516)
2012,Mayo,Kenia,1,0,,1,POINT (10886686 -74776479)
2012,Mayo,Kenia,1,2,,3,POINT (3451668 -76532004)
2012,Mayo,Kenia,2,6,,8,POINT (4697157 -74140516)
2012,Mayo,Kirguistán,1,0,,1,POINT (4697157 -74140516)
2012,Mayo,Kuwait,0,4,,4,POINT (4697157 -74140516)
2012,Mayo,Lesoto,1,0,,1,POINT (4697157 -74140516)
2012,Mayo,Letonia,0,1,,1,POINT (3451668 -76532004)
2012,Mayo,Letonia,0,1,,1,POINT (3884426 -77061029)
2012,Mayo,Letonia,3,5,,8,POINT (4697157 -74140516)
2012,Mayo,Letonia,1,0,,1,POINT (863337 -7735002)
2012,Mayo,Lituania,0,1,,1,POINT (10406342 -75527794)
2012,Mayo,Lituania,0,1,,1,POINT (3451668 -76532004)
2012,Mayo,Lituania,5,5,,10,POINT (4697157 -74140516)
2012,Mayo,Líbano,0,1,,1,POINT (0.81488 -77356)
2012,Mayo,Líbano,1,4,,5,POINT (10446304 -75516486)
2012,Mayo,Líbano,1,2,,3,POINT (10886686 -74776479)
2012,Mayo,Líbano,4,4,,8,POINT (11360029 -72129595)
2012,Mayo,Líbano,0,1,,1,POINT (3451668 -76532004)
2012,Mayo,Líbano,7,20,,27,POINT (4697157 -74140516)
2012,Mayo,Líbano,0,1,,1,POINT (7128047 -73181317)
2012,Mayo,Líbano,0,1,,1,POINT (7927233 -72508188)
2012,Mayo,Liechtenstein,0,2,,2,POINT (4697157 -74140516)
2012,Mayo,Luxemburgo,4,4,,8,POINT (4697157 -74140516)
2012,Mayo,Macedonia,1,1,,2,POINT (4697157 -74140516)
2012,Mayo,Malasia,0,1,,1,POINT (0.81488 -77356)
2012,Mayo,Malasia,1,3,,4,POINT (10446304 -75516486)
2012,Mayo,Malasia,0,1,,1,POINT (10886686 -74776479)
2012,Mayo,Malasia,1,1,,2,POINT (11360029 -72129595)
2012,Mayo,Malasia,8,20,,28,POINT (4697157 -74140516)
2012,Mayo,Malasia,2,2,,4,POINT (6170465 -7542726)
2012,Mayo,Malawi,1,0,,1,POINT (4697157 -74140516)
2012,Mayo,Malta,0,1,,1,POINT (0.81488 -77356)
2012,Mayo,Malta,1,1,,2,POINT (10446304 -75516486)
2012,Mayo,Malta,1,3,,4,POINT (4697157 -74140516)
2012,Mayo,Marruecos,2,5,,7,POINT (4697157 -74140516)
2012,Mayo,Mauricio,1,0,,1,POINT (4697157 -74140516)
2012,Mayo,Mauritania,0,1,,1,POINT (4697157 -74140516)
2012,Mayo,México,0,2,,2,POINT (-4191162 -69941498)
2012,Mayo,México,2,6,,8,POINT (0.81488 -77356)
2012,Mayo,México,1,8,,9,POINT (10406342 -75527794)
2012,Mayo,México,93,171,,264,POINT (10446304 -75516486)
2012,Mayo,México,13,22,,35,POINT (10886686 -74776479)
2012,Mayo,México,2,3,,5,POINT (11360029 -72129595)
2012,Mayo,México,0,2,,2,POINT (125744111 -81703935)
2012,Mayo,México,3,3,,6,POINT (125862 -81702165)
2012,Mayo,México,32,108,,140,POINT (3451668 -76532004)
2012,Mayo,México,1740,3919,,5659,POINT (4697157 -74140516)
2012,Mayo,México,3,10,,13,POINT (4815189 -75736374)
2012,Mayo,México,87,299,,386,POINT (6170465 -7542726)
2012,Mayo,México,3,3,,6,POINT (7128047 -73181317)
2012,Mayo,México,12,35,,47,POINT (7819 -72453013)
2012,Mayo,México,2,5,,7,POINT (7927233 -72508188)
2012,Mayo,México,0,3,,3,POINT (863337 -7735002)
2012,Mayo,República de Moldavia,0,1,,1,POINT (0.81488 -77356)
2012,Mayo,República de Moldavia,2,0,,2,POINT (4697157 -74140516)
2012,Mayo,Mónaco,0,1,,1,POINT (4697157 -74140516)
2012,Mayo,Mongolia,1,1,,2,POINT (4697157 -74140516)
2012,Mayo,Mozambique,0,3,,3,POINT (4697157 -74140516)
2012,Mayo,Myanmar,0,1,,1,POINT (10970933 -74765343)
2012,Mayo,Nepal,0,7,,7,POINT (4697157 -74140516)
2012,Mayo,Nepal,0,1,,1,POINT (6170465 -7542726)
2012,Mayo,Nicaragua,7,4,,11,POINT (10446304 -75516486)
2012,Mayo,Nicaragua,1,1,,2,POINT (10886686 -74776479)
2012,Mayo,Nicaragua,0,1,,1,POINT (125862 -81702165)
2012,Mayo,Nicaragua,3,6,,9,POINT (3451668 -76532004)
2012,Mayo,Nicaragua,56,43,,99,POINT (4697157 -74140516)
2012,Mayo,Nicaragua,8,15,,23,POINT (6170465 -7542726)
2012,Mayo,Nicaragua,1,0,,1,POINT (7128047 -73181317)
2012,Mayo,Nigeria,0,1,,1,POINT (0.81488 -77356)
2012,Mayo,Nigeria,1,3,,4,POINT (4697157 -74140516)
2012,Mayo,Níger,1,1,,2,POINT (4697157 -74140516)
2012,Mayo,Noruega,1,1,,2,POINT (-4191162 -69941498)
2012,Mayo,Noruega,9,5,,14,POINT (0.81488 -77356)
2012,Mayo,Noruega,7,3,,10,POINT (10406342 -75527794)
2012,Mayo,Noruega,0,1,,1,POINT (10446304 -75516486)
2012,Mayo,Noruega,0,1,,1,POINT (10886686 -74776479)
2012,Mayo,Noruega,0,1,,1,POINT (11360029 -72129595)
2012,Mayo,Noruega,1,3,,4,POINT (3451668 -76532004)
2012,Mayo,Noruega,34,67,,101,POINT (4697157 -74140516)
2012,Mayo,Noruega,2,3,,5,POINT (6170465 -7542726)
2012,Mayo,Noruega,0,1,,1,POINT (7128047 -73181317)
2012,Mayo,Noruega,1,0,,1,POINT (863337 -7735002)
2012,Mayo,Nueva Zelanda,4,2,,6,POINT (-4191162 -69941498)
2012,Mayo,Nueva Zelanda,9,20,,29,POINT (0.81488 -77356)
2012,Mayo,Nueva Zelanda,0,1,,1,POINT (10406342 -75527794)
2012,Mayo,Nueva Zelanda,1,5,,6,POINT (10446304 -75516486)
2012,Mayo,Nueva Zelanda,1,0,,1,POINT (10886686 -74776479)
2012,Mayo,Nueva Zelanda,2,1,,3,POINT (11360029 -72129595)
2012,Mayo,Nueva Zelanda,2,0,,2,POINT (3451668 -76532004)
2012,Mayo,Nueva Zelanda,32,61,,93,POINT (4697157 -74140516)
2012,Mayo,Nueva Zelanda,3,11,,14,POINT (6170465 -7542726)
2012,Mayo,Omán,1,1,,2,POINT (4697157 -74140516)
2012,Mayo,Nueva Zelanda,0,1,,1,POINT (0.81488 -77356)
2012,Mayo,Nueva Zelanda,1,1,,2,POINT (10406342 -75527794)
2012,Mayo,Nueva Zelanda,0,1,,1,POINT (10886686 -74776479)
2012,Mayo,Nueva Zelanda,3,6,,9,POINT (4697157 -74140516)
2012,Mayo,Países Bajos,1,0,,1,POINT (-4191162 -69941498)
2012,Mayo,Países Bajos,7,18,,25,POINT (0.81488 -77356)
2012,Mayo,Países Bajos,2,10,,12,POINT (10446304 -75516486)
2012,Mayo,Países Bajos,4,6,,10,POINT (10886686 -74776479)
2012,Mayo,Países Bajos,1,5,,6,POINT (11360029 -72129595)
2012,Mayo,Países Bajos,25,31,,56,POINT (1152863 -72919186)
2012,Mayo,Países Bajos,38,20,,58,POINT (3451668 -76532004)
2012,Mayo,Países Bajos,120,208,,328,POINT (4697157 -74140516)
2012,Mayo,Países Bajos,116,169,,285,POINT (6170465 -7542726)
2012,Mayo,Países Bajos,1,2,,3,POINT (7128047 -73181317)
2012,Mayo,Pakistán,0,5,,5,POINT (3451668 -76532004)
2012,Mayo,Pakistán,1,10,,11,POINT (4697157 -74140516)
2012,Mayo,Pakistán,0,2,,2,POINT (6170465 -7542726)
2012,Mayo,Panamá,1,0,,1,POINT (0.81488 -77356)
2012,Mayo,Panamá,1,19,,20,POINT (10406342 -75527794)
2012,Mayo,Panamá,84,144,,228,POINT (10446304 -75516486)
2012,Mayo,Panamá,37,87,,124,POINT (10886686 -74776479)
2012,Mayo,Panamá,0,4,,4,POINT (11360029 -72129595)
2012,Mayo,Panamá,1,1,,2,POINT (125744111 -81703935)
2012,Mayo,Panamá,22,25,,47,POINT (125862 -81702165)
2012,Mayo,Panamá,52,110,,162,POINT (3451668 -76532004)
2012,Mayo,Panamá,0,1,,1,POINT (445285 -75766353)
2012,Mayo,Panamá,389,719,,1108,POINT (4697157 -74140516)
2012,Mayo,Panamá,49,63,,112,POINT (4815189 -75736374)
2012,Mayo,Panamá,80,202,,282,POINT (6170465 -7542726)
2012,Mayo,Panamá,3,0,,3,POINT (6222552 -77401154)
2012,Mayo,Panamá,2,11,,13,POINT (7128047 -73181317)
2012,Mayo,Panamá,4,3,,7,POINT (7819 -72453013)
2012,Mayo,Panamá,3,13,,16,POINT (7927233 -72508188)
2012,Mayo,Panamá,7,4,,11,POINT (863337 -7735002)
2012,Mayo,Paraguay,0,1,,1,POINT (0.81488 -77356)
2012,Mayo,Paraguay,5,7,,12,POINT (10446304 -75516486)
2012,Mayo,Paraguay,1,1,,2,POINT (125862 -81702165)
2012,Mayo,Paraguay,0,5,,5,POINT (3451668 -76532004)
2012,Mayo,Paraguay,61,65,,126,POINT (4697157 -74140516)
2012,Mayo,Paraguay,5,11,,16,POINT (6170465 -7542726)
2012,Mayo,Paraguay,0,1,,1,POINT (7819 -72453013)
2012,Mayo,Paraguay,0,2,,2,POINT (7927233 -72508188)
2012,Mayo,Perú,23,21,,44,POINT (-4191162 -69941498)
2012,Mayo,Perú,0,5,,5,POINT (0.33002 -76876446)
2012,Mayo,Perú,129,285,,414,POINT (0.81488 -77356)
2012,Mayo,Perú,0,3,,3,POINT (10406342 -75527794)
2012,Mayo,Perú,79,75,,154,POINT (10446304 -75516486)
2012,Mayo,Perú,5,15,,20,POINT (10886686 -74776479)
2012,Mayo,Perú,0,1,,1,POINT (10970933 -74765343)
2012,Mayo,Perú,0,3,,3,POINT (11360029 -72129595)
2012,Mayo,Perú,177,121,,298,POINT (125862 -81702165)
2012,Mayo,Perú,45,114,,159,POINT (3451668 -76532004)
2012,Mayo,Perú,0,1,,1,POINT (445285 -75766353)
2012,Mayo,Perú,2532,3191,,5723,POINT (4697157 -74140516)
2012,Mayo,Perú,1,1,,2,POINT (4815189 -75736374)
2012,Mayo,Perú,119,251,,370,POINT (6170465 -7542726)
2012,Mayo,Perú,2,2,,4,POINT (7128047 -73181317)
2012,Mayo,Perú,26,59,,85,POINT (7819 -72453013)
2012,Mayo,Perú,0,3,,3,POINT (7927233 -72508188)
2012,Mayo,Perú,1,2,,3,POINT (863337 -7735002)
2012,Mayo,Polonia,1,0,,1,POINT (-4191162 -69941498)
2012,Mayo,Polonia,4,3,,7,POINT (0.81488 -77356)
2012,Mayo,Polonia,3,8,,11,POINT (10406342 -75527794)
2012,Mayo,Polonia,0,4,,4,POINT (10446304 -75516486)
2012,Mayo,Polonia,3,1,,4,POINT (10886686 -74776479)
2012,Mayo,Polonia,0,1,,1,POINT (11247723 -74213989)
2012,Mayo,Polonia,0,2,,2,POINT (11360029 -72129595)
2012,Mayo,Polonia,3,0,,3,POINT (3451668 -76532004)
2012,Mayo,Polonia,38,54,,92,POINT (4697157 -74140516)
2012,Mayo,Polonia,0,1,,1,POINT (6170465 -7542726)
2012,Mayo,Polonia,0,5,,5,POINT (7819 -72453013)
2012,Mayo,Polonia,0,1,,1,POINT (9402597 -75681642)
2012,Mayo,Portugal,0,3,,3,POINT (0.33002 -76876446)
2012,Mayo,Portugal,3,3,,6,POINT (0.81488 -77356)
2012,Mayo,Portugal,2,3,,5,POINT (10446304 -75516486)
2012,Mayo,Portugal,0,1,,1,POINT (10886686 -74776479)
2012,Mayo,Portugal,1,0,,1,POINT (125862 -81702165)
2012,Mayo,Portugal,1,6,,7,POINT (3451668 -76532004)
2012,Mayo,Portugal,63,303,,366,POINT (4697157 -74140516)
2012,Mayo,Portugal,4,15,,19,POINT (6170465 -7542726)
2012,Mayo,Portugal,0,1,,1,POINT (7819 -72453013)
2012,Mayo,Portugal,0,1,,1,POINT (863337 -7735002)
2012,Mayo,Puerto Rico/Territorio de Estados Unidos,1,0,,1,POINT (10446304 -75516486)
2012,Mayo,Puerto Rico/Territorio de Estados Unidos,0,1,,1,POINT (4697157 -74140516)
2012,Mayo,Puerto Rico/Territorio de Estados Unidos,1,0,,1,POINT (6170465 -7542726)
2012,Mayo,Qatar,1,1,,2,POINT (6170465 -7542726)
2012,Mayo,Reino Unido de Gran Bretaña e Irlanda del Norte,5,6,,11,POINT (-4191162 -69941498)
2012,Mayo,Reino Unido de Gran Bretaña e Irlanda del Norte,14,15,,29,POINT (0.81488 -77356)
2012,Mayo,Reino Unido de Gran Bretaña e Irlanda del Norte,3,19,,22,POINT (10446304 -75516486)
2012,Mayo,Reino Unido de Gran Bretaña e Irlanda del Norte,1,6,,7,POINT (11360029 -72129595)
2012,Mayo,Reino Unido de Gran Bretaña e Irlanda del Norte,5,12,,17,POINT (3451668 -76532004)
2012,Mayo,Reino Unido de Gran Bretaña e Irlanda del Norte,159,476,,635,POINT (4697157 -74140516)
2012,Mayo,Reino Unido de Gran Bretaña e Irlanda del Norte,6,31,,37,POINT (6170465 -7542726)
2012,Mayo,Reino Unido de Gran Bretaña e Irlanda del Norte,2,2,,4,POINT (7819 -72453013)
2012,Mayo,Reino Unido de Gran Bretaña e Irlanda del Norte,0,1,,1,POINT (7927233 -72508188)
2012,Mayo,Reino Unido de Gran Bretaña e Irlanda del Norte,0,1,,1,POINT (863337 -7735002)
2012,Mayo,República Dominicana,2,6,,8,POINT (0.81488 -77356)
2012,Mayo,República Dominicana,27,34,,61,POINT (10446304 -75516486)
2012,Mayo,República Dominicana,9,29,,38,POINT (10886686 -74776479)
2012,Mayo,República Dominicana,0,1,,1,POINT (11360029 -72129595)
2012,Mayo,República Dominicana,17,22,,39,POINT (3451668 -76532004)
2012,Mayo,República Dominicana,202,283,,485,POINT (4697157 -74140516)
2012,Mayo,República Dominicana,0,4,,4,POINT (4815189 -75736374)
2012,Mayo,República Dominicana,29,72,,101,POINT (6170465 -7542726)
2012,Mayo,República Dominicana,3,2,,5,POINT (7128047 -73181317)
2012,Mayo,República Dominicana,4,0,,4,POINT (7819 -72453013)
2012,Mayo,República Dominicana,4,6,,10,POINT (7927233 -72508188)
2012,Mayo,República Checa,1,7,,8,POINT (4697157 -74140516)
2012,Mayo,Rumania,1,3,,4,POINT (0.81488 -77356)
2012,Mayo,Rumania,1,2,,3,POINT (10406342 -75527794)
2012,Mayo,Rumania,2,2,,4,POINT (10446304 -75516486)
2012,Mayo,Rumania,0,1,,1,POINT (10886686 -74776479)
2012,Mayo,Rumania,1,1,,2,POINT (11360029 -72129595)
2012,Mayo,Rumania,6,1,,7,POINT (3451668 -76532004)
2012,Mayo,Rumania,43,58,,101,POINT (4697157 -74140516)
2012,Mayo,Rumania,2,3,,5,POINT (6170465 -7542726)
2012,Mayo,Rumania,0,1,,1,POINT (7819 -72453013)
2012,Mayo,Rumania,0,1,,1,POINT (863337 -7735002)
2012,Mayo,Federación de Rusia,7,4,,11,POINT (0.81488 -77356)
2012,Mayo,Federación de Rusia,0,1,,1,POINT (10406342 -75527794)
2012,Mayo,Federación de Rusia,2,2,,4,POINT (10446304 -75516486)
2012,Mayo,Federación de Rusia,2,5,,7,POINT (11360029 -72129595)
2012,Mayo,Federación de Rusia,0,1,,1,POINT (3451668 -76532004)
2012,Mayo,Federación de Rusia,25,50,,75,POINT (4697157 -74140516)
2012,Mayo,Federación de Rusia,2,0,,2,POINT (6170465 -7542726)
2012,Mayo,Federación de Rusia,1,0,,1,POINT (7128047 -73181317)
2012,Mayo,San Cristóbal y Nevis,0,3,,3,POINT (4697157 -74140516)
2012,Mayo,San  Vicente y las Granadinas,0,1,,1,POINT (10446304 -75516486)
2012,Mayo,San  Vicente y las Granadinas,0,1,,1,POINT (125744111 -81703935)
2012,Mayo,San  Vicente y las Granadinas,1,0,,1,POINT (6170465 -7542726)
2012,Mayo,Santa Lucia,3,0,,3,POINT (10446304 -75516486)
2012,Mayo,Santa Lucia,0,2,,2,POINT (4697157 -74140516)
2012,Mayo,Santa Lucia,2,0,,2,POINT (7128047 -73181317)
2012,Mayo,Santa Sede/Ciudad del Vaticano,0,1,,1,POINT (4697157 -74140516)
2012,Mayo,Senegal,1,2,,3,POINT (4697157 -74140516)
2012,Mayo,Serbia,1,2,,3,POINT (4697157 -74140516)
2012,Mayo,Sierra Leona,0,1,,1,POINT (6170465 -7542726)
2012,Mayo,Singapur,1,1,,2,POINT (0.81488 -77356)
2012,Mayo,Singapur,1,1,,2,POINT (10446304 -75516486)
2012,Mayo,Singapur,9,15,,24,POINT (4697157 -74140516)
2012,Mayo,Singapur,1,0,,1,POINT (863337 -7735002)
2012,Mayo,República Árabe Siria,1,0,,1,POINT (11360029 -72129595)
2012,Mayo,República Árabe Siria,3,0,,3,POINT (4697157 -74140516)
2012,Mayo,Sri Lanka,0,3,,3,POINT (4697157 -74140516)
2012,Mayo,Sudáfrica,7,5,,12,POINT (-4191162 -69941498)
2012,Mayo,Sudáfrica,3,3,,6,POINT (0.81488 -77356)
2012,Mayo,Sudáfrica,1,2,,3,POINT (10406342 -75527794)
2012,Mayo,Sudáfrica,3,2,,5,POINT (10446304 -75516486)
2012,Mayo,Sudáfrica,1,3,,4,POINT (10886686 -74776479)
2012,Mayo,Sudáfrica,0,2,,2,POINT (10970933 -74765343)
2012,Mayo,Sudáfrica,0,1,,1,POINT (125744111 -81703935)
2012,Mayo,Sudáfrica,0,1,,1,POINT (3451668 -76532004)
2012,Mayo,Sudáfrica,31,78,,109,POINT (4697157 -74140516)
2012,Mayo,Sudáfrica,0,1,,1,POINT (6170465 -7542726)
2012,Mayo,Sudáfrica,0,1,,1,POINT (7819 -72453013)
2012,Mayo,Sudáfrica,0,1,,1,POINT (7927233 -72508188)
2012,Mayo,Sudán,1,2,,3,POINT (4697157 -74140516)
2012,Mayo,Suecia,0,2,,2,POINT (-4191162 -69941498)
2012,Mayo,Suecia,23,23,,46,POINT (0.81488 -77356)
2012,Mayo,Suecia,4,8,,12,POINT (10406342 -75527794)
2012,Mayo,Suecia,1,1,,2,POINT (10446304 -75516486)
2012,Mayo,Suecia,2,3,,5,POINT (10886686 -74776479)
2012,Mayo,Suecia,2,0,,2,POINT (11360029 -72129595)
2012,Mayo,Suecia,4,5,,9,POINT (3451668 -76532004)
2012,Mayo,Suecia,102,162,,264,POINT (4697157 -74140516)
2012,Mayo,Suecia,8,22,,30,POINT (6170465 -7542726)
2012,Mayo,Suecia,1,3,,4,POINT (7819 -72453013)
2012,Mayo,Suiza,6,5,,11,POINT (-4191162 -69941498)
2012,Mayo,Suiza,33,29,,62,POINT (0.81488 -77356)
2012,Mayo,Suiza,6,11,,17,POINT (10406342 -75527794)
2012,Mayo,Suiza,5,18,,23,POINT (10446304 -75516486)
2012,Mayo,Suiza,2,4,,6,POINT (10886686 -74776479)
2012,Mayo,Suiza,3,2,,5,POINT (11360029 -72129595)
2012,Mayo,Suiza,1,1,,2,POINT (125744111 -81703935)
2012,Mayo,Suiza,1,0,,1,POINT (125862 -81702165)
2012,Mayo,Suiza,7,27,,34,POINT (3451668 -76532004)
2012,Mayo,Suiza,173,368,,541,POINT (4697157 -74140516)
2012,Mayo,Suiza,12,23,,35,POINT (6170465 -7542726)
2012,Mayo,Suiza,2,6,,8,POINT (7819 -72453013)
2012,Mayo,Suiza,0,2,,2,POINT (863337 -7735002)
2012,Mayo,Surinam,7,21,,28,POINT (4697157 -74140516)
2012,Mayo,Surinam,0,6,,6,POINT (6170465 -7542726)
2012,Mayo,Taiwán,1,0,,1,POINT (10446304 -75516486)
2012,Mayo,Taiwán,1,0,,1,POINT (3451668 -76532004)
2012,Mayo,Taiwán,1,4,,5,POINT (4697157 -74140516)
2012,Mayo,Taiwán,1,0,,1,POINT (4815189 -75736374)
2012,Mayo,Tailandia,1,0,,1,POINT (3451668 -76532004)
2012,Mayo,Tailandia,7,18,,25,POINT (4697157 -74140516)
2012,Mayo,Tailandia,0,2,,2,POINT (7927233 -72508188)
2012,Mayo,Tíbet/Región Autónoma de China,0,1,,1,POINT (4697157 -74140516)
2012,Mayo,Territorio Antártico Británico/Territorio Británico de Ultramar,0,1,,1,POINT (0.81488 -77356)
2012,Mayo,Territorio Antártico Británico/Territorio Británico de Ultramar,1,4,,5,POINT (4697157 -74140516)
2012,Mayo,Territorio Antártico Británico/Territorio Británico de Ultramar,0,1,,1,POINT (7819 -72453013)
2012,Mayo,Tanzania,1,1,,2,POINT (4697157 -74140516)
2012,Mayo,Togo,0,1,,1,POINT (10446304 -75516486)
2012,Mayo,Trinidad y Tobago,0,8,,8,POINT (10406342 -75527794)
2012,Mayo,Trinidad y Tobago,3,31,,34,POINT (10446304 -75516486)
2012,Mayo,Trinidad y Tobago,0,9,,9,POINT (10886686 -74776479)
2012,Mayo,Trinidad y Tobago,2,4,,6,POINT (3451668 -76532004)
2012,Mayo,Trinidad y Tobago,19,66,,85,POINT (4697157 -74140516)
2012,Mayo,Trinidad y Tobago,0,2,,2,POINT (6170465 -7542726)
2012,Mayo,Trinidad y Tobago,1,3,,4,POINT (7128047 -73181317)
2012,Mayo,Trinidad y Tobago,0,2,,2,POINT (7819 -72453013)
2012,Mayo,Túnez,0,1,,1,POINT (3451668 -76532004)
2012,Mayo,Túnez,3,3,,6,POINT (4697157 -74140516)
2012,Mayo,Turquía,1,4,,5,POINT (0.81488 -77356)
2012,Mayo,Turquía,2,1,,3,POINT (10446304 -75516486)
2012,Mayo,Turquía,1,5,,6,POINT (10886686 -74776479)
2012,Mayo,Turquía,19,68,,87,POINT (4697157 -74140516)
2012,Mayo,Turquía,0,4,,4,POINT (6170465 -7542726)
2012,Mayo,Turquía,0,1,,1,POINT (7819 -72453013)
2012,Mayo,Turkmenistán,1,0,,1,POINT (4697157 -74140516)
2012,Mayo,Ucrania,0,1,,1,POINT (10446304 -75516486)
2012,Mayo,Ucrania,0,1,,1,POINT (11247723 -74213989)
2012,Mayo,Ucrania,0,1,,1,POINT (3884426 -77061029)
2012,Mayo,Ucrania,11,17,,28,POINT (4697157 -74140516)
2012,Mayo,Ucrania,1,0,,1,POINT (6170465 -7542726)
2012,Mayo,Uganda,3,1,,4,POINT (4697157 -74140516)
2012,Mayo,Federación de Rusia,0,3,,3,POINT (-4191162 -69941498)
2012,Mayo,Federación de Rusia,1,4,,5,POINT (0.81488 -77356)
2012,Mayo,Federación de Rusia,0,4,,4,POINT (10406342 -75527794)
2012,Mayo,Federación de Rusia,1,2,,3,POINT (10446304 -75516486)
2012,Mayo,Federación de Rusia,0,2,,2,POINT (10970933 -74765343)
2012,Mayo,Federación de Rusia,1,2,,3,POINT (11247723 -74213989)
2012,Mayo,Federación de Rusia,2,3,,5,POINT (11360029 -72129595)
2012,Mayo,Federación de Rusia,1,0,,1,POINT (3451668 -76532004)
2012,Mayo,Federación de Rusia,0,1,,1,POINT (3884426 -77061029)
2012,Mayo,Federación de Rusia,65,92,,157,POINT (4697157 -74140516)
2012,Mayo,Federación de Rusia,1,1,,2,POINT (6170465 -7542726)
2012,Mayo,Federación de Rusia,4,1,,5,POINT (7819 -72453013)
2012,Mayo,Federación de Rusia,0,5,,5,POINT (9402597 -75681642)
2012,Mayo,Uruguay,1,0,,1,POINT (-4191162 -69941498)
2012,Mayo,Uruguay,2,8,,10,POINT (0.81488 -77356)
2012,Mayo,Uruguay,0,1,,1,POINT (10406342 -75527794)
2012,Mayo,Uruguay,112,66,,178,POINT (10446304 -75516486)
2012,Mayo,Uruguay,3,8,,11,POINT (10886686 -74776479)
2012,Mayo,Uruguay,71,40,,111,POINT (125862 -81702165)
2012,Mayo,Uruguay,3,7,,10,POINT (3451668 -76532004)
2012,Mayo,Uruguay,102,241,,343,POINT (4697157 -74140516)
2012,Mayo,Uruguay,0,3,,3,POINT (4815189 -75736374)
2012,Mayo,Uruguay,12,24,,36,POINT (6170465 -7542726)
2012,Mayo,Uruguay,0,1,,1,POINT (7128047 -73181317)
2012,Mayo,Uruguay,3,3,,6,POINT (7819 -72453013)
2012,Mayo,Venezuela,0,2,,2,POINT (-4191162 -69941498)
2012,Mayo,Venezuela,40,60,,100,POINT (0.81488 -77356)
2012,Mayo,Venezuela,3,12,,15,POINT (10406342 -75527794)
2012,Mayo,Venezuela,88,130,,218,POINT (10446304 -75516486)
2012,Mayo,Venezuela,56,92,,148,POINT (10886686 -74776479)
2012,Mayo,Venezuela,0,1,,1,POINT (10970933 -74765343)
2012,Mayo,Venezuela,0,2,,2,POINT (11247723 -74213989)
2012,Mayo,Venezuela,1008,1448,,2456,POINT (11360029 -72129595)
2012,Mayo,Venezuela,1,5,,6,POINT (1152863 -72919186)
2012,Mayo,Venezuela,11,9,,20,POINT (125862 -81702165)
2012,Mayo,Venezuela,52,78,,130,POINT (3451668 -76532004)
2012,Mayo,Venezuela,3812,5305,,9117,POINT (4697157 -74140516)
2012,Mayo,Venezuela,5,20,,25,POINT (4815189 -75736374)
2012,Mayo,Venezuela,320,415,,735,POINT (6170465 -7542726)
2012,Mayo,Venezuela,0,4,,4,POINT (6185536 -67484028)
2012,Mayo,Venezuela,30,68,,98,POINT (7088729 -70740253)
2012,Mayo,Venezuela,13,20,,33,POINT (7128047 -73181317)
2012,Mayo,Venezuela,851,1016,,1867,POINT (7819 -72453013)
2012,Mayo,Venezuela,175,197,,372,POINT (7927233 -72508188)
2012,Mayo,Venezuela,0,1,,1,POINT (863337 -7735002)
2012,Mayo,Vietnam,1,0,,1,POINT (10886686 -74776479)
2012,Mayo,Vietnam,2,9,,11,POINT (4697157 -74140516)
2012,Mayo,Vietnam,0,2,,2,POINT (7927233 -72508188)
2012,Mayo,Islas Vírgenes Británicas/Territorio Británico de Ultramar,0,1,,1,POINT (4697157 -74140516)
2012,Mayo,República Árabe de Yemen,0,1,,1,POINT (4697157 -74140516)
2012,Mayo,Yugoslavia,1,1,,2,POINT (4697157 -74140516)
2012,Mayo,Zambia,2,1,,3,POINT (4697157 -74140516)
2012,Mayo,Zimbabue,0,2,,2,POINT (4697157 -74140516)
2012,Mayo,Reino Unido de Gran Bretaña e Irlanda del Norte,2,3,,5,POINT (-4191162 -69941498)
2012,Mayo,Reino Unido de Gran Bretaña e Irlanda del Norte,60,65,,125,POINT (0.81488 -77356)
2012,Mayo,Reino Unido de Gran Bretaña e Irlanda del Norte,14,32,,46,POINT (10406342 -75527794)
2012,Mayo,Reino Unido de Gran Bretaña e Irlanda del Norte,9,27,,36,POINT (10446304 -75516486)
2012,Mayo,Reino Unido de Gran Bretaña e Irlanda del Norte,1,6,,7,POINT (10886686 -74776479)
2012,Mayo,Reino Unido de Gran Bretaña e Irlanda del Norte,4,6,,10,POINT (11360029 -72129595)
2012,Mayo,Reino Unido de Gran Bretaña e Irlanda del Norte,0,1,,1,POINT (125862 -81702165)
2012,Mayo,Reino Unido de Gran Bretaña e Irlanda del Norte,0,3,,3,POINT (133387613 -81372937)
2012,Mayo,Reino Unido de Gran Bretaña e Irlanda del Norte,8,9,,17,POINT (3451668 -76532004)
2012,Mayo,Reino Unido de Gran Bretaña e Irlanda del Norte,187,514,,701,POINT (4697157 -74140516)
2012,Mayo,Reino Unido de Gran Bretaña e Irlanda del Norte,10,19,,29,POINT (6170465 -7542726)
2012,Mayo,Reino Unido de Gran Bretaña e Irlanda del Norte,2,5,,7,POINT (7819 -72453013)
2012,Mayo,Reino Unido de Gran Bretaña e Irlanda del Norte,0,1,,1,POINT (7927233 -72508188)
2012,Mayo,Reino Unido de Gran Bretaña e Irlanda del Norte,3,2,,5,POINT (863337 -7735002)
2012,Mayo,Países Bajos,3,3,,6,POINT (-4191162 -69941498)
2012,Mayo,Países Bajos,15,15,,30,POINT (0.81488 -77356)
2012,Mayo,Países Bajos,10,10,,20,POINT (10406342 -75527794)
2012,Mayo,Países Bajos,5,31,,36,POINT (10446304 -75516486)
2012,Mayo,Países Bajos,1,4,,5,POINT (10886686 -74776479)
2012,Mayo,Países Bajos,2,0,,2,POINT (11247723 -74213989)
2012,Mayo,Países Bajos,1,1,,2,POINT (11360029 -72129595)
2012,Mayo,Países Bajos,0,3,,3,POINT (125862 -81702165)
2012,Mayo,Países Bajos,0,1,,1,POINT (133387613 -81372937)
2012,Mayo,Países Bajos,10,33,,43,POINT (3451668 -76532004)
2012,Mayo,Países Bajos,316,616,,932,POINT (4697157 -74140516)
2012,Mayo,Países Bajos,1,1,,2,POINT (4815189 -75736374)
2012,Mayo,Países Bajos,32,52,,84,POINT (6170465 -7542726)
2012,Mayo,Países Bajos,0,1,,1,POINT (6185536 -67484028)
2012,Mayo,Países Bajos,0,1,,1,POINT (6222552 -77401154)
2012,Mayo,Países Bajos,0,5,,5,POINT (7128047 -73181317)
2012,Mayo,Países Bajos,5,10,,15,POINT (7819 -72453013)
2012,Mayo,Países Bajos,1,1,,2,POINT (7927233 -72508188)
2012,Mayo,Países Bajos,5,2,,7,POINT (863337 -7735002)
2012,Mayo,Desconocido,0,1,,1,POINT (10446304 -75516486)
2012,Mayo,Eslovenia,1,1,,2,POINT (10446304 -75516486)
2012,Mayo,Eslovenia,1,0,,1,POINT (4697157 -74140516)
2012,Mayo,Lituania,0,1,,1,POINT (10970933 -74765343)
2012,Mayo,Lituania,1,1,,2,POINT (3451668 -76532004)
2012,Mayo,Lituania,3,1,,4,POINT (4697157 -74140516)
2012,Mayo,Reino Unido de Gran Bretaña e Irlanda del Norte,0,2,,2,POINT (11247723 -74213989)
2012,Mayo,Reino Unido de Gran Bretaña e Irlanda del Norte,1,0,,1,POINT (3451668 -76532004)
2012,Mayo,Reino Unido de Gran Bretaña e Irlanda del Norte,1,0,,1,POINT (3451668 -76532004)
2012,Mayo,Reino Unido de Gran Bretaña e Irlanda del Norte,3,2,,5,POINT (4697157 -74140516)
2012,Mayo,Reino Unido de Gran Bretaña e Irlanda del Norte,1,0,,1,POINT (0.33002 -76876446)
2012,Mayo,Reino Unido de Gran Bretaña e Irlanda del Norte,1,0,,1,POINT (0.81488 -77356)
2012,Mayo,Reino Unido de Gran Bretaña e Irlanda del Norte,2,8,,10,POINT (10406342 -75527794)
2012,Mayo,Reino Unido de Gran Bretaña e Irlanda del Norte,0,2,,2,POINT (10446304 -75516486)
2012,Mayo,Reino Unido de Gran Bretaña e Irlanda del Norte,1,1,,2,POINT (11360029 -72129595)
2012,Mayo,Reino Unido de Gran Bretaña e Irlanda del Norte,0,1,,1,POINT (3451668 -76532004)
2012,Mayo,Reino Unido de Gran Bretaña e Irlanda del Norte,2,16,,18,POINT (4697157 -74140516)
2012,Mayo,Reino Unido de Gran Bretaña e Irlanda del Norte,0,2,,2,POINT (6170465 -7542726)
2012,Mayo,Reino Unido de Gran Bretaña e Irlanda del Norte,0,1,,1,POINT (7819 -72453013)
2012,Mayo,Letonia,0,1,,1,POINT (3884426 -77061029)
2012,Junio,Albania,2,1,,3,POINT (4697157 -74140516)
2012,Junio,Alemania,7,7,,14,POINT (-4191162 -69941498)
2012,Junio,Alemania,2,0,,2,POINT (0.33002 -76876446)
2012,Junio,Alemania,55,54,,109,POINT (0.81488 -77356)
2012,Junio,Alemania,23,39,,62,POINT (10406342 -75527794)
2012,Junio,Alemania,20,32,,52,POINT (10446304 -75516486)
2012,Junio,Alemania,2,10,,12,POINT (10886686 -74776479)
2012,Junio,Alemania,0,1,,1,POINT (10970933 -74765343)
2012,Junio,Alemania,0,1,,1,POINT (11247723 -74213989)
2012,Junio,Alemania,3,13,,16,POINT (11360029 -72129595)
2012,Junio,Alemania,1,1,,2,POINT (125862 -81702165)
2012,Junio,Alemania,22,45,,67,POINT (3451668 -76532004)
2012,Junio,Alemania,2,6,,8,POINT (3884426 -77061029)
2012,Junio,Alemania,919,1411,,2330,POINT (4697157 -74140516)
2012,Junio,Alemania,5,2,,7,POINT (4815189 -75736374)
2012,Junio,Alemania,25,69,,94,POINT (6170465 -7542726)
2012,Junio,Alemania,1,0,,1,POINT (6185536 -67484028)
2012,Junio,Alemania,1,2,,3,POINT (7128047 -73181317)
2012,Junio,Alemania,1,15,,16,POINT (7819 -72453013)
2012,Junio,Alemania,0,1,,1,POINT (7927233 -72508188)
2012,Junio,Alemania,0,1,,1,POINT (863337 -7735002)
2012,Junio,Andorra,0,11,,11,POINT (4697157 -74140516)
2012,Junio,Andorra,0,1,,1,POINT (6170465 -7542726)
2012,Junio,Angola,1,3,,4,POINT (4697157 -74140516)
2012,Junio,Antigua y Barbuda,0,3,,3,POINT (4697157 -74140516)
2012,Junio,Países Bajos,1,0,,1,POINT (4697157 -74140516)
2012,Junio,Países Bajos,0,1,,1,POINT (6170465 -7542726)
2012,Junio,Arabia Saudita,0,3,,3,POINT (4697157 -74140516)
2012,Junio,Arabia Saudita,0,1,,1,POINT (10446304 -75516486)
2012,Junio,Arabia Saudita,0,10,,10,POINT (4697157 -74140516)
2012,Junio,Arabia Saudita,0,1,,1,POINT (6170465 -7542726)
2012,Junio,Argelia,1,6,,7,POINT (4697157 -74140516)
2012,Junio,Argentina,2,7,,9,POINT (-4191162 -69941498)
2012,Junio,Argentina,48,113,,161,POINT (0.81488 -77356)
2012,Junio,Argentina,1,5,,6,POINT (10406342 -75527794)
2012,Junio,Argentina,551,390,,941,POINT (10446304 -75516486)
2012,Junio,Argentina,12,25,,37,POINT (10886686 -74776479)
2012,Junio,Argentina,13,22,,35,POINT (11360029 -72129595)
2012,Junio,Argentina,211,166,,377,POINT (125862 -81702165)
2012,Junio,Argentina,33,68,,101,POINT (3451668 -76532004)
2012,Junio,Argentina,2091,3495,,5586,POINT (4697157 -74140516)
2012,Junio,Argentina,1,5,,6,POINT (4815189 -75736374)
2012,Junio,Argentina,87,157,,244,POINT (6170465 -7542726)
2012,Junio,Argentina,3,3,,6,POINT (7128047 -73181317)
2012,Junio,Argentina,12,32,,44,POINT (7819 -72453013)
2012,Junio,Argentina,0,7,,7,POINT (7927233 -72508188)
2012,Junio,Argentina,0,1,,1,POINT (863337 -7735002)
2012,Junio,República de Armenia,0,1,,1,POINT (4697157 -74140516)
2012,Junio,Aruba,0,1,,1,POINT (11360029 -72129595)
2012,Junio,Aruba,0,1,,1,POINT (3451668 -76532004)
2012,Junio,Aruba,4,1,,5,POINT (4697157 -74140516)
2012,Junio,Australia,9,6,,15,POINT (-4191162 -69941498)
2012,Junio,Australia,1,0,,1,POINT (0.33002 -76876446)
2012,Junio,Australia,42,48,,90,POINT (0.81488 -77356)
2012,Junio,Australia,19,30,,49,POINT (10406342 -75527794)
2012,Junio,Australia,12,20,,32,POINT (10446304 -75516486)
2012,Junio,Australia,3,8,,11,POINT (10886686 -74776479)
2012,Junio,Australia,2,2,,4,POINT (11247723 -74213989)
2012,Junio,Australia,4,3,,7,POINT (11360029 -72129595)
2012,Junio,Australia,3,10,,13,POINT (3451668 -76532004)
2012,Junio,Australia,0,1,,1,POINT (445285 -75766353)
2012,Junio,Australia,207,353,,560,POINT (4697157 -74140516)
2012,Junio,Australia,0,1,,1,POINT (4815189 -75736374)
2012,Junio,Australia,16,46,,62,POINT (6170465 -7542726)
2012,Junio,Australia,0,1,,1,POINT (7128047 -73181317)
2012,Junio,Australia,1,5,,6,POINT (7819 -72453013)
2012,Junio,Australia,1,1,,2,POINT (863337 -7735002)
2012,Junio,Austria,0,1,,1,POINT (-4191162 -69941498)
2012,Junio,Austria,13,10,,23,POINT (0.81488 -77356)
2012,Junio,Austria,4,3,,7,POINT (10406342 -75527794)
2012,Junio,Austria,4,3,,7,POINT (10446304 -75516486)
2012,Junio,Austria,0,3,,3,POINT (10886686 -74776479)
2012,Junio,Austria,1,0,,1,POINT (11360029 -72129595)
2012,Junio,Austria,1,1,,2,POINT (125862 -81702165)
2012,Junio,Austria,7,8,,15,POINT (3451668 -76532004)
2012,Junio,Austria,76,138,,214,POINT (4697157 -74140516)
2012,Junio,Austria,2,6,,8,POINT (6170465 -7542726)
2012,Junio,Austria,1,0,,1,POINT (7819 -72453013)
2012,Junio,Azerbaiyán,0,1,,1,POINT (10446304 -75516486)
2012,Junio,Azerbaiyán,0,2,,2,POINT (4697157 -74140516)
2012,Junio,Bahamas,1,1,,2,POINT (10446304 -75516486)
2012,Junio,Bahamas,0,1,,1,POINT (3451668 -76532004)
2012,Junio,Bahamas,5,11,,16,POINT (4697157 -74140516)
2012,Junio,Bahamas,0,1,,1,POINT (4815189 -75736374)
2012,Junio,Bahamas,0,2,,2,POINT (6170465 -7542726)
2012,Junio,Bangladesh,0,2,,2,POINT (4697157 -74140516)
2012,Junio,Bangladesh,0,1,,1,POINT (6170465 -7542726)
2012,Junio,Barbados,1,0,,1,POINT (10446304 -75516486)
2012,Junio,Barbados,1,6,,7,POINT (4697157 -74140516)
2012,Junio,República de Belarús,2,1,,3,POINT (4697157 -74140516)
2012,Junio,Bélgica,0,5,,5,POINT (-4191162 -69941498)
2012,Junio,Bélgica,7,15,,22,POINT (0.81488 -77356)
2012,Junio,Bélgica,1,4,,5,POINT (10406342 -75527794)
2012,Junio,Bélgica,3,5,,8,POINT (10446304 -75516486)
2012,Junio,Bélgica,1,2,,3,POINT (10886686 -74776479)
2012,Junio,Bélgica,0,26,,26,POINT (11247723 -74213989)
2012,Junio,Bélgica,0,2,,2,POINT (11360029 -72129595)
2012,Junio,Bélgica,7,15,,22,POINT (3451668 -76532004)
2012,Junio,Bélgica,159,293,,452,POINT (4697157 -74140516)
2012,Junio,Bélgica,0,1,,1,POINT (4815189 -75736374)
2012,Junio,Bélgica,10,27,,37,POINT (6170465 -7542726)
2012,Junio,Belice,0,1,,1,POINT (10446304 -75516486)
2012,Junio,Belice,0,1,,1,POINT (10886686 -74776479)
2012,Junio,Belice,1,0,,1,POINT (11360029 -72129595)
2012,Junio,Belice,3,21,,24,POINT (4697157 -74140516)
2012,Junio,Benín,1,0,,1,POINT (4697157 -74140516)
2012,Junio,Bermudas/Territorio Británico de Ultramar,0,1,,1,POINT (3451668 -76532004)
2012,Junio,Bermudas/Territorio Británico de Ultramar,1,0,,1,POINT (4697157 -74140516)
2012,Junio,Bolivia,1,0,,1,POINT (-4191162 -69941498)
2012,Junio,Bolivia,0,1,,1,POINT (0.33002 -76876446)
2012,Junio,Bolivia,7,11,,18,POINT (0.81488 -77356)
2012,Junio,Bolivia,5,6,,11,POINT (10446304 -75516486)
2012,Junio,Bolivia,3,1,,4,POINT (10886686 -74776479)
2012,Junio,Bolivia,0,1,,1,POINT (125862 -81702165)
2012,Junio,Bolivia,5,5,,10,POINT (3451668 -76532004)
2012,Junio,Bolivia,281,396,,677,POINT (4697157 -74140516)
2012,Junio,Bolivia,3,4,,7,POINT (4815189 -75736374)
2012,Junio,Bolivia,5,17,,22,POINT (6170465 -7542726)
2012,Junio,Bolivia,1,0,,1,POINT (7128047 -73181317)
2012,Junio,Bolivia,0,4,,4,POINT (7819 -72453013)
2012,Junio,Bosnia y Herzegovina,1,2,,3,POINT (4697157 -74140516)
2012,Junio,Botsuana,0,1,,1,POINT (4697157 -74140516)
2012,Junio,Brasil,55,63,,118,POINT (-4191162 -69941498)
2012,Junio,Brasil,0,1,,1,POINT (0.33002 -76876446)
2012,Junio,Brasil,8,21,,29,POINT (0.81488 -77356)
2012,Junio,Brasil,2,4,,6,POINT (10406342 -75527794)
2012,Junio,Brasil,91,95,,186,POINT (10446304 -75516486)
2012,Junio,Brasil,6,29,,35,POINT (10886686 -74776479)
2012,Junio,Brasil,5,9,,14,POINT (11360029 -72129595)
2012,Junio,Brasil,11,11,,22,POINT (125862 -81702165)
2012,Junio,Brasil,0,1,,1,POINT (133387613 -81372937)
2012,Junio,Brasil,13,46,,59,POINT (3451668 -76532004)
2012,Junio,Brasil,1,0,,1,POINT (445285 -75766353)
2012,Junio,Brasil,2035,3489,,5524,POINT (4697157 -74140516)
2012,Junio,Brasil,2,3,,5,POINT (4815189 -75736374)
2012,Junio,Brasil,23,62,,85,POINT (6170465 -7542726)
2012,Junio,Brasil,1,3,,4,POINT (6185536 -67484028)
2012,Junio,Brasil,0,1,,1,POINT (7128047 -73181317)
2012,Junio,Brasil,6,10,,16,POINT (7819 -72453013)
2012,Junio,Brasil,0,1,,1,POINT (7927233 -72508188)
2012,Junio,Brasil,0,1,,1,POINT (863337 -7735002)
2012,Junio,Brunei Darussalam,1,0,,1,POINT (4697157 -74140516)
2012,Junio,Bulgaria,1,0,,1,POINT (3451668 -76532004)
2012,Junio,Bulgaria,6,8,,14,POINT (4697157 -74140516)
2012,Junio,Bulgaria,1,0,,1,POINT (6170465 -7542726)
2012,Junio,Burkina Faso,1,0,,1,POINT (3451668 -76532004)
2012,Junio,Burkina Faso,0,2,,2,POINT (4697157 -74140516)
2012,Junio,Burundi,0,1,,1,POINT (4697157 -74140516)
2012,Junio,Bután,0,3,,3,POINT (4697157 -74140516)
2012,Junio,Islas Caimán/Territorio Británico de Ultramar,2,2,,4,POINT (125744111 -81703935)
2012,Junio,Islas Caimán/Territorio Británico de Ultramar,4,7,,11,POINT (125862 -81702165)
2012,Junio,Islas Caimán/Territorio Británico de Ultramar,3,0,,3,POINT (3451668 -76532004)
2012,Junio,Islas Caimán/Territorio Británico de Ultramar,0,1,,1,POINT (4697157 -74140516)
2012,Junio,Camboya,0,2,,2,POINT (4697157 -74140516)
2012,Junio,Camerún,1,0,,1,POINT (10446304 -75516486)
2012,Junio,Camerún,1,4,,5,POINT (4697157 -74140516)
2012,Junio,Camerún,0,1,,1,POINT (6170465 -7542726)
2012,Junio,Canadá,17,15,,32,POINT (0.81488 -77356)
2012,Junio,Canadá,14,10,,24,POINT (10406342 -75527794)
2012,Junio,Canadá,20,68,,88,POINT (10446304 -75516486)
2012,Junio,Canadá,8,25,,33,POINT (10886686 -74776479)
2012,Junio,Canadá,0,1,,1,POINT (11247723 -74213989)
2012,Junio,Canadá,2,2,,4,POINT (11360029 -72129595)
2012,Junio,Canadá,1,2,,3,POINT (125862 -81702165)
2012,Junio,Canadá,1,0,,1,POINT (133387613 -81372937)
2012,Junio,Canadá,32,53,,85,POINT (3451668 -76532004)
2012,Junio,Canadá,3,1,,4,POINT (445285 -75766353)
2012,Junio,Canadá,589,1240,,1829,POINT (4697157 -74140516)
2012,Junio,Canadá,3,1,,4,POINT (4815189 -75736374)
2012,Junio,Canadá,74,136,,210,POINT (6170465 -7542726)
2012,Junio,Canadá,3,10,,13,POINT (7128047 -73181317)
2012,Junio,Canadá,2,5,,7,POINT (7819 -72453013)
2012,Junio,Canadá,2,6,,8,POINT (7927233 -72508188)
2012,Junio,Canadá,0,1,,1,POINT (863337 -7735002)
2012,Junio,Chad,0,1,,1,POINT (4697157 -74140516)
2012,Junio,España,4,5,,9,POINT (0.81488 -77356)
2012,Junio,España,3,16,,19,POINT (10446304 -75516486)
2012,Junio,España,7,13,,20,POINT (10886686 -74776479)
2012,Junio,España,2,0,,2,POINT (11360029 -72129595)
2012,Junio,España,1,0,,1,POINT (125862 -81702165)
2012,Junio,España,111,154,,265,POINT (3451668 -76532004)
2012,Junio,España,142,352,,494,POINT (4697157 -74140516)
2012,Junio,España,1,13,,14,POINT (4815189 -75736374)
2012,Junio,España,25,92,,117,POINT (6170465 -7542726)
2012,Junio,España,1,1,,2,POINT (7819 -72453013)
2012,Junio,España,1,2,,3,POINT (7927233 -72508188)
2012,Junio,República Democrática del Congo,2,5,,7,POINT (4697157 -74140516)
2012,Junio,República de Corea,9,11,,20,POINT (0.81488 -77356)
2012,Junio,República de Corea,3,10,,13,POINT (10446304 -75516486)
2012,Junio,República de Corea,1,2,,3,POINT (10886686 -74776479)
2012,Junio,República de Corea,0,1,,1,POINT (11360029 -72129595)
2012,Junio,República de Corea,9,22,,31,POINT (3451668 -76532004)
2012,Junio,República de Corea,0,2,,2,POINT (3884426 -77061029)
2012,Junio,República de Corea,169,698,,867,POINT (4697157 -74140516)
2012,Junio,República de Corea,0,3,,3,POINT (4815189 -75736374)
2012,Junio,República de Corea,2,9,,11,POINT (6170465 -7542726)
2012,Junio,República de Corea,0,1,,1,POINT (7819 -72453013)
2012,Junio,República de Corea,0,7,,7,POINT (9402597 -75681642)
2012,Junio,Costa de Marfil,0,2,,2,POINT (4697157 -74140516)
2012,Junio,Costa Rica,2,3,,5,POINT (0.81488 -77356)
2012,Junio,Costa Rica,50,68,,118,POINT (10446304 -75516486)
2012,Junio,Costa Rica,11,13,,24,POINT (10886686 -74776479)
2012,Junio,Costa Rica,1,0,,1,POINT (11360029 -72129595)
2012,Junio,Costa Rica,60,39,,99,POINT (125862 -81702165)
2012,Junio,Costa Rica,12,44,,56,POINT (3451668 -76532004)
2012,Junio,Costa Rica,390,674,,1064,POINT (4697157 -74140516)
2012,Junio,Costa Rica,3,8,,11,POINT (4815189 -75736374)
2012,Junio,Costa Rica,90,127,,217,POINT (6170465 -7542726)
2012,Junio,Costa Rica,1,4,,5,POINT (7128047 -73181317)
2012,Junio,Costa Rica,3,2,,5,POINT (7819 -72453013)
2012,Junio,Croacia,1,2,,3,POINT (10406342 -75527794)
2012,Junio,Croacia,0,1,,1,POINT (10446304 -75516486)
2012,Junio,Croacia,0,1,,1,POINT (10886686 -74776479)
2012,Junio,Croacia,0,12,,12,POINT (11247723 -74213989)
2012,Junio,Croacia,5,37,,42,POINT (4697157 -74140516)
2012,Junio,Cuba,0,1,,1,POINT (-4191162 -69941498)
2012,Junio,Cuba,1,2,,3,POINT (0.81488 -77356)
2012,Junio,Cuba,1,1,,2,POINT (10406342 -75527794)
2012,Junio,Cuba,5,9,,14,POINT (10446304 -75516486)
2012,Junio,Cuba,4,12,,16,POINT (10886686 -74776479)
2012,Junio,Cuba,1,0,,1,POINT (11360029 -72129595)
2012,Junio,Cuba,12,18,,30,POINT (3451668 -76532004)
2012,Junio,Cuba,66,133,,199,POINT (4697157 -74140516)
2012,Junio,Cuba,0,1,,1,POINT (4815189 -75736374)
2012,Junio,Cuba,12,15,,27,POINT (6170465 -7542726)
2012,Junio,Cuba,2,1,,3,POINT (7128047 -73181317)
2012,Junio,Cuba,0,2,,2,POINT (7819 -72453013)
2012,Junio,Cuba,0,2,,2,POINT (7927233 -72508188)
2012,Junio,Curazao,4,0,,4,POINT (4697157 -74140516)
2012,Junio,Curazao,2,1,,3,POINT (6170465 -7542726)
2012,Junio,República Checa,3,3,,6,POINT (0.81488 -77356)
2012,Junio,República Checa,1,1,,2,POINT (10446304 -75516486)
2012,Junio,República Checa,0,2,,2,POINT (125862 -81702165)
2012,Junio,República Checa,1,3,,4,POINT (3451668 -76532004)
2012,Junio,República Checa,37,75,,112,POINT (4697157 -74140516)
2012,Junio,República Checa,0,2,,2,POINT (6170465 -7542726)
2012,Junio,República Checa,0,1,,1,POINT (7819 -72453013)
2012,Junio,Chile,2,1,,3,POINT (-4191162 -69941498)
2012,Junio,Chile,28,36,,64,POINT (0.81488 -77356)
2012,Junio,Chile,0,1,,1,POINT (10406342 -75527794)
2012,Junio,Chile,111,104,,215,POINT (10446304 -75516486)
2012,Junio,Chile,7,10,,17,POINT (10886686 -74776479)
2012,Junio,Chile,2,5,,7,POINT (11360029 -72129595)
2012,Junio,Chile,1,2,,3,POINT (125744111 -81703935)
2012,Junio,Chile,103,66,,169,POINT (125862 -81702165)
2012,Junio,Chile,21,53,,74,POINT (3451668 -76532004)
2012,Junio,Chile,1954,3084,,5038,POINT (4697157 -74140516)
2012,Junio,Chile,0,1,,1,POINT (4815189 -75736374)
2012,Junio,Chile,37,68,,105,POINT (6170465 -7542726)
2012,Junio,Chile,0,1,,1,POINT (6185536 -67484028)
2012,Junio,Chile,0,3,,3,POINT (7128047 -73181317)
2012,Junio,Chile,4,8,,12,POINT (7819 -72453013)
2012,Junio,Chile,0,2,,2,POINT (7927233 -72508188)
2012,Junio,China,1,1,,2,POINT (0.81488 -77356)
2012,Junio,China,0,1,,1,POINT (10406342 -75527794)
2012,Junio,China,3,13,,16,POINT (10446304 -75516486)
2012,Junio,China,1,0,,1,POINT (10886686 -74776479)
2012,Junio,China,4,0,,4,POINT (11360029 -72129595)
2012,Junio,China,0,1,,1,POINT (125862 -81702165)
2012,Junio,China,1,5,,6,POINT (3451668 -76532004)
2012,Junio,China,121,424,,545,POINT (4697157 -74140516)
2012,Junio,China,4,6,,10,POINT (6170465 -7542726)
2012,Junio,China,3,3,,6,POINT (7819 -72453013)
2012,Junio,Taiwán,1,2,,3,POINT (0.81488 -77356)
2012,Junio,Taiwán,1,2,,3,POINT (10446304 -75516486)
2012,Junio,Taiwán,0,1,,1,POINT (10886686 -74776479)
2012,Junio,Taiwán,0,1,,1,POINT (3451668 -76532004)
2012,Junio,Taiwán,27,48,,75,POINT (4697157 -74140516)
2012,Junio,Taiwán,0,1,,1,POINT (4815189 -75736374)
2012,Junio,Taiwán,4,9,,13,POINT (6170465 -7542726)
2012,Junio,Taiwán,0,3,,3,POINT (7819 -72453013)
2012,Junio,Chipre,1,0,,1,POINT (3451668 -76532004)
2012,Junio,Chipre,1,5,,6,POINT (4697157 -74140516)
2012,Junio,Dinamarca,3,0,,3,POINT (-4191162 -69941498)
2012,Junio,Dinamarca,3,0,,3,POINT (0.81488 -77356)
2012,Junio,Dinamarca,1,3,,4,POINT (10406342 -75527794)
2012,Junio,Dinamarca,2,1,,3,POINT (10446304 -75516486)
2012,Junio,Dinamarca,0,1,,1,POINT (11247723 -74213989)
2012,Junio,Dinamarca,1,1,,2,POINT (3451668 -76532004)
2012,Junio,Dinamarca,0,3,,3,POINT (3884426 -77061029)
2012,Junio,Dinamarca,64,129,,193,POINT (4697157 -74140516)
2012,Junio,Dinamarca,8,11,,19,POINT (6170465 -7542726)
2012,Junio,Dinamarca,1,0,,1,POINT (7819 -72453013)
2012,Junio,Dominica,1,3,,4,POINT (4697157 -74140516)
2012,Junio,Ecuador,1,3,,4,POINT (-4191162 -69941498)
2012,Junio,Ecuador,13,41,,54,POINT (0.33002 -76876446)
2012,Junio,Ecuador,687,1185,,1872,POINT (0.81488 -77356)
2012,Junio,Ecuador,0,145,,145,POINT (1800143 -78802679)
2012,Junio,Ecuador,1,9,,10,POINT (10406342 -75527794)
2012,Junio,Ecuador,72,74,,146,POINT (10446304 -75516486)
2012,Junio,Ecuador,1,11,,12,POINT (10886686 -74776479)
2012,Junio,Ecuador,7,8,,15,POINT (11360029 -72129595)
2012,Junio,Ecuador,5,5,,10,POINT (125862 -81702165)
2012,Junio,Ecuador,222,256,,478,POINT (3451668 -76532004)
2012,Junio,Ecuador,1375,2503,,3878,POINT (4697157 -74140516)
2012,Junio,Ecuador,1,1,,2,POINT (4815189 -75736374)
2012,Junio,Ecuador,308,434,,742,POINT (6170465 -7542726)
2012,Junio,Ecuador,2,3,,5,POINT (7128047 -73181317)
2012,Junio,Ecuador,97,162,,259,POINT (7819 -72453013)
2012,Junio,Ecuador,2,2,,4,POINT (7927233 -72508188)
2012,Junio,Ecuador,0,2,,2,POINT (863337 -7735002)
2012,Junio,Egipto,0,1,,1,POINT (10446304 -75516486)
2012,Junio,Egipto,2,11,,13,POINT (4697157 -74140516)
2012,Junio,El Salvador,0,1,,1,POINT (0.81488 -77356)
2012,Junio,El Salvador,7,11,,18,POINT (10446304 -75516486)
2012,Junio,El Salvador,1,3,,4,POINT (10886686 -74776479)
2012,Junio,El Salvador,0,1,,1,POINT (11360029 -72129595)
2012,Junio,El Salvador,2,1,,3,POINT (125862 -81702165)
2012,Junio,El Salvador,6,10,,16,POINT (3451668 -76532004)
2012,Junio,El Salvador,311,586,,897,POINT (4697157 -74140516)
2012,Junio,El Salvador,1,0,,1,POINT (4815189 -75736374)
2012,Junio,El Salvador,17,24,,41,POINT (6170465 -7542726)
2012,Junio,El Salvador,0,1,,1,POINT (7128047 -73181317)
2012,Junio,El Salvador,0,1,,1,POINT (7819 -72453013)
2012,Junio,Emiratos Árabes,0,1,,1,POINT (10446304 -75516486)
2012,Junio,Emiratos Árabes,2,6,,8,POINT (4697157 -74140516)
2012,Junio,España,4,8,,12,POINT (-4191162 -69941498)
2012,Junio,España,0,1,,1,POINT (0.33002 -76876446)
2012,Junio,España,16,54,,70,POINT (0.81488 -77356)
2012,Junio,España,4,14,,18,POINT (10406342 -75527794)
2012,Junio,España,33,94,,127,POINT (10446304 -75516486)
2012,Junio,España,3,7,,10,POINT (10886686 -74776479)
2012,Junio,España,5,9,,14,POINT (11360029 -72129595)
2012,Junio,España,5,2,,7,POINT (125862 -81702165)
2012,Junio,España,278,398,,676,POINT (3451668 -76532004)
2012,Junio,España,1,0,,1,POINT (3884426 -77061029)
2012,Junio,España,1763,4189,,5952,POINT (4697157 -74140516)
2012,Junio,España,3,12,,15,POINT (4815189 -75736374)
2012,Junio,España,115,213,,328,POINT (6170465 -7542726)
2012,Junio,España,1,1,,2,POINT (6185536 -67484028)
2012,Junio,España,0,1,,1,POINT (7088729 -70740253)
2012,Junio,España,7,39,,46,POINT (7819 -72453013)
2012,Junio,España,1,5,,6,POINT (7927233 -72508188)
2012,Junio,España,1,1,,2,POINT (863337 -7735002)
2012,Junio,Eritrea,0,1,,1,POINT (4697157 -74140516)
2012,Junio,Eslovaquia,0,1,,1,POINT (0.81488 -77356)
2012,Junio,Eslovaquia,1,1,,2,POINT (3451668 -76532004)
2012,Junio,Eslovaquia,9,19,,28,POINT (4697157 -74140516)
2012,Junio,Eslovenia,0,1,,1,POINT (10406342 -75527794)
2012,Junio,Eslovenia,1,2,,3,POINT (3451668 -76532004)
2012,Junio,Eslovenia,3,12,,15,POINT (4697157 -74140516)
2012,Junio,Eslovenia,3,2,,5,POINT (6170465 -7542726)
2012,Junio,Estados Unidos de América,26,41,,67,POINT (-4191162 -69941498)
2012,Junio,Estados Unidos de América,0,2,,2,POINT (0.33002 -76876446)
2012,Junio,Estados Unidos de América,39,68,,107,POINT (0.81488 -77356)
2012,Junio,Estados Unidos de América,0,2,,2,POINT (1800143 -78802679)
2012,Junio,Estados Unidos de América,15,47,,62,POINT (10406342 -75527794)
2012,Junio,Estados Unidos de América,1054,1812,,2866,POINT (10446304 -75516486)
2012,Junio,Estados Unidos de América,705,860,,1565,POINT (10886686 -74776479)
2012,Junio,Estados Unidos de América,3,18,,21,POINT (11247723 -74213989)
2012,Junio,Estados Unidos de América,9,16,,25,POINT (11360029 -72129595)
2012,Junio,Estados Unidos de América,0,1,,1,POINT (1152863 -72919186)
2012,Junio,Estados Unidos de América,1,9,,10,POINT (125744111 -81703935)
2012,Junio,Estados Unidos de América,35,49,,84,POINT (125862 -81702165)
2012,Junio,Estados Unidos de América,4,8,,12,POINT (133387613 -81372937)
2012,Junio,Estados Unidos de América,1586,1908,,3494,POINT (3451668 -76532004)
2012,Junio,Estados Unidos de América,116,150,,266,POINT (445285 -75766353)
2012,Junio,Estados Unidos de América,8744,14303,,23047,POINT (4697157 -74140516)
2012,Junio,Estados Unidos de América,121,144,,265,POINT (4815189 -75736374)
2012,Junio,Estados Unidos de América,1810,2943,,4753,POINT (6170465 -7542726)
2012,Junio,Estados Unidos de América,1,2,,3,POINT (6185536 -67484028)
2012,Junio,Estados Unidos de América,41,43,,84,POINT (7128047 -73181317)
2012,Junio,Estados Unidos de América,19,35,,54,POINT (7819 -72453013)
2012,Junio,Estados Unidos de América,17,29,,46,POINT (7927233 -72508188)
2012,Junio,Estados Unidos de América,2,0,,2,POINT (863337 -7735002)
2012,Junio,Estonia,1,0,,1,POINT (3451668 -76532004)
2012,Junio,Estonia,3,4,,7,POINT (4697157 -74140516)
2012,Junio,Estonia,0,2,,2,POINT (7819 -72453013)
2012,Junio,Etiopia,0,5,,5,POINT (4697157 -74140516)
2012,Junio,Filipinas,1,0,,1,POINT (0.81488 -77356)
2012,Junio,Filipinas,0,33,,33,POINT (10406342 -75527794)
2012,Junio,Filipinas,2,15,,17,POINT (10446304 -75516486)
2012,Junio,Filipinas,0,1,,1,POINT (10886686 -74776479)
2012,Junio,Filipinas,0,15,,15,POINT (10970933 -74765343)
2012,Junio,Filipinas,0,30,,30,POINT (11247723 -74213989)
2012,Junio,Filipinas,1,0,,1,POINT (125862 -81702165)
2012,Junio,Filipinas,1,1,,2,POINT (3451668 -76532004)
2012,Junio,Filipinas,0,1,,1,POINT (3884426 -77061029)
2012,Junio,Filipinas,16,53,,69,POINT (4697157 -74140516)
2012,Junio,Filipinas,2,2,,4,POINT (6170465 -7542726)
2012,Junio,Filipinas,0,1,,1,POINT (863337 -7735002)
2012,Junio,Finlandia,7,4,,11,POINT (-4191162 -69941498)
2012,Junio,Finlandia,1,0,,1,POINT (0.81488 -77356)
2012,Junio,Finlandia,2,3,,5,POINT (10446304 -75516486)
2012,Junio,Finlandia,0,1,,1,POINT (10886686 -74776479)
2012,Junio,Finlandia,0,2,,2,POINT (3451668 -76532004)
2012,Junio,Finlandia,36,58,,94,POINT (4697157 -74140516)
2012,Junio,Finlandia,1,1,,2,POINT (6170465 -7542726)
2012,Junio,Francia,10,15,,25,POINT (-4191162 -69941498)
2012,Junio,Francia,1,1,,2,POINT (0.33002 -76876446)
2012,Junio,Francia,52,72,,124,POINT (0.81488 -77356)
2012,Junio,Francia,0,1,,1,POINT (1800143 -78802679)
2012,Junio,Francia,12,13,,25,POINT (10406342 -75527794)
2012,Junio,Francia,18,41,,59,POINT (10446304 -75516486)
2012,Junio,Francia,0,6,,6,POINT (10886686 -74776479)
2012,Junio,Francia,2,3,,5,POINT (11247723 -74213989)
2012,Junio,Francia,7,12,,19,POINT (11360029 -72129595)
2012,Junio,Francia,33,56,,89,POINT (3451668 -76532004)
2012,Junio,Francia,901,1606,,2507,POINT (4697157 -74140516)
2012,Junio,Francia,0,4,,4,POINT (4815189 -75736374)
2012,Junio,Francia,24,41,,65,POINT (6170465 -7542726)
2012,Junio,Francia,0,2,,2,POINT (6185536 -67484028)
2012,Junio,Francia,0,1,,1,POINT (7128047 -73181317)
2012,Junio,Francia,3,10,,13,POINT (7819 -72453013)
2012,Junio,Francia,0,2,,2,POINT (7927233 -72508188)
2012,Junio,Francia,0,2,,2,POINT (863337 -7735002)
2012,Junio,Gabón,1,2,,3,POINT (4697157 -74140516)
2012,Junio,Georgia,0,2,,2,POINT (3884426 -77061029)
2012,Junio,Georgia,1,0,,1,POINT (4697157 -74140516)
2012,Junio,Ghana,0,1,,1,POINT (10446304 -75516486)
2012,Junio,Ghana,1,3,,4,POINT (4697157 -74140516)
2012,Junio,Granada,0,3,,3,POINT (4697157 -74140516)
2012,Junio,Grecia,0,3,,3,POINT (10406342 -75527794)
2012,Junio,Grecia,1,2,,3,POINT (10446304 -75516486)
2012,Junio,Grecia,0,1,,1,POINT (10970933 -74765343)
2012,Junio,Grecia,0,4,,4,POINT (3451668 -76532004)
2012,Junio,Grecia,16,40,,56,POINT (4697157 -74140516)
2012,Junio,Grecia,1,3,,4,POINT (6170465 -7542726)
2012,Junio,Grecia,0,1,,1,POINT (9402597 -75681642)
2012,Junio,Guatemala,1,5,,6,POINT (0.81488 -77356)
2012,Junio,Guatemala,0,2,,2,POINT (10406342 -75527794)
2012,Junio,Guatemala,40,50,,90,POINT (10446304 -75516486)
2012,Junio,Guatemala,4,10,,14,POINT (10886686 -74776479)
2012,Junio,Guatemala,0,1,,1,POINT (11360029 -72129595)
2012,Junio,Guatemala,10,9,,19,POINT (125862 -81702165)
2012,Junio,Guatemala,12,30,,42,POINT (3451668 -76532004)
2012,Junio,Guatemala,0,1,,1,POINT (445285 -75766353)
2012,Junio,Guatemala,217,498,,715,POINT (4697157 -74140516)
2012,Junio,Guatemala,4,6,,10,POINT (4815189 -75736374)
2012,Junio,Guatemala,42,62,,104,POINT (6170465 -7542726)
2012,Junio,Guatemala,4,4,,8,POINT (7128047 -73181317)
2012,Junio,Guatemala,3,7,,10,POINT (7819 -72453013)
2012,Junio,Guatemala,0,1,,1,POINT (863337 -7735002)
2012,Junio,Guyana,0,1,,1,POINT (10446304 -75516486)
2012,Junio,Guyana,1,0,,1,POINT (10886686 -74776479)
2012,Junio,Guyana,1,0,,1,POINT (125862 -81702165)
2012,Junio,Guyana,5,16,,21,POINT (4697157 -74140516)
2012,Junio,Guinea,0,1,,1,POINT (4697157 -74140516)
2012,Junio,Guinea Ecuatorial,1,0,,1,POINT (0.81488 -77356)
2012,Junio,Haití,0,2,,2,POINT (10446304 -75516486)
2012,Junio,Haití,1,0,,1,POINT (3451668 -76532004)
2012,Junio,Haití,3,15,,18,POINT (4697157 -74140516)
2012,Junio,Haití,0,4,,4,POINT (6170465 -7542726)
2012,Junio,Honduras,1,2,,3,POINT (0.81488 -77356)
2012,Junio,Honduras,1,4,,5,POINT (10406342 -75527794)
2012,Junio,Honduras,2,14,,16,POINT (10446304 -75516486)
2012,Junio,Honduras,10,14,,24,POINT (10886686 -74776479)
2012,Junio,Honduras,0,1,,1,POINT (11360029 -72129595)
2012,Junio,Honduras,0,37,,37,POINT (125744111 -81703935)
2012,Junio,Honduras,0,4,,4,POINT (125862 -81702165)
2012,Junio,Honduras,10,16,,26,POINT (3451668 -76532004)
2012,Junio,Honduras,104,211,,315,POINT (4697157 -74140516)
2012,Junio,Honduras,1,1,,2,POINT (4815189 -75736374)
2012,Junio,Honduras,10,21,,31,POINT (6170465 -7542726)
2012,Junio,Honduras,0,1,,1,POINT (7927233 -72508188)
2012,Junio,Hungría,2,0,,2,POINT (0.81488 -77356)
2012,Junio,Hungría,0,1,,1,POINT (10406342 -75527794)
2012,Junio,Hungría,1,0,,1,POINT (10446304 -75516486)
2012,Junio,Hungría,0,1,,1,POINT (3451668 -76532004)
2012,Junio,Hungría,15,22,,37,POINT (4697157 -74140516)
2012,Junio,Hungría,0,2,,2,POINT (6170465 -7542726)
2012,Junio,India,1,12,,13,POINT (10446304 -75516486)
2012,Junio,India,1,10,,11,POINT (3451668 -76532004)
2012,Junio,India,40,217,,257,POINT (4697157 -74140516)
2012,Junio,India,0,3,,3,POINT (4815189 -75736374)
2012,Junio,India,3,7,,10,POINT (6170465 -7542726)
2012,Junio,Indonesia,1,0,,1,POINT (0.81488 -77356)
2012,Junio,Indonesia,0,10,,10,POINT (10406342 -75527794)
2012,Junio,Indonesia,2,1,,3,POINT (10446304 -75516486)
2012,Junio,Indonesia,0,4,,4,POINT (11247723 -74213989)
2012,Junio,Indonesia,11,20,,31,POINT (4697157 -74140516)
2012,Junio,Irán,7,18,,25,POINT (4697157 -74140516)
2012,Junio,República de Irlanda,4,3,,7,POINT (-4191162 -69941498)
2012,Junio,República de Irlanda,2,0,,2,POINT (0.33002 -76876446)
2012,Junio,República de Irlanda,13,13,,26,POINT (0.81488 -77356)
2012,Junio,República de Irlanda,2,1,,3,POINT (10406342 -75527794)
2012,Junio,República de Irlanda,3,6,,9,POINT (10446304 -75516486)
2012,Junio,República de Irlanda,0,1,,1,POINT (10886686 -74776479)
2012,Junio,República de Irlanda,1,1,,2,POINT (11360029 -72129595)
2012,Junio,República de Irlanda,0,1,,1,POINT (125862 -81702165)
2012,Junio,República de Irlanda,4,2,,6,POINT (3451668 -76532004)
2012,Junio,República de Irlanda,47,90,,137,POINT (4697157 -74140516)
2012,Junio,República de Irlanda,0,4,,4,POINT (6170465 -7542726)
2012,Junio,República de Irlanda,0,1,,1,POINT (7128047 -73181317)
2012,Junio,República de Irlanda,0,1,,1,POINT (863337 -7735002)
2012,Junio,Islandia,5,0,,5,POINT (0.81488 -77356)
2012,Junio,Islandia,5,3,,8,POINT (4697157 -74140516)
2012,Junio,Isla de Man,22,26,,48,POINT (0.81488 -77356)
2012,Junio,Isla de Man,5,15,,20,POINT (10446304 -75516486)
2012,Junio,Isla de Man,2,8,,10,POINT (10886686 -74776479)
2012,Junio,Isla de Man,0,1,,1,POINT (125862 -81702165)
2012,Junio,Isla de Man,6,11,,17,POINT (3451668 -76532004)
2012,Junio,Isla de Man,44,107,,151,POINT (4697157 -74140516)
2012,Junio,Isla de Man,0,1,,1,POINT (4815189 -75736374)
2012,Junio,Isla de Man,8,27,,35,POINT (6170465 -7542726)
2012,Junio,Isla de Man,1,1,,2,POINT (7927233 -72508188)
2012,Junio,Israel,0,9,,9,POINT (-4191162 -69941498)
2012,Junio,Israel,27,97,,124,POINT (0.81488 -77356)
2012,Junio,Israel,0,1,,1,POINT (10406342 -75527794)
2012,Junio,Israel,2,17,,19,POINT (10446304 -75516486)
2012,Junio,Israel,0,4,,4,POINT (10886686 -74776479)
2012,Junio,Israel,0,1,,1,POINT (11360029 -72129595)
2012,Junio,Israel,1,1,,2,POINT (125862 -81702165)
2012,Junio,Israel,6,12,,18,POINT (3451668 -76532004)
2012,Junio,Israel,106,492,,598,POINT (4697157 -74140516)
2012,Junio,Israel,7,44,,51,POINT (6170465 -7542726)
2012,Junio,Israel,0,1,,1,POINT (863337 -7735002)
2012,Junio,Islas Aland/Provincia de Finlandia,0,1,,1,POINT (4697157 -74140516)
2012,Junio,Italia,1,9,,10,POINT (-4191162 -69941498)
2012,Junio,Italia,6,20,,26,POINT (0.81488 -77356)
2012,Junio,Italia,0,4,,4,POINT (10406342 -75527794)
2012,Junio,Italia,17,66,,83,POINT (10446304 -75516486)
2012,Junio,Italia,1,13,,14,POINT (10886686 -74776479)
2012,Junio,Italia,1,4,,5,POINT (11360029 -72129595)
2012,Junio,Italia,12,10,,22,POINT (125862 -81702165)
2012,Junio,Italia,27,74,,101,POINT (3451668 -76532004)
2012,Junio,Italia,0,1,,1,POINT (3884426 -77061029)
2012,Junio,Italia,450,1402,,1852,POINT (4697157 -74140516)
2012,Junio,Italia,1,0,,1,POINT (4815189 -75736374)
2012,Junio,Italia,19,73,,92,POINT (6170465 -7542726)
2012,Junio,Italia,0,13,,13,POINT (7819 -72453013)
2012,Junio,Italia,2,3,,5,POINT (7927233 -72508188)
2012,Junio,Italia,0,1,,1,POINT (863337 -7735002)
2012,Junio,Islas del Canal,0,1,,1,POINT (4697157 -74140516)
2012,Junio,Jamaica,3,8,,11,POINT (10446304 -75516486)
2012,Junio,Jamaica,0,1,,1,POINT (10886686 -74776479)
2012,Junio,Jamaica,0,1,,1,POINT (11360029 -72129595)
2012,Junio,Jamaica,2,7,,9,POINT (125862 -81702165)
2012,Junio,Jamaica,0,2,,2,POINT (3451668 -76532004)
2012,Junio,Jamaica,0,1,,1,POINT (445285 -75766353)
2012,Junio,Jamaica,9,28,,37,POINT (4697157 -74140516)
2012,Junio,Jamaica,0,3,,3,POINT (6170465 -7542726)
2012,Junio,Jamaica,0,1,,1,POINT (7819 -72453013)
2012,Junio,Jamaica,1,0,,1,POINT (7927233 -72508188)
2012,Junio,Islas Salomón,0,1,,1,POINT (7819 -72453013)
2012,Junio,Japón,0,2,,2,POINT (-4191162 -69941498)
2012,Junio,Japón,11,8,,19,POINT (0.81488 -77356)
2012,Junio,Japón,26,21,,47,POINT (10406342 -75527794)
2012,Junio,Japón,5,9,,14,POINT (10446304 -75516486)
2012,Junio,Japón,0,7,,7,POINT (10886686 -74776479)
2012,Junio,Japón,0,1,,1,POINT (11360029 -72129595)
2012,Junio,Japón,1,0,,1,POINT (125862 -81702165)
2012,Junio,Japón,4,19,,23,POINT (3451668 -76532004)
2012,Junio,Japón,111,401,,512,POINT (4697157 -74140516)
2012,Junio,Japón,1,0,,1,POINT (4815189 -75736374)
2012,Junio,Japón,5,19,,24,POINT (6170465 -7542726)
2012,Junio,Japón,3,4,,7,POINT (7819 -72453013)
2012,Junio,Jordania,0,5,,5,POINT (4697157 -74140516)
2012,Junio,Kazajistán,3,0,,3,POINT (4697157 -74140516)
2012,Junio,Kazajistán,1,1,,2,POINT (6170465 -7542726)
2012,Junio,Kenia,5,20,,25,POINT (4697157 -74140516)
2012,Junio,Kenia,1,2,,3,POINT (7819 -72453013)
2012,Junio,Kuwait,0,7,,7,POINT (4697157 -74140516)
2012,Junio,República de Kosovo,1,0,,1,POINT (4697157 -74140516)
2012,Junio,República Democrática Popular  Lao,0,2,,2,POINT (4697157 -74140516)
2012,Junio,Letonia,0,2,,2,POINT (0.81488 -77356)
2012,Junio,Letonia,3,6,,9,POINT (4697157 -74140516)
2012,Junio,Letonia,2,0,,2,POINT (6170465 -7542726)
2012,Junio,Lituania,0,1,,1,POINT (0.81488 -77356)
2012,Junio,Lituania,3,1,,4,POINT (3451668 -76532004)
2012,Junio,Lituania,3,3,,6,POINT (4697157 -74140516)
2012,Junio,Líbano,0,3,,3,POINT (10886686 -74776479)
2012,Junio,Líbano,1,4,,5,POINT (11360029 -72129595)
2012,Junio,Líbano,0,1,,1,POINT (125862 -81702165)
2012,Junio,Líbano,0,1,,1,POINT (3451668 -76532004)
2012,Junio,Líbano,10,27,,37,POINT (4697157 -74140516)
2012,Junio,Líbano,0,1,,1,POINT (7819 -72453013)
2012,Junio,Liberia,0,2,,2,POINT (4697157 -74140516)
2012,Junio,Libia,0,1,,1,POINT (0.81488 -77356)
2012,Junio,Libia,0,2,,2,POINT (4697157 -74140516)
2012,Junio,Luxemburgo,0,2,,2,POINT (10446304 -75516486)
2012,Junio,Luxemburgo,1,0,,1,POINT (3451668 -76532004)
2012,Junio,Luxemburgo,2,9,,11,POINT (4697157 -74140516)
2012,Junio,Luxemburgo,0,1,,1,POINT (6170465 -7542726)
2012,Junio,Macedonia,0,1,,1,POINT (0.81488 -77356)
2012,Junio,Macedonia,1,0,,1,POINT (10886686 -74776479)
2012,Junio,Macedonia,2,1,,3,POINT (4697157 -74140516)
2012,Junio,Madagascar,1,1,,2,POINT (4697157 -74140516)
2012,Junio,Malasia,0,3,,3,POINT (10446304 -75516486)
2012,Junio,Malasia,10,24,,34,POINT (4697157 -74140516)
2012,Junio,Malasia,1,0,,1,POINT (6170465 -7542726)
2012,Junio,Malta,1,0,,1,POINT (3451668 -76532004)
2012,Junio,Malta,1,1,,2,POINT (4697157 -74140516)
2012,Junio,Marruecos,0,1,,1,POINT (10446304 -75516486)
2012,Junio,Marruecos,1,0,,1,POINT (3451668 -76532004)
2012,Junio,Marruecos,2,5,,7,POINT (4697157 -74140516)
2012,Junio,Mauricio,0,1,,1,POINT (4697157 -74140516)
2012,Junio,Mauritania,0,1,,1,POINT (10886686 -74776479)
2012,Junio,Mauritania,0,1,,1,POINT (4697157 -74140516)
2012,Junio,México,0,1,,1,POINT (-4191162 -69941498)
2012,Junio,México,2,9,,11,POINT (0.81488 -77356)
2012,Junio,México,0,3,,3,POINT (1800143 -78802679)
2012,Junio,México,1,6,,7,POINT (10406342 -75527794)
2012,Junio,México,77,118,,195,POINT (10446304 -75516486)
2012,Junio,México,13,34,,47,POINT (10886686 -74776479)
2012,Junio,México,0,11,,11,POINT (11360029 -72129595)
2012,Junio,México,0,2,,2,POINT (125744111 -81703935)
2012,Junio,México,5,4,,9,POINT (125862 -81702165)
2012,Junio,México,21,70,,91,POINT (3451668 -76532004)
2012,Junio,México,0,1,,1,POINT (3884426 -77061029)
2012,Junio,México,0,1,,1,POINT (445285 -75766353)
2012,Junio,México,1680,3875,,5555,POINT (4697157 -74140516)
2012,Junio,México,1,15,,16,POINT (4815189 -75736374)
2012,Junio,México,109,278,,387,POINT (6170465 -7542726)
2012,Junio,México,1,2,,3,POINT (6185536 -67484028)
2012,Junio,México,0,1,,1,POINT (7088729 -70740253)
2012,Junio,México,2,6,,8,POINT (7128047 -73181317)
2012,Junio,México,10,26,,36,POINT (7819 -72453013)
2012,Junio,México,2,8,,10,POINT (7927233 -72508188)
2012,Junio,República de Moldavia,1,0,,1,POINT (6170465 -7542726)
2012,Junio,Mónaco,0,1,,1,POINT (4697157 -74140516)
2012,Junio,Mongolia,1,0,,1,POINT (445285 -75766353)
2012,Junio,Mozambique,0,2,,2,POINT (4697157 -74140516)
2012,Junio,Namibia,0,1,,1,POINT (4697157 -74140516)
2012,Junio,Nepal,0,3,,3,POINT (4697157 -74140516)
2012,Junio,Nicaragua,0,1,,1,POINT (10406342 -75527794)
2012,Junio,Nicaragua,2,4,,6,POINT (10446304 -75516486)
2012,Junio,Nicaragua,0,5,,5,POINT (10886686 -74776479)
2012,Junio,Nicaragua,2,2,,4,POINT (125744111 -81703935)
2012,Junio,Nicaragua,2,5,,7,POINT (3451668 -76532004)
2012,Junio,Nicaragua,47,68,,115,POINT (4697157 -74140516)
2012,Junio,Nicaragua,2,0,,2,POINT (4815189 -75736374)
2012,Junio,Nicaragua,13,13,,26,POINT (6170465 -7542726)
2012,Junio,Nigeria,0,2,,2,POINT (10446304 -75516486)
2012,Junio,Nigeria,4,10,,14,POINT (4697157 -74140516)
2012,Junio,Nigeria,0,1,,1,POINT (7819 -72453013)
2012,Junio,Noruega,0,2,,2,POINT (-4191162 -69941498)
2012,Junio,Noruega,4,5,,9,POINT (0.81488 -77356)
2012,Junio,Noruega,1,1,,2,POINT (10406342 -75527794)
2012,Junio,Noruega,6,7,,13,POINT (10446304 -75516486)
2012,Junio,Noruega,2,0,,2,POINT (10886686 -74776479)
2012,Junio,Noruega,0,3,,3,POINT (11360029 -72129595)
2012,Junio,Noruega,9,15,,24,POINT (3451668 -76532004)
2012,Junio,Noruega,105,172,,277,POINT (4697157 -74140516)
2012,Junio,Noruega,2,0,,2,POINT (4815189 -75736374)
2012,Junio,Noruega,14,15,,29,POINT (6170465 -7542726)
2012,Junio,Noruega,0,1,,1,POINT (7128047 -73181317)
2012,Junio,Nueva Zelanda,1,1,,2,POINT (-4191162 -69941498)
2012,Junio,Nueva Zelanda,7,10,,17,POINT (0.81488 -77356)
2012,Junio,Nueva Zelanda,2,3,,5,POINT (10446304 -75516486)
2012,Junio,Nueva Zelanda,0,1,,1,POINT (10886686 -74776479)
2012,Junio,Nueva Zelanda,0,1,,1,POINT (11360029 -72129595)
2012,Junio,Nueva Zelanda,1,1,,2,POINT (3451668 -76532004)
2012,Junio,Nueva Zelanda,37,61,,98,POINT (4697157 -74140516)
2012,Junio,Nueva Zelanda,0,1,,1,POINT (4815189 -75736374)
2012,Junio,Nueva Zelanda,5,7,,12,POINT (6170465 -7542726)
2012,Junio,Nueva Zelanda,1,0,,1,POINT (7819 -72453013)
2012,Junio,Omán,0,1,,1,POINT (10446304 -75516486)
2012,Junio,Nueva Zelanda,4,4,,8,POINT (10406342 -75527794)
2012,Junio,Nueva Zelanda,4,7,,11,POINT (4697157 -74140516)
2012,Junio,Países Bajos,0,1,,1,POINT (-4191162 -69941498)
2012,Junio,Países Bajos,5,11,,16,POINT (0.81488 -77356)
2012,Junio,Países Bajos,2,6,,8,POINT (10446304 -75516486)
2012,Junio,Países Bajos,10,6,,16,POINT (10886686 -74776479)
2012,Junio,Países Bajos,5,1,,6,POINT (11360029 -72129595)
2012,Junio,Países Bajos,17,18,,35,POINT (1152863 -72919186)
2012,Junio,Países Bajos,5,13,,18,POINT (3451668 -76532004)
2012,Junio,Países Bajos,0,1,,1,POINT (3884426 -77061029)
2012,Junio,Países Bajos,202,284,,486,POINT (4697157 -74140516)
2012,Junio,Países Bajos,2,0,,2,POINT (4815189 -75736374)
2012,Junio,Países Bajos,166,182,,348,POINT (6170465 -7542726)
2012,Junio,Países Bajos,5,3,,8,POINT (7128047 -73181317)
2012,Junio,Pakistán,0,13,,13,POINT (4697157 -74140516)
2012,Junio,Pakistán,0,1,,1,POINT (7819 -72453013)
2012,Junio,Panamá,2,1,,3,POINT (0.81488 -77356)
2012,Junio,Panamá,0,3,,3,POINT (10406342 -75527794)
2012,Junio,Panamá,79,147,,226,POINT (10446304 -75516486)
2012,Junio,Panamá,39,79,,118,POINT (10886686 -74776479)
2012,Junio,Panamá,0,4,,4,POINT (11360029 -72129595)
2012,Junio,Panamá,0,4,,4,POINT (125744111 -81703935)
2012,Junio,Panamá,49,59,,108,POINT (125862 -81702165)
2012,Junio,Panamá,69,108,,177,POINT (3451668 -76532004)
2012,Junio,Panamá,443,735,,1178,POINT (4697157 -74140516)
2012,Junio,Panamá,49,68,,117,POINT (4815189 -75736374)
2012,Junio,Panamá,65,186,,251,POINT (6170465 -7542726)
2012,Junio,Panamá,3,1,,4,POINT (6222552 -77401154)
2012,Junio,Panamá,0,1,,1,POINT (7088729 -70740253)
2012,Junio,Panamá,2,9,,11,POINT (7128047 -73181317)
2012,Junio,Panamá,0,1,,1,POINT (7819 -72453013)
2012,Junio,Panamá,5,7,,12,POINT (7927233 -72508188)
2012,Junio,Panamá,1,1,,2,POINT (863337 -7735002)
2012,Junio,Papúa Nueva Guinea,1,2,,3,POINT (4697157 -74140516)
2012,Junio,Paraguay,1,5,,6,POINT (0.81488 -77356)
2012,Junio,Paraguay,9,9,,18,POINT (10446304 -75516486)
2012,Junio,Paraguay,2,0,,2,POINT (10886686 -74776479)
2012,Junio,Paraguay,1,1,,2,POINT (11360029 -72129595)
2012,Junio,Paraguay,4,2,,6,POINT (3451668 -76532004)
2012,Junio,Paraguay,144,269,,413,POINT (4697157 -74140516)
2012,Junio,Paraguay,5,9,,14,POINT (6170465 -7542726)
2012,Junio,Paraguay,1,0,,1,POINT (7088729 -70740253)
2012,Junio,Paraguay,1,1,,2,POINT (7819 -72453013)
2012,Junio,Perú,15,22,,37,POINT (-4191162 -69941498)
2012,Junio,Perú,3,1,,4,POINT (0.33002 -76876446)
2012,Junio,Perú,133,288,,421,POINT (0.81488 -77356)
2012,Junio,Perú,0,4,,4,POINT (10406342 -75527794)
2012,Junio,Perú,166,136,,302,POINT (10446304 -75516486)
2012,Junio,Perú,6,12,,18,POINT (10886686 -74776479)
2012,Junio,Perú,5,7,,12,POINT (11360029 -72129595)
2012,Junio,Perú,319,209,,528,POINT (125862 -81702165)
2012,Junio,Perú,46,97,,143,POINT (3451668 -76532004)
2012,Junio,Perú,0,1,,1,POINT (3884426 -77061029)
2012,Junio,Perú,1,0,,1,POINT (445285 -75766353)
2012,Junio,Perú,1850,2853,,4703,POINT (4697157 -74140516)
2012,Junio,Perú,0,3,,3,POINT (4815189 -75736374)
2012,Junio,Perú,86,198,,284,POINT (6170465 -7542726)
2012,Junio,Perú,0,1,,1,POINT (6185536 -67484028)
2012,Junio,Perú,2,2,,4,POINT (7128047 -73181317)
2012,Junio,Perú,22,55,,77,POINT (7819 -72453013)
2012,Junio,Perú,0,1,,1,POINT (7927233 -72508188)
2012,Junio,Perú,0,1,,1,POINT (9402597 -75681642)
2012,Junio,Palestina,1,1,,2,POINT (4697157 -74140516)
2012,Junio,Polonia,1,1,,2,POINT (-4191162 -69941498)
2012,Junio,Polonia,5,5,,10,POINT (0.81488 -77356)
2012,Junio,Polonia,2,8,,10,POINT (10406342 -75527794)
2012,Junio,Polonia,2,2,,4,POINT (10446304 -75516486)
2012,Junio,Polonia,0,3,,3,POINT (10970933 -74765343)
2012,Junio,Polonia,2,2,,4,POINT (11247723 -74213989)
2012,Junio,Polonia,4,3,,7,POINT (11360029 -72129595)
2012,Junio,Polonia,2,1,,3,POINT (3451668 -76532004)
2012,Junio,Polonia,54,76,,130,POINT (4697157 -74140516)
2012,Junio,Polonia,6,6,,12,POINT (7819 -72453013)
2012,Junio,Portugal,0,1,,1,POINT (-4191162 -69941498)
2012,Junio,Portugal,1,0,,1,POINT (0.81488 -77356)
2012,Junio,Portugal,2,4,,6,POINT (10406342 -75527794)
2012,Junio,Portugal,3,5,,8,POINT (10446304 -75516486)
2012,Junio,Portugal,1,1,,2,POINT (10886686 -74776479)
2012,Junio,Portugal,1,3,,4,POINT (11360029 -72129595)
2012,Junio,Portugal,3,9,,12,POINT (3451668 -76532004)
2012,Junio,Portugal,69,319,,388,POINT (4697157 -74140516)
2012,Junio,Portugal,3,15,,18,POINT (6170465 -7542726)
2012,Junio,Portugal,1,2,,3,POINT (7819 -72453013)
2012,Junio,Portugal,1,2,,3,POINT (7927233 -72508188)
2012,Junio,Puerto Rico/Territorio de Estados Unidos,3,6,,9,POINT (10446304 -75516486)
2012,Junio,Puerto Rico/Territorio de Estados Unidos,0,2,,2,POINT (10886686 -74776479)
2012,Junio,Puerto Rico/Territorio de Estados Unidos,1,3,,4,POINT (3451668 -76532004)
2012,Junio,Puerto Rico/Territorio de Estados Unidos,0,1,,1,POINT (6170465 -7542726)
2012,Junio,Reino Unido de Gran Bretaña e Irlanda del Norte,6,14,,20,POINT (-4191162 -69941498)
2012,Junio,Reino Unido de Gran Bretaña e Irlanda del Norte,10,21,,31,POINT (0.81488 -77356)
2012,Junio,Reino Unido de Gran Bretaña e Irlanda del Norte,10,25,,35,POINT (10446304 -75516486)
2012,Junio,Reino Unido de Gran Bretaña e Irlanda del Norte,3,9,,12,POINT (11360029 -72129595)
2012,Junio,Reino Unido de Gran Bretaña e Irlanda del Norte,0,1,,1,POINT (125862 -81702165)
2012,Junio,Reino Unido de Gran Bretaña e Irlanda del Norte,4,15,,19,POINT (3451668 -76532004)
2012,Junio,Reino Unido de Gran Bretaña e Irlanda del Norte,188,440,,628,POINT (4697157 -74140516)
2012,Junio,Reino Unido de Gran Bretaña e Irlanda del Norte,0,1,,1,POINT (4815189 -75736374)
2012,Junio,Reino Unido de Gran Bretaña e Irlanda del Norte,10,25,,35,POINT (6170465 -7542726)
2012,Junio,Reino Unido de Gran Bretaña e Irlanda del Norte,0,1,,1,POINT (7819 -72453013)
2012,Junio,República de Belarús,0,2,,2,POINT (4697157 -74140516)
2012,Junio,República de Belarús,0,2,,2,POINT (6170465 -7542726)
2012,Junio,República Dominicana,2,6,,8,POINT (0.81488 -77356)
2012,Junio,República Dominicana,24,40,,64,POINT (10446304 -75516486)
2012,Junio,República Dominicana,6,9,,15,POINT (10886686 -74776479)
2012,Junio,República Dominicana,0,1,,1,POINT (11360029 -72129595)
2012,Junio,República Dominicana,21,34,,55,POINT (3451668 -76532004)
2012,Junio,República Dominicana,203,318,,521,POINT (4697157 -74140516)
2012,Junio,República Dominicana,1,0,,1,POINT (4815189 -75736374)
2012,Junio,República Dominicana,23,56,,79,POINT (6170465 -7542726)
2012,Junio,República Dominicana,3,0,,3,POINT (7128047 -73181317)
2012,Junio,República Dominicana,1,2,,3,POINT (7819 -72453013)
2012,Junio,República Dominicana,7,8,,15,POINT (7927233 -72508188)
2012,Junio,República Checa,0,2,,2,POINT (10406342 -75527794)
2012,Junio,República Checa,0,1,,1,POINT (11247723 -74213989)
2012,Junio,República Checa,4,2,,6,POINT (4697157 -74140516)
2012,Junio,Rumania,0,2,,2,POINT (0.81488 -77356)
2012,Junio,Rumania,0,4,,4,POINT (10406342 -75527794)
2012,Junio,Rumania,1,1,,2,POINT (10446304 -75516486)
2012,Junio,Rumania,3,4,,7,POINT (3451668 -76532004)
2012,Junio,Rumania,11,38,,49,POINT (4697157 -74140516)
2012,Junio,Rumania,1,4,,5,POINT (6170465 -7542726)
2012,Junio,Rumania,1,0,,1,POINT (7819 -72453013)
2012,Junio,Federación de Rusia,0,1,,1,POINT (-4191162 -69941498)
2012,Junio,Federación de Rusia,6,6,,12,POINT (0.81488 -77356)
2012,Junio,Federación de Rusia,0,2,,2,POINT (10406342 -75527794)
2012,Junio,Federación de Rusia,0,1,,1,POINT (10446304 -75516486)
2012,Junio,Federación de Rusia,1,3,,4,POINT (11360029 -72129595)
2012,Junio,Federación de Rusia,0,1,,1,POINT (3451668 -76532004)
2012,Junio,Federación de Rusia,0,1,,1,POINT (3884426 -77061029)
2012,Junio,Federación de Rusia,32,48,,80,POINT (4697157 -74140516)
2012,Junio,Federación de Rusia,3,0,,3,POINT (6170465 -7542726)
2012,Junio,Rwanda,1,0,,1,POINT (4697157 -74140516)
2012,Junio,San Cristóbal y Nevis,0,6,,6,POINT (4697157 -74140516)
2012,Junio,Santa Lucia,0,1,,1,POINT (10886686 -74776479)
2012,Junio,Santa Lucia,1,2,,3,POINT (4697157 -74140516)
2012,Junio,Santa Lucia,0,1,,1,POINT (6170465 -7542726)
2012,Junio,Santa Lucia,1,1,,2,POINT (7128047 -73181317)
2012,Junio,Santa Sede/Ciudad del Vaticano,0,1,,1,POINT (4697157 -74140516)
2012,Junio,Senegal,0,2,,2,POINT (4697157 -74140516)
2012,Junio,Serbia,2,1,,3,POINT (0.81488 -77356)
2012,Junio,Serbia,0,4,,4,POINT (4697157 -74140516)
2012,Junio,Sierra Leona,2,0,,2,POINT (4697157 -74140516)
2012,Junio,Singapur,0,1,,1,POINT (10886686 -74776479)
2012,Junio,Singapur,0,1,,1,POINT (3451668 -76532004)
2012,Junio,Singapur,6,10,,16,POINT (4697157 -74140516)
2012,Junio,Singapur,1,0,,1,POINT (6170465 -7542726)
2012,Junio,República Árabe Siria,0,1,,1,POINT (11360029 -72129595)
2012,Junio,República Árabe Siria,0,1,,1,POINT (4697157 -74140516)
2012,Junio,República Árabe Siria,0,1,,1,POINT (7819 -72453013)
2012,Junio,Somalia,0,1,,1,POINT (4697157 -74140516)
2012,Junio,Sri Lanka,1,0,,1,POINT (10446304 -75516486)
2012,Junio,Sri Lanka,1,0,,1,POINT (4697157 -74140516)
2012,Junio,Sudáfrica,3,3,,6,POINT (10406342 -75527794)
2012,Junio,Sudáfrica,3,3,,6,POINT (10446304 -75516486)
2012,Junio,Sudáfrica,0,6,,6,POINT (10886686 -74776479)
2012,Junio,Sudáfrica,0,5,,5,POINT (10970933 -74765343)
2012,Junio,Sudáfrica,0,2,,2,POINT (11360029 -72129595)
2012,Junio,Sudáfrica,16,75,,91,POINT (4697157 -74140516)
2012,Junio,Sudáfrica,0,1,,1,POINT (6170465 -7542726)
2012,Junio,Sudáfrica,0,1,,1,POINT (7128047 -73181317)
2012,Junio,Sudán,0,2,,2,POINT (4697157 -74140516)
2012,Junio,Suecia,0,3,,3,POINT (-4191162 -69941498)
2012,Junio,Suecia,3,3,,6,POINT (0.81488 -77356)
2012,Junio,Suecia,4,6,,10,POINT (10406342 -75527794)
2012,Junio,Suecia,3,6,,9,POINT (10446304 -75516486)
2012,Junio,Suecia,1,2,,3,POINT (10886686 -74776479)
2012,Junio,Suecia,0,1,,1,POINT (11247723 -74213989)
2012,Junio,Suecia,0,2,,2,POINT (11360029 -72129595)
2012,Junio,Suecia,12,18,,30,POINT (3451668 -76532004)
2012,Junio,Suecia,189,216,,405,POINT (4697157 -74140516)
2012,Junio,Suecia,12,19,,31,POINT (6170465 -7542726)
2012,Junio,Suecia,0,7,,7,POINT (7819 -72453013)
2012,Junio,Suiza,2,7,,9,POINT (-4191162 -69941498)
2012,Junio,Suiza,23,23,,46,POINT (0.81488 -77356)
2012,Junio,Suiza,12,9,,21,POINT (10406342 -75527794)
2012,Junio,Suiza,8,10,,18,POINT (10446304 -75516486)
2012,Junio,Suiza,5,6,,11,POINT (10886686 -74776479)
2012,Junio,Suiza,1,2,,3,POINT (11360029 -72129595)
2012,Junio,Suiza,13,14,,27,POINT (3451668 -76532004)
2012,Junio,Suiza,279,461,,740,POINT (4697157 -74140516)
2012,Junio,Suiza,0,1,,1,POINT (4815189 -75736374)
2012,Junio,Suiza,6,35,,41,POINT (6170465 -7542726)
2012,Junio,Suiza,0,2,,2,POINT (7128047 -73181317)
2012,Junio,Suiza,2,2,,4,POINT (7819 -72453013)
2012,Junio,Suiza,1,1,,2,POINT (7927233 -72508188)
2012,Junio,Surinam,5,16,,21,POINT (4697157 -74140516)
2012,Junio,Surinam,0,5,,5,POINT (6170465 -7542726)
2012,Junio,Taiwán,0,2,,2,POINT (10406342 -75527794)
2012,Junio,Taiwán,0,1,,1,POINT (10446304 -75516486)
2012,Junio,Taiwán,1,4,,5,POINT (4697157 -74140516)
2012,Junio,Taiwán,0,1,,1,POINT (6170465 -7542726)
2012,Junio,Tailandia,1,0,,1,POINT (10446304 -75516486)
2012,Junio,Tailandia,3,5,,8,POINT (4697157 -74140516)
2012,Junio,Tíbet/Región Autónoma de China,0,2,,2,POINT (4697157 -74140516)
2012,Junio,Territorio Antártico Británico/Territorio Británico de Ultramar,2,4,,6,POINT (4697157 -74140516)
2012,Junio,Tanzania,1,5,,6,POINT (4697157 -74140516)
2012,Junio,Trinidad y Tobago,2,36,,38,POINT (10446304 -75516486)
2012,Junio,Trinidad y Tobago,0,2,,2,POINT (10886686 -74776479)
2012,Junio,Trinidad y Tobago,0,1,,1,POINT (125862 -81702165)
2012,Junio,Trinidad y Tobago,0,1,,1,POINT (3451668 -76532004)
2012,Junio,Trinidad y Tobago,12,61,,73,POINT (4697157 -74140516)
2012,Junio,Trinidad y Tobago,0,1,,1,POINT (4815189 -75736374)
2012,Junio,Trinidad y Tobago,4,11,,15,POINT (6170465 -7542726)
2012,Junio,Túnez,2,0,,2,POINT (3451668 -76532004)
2012,Junio,Túnez,0,4,,4,POINT (4697157 -74140516)
2012,Junio,Turquía,0,2,,2,POINT (0.81488 -77356)
2012,Junio,Turquía,0,1,,1,POINT (10406342 -75527794)
2012,Junio,Turquía,0,1,,1,POINT (10446304 -75516486)
2012,Junio,Turquía,0,3,,3,POINT (10886686 -74776479)
2012,Junio,Turquía,0,3,,3,POINT (10970933 -74765343)
2012,Junio,Turquía,0,3,,3,POINT (11360029 -72129595)
2012,Junio,Turquía,0,1,,1,POINT (3451668 -76532004)
2012,Junio,Turquía,16,71,,87,POINT (4697157 -74140516)
2012,Junio,Turquía,1,2,,3,POINT (6170465 -7542726)
2012,Junio,Ucrania,1,0,,1,POINT (3451668 -76532004)
2012,Junio,Ucrania,16,11,,27,POINT (4697157 -74140516)
2012,Junio,Uganda,1,3,,4,POINT (4697157 -74140516)
2012,Junio,Federación de Rusia,0,1,,1,POINT (0.81488 -77356)
2012,Junio,Federación de Rusia,1,1,,2,POINT (10446304 -75516486)
2012,Junio,Federación de Rusia,0,2,,2,POINT (10970933 -74765343)
2012,Junio,Federación de Rusia,0,3,,3,POINT (11247723 -74213989)
2012,Junio,Federación de Rusia,2,2,,4,POINT (11360029 -72129595)
2012,Junio,Federación de Rusia,78,97,,175,POINT (4697157 -74140516)
2012,Junio,Federación de Rusia,1,0,,1,POINT (6170465 -7542726)
2012,Junio,Federación de Rusia,3,3,,6,POINT (7819 -72453013)
2012,Junio,Federación de Rusia,1,0,,1,POINT (7927233 -72508188)
2012,Junio,Uruguay,3,8,,11,POINT (0.81488 -77356)
2012,Junio,Uruguay,84,71,,155,POINT (10446304 -75516486)
2012,Junio,Uruguay,0,5,,5,POINT (10886686 -74776479)
2012,Junio,Uruguay,1,0,,1,POINT (11360029 -72129595)
2012,Junio,Uruguay,69,47,,116,POINT (125862 -81702165)
2012,Junio,Uruguay,4,13,,17,POINT (3451668 -76532004)
2012,Junio,Uruguay,0,2,,2,POINT (445285 -75766353)
2012,Junio,Uruguay,144,303,,447,POINT (4697157 -74140516)
2012,Junio,Uruguay,0,10,,10,POINT (4815189 -75736374)
2012,Junio,Uruguay,14,45,,59,POINT (6170465 -7542726)
2012,Junio,Uruguay,5,6,,11,POINT (7819 -72453013)
2012,Junio,Vanuatu,0,1,,1,POINT (4697157 -74140516)
2012,Junio,Venezuela,32,69,,101,POINT (0.81488 -77356)
2012,Junio,Venezuela,0,27,,27,POINT (10406342 -75527794)
2012,Junio,Venezuela,80,122,,202,POINT (10446304 -75516486)
2012,Junio,Venezuela,40,97,,137,POINT (10886686 -74776479)
2012,Junio,Venezuela,0,2,,2,POINT (11247723 -74213989)
2012,Junio,Venezuela,1048,1561,,2609,POINT (11360029 -72129595)
2012,Junio,Venezuela,3,1,,4,POINT (1152863 -72919186)
2012,Junio,Venezuela,11,10,,21,POINT (125862 -81702165)
2012,Junio,Venezuela,39,50,,89,POINT (3451668 -76532004)
2012,Junio,Venezuela,3770,4979,,8749,POINT (4697157 -74140516)
2012,Junio,Venezuela,3,13,,16,POINT (4815189 -75736374)
2012,Junio,Venezuela,292,362,,654,POINT (6170465 -7542726)
2012,Junio,Venezuela,7,4,,11,POINT (6185536 -67484028)
2012,Junio,Venezuela,59,110,,169,POINT (7088729 -70740253)
2012,Junio,Venezuela,7,10,,17,POINT (7128047 -73181317)
2012,Junio,Venezuela,1018,1303,,2321,POINT (7819 -72453013)
2012,Junio,Venezuela,186,236,,422,POINT (7927233 -72508188)
2012,Junio,Vietnam,0,5,,5,POINT (10406342 -75527794)
2012,Junio,Vietnam,1,4,,5,POINT (4697157 -74140516)
2012,Junio,Islas Vírgenes Británicas/Territorio Británico de Ultramar,0,1,,1,POINT (4697157 -74140516)
2012,Junio,Zambia,0,6,,6,POINT (4697157 -74140516)
2012,Junio,Zimbabue,2,7,,9,POINT (4697157 -74140516)
2012,Junio,Reino Unido de Gran Bretaña e Irlanda del Norte,1,4,,5,POINT (-4191162 -69941498)
2012,Junio,Reino Unido de Gran Bretaña e Irlanda del Norte,50,44,,94,POINT (0.81488 -77356)
2012,Junio,Reino Unido de Gran Bretaña e Irlanda del Norte,11,17,,28,POINT (10406342 -75527794)
2012,Junio,Reino Unido de Gran Bretaña e Irlanda del Norte,7,24,,31,POINT (10446304 -75516486)
2012,Junio,Reino Unido de Gran Bretaña e Irlanda del Norte,2,3,,5,POINT (11360029 -72129595)
2012,Junio,Reino Unido de Gran Bretaña e Irlanda del Norte,0,1,,1,POINT (125862 -81702165)
2012,Junio,Reino Unido de Gran Bretaña e Irlanda del Norte,1,1,,2,POINT (133387613 -81372937)
2012,Junio,Reino Unido de Gran Bretaña e Irlanda del Norte,8,18,,26,POINT (3451668 -76532004)
2012,Junio,Reino Unido de Gran Bretaña e Irlanda del Norte,252,542,,794,POINT (4697157 -74140516)
2012,Junio,Reino Unido de Gran Bretaña e Irlanda del Norte,1,0,,1,POINT (4815189 -75736374)
2012,Junio,Reino Unido de Gran Bretaña e Irlanda del Norte,9,27,,36,POINT (6170465 -7542726)
2012,Junio,Reino Unido de Gran Bretaña e Irlanda del Norte,2,4,,6,POINT (7819 -72453013)
2012,Junio,Reino Unido de Gran Bretaña e Irlanda del Norte,0,1,,1,POINT (863337 -7735002)
2012,Junio,Países Bajos,0,3,,3,POINT (-4191162 -69941498)
2012,Junio,Países Bajos,15,22,,37,POINT (0.81488 -77356)
2012,Junio,Países Bajos,6,8,,14,POINT (10406342 -75527794)
2012,Junio,Países Bajos,4,24,,28,POINT (10446304 -75516486)
2012,Junio,Países Bajos,7,1,,8,POINT (10886686 -74776479)
2012,Junio,Países Bajos,0,14,,14,POINT (11247723 -74213989)
2012,Junio,Países Bajos,3,2,,5,POINT (11360029 -72129595)
2012,Junio,Países Bajos,18,45,,63,POINT (3451668 -76532004)
2012,Junio,Países Bajos,338,671,,1009,POINT (4697157 -74140516)
2012,Junio,Países Bajos,0,3,,3,POINT (4815189 -75736374)
2012,Junio,Países Bajos,64,85,,149,POINT (6170465 -7542726)
2012,Junio,Países Bajos,4,0,,4,POINT (7128047 -73181317)
2012,Junio,Países Bajos,4,5,,9,POINT (7819 -72453013)
2012,Junio,Países Bajos,1,0,,1,POINT (863337 -7735002)
2012,Junio,Eslovenia,1,0,,1,POINT (10446304 -75516486)
2012,Junio,Eslovenia,0,1,,1,POINT (4697157 -74140516)
2012,Junio,Lituania,0,1,,1,POINT (3451668 -76532004)
2012,Junio,Lituania,0,1,,1,POINT (4697157 -74140516)
2012,Junio,Lituania,0,1,,1,POINT (6170465 -7542726)
2012,Junio,Reino Unido de Gran Bretaña e Irlanda del Norte,1,1,,2,POINT (11247723 -74213989)
2012,Junio,Reino Unido de Gran Bretaña e Irlanda del Norte,0,1,,1,POINT (0.81488 -77356)
2012,Junio,Reino Unido de Gran Bretaña e Irlanda del Norte,1,0,,1,POINT (10446304 -75516486)
2012,Junio,Reino Unido de Gran Bretaña e Irlanda del Norte,7,7,,14,POINT (4697157 -74140516)
2012,Junio,Reino Unido de Gran Bretaña e Irlanda del Norte,1,0,,1,POINT (0.81488 -77356)
2012,Junio,Reino Unido de Gran Bretaña e Irlanda del Norte,2,1,,3,POINT (10406342 -75527794)
2012,Junio,Reino Unido de Gran Bretaña e Irlanda del Norte,0,1,,1,POINT (10446304 -75516486)
2012,Junio,Reino Unido de Gran Bretaña e Irlanda del Norte,4,3,,7,POINT (4697157 -74140516)
2012,Junio,República CentroÁfricana,0,1,,1,POINT (4697157 -74140516)
2012,Junio,República CentroÁfricana,0,1,,1,POINT (7819 -72453013)
2012,Julio,Albania,0,4,,4,POINT (4697157 -74140516)
2012,Julio,Alemania,12,14,,26,POINT (-4191162 -69941498)
2012,Julio,Alemania,78,97,,175,POINT (0.81488 -77356)
2012,Julio,Alemania,16,15,,31,POINT (10406342 -75527794)
2012,Julio,Alemania,22,48,,70,POINT (10446304 -75516486)
2012,Julio,Alemania,7,10,,17,POINT (10886686 -74776479)
2012,Julio,Alemania,5,12,,17,POINT (11360029 -72129595)
2012,Julio,Alemania,5,5,,10,POINT (125862 -81702165)
2012,Julio,Alemania,60,73,,133,POINT (3451668 -76532004)
2012,Julio,Alemania,1425,1967,,3392,POINT (4697157 -74140516)
2012,Julio,Alemania,0,3,,3,POINT (4815189 -75736374)
2012,Julio,Alemania,59,110,,169,POINT (6170465 -7542726)
2012,Julio,Alemania,1,0,,1,POINT (6222552 -77401154)
2012,Julio,Alemania,2,0,,2,POINT (7128047 -73181317)
2012,Julio,Alemania,10,16,,26,POINT (7819 -72453013)
2012,Julio,Alemania,1,1,,2,POINT (7927233 -72508188)
2012,Julio,Alemania,10,15,,25,POINT (863337 -7735002)
2012,Julio,Andorra,0,2,,2,POINT (3451668 -76532004)
2012,Julio,Andorra,0,8,,8,POINT (4697157 -74140516)
2012,Julio,Angola,0,1,,1,POINT (4697157 -74140516)
2012,Julio,Antigua y Barbuda,0,1,,1,POINT (11247723 -74213989)
2012,Julio,Antigua y Barbuda,0,1,,1,POINT (4697157 -74140516)
2012,Julio,Antigua y Barbuda,2,0,,2,POINT (6170465 -7542726)
2012,Julio,Países Bajos,14,9,,23,POINT (6170465 -7542726)
2012,Julio,Arabia Saudita,0,1,,1,POINT (10446304 -75516486)
2012,Julio,Arabia Saudita,2,1,,3,POINT (4697157 -74140516)
2012,Julio,Arabia Saudita,0,1,,1,POINT (4697157 -74140516)
2012,Julio,Argelia,0,1,,1,POINT (3451668 -76532004)
2012,Julio,Argelia,1,2,,3,POINT (4697157 -74140516)
2012,Julio,Argentina,1,12,,13,POINT (-4191162 -69941498)
2012,Julio,Argentina,2,3,,5,POINT (0.33002 -76876446)
2012,Julio,Argentina,61,121,,182,POINT (0.81488 -77356)
2012,Julio,Argentina,1,7,,8,POINT (10406342 -75527794)
2012,Julio,Argentina,411,362,,773,POINT (10446304 -75516486)
2012,Julio,Argentina,4,18,,22,POINT (10886686 -74776479)
2012,Julio,Argentina,1,1,,2,POINT (11247723 -74213989)
2012,Julio,Argentina,17,16,,33,POINT (11360029 -72129595)
2012,Julio,Argentina,180,135,,315,POINT (125862 -81702165)
2012,Julio,Argentina,46,76,,122,POINT (3451668 -76532004)
2012,Julio,Argentina,0,3,,3,POINT (445285 -75766353)
2012,Julio,Argentina,2875,4287,,7162,POINT (4697157 -74140516)
2012,Julio,Argentina,0,1,,1,POINT (4815189 -75736374)
2012,Julio,Argentina,112,163,,275,POINT (6170465 -7542726)
2012,Julio,Argentina,0,2,,2,POINT (6185536 -67484028)
2012,Julio,Argentina,3,17,,20,POINT (7128047 -73181317)
2012,Julio,Argentina,21,53,,74,POINT (7819 -72453013)
2012,Julio,Argentina,1,8,,9,POINT (7927233 -72508188)
2012,Julio,Argentina,5,10,,15,POINT (863337 -7735002)
2012,Julio,Aruba,1,0,,1,POINT (10886686 -74776479)
2012,Julio,Aruba,0,1,,1,POINT (3451668 -76532004)
2012,Julio,Aruba,1,4,,5,POINT (4697157 -74140516)
2012,Julio,Aruba,4,3,,7,POINT (6170465 -7542726)
2012,Julio,Australia,3,6,,9,POINT (-4191162 -69941498)
2012,Julio,Australia,44,57,,101,POINT (0.81488 -77356)
2012,Julio,Australia,17,18,,35,POINT (10406342 -75527794)
2012,Julio,Australia,24,38,,62,POINT (10446304 -75516486)
2012,Julio,Australia,3,9,,12,POINT (10886686 -74776479)
2012,Julio,Australia,0,1,,1,POINT (11247723 -74213989)
2012,Julio,Australia,1,3,,4,POINT (11360029 -72129595)
2012,Julio,Australia,0,1,,1,POINT (133387613 -81372937)
2012,Julio,Australia,9,18,,27,POINT (3451668 -76532004)
2012,Julio,Australia,216,355,,571,POINT (4697157 -74140516)
2012,Julio,Australia,0,1,,1,POINT (4815189 -75736374)
2012,Julio,Australia,26,32,,58,POINT (6170465 -7542726)
2012,Julio,Australia,0,1,,1,POINT (7128047 -73181317)
2012,Julio,Australia,2,3,,5,POINT (7819 -72453013)
2012,Julio,Australia,0,1,,1,POINT (7927233 -72508188)
2012,Julio,Australia,4,4,,8,POINT (863337 -7735002)
2012,Julio,Austria,1,2,,3,POINT (-4191162 -69941498)
2012,Julio,Austria,7,14,,21,POINT (0.81488 -77356)
2012,Julio,Austria,4,5,,9,POINT (10406342 -75527794)
2012,Julio,Austria,8,10,,18,POINT (10446304 -75516486)
2012,Julio,Austria,3,7,,10,POINT (11360029 -72129595)
2012,Julio,Austria,2,16,,18,POINT (3451668 -76532004)
2012,Julio,Austria,169,269,,438,POINT (4697157 -74140516)
2012,Julio,Austria,3,6,,9,POINT (6170465 -7542726)
2012,Julio,Austria,0,3,,3,POINT (7819 -72453013)
2012,Julio,Austria,0,3,,3,POINT (863337 -7735002)
2012,Julio,Azerbaiyán,7,20,,27,POINT (4697157 -74140516)
2012,Julio,Bahamas,0,1,,1,POINT (10886686 -74776479)
2012,Julio,Bahamas,1,1,,2,POINT (3451668 -76532004)
2012,Julio,Bahamas,4,6,,10,POINT (4697157 -74140516)
2012,Julio,Bahamas,2,1,,3,POINT (6170465 -7542726)
2012,Julio,Bahamas,0,1,,1,POINT (7927233 -72508188)
2012,Julio,Bangladesh,0,1,,1,POINT (11360029 -72129595)
2012,Julio,Barbados,0,1,,1,POINT (3451668 -76532004)
2012,Julio,Barbados,5,1,,6,POINT (4697157 -74140516)
2012,Julio,Barbados,1,1,,2,POINT (6170465 -7542726)
2012,Julio,Barbados,1,2,,3,POINT (7819 -72453013)
2012,Julio,República de Belarús,0,1,,1,POINT (4697157 -74140516)
2012,Julio,República de Belarús,0,1,,1,POINT (6170465 -7542726)
2012,Julio,Bélgica,2,3,,5,POINT (-4191162 -69941498)
2012,Julio,Bélgica,1,0,,1,POINT (0.33002 -76876446)
2012,Julio,Bélgica,7,16,,23,POINT (0.81488 -77356)
2012,Julio,Bélgica,1,2,,3,POINT (10406342 -75527794)
2012,Julio,Bélgica,8,8,,16,POINT (10446304 -75516486)
2012,Julio,Bélgica,2,3,,5,POINT (10886686 -74776479)
2012,Julio,Bélgica,1,2,,3,POINT (11360029 -72129595)
2012,Julio,Bélgica,1,1,,2,POINT (125862 -81702165)
2012,Julio,Bélgica,12,24,,36,POINT (3451668 -76532004)
2012,Julio,Bélgica,225,390,,615,POINT (4697157 -74140516)
2012,Julio,Bélgica,7,18,,25,POINT (6170465 -7542726)
2012,Julio,Bélgica,3,2,,5,POINT (7819 -72453013)
2012,Julio,Bélgica,0,2,,2,POINT (863337 -7735002)
2012,Julio,Belice,0,1,,1,POINT (-4191162 -69941498)
2012,Julio,Belice,1,0,,1,POINT (0.81488 -77356)
2012,Julio,Belice,1,1,,2,POINT (10446304 -75516486)
2012,Julio,Belice,1,1,,2,POINT (3451668 -76532004)
2012,Julio,Belice,2,13,,15,POINT (4697157 -74140516)
2012,Julio,Belice,1,1,,2,POINT (6170465 -7542726)
2012,Julio,Bermudas/Territorio Británico de Ultramar,0,1,,1,POINT (3451668 -76532004)
2012,Julio,Bermudas/Territorio Británico de Ultramar,0,1,,1,POINT (4697157 -74140516)
2012,Julio,Bermudas/Territorio Británico de Ultramar,0,1,,1,POINT (6170465 -7542726)
2012,Julio,Bolivia,1,1,,2,POINT (-4191162 -69941498)
2012,Julio,Bolivia,13,22,,35,POINT (0.81488 -77356)
2012,Julio,Bolivia,6,4,,10,POINT (10446304 -75516486)
2012,Julio,Bolivia,3,1,,4,POINT (10886686 -74776479)
2012,Julio,Bolivia,1,8,,9,POINT (11360029 -72129595)
2012,Julio,Bolivia,4,5,,9,POINT (125862 -81702165)
2012,Julio,Bolivia,16,17,,33,POINT (3451668 -76532004)
2012,Julio,Bolivia,1,0,,1,POINT (445285 -75766353)
2012,Julio,Bolivia,307,409,,716,POINT (4697157 -74140516)
2012,Julio,Bolivia,10,20,,30,POINT (6170465 -7542726)
2012,Julio,Bolivia,8,14,,22,POINT (7819 -72453013)
2012,Julio,Bolivia,1,0,,1,POINT (863337 -7735002)
2012,Julio,Bosnia y Herzegovina,1,0,,1,POINT (11360029 -72129595)
2012,Julio,Bosnia y Herzegovina,0,2,,2,POINT (4697157 -74140516)
2012,Julio,Brasil,76,74,,150,POINT (-4191162 -69941498)
2012,Julio,Brasil,19,31,,50,POINT (0.81488 -77356)
2012,Julio,Brasil,124,130,,254,POINT (10446304 -75516486)
2012,Julio,Brasil,17,19,,36,POINT (10886686 -74776479)
2012,Julio,Brasil,12,16,,28,POINT (11360029 -72129595)
2012,Julio,Brasil,25,12,,37,POINT (125862 -81702165)
2012,Julio,Brasil,40,78,,118,POINT (3451668 -76532004)
2012,Julio,Brasil,3215,4416,,7631,POINT (4697157 -74140516)
2012,Julio,Brasil,3,4,,7,POINT (4815189 -75736374)
2012,Julio,Brasil,42,83,,125,POINT (6170465 -7542726)
2012,Julio,Brasil,0,5,,5,POINT (6185536 -67484028)
2012,Julio,Brasil,1,1,,2,POINT (7128047 -73181317)
2012,Julio,Brasil,14,22,,36,POINT (7819 -72453013)
2012,Julio,Brasil,1,2,,3,POINT (7927233 -72508188)
2012,Julio,Bulgaria,0,1,,1,POINT (10406342 -75527794)
2012,Julio,Bulgaria,0,1,,1,POINT (3451668 -76532004)
2012,Julio,Bulgaria,7,3,,10,POINT (4697157 -74140516)
2012,Julio,Bulgaria,1,1,,2,POINT (6170465 -7542726)
2012,Julio,Bulgaria,1,0,,1,POINT (7819 -72453013)
2012,Julio,Bulgaria,0,1,,1,POINT (863337 -7735002)
2012,Julio,Burkina Faso,1,0,,1,POINT (0.81488 -77356)
2012,Julio,Islas Caimán/Territorio Británico de Ultramar,4,10,,14,POINT (125862 -81702165)
2012,Julio,Camerún,0,1,,1,POINT (4697157 -74140516)
2012,Julio,Canadá,5,7,,12,POINT (-4191162 -69941498)
2012,Julio,Canadá,33,27,,60,POINT (0.81488 -77356)
2012,Julio,Canadá,7,9,,16,POINT (10406342 -75527794)
2012,Julio,Canadá,52,81,,133,POINT (10446304 -75516486)
2012,Julio,Canadá,12,21,,33,POINT (10886686 -74776479)
2012,Julio,Canadá,0,1,,1,POINT (11247723 -74213989)
2012,Julio,Canadá,6,7,,13,POINT (11360029 -72129595)
2012,Julio,Canadá,7,4,,11,POINT (125862 -81702165)
2012,Julio,Canadá,1,4,,5,POINT (133387613 -81372937)
2012,Julio,Canadá,48,43,,91,POINT (3451668 -76532004)
2012,Julio,Canadá,4,7,,11,POINT (445285 -75766353)
2012,Julio,Canadá,1052,1700,,2752,POINT (4697157 -74140516)
2012,Julio,Canadá,1,4,,5,POINT (4815189 -75736374)
2012,Julio,Canadá,108,158,,266,POINT (6170465 -7542726)
2012,Julio,Canadá,1,4,,5,POINT (7128047 -73181317)
2012,Julio,Canadá,6,10,,16,POINT (7819 -72453013)
2012,Julio,Canadá,1,3,,4,POINT (7927233 -72508188)
2012,Julio,Canadá,10,3,,13,POINT (863337 -7735002)
2012,Julio,España,8,16,,24,POINT (0.81488 -77356)
2012,Julio,España,0,1,,1,POINT (10406342 -75527794)
2012,Julio,España,3,14,,17,POINT (10446304 -75516486)
2012,Julio,España,4,10,,14,POINT (10886686 -74776479)
2012,Julio,España,0,1,,1,POINT (133387613 -81372937)
2012,Julio,España,96,145,,241,POINT (3451668 -76532004)
2012,Julio,España,186,390,,576,POINT (4697157 -74140516)
2012,Julio,España,1,9,,10,POINT (4815189 -75736374)
2012,Julio,España,56,98,,154,POINT (6170465 -7542726)
2012,Julio,España,0,1,,1,POINT (7128047 -73181317)
2012,Julio,España,1,0,,1,POINT (7819 -72453013)
2012,Julio,España,4,0,,4,POINT (7927233 -72508188)
2012,Julio,República Democrática del Congo,1,0,,1,POINT (0.81488 -77356)
2012,Julio,República Democrática del Congo,1,1,,2,POINT (4697157 -74140516)
2012,Julio,República de Corea,2,2,,4,POINT (-4191162 -69941498)
2012,Julio,República de Corea,6,4,,10,POINT (0.81488 -77356)
2012,Julio,República de Corea,3,5,,8,POINT (10446304 -75516486)
2012,Julio,República de Corea,3,5,,8,POINT (10886686 -74776479)
2012,Julio,República de Corea,1,3,,4,POINT (3451668 -76532004)
2012,Julio,República de Corea,114,354,,468,POINT (4697157 -74140516)
2012,Julio,República de Corea,0,2,,2,POINT (4815189 -75736374)
2012,Julio,República de Corea,2,14,,16,POINT (6170465 -7542726)
2012,Julio,República de Corea,1,2,,3,POINT (7819 -72453013)
2012,Julio,República de Corea,0,1,,1,POINT (863337 -7735002)
2012,Julio,Costa Rica,0,1,,1,POINT (0.81488 -77356)
2012,Julio,Costa Rica,0,1,,1,POINT (10406342 -75527794)
2012,Julio,Costa Rica,52,53,,105,POINT (10446304 -75516486)
2012,Julio,Costa Rica,7,18,,25,POINT (10886686 -74776479)
2012,Julio,Costa Rica,314,221,,535,POINT (125862 -81702165)
2012,Julio,Costa Rica,34,55,,89,POINT (3451668 -76532004)
2012,Julio,Costa Rica,434,701,,1135,POINT (4697157 -74140516)
2012,Julio,Costa Rica,0,2,,2,POINT (4815189 -75736374)
2012,Julio,Costa Rica,117,164,,281,POINT (6170465 -7542726)
2012,Julio,Costa Rica,0,1,,1,POINT (7128047 -73181317)
2012,Julio,Costa Rica,1,2,,3,POINT (7819 -72453013)
2012,Julio,Costa Rica,2,0,,2,POINT (7927233 -72508188)
2012,Julio,Costa Rica,0,1,,1,POINT (863337 -7735002)
2012,Julio,Croacia,3,1,,4,POINT (10446304 -75516486)
2012,Julio,Croacia,0,1,,1,POINT (10886686 -74776479)
2012,Julio,Croacia,4,28,,32,POINT (4697157 -74140516)
2012,Julio,Croacia,1,0,,1,POINT (7819 -72453013)
2012,Julio,Cuba,1,0,,1,POINT (0.81488 -77356)
2012,Julio,Cuba,1,1,,2,POINT (10406342 -75527794)
2012,Julio,Cuba,11,18,,29,POINT (10446304 -75516486)
2012,Julio,Cuba,4,20,,24,POINT (10886686 -74776479)
2012,Julio,Cuba,0,1,,1,POINT (11360029 -72129595)
2012,Julio,Cuba,16,37,,53,POINT (3451668 -76532004)
2012,Julio,Cuba,88,158,,246,POINT (4697157 -74140516)
2012,Julio,Cuba,0,3,,3,POINT (4815189 -75736374)
2012,Julio,Cuba,16,34,,50,POINT (6170465 -7542726)
2012,Julio,Cuba,3,3,,6,POINT (7128047 -73181317)
2012,Julio,Cuba,1,5,,6,POINT (7819 -72453013)
2012,Julio,Cuba,1,2,,3,POINT (7927233 -72508188)
2012,Julio,Curazao,2,6,,8,POINT (4697157 -74140516)
2012,Julio,Curazao,5,6,,11,POINT (6170465 -7542726)
2012,Julio,República Checa,3,2,,5,POINT (0.81488 -77356)
2012,Julio,República Checa,1,1,,2,POINT (10446304 -75516486)
2012,Julio,República Checa,2,0,,2,POINT (3451668 -76532004)
2012,Julio,República Checa,17,41,,58,POINT (4697157 -74140516)
2012,Julio,República Checa,0,2,,2,POINT (6170465 -7542726)
2012,Julio,República Checa,3,0,,3,POINT (7819 -72453013)
2012,Julio,República Checa,0,1,,1,POINT (863337 -7735002)
2012,Julio,Chile,1,3,,4,POINT (-4191162 -69941498)
2012,Julio,Chile,0,3,,3,POINT (0.33002 -76876446)
2012,Julio,Chile,27,62,,89,POINT (0.81488 -77356)
2012,Julio,Chile,0,1,,1,POINT (10406342 -75527794)
2012,Julio,Chile,159,137,,296,POINT (10446304 -75516486)
2012,Julio,Chile,18,20,,38,POINT (10886686 -74776479)
2012,Julio,Chile,4,8,,12,POINT (11360029 -72129595)
2012,Julio,Chile,0,1,,1,POINT (1152863 -72919186)
2012,Julio,Chile,92,60,,152,POINT (125862 -81702165)
2012,Julio,Chile,51,73,,124,POINT (3451668 -76532004)
2012,Julio,Chile,0,1,,1,POINT (445285 -75766353)
2012,Julio,Chile,2328,3166,,5494,POINT (4697157 -74140516)
2012,Julio,Chile,1,1,,2,POINT (4815189 -75736374)
2012,Julio,Chile,56,117,,173,POINT (6170465 -7542726)
2012,Julio,Chile,11,13,,24,POINT (7819 -72453013)
2012,Julio,Chile,0,3,,3,POINT (863337 -7735002)
2012,Julio,China,1,3,,4,POINT (0.81488 -77356)
2012,Julio,China,2,0,,2,POINT (10446304 -75516486)
2012,Julio,China,0,2,,2,POINT (10886686 -74776479)
2012,Julio,China,0,2,,2,POINT (11360029 -72129595)
2012,Julio,China,6,10,,16,POINT (3451668 -76532004)
2012,Julio,China,146,367,,513,POINT (4697157 -74140516)
2012,Julio,China,0,2,,2,POINT (4815189 -75736374)
2012,Julio,China,4,10,,14,POINT (6170465 -7542726)
2012,Julio,China,0,2,,2,POINT (7819 -72453013)
2012,Julio,Taiwán,0,1,,1,POINT (-4191162 -69941498)
2012,Julio,Taiwán,1,1,,2,POINT (0.81488 -77356)
2012,Julio,Taiwán,3,4,,7,POINT (10446304 -75516486)
2012,Julio,Taiwán,1,1,,2,POINT (10886686 -74776479)
2012,Julio,Taiwán,2,1,,3,POINT (3451668 -76532004)
2012,Julio,Taiwán,21,39,,60,POINT (4697157 -74140516)
2012,Julio,Taiwán,1,2,,3,POINT (4815189 -75736374)
2012,Julio,Taiwán,3,8,,11,POINT (6170465 -7542726)
2012,Julio,Taiwán,2,1,,3,POINT (7819 -72453013)
2012,Julio,Chipre,0,1,,1,POINT (10406342 -75527794)
2012,Julio,Chipre,2,0,,2,POINT (3451668 -76532004)
2012,Julio,Chipre,3,0,,3,POINT (4697157 -74140516)
2012,Julio,Dinamarca,2,0,,2,POINT (-4191162 -69941498)
2012,Julio,Dinamarca,0,2,,2,POINT (0.33002 -76876446)
2012,Julio,Dinamarca,7,5,,12,POINT (0.81488 -77356)
2012,Julio,Dinamarca,4,8,,12,POINT (10406342 -75527794)
2012,Julio,Dinamarca,2,9,,11,POINT (10446304 -75516486)
2012,Julio,Dinamarca,1,0,,1,POINT (10886686 -74776479)
2012,Julio,Dinamarca,0,4,,4,POINT (11247723 -74213989)
2012,Julio,Dinamarca,0,1,,1,POINT (11360029 -72129595)
2012,Julio,Dinamarca,0,2,,2,POINT (125862 -81702165)
2012,Julio,Dinamarca,2,8,,10,POINT (3451668 -76532004)
2012,Julio,Dinamarca,107,146,,253,POINT (4697157 -74140516)
2012,Julio,Dinamarca,0,1,,1,POINT (4815189 -75736374)
2012,Julio,Dinamarca,5,10,,15,POINT (6170465 -7542726)
2012,Julio,Dinamarca,2,0,,2,POINT (7128047 -73181317)
2012,Julio,Dinamarca,2,1,,3,POINT (7819 -72453013)
2012,Julio,Dinamarca,0,1,,1,POINT (863337 -7735002)
2012,Julio,Dominica,0,1,,1,POINT (11360029 -72129595)
2012,Julio,Dominica,2,2,,4,POINT (4697157 -74140516)
2012,Julio,Dominica,1,0,,1,POINT (6170465 -7542726)
2012,Julio,Dominica,1,0,,1,POINT (7819 -72453013)
2012,Julio,Ecuador,0,2,,2,POINT (-4191162 -69941498)
2012,Julio,Ecuador,32,47,,79,POINT (0.33002 -76876446)
2012,Julio,Ecuador,1792,2083,,3875,POINT (0.81488 -77356)
2012,Julio,Ecuador,1,105,,106,POINT (1800143 -78802679)
2012,Julio,Ecuador,0,44,,44,POINT (10406342 -75527794)
2012,Julio,Ecuador,266,273,,539,POINT (10446304 -75516486)
2012,Julio,Ecuador,4,7,,11,POINT (10886686 -74776479)
2012,Julio,Ecuador,21,32,,53,POINT (11360029 -72129595)
2012,Julio,Ecuador,253,200,,453,POINT (125862 -81702165)
2012,Julio,Ecuador,330,392,,722,POINT (3451668 -76532004)
2012,Julio,Ecuador,0,4,,4,POINT (3884426 -77061029)
2012,Julio,Ecuador,0,2,,2,POINT (445285 -75766353)
2012,Julio,Ecuador,1883,2982,,4865,POINT (4697157 -74140516)
2012,Julio,Ecuador,0,8,,8,POINT (4815189 -75736374)
2012,Julio,Ecuador,462,557,,1019,POINT (6170465 -7542726)
2012,Julio,Ecuador,2,11,,13,POINT (7128047 -73181317)
2012,Julio,Ecuador,125,249,,374,POINT (7819 -72453013)
2012,Julio,Ecuador,3,53,,56,POINT (7927233 -72508188)
2012,Julio,Ecuador,1,1,,2,POINT (863337 -7735002)
2012,Julio,Egipto,0,1,,1,POINT (10446304 -75516486)
2012,Julio,Egipto,5,23,,28,POINT (4697157 -74140516)
2012,Julio,Egipto,1,0,,1,POINT (6170465 -7542726)
2012,Julio,El Salvador,1,1,,2,POINT (0.81488 -77356)
2012,Julio,El Salvador,8,19,,27,POINT (10446304 -75516486)
2012,Julio,El Salvador,3,3,,6,POINT (10886686 -74776479)
2012,Julio,El Salvador,0,1,,1,POINT (125862 -81702165)
2012,Julio,El Salvador,44,60,,104,POINT (3451668 -76532004)
2012,Julio,El Salvador,350,524,,874,POINT (4697157 -74140516)
2012,Julio,El Salvador,0,1,,1,POINT (4815189 -75736374)
2012,Julio,El Salvador,29,31,,60,POINT (6170465 -7542726)
2012,Julio,El Salvador,0,3,,3,POINT (7128047 -73181317)
2012,Julio,El Salvador,0,1,,1,POINT (7819 -72453013)
2012,Julio,Emiratos Árabes,6,8,,14,POINT (4697157 -74140516)
2012,Julio,España,13,10,,23,POINT (-4191162 -69941498)
2012,Julio,España,1,2,,3,POINT (0.33002 -76876446)
2012,Julio,España,22,35,,57,POINT (0.81488 -77356)
2012,Julio,España,0,10,,10,POINT (10406342 -75527794)
2012,Julio,España,30,68,,98,POINT (10446304 -75516486)
2012,Julio,España,2,8,,10,POINT (10886686 -74776479)
2012,Julio,España,3,12,,15,POINT (11360029 -72129595)
2012,Julio,España,11,4,,15,POINT (125862 -81702165)
2012,Julio,España,216,386,,602,POINT (3451668 -76532004)
2012,Julio,España,0,1,,1,POINT (445285 -75766353)
2012,Julio,España,1805,3758,,5563,POINT (4697157 -74140516)
2012,Julio,España,0,5,,5,POINT (4815189 -75736374)
2012,Julio,España,115,222,,337,POINT (6170465 -7542726)
2012,Julio,España,1,4,,5,POINT (7128047 -73181317)
2012,Julio,España,29,39,,68,POINT (7819 -72453013)
2012,Julio,España,0,1,,1,POINT (7927233 -72508188)
2012,Julio,España,1,10,,11,POINT (863337 -7735002)
2012,Julio,Eslovaquia,0,1,,1,POINT (-4191162 -69941498)
2012,Julio,Eslovaquia,2,1,,3,POINT (0.81488 -77356)
2012,Julio,Eslovaquia,1,1,,2,POINT (3451668 -76532004)
2012,Julio,Eslovaquia,16,5,,21,POINT (4697157 -74140516)
2012,Julio,Eslovenia,2,0,,2,POINT (0.81488 -77356)
2012,Julio,Eslovenia,0,2,,2,POINT (10406342 -75527794)
2012,Julio,Eslovenia,0,2,,2,POINT (10446304 -75516486)
2012,Julio,Eslovenia,4,0,,4,POINT (11360029 -72129595)
2012,Julio,Eslovenia,1,0,,1,POINT (125862 -81702165)
2012,Julio,Eslovenia,1,1,,2,POINT (133387613 -81372937)
2012,Julio,Eslovenia,0,3,,3,POINT (3451668 -76532004)
2012,Julio,Eslovenia,22,17,,39,POINT (4697157 -74140516)
2012,Julio,Eslovenia,1,0,,1,POINT (6170465 -7542726)
2012,Julio,Eslovenia,1,1,,2,POINT (7819 -72453013)
2012,Julio,Estados Unidos de América,15,27,,42,POINT (-4191162 -69941498)
2012,Julio,Estados Unidos de América,0,4,,4,POINT (0.33002 -76876446)
2012,Julio,Estados Unidos de América,83,124,,207,POINT (0.81488 -77356)
2012,Julio,Estados Unidos de América,0,1,,1,POINT (1800143 -78802679)
2012,Julio,Estados Unidos de América,17,32,,49,POINT (10406342 -75527794)
2012,Julio,Estados Unidos de América,1175,1881,,3056,POINT (10446304 -75516486)
2012,Julio,Estados Unidos de América,428,552,,980,POINT (10886686 -74776479)
2012,Julio,Estados Unidos de América,0,1,,1,POINT (10970933 -74765343)
2012,Julio,Estados Unidos de América,0,1,,1,POINT (11117206 -74232675)
2012,Julio,Estados Unidos de América,1,3,,4,POINT (11247723 -74213989)
2012,Julio,Estados Unidos de América,11,19,,30,POINT (11360029 -72129595)
2012,Julio,Estados Unidos de América,0,1,,1,POINT (125744111 -81703935)
2012,Julio,Estados Unidos de América,33,62,,95,POINT (125862 -81702165)
2012,Julio,Estados Unidos de América,4,3,,7,POINT (133387613 -81372937)
2012,Julio,Estados Unidos de América,1350,1680,,3030,POINT (3451668 -76532004)
2012,Julio,Estados Unidos de América,0,1,,1,POINT (3884426 -77061029)
2012,Julio,Estados Unidos de América,141,151,,292,POINT (445285 -75766353)
2012,Julio,Estados Unidos de América,7668,12523,,20191,POINT (4697157 -74140516)
2012,Julio,Estados Unidos de América,125,143,,268,POINT (4815189 -75736374)
2012,Julio,Estados Unidos de América,1796,2985,,4781,POINT (6170465 -7542726)
2012,Julio,Estados Unidos de América,1,0,,1,POINT (6185536 -67484028)
2012,Julio,Estados Unidos de América,1,4,,5,POINT (7088729 -70740253)
2012,Julio,Estados Unidos de América,34,58,,92,POINT (7128047 -73181317)
2012,Julio,Estados Unidos de América,23,70,,93,POINT (7819 -72453013)
2012,Julio,Estados Unidos de América,27,29,,56,POINT (7927233 -72508188)
2012,Julio,Estados Unidos de América,4,6,,10,POINT (863337 -7735002)
2012,Julio,Estados Unidos de América,0,1,,1,POINT (9402597 -75681642)
2012,Julio,Estonia,1,0,,1,POINT (0.81488 -77356)
2012,Julio,Estonia,2,0,,2,POINT (4697157 -74140516)
2012,Julio,Estonia,1,1,,2,POINT (6170465 -7542726)
2012,Julio,Estonia,1,0,,1,POINT (7819 -72453013)
2012,Julio,Etiopia,3,3,,6,POINT (4697157 -74140516)
2012,Julio,Filipinas,0,36,,36,POINT (10406342 -75527794)
2012,Julio,Filipinas,1,13,,14,POINT (10446304 -75516486)
2012,Julio,Filipinas,0,8,,8,POINT (10886686 -74776479)
2012,Julio,Filipinas,0,10,,10,POINT (10970933 -74765343)
2012,Julio,Filipinas,0,3,,3,POINT (11247723 -74213989)
2012,Julio,Filipinas,3,4,,7,POINT (3451668 -76532004)
2012,Julio,Filipinas,0,17,,17,POINT (3884426 -77061029)
2012,Julio,Filipinas,19,30,,49,POINT (4697157 -74140516)
2012,Julio,Filipinas,1,4,,5,POINT (6170465 -7542726)
2012,Julio,Filipinas,0,4,,4,POINT (9402597 -75681642)
2012,Julio,Finlandia,0,2,,2,POINT (-4191162 -69941498)
2012,Julio,Finlandia,2,2,,4,POINT (0.81488 -77356)
2012,Julio,Finlandia,1,2,,3,POINT (10446304 -75516486)
2012,Julio,Finlandia,1,1,,2,POINT (3451668 -76532004)
2012,Julio,Finlandia,33,52,,85,POINT (4697157 -74140516)
2012,Julio,Finlandia,1,1,,2,POINT (6170465 -7542726)
2012,Julio,Finlandia,1,1,,2,POINT (7819 -72453013)
2012,Julio,Finlandia,1,1,,2,POINT (863337 -7735002)
2012,Julio,Francia,12,12,,24,POINT (-4191162 -69941498)
2012,Julio,Francia,2,1,,3,POINT (0.33002 -76876446)
2012,Julio,Francia,61,73,,134,POINT (0.81488 -77356)
2012,Julio,Francia,4,18,,22,POINT (10406342 -75527794)
2012,Julio,Francia,31,47,,78,POINT (10446304 -75516486)
2012,Julio,Francia,3,13,,16,POINT (10886686 -74776479)
2012,Julio,Francia,5,4,,9,POINT (11247723 -74213989)
2012,Julio,Francia,17,25,,42,POINT (11360029 -72129595)
2012,Julio,Francia,50,104,,154,POINT (3451668 -76532004)
2012,Julio,Francia,0,1,,1,POINT (445285 -75766353)
2012,Julio,Francia,1483,2272,,3755,POINT (4697157 -74140516)
2012,Julio,Francia,0,1,,1,POINT (4815189 -75736374)
2012,Julio,Francia,50,85,,135,POINT (6170465 -7542726)
2012,Julio,Francia,0,1,,1,POINT (7088729 -70740253)
2012,Julio,Francia,0,1,,1,POINT (7128047 -73181317)
2012,Julio,Francia,10,28,,38,POINT (7819 -72453013)
2012,Julio,Francia,1,3,,4,POINT (7927233 -72508188)
2012,Julio,Francia,4,10,,14,POINT (863337 -7735002)
2012,Julio,Gabón,1,0,,1,POINT (4697157 -74140516)
2012,Julio,Georgia,0,1,,1,POINT (10446304 -75516486)
2012,Julio,Georgia,3,5,,8,POINT (4697157 -74140516)
2012,Julio,Ghana,0,1,,1,POINT (11360029 -72129595)
2012,Julio,Ghana,1,2,,3,POINT (4697157 -74140516)
2012,Julio,Ghana,0,1,,1,POINT (7819 -72453013)
2012,Julio,Granada,0,1,,1,POINT (11360029 -72129595)
2012,Julio,Granada,1,0,,1,POINT (6170465 -7542726)
2012,Julio,Grecia,2,1,,3,POINT (0.81488 -77356)
2012,Julio,Grecia,0,1,,1,POINT (10406342 -75527794)
2012,Julio,Grecia,1,6,,7,POINT (10446304 -75516486)
2012,Julio,Grecia,0,1,,1,POINT (10886686 -74776479)
2012,Julio,Grecia,0,1,,1,POINT (10970933 -74765343)
2012,Julio,Grecia,1,0,,1,POINT (11360029 -72129595)
2012,Julio,Grecia,0,5,,5,POINT (3451668 -76532004)
2012,Julio,Grecia,21,34,,55,POINT (4697157 -74140516)
2012,Julio,Grecia,2,4,,6,POINT (6170465 -7542726)
2012,Julio,Grecia,0,1,,1,POINT (7819 -72453013)
2012,Julio,Grecia,0,1,,1,POINT (9402597 -75681642)
2012,Julio,Guatemala,0,1,,1,POINT (-4191162 -69941498)
2012,Julio,Guatemala,0,4,,4,POINT (0.81488 -77356)
2012,Julio,Guatemala,0,3,,3,POINT (10406342 -75527794)
2012,Julio,Guatemala,14,24,,38,POINT (10446304 -75516486)
2012,Julio,Guatemala,3,11,,14,POINT (10886686 -74776479)
2012,Julio,Guatemala,0,1,,1,POINT (11117206 -74232675)
2012,Julio,Guatemala,1,2,,3,POINT (11360029 -72129595)
2012,Julio,Guatemala,3,3,,6,POINT (125862 -81702165)
2012,Julio,Guatemala,10,70,,80,POINT (3451668 -76532004)
2012,Julio,Guatemala,148,329,,477,POINT (4697157 -74140516)
2012,Julio,Guatemala,0,8,,8,POINT (4815189 -75736374)
2012,Julio,Guatemala,45,78,,123,POINT (6170465 -7542726)
2012,Julio,Guatemala,1,0,,1,POINT (6222552 -77401154)
2012,Julio,Guatemala,2,2,,4,POINT (7128047 -73181317)
2012,Julio,Guatemala,18,15,,33,POINT (7819 -72453013)
2012,Julio,Guatemala,1,0,,1,POINT (863337 -7735002)
2012,Julio,Guyana,0,1,,1,POINT (0.81488 -77356)
2012,Julio,Guyana,0,1,,1,POINT (10446304 -75516486)
2012,Julio,Guyana,0,1,,1,POINT (3451668 -76532004)
2012,Julio,Guyana,2,4,,6,POINT (4697157 -74140516)
2012,Julio,Guyana,0,1,,1,POINT (6170465 -7542726)
2012,Julio,Guyana,0,1,,1,POINT (7819 -72453013)
2012,Julio,Guinea Ecuatorial,1,0,,1,POINT (4697157 -74140516)
2012,Julio,Guayana Francesa/Departamento de Ultramar Francés,0,1,,1,POINT (4697157 -74140516)
2012,Julio,Haití,1,1,,2,POINT (0.81488 -77356)
2012,Julio,Haití,1,0,,1,POINT (10886686 -74776479)
2012,Julio,Haití,0,3,,3,POINT (3451668 -76532004)
2012,Julio,Haití,1,11,,12,POINT (4697157 -74140516)
2012,Julio,Honduras,0,5,,5,POINT (0.81488 -77356)
2012,Julio,Honduras,0,9,,9,POINT (10406342 -75527794)
2012,Julio,Honduras,7,13,,20,POINT (10446304 -75516486)
2012,Julio,Honduras,12,14,,26,POINT (10886686 -74776479)
2012,Julio,Honduras,3,131,,134,POINT (125744111 -81703935)
2012,Julio,Honduras,1,1,,2,POINT (133387613 -81372937)
2012,Julio,Honduras,18,17,,35,POINT (3451668 -76532004)
2012,Julio,Honduras,118,185,,303,POINT (4697157 -74140516)
2012,Julio,Honduras,15,5,,20,POINT (4815189 -75736374)
2012,Julio,Honduras,30,30,,60,POINT (6170465 -7542726)
2012,Julio,Honduras,0,1,,1,POINT (6222552 -77401154)
2012,Julio,Honduras,1,0,,1,POINT (863337 -7735002)
2012,Julio,Hungría,0,2,,2,POINT (0.81488 -77356)
2012,Julio,Hungría,0,3,,3,POINT (10446304 -75516486)
2012,Julio,Hungría,1,2,,3,POINT (11360029 -72129595)
2012,Julio,Hungría,0,2,,2,POINT (3451668 -76532004)
2012,Julio,Hungría,24,29,,53,POINT (4697157 -74140516)
2012,Julio,Hungría,0,3,,3,POINT (6170465 -7542726)
2012,Julio,India,0,3,,3,POINT (10446304 -75516486)
2012,Julio,India,0,4,,4,POINT (10886686 -74776479)
2012,Julio,India,0,1,,1,POINT (11247723 -74213989)
2012,Julio,India,1,0,,1,POINT (1152863 -72919186)
2012,Julio,India,4,11,,15,POINT (3451668 -76532004)
2012,Julio,India,24,244,,268,POINT (4697157 -74140516)
2012,Julio,India,1,16,,17,POINT (6170465 -7542726)
2012,Julio,India,0,2,,2,POINT (7128047 -73181317)
2012,Julio,Indonesia,1,3,,4,POINT (0.81488 -77356)
2012,Julio,Indonesia,4,29,,33,POINT (4697157 -74140516)
2012,Julio,Indonesia,0,4,,4,POINT (7819 -72453013)
2012,Julio,Irán,0,1,,1,POINT (3451668 -76532004)
2012,Julio,Irán,7,18,,25,POINT (4697157 -74140516)
2012,Julio,Irán,0,1,,1,POINT (6170465 -7542726)
2012,Julio,República de Irlanda,5,3,,8,POINT (-4191162 -69941498)
2012,Julio,República de Irlanda,13,19,,32,POINT (0.81488 -77356)
2012,Julio,República de Irlanda,2,4,,6,POINT (10406342 -75527794)
2012,Julio,República de Irlanda,5,11,,16,POINT (10446304 -75516486)
2012,Julio,República de Irlanda,1,2,,3,POINT (10886686 -74776479)
2012,Julio,República de Irlanda,5,5,,10,POINT (3451668 -76532004)
2012,Julio,República de Irlanda,73,100,,173,POINT (4697157 -74140516)
2012,Julio,República de Irlanda,11,10,,21,POINT (6170465 -7542726)
2012,Julio,República de Irlanda,1,3,,4,POINT (7819 -72453013)
2012,Julio,Islandia,0,1,,1,POINT (10446304 -75516486)
2012,Julio,Islandia,1,0,,1,POINT (3451668 -76532004)
2012,Julio,Islandia,5,8,,13,POINT (4697157 -74140516)
2012,Julio,Islandia,0,1,,1,POINT (6170465 -7542726)
2012,Julio,Isla de Man,21,31,,52,POINT (0.81488 -77356)
2012,Julio,Isla de Man,1,14,,15,POINT (10446304 -75516486)
2012,Julio,Isla de Man,1,8,,9,POINT (10886686 -74776479)
2012,Julio,Isla de Man,2,2,,4,POINT (11360029 -72129595)
2012,Julio,Isla de Man,1,0,,1,POINT (125862 -81702165)
2012,Julio,Isla de Man,12,25,,37,POINT (3451668 -76532004)
2012,Julio,Isla de Man,35,113,,148,POINT (4697157 -74140516)
2012,Julio,Isla de Man,2,2,,4,POINT (4815189 -75736374)
2012,Julio,Isla de Man,13,25,,38,POINT (6170465 -7542726)
2012,Julio,Isla de Man,0,1,,1,POINT (7128047 -73181317)
2012,Julio,Isla Johnston,5,0,,5,POINT (4697157 -74140516)
2012,Julio,Israel,2,6,,8,POINT (-4191162 -69941498)
2012,Julio,Israel,36,83,,119,POINT (0.81488 -77356)
2012,Julio,Israel,0,3,,3,POINT (10406342 -75527794)
2012,Julio,Israel,2,18,,20,POINT (10446304 -75516486)
2012,Julio,Israel,0,2,,2,POINT (10886686 -74776479)
2012,Julio,Israel,6,9,,15,POINT (3451668 -76532004)
2012,Julio,Israel,93,413,,506,POINT (4697157 -74140516)
2012,Julio,Israel,4,54,,58,POINT (6170465 -7542726)
2012,Julio,Israel,0,2,,2,POINT (7927233 -72508188)
2012,Julio,Israel,1,2,,3,POINT (863337 -7735002)
2012,Julio,Islas Aland/Provincia de Finlandia,1,1,,2,POINT (4697157 -74140516)
2012,Julio,Italia,3,2,,5,POINT (-4191162 -69941498)
2012,Julio,Italia,9,10,,19,POINT (0.81488 -77356)
2012,Julio,Italia,2,1,,3,POINT (10406342 -75527794)
2012,Julio,Italia,29,61,,90,POINT (10446304 -75516486)
2012,Julio,Italia,1,6,,7,POINT (10886686 -74776479)
2012,Julio,Italia,1,1,,2,POINT (11247723 -74213989)
2012,Julio,Italia,9,13,,22,POINT (11360029 -72129595)
2012,Julio,Italia,1,6,,7,POINT (125862 -81702165)
2012,Julio,Italia,32,84,,116,POINT (3451668 -76532004)
2012,Julio,Italia,505,1441,,1946,POINT (4697157 -74140516)
2012,Julio,Italia,36,88,,124,POINT (6170465 -7542726)
2012,Julio,Italia,0,1,,1,POINT (6185536 -67484028)
2012,Julio,Italia,6,22,,28,POINT (7819 -72453013)
2012,Julio,Italia,0,1,,1,POINT (7927233 -72508188)
2012,Julio,Italia,0,2,,2,POINT (863337 -7735002)
2012,Julio,Italia,0,1,,1,POINT (9402597 -75681642)
2012,Julio,Jamaica,2,3,,5,POINT (10446304 -75516486)
2012,Julio,Jamaica,1,1,,2,POINT (1152863 -72919186)
2012,Julio,Jamaica,2,3,,5,POINT (125862 -81702165)
2012,Julio,Jamaica,3,0,,3,POINT (3451668 -76532004)
2012,Julio,Jamaica,24,21,,45,POINT (4697157 -74140516)
2012,Julio,Jamaica,0,4,,4,POINT (6170465 -7542726)
2012,Julio,Jamaica,1,0,,1,POINT (7128047 -73181317)
2012,Julio,Jamaica,0,1,,1,POINT (7819 -72453013)
2012,Julio,Islas Marianas del Norte,0,1,,1,POINT (6170465 -7542726)
2012,Julio,Japón,0,2,,2,POINT (-4191162 -69941498)
2012,Julio,Japón,6,15,,21,POINT (0.81488 -77356)
2012,Julio,Japón,6,10,,16,POINT (10446304 -75516486)
2012,Julio,Japón,2,7,,9,POINT (10886686 -74776479)
2012,Julio,Japón,1,4,,5,POINT (11360029 -72129595)
2012,Julio,Japón,1,0,,1,POINT (125862 -81702165)
2012,Julio,Japón,6,18,,24,POINT (3451668 -76532004)
2012,Julio,Japón,144,412,,556,POINT (4697157 -74140516)
2012,Julio,Japón,6,31,,37,POINT (6170465 -7542726)
2012,Julio,Japón,3,4,,7,POINT (7819 -72453013)
2012,Julio,Japón,0,1,,1,POINT (7927233 -72508188)
2012,Julio,Japón,0,1,,1,POINT (863337 -7735002)
2012,Julio,Jordania,0,4,,4,POINT (4697157 -74140516)
2012,Julio,Kazajistán,1,0,,1,POINT (4697157 -74140516)
2012,Julio,Kenia,0,2,,2,POINT (0.81488 -77356)
2012,Julio,Kenia,1,0,,1,POINT (10446304 -75516486)
2012,Julio,Kenia,1,1,,2,POINT (3451668 -76532004)
2012,Julio,Kenia,6,10,,16,POINT (4697157 -74140516)
2012,Julio,Kenia,0,1,,1,POINT (6170465 -7542726)
2012,Julio,Kirguistán,1,1,,2,POINT (4697157 -74140516)
2012,Julio,Kuwait,1,0,,1,POINT (4697157 -74140516)
2012,Julio,Letonia,0,1,,1,POINT (10446304 -75516486)
2012,Julio,Letonia,1,1,,2,POINT (1152863 -72919186)
2012,Julio,Letonia,3,17,,20,POINT (4697157 -74140516)
2012,Julio,Letonia,1,1,,2,POINT (6170465 -7542726)
2012,Julio,Letonia,0,1,,1,POINT (9402597 -75681642)
2012,Julio,Lituania,1,1,,2,POINT (11360029 -72129595)
2012,Julio,Lituania,5,4,,9,POINT (4697157 -74140516)
2012,Julio,Líbano,0,3,,3,POINT (0.81488 -77356)
2012,Julio,Líbano,0,5,,5,POINT (10886686 -74776479)
2012,Julio,Líbano,5,5,,10,POINT (11360029 -72129595)
2012,Julio,Líbano,1,1,,2,POINT (3451668 -76532004)
2012,Julio,Líbano,21,23,,44,POINT (4697157 -74140516)
2012,Julio,Liechtenstein,4,5,,9,POINT (4697157 -74140516)
2012,Julio,Luxemburgo,0,1,,1,POINT (10446304 -75516486)
2012,Julio,Luxemburgo,10,8,,18,POINT (4697157 -74140516)
2012,Julio,Macedonia,2,2,,4,POINT (4697157 -74140516)
2012,Julio,Madagascar,1,0,,1,POINT (6170465 -7542726)
2012,Julio,Malasia,6,18,,24,POINT (4697157 -74140516)
2012,Julio,Malasia,0,1,,1,POINT (4815189 -75736374)
2012,Julio,Malasia,1,0,,1,POINT (6170465 -7542726)
2012,Julio,Malta,1,2,,3,POINT (4697157 -74140516)
2012,Julio,Marruecos,0,1,,1,POINT (10446304 -75516486)
2012,Julio,Marruecos,5,12,,17,POINT (4697157 -74140516)
2012,Julio,Mauricio,0,1,,1,POINT (4697157 -74140516)
2012,Julio,Mauritania,0,1,,1,POINT (4697157 -74140516)
2012,Julio,México,2,2,,4,POINT (-4191162 -69941498)
2012,Julio,México,0,1,,1,POINT (0.33002 -76876446)
2012,Julio,México,22,23,,45,POINT (0.81488 -77356)
2012,Julio,México,0,2,,2,POINT (10406342 -75527794)
2012,Julio,México,156,166,,322,POINT (10446304 -75516486)
2012,Julio,México,19,46,,65,POINT (10886686 -74776479)
2012,Julio,México,5,4,,9,POINT (11360029 -72129595)
2012,Julio,México,0,3,,3,POINT (125744111 -81703935)
2012,Julio,México,7,4,,11,POINT (125862 -81702165)
2012,Julio,México,68,157,,225,POINT (3451668 -76532004)
2012,Julio,México,0,2,,2,POINT (445285 -75766353)
2012,Julio,México,2390,4704,,7094,POINT (4697157 -74140516)
2012,Julio,México,8,21,,29,POINT (4815189 -75736374)
2012,Julio,México,193,387,,580,POINT (6170465 -7542726)
2012,Julio,México,4,12,,16,POINT (7128047 -73181317)
2012,Julio,México,12,26,,38,POINT (7819 -72453013)
2012,Julio,México,3,9,,12,POINT (7927233 -72508188)
2012,Julio,México,3,1,,4,POINT (863337 -7735002)
2012,Julio,República de Moldavia,2,0,,2,POINT (4697157 -74140516)
2012,Julio,Montenegro,0,1,,1,POINT (3884426 -77061029)
2012,Julio,Montenegro,1,1,,2,POINT (4697157 -74140516)
2012,Julio,Mozambique,1,0,,1,POINT (4697157 -74140516)
2012,Julio,Myanmar,0,1,,1,POINT (10406342 -75527794)
2012,Julio,Namibia,0,2,,2,POINT (4697157 -74140516)
2012,Julio,Nepal,0,1,,1,POINT (0.81488 -77356)
2012,Julio,Nepal,0,1,,1,POINT (4697157 -74140516)
2012,Julio,Nicaragua,0,1,,1,POINT (10406342 -75527794)
2012,Julio,Nicaragua,5,7,,12,POINT (10446304 -75516486)
2012,Julio,Nicaragua,2,1,,3,POINT (10886686 -74776479)
2012,Julio,Nicaragua,0,1,,1,POINT (125744111 -81703935)
2012,Julio,Nicaragua,3,2,,5,POINT (125862 -81702165)
2012,Julio,Nicaragua,5,4,,9,POINT (3451668 -76532004)
2012,Julio,Nicaragua,39,55,,94,POINT (4697157 -74140516)
2012,Julio,Nicaragua,0,2,,2,POINT (4815189 -75736374)
2012,Julio,Nicaragua,12,14,,26,POINT (6170465 -7542726)
2012,Julio,Nigeria,1,0,,1,POINT (10446304 -75516486)
2012,Julio,Nigeria,0,3,,3,POINT (4697157 -74140516)
2012,Julio,Nigeria,0,1,,1,POINT (7819 -72453013)
2012,Julio,Noruega,1,0,,1,POINT (-4191162 -69941498)
2012,Julio,Noruega,4,3,,7,POINT (0.81488 -77356)
2012,Julio,Noruega,3,4,,7,POINT (10406342 -75527794)
2012,Julio,Noruega,6,13,,19,POINT (10446304 -75516486)
2012,Julio,Noruega,2,2,,4,POINT (10886686 -74776479)
2012,Julio,Noruega,2,1,,3,POINT (11360029 -72129595)
2012,Julio,Noruega,6,11,,17,POINT (3451668 -76532004)
2012,Julio,Noruega,1,0,,1,POINT (445285 -75766353)
2012,Julio,Noruega,93,127,,220,POINT (4697157 -74140516)
2012,Julio,Noruega,10,15,,25,POINT (6170465 -7542726)
2012,Julio,Noruega,0,2,,2,POINT (7819 -72453013)
2012,Julio,Nueva Zelanda,4,4,,8,POINT (-4191162 -69941498)
2012,Julio,Nueva Zelanda,9,10,,19,POINT (0.81488 -77356)
2012,Julio,Nueva Zelanda,5,6,,11,POINT (10446304 -75516486)
2012,Julio,Nueva Zelanda,1,0,,1,POINT (125862 -81702165)
2012,Julio,Nueva Zelanda,1,3,,4,POINT (3451668 -76532004)
2012,Julio,Nueva Zelanda,40,73,,113,POINT (4697157 -74140516)
2012,Julio,Nueva Zelanda,4,8,,12,POINT (6170465 -7542726)
2012,Julio,Nueva Zelanda,0,1,,1,POINT (7819 -72453013)
2012,Julio,Nueva Zelanda,1,2,,3,POINT (863337 -7735002)
2012,Julio,Nueva Zelanda,1,6,,7,POINT (10406342 -75527794)
2012,Julio,Nueva Zelanda,0,1,,1,POINT (10446304 -75516486)
2012,Julio,Nueva Zelanda,0,1,,1,POINT (11247723 -74213989)
2012,Julio,Nueva Zelanda,7,5,,12,POINT (4697157 -74140516)
2012,Julio,Nueva Zelanda,2,5,,7,POINT (6170465 -7542726)
2012,Julio,Nueva Zelanda,2,2,,4,POINT (7819 -72453013)
2012,Julio,Nueva Zelanda,0,1,,1,POINT (863337 -7735002)
2012,Julio,Países Bajos,8,12,,20,POINT (0.81488 -77356)
2012,Julio,Países Bajos,3,8,,11,POINT (10446304 -75516486)
2012,Julio,Países Bajos,4,7,,11,POINT (10886686 -74776479)
2012,Julio,Países Bajos,9,20,,29,POINT (11360029 -72129595)
2012,Julio,Países Bajos,89,76,,165,POINT (1152863 -72919186)
2012,Julio,Países Bajos,9,37,,46,POINT (3451668 -76532004)
2012,Julio,Países Bajos,0,3,,3,POINT (3884426 -77061029)
2012,Julio,Países Bajos,337,390,,727,POINT (4697157 -74140516)
2012,Julio,Países Bajos,2,3,,5,POINT (4815189 -75736374)
2012,Julio,Países Bajos,284,302,,586,POINT (6170465 -7542726)
2012,Julio,Países Bajos,4,7,,11,POINT (7128047 -73181317)
2012,Julio,Países Bajos,0,1,,1,POINT (7819 -72453013)
2012,Julio,Pakistán,0,1,,1,POINT (0.81488 -77356)
2012,Julio,Pakistán,0,1,,1,POINT (10446304 -75516486)
2012,Julio,Pakistán,1,14,,15,POINT (4697157 -74140516)
2012,Julio,Pakistán,0,1,,1,POINT (6170465 -7542726)
2012,Julio,Palau,0,1,,1,POINT (4697157 -74140516)
2012,Julio,Panamá,0,1,,1,POINT (-4191162 -69941498)
2012,Julio,Panamá,1,1,,2,POINT (0.81488 -77356)
2012,Julio,Panamá,0,9,,9,POINT (10406342 -75527794)
2012,Julio,Panamá,87,137,,224,POINT (10446304 -75516486)
2012,Julio,Panamá,47,74,,121,POINT (10886686 -74776479)
2012,Julio,Panamá,1,3,,4,POINT (11360029 -72129595)
2012,Julio,Panamá,0,2,,2,POINT (125744111 -81703935)
2012,Julio,Panamá,30,48,,78,POINT (125862 -81702165)
2012,Julio,Panamá,60,119,,179,POINT (3451668 -76532004)
2012,Julio,Panamá,0,1,,1,POINT (445285 -75766353)
2012,Julio,Panamá,476,848,,1324,POINT (4697157 -74140516)
2012,Julio,Panamá,112,90,,202,POINT (4815189 -75736374)
2012,Julio,Panamá,156,272,,428,POINT (6170465 -7542726)
2012,Julio,Panamá,3,2,,5,POINT (6222552 -77401154)
2012,Julio,Panamá,3,6,,9,POINT (7128047 -73181317)
2012,Julio,Panamá,3,6,,9,POINT (7819 -72453013)
2012,Julio,Panamá,7,10,,17,POINT (7927233 -72508188)
2012,Julio,Panamá,1,7,,8,POINT (863337 -7735002)
2012,Julio,Paraguay,2,2,,4,POINT (0.81488 -77356)
2012,Julio,Paraguay,6,6,,12,POINT (10446304 -75516486)
2012,Julio,Paraguay,2,2,,4,POINT (10886686 -74776479)
2012,Julio,Paraguay,3,4,,7,POINT (125862 -81702165)
2012,Julio,Paraguay,0,5,,5,POINT (3451668 -76532004)
2012,Julio,Paraguay,51,72,,123,POINT (4697157 -74140516)
2012,Julio,Paraguay,1,0,,1,POINT (4815189 -75736374)
2012,Julio,Paraguay,7,3,,10,POINT (6170465 -7542726)
2012,Julio,Paraguay,0,1,,1,POINT (7819 -72453013)
2012,Julio,Paraguay,0,2,,2,POINT (7927233 -72508188)
2012,Julio,Perú,24,67,,91,POINT (-4191162 -69941498)
2012,Julio,Perú,2,2,,4,POINT (0.33002 -76876446)
2012,Julio,Perú,174,318,,492,POINT (0.81488 -77356)
2012,Julio,Perú,139,156,,295,POINT (10446304 -75516486)
2012,Julio,Perú,10,11,,21,POINT (10886686 -74776479)
2012,Julio,Perú,7,22,,29,POINT (11360029 -72129595)
2012,Julio,Perú,257,189,,446,POINT (125862 -81702165)
2012,Julio,Perú,141,86,,227,POINT (3451668 -76532004)
2012,Julio,Perú,0,1,,1,POINT (3884426 -77061029)
2012,Julio,Perú,2015,2969,,4984,POINT (4697157 -74140516)
2012,Julio,Perú,0,3,,3,POINT (4815189 -75736374)
2012,Julio,Perú,218,265,,483,POINT (6170465 -7542726)
2012,Julio,Perú,1,0,,1,POINT (6185536 -67484028)
2012,Julio,Perú,0,1,,1,POINT (7088729 -70740253)
2012,Julio,Perú,3,6,,9,POINT (7128047 -73181317)
2012,Julio,Perú,27,53,,80,POINT (7819 -72453013)
2012,Julio,Perú,0,1,,1,POINT (7927233 -72508188)
2012,Julio,Perú,0,1,,1,POINT (863337 -7735002)
2012,Julio,Palestina,2,3,,5,POINT (4697157 -74140516)
2012,Julio,Polonia,1,0,,1,POINT (-4191162 -69941498)
2012,Julio,Polonia,1,0,,1,POINT (0.33002 -76876446)
2012,Julio,Polonia,3,2,,5,POINT (0.81488 -77356)
2012,Julio,Polonia,3,8,,11,POINT (10406342 -75527794)
2012,Julio,Polonia,5,3,,8,POINT (10446304 -75516486)
2012,Julio,Polonia,1,0,,1,POINT (11247723 -74213989)
2012,Julio,Polonia,0,2,,2,POINT (11360029 -72129595)
2012,Julio,Polonia,1,1,,2,POINT (3451668 -76532004)
2012,Julio,Polonia,53,63,,116,POINT (4697157 -74140516)
2012,Julio,Polonia,5,2,,7,POINT (6170465 -7542726)
2012,Julio,Polonia,1,1,,2,POINT (7819 -72453013)
2012,Julio,Polonia,0,1,,1,POINT (9402597 -75681642)
2012,Julio,Portugal,0,2,,2,POINT (-4191162 -69941498)
2012,Julio,Portugal,2,3,,5,POINT (0.81488 -77356)
2012,Julio,Portugal,0,2,,2,POINT (10406342 -75527794)
2012,Julio,Portugal,2,4,,6,POINT (10446304 -75516486)
2012,Julio,Portugal,0,1,,1,POINT (10886686 -74776479)
2012,Julio,Portugal,1,4,,5,POINT (11360029 -72129595)
2012,Julio,Portugal,0,1,,1,POINT (125862 -81702165)
2012,Julio,Portugal,1,19,,20,POINT (3451668 -76532004)
2012,Julio,Portugal,80,235,,315,POINT (4697157 -74140516)
2012,Julio,Portugal,5,19,,24,POINT (6170465 -7542726)
2012,Julio,Portugal,1,2,,3,POINT (7819 -72453013)
2012,Julio,Portugal,1,5,,6,POINT (7927233 -72508188)
2012,Julio,Portugal,2,2,,4,POINT (863337 -7735002)
2012,Julio,Puerto Rico/Territorio de Estados Unidos,2,4,,6,POINT (10446304 -75516486)
2012,Julio,Puerto Rico/Territorio de Estados Unidos,1,0,,1,POINT (10886686 -74776479)
2012,Julio,Puerto Rico/Territorio de Estados Unidos,1,0,,1,POINT (3451668 -76532004)
2012,Julio,Puerto Rico/Territorio de Estados Unidos,0,2,,2,POINT (6170465 -7542726)
2012,Julio,Qatar,0,1,,1,POINT (4697157 -74140516)
2012,Julio,Qatar,0,1,,1,POINT (6170465 -7542726)
2012,Julio,Reino Unido de Gran Bretaña e Irlanda del Norte,5,16,,21,POINT (-4191162 -69941498)
2012,Julio,Reino Unido de Gran Bretaña e Irlanda del Norte,10,10,,20,POINT (0.81488 -77356)
2012,Julio,Reino Unido de Gran Bretaña e Irlanda del Norte,1,0,,1,POINT (10406342 -75527794)
2012,Julio,Reino Unido de Gran Bretaña e Irlanda del Norte,12,31,,43,POINT (10446304 -75516486)
2012,Julio,Reino Unido de Gran Bretaña e Irlanda del Norte,1,4,,5,POINT (10886686 -74776479)
2012,Julio,Reino Unido de Gran Bretaña e Irlanda del Norte,6,3,,9,POINT (11360029 -72129595)
2012,Julio,Reino Unido de Gran Bretaña e Irlanda del Norte,1,0,,1,POINT (125862 -81702165)
2012,Julio,Reino Unido de Gran Bretaña e Irlanda del Norte,11,18,,29,POINT (3451668 -76532004)
2012,Julio,Reino Unido de Gran Bretaña e Irlanda del Norte,1,0,,1,POINT (445285 -75766353)
2012,Julio,Reino Unido de Gran Bretaña e Irlanda del Norte,269,508,,777,POINT (4697157 -74140516)
2012,Julio,Reino Unido de Gran Bretaña e Irlanda del Norte,7,24,,31,POINT (6170465 -7542726)
2012,Julio,Reino Unido de Gran Bretaña e Irlanda del Norte,1,2,,3,POINT (7819 -72453013)
2012,Julio,Reino Unido de Gran Bretaña e Irlanda del Norte,0,1,,1,POINT (863337 -7735002)
2012,Julio,República de Belarús,0,1,,1,POINT (4697157 -74140516)
2012,Julio,República Dominicana,3,5,,8,POINT (0.81488 -77356)
2012,Julio,República Dominicana,0,2,,2,POINT (10406342 -75527794)
2012,Julio,República Dominicana,24,14,,38,POINT (10446304 -75516486)
2012,Julio,República Dominicana,8,34,,42,POINT (10886686 -74776479)
2012,Julio,República Dominicana,1,3,,4,POINT (11360029 -72129595)
2012,Julio,República Dominicana,26,22,,48,POINT (3451668 -76532004)
2012,Julio,República Dominicana,1,0,,1,POINT (445285 -75766353)
2012,Julio,República Dominicana,208,354,,562,POINT (4697157 -74140516)
2012,Julio,República Dominicana,5,4,,9,POINT (4815189 -75736374)
2012,Julio,República Dominicana,35,54,,89,POINT (6170465 -7542726)
2012,Julio,República Dominicana,6,0,,6,POINT (7128047 -73181317)
2012,Julio,República Dominicana,0,1,,1,POINT (7819 -72453013)
2012,Julio,República Dominicana,7,12,,19,POINT (7927233 -72508188)
2012,Julio,República Checa,0,2,,2,POINT (125862 -81702165)
2012,Julio,República Checa,0,3,,3,POINT (4697157 -74140516)
2012,Julio,República Checa,0,1,,1,POINT (7819 -72453013)
2012,Julio,Rumania,0,1,,1,POINT (-4191162 -69941498)
2012,Julio,Rumania,1,0,,1,POINT (0.81488 -77356)
2012,Julio,Rumania,0,1,,1,POINT (10406342 -75527794)
2012,Julio,Rumania,0,1,,1,POINT (10446304 -75516486)
2012,Julio,Rumania,0,1,,1,POINT (10970933 -74765343)
2012,Julio,Rumania,1,4,,5,POINT (3451668 -76532004)
2012,Julio,Rumania,0,1,,1,POINT (3884426 -77061029)
2012,Julio,Rumania,26,40,,66,POINT (4697157 -74140516)
2012,Julio,Rumania,0,2,,2,POINT (9402597 -75681642)
2012,Julio,Federación de Rusia,0,2,,2,POINT (0.81488 -77356)
2012,Julio,Federación de Rusia,1,6,,7,POINT (10406342 -75527794)
2012,Julio,Federación de Rusia,3,1,,4,POINT (10446304 -75516486)
2012,Julio,Federación de Rusia,0,1,,1,POINT (10886686 -74776479)
2012,Julio,Federación de Rusia,1,1,,2,POINT (11360029 -72129595)
2012,Julio,Federación de Rusia,3,3,,6,POINT (3451668 -76532004)
2012,Julio,Federación de Rusia,31,39,,70,POINT (4697157 -74140516)
2012,Julio,Federación de Rusia,1,0,,1,POINT (4815189 -75736374)
2012,Julio,Federación de Rusia,3,1,,4,POINT (6170465 -7542726)
2012,Julio,Federación de Rusia,0,1,,1,POINT (9402597 -75681642)
2012,Julio,Rwanda,1,0,,1,POINT (4697157 -74140516)
2012,Julio,San Cristóbal y Nevis,0,1,,1,POINT (11360029 -72129595)
2012,Julio,San Marino,0,1,,1,POINT (11360029 -72129595)
2012,Julio,San  Vicente y las Granadinas,0,1,,1,POINT (10446304 -75516486)
2012,Julio,San  Vicente y las Granadinas,0,1,,1,POINT (4697157 -74140516)
2012,Julio,Santa Lucia,2,3,,5,POINT (10446304 -75516486)
2012,Julio,Santa Lucia,1,0,,1,POINT (4697157 -74140516)
2012,Julio,Santa Lucia,1,0,,1,POINT (6170465 -7542726)
2012,Julio,Santa Lucia,2,0,,2,POINT (7128047 -73181317)
2012,Julio,Santa Sede/Ciudad del Vaticano,0,3,,3,POINT (4697157 -74140516)
2012,Julio,Santa Sede/Ciudad del Vaticano,0,1,,1,POINT (6170465 -7542726)
2012,Julio,Senegal,0,1,,1,POINT (4697157 -74140516)
2012,Julio,Serbia,0,1,,1,POINT (0.81488 -77356)
2012,Julio,Serbia,3,5,,8,POINT (4697157 -74140516)
2012,Julio,Sierra Leona,0,1,,1,POINT (4697157 -74140516)
2012,Julio,Singapur,1,0,,1,POINT (0.81488 -77356)
2012,Julio,Singapur,1,0,,1,POINT (10406342 -75527794)
2012,Julio,Singapur,5,15,,20,POINT (4697157 -74140516)
2012,Julio,Singapur,0,1,,1,POINT (6170465 -7542726)
2012,Julio,República Árabe Siria,0,1,,1,POINT (10406342 -75527794)
2012,Julio,República Árabe Siria,0,1,,1,POINT (11360029 -72129595)
2012,Julio,República Árabe Siria,0,1,,1,POINT (4697157 -74140516)
2012,Julio,Sri Lanka,0,1,,1,POINT (3451668 -76532004)
2012,Julio,Sri Lanka,0,2,,2,POINT (4697157 -74140516)
2012,Julio,Sudáfrica,3,2,,5,POINT (0.81488 -77356)
2012,Julio,Sudáfrica,0,2,,2,POINT (10446304 -75516486)
2012,Julio,Sudáfrica,0,2,,2,POINT (3451668 -76532004)
2012,Julio,Sudáfrica,11,59,,70,POINT (4697157 -74140516)
2012,Julio,Sudáfrica,1,4,,5,POINT (6170465 -7542726)
2012,Julio,Sudáfrica,0,2,,2,POINT (7927233 -72508188)
2012,Julio,Sudán,0,1,,1,POINT (4697157 -74140516)
2012,Julio,Suecia,0,5,,5,POINT (-4191162 -69941498)
2012,Julio,Suecia,8,2,,10,POINT (0.81488 -77356)
2012,Julio,Suecia,1,3,,4,POINT (10406342 -75527794)
2012,Julio,Suecia,6,7,,13,POINT (10446304 -75516486)
2012,Julio,Suecia,2,3,,5,POINT (10886686 -74776479)
2012,Julio,Suecia,0,4,,4,POINT (11360029 -72129595)
2012,Julio,Suecia,1,8,,9,POINT (3451668 -76532004)
2012,Julio,Suecia,112,164,,276,POINT (4697157 -74140516)
2012,Julio,Suecia,0,1,,1,POINT (4815189 -75736374)
2012,Julio,Suecia,16,14,,30,POINT (6170465 -7542726)
2012,Julio,Suecia,0,2,,2,POINT (7819 -72453013)
2012,Julio,Suecia,0,1,,1,POINT (863337 -7735002)
2012,Julio,Suiza,7,7,,14,POINT (-4191162 -69941498)
2012,Julio,Suiza,25,36,,61,POINT (0.81488 -77356)
2012,Julio,Suiza,14,14,,28,POINT (10406342 -75527794)
2012,Julio,Suiza,25,24,,49,POINT (10446304 -75516486)
2012,Julio,Suiza,5,6,,11,POINT (10886686 -74776479)
2012,Julio,Suiza,0,1,,1,POINT (11247723 -74213989)
2012,Julio,Suiza,3,10,,13,POINT (11360029 -72129595)
2012,Julio,Suiza,1,0,,1,POINT (125862 -81702165)
2012,Julio,Suiza,53,62,,115,POINT (3451668 -76532004)
2012,Julio,Suiza,589,734,,1323,POINT (4697157 -74140516)
2012,Julio,Suiza,3,3,,6,POINT (4815189 -75736374)
2012,Julio,Suiza,28,48,,76,POINT (6170465 -7542726)
2012,Julio,Suiza,0,1,,1,POINT (6222552 -77401154)
2012,Julio,Suiza,1,9,,10,POINT (7819 -72453013)
2012,Julio,Suiza,3,6,,9,POINT (863337 -7735002)
2012,Julio,Surinam,3,2,,5,POINT (10446304 -75516486)
2012,Julio,Surinam,0,1,,1,POINT (10886686 -74776479)
2012,Julio,Surinam,15,7,,22,POINT (4697157 -74140516)
2012,Julio,Surinam,0,1,,1,POINT (863337 -7735002)
2012,Julio,Taiwán,0,1,,1,POINT (3451668 -76532004)
2012,Julio,Taiwán,1,6,,7,POINT (4697157 -74140516)
2012,Julio,Tailandia,1,0,,1,POINT (0.81488 -77356)
2012,Julio,Tailandia,1,0,,1,POINT (10446304 -75516486)
2012,Julio,Tailandia,1,0,,1,POINT (3451668 -76532004)
2012,Julio,Tailandia,5,2,,7,POINT (4697157 -74140516)
2012,Julio,Tailandia,1,1,,2,POINT (6170465 -7542726)
2012,Julio,Tíbet/Región Autónoma de China,1,1,,2,POINT (4697157 -74140516)
2012,Julio,Territorio Antártico Británico/Territorio Británico de Ultramar,0,1,,1,POINT (-4191162 -69941498)
2012,Julio,Territorio Antártico Británico/Territorio Británico de Ultramar,0,3,,3,POINT (0.81488 -77356)
2012,Julio,Territorio Antártico Británico/Territorio Británico de Ultramar,0,1,,1,POINT (11360029 -72129595)
2012,Julio,Territorio Antártico Británico/Territorio Británico de Ultramar,2,1,,3,POINT (4697157 -74140516)
2012,Julio,Territorio Antártico Británico/Territorio Británico de Ultramar,0,1,,1,POINT (6170465 -7542726)
2012,Julio,Tanzania,0,2,,2,POINT (4697157 -74140516)
2012,Julio,Trinidad y Tobago,6,24,,30,POINT (10446304 -75516486)
2012,Julio,Trinidad y Tobago,0,2,,2,POINT (10886686 -74776479)
2012,Julio,Trinidad y Tobago,7,7,,14,POINT (11360029 -72129595)
2012,Julio,Trinidad y Tobago,5,10,,15,POINT (3451668 -76532004)
2012,Julio,Trinidad y Tobago,18,73,,91,POINT (4697157 -74140516)
2012,Julio,Trinidad y Tobago,17,25,,42,POINT (6170465 -7542726)
2012,Julio,Trinidad y Tobago,1,4,,5,POINT (7128047 -73181317)
2012,Julio,Trinidad y Tobago,1,0,,1,POINT (7819 -72453013)
2012,Julio,Trinidad y Tobago,0,2,,2,POINT (7927233 -72508188)
2012,Julio,Túnez,1,2,,3,POINT (4697157 -74140516)
2012,Julio,Turkmenistán,0,1,,1,POINT (4815189 -75736374)
2012,Julio,Turquía,0,1,,1,POINT (0.81488 -77356)
2012,Julio,Turquía,0,2,,2,POINT (10406342 -75527794)
2012,Julio,Turquía,0,26,,26,POINT (10446304 -75516486)
2012,Julio,Turquía,0,1,,1,POINT (10886686 -74776479)
2012,Julio,Turquía,0,3,,3,POINT (3451668 -76532004)
2012,Julio,Turquía,28,66,,94,POINT (4697157 -74140516)
2012,Julio,Turquía,1,10,,11,POINT (6170465 -7542726)
2012,Julio,Turquía,0,5,,5,POINT (7819 -72453013)
2012,Julio,Turquía,0,1,,1,POINT (7927233 -72508188)
2012,Julio,Ucrania,1,0,,1,POINT (10446304 -75516486)
2012,Julio,Ucrania,1,1,,2,POINT (3451668 -76532004)
2012,Julio,Ucrania,0,5,,5,POINT (3884426 -77061029)
2012,Julio,Ucrania,17,19,,36,POINT (4697157 -74140516)
2012,Julio,Ucrania,1,0,,1,POINT (6170465 -7542726)
2012,Julio,Uganda,0,1,,1,POINT (10446304 -75516486)
2012,Julio,Uganda,0,2,,2,POINT (4697157 -74140516)
2012,Julio,Federación de Rusia,1,3,,4,POINT (0.81488 -77356)
2012,Julio,Federación de Rusia,4,4,,8,POINT (10446304 -75516486)
2012,Julio,Federación de Rusia,0,1,,1,POINT (10970933 -74765343)
2012,Julio,Federación de Rusia,0,1,,1,POINT (11360029 -72129595)
2012,Julio,Federación de Rusia,1,2,,3,POINT (3451668 -76532004)
2012,Julio,Federación de Rusia,70,83,,153,POINT (4697157 -74140516)
2012,Julio,Federación de Rusia,0,3,,3,POINT (7819 -72453013)
2012,Julio,Uruguay,1,0,,1,POINT (0.33002 -76876446)
2012,Julio,Uruguay,1,7,,8,POINT (0.81488 -77356)
2012,Julio,Uruguay,0,1,,1,POINT (10406342 -75527794)
2012,Julio,Uruguay,136,99,,235,POINT (10446304 -75516486)
2012,Julio,Uruguay,2,8,,10,POINT (10886686 -74776479)
2012,Julio,Uruguay,52,37,,89,POINT (125862 -81702165)
2012,Julio,Uruguay,7,19,,26,POINT (3451668 -76532004)
2012,Julio,Uruguay,130,277,,407,POINT (4697157 -74140516)
2012,Julio,Uruguay,0,3,,3,POINT (4815189 -75736374)
2012,Julio,Uruguay,17,30,,47,POINT (6170465 -7542726)
2012,Julio,Uruguay,0,9,,9,POINT (7819 -72453013)
2012,Julio,Uruguay,0,1,,1,POINT (7927233 -72508188)
2012,Julio,Uzbekistán,2,0,,2,POINT (4697157 -74140516)
2012,Julio,Venezuela,1,1,,2,POINT (0.33002 -76876446)
2012,Julio,Venezuela,47,75,,122,POINT (0.81488 -77356)
2012,Julio,Venezuela,0,3,,3,POINT (10406342 -75527794)
2012,Julio,Venezuela,88,94,,182,POINT (10446304 -75516486)
2012,Julio,Venezuela,29,70,,99,POINT (10886686 -74776479)
2012,Julio,Venezuela,0,5,,5,POINT (11117206 -74232675)
2012,Julio,Venezuela,1810,2333,,4143,POINT (11360029 -72129595)
2012,Julio,Venezuela,1,2,,3,POINT (1152863 -72919186)
2012,Julio,Venezuela,22,24,,46,POINT (125862 -81702165)
2012,Julio,Venezuela,37,55,,92,POINT (3451668 -76532004)
2012,Julio,Venezuela,0,1,,1,POINT (445285 -75766353)
2012,Julio,Venezuela,4918,6202,,11120,POINT (4697157 -74140516)
2012,Julio,Venezuela,5,17,,22,POINT (4815189 -75736374)
2012,Julio,Venezuela,478,511,,989,POINT (6170465 -7542726)
2012,Julio,Venezuela,7,4,,11,POINT (6185536 -67484028)
2012,Julio,Venezuela,30,40,,70,POINT (7088729 -70740253)
2012,Julio,Venezuela,5,4,,9,POINT (7128047 -73181317)
2012,Julio,Venezuela,1785,1888,,3673,POINT (7819 -72453013)
2012,Julio,Venezuela,282,263,,545,POINT (7927233 -72508188)
2012,Julio,Vietnam,1,1,,2,POINT (4697157 -74140516)
2012,Julio,Yugoslavia,1,0,,1,POINT (4697157 -74140516)
2012,Julio,Zimbabue,0,4,,4,POINT (4697157 -74140516)
2012,Julio,Anguila/Territorio Británico de Ultramar,0,3,,3,POINT (4697157 -74140516)
2012,Julio,Reino Unido de Gran Bretaña e Irlanda del Norte,5,14,,19,POINT (-4191162 -69941498)
2012,Julio,Reino Unido de Gran Bretaña e Irlanda del Norte,39,58,,97,POINT (0.81488 -77356)
2012,Julio,Reino Unido de Gran Bretaña e Irlanda del Norte,12,19,,31,POINT (10406342 -75527794)
2012,Julio,Reino Unido de Gran Bretaña e Irlanda del Norte,12,22,,34,POINT (10446304 -75516486)
2012,Julio,Reino Unido de Gran Bretaña e Irlanda del Norte,0,4,,4,POINT (10886686 -74776479)
2012,Julio,Reino Unido de Gran Bretaña e Irlanda del Norte,1,1,,2,POINT (11247723 -74213989)
2012,Julio,Reino Unido de Gran Bretaña e Irlanda del Norte,2,7,,9,POINT (11360029 -72129595)
2012,Julio,Reino Unido de Gran Bretaña e Irlanda del Norte,0,1,,1,POINT (125862 -81702165)
2012,Julio,Reino Unido de Gran Bretaña e Irlanda del Norte,0,2,,2,POINT (133387613 -81372937)
2012,Julio,Reino Unido de Gran Bretaña e Irlanda del Norte,9,22,,31,POINT (3451668 -76532004)
2012,Julio,Reino Unido de Gran Bretaña e Irlanda del Norte,301,622,,923,POINT (4697157 -74140516)
2012,Julio,Reino Unido de Gran Bretaña e Irlanda del Norte,0,4,,4,POINT (4815189 -75736374)
2012,Julio,Reino Unido de Gran Bretaña e Irlanda del Norte,6,22,,28,POINT (6170465 -7542726)
2012,Julio,Reino Unido de Gran Bretaña e Irlanda del Norte,5,17,,22,POINT (7819 -72453013)
2012,Julio,Reino Unido de Gran Bretaña e Irlanda del Norte,0,1,,1,POINT (7927233 -72508188)
2012,Julio,Reino Unido de Gran Bretaña e Irlanda del Norte,5,12,,17,POINT (863337 -7735002)
2012,Julio,Reino Unido de Gran Bretaña e Irlanda del Norte,0,1,,1,POINT (9402597 -75681642)
2012,Julio,Países Bajos,2,4,,6,POINT (-4191162 -69941498)
2012,Julio,Países Bajos,15,24,,39,POINT (0.81488 -77356)
2012,Julio,Países Bajos,9,13,,22,POINT (10406342 -75527794)
2012,Julio,Países Bajos,17,34,,51,POINT (10446304 -75516486)
2012,Julio,Países Bajos,8,11,,19,POINT (10886686 -74776479)
2012,Julio,Países Bajos,0,1,,1,POINT (11247723 -74213989)
2012,Julio,Países Bajos,1,8,,9,POINT (11360029 -72129595)
2012,Julio,Países Bajos,2,4,,6,POINT (125862 -81702165)
2012,Julio,Países Bajos,27,62,,89,POINT (3451668 -76532004)
2012,Julio,Países Bajos,0,9,,9,POINT (3884426 -77061029)
2012,Julio,Países Bajos,693,946,,1639,POINT (4697157 -74140516)
2012,Julio,Países Bajos,3,3,,6,POINT (4815189 -75736374)
2012,Julio,Países Bajos,69,85,,154,POINT (6170465 -7542726)
2012,Julio,Países Bajos,7,10,,17,POINT (7128047 -73181317)
2012,Julio,Países Bajos,6,14,,20,POINT (7819 -72453013)
2012,Julio,Países Bajos,2,0,,2,POINT (7927233 -72508188)
2012,Julio,Países Bajos,2,2,,4,POINT (863337 -7735002)
2012,Julio,Eslovenia,0,1,,1,POINT (10446304 -75516486)
2012,Julio,Lituania,0,1,,1,POINT (10406342 -75527794)
2012,Julio,Lituania,1,5,,6,POINT (4697157 -74140516)
2012,Julio,Lituania,0,1,,1,POINT (6170465 -7542726)
2012,Julio,Reino Unido de Gran Bretaña e Irlanda del Norte,0,2,,2,POINT (11247723 -74213989)
2012,Julio,Reino Unido de Gran Bretaña e Irlanda del Norte,1,0,,1,POINT (0.81488 -77356)
2012,Julio,Reino Unido de Gran Bretaña e Irlanda del Norte,0,1,,1,POINT (11247723 -74213989)
2012,Julio,Reino Unido de Gran Bretaña e Irlanda del Norte,2,4,,6,POINT (4697157 -74140516)
2012,Julio,Reino Unido de Gran Bretaña e Irlanda del Norte,1,0,,1,POINT (-4191162 -69941498)
2012,Julio,Reino Unido de Gran Bretaña e Irlanda del Norte,2,1,,3,POINT (0.81488 -77356)
2012,Julio,Reino Unido de Gran Bretaña e Irlanda del Norte,0,1,,1,POINT (10446304 -75516486)
2012,Julio,Reino Unido de Gran Bretaña e Irlanda del Norte,0,1,,1,POINT (11360029 -72129595)
2012,Julio,Reino Unido de Gran Bretaña e Irlanda del Norte,0,1,,1,POINT (3451668 -76532004)
2012,Julio,Reino Unido de Gran Bretaña e Irlanda del Norte,14,15,,29,POINT (4697157 -74140516)
2012,Julio,Reino Unido de Gran Bretaña e Irlanda del Norte,0,2,,2,POINT (6170465 -7542726)
2012,Julio,Reino Unido de Gran Bretaña e Irlanda del Norte,8,0,,8,POINT (863337 -7735002)
2012,Julio,Letonia,0,1,,1,POINT (4697157 -74140516)
2012,Agosto,Albania,1,0,,1,POINT (4697157 -74140516)
2012,Agosto,Alemania,13,13,,26,POINT (-4191162 -69941498)
2012,Agosto,Alemania,67,81,,148,POINT (0.81488 -77356)
2012,Agosto,Alemania,0,1,,1,POINT (1800143 -78802679)
2012,Agosto,Alemania,18,23,,41,POINT (10406342 -75527794)
2012,Agosto,Alemania,30,45,,75,POINT (10446304 -75516486)
2012,Agosto,Alemania,1,7,,8,POINT (10886686 -74776479)
2012,Agosto,Alemania,2,2,,4,POINT (11247723 -74213989)
2012,Agosto,Alemania,18,18,,36,POINT (11360029 -72129595)
2012,Agosto,Alemania,2,1,,3,POINT (1152863 -72919186)
2012,Agosto,Alemania,1,3,,4,POINT (125744111 -81703935)
2012,Agosto,Alemania,0,2,,2,POINT (125862 -81702165)
2012,Agosto,Alemania,41,59,,100,POINT (3451668 -76532004)
2012,Agosto,Alemania,0,1,,1,POINT (3884426 -77061029)
2012,Agosto,Alemania,2,1,,3,POINT (445285 -75766353)
2012,Agosto,Alemania,1439,1954,,3393,POINT (4697157 -74140516)
2012,Agosto,Alemania,1,0,,1,POINT (4815189 -75736374)
2012,Agosto,Alemania,55,93,,148,POINT (6170465 -7542726)
2012,Agosto,Alemania,1,2,,3,POINT (7128047 -73181317)
2012,Agosto,Alemania,5,15,,20,POINT (7819 -72453013)
2012,Agosto,Alemania,1,1,,2,POINT (7927233 -72508188)
2012,Agosto,Alemania,3,9,,12,POINT (863337 -7735002)
2012,Agosto,Andorra,1,11,,12,POINT (4697157 -74140516)
2012,Agosto,Angola,0,2,,2,POINT (4697157 -74140516)
2012,Agosto,Antigua y Barbuda,1,5,,6,POINT (4697157 -74140516)
2012,Agosto,Países Bajos,0,3,,3,POINT (6170465 -7542726)
2012,Agosto,Arabia Saudita,1,2,,3,POINT (4697157 -74140516)
2012,Agosto,Arabia Saudita,0,1,,1,POINT (4697157 -74140516)
2012,Agosto,Argelia,3,4,,7,POINT (4697157 -74140516)
2012,Agosto,Argentina,3,3,,6,POINT (-4191162 -69941498)
2012,Agosto,Argentina,2,1,,3,POINT (0.33002 -76876446)
2012,Agosto,Argentina,72,108,,180,POINT (0.81488 -77356)
2012,Agosto,Argentina,0,1,,1,POINT (1800143 -78802679)
2012,Agosto,Argentina,0,5,,5,POINT (10406342 -75527794)
2012,Agosto,Argentina,652,577,,1229,POINT (10446304 -75516486)
2012,Agosto,Argentina,13,26,,39,POINT (10886686 -74776479)
2012,Agosto,Argentina,20,41,,61,POINT (11360029 -72129595)
2012,Agosto,Argentina,271,218,,489,POINT (125862 -81702165)
2012,Agosto,Argentina,47,111,,158,POINT (3451668 -76532004)
2012,Agosto,Argentina,0,1,,1,POINT (445285 -75766353)
2012,Agosto,Argentina,2311,3747,,6058,POINT (4697157 -74140516)
2012,Agosto,Argentina,1,5,,6,POINT (4815189 -75736374)
2012,Agosto,Argentina,91,213,,304,POINT (6170465 -7542726)
2012,Agosto,Argentina,1,0,,1,POINT (7088729 -70740253)
2012,Agosto,Argentina,1,0,,1,POINT (7128047 -73181317)
2012,Agosto,Argentina,42,49,,91,POINT (7819 -72453013)
2012,Agosto,Argentina,1,0,,1,POINT (7927233 -72508188)
2012,Agosto,Argentina,7,10,,17,POINT (863337 -7735002)
2012,Agosto,República de Armenia,0,1,,1,POINT (0.81488 -77356)
2012,Agosto,República de Armenia,0,1,,1,POINT (4697157 -74140516)
2012,Agosto,Aruba,0,2,,2,POINT (10886686 -74776479)
2012,Agosto,Aruba,2,3,,5,POINT (4697157 -74140516)
2012,Agosto,Aruba,1,0,,1,POINT (6170465 -7542726)
2012,Agosto,Australia,6,6,,12,POINT (-4191162 -69941498)
2012,Agosto,Australia,37,39,,76,POINT (0.81488 -77356)
2012,Agosto,Australia,22,30,,52,POINT (10406342 -75527794)
2012,Agosto,Australia,20,17,,37,POINT (10446304 -75516486)
2012,Agosto,Australia,4,9,,13,POINT (10886686 -74776479)
2012,Agosto,Australia,4,5,,9,POINT (11360029 -72129595)
2012,Agosto,Australia,0,1,,1,POINT (125744111 -81703935)
2012,Agosto,Australia,0,3,,3,POINT (125862 -81702165)
2012,Agosto,Australia,6,18,,24,POINT (3451668 -76532004)
2012,Agosto,Australia,198,363,,561,POINT (4697157 -74140516)
2012,Agosto,Australia,35,57,,92,POINT (6170465 -7542726)
2012,Agosto,Australia,1,4,,5,POINT (7819 -72453013)
2012,Agosto,Australia,2,3,,5,POINT (863337 -7735002)
2012,Agosto,Austria,5,7,,12,POINT (-4191162 -69941498)
2012,Agosto,Austria,15,12,,27,POINT (0.81488 -77356)
2012,Agosto,Austria,1,4,,5,POINT (10406342 -75527794)
2012,Agosto,Austria,4,10,,14,POINT (10446304 -75516486)
2012,Agosto,Austria,0,3,,3,POINT (10886686 -74776479)
2012,Agosto,Austria,0,1,,1,POINT (11247723 -74213989)
2012,Agosto,Austria,2,1,,3,POINT (11360029 -72129595)
2012,Agosto,Austria,1,1,,2,POINT (1152863 -72919186)
2012,Agosto,Austria,1,0,,1,POINT (125862 -81702165)
2012,Agosto,Austria,4,3,,7,POINT (3451668 -76532004)
2012,Agosto,Austria,123,218,,341,POINT (4697157 -74140516)
2012,Agosto,Austria,2,12,,14,POINT (6170465 -7542726)
2012,Agosto,Austria,1,0,,1,POINT (7819 -72453013)
2012,Agosto,Azerbaiyán,2,4,,6,POINT (4697157 -74140516)
2012,Agosto,Bahamas,0,4,,4,POINT (10446304 -75516486)
2012,Agosto,Bahamas,1,0,,1,POINT (10886686 -74776479)
2012,Agosto,Bahamas,0,1,,1,POINT (3451668 -76532004)
2012,Agosto,Bahamas,4,3,,7,POINT (4697157 -74140516)
2012,Agosto,Bahamas,0,1,,1,POINT (6170465 -7542726)
2012,Agosto,Bangladesh,0,2,,2,POINT (4697157 -74140516)
2012,Agosto,Barbados,1,0,,1,POINT (10446304 -75516486)
2012,Agosto,Barbados,4,2,,6,POINT (4697157 -74140516)
2012,Agosto,Barbados,0,3,,3,POINT (6170465 -7542726)
2012,Agosto,Barbados,0,1,,1,POINT (7927233 -72508188)
2012,Agosto,República de Belarús,1,2,,3,POINT (4697157 -74140516)
2012,Agosto,Bélgica,1,2,,3,POINT (-4191162 -69941498)
2012,Agosto,Bélgica,9,11,,20,POINT (0.81488 -77356)
2012,Agosto,Bélgica,4,11,,15,POINT (10446304 -75516486)
2012,Agosto,Bélgica,1,1,,2,POINT (10886686 -74776479)
2012,Agosto,Bélgica,0,1,,1,POINT (11247723 -74213989)
2012,Agosto,Bélgica,2,3,,5,POINT (11360029 -72129595)
2012,Agosto,Bélgica,7,12,,19,POINT (3451668 -76532004)
2012,Agosto,Bélgica,93,248,,341,POINT (4697157 -74140516)
2012,Agosto,Bélgica,7,18,,25,POINT (6170465 -7542726)
2012,Agosto,Bélgica,0,2,,2,POINT (7819 -72453013)
2012,Agosto,Bélgica,0,2,,2,POINT (863337 -7735002)
2012,Agosto,Belice,4,9,,13,POINT (4697157 -74140516)
2012,Agosto,Belice,0,1,,1,POINT (6170465 -7542726)
2012,Agosto,Benín,1,2,,3,POINT (4697157 -74140516)
2012,Agosto,Bermudas/Territorio Británico de Ultramar,0,1,,1,POINT (4697157 -74140516)
2012,Agosto,Bolivia,0,1,,1,POINT (0.33002 -76876446)
2012,Agosto,Bolivia,18,39,,57,POINT (0.81488 -77356)
2012,Agosto,Bolivia,11,19,,30,POINT (10446304 -75516486)
2012,Agosto,Bolivia,3,0,,3,POINT (10886686 -74776479)
2012,Agosto,Bolivia,1,3,,4,POINT (11360029 -72129595)
2012,Agosto,Bolivia,10,9,,19,POINT (125862 -81702165)
2012,Agosto,Bolivia,17,15,,32,POINT (3451668 -76532004)
2012,Agosto,Bolivia,246,355,,601,POINT (4697157 -74140516)
2012,Agosto,Bolivia,29,34,,63,POINT (6170465 -7542726)
2012,Agosto,Bolivia,2,7,,9,POINT (7819 -72453013)
2012,Agosto,Bosnia y Herzegovina,1,0,,1,POINT (6170465 -7542726)
2012,Agosto,Brasil,69,74,,143,POINT (-4191162 -69941498)
2012,Agosto,Brasil,13,38,,51,POINT (0.81488 -77356)
2012,Agosto,Brasil,2,0,,2,POINT (1800143 -78802679)
2012,Agosto,Brasil,1,0,,1,POINT (10406342 -75527794)
2012,Agosto,Brasil,87,91,,178,POINT (10446304 -75516486)
2012,Agosto,Brasil,6,14,,20,POINT (10886686 -74776479)
2012,Agosto,Brasil,0,2,,2,POINT (11247723 -74213989)
2012,Agosto,Brasil,4,19,,23,POINT (11360029 -72129595)
2012,Agosto,Brasil,25,26,,51,POINT (125862 -81702165)
2012,Agosto,Brasil,32,59,,91,POINT (3451668 -76532004)
2012,Agosto,Brasil,2122,3685,,5807,POINT (4697157 -74140516)
2012,Agosto,Brasil,0,1,,1,POINT (4815189 -75736374)
2012,Agosto,Brasil,41,80,,121,POINT (6170465 -7542726)
2012,Agosto,Brasil,0,2,,2,POINT (6185536 -67484028)
2012,Agosto,Brasil,5,28,,33,POINT (7819 -72453013)
2012,Agosto,Brasil,1,4,,5,POINT (7927233 -72508188)
2012,Agosto,Brasil,1,1,,2,POINT (863337 -7735002)
2012,Agosto,Bulgaria,1,0,,1,POINT (0.81488 -77356)
2012,Agosto,Bulgaria,0,1,,1,POINT (10886686 -74776479)
2012,Agosto,Bulgaria,14,23,,37,POINT (4697157 -74140516)
2012,Agosto,Bulgaria,2,2,,4,POINT (6170465 -7542726)
2012,Agosto,Islas Caimán/Territorio Británico de Ultramar,1,0,,1,POINT (3451668 -76532004)
2012,Agosto,Camerún,0,1,,1,POINT (3451668 -76532004)
2012,Agosto,Camerún,0,3,,3,POINT (4697157 -74140516)
2012,Agosto,Canadá,6,5,,11,POINT (-4191162 -69941498)
2012,Agosto,Canadá,12,13,,25,POINT (0.81488 -77356)
2012,Agosto,Canadá,7,9,,16,POINT (10406342 -75527794)
2012,Agosto,Canadá,32,52,,84,POINT (10446304 -75516486)
2012,Agosto,Canadá,6,23,,29,POINT (10886686 -74776479)
2012,Agosto,Canadá,0,1,,1,POINT (10970933 -74765343)
2012,Agosto,Canadá,0,4,,4,POINT (11360029 -72129595)
2012,Agosto,Canadá,4,11,,15,POINT (125862 -81702165)
2012,Agosto,Canadá,0,1,,1,POINT (133387613 -81372937)
2012,Agosto,Canadá,33,35,,68,POINT (3451668 -76532004)
2012,Agosto,Canadá,2,5,,7,POINT (445285 -75766353)
2012,Agosto,Canadá,878,1497,,2375,POINT (4697157 -74140516)
2012,Agosto,Canadá,1,2,,3,POINT (4815189 -75736374)
2012,Agosto,Canadá,41,141,,182,POINT (6170465 -7542726)
2012,Agosto,Canadá,0,1,,1,POINT (7128047 -73181317)
2012,Agosto,Canadá,3,9,,12,POINT (7819 -72453013)
2012,Agosto,Canadá,3,3,,6,POINT (863337 -7735002)
2012,Agosto,España,14,10,,24,POINT (0.81488 -77356)
2012,Agosto,España,1,2,,3,POINT (10406342 -75527794)
2012,Agosto,España,8,20,,28,POINT (10446304 -75516486)
2012,Agosto,España,4,7,,11,POINT (10886686 -74776479)
2012,Agosto,España,0,1,,1,POINT (11360029 -72129595)
2012,Agosto,España,0,1,,1,POINT (1152863 -72919186)
2012,Agosto,España,3,1,,4,POINT (125862 -81702165)
2012,Agosto,España,83,159,,242,POINT (3451668 -76532004)
2012,Agosto,España,199,357,,556,POINT (4697157 -74140516)
2012,Agosto,España,2,7,,9,POINT (4815189 -75736374)
2012,Agosto,España,78,176,,254,POINT (6170465 -7542726)
2012,Agosto,España,0,1,,1,POINT (7128047 -73181317)
2012,Agosto,España,2,3,,5,POINT (7819 -72453013)
2012,Agosto,España,0,3,,3,POINT (7927233 -72508188)
2012,Agosto,República Democrática del Congo,2,2,,4,POINT (4697157 -74140516)
2012,Agosto,República de Corea,0,1,,1,POINT (-4191162 -69941498)
2012,Agosto,República de Corea,8,5,,13,POINT (0.81488 -77356)
2012,Agosto,República de Corea,3,2,,5,POINT (10446304 -75516486)
2012,Agosto,República de Corea,0,2,,2,POINT (10886686 -74776479)
2012,Agosto,República de Corea,0,1,,1,POINT (11360029 -72129595)
2012,Agosto,República de Corea,1,1,,2,POINT (125862 -81702165)
2012,Agosto,República de Corea,0,1,,1,POINT (3451668 -76532004)
2012,Agosto,República de Corea,140,302,,442,POINT (4697157 -74140516)
2012,Agosto,República de Corea,7,7,,14,POINT (6170465 -7542726)
2012,Agosto,República de Corea,0,3,,3,POINT (7819 -72453013)
2012,Agosto,Costa de Marfil,0,1,,1,POINT (3451668 -76532004)
2012,Agosto,Costa Rica,0,2,,2,POINT (0.81488 -77356)
2012,Agosto,Costa Rica,1,1,,2,POINT (10406342 -75527794)
2012,Agosto,Costa Rica,47,45,,92,POINT (10446304 -75516486)
2012,Agosto,Costa Rica,3,21,,24,POINT (10886686 -74776479)
2012,Agosto,Costa Rica,0,1,,1,POINT (11360029 -72129595)
2012,Agosto,Costa Rica,236,238,,474,POINT (125862 -81702165)
2012,Agosto,Costa Rica,32,57,,89,POINT (3451668 -76532004)
2012,Agosto,Costa Rica,368,625,,993,POINT (4697157 -74140516)
2012,Agosto,Costa Rica,1,7,,8,POINT (4815189 -75736374)
2012,Agosto,Costa Rica,89,219,,308,POINT (6170465 -7542726)
2012,Agosto,Costa Rica,1,0,,1,POINT (6185536 -67484028)
2012,Agosto,Costa Rica,1,1,,2,POINT (7128047 -73181317)
2012,Agosto,Costa Rica,5,5,,10,POINT (7819 -72453013)
2012,Agosto,Costa Rica,0,2,,2,POINT (7927233 -72508188)
2012,Agosto,Costa Rica,1,0,,1,POINT (863337 -7735002)
2012,Agosto,Croacia,0,1,,1,POINT (10406342 -75527794)
2012,Agosto,Croacia,1,1,,2,POINT (10446304 -75516486)
2012,Agosto,Croacia,0,4,,4,POINT (10970933 -74765343)
2012,Agosto,Croacia,0,1,,1,POINT (11247723 -74213989)
2012,Agosto,Croacia,0,1,,1,POINT (3451668 -76532004)
2012,Agosto,Croacia,0,1,,1,POINT (3884426 -77061029)
2012,Agosto,Croacia,6,27,,33,POINT (4697157 -74140516)
2012,Agosto,Croacia,1,0,,1,POINT (6170465 -7542726)
2012,Agosto,Croacia,0,1,,1,POINT (7819 -72453013)
2012,Agosto,Cuba,0,1,,1,POINT (0.33002 -76876446)
2012,Agosto,Cuba,2,2,,4,POINT (0.81488 -77356)
2012,Agosto,Cuba,1,1,,2,POINT (10406342 -75527794)
2012,Agosto,Cuba,11,24,,35,POINT (10446304 -75516486)
2012,Agosto,Cuba,3,10,,13,POINT (10886686 -74776479)
2012,Agosto,Cuba,0,3,,3,POINT (11360029 -72129595)
2012,Agosto,Cuba,0,1,,1,POINT (125862 -81702165)
2012,Agosto,Cuba,14,27,,41,POINT (3451668 -76532004)
2012,Agosto,Cuba,67,172,,239,POINT (4697157 -74140516)
2012,Agosto,Cuba,3,3,,6,POINT (4815189 -75736374)
2012,Agosto,Cuba,10,24,,34,POINT (6170465 -7542726)
2012,Agosto,Cuba,4,1,,5,POINT (7128047 -73181317)
2012,Agosto,Cuba,0,3,,3,POINT (7819 -72453013)
2012,Agosto,Cuba,1,2,,3,POINT (7927233 -72508188)
2012,Agosto,Curazao,1,0,,1,POINT (4697157 -74140516)
2012,Agosto,Curazao,3,7,,10,POINT (6170465 -7542726)
2012,Agosto,República Checa,8,5,,13,POINT (0.81488 -77356)
2012,Agosto,República Checa,0,2,,2,POINT (11360029 -72129595)
2012,Agosto,República Checa,1,2,,3,POINT (3451668 -76532004)
2012,Agosto,República Checa,19,27,,46,POINT (4697157 -74140516)
2012,Agosto,República Checa,1,0,,1,POINT (7128047 -73181317)
2012,Agosto,República Checa,1,1,,2,POINT (7819 -72453013)
2012,Agosto,Chile,1,2,,3,POINT (-4191162 -69941498)
2012,Agosto,Chile,0,2,,2,POINT (0.33002 -76876446)
2012,Agosto,Chile,38,57,,95,POINT (0.81488 -77356)
2012,Agosto,Chile,1,0,,1,POINT (1800143 -78802679)
2012,Agosto,Chile,2,0,,2,POINT (10406342 -75527794)
2012,Agosto,Chile,197,172,,369,POINT (10446304 -75516486)
2012,Agosto,Chile,5,27,,32,POINT (10886686 -74776479)
2012,Agosto,Chile,1,6,,7,POINT (11360029 -72129595)
2012,Agosto,Chile,132,63,,195,POINT (125862 -81702165)
2012,Agosto,Chile,26,75,,101,POINT (3451668 -76532004)
2012,Agosto,Chile,2064,3231,,5295,POINT (4697157 -74140516)
2012,Agosto,Chile,56,160,,216,POINT (6170465 -7542726)
2012,Agosto,Chile,1,2,,3,POINT (7128047 -73181317)
2012,Agosto,Chile,13,21,,34,POINT (7819 -72453013)
2012,Agosto,Chile,0,1,,1,POINT (7927233 -72508188)
2012,Agosto,China,0,1,,1,POINT (0.33002 -76876446)
2012,Agosto,China,0,2,,2,POINT (0.81488 -77356)
2012,Agosto,China,5,3,,8,POINT (10446304 -75516486)
2012,Agosto,China,1,0,,1,POINT (10886686 -74776479)
2012,Agosto,China,1,1,,2,POINT (11360029 -72129595)
2012,Agosto,China,1,0,,1,POINT (125862 -81702165)
2012,Agosto,China,2,2,,4,POINT (3451668 -76532004)
2012,Agosto,China,149,464,,613,POINT (4697157 -74140516)
2012,Agosto,China,5,11,,16,POINT (6170465 -7542726)
2012,Agosto,China,2,6,,8,POINT (7819 -72453013)
2012,Agosto,Taiwán,1,1,,2,POINT (0.81488 -77356)
2012,Agosto,Taiwán,1,4,,5,POINT (10446304 -75516486)
2012,Agosto,Taiwán,3,4,,7,POINT (125862 -81702165)
2012,Agosto,Taiwán,1,3,,4,POINT (3451668 -76532004)
2012,Agosto,Taiwán,28,53,,81,POINT (4697157 -74140516)
2012,Agosto,Taiwán,3,10,,13,POINT (6170465 -7542726)
2012,Agosto,Taiwán,1,1,,2,POINT (7128047 -73181317)
2012,Agosto,Taiwán,0,2,,2,POINT (7819 -72453013)
2012,Agosto,Chipre,1,9,,10,POINT (4697157 -74140516)
2012,Agosto,Dinamarca,1,6,,7,POINT (0.81488 -77356)
2012,Agosto,Dinamarca,0,1,,1,POINT (10406342 -75527794)
2012,Agosto,Dinamarca,2,9,,11,POINT (10446304 -75516486)
2012,Agosto,Dinamarca,0,2,,2,POINT (10886686 -74776479)
2012,Agosto,Dinamarca,0,2,,2,POINT (10970933 -74765343)
2012,Agosto,Dinamarca,0,3,,3,POINT (11360029 -72129595)
2012,Agosto,Dinamarca,3,5,,8,POINT (3451668 -76532004)
2012,Agosto,Dinamarca,42,97,,139,POINT (4697157 -74140516)
2012,Agosto,Dinamarca,1,5,,6,POINT (6170465 -7542726)
2012,Agosto,Dominica,0,1,,1,POINT (10406342 -75527794)
2012,Agosto,Dominica,0,1,,1,POINT (11360029 -72129595)
2012,Agosto,Dominica,5,3,,8,POINT (4697157 -74140516)
2012,Agosto,Ecuador,0,1,,1,POINT (-4191162 -69941498)
2012,Agosto,Ecuador,37,52,,89,POINT (0.33002 -76876446)
2012,Agosto,Ecuador,1527,2087,,3614,POINT (0.81488 -77356)
2012,Agosto,Ecuador,0,173,,173,POINT (1800143 -78802679)
2012,Agosto,Ecuador,1,29,,30,POINT (10406342 -75527794)
2012,Agosto,Ecuador,155,139,,294,POINT (10446304 -75516486)
2012,Agosto,Ecuador,1,3,,4,POINT (10886686 -74776479)
2012,Agosto,Ecuador,8,11,,19,POINT (11360029 -72129595)
2012,Agosto,Ecuador,0,1,,1,POINT (1152863 -72919186)
2012,Agosto,Ecuador,0,2,,2,POINT (125744111 -81703935)
2012,Agosto,Ecuador,154,109,,263,POINT (125862 -81702165)
2012,Agosto,Ecuador,572,640,,1212,POINT (3451668 -76532004)
2012,Agosto,Ecuador,1,2,,3,POINT (445285 -75766353)
2012,Agosto,Ecuador,2372,3256,,5628,POINT (4697157 -74140516)
2012,Agosto,Ecuador,0,1,,1,POINT (4815189 -75736374)
2012,Agosto,Ecuador,694,807,,1501,POINT (6170465 -7542726)
2012,Agosto,Ecuador,1,2,,3,POINT (7128047 -73181317)
2012,Agosto,Ecuador,196,217,,413,POINT (7819 -72453013)
2012,Agosto,Ecuador,5,7,,12,POINT (7927233 -72508188)
2012,Agosto,Egipto,3,16,,19,POINT (4697157 -74140516)
2012,Agosto,El Salvador,0,1,,1,POINT (0.81488 -77356)
2012,Agosto,El Salvador,9,8,,17,POINT (10446304 -75516486)
2012,Agosto,El Salvador,1,1,,2,POINT (10886686 -74776479)
2012,Agosto,El Salvador,1,0,,1,POINT (11360029 -72129595)
2012,Agosto,El Salvador,35,14,,49,POINT (125862 -81702165)
2012,Agosto,El Salvador,53,64,,117,POINT (3451668 -76532004)
2012,Agosto,El Salvador,365,562,,927,POINT (4697157 -74140516)
2012,Agosto,El Salvador,26,49,,75,POINT (6170465 -7542726)
2012,Agosto,El Salvador,2,2,,4,POINT (7819 -72453013)
2012,Agosto,Emiratos Árabes,0,1,,1,POINT (4697157 -74140516)
2012,Agosto,España,10,10,,20,POINT (-4191162 -69941498)
2012,Agosto,España,25,43,,68,POINT (0.81488 -77356)
2012,Agosto,España,1,0,,1,POINT (1800143 -78802679)
2012,Agosto,España,2,5,,7,POINT (10406342 -75527794)
2012,Agosto,España,51,99,,150,POINT (10446304 -75516486)
2012,Agosto,España,5,10,,15,POINT (10886686 -74776479)
2012,Agosto,España,9,18,,27,POINT (11360029 -72129595)
2012,Agosto,España,5,2,,7,POINT (125862 -81702165)
2012,Agosto,España,234,458,,692,POINT (3451668 -76532004)
2012,Agosto,España,2,1,,3,POINT (445285 -75766353)
2012,Agosto,España,2147,4050,,6197,POINT (4697157 -74140516)
2012,Agosto,España,2,5,,7,POINT (4815189 -75736374)
2012,Agosto,España,125,255,,380,POINT (6170465 -7542726)
2012,Agosto,España,0,4,,4,POINT (7088729 -70740253)
2012,Agosto,España,1,4,,5,POINT (7128047 -73181317)
2012,Agosto,España,14,28,,42,POINT (7819 -72453013)
2012,Agosto,España,0,6,,6,POINT (7927233 -72508188)
2012,Agosto,España,3,0,,3,POINT (863337 -7735002)
2012,Agosto,Eritrea,0,2,,2,POINT (4697157 -74140516)
2012,Agosto,Eslovaquia,1,0,,1,POINT (10446304 -75516486)
2012,Agosto,Eslovaquia,0,2,,2,POINT (10886686 -74776479)
2012,Agosto,Eslovaquia,1,1,,2,POINT (3451668 -76532004)
2012,Agosto,Eslovaquia,29,12,,41,POINT (4697157 -74140516)
2012,Agosto,Eslovenia,1,1,,2,POINT (0.81488 -77356)
2012,Agosto,Eslovenia,0,2,,2,POINT (10406342 -75527794)
2012,Agosto,Eslovenia,2,0,,2,POINT (11360029 -72129595)
2012,Agosto,Eslovenia,0,1,,1,POINT (3451668 -76532004)
2012,Agosto,Eslovenia,5,15,,20,POINT (4697157 -74140516)
2012,Agosto,Estados Unidos de América,17,11,,28,POINT (-4191162 -69941498)
2012,Agosto,Estados Unidos de América,0,2,,2,POINT (0.33002 -76876446)
2012,Agosto,Estados Unidos de América,62,83,,145,POINT (0.81488 -77356)
2012,Agosto,Estados Unidos de América,38,65,,103,POINT (10406342 -75527794)
2012,Agosto,Estados Unidos de América,889,1713,,2602,POINT (10446304 -75516486)
2012,Agosto,Estados Unidos de América,361,555,,916,POINT (10886686 -74776479)
2012,Agosto,Estados Unidos de América,0,1,,1,POINT (11117206 -74232675)
2012,Agosto,Estados Unidos de América,3,7,,10,POINT (11247723 -74213989)
2012,Agosto,Estados Unidos de América,12,23,,35,POINT (11360029 -72129595)
2012,Agosto,Estados Unidos de América,2,0,,2,POINT (1152863 -72919186)
2012,Agosto,Estados Unidos de América,42,38,,80,POINT (125862 -81702165)
2012,Agosto,Estados Unidos de América,5,4,,9,POINT (133387613 -81372937)
2012,Agosto,Estados Unidos de América,876,1294,,2170,POINT (3451668 -76532004)
2012,Agosto,Estados Unidos de América,100,137,,237,POINT (445285 -75766353)
2012,Agosto,Estados Unidos de América,6568,12252,,18820,POINT (4697157 -74140516)
2012,Agosto,Estados Unidos de América,87,113,,200,POINT (4815189 -75736374)
2012,Agosto,Estados Unidos de América,1342,3083,,4425,POINT (6170465 -7542726)
2012,Agosto,Estados Unidos de América,1,1,,2,POINT (7088729 -70740253)
2012,Agosto,Estados Unidos de América,13,43,,56,POINT (7128047 -73181317)
2012,Agosto,Estados Unidos de América,53,70,,123,POINT (7819 -72453013)
2012,Agosto,Estados Unidos de América,16,13,,29,POINT (7927233 -72508188)
2012,Agosto,Estados Unidos de América,7,14,,21,POINT (863337 -7735002)
2012,Agosto,Estonia,1,0,,1,POINT (-4191162 -69941498)
2012,Agosto,Estonia,5,7,,12,POINT (4697157 -74140516)
2012,Agosto,Etiopia,0,4,,4,POINT (4697157 -74140516)
2012,Agosto,Islas Fiji,1,0,,1,POINT (4697157 -74140516)
2012,Agosto,Filipinas,1,1,,2,POINT (0.81488 -77356)
2012,Agosto,Filipinas,0,19,,19,POINT (10406342 -75527794)
2012,Agosto,Filipinas,1,6,,7,POINT (10446304 -75516486)
2012,Agosto,Filipinas,0,26,,26,POINT (10970933 -74765343)
2012,Agosto,Filipinas,1,1,,2,POINT (11247723 -74213989)
2012,Agosto,Filipinas,1,0,,1,POINT (125862 -81702165)
2012,Agosto,Filipinas,0,15,,15,POINT (3451668 -76532004)
2012,Agosto,Filipinas,0,27,,27,POINT (3884426 -77061029)
2012,Agosto,Filipinas,18,63,,81,POINT (4697157 -74140516)
2012,Agosto,Filipinas,0,1,,1,POINT (6170465 -7542726)
2012,Agosto,Filipinas,1,1,,2,POINT (7819 -72453013)
2012,Agosto,Filipinas,0,5,,5,POINT (9402597 -75681642)
2012,Agosto,Finlandia,4,2,,6,POINT (0.81488 -77356)
2012,Agosto,Finlandia,1,0,,1,POINT (10406342 -75527794)
2012,Agosto,Finlandia,0,2,,2,POINT (10446304 -75516486)
2012,Agosto,Finlandia,0,2,,2,POINT (10886686 -74776479)
2012,Agosto,Finlandia,2,1,,3,POINT (11360029 -72129595)
2012,Agosto,Finlandia,1,1,,2,POINT (3451668 -76532004)
2012,Agosto,Finlandia,30,45,,75,POINT (4697157 -74140516)
2012,Agosto,Finlandia,1,4,,5,POINT (6170465 -7542726)
2012,Agosto,Finlandia,0,2,,2,POINT (7128047 -73181317)
2012,Agosto,Finlandia,0,1,,1,POINT (7819 -72453013)
2012,Agosto,Francia,12,17,,29,POINT (-4191162 -69941498)
2012,Agosto,Francia,43,63,,106,POINT (0.81488 -77356)
2012,Agosto,Francia,1,0,,1,POINT (1800143 -78802679)
2012,Agosto,Francia,9,14,,23,POINT (10406342 -75527794)
2012,Agosto,Francia,30,37,,67,POINT (10446304 -75516486)
2012,Agosto,Francia,0,11,,11,POINT (10886686 -74776479)
2012,Agosto,Francia,3,2,,5,POINT (11247723 -74213989)
2012,Agosto,Francia,10,22,,32,POINT (11360029 -72129595)
2012,Agosto,Francia,0,1,,1,POINT (1152863 -72919186)
2012,Agosto,Francia,0,1,,1,POINT (125862 -81702165)
2012,Agosto,Francia,33,68,,101,POINT (3451668 -76532004)
2012,Agosto,Francia,1345,2089,,3434,POINT (4697157 -74140516)
2012,Agosto,Francia,3,4,,7,POINT (4815189 -75736374)
2012,Agosto,Francia,35,66,,101,POINT (6170465 -7542726)
2012,Agosto,Francia,0,2,,2,POINT (7128047 -73181317)
2012,Agosto,Francia,13,20,,33,POINT (7819 -72453013)
2012,Agosto,Francia,2,2,,4,POINT (7927233 -72508188)
2012,Agosto,Francia,2,6,,8,POINT (863337 -7735002)
2012,Agosto,Gambia,0,1,,1,POINT (10886686 -74776479)
2012,Agosto,Georgia,0,1,,1,POINT (4697157 -74140516)
2012,Agosto,Ghana,0,2,,2,POINT (4697157 -74140516)
2012,Agosto,Granada,1,0,,1,POINT (4697157 -74140516)
2012,Agosto,Granada,2,1,,3,POINT (6170465 -7542726)
2012,Agosto,Grecia,0,2,,2,POINT (10406342 -75527794)
2012,Agosto,Grecia,0,2,,2,POINT (10446304 -75516486)
2012,Agosto,Grecia,2,0,,2,POINT (10886686 -74776479)
2012,Agosto,Grecia,17,41,,58,POINT (4697157 -74140516)
2012,Agosto,Grecia,1,3,,4,POINT (6170465 -7542726)
2012,Agosto,Grecia,1,0,,1,POINT (7819 -72453013)
2012,Agosto,Grecia,0,2,,2,POINT (9402597 -75681642)
2012,Agosto,Guatemala,0,1,,1,POINT (0.81488 -77356)
2012,Agosto,Guatemala,19,33,,52,POINT (10446304 -75516486)
2012,Agosto,Guatemala,6,11,,17,POINT (10886686 -74776479)
2012,Agosto,Guatemala,0,1,,1,POINT (11117206 -74232675)
2012,Agosto,Guatemala,1,3,,4,POINT (11360029 -72129595)
2012,Agosto,Guatemala,32,78,,110,POINT (3451668 -76532004)
2012,Agosto,Guatemala,1,1,,2,POINT (445285 -75766353)
2012,Agosto,Guatemala,176,329,,505,POINT (4697157 -74140516)
2012,Agosto,Guatemala,2,10,,12,POINT (4815189 -75736374)
2012,Agosto,Guatemala,41,128,,169,POINT (6170465 -7542726)
2012,Agosto,Guatemala,0,2,,2,POINT (7128047 -73181317)
2012,Agosto,Guatemala,3,12,,15,POINT (7819 -72453013)
2012,Agosto,Guatemala,0,4,,4,POINT (7927233 -72508188)
2012,Agosto,Guyana,1,2,,3,POINT (10446304 -75516486)
2012,Agosto,Guyana,0,1,,1,POINT (11360029 -72129595)
2012,Agosto,Guyana,1,5,,6,POINT (3451668 -76532004)
2012,Agosto,Guyana,0,5,,5,POINT (4697157 -74140516)
2012,Agosto,Guyana,1,4,,5,POINT (6170465 -7542726)
2012,Agosto,Guinea Ecuatorial,1,0,,1,POINT (4697157 -74140516)
2012,Agosto,Guayana Francesa/Departamento de Ultramar Francés,0,1,,1,POINT (1152863 -72919186)
2012,Agosto,Haití,0,2,,2,POINT (10446304 -75516486)
2012,Agosto,Haití,1,1,,2,POINT (10886686 -74776479)
2012,Agosto,Haití,6,12,,18,POINT (4697157 -74140516)
2012,Agosto,Haití,2,4,,6,POINT (6170465 -7542726)
2012,Agosto,Honduras,0,7,,7,POINT (10406342 -75527794)
2012,Agosto,Honduras,10,23,,33,POINT (10446304 -75516486)
2012,Agosto,Honduras,2,4,,6,POINT (10886686 -74776479)
2012,Agosto,Honduras,0,2,,2,POINT (10970933 -74765343)
2012,Agosto,Honduras,0,39,,39,POINT (125744111 -81703935)
2012,Agosto,Honduras,1,2,,3,POINT (125862 -81702165)
2012,Agosto,Honduras,11,18,,29,POINT (3451668 -76532004)
2012,Agosto,Honduras,136,148,,284,POINT (4697157 -74140516)
2012,Agosto,Honduras,1,0,,1,POINT (4815189 -75736374)
2012,Agosto,Honduras,27,36,,63,POINT (6170465 -7542726)
2012,Agosto,Honduras,0,1,,1,POINT (7819 -72453013)
2012,Agosto,Honduras,1,0,,1,POINT (863337 -7735002)
2012,Agosto,Hungría,1,1,,2,POINT (0.81488 -77356)
2012,Agosto,Hungría,0,1,,1,POINT (10406342 -75527794)
2012,Agosto,Hungría,0,2,,2,POINT (3451668 -76532004)
2012,Agosto,Hungría,15,27,,42,POINT (4697157 -74140516)
2012,Agosto,Hungría,1,2,,3,POINT (6170465 -7542726)
2012,Agosto,Hungría,2,4,,6,POINT (7819 -72453013)
2012,Agosto,India,0,1,,1,POINT (-4191162 -69941498)
2012,Agosto,India,0,7,,7,POINT (0.81488 -77356)
2012,Agosto,India,0,1,,1,POINT (10406342 -75527794)
2012,Agosto,India,3,6,,9,POINT (10446304 -75516486)
2012,Agosto,India,0,4,,4,POINT (10886686 -74776479)
2012,Agosto,India,0,5,,5,POINT (3451668 -76532004)
2012,Agosto,India,0,1,,1,POINT (3884426 -77061029)
2012,Agosto,India,32,258,,290,POINT (4697157 -74140516)
2012,Agosto,India,5,22,,27,POINT (6170465 -7542726)
2012,Agosto,Indonesia,1,1,,2,POINT (10446304 -75516486)
2012,Agosto,Indonesia,0,1,,1,POINT (10970933 -74765343)
2012,Agosto,Indonesia,0,1,,1,POINT (3451668 -76532004)
2012,Agosto,Indonesia,6,5,,11,POINT (4697157 -74140516)
2012,Agosto,Iraq,2,0,,2,POINT (4697157 -74140516)
2012,Agosto,Irán,5,19,,24,POINT (4697157 -74140516)
2012,Agosto,Irán,0,1,,1,POINT (7819 -72453013)
2012,Agosto,República de Irlanda,1,5,,6,POINT (-4191162 -69941498)
2012,Agosto,República de Irlanda,11,17,,28,POINT (0.81488 -77356)
2012,Agosto,República de Irlanda,3,2,,5,POINT (10406342 -75527794)
2012,Agosto,República de Irlanda,5,9,,14,POINT (10446304 -75516486)
2012,Agosto,República de Irlanda,0,1,,1,POINT (11360029 -72129595)
2012,Agosto,República de Irlanda,0,6,,6,POINT (3451668 -76532004)
2012,Agosto,República de Irlanda,63,103,,166,POINT (4697157 -74140516)
2012,Agosto,República de Irlanda,5,7,,12,POINT (6170465 -7542726)
2012,Agosto,República de Irlanda,1,3,,4,POINT (863337 -7735002)
2012,Agosto,Islandia,1,0,,1,POINT (-4191162 -69941498)
2012,Agosto,Islandia,0,1,,1,POINT (0.81488 -77356)
2012,Agosto,Islandia,0,1,,1,POINT (10406342 -75527794)
2012,Agosto,Islandia,2,2,,4,POINT (10446304 -75516486)
2012,Agosto,Islandia,0,1,,1,POINT (10970933 -74765343)
2012,Agosto,Islandia,0,1,,1,POINT (3451668 -76532004)
2012,Agosto,Islandia,5,6,,11,POINT (4697157 -74140516)
2012,Agosto,Islandia,0,1,,1,POINT (6170465 -7542726)
2012,Agosto,Isla de Man,0,1,,1,POINT (-4191162 -69941498)
2012,Agosto,Isla de Man,8,21,,29,POINT (0.81488 -77356)
2012,Agosto,Isla de Man,0,7,,7,POINT (10446304 -75516486)
2012,Agosto,Isla de Man,1,5,,6,POINT (10886686 -74776479)
2012,Agosto,Isla de Man,10,18,,28,POINT (3451668 -76532004)
2012,Agosto,Isla de Man,41,69,,110,POINT (4697157 -74140516)
2012,Agosto,Isla de Man,8,43,,51,POINT (6170465 -7542726)
2012,Agosto,Isla de Man,1,2,,3,POINT (7819 -72453013)
2012,Agosto,Isla Johnston,0,1,,1,POINT (6170465 -7542726)
2012,Agosto,Israel,2,1,,3,POINT (-4191162 -69941498)
2012,Agosto,Israel,23,53,,76,POINT (0.81488 -77356)
2012,Agosto,Israel,0,1,,1,POINT (10406342 -75527794)
2012,Agosto,Israel,4,29,,33,POINT (10446304 -75516486)
2012,Agosto,Israel,3,8,,11,POINT (10886686 -74776479)
2012,Agosto,Israel,2,3,,5,POINT (125862 -81702165)
2012,Agosto,Israel,3,18,,21,POINT (3451668 -76532004)
2012,Agosto,Israel,83,339,,422,POINT (4697157 -74140516)
2012,Agosto,Israel,15,73,,88,POINT (6170465 -7542726)
2012,Agosto,Israel,0,1,,1,POINT (7128047 -73181317)
2012,Agosto,Israel,0,1,,1,POINT (7819 -72453013)
2012,Agosto,Israel,3,4,,7,POINT (863337 -7735002)
2012,Agosto,Islas Aland/Provincia de Finlandia,0,2,,2,POINT (4697157 -74140516)
2012,Agosto,Italia,7,12,,19,POINT (-4191162 -69941498)
2012,Agosto,Italia,13,24,,37,POINT (0.81488 -77356)
2012,Agosto,Italia,6,10,,16,POINT (10406342 -75527794)
2012,Agosto,Italia,49,156,,205,POINT (10446304 -75516486)
2012,Agosto,Italia,4,13,,17,POINT (10886686 -74776479)
2012,Agosto,Italia,11,19,,30,POINT (11360029 -72129595)
2012,Agosto,Italia,10,12,,22,POINT (125862 -81702165)
2012,Agosto,Italia,29,91,,120,POINT (3451668 -76532004)
2012,Agosto,Italia,649,1739,,2388,POINT (4697157 -74140516)
2012,Agosto,Italia,2,1,,3,POINT (4815189 -75736374)
2012,Agosto,Italia,50,117,,167,POINT (6170465 -7542726)
2012,Agosto,Italia,0,3,,3,POINT (7128047 -73181317)
2012,Agosto,Italia,7,27,,34,POINT (7819 -72453013)
2012,Agosto,Italia,1,5,,6,POINT (7927233 -72508188)
2012,Agosto,Italia,0,3,,3,POINT (863337 -7735002)
2012,Agosto,Jamaica,2,0,,2,POINT (10446304 -75516486)
2012,Agosto,Jamaica,0,2,,2,POINT (10886686 -74776479)
2012,Agosto,Jamaica,3,3,,6,POINT (3451668 -76532004)
2012,Agosto,Jamaica,11,15,,26,POINT (4697157 -74140516)
2012,Agosto,Jamaica,2,9,,11,POINT (6170465 -7542726)
2012,Agosto,Jamaica,0,1,,1,POINT (7819 -72453013)
2012,Agosto,Japón,0,1,,1,POINT (-4191162 -69941498)
2012,Agosto,Japón,7,18,,25,POINT (0.81488 -77356)
2012,Agosto,Japón,4,0,,4,POINT (10406342 -75527794)
2012,Agosto,Japón,1,17,,18,POINT (10446304 -75516486)
2012,Agosto,Japón,0,3,,3,POINT (10886686 -74776479)
2012,Agosto,Japón,0,1,,1,POINT (11360029 -72129595)
2012,Agosto,Japón,0,1,,1,POINT (125862 -81702165)
2012,Agosto,Japón,9,11,,20,POINT (3451668 -76532004)
2012,Agosto,Japón,176,451,,627,POINT (4697157 -74140516)
2012,Agosto,Japón,3,30,,33,POINT (6170465 -7542726)
2012,Agosto,Japón,4,3,,7,POINT (7819 -72453013)
2012,Agosto,Jordania,1,2,,3,POINT (4697157 -74140516)
2012,Agosto,Jordania,0,1,,1,POINT (6170465 -7542726)
2012,Agosto,Kazajistán,0,1,,1,POINT (10406342 -75527794)
2012,Agosto,Kenia,6,5,,11,POINT (3451668 -76532004)
2012,Agosto,Kenia,1,6,,7,POINT (4697157 -74140516)
2012,Agosto,Kenia,0,1,,1,POINT (6170465 -7542726)
2012,Agosto,Kuwait,0,3,,3,POINT (4697157 -74140516)
2012,Agosto,Letonia,0,2,,2,POINT (10446304 -75516486)
2012,Agosto,Letonia,1,0,,1,POINT (10886686 -74776479)
2012,Agosto,Letonia,6,7,,13,POINT (4697157 -74140516)
2012,Agosto,Lituania,2,0,,2,POINT (0.81488 -77356)
2012,Agosto,Lituania,2,1,,3,POINT (10446304 -75516486)
2012,Agosto,Lituania,0,1,,1,POINT (3451668 -76532004)
2012,Agosto,Lituania,5,7,,12,POINT (4697157 -74140516)
2012,Agosto,Lituania,0,2,,2,POINT (6170465 -7542726)
2012,Agosto,Líbano,0,1,,1,POINT (10886686 -74776479)
2012,Agosto,Líbano,7,5,,12,POINT (11360029 -72129595)
2012,Agosto,Líbano,1,2,,3,POINT (3451668 -76532004)
2012,Agosto,Líbano,22,39,,61,POINT (4697157 -74140516)
2012,Agosto,Líbano,0,1,,1,POINT (6170465 -7542726)
2012,Agosto,Líbano,0,1,,1,POINT (7128047 -73181317)
2012,Agosto,Liechtenstein,2,2,,4,POINT (4697157 -74140516)
2012,Agosto,Liechtenstein,0,1,,1,POINT (6170465 -7542726)
2012,Agosto,Luxemburgo,4,2,,6,POINT (-4191162 -69941498)
2012,Agosto,Luxemburgo,0,1,,1,POINT (11360029 -72129595)
2012,Agosto,Luxemburgo,9,20,,29,POINT (4697157 -74140516)
2012,Agosto,Luxemburgo,0,1,,1,POINT (6170465 -7542726)
2012,Agosto,Madagascar,0,2,,2,POINT (4697157 -74140516)
2012,Agosto,Malasia,0,2,,2,POINT (10446304 -75516486)
2012,Agosto,Malasia,10,19,,29,POINT (4697157 -74140516)
2012,Agosto,Malasia,0,2,,2,POINT (6170465 -7542726)
2012,Agosto,Malasia,0,1,,1,POINT (7819 -72453013)
2012,Agosto,Malawi,0,1,,1,POINT (3451668 -76532004)
2012,Agosto,Malta,0,1,,1,POINT (10446304 -75516486)
2012,Agosto,Malta,2,1,,3,POINT (4697157 -74140516)
2012,Agosto,Marruecos,0,2,,2,POINT (10886686 -74776479)
2012,Agosto,Marruecos,4,8,,12,POINT (4697157 -74140516)
2012,Agosto,Marruecos,0,1,,1,POINT (7819 -72453013)
2012,Agosto,Mauricio,1,0,,1,POINT (10446304 -75516486)
2012,Agosto,México,0,1,,1,POINT (-4191162 -69941498)
2012,Agosto,México,4,0,,4,POINT (0.33002 -76876446)
2012,Agosto,México,15,25,,40,POINT (0.81488 -77356)
2012,Agosto,México,0,2,,2,POINT (1800143 -78802679)
2012,Agosto,México,2,9,,11,POINT (10406342 -75527794)
2012,Agosto,México,82,153,,235,POINT (10446304 -75516486)
2012,Agosto,México,15,37,,52,POINT (10886686 -74776479)
2012,Agosto,México,5,6,,11,POINT (11360029 -72129595)
2012,Agosto,México,0,1,,1,POINT (1152863 -72919186)
2012,Agosto,México,0,2,,2,POINT (125744111 -81703935)
2012,Agosto,México,2,11,,13,POINT (125862 -81702165)
2012,Agosto,México,65,160,,225,POINT (3451668 -76532004)
2012,Agosto,México,2015,4485,,6500,POINT (4697157 -74140516)
2012,Agosto,México,6,7,,13,POINT (4815189 -75736374)
2012,Agosto,México,128,401,,529,POINT (6170465 -7542726)
2012,Agosto,México,0,6,,6,POINT (7128047 -73181317)
2012,Agosto,México,14,32,,46,POINT (7819 -72453013)
2012,Agosto,México,2,4,,6,POINT (7927233 -72508188)
2012,Agosto,México,1,2,,3,POINT (863337 -7735002)
2012,Agosto,República de Moldavia,2,0,,2,POINT (4697157 -74140516)
2012,Agosto,República de Moldavia,1,0,,1,POINT (6170465 -7542726)
2012,Agosto,Mónaco,0,1,,1,POINT (10446304 -75516486)
2012,Agosto,Mongolia,0,1,,1,POINT (6170465 -7542726)
2012,Agosto,Mozambique,0,1,,1,POINT (0.33002 -76876446)
2012,Agosto,Mozambique,1,6,,7,POINT (4697157 -74140516)
2012,Agosto,Nepal,0,2,,2,POINT (4697157 -74140516)
2012,Agosto,Nicaragua,0,1,,1,POINT (10406342 -75527794)
2012,Agosto,Nicaragua,6,7,,13,POINT (10446304 -75516486)
2012,Agosto,Nicaragua,2,1,,3,POINT (10886686 -74776479)
2012,Agosto,Nicaragua,3,1,,4,POINT (125862 -81702165)
2012,Agosto,Nicaragua,8,3,,11,POINT (3451668 -76532004)
2012,Agosto,Nicaragua,49,26,,75,POINT (4697157 -74140516)
2012,Agosto,Nicaragua,6,9,,15,POINT (6170465 -7542726)
2012,Agosto,Nicaragua,0,1,,1,POINT (863337 -7735002)
2012,Agosto,Nigeria,1,3,,4,POINT (4697157 -74140516)
2012,Agosto,Noruega,2,1,,3,POINT (0.81488 -77356)
2012,Agosto,Noruega,0,1,,1,POINT (10406342 -75527794)
2012,Agosto,Noruega,1,6,,7,POINT (10446304 -75516486)
2012,Agosto,Noruega,0,2,,2,POINT (10886686 -74776479)
2012,Agosto,Noruega,1,5,,6,POINT (10970933 -74765343)
2012,Agosto,Noruega,0,1,,1,POINT (11360029 -72129595)
2012,Agosto,Noruega,4,8,,12,POINT (3451668 -76532004)
2012,Agosto,Noruega,43,81,,124,POINT (4697157 -74140516)
2012,Agosto,Noruega,1,14,,15,POINT (6170465 -7542726)
2012,Agosto,Noruega,2,3,,5,POINT (7128047 -73181317)
2012,Agosto,Noruega,2,4,,6,POINT (7819 -72453013)
2012,Agosto,Nueva Zelanda,1,0,,1,POINT (-4191162 -69941498)
2012,Agosto,Nueva Zelanda,7,9,,16,POINT (0.81488 -77356)
2012,Agosto,Nueva Zelanda,3,8,,11,POINT (10446304 -75516486)
2012,Agosto,Nueva Zelanda,0,2,,2,POINT (10886686 -74776479)
2012,Agosto,Nueva Zelanda,2,2,,4,POINT (11360029 -72129595)
2012,Agosto,Nueva Zelanda,0,2,,2,POINT (3451668 -76532004)
2012,Agosto,Nueva Zelanda,32,60,,92,POINT (4697157 -74140516)
2012,Agosto,Nueva Zelanda,0,1,,1,POINT (4815189 -75736374)
2012,Agosto,Nueva Zelanda,4,5,,9,POINT (6170465 -7542726)
2012,Agosto,Nueva Zelanda,4,3,,7,POINT (863337 -7735002)
2012,Agosto,Omán,1,0,,1,POINT (4697157 -74140516)
2012,Agosto,Nueva Zelanda,4,6,,10,POINT (10406342 -75527794)
2012,Agosto,Nueva Zelanda,1,0,,1,POINT (10446304 -75516486)
2012,Agosto,Nueva Zelanda,0,4,,4,POINT (4697157 -74140516)
2012,Agosto,Países Bajos,2,16,,18,POINT (0.81488 -77356)
2012,Agosto,Países Bajos,3,7,,10,POINT (10446304 -75516486)
2012,Agosto,Países Bajos,3,6,,9,POINT (10886686 -74776479)
2012,Agosto,Países Bajos,5,8,,13,POINT (11360029 -72129595)
2012,Agosto,Países Bajos,30,30,,60,POINT (1152863 -72919186)
2012,Agosto,Países Bajos,10,28,,38,POINT (3451668 -76532004)
2012,Agosto,Países Bajos,0,2,,2,POINT (3884426 -77061029)
2012,Agosto,Países Bajos,145,282,,427,POINT (4697157 -74140516)
2012,Agosto,Países Bajos,0,2,,2,POINT (4815189 -75736374)
2012,Agosto,Países Bajos,115,191,,306,POINT (6170465 -7542726)
2012,Agosto,Países Bajos,6,8,,14,POINT (7128047 -73181317)
2012,Agosto,Países Bajos,1,0,,1,POINT (7819 -72453013)
2012,Agosto,Países Bajos,0,1,,1,POINT (7927233 -72508188)
2012,Agosto,Pakistán,0,1,,1,POINT (0.81488 -77356)
2012,Agosto,Pakistán,0,1,,1,POINT (11360029 -72129595)
2012,Agosto,Pakistán,4,12,,16,POINT (4697157 -74140516)
2012,Agosto,Pakistán,0,1,,1,POINT (7819 -72453013)
2012,Agosto,Panamá,0,2,,2,POINT (0.81488 -77356)
2012,Agosto,Panamá,1,54,,55,POINT (10406342 -75527794)
2012,Agosto,Panamá,132,186,,318,POINT (10446304 -75516486)
2012,Agosto,Panamá,74,107,,181,POINT (10886686 -74776479)
2012,Agosto,Panamá,0,1,,1,POINT (10970933 -74765343)
2012,Agosto,Panamá,1,2,,3,POINT (11360029 -72129595)
2012,Agosto,Panamá,27,26,,53,POINT (125862 -81702165)
2012,Agosto,Panamá,104,172,,276,POINT (3451668 -76532004)
2012,Agosto,Panamá,479,766,,1245,POINT (4697157 -74140516)
2012,Agosto,Panamá,49,75,,124,POINT (4815189 -75736374)
2012,Agosto,Panamá,151,308,,459,POINT (6170465 -7542726)
2012,Agosto,Panamá,4,4,,8,POINT (6222552 -77401154)
2012,Agosto,Panamá,11,9,,20,POINT (7128047 -73181317)
2012,Agosto,Panamá,1,3,,4,POINT (7819 -72453013)
2012,Agosto,Panamá,1,5,,6,POINT (7927233 -72508188)
2012,Agosto,Panamá,2,0,,2,POINT (806667 -767333)
2012,Agosto,Panamá,1,1,,2,POINT (863337 -7735002)
2012,Agosto,Papúa Nueva Guinea,0,1,,1,POINT (4697157 -74140516)
2012,Agosto,Paraguay,2,0,,2,POINT (0.81488 -77356)
2012,Agosto,Paraguay,32,13,,45,POINT (10446304 -75516486)
2012,Agosto,Paraguay,0,1,,1,POINT (10886686 -74776479)
2012,Agosto,Paraguay,4,1,,5,POINT (125862 -81702165)
2012,Agosto,Paraguay,3,1,,4,POINT (3451668 -76532004)
2012,Agosto,Paraguay,65,77,,142,POINT (4697157 -74140516)
2012,Agosto,Paraguay,3,7,,10,POINT (6170465 -7542726)
2012,Agosto,Paraguay,1,1,,2,POINT (7819 -72453013)
2012,Agosto,Perú,24,33,,57,POINT (-4191162 -69941498)
2012,Agosto,Perú,0,3,,3,POINT (0.33002 -76876446)
2012,Agosto,Perú,153,357,,510,POINT (0.81488 -77356)
2012,Agosto,Perú,1,4,,5,POINT (10406342 -75527794)
2012,Agosto,Perú,155,163,,318,POINT (10446304 -75516486)
2012,Agosto,Perú,6,23,,29,POINT (10886686 -74776479)
2012,Agosto,Perú,0,2,,2,POINT (10970933 -74765343)
2012,Agosto,Perú,6,21,,27,POINT (11360029 -72129595)
2012,Agosto,Perú,318,250,,568,POINT (125862 -81702165)
2012,Agosto,Perú,88,101,,189,POINT (3451668 -76532004)
2012,Agosto,Perú,0,1,,1,POINT (3884426 -77061029)
2012,Agosto,Perú,2511,3245,,5756,POINT (4697157 -74140516)
2012,Agosto,Perú,0,2,,2,POINT (4815189 -75736374)
2012,Agosto,Perú,160,315,,475,POINT (6170465 -7542726)
2012,Agosto,Perú,3,3,,6,POINT (7128047 -73181317)
2012,Agosto,Perú,32,65,,97,POINT (7819 -72453013)
2012,Agosto,Perú,0,1,,1,POINT (7927233 -72508188)
2012,Agosto,Perú,1,1,,2,POINT (863337 -7735002)
2012,Agosto,Perú,0,2,,2,POINT (9402597 -75681642)
2012,Agosto,Palestina,1,4,,5,POINT (4697157 -74140516)
2012,Agosto,Polonia,3,1,,4,POINT (-4191162 -69941498)
2012,Agosto,Polonia,6,9,,15,POINT (0.81488 -77356)
2012,Agosto,Polonia,1,4,,5,POINT (10406342 -75527794)
2012,Agosto,Polonia,1,2,,3,POINT (10446304 -75516486)
2012,Agosto,Polonia,3,1,,4,POINT (11360029 -72129595)
2012,Agosto,Polonia,0,2,,2,POINT (3451668 -76532004)
2012,Agosto,Polonia,76,102,,178,POINT (4697157 -74140516)
2012,Agosto,Polonia,7,5,,12,POINT (6170465 -7542726)
2012,Agosto,Polonia,1,7,,8,POINT (7819 -72453013)
2012,Agosto,Polonia,0,1,,1,POINT (863337 -7735002)
2012,Agosto,Portugal,1,3,,4,POINT (0.81488 -77356)
2012,Agosto,Portugal,0,1,,1,POINT (10406342 -75527794)
2012,Agosto,Portugal,1,4,,5,POINT (10446304 -75516486)
2012,Agosto,Portugal,2,0,,2,POINT (10886686 -74776479)
2012,Agosto,Portugal,1,1,,2,POINT (11360029 -72129595)
2012,Agosto,Portugal,4,7,,11,POINT (3451668 -76532004)
2012,Agosto,Portugal,74,274,,348,POINT (4697157 -74140516)
2012,Agosto,Portugal,9,17,,26,POINT (6170465 -7542726)
2012,Agosto,Portugal,3,3,,6,POINT (7819 -72453013)
2012,Agosto,Puerto Rico/Territorio de Estados Unidos,0,3,,3,POINT (10446304 -75516486)
2012,Agosto,Puerto Rico/Territorio de Estados Unidos,0,1,,1,POINT (4697157 -74140516)
2012,Agosto,Puerto Rico/Territorio de Estados Unidos,1,1,,2,POINT (6170465 -7542726)
2012,Agosto,Qatar,3,0,,3,POINT (4697157 -74140516)
2012,Agosto,Qatar,0,1,,1,POINT (6170465 -7542726)
2012,Agosto,Reino Unido de Gran Bretaña e Irlanda del Norte,8,4,,12,POINT (-4191162 -69941498)
2012,Agosto,Reino Unido de Gran Bretaña e Irlanda del Norte,7,8,,15,POINT (0.81488 -77356)
2012,Agosto,Reino Unido de Gran Bretaña e Irlanda del Norte,17,27,,44,POINT (10446304 -75516486)
2012,Agosto,Reino Unido de Gran Bretaña e Irlanda del Norte,1,2,,3,POINT (10886686 -74776479)
2012,Agosto,Reino Unido de Gran Bretaña e Irlanda del Norte,2,7,,9,POINT (10970933 -74765343)
2012,Agosto,Reino Unido de Gran Bretaña e Irlanda del Norte,4,6,,10,POINT (11360029 -72129595)
2012,Agosto,Reino Unido de Gran Bretaña e Irlanda del Norte,0,1,,1,POINT (125862 -81702165)
2012,Agosto,Reino Unido de Gran Bretaña e Irlanda del Norte,12,15,,27,POINT (3451668 -76532004)
2012,Agosto,Reino Unido de Gran Bretaña e Irlanda del Norte,244,525,,769,POINT (4697157 -74140516)
2012,Agosto,Reino Unido de Gran Bretaña e Irlanda del Norte,16,26,,42,POINT (6170465 -7542726)
2012,Agosto,Reino Unido de Gran Bretaña e Irlanda del Norte,0,2,,2,POINT (7819 -72453013)
2012,Agosto,República de Belarús,0,1,,1,POINT (4697157 -74140516)
2012,Agosto,República Dominicana,5,10,,15,POINT (0.81488 -77356)
2012,Agosto,República Dominicana,0,2,,2,POINT (10406342 -75527794)
2012,Agosto,República Dominicana,18,42,,60,POINT (10446304 -75516486)
2012,Agosto,República Dominicana,18,28,,46,POINT (10886686 -74776479)
2012,Agosto,República Dominicana,0,1,,1,POINT (11247723 -74213989)
2012,Agosto,República Dominicana,0,1,,1,POINT (1152863 -72919186)
2012,Agosto,República Dominicana,0,1,,1,POINT (125862 -81702165)
2012,Agosto,República Dominicana,18,22,,40,POINT (3451668 -76532004)
2012,Agosto,República Dominicana,226,268,,494,POINT (4697157 -74140516)
2012,Agosto,República Dominicana,1,1,,2,POINT (4815189 -75736374)
2012,Agosto,República Dominicana,30,97,,127,POINT (6170465 -7542726)
2012,Agosto,República Dominicana,2,4,,6,POINT (7128047 -73181317)
2012,Agosto,República Dominicana,7,7,,14,POINT (7819 -72453013)
2012,Agosto,República Dominicana,7,3,,10,POINT (7927233 -72508188)
2012,Agosto,República Dominicana,0,1,,1,POINT (863337 -7735002)
2012,Agosto,República Checa,3,3,,6,POINT (4697157 -74140516)
2012,Agosto,República Checa,0,2,,2,POINT (7819 -72453013)
2012,Agosto,Rumania,0,1,,1,POINT (0.81488 -77356)
2012,Agosto,Rumania,0,3,,3,POINT (10406342 -75527794)
2012,Agosto,Rumania,0,1,,1,POINT (10970933 -74765343)
2012,Agosto,Rumania,0,1,,1,POINT (11247723 -74213989)
2012,Agosto,Rumania,0,1,,1,POINT (11360029 -72129595)
2012,Agosto,Rumania,2,3,,5,POINT (3451668 -76532004)
2012,Agosto,Rumania,26,36,,62,POINT (4697157 -74140516)
2012,Agosto,Rumania,0,2,,2,POINT (6170465 -7542726)
2012,Agosto,Rumania,0,1,,1,POINT (7819 -72453013)
2012,Agosto,Federación de Rusia,0,4,,4,POINT (0.81488 -77356)
2012,Agosto,Federación de Rusia,0,1,,1,POINT (10406342 -75527794)
2012,Agosto,Federación de Rusia,3,4,,7,POINT (10446304 -75516486)
2012,Agosto,Federación de Rusia,2,1,,3,POINT (11360029 -72129595)
2012,Agosto,Federación de Rusia,4,2,,6,POINT (3451668 -76532004)
2012,Agosto,Federación de Rusia,40,40,,80,POINT (4697157 -74140516)
2012,Agosto,Federación de Rusia,1,0,,1,POINT (4815189 -75736374)
2012,Agosto,Federación de Rusia,0,1,,1,POINT (6170465 -7542726)
2012,Agosto,Rwanda,0,1,,1,POINT (3451668 -76532004)
2012,Agosto,San Cristóbal y Nevis,0,1,,1,POINT (11360029 -72129595)
2012,Agosto,San Cristóbal y Nevis,0,2,,2,POINT (4697157 -74140516)
2012,Agosto,San Cristóbal y Nevis,1,1,,2,POINT (6170465 -7542726)
2012,Agosto,San  Vicente y las Granadinas,0,2,,2,POINT (4697157 -74140516)
2012,Agosto,San  Vicente y las Granadinas,0,2,,2,POINT (6170465 -7542726)
2012,Agosto,Santa Lucia,1,0,,1,POINT (10446304 -75516486)
2012,Agosto,Santa Lucia,3,0,,3,POINT (4697157 -74140516)
2012,Agosto,Santa Lucia,3,2,,5,POINT (6170465 -7542726)
2012,Agosto,Santa Lucia,1,1,,2,POINT (7128047 -73181317)
2012,Agosto,Serbia,0,1,,1,POINT (0.81488 -77356)
2012,Agosto,Serbia,1,0,,1,POINT (10446304 -75516486)
2012,Agosto,Serbia,2,2,,4,POINT (4697157 -74140516)
2012,Agosto,Sierra Leona,0,1,,1,POINT (4697157 -74140516)
2012,Agosto,Singapur,1,0,,1,POINT (0.81488 -77356)
2012,Agosto,Singapur,0,1,,1,POINT (10446304 -75516486)
2012,Agosto,Singapur,15,19,,34,POINT (4697157 -74140516)
2012,Agosto,Singapur,0,2,,2,POINT (6170465 -7542726)
2012,Agosto,República Árabe Siria,1,1,,2,POINT (10886686 -74776479)
2012,Agosto,República Árabe Siria,0,1,,1,POINT (11360029 -72129595)
2012,Agosto,Sri Lanka,1,3,,4,POINT (4697157 -74140516)
2012,Agosto,Sudáfrica,0,1,,1,POINT (-4191162 -69941498)
2012,Agosto,Sudáfrica,1,3,,4,POINT (0.81488 -77356)
2012,Agosto,Sudáfrica,2,4,,6,POINT (10446304 -75516486)
2012,Agosto,Sudáfrica,0,4,,4,POINT (10886686 -74776479)
2012,Agosto,Sudáfrica,0,1,,1,POINT (10970933 -74765343)
2012,Agosto,Sudáfrica,1,1,,2,POINT (11360029 -72129595)
2012,Agosto,Sudáfrica,0,3,,3,POINT (3451668 -76532004)
2012,Agosto,Sudáfrica,29,89,,118,POINT (4697157 -74140516)
2012,Agosto,Sudáfrica,2,2,,4,POINT (6170465 -7542726)
2012,Agosto,Sudáfrica,1,0,,1,POINT (7927233 -72508188)
2012,Agosto,Sudáfrica,0,5,,5,POINT (863337 -7735002)
2012,Agosto,Sudán,1,0,,1,POINT (10446304 -75516486)
2012,Agosto,Sudán,1,0,,1,POINT (4697157 -74140516)
2012,Agosto,Suecia,1,0,,1,POINT (-4191162 -69941498)
2012,Agosto,Suecia,1,4,,5,POINT (0.81488 -77356)
2012,Agosto,Suecia,1,0,,1,POINT (10406342 -75527794)
2012,Agosto,Suecia,4,9,,13,POINT (10446304 -75516486)
2012,Agosto,Suecia,0,1,,1,POINT (11247723 -74213989)
2012,Agosto,Suecia,1,1,,2,POINT (11360029 -72129595)
2012,Agosto,Suecia,0,1,,1,POINT (133387613 -81372937)
2012,Agosto,Suecia,3,7,,10,POINT (3451668 -76532004)
2012,Agosto,Suecia,80,159,,239,POINT (4697157 -74140516)
2012,Agosto,Suecia,0,1,,1,POINT (4815189 -75736374)
2012,Agosto,Suecia,4,16,,20,POINT (6170465 -7542726)
2012,Agosto,Suecia,0,2,,2,POINT (7128047 -73181317)
2012,Agosto,Suecia,0,2,,2,POINT (7819 -72453013)
2012,Agosto,Suecia,2,0,,2,POINT (7927233 -72508188)
2012,Agosto,Suiza,2,8,,10,POINT (-4191162 -69941498)
2012,Agosto,Suiza,16,29,,45,POINT (0.81488 -77356)
2012,Agosto,Suiza,10,9,,19,POINT (10406342 -75527794)
2012,Agosto,Suiza,13,16,,29,POINT (10446304 -75516486)
2012,Agosto,Suiza,1,1,,2,POINT (10886686 -74776479)
2012,Agosto,Suiza,1,1,,2,POINT (11247723 -74213989)
2012,Agosto,Suiza,3,0,,3,POINT (11360029 -72129595)
2012,Agosto,Suiza,11,26,,37,POINT (3451668 -76532004)
2012,Agosto,Suiza,238,422,,660,POINT (4697157 -74140516)
2012,Agosto,Suiza,1,1,,2,POINT (4815189 -75736374)
2012,Agosto,Suiza,13,36,,49,POINT (6170465 -7542726)
2012,Agosto,Suiza,0,6,,6,POINT (7819 -72453013)
2012,Agosto,Suiza,0,1,,1,POINT (7927233 -72508188)
2012,Agosto,Suiza,3,0,,3,POINT (863337 -7735002)
2012,Agosto,Surinam,4,8,,12,POINT (4697157 -74140516)
2012,Agosto,Surinam,3,4,,7,POINT (6170465 -7542726)
2012,Agosto,Taiwán,2,0,,2,POINT (10406342 -75527794)
2012,Agosto,Taiwán,1,0,,1,POINT (3451668 -76532004)
2012,Agosto,Taiwán,0,4,,4,POINT (4697157 -74140516)
2012,Agosto,Tailandia,1,0,,1,POINT (10886686 -74776479)
2012,Agosto,Tailandia,0,1,,1,POINT (11360029 -72129595)
2012,Agosto,Tailandia,7,8,,15,POINT (4697157 -74140516)
2012,Agosto,Tailandia,1,1,,2,POINT (6170465 -7542726)
2012,Agosto,Territorio Antártico Británico/Territorio Británico de Ultramar,0,2,,2,POINT (0.81488 -77356)
2012,Agosto,Territorio Antártico Británico/Territorio Británico de Ultramar,0,1,,1,POINT (11360029 -72129595)
2012,Agosto,Territorio Antártico Británico/Territorio Británico de Ultramar,0,4,,4,POINT (4697157 -74140516)
2012,Agosto,Territorio Antártico Británico/Territorio Británico de Ultramar,0,1,,1,POINT (7819 -72453013)
2012,Agosto,Tanzania,0,1,,1,POINT (3451668 -76532004)
2012,Agosto,Togo,0,1,,1,POINT (10446304 -75516486)
2012,Agosto,Togo,0,1,,1,POINT (4697157 -74140516)
2012,Agosto,Trinidad y Tobago,0,3,,3,POINT (10406342 -75527794)
2012,Agosto,Trinidad y Tobago,6,15,,21,POINT (10446304 -75516486)
2012,Agosto,Trinidad y Tobago,0,4,,4,POINT (10886686 -74776479)
2012,Agosto,Trinidad y Tobago,1,2,,3,POINT (11360029 -72129595)
2012,Agosto,Trinidad y Tobago,0,1,,1,POINT (125862 -81702165)
2012,Agosto,Trinidad y Tobago,0,1,,1,POINT (3451668 -76532004)
2012,Agosto,Trinidad y Tobago,21,65,,86,POINT (4697157 -74140516)
2012,Agosto,Trinidad y Tobago,66,52,,118,POINT (6170465 -7542726)
2012,Agosto,Trinidad y Tobago,3,1,,4,POINT (7128047 -73181317)
2012,Agosto,Túnez,2,6,,8,POINT (4697157 -74140516)
2012,Agosto,Turquía,2,1,,3,POINT (-4191162 -69941498)
2012,Agosto,Turquía,0,1,,1,POINT (0.81488 -77356)
2012,Agosto,Turquía,1,1,,2,POINT (10446304 -75516486)
2012,Agosto,Turquía,1,1,,2,POINT (11360029 -72129595)
2012,Agosto,Turquía,0,2,,2,POINT (3451668 -76532004)
2012,Agosto,Turquía,42,58,,100,POINT (4697157 -74140516)
2012,Agosto,Turquía,1,6,,7,POINT (6170465 -7542726)
2012,Agosto,Turquía,0,2,,2,POINT (7819 -72453013)
2012,Agosto,Turkmenistán,1,0,,1,POINT (4697157 -74140516)
2012,Agosto,Ucrania,1,0,,1,POINT (10406342 -75527794)
2012,Agosto,Ucrania,0,1,,1,POINT (10970933 -74765343)
2012,Agosto,Ucrania,1,9,,10,POINT (3451668 -76532004)
2012,Agosto,Ucrania,13,10,,23,POINT (4697157 -74140516)
2012,Agosto,Ucrania,4,1,,5,POINT (6170465 -7542726)
2012,Agosto,Uganda,2,0,,2,POINT (3451668 -76532004)
2012,Agosto,Uganda,3,1,,4,POINT (4697157 -74140516)
2012,Agosto,Federación de Rusia,1,2,,3,POINT (0.81488 -77356)
2012,Agosto,Federación de Rusia,4,4,,8,POINT (10446304 -75516486)
2012,Agosto,Federación de Rusia,0,3,,3,POINT (10970933 -74765343)
2012,Agosto,Federación de Rusia,0,2,,2,POINT (11247723 -74213989)
2012,Agosto,Federación de Rusia,0,1,,1,POINT (11360029 -72129595)
2012,Agosto,Federación de Rusia,2,0,,2,POINT (3451668 -76532004)
2012,Agosto,Federación de Rusia,0,1,,1,POINT (3884426 -77061029)
2012,Agosto,Federación de Rusia,96,135,,231,POINT (4697157 -74140516)
2012,Agosto,Federación de Rusia,9,1,,10,POINT (6170465 -7542726)
2012,Agosto,Federación de Rusia,1,0,,1,POINT (7819 -72453013)
2012,Agosto,Federación de Rusia,0,7,,7,POINT (9402597 -75681642)
2012,Agosto,Uruguay,0,1,,1,POINT (-4191162 -69941498)
2012,Agosto,Uruguay,4,8,,12,POINT (0.81488 -77356)
2012,Agosto,Uruguay,1,0,,1,POINT (10406342 -75527794)
2012,Agosto,Uruguay,138,107,,245,POINT (10446304 -75516486)
2012,Agosto,Uruguay,2,9,,11,POINT (10886686 -74776479)
2012,Agosto,Uruguay,2,3,,5,POINT (11360029 -72129595)
2012,Agosto,Uruguay,58,55,,113,POINT (125862 -81702165)
2012,Agosto,Uruguay,9,28,,37,POINT (3451668 -76532004)
2012,Agosto,Uruguay,131,308,,439,POINT (4697157 -74140516)
2012,Agosto,Uruguay,1,0,,1,POINT (4815189 -75736374)
2012,Agosto,Uruguay,16,71,,87,POINT (6170465 -7542726)
2012,Agosto,Uruguay,1,0,,1,POINT (7128047 -73181317)
2012,Agosto,Uruguay,4,5,,9,POINT (7819 -72453013)
2012,Agosto,Venezuela,0,1,,1,POINT (-4191162 -69941498)
2012,Agosto,Venezuela,5,1,,6,POINT (0.33002 -76876446)
2012,Agosto,Venezuela,95,126,,221,POINT (0.81488 -77356)
2012,Agosto,Venezuela,0,10,,10,POINT (10406342 -75527794)
2012,Agosto,Venezuela,462,289,,751,POINT (10446304 -75516486)
2012,Agosto,Venezuela,45,68,,113,POINT (10886686 -74776479)
2012,Agosto,Venezuela,3578,3358,,6936,POINT (11360029 -72129595)
2012,Agosto,Venezuela,2,0,,2,POINT (1152863 -72919186)
2012,Agosto,Venezuela,30,28,,58,POINT (125862 -81702165)
2012,Agosto,Venezuela,33,54,,87,POINT (3451668 -76532004)
2012,Agosto,Venezuela,1,1,,2,POINT (445285 -75766353)
2012,Agosto,Venezuela,6480,6578,,13058,POINT (4697157 -74140516)
2012,Agosto,Venezuela,1,9,,10,POINT (4815189 -75736374)
2012,Agosto,Venezuela,562,648,,1210,POINT (6170465 -7542726)
2012,Agosto,Venezuela,3,5,,8,POINT (6185536 -67484028)
2012,Agosto,Venezuela,103,133,,236,POINT (7088729 -70740253)
2012,Agosto,Venezuela,3,8,,11,POINT (7128047 -73181317)
2012,Agosto,Venezuela,3295,3022,,6317,POINT (7819 -72453013)
2012,Agosto,Venezuela,502,484,,986,POINT (7927233 -72508188)
2012,Agosto,Venezuela,0,1,,1,POINT (806667 -767333)
2012,Agosto,Vietnam,3,3,,6,POINT (4697157 -74140516)
2012,Agosto,Yugoslavia,1,0,,1,POINT (3451668 -76532004)
2012,Agosto,Zambia,1,0,,1,POINT (3451668 -76532004)
2012,Agosto,Zimbabue,3,3,,6,POINT (4697157 -74140516)
2012,Agosto,Zimbabue,1,0,,1,POINT (6170465 -7542726)
2012,Agosto,Reino Unido de Gran Bretaña e Irlanda del Norte,8,10,,18,POINT (-4191162 -69941498)
2012,Agosto,Reino Unido de Gran Bretaña e Irlanda del Norte,29,39,,68,POINT (0.81488 -77356)
2012,Agosto,Reino Unido de Gran Bretaña e Irlanda del Norte,13,24,,37,POINT (10406342 -75527794)
2012,Agosto,Reino Unido de Gran Bretaña e Irlanda del Norte,19,31,,50,POINT (10446304 -75516486)
2012,Agosto,Reino Unido de Gran Bretaña e Irlanda del Norte,1,3,,4,POINT (10886686 -74776479)
2012,Agosto,Reino Unido de Gran Bretaña e Irlanda del Norte,0,1,,1,POINT (10970933 -74765343)
2012,Agosto,Reino Unido de Gran Bretaña e Irlanda del Norte,4,11,,15,POINT (11360029 -72129595)
2012,Agosto,Reino Unido de Gran Bretaña e Irlanda del Norte,1,3,,4,POINT (125862 -81702165)
2012,Agosto,Reino Unido de Gran Bretaña e Irlanda del Norte,13,13,,26,POINT (3451668 -76532004)
2012,Agosto,Reino Unido de Gran Bretaña e Irlanda del Norte,254,565,,819,POINT (4697157 -74140516)
2012,Agosto,Reino Unido de Gran Bretaña e Irlanda del Norte,0,1,,1,POINT (4815189 -75736374)
2012,Agosto,Reino Unido de Gran Bretaña e Irlanda del Norte,4,10,,14,POINT (6170465 -7542726)
2012,Agosto,Reino Unido de Gran Bretaña e Irlanda del Norte,5,8,,13,POINT (7819 -72453013)
2012,Agosto,Reino Unido de Gran Bretaña e Irlanda del Norte,0,2,,2,POINT (7927233 -72508188)
2012,Agosto,Reino Unido de Gran Bretaña e Irlanda del Norte,3,3,,6,POINT (863337 -7735002)
2012,Agosto,Países Bajos,5,9,,14,POINT (-4191162 -69941498)
2012,Agosto,Países Bajos,14,11,,25,POINT (0.81488 -77356)
2012,Agosto,Países Bajos,0,2,,2,POINT (1800143 -78802679)
2012,Agosto,Países Bajos,6,13,,19,POINT (10406342 -75527794)
2012,Agosto,Países Bajos,7,21,,28,POINT (10446304 -75516486)
2012,Agosto,Países Bajos,0,9,,9,POINT (10886686 -74776479)
2012,Agosto,Países Bajos,0,1,,1,POINT (10970933 -74765343)
2012,Agosto,Países Bajos,0,3,,3,POINT (11247723 -74213989)
2012,Agosto,Países Bajos,0,1,,1,POINT (11360029 -72129595)
2012,Agosto,Países Bajos,1,0,,1,POINT (125862 -81702165)
2012,Agosto,Países Bajos,7,56,,63,POINT (3451668 -76532004)
2012,Agosto,Países Bajos,0,11,,11,POINT (3884426 -77061029)
2012,Agosto,Países Bajos,0,1,,1,POINT (445285 -75766353)
2012,Agosto,Países Bajos,333,612,,945,POINT (4697157 -74140516)
2012,Agosto,Países Bajos,2,7,,9,POINT (4815189 -75736374)
2012,Agosto,Países Bajos,53,71,,124,POINT (6170465 -7542726)
2012,Agosto,Países Bajos,2,1,,3,POINT (7128047 -73181317)
2012,Agosto,Países Bajos,1,9,,10,POINT (7819 -72453013)
2012,Agosto,Países Bajos,1,0,,1,POINT (7927233 -72508188)
2012,Agosto,Países Bajos,1,1,,2,POINT (863337 -7735002)
2012,Agosto,Desconocido,0,1,,1,POINT (4697157 -74140516)
2012,Agosto,Lituania,2,2,,4,POINT (4697157 -74140516)
2012,Agosto,Lituania,1,0,,1,POINT (6222552 -77401154)
2012,Agosto,Reino Unido de Gran Bretaña e Irlanda del Norte,0,1,,1,POINT (10406342 -75527794)
2012,Agosto,Reino Unido de Gran Bretaña e Irlanda del Norte,1,0,,1,POINT (0.81488 -77356)
2012,Agosto,Reino Unido de Gran Bretaña e Irlanda del Norte,5,8,,13,POINT (4697157 -74140516)
2012,Agosto,Reino Unido de Gran Bretaña e Irlanda del Norte,1,3,,4,POINT (6170465 -7542726)
2012,Agosto,Reino Unido de Gran Bretaña e Irlanda del Norte,0,1,,1,POINT (0.81488 -77356)
2012,Agosto,Reino Unido de Gran Bretaña e Irlanda del Norte,0,4,,4,POINT (10406342 -75527794)
2012,Agosto,Reino Unido de Gran Bretaña e Irlanda del Norte,0,1,,1,POINT (10446304 -75516486)
2012,Agosto,Reino Unido de Gran Bretaña e Irlanda del Norte,5,9,,14,POINT (4697157 -74140516)
2012,Agosto,Reino Unido de Gran Bretaña e Irlanda del Norte,0,1,,1,POINT (6170465 -7542726)
2012,Agosto,Letonia,1,0,,1,POINT (10446304 -75516486)
2012,Agosto,República CentroÁfricana,0,1,,1,POINT (4697157 -74140516)
2012,Septiembre,Afganistán,0,1,,1,POINT (0.81488 -77356)
2012,Septiembre,Albania,0,1,,1,POINT (3451668 -76532004)
2012,Septiembre,Albania,2,3,,5,POINT (4697157 -74140516)
2012,Septiembre,Alemania,9,25,,34,POINT (-4191162 -69941498)
2012,Septiembre,Alemania,56,53,,109,POINT (0.81488 -77356)
2012,Septiembre,Alemania,12,21,,33,POINT (10406342 -75527794)
2012,Septiembre,Alemania,39,45,,84,POINT (10446304 -75516486)
2012,Septiembre,Alemania,7,13,,20,POINT (10886686 -74776479)
2012,Septiembre,Alemania,2,5,,7,POINT (11360029 -72129595)
2012,Septiembre,Alemania,0,1,,1,POINT (1152863 -72919186)
2012,Septiembre,Alemania,3,2,,5,POINT (125862 -81702165)
2012,Septiembre,Alemania,22,40,,62,POINT (3451668 -76532004)
2012,Septiembre,Alemania,0,2,,2,POINT (445285 -75766353)
2012,Septiembre,Alemania,920,1590,,2510,POINT (4697157 -74140516)
2012,Septiembre,Alemania,0,1,,1,POINT (4815189 -75736374)
2012,Septiembre,Alemania,26,77,,103,POINT (6170465 -7542726)
2012,Septiembre,Alemania,1,0,,1,POINT (7088729 -70740253)
2012,Septiembre,Alemania,1,0,,1,POINT (7128047 -73181317)
2012,Septiembre,Alemania,8,5,,13,POINT (7819 -72453013)
2012,Septiembre,Alemania,2,1,,3,POINT (7927233 -72508188)
2012,Septiembre,Alemania,12,11,,23,POINT (863337 -7735002)
2012,Septiembre,Andorra,2,5,,7,POINT (4697157 -74140516)
2012,Septiembre,Angola,0,1,,1,POINT (10886686 -74776479)
2012,Septiembre,Angola,1,0,,1,POINT (3451668 -76532004)
2012,Septiembre,Angola,0,1,,1,POINT (4697157 -74140516)
2012,Septiembre,Antigua y Barbuda,0,1,,1,POINT (10446304 -75516486)
2012,Septiembre,Antigua y Barbuda,0,1,,1,POINT (4697157 -74140516)
2012,Septiembre,Países Bajos,0,2,,2,POINT (6170465 -7542726)
2012,Septiembre,Arabia Saudita,0,2,,2,POINT (4697157 -74140516)
2012,Septiembre,Argelia,4,9,,13,POINT (4697157 -74140516)
2012,Septiembre,Argentina,1,9,,10,POINT (-4191162 -69941498)
2012,Septiembre,Argentina,1,0,,1,POINT (0.33002 -76876446)
2012,Septiembre,Argentina,59,104,,163,POINT (0.81488 -77356)
2012,Septiembre,Argentina,1,3,,4,POINT (10406342 -75527794)
2012,Septiembre,Argentina,714,628,,1342,POINT (10446304 -75516486)
2012,Septiembre,Argentina,6,24,,30,POINT (10886686 -74776479)
2012,Septiembre,Argentina,0,1,,1,POINT (11247723 -74213989)
2012,Septiembre,Argentina,13,15,,28,POINT (11360029 -72129595)
2012,Septiembre,Argentina,291,200,,491,POINT (125862 -81702165)
2012,Septiembre,Argentina,66,99,,165,POINT (3451668 -76532004)
2012,Septiembre,Argentina,1,1,,2,POINT (445285 -75766353)
2012,Septiembre,Argentina,2610,4048,,6658,POINT (4697157 -74140516)
2012,Septiembre,Argentina,1,2,,3,POINT (4815189 -75736374)
2012,Septiembre,Argentina,83,204,,287,POINT (6170465 -7542726)
2012,Septiembre,Argentina,0,1,,1,POINT (6185536 -67484028)
2012,Septiembre,Argentina,0,1,,1,POINT (7088729 -70740253)
2012,Septiembre,Argentina,2,4,,6,POINT (7128047 -73181317)
2012,Septiembre,Argentina,27,45,,72,POINT (7819 -72453013)
2012,Septiembre,Argentina,3,2,,5,POINT (7927233 -72508188)
2012,Septiembre,Argentina,9,14,,23,POINT (863337 -7735002)
2012,Septiembre,República de Armenia,1,0,,1,POINT (3451668 -76532004)
2012,Septiembre,República de Armenia,1,2,,3,POINT (4697157 -74140516)
2012,Septiembre,Aruba,1,0,,1,POINT (10886686 -74776479)
2012,Septiembre,Aruba,3,2,,5,POINT (6170465 -7542726)
2012,Septiembre,Australia,3,5,,8,POINT (-4191162 -69941498)
2012,Septiembre,Australia,20,30,,50,POINT (0.81488 -77356)
2012,Septiembre,Australia,24,26,,50,POINT (10406342 -75527794)
2012,Septiembre,Australia,17,25,,42,POINT (10446304 -75516486)
2012,Septiembre,Australia,3,18,,21,POINT (10886686 -74776479)
2012,Septiembre,Australia,0,1,,1,POINT (11247723 -74213989)
2012,Septiembre,Australia,0,2,,2,POINT (11360029 -72129595)
2012,Septiembre,Australia,5,16,,21,POINT (3451668 -76532004)
2012,Septiembre,Australia,0,1,,1,POINT (445285 -75766353)
2012,Septiembre,Australia,192,356,,548,POINT (4697157 -74140516)
2012,Septiembre,Australia,18,43,,61,POINT (6170465 -7542726)
2012,Septiembre,Australia,0,1,,1,POINT (7819 -72453013)
2012,Septiembre,Australia,1,2,,3,POINT (863337 -7735002)
2012,Septiembre,Austria,0,1,,1,POINT (-4191162 -69941498)
2012,Septiembre,Austria,10,18,,28,POINT (0.81488 -77356)
2012,Septiembre,Austria,2,2,,4,POINT (10406342 -75527794)
2012,Septiembre,Austria,4,7,,11,POINT (10446304 -75516486)
2012,Septiembre,Austria,0,2,,2,POINT (10886686 -74776479)
2012,Septiembre,Austria,2,6,,8,POINT (3451668 -76532004)
2012,Septiembre,Austria,54,189,,243,POINT (4697157 -74140516)
2012,Septiembre,Austria,0,1,,1,POINT (4815189 -75736374)
2012,Septiembre,Austria,2,10,,12,POINT (6170465 -7542726)
2012,Septiembre,Austria,1,0,,1,POINT (7819 -72453013)
2012,Septiembre,Austria,0,1,,1,POINT (7927233 -72508188)
2012,Septiembre,Azerbaiyán,1,1,,2,POINT (10446304 -75516486)
2012,Septiembre,Azerbaiyán,0,1,,1,POINT (4697157 -74140516)
2012,Septiembre,Bahamas,0,1,,1,POINT (10446304 -75516486)
2012,Septiembre,Bahamas,0,3,,3,POINT (10886686 -74776479)
2012,Septiembre,Bahamas,0,2,,2,POINT (3451668 -76532004)
2012,Septiembre,Bahamas,0,3,,3,POINT (4697157 -74140516)
2012,Septiembre,Bahamas,0,27,,27,POINT (6170465 -7542726)
2012,Septiembre,Bangladesh,0,3,,3,POINT (4697157 -74140516)
2012,Septiembre,Bangladesh,0,1,,1,POINT (6170465 -7542726)
2012,Septiembre,Barbados,0,3,,3,POINT (10886686 -74776479)
2012,Septiembre,Barbados,0,3,,3,POINT (3451668 -76532004)
2012,Septiembre,Barbados,1,3,,4,POINT (4697157 -74140516)
2012,Septiembre,Barbados,0,1,,1,POINT (6170465 -7542726)
2012,Septiembre,República de Belarús,2,0,,2,POINT (4697157 -74140516)
2012,Septiembre,Bélgica,4,5,,9,POINT (0.81488 -77356)
2012,Septiembre,Bélgica,5,6,,11,POINT (10446304 -75516486)
2012,Septiembre,Bélgica,0,1,,1,POINT (10886686 -74776479)
2012,Septiembre,Bélgica,0,1,,1,POINT (11360029 -72129595)
2012,Septiembre,Bélgica,4,11,,15,POINT (3451668 -76532004)
2012,Septiembre,Bélgica,103,224,,327,POINT (4697157 -74140516)
2012,Septiembre,Bélgica,9,14,,23,POINT (6170465 -7542726)
2012,Septiembre,Bélgica,0,1,,1,POINT (7819 -72453013)
2012,Septiembre,Belice,3,0,,3,POINT (10446304 -75516486)
2012,Septiembre,Belice,0,2,,2,POINT (10886686 -74776479)
2012,Septiembre,Belice,0,1,,1,POINT (11360029 -72129595)
2012,Septiembre,Belice,0,1,,1,POINT (3451668 -76532004)
2012,Septiembre,Belice,3,8,,11,POINT (4697157 -74140516)
2012,Septiembre,Belice,0,1,,1,POINT (6170465 -7542726)
2012,Septiembre,Benín,0,4,,4,POINT (4697157 -74140516)
2012,Septiembre,Bermudas/Territorio Británico de Ultramar,1,3,,4,POINT (4697157 -74140516)
2012,Septiembre,Bolivia,1,0,,1,POINT (-4191162 -69941498)
2012,Septiembre,Bolivia,20,24,,44,POINT (0.81488 -77356)
2012,Septiembre,Bolivia,0,1,,1,POINT (10406342 -75527794)
2012,Septiembre,Bolivia,16,32,,48,POINT (10446304 -75516486)
2012,Septiembre,Bolivia,4,3,,7,POINT (10886686 -74776479)
2012,Septiembre,Bolivia,0,3,,3,POINT (11360029 -72129595)
2012,Septiembre,Bolivia,2,2,,4,POINT (125862 -81702165)
2012,Septiembre,Bolivia,32,21,,53,POINT (3451668 -76532004)
2012,Septiembre,Bolivia,314,418,,732,POINT (4697157 -74140516)
2012,Septiembre,Bolivia,16,49,,65,POINT (6170465 -7542726)
2012,Septiembre,Bolivia,3,0,,3,POINT (7819 -72453013)
2012,Septiembre,Bolivia,2,0,,2,POINT (7927233 -72508188)
2012,Septiembre,Bolivia,1,1,,2,POINT (863337 -7735002)
2012,Septiembre,Bosnia y Herzegovina,0,1,,1,POINT (4697157 -74140516)
2012,Septiembre,Brasil,117,119,,236,POINT (-4191162 -69941498)
2012,Septiembre,Brasil,6,16,,22,POINT (0.81488 -77356)
2012,Septiembre,Brasil,140,144,,284,POINT (10446304 -75516486)
2012,Septiembre,Brasil,5,11,,16,POINT (10886686 -74776479)
2012,Septiembre,Brasil,0,1,,1,POINT (11247723 -74213989)
2012,Septiembre,Brasil,5,3,,8,POINT (11360029 -72129595)
2012,Septiembre,Brasil,19,15,,34,POINT (125862 -81702165)
2012,Septiembre,Brasil,39,79,,118,POINT (3451668 -76532004)
2012,Septiembre,Brasil,2409,3943,,6352,POINT (4697157 -74140516)
2012,Septiembre,Brasil,0,1,,1,POINT (4815189 -75736374)
2012,Septiembre,Brasil,52,117,,169,POINT (6170465 -7542726)
2012,Septiembre,Brasil,0,1,,1,POINT (6185536 -67484028)
2012,Septiembre,Brasil,0,1,,1,POINT (7088729 -70740253)
2012,Septiembre,Brasil,9,19,,28,POINT (7819 -72453013)
2012,Septiembre,Brasil,1,2,,3,POINT (7927233 -72508188)
2012,Septiembre,Brasil,0,2,,2,POINT (863337 -7735002)
2012,Septiembre,Bulgaria,0,10,,10,POINT (10446304 -75516486)
2012,Septiembre,Bulgaria,4,13,,17,POINT (4697157 -74140516)
2012,Septiembre,Bulgaria,3,1,,4,POINT (6170465 -7542726)
2012,Septiembre,Burundi,0,1,,1,POINT (4697157 -74140516)
2012,Septiembre,Cabo Verde,0,1,,1,POINT (3451668 -76532004)
2012,Septiembre,Cabo Verde,0,1,,1,POINT (4697157 -74140516)
2012,Septiembre,Cabo Verde,0,1,,1,POINT (6170465 -7542726)
2012,Septiembre,Islas Caimán/Territorio Británico de Ultramar,1,2,,3,POINT (10446304 -75516486)
2012,Septiembre,Camerún,1,0,,1,POINT (0.81488 -77356)
2012,Septiembre,Camerún,1,3,,4,POINT (4697157 -74140516)
2012,Septiembre,Canadá,3,8,,11,POINT (-4191162 -69941498)
2012,Septiembre,Canadá,10,4,,14,POINT (0.81488 -77356)
2012,Septiembre,Canadá,3,14,,17,POINT (10406342 -75527794)
2012,Septiembre,Canadá,31,73,,104,POINT (10446304 -75516486)
2012,Septiembre,Canadá,11,32,,43,POINT (10886686 -74776479)
2012,Septiembre,Canadá,0,4,,4,POINT (11117206 -74232675)
2012,Septiembre,Canadá,1,0,,1,POINT (11247723 -74213989)
2012,Septiembre,Canadá,0,2,,2,POINT (11360029 -72129595)
2012,Septiembre,Canadá,1,0,,1,POINT (125862 -81702165)
2012,Septiembre,Canadá,31,49,,80,POINT (3451668 -76532004)
2012,Septiembre,Canadá,1,3,,4,POINT (445285 -75766353)
2012,Septiembre,Canadá,494,1225,,1719,POINT (4697157 -74140516)
2012,Septiembre,Canadá,3,6,,9,POINT (4815189 -75736374)
2012,Septiembre,Canadá,46,138,,184,POINT (6170465 -7542726)
2012,Septiembre,Canadá,0,1,,1,POINT (7088729 -70740253)
2012,Septiembre,Canadá,0,1,,1,POINT (7128047 -73181317)
2012,Septiembre,Canadá,0,4,,4,POINT (7819 -72453013)
2012,Septiembre,Canadá,1,2,,3,POINT (7927233 -72508188)
2012,Septiembre,Canadá,7,3,,10,POINT (863337 -7735002)
2012,Septiembre,España,0,1,,1,POINT (0.33002 -76876446)
2012,Septiembre,España,5,8,,13,POINT (0.81488 -77356)
2012,Septiembre,España,0,2,,2,POINT (10406342 -75527794)
2012,Septiembre,España,2,7,,9,POINT (10446304 -75516486)
2012,Septiembre,España,3,10,,13,POINT (10886686 -74776479)
2012,Septiembre,España,0,1,,1,POINT (125862 -81702165)
2012,Septiembre,España,63,112,,175,POINT (3451668 -76532004)
2012,Septiembre,España,159,417,,576,POINT (4697157 -74140516)
2012,Septiembre,España,1,2,,3,POINT (4815189 -75736374)
2012,Septiembre,España,38,98,,136,POINT (6170465 -7542726)
2012,Septiembre,España,1,9,,10,POINT (7819 -72453013)
2012,Septiembre,España,1,0,,1,POINT (7927233 -72508188)
2012,Septiembre,República de Corea,2,2,,4,POINT (0.81488 -77356)
2012,Septiembre,República de Corea,1,4,,5,POINT (10446304 -75516486)
2012,Septiembre,República de Corea,0,2,,2,POINT (10886686 -74776479)
2012,Septiembre,República de Corea,1,0,,1,POINT (11360029 -72129595)
2012,Septiembre,República de Corea,0,1,,1,POINT (3451668 -76532004)
2012,Septiembre,República de Corea,94,385,,479,POINT (4697157 -74140516)
2012,Septiembre,República de Corea,2,16,,18,POINT (6170465 -7542726)
2012,Septiembre,República de Corea,3,2,,5,POINT (7819 -72453013)
2012,Septiembre,República de Corea,1,0,,1,POINT (863337 -7735002)
2012,Septiembre,Costa de Marfil,0,2,,2,POINT (3451668 -76532004)
2012,Septiembre,Costa Rica,1,2,,3,POINT (0.81488 -77356)
2012,Septiembre,Costa Rica,48,69,,117,POINT (10446304 -75516486)
2012,Septiembre,Costa Rica,8,24,,32,POINT (10886686 -74776479)
2012,Septiembre,Costa Rica,237,164,,401,POINT (125862 -81702165)
2012,Septiembre,Costa Rica,25,93,,118,POINT (3451668 -76532004)
2012,Septiembre,Costa Rica,411,684,,1095,POINT (4697157 -74140516)
2012,Septiembre,Costa Rica,3,2,,5,POINT (4815189 -75736374)
2012,Septiembre,Costa Rica,110,151,,261,POINT (6170465 -7542726)
2012,Septiembre,Costa Rica,0,2,,2,POINT (7128047 -73181317)
2012,Septiembre,Costa Rica,2,2,,4,POINT (7819 -72453013)
2012,Septiembre,Costa Rica,2,2,,4,POINT (7927233 -72508188)
2012,Septiembre,Costa Rica,0,1,,1,POINT (863337 -7735002)
2012,Septiembre,Croacia,0,3,,3,POINT (10406342 -75527794)
2012,Septiembre,Croacia,0,1,,1,POINT (10970933 -74765343)
2012,Septiembre,Croacia,6,24,,30,POINT (4697157 -74140516)
2012,Septiembre,Croacia,0,1,,1,POINT (6170465 -7542726)
2012,Septiembre,Cuba,0,1,,1,POINT (-4191162 -69941498)
2012,Septiembre,Cuba,1,3,,4,POINT (0.81488 -77356)
2012,Septiembre,Cuba,1,1,,2,POINT (10406342 -75527794)
2012,Septiembre,Cuba,12,11,,23,POINT (10446304 -75516486)
2012,Septiembre,Cuba,4,15,,19,POINT (10886686 -74776479)
2012,Septiembre,Cuba,10,30,,40,POINT (3451668 -76532004)
2012,Septiembre,Cuba,0,1,,1,POINT (445285 -75766353)
2012,Septiembre,Cuba,73,169,,242,POINT (4697157 -74140516)
2012,Septiembre,Cuba,10,28,,38,POINT (6170465 -7542726)
2012,Septiembre,Cuba,1,1,,2,POINT (7128047 -73181317)
2012,Septiembre,Cuba,0,3,,3,POINT (7819 -72453013)
2012,Septiembre,Cuba,1,0,,1,POINT (7927233 -72508188)
2012,Septiembre,Curazao,0,1,,1,POINT (10886686 -74776479)
2012,Septiembre,Curazao,1,2,,3,POINT (4697157 -74140516)
2012,Septiembre,Curazao,6,9,,15,POINT (6170465 -7542726)
2012,Septiembre,República Checa,0,1,,1,POINT (-4191162 -69941498)
2012,Septiembre,República Checa,3,10,,13,POINT (0.81488 -77356)
2012,Septiembre,República Checa,1,2,,3,POINT (10446304 -75516486)
2012,Septiembre,República Checa,0,2,,2,POINT (11360029 -72129595)
2012,Septiembre,República Checa,0,2,,2,POINT (3451668 -76532004)
2012,Septiembre,República Checa,22,32,,54,POINT (4697157 -74140516)
2012,Septiembre,República Checa,0,6,,6,POINT (6170465 -7542726)
2012,Septiembre,Chile,1,1,,2,POINT (-4191162 -69941498)
2012,Septiembre,Chile,30,39,,69,POINT (0.81488 -77356)
2012,Septiembre,Chile,0,1,,1,POINT (10406342 -75527794)
2012,Septiembre,Chile,112,119,,231,POINT (10446304 -75516486)
2012,Septiembre,Chile,9,27,,36,POINT (10886686 -74776479)
2012,Septiembre,Chile,4,8,,12,POINT (11360029 -72129595)
2012,Septiembre,Chile,140,99,,239,POINT (125862 -81702165)
2012,Septiembre,Chile,49,76,,125,POINT (3451668 -76532004)
2012,Septiembre,Chile,2750,3758,,6508,POINT (4697157 -74140516)
2012,Septiembre,Chile,1,2,,3,POINT (4815189 -75736374)
2012,Septiembre,Chile,41,132,,173,POINT (6170465 -7542726)
2012,Septiembre,Chile,0,1,,1,POINT (6185536 -67484028)
2012,Septiembre,Chile,0,2,,2,POINT (7128047 -73181317)
2012,Septiembre,Chile,11,14,,25,POINT (7819 -72453013)
2012,Septiembre,Chile,1,2,,3,POINT (7927233 -72508188)
2012,Septiembre,Chile,1,2,,3,POINT (863337 -7735002)
2012,Septiembre,China,0,2,,2,POINT (0.81488 -77356)
2012,Septiembre,China,2,2,,4,POINT (10446304 -75516486)
2012,Septiembre,China,2,1,,3,POINT (10886686 -74776479)
2012,Septiembre,China,1,7,,8,POINT (3451668 -76532004)
2012,Septiembre,China,172,458,,630,POINT (4697157 -74140516)
2012,Septiembre,China,6,12,,18,POINT (6170465 -7542726)
2012,Septiembre,China,2,4,,6,POINT (7819 -72453013)
2012,Septiembre,China,2,0,,2,POINT (863337 -7735002)
2012,Septiembre,Taiwán,0,1,,1,POINT (-4191162 -69941498)
2012,Septiembre,Taiwán,5,1,,6,POINT (0.81488 -77356)
2012,Septiembre,Taiwán,3,2,,5,POINT (10446304 -75516486)
2012,Septiembre,Taiwán,0,2,,2,POINT (10886686 -74776479)
2012,Septiembre,Taiwán,1,1,,2,POINT (11360029 -72129595)
2012,Septiembre,Taiwán,0,2,,2,POINT (3451668 -76532004)
2012,Septiembre,Taiwán,53,91,,144,POINT (4697157 -74140516)
2012,Septiembre,Taiwán,1,4,,5,POINT (4815189 -75736374)
2012,Septiembre,Taiwán,3,5,,8,POINT (6170465 -7542726)
2012,Septiembre,Taiwán,2,0,,2,POINT (7819 -72453013)
2012,Septiembre,Chipre,4,2,,6,POINT (4697157 -74140516)
2012,Septiembre,Dinamarca,1,1,,2,POINT (-4191162 -69941498)
2012,Septiembre,Dinamarca,3,1,,4,POINT (0.81488 -77356)
2012,Septiembre,Dinamarca,0,1,,1,POINT (10406342 -75527794)
2012,Septiembre,Dinamarca,1,6,,7,POINT (10446304 -75516486)
2012,Septiembre,Dinamarca,0,1,,1,POINT (10886686 -74776479)
2012,Septiembre,Dinamarca,2,3,,5,POINT (3451668 -76532004)
2012,Septiembre,Dinamarca,38,112,,150,POINT (4697157 -74140516)
2012,Septiembre,Dinamarca,6,8,,14,POINT (6170465 -7542726)
2012,Septiembre,Dinamarca,0,2,,2,POINT (7819 -72453013)
2012,Septiembre,Dominica,0,1,,1,POINT (0.81488 -77356)
2012,Septiembre,Dominica,4,7,,11,POINT (4697157 -74140516)
2012,Septiembre,Dominica,0,1,,1,POINT (6170465 -7542726)
2012,Septiembre,Ecuador,0,1,,1,POINT (-4191162 -69941498)
2012,Septiembre,Ecuador,10,25,,35,POINT (0.33002 -76876446)
2012,Septiembre,Ecuador,802,1276,,2078,POINT (0.81488 -77356)
2012,Septiembre,Ecuador,0,109,,109,POINT (1800143 -78802679)
2012,Septiembre,Ecuador,2,25,,27,POINT (10406342 -75527794)
2012,Septiembre,Ecuador,18,32,,50,POINT (10446304 -75516486)
2012,Septiembre,Ecuador,1,7,,8,POINT (10886686 -74776479)
2012,Septiembre,Ecuador,6,21,,27,POINT (11360029 -72129595)
2012,Septiembre,Ecuador,17,8,,25,POINT (125862 -81702165)
2012,Septiembre,Ecuador,338,359,,697,POINT (3451668 -76532004)
2012,Septiembre,Ecuador,0,3,,3,POINT (3884426 -77061029)
2012,Septiembre,Ecuador,0,2,,2,POINT (445285 -75766353)
2012,Septiembre,Ecuador,1766,3007,,4773,POINT (4697157 -74140516)
2012,Septiembre,Ecuador,2,1,,3,POINT (4815189 -75736374)
2012,Septiembre,Ecuador,455,571,,1026,POINT (6170465 -7542726)
2012,Septiembre,Ecuador,1,0,,1,POINT (6185536 -67484028)
2012,Septiembre,Ecuador,5,3,,8,POINT (7128047 -73181317)
2012,Septiembre,Ecuador,127,173,,300,POINT (7819 -72453013)
2012,Septiembre,Ecuador,2,3,,5,POINT (7927233 -72508188)
2012,Septiembre,Egipto,1,10,,11,POINT (4697157 -74140516)
2012,Septiembre,El Salvador,0,2,,2,POINT (0.81488 -77356)
2012,Septiembre,El Salvador,22,19,,41,POINT (10446304 -75516486)
2012,Septiembre,El Salvador,1,5,,6,POINT (10886686 -74776479)
2012,Septiembre,El Salvador,0,1,,1,POINT (11360029 -72129595)
2012,Septiembre,El Salvador,1,1,,2,POINT (125862 -81702165)
2012,Septiembre,El Salvador,42,95,,137,POINT (3451668 -76532004)
2012,Septiembre,El Salvador,342,663,,1005,POINT (4697157 -74140516)
2012,Septiembre,El Salvador,0,1,,1,POINT (4815189 -75736374)
2012,Septiembre,El Salvador,33,46,,79,POINT (6170465 -7542726)
2012,Septiembre,El Salvador,1,1,,2,POINT (7819 -72453013)
2012,Septiembre,El Salvador,0,1,,1,POINT (7927233 -72508188)
2012,Septiembre,El Salvador,0,1,,1,POINT (863337 -7735002)
2012,Septiembre,Emiratos Árabes,1,13,,14,POINT (4697157 -74140516)
2012,Septiembre,España,3,6,,9,POINT (-4191162 -69941498)
2012,Septiembre,España,20,32,,52,POINT (0.81488 -77356)
2012,Septiembre,España,2,9,,11,POINT (10406342 -75527794)
2012,Septiembre,España,27,64,,91,POINT (10446304 -75516486)
2012,Septiembre,España,2,12,,14,POINT (10886686 -74776479)
2012,Septiembre,España,7,5,,12,POINT (11360029 -72129595)
2012,Septiembre,España,0,1,,1,POINT (125744111 -81703935)
2012,Septiembre,España,3,8,,11,POINT (125862 -81702165)
2012,Septiembre,España,146,310,,456,POINT (3451668 -76532004)
2012,Septiembre,España,0,3,,3,POINT (445285 -75766353)
2012,Septiembre,España,1716,4364,,6080,POINT (4697157 -74140516)
2012,Septiembre,España,2,7,,9,POINT (4815189 -75736374)
2012,Septiembre,España,84,201,,285,POINT (6170465 -7542726)
2012,Septiembre,España,1,3,,4,POINT (7128047 -73181317)
2012,Septiembre,España,9,30,,39,POINT (7819 -72453013)
2012,Septiembre,España,0,8,,8,POINT (7927233 -72508188)
2012,Septiembre,España,3,5,,8,POINT (863337 -7735002)
2012,Septiembre,Eslovaquia,3,3,,6,POINT (10446304 -75516486)
2012,Septiembre,Eslovaquia,0,1,,1,POINT (3451668 -76532004)
2012,Septiembre,Eslovaquia,9,12,,21,POINT (4697157 -74140516)
2012,Septiembre,Eslovaquia,1,0,,1,POINT (6170465 -7542726)
2012,Septiembre,Eslovaquia,3,3,,6,POINT (7819 -72453013)
2012,Septiembre,Eslovenia,0,1,,1,POINT (10406342 -75527794)
2012,Septiembre,Eslovenia,1,1,,2,POINT (3451668 -76532004)
2012,Septiembre,Eslovenia,7,19,,26,POINT (4697157 -74140516)
2012,Septiembre,Estados Unidos de América,8,18,,26,POINT (-4191162 -69941498)
2012,Septiembre,Estados Unidos de América,31,58,,89,POINT (0.81488 -77356)
2012,Septiembre,Estados Unidos de América,20,24,,44,POINT (10406342 -75527794)
2012,Septiembre,Estados Unidos de América,724,1524,,2248,POINT (10446304 -75516486)
2012,Septiembre,Estados Unidos de América,217,458,,675,POINT (10886686 -74776479)
2012,Septiembre,Estados Unidos de América,0,3,,3,POINT (11117206 -74232675)
2012,Septiembre,Estados Unidos de América,4,9,,13,POINT (11247723 -74213989)
2012,Septiembre,Estados Unidos de América,4,6,,10,POINT (11360029 -72129595)
2012,Septiembre,Estados Unidos de América,0,3,,3,POINT (1152863 -72919186)
2012,Septiembre,Estados Unidos de América,0,2,,2,POINT (125744111 -81703935)
2012,Septiembre,Estados Unidos de América,16,11,,27,POINT (125862 -81702165)
2012,Septiembre,Estados Unidos de América,0,2,,2,POINT (133387613 -81372937)
2012,Septiembre,Estados Unidos de América,482,938,,1420,POINT (3451668 -76532004)
2012,Septiembre,Estados Unidos de América,68,115,,183,POINT (445285 -75766353)
2012,Septiembre,Estados Unidos de América,4141,9719,,13860,POINT (4697157 -74140516)
2012,Septiembre,Estados Unidos de América,43,45,,88,POINT (4815189 -75736374)
2012,Septiembre,Estados Unidos de América,697,2191,,2888,POINT (6170465 -7542726)
2012,Septiembre,Estados Unidos de América,9,21,,30,POINT (7128047 -73181317)
2012,Septiembre,Estados Unidos de América,19,33,,52,POINT (7819 -72453013)
2012,Septiembre,Estados Unidos de América,9,16,,25,POINT (7927233 -72508188)
2012,Septiembre,Estados Unidos de América,6,6,,12,POINT (863337 -7735002)
2012,Septiembre,Estonia,0,1,,1,POINT (0.81488 -77356)
2012,Septiembre,Estonia,0,1,,1,POINT (10406342 -75527794)
2012,Septiembre,Estonia,1,5,,6,POINT (4697157 -74140516)
2012,Septiembre,Etiopia,3,4,,7,POINT (4697157 -74140516)
2012,Septiembre,Filipinas,0,58,,58,POINT (10406342 -75527794)
2012,Septiembre,Filipinas,3,22,,25,POINT (10446304 -75516486)
2012,Septiembre,Filipinas,0,8,,8,POINT (10886686 -74776479)
2012,Septiembre,Filipinas,0,16,,16,POINT (10970933 -74765343)
2012,Septiembre,Filipinas,0,11,,11,POINT (11247723 -74213989)
2012,Septiembre,Filipinas,2,11,,13,POINT (3451668 -76532004)
2012,Septiembre,Filipinas,0,9,,9,POINT (3884426 -77061029)
2012,Septiembre,Filipinas,14,79,,93,POINT (4697157 -74140516)
2012,Septiembre,Filipinas,4,2,,6,POINT (6170465 -7542726)
2012,Septiembre,Filipinas,0,3,,3,POINT (9402597 -75681642)
2012,Septiembre,Finlandia,1,0,,1,POINT (-4191162 -69941498)
2012,Septiembre,Finlandia,3,0,,3,POINT (0.81488 -77356)
2012,Septiembre,Finlandia,0,1,,1,POINT (1800143 -78802679)
2012,Septiembre,Finlandia,1,4,,5,POINT (10446304 -75516486)
2012,Septiembre,Finlandia,0,1,,1,POINT (125862 -81702165)
2012,Septiembre,Finlandia,0,2,,2,POINT (3451668 -76532004)
2012,Septiembre,Finlandia,27,60,,87,POINT (4697157 -74140516)
2012,Septiembre,Finlandia,0,2,,2,POINT (6170465 -7542726)
2012,Septiembre,Francia,5,4,,9,POINT (-4191162 -69941498)
2012,Septiembre,Francia,0,1,,1,POINT (0.33002 -76876446)
2012,Septiembre,Francia,27,43,,70,POINT (0.81488 -77356)
2012,Septiembre,Francia,5,8,,13,POINT (10406342 -75527794)
2012,Septiembre,Francia,10,50,,60,POINT (10446304 -75516486)
2012,Septiembre,Francia,6,17,,23,POINT (10886686 -74776479)
2012,Septiembre,Francia,5,5,,10,POINT (11247723 -74213989)
2012,Septiembre,Francia,6,7,,13,POINT (11360029 -72129595)
2012,Septiembre,Francia,26,58,,84,POINT (3451668 -76532004)
2012,Septiembre,Francia,664,1466,,2130,POINT (4697157 -74140516)
2012,Septiembre,Francia,0,4,,4,POINT (4815189 -75736374)
2012,Septiembre,Francia,22,58,,80,POINT (6170465 -7542726)
2012,Septiembre,Francia,0,1,,1,POINT (7128047 -73181317)
2012,Septiembre,Francia,1,11,,12,POINT (7819 -72453013)
2012,Septiembre,Francia,2,7,,9,POINT (863337 -7735002)
2012,Septiembre,Georgia,1,0,,1,POINT (10886686 -74776479)
2012,Septiembre,Georgia,3,0,,3,POINT (4697157 -74140516)
2012,Septiembre,Ghana,0,2,,2,POINT (4697157 -74140516)
2012,Septiembre,Ghana,0,1,,1,POINT (7819 -72453013)
2012,Septiembre,Granada,0,1,,1,POINT (10886686 -74776479)
2012,Septiembre,Granada,0,2,,2,POINT (4697157 -74140516)
2012,Septiembre,Grecia,2,0,,2,POINT (0.81488 -77356)
2012,Septiembre,Grecia,0,7,,7,POINT (10406342 -75527794)
2012,Septiembre,Grecia,0,2,,2,POINT (10446304 -75516486)
2012,Septiembre,Grecia,0,3,,3,POINT (11247723 -74213989)
2012,Septiembre,Grecia,1,4,,5,POINT (3451668 -76532004)
2012,Septiembre,Grecia,12,34,,46,POINT (4697157 -74140516)
2012,Septiembre,Grecia,0,2,,2,POINT (6170465 -7542726)
2012,Septiembre,Grecia,0,2,,2,POINT (7819 -72453013)
2012,Septiembre,Grecia,0,1,,1,POINT (806667 -767333)
2012,Septiembre,Guatemala,3,4,,7,POINT (-4191162 -69941498)
2012,Septiembre,Guatemala,2,5,,7,POINT (0.81488 -77356)
2012,Septiembre,Guatemala,0,1,,1,POINT (10406342 -75527794)
2012,Septiembre,Guatemala,22,63,,85,POINT (10446304 -75516486)
2012,Septiembre,Guatemala,6,20,,26,POINT (10886686 -74776479)
2012,Septiembre,Guatemala,0,1,,1,POINT (11117206 -74232675)
2012,Septiembre,Guatemala,0,2,,2,POINT (11360029 -72129595)
2012,Septiembre,Guatemala,3,3,,6,POINT (125862 -81702165)
2012,Septiembre,Guatemala,24,147,,171,POINT (3451668 -76532004)
2012,Septiembre,Guatemala,176,492,,668,POINT (4697157 -74140516)
2012,Septiembre,Guatemala,0,2,,2,POINT (4815189 -75736374)
2012,Septiembre,Guatemala,39,111,,150,POINT (6170465 -7542726)
2012,Septiembre,Guatemala,0,1,,1,POINT (7128047 -73181317)
2012,Septiembre,Guatemala,34,22,,56,POINT (7819 -72453013)
2012,Septiembre,Guatemala,29,16,,45,POINT (7927233 -72508188)
2012,Septiembre,Guatemala,0,3,,3,POINT (863337 -7735002)
2012,Septiembre,Guyana,0,4,,4,POINT (10886686 -74776479)
2012,Septiembre,Guyana,0,4,,4,POINT (3451668 -76532004)
2012,Septiembre,Guyana,1,7,,8,POINT (4697157 -74140516)
2012,Septiembre,Guyana,0,1,,1,POINT (4815189 -75736374)
2012,Septiembre,Guyana,1,2,,3,POINT (6170465 -7542726)
2012,Septiembre,Haití,1,1,,2,POINT (0.81488 -77356)
2012,Septiembre,Haití,1,1,,2,POINT (10446304 -75516486)
2012,Septiembre,Haití,1,1,,2,POINT (10886686 -74776479)
2012,Septiembre,Haití,7,14,,21,POINT (4697157 -74140516)
2012,Septiembre,Haití,0,1,,1,POINT (6170465 -7542726)
2012,Septiembre,Honduras,1,1,,2,POINT (10406342 -75527794)
2012,Septiembre,Honduras,21,49,,70,POINT (10446304 -75516486)
2012,Septiembre,Honduras,6,7,,13,POINT (10886686 -74776479)
2012,Septiembre,Honduras,2,10,,12,POINT (125744111 -81703935)
2012,Septiembre,Honduras,0,1,,1,POINT (125862 -81702165)
2012,Septiembre,Honduras,13,32,,45,POINT (3451668 -76532004)
2012,Septiembre,Honduras,108,161,,269,POINT (4697157 -74140516)
2012,Septiembre,Honduras,25,44,,69,POINT (6170465 -7542726)
2012,Septiembre,Honduras,0,1,,1,POINT (806667 -767333)
2012,Septiembre,Honduras,0,1,,1,POINT (863337 -7735002)
2012,Septiembre,Hungría,0,1,,1,POINT (-4191162 -69941498)
2012,Septiembre,Hungría,1,2,,3,POINT (10446304 -75516486)
2012,Septiembre,Hungría,0,1,,1,POINT (10886686 -74776479)
2012,Septiembre,Hungría,3,0,,3,POINT (3451668 -76532004)
2012,Septiembre,Hungría,20,42,,62,POINT (4697157 -74140516)
2012,Septiembre,Hungría,0,1,,1,POINT (7927233 -72508188)
2012,Septiembre,India,0,1,,1,POINT (-4191162 -69941498)
2012,Septiembre,India,0,2,,2,POINT (0.81488 -77356)
2012,Septiembre,India,2,5,,7,POINT (10446304 -75516486)
2012,Septiembre,India,0,2,,2,POINT (10886686 -74776479)
2012,Septiembre,India,3,12,,15,POINT (3451668 -76532004)
2012,Septiembre,India,23,262,,285,POINT (4697157 -74140516)
2012,Septiembre,India,3,27,,30,POINT (6170465 -7542726)
2012,Septiembre,India,0,1,,1,POINT (7128047 -73181317)
2012,Septiembre,Indonesia,0,1,,1,POINT (-4191162 -69941498)
2012,Septiembre,Indonesia,1,12,,13,POINT (10406342 -75527794)
2012,Septiembre,Indonesia,0,1,,1,POINT (3451668 -76532004)
2012,Septiembre,Indonesia,4,46,,50,POINT (4697157 -74140516)
2012,Septiembre,Indonesia,2,0,,2,POINT (6170465 -7542726)
2012,Septiembre,Irán,0,1,,1,POINT (10886686 -74776479)
2012,Septiembre,Irán,3,12,,15,POINT (4697157 -74140516)
2012,Septiembre,Irán,0,1,,1,POINT (6170465 -7542726)
2012,Septiembre,República de Irlanda,12,6,,18,POINT (0.81488 -77356)
2012,Septiembre,República de Irlanda,1,3,,4,POINT (10406342 -75527794)
2012,Septiembre,República de Irlanda,7,7,,14,POINT (10446304 -75516486)
2012,Septiembre,República de Irlanda,1,5,,6,POINT (10886686 -74776479)
2012,Septiembre,República de Irlanda,1,8,,9,POINT (3451668 -76532004)
2012,Septiembre,República de Irlanda,52,89,,141,POINT (4697157 -74140516)
2012,Septiembre,República de Irlanda,2,8,,10,POINT (6170465 -7542726)
2012,Septiembre,República de Irlanda,2,0,,2,POINT (7819 -72453013)
2012,Septiembre,República de Irlanda,0,1,,1,POINT (863337 -7735002)
2012,Septiembre,Islandia,0,2,,2,POINT (0.81488 -77356)
2012,Septiembre,Islandia,1,1,,2,POINT (10446304 -75516486)
2012,Septiembre,Islandia,2,5,,7,POINT (4697157 -74140516)
2012,Septiembre,Islandia,0,2,,2,POINT (6170465 -7542726)
2012,Septiembre,Islandia,1,2,,3,POINT (7819 -72453013)
2012,Septiembre,Islandia,1,1,,2,POINT (863337 -7735002)
2012,Septiembre,Isla de Man,3,6,,9,POINT (0.81488 -77356)
2012,Septiembre,Isla de Man,5,7,,12,POINT (10446304 -75516486)
2012,Septiembre,Isla de Man,0,4,,4,POINT (10886686 -74776479)
2012,Septiembre,Isla de Man,4,21,,25,POINT (3451668 -76532004)
2012,Septiembre,Isla de Man,27,81,,108,POINT (4697157 -74140516)
2012,Septiembre,Isla de Man,9,41,,50,POINT (6170465 -7542726)
2012,Septiembre,Isla de Man,1,3,,4,POINT (7819 -72453013)
2012,Septiembre,Israel,1,2,,3,POINT (-4191162 -69941498)
2012,Septiembre,Israel,8,24,,32,POINT (0.81488 -77356)
2012,Septiembre,Israel,1,1,,2,POINT (10406342 -75527794)
2012,Septiembre,Israel,3,15,,18,POINT (10446304 -75516486)
2012,Septiembre,Israel,0,3,,3,POINT (10886686 -74776479)
2012,Septiembre,Israel,0,1,,1,POINT (11247723 -74213989)
2012,Septiembre,Israel,1,3,,4,POINT (125862 -81702165)
2012,Septiembre,Israel,5,7,,12,POINT (3451668 -76532004)
2012,Septiembre,Israel,100,393,,493,POINT (4697157 -74140516)
2012,Septiembre,Israel,7,34,,41,POINT (6170465 -7542726)
2012,Septiembre,Israel,0,1,,1,POINT (863337 -7735002)
2012,Septiembre,Islas Aland/Provincia de Finlandia,0,1,,1,POINT (4697157 -74140516)
2012,Septiembre,Italia,1,0,,1,POINT (-4191162 -69941498)
2012,Septiembre,Italia,0,1,,1,POINT (0.33002 -76876446)
2012,Septiembre,Italia,9,11,,20,POINT (0.81488 -77356)
2012,Septiembre,Italia,1,4,,5,POINT (10406342 -75527794)
2012,Septiembre,Italia,26,68,,94,POINT (10446304 -75516486)
2012,Septiembre,Italia,6,13,,19,POINT (10886686 -74776479)
2012,Septiembre,Italia,2,1,,3,POINT (11247723 -74213989)
2012,Septiembre,Italia,2,3,,5,POINT (11360029 -72129595)
2012,Septiembre,Italia,4,5,,9,POINT (125862 -81702165)
2012,Septiembre,Italia,17,69,,86,POINT (3451668 -76532004)
2012,Septiembre,Italia,337,1366,,1703,POINT (4697157 -74140516)
2012,Septiembre,Italia,0,3,,3,POINT (4815189 -75736374)
2012,Septiembre,Italia,19,81,,100,POINT (6170465 -7542726)
2012,Septiembre,Italia,0,1,,1,POINT (7088729 -70740253)
2012,Septiembre,Italia,5,16,,21,POINT (7819 -72453013)
2012,Septiembre,Italia,1,2,,3,POINT (7927233 -72508188)
2012,Septiembre,Italia,0,4,,4,POINT (863337 -7735002)
2012,Septiembre,Islas del Canal,1,1,,2,POINT (4697157 -74140516)
2012,Septiembre,Jamaica,3,1,,4,POINT (10446304 -75516486)
2012,Septiembre,Jamaica,0,1,,1,POINT (10886686 -74776479)
2012,Septiembre,Jamaica,2,2,,4,POINT (3451668 -76532004)
2012,Septiembre,Jamaica,5,5,,10,POINT (4697157 -74140516)
2012,Septiembre,Jamaica,2,2,,4,POINT (6170465 -7542726)
2012,Septiembre,Japón,0,4,,4,POINT (-4191162 -69941498)
2012,Septiembre,Japón,4,6,,10,POINT (0.81488 -77356)
2012,Septiembre,Japón,1,5,,6,POINT (10406342 -75527794)
2012,Septiembre,Japón,4,8,,12,POINT (10446304 -75516486)
2012,Septiembre,Japón,0,5,,5,POINT (10886686 -74776479)
2012,Septiembre,Japón,1,2,,3,POINT (11360029 -72129595)
2012,Septiembre,Japón,1,1,,2,POINT (125862 -81702165)
2012,Septiembre,Japón,8,13,,21,POINT (3451668 -76532004)
2012,Septiembre,Japón,0,1,,1,POINT (445285 -75766353)
2012,Septiembre,Japón,140,419,,559,POINT (4697157 -74140516)
2012,Septiembre,Japón,0,2,,2,POINT (4815189 -75736374)
2012,Septiembre,Japón,3,27,,30,POINT (6170465 -7542726)
2012,Septiembre,Japón,0,1,,1,POINT (6222552 -77401154)
2012,Septiembre,Japón,2,4,,6,POINT (7819 -72453013)
2012,Septiembre,Jordania,5,6,,11,POINT (4697157 -74140516)
2012,Septiembre,Kazajistán,2,3,,5,POINT (4697157 -74140516)
2012,Septiembre,Kazajistán,2,0,,2,POINT (6170465 -7542726)
2012,Septiembre,Kenia,5,15,,20,POINT (4697157 -74140516)
2012,Septiembre,Kenia,0,1,,1,POINT (6170465 -7542726)
2012,Septiembre,Kuwait,0,1,,1,POINT (6170465 -7542726)
2012,Septiembre,Letonia,0,2,,2,POINT (0.81488 -77356)
2012,Septiembre,Letonia,1,1,,2,POINT (10446304 -75516486)
2012,Septiembre,Letonia,1,0,,1,POINT (10886686 -74776479)
2012,Septiembre,Letonia,1,10,,11,POINT (10970933 -74765343)
2012,Septiembre,Letonia,1,8,,9,POINT (4697157 -74140516)
2012,Septiembre,Letonia,0,1,,1,POINT (6170465 -7542726)
2012,Septiembre,Lituania,0,1,,1,POINT (0.81488 -77356)
2012,Septiembre,Lituania,1,0,,1,POINT (10446304 -75516486)
2012,Septiembre,Lituania,0,1,,1,POINT (3451668 -76532004)
2012,Septiembre,Lituania,1,10,,11,POINT (4697157 -74140516)
2012,Septiembre,Lituania,0,1,,1,POINT (6170465 -7542726)
2012,Septiembre,Líbano,0,2,,2,POINT (0.81488 -77356)
2012,Septiembre,Líbano,0,1,,1,POINT (10446304 -75516486)
2012,Septiembre,Líbano,0,3,,3,POINT (10886686 -74776479)
2012,Septiembre,Líbano,9,1,,10,POINT (11360029 -72129595)
2012,Septiembre,Líbano,0,2,,2,POINT (125862 -81702165)
2012,Septiembre,Líbano,0,3,,3,POINT (3451668 -76532004)
2012,Septiembre,Líbano,22,36,,58,POINT (4697157 -74140516)
2012,Septiembre,Líbano,0,1,,1,POINT (7128047 -73181317)
2012,Septiembre,Líbano,1,0,,1,POINT (7819 -72453013)
2012,Septiembre,Libia,0,2,,2,POINT (4697157 -74140516)
2012,Septiembre,Liechtenstein,0,1,,1,POINT (10446304 -75516486)
2012,Septiembre,Liechtenstein,0,2,,2,POINT (4697157 -74140516)
2012,Septiembre,Luxemburgo,0,2,,2,POINT (0.81488 -77356)
2012,Septiembre,Luxemburgo,3,6,,9,POINT (4697157 -74140516)
2012,Septiembre,Macedonia,0,1,,1,POINT (4697157 -74140516)
2012,Septiembre,Madagascar,1,0,,1,POINT (4697157 -74140516)
2012,Septiembre,Malasia,1,4,,5,POINT (10446304 -75516486)
2012,Septiembre,Malasia,25,66,,91,POINT (4697157 -74140516)
2012,Septiembre,Malasia,0,1,,1,POINT (6170465 -7542726)
2012,Septiembre,Malta,0,1,,1,POINT (4697157 -74140516)
2012,Septiembre,Malta,0,1,,1,POINT (6170465 -7542726)
2012,Septiembre,Marruecos,10,7,,17,POINT (4697157 -74140516)
2012,Septiembre,Mauricio,0,1,,1,POINT (4697157 -74140516)
2012,Septiembre,Mauritania,3,1,,4,POINT (4697157 -74140516)
2012,Septiembre,México,2,1,,3,POINT (-4191162 -69941498)
2012,Septiembre,México,6,14,,20,POINT (0.81488 -77356)
2012,Septiembre,México,0,2,,2,POINT (10406342 -75527794)
2012,Septiembre,México,108,159,,267,POINT (10446304 -75516486)
2012,Septiembre,México,19,57,,76,POINT (10886686 -74776479)
2012,Septiembre,México,5,5,,10,POINT (11360029 -72129595)
2012,Septiembre,México,0,4,,4,POINT (125744111 -81703935)
2012,Septiembre,México,9,1,,10,POINT (125862 -81702165)
2012,Septiembre,México,47,196,,243,POINT (3451668 -76532004)
2012,Septiembre,México,0,1,,1,POINT (445285 -75766353)
2012,Septiembre,México,1813,4769,,6582,POINT (4697157 -74140516)
2012,Septiembre,México,0,13,,13,POINT (4815189 -75736374)
2012,Septiembre,México,128,387,,515,POINT (6170465 -7542726)
2012,Septiembre,México,0,1,,1,POINT (7088729 -70740253)
2012,Septiembre,México,1,17,,18,POINT (7128047 -73181317)
2012,Septiembre,México,26,25,,51,POINT (7819 -72453013)
2012,Septiembre,México,1,5,,6,POINT (7927233 -72508188)
2012,Septiembre,México,1,2,,3,POINT (863337 -7735002)
2012,Septiembre,República de Moldavia,1,0,,1,POINT (4697157 -74140516)
2012,Septiembre,República de Moldavia,1,0,,1,POINT (6170465 -7542726)
2012,Septiembre,Mongolia,1,0,,1,POINT (4697157 -74140516)
2012,Septiembre,Mozambique,0,2,,2,POINT (4697157 -74140516)
2012,Septiembre,Namibia,1,0,,1,POINT (4697157 -74140516)
2012,Septiembre,Nepal,0,1,,1,POINT (4697157 -74140516)
2012,Septiembre,Nicaragua,13,18,,31,POINT (10446304 -75516486)
2012,Septiembre,Nicaragua,2,3,,5,POINT (10886686 -74776479)
2012,Septiembre,Nicaragua,1,4,,5,POINT (125862 -81702165)
2012,Septiembre,Nicaragua,7,34,,41,POINT (3451668 -76532004)
2012,Septiembre,Nicaragua,53,82,,135,POINT (4697157 -74140516)
2012,Septiembre,Nicaragua,4,7,,11,POINT (6170465 -7542726)
2012,Septiembre,Nigeria,1,0,,1,POINT (10446304 -75516486)
2012,Septiembre,Nigeria,0,9,,9,POINT (4697157 -74140516)
2012,Septiembre,Nigeria,1,1,,2,POINT (6170465 -7542726)
2012,Septiembre,Noruega,0,1,,1,POINT (0.81488 -77356)
2012,Septiembre,Noruega,1,3,,4,POINT (10406342 -75527794)
2012,Septiembre,Noruega,1,10,,11,POINT (10446304 -75516486)
2012,Septiembre,Noruega,0,2,,2,POINT (10886686 -74776479)
2012,Septiembre,Noruega,1,0,,1,POINT (11360029 -72129595)
2012,Septiembre,Noruega,3,8,,11,POINT (3451668 -76532004)
2012,Septiembre,Noruega,1,0,,1,POINT (445285 -75766353)
2012,Septiembre,Noruega,37,83,,120,POINT (4697157 -74140516)
2012,Septiembre,Noruega,1,15,,16,POINT (6170465 -7542726)
2012,Septiembre,Nueva Caledonia/Territorio francés,0,1,,1,POINT (10406342 -75527794)
2012,Septiembre,Nueva Zelanda,0,1,,1,POINT (-4191162 -69941498)
2012,Septiembre,Nueva Zelanda,9,9,,18,POINT (0.81488 -77356)
2012,Septiembre,Nueva Zelanda,1,4,,5,POINT (10446304 -75516486)
2012,Septiembre,Nueva Zelanda,0,1,,1,POINT (10886686 -74776479)
2012,Septiembre,Nueva Zelanda,2,5,,7,POINT (3451668 -76532004)
2012,Septiembre,Nueva Zelanda,39,57,,96,POINT (4697157 -74140516)
2012,Septiembre,Nueva Zelanda,0,1,,1,POINT (4815189 -75736374)
2012,Septiembre,Nueva Zelanda,2,8,,10,POINT (6170465 -7542726)
2012,Septiembre,Nueva Zelanda,0,1,,1,POINT (863337 -7735002)
2012,Septiembre,Nueva Zelanda,0,1,,1,POINT (0.81488 -77356)
2012,Septiembre,Nueva Zelanda,4,7,,11,POINT (10406342 -75527794)
2012,Septiembre,Nueva Zelanda,3,5,,8,POINT (4697157 -74140516)
2012,Septiembre,Nueva Zelanda,0,1,,1,POINT (6170465 -7542726)
2012,Septiembre,Países Bajos,1,3,,4,POINT (0.81488 -77356)
2012,Septiembre,Países Bajos,0,5,,5,POINT (10446304 -75516486)
2012,Septiembre,Países Bajos,2,4,,6,POINT (10886686 -74776479)
2012,Septiembre,Países Bajos,1,1,,2,POINT (11360029 -72129595)
2012,Septiembre,Países Bajos,17,21,,38,POINT (1152863 -72919186)
2012,Septiembre,Países Bajos,11,21,,32,POINT (3451668 -76532004)
2012,Septiembre,Países Bajos,170,281,,451,POINT (4697157 -74140516)
2012,Septiembre,Países Bajos,1,0,,1,POINT (4815189 -75736374)
2012,Septiembre,Países Bajos,111,173,,284,POINT (6170465 -7542726)
2012,Septiembre,Países Bajos,5,6,,11,POINT (7128047 -73181317)
2012,Septiembre,Países Bajos,1,1,,2,POINT (7819 -72453013)
2012,Septiembre,Países Bajos,1,0,,1,POINT (7927233 -72508188)
2012,Septiembre,Pakistán,0,1,,1,POINT (11360029 -72129595)
2012,Septiembre,Pakistán,0,2,,2,POINT (3451668 -76532004)
2012,Septiembre,Pakistán,2,6,,8,POINT (4697157 -74140516)
2012,Septiembre,Panamá,0,15,,15,POINT (10406342 -75527794)
2012,Septiembre,Panamá,153,234,,387,POINT (10446304 -75516486)
2012,Septiembre,Panamá,58,103,,161,POINT (10886686 -74776479)
2012,Septiembre,Panamá,1,2,,3,POINT (11360029 -72129595)
2012,Septiembre,Panamá,0,1,,1,POINT (125744111 -81703935)
2012,Septiembre,Panamá,79,66,,145,POINT (125862 -81702165)
2012,Septiembre,Panamá,133,160,,293,POINT (3451668 -76532004)
2012,Septiembre,Panamá,413,653,,1066,POINT (4697157 -74140516)
2012,Septiembre,Panamá,48,47,,95,POINT (4815189 -75736374)
2012,Septiembre,Panamá,181,303,,484,POINT (6170465 -7542726)
2012,Septiembre,Panamá,1,1,,2,POINT (6222552 -77401154)
2012,Septiembre,Panamá,0,1,,1,POINT (7088729 -70740253)
2012,Septiembre,Panamá,3,4,,7,POINT (7128047 -73181317)
2012,Septiembre,Panamá,2,4,,6,POINT (7819 -72453013)
2012,Septiembre,Panamá,5,14,,19,POINT (7927233 -72508188)
2012,Septiembre,Panamá,3,8,,11,POINT (863337 -7735002)
2012,Septiembre,Paraguay,1,2,,3,POINT (0.81488 -77356)
2012,Septiembre,Paraguay,23,22,,45,POINT (10446304 -75516486)
2012,Septiembre,Paraguay,7,10,,17,POINT (10886686 -74776479)
2012,Septiembre,Paraguay,10,40,,50,POINT (3451668 -76532004)
2012,Septiembre,Paraguay,70,100,,170,POINT (4697157 -74140516)
2012,Septiembre,Paraguay,10,13,,23,POINT (6170465 -7542726)
2012,Septiembre,Paraguay,1,0,,1,POINT (7088729 -70740253)
2012,Septiembre,Paraguay,3,1,,4,POINT (7819 -72453013)
2012,Septiembre,Paraguay,0,1,,1,POINT (7927233 -72508188)
2012,Septiembre,Perú,18,28,,46,POINT (-4191162 -69941498)
2012,Septiembre,Perú,2,3,,5,POINT (0.33002 -76876446)
2012,Septiembre,Perú,128,305,,433,POINT (0.81488 -77356)
2012,Septiembre,Perú,0,1,,1,POINT (10406342 -75527794)
2012,Septiembre,Perú,140,124,,264,POINT (10446304 -75516486)
2012,Septiembre,Perú,5,9,,14,POINT (10886686 -74776479)
2012,Septiembre,Perú,0,1,,1,POINT (11247723 -74213989)
2012,Septiembre,Perú,8,18,,26,POINT (11360029 -72129595)
2012,Septiembre,Perú,163,114,,277,POINT (125862 -81702165)
2012,Septiembre,Perú,126,166,,292,POINT (3451668 -76532004)
2012,Septiembre,Perú,1,2,,3,POINT (445285 -75766353)
2012,Septiembre,Perú,2244,3415,,5659,POINT (4697157 -74140516)
2012,Septiembre,Perú,0,2,,2,POINT (4815189 -75736374)
2012,Septiembre,Perú,196,376,,572,POINT (6170465 -7542726)
2012,Septiembre,Perú,2,3,,5,POINT (6185536 -67484028)
2012,Septiembre,Perú,0,2,,2,POINT (7128047 -73181317)
2012,Septiembre,Perú,29,33,,62,POINT (7819 -72453013)
2012,Septiembre,Perú,2,1,,3,POINT (7927233 -72508188)
2012,Septiembre,Perú,0,2,,2,POINT (863337 -7735002)
2012,Septiembre,Palestina,2,1,,3,POINT (4697157 -74140516)
2012,Septiembre,Polonia,0,1,,1,POINT (-4191162 -69941498)
2012,Septiembre,Polonia,5,8,,13,POINT (0.81488 -77356)
2012,Septiembre,Polonia,1,9,,10,POINT (10406342 -75527794)
2012,Septiembre,Polonia,1,2,,3,POINT (10446304 -75516486)
2012,Septiembre,Polonia,3,2,,5,POINT (11360029 -72129595)
2012,Septiembre,Polonia,0,1,,1,POINT (3451668 -76532004)
2012,Septiembre,Polonia,49,98,,147,POINT (4697157 -74140516)
2012,Septiembre,Polonia,3,3,,6,POINT (6170465 -7542726)
2012,Septiembre,Polonia,1,1,,2,POINT (863337 -7735002)
2012,Septiembre,Portugal,1,0,,1,POINT (-4191162 -69941498)
2012,Septiembre,Portugal,3,3,,6,POINT (0.81488 -77356)
2012,Septiembre,Portugal,1,2,,3,POINT (10406342 -75527794)
2012,Septiembre,Portugal,8,31,,39,POINT (10446304 -75516486)
2012,Septiembre,Portugal,2,0,,2,POINT (10886686 -74776479)
2012,Septiembre,Portugal,0,1,,1,POINT (11360029 -72129595)
2012,Septiembre,Portugal,1,21,,22,POINT (3451668 -76532004)
2012,Septiembre,Portugal,83,303,,386,POINT (4697157 -74140516)
2012,Septiembre,Portugal,6,16,,22,POINT (6170465 -7542726)
2012,Septiembre,Portugal,1,6,,7,POINT (7819 -72453013)
2012,Septiembre,Portugal,0,1,,1,POINT (7927233 -72508188)
2012,Septiembre,Portugal,0,2,,2,POINT (863337 -7735002)
2012,Septiembre,Puerto Rico/Territorio de Estados Unidos,0,4,,4,POINT (6170465 -7542726)
2012,Septiembre,Qatar,0,1,,1,POINT (6170465 -7542726)
2012,Septiembre,Reino Unido de Gran Bretaña e Irlanda del Norte,1,2,,3,POINT (-4191162 -69941498)
2012,Septiembre,Reino Unido de Gran Bretaña e Irlanda del Norte,2,3,,5,POINT (0.81488 -77356)
2012,Septiembre,Reino Unido de Gran Bretaña e Irlanda del Norte,0,1,,1,POINT (10406342 -75527794)
2012,Septiembre,Reino Unido de Gran Bretaña e Irlanda del Norte,10,18,,28,POINT (10446304 -75516486)
2012,Septiembre,Reino Unido de Gran Bretaña e Irlanda del Norte,1,4,,5,POINT (11247723 -74213989)
2012,Septiembre,Reino Unido de Gran Bretaña e Irlanda del Norte,5,16,,21,POINT (3451668 -76532004)
2012,Septiembre,Reino Unido de Gran Bretaña e Irlanda del Norte,196,509,,705,POINT (4697157 -74140516)
2012,Septiembre,Reino Unido de Gran Bretaña e Irlanda del Norte,0,1,,1,POINT (4815189 -75736374)
2012,Septiembre,Reino Unido de Gran Bretaña e Irlanda del Norte,11,33,,44,POINT (6170465 -7542726)
2012,Septiembre,Reino Unido de Gran Bretaña e Irlanda del Norte,3,1,,4,POINT (7819 -72453013)
2012,Septiembre,República Dominicana,2,8,,10,POINT (0.81488 -77356)
2012,Septiembre,República Dominicana,37,68,,105,POINT (10446304 -75516486)
2012,Septiembre,República Dominicana,13,33,,46,POINT (10886686 -74776479)
2012,Septiembre,República Dominicana,1,0,,1,POINT (11360029 -72129595)
2012,Septiembre,República Dominicana,0,1,,1,POINT (125862 -81702165)
2012,Septiembre,República Dominicana,32,62,,94,POINT (3451668 -76532004)
2012,Septiembre,República Dominicana,200,398,,598,POINT (4697157 -74140516)
2012,Septiembre,República Dominicana,1,5,,6,POINT (4815189 -75736374)
2012,Septiembre,República Dominicana,24,76,,100,POINT (6170465 -7542726)
2012,Septiembre,República Dominicana,0,2,,2,POINT (7128047 -73181317)
2012,Septiembre,República Dominicana,2,0,,2,POINT (7819 -72453013)
2012,Septiembre,República Dominicana,12,16,,28,POINT (7927233 -72508188)
2012,Septiembre,República Checa,0,1,,1,POINT (3451668 -76532004)
2012,Septiembre,República Checa,1,3,,4,POINT (4697157 -74140516)
2012,Septiembre,República Checa,1,2,,3,POINT (7819 -72453013)
2012,Septiembre,Rumania,0,3,,3,POINT (10406342 -75527794)
2012,Septiembre,Rumania,0,1,,1,POINT (10970933 -74765343)
2012,Septiembre,Rumania,2,5,,7,POINT (3451668 -76532004)
2012,Septiembre,Rumania,34,58,,92,POINT (4697157 -74140516)
2012,Septiembre,Rumania,1,4,,5,POINT (6170465 -7542726)
2012,Septiembre,Federación de Rusia,4,4,,8,POINT (0.81488 -77356)
2012,Septiembre,Federación de Rusia,0,1,,1,POINT (10406342 -75527794)
2012,Septiembre,Federación de Rusia,1,1,,2,POINT (10446304 -75516486)
2012,Septiembre,Federación de Rusia,1,2,,3,POINT (3451668 -76532004)
2012,Septiembre,Federación de Rusia,0,1,,1,POINT (3884426 -77061029)
2012,Septiembre,Federación de Rusia,32,34,,66,POINT (4697157 -74140516)
2012,Septiembre,Federación de Rusia,1,1,,2,POINT (7819 -72453013)
2012,Septiembre,Federación de Rusia,1,0,,1,POINT (863337 -7735002)
2012,Septiembre,San Cristóbal y Nevis,0,1,,1,POINT (10886686 -74776479)
2012,Septiembre,San Cristóbal y Nevis,0,2,,2,POINT (11360029 -72129595)
2012,Septiembre,San Cristóbal y Nevis,0,1,,1,POINT (1152863 -72919186)
2012,Septiembre,San Cristóbal y Nevis,0,1,,1,POINT (6170465 -7542726)
2012,Septiembre,Santa Lucia,1,0,,1,POINT (10446304 -75516486)
2012,Septiembre,Santa Lucia,0,1,,1,POINT (10886686 -74776479)
2012,Septiembre,Santa Lucia,2,2,,4,POINT (4697157 -74140516)
2012,Septiembre,Santa Lucia,0,1,,1,POINT (7128047 -73181317)
2012,Septiembre,Senegal,1,2,,3,POINT (4697157 -74140516)
2012,Septiembre,Serbia,1,1,,2,POINT (10446304 -75516486)
2012,Septiembre,Serbia,1,5,,6,POINT (4697157 -74140516)
2012,Septiembre,Sierra Leona,0,1,,1,POINT (4697157 -74140516)
2012,Septiembre,Singapur,1,0,,1,POINT (10446304 -75516486)
2012,Septiembre,Singapur,3,3,,6,POINT (3451668 -76532004)
2012,Septiembre,Singapur,11,20,,31,POINT (4697157 -74140516)
2012,Septiembre,Singapur,2,0,,2,POINT (6170465 -7542726)
2012,Septiembre,República Árabe Siria,2,2,,4,POINT (4697157 -74140516)
2012,Septiembre,Sri Lanka,1,1,,2,POINT (4697157 -74140516)
2012,Septiembre,Sudáfrica,1,0,,1,POINT (-4191162 -69941498)
2012,Septiembre,Sudáfrica,1,0,,1,POINT (10406342 -75527794)
2012,Septiembre,Sudáfrica,0,3,,3,POINT (10446304 -75516486)
2012,Septiembre,Sudáfrica,0,5,,5,POINT (10886686 -74776479)
2012,Septiembre,Sudáfrica,0,2,,2,POINT (3451668 -76532004)
2012,Septiembre,Sudáfrica,23,54,,77,POINT (4697157 -74140516)
2012,Septiembre,Sudáfrica,1,7,,8,POINT (6170465 -7542726)
2012,Septiembre,Suecia,2,9,,11,POINT (0.81488 -77356)
2012,Septiembre,Suecia,1,2,,3,POINT (10406342 -75527794)
2012,Septiembre,Suecia,2,9,,11,POINT (10446304 -75516486)
2012,Septiembre,Suecia,0,1,,1,POINT (10886686 -74776479)
2012,Septiembre,Suecia,1,1,,2,POINT (11360029 -72129595)
2012,Septiembre,Suecia,2,3,,5,POINT (3451668 -76532004)
2012,Septiembre,Suecia,100,173,,273,POINT (4697157 -74140516)
2012,Septiembre,Suecia,2,0,,2,POINT (4815189 -75736374)
2012,Septiembre,Suecia,5,13,,18,POINT (6170465 -7542726)
2012,Septiembre,Suecia,0,2,,2,POINT (7819 -72453013)
2012,Septiembre,Suecia,1,0,,1,POINT (863337 -7735002)
2012,Septiembre,Suiza,4,5,,9,POINT (-4191162 -69941498)
2012,Septiembre,Suiza,9,16,,25,POINT (0.81488 -77356)
2012,Septiembre,Suiza,1,1,,2,POINT (10406342 -75527794)
2012,Septiembre,Suiza,14,20,,34,POINT (10446304 -75516486)
2012,Septiembre,Suiza,1,3,,4,POINT (10886686 -74776479)
2012,Septiembre,Suiza,0,2,,2,POINT (11247723 -74213989)
2012,Septiembre,Suiza,1,3,,4,POINT (11360029 -72129595)
2012,Septiembre,Suiza,8,24,,32,POINT (3451668 -76532004)
2012,Septiembre,Suiza,1,0,,1,POINT (445285 -75766353)
2012,Septiembre,Suiza,175,414,,589,POINT (4697157 -74140516)
2012,Septiembre,Suiza,5,32,,37,POINT (6170465 -7542726)
2012,Septiembre,Suiza,3,8,,11,POINT (7819 -72453013)
2012,Septiembre,Suiza,1,2,,3,POINT (863337 -7735002)
2012,Septiembre,Surinam,1,0,,1,POINT (10446304 -75516486)
2012,Septiembre,Surinam,0,1,,1,POINT (3451668 -76532004)
2012,Septiembre,Surinam,13,15,,28,POINT (4697157 -74140516)
2012,Septiembre,Surinam,2,1,,3,POINT (6170465 -7542726)
2012,Septiembre,Taiwán,3,5,,8,POINT (4697157 -74140516)
2012,Septiembre,Tailandia,7,9,,16,POINT (4697157 -74140516)
2012,Septiembre,Tailandia,1,0,,1,POINT (6170465 -7542726)
2012,Septiembre,Territorio Antártico Británico/Territorio Británico de Ultramar,1,7,,8,POINT (4697157 -74140516)
2012,Septiembre,Territorio Antártico Británico/Territorio Británico de Ultramar,0,1,,1,POINT (6170465 -7542726)
2012,Septiembre,Tanzania,0,1,,1,POINT (4697157 -74140516)
2012,Septiembre,Tanzania,0,1,,1,POINT (6170465 -7542726)
2012,Septiembre,Trinidad y Tobago,77,55,,132,POINT (10446304 -75516486)
2012,Septiembre,Trinidad y Tobago,2,3,,5,POINT (10886686 -74776479)
2012,Septiembre,Trinidad y Tobago,1,0,,1,POINT (11360029 -72129595)
2012,Septiembre,Trinidad y Tobago,1,17,,18,POINT (3451668 -76532004)
2012,Septiembre,Trinidad y Tobago,15,47,,62,POINT (4697157 -74140516)
2012,Septiembre,Trinidad y Tobago,0,3,,3,POINT (4815189 -75736374)
2012,Septiembre,Trinidad y Tobago,0,13,,13,POINT (6170465 -7542726)
2012,Septiembre,Trinidad y Tobago,2,1,,3,POINT (7128047 -73181317)
2012,Septiembre,Trinidad y Tobago,0,3,,3,POINT (7819 -72453013)
2012,Septiembre,Túnez,0,1,,1,POINT (4697157 -74140516)
2012,Septiembre,Túnez,0,1,,1,POINT (6170465 -7542726)
2012,Septiembre,Turquía,0,2,,2,POINT (0.81488 -77356)
2012,Septiembre,Turquía,0,2,,2,POINT (10406342 -75527794)
2012,Septiembre,Turquía,2,1,,3,POINT (10446304 -75516486)
2012,Septiembre,Turquía,0,1,,1,POINT (10886686 -74776479)
2012,Septiembre,Turquía,0,1,,1,POINT (11360029 -72129595)
2012,Septiembre,Turquía,1,4,,5,POINT (3451668 -76532004)
2012,Septiembre,Turquía,10,67,,77,POINT (4697157 -74140516)
2012,Septiembre,Turquía,0,2,,2,POINT (6170465 -7542726)
2012,Septiembre,Turquía,0,1,,1,POINT (863337 -7735002)
2012,Septiembre,Turkmenistán,1,0,,1,POINT (4697157 -74140516)
2012,Septiembre,Ucrania,1,1,,2,POINT (10446304 -75516486)
2012,Septiembre,Ucrania,0,3,,3,POINT (3451668 -76532004)
2012,Septiembre,Ucrania,16,12,,28,POINT (4697157 -74140516)
2012,Septiembre,Uganda,0,3,,3,POINT (4697157 -74140516)
2012,Septiembre,Federación de Rusia,0,1,,1,POINT (-4191162 -69941498)
2012,Septiembre,Federación de Rusia,2,0,,2,POINT (0.81488 -77356)
2012,Septiembre,Federación de Rusia,0,1,,1,POINT (10406342 -75527794)
2012,Septiembre,Federación de Rusia,1,0,,1,POINT (10446304 -75516486)
2012,Septiembre,Federación de Rusia,0,1,,1,POINT (10970933 -74765343)
2012,Septiembre,Federación de Rusia,0,1,,1,POINT (11360029 -72129595)
2012,Septiembre,Federación de Rusia,1,1,,2,POINT (3451668 -76532004)
2012,Septiembre,Federación de Rusia,98,132,,230,POINT (4697157 -74140516)
2012,Septiembre,Federación de Rusia,3,1,,4,POINT (6170465 -7542726)
2012,Septiembre,Federación de Rusia,0,1,,1,POINT (9402597 -75681642)
2012,Septiembre,Uruguay,4,12,,16,POINT (0.81488 -77356)
2012,Septiembre,Uruguay,1,0,,1,POINT (10406342 -75527794)
2012,Septiembre,Uruguay,74,69,,143,POINT (10446304 -75516486)
2012,Septiembre,Uruguay,8,109,,117,POINT (10886686 -74776479)
2012,Septiembre,Uruguay,0,2,,2,POINT (11360029 -72129595)
2012,Septiembre,Uruguay,46,44,,90,POINT (125862 -81702165)
2012,Septiembre,Uruguay,12,33,,45,POINT (3451668 -76532004)
2012,Septiembre,Uruguay,1,0,,1,POINT (445285 -75766353)
2012,Septiembre,Uruguay,131,370,,501,POINT (4697157 -74140516)
2012,Septiembre,Uruguay,0,1,,1,POINT (4815189 -75736374)
2012,Septiembre,Uruguay,37,44,,81,POINT (6170465 -7542726)
2012,Septiembre,Uruguay,0,1,,1,POINT (7088729 -70740253)
2012,Septiembre,Uruguay,0,1,,1,POINT (7128047 -73181317)
2012,Septiembre,Uruguay,5,11,,16,POINT (7819 -72453013)
2012,Septiembre,Uzbekistán,0,1,,1,POINT (4697157 -74140516)
2012,Septiembre,Venezuela,0,4,,4,POINT (0.33002 -76876446)
2012,Septiembre,Venezuela,144,156,,300,POINT (0.81488 -77356)
2012,Septiembre,Venezuela,347,311,,658,POINT (10446304 -75516486)
2012,Septiembre,Venezuela,34,81,,115,POINT (10886686 -74776479)
2012,Septiembre,Venezuela,0,4,,4,POINT (11117206 -74232675)
2012,Septiembre,Venezuela,1360,1693,,3053,POINT (11360029 -72129595)
2012,Septiembre,Venezuela,1,0,,1,POINT (1152863 -72919186)
2012,Septiembre,Venezuela,27,16,,43,POINT (125862 -81702165)
2012,Septiembre,Venezuela,112,104,,216,POINT (3451668 -76532004)
2012,Septiembre,Venezuela,5947,6938,,12885,POINT (4697157 -74140516)
2012,Septiembre,Venezuela,0,7,,7,POINT (4815189 -75736374)
2012,Septiembre,Venezuela,310,366,,676,POINT (6170465 -7542726)
2012,Septiembre,Venezuela,2,3,,5,POINT (6185536 -67484028)
2012,Septiembre,Venezuela,2,0,,2,POINT (6222552 -77401154)
2012,Septiembre,Venezuela,28,47,,75,POINT (7088729 -70740253)
2012,Septiembre,Venezuela,9,7,,16,POINT (7128047 -73181317)
2012,Septiembre,Venezuela,1801,1765,,3566,POINT (7819 -72453013)
2012,Septiembre,Venezuela,402,444,,846,POINT (7927233 -72508188)
2012,Septiembre,Venezuela,0,2,,2,POINT (806667 -767333)
2012,Septiembre,Venezuela,0,1,,1,POINT (863337 -7735002)
2012,Septiembre,Zimbabue,0,1,,1,POINT (4697157 -74140516)
2012,Septiembre,Reino Unido de Gran Bretaña e Irlanda del Norte,1,8,,9,POINT (-4191162 -69941498)
2012,Septiembre,Reino Unido de Gran Bretaña e Irlanda del Norte,23,42,,65,POINT (0.81488 -77356)
2012,Septiembre,Reino Unido de Gran Bretaña e Irlanda del Norte,12,13,,25,POINT (10406342 -75527794)
2012,Septiembre,Reino Unido de Gran Bretaña e Irlanda del Norte,18,40,,58,POINT (10446304 -75516486)
2012,Septiembre,Reino Unido de Gran Bretaña e Irlanda del Norte,2,6,,8,POINT (10886686 -74776479)
2012,Septiembre,Reino Unido de Gran Bretaña e Irlanda del Norte,0,1,,1,POINT (11247723 -74213989)
2012,Septiembre,Reino Unido de Gran Bretaña e Irlanda del Norte,1,4,,5,POINT (11360029 -72129595)
2012,Septiembre,Reino Unido de Gran Bretaña e Irlanda del Norte,0,1,,1,POINT (125862 -81702165)
2012,Septiembre,Reino Unido de Gran Bretaña e Irlanda del Norte,15,32,,47,POINT (3451668 -76532004)
2012,Septiembre,Reino Unido de Gran Bretaña e Irlanda del Norte,189,489,,678,POINT (4697157 -74140516)
2012,Septiembre,Reino Unido de Gran Bretaña e Irlanda del Norte,1,0,,1,POINT (4815189 -75736374)
2012,Septiembre,Reino Unido de Gran Bretaña e Irlanda del Norte,7,15,,22,POINT (6170465 -7542726)
2012,Septiembre,Reino Unido de Gran Bretaña e Irlanda del Norte,0,9,,9,POINT (7819 -72453013)
2012,Septiembre,Reino Unido de Gran Bretaña e Irlanda del Norte,0,1,,1,POINT (7927233 -72508188)
2012,Septiembre,Reino Unido de Gran Bretaña e Irlanda del Norte,1,6,,7,POINT (863337 -7735002)
2012,Septiembre,Países Bajos,0,4,,4,POINT (-4191162 -69941498)
2012,Septiembre,Países Bajos,8,9,,17,POINT (0.81488 -77356)
2012,Septiembre,Países Bajos,5,17,,22,POINT (10406342 -75527794)
2012,Septiembre,Países Bajos,14,37,,51,POINT (10446304 -75516486)
2012,Septiembre,Países Bajos,1,12,,13,POINT (10886686 -74776479)
2012,Septiembre,Países Bajos,3,4,,7,POINT (11247723 -74213989)
2012,Septiembre,Países Bajos,1,3,,4,POINT (11360029 -72129595)
2012,Septiembre,Países Bajos,0,1,,1,POINT (125862 -81702165)
2012,Septiembre,Países Bajos,14,49,,63,POINT (3451668 -76532004)
2012,Septiembre,Países Bajos,343,611,,954,POINT (4697157 -74140516)
2012,Septiembre,Países Bajos,0,2,,2,POINT (4815189 -75736374)
2012,Septiembre,Países Bajos,73,110,,183,POINT (6170465 -7542726)
2012,Septiembre,Países Bajos,3,3,,6,POINT (7128047 -73181317)
2012,Septiembre,Países Bajos,2,2,,4,POINT (7819 -72453013)
2012,Septiembre,Países Bajos,1,4,,5,POINT (7927233 -72508188)
2012,Septiembre,Eslovenia,0,2,,2,POINT (4697157 -74140516)
2012,Septiembre,Lituania,0,1,,1,POINT (10970933 -74765343)
2012,Septiembre,Lituania,0,1,,1,POINT (3451668 -76532004)
2012,Septiembre,Lituania,1,3,,4,POINT (4697157 -74140516)
2012,Septiembre,Reino Unido de Gran Bretaña e Irlanda del Norte,1,5,,6,POINT (4697157 -74140516)
2012,Septiembre,Reino Unido de Gran Bretaña e Irlanda del Norte,0,1,,1,POINT (6170465 -7542726)
2012,Septiembre,Reino Unido de Gran Bretaña e Irlanda del Norte,4,7,,11,POINT (10406342 -75527794)
2012,Septiembre,Reino Unido de Gran Bretaña e Irlanda del Norte,1,0,,1,POINT (10446304 -75516486)
2012,Septiembre,Reino Unido de Gran Bretaña e Irlanda del Norte,0,3,,3,POINT (11247723 -74213989)
2012,Septiembre,Reino Unido de Gran Bretaña e Irlanda del Norte,0,1,,1,POINT (11360029 -72129595)
2012,Septiembre,Reino Unido de Gran Bretaña e Irlanda del Norte,9,7,,16,POINT (4697157 -74140516)
2012,Septiembre,Letonia,0,4,,4,POINT (4697157 -74140516)
2012,Septiembre,Marruecos,1,0,,1,POINT (4697157 -74140516)
2012,Septiembre,República CentroÁfricana,1,2,,3,POINT (4697157 -74140516)
2012,Octubre,Desconocido,1,0,,1,POINT (4697157 -74140516)
2012,Octubre,Albania,0,3,,3,POINT (0.81488 -77356)
2012,Octubre,Albania,1,3,,4,POINT (4697157 -74140516)
2012,Octubre,Alemania,3,2,,5,POINT (-4191162 -69941498)
2012,Octubre,Alemania,0,1,,1,POINT (0.33002 -76876446)
2012,Octubre,Alemania,28,38,,66,POINT (0.81488 -77356)
2012,Octubre,Alemania,1,0,,1,POINT (1800143 -78802679)
2012,Octubre,Alemania,13,21,,34,POINT (10406342 -75527794)
2012,Octubre,Alemania,11,30,,41,POINT (10446304 -75516486)
2012,Octubre,Alemania,9,9,,18,POINT (10886686 -74776479)
2012,Octubre,Alemania,5,6,,11,POINT (11360029 -72129595)
2012,Octubre,Alemania,0,2,,2,POINT (1152863 -72919186)
2012,Octubre,Alemania,1,5,,6,POINT (125862 -81702165)
2012,Octubre,Alemania,30,64,,94,POINT (3451668 -76532004)
2012,Octubre,Alemania,0,1,,1,POINT (3884426 -77061029)
2012,Octubre,Alemania,1,1,,2,POINT (445285 -75766353)
2012,Octubre,Alemania,940,1749,,2689,POINT (4697157 -74140516)
2012,Octubre,Alemania,0,2,,2,POINT (4815189 -75736374)
2012,Octubre,Alemania,29,95,,124,POINT (6170465 -7542726)
2012,Octubre,Alemania,0,2,,2,POINT (7088729 -70740253)
2012,Octubre,Alemania,10,7,,17,POINT (7819 -72453013)
2012,Octubre,Alemania,0,2,,2,POINT (7927233 -72508188)
2012,Octubre,Alemania,4,7,,11,POINT (863337 -7735002)
2012,Octubre,Andorra,1,1,,2,POINT (3451668 -76532004)
2012,Octubre,Andorra,2,7,,9,POINT (4697157 -74140516)
2012,Octubre,Angola,0,1,,1,POINT (10446304 -75516486)
2012,Octubre,Angola,1,1,,2,POINT (4697157 -74140516)
2012,Octubre,Antigua y Barbuda,2,1,,3,POINT (3451668 -76532004)
2012,Octubre,Antigua y Barbuda,1,1,,2,POINT (4697157 -74140516)
2012,Octubre,Antigua y Barbuda,1,0,,1,POINT (6170465 -7542726)
2012,Octubre,Países Bajos,1,0,,1,POINT (4697157 -74140516)
2012,Octubre,Países Bajos,0,1,,1,POINT (6170465 -7542726)
2012,Octubre,Arabia Saudita,0,1,,1,POINT (4697157 -74140516)
2012,Octubre,Arabia Saudita,0,6,,6,POINT (4697157 -74140516)
2012,Octubre,Arabia Saudita,0,1,,1,POINT (6170465 -7542726)
2012,Octubre,Argelia,1,2,,3,POINT (4697157 -74140516)
2012,Octubre,Argentina,1,5,,6,POINT (-4191162 -69941498)
2012,Octubre,Argentina,4,3,,7,POINT (0.33002 -76876446)
2012,Octubre,Argentina,43,68,,111,POINT (0.81488 -77356)
2012,Octubre,Argentina,0,1,,1,POINT (1800143 -78802679)
2012,Octubre,Argentina,2,4,,6,POINT (10406342 -75527794)
2012,Octubre,Argentina,825,624,,1449,POINT (10446304 -75516486)
2012,Octubre,Argentina,10,30,,40,POINT (10886686 -74776479)
2012,Octubre,Argentina,9,17,,26,POINT (11360029 -72129595)
2012,Octubre,Argentina,0,1,,1,POINT (125744111 -81703935)
2012,Octubre,Argentina,240,199,,439,POINT (125862 -81702165)
2012,Octubre,Argentina,35,68,,103,POINT (3451668 -76532004)
2012,Octubre,Argentina,2509,4122,,6631,POINT (4697157 -74140516)
2012,Octubre,Argentina,3,1,,4,POINT (4815189 -75736374)
2012,Octubre,Argentina,100,236,,336,POINT (6170465 -7542726)
2012,Octubre,Argentina,0,1,,1,POINT (6185536 -67484028)
2012,Octubre,Argentina,20,40,,60,POINT (7819 -72453013)
2012,Octubre,Argentina,0,1,,1,POINT (7927233 -72508188)
2012,Octubre,Argentina,6,7,,13,POINT (863337 -7735002)
2012,Octubre,República de Armenia,0,2,,2,POINT (4697157 -74140516)
2012,Octubre,Aruba,1,0,,1,POINT (3451668 -76532004)
2012,Octubre,Aruba,1,3,,4,POINT (4697157 -74140516)
2012,Octubre,Australia,3,5,,8,POINT (-4191162 -69941498)
2012,Octubre,Australia,22,41,,63,POINT (0.81488 -77356)
2012,Octubre,Australia,27,38,,65,POINT (10406342 -75527794)
2012,Octubre,Australia,14,22,,36,POINT (10446304 -75516486)
2012,Octubre,Australia,1,11,,12,POINT (10886686 -74776479)
2012,Octubre,Australia,3,3,,6,POINT (11247723 -74213989)
2012,Octubre,Australia,3,4,,7,POINT (11360029 -72129595)
2012,Octubre,Australia,14,21,,35,POINT (3451668 -76532004)
2012,Octubre,Australia,1,0,,1,POINT (445285 -75766353)
2012,Octubre,Australia,198,358,,556,POINT (4697157 -74140516)
2012,Octubre,Australia,0,1,,1,POINT (4815189 -75736374)
2012,Octubre,Australia,17,58,,75,POINT (6170465 -7542726)
2012,Octubre,Australia,1,6,,7,POINT (7819 -72453013)
2012,Octubre,Australia,1,2,,3,POINT (863337 -7735002)
2012,Octubre,Austria,0,2,,2,POINT (-4191162 -69941498)
2012,Octubre,Austria,4,1,,5,POINT (0.81488 -77356)
2012,Octubre,Austria,3,4,,7,POINT (10406342 -75527794)
2012,Octubre,Austria,3,5,,8,POINT (10446304 -75516486)
2012,Octubre,Austria,1,3,,4,POINT (10886686 -74776479)
2012,Octubre,Austria,0,1,,1,POINT (11360029 -72129595)
2012,Octubre,Austria,3,5,,8,POINT (3451668 -76532004)
2012,Octubre,Austria,80,178,,258,POINT (4697157 -74140516)
2012,Octubre,Austria,8,12,,20,POINT (6170465 -7542726)
2012,Octubre,Austria,0,1,,1,POINT (7819 -72453013)
2012,Octubre,Azerbaiyán,2,1,,3,POINT (4697157 -74140516)
2012,Octubre,Bahamas,1,0,,1,POINT (125862 -81702165)
2012,Octubre,Bahamas,1,1,,2,POINT (3451668 -76532004)
2012,Octubre,Bahamas,3,1,,4,POINT (4697157 -74140516)
2012,Octubre,Bangladesh,0,1,,1,POINT (0.81488 -77356)
2012,Octubre,Bangladesh,0,1,,1,POINT (10446304 -75516486)
2012,Octubre,Bangladesh,1,3,,4,POINT (4697157 -74140516)
2012,Octubre,Barbados,0,1,,1,POINT (10886686 -74776479)
2012,Octubre,Barbados,1,2,,3,POINT (3451668 -76532004)
2012,Octubre,Barbados,1,1,,2,POINT (4697157 -74140516)
2012,Octubre,Barbados,0,1,,1,POINT (6170465 -7542726)
2012,Octubre,República de Belarús,5,6,,11,POINT (4697157 -74140516)
2012,Octubre,Bélgica,1,2,,3,POINT (-4191162 -69941498)
2012,Octubre,Bélgica,1,6,,7,POINT (0.81488 -77356)
2012,Octubre,Bélgica,1,8,,9,POINT (10406342 -75527794)
2012,Octubre,Bélgica,4,5,,9,POINT (10446304 -75516486)
2012,Octubre,Bélgica,1,3,,4,POINT (10886686 -74776479)
2012,Octubre,Bélgica,0,13,,13,POINT (10970933 -74765343)
2012,Octubre,Bélgica,0,1,,1,POINT (11360029 -72129595)
2012,Octubre,Bélgica,6,26,,32,POINT (3451668 -76532004)
2012,Octubre,Bélgica,80,281,,361,POINT (4697157 -74140516)
2012,Octubre,Bélgica,8,8,,16,POINT (6170465 -7542726)
2012,Octubre,Bélgica,0,2,,2,POINT (863337 -7735002)
2012,Octubre,Belice,4,15,,19,POINT (4697157 -74140516)
2012,Octubre,Belice,1,3,,4,POINT (6170465 -7542726)
2012,Octubre,Benín,1,0,,1,POINT (4697157 -74140516)
2012,Octubre,Bermudas/Territorio Británico de Ultramar,0,1,,1,POINT (4697157 -74140516)
2012,Octubre,Bolivia,1,0,,1,POINT (-4191162 -69941498)
2012,Octubre,Bolivia,10,14,,24,POINT (0.81488 -77356)
2012,Octubre,Bolivia,5,5,,10,POINT (10446304 -75516486)
2012,Octubre,Bolivia,1,3,,4,POINT (10886686 -74776479)
2012,Octubre,Bolivia,0,3,,3,POINT (11360029 -72129595)
2012,Octubre,Bolivia,8,5,,13,POINT (125862 -81702165)
2012,Octubre,Bolivia,14,19,,33,POINT (3451668 -76532004)
2012,Octubre,Bolivia,284,465,,749,POINT (4697157 -74140516)
2012,Octubre,Bolivia,0,2,,2,POINT (4815189 -75736374)
2012,Octubre,Bolivia,17,26,,43,POINT (6170465 -7542726)
2012,Octubre,Bolivia,0,4,,4,POINT (7819 -72453013)
2012,Octubre,Bolivia,1,0,,1,POINT (863337 -7735002)
2012,Octubre,Bosnia y Herzegovina,1,1,,2,POINT (4697157 -74140516)
2012,Octubre,Brasil,67,67,,134,POINT (-4191162 -69941498)
2012,Octubre,Brasil,6,20,,26,POINT (0.81488 -77356)
2012,Octubre,Brasil,1,5,,6,POINT (10406342 -75527794)
2012,Octubre,Brasil,190,228,,418,POINT (10446304 -75516486)
2012,Octubre,Brasil,11,52,,63,POINT (10886686 -74776479)
2012,Octubre,Brasil,6,11,,17,POINT (11360029 -72129595)
2012,Octubre,Brasil,15,17,,32,POINT (125862 -81702165)
2012,Octubre,Brasil,27,63,,90,POINT (3451668 -76532004)
2012,Octubre,Brasil,2198,3858,,6056,POINT (4697157 -74140516)
2012,Octubre,Brasil,1,3,,4,POINT (4815189 -75736374)
2012,Octubre,Brasil,55,114,,169,POINT (6170465 -7542726)
2012,Octubre,Brasil,0,2,,2,POINT (6185536 -67484028)
2012,Octubre,Brasil,1,1,,2,POINT (7128047 -73181317)
2012,Octubre,Brasil,9,14,,23,POINT (7819 -72453013)
2012,Octubre,Brasil,0,3,,3,POINT (7927233 -72508188)
2012,Octubre,Brunei Darussalam,1,0,,1,POINT (0.81488 -77356)
2012,Octubre,Brunei Darussalam,3,2,,5,POINT (4697157 -74140516)
2012,Octubre,Bulgaria,1,0,,1,POINT (0.81488 -77356)
2012,Octubre,Bulgaria,0,1,,1,POINT (3451668 -76532004)
2012,Octubre,Bulgaria,6,9,,15,POINT (4697157 -74140516)
2012,Octubre,Bulgaria,0,2,,2,POINT (6170465 -7542726)
2012,Octubre,Cabo Verde,1,0,,1,POINT (10446304 -75516486)
2012,Octubre,Camboya,2,2,,4,POINT (4697157 -74140516)
2012,Octubre,Camerún,0,25,,25,POINT (4697157 -74140516)
2012,Octubre,Canadá,2,2,,4,POINT (-4191162 -69941498)
2012,Octubre,Canadá,12,9,,21,POINT (0.81488 -77356)
2012,Octubre,Canadá,9,16,,25,POINT (10406342 -75527794)
2012,Octubre,Canadá,25,92,,117,POINT (10446304 -75516486)
2012,Octubre,Canadá,8,16,,24,POINT (10886686 -74776479)
2012,Octubre,Canadá,2,2,,4,POINT (11360029 -72129595)
2012,Octubre,Canadá,0,1,,1,POINT (1152863 -72919186)
2012,Octubre,Canadá,2,2,,4,POINT (125862 -81702165)
2012,Octubre,Canadá,17,33,,50,POINT (3451668 -76532004)
2012,Octubre,Canadá,1,1,,2,POINT (445285 -75766353)
2012,Octubre,Canadá,570,1341,,1911,POINT (4697157 -74140516)
2012,Octubre,Canadá,1,0,,1,POINT (4815189 -75736374)
2012,Octubre,Canadá,43,159,,202,POINT (6170465 -7542726)
2012,Octubre,Canadá,0,1,,1,POINT (6222552 -77401154)
2012,Octubre,Canadá,1,1,,2,POINT (7088729 -70740253)
2012,Octubre,Canadá,0,4,,4,POINT (7128047 -73181317)
2012,Octubre,Canadá,1,3,,4,POINT (7819 -72453013)
2012,Octubre,Canadá,0,1,,1,POINT (7927233 -72508188)
2012,Octubre,Canadá,0,5,,5,POINT (863337 -7735002)
2012,Octubre,España,7,6,,13,POINT (0.81488 -77356)
2012,Octubre,España,0,1,,1,POINT (1800143 -78802679)
2012,Octubre,España,11,13,,24,POINT (10446304 -75516486)
2012,Octubre,España,1,8,,9,POINT (10886686 -74776479)
2012,Octubre,España,61,124,,185,POINT (3451668 -76532004)
2012,Octubre,España,1,0,,1,POINT (3884426 -77061029)
2012,Octubre,España,170,488,,658,POINT (4697157 -74140516)
2012,Octubre,España,0,3,,3,POINT (4815189 -75736374)
2012,Octubre,España,39,122,,161,POINT (6170465 -7542726)
2012,Octubre,España,1,7,,8,POINT (7819 -72453013)
2012,Octubre,España,1,0,,1,POINT (7927233 -72508188)
2012,Octubre,España,0,1,,1,POINT (863337 -7735002)
2012,Octubre,República Democrática del Congo,4,2,,6,POINT (4697157 -74140516)
2012,Octubre,República de Corea,0,1,,1,POINT (-4191162 -69941498)
2012,Octubre,República de Corea,2,3,,5,POINT (0.81488 -77356)
2012,Octubre,República de Corea,0,1,,1,POINT (10406342 -75527794)
2012,Octubre,República de Corea,2,4,,6,POINT (10446304 -75516486)
2012,Octubre,República de Corea,0,2,,2,POINT (10886686 -74776479)
2012,Octubre,República de Corea,0,6,,6,POINT (3451668 -76532004)
2012,Octubre,República de Corea,105,410,,515,POINT (4697157 -74140516)
2012,Octubre,República de Corea,3,17,,20,POINT (6170465 -7542726)
2012,Octubre,República de Corea,1,2,,3,POINT (7819 -72453013)
2012,Octubre,Costa de Marfil,2,3,,5,POINT (3451668 -76532004)
2012,Octubre,Costa de Marfil,1,1,,2,POINT (4697157 -74140516)
2012,Octubre,Costa de Marfil,0,1,,1,POINT (6170465 -7542726)
2012,Octubre,Costa Rica,1,1,,2,POINT (0.81488 -77356)
2012,Octubre,Costa Rica,37,44,,81,POINT (10446304 -75516486)
2012,Octubre,Costa Rica,7,14,,21,POINT (10886686 -74776479)
2012,Octubre,Costa Rica,0,3,,3,POINT (11360029 -72129595)
2012,Octubre,Costa Rica,239,208,,447,POINT (125862 -81702165)
2012,Octubre,Costa Rica,28,98,,126,POINT (3451668 -76532004)
2012,Octubre,Costa Rica,400,686,,1086,POINT (4697157 -74140516)
2012,Octubre,Costa Rica,3,7,,10,POINT (4815189 -75736374)
2012,Octubre,Costa Rica,93,161,,254,POINT (6170465 -7542726)
2012,Octubre,Costa Rica,3,0,,3,POINT (7128047 -73181317)
2012,Octubre,Costa Rica,2,1,,3,POINT (7819 -72453013)
2012,Octubre,Costa Rica,0,1,,1,POINT (7927233 -72508188)
2012,Octubre,Costa Rica,1,3,,4,POINT (863337 -7735002)
2012,Octubre,Croacia,0,1,,1,POINT (0.81488 -77356)
2012,Octubre,Croacia,0,4,,4,POINT (10406342 -75527794)
2012,Octubre,Croacia,0,3,,3,POINT (10970933 -74765343)
2012,Octubre,Croacia,0,1,,1,POINT (11360029 -72129595)
2012,Octubre,Croacia,8,25,,33,POINT (4697157 -74140516)
2012,Octubre,Croacia,0,1,,1,POINT (7819 -72453013)
2012,Octubre,Cuba,0,3,,3,POINT (0.81488 -77356)
2012,Octubre,Cuba,1,1,,2,POINT (10406342 -75527794)
2012,Octubre,Cuba,11,19,,30,POINT (10446304 -75516486)
2012,Octubre,Cuba,3,8,,11,POINT (10886686 -74776479)
2012,Octubre,Cuba,0,1,,1,POINT (11360029 -72129595)
2012,Octubre,Cuba,26,24,,50,POINT (3451668 -76532004)
2012,Octubre,Cuba,0,3,,3,POINT (445285 -75766353)
2012,Octubre,Cuba,98,175,,273,POINT (4697157 -74140516)
2012,Octubre,Cuba,4,3,,7,POINT (4815189 -75736374)
2012,Octubre,Cuba,18,15,,33,POINT (6170465 -7542726)
2012,Octubre,Cuba,0,2,,2,POINT (7128047 -73181317)
2012,Octubre,Cuba,0,2,,2,POINT (7819 -72453013)
2012,Octubre,Cuba,0,2,,2,POINT (7927233 -72508188)
2012,Octubre,Curazao,0,2,,2,POINT (4697157 -74140516)
2012,Octubre,Curazao,3,0,,3,POINT (6170465 -7542726)
2012,Octubre,República Checa,0,3,,3,POINT (0.81488 -77356)
2012,Octubre,República Checa,6,0,,6,POINT (10446304 -75516486)
2012,Octubre,República Checa,1,4,,5,POINT (3451668 -76532004)
2012,Octubre,República Checa,13,40,,53,POINT (4697157 -74140516)
2012,Octubre,República Checa,1,4,,5,POINT (6170465 -7542726)
2012,Octubre,Chile,0,3,,3,POINT (-4191162 -69941498)
2012,Octubre,Chile,0,1,,1,POINT (0.33002 -76876446)
2012,Octubre,Chile,19,38,,57,POINT (0.81488 -77356)
2012,Octubre,Chile,126,119,,245,POINT (10446304 -75516486)
2012,Octubre,Chile,4,12,,16,POINT (10886686 -74776479)
2012,Octubre,Chile,4,12,,16,POINT (11360029 -72129595)
2012,Octubre,Chile,123,70,,193,POINT (125862 -81702165)
2012,Octubre,Chile,23,58,,81,POINT (3451668 -76532004)
2012,Octubre,Chile,0,1,,1,POINT (3884426 -77061029)
2012,Octubre,Chile,2459,3741,,6200,POINT (4697157 -74140516)
2012,Octubre,Chile,2,2,,4,POINT (4815189 -75736374)
2012,Octubre,Chile,51,138,,189,POINT (6170465 -7542726)
2012,Octubre,Chile,7,12,,19,POINT (7819 -72453013)
2012,Octubre,Chile,1,0,,1,POINT (7927233 -72508188)
2012,Octubre,Chile,0,1,,1,POINT (863337 -7735002)
2012,Octubre,China,3,3,,6,POINT (0.81488 -77356)
2012,Octubre,China,0,3,,3,POINT (10406342 -75527794)
2012,Octubre,China,1,2,,3,POINT (10446304 -75516486)
2012,Octubre,China,4,6,,10,POINT (10886686 -74776479)
2012,Octubre,China,2,2,,4,POINT (11360029 -72129595)
2012,Octubre,China,3,6,,9,POINT (3451668 -76532004)
2012,Octubre,China,195,565,,760,POINT (4697157 -74140516)
2012,Octubre,China,6,10,,16,POINT (6170465 -7542726)
2012,Octubre,China,1,7,,8,POINT (7819 -72453013)
2012,Octubre,Taiwán,0,2,,2,POINT (0.81488 -77356)
2012,Octubre,Taiwán,0,1,,1,POINT (10886686 -74776479)
2012,Octubre,Taiwán,0,1,,1,POINT (10970933 -74765343)
2012,Octubre,Taiwán,1,0,,1,POINT (125862 -81702165)
2012,Octubre,Taiwán,1,2,,3,POINT (3451668 -76532004)
2012,Octubre,Taiwán,27,48,,75,POINT (4697157 -74140516)
2012,Octubre,Taiwán,5,13,,18,POINT (6170465 -7542726)
2012,Octubre,Taiwán,0,2,,2,POINT (7819 -72453013)
2012,Octubre,Chipre,2,2,,4,POINT (4697157 -74140516)
2012,Octubre,Chipre,0,2,,2,POINT (6170465 -7542726)
2012,Octubre,Dinamarca,2,5,,7,POINT (0.81488 -77356)
2012,Octubre,Dinamarca,1,1,,2,POINT (10406342 -75527794)
2012,Octubre,Dinamarca,2,3,,5,POINT (10446304 -75516486)
2012,Octubre,Dinamarca,0,1,,1,POINT (11360029 -72129595)
2012,Octubre,Dinamarca,0,6,,6,POINT (125744111 -81703935)
2012,Octubre,Dinamarca,0,7,,7,POINT (3451668 -76532004)
2012,Octubre,Dinamarca,58,105,,163,POINT (4697157 -74140516)
2012,Octubre,Dinamarca,5,11,,16,POINT (6170465 -7542726)
2012,Octubre,Dominica,1,0,,1,POINT (3451668 -76532004)
2012,Octubre,Dominica,1,3,,4,POINT (4697157 -74140516)
2012,Octubre,Ecuador,0,7,,7,POINT (-4191162 -69941498)
2012,Octubre,Ecuador,9,34,,43,POINT (0.33002 -76876446)
2012,Octubre,Ecuador,859,1397,,2256,POINT (0.81488 -77356)
2012,Octubre,Ecuador,5,164,,169,POINT (1800143 -78802679)
2012,Octubre,Ecuador,0,40,,40,POINT (10406342 -75527794)
2012,Octubre,Ecuador,21,43,,64,POINT (10446304 -75516486)
2012,Octubre,Ecuador,3,5,,8,POINT (10886686 -74776479)
2012,Octubre,Ecuador,6,18,,24,POINT (11360029 -72129595)
2012,Octubre,Ecuador,5,9,,14,POINT (125862 -81702165)
2012,Octubre,Ecuador,359,368,,727,POINT (3451668 -76532004)
2012,Octubre,Ecuador,1,0,,1,POINT (445285 -75766353)
2012,Octubre,Ecuador,1944,3353,,5297,POINT (4697157 -74140516)
2012,Octubre,Ecuador,2,4,,6,POINT (4815189 -75736374)
2012,Octubre,Ecuador,388,536,,924,POINT (6170465 -7542726)
2012,Octubre,Ecuador,0,1,,1,POINT (7088729 -70740253)
2012,Octubre,Ecuador,0,1,,1,POINT (7128047 -73181317)
2012,Octubre,Ecuador,79,126,,205,POINT (7819 -72453013)
2012,Octubre,Ecuador,1,2,,3,POINT (7927233 -72508188)
2012,Octubre,Egipto,1,0,,1,POINT (0.81488 -77356)
2012,Octubre,Egipto,0,1,,1,POINT (10446304 -75516486)
2012,Octubre,Egipto,1,1,,2,POINT (3451668 -76532004)
2012,Octubre,Egipto,4,13,,17,POINT (4697157 -74140516)
2012,Octubre,El Salvador,1,2,,3,POINT (0.81488 -77356)
2012,Octubre,El Salvador,13,18,,31,POINT (10446304 -75516486)
2012,Octubre,El Salvador,0,2,,2,POINT (10886686 -74776479)
2012,Octubre,El Salvador,0,6,,6,POINT (125744111 -81703935)
2012,Octubre,El Salvador,5,5,,10,POINT (125862 -81702165)
2012,Octubre,El Salvador,43,56,,99,POINT (3451668 -76532004)
2012,Octubre,El Salvador,396,645,,1041,POINT (4697157 -74140516)
2012,Octubre,El Salvador,0,1,,1,POINT (4815189 -75736374)
2012,Octubre,El Salvador,29,49,,78,POINT (6170465 -7542726)
2012,Octubre,Emiratos Árabes,0,1,,1,POINT (4697157 -74140516)
2012,Octubre,España,7,9,,16,POINT (-4191162 -69941498)
2012,Octubre,España,2,3,,5,POINT (0.33002 -76876446)
2012,Octubre,España,6,23,,29,POINT (0.81488 -77356)
2012,Octubre,España,2,7,,9,POINT (10406342 -75527794)
2012,Octubre,España,43,91,,134,POINT (10446304 -75516486)
2012,Octubre,España,1,14,,15,POINT (10886686 -74776479)
2012,Octubre,España,6,8,,14,POINT (11360029 -72129595)
2012,Octubre,España,0,1,,1,POINT (125744111 -81703935)
2012,Octubre,España,7,5,,12,POINT (125862 -81702165)
2012,Octubre,España,131,291,,422,POINT (3451668 -76532004)
2012,Octubre,España,1,2,,3,POINT (445285 -75766353)
2012,Octubre,España,1792,4612,,6404,POINT (4697157 -74140516)
2012,Octubre,España,0,8,,8,POINT (4815189 -75736374)
2012,Octubre,España,79,222,,301,POINT (6170465 -7542726)
2012,Octubre,España,0,3,,3,POINT (6185536 -67484028)
2012,Octubre,España,1,1,,2,POINT (7088729 -70740253)
2012,Octubre,España,9,23,,32,POINT (7819 -72453013)
2012,Octubre,España,4,5,,9,POINT (7927233 -72508188)
2012,Octubre,España,4,2,,6,POINT (863337 -7735002)
2012,Octubre,Eritrea,0,1,,1,POINT (4697157 -74140516)
2012,Octubre,Eslovaquia,0,1,,1,POINT (0.81488 -77356)
2012,Octubre,Eslovaquia,0,1,,1,POINT (11360029 -72129595)
2012,Octubre,Eslovaquia,1,1,,2,POINT (3451668 -76532004)
2012,Octubre,Eslovaquia,7,7,,14,POINT (4697157 -74140516)
2012,Octubre,Eslovaquia,2,0,,2,POINT (6170465 -7542726)
2012,Octubre,Eslovenia,1,0,,1,POINT (0.81488 -77356)
2012,Octubre,Eslovenia,0,2,,2,POINT (10406342 -75527794)
2012,Octubre,Eslovenia,1,0,,1,POINT (10446304 -75516486)
2012,Octubre,Eslovenia,7,1,,8,POINT (11360029 -72129595)
2012,Octubre,Eslovenia,6,17,,23,POINT (4697157 -74140516)
2012,Octubre,Eslovenia,1,1,,2,POINT (6170465 -7542726)
2012,Octubre,Eslovenia,0,1,,1,POINT (863337 -7735002)
2012,Octubre,Estados Unidos de América,11,15,,26,POINT (-4191162 -69941498)
2012,Octubre,Estados Unidos de América,37,54,,91,POINT (0.81488 -77356)
2012,Octubre,Estados Unidos de América,1,0,,1,POINT (1800143 -78802679)
2012,Octubre,Estados Unidos de América,20,34,,54,POINT (10406342 -75527794)
2012,Octubre,Estados Unidos de América,637,1508,,2145,POINT (10446304 -75516486)
2012,Octubre,Estados Unidos de América,237,421,,658,POINT (10886686 -74776479)
2012,Octubre,Estados Unidos de América,0,4,,4,POINT (11117206 -74232675)
2012,Octubre,Estados Unidos de América,3,6,,9,POINT (11247723 -74213989)
2012,Octubre,Estados Unidos de América,7,15,,22,POINT (11360029 -72129595)
2012,Octubre,Estados Unidos de América,0,1,,1,POINT (1152863 -72919186)
2012,Octubre,Estados Unidos de América,1,4,,5,POINT (125744111 -81703935)
2012,Octubre,Estados Unidos de América,3,10,,13,POINT (125862 -81702165)
2012,Octubre,Estados Unidos de América,7,6,,13,POINT (133387613 -81372937)
2012,Octubre,Estados Unidos de América,445,906,,1351,POINT (3451668 -76532004)
2012,Octubre,Estados Unidos de América,71,130,,201,POINT (445285 -75766353)
2012,Octubre,Estados Unidos de América,4338,10140,,14478,POINT (4697157 -74140516)
2012,Octubre,Estados Unidos de América,31,42,,73,POINT (4815189 -75736374)
2012,Octubre,Estados Unidos de América,661,2029,,2690,POINT (6170465 -7542726)
2012,Octubre,Estados Unidos de América,0,1,,1,POINT (6185536 -67484028)
2012,Octubre,Estados Unidos de América,1,4,,5,POINT (7088729 -70740253)
2012,Octubre,Estados Unidos de América,6,21,,27,POINT (7128047 -73181317)
2012,Octubre,Estados Unidos de América,14,38,,52,POINT (7819 -72453013)
2012,Octubre,Estados Unidos de América,3,8,,11,POINT (7927233 -72508188)
2012,Octubre,Estados Unidos de América,3,13,,16,POINT (863337 -7735002)
2012,Octubre,Estonia,7,9,,16,POINT (4697157 -74140516)
2012,Octubre,Estonia,1,3,,4,POINT (6170465 -7542726)
2012,Octubre,Estonia,0,1,,1,POINT (806667 -767333)
2012,Octubre,Estonia,0,1,,1,POINT (863337 -7735002)
2012,Octubre,Etiopia,0,1,,1,POINT (10446304 -75516486)
2012,Octubre,Etiopia,1,0,,1,POINT (10886686 -74776479)
2012,Octubre,Etiopia,1,0,,1,POINT (125862 -81702165)
2012,Octubre,Etiopia,1,1,,2,POINT (4697157 -74140516)
2012,Octubre,Filipinas,2,0,,2,POINT (0.81488 -77356)
2012,Octubre,Filipinas,0,1,,1,POINT (1800143 -78802679)
2012,Octubre,Filipinas,0,38,,38,POINT (10406342 -75527794)
2012,Octubre,Filipinas,0,24,,24,POINT (10446304 -75516486)
2012,Octubre,Filipinas,0,26,,26,POINT (10970933 -74765343)
2012,Octubre,Filipinas,0,6,,6,POINT (11247723 -74213989)
2012,Octubre,Filipinas,0,12,,12,POINT (3451668 -76532004)
2012,Octubre,Filipinas,0,6,,6,POINT (3884426 -77061029)
2012,Octubre,Filipinas,15,71,,86,POINT (4697157 -74140516)
2012,Octubre,Filipinas,5,3,,8,POINT (6170465 -7542726)
2012,Octubre,Filipinas,1,0,,1,POINT (7819 -72453013)
2012,Octubre,Filipinas,0,2,,2,POINT (7927233 -72508188)
2012,Octubre,Filipinas,0,3,,3,POINT (806667 -767333)
2012,Octubre,Filipinas,0,1,,1,POINT (9402597 -75681642)
2012,Octubre,Finlandia,1,1,,2,POINT (0.81488 -77356)
2012,Octubre,Finlandia,1,2,,3,POINT (10446304 -75516486)
2012,Octubre,Finlandia,47,87,,134,POINT (4697157 -74140516)
2012,Octubre,Finlandia,2,5,,7,POINT (6170465 -7542726)
2012,Octubre,Finlandia,0,1,,1,POINT (7819 -72453013)
2012,Octubre,Finlandia,0,1,,1,POINT (7927233 -72508188)
2012,Octubre,Francia,4,3,,7,POINT (-4191162 -69941498)
2012,Octubre,Francia,1,0,,1,POINT (0.33002 -76876446)
2012,Octubre,Francia,43,50,,93,POINT (0.81488 -77356)
2012,Octubre,Francia,0,1,,1,POINT (1800143 -78802679)
2012,Octubre,Francia,4,17,,21,POINT (10406342 -75527794)
2012,Octubre,Francia,11,38,,49,POINT (10446304 -75516486)
2012,Octubre,Francia,3,8,,11,POINT (10886686 -74776479)
2012,Octubre,Francia,1,1,,2,POINT (11247723 -74213989)
2012,Octubre,Francia,4,7,,11,POINT (11360029 -72129595)
2012,Octubre,Francia,1,2,,3,POINT (125862 -81702165)
2012,Octubre,Francia,2,3,,5,POINT (133387613 -81372937)
2012,Octubre,Francia,19,48,,67,POINT (3451668 -76532004)
2012,Octubre,Francia,898,1745,,2643,POINT (4697157 -74140516)
2012,Octubre,Francia,2,4,,6,POINT (4815189 -75736374)
2012,Octubre,Francia,40,80,,120,POINT (6170465 -7542726)
2012,Octubre,Francia,0,4,,4,POINT (6185536 -67484028)
2012,Octubre,Francia,8,15,,23,POINT (7819 -72453013)
2012,Octubre,Francia,3,7,,10,POINT (863337 -7735002)
2012,Octubre,Gabón,1,0,,1,POINT (3451668 -76532004)
2012,Octubre,Gabón,0,2,,2,POINT (4697157 -74140516)
2012,Octubre,Georgia,1,0,,1,POINT (4697157 -74140516)
2012,Octubre,Ghana,1,3,,4,POINT (4697157 -74140516)
2012,Octubre,Granada,0,1,,1,POINT (6170465 -7542726)
2012,Octubre,Grecia,1,5,,6,POINT (10406342 -75527794)
2012,Octubre,Grecia,2,2,,4,POINT (10446304 -75516486)
2012,Octubre,Grecia,0,1,,1,POINT (10970933 -74765343)
2012,Octubre,Grecia,0,2,,2,POINT (11360029 -72129595)
2012,Octubre,Grecia,0,2,,2,POINT (3451668 -76532004)
2012,Octubre,Grecia,11,50,,61,POINT (4697157 -74140516)
2012,Octubre,Grecia,0,2,,2,POINT (6170465 -7542726)
2012,Octubre,Grecia,0,1,,1,POINT (7819 -72453013)
2012,Octubre,Grecia,0,1,,1,POINT (7927233 -72508188)
2012,Octubre,Grecia,0,2,,2,POINT (806667 -767333)
2012,Octubre,Grecia,0,1,,1,POINT (863337 -7735002)
2012,Octubre,Guatemala,5,5,,10,POINT (-4191162 -69941498)
2012,Octubre,Guatemala,0,3,,3,POINT (10406342 -75527794)
2012,Octubre,Guatemala,41,62,,103,POINT (10446304 -75516486)
2012,Octubre,Guatemala,2,6,,8,POINT (10886686 -74776479)
2012,Octubre,Guatemala,0,1,,1,POINT (11360029 -72129595)
2012,Octubre,Guatemala,4,3,,7,POINT (125862 -81702165)
2012,Octubre,Guatemala,22,48,,70,POINT (3451668 -76532004)
2012,Octubre,Guatemala,168,412,,580,POINT (4697157 -74140516)
2012,Octubre,Guatemala,4,2,,6,POINT (4815189 -75736374)
2012,Octubre,Guatemala,53,73,,126,POINT (6170465 -7542726)
2012,Octubre,Guatemala,8,12,,20,POINT (7819 -72453013)
2012,Octubre,Guatemala,2,1,,3,POINT (7927233 -72508188)
2012,Octubre,Guatemala,0,2,,2,POINT (863337 -7735002)
2012,Octubre,Guyana,0,3,,3,POINT (10886686 -74776479)
2012,Octubre,Guyana,0,1,,1,POINT (3451668 -76532004)
2012,Octubre,Guyana,4,7,,11,POINT (4697157 -74140516)
2012,Octubre,Guyana,2,3,,5,POINT (6170465 -7542726)
2012,Octubre,Guayana Francesa/Departamento de Ultramar Francés,0,1,,1,POINT (10886686 -74776479)
2012,Octubre,Haití,2,1,,3,POINT (10446304 -75516486)
2012,Octubre,Haití,0,1,,1,POINT (10886686 -74776479)
2012,Octubre,Haití,0,4,,4,POINT (3451668 -76532004)
2012,Octubre,Haití,4,68,,72,POINT (4697157 -74140516)
2012,Octubre,Haití,0,2,,2,POINT (6170465 -7542726)
2012,Octubre,Honduras,1,2,,3,POINT (0.81488 -77356)
2012,Octubre,Honduras,7,15,,22,POINT (10446304 -75516486)
2012,Octubre,Honduras,4,3,,7,POINT (10886686 -74776479)
2012,Octubre,Honduras,1,22,,23,POINT (125744111 -81703935)
2012,Octubre,Honduras,5,7,,12,POINT (125862 -81702165)
2012,Octubre,Honduras,12,21,,33,POINT (3451668 -76532004)
2012,Octubre,Honduras,117,206,,323,POINT (4697157 -74140516)
2012,Octubre,Honduras,1,2,,3,POINT (4815189 -75736374)
2012,Octubre,Honduras,26,38,,64,POINT (6170465 -7542726)
2012,Octubre,Honduras,0,2,,2,POINT (7128047 -73181317)
2012,Octubre,Honduras,0,1,,1,POINT (7927233 -72508188)
2012,Octubre,Honduras,0,1,,1,POINT (806667 -767333)
2012,Octubre,Hong Kong,0,1,,1,POINT (4697157 -74140516)
2012,Octubre,Hungría,0,2,,2,POINT (10446304 -75516486)
2012,Octubre,Hungría,1,1,,2,POINT (3451668 -76532004)
2012,Octubre,Hungría,11,22,,33,POINT (4697157 -74140516)
2012,Octubre,Hungría,0,1,,1,POINT (6170465 -7542726)
2012,Octubre,Hungría,1,1,,2,POINT (7819 -72453013)
2012,Octubre,India,0,2,,2,POINT (10406342 -75527794)
2012,Octubre,India,3,8,,11,POINT (10446304 -75516486)
2012,Octubre,India,0,1,,1,POINT (10886686 -74776479)
2012,Octubre,India,1,11,,12,POINT (3451668 -76532004)
2012,Octubre,India,29,242,,271,POINT (4697157 -74140516)
2012,Octubre,India,4,25,,29,POINT (6170465 -7542726)
2012,Octubre,Indonesia,1,1,,2,POINT (0.81488 -77356)
2012,Octubre,Indonesia,0,1,,1,POINT (10406342 -75527794)
2012,Octubre,Indonesia,7,25,,32,POINT (4697157 -74140516)
2012,Octubre,Indonesia,1,0,,1,POINT (6170465 -7542726)
2012,Octubre,Iraq,7,5,,12,POINT (4697157 -74140516)
2012,Octubre,Irán,0,2,,2,POINT (10446304 -75516486)
2012,Octubre,Irán,6,12,,18,POINT (4697157 -74140516)
2012,Octubre,República de Irlanda,10,9,,19,POINT (0.81488 -77356)
2012,Octubre,República de Irlanda,1,6,,7,POINT (10406342 -75527794)
2012,Octubre,República de Irlanda,2,10,,12,POINT (10446304 -75516486)
2012,Octubre,República de Irlanda,0,1,,1,POINT (10886686 -74776479)
2012,Octubre,República de Irlanda,0,6,,6,POINT (11360029 -72129595)
2012,Octubre,República de Irlanda,0,2,,2,POINT (3451668 -76532004)
2012,Octubre,República de Irlanda,42,97,,139,POINT (4697157 -74140516)
2012,Octubre,República de Irlanda,3,8,,11,POINT (6170465 -7542726)
2012,Octubre,República de Irlanda,1,0,,1,POINT (863337 -7735002)
2012,Octubre,Islandia,0,4,,4,POINT (-4191162 -69941498)
2012,Octubre,Islandia,0,1,,1,POINT (10446304 -75516486)
2012,Octubre,Islandia,0,1,,1,POINT (3451668 -76532004)
2012,Octubre,Islandia,6,9,,15,POINT (4697157 -74140516)
2012,Octubre,Isla de Man,9,13,,22,POINT (0.81488 -77356)
2012,Octubre,Isla de Man,3,14,,17,POINT (10446304 -75516486)
2012,Octubre,Isla de Man,2,4,,6,POINT (10886686 -74776479)
2012,Octubre,Isla de Man,5,14,,19,POINT (3451668 -76532004)
2012,Octubre,Isla de Man,35,95,,130,POINT (4697157 -74140516)
2012,Octubre,Isla de Man,0,1,,1,POINT (4815189 -75736374)
2012,Octubre,Isla de Man,14,34,,48,POINT (6170465 -7542726)
2012,Octubre,Isla de Man,0,1,,1,POINT (7819 -72453013)
2012,Octubre,Isla de Man,0,1,,1,POINT (863337 -7735002)
2012,Octubre,Isla Johnston,0,2,,2,POINT (4697157 -74140516)
2012,Octubre,Israel,1,3,,4,POINT (-4191162 -69941498)
2012,Octubre,Israel,5,11,,16,POINT (0.81488 -77356)
2012,Octubre,Israel,1,3,,4,POINT (10406342 -75527794)
2012,Octubre,Israel,4,21,,25,POINT (10446304 -75516486)
2012,Octubre,Israel,0,3,,3,POINT (10886686 -74776479)
2012,Octubre,Israel,4,18,,22,POINT (3451668 -76532004)
2012,Octubre,Israel,1,0,,1,POINT (445285 -75766353)
2012,Octubre,Israel,75,417,,492,POINT (4697157 -74140516)
2012,Octubre,Israel,7,40,,47,POINT (6170465 -7542726)
2012,Octubre,Israel,0,1,,1,POINT (7819 -72453013)
2012,Octubre,Israel,0,1,,1,POINT (7927233 -72508188)
2012,Octubre,Israel,2,6,,8,POINT (863337 -7735002)
2012,Octubre,Islas Aland/Provincia de Finlandia,0,2,,2,POINT (4697157 -74140516)
2012,Octubre,Italia,0,1,,1,POINT (-4191162 -69941498)
2012,Octubre,Italia,3,18,,21,POINT (0.81488 -77356)
2012,Octubre,Italia,2,9,,11,POINT (10406342 -75527794)
2012,Octubre,Italia,31,64,,95,POINT (10446304 -75516486)
2012,Octubre,Italia,1,13,,14,POINT (10886686 -74776479)
2012,Octubre,Italia,0,2,,2,POINT (10970933 -74765343)
2012,Octubre,Italia,0,1,,1,POINT (11247723 -74213989)
2012,Octubre,Italia,1,7,,8,POINT (11360029 -72129595)
2012,Octubre,Italia,7,8,,15,POINT (125862 -81702165)
2012,Octubre,Italia,21,84,,105,POINT (3451668 -76532004)
2012,Octubre,Italia,402,1513,,1915,POINT (4697157 -74140516)
2012,Octubre,Italia,0,2,,2,POINT (4815189 -75736374)
2012,Octubre,Italia,13,96,,109,POINT (6170465 -7542726)
2012,Octubre,Italia,0,3,,3,POINT (6185536 -67484028)
2012,Octubre,Italia,0,3,,3,POINT (7128047 -73181317)
2012,Octubre,Italia,3,18,,21,POINT (7819 -72453013)
2012,Octubre,Italia,0,4,,4,POINT (7927233 -72508188)
2012,Octubre,Italia,0,5,,5,POINT (863337 -7735002)
2012,Octubre,Islas del Canal,0,1,,1,POINT (4697157 -74140516)
2012,Octubre,Jamaica,2,6,,8,POINT (10446304 -75516486)
2012,Octubre,Jamaica,0,3,,3,POINT (10886686 -74776479)
2012,Octubre,Jamaica,0,1,,1,POINT (11360029 -72129595)
2012,Octubre,Jamaica,1,4,,5,POINT (125862 -81702165)
2012,Octubre,Jamaica,1,3,,4,POINT (3451668 -76532004)
2012,Octubre,Jamaica,10,19,,29,POINT (4697157 -74140516)
2012,Octubre,Jamaica,3,1,,4,POINT (6170465 -7542726)
2012,Octubre,Jamaica,1,0,,1,POINT (7128047 -73181317)
2012,Octubre,Jamaica,0,2,,2,POINT (7819 -72453013)
2012,Octubre,Japón,0,2,,2,POINT (-4191162 -69941498)
2012,Octubre,Japón,2,9,,11,POINT (0.81488 -77356)
2012,Octubre,Japón,4,4,,8,POINT (10406342 -75527794)
2012,Octubre,Japón,2,12,,14,POINT (10446304 -75516486)
2012,Octubre,Japón,1,10,,11,POINT (10886686 -74776479)
2012,Octubre,Japón,0,1,,1,POINT (125862 -81702165)
2012,Octubre,Japón,9,33,,42,POINT (3451668 -76532004)
2012,Octubre,Japón,77,429,,506,POINT (4697157 -74140516)
2012,Octubre,Japón,3,22,,25,POINT (6170465 -7542726)
2012,Octubre,Japón,3,5,,8,POINT (7819 -72453013)
2012,Octubre,Japón,0,1,,1,POINT (7927233 -72508188)
2012,Octubre,Jordania,0,1,,1,POINT (3451668 -76532004)
2012,Octubre,Jordania,1,5,,6,POINT (4697157 -74140516)
2012,Octubre,Jordania,0,1,,1,POINT (7819 -72453013)
2012,Octubre,Kazajistán,0,6,,6,POINT (3451668 -76532004)
2012,Octubre,Kenia,0,1,,1,POINT (10446304 -75516486)
2012,Octubre,Kenia,4,17,,21,POINT (4697157 -74140516)
2012,Octubre,Kenia,1,0,,1,POINT (6170465 -7542726)
2012,Octubre,Kirguistán,1,1,,2,POINT (4697157 -74140516)
2012,Octubre,Letonia,0,2,,2,POINT (10406342 -75527794)
2012,Octubre,Letonia,0,1,,1,POINT (10970933 -74765343)
2012,Octubre,Letonia,2,6,,8,POINT (4697157 -74140516)
2012,Octubre,Letonia,0,3,,3,POINT (6170465 -7542726)
2012,Octubre,Lituania,1,0,,1,POINT (0.81488 -77356)
2012,Octubre,Lituania,0,2,,2,POINT (10406342 -75527794)
2012,Octubre,Lituania,1,0,,1,POINT (3451668 -76532004)
2012,Octubre,Lituania,8,13,,21,POINT (4697157 -74140516)
2012,Octubre,Lituania,1,0,,1,POINT (6170465 -7542726)
2012,Octubre,Líbano,0,3,,3,POINT (0.81488 -77356)
2012,Octubre,Líbano,1,0,,1,POINT (10446304 -75516486)
2012,Octubre,Líbano,1,6,,7,POINT (10886686 -74776479)
2012,Octubre,Líbano,1,8,,9,POINT (11360029 -72129595)
2012,Octubre,Líbano,0,2,,2,POINT (3451668 -76532004)
2012,Octubre,Líbano,18,25,,43,POINT (4697157 -74140516)
2012,Octubre,Libia,0,1,,1,POINT (4697157 -74140516)
2012,Octubre,Liechtenstein,0,1,,1,POINT (4697157 -74140516)
2012,Octubre,Liechtenstein,0,1,,1,POINT (6170465 -7542726)
2012,Octubre,Luxemburgo,2,13,,15,POINT (4697157 -74140516)
2012,Octubre,Luxemburgo,1,0,,1,POINT (6170465 -7542726)
2012,Octubre,Macedonia,0,1,,1,POINT (4697157 -74140516)
2012,Octubre,Madagascar,1,2,,3,POINT (4697157 -74140516)
2012,Octubre,Malasia,1,3,,4,POINT (10446304 -75516486)
2012,Octubre,Malasia,1,2,,3,POINT (3451668 -76532004)
2012,Octubre,Malasia,10,15,,25,POINT (4697157 -74140516)
2012,Octubre,Malasia,3,0,,3,POINT (6170465 -7542726)
2012,Octubre,Malawi,0,1,,1,POINT (4697157 -74140516)
2012,Octubre,Malí,0,1,,1,POINT (4697157 -74140516)
2012,Octubre,Malta,1,0,,1,POINT (4697157 -74140516)
2012,Octubre,Malta,1,0,,1,POINT (7819 -72453013)
2012,Octubre,Marruecos,3,7,,10,POINT (4697157 -74140516)
2012,Octubre,Mauricio,1,0,,1,POINT (0.81488 -77356)
2012,Octubre,Mauricio,0,1,,1,POINT (4697157 -74140516)
2012,Octubre,México,0,1,,1,POINT (0.33002 -76876446)
2012,Octubre,México,10,21,,31,POINT (0.81488 -77356)
2012,Octubre,México,2,4,,6,POINT (10406342 -75527794)
2012,Octubre,México,142,250,,392,POINT (10446304 -75516486)
2012,Octubre,México,18,59,,77,POINT (10886686 -74776479)
2012,Octubre,México,1,2,,3,POINT (11360029 -72129595)
2012,Octubre,México,4,2,,6,POINT (125862 -81702165)
2012,Octubre,México,63,172,,235,POINT (3451668 -76532004)
2012,Octubre,México,1980,4630,,6610,POINT (4697157 -74140516)
2012,Octubre,México,4,17,,21,POINT (4815189 -75736374)
2012,Octubre,México,126,343,,469,POINT (6170465 -7542726)
2012,Octubre,México,1,1,,2,POINT (6185536 -67484028)
2012,Octubre,México,3,8,,11,POINT (7128047 -73181317)
2012,Octubre,México,6,22,,28,POINT (7819 -72453013)
2012,Octubre,México,2,4,,6,POINT (7927233 -72508188)
2012,Octubre,México,2,4,,6,POINT (863337 -7735002)
2012,Octubre,República de Moldavia,3,1,,4,POINT (4697157 -74140516)
2012,Octubre,Mongolia,0,1,,1,POINT (3451668 -76532004)
2012,Octubre,Mongolia,1,0,,1,POINT (4697157 -74140516)
2012,Octubre,Mongolia,1,0,,1,POINT (6170465 -7542726)
2012,Octubre,Myanmar,0,1,,1,POINT (4697157 -74140516)
2012,Octubre,Namibia,1,4,,5,POINT (4697157 -74140516)
2012,Octubre,Nepal,1,1,,2,POINT (4697157 -74140516)
2012,Octubre,Nicaragua,1,0,,1,POINT (0.81488 -77356)
2012,Octubre,Nicaragua,13,5,,18,POINT (10446304 -75516486)
2012,Octubre,Nicaragua,0,2,,2,POINT (10886686 -74776479)
2012,Octubre,Nicaragua,7,3,,10,POINT (125862 -81702165)
2012,Octubre,Nicaragua,7,18,,25,POINT (3451668 -76532004)
2012,Octubre,Nicaragua,0,1,,1,POINT (445285 -75766353)
2012,Octubre,Nicaragua,68,78,,146,POINT (4697157 -74140516)
2012,Octubre,Nicaragua,0,2,,2,POINT (4815189 -75736374)
2012,Octubre,Nicaragua,10,15,,25,POINT (6170465 -7542726)
2012,Octubre,Nicaragua,0,1,,1,POINT (7128047 -73181317)
2012,Octubre,Nigeria,1,1,,2,POINT (10446304 -75516486)
2012,Octubre,Nigeria,0,1,,1,POINT (3451668 -76532004)
2012,Octubre,Nigeria,2,6,,8,POINT (4697157 -74140516)
2012,Octubre,Noruega,2,3,,5,POINT (0.81488 -77356)
2012,Octubre,Noruega,0,4,,4,POINT (10406342 -75527794)
2012,Octubre,Noruega,0,5,,5,POINT (10446304 -75516486)
2012,Octubre,Noruega,0,3,,3,POINT (10886686 -74776479)
2012,Octubre,Noruega,2,5,,7,POINT (3451668 -76532004)
2012,Octubre,Noruega,50,103,,153,POINT (4697157 -74140516)
2012,Octubre,Noruega,1,9,,10,POINT (6170465 -7542726)
2012,Octubre,Noruega,0,2,,2,POINT (7128047 -73181317)
2012,Octubre,Nueva Zelanda,1,3,,4,POINT (-4191162 -69941498)
2012,Octubre,Nueva Zelanda,6,16,,22,POINT (0.81488 -77356)
2012,Octubre,Nueva Zelanda,4,4,,8,POINT (10446304 -75516486)
2012,Octubre,Nueva Zelanda,0,2,,2,POINT (10886686 -74776479)
2012,Octubre,Nueva Zelanda,2,3,,5,POINT (3451668 -76532004)
2012,Octubre,Nueva Zelanda,39,61,,100,POINT (4697157 -74140516)
2012,Octubre,Nueva Zelanda,0,1,,1,POINT (4815189 -75736374)
2012,Octubre,Nueva Zelanda,9,10,,19,POINT (6170465 -7542726)
2012,Octubre,Nueva Zelanda,0,1,,1,POINT (7819 -72453013)
2012,Octubre,Nueva Zelanda,0,1,,1,POINT (-4191162 -69941498)
2012,Octubre,Nueva Zelanda,1,0,,1,POINT (0.81488 -77356)
2012,Octubre,Nueva Zelanda,2,3,,5,POINT (10406342 -75527794)
2012,Octubre,Nueva Zelanda,0,2,,2,POINT (10446304 -75516486)
2012,Octubre,Nueva Zelanda,2,2,,4,POINT (4697157 -74140516)
2012,Octubre,Nueva Zelanda,1,1,,2,POINT (6170465 -7542726)
2012,Octubre,Países Bajos,1,2,,3,POINT (0.81488 -77356)
2012,Octubre,Países Bajos,6,4,,10,POINT (10446304 -75516486)
2012,Octubre,Países Bajos,4,7,,11,POINT (10886686 -74776479)
2012,Octubre,Países Bajos,20,26,,46,POINT (1152863 -72919186)
2012,Octubre,Países Bajos,5,25,,30,POINT (3451668 -76532004)
2012,Octubre,Países Bajos,4,12,,16,POINT (445285 -75766353)
2012,Octubre,Países Bajos,132,251,,383,POINT (4697157 -74140516)
2012,Octubre,Países Bajos,1,2,,3,POINT (4815189 -75736374)
2012,Octubre,Países Bajos,188,194,,382,POINT (6170465 -7542726)
2012,Octubre,Países Bajos,9,6,,15,POINT (7128047 -73181317)
2012,Octubre,Pakistán,0,1,,1,POINT (0.81488 -77356)
2012,Octubre,Pakistán,0,1,,1,POINT (10446304 -75516486)
2012,Octubre,Pakistán,1,10,,11,POINT (4697157 -74140516)
2012,Octubre,Pakistán,0,1,,1,POINT (7819 -72453013)
2012,Octubre,Panamá,2,0,,2,POINT (0.81488 -77356)
2012,Octubre,Panamá,0,9,,9,POINT (10406342 -75527794)
2012,Octubre,Panamá,126,173,,299,POINT (10446304 -75516486)
2012,Octubre,Panamá,40,98,,138,POINT (10886686 -74776479)
2012,Octubre,Panamá,0,1,,1,POINT (11360029 -72129595)
2012,Octubre,Panamá,23,24,,47,POINT (125862 -81702165)
2012,Octubre,Panamá,93,136,,229,POINT (3451668 -76532004)
2012,Octubre,Panamá,0,2,,2,POINT (3884426 -77061029)
2012,Octubre,Panamá,432,748,,1180,POINT (4697157 -74140516)
2012,Octubre,Panamá,46,81,,127,POINT (4815189 -75736374)
2012,Octubre,Panamá,179,313,,492,POINT (6170465 -7542726)
2012,Octubre,Panamá,2,2,,4,POINT (6222552 -77401154)
2012,Octubre,Panamá,0,1,,1,POINT (7088729 -70740253)
2012,Octubre,Panamá,6,5,,11,POINT (7128047 -73181317)
2012,Octubre,Panamá,1,10,,11,POINT (7819 -72453013)
2012,Octubre,Panamá,5,6,,11,POINT (7927233 -72508188)
2012,Octubre,Panamá,2,5,,7,POINT (863337 -7735002)
2012,Octubre,Paraguay,0,1,,1,POINT (0.33002 -76876446)
2012,Octubre,Paraguay,2,3,,5,POINT (0.81488 -77356)
2012,Octubre,Paraguay,73,83,,156,POINT (10446304 -75516486)
2012,Octubre,Paraguay,20,105,,125,POINT (10886686 -74776479)
2012,Octubre,Paraguay,1,1,,2,POINT (11360029 -72129595)
2012,Octubre,Paraguay,1,0,,1,POINT (125862 -81702165)
2012,Octubre,Paraguay,14,9,,23,POINT (3451668 -76532004)
2012,Octubre,Paraguay,89,119,,208,POINT (4697157 -74140516)
2012,Octubre,Paraguay,0,1,,1,POINT (4815189 -75736374)
2012,Octubre,Paraguay,24,24,,48,POINT (6170465 -7542726)
2012,Octubre,Paraguay,3,3,,6,POINT (7128047 -73181317)
2012,Octubre,Paraguay,1,2,,3,POINT (7819 -72453013)
2012,Octubre,Perú,30,43,,73,POINT (-4191162 -69941498)
2012,Octubre,Perú,1,2,,3,POINT (0.33002 -76876446)
2012,Octubre,Perú,93,281,,374,POINT (0.81488 -77356)
2012,Octubre,Perú,1,0,,1,POINT (1800143 -78802679)
2012,Octubre,Perú,0,1,,1,POINT (10406342 -75527794)
2012,Octubre,Perú,165,167,,332,POINT (10446304 -75516486)
2012,Octubre,Perú,26,41,,67,POINT (10886686 -74776479)
2012,Octubre,Perú,6,18,,24,POINT (11360029 -72129595)
2012,Octubre,Perú,255,145,,400,POINT (125862 -81702165)
2012,Octubre,Perú,147,203,,350,POINT (3451668 -76532004)
2012,Octubre,Perú,2,0,,2,POINT (445285 -75766353)
2012,Octubre,Perú,2412,3414,,5826,POINT (4697157 -74140516)
2012,Octubre,Perú,1,1,,2,POINT (4815189 -75736374)
2012,Octubre,Perú,157,372,,529,POINT (6170465 -7542726)
2012,Octubre,Perú,1,0,,1,POINT (6185536 -67484028)
2012,Octubre,Perú,1,2,,3,POINT (7128047 -73181317)
2012,Octubre,Perú,18,42,,60,POINT (7819 -72453013)
2012,Octubre,Perú,0,2,,2,POINT (7927233 -72508188)
2012,Octubre,Perú,0,1,,1,POINT (863337 -7735002)
2012,Octubre,Palestina,2,4,,6,POINT (4697157 -74140516)
2012,Octubre,Polonia,14,11,,25,POINT (0.81488 -77356)
2012,Octubre,Polonia,0,10,,10,POINT (10406342 -75527794)
2012,Octubre,Polonia,2,1,,3,POINT (10446304 -75516486)
2012,Octubre,Polonia,1,1,,2,POINT (10886686 -74776479)
2012,Octubre,Polonia,0,1,,1,POINT (10970933 -74765343)
2012,Octubre,Polonia,0,1,,1,POINT (11247723 -74213989)
2012,Octubre,Polonia,2,2,,4,POINT (11360029 -72129595)
2012,Octubre,Polonia,4,1,,5,POINT (3451668 -76532004)
2012,Octubre,Polonia,58,93,,151,POINT (4697157 -74140516)
2012,Octubre,Polonia,2,16,,18,POINT (6170465 -7542726)
2012,Octubre,Polonia,1,1,,2,POINT (863337 -7735002)
2012,Octubre,Polonia,0,1,,1,POINT (9402597 -75681642)
2012,Octubre,Portugal,0,1,,1,POINT (-4191162 -69941498)
2012,Octubre,Portugal,1,2,,3,POINT (0.81488 -77356)
2012,Octubre,Portugal,0,2,,2,POINT (10406342 -75527794)
2012,Octubre,Portugal,3,7,,10,POINT (10446304 -75516486)
2012,Octubre,Portugal,1,1,,2,POINT (10886686 -74776479)
2012,Octubre,Portugal,0,4,,4,POINT (11360029 -72129595)
2012,Octubre,Portugal,4,18,,22,POINT (3451668 -76532004)
2012,Octubre,Portugal,0,1,,1,POINT (445285 -75766353)
2012,Octubre,Portugal,96,297,,393,POINT (4697157 -74140516)
2012,Octubre,Portugal,7,25,,32,POINT (6170465 -7542726)
2012,Octubre,Portugal,3,3,,6,POINT (7819 -72453013)
2012,Octubre,Portugal,1,1,,2,POINT (7927233 -72508188)
2012,Octubre,Puerto Rico/Territorio de Estados Unidos,0,4,,4,POINT (10446304 -75516486)
2012,Octubre,Puerto Rico/Territorio de Estados Unidos,0,1,,1,POINT (4697157 -74140516)
2012,Octubre,Puerto Rico/Territorio de Estados Unidos,1,0,,1,POINT (6170465 -7542726)
2012,Octubre,Reino Unido de Gran Bretaña e Irlanda del Norte,0,2,,2,POINT (-4191162 -69941498)
2012,Octubre,Reino Unido de Gran Bretaña e Irlanda del Norte,0,7,,7,POINT (0.81488 -77356)
2012,Octubre,Reino Unido de Gran Bretaña e Irlanda del Norte,0,1,,1,POINT (10406342 -75527794)
2012,Octubre,Reino Unido de Gran Bretaña e Irlanda del Norte,21,33,,54,POINT (10446304 -75516486)
2012,Octubre,Reino Unido de Gran Bretaña e Irlanda del Norte,1,1,,2,POINT (10886686 -74776479)
2012,Octubre,Reino Unido de Gran Bretaña e Irlanda del Norte,2,2,,4,POINT (11360029 -72129595)
2012,Octubre,Reino Unido de Gran Bretaña e Irlanda del Norte,0,1,,1,POINT (125862 -81702165)
2012,Octubre,Reino Unido de Gran Bretaña e Irlanda del Norte,6,16,,22,POINT (3451668 -76532004)
2012,Octubre,Reino Unido de Gran Bretaña e Irlanda del Norte,0,1,,1,POINT (445285 -75766353)
2012,Octubre,Reino Unido de Gran Bretaña e Irlanda del Norte,196,581,,777,POINT (4697157 -74140516)
2012,Octubre,Reino Unido de Gran Bretaña e Irlanda del Norte,12,30,,42,POINT (6170465 -7542726)
2012,Octubre,Reino Unido de Gran Bretaña e Irlanda del Norte,0,3,,3,POINT (7819 -72453013)
2012,Octubre,República de Belarús,4,7,,11,POINT (4697157 -74140516)
2012,Octubre,República Dominicana,2,6,,8,POINT (0.81488 -77356)
2012,Octubre,República Dominicana,26,41,,67,POINT (10446304 -75516486)
2012,Octubre,República Dominicana,11,22,,33,POINT (10886686 -74776479)
2012,Octubre,República Dominicana,3,3,,6,POINT (11360029 -72129595)
2012,Octubre,República Dominicana,0,1,,1,POINT (125862 -81702165)
2012,Octubre,República Dominicana,31,37,,68,POINT (3451668 -76532004)
2012,Octubre,República Dominicana,0,1,,1,POINT (445285 -75766353)
2012,Octubre,República Dominicana,211,312,,523,POINT (4697157 -74140516)
2012,Octubre,República Dominicana,3,0,,3,POINT (4815189 -75736374)
2012,Octubre,República Dominicana,32,55,,87,POINT (6170465 -7542726)
2012,Octubre,República Dominicana,2,4,,6,POINT (7128047 -73181317)
2012,Octubre,República Dominicana,1,2,,3,POINT (7819 -72453013)
2012,Octubre,República Dominicana,13,26,,39,POINT (7927233 -72508188)
2012,Octubre,República Checa,2,1,,3,POINT (0.81488 -77356)
2012,Octubre,República Checa,0,1,,1,POINT (10446304 -75516486)
2012,Octubre,República Checa,0,1,,1,POINT (4697157 -74140516)
2012,Octubre,Rumania,0,2,,2,POINT (10406342 -75527794)
2012,Octubre,Rumania,4,2,,6,POINT (10446304 -75516486)
2012,Octubre,Rumania,0,2,,2,POINT (11247723 -74213989)
2012,Octubre,Rumania,3,3,,6,POINT (3451668 -76532004)
2012,Octubre,Rumania,32,51,,83,POINT (4697157 -74140516)
2012,Octubre,Rumania,0,6,,6,POINT (6170465 -7542726)
2012,Octubre,Rumania,0,1,,1,POINT (7819 -72453013)
2012,Octubre,Federación de Rusia,2,5,,7,POINT (0.81488 -77356)
2012,Octubre,Federación de Rusia,2,20,,22,POINT (10406342 -75527794)
2012,Octubre,Federación de Rusia,3,18,,21,POINT (10446304 -75516486)
2012,Octubre,Federación de Rusia,2,1,,3,POINT (3451668 -76532004)
2012,Octubre,Federación de Rusia,42,63,,105,POINT (4697157 -74140516)
2012,Octubre,Federación de Rusia,1,0,,1,POINT (4815189 -75736374)
2012,Octubre,Federación de Rusia,1,1,,2,POINT (6170465 -7542726)
2012,Octubre,Federación de Rusia,1,0,,1,POINT (7128047 -73181317)
2012,Octubre,Rwanda,0,2,,2,POINT (4697157 -74140516)
2012,Octubre,Rwanda,0,1,,1,POINT (6170465 -7542726)
2012,Octubre,San Cristóbal y Nevis,0,1,,1,POINT (4697157 -74140516)
2012,Octubre,Samoa Estadounidense/Territorio no incorporado de Estados Unidos,0,1,,1,POINT (6170465 -7542726)
2012,Octubre,San  Vicente y las Granadinas,1,0,,1,POINT (0.81488 -77356)
2012,Octubre,San  Vicente y las Granadinas,0,2,,2,POINT (3451668 -76532004)
2012,Octubre,San  Vicente y las Granadinas,1,1,,2,POINT (4697157 -74140516)
2012,Octubre,Santa Lucia,1,0,,1,POINT (10446304 -75516486)
2012,Octubre,Santa Lucia,2,2,,4,POINT (3451668 -76532004)
2012,Octubre,Santa Lucia,2,3,,5,POINT (4697157 -74140516)
2012,Octubre,Santa Lucia,1,0,,1,POINT (6170465 -7542726)
2012,Octubre,Santa Lucia,6,1,,7,POINT (7128047 -73181317)
2012,Octubre,Santa Sede/Ciudad del Vaticano,0,1,,1,POINT (4697157 -74140516)
2012,Octubre,Senegal,0,1,,1,POINT (10446304 -75516486)
2012,Octubre,Senegal,1,0,,1,POINT (3451668 -76532004)
2012,Octubre,Senegal,3,3,,6,POINT (4697157 -74140516)
2012,Octubre,Serbia,3,6,,9,POINT (4697157 -74140516)
2012,Octubre,Serbia,0,1,,1,POINT (6170465 -7542726)
2012,Octubre,Singapur,1,0,,1,POINT (0.81488 -77356)
2012,Octubre,Singapur,3,0,,3,POINT (10446304 -75516486)
2012,Octubre,Singapur,5,12,,17,POINT (4697157 -74140516)
2012,Octubre,Singapur,0,1,,1,POINT (4815189 -75736374)
2012,Octubre,Singapur,0,1,,1,POINT (6170465 -7542726)
2012,Octubre,Singapur,0,1,,1,POINT (7819 -72453013)
2012,Octubre,República Árabe Siria,0,1,,1,POINT (11360029 -72129595)
2012,Octubre,República Árabe Siria,0,4,,4,POINT (4697157 -74140516)
2012,Octubre,Sri Lanka,0,1,,1,POINT (10406342 -75527794)
2012,Octubre,Sri Lanka,0,3,,3,POINT (4697157 -74140516)
2012,Octubre,Sudáfrica,0,2,,2,POINT (0.81488 -77356)
2012,Octubre,Sudáfrica,3,1,,4,POINT (10406342 -75527794)
2012,Octubre,Sudáfrica,1,2,,3,POINT (10446304 -75516486)
2012,Octubre,Sudáfrica,1,3,,4,POINT (10886686 -74776479)
2012,Octubre,Sudáfrica,0,2,,2,POINT (10970933 -74765343)
2012,Octubre,Sudáfrica,1,1,,2,POINT (3451668 -76532004)
2012,Octubre,Sudáfrica,20,75,,95,POINT (4697157 -74140516)
2012,Octubre,Sudáfrica,2,8,,10,POINT (6170465 -7542726)
2012,Octubre,Sudáfrica,1,0,,1,POINT (7927233 -72508188)
2012,Octubre,Sudán,0,1,,1,POINT (4697157 -74140516)
2012,Octubre,Suecia,4,4,,8,POINT (0.81488 -77356)
2012,Octubre,Suecia,1,0,,1,POINT (10406342 -75527794)
2012,Octubre,Suecia,5,12,,17,POINT (10446304 -75516486)
2012,Octubre,Suecia,1,0,,1,POINT (10886686 -74776479)
2012,Octubre,Suecia,1,4,,5,POINT (11247723 -74213989)
2012,Octubre,Suecia,1,3,,4,POINT (11360029 -72129595)
2012,Octubre,Suecia,1,6,,7,POINT (3451668 -76532004)
2012,Octubre,Suecia,0,1,,1,POINT (445285 -75766353)
2012,Octubre,Suecia,115,229,,344,POINT (4697157 -74140516)
2012,Octubre,Suecia,7,20,,27,POINT (6170465 -7542726)
2012,Octubre,Suecia,1,1,,2,POINT (7128047 -73181317)
2012,Octubre,Suecia,3,4,,7,POINT (7819 -72453013)
2012,Octubre,Suecia,0,2,,2,POINT (863337 -7735002)
2012,Octubre,Suiza,1,1,,2,POINT (-4191162 -69941498)
2012,Octubre,Suiza,15,16,,31,POINT (0.81488 -77356)
2012,Octubre,Suiza,8,15,,23,POINT (10406342 -75527794)
2012,Octubre,Suiza,7,11,,18,POINT (10446304 -75516486)
2012,Octubre,Suiza,0,7,,7,POINT (10886686 -74776479)
2012,Octubre,Suiza,1,1,,2,POINT (11360029 -72129595)
2012,Octubre,Suiza,1,1,,2,POINT (1152863 -72919186)
2012,Octubre,Suiza,1,4,,5,POINT (125862 -81702165)
2012,Octubre,Suiza,15,43,,58,POINT (3451668 -76532004)
2012,Octubre,Suiza,216,494,,710,POINT (4697157 -74140516)
2012,Octubre,Suiza,0,1,,1,POINT (4815189 -75736374)
2012,Octubre,Suiza,11,41,,52,POINT (6170465 -7542726)
2012,Octubre,Suiza,0,1,,1,POINT (7819 -72453013)
2012,Octubre,Suiza,2,0,,2,POINT (863337 -7735002)
2012,Octubre,Surinam,0,5,,5,POINT (10446304 -75516486)
2012,Octubre,Surinam,1,1,,2,POINT (3451668 -76532004)
2012,Octubre,Surinam,12,15,,27,POINT (4697157 -74140516)
2012,Octubre,Surinam,2,3,,5,POINT (6170465 -7542726)
2012,Octubre,Taiwán,0,1,,1,POINT (10446304 -75516486)
2012,Octubre,Taiwán,0,1,,1,POINT (125862 -81702165)
2012,Octubre,Taiwán,1,1,,2,POINT (3451668 -76532004)
2012,Octubre,Taiwán,0,4,,4,POINT (4697157 -74140516)
2012,Octubre,Taiwán,1,0,,1,POINT (6170465 -7542726)
2012,Octubre,Tailandia,1,0,,1,POINT (10446304 -75516486)
2012,Octubre,Tailandia,1,2,,3,POINT (3451668 -76532004)
2012,Octubre,Tailandia,3,6,,9,POINT (4697157 -74140516)
2012,Octubre,Tailandia,1,0,,1,POINT (6170465 -7542726)
2012,Octubre,Territorio Antártico Británico/Territorio Británico de Ultramar,0,1,,1,POINT (4697157 -74140516)
2012,Octubre,Tanzania,0,3,,3,POINT (6170465 -7542726)
2012,Octubre,Togo,0,2,,2,POINT (4697157 -74140516)
2012,Octubre,Trinidad y Tobago,0,1,,1,POINT (10406342 -75527794)
2012,Octubre,Trinidad y Tobago,1,9,,10,POINT (10446304 -75516486)
2012,Octubre,Trinidad y Tobago,0,2,,2,POINT (10886686 -74776479)
2012,Octubre,Trinidad y Tobago,0,1,,1,POINT (11360029 -72129595)
2012,Octubre,Trinidad y Tobago,7,6,,13,POINT (3451668 -76532004)
2012,Octubre,Trinidad y Tobago,10,84,,94,POINT (4697157 -74140516)
2012,Octubre,Trinidad y Tobago,0,17,,17,POINT (6170465 -7542726)
2012,Octubre,Trinidad y Tobago,0,1,,1,POINT (7128047 -73181317)
2012,Octubre,Trinidad y Tobago,0,1,,1,POINT (7927233 -72508188)
2012,Octubre,Túnez,1,1,,2,POINT (4697157 -74140516)
2012,Octubre,Turquía,0,2,,2,POINT (0.81488 -77356)
2012,Octubre,Turquía,0,1,,1,POINT (1800143 -78802679)
2012,Octubre,Turquía,0,2,,2,POINT (10406342 -75527794)
2012,Octubre,Turquía,0,2,,2,POINT (10446304 -75516486)
2012,Octubre,Turquía,0,1,,1,POINT (11360029 -72129595)
2012,Octubre,Turquía,0,1,,1,POINT (3451668 -76532004)
2012,Octubre,Turquía,48,79,,127,POINT (4697157 -74140516)
2012,Octubre,Turquía,0,5,,5,POINT (6170465 -7542726)
2012,Octubre,Turquía,0,1,,1,POINT (7819 -72453013)
2012,Octubre,Ucrania,0,2,,2,POINT (3451668 -76532004)
2012,Octubre,Ucrania,0,2,,2,POINT (3884426 -77061029)
2012,Octubre,Ucrania,23,28,,51,POINT (4697157 -74140516)
2012,Octubre,Ucrania,1,0,,1,POINT (6170465 -7542726)
2012,Octubre,Uganda,0,1,,1,POINT (0.33002 -76876446)
2012,Octubre,Uganda,2,0,,2,POINT (4697157 -74140516)
2012,Octubre,Federación de Rusia,1,3,,4,POINT (-4191162 -69941498)
2012,Octubre,Federación de Rusia,0,1,,1,POINT (0.81488 -77356)
2012,Octubre,Federación de Rusia,0,2,,2,POINT (10406342 -75527794)
2012,Octubre,Federación de Rusia,3,0,,3,POINT (10446304 -75516486)
2012,Octubre,Federación de Rusia,0,1,,1,POINT (10970933 -74765343)
2012,Octubre,Federación de Rusia,2,3,,5,POINT (3451668 -76532004)
2012,Octubre,Federación de Rusia,88,168,,256,POINT (4697157 -74140516)
2012,Octubre,Federación de Rusia,2,1,,3,POINT (6170465 -7542726)
2012,Octubre,Federación de Rusia,2,1,,3,POINT (7819 -72453013)
2012,Octubre,Uruguay,2,9,,11,POINT (0.81488 -77356)
2012,Octubre,Uruguay,0,1,,1,POINT (10406342 -75527794)
2012,Octubre,Uruguay,80,74,,154,POINT (10446304 -75516486)
2012,Octubre,Uruguay,0,4,,4,POINT (10886686 -74776479)
2012,Octubre,Uruguay,0,5,,5,POINT (11360029 -72129595)
2012,Octubre,Uruguay,39,31,,70,POINT (125862 -81702165)
2012,Octubre,Uruguay,12,23,,35,POINT (3451668 -76532004)
2012,Octubre,Uruguay,116,290,,406,POINT (4697157 -74140516)
2012,Octubre,Uruguay,0,2,,2,POINT (4815189 -75736374)
2012,Octubre,Uruguay,25,47,,72,POINT (6170465 -7542726)
2012,Octubre,Uruguay,2,3,,5,POINT (7819 -72453013)
2012,Octubre,Venezuela,0,2,,2,POINT (-4191162 -69941498)
2012,Octubre,Venezuela,0,1,,1,POINT (0.33002 -76876446)
2012,Octubre,Venezuela,69,83,,152,POINT (0.81488 -77356)
2012,Octubre,Venezuela,0,20,,20,POINT (1397318 -77290564)
2012,Octubre,Venezuela,0,1,,1,POINT (10406342 -75527794)
2012,Octubre,Venezuela,131,153,,284,POINT (10446304 -75516486)
2012,Octubre,Venezuela,35,75,,110,POINT (10886686 -74776479)
2012,Octubre,Venezuela,2,7,,9,POINT (11117206 -74232675)
2012,Octubre,Venezuela,776,1425,,2201,POINT (11360029 -72129595)
2012,Octubre,Venezuela,20,12,,32,POINT (125862 -81702165)
2012,Octubre,Venezuela,55,81,,136,POINT (3451668 -76532004)
2012,Octubre,Venezuela,1,3,,4,POINT (445285 -75766353)
2012,Octubre,Venezuela,5287,6649,,11936,POINT (4697157 -74140516)
2012,Octubre,Venezuela,1,12,,13,POINT (4815189 -75736374)
2012,Octubre,Venezuela,313,393,,706,POINT (6170465 -7542726)
2012,Octubre,Venezuela,51,89,,140,POINT (6185536 -67484028)
2012,Octubre,Venezuela,49,101,,150,POINT (7088729 -70740253)
2012,Octubre,Venezuela,2,2,,4,POINT (7128047 -73181317)
2012,Octubre,Venezuela,1046,1305,,2351,POINT (7819 -72453013)
2012,Octubre,Venezuela,214,302,,516,POINT (7927233 -72508188)
2012,Octubre,Venezuela,0,1,,1,POINT (863337 -7735002)
2012,Octubre,Vietnam,0,2,,2,POINT (10406342 -75527794)
2012,Octubre,Vietnam,2,4,,6,POINT (4697157 -74140516)
2012,Octubre,República Árabe de Yemen,0,1,,1,POINT (4697157 -74140516)
2012,Octubre,Yugoslavia,1,0,,1,POINT (10446304 -75516486)
2012,Octubre,Zambia,0,1,,1,POINT (4697157 -74140516)
2012,Octubre,Zimbabue,1,0,,1,POINT (4697157 -74140516)
2012,Octubre,Reino Unido de Gran Bretaña e Irlanda del Norte,8,3,,11,POINT (-4191162 -69941498)
2012,Octubre,Reino Unido de Gran Bretaña e Irlanda del Norte,20,33,,53,POINT (0.81488 -77356)
2012,Octubre,Reino Unido de Gran Bretaña e Irlanda del Norte,24,33,,57,POINT (10406342 -75527794)
2012,Octubre,Reino Unido de Gran Bretaña e Irlanda del Norte,11,29,,40,POINT (10446304 -75516486)
2012,Octubre,Reino Unido de Gran Bretaña e Irlanda del Norte,0,2,,2,POINT (10886686 -74776479)
2012,Octubre,Reino Unido de Gran Bretaña e Irlanda del Norte,3,8,,11,POINT (11360029 -72129595)
2012,Octubre,Reino Unido de Gran Bretaña e Irlanda del Norte,1,1,,2,POINT (125862 -81702165)
2012,Octubre,Reino Unido de Gran Bretaña e Irlanda del Norte,6,26,,32,POINT (3451668 -76532004)
2012,Octubre,Reino Unido de Gran Bretaña e Irlanda del Norte,1,0,,1,POINT (445285 -75766353)
2012,Octubre,Reino Unido de Gran Bretaña e Irlanda del Norte,185,589,,774,POINT (4697157 -74140516)
2012,Octubre,Reino Unido de Gran Bretaña e Irlanda del Norte,8,28,,36,POINT (6170465 -7542726)
2012,Octubre,Reino Unido de Gran Bretaña e Irlanda del Norte,0,6,,6,POINT (7819 -72453013)
2012,Octubre,Reino Unido de Gran Bretaña e Irlanda del Norte,4,0,,4,POINT (863337 -7735002)
2012,Octubre,Países Bajos,3,3,,6,POINT (-4191162 -69941498)
2012,Octubre,Países Bajos,7,10,,17,POINT (0.81488 -77356)
2012,Octubre,Países Bajos,5,11,,16,POINT (10406342 -75527794)
2012,Octubre,Países Bajos,9,29,,38,POINT (10446304 -75516486)
2012,Octubre,Países Bajos,5,4,,9,POINT (10886686 -74776479)
2012,Octubre,Países Bajos,0,4,,4,POINT (10970933 -74765343)
2012,Octubre,Países Bajos,1,1,,2,POINT (11247723 -74213989)
2012,Octubre,Países Bajos,1,4,,5,POINT (11360029 -72129595)
2012,Octubre,Países Bajos,0,1,,1,POINT (125744111 -81703935)
2012,Octubre,Países Bajos,10,54,,64,POINT (3451668 -76532004)
2012,Octubre,Países Bajos,13,17,,30,POINT (445285 -75766353)
2012,Octubre,Países Bajos,382,695,,1077,POINT (4697157 -74140516)
2012,Octubre,Países Bajos,92,120,,212,POINT (6170465 -7542726)
2012,Octubre,Países Bajos,3,3,,6,POINT (7128047 -73181317)
2012,Octubre,Países Bajos,1,3,,4,POINT (7819 -72453013)
2012,Octubre,Países Bajos,0,3,,3,POINT (806667 -767333)
2012,Octubre,Países Bajos,0,1,,1,POINT (863337 -7735002)
2012,Octubre,Eslovenia,1,0,,1,POINT (4697157 -74140516)
2012,Octubre,Lituania,2,0,,2,POINT (4697157 -74140516)
2012,Octubre,Reino Unido de Gran Bretaña e Irlanda del Norte,4,7,,11,POINT (4697157 -74140516)
2012,Octubre,Reino Unido de Gran Bretaña e Irlanda del Norte,0,1,,1,POINT (6170465 -7542726)
2012,Octubre,Reino Unido de Gran Bretaña e Irlanda del Norte,0,1,,1,POINT (0.81488 -77356)
2012,Octubre,Reino Unido de Gran Bretaña e Irlanda del Norte,0,2,,2,POINT (10446304 -75516486)
2012,Octubre,Reino Unido de Gran Bretaña e Irlanda del Norte,4,5,,9,POINT (4697157 -74140516)
2012,Octubre,República CentroÁfricana,0,2,,2,POINT (4697157 -74140516)
2012,Noviembre,Desconocido,1,3,,4,POINT (4697157 -74140516)
2012,Noviembre,Afganistán,0,2,,2,POINT (4697157 -74140516)
2012,Noviembre,Albania,0,1,,1,POINT (3451668 -76532004)
2012,Noviembre,Albania,1,1,,2,POINT (4697157 -74140516)
2012,Noviembre,Alemania,9,18,,27,POINT (-4191162 -69941498)
2012,Noviembre,Alemania,37,36,,73,POINT (0.81488 -77356)
2012,Noviembre,Alemania,0,1,,1,POINT (1800143 -78802679)
2012,Noviembre,Alemania,25,34,,59,POINT (10406342 -75527794)
2012,Noviembre,Alemania,29,73,,102,POINT (10446304 -75516486)
2012,Noviembre,Alemania,7,11,,18,POINT (10886686 -74776479)
2012,Noviembre,Alemania,2,1,,3,POINT (11247723 -74213989)
2012,Noviembre,Alemania,6,9,,15,POINT (11360029 -72129595)
2012,Noviembre,Alemania,1,2,,3,POINT (125862 -81702165)
2012,Noviembre,Alemania,1,0,,1,POINT (133387613 -81372937)
2012,Noviembre,Alemania,29,63,,92,POINT (3451668 -76532004)
2012,Noviembre,Alemania,1199,2033,,3232,POINT (4697157 -74140516)
2012,Noviembre,Alemania,1,2,,3,POINT (4815189 -75736374)
2012,Noviembre,Alemania,26,88,,114,POINT (6170465 -7542726)
2012,Noviembre,Alemania,1,1,,2,POINT (7128047 -73181317)
2012,Noviembre,Alemania,5,14,,19,POINT (7819 -72453013)
2012,Noviembre,Alemania,0,4,,4,POINT (7927233 -72508188)
2012,Noviembre,Alemania,4,8,,12,POINT (863337 -7735002)
2012,Noviembre,Andorra,0,10,,10,POINT (4697157 -74140516)
2012,Noviembre,Andorra,0,1,,1,POINT (4815189 -75736374)
2012,Noviembre,Andorra,0,1,,1,POINT (6170465 -7542726)
2012,Noviembre,Angola,1,0,,1,POINT (4697157 -74140516)
2012,Noviembre,Antigua y Barbuda,0,1,,1,POINT (10406342 -75527794)
2012,Noviembre,Antigua y Barbuda,0,1,,1,POINT (10886686 -74776479)
2012,Noviembre,Antigua y Barbuda,0,2,,2,POINT (4697157 -74140516)
2012,Noviembre,Países Bajos,0,1,,1,POINT (6170465 -7542726)
2012,Noviembre,Países Bajos,1,1,,2,POINT (7128047 -73181317)
2012,Noviembre,Arabia Saudita,1,0,,1,POINT (4697157 -74140516)
2012,Noviembre,Arabia Saudita,0,1,,1,POINT (10446304 -75516486)
2012,Noviembre,Arabia Saudita,0,2,,2,POINT (4697157 -74140516)
2012,Noviembre,Argelia,0,3,,3,POINT (4697157 -74140516)
2012,Noviembre,Argentina,3,3,,6,POINT (-4191162 -69941498)
2012,Noviembre,Argentina,1,1,,2,POINT (0.33002 -76876446)
2012,Noviembre,Argentina,43,81,,124,POINT (0.81488 -77356)
2012,Noviembre,Argentina,1,0,,1,POINT (1800143 -78802679)
2012,Noviembre,Argentina,1,5,,6,POINT (10406342 -75527794)
2012,Noviembre,Argentina,813,515,,1328,POINT (10446304 -75516486)
2012,Noviembre,Argentina,4,18,,22,POINT (10886686 -74776479)
2012,Noviembre,Argentina,5,15,,20,POINT (11360029 -72129595)
2012,Noviembre,Argentina,0,6,,6,POINT (125744111 -81703935)
2012,Noviembre,Argentina,268,190,,458,POINT (125862 -81702165)
2012,Noviembre,Argentina,40,116,,156,POINT (3451668 -76532004)
2012,Noviembre,Argentina,0,1,,1,POINT (445285 -75766353)
2012,Noviembre,Argentina,2538,3910,,6448,POINT (4697157 -74140516)
2012,Noviembre,Argentina,0,6,,6,POINT (4815189 -75736374)
2012,Noviembre,Argentina,102,243,,345,POINT (6170465 -7542726)
2012,Noviembre,Argentina,0,1,,1,POINT (6185536 -67484028)
2012,Noviembre,Argentina,2,2,,4,POINT (7128047 -73181317)
2012,Noviembre,Argentina,21,37,,58,POINT (7819 -72453013)
2012,Noviembre,Argentina,0,2,,2,POINT (7927233 -72508188)
2012,Noviembre,Argentina,7,6,,13,POINT (863337 -7735002)
2012,Noviembre,República de Armenia,1,0,,1,POINT (10406342 -75527794)
2012,Noviembre,República de Armenia,1,1,,2,POINT (4697157 -74140516)
2012,Noviembre,Aruba,1,1,,2,POINT (445285 -75766353)
2012,Noviembre,Aruba,3,1,,4,POINT (4697157 -74140516)
2012,Noviembre,Aruba,2,2,,4,POINT (6170465 -7542726)
2012,Noviembre,Australia,6,10,,16,POINT (-4191162 -69941498)
2012,Noviembre,Australia,21,37,,58,POINT (0.81488 -77356)
2012,Noviembre,Australia,15,37,,52,POINT (10406342 -75527794)
2012,Noviembre,Australia,24,35,,59,POINT (10446304 -75516486)
2012,Noviembre,Australia,3,4,,7,POINT (10886686 -74776479)
2012,Noviembre,Australia,1,2,,3,POINT (11247723 -74213989)
2012,Noviembre,Australia,1,2,,3,POINT (11360029 -72129595)
2012,Noviembre,Australia,0,3,,3,POINT (125744111 -81703935)
2012,Noviembre,Australia,2,1,,3,POINT (133387613 -81372937)
2012,Noviembre,Australia,10,25,,35,POINT (3451668 -76532004)
2012,Noviembre,Australia,258,438,,696,POINT (4697157 -74140516)
2012,Noviembre,Australia,0,1,,1,POINT (4815189 -75736374)
2012,Noviembre,Australia,33,60,,93,POINT (6170465 -7542726)
2012,Noviembre,Australia,0,1,,1,POINT (7128047 -73181317)
2012,Noviembre,Australia,0,1,,1,POINT (7819 -72453013)
2012,Noviembre,Australia,3,8,,11,POINT (863337 -7735002)
2012,Noviembre,Austria,2,2,,4,POINT (0.81488 -77356)
2012,Noviembre,Austria,5,8,,13,POINT (10406342 -75527794)
2012,Noviembre,Austria,11,8,,19,POINT (10446304 -75516486)
2012,Noviembre,Austria,0,1,,1,POINT (10886686 -74776479)
2012,Noviembre,Austria,0,1,,1,POINT (11247723 -74213989)
2012,Noviembre,Austria,0,5,,5,POINT (11360029 -72129595)
2012,Noviembre,Austria,3,12,,15,POINT (3451668 -76532004)
2012,Noviembre,Austria,102,236,,338,POINT (4697157 -74140516)
2012,Noviembre,Austria,5,6,,11,POINT (6170465 -7542726)
2012,Noviembre,Austria,3,0,,3,POINT (6222552 -77401154)
2012,Noviembre,Austria,1,0,,1,POINT (7819 -72453013)
2012,Noviembre,Austria,0,1,,1,POINT (863337 -7735002)
2012,Noviembre,Azerbaiyán,0,1,,1,POINT (4697157 -74140516)
2012,Noviembre,Bahamas,1,0,,1,POINT (10886686 -74776479)
2012,Noviembre,Bahamas,5,11,,16,POINT (4697157 -74140516)
2012,Noviembre,Bahamas,0,3,,3,POINT (6170465 -7542726)
2012,Noviembre,Bangladesh,1,1,,2,POINT (4697157 -74140516)
2012,Noviembre,Barbados,0,1,,1,POINT (10886686 -74776479)
2012,Noviembre,Barbados,3,5,,8,POINT (4697157 -74140516)
2012,Noviembre,Barbados,1,1,,2,POINT (4815189 -75736374)
2012,Noviembre,Barbados,0,1,,1,POINT (6170465 -7542726)
2012,Noviembre,Barbados,0,1,,1,POINT (7128047 -73181317)
2012,Noviembre,República de Belarús,3,1,,4,POINT (4697157 -74140516)
2012,Noviembre,Bélgica,1,0,,1,POINT (-4191162 -69941498)
2012,Noviembre,Bélgica,7,11,,18,POINT (0.81488 -77356)
2012,Noviembre,Bélgica,2,1,,3,POINT (10406342 -75527794)
2012,Noviembre,Bélgica,3,7,,10,POINT (10446304 -75516486)
2012,Noviembre,Bélgica,1,0,,1,POINT (10886686 -74776479)
2012,Noviembre,Bélgica,2,6,,8,POINT (11247723 -74213989)
2012,Noviembre,Bélgica,6,14,,20,POINT (3451668 -76532004)
2012,Noviembre,Bélgica,105,280,,385,POINT (4697157 -74140516)
2012,Noviembre,Bélgica,0,1,,1,POINT (4815189 -75736374)
2012,Noviembre,Bélgica,6,14,,20,POINT (6170465 -7542726)
2012,Noviembre,Bélgica,0,1,,1,POINT (7819 -72453013)
2012,Noviembre,Bélgica,1,1,,2,POINT (863337 -7735002)
2012,Noviembre,Belice,1,0,,1,POINT (10446304 -75516486)
2012,Noviembre,Belice,0,1,,1,POINT (125862 -81702165)
2012,Noviembre,Belice,1,5,,6,POINT (4697157 -74140516)
2012,Noviembre,Belice,0,2,,2,POINT (6170465 -7542726)
2012,Noviembre,Benín,1,0,,1,POINT (6170465 -7542726)
2012,Noviembre,Bermudas/Territorio Británico de Ultramar,1,0,,1,POINT (11360029 -72129595)
2012,Noviembre,Bermudas/Territorio Británico de Ultramar,0,1,,1,POINT (4697157 -74140516)
2012,Noviembre,Bermudas/Territorio Británico de Ultramar,0,1,,1,POINT (4815189 -75736374)
2012,Noviembre,Bolivia,0,1,,1,POINT (-4191162 -69941498)
2012,Noviembre,Bolivia,0,1,,1,POINT (0.33002 -76876446)
2012,Noviembre,Bolivia,5,11,,16,POINT (0.81488 -77356)
2012,Noviembre,Bolivia,6,11,,17,POINT (10446304 -75516486)
2012,Noviembre,Bolivia,7,3,,10,POINT (10886686 -74776479)
2012,Noviembre,Bolivia,0,4,,4,POINT (11360029 -72129595)
2012,Noviembre,Bolivia,3,2,,5,POINT (125862 -81702165)
2012,Noviembre,Bolivia,12,16,,28,POINT (3451668 -76532004)
2012,Noviembre,Bolivia,377,553,,930,POINT (4697157 -74140516)
2012,Noviembre,Bolivia,0,2,,2,POINT (4815189 -75736374)
2012,Noviembre,Bolivia,13,33,,46,POINT (6170465 -7542726)
2012,Noviembre,Bolivia,1,0,,1,POINT (7128047 -73181317)
2012,Noviembre,Bolivia,1,2,,3,POINT (7819 -72453013)
2012,Noviembre,Bosnia y Herzegovina,0,1,,1,POINT (0.81488 -77356)
2012,Noviembre,Bosnia y Herzegovina,0,1,,1,POINT (4697157 -74140516)
2012,Noviembre,Botsuana,2,0,,2,POINT (4697157 -74140516)
2012,Noviembre,Brasil,101,144,,245,POINT (-4191162 -69941498)
2012,Noviembre,Brasil,5,15,,20,POINT (0.81488 -77356)
2012,Noviembre,Brasil,1,10,,11,POINT (10406342 -75527794)
2012,Noviembre,Brasil,126,124,,250,POINT (10446304 -75516486)
2012,Noviembre,Brasil,8,12,,20,POINT (10886686 -74776479)
2012,Noviembre,Brasil,6,9,,15,POINT (11360029 -72129595)
2012,Noviembre,Brasil,1,1,,2,POINT (1152863 -72919186)
2012,Noviembre,Brasil,18,19,,37,POINT (125862 -81702165)
2012,Noviembre,Brasil,15,58,,73,POINT (3451668 -76532004)
2012,Noviembre,Brasil,2035,3449,,5484,POINT (4697157 -74140516)
2012,Noviembre,Brasil,2,31,,33,POINT (4815189 -75736374)
2012,Noviembre,Brasil,58,122,,180,POINT (6170465 -7542726)
2012,Noviembre,Brasil,0,1,,1,POINT (6185536 -67484028)
2012,Noviembre,Brasil,0,1,,1,POINT (7128047 -73181317)
2012,Noviembre,Brasil,6,21,,27,POINT (7819 -72453013)
2012,Noviembre,Brasil,1,2,,3,POINT (7927233 -72508188)
2012,Noviembre,Brasil,1,1,,2,POINT (863337 -7735002)
2012,Noviembre,Bulgaria,7,14,,21,POINT (4697157 -74140516)
2012,Noviembre,Bulgaria,0,2,,2,POINT (6170465 -7542726)
2012,Noviembre,Burundi,0,2,,2,POINT (4697157 -74140516)
2012,Noviembre,Islas Caimán/Territorio Británico de Ultramar,1,1,,2,POINT (125862 -81702165)
2012,Noviembre,Camboya,1,3,,4,POINT (4697157 -74140516)
2012,Noviembre,Camerún,0,1,,1,POINT (3451668 -76532004)
2012,Noviembre,Camerún,0,3,,3,POINT (4697157 -74140516)
2012,Noviembre,Camerún,0,1,,1,POINT (4815189 -75736374)
2012,Noviembre,Camerún,1,0,,1,POINT (6170465 -7542726)
2012,Noviembre,Canadá,0,5,,5,POINT (-4191162 -69941498)
2012,Noviembre,Canadá,15,22,,37,POINT (0.81488 -77356)
2012,Noviembre,Canadá,9,18,,27,POINT (10406342 -75527794)
2012,Noviembre,Canadá,189,225,,414,POINT (10446304 -75516486)
2012,Noviembre,Canadá,15,25,,40,POINT (10886686 -74776479)
2012,Noviembre,Canadá,1,2,,3,POINT (11247723 -74213989)
2012,Noviembre,Canadá,0,5,,5,POINT (11360029 -72129595)
2012,Noviembre,Canadá,1,3,,4,POINT (125744111 -81703935)
2012,Noviembre,Canadá,6,6,,12,POINT (125862 -81702165)
2012,Noviembre,Canadá,2,2,,4,POINT (133387613 -81372937)
2012,Noviembre,Canadá,38,57,,95,POINT (3451668 -76532004)
2012,Noviembre,Canadá,5,9,,14,POINT (445285 -75766353)
2012,Noviembre,Canadá,663,1461,,2124,POINT (4697157 -74140516)
2012,Noviembre,Canadá,4,5,,9,POINT (4815189 -75736374)
2012,Noviembre,Canadá,76,192,,268,POINT (6170465 -7542726)
2012,Noviembre,Canadá,0,5,,5,POINT (7128047 -73181317)
2012,Noviembre,Canadá,2,2,,4,POINT (7819 -72453013)
2012,Noviembre,Canadá,0,2,,2,POINT (7927233 -72508188)
2012,Noviembre,Canadá,2,2,,4,POINT (863337 -7735002)
2012,Noviembre,España,0,1,,1,POINT (0.33002 -76876446)
2012,Noviembre,España,6,11,,17,POINT (0.81488 -77356)
2012,Noviembre,España,1,1,,2,POINT (1800143 -78802679)
2012,Noviembre,España,5,12,,17,POINT (10446304 -75516486)
2012,Noviembre,España,3,8,,11,POINT (10886686 -74776479)
2012,Noviembre,España,1,0,,1,POINT (11247723 -74213989)
2012,Noviembre,España,70,148,,218,POINT (3451668 -76532004)
2012,Noviembre,España,0,2,,2,POINT (445285 -75766353)
2012,Noviembre,España,196,631,,827,POINT (4697157 -74140516)
2012,Noviembre,España,0,8,,8,POINT (4815189 -75736374)
2012,Noviembre,España,43,116,,159,POINT (6170465 -7542726)
2012,Noviembre,España,2,1,,3,POINT (7128047 -73181317)
2012,Noviembre,España,1,4,,5,POINT (7819 -72453013)
2012,Noviembre,España,1,0,,1,POINT (7927233 -72508188)
2012,Noviembre,República Democrática del Congo,6,1,,7,POINT (4697157 -74140516)
2012,Noviembre,República de Corea,1,2,,3,POINT (-4191162 -69941498)
2012,Noviembre,República de Corea,2,3,,5,POINT (0.81488 -77356)
2012,Noviembre,República de Corea,1,1,,2,POINT (10406342 -75527794)
2012,Noviembre,República de Corea,1,0,,1,POINT (11360029 -72129595)
2012,Noviembre,República de Corea,1,13,,14,POINT (3451668 -76532004)
2012,Noviembre,República de Corea,1,0,,1,POINT (445285 -75766353)
2012,Noviembre,República de Corea,144,522,,666,POINT (4697157 -74140516)
2012,Noviembre,República de Corea,7,16,,23,POINT (6170465 -7542726)
2012,Noviembre,República de Corea,2,4,,6,POINT (7819 -72453013)
2012,Noviembre,República de Corea,1,1,,2,POINT (863337 -7735002)
2012,Noviembre,Costa de Marfil,1,1,,2,POINT (4697157 -74140516)
2012,Noviembre,Costa Rica,1,0,,1,POINT (-4191162 -69941498)
2012,Noviembre,Costa Rica,3,1,,4,POINT (0.81488 -77356)
2012,Noviembre,Costa Rica,1,13,,14,POINT (10406342 -75527794)
2012,Noviembre,Costa Rica,42,42,,84,POINT (10446304 -75516486)
2012,Noviembre,Costa Rica,7,23,,30,POINT (10886686 -74776479)
2012,Noviembre,Costa Rica,1,0,,1,POINT (11360029 -72129595)
2012,Noviembre,Costa Rica,296,201,,497,POINT (125862 -81702165)
2012,Noviembre,Costa Rica,26,56,,82,POINT (3451668 -76532004)
2012,Noviembre,Costa Rica,400,702,,1102,POINT (4697157 -74140516)
2012,Noviembre,Costa Rica,1,8,,9,POINT (4815189 -75736374)
2012,Noviembre,Costa Rica,68,141,,209,POINT (6170465 -7542726)
2012,Noviembre,Costa Rica,1,0,,1,POINT (6185536 -67484028)
2012,Noviembre,Costa Rica,0,1,,1,POINT (7819 -72453013)
2012,Noviembre,Costa Rica,1,1,,2,POINT (7927233 -72508188)
2012,Noviembre,Croacia,0,1,,1,POINT (0.81488 -77356)
2012,Noviembre,Croacia,0,2,,2,POINT (10406342 -75527794)
2012,Noviembre,Croacia,0,5,,5,POINT (10446304 -75516486)
2012,Noviembre,Croacia,0,1,,1,POINT (10970933 -74765343)
2012,Noviembre,Croacia,0,1,,1,POINT (3451668 -76532004)
2012,Noviembre,Croacia,0,2,,2,POINT (3884426 -77061029)
2012,Noviembre,Croacia,2,23,,25,POINT (4697157 -74140516)
2012,Noviembre,Cuba,0,3,,3,POINT (0.81488 -77356)
2012,Noviembre,Cuba,0,1,,1,POINT (10406342 -75527794)
2012,Noviembre,Cuba,8,7,,15,POINT (10446304 -75516486)
2012,Noviembre,Cuba,2,6,,8,POINT (10886686 -74776479)
2012,Noviembre,Cuba,0,2,,2,POINT (11360029 -72129595)
2012,Noviembre,Cuba,4,3,,7,POINT (125862 -81702165)
2012,Noviembre,Cuba,9,23,,32,POINT (3451668 -76532004)
2012,Noviembre,Cuba,89,135,,224,POINT (4697157 -74140516)
2012,Noviembre,Cuba,0,1,,1,POINT (4815189 -75736374)
2012,Noviembre,Cuba,12,20,,32,POINT (6170465 -7542726)
2012,Noviembre,Cuba,0,1,,1,POINT (7088729 -70740253)
2012,Noviembre,Cuba,1,4,,5,POINT (7128047 -73181317)
2012,Noviembre,Cuba,1,1,,2,POINT (7927233 -72508188)
2012,Noviembre,Curazao,0,1,,1,POINT (3451668 -76532004)
2012,Noviembre,Curazao,1,1,,2,POINT (4697157 -74140516)
2012,Noviembre,Curazao,12,9,,21,POINT (6170465 -7542726)
2012,Noviembre,República Checa,2,1,,3,POINT (0.81488 -77356)
2012,Noviembre,República Checa,0,1,,1,POINT (11360029 -72129595)
2012,Noviembre,República Checa,1,1,,2,POINT (3451668 -76532004)
2012,Noviembre,República Checa,24,30,,54,POINT (4697157 -74140516)
2012,Noviembre,República Checa,0,1,,1,POINT (6170465 -7542726)
2012,Noviembre,República Checa,2,2,,4,POINT (863337 -7735002)
2012,Noviembre,Chile,0,2,,2,POINT (-4191162 -69941498)
2012,Noviembre,Chile,0,1,,1,POINT (0.33002 -76876446)
2012,Noviembre,Chile,31,46,,77,POINT (0.81488 -77356)
2012,Noviembre,Chile,0,4,,4,POINT (10406342 -75527794)
2012,Noviembre,Chile,95,84,,179,POINT (10446304 -75516486)
2012,Noviembre,Chile,4,10,,14,POINT (10886686 -74776479)
2012,Noviembre,Chile,1,4,,5,POINT (11360029 -72129595)
2012,Noviembre,Chile,71,29,,100,POINT (125862 -81702165)
2012,Noviembre,Chile,1,0,,1,POINT (133387613 -81372937)
2012,Noviembre,Chile,20,61,,81,POINT (3451668 -76532004)
2012,Noviembre,Chile,2043,3240,,5283,POINT (4697157 -74140516)
2012,Noviembre,Chile,4,2,,6,POINT (4815189 -75736374)
2012,Noviembre,Chile,56,114,,170,POINT (6170465 -7542726)
2012,Noviembre,Chile,0,2,,2,POINT (7088729 -70740253)
2012,Noviembre,Chile,1,1,,2,POINT (7128047 -73181317)
2012,Noviembre,Chile,10,16,,26,POINT (7819 -72453013)
2012,Noviembre,Chile,3,3,,6,POINT (863337 -7735002)
2012,Noviembre,China,1,2,,3,POINT (0.81488 -77356)
2012,Noviembre,China,0,1,,1,POINT (10406342 -75527794)
2012,Noviembre,China,1,6,,7,POINT (10446304 -75516486)
2012,Noviembre,China,0,2,,2,POINT (10886686 -74776479)
2012,Noviembre,China,2,0,,2,POINT (11360029 -72129595)
2012,Noviembre,China,3,8,,11,POINT (3451668 -76532004)
2012,Noviembre,China,0,3,,3,POINT (3884426 -77061029)
2012,Noviembre,China,169,526,,695,POINT (4697157 -74140516)
2012,Noviembre,China,0,1,,1,POINT (4815189 -75736374)
2012,Noviembre,China,5,17,,22,POINT (6170465 -7542726)
2012,Noviembre,China,1,0,,1,POINT (7128047 -73181317)
2012,Noviembre,Taiwán,1,1,,2,POINT (0.81488 -77356)
2012,Noviembre,Taiwán,1,5,,6,POINT (10446304 -75516486)
2012,Noviembre,Taiwán,1,3,,4,POINT (10886686 -74776479)
2012,Noviembre,Taiwán,0,4,,4,POINT (3451668 -76532004)
2012,Noviembre,Taiwán,1,0,,1,POINT (445285 -75766353)
2012,Noviembre,Taiwán,26,47,,73,POINT (4697157 -74140516)
2012,Noviembre,Taiwán,0,1,,1,POINT (4815189 -75736374)
2012,Noviembre,Taiwán,4,11,,15,POINT (6170465 -7542726)
2012,Noviembre,Chipre,0,2,,2,POINT (4697157 -74140516)
2012,Noviembre,Chipre,0,1,,1,POINT (6170465 -7542726)
2012,Noviembre,Dinamarca,1,1,,2,POINT (-4191162 -69941498)
2012,Noviembre,Dinamarca,5,3,,8,POINT (0.81488 -77356)
2012,Noviembre,Dinamarca,2,3,,5,POINT (10406342 -75527794)
2012,Noviembre,Dinamarca,6,9,,15,POINT (10446304 -75516486)
2012,Noviembre,Dinamarca,0,1,,1,POINT (10886686 -74776479)
2012,Noviembre,Dinamarca,0,2,,2,POINT (11360029 -72129595)
2012,Noviembre,Dinamarca,2,6,,8,POINT (3451668 -76532004)
2012,Noviembre,Dinamarca,70,116,,186,POINT (4697157 -74140516)
2012,Noviembre,Dinamarca,7,14,,21,POINT (6170465 -7542726)
2012,Noviembre,Dinamarca,1,1,,2,POINT (863337 -7735002)
2012,Noviembre,Dominica,0,1,,1,POINT (11360029 -72129595)
2012,Noviembre,Dominica,3,4,,7,POINT (4697157 -74140516)
2012,Noviembre,Dominica,0,1,,1,POINT (6170465 -7542726)
2012,Noviembre,Ecuador,0,2,,2,POINT (-4191162 -69941498)
2012,Noviembre,Ecuador,10,65,,75,POINT (0.33002 -76876446)
2012,Noviembre,Ecuador,1068,1508,,2576,POINT (0.81488 -77356)
2012,Noviembre,Ecuador,1,139,,140,POINT (1800143 -78802679)
2012,Noviembre,Ecuador,0,9,,9,POINT (10406342 -75527794)
2012,Noviembre,Ecuador,15,27,,42,POINT (10446304 -75516486)
2012,Noviembre,Ecuador,4,6,,10,POINT (10886686 -74776479)
2012,Noviembre,Ecuador,13,20,,33,POINT (11360029 -72129595)
2012,Noviembre,Ecuador,0,2,,2,POINT (125744111 -81703935)
2012,Noviembre,Ecuador,3,2,,5,POINT (125862 -81702165)
2012,Noviembre,Ecuador,282,343,,625,POINT (3451668 -76532004)
2012,Noviembre,Ecuador,0,2,,2,POINT (3884426 -77061029)
2012,Noviembre,Ecuador,0,2,,2,POINT (445285 -75766353)
2012,Noviembre,Ecuador,1935,2863,,4798,POINT (4697157 -74140516)
2012,Noviembre,Ecuador,1,3,,4,POINT (4815189 -75736374)
2012,Noviembre,Ecuador,519,550,,1069,POINT (6170465 -7542726)
2012,Noviembre,Ecuador,1,0,,1,POINT (6185536 -67484028)
2012,Noviembre,Ecuador,4,1,,5,POINT (7128047 -73181317)
2012,Noviembre,Ecuador,94,135,,229,POINT (7819 -72453013)
2012,Noviembre,Ecuador,0,1,,1,POINT (7927233 -72508188)
2012,Noviembre,Egipto,2,11,,13,POINT (4697157 -74140516)
2012,Noviembre,Egipto,0,2,,2,POINT (6170465 -7542726)
2012,Noviembre,El Salvador,2,0,,2,POINT (0.81488 -77356)
2012,Noviembre,El Salvador,10,17,,27,POINT (10446304 -75516486)
2012,Noviembre,El Salvador,0,1,,1,POINT (11360029 -72129595)
2012,Noviembre,El Salvador,21,6,,27,POINT (125862 -81702165)
2012,Noviembre,El Salvador,37,66,,103,POINT (3451668 -76532004)
2012,Noviembre,El Salvador,427,676,,1103,POINT (4697157 -74140516)
2012,Noviembre,El Salvador,1,3,,4,POINT (4815189 -75736374)
2012,Noviembre,El Salvador,12,40,,52,POINT (6170465 -7542726)
2012,Noviembre,El Salvador,0,1,,1,POINT (7819 -72453013)
2012,Noviembre,Emiratos Árabes,0,1,,1,POINT (3451668 -76532004)
2012,Noviembre,Emiratos Árabes,1,2,,3,POINT (4697157 -74140516)
2012,Noviembre,España,3,9,,12,POINT (-4191162 -69941498)
2012,Noviembre,España,0,3,,3,POINT (0.33002 -76876446)
2012,Noviembre,España,23,30,,53,POINT (0.81488 -77356)
2012,Noviembre,España,2,7,,9,POINT (10406342 -75527794)
2012,Noviembre,España,44,118,,162,POINT (10446304 -75516486)
2012,Noviembre,España,3,10,,13,POINT (10886686 -74776479)
2012,Noviembre,España,8,11,,19,POINT (11360029 -72129595)
2012,Noviembre,España,3,8,,11,POINT (125862 -81702165)
2012,Noviembre,España,190,300,,490,POINT (3451668 -76532004)
2012,Noviembre,España,1684,4793,,6477,POINT (4697157 -74140516)
2012,Noviembre,España,1,15,,16,POINT (4815189 -75736374)
2012,Noviembre,España,70,234,,304,POINT (6170465 -7542726)
2012,Noviembre,España,20,50,,70,POINT (7819 -72453013)
2012,Noviembre,España,2,10,,12,POINT (7927233 -72508188)
2012,Noviembre,España,2,11,,13,POINT (863337 -7735002)
2012,Noviembre,Eslovaquia,1,0,,1,POINT (-4191162 -69941498)
2012,Noviembre,Eslovaquia,0,1,,1,POINT (10406342 -75527794)
2012,Noviembre,Eslovaquia,0,1,,1,POINT (10446304 -75516486)
2012,Noviembre,Eslovaquia,1,0,,1,POINT (10886686 -74776479)
2012,Noviembre,Eslovaquia,0,2,,2,POINT (3451668 -76532004)
2012,Noviembre,Eslovaquia,16,15,,31,POINT (4697157 -74140516)
2012,Noviembre,Eslovaquia,2,1,,3,POINT (6170465 -7542726)
2012,Noviembre,Eslovaquia,1,0,,1,POINT (863337 -7735002)
2012,Noviembre,Eslovenia,1,2,,3,POINT (0.81488 -77356)
2012,Noviembre,Eslovenia,0,2,,2,POINT (10406342 -75527794)
2012,Noviembre,Eslovenia,2,1,,3,POINT (10446304 -75516486)
2012,Noviembre,Eslovenia,14,26,,40,POINT (4697157 -74140516)
2012,Noviembre,Eslovenia,1,1,,2,POINT (6170465 -7542726)
2012,Noviembre,Eslovenia,0,1,,1,POINT (7819 -72453013)
2012,Noviembre,Estados Unidos de América,9,12,,21,POINT (-4191162 -69941498)
2012,Noviembre,Estados Unidos de América,23,65,,88,POINT (0.81488 -77356)
2012,Noviembre,Estados Unidos de América,1,0,,1,POINT (1800143 -78802679)
2012,Noviembre,Estados Unidos de América,44,75,,119,POINT (10406342 -75527794)
2012,Noviembre,Estados Unidos de América,992,1846,,2838,POINT (10446304 -75516486)
2012,Noviembre,Estados Unidos de América,244,404,,648,POINT (10886686 -74776479)
2012,Noviembre,Estados Unidos de América,0,3,,3,POINT (11117206 -74232675)
2012,Noviembre,Estados Unidos de América,8,14,,22,POINT (11247723 -74213989)
2012,Noviembre,Estados Unidos de América,3,11,,14,POINT (11360029 -72129595)
2012,Noviembre,Estados Unidos de América,0,1,,1,POINT (1152863 -72919186)
2012,Noviembre,Estados Unidos de América,2,13,,15,POINT (125744111 -81703935)
2012,Noviembre,Estados Unidos de América,10,19,,29,POINT (125862 -81702165)
2012,Noviembre,Estados Unidos de América,6,12,,18,POINT (133387613 -81372937)
2012,Noviembre,Estados Unidos de América,579,1048,,1627,POINT (3451668 -76532004)
2012,Noviembre,Estados Unidos de América,81,139,,220,POINT (445285 -75766353)
2012,Noviembre,Estados Unidos de América,4803,10722,,15525,POINT (4697157 -74140516)
2012,Noviembre,Estados Unidos de América,45,76,,121,POINT (4815189 -75736374)
2012,Noviembre,Estados Unidos de América,923,2378,,3301,POINT (6170465 -7542726)
2012,Noviembre,Estados Unidos de América,10,27,,37,POINT (7128047 -73181317)
2012,Noviembre,Estados Unidos de América,15,36,,51,POINT (7819 -72453013)
2012,Noviembre,Estados Unidos de América,12,7,,19,POINT (7927233 -72508188)
2012,Noviembre,Estados Unidos de América,8,15,,23,POINT (863337 -7735002)
2012,Noviembre,Estonia,0,2,,2,POINT (0.81488 -77356)
2012,Noviembre,Estonia,0,1,,1,POINT (3451668 -76532004)
2012,Noviembre,Estonia,1,1,,2,POINT (445285 -75766353)
2012,Noviembre,Estonia,3,11,,14,POINT (4697157 -74140516)
2012,Noviembre,Estonia,1,2,,3,POINT (6170465 -7542726)
2012,Noviembre,Etiopia,2,3,,5,POINT (4697157 -74140516)
2012,Noviembre,Islas Fiji,0,1,,1,POINT (4697157 -74140516)
2012,Noviembre,Filipinas,0,30,,30,POINT (10406342 -75527794)
2012,Noviembre,Filipinas,3,6,,9,POINT (10446304 -75516486)
2012,Noviembre,Filipinas,0,6,,6,POINT (10886686 -74776479)
2012,Noviembre,Filipinas,0,25,,25,POINT (10970933 -74765343)
2012,Noviembre,Filipinas,0,4,,4,POINT (11247723 -74213989)
2012,Noviembre,Filipinas,0,10,,10,POINT (3451668 -76532004)
2012,Noviembre,Filipinas,0,9,,9,POINT (3884426 -77061029)
2012,Noviembre,Filipinas,12,80,,92,POINT (4697157 -74140516)
2012,Noviembre,Filipinas,1,3,,4,POINT (6170465 -7542726)
2012,Noviembre,Filipinas,0,3,,3,POINT (9402597 -75681642)
2012,Noviembre,Finlandia,2,2,,4,POINT (-4191162 -69941498)
2012,Noviembre,Finlandia,4,0,,4,POINT (0.81488 -77356)
2012,Noviembre,Finlandia,2,2,,4,POINT (10406342 -75527794)
2012,Noviembre,Finlandia,1,3,,4,POINT (10446304 -75516486)
2012,Noviembre,Finlandia,0,2,,2,POINT (10886686 -74776479)
2012,Noviembre,Finlandia,2,0,,2,POINT (125862 -81702165)
2012,Noviembre,Finlandia,0,5,,5,POINT (3451668 -76532004)
2012,Noviembre,Finlandia,25,73,,98,POINT (4697157 -74140516)
2012,Noviembre,Finlandia,1,5,,6,POINT (6170465 -7542726)
2012,Noviembre,Francia,1,4,,5,POINT (-4191162 -69941498)
2012,Noviembre,Francia,0,1,,1,POINT (0.33002 -76876446)
2012,Noviembre,Francia,19,35,,54,POINT (0.81488 -77356)
2012,Noviembre,Francia,18,26,,44,POINT (10406342 -75527794)
2012,Noviembre,Francia,21,74,,95,POINT (10446304 -75516486)
2012,Noviembre,Francia,2,5,,7,POINT (10886686 -74776479)
2012,Noviembre,Francia,9,9,,18,POINT (11247723 -74213989)
2012,Noviembre,Francia,10,15,,25,POINT (11360029 -72129595)
2012,Noviembre,Francia,1,0,,1,POINT (125862 -81702165)
2012,Noviembre,Francia,28,48,,76,POINT (3451668 -76532004)
2012,Noviembre,Francia,894,1770,,2664,POINT (4697157 -74140516)
2012,Noviembre,Francia,0,4,,4,POINT (4815189 -75736374)
2012,Noviembre,Francia,28,89,,117,POINT (6170465 -7542726)
2012,Noviembre,Francia,0,2,,2,POINT (7088729 -70740253)
2012,Noviembre,Francia,6,20,,26,POINT (7819 -72453013)
2012,Noviembre,Francia,0,1,,1,POINT (7927233 -72508188)
2012,Noviembre,Francia,6,9,,15,POINT (863337 -7735002)
2012,Noviembre,Gabón,0,2,,2,POINT (4697157 -74140516)
2012,Noviembre,Georgia,0,3,,3,POINT (4697157 -74140516)
2012,Noviembre,Georgia,2,2,,4,POINT (6170465 -7542726)
2012,Noviembre,Ghana,0,1,,1,POINT (0.81488 -77356)
2012,Noviembre,Ghana,0,1,,1,POINT (11247723 -74213989)
2012,Noviembre,Ghana,0,6,,6,POINT (4697157 -74140516)
2012,Noviembre,Ghana,0,2,,2,POINT (6170465 -7542726)
2012,Noviembre,Ghana,0,1,,1,POINT (7819 -72453013)
2012,Noviembre,Granada,1,0,,1,POINT (10446304 -75516486)
2012,Noviembre,Granada,0,2,,2,POINT (10886686 -74776479)
2012,Noviembre,Granada,0,1,,1,POINT (4697157 -74140516)
2012,Noviembre,Grecia,2,2,,4,POINT (0.81488 -77356)
2012,Noviembre,Grecia,0,6,,6,POINT (10406342 -75527794)
2012,Noviembre,Grecia,1,7,,8,POINT (10446304 -75516486)
2012,Noviembre,Grecia,0,1,,1,POINT (10886686 -74776479)
2012,Noviembre,Grecia,0,1,,1,POINT (11247723 -74213989)
2012,Noviembre,Grecia,0,3,,3,POINT (3451668 -76532004)
2012,Noviembre,Grecia,28,52,,80,POINT (4697157 -74140516)
2012,Noviembre,Grecia,0,3,,3,POINT (6170465 -7542726)
2012,Noviembre,Grecia,0,1,,1,POINT (7819 -72453013)
2012,Noviembre,Grecia,0,2,,2,POINT (806667 -767333)
2012,Noviembre,Guatemala,2,3,,5,POINT (0.81488 -77356)
2012,Noviembre,Guatemala,0,2,,2,POINT (10406342 -75527794)
2012,Noviembre,Guatemala,42,66,,108,POINT (10446304 -75516486)
2012,Noviembre,Guatemala,2,17,,19,POINT (10886686 -74776479)
2012,Noviembre,Guatemala,0,2,,2,POINT (11360029 -72129595)
2012,Noviembre,Guatemala,9,5,,14,POINT (125862 -81702165)
2012,Noviembre,Guatemala,15,51,,66,POINT (3451668 -76532004)
2012,Noviembre,Guatemala,183,435,,618,POINT (4697157 -74140516)
2012,Noviembre,Guatemala,0,18,,18,POINT (4815189 -75736374)
2012,Noviembre,Guatemala,47,94,,141,POINT (6170465 -7542726)
2012,Noviembre,Guatemala,0,1,,1,POINT (6222552 -77401154)
2012,Noviembre,Guatemala,3,1,,4,POINT (7128047 -73181317)
2012,Noviembre,Guatemala,24,25,,49,POINT (7819 -72453013)
2012,Noviembre,Guatemala,2,0,,2,POINT (7927233 -72508188)
2012,Noviembre,Guyana,1,0,,1,POINT (0.81488 -77356)
2012,Noviembre,Guyana,0,1,,1,POINT (10406342 -75527794)
2012,Noviembre,Guyana,1,0,,1,POINT (10446304 -75516486)
2012,Noviembre,Guyana,0,6,,6,POINT (11247723 -74213989)
2012,Noviembre,Guyana,2,9,,11,POINT (4697157 -74140516)
2012,Noviembre,Guyana,0,1,,1,POINT (6170465 -7542726)
2012,Noviembre,Guinea Ecuatorial,0,1,,1,POINT (4697157 -74140516)
2012,Noviembre,Guayana Francesa/Departamento de Ultramar Francés,0,1,,1,POINT (4697157 -74140516)
2012,Noviembre,Haití,1,3,,4,POINT (10446304 -75516486)
2012,Noviembre,Haití,0,6,,6,POINT (10886686 -74776479)
2012,Noviembre,Haití,1,0,,1,POINT (3451668 -76532004)
2012,Noviembre,Haití,9,13,,22,POINT (4697157 -74140516)
2012,Noviembre,Haití,2,8,,10,POINT (7128047 -73181317)
2012,Noviembre,Haití,0,1,,1,POINT (7819 -72453013)
2012,Noviembre,Honduras,1,3,,4,POINT (10406342 -75527794)
2012,Noviembre,Honduras,23,19,,42,POINT (10446304 -75516486)
2012,Noviembre,Honduras,6,11,,17,POINT (10886686 -74776479)
2012,Noviembre,Honduras,0,4,,4,POINT (10970933 -74765343)
2012,Noviembre,Honduras,0,1,,1,POINT (125862 -81702165)
2012,Noviembre,Honduras,11,20,,31,POINT (3451668 -76532004)
2012,Noviembre,Honduras,0,1,,1,POINT (445285 -75766353)
2012,Noviembre,Honduras,135,164,,299,POINT (4697157 -74140516)
2012,Noviembre,Honduras,0,7,,7,POINT (4815189 -75736374)
2012,Noviembre,Honduras,26,45,,71,POINT (6170465 -7542726)
2012,Noviembre,Honduras,2,1,,3,POINT (7819 -72453013)
2012,Noviembre,Honduras,0,2,,2,POINT (806667 -767333)
2012,Noviembre,Hungría,1,1,,2,POINT (10406342 -75527794)
2012,Noviembre,Hungría,1,0,,1,POINT (10446304 -75516486)
2012,Noviembre,Hungría,0,1,,1,POINT (125862 -81702165)
2012,Noviembre,Hungría,0,1,,1,POINT (3451668 -76532004)
2012,Noviembre,Hungría,18,24,,42,POINT (4697157 -74140516)
2012,Noviembre,Hungría,0,5,,5,POINT (6170465 -7542726)
2012,Noviembre,India,0,1,,1,POINT (10406342 -75527794)
2012,Noviembre,India,1,3,,4,POINT (10446304 -75516486)
2012,Noviembre,India,0,2,,2,POINT (10886686 -74776479)
2012,Noviembre,India,2,10,,12,POINT (3451668 -76532004)
2012,Noviembre,India,0,1,,1,POINT (3884426 -77061029)
2012,Noviembre,India,28,243,,271,POINT (4697157 -74140516)
2012,Noviembre,India,3,24,,27,POINT (6170465 -7542726)
2012,Noviembre,Indonesia,0,18,,18,POINT (10406342 -75527794)
2012,Noviembre,Indonesia,0,17,,17,POINT (10446304 -75516486)
2012,Noviembre,Indonesia,4,32,,36,POINT (4697157 -74140516)
2012,Noviembre,Indonesia,0,3,,3,POINT (6170465 -7542726)
2012,Noviembre,Iraq,0,1,,1,POINT (4697157 -74140516)
2012,Noviembre,Irán,6,7,,13,POINT (4697157 -74140516)
2012,Noviembre,República de Irlanda,1,1,,2,POINT (-4191162 -69941498)
2012,Noviembre,República de Irlanda,5,14,,19,POINT (0.81488 -77356)
2012,Noviembre,República de Irlanda,2,2,,4,POINT (10406342 -75527794)
2012,Noviembre,República de Irlanda,8,15,,23,POINT (10446304 -75516486)
2012,Noviembre,República de Irlanda,0,4,,4,POINT (11360029 -72129595)
2012,Noviembre,República de Irlanda,0,4,,4,POINT (3451668 -76532004)
2012,Noviembre,República de Irlanda,41,131,,172,POINT (4697157 -74140516)
2012,Noviembre,República de Irlanda,3,12,,15,POINT (6170465 -7542726)
2012,Noviembre,República de Irlanda,1,1,,2,POINT (7128047 -73181317)
2012,Noviembre,República de Irlanda,0,1,,1,POINT (7819 -72453013)
2012,Noviembre,República de Irlanda,0,1,,1,POINT (863337 -7735002)
2012,Noviembre,Islandia,0,1,,1,POINT (0.81488 -77356)
2012,Noviembre,Islandia,2,6,,8,POINT (10446304 -75516486)
2012,Noviembre,Islandia,5,4,,9,POINT (4697157 -74140516)
2012,Noviembre,Islandia,1,1,,2,POINT (6170465 -7542726)
2012,Noviembre,Islandia,0,1,,1,POINT (7819 -72453013)
2012,Noviembre,Isla de Man,6,18,,24,POINT (0.81488 -77356)
2012,Noviembre,Isla de Man,2,18,,20,POINT (10446304 -75516486)
2012,Noviembre,Isla de Man,2,6,,8,POINT (10886686 -74776479)
2012,Noviembre,Isla de Man,9,14,,23,POINT (3451668 -76532004)
2012,Noviembre,Isla de Man,0,1,,1,POINT (445285 -75766353)
2012,Noviembre,Isla de Man,46,122,,168,POINT (4697157 -74140516)
2012,Noviembre,Isla de Man,0,1,,1,POINT (4815189 -75736374)
2012,Noviembre,Isla de Man,10,37,,47,POINT (6170465 -7542726)
2012,Noviembre,Isla de Man,0,2,,2,POINT (7819 -72453013)
2012,Noviembre,Isla Johnston,0,1,,1,POINT (0.81488 -77356)
2012,Noviembre,Isla Johnston,0,1,,1,POINT (4697157 -74140516)
2012,Noviembre,Israel,0,3,,3,POINT (-4191162 -69941498)
2012,Noviembre,Israel,3,14,,17,POINT (0.81488 -77356)
2012,Noviembre,Israel,0,1,,1,POINT (10406342 -75527794)
2012,Noviembre,Israel,4,25,,29,POINT (10446304 -75516486)
2012,Noviembre,Israel,0,2,,2,POINT (10886686 -74776479)
2012,Noviembre,Israel,1,3,,4,POINT (125862 -81702165)
2012,Noviembre,Israel,1,13,,14,POINT (3451668 -76532004)
2012,Noviembre,Israel,34,289,,323,POINT (4697157 -74140516)
2012,Noviembre,Israel,0,1,,1,POINT (4815189 -75736374)
2012,Noviembre,Israel,3,29,,32,POINT (6170465 -7542726)
2012,Noviembre,Israel,1,1,,2,POINT (863337 -7735002)
2012,Noviembre,Italia,2,5,,7,POINT (-4191162 -69941498)
2012,Noviembre,Italia,3,11,,14,POINT (0.81488 -77356)
2012,Noviembre,Italia,16,16,,32,POINT (10406342 -75527794)
2012,Noviembre,Italia,43,96,,139,POINT (10446304 -75516486)
2012,Noviembre,Italia,6,10,,16,POINT (10886686 -74776479)
2012,Noviembre,Italia,2,19,,21,POINT (11360029 -72129595)
2012,Noviembre,Italia,6,9,,15,POINT (125862 -81702165)
2012,Noviembre,Italia,24,74,,98,POINT (3451668 -76532004)
2012,Noviembre,Italia,426,1687,,2113,POINT (4697157 -74140516)
2012,Noviembre,Italia,1,5,,6,POINT (4815189 -75736374)
2012,Noviembre,Italia,23,101,,124,POINT (6170465 -7542726)
2012,Noviembre,Italia,0,3,,3,POINT (7128047 -73181317)
2012,Noviembre,Italia,2,23,,25,POINT (7819 -72453013)
2012,Noviembre,Italia,1,3,,4,POINT (7927233 -72508188)
2012,Noviembre,Italia,1,6,,7,POINT (863337 -7735002)
2012,Noviembre,Islas del Canal,0,2,,2,POINT (10446304 -75516486)
2012,Noviembre,Islas del Canal,0,1,,1,POINT (3451668 -76532004)
2012,Noviembre,Islas del Canal,1,0,,1,POINT (4697157 -74140516)
2012,Noviembre,Islas del Canal,0,1,,1,POINT (6170465 -7542726)
2012,Noviembre,Jamaica,0,1,,1,POINT (0.81488 -77356)
2012,Noviembre,Jamaica,2,3,,5,POINT (10446304 -75516486)
2012,Noviembre,Jamaica,1,0,,1,POINT (125862 -81702165)
2012,Noviembre,Jamaica,14,10,,24,POINT (4697157 -74140516)
2012,Noviembre,Jamaica,0,2,,2,POINT (6170465 -7542726)
2012,Noviembre,Jamaica,0,1,,1,POINT (7819 -72453013)
2012,Noviembre,Jamaica,0,1,,1,POINT (7927233 -72508188)
2012,Noviembre,Islas Midway/Territorio no incorporado de Estados Unidos,0,1,,1,POINT (6170465 -7542726)
2012,Noviembre,Japón,0,1,,1,POINT (-4191162 -69941498)
2012,Noviembre,Japón,2,5,,7,POINT (0.81488 -77356)
2012,Noviembre,Japón,1,9,,10,POINT (10406342 -75527794)
2012,Noviembre,Japón,3,13,,16,POINT (10446304 -75516486)
2012,Noviembre,Japón,0,12,,12,POINT (10886686 -74776479)
2012,Noviembre,Japón,1,1,,2,POINT (11360029 -72129595)
2012,Noviembre,Japón,2,1,,3,POINT (125862 -81702165)
2012,Noviembre,Japón,5,17,,22,POINT (3451668 -76532004)
2012,Noviembre,Japón,124,462,,586,POINT (4697157 -74140516)
2012,Noviembre,Japón,0,3,,3,POINT (4815189 -75736374)
2012,Noviembre,Japón,4,30,,34,POINT (6170465 -7542726)
2012,Noviembre,Japón,3,6,,9,POINT (7819 -72453013)
2012,Noviembre,Japón,0,1,,1,POINT (7927233 -72508188)
2012,Noviembre,Japón,1,1,,2,POINT (863337 -7735002)
2012,Noviembre,Jordania,1,0,,1,POINT (0.33002 -76876446)
2012,Noviembre,Jordania,0,6,,6,POINT (4697157 -74140516)
2012,Noviembre,Jordania,0,1,,1,POINT (6170465 -7542726)
2012,Noviembre,Kazajistán,0,1,,1,POINT (10446304 -75516486)
2012,Noviembre,Kazajistán,3,0,,3,POINT (4697157 -74140516)
2012,Noviembre,Kenia,1,0,,1,POINT (3451668 -76532004)
2012,Noviembre,Kenia,2,7,,9,POINT (4697157 -74140516)
2012,Noviembre,Kenia,2,1,,3,POINT (6170465 -7542726)
2012,Noviembre,Kirguistán,2,0,,2,POINT (4697157 -74140516)
2012,Noviembre,Kuwait,0,2,,2,POINT (4697157 -74140516)
2012,Noviembre,República de Kosovo,0,1,,1,POINT (4697157 -74140516)
2012,Noviembre,Letonia,1,0,,1,POINT (0.81488 -77356)
2012,Noviembre,Letonia,0,1,,1,POINT (10406342 -75527794)
2012,Noviembre,Letonia,0,1,,1,POINT (11360029 -72129595)
2012,Noviembre,Letonia,7,17,,24,POINT (4697157 -74140516)
2012,Noviembre,Letonia,0,4,,4,POINT (6170465 -7542726)
2012,Noviembre,Lituania,1,0,,1,POINT (10446304 -75516486)
2012,Noviembre,Lituania,1,0,,1,POINT (3451668 -76532004)
2012,Noviembre,Lituania,2,6,,8,POINT (4697157 -74140516)
2012,Noviembre,Líbano,1,0,,1,POINT (10446304 -75516486)
2012,Noviembre,Líbano,1,2,,3,POINT (10886686 -74776479)
2012,Noviembre,Líbano,4,3,,7,POINT (11360029 -72129595)
2012,Noviembre,Líbano,2,0,,2,POINT (125862 -81702165)
2012,Noviembre,Líbano,13,30,,43,POINT (4697157 -74140516)
2012,Noviembre,Liberia,3,1,,4,POINT (4697157 -74140516)
2012,Noviembre,Libia,0,1,,1,POINT (4697157 -74140516)
2012,Noviembre,Liechtenstein,1,2,,3,POINT (4697157 -74140516)
2012,Noviembre,Luxemburgo,3,9,,12,POINT (4697157 -74140516)
2012,Noviembre,Macedonia,5,1,,6,POINT (4697157 -74140516)
2012,Noviembre,Madagascar,5,0,,5,POINT (4697157 -74140516)
2012,Noviembre,Madagascar,1,0,,1,POINT (6170465 -7542726)
2012,Noviembre,Malasia,0,2,,2,POINT (10446304 -75516486)
2012,Noviembre,Malasia,0,2,,2,POINT (3451668 -76532004)
2012,Noviembre,Malasia,9,15,,24,POINT (4697157 -74140516)
2012,Noviembre,Malasia,4,1,,5,POINT (6170465 -7542726)
2012,Noviembre,Malawi,0,1,,1,POINT (4697157 -74140516)
2012,Noviembre,Malí,1,2,,3,POINT (6170465 -7542726)
2012,Noviembre,Malta,0,2,,2,POINT (4697157 -74140516)
2012,Noviembre,Marruecos,0,5,,5,POINT (4697157 -74140516)
2012,Noviembre,Mauricio,0,1,,1,POINT (4697157 -74140516)
2012,Noviembre,Mauritania,0,1,,1,POINT (4697157 -74140516)
2012,Noviembre,México,0,1,,1,POINT (-4191162 -69941498)
2012,Noviembre,México,3,0,,3,POINT (0.33002 -76876446)
2012,Noviembre,México,10,19,,29,POINT (0.81488 -77356)
2012,Noviembre,México,6,4,,10,POINT (10406342 -75527794)
2012,Noviembre,México,95,184,,279,POINT (10446304 -75516486)
2012,Noviembre,México,13,30,,43,POINT (10886686 -74776479)
2012,Noviembre,México,1,2,,3,POINT (11360029 -72129595)
2012,Noviembre,México,6,6,,12,POINT (125862 -81702165)
2012,Noviembre,México,57,167,,224,POINT (3451668 -76532004)
2012,Noviembre,México,0,3,,3,POINT (445285 -75766353)
2012,Noviembre,México,1889,4291,,6180,POINT (4697157 -74140516)
2012,Noviembre,México,4,12,,16,POINT (4815189 -75736374)
2012,Noviembre,México,119,372,,491,POINT (6170465 -7542726)
2012,Noviembre,México,1,8,,9,POINT (7128047 -73181317)
2012,Noviembre,México,17,40,,57,POINT (7819 -72453013)
2012,Noviembre,México,0,8,,8,POINT (7927233 -72508188)
2012,Noviembre,México,2,8,,10,POINT (863337 -7735002)
2012,Noviembre,República de Moldavia,0,1,,1,POINT (4697157 -74140516)
2012,Noviembre,Mónaco,0,2,,2,POINT (4697157 -74140516)
2012,Noviembre,Montenegro,0,1,,1,POINT (9402597 -75681642)
2012,Noviembre,Montserrat/Territorio Británico de Ultramar,1,0,,1,POINT (10446304 -75516486)
2012,Noviembre,Montserrat/Territorio Británico de Ultramar,0,1,,1,POINT (4697157 -74140516)
2012,Noviembre,Mozambique,1,1,,2,POINT (4697157 -74140516)
2012,Noviembre,Namibia,2,1,,3,POINT (4697157 -74140516)
2012,Noviembre,Nepal,0,1,,1,POINT (0.81488 -77356)
2012,Noviembre,Nepal,0,2,,2,POINT (4697157 -74140516)
2012,Noviembre,Nepal,1,0,,1,POINT (6170465 -7542726)
2012,Noviembre,Nicaragua,9,8,,17,POINT (10446304 -75516486)
2012,Noviembre,Nicaragua,0,3,,3,POINT (10886686 -74776479)
2012,Noviembre,Nicaragua,0,1,,1,POINT (125744111 -81703935)
2012,Noviembre,Nicaragua,3,3,,6,POINT (125862 -81702165)
2012,Noviembre,Nicaragua,1,4,,5,POINT (3451668 -76532004)
2012,Noviembre,Nicaragua,0,1,,1,POINT (445285 -75766353)
2012,Noviembre,Nicaragua,42,66,,108,POINT (4697157 -74140516)
2012,Noviembre,Nicaragua,1,7,,8,POINT (4815189 -75736374)
2012,Noviembre,Nicaragua,13,8,,21,POINT (6170465 -7542726)
2012,Noviembre,Nicaragua,1,0,,1,POINT (7128047 -73181317)
2012,Noviembre,Nigeria,0,2,,2,POINT (10446304 -75516486)
2012,Noviembre,Nigeria,2,2,,4,POINT (4697157 -74140516)
2012,Noviembre,Nigeria,1,1,,2,POINT (6170465 -7542726)
2012,Noviembre,Níger,0,1,,1,POINT (3451668 -76532004)
2012,Noviembre,Noruega,0,4,,4,POINT (-4191162 -69941498)
2012,Noviembre,Noruega,1,1,,2,POINT (0.81488 -77356)
2012,Noviembre,Noruega,3,3,,6,POINT (10406342 -75527794)
2012,Noviembre,Noruega,4,7,,11,POINT (10446304 -75516486)
2012,Noviembre,Noruega,1,6,,7,POINT (10886686 -74776479)
2012,Noviembre,Noruega,0,2,,2,POINT (11247723 -74213989)
2012,Noviembre,Noruega,5,4,,9,POINT (3451668 -76532004)
2012,Noviembre,Noruega,59,113,,172,POINT (4697157 -74140516)
2012,Noviembre,Noruega,6,5,,11,POINT (6170465 -7542726)
2012,Noviembre,Nueva Zelanda,7,17,,24,POINT (0.81488 -77356)
2012,Noviembre,Nueva Zelanda,2,2,,4,POINT (10446304 -75516486)
2012,Noviembre,Nueva Zelanda,0,2,,2,POINT (11360029 -72129595)
2012,Noviembre,Nueva Zelanda,1,2,,3,POINT (3451668 -76532004)
2012,Noviembre,Nueva Zelanda,0,2,,2,POINT (445285 -75766353)
2012,Noviembre,Nueva Zelanda,25,53,,78,POINT (4697157 -74140516)
2012,Noviembre,Nueva Zelanda,4,6,,10,POINT (6170465 -7542726)
2012,Noviembre,Nueva Zelanda,1,0,,1,POINT (7819 -72453013)
2012,Noviembre,Nueva Zelanda,4,1,,5,POINT (863337 -7735002)
2012,Noviembre,Omán,0,1,,1,POINT (4697157 -74140516)
2012,Noviembre,Nueva Zelanda,0,1,,1,POINT (-4191162 -69941498)
2012,Noviembre,Nueva Zelanda,2,7,,9,POINT (10406342 -75527794)
2012,Noviembre,Nueva Zelanda,1,1,,2,POINT (11247723 -74213989)
2012,Noviembre,Nueva Zelanda,2,0,,2,POINT (4697157 -74140516)
2012,Noviembre,Países Bajos,0,1,,1,POINT (-4191162 -69941498)
2012,Noviembre,Países Bajos,4,6,,10,POINT (0.81488 -77356)
2012,Noviembre,Países Bajos,3,4,,7,POINT (10446304 -75516486)
2012,Noviembre,Países Bajos,1,5,,6,POINT (10886686 -74776479)
2012,Noviembre,Países Bajos,1,1,,2,POINT (11360029 -72129595)
2012,Noviembre,Países Bajos,19,18,,37,POINT (1152863 -72919186)
2012,Noviembre,Países Bajos,8,37,,45,POINT (3451668 -76532004)
2012,Noviembre,Países Bajos,12,34,,46,POINT (445285 -75766353)
2012,Noviembre,Países Bajos,163,289,,452,POINT (4697157 -74140516)
2012,Noviembre,Países Bajos,0,1,,1,POINT (4815189 -75736374)
2012,Noviembre,Países Bajos,120,177,,297,POINT (6170465 -7542726)
2012,Noviembre,Países Bajos,27,24,,51,POINT (7128047 -73181317)
2012,Noviembre,Países Bajos,0,1,,1,POINT (7819 -72453013)
2012,Noviembre,Países Bajos,0,3,,3,POINT (7927233 -72508188)
2012,Noviembre,Pakistán,0,2,,2,POINT (0.81488 -77356)
2012,Noviembre,Pakistán,0,2,,2,POINT (10446304 -75516486)
2012,Noviembre,Pakistán,0,1,,1,POINT (3451668 -76532004)
2012,Noviembre,Pakistán,3,10,,13,POINT (4697157 -74140516)
2012,Noviembre,Pakistán,0,3,,3,POINT (6170465 -7542726)
2012,Noviembre,Panamá,0,1,,1,POINT (-4191162 -69941498)
2012,Noviembre,Panamá,0,2,,2,POINT (0.81488 -77356)
2012,Noviembre,Panamá,0,8,,8,POINT (10406342 -75527794)
2012,Noviembre,Panamá,178,214,,392,POINT (10446304 -75516486)
2012,Noviembre,Panamá,61,141,,202,POINT (10886686 -74776479)
2012,Noviembre,Panamá,0,2,,2,POINT (125744111 -81703935)
2012,Noviembre,Panamá,58,48,,106,POINT (125862 -81702165)
2012,Noviembre,Panamá,92,180,,272,POINT (3451668 -76532004)
2012,Noviembre,Panamá,444,687,,1131,POINT (4697157 -74140516)
2012,Noviembre,Panamá,51,69,,120,POINT (4815189 -75736374)
2012,Noviembre,Panamá,221,381,,602,POINT (6170465 -7542726)
2012,Noviembre,Panamá,1,2,,3,POINT (6222552 -77401154)
2012,Noviembre,Panamá,0,1,,1,POINT (7088729 -70740253)
2012,Noviembre,Panamá,4,9,,13,POINT (7128047 -73181317)
2012,Noviembre,Panamá,2,5,,7,POINT (7819 -72453013)
2012,Noviembre,Panamá,4,11,,15,POINT (7927233 -72508188)
2012,Noviembre,Panamá,2,2,,4,POINT (863337 -7735002)
2012,Noviembre,Papúa Nueva Guinea,0,1,,1,POINT (4697157 -74140516)
2012,Noviembre,Paraguay,2,0,,2,POINT (0.81488 -77356)
2012,Noviembre,Paraguay,41,22,,63,POINT (10446304 -75516486)
2012,Noviembre,Paraguay,1,2,,3,POINT (10886686 -74776479)
2012,Noviembre,Paraguay,3,1,,4,POINT (125862 -81702165)
2012,Noviembre,Paraguay,3,2,,5,POINT (3451668 -76532004)
2012,Noviembre,Paraguay,122,117,,239,POINT (4697157 -74140516)
2012,Noviembre,Paraguay,7,14,,21,POINT (6170465 -7542726)
2012,Noviembre,Paraguay,1,1,,2,POINT (7819 -72453013)
2012,Noviembre,Perú,25,38,,63,POINT (-4191162 -69941498)
2012,Noviembre,Perú,8,14,,22,POINT (0.33002 -76876446)
2012,Noviembre,Perú,114,313,,427,POINT (0.81488 -77356)
2012,Noviembre,Perú,0,1,,1,POINT (1800143 -78802679)
2012,Noviembre,Perú,1,6,,7,POINT (10406342 -75527794)
2012,Noviembre,Perú,129,119,,248,POINT (10446304 -75516486)
2012,Noviembre,Perú,28,39,,67,POINT (10886686 -74776479)
2012,Noviembre,Perú,0,6,,6,POINT (11247723 -74213989)
2012,Noviembre,Perú,5,33,,38,POINT (11360029 -72129595)
2012,Noviembre,Perú,189,123,,312,POINT (125862 -81702165)
2012,Noviembre,Perú,97,134,,231,POINT (3451668 -76532004)
2012,Noviembre,Perú,0,3,,3,POINT (3884426 -77061029)
2012,Noviembre,Perú,0,1,,1,POINT (445285 -75766353)
2012,Noviembre,Perú,2443,3204,,5647,POINT (4697157 -74140516)
2012,Noviembre,Perú,1,3,,4,POINT (4815189 -75736374)
2012,Noviembre,Perú,190,342,,532,POINT (6170465 -7542726)
2012,Noviembre,Perú,2,1,,3,POINT (6185536 -67484028)
2012,Noviembre,Perú,0,1,,1,POINT (7088729 -70740253)
2012,Noviembre,Perú,0,1,,1,POINT (7128047 -73181317)
2012,Noviembre,Perú,32,48,,80,POINT (7819 -72453013)
2012,Noviembre,Perú,1,0,,1,POINT (7927233 -72508188)
2012,Noviembre,Palestina,0,1,,1,POINT (6170465 -7542726)
2012,Noviembre,Polonia,13,2,,15,POINT (-4191162 -69941498)
2012,Noviembre,Polonia,2,4,,6,POINT (0.81488 -77356)
2012,Noviembre,Polonia,1,6,,7,POINT (10406342 -75527794)
2012,Noviembre,Polonia,8,5,,13,POINT (10446304 -75516486)
2012,Noviembre,Polonia,0,3,,3,POINT (10970933 -74765343)
2012,Noviembre,Polonia,2,4,,6,POINT (11360029 -72129595)
2012,Noviembre,Polonia,4,2,,6,POINT (3451668 -76532004)
2012,Noviembre,Polonia,0,1,,1,POINT (3884426 -77061029)
2012,Noviembre,Polonia,95,110,,205,POINT (4697157 -74140516)
2012,Noviembre,Polonia,2,3,,5,POINT (6170465 -7542726)
2012,Noviembre,Polonia,0,5,,5,POINT (7819 -72453013)
2012,Noviembre,Polonia,0,2,,2,POINT (7927233 -72508188)
2012,Noviembre,Polonia,0,1,,1,POINT (863337 -7735002)
2012,Noviembre,Portugal,1,1,,2,POINT (0.81488 -77356)
2012,Noviembre,Portugal,0,2,,2,POINT (10406342 -75527794)
2012,Noviembre,Portugal,2,5,,7,POINT (10446304 -75516486)
2012,Noviembre,Portugal,1,0,,1,POINT (10886686 -74776479)
2012,Noviembre,Portugal,0,1,,1,POINT (125862 -81702165)
2012,Noviembre,Portugal,3,9,,12,POINT (3451668 -76532004)
2012,Noviembre,Portugal,84,280,,364,POINT (4697157 -74140516)
2012,Noviembre,Portugal,1,0,,1,POINT (4815189 -75736374)
2012,Noviembre,Portugal,2,13,,15,POINT (6170465 -7542726)
2012,Noviembre,Portugal,2,3,,5,POINT (7819 -72453013)
2012,Noviembre,Portugal,0,2,,2,POINT (7927233 -72508188)
2012,Noviembre,Portugal,0,1,,1,POINT (863337 -7735002)
2012,Noviembre,Polinesia Francesa/Colectividad de Ultramar Francesa,0,1,,1,POINT (10406342 -75527794)
2012,Noviembre,Puerto Rico/Territorio de Estados Unidos,2,2,,4,POINT (10446304 -75516486)
2012,Noviembre,Puerto Rico/Territorio de Estados Unidos,1,0,,1,POINT (3451668 -76532004)
2012,Noviembre,Puerto Rico/Territorio de Estados Unidos,1,0,,1,POINT (6170465 -7542726)
2012,Noviembre,Qatar,0,1,,1,POINT (10446304 -75516486)
2012,Noviembre,Qatar,1,1,,2,POINT (4697157 -74140516)
2012,Noviembre,Reino Unido de Gran Bretaña e Irlanda del Norte,1,2,,3,POINT (-4191162 -69941498)
2012,Noviembre,Reino Unido de Gran Bretaña e Irlanda del Norte,4,5,,9,POINT (0.81488 -77356)
2012,Noviembre,Reino Unido de Gran Bretaña e Irlanda del Norte,10,24,,34,POINT (10446304 -75516486)
2012,Noviembre,Reino Unido de Gran Bretaña e Irlanda del Norte,0,3,,3,POINT (10886686 -74776479)
2012,Noviembre,Reino Unido de Gran Bretaña e Irlanda del Norte,0,4,,4,POINT (11360029 -72129595)
2012,Noviembre,Reino Unido de Gran Bretaña e Irlanda del Norte,0,1,,1,POINT (125862 -81702165)
2012,Noviembre,Reino Unido de Gran Bretaña e Irlanda del Norte,6,15,,21,POINT (3451668 -76532004)
2012,Noviembre,Reino Unido de Gran Bretaña e Irlanda del Norte,0,1,,1,POINT (445285 -75766353)
2012,Noviembre,Reino Unido de Gran Bretaña e Irlanda del Norte,186,493,,679,POINT (4697157 -74140516)
2012,Noviembre,Reino Unido de Gran Bretaña e Irlanda del Norte,10,35,,45,POINT (6170465 -7542726)
2012,Noviembre,Reino Unido de Gran Bretaña e Irlanda del Norte,0,2,,2,POINT (7819 -72453013)
2012,Noviembre,República CentroÁfricana,1,0,,1,POINT (4697157 -74140516)
2012,Noviembre,República de Belarús,1,2,,3,POINT (4697157 -74140516)
2012,Noviembre,República Dominicana,0,14,,14,POINT (0.81488 -77356)
2012,Noviembre,República Dominicana,74,45,,119,POINT (10446304 -75516486)
2012,Noviembre,República Dominicana,3,37,,40,POINT (10886686 -74776479)
2012,Noviembre,República Dominicana,0,2,,2,POINT (11360029 -72129595)
2012,Noviembre,República Dominicana,14,18,,32,POINT (3451668 -76532004)
2012,Noviembre,República Dominicana,1,2,,3,POINT (445285 -75766353)
2012,Noviembre,República Dominicana,294,382,,676,POINT (4697157 -74140516)
2012,Noviembre,República Dominicana,6,37,,43,POINT (4815189 -75736374)
2012,Noviembre,República Dominicana,31,41,,72,POINT (6170465 -7542726)
2012,Noviembre,República Dominicana,3,4,,7,POINT (7128047 -73181317)
2012,Noviembre,República Dominicana,1,0,,1,POINT (7819 -72453013)
2012,Noviembre,República Dominicana,9,14,,23,POINT (7927233 -72508188)
2012,Noviembre,República Checa,0,1,,1,POINT (10406342 -75527794)
2012,Noviembre,República Checa,0,1,,1,POINT (3451668 -76532004)
2012,Noviembre,República Checa,2,1,,3,POINT (4697157 -74140516)
2012,Noviembre,República Checa,1,0,,1,POINT (6170465 -7542726)
2012,Noviembre,República Checa,0,1,,1,POINT (7927233 -72508188)
2012,Noviembre,Rumania,1,0,,1,POINT (0.81488 -77356)
2012,Noviembre,Rumania,1,1,,2,POINT (10406342 -75527794)
2012,Noviembre,Rumania,9,8,,17,POINT (10446304 -75516486)
2012,Noviembre,Rumania,2,4,,6,POINT (3451668 -76532004)
2012,Noviembre,Rumania,22,54,,76,POINT (4697157 -74140516)
2012,Noviembre,Rumania,5,6,,11,POINT (6170465 -7542726)
2012,Noviembre,Rumania,0,1,,1,POINT (7819 -72453013)
2012,Noviembre,Rumania,0,1,,1,POINT (863337 -7735002)
2012,Noviembre,Federación de Rusia,3,2,,5,POINT (0.81488 -77356)
2012,Noviembre,Federación de Rusia,1,5,,6,POINT (10406342 -75527794)
2012,Noviembre,Federación de Rusia,5,1,,6,POINT (10446304 -75516486)
2012,Noviembre,Federación de Rusia,2,1,,3,POINT (10886686 -74776479)
2012,Noviembre,Federación de Rusia,3,2,,5,POINT (11360029 -72129595)
2012,Noviembre,Federación de Rusia,1,1,,2,POINT (3451668 -76532004)
2012,Noviembre,Federación de Rusia,37,50,,87,POINT (4697157 -74140516)
2012,Noviembre,Federación de Rusia,1,4,,5,POINT (6170465 -7542726)
2012,Noviembre,San Cristóbal y Nevis,2,1,,3,POINT (4697157 -74140516)
2012,Noviembre,San Cristóbal y Nevis,0,1,,1,POINT (6170465 -7542726)
2012,Noviembre,San  Vicente y las Granadinas,0,2,,2,POINT (4697157 -74140516)
2012,Noviembre,Santa Lucia,0,2,,2,POINT (10446304 -75516486)
2012,Noviembre,Santa Lucia,1,2,,3,POINT (4697157 -74140516)
2012,Noviembre,Santa Lucia,3,1,,4,POINT (7128047 -73181317)
2012,Noviembre,Senegal,0,1,,1,POINT (4697157 -74140516)
2012,Noviembre,Serbia,0,1,,1,POINT (3451668 -76532004)
2012,Noviembre,Serbia,2,6,,8,POINT (4697157 -74140516)
2012,Noviembre,Singapur,3,0,,3,POINT (10446304 -75516486)
2012,Noviembre,Singapur,13,22,,35,POINT (4697157 -74140516)
2012,Noviembre,Singapur,0,2,,2,POINT (6170465 -7542726)
2012,Noviembre,República Árabe Siria,0,2,,2,POINT (11360029 -72129595)
2012,Noviembre,República Árabe Siria,0,2,,2,POINT (4697157 -74140516)
2012,Noviembre,República Árabe Siria,0,1,,1,POINT (6170465 -7542726)
2012,Noviembre,República Árabe Siria,0,1,,1,POINT (7819 -72453013)
2012,Noviembre,Sri Lanka,0,1,,1,POINT (10406342 -75527794)
2012,Noviembre,Sri Lanka,0,1,,1,POINT (10446304 -75516486)
2012,Noviembre,Sri Lanka,1,0,,1,POINT (4697157 -74140516)
2012,Noviembre,Sudáfrica,0,1,,1,POINT (-4191162 -69941498)
2012,Noviembre,Sudáfrica,0,1,,1,POINT (0.81488 -77356)
2012,Noviembre,Sudáfrica,2,1,,3,POINT (10406342 -75527794)
2012,Noviembre,Sudáfrica,2,1,,3,POINT (10446304 -75516486)
2012,Noviembre,Sudáfrica,2,4,,6,POINT (10886686 -74776479)
2012,Noviembre,Sudáfrica,1,1,,2,POINT (3451668 -76532004)
2012,Noviembre,Sudáfrica,19,95,,114,POINT (4697157 -74140516)
2012,Noviembre,Sudáfrica,1,6,,7,POINT (6170465 -7542726)
2012,Noviembre,Sudán,3,1,,4,POINT (4697157 -74140516)
2012,Noviembre,Suecia,0,1,,1,POINT (-4191162 -69941498)
2012,Noviembre,Suecia,0,1,,1,POINT (0.33002 -76876446)
2012,Noviembre,Suecia,6,10,,16,POINT (0.81488 -77356)
2012,Noviembre,Suecia,6,13,,19,POINT (10406342 -75527794)
2012,Noviembre,Suecia,7,7,,14,POINT (10446304 -75516486)
2012,Noviembre,Suecia,0,3,,3,POINT (10886686 -74776479)
2012,Noviembre,Suecia,3,3,,6,POINT (11360029 -72129595)
2012,Noviembre,Suecia,0,1,,1,POINT (125862 -81702165)
2012,Noviembre,Suecia,11,12,,23,POINT (3451668 -76532004)
2012,Noviembre,Suecia,151,242,,393,POINT (4697157 -74140516)
2012,Noviembre,Suecia,11,14,,25,POINT (6170465 -7542726)
2012,Noviembre,Suecia,0,1,,1,POINT (7128047 -73181317)
2012,Noviembre,Suecia,0,1,,1,POINT (7819 -72453013)
2012,Noviembre,Suiza,3,9,,12,POINT (-4191162 -69941498)
2012,Noviembre,Suiza,12,13,,25,POINT (0.81488 -77356)
2012,Noviembre,Suiza,15,13,,28,POINT (10406342 -75527794)
2012,Noviembre,Suiza,8,12,,20,POINT (10446304 -75516486)
2012,Noviembre,Suiza,2,3,,5,POINT (10886686 -74776479)
2012,Noviembre,Suiza,1,1,,2,POINT (11247723 -74213989)
2012,Noviembre,Suiza,2,3,,5,POINT (11360029 -72129595)
2012,Noviembre,Suiza,0,2,,2,POINT (125862 -81702165)
2012,Noviembre,Suiza,1,0,,1,POINT (133387613 -81372937)
2012,Noviembre,Suiza,13,27,,40,POINT (3451668 -76532004)
2012,Noviembre,Suiza,236,469,,705,POINT (4697157 -74140516)
2012,Noviembre,Suiza,11,43,,54,POINT (6170465 -7542726)
2012,Noviembre,Suiza,1,2,,3,POINT (7819 -72453013)
2012,Noviembre,Suiza,1,1,,2,POINT (863337 -7735002)
2012,Noviembre,Surinam,1,0,,1,POINT (10886686 -74776479)
2012,Noviembre,Surinam,3,15,,18,POINT (4697157 -74140516)
2012,Noviembre,Surinam,21,18,,39,POINT (6170465 -7542726)
2012,Noviembre,Taiwán,0,2,,2,POINT (10446304 -75516486)
2012,Noviembre,Taiwán,2,1,,3,POINT (4697157 -74140516)
2012,Noviembre,Taiwán,1,0,,1,POINT (6170465 -7542726)
2012,Noviembre,Tailandia,1,0,,1,POINT (10446304 -75516486)
2012,Noviembre,Tailandia,1,0,,1,POINT (3451668 -76532004)
2012,Noviembre,Tailandia,6,4,,10,POINT (4697157 -74140516)
2012,Noviembre,Tailandia,0,1,,1,POINT (7819 -72453013)
2012,Noviembre,Tíbet/Región Autónoma de China,0,1,,1,POINT (4697157 -74140516)
2012,Noviembre,Territorio Antártico Británico/Territorio Británico de Ultramar,0,4,,4,POINT (4697157 -74140516)
2012,Noviembre,Territorio Antártico Británico/Territorio Británico de Ultramar,0,1,,1,POINT (6170465 -7542726)
2012,Noviembre,Territorio Antártico Británico/Territorio Británico de Ultramar,0,1,,1,POINT (7927233 -72508188)
2012,Noviembre,Tanzania,1,1,,2,POINT (4697157 -74140516)
2012,Noviembre,Togo,0,1,,1,POINT (10446304 -75516486)
2012,Noviembre,Trinidad y Tobago,7,8,,15,POINT (10446304 -75516486)
2012,Noviembre,Trinidad y Tobago,0,1,,1,POINT (10886686 -74776479)
2012,Noviembre,Trinidad y Tobago,0,4,,4,POINT (11247723 -74213989)
2012,Noviembre,Trinidad y Tobago,0,1,,1,POINT (11360029 -72129595)
2012,Noviembre,Trinidad y Tobago,1,27,,28,POINT (3451668 -76532004)
2012,Noviembre,Trinidad y Tobago,8,31,,39,POINT (4697157 -74140516)
2012,Noviembre,Trinidad y Tobago,0,10,,10,POINT (6170465 -7542726)
2012,Noviembre,Túnez,0,1,,1,POINT (0.81488 -77356)
2012,Noviembre,Túnez,1,0,,1,POINT (4697157 -74140516)
2012,Noviembre,Túnez,0,1,,1,POINT (6170465 -7542726)
2012,Noviembre,Turquía,1,1,,2,POINT (-4191162 -69941498)
2012,Noviembre,Turquía,0,1,,1,POINT (0.81488 -77356)
2012,Noviembre,Turquía,2,0,,2,POINT (10446304 -75516486)
2012,Noviembre,Turquía,0,3,,3,POINT (10886686 -74776479)
2012,Noviembre,Turquía,18,52,,70,POINT (4697157 -74140516)
2012,Noviembre,Turquía,0,8,,8,POINT (6170465 -7542726)
2012,Noviembre,Turquía,0,1,,1,POINT (6185536 -67484028)
2012,Noviembre,Turquía,0,1,,1,POINT (7819 -72453013)
2012,Noviembre,Ucrania,1,1,,2,POINT (10446304 -75516486)
2012,Noviembre,Ucrania,0,1,,1,POINT (10886686 -74776479)
2012,Noviembre,Ucrania,0,7,,7,POINT (3451668 -76532004)
2012,Noviembre,Ucrania,12,28,,40,POINT (4697157 -74140516)
2012,Noviembre,Ucrania,4,0,,4,POINT (6170465 -7542726)
2012,Noviembre,Ucrania,0,1,,1,POINT (7128047 -73181317)
2012,Noviembre,Uganda,3,1,,4,POINT (4697157 -74140516)
2012,Noviembre,Federación de Rusia,1,0,,1,POINT (-4191162 -69941498)
2012,Noviembre,Federación de Rusia,0,1,,1,POINT (0.81488 -77356)
2012,Noviembre,Federación de Rusia,1,1,,2,POINT (10406342 -75527794)
2012,Noviembre,Federación de Rusia,0,3,,3,POINT (10446304 -75516486)
2012,Noviembre,Federación de Rusia,0,1,,1,POINT (11360029 -72129595)
2012,Noviembre,Federación de Rusia,1,2,,3,POINT (3451668 -76532004)
2012,Noviembre,Federación de Rusia,95,141,,236,POINT (4697157 -74140516)
2012,Noviembre,Federación de Rusia,3,0,,3,POINT (6170465 -7542726)
2012,Noviembre,Federación de Rusia,1,0,,1,POINT (7819 -72453013)
2012,Noviembre,Uruguay,0,1,,1,POINT (-4191162 -69941498)
2012,Noviembre,Uruguay,3,7,,10,POINT (0.81488 -77356)
2012,Noviembre,Uruguay,93,65,,158,POINT (10446304 -75516486)
2012,Noviembre,Uruguay,1,11,,12,POINT (10886686 -74776479)
2012,Noviembre,Uruguay,19,13,,32,POINT (125862 -81702165)
2012,Noviembre,Uruguay,15,28,,43,POINT (3451668 -76532004)
2012,Noviembre,Uruguay,0,1,,1,POINT (445285 -75766353)
2012,Noviembre,Uruguay,120,277,,397,POINT (4697157 -74140516)
2012,Noviembre,Uruguay,1,0,,1,POINT (4815189 -75736374)
2012,Noviembre,Uruguay,19,42,,61,POINT (6170465 -7542726)
2012,Noviembre,Uruguay,1,6,,7,POINT (7819 -72453013)
2012,Noviembre,Uruguay,0,1,,1,POINT (7927233 -72508188)
2012,Noviembre,Uruguay,1,0,,1,POINT (863337 -7735002)
2012,Noviembre,Venezuela,2,4,,6,POINT (-4191162 -69941498)
2012,Noviembre,Venezuela,0,2,,2,POINT (0.33002 -76876446)
2012,Noviembre,Venezuela,36,64,,100,POINT (0.81488 -77356)
2012,Noviembre,Venezuela,3,5,,8,POINT (10406342 -75527794)
2012,Noviembre,Venezuela,72,90,,162,POINT (10446304 -75516486)
2012,Noviembre,Venezuela,27,63,,90,POINT (10886686 -74776479)
2012,Noviembre,Venezuela,0,5,,5,POINT (11117206 -74232675)
2012,Noviembre,Venezuela,0,2,,2,POINT (11247723 -74213989)
2012,Noviembre,Venezuela,749,1391,,2140,POINT (11360029 -72129595)
2012,Noviembre,Venezuela,0,1,,1,POINT (1152863 -72919186)
2012,Noviembre,Venezuela,16,10,,26,POINT (125862 -81702165)
2012,Noviembre,Venezuela,62,89,,151,POINT (3451668 -76532004)
2012,Noviembre,Venezuela,2,3,,5,POINT (445285 -75766353)
2012,Noviembre,Venezuela,5158,6676,,11834,POINT (4697157 -74140516)
2012,Noviembre,Venezuela,7,14,,21,POINT (4815189 -75736374)
2012,Noviembre,Venezuela,372,561,,933,POINT (6170465 -7542726)
2012,Noviembre,Venezuela,197,243,,440,POINT (6185536 -67484028)
2012,Noviembre,Venezuela,40,79,,119,POINT (7088729 -70740253)
2012,Noviembre,Venezuela,11,13,,24,POINT (7128047 -73181317)
2012,Noviembre,Venezuela,1063,1339,,2402,POINT (7819 -72453013)
2012,Noviembre,Venezuela,179,200,,379,POINT (7927233 -72508188)
2012,Noviembre,Venezuela,1,1,,2,POINT (863337 -7735002)
2012,Noviembre,Vietnam,0,5,,5,POINT (4697157 -74140516)
2012,Noviembre,República Árabe de Yemen,0,3,,3,POINT (4697157 -74140516)
2012,Noviembre,Yugoslavia,2,1,,3,POINT (4697157 -74140516)
2012,Noviembre,Zambia,0,1,,1,POINT (4697157 -74140516)
2012,Noviembre,Zimbabue,1,5,,6,POINT (4697157 -74140516)
2012,Noviembre,Zimbabue,0,1,,1,POINT (6170465 -7542726)
2012,Noviembre,Reino Unido de Gran Bretaña e Irlanda del Norte,4,7,,11,POINT (-4191162 -69941498)
2012,Noviembre,Reino Unido de Gran Bretaña e Irlanda del Norte,23,27,,50,POINT (0.81488 -77356)
2012,Noviembre,Reino Unido de Gran Bretaña e Irlanda del Norte,16,20,,36,POINT (10406342 -75527794)
2012,Noviembre,Reino Unido de Gran Bretaña e Irlanda del Norte,10,24,,34,POINT (10446304 -75516486)
2012,Noviembre,Reino Unido de Gran Bretaña e Irlanda del Norte,1,3,,4,POINT (10886686 -74776479)
2012,Noviembre,Reino Unido de Gran Bretaña e Irlanda del Norte,1,0,,1,POINT (11247723 -74213989)
2012,Noviembre,Reino Unido de Gran Bretaña e Irlanda del Norte,2,1,,3,POINT (11360029 -72129595)
2012,Noviembre,Reino Unido de Gran Bretaña e Irlanda del Norte,1,4,,5,POINT (125862 -81702165)
2012,Noviembre,Reino Unido de Gran Bretaña e Irlanda del Norte,5,23,,28,POINT (3451668 -76532004)
2012,Noviembre,Reino Unido de Gran Bretaña e Irlanda del Norte,1,0,,1,POINT (445285 -75766353)
2012,Noviembre,Reino Unido de Gran Bretaña e Irlanda del Norte,250,636,,886,POINT (4697157 -74140516)
2012,Noviembre,Reino Unido de Gran Bretaña e Irlanda del Norte,7,22,,29,POINT (6170465 -7542726)
2012,Noviembre,Reino Unido de Gran Bretaña e Irlanda del Norte,1,0,,1,POINT (7128047 -73181317)
2012,Noviembre,Reino Unido de Gran Bretaña e Irlanda del Norte,1,4,,5,POINT (7819 -72453013)
2012,Noviembre,Reino Unido de Gran Bretaña e Irlanda del Norte,1,0,,1,POINT (7927233 -72508188)
2012,Noviembre,Reino Unido de Gran Bretaña e Irlanda del Norte,1,5,,6,POINT (863337 -7735002)
2012,Noviembre,Países Bajos,1,6,,7,POINT (-4191162 -69941498)
2012,Noviembre,Países Bajos,11,8,,19,POINT (0.81488 -77356)
2012,Noviembre,Países Bajos,7,12,,19,POINT (10406342 -75527794)
2012,Noviembre,Países Bajos,11,28,,39,POINT (10446304 -75516486)
2012,Noviembre,Países Bajos,3,3,,6,POINT (10886686 -74776479)
2012,Noviembre,Países Bajos,1,1,,2,POINT (11247723 -74213989)
2012,Noviembre,Países Bajos,2,1,,3,POINT (11360029 -72129595)
2012,Noviembre,Países Bajos,1,0,,1,POINT (125862 -81702165)
2012,Noviembre,Países Bajos,11,45,,56,POINT (3451668 -76532004)
2012,Noviembre,Países Bajos,0,1,,1,POINT (3884426 -77061029)
2012,Noviembre,Países Bajos,2,1,,3,POINT (445285 -75766353)
2012,Noviembre,Países Bajos,317,680,,997,POINT (4697157 -74140516)
2012,Noviembre,Países Bajos,1,0,,1,POINT (4815189 -75736374)
2012,Noviembre,Países Bajos,100,168,,268,POINT (6170465 -7542726)
2012,Noviembre,Países Bajos,54,39,,93,POINT (7128047 -73181317)
2012,Noviembre,Países Bajos,1,9,,10,POINT (7819 -72453013)
2012,Noviembre,Países Bajos,1,1,,2,POINT (7927233 -72508188)
2012,Noviembre,Países Bajos,1,1,,2,POINT (863337 -7735002)
2012,Noviembre,Eslovenia,1,2,,3,POINT (4697157 -74140516)
2012,Noviembre,Lituania,2,2,,4,POINT (4697157 -74140516)
2012,Noviembre,Reino Unido de Gran Bretaña e Irlanda del Norte,2,2,,4,POINT (11247723 -74213989)
2012,Noviembre,Reino Unido de Gran Bretaña e Irlanda del Norte,4,4,,8,POINT (4697157 -74140516)
2012,Noviembre,Reino Unido de Gran Bretaña e Irlanda del Norte,0,1,,1,POINT (6170465 -7542726)
2012,Noviembre,Reino Unido de Gran Bretaña e Irlanda del Norte,0,1,,1,POINT (0.81488 -77356)
2012,Noviembre,Reino Unido de Gran Bretaña e Irlanda del Norte,8,0,,8,POINT (10406342 -75527794)
2012,Noviembre,Reino Unido de Gran Bretaña e Irlanda del Norte,0,1,,1,POINT (3451668 -76532004)
2012,Noviembre,Reino Unido de Gran Bretaña e Irlanda del Norte,7,19,,26,POINT (4697157 -74140516)
2012,Noviembre,Letonia,0,2,,2,POINT (10406342 -75527794)
2012,Noviembre,República CentroÁfricana,0,3,,3,POINT (4697157 -74140516)
2012,Diciembre,Afganistán,0,1,,1,POINT (4697157 -74140516)
2012,Diciembre,Albania,0,1,,1,POINT (0.81488 -77356)
2012,Diciembre,Albania,1,1,,2,POINT (10446304 -75516486)
2012,Diciembre,Albania,1,2,,3,POINT (4697157 -74140516)
2012,Diciembre,Alemania,13,13,,26,POINT (-4191162 -69941498)
2012,Diciembre,Alemania,1,1,,2,POINT (0.33002 -76876446)
2012,Diciembre,Alemania,52,72,,124,POINT (0.81488 -77356)
2012,Diciembre,Alemania,26,46,,72,POINT (10406342 -75527794)
2012,Diciembre,Alemania,46,87,,133,POINT (10446304 -75516486)
2012,Diciembre,Alemania,9,17,,26,POINT (10886686 -74776479)
2012,Diciembre,Alemania,2,2,,4,POINT (11247723 -74213989)
2012,Diciembre,Alemania,4,21,,25,POINT (11360029 -72129595)
2012,Diciembre,Alemania,4,4,,8,POINT (125862 -81702165)
2012,Diciembre,Alemania,42,67,,109,POINT (3451668 -76532004)
2012,Diciembre,Alemania,1412,2176,,3588,POINT (4697157 -74140516)
2012,Diciembre,Alemania,49,95,,144,POINT (6170465 -7542726)
2012,Diciembre,Alemania,2,0,,2,POINT (6185536 -67484028)
2012,Diciembre,Alemania,0,1,,1,POINT (6222552 -77401154)
2012,Diciembre,Alemania,11,14,,25,POINT (7819 -72453013)
2012,Diciembre,Alemania,7,9,,16,POINT (863337 -7735002)
2012,Diciembre,Andorra,0,1,,1,POINT (10886686 -74776479)
2012,Diciembre,Andorra,1,7,,8,POINT (4697157 -74140516)
2012,Diciembre,Angola,0,1,,1,POINT (4697157 -74140516)
2012,Diciembre,Antigua y Barbuda,0,1,,1,POINT (4697157 -74140516)
2012,Diciembre,Países Bajos,0,1,,1,POINT (6170465 -7542726)
2012,Diciembre,Arabia Saudita,0,1,,1,POINT (4697157 -74140516)
2012,Diciembre,Arabia Saudita,1,6,,7,POINT (10446304 -75516486)
2012,Diciembre,Arabia Saudita,0,7,,7,POINT (4697157 -74140516)
2012,Diciembre,Argelia,3,2,,5,POINT (4697157 -74140516)
2012,Diciembre,Argentina,1,1,,2,POINT (-4191162 -69941498)
2012,Diciembre,Argentina,53,95,,148,POINT (0.81488 -77356)
2012,Diciembre,Argentina,61,45,,106,POINT (10406342 -75527794)
2012,Diciembre,Argentina,512,412,,924,POINT (10446304 -75516486)
2012,Diciembre,Argentina,28,37,,65,POINT (10886686 -74776479)
2012,Diciembre,Argentina,21,30,,51,POINT (11360029 -72129595)
2012,Diciembre,Argentina,203,209,,412,POINT (125862 -81702165)
2012,Diciembre,Argentina,61,95,,156,POINT (3451668 -76532004)
2012,Diciembre,Argentina,0,1,,1,POINT (445285 -75766353)
2012,Diciembre,Argentina,2615,3678,,6293,POINT (4697157 -74140516)
2012,Diciembre,Argentina,3,4,,7,POINT (4815189 -75736374)
2012,Diciembre,Argentina,171,314,,485,POINT (6170465 -7542726)
2012,Diciembre,Argentina,0,1,,1,POINT (6222552 -77401154)
2012,Diciembre,Argentina,0,3,,3,POINT (7128047 -73181317)
2012,Diciembre,Argentina,22,41,,63,POINT (7819 -72453013)
2012,Diciembre,Argentina,4,5,,9,POINT (7927233 -72508188)
2012,Diciembre,Argentina,1,5,,6,POINT (863337 -7735002)
2012,Diciembre,República de Armenia,1,0,,1,POINT (0.81488 -77356)
2012,Diciembre,República de Armenia,2,0,,2,POINT (4697157 -74140516)
2012,Diciembre,Aruba,2,1,,3,POINT (4697157 -74140516)
2012,Diciembre,Aruba,2,3,,5,POINT (6170465 -7542726)
2012,Diciembre,Australia,8,8,,16,POINT (-4191162 -69941498)
2012,Diciembre,Australia,25,36,,61,POINT (0.81488 -77356)
2012,Diciembre,Australia,30,48,,78,POINT (10406342 -75527794)
2012,Diciembre,Australia,23,40,,63,POINT (10446304 -75516486)
2012,Diciembre,Australia,5,12,,17,POINT (10886686 -74776479)
2012,Diciembre,Australia,0,1,,1,POINT (11247723 -74213989)
2012,Diciembre,Australia,2,8,,10,POINT (11360029 -72129595)
2012,Diciembre,Australia,26,35,,61,POINT (3451668 -76532004)
2012,Diciembre,Australia,361,598,,959,POINT (4697157 -74140516)
2012,Diciembre,Australia,5,4,,9,POINT (4815189 -75736374)
2012,Diciembre,Australia,33,67,,100,POINT (6170465 -7542726)
2012,Diciembre,Australia,0,1,,1,POINT (7128047 -73181317)
2012,Diciembre,Australia,5,5,,10,POINT (7819 -72453013)
2012,Diciembre,Australia,7,2,,9,POINT (863337 -7735002)
2012,Diciembre,Austria,1,1,,2,POINT (-4191162 -69941498)
2012,Diciembre,Austria,4,3,,7,POINT (0.81488 -77356)
2012,Diciembre,Austria,1,3,,4,POINT (10406342 -75527794)
2012,Diciembre,Austria,11,20,,31,POINT (10446304 -75516486)
2012,Diciembre,Austria,2,1,,3,POINT (10886686 -74776479)
2012,Diciembre,Austria,1,1,,2,POINT (11247723 -74213989)
2012,Diciembre,Austria,2,5,,7,POINT (11360029 -72129595)
2012,Diciembre,Austria,3,5,,8,POINT (3451668 -76532004)
2012,Diciembre,Austria,132,241,,373,POINT (4697157 -74140516)
2012,Diciembre,Austria,5,8,,13,POINT (6170465 -7542726)
2012,Diciembre,Austria,2,0,,2,POINT (7819 -72453013)
2012,Diciembre,Austria,2,0,,2,POINT (7927233 -72508188)
2012,Diciembre,Austria,1,0,,1,POINT (863337 -7735002)
2012,Diciembre,Azerbaiyán,1,0,,1,POINT (10446304 -75516486)
2012,Diciembre,Azerbaiyán,0,1,,1,POINT (10970933 -74765343)
2012,Diciembre,Azerbaiyán,0,1,,1,POINT (4697157 -74140516)
2012,Diciembre,Bahamas,1,1,,2,POINT (10446304 -75516486)
2012,Diciembre,Bahamas,0,1,,1,POINT (3451668 -76532004)
2012,Diciembre,Bahamas,3,1,,4,POINT (4697157 -74140516)
2012,Diciembre,Bahamas,0,1,,1,POINT (4815189 -75736374)
2012,Diciembre,Bahamas,0,7,,7,POINT (6170465 -7542726)
2012,Diciembre,Bangladesh,0,1,,1,POINT (10446304 -75516486)
2012,Diciembre,Bangladesh,0,1,,1,POINT (4697157 -74140516)
2012,Diciembre,Barbados,1,0,,1,POINT (4697157 -74140516)
2012,Diciembre,Barbados,2,4,,6,POINT (6170465 -7542726)
2012,Diciembre,República de Belarús,0,1,,1,POINT (4697157 -74140516)
2012,Diciembre,Bélgica,0,1,,1,POINT (-4191162 -69941498)
2012,Diciembre,Bélgica,13,14,,27,POINT (0.81488 -77356)
2012,Diciembre,Bélgica,3,0,,3,POINT (10406342 -75527794)
2012,Diciembre,Bélgica,8,20,,28,POINT (10446304 -75516486)
2012,Diciembre,Bélgica,0,9,,9,POINT (10886686 -74776479)
2012,Diciembre,Bélgica,2,4,,6,POINT (11360029 -72129595)
2012,Diciembre,Bélgica,5,9,,14,POINT (3451668 -76532004)
2012,Diciembre,Bélgica,139,328,,467,POINT (4697157 -74140516)
2012,Diciembre,Bélgica,13,31,,44,POINT (6170465 -7542726)
2012,Diciembre,Bélgica,0,1,,1,POINT (7819 -72453013)
2012,Diciembre,Bélgica,2,1,,3,POINT (863337 -7735002)
2012,Diciembre,Belice,2,4,,6,POINT (10446304 -75516486)
2012,Diciembre,Belice,0,1,,1,POINT (10886686 -74776479)
2012,Diciembre,Belice,0,1,,1,POINT (11360029 -72129595)
2012,Diciembre,Belice,4,5,,9,POINT (4697157 -74140516)
2012,Diciembre,Bermudas/Territorio Británico de Ultramar,0,1,,1,POINT (10886686 -74776479)
2012,Diciembre,Bermudas/Territorio Británico de Ultramar,1,2,,3,POINT (4697157 -74140516)
2012,Diciembre,Bermudas/Territorio Británico de Ultramar,0,2,,2,POINT (6170465 -7542726)
2012,Diciembre,Bermudas/Territorio Británico de Ultramar,0,2,,2,POINT (7128047 -73181317)
2012,Diciembre,Bolivia,19,24,,43,POINT (0.81488 -77356)
2012,Diciembre,Bolivia,12,12,,24,POINT (10446304 -75516486)
2012,Diciembre,Bolivia,1,3,,4,POINT (10886686 -74776479)
2012,Diciembre,Bolivia,18,11,,29,POINT (125862 -81702165)
2012,Diciembre,Bolivia,8,9,,17,POINT (3451668 -76532004)
2012,Diciembre,Bolivia,384,454,,838,POINT (4697157 -74140516)
2012,Diciembre,Bolivia,15,21,,36,POINT (6170465 -7542726)
2012,Diciembre,Bolivia,3,8,,11,POINT (7819 -72453013)
2012,Diciembre,Bosnia y Herzegovina,0,1,,1,POINT (10446304 -75516486)
2012,Diciembre,Bosnia y Herzegovina,0,1,,1,POINT (4697157 -74140516)
2012,Diciembre,Brasil,83,68,,151,POINT (-4191162 -69941498)
2012,Diciembre,Brasil,9,17,,26,POINT (0.81488 -77356)
2012,Diciembre,Brasil,13,9,,22,POINT (10406342 -75527794)
2012,Diciembre,Brasil,203,156,,359,POINT (10446304 -75516486)
2012,Diciembre,Brasil,9,21,,30,POINT (10886686 -74776479)
2012,Diciembre,Brasil,18,24,,42,POINT (11360029 -72129595)
2012,Diciembre,Brasil,30,18,,48,POINT (125862 -81702165)
2012,Diciembre,Brasil,23,51,,74,POINT (3451668 -76532004)
2012,Diciembre,Brasil,0,1,,1,POINT (445285 -75766353)
2012,Diciembre,Brasil,2320,3022,,5342,POINT (4697157 -74140516)
2012,Diciembre,Brasil,1,1,,2,POINT (4815189 -75736374)
2012,Diciembre,Brasil,76,103,,179,POINT (6170465 -7542726)
2012,Diciembre,Brasil,0,1,,1,POINT (6185536 -67484028)
2012,Diciembre,Brasil,1,7,,8,POINT (7128047 -73181317)
2012,Diciembre,Brasil,9,18,,27,POINT (7819 -72453013)
2012,Diciembre,Brasil,5,10,,15,POINT (7927233 -72508188)
2012,Diciembre,Bulgaria,1,0,,1,POINT (0.81488 -77356)
2012,Diciembre,Bulgaria,1,0,,1,POINT (10446304 -75516486)
2012,Diciembre,Bulgaria,1,0,,1,POINT (3451668 -76532004)
2012,Diciembre,Bulgaria,8,12,,20,POINT (4697157 -74140516)
2012,Diciembre,Bulgaria,0,3,,3,POINT (6170465 -7542726)
2012,Diciembre,Cabo Verde,1,0,,1,POINT (4697157 -74140516)
2012,Diciembre,Islas Caimán/Territorio Británico de Ultramar,14,25,,39,POINT (125862 -81702165)
2012,Diciembre,Islas Caimán/Territorio Británico de Ultramar,0,1,,1,POINT (4697157 -74140516)
2012,Diciembre,Camboya,1,0,,1,POINT (3451668 -76532004)
2012,Diciembre,Camboya,1,0,,1,POINT (4697157 -74140516)
2012,Diciembre,Camerún,1,0,,1,POINT (0.81488 -77356)
2012,Diciembre,Camerún,0,2,,2,POINT (4697157 -74140516)
2012,Diciembre,Canadá,3,3,,6,POINT (-4191162 -69941498)
2012,Diciembre,Canadá,0,1,,1,POINT (0.33002 -76876446)
2012,Diciembre,Canadá,6,17,,23,POINT (0.81488 -77356)
2012,Diciembre,Canadá,19,29,,48,POINT (10406342 -75527794)
2012,Diciembre,Canadá,474,550,,1024,POINT (10446304 -75516486)
2012,Diciembre,Canadá,11,33,,44,POINT (10886686 -74776479)
2012,Diciembre,Canadá,3,2,,5,POINT (11247723 -74213989)
2012,Diciembre,Canadá,2,5,,7,POINT (11360029 -72129595)
2012,Diciembre,Canadá,158,172,,330,POINT (125862 -81702165)
2012,Diciembre,Canadá,2,3,,5,POINT (133387613 -81372937)
2012,Diciembre,Canadá,84,112,,196,POINT (3451668 -76532004)
2012,Diciembre,Canadá,18,19,,37,POINT (445285 -75766353)
2012,Diciembre,Canadá,1025,1823,,2848,POINT (4697157 -74140516)
2012,Diciembre,Canadá,3,5,,8,POINT (4815189 -75736374)
2012,Diciembre,Canadá,154,263,,417,POINT (6170465 -7542726)
2012,Diciembre,Canadá,3,10,,13,POINT (7128047 -73181317)
2012,Diciembre,Canadá,7,15,,22,POINT (7819 -72453013)
2012,Diciembre,Canadá,0,5,,5,POINT (7927233 -72508188)
2012,Diciembre,Canadá,6,11,,17,POINT (863337 -7735002)
2012,Diciembre,España,0,1,,1,POINT (0.33002 -76876446)
2012,Diciembre,España,7,14,,21,POINT (0.81488 -77356)
2012,Diciembre,España,3,6,,9,POINT (10406342 -75527794)
2012,Diciembre,España,7,6,,13,POINT (10446304 -75516486)
2012,Diciembre,España,3,17,,20,POINT (10886686 -74776479)
2012,Diciembre,España,0,3,,3,POINT (11247723 -74213989)
2012,Diciembre,España,0,1,,1,POINT (11360029 -72129595)
2012,Diciembre,España,1,0,,1,POINT (125862 -81702165)
2012,Diciembre,España,1,0,,1,POINT (133387613 -81372937)
2012,Diciembre,España,104,165,,269,POINT (3451668 -76532004)
2012,Diciembre,España,205,377,,582,POINT (4697157 -74140516)
2012,Diciembre,España,0,5,,5,POINT (4815189 -75736374)
2012,Diciembre,España,47,132,,179,POINT (6170465 -7542726)
2012,Diciembre,España,1,10,,11,POINT (7819 -72453013)
2012,Diciembre,España,0,2,,2,POINT (7927233 -72508188)
2012,Diciembre,España,1,0,,1,POINT (863337 -7735002)
2012,Diciembre,República Democrática del Congo,0,1,,1,POINT (4697157 -74140516)
2012,Diciembre,República de Corea,3,9,,12,POINT (0.81488 -77356)
2012,Diciembre,República de Corea,1,1,,2,POINT (10406342 -75527794)
2012,Diciembre,República de Corea,6,3,,9,POINT (10446304 -75516486)
2012,Diciembre,República de Corea,0,1,,1,POINT (11360029 -72129595)
2012,Diciembre,República de Corea,0,2,,2,POINT (125862 -81702165)
2012,Diciembre,República de Corea,2,4,,6,POINT (3451668 -76532004)
2012,Diciembre,República de Corea,176,400,,576,POINT (4697157 -74140516)
2012,Diciembre,República de Corea,3,13,,16,POINT (6170465 -7542726)
2012,Diciembre,República de Corea,2,5,,7,POINT (7819 -72453013)
2012,Diciembre,República de Corea,0,1,,1,POINT (863337 -7735002)
2012,Diciembre,Costa de Marfil,1,1,,2,POINT (4697157 -74140516)
2012,Diciembre,Costa Rica,1,0,,1,POINT (0.33002 -76876446)
2012,Diciembre,Costa Rica,1,2,,3,POINT (0.81488 -77356)
2012,Diciembre,Costa Rica,1,1,,2,POINT (10406342 -75527794)
2012,Diciembre,Costa Rica,65,64,,129,POINT (10446304 -75516486)
2012,Diciembre,Costa Rica,38,42,,80,POINT (10886686 -74776479)
2012,Diciembre,Costa Rica,0,3,,3,POINT (11360029 -72129595)
2012,Diciembre,Costa Rica,1,1,,2,POINT (125744111 -81703935)
2012,Diciembre,Costa Rica,363,286,,649,POINT (125862 -81702165)
2012,Diciembre,Costa Rica,40,55,,95,POINT (3451668 -76532004)
2012,Diciembre,Costa Rica,533,738,,1271,POINT (4697157 -74140516)
2012,Diciembre,Costa Rica,7,9,,16,POINT (4815189 -75736374)
2012,Diciembre,Costa Rica,191,216,,407,POINT (6170465 -7542726)
2012,Diciembre,Costa Rica,0,1,,1,POINT (7088729 -70740253)
2012,Diciembre,Costa Rica,5,4,,9,POINT (7128047 -73181317)
2012,Diciembre,Costa Rica,2,3,,5,POINT (7819 -72453013)
2012,Diciembre,Costa Rica,4,5,,9,POINT (7927233 -72508188)
2012,Diciembre,Costa Rica,1,1,,2,POINT (863337 -7735002)
2012,Diciembre,Croacia,1,5,,6,POINT (10406342 -75527794)
2012,Diciembre,Croacia,1,1,,2,POINT (10446304 -75516486)
2012,Diciembre,Croacia,0,1,,1,POINT (10886686 -74776479)
2012,Diciembre,Croacia,0,3,,3,POINT (3884426 -77061029)
2012,Diciembre,Croacia,10,19,,29,POINT (4697157 -74140516)
2012,Diciembre,Cuba,1,2,,3,POINT (-4191162 -69941498)
2012,Diciembre,Cuba,4,5,,9,POINT (0.81488 -77356)
2012,Diciembre,Cuba,1,1,,2,POINT (10406342 -75527794)
2012,Diciembre,Cuba,11,13,,24,POINT (10446304 -75516486)
2012,Diciembre,Cuba,4,10,,14,POINT (10886686 -74776479)
2012,Diciembre,Cuba,1,2,,3,POINT (11360029 -72129595)
2012,Diciembre,Cuba,1,0,,1,POINT (125862 -81702165)
2012,Diciembre,Cuba,13,45,,58,POINT (3451668 -76532004)
2012,Diciembre,Cuba,90,140,,230,POINT (4697157 -74140516)
2012,Diciembre,Cuba,1,1,,2,POINT (4815189 -75736374)
2012,Diciembre,Cuba,12,16,,28,POINT (6170465 -7542726)
2012,Diciembre,Cuba,0,6,,6,POINT (7128047 -73181317)
2012,Diciembre,Cuba,0,3,,3,POINT (7819 -72453013)
2012,Diciembre,Cuba,2,1,,3,POINT (7927233 -72508188)
2012,Diciembre,Curazao,4,3,,7,POINT (4697157 -74140516)
2012,Diciembre,Curazao,10,10,,20,POINT (6170465 -7542726)
2012,Diciembre,República Checa,1,2,,3,POINT (0.81488 -77356)
2012,Diciembre,República Checa,1,3,,4,POINT (10446304 -75516486)
2012,Diciembre,República Checa,0,1,,1,POINT (11360029 -72129595)
2012,Diciembre,República Checa,1,3,,4,POINT (125862 -81702165)
2012,Diciembre,República Checa,0,1,,1,POINT (3451668 -76532004)
2012,Diciembre,República Checa,31,29,,60,POINT (4697157 -74140516)
2012,Diciembre,República Checa,0,1,,1,POINT (6170465 -7542726)
2012,Diciembre,República Checa,0,3,,3,POINT (7819 -72453013)
2012,Diciembre,Chile,47,91,,138,POINT (0.81488 -77356)
2012,Diciembre,Chile,13,14,,27,POINT (10406342 -75527794)
2012,Diciembre,Chile,163,171,,334,POINT (10446304 -75516486)
2012,Diciembre,Chile,11,27,,38,POINT (10886686 -74776479)
2012,Diciembre,Chile,0,4,,4,POINT (11247723 -74213989)
2012,Diciembre,Chile,5,8,,13,POINT (11360029 -72129595)
2012,Diciembre,Chile,31,32,,63,POINT (125862 -81702165)
2012,Diciembre,Chile,52,92,,144,POINT (3451668 -76532004)
2012,Diciembre,Chile,1798,2925,,4723,POINT (4697157 -74140516)
2012,Diciembre,Chile,1,0,,1,POINT (4815189 -75736374)
2012,Diciembre,Chile,59,134,,193,POINT (6170465 -7542726)
2012,Diciembre,Chile,0,2,,2,POINT (6185536 -67484028)
2012,Diciembre,Chile,1,2,,3,POINT (7128047 -73181317)
2012,Diciembre,Chile,9,19,,28,POINT (7819 -72453013)
2012,Diciembre,Chile,2,5,,7,POINT (7927233 -72508188)
2012,Diciembre,Chile,2,2,,4,POINT (863337 -7735002)
2012,Diciembre,China,0,1,,1,POINT (-4191162 -69941498)
2012,Diciembre,China,2,4,,6,POINT (0.81488 -77356)
2012,Diciembre,China,7,4,,11,POINT (10406342 -75527794)
2012,Diciembre,China,2,2,,4,POINT (10446304 -75516486)
2012,Diciembre,China,1,6,,7,POINT (10886686 -74776479)
2012,Diciembre,China,0,1,,1,POINT (10970933 -74765343)
2012,Diciembre,China,0,3,,3,POINT (3451668 -76532004)
2012,Diciembre,China,0,1,,1,POINT (3884426 -77061029)
2012,Diciembre,China,149,357,,506,POINT (4697157 -74140516)
2012,Diciembre,China,2,6,,8,POINT (6170465 -7542726)
2012,Diciembre,China,2,0,,2,POINT (7819 -72453013)
2012,Diciembre,Taiwán,2,2,,4,POINT (0.81488 -77356)
2012,Diciembre,Taiwán,3,1,,4,POINT (10446304 -75516486)
2012,Diciembre,Taiwán,1,2,,3,POINT (10886686 -74776479)
2012,Diciembre,Taiwán,1,1,,2,POINT (125862 -81702165)
2012,Diciembre,Taiwán,2,3,,5,POINT (3451668 -76532004)
2012,Diciembre,Taiwán,33,58,,91,POINT (4697157 -74140516)
2012,Diciembre,Taiwán,0,1,,1,POINT (4815189 -75736374)
2012,Diciembre,Taiwán,4,1,,5,POINT (6170465 -7542726)
2012,Diciembre,Taiwán,2,1,,3,POINT (7819 -72453013)
2012,Diciembre,Taiwán,0,1,,1,POINT (7927233 -72508188)
2012,Diciembre,Chipre,1,7,,8,POINT (4697157 -74140516)
2012,Diciembre,Dinamarca,1,2,,3,POINT (-4191162 -69941498)
2012,Diciembre,Dinamarca,4,1,,5,POINT (0.81488 -77356)
2012,Diciembre,Dinamarca,1,2,,3,POINT (10406342 -75527794)
2012,Diciembre,Dinamarca,3,7,,10,POINT (10446304 -75516486)
2012,Diciembre,Dinamarca,0,1,,1,POINT (10886686 -74776479)
2012,Diciembre,Dinamarca,0,2,,2,POINT (11360029 -72129595)
2012,Diciembre,Dinamarca,3,6,,9,POINT (3451668 -76532004)
2012,Diciembre,Dinamarca,62,131,,193,POINT (4697157 -74140516)
2012,Diciembre,Dinamarca,0,4,,4,POINT (6170465 -7542726)
2012,Diciembre,Dinamarca,0,2,,2,POINT (7819 -72453013)
2012,Diciembre,Dominica,1,0,,1,POINT (11360029 -72129595)
2012,Diciembre,Dominica,0,1,,1,POINT (125862 -81702165)
2012,Diciembre,Dominica,1,1,,2,POINT (4697157 -74140516)
2012,Diciembre,Dominica,3,0,,3,POINT (863337 -7735002)
2012,Diciembre,Ecuador,1,3,,4,POINT (-4191162 -69941498)
2012,Diciembre,Ecuador,47,70,,117,POINT (0.33002 -76876446)
2012,Diciembre,Ecuador,1185,1973,,3158,POINT (0.81488 -77356)
2012,Diciembre,Ecuador,12,67,,79,POINT (1800143 -78802679)
2012,Diciembre,Ecuador,4,15,,19,POINT (10406342 -75527794)
2012,Diciembre,Ecuador,17,34,,51,POINT (10446304 -75516486)
2012,Diciembre,Ecuador,10,12,,22,POINT (10886686 -74776479)
2012,Diciembre,Ecuador,17,25,,42,POINT (11360029 -72129595)
2012,Diciembre,Ecuador,0,6,,6,POINT (125744111 -81703935)
2012,Diciembre,Ecuador,5,3,,8,POINT (125862 -81702165)
2012,Diciembre,Ecuador,308,383,,691,POINT (3451668 -76532004)
2012,Diciembre,Ecuador,0,1,,1,POINT (445285 -75766353)
2012,Diciembre,Ecuador,1829,2608,,4437,POINT (4697157 -74140516)
2012,Diciembre,Ecuador,0,3,,3,POINT (4815189 -75736374)
2012,Diciembre,Ecuador,475,513,,988,POINT (6170465 -7542726)
2012,Diciembre,Ecuador,0,1,,1,POINT (7088729 -70740253)
2012,Diciembre,Ecuador,4,4,,8,POINT (7128047 -73181317)
2012,Diciembre,Ecuador,250,355,,605,POINT (7819 -72453013)
2012,Diciembre,Ecuador,5,6,,11,POINT (7927233 -72508188)
2012,Diciembre,Ecuador,0,1,,1,POINT (863337 -7735002)
2012,Diciembre,Egipto,2,1,,3,POINT (10446304 -75516486)
2012,Diciembre,Egipto,0,1,,1,POINT (3451668 -76532004)
2012,Diciembre,Egipto,6,20,,26,POINT (4697157 -74140516)
2012,Diciembre,Egipto,0,1,,1,POINT (6170465 -7542726)
2012,Diciembre,El Salvador,0,1,,1,POINT (0.81488 -77356)
2012,Diciembre,El Salvador,8,14,,22,POINT (10446304 -75516486)
2012,Diciembre,El Salvador,2,6,,8,POINT (10886686 -74776479)
2012,Diciembre,El Salvador,1,1,,2,POINT (125862 -81702165)
2012,Diciembre,El Salvador,34,50,,84,POINT (3451668 -76532004)
2012,Diciembre,El Salvador,298,495,,793,POINT (4697157 -74140516)
2012,Diciembre,El Salvador,1,4,,5,POINT (4815189 -75736374)
2012,Diciembre,El Salvador,15,37,,52,POINT (6170465 -7542726)
2012,Diciembre,El Salvador,2,0,,2,POINT (7128047 -73181317)
2012,Diciembre,El Salvador,1,1,,2,POINT (7819 -72453013)
2012,Diciembre,El Salvador,0,1,,1,POINT (7927233 -72508188)
2012,Diciembre,El Salvador,0,1,,1,POINT (863337 -7735002)
2012,Diciembre,Emiratos Árabes,0,1,,1,POINT (10446304 -75516486)
2012,Diciembre,Emiratos Árabes,0,6,,6,POINT (4697157 -74140516)
2012,Diciembre,España,4,4,,8,POINT (-4191162 -69941498)
2012,Diciembre,España,33,42,,75,POINT (0.81488 -77356)
2012,Diciembre,España,10,14,,24,POINT (10406342 -75527794)
2012,Diciembre,España,50,94,,144,POINT (10446304 -75516486)
2012,Diciembre,España,3,14,,17,POINT (10886686 -74776479)
2012,Diciembre,España,6,14,,20,POINT (11360029 -72129595)
2012,Diciembre,España,0,1,,1,POINT (125744111 -81703935)
2012,Diciembre,España,2,6,,8,POINT (125862 -81702165)
2012,Diciembre,España,0,2,,2,POINT (133387613 -81372937)
2012,Diciembre,España,194,348,,542,POINT (3451668 -76532004)
2012,Diciembre,España,1894,4061,,5955,POINT (4697157 -74140516)
2012,Diciembre,España,2,5,,7,POINT (4815189 -75736374)
2012,Diciembre,España,88,212,,300,POINT (6170465 -7542726)
2012,Diciembre,España,1,1,,2,POINT (6185536 -67484028)
2012,Diciembre,España,0,2,,2,POINT (7128047 -73181317)
2012,Diciembre,España,18,37,,55,POINT (7819 -72453013)
2012,Diciembre,España,3,4,,7,POINT (7927233 -72508188)
2012,Diciembre,España,2,9,,11,POINT (863337 -7735002)
2012,Diciembre,Eritrea,0,1,,1,POINT (7819 -72453013)
2012,Diciembre,Eslovaquia,1,1,,2,POINT (0.81488 -77356)
2012,Diciembre,Eslovaquia,0,3,,3,POINT (10446304 -75516486)
2012,Diciembre,Eslovaquia,0,1,,1,POINT (10886686 -74776479)
2012,Diciembre,Eslovaquia,0,2,,2,POINT (11360029 -72129595)
2012,Diciembre,Eslovaquia,1,0,,1,POINT (3451668 -76532004)
2012,Diciembre,Eslovaquia,10,14,,24,POINT (4697157 -74140516)
2012,Diciembre,Eslovaquia,0,1,,1,POINT (6170465 -7542726)
2012,Diciembre,Eslovaquia,0,1,,1,POINT (7819 -72453013)
2012,Diciembre,Eslovenia,1,1,,2,POINT (0.81488 -77356)
2012,Diciembre,Eslovenia,0,3,,3,POINT (10406342 -75527794)
2012,Diciembre,Eslovenia,1,1,,2,POINT (11360029 -72129595)
2012,Diciembre,Eslovenia,5,18,,23,POINT (4697157 -74140516)
2012,Diciembre,Estados Unidos de América,10,6,,16,POINT (-4191162 -69941498)
2012,Diciembre,Estados Unidos de América,0,2,,2,POINT (0.33002 -76876446)
2012,Diciembre,Estados Unidos de América,35,86,,121,POINT (0.81488 -77356)
2012,Diciembre,Estados Unidos de América,1,0,,1,POINT (1800143 -78802679)
2012,Diciembre,Estados Unidos de América,39,81,,120,POINT (10406342 -75527794)
2012,Diciembre,Estados Unidos de América,1358,2295,,3653,POINT (10446304 -75516486)
2012,Diciembre,Estados Unidos de América,512,792,,1304,POINT (10886686 -74776479)
2012,Diciembre,Estados Unidos de América,3,3,,6,POINT (11247723 -74213989)
2012,Diciembre,Estados Unidos de América,5,20,,25,POINT (11360029 -72129595)
2012,Diciembre,Estados Unidos de América,4,1,,5,POINT (1152863 -72919186)
2012,Diciembre,Estados Unidos de América,3,11,,14,POINT (125744111 -81703935)
2012,Diciembre,Estados Unidos de América,31,66,,97,POINT (125862 -81702165)
2012,Diciembre,Estados Unidos de América,6,4,,10,POINT (133387613 -81372937)
2012,Diciembre,Estados Unidos de América,1226,1926,,3152,POINT (3451668 -76532004)
2012,Diciembre,Estados Unidos de América,100,133,,233,POINT (445285 -75766353)
2012,Diciembre,Estados Unidos de América,7533,13426,,20959,POINT (4697157 -74140516)
2012,Diciembre,Estados Unidos de América,162,217,,379,POINT (4815189 -75736374)
2012,Diciembre,Estados Unidos de América,1677,3139,,4816,POINT (6170465 -7542726)
2012,Diciembre,Estados Unidos de América,0,1,,1,POINT (6222552 -77401154)
2012,Diciembre,Estados Unidos de América,1,1,,2,POINT (7088729 -70740253)
2012,Diciembre,Estados Unidos de América,60,83,,143,POINT (7128047 -73181317)
2012,Diciembre,Estados Unidos de América,28,47,,75,POINT (7819 -72453013)
2012,Diciembre,Estados Unidos de América,53,80,,133,POINT (7927233 -72508188)
2012,Diciembre,Estados Unidos de América,6,9,,15,POINT (863337 -7735002)
2012,Diciembre,Estonia,0,2,,2,POINT (10446304 -75516486)
2012,Diciembre,Estonia,0,1,,1,POINT (3451668 -76532004)
2012,Diciembre,Estonia,6,8,,14,POINT (4697157 -74140516)
2012,Diciembre,Etiopia,1,2,,3,POINT (4697157 -74140516)
2012,Diciembre,Filipinas,0,1,,1,POINT (0.81488 -77356)
2012,Diciembre,Filipinas,0,32,,32,POINT (10406342 -75527794)
2012,Diciembre,Filipinas,0,15,,15,POINT (10446304 -75516486)
2012,Diciembre,Filipinas,0,4,,4,POINT (10886686 -74776479)
2012,Diciembre,Filipinas,0,18,,18,POINT (10970933 -74765343)
2012,Diciembre,Filipinas,0,7,,7,POINT (11247723 -74213989)
2012,Diciembre,Filipinas,0,8,,8,POINT (3451668 -76532004)
2012,Diciembre,Filipinas,0,19,,19,POINT (3884426 -77061029)
2012,Diciembre,Filipinas,11,57,,68,POINT (4697157 -74140516)
2012,Diciembre,Filipinas,0,2,,2,POINT (9402597 -75681642)
2012,Diciembre,Finlandia,1,2,,3,POINT (0.81488 -77356)
2012,Diciembre,Finlandia,0,3,,3,POINT (10406342 -75527794)
2012,Diciembre,Finlandia,3,7,,10,POINT (10446304 -75516486)
2012,Diciembre,Finlandia,0,1,,1,POINT (3451668 -76532004)
2012,Diciembre,Finlandia,55,90,,145,POINT (4697157 -74140516)
2012,Diciembre,Finlandia,8,5,,13,POINT (6170465 -7542726)
2012,Diciembre,Finlandia,0,1,,1,POINT (7128047 -73181317)
2012,Diciembre,Francia,3,7,,10,POINT (-4191162 -69941498)
2012,Diciembre,Francia,0,1,,1,POINT (0.33002 -76876446)
2012,Diciembre,Francia,33,51,,84,POINT (0.81488 -77356)
2012,Diciembre,Francia,10,13,,23,POINT (10406342 -75527794)
2012,Diciembre,Francia,33,63,,96,POINT (10446304 -75516486)
2012,Diciembre,Francia,2,8,,10,POINT (10886686 -74776479)
2012,Diciembre,Francia,5,2,,7,POINT (11247723 -74213989)
2012,Diciembre,Francia,5,10,,15,POINT (11360029 -72129595)
2012,Diciembre,Francia,1,1,,2,POINT (125744111 -81703935)
2012,Diciembre,Francia,1,2,,3,POINT (125862 -81702165)
2012,Diciembre,Francia,2,3,,5,POINT (133387613 -81372937)
2012,Diciembre,Francia,37,71,,108,POINT (3451668 -76532004)
2012,Diciembre,Francia,1112,2054,,3166,POINT (4697157 -74140516)
2012,Diciembre,Francia,2,3,,5,POINT (4815189 -75736374)
2012,Diciembre,Francia,25,70,,95,POINT (6170465 -7542726)
2012,Diciembre,Francia,1,3,,4,POINT (7128047 -73181317)
2012,Diciembre,Francia,9,17,,26,POINT (7819 -72453013)
2012,Diciembre,Francia,0,2,,2,POINT (7927233 -72508188)
2012,Diciembre,Francia,6,15,,21,POINT (863337 -7735002)
2012,Diciembre,Gabón,0,1,,1,POINT (4697157 -74140516)
2012,Diciembre,Gambia,0,1,,1,POINT (3451668 -76532004)
2012,Diciembre,Georgia,0,1,,1,POINT (4697157 -74140516)
2012,Diciembre,Ghana,1,3,,4,POINT (4697157 -74140516)
2012,Diciembre,Ghana,0,1,,1,POINT (6170465 -7542726)
2012,Diciembre,Ghana,0,2,,2,POINT (7819 -72453013)
2012,Diciembre,Granada,0,1,,1,POINT (7927233 -72508188)
2012,Diciembre,Grecia,1,0,,1,POINT (-4191162 -69941498)
2012,Diciembre,Grecia,0,1,,1,POINT (0.33002 -76876446)
2012,Diciembre,Grecia,2,1,,3,POINT (0.81488 -77356)
2012,Diciembre,Grecia,0,8,,8,POINT (10406342 -75527794)
2012,Diciembre,Grecia,0,6,,6,POINT (10446304 -75516486)
2012,Diciembre,Grecia,0,1,,1,POINT (11360029 -72129595)
2012,Diciembre,Grecia,29,51,,80,POINT (4697157 -74140516)
2012,Diciembre,Grecia,0,3,,3,POINT (6170465 -7542726)
2012,Diciembre,Grecia,0,2,,2,POINT (7819 -72453013)
2012,Diciembre,Guatemala,1,3,,4,POINT (0.81488 -77356)
2012,Diciembre,Guatemala,2,3,,5,POINT (10406342 -75527794)
2012,Diciembre,Guatemala,41,40,,81,POINT (10446304 -75516486)
2012,Diciembre,Guatemala,1,11,,12,POINT (10886686 -74776479)
2012,Diciembre,Guatemala,10,11,,21,POINT (125862 -81702165)
2012,Diciembre,Guatemala,36,58,,94,POINT (3451668 -76532004)
2012,Diciembre,Guatemala,0,2,,2,POINT (445285 -75766353)
2012,Diciembre,Guatemala,162,303,,465,POINT (4697157 -74140516)
2012,Diciembre,Guatemala,2,8,,10,POINT (4815189 -75736374)
2012,Diciembre,Guatemala,46,80,,126,POINT (6170465 -7542726)
2012,Diciembre,Guatemala,1,0,,1,POINT (7128047 -73181317)
2012,Diciembre,Guatemala,7,13,,20,POINT (7819 -72453013)
2012,Diciembre,Guatemala,1,6,,7,POINT (7927233 -72508188)
2012,Diciembre,Guyana,0,2,,2,POINT (0.81488 -77356)
2012,Diciembre,Guyana,0,1,,1,POINT (10446304 -75516486)
2012,Diciembre,Guyana,3,1,,4,POINT (10886686 -74776479)
2012,Diciembre,Guyana,0,1,,1,POINT (11360029 -72129595)
2012,Diciembre,Guyana,0,1,,1,POINT (125862 -81702165)
2012,Diciembre,Guyana,0,1,,1,POINT (3451668 -76532004)
2012,Diciembre,Guyana,1,3,,4,POINT (4697157 -74140516)
2012,Diciembre,Guyana,1,2,,3,POINT (6170465 -7542726)
2012,Diciembre,Guyana,1,0,,1,POINT (7128047 -73181317)
2012,Diciembre,Guinea Bissau,0,1,,1,POINT (7819 -72453013)
2012,Diciembre,Guinea Bissau,0,1,,1,POINT (7927233 -72508188)
2012,Diciembre,Haití,0,1,,1,POINT (0.81488 -77356)
2012,Diciembre,Haití,0,1,,1,POINT (10406342 -75527794)
2012,Diciembre,Haití,0,2,,2,POINT (10446304 -75516486)
2012,Diciembre,Haití,2,0,,2,POINT (10886686 -74776479)
2012,Diciembre,Haití,13,16,,29,POINT (4697157 -74140516)
2012,Diciembre,Haití,3,6,,9,POINT (6170465 -7542726)
2012,Diciembre,Honduras,2,1,,3,POINT (0.81488 -77356)
2012,Diciembre,Honduras,0,1,,1,POINT (10406342 -75527794)
2012,Diciembre,Honduras,9,11,,20,POINT (10446304 -75516486)
2012,Diciembre,Honduras,1,5,,6,POINT (10886686 -74776479)
2012,Diciembre,Honduras,0,2,,2,POINT (10970933 -74765343)
2012,Diciembre,Honduras,0,2,,2,POINT (11360029 -72129595)
2012,Diciembre,Honduras,0,27,,27,POINT (125744111 -81703935)
2012,Diciembre,Honduras,2,4,,6,POINT (125862 -81702165)
2012,Diciembre,Honduras,20,26,,46,POINT (3451668 -76532004)
2012,Diciembre,Honduras,1,0,,1,POINT (445285 -75766353)
2012,Diciembre,Honduras,103,138,,241,POINT (4697157 -74140516)
2012,Diciembre,Honduras,0,2,,2,POINT (4815189 -75736374)
2012,Diciembre,Honduras,26,40,,66,POINT (6170465 -7542726)
2012,Diciembre,Honduras,0,1,,1,POINT (7128047 -73181317)
2012,Diciembre,Honduras,1,2,,3,POINT (7927233 -72508188)
2012,Diciembre,Honduras,0,1,,1,POINT (806667 -767333)
2012,Diciembre,Hungría,0,1,,1,POINT (0.81488 -77356)
2012,Diciembre,Hungría,0,1,,1,POINT (3451668 -76532004)
2012,Diciembre,Hungría,20,27,,47,POINT (4697157 -74140516)
2012,Diciembre,Hungría,1,0,,1,POINT (6170465 -7542726)
2012,Diciembre,Hungría,0,1,,1,POINT (863337 -7735002)
2012,Diciembre,India,0,2,,2,POINT (0.81488 -77356)
2012,Diciembre,India,2,5,,7,POINT (10446304 -75516486)
2012,Diciembre,India,0,3,,3,POINT (10886686 -74776479)
2012,Diciembre,India,0,1,,1,POINT (11247723 -74213989)
2012,Diciembre,India,1,17,,18,POINT (3451668 -76532004)
2012,Diciembre,India,0,14,,14,POINT (3884426 -77061029)
2012,Diciembre,India,28,218,,246,POINT (4697157 -74140516)
2012,Diciembre,India,0,2,,2,POINT (4815189 -75736374)
2012,Diciembre,India,3,16,,19,POINT (6170465 -7542726)
2012,Diciembre,India,0,1,,1,POINT (7927233 -72508188)
2012,Diciembre,Indonesia,0,1,,1,POINT (10406342 -75527794)
2012,Diciembre,Indonesia,9,17,,26,POINT (4697157 -74140516)
2012,Diciembre,Indonesia,2,1,,3,POINT (6170465 -7542726)
2012,Diciembre,Indonesia,0,7,,7,POINT (7819 -72453013)
2012,Diciembre,Irán,12,24,,36,POINT (4697157 -74140516)
2012,Diciembre,Irán,1,0,,1,POINT (7819 -72453013)
2012,Diciembre,República de Irlanda,0,1,,1,POINT (-4191162 -69941498)
2012,Diciembre,República de Irlanda,12,10,,22,POINT (0.81488 -77356)
2012,Diciembre,República de Irlanda,0,2,,2,POINT (10406342 -75527794)
2012,Diciembre,República de Irlanda,6,7,,13,POINT (10446304 -75516486)
2012,Diciembre,República de Irlanda,1,2,,3,POINT (11360029 -72129595)
2012,Diciembre,República de Irlanda,2,6,,8,POINT (3451668 -76532004)
2012,Diciembre,República de Irlanda,52,120,,172,POINT (4697157 -74140516)
2012,Diciembre,República de Irlanda,0,1,,1,POINT (4815189 -75736374)
2012,Diciembre,República de Irlanda,6,8,,14,POINT (6170465 -7542726)
2012,Diciembre,República de Irlanda,1,1,,2,POINT (7819 -72453013)
2012,Diciembre,República de Irlanda,0,1,,1,POINT (7927233 -72508188)
2012,Diciembre,Islandia,2,1,,3,POINT (0.81488 -77356)
2012,Diciembre,Islandia,1,3,,4,POINT (10446304 -75516486)
2012,Diciembre,Islandia,0,1,,1,POINT (11247723 -74213989)
2012,Diciembre,Islandia,0,1,,1,POINT (3451668 -76532004)
2012,Diciembre,Islandia,7,6,,13,POINT (4697157 -74140516)
2012,Diciembre,Islandia,0,2,,2,POINT (6170465 -7542726)
2012,Diciembre,Islandia,0,1,,1,POINT (7819 -72453013)
2012,Diciembre,Isla de Man,10,16,,26,POINT (0.81488 -77356)
2012,Diciembre,Isla de Man,8,21,,29,POINT (10446304 -75516486)
2012,Diciembre,Isla de Man,5,6,,11,POINT (10886686 -74776479)
2012,Diciembre,Isla de Man,10,22,,32,POINT (3451668 -76532004)
2012,Diciembre,Isla de Man,1,1,,2,POINT (445285 -75766353)
2012,Diciembre,Isla de Man,55,132,,187,POINT (4697157 -74140516)
2012,Diciembre,Isla de Man,0,1,,1,POINT (4815189 -75736374)
2012,Diciembre,Isla de Man,15,60,,75,POINT (6170465 -7542726)
2012,Diciembre,Isla de Man,0,2,,2,POINT (7927233 -72508188)
2012,Diciembre,Isla Johnston,1,0,,1,POINT (4697157 -74140516)
2012,Diciembre,Israel,2,4,,6,POINT (0.81488 -77356)
2012,Diciembre,Israel,0,4,,4,POINT (10406342 -75527794)
2012,Diciembre,Israel,12,27,,39,POINT (10446304 -75516486)
2012,Diciembre,Israel,0,5,,5,POINT (10886686 -74776479)
2012,Diciembre,Israel,1,0,,1,POINT (11247723 -74213989)
2012,Diciembre,Israel,3,15,,18,POINT (3451668 -76532004)
2012,Diciembre,Israel,1,0,,1,POINT (445285 -75766353)
2012,Diciembre,Israel,53,282,,335,POINT (4697157 -74140516)
2012,Diciembre,Israel,7,34,,41,POINT (6170465 -7542726)
2012,Diciembre,Israel,0,1,,1,POINT (7927233 -72508188)
2012,Diciembre,Israel,0,1,,1,POINT (863337 -7735002)
2012,Diciembre,Islas Aland/Provincia de Finlandia,0,1,,1,POINT (4697157 -74140516)
2012,Diciembre,Italia,0,5,,5,POINT (-4191162 -69941498)
2012,Diciembre,Italia,7,27,,34,POINT (0.81488 -77356)
2012,Diciembre,Italia,7,16,,23,POINT (10406342 -75527794)
2012,Diciembre,Italia,39,128,,167,POINT (10446304 -75516486)
2012,Diciembre,Italia,6,16,,22,POINT (10886686 -74776479)
2012,Diciembre,Italia,0,10,,10,POINT (11247723 -74213989)
2012,Diciembre,Italia,9,17,,26,POINT (11360029 -72129595)
2012,Diciembre,Italia,0,1,,1,POINT (125744111 -81703935)
2012,Diciembre,Italia,11,8,,19,POINT (125862 -81702165)
2012,Diciembre,Italia,1,2,,3,POINT (133387613 -81372937)
2012,Diciembre,Italia,25,95,,120,POINT (3451668 -76532004)
2012,Diciembre,Italia,562,1668,,2230,POINT (4697157 -74140516)
2012,Diciembre,Italia,0,3,,3,POINT (4815189 -75736374)
2012,Diciembre,Italia,30,106,,136,POINT (6170465 -7542726)
2012,Diciembre,Italia,0,1,,1,POINT (6222552 -77401154)
2012,Diciembre,Italia,3,3,,6,POINT (7128047 -73181317)
2012,Diciembre,Italia,11,17,,28,POINT (7819 -72453013)
2012,Diciembre,Italia,5,2,,7,POINT (7927233 -72508188)
2012,Diciembre,Italia,2,2,,4,POINT (863337 -7735002)
2012,Diciembre,Islas del Canal,0,1,,1,POINT (10446304 -75516486)
2012,Diciembre,Islas del Canal,0,2,,2,POINT (4815189 -75736374)
2012,Diciembre,Jamaica,2,2,,4,POINT (10446304 -75516486)
2012,Diciembre,Jamaica,1,3,,4,POINT (10886686 -74776479)
2012,Diciembre,Jamaica,4,5,,9,POINT (125862 -81702165)
2012,Diciembre,Jamaica,1,2,,3,POINT (3451668 -76532004)
2012,Diciembre,Jamaica,6,22,,28,POINT (4697157 -74140516)
2012,Diciembre,Jamaica,0,1,,1,POINT (4815189 -75736374)
2012,Diciembre,Jamaica,2,7,,9,POINT (6170465 -7542726)
2012,Diciembre,Japón,6,10,,16,POINT (0.81488 -77356)
2012,Diciembre,Japón,4,5,,9,POINT (10446304 -75516486)
2012,Diciembre,Japón,0,6,,6,POINT (10886686 -74776479)
2012,Diciembre,Japón,0,2,,2,POINT (11360029 -72129595)
2012,Diciembre,Japón,1,2,,3,POINT (125862 -81702165)
2012,Diciembre,Japón,9,14,,23,POINT (3451668 -76532004)
2012,Diciembre,Japón,154,323,,477,POINT (4697157 -74140516)
2012,Diciembre,Japón,1,2,,3,POINT (4815189 -75736374)
2012,Diciembre,Japón,6,26,,32,POINT (6170465 -7542726)
2012,Diciembre,Japón,3,5,,8,POINT (7819 -72453013)
2012,Diciembre,Japón,0,1,,1,POINT (863337 -7735002)
2012,Diciembre,Jordania,5,6,,11,POINT (4697157 -74140516)
2012,Diciembre,Kazajistán,1,2,,3,POINT (4697157 -74140516)
2012,Diciembre,Kazajistán,1,0,,1,POINT (6170465 -7542726)
2012,Diciembre,Kenia,0,1,,1,POINT (11360029 -72129595)
2012,Diciembre,Kenia,2,6,,8,POINT (4697157 -74140516)
2012,Diciembre,Kirguistán,0,1,,1,POINT (4697157 -74140516)
2012,Diciembre,Kuwait,0,6,,6,POINT (4697157 -74140516)
2012,Diciembre,Letonia,0,1,,1,POINT (10406342 -75527794)
2012,Diciembre,Letonia,0,3,,3,POINT (10970933 -74765343)
2012,Diciembre,Letonia,0,1,,1,POINT (3884426 -77061029)
2012,Diciembre,Letonia,7,6,,13,POINT (4697157 -74140516)
2012,Diciembre,Letonia,3,4,,7,POINT (6170465 -7542726)
2012,Diciembre,Lituania,0,1,,1,POINT (10446304 -75516486)
2012,Diciembre,Lituania,1,0,,1,POINT (3451668 -76532004)
2012,Diciembre,Lituania,11,8,,19,POINT (4697157 -74140516)
2012,Diciembre,Lituania,1,1,,2,POINT (6170465 -7542726)
2012,Diciembre,Líbano,1,0,,1,POINT (0.81488 -77356)
2012,Diciembre,Líbano,0,2,,2,POINT (10446304 -75516486)
2012,Diciembre,Líbano,1,1,,2,POINT (10886686 -74776479)
2012,Diciembre,Líbano,5,3,,8,POINT (11360029 -72129595)
2012,Diciembre,Líbano,10,28,,38,POINT (4697157 -74140516)
2012,Diciembre,Líbano,0,1,,1,POINT (7819 -72453013)
2012,Diciembre,Libia,0,7,,7,POINT (4697157 -74140516)
2012,Diciembre,Liechtenstein,4,6,,10,POINT (4697157 -74140516)
2012,Diciembre,Luxemburgo,4,12,,16,POINT (4697157 -74140516)
2012,Diciembre,Luxemburgo,1,0,,1,POINT (7819 -72453013)
2012,Diciembre,Luxemburgo,0,1,,1,POINT (863337 -7735002)
2012,Diciembre,Macedonia,1,0,,1,POINT (4697157 -74140516)
2012,Diciembre,Madagascar,0,1,,1,POINT (3451668 -76532004)
2012,Diciembre,Malasia,1,0,,1,POINT (-4191162 -69941498)
2012,Diciembre,Malasia,0,2,,2,POINT (10446304 -75516486)
2012,Diciembre,Malasia,9,23,,32,POINT (4697157 -74140516)
2012,Diciembre,Malasia,1,2,,3,POINT (6170465 -7542726)
2012,Diciembre,Malta,0,1,,1,POINT (10446304 -75516486)
2012,Diciembre,Malta,1,4,,5,POINT (4697157 -74140516)
2012,Diciembre,Marruecos,0,6,,6,POINT (4697157 -74140516)
2012,Diciembre,Mauricio,1,2,,3,POINT (4697157 -74140516)
2012,Diciembre,Mauritania,0,1,,1,POINT (10446304 -75516486)
2012,Diciembre,México,0,1,,1,POINT (-4191162 -69941498)
2012,Diciembre,México,0,2,,2,POINT (0.33002 -76876446)
2012,Diciembre,México,23,27,,50,POINT (0.81488 -77356)
2012,Diciembre,México,9,6,,15,POINT (10406342 -75527794)
2012,Diciembre,México,195,250,,445,POINT (10446304 -75516486)
2012,Diciembre,México,23,70,,93,POINT (10886686 -74776479)
2012,Diciembre,México,4,9,,13,POINT (11360029 -72129595)
2012,Diciembre,México,3,3,,6,POINT (125862 -81702165)
2012,Diciembre,México,88,164,,252,POINT (3451668 -76532004)
2012,Diciembre,México,2107,3995,,6102,POINT (4697157 -74140516)
2012,Diciembre,México,9,19,,28,POINT (4815189 -75736374)
2012,Diciembre,México,151,316,,467,POINT (6170465 -7542726)
2012,Diciembre,México,1,0,,1,POINT (6185536 -67484028)
2012,Diciembre,México,0,1,,1,POINT (7088729 -70740253)
2012,Diciembre,México,16,17,,33,POINT (7128047 -73181317)
2012,Diciembre,México,7,31,,38,POINT (7819 -72453013)
2012,Diciembre,México,13,42,,55,POINT (7927233 -72508188)
2012,Diciembre,México,2,5,,7,POINT (863337 -7735002)
2012,Diciembre,República de Moldavia,1,0,,1,POINT (3451668 -76532004)
2012,Diciembre,República de Moldavia,0,1,,1,POINT (4697157 -74140516)
2012,Diciembre,Mónaco,3,0,,3,POINT (4697157 -74140516)
2012,Diciembre,Mongolia,1,0,,1,POINT (4697157 -74140516)
2012,Diciembre,Montenegro,0,1,,1,POINT (6170465 -7542726)
2012,Diciembre,Mozambique,1,4,,5,POINT (4697157 -74140516)
2012,Diciembre,Nepal,1,1,,2,POINT (4697157 -74140516)
2012,Diciembre,Nicaragua,1,0,,1,POINT (0.81488 -77356)
2012,Diciembre,Nicaragua,5,10,,15,POINT (10446304 -75516486)
2012,Diciembre,Nicaragua,2,3,,5,POINT (10886686 -74776479)
2012,Diciembre,Nicaragua,0,2,,2,POINT (125744111 -81703935)
2012,Diciembre,Nicaragua,1,0,,1,POINT (125862 -81702165)
2012,Diciembre,Nicaragua,3,5,,8,POINT (3451668 -76532004)
2012,Diciembre,Nicaragua,44,46,,90,POINT (4697157 -74140516)
2012,Diciembre,Nicaragua,1,0,,1,POINT (4815189 -75736374)
2012,Diciembre,Nicaragua,10,17,,27,POINT (6170465 -7542726)
2012,Diciembre,Nicaragua,1,1,,2,POINT (7128047 -73181317)
2012,Diciembre,Nigeria,0,1,,1,POINT (0.81488 -77356)
2012,Diciembre,Nigeria,0,2,,2,POINT (10446304 -75516486)
2012,Diciembre,Nigeria,2,7,,9,POINT (4697157 -74140516)
2012,Diciembre,Noruega,3,4,,7,POINT (0.81488 -77356)
2012,Diciembre,Noruega,4,3,,7,POINT (10406342 -75527794)
2012,Diciembre,Noruega,11,20,,31,POINT (10446304 -75516486)
2012,Diciembre,Noruega,2,6,,8,POINT (10886686 -74776479)
2012,Diciembre,Noruega,0,1,,1,POINT (11247723 -74213989)
2012,Diciembre,Noruega,10,12,,22,POINT (3451668 -76532004)
2012,Diciembre,Noruega,150,200,,350,POINT (4697157 -74140516)
2012,Diciembre,Noruega,10,8,,18,POINT (6170465 -7542726)
2012,Diciembre,Noruega,0,5,,5,POINT (7819 -72453013)
2012,Diciembre,Nueva Zelanda,1,1,,2,POINT (-4191162 -69941498)
2012,Diciembre,Nueva Zelanda,4,11,,15,POINT (0.81488 -77356)
2012,Diciembre,Nueva Zelanda,3,14,,17,POINT (10446304 -75516486)
2012,Diciembre,Nueva Zelanda,1,2,,3,POINT (10886686 -74776479)
2012,Diciembre,Nueva Zelanda,1,7,,8,POINT (11360029 -72129595)
2012,Diciembre,Nueva Zelanda,1,3,,4,POINT (3451668 -76532004)
2012,Diciembre,Nueva Zelanda,43,81,,124,POINT (4697157 -74140516)
2012,Diciembre,Nueva Zelanda,0,2,,2,POINT (4815189 -75736374)
2012,Diciembre,Nueva Zelanda,2,9,,11,POINT (6170465 -7542726)
2012,Diciembre,Nueva Zelanda,2,0,,2,POINT (7819 -72453013)
2012,Diciembre,Nueva Zelanda,2,4,,6,POINT (863337 -7735002)
2012,Diciembre,Omán,1,0,,1,POINT (4697157 -74140516)
2012,Diciembre,Nueva Zelanda,2,8,,10,POINT (10406342 -75527794)
2012,Diciembre,Nueva Zelanda,0,1,,1,POINT (11247723 -74213989)
2012,Diciembre,Nueva Zelanda,1,1,,2,POINT (133387613 -81372937)
2012,Diciembre,Nueva Zelanda,5,4,,9,POINT (4697157 -74140516)
2012,Diciembre,Nueva Zelanda,0,1,,1,POINT (7819 -72453013)
2012,Diciembre,Países Bajos,0,2,,2,POINT (-4191162 -69941498)
2012,Diciembre,Países Bajos,1,1,,2,POINT (0.33002 -76876446)
2012,Diciembre,Países Bajos,4,7,,11,POINT (0.81488 -77356)
2012,Diciembre,Países Bajos,3,8,,11,POINT (10446304 -75516486)
2012,Diciembre,Países Bajos,5,9,,14,POINT (10886686 -74776479)
2012,Diciembre,Países Bajos,3,1,,4,POINT (11360029 -72129595)
2012,Diciembre,Países Bajos,26,39,,65,POINT (1152863 -72919186)
2012,Diciembre,Países Bajos,5,18,,23,POINT (3451668 -76532004)
2012,Diciembre,Países Bajos,33,47,,80,POINT (445285 -75766353)
2012,Diciembre,Países Bajos,207,349,,556,POINT (4697157 -74140516)
2012,Diciembre,Países Bajos,133,206,,339,POINT (6170465 -7542726)
2012,Diciembre,Países Bajos,11,9,,20,POINT (7128047 -73181317)
2012,Diciembre,Países Bajos,1,7,,8,POINT (7819 -72453013)
2012,Diciembre,Países Bajos,2,0,,2,POINT (7927233 -72508188)
2012,Diciembre,Pakistán,0,1,,1,POINT (0.81488 -77356)
2012,Diciembre,Pakistán,0,1,,1,POINT (11360029 -72129595)
2012,Diciembre,Pakistán,0,11,,11,POINT (4697157 -74140516)
2012,Diciembre,Pakistán,0,1,,1,POINT (7819 -72453013)
2012,Diciembre,Panamá,1,0,,1,POINT (0.33002 -76876446)
2012,Diciembre,Panamá,2,11,,13,POINT (10406342 -75527794)
2012,Diciembre,Panamá,237,290,,527,POINT (10446304 -75516486)
2012,Diciembre,Panamá,120,175,,295,POINT (10886686 -74776479)
2012,Diciembre,Panamá,0,3,,3,POINT (11360029 -72129595)
2012,Diciembre,Panamá,0,5,,5,POINT (125744111 -81703935)
2012,Diciembre,Panamá,34,31,,65,POINT (125862 -81702165)
2012,Diciembre,Panamá,133,254,,387,POINT (3451668 -76532004)
2012,Diciembre,Panamá,515,835,,1350,POINT (4697157 -74140516)
2012,Diciembre,Panamá,64,99,,163,POINT (4815189 -75736374)
2012,Diciembre,Panamá,183,335,,518,POINT (6170465 -7542726)
2012,Diciembre,Panamá,9,3,,12,POINT (6222552 -77401154)
2012,Diciembre,Panamá,7,14,,21,POINT (7128047 -73181317)
2012,Diciembre,Panamá,2,8,,10,POINT (7819 -72453013)
2012,Diciembre,Panamá,6,18,,24,POINT (7927233 -72508188)
2012,Diciembre,Panamá,11,14,,25,POINT (863337 -7735002)
2012,Diciembre,Paraguay,2,0,,2,POINT (10406342 -75527794)
2012,Diciembre,Paraguay,22,12,,34,POINT (10446304 -75516486)
2012,Diciembre,Paraguay,0,12,,12,POINT (10886686 -74776479)
2012,Diciembre,Paraguay,1,2,,3,POINT (11360029 -72129595)
2012,Diciembre,Paraguay,7,5,,12,POINT (3451668 -76532004)
2012,Diciembre,Paraguay,50,54,,104,POINT (4697157 -74140516)
2012,Diciembre,Paraguay,1,0,,1,POINT (4815189 -75736374)
2012,Diciembre,Paraguay,11,7,,18,POINT (6170465 -7542726)
2012,Diciembre,Paraguay,1,0,,1,POINT (7088729 -70740253)
2012,Diciembre,Paraguay,1,2,,3,POINT (7819 -72453013)
2012,Diciembre,Paraguay,0,1,,1,POINT (7927233 -72508188)
2012,Diciembre,Perú,25,22,,47,POINT (-4191162 -69941498)
2012,Diciembre,Perú,145,346,,491,POINT (0.81488 -77356)
2012,Diciembre,Perú,13,14,,27,POINT (10406342 -75527794)
2012,Diciembre,Perú,130,106,,236,POINT (10446304 -75516486)
2012,Diciembre,Perú,26,37,,63,POINT (10886686 -74776479)
2012,Diciembre,Perú,17,42,,59,POINT (11360029 -72129595)
2012,Diciembre,Perú,105,67,,172,POINT (125862 -81702165)
2012,Diciembre,Perú,95,148,,243,POINT (3451668 -76532004)
2012,Diciembre,Perú,0,1,,1,POINT (445285 -75766353)
2012,Diciembre,Perú,1992,2832,,4824,POINT (4697157 -74140516)
2012,Diciembre,Perú,0,7,,7,POINT (4815189 -75736374)
2012,Diciembre,Perú,130,255,,385,POINT (6170465 -7542726)
2012,Diciembre,Perú,0,3,,3,POINT (6185536 -67484028)
2012,Diciembre,Perú,2,2,,4,POINT (7128047 -73181317)
2012,Diciembre,Perú,50,98,,148,POINT (7819 -72453013)
2012,Diciembre,Perú,3,5,,8,POINT (7927233 -72508188)
2012,Diciembre,Perú,0,1,,1,POINT (863337 -7735002)
2012,Diciembre,Palestina,1,0,,1,POINT (4697157 -74140516)
2012,Diciembre,Polonia,1,3,,4,POINT (-4191162 -69941498)
2012,Diciembre,Polonia,5,6,,11,POINT (0.81488 -77356)
2012,Diciembre,Polonia,1,18,,19,POINT (10406342 -75527794)
2012,Diciembre,Polonia,6,3,,9,POINT (10446304 -75516486)
2012,Diciembre,Polonia,2,1,,3,POINT (10886686 -74776479)
2012,Diciembre,Polonia,0,2,,2,POINT (10970933 -74765343)
2012,Diciembre,Polonia,1,2,,3,POINT (3451668 -76532004)
2012,Diciembre,Polonia,81,89,,170,POINT (4697157 -74140516)
2012,Diciembre,Polonia,1,2,,3,POINT (6170465 -7542726)
2012,Diciembre,Polonia,0,3,,3,POINT (7819 -72453013)
2012,Diciembre,Polonia,0,2,,2,POINT (863337 -7735002)
2012,Diciembre,Portugal,4,2,,6,POINT (0.81488 -77356)
2012,Diciembre,Portugal,0,4,,4,POINT (10406342 -75527794)
2012,Diciembre,Portugal,2,4,,6,POINT (10446304 -75516486)
2012,Diciembre,Portugal,0,5,,5,POINT (11360029 -72129595)
2012,Diciembre,Portugal,5,22,,27,POINT (3451668 -76532004)
2012,Diciembre,Portugal,81,271,,352,POINT (4697157 -74140516)
2012,Diciembre,Portugal,7,16,,23,POINT (6170465 -7542726)
2012,Diciembre,Portugal,0,1,,1,POINT (7128047 -73181317)
2012,Diciembre,Portugal,1,2,,3,POINT (7819 -72453013)
2012,Diciembre,Portugal,0,1,,1,POINT (7927233 -72508188)
2012,Diciembre,Qatar,0,5,,5,POINT (4697157 -74140516)
2012,Diciembre,Reino Unido de Gran Bretaña e Irlanda del Norte,3,4,,7,POINT (-4191162 -69941498)
2012,Diciembre,Reino Unido de Gran Bretaña e Irlanda del Norte,3,3,,6,POINT (0.81488 -77356)
2012,Diciembre,Reino Unido de Gran Bretaña e Irlanda del Norte,0,1,,1,POINT (10406342 -75527794)
2012,Diciembre,Reino Unido de Gran Bretaña e Irlanda del Norte,21,56,,77,POINT (10446304 -75516486)
2012,Diciembre,Reino Unido de Gran Bretaña e Irlanda del Norte,0,2,,2,POINT (10886686 -74776479)
2012,Diciembre,Reino Unido de Gran Bretaña e Irlanda del Norte,0,1,,1,POINT (10970933 -74765343)
2012,Diciembre,Reino Unido de Gran Bretaña e Irlanda del Norte,0,1,,1,POINT (11247723 -74213989)
2012,Diciembre,Reino Unido de Gran Bretaña e Irlanda del Norte,1,3,,4,POINT (11360029 -72129595)
2012,Diciembre,Reino Unido de Gran Bretaña e Irlanda del Norte,0,2,,2,POINT (125862 -81702165)
2012,Diciembre,Reino Unido de Gran Bretaña e Irlanda del Norte,10,17,,27,POINT (3451668 -76532004)
2012,Diciembre,Reino Unido de Gran Bretaña e Irlanda del Norte,1,1,,2,POINT (445285 -75766353)
2012,Diciembre,Reino Unido de Gran Bretaña e Irlanda del Norte,268,604,,872,POINT (4697157 -74140516)
2012,Diciembre,Reino Unido de Gran Bretaña e Irlanda del Norte,1,1,,2,POINT (4815189 -75736374)
2012,Diciembre,Reino Unido de Gran Bretaña e Irlanda del Norte,9,41,,50,POINT (6170465 -7542726)
2012,Diciembre,Reino Unido de Gran Bretaña e Irlanda del Norte,0,1,,1,POINT (7128047 -73181317)
2012,Diciembre,Reino Unido de Gran Bretaña e Irlanda del Norte,1,6,,7,POINT (7819 -72453013)
2012,Diciembre,Reino Unido de Gran Bretaña e Irlanda del Norte,0,2,,2,POINT (7927233 -72508188)
2012,Diciembre,República CentroÁfricana,1,0,,1,POINT (4697157 -74140516)
2012,Diciembre,República de Belarús,2,0,,2,POINT (4697157 -74140516)
2012,Diciembre,República Dominicana,5,15,,20,POINT (0.81488 -77356)
2012,Diciembre,República Dominicana,0,2,,2,POINT (10406342 -75527794)
2012,Diciembre,República Dominicana,18,20,,38,POINT (10446304 -75516486)
2012,Diciembre,República Dominicana,14,34,,48,POINT (10886686 -74776479)
2012,Diciembre,República Dominicana,0,7,,7,POINT (11360029 -72129595)
2012,Diciembre,República Dominicana,0,2,,2,POINT (125862 -81702165)
2012,Diciembre,República Dominicana,11,55,,66,POINT (3451668 -76532004)
2012,Diciembre,República Dominicana,1,0,,1,POINT (445285 -75766353)
2012,Diciembre,República Dominicana,197,341,,538,POINT (4697157 -74140516)
2012,Diciembre,República Dominicana,10,8,,18,POINT (4815189 -75736374)
2012,Diciembre,República Dominicana,39,61,,100,POINT (6170465 -7542726)
2012,Diciembre,República Dominicana,1,1,,2,POINT (7128047 -73181317)
2012,Diciembre,República Dominicana,0,5,,5,POINT (7819 -72453013)
2012,Diciembre,República Dominicana,2,5,,7,POINT (7927233 -72508188)
2012,Diciembre,República Checa,2,3,,5,POINT (10406342 -75527794)
2012,Diciembre,República Checa,1,0,,1,POINT (11360029 -72129595)
2012,Diciembre,República Checa,3,3,,6,POINT (4697157 -74140516)
2012,Diciembre,República Checa,1,1,,2,POINT (7819 -72453013)
2012,Diciembre,Rumania,1,0,,1,POINT (0.81488 -77356)
2012,Diciembre,Rumania,1,4,,5,POINT (10406342 -75527794)
2012,Diciembre,Rumania,1,2,,3,POINT (10446304 -75516486)
2012,Diciembre,Rumania,0,4,,4,POINT (11360029 -72129595)
2012,Diciembre,Rumania,2,0,,2,POINT (3451668 -76532004)
2012,Diciembre,Rumania,28,62,,90,POINT (4697157 -74140516)
2012,Diciembre,Rumania,6,2,,8,POINT (6170465 -7542726)
2012,Diciembre,Federación de Rusia,1,0,,1,POINT (0.81488 -77356)
2012,Diciembre,Federación de Rusia,0,1,,1,POINT (10406342 -75527794)
2012,Diciembre,Federación de Rusia,2,3,,5,POINT (10446304 -75516486)
2012,Diciembre,Federación de Rusia,0,1,,1,POINT (10970933 -74765343)
2012,Diciembre,Federación de Rusia,1,0,,1,POINT (125862 -81702165)
2012,Diciembre,Federación de Rusia,2,4,,6,POINT (3451668 -76532004)
2012,Diciembre,Federación de Rusia,26,45,,71,POINT (4697157 -74140516)
2012,Diciembre,Federación de Rusia,2,1,,3,POINT (6170465 -7542726)
2012,Diciembre,Federación de Rusia,1,0,,1,POINT (7819 -72453013)
2012,Diciembre,San Marino,0,3,,3,POINT (4697157 -74140516)
2012,Diciembre,San  Vicente y las Granadinas,0,1,,1,POINT (11247723 -74213989)
2012,Diciembre,San  Vicente y las Granadinas,1,0,,1,POINT (3451668 -76532004)
2012,Diciembre,Santa Lucia,2,1,,3,POINT (0.81488 -77356)
2012,Diciembre,Santa Lucia,4,1,,5,POINT (10446304 -75516486)
2012,Diciembre,Santa Lucia,0,1,,1,POINT (125862 -81702165)
2012,Diciembre,Santa Lucia,0,1,,1,POINT (7128047 -73181317)
2012,Diciembre,Santa Sede/Ciudad del Vaticano,0,1,,1,POINT (4697157 -74140516)
2012,Diciembre,Senegal,0,1,,1,POINT (0.81488 -77356)
2012,Diciembre,Senegal,0,3,,3,POINT (4697157 -74140516)
2012,Diciembre,Serbia,7,10,,17,POINT (4697157 -74140516)
2012,Diciembre,Serbia,1,2,,3,POINT (6170465 -7542726)
2012,Diciembre,Singapur,6,14,,20,POINT (4697157 -74140516)
2012,Diciembre,Singapur,0,2,,2,POINT (6170465 -7542726)
2012,Diciembre,República Árabe Siria,0,1,,1,POINT (11360029 -72129595)
2012,Diciembre,República Árabe Siria,1,1,,2,POINT (4697157 -74140516)
2012,Diciembre,Sri Lanka,0,1,,1,POINT (10446304 -75516486)
2012,Diciembre,Sri Lanka,0,1,,1,POINT (6170465 -7542726)
2012,Diciembre,Sudáfrica,3,1,,4,POINT (0.81488 -77356)
2012,Diciembre,Sudáfrica,2,3,,5,POINT (10406342 -75527794)
2012,Diciembre,Sudáfrica,3,1,,4,POINT (10446304 -75516486)
2012,Diciembre,Sudáfrica,1,2,,3,POINT (10886686 -74776479)
2012,Diciembre,Sudáfrica,0,1,,1,POINT (125862 -81702165)
2012,Diciembre,Sudáfrica,0,2,,2,POINT (3451668 -76532004)
2012,Diciembre,Sudáfrica,24,59,,83,POINT (4697157 -74140516)
2012,Diciembre,Sudáfrica,2,7,,9,POINT (6170465 -7542726)
2012,Diciembre,Suecia,1,0,,1,POINT (-4191162 -69941498)
2012,Diciembre,Suecia,0,1,,1,POINT (0.33002 -76876446)
2012,Diciembre,Suecia,11,13,,24,POINT (0.81488 -77356)
2012,Diciembre,Suecia,3,6,,9,POINT (10406342 -75527794)
2012,Diciembre,Suecia,11,19,,30,POINT (10446304 -75516486)
2012,Diciembre,Suecia,2,4,,6,POINT (10886686 -74776479)
2012,Diciembre,Suecia,0,1,,1,POINT (11247723 -74213989)
2012,Diciembre,Suecia,1,2,,3,POINT (11360029 -72129595)
2012,Diciembre,Suecia,0,1,,1,POINT (125862 -81702165)
2012,Diciembre,Suecia,1,1,,2,POINT (133387613 -81372937)
2012,Diciembre,Suecia,12,19,,31,POINT (3451668 -76532004)
2012,Diciembre,Suecia,0,4,,4,POINT (3884426 -77061029)
2012,Diciembre,Suecia,311,478,,789,POINT (4697157 -74140516)
2012,Diciembre,Suecia,0,1,,1,POINT (4815189 -75736374)
2012,Diciembre,Suecia,7,28,,35,POINT (6170465 -7542726)
2012,Diciembre,Suecia,4,4,,8,POINT (7819 -72453013)
2012,Diciembre,Suecia,0,1,,1,POINT (863337 -7735002)
2012,Diciembre,Suiza,5,4,,9,POINT (-4191162 -69941498)
2012,Diciembre,Suiza,20,26,,46,POINT (0.81488 -77356)
2012,Diciembre,Suiza,13,15,,28,POINT (10406342 -75527794)
2012,Diciembre,Suiza,22,39,,61,POINT (10446304 -75516486)
2012,Diciembre,Suiza,7,8,,15,POINT (10886686 -74776479)
2012,Diciembre,Suiza,1,0,,1,POINT (11247723 -74213989)
2012,Diciembre,Suiza,5,3,,8,POINT (11360029 -72129595)
2012,Diciembre,Suiza,2,0,,2,POINT (125862 -81702165)
2012,Diciembre,Suiza,20,49,,69,POINT (3451668 -76532004)
2012,Diciembre,Suiza,419,780,,1199,POINT (4697157 -74140516)
2012,Diciembre,Suiza,0,1,,1,POINT (4815189 -75736374)
2012,Diciembre,Suiza,30,48,,78,POINT (6170465 -7542726)
2012,Diciembre,Suiza,1,0,,1,POINT (6185536 -67484028)
2012,Diciembre,Suiza,4,2,,6,POINT (7128047 -73181317)
2012,Diciembre,Suiza,1,3,,4,POINT (7819 -72453013)
2012,Diciembre,Suiza,0,1,,1,POINT (7927233 -72508188)
2012,Diciembre,Suiza,1,2,,3,POINT (863337 -7735002)
2012,Diciembre,Surinam,0,1,,1,POINT (11360029 -72129595)
2012,Diciembre,Surinam,3,0,,3,POINT (4697157 -74140516)
2012,Diciembre,Surinam,0,1,,1,POINT (6170465 -7542726)
2012,Diciembre,Taiwán,2,0,,2,POINT (10406342 -75527794)
2012,Diciembre,Taiwán,2,4,,6,POINT (4697157 -74140516)
2012,Diciembre,Taiwán,2,1,,3,POINT (7819 -72453013)
2012,Diciembre,Tailandia,1,1,,2,POINT (0.81488 -77356)
2012,Diciembre,Tailandia,0,3,,3,POINT (3451668 -76532004)
2012,Diciembre,Tailandia,0,4,,4,POINT (4697157 -74140516)
2012,Diciembre,Tíbet/Región Autónoma de China,0,2,,2,POINT (4697157 -74140516)
2012,Diciembre,Territorio Antártico Británico/Territorio Británico de Ultramar,2,3,,5,POINT (4697157 -74140516)
2012,Diciembre,Territorio Antártico Británico/Territorio Británico de Ultramar,0,1,,1,POINT (6170465 -7542726)
2012,Diciembre,Tanzania,0,3,,3,POINT (4697157 -74140516)
2012,Diciembre,Trinidad y Tobago,4,9,,13,POINT (10446304 -75516486)
2012,Diciembre,Trinidad y Tobago,0,1,,1,POINT (10886686 -74776479)
2012,Diciembre,Trinidad y Tobago,0,2,,2,POINT (11360029 -72129595)
2012,Diciembre,Trinidad y Tobago,0,2,,2,POINT (125744111 -81703935)
2012,Diciembre,Trinidad y Tobago,3,7,,10,POINT (3451668 -76532004)
2012,Diciembre,Trinidad y Tobago,40,36,,76,POINT (4697157 -74140516)
2012,Diciembre,Trinidad y Tobago,0,2,,2,POINT (4815189 -75736374)
2012,Diciembre,Trinidad y Tobago,5,16,,21,POINT (6170465 -7542726)
2012,Diciembre,Trinidad y Tobago,1,1,,2,POINT (7819 -72453013)
2012,Diciembre,Trinidad y Tobago,1,2,,3,POINT (7927233 -72508188)
2012,Diciembre,Túnez,1,0,,1,POINT (10446304 -75516486)
2012,Diciembre,Túnez,0,2,,2,POINT (4697157 -74140516)
2012,Diciembre,Túnez,0,1,,1,POINT (6170465 -7542726)
2012,Diciembre,Turquía,0,1,,1,POINT (-4191162 -69941498)
2012,Diciembre,Turquía,1,0,,1,POINT (0.81488 -77356)
2012,Diciembre,Turquía,1,1,,2,POINT (10406342 -75527794)
2012,Diciembre,Turquía,0,5,,5,POINT (10446304 -75516486)
2012,Diciembre,Turquía,0,6,,6,POINT (10970933 -74765343)
2012,Diciembre,Turquía,1,3,,4,POINT (3451668 -76532004)
2012,Diciembre,Turquía,31,80,,111,POINT (4697157 -74140516)
2012,Diciembre,Turquía,0,4,,4,POINT (6170465 -7542726)
2012,Diciembre,Turquía,0,1,,1,POINT (7128047 -73181317)
2012,Diciembre,Turquía,0,2,,2,POINT (7819 -72453013)
2012,Diciembre,Turquía,0,1,,1,POINT (863337 -7735002)
2012,Diciembre,Ucrania,0,1,,1,POINT (10406342 -75527794)
2012,Diciembre,Ucrania,1,2,,3,POINT (10446304 -75516486)
2012,Diciembre,Ucrania,3,1,,4,POINT (3451668 -76532004)
2012,Diciembre,Ucrania,20,30,,50,POINT (4697157 -74140516)
2012,Diciembre,Ucrania,0,1,,1,POINT (7128047 -73181317)
2012,Diciembre,Federación de Rusia,0,2,,2,POINT (-4191162 -69941498)
2012,Diciembre,Federación de Rusia,3,8,,11,POINT (0.81488 -77356)
2012,Diciembre,Federación de Rusia,2,37,,39,POINT (10406342 -75527794)
2012,Diciembre,Federación de Rusia,7,5,,12,POINT (10446304 -75516486)
2012,Diciembre,Federación de Rusia,0,5,,5,POINT (10970933 -74765343)
2012,Diciembre,Federación de Rusia,109,138,,247,POINT (4697157 -74140516)
2012,Diciembre,Federación de Rusia,5,4,,9,POINT (6170465 -7542726)
2012,Diciembre,Federación de Rusia,3,5,,8,POINT (7819 -72453013)
2012,Diciembre,Federación de Rusia,0,3,,3,POINT (9402597 -75681642)
2012,Diciembre,Uruguay,1,8,,9,POINT (0.81488 -77356)
2012,Diciembre,Uruguay,1,6,,7,POINT (10406342 -75527794)
2012,Diciembre,Uruguay,50,46,,96,POINT (10446304 -75516486)
2012,Diciembre,Uruguay,6,6,,12,POINT (10886686 -74776479)
2012,Diciembre,Uruguay,1,2,,3,POINT (11360029 -72129595)
2012,Diciembre,Uruguay,25,15,,40,POINT (125862 -81702165)
2012,Diciembre,Uruguay,8,21,,29,POINT (3451668 -76532004)
2012,Diciembre,Uruguay,92,246,,338,POINT (4697157 -74140516)
2012,Diciembre,Uruguay,0,3,,3,POINT (4815189 -75736374)
2012,Diciembre,Uruguay,18,51,,69,POINT (6170465 -7542726)
2012,Diciembre,Uruguay,0,1,,1,POINT (7128047 -73181317)
2012,Diciembre,Uruguay,5,13,,18,POINT (7819 -72453013)
2012,Diciembre,Uruguay,1,0,,1,POINT (7927233 -72508188)
2012,Diciembre,Uruguay,0,3,,3,POINT (863337 -7735002)
2012,Diciembre,Venezuela,0,1,,1,POINT (-4191162 -69941498)
2012,Diciembre,Venezuela,0,2,,2,POINT (0.33002 -76876446)
2012,Diciembre,Venezuela,66,95,,161,POINT (0.81488 -77356)
2012,Diciembre,Venezuela,8,31,,39,POINT (10406342 -75527794)
2012,Diciembre,Venezuela,138,155,,293,POINT (10446304 -75516486)
2012,Diciembre,Venezuela,74,106,,180,POINT (10886686 -74776479)
2012,Diciembre,Venezuela,3349,4331,,7680,POINT (11360029 -72129595)
2012,Diciembre,Venezuela,2,3,,5,POINT (1152863 -72919186)
2012,Diciembre,Venezuela,10,9,,19,POINT (125862 -81702165)
2012,Diciembre,Venezuela,91,104,,195,POINT (3451668 -76532004)
2012,Diciembre,Venezuela,3,3,,6,POINT (445285 -75766353)
2012,Diciembre,Venezuela,6518,6896,,13414,POINT (4697157 -74140516)
2012,Diciembre,Venezuela,6,18,,24,POINT (4815189 -75736374)
2012,Diciembre,Venezuela,630,616,,1246,POINT (6170465 -7542726)
2012,Diciembre,Venezuela,174,236,,410,POINT (6185536 -67484028)
2012,Diciembre,Venezuela,115,174,,289,POINT (7088729 -70740253)
2012,Diciembre,Venezuela,11,12,,23,POINT (7128047 -73181317)
2012,Diciembre,Venezuela,2675,3224,,5899,POINT (7819 -72453013)
2012,Diciembre,Venezuela,648,666,,1314,POINT (7927233 -72508188)
2012,Diciembre,Vietnam,8,8,,16,POINT (4697157 -74140516)
2012,Diciembre,Zambia,0,1,,1,POINT (4697157 -74140516)
2012,Diciembre,Reino Unido de Gran Bretaña e Irlanda del Norte,3,8,,11,POINT (-4191162 -69941498)
2012,Diciembre,Reino Unido de Gran Bretaña e Irlanda del Norte,18,32,,50,POINT (0.81488 -77356)
2012,Diciembre,Reino Unido de Gran Bretaña e Irlanda del Norte,20,28,,48,POINT (10406342 -75527794)
2012,Diciembre,Reino Unido de Gran Bretaña e Irlanda del Norte,29,37,,66,POINT (10446304 -75516486)
2012,Diciembre,Reino Unido de Gran Bretaña e Irlanda del Norte,0,2,,2,POINT (10886686 -74776479)
2012,Diciembre,Reino Unido de Gran Bretaña e Irlanda del Norte,1,4,,5,POINT (11247723 -74213989)
2012,Diciembre,Reino Unido de Gran Bretaña e Irlanda del Norte,0,6,,6,POINT (11360029 -72129595)
2012,Diciembre,Reino Unido de Gran Bretaña e Irlanda del Norte,0,7,,7,POINT (125862 -81702165)
2012,Diciembre,Reino Unido de Gran Bretaña e Irlanda del Norte,2,2,,4,POINT (133387613 -81372937)
2012,Diciembre,Reino Unido de Gran Bretaña e Irlanda del Norte,14,34,,48,POINT (3451668 -76532004)
2012,Diciembre,Reino Unido de Gran Bretaña e Irlanda del Norte,0,1,,1,POINT (445285 -75766353)
2012,Diciembre,Reino Unido de Gran Bretaña e Irlanda del Norte,362,853,,1215,POINT (4697157 -74140516)
2012,Diciembre,Reino Unido de Gran Bretaña e Irlanda del Norte,4,18,,22,POINT (6170465 -7542726)
2012,Diciembre,Reino Unido de Gran Bretaña e Irlanda del Norte,0,1,,1,POINT (6185536 -67484028)
2012,Diciembre,Reino Unido de Gran Bretaña e Irlanda del Norte,0,1,,1,POINT (7128047 -73181317)
2012,Diciembre,Reino Unido de Gran Bretaña e Irlanda del Norte,0,1,,1,POINT (7819 -72453013)
2012,Diciembre,Reino Unido de Gran Bretaña e Irlanda del Norte,1,8,,9,POINT (863337 -7735002)
2012,Diciembre,Países Bajos,0,1,,1,POINT (-4191162 -69941498)
2012,Diciembre,Países Bajos,11,17,,28,POINT (0.81488 -77356)
2012,Diciembre,Países Bajos,21,20,,41,POINT (10406342 -75527794)
2012,Diciembre,Países Bajos,11,35,,46,POINT (10446304 -75516486)
2012,Diciembre,Países Bajos,2,3,,5,POINT (10886686 -74776479)
2012,Diciembre,Países Bajos,1,2,,3,POINT (11247723 -74213989)
2012,Diciembre,Países Bajos,3,9,,12,POINT (11360029 -72129595)
2012,Diciembre,Países Bajos,15,42,,57,POINT (3451668 -76532004)
2012,Diciembre,Países Bajos,2,4,,6,POINT (445285 -75766353)
2012,Diciembre,Países Bajos,467,922,,1389,POINT (4697157 -74140516)
2012,Diciembre,Países Bajos,1,2,,3,POINT (4815189 -75736374)
2012,Diciembre,Países Bajos,70,135,,205,POINT (6170465 -7542726)
2012,Diciembre,Países Bajos,2,3,,5,POINT (7128047 -73181317)
2012,Diciembre,Países Bajos,5,20,,25,POINT (7819 -72453013)
2012,Diciembre,Países Bajos,0,1,,1,POINT (7927233 -72508188)
2012,Diciembre,Países Bajos,0,2,,2,POINT (806667 -767333)
2012,Diciembre,Países Bajos,3,1,,4,POINT (863337 -7735002)
2012,Diciembre,Eslovenia,0,1,,1,POINT (4697157 -74140516)
2012,Diciembre,Lituania,4,2,,6,POINT (4697157 -74140516)
2012,Diciembre,Reino Unido de Gran Bretaña e Irlanda del Norte,0,1,,1,POINT (4697157 -74140516)
2012,Diciembre,Reino Unido de Gran Bretaña e Irlanda del Norte,0,1,,1,POINT (0.81488 -77356)
2012,Diciembre,Reino Unido de Gran Bretaña e Irlanda del Norte,3,5,,8,POINT (10406342 -75527794)
2012,Diciembre,Reino Unido de Gran Bretaña e Irlanda del Norte,1,1,,2,POINT (10446304 -75516486)
2012,Diciembre,Reino Unido de Gran Bretaña e Irlanda del Norte,1,0,,1,POINT (11247723 -74213989)
2012,Diciembre,Reino Unido de Gran Bretaña e Irlanda del Norte,3,9,,12,POINT (4697157 -74140516)
2012,Diciembre,Marruecos,1,2,,3,POINT (4697157 -74140516)
2013,Enero,Albania,1,1,,2,POINT (4697157 -74140516)
2013,Enero,Alemania,8,9,,17,POINT (-4191162 -69941498)
2013,Enero,Alemania,1,0,,1,POINT (0.33002 -76876446)
2013,Enero,Alemania,61,82,,143,POINT (0.81488 -77356)
2013,Enero,Alemania,18,20,,38,POINT (10406342 -75527794)
2013,Enero,Alemania,39,61,,100,POINT (10446304 -75516486)
2013,Enero,Alemania,10,7,,17,POINT (10886686 -74776479)
2013,Enero,Alemania,1,1,,2,POINT (11247723 -74213989)
2013,Enero,Alemania,12,8,,20,POINT (11360029 -72129595)
2013,Enero,Alemania,0,1,,1,POINT (1152863 -72919186)
2013,Enero,Alemania,2,2,,4,POINT (125862 -81702165)
2013,Enero,Alemania,0,1,,1,POINT (133387613 -81372937)
2013,Enero,Alemania,32,41,,73,POINT (3451668 -76532004)
2013,Enero,Alemania,0,1,,1,POINT (3884426 -77061029)
2013,Enero,Alemania,1,0,,1,POINT (445285 -75766353)
2013,Enero,Alemania,1257,1942,,3199,POINT (4697157 -74140516)
2013,Enero,Alemania,1,4,,5,POINT (4815189 -75736374)
2013,Enero,Alemania,50,97,,147,POINT (6170465 -7542726)
2013,Enero,Alemania,1,2,,3,POINT (6185536 -67484028)
2013,Enero,Alemania,0,1,,1,POINT (7088729 -70740253)
2013,Enero,Alemania,1,3,,4,POINT (7128047 -73181317)
2013,Enero,Alemania,9,24,,33,POINT (7819 -72453013)
2013,Enero,Alemania,1,0,,1,POINT (7927233 -72508188)
2013,Enero,Alemania,7,14,,21,POINT (863337 -7735002)
2013,Enero,Andorra,1,1,,2,POINT (10446304 -75516486)
2013,Enero,Andorra,0,1,,1,POINT (10886686 -74776479)
2013,Enero,Andorra,4,7,,11,POINT (4697157 -74140516)
2013,Enero,Angola,0,9,,9,POINT (4697157 -74140516)
2013,Enero,Antigua y Barbuda,1,0,,1,POINT (125862 -81702165)
2013,Enero,Antigua y Barbuda,0,1,,1,POINT (3451668 -76532004)
2013,Enero,Antigua y Barbuda,1,0,,1,POINT (6170465 -7542726)
2013,Enero,Países Bajos,0,4,,4,POINT (6170465 -7542726)
2013,Enero,Países Bajos,0,1,,1,POINT (7128047 -73181317)
2013,Enero,Arabia Saudita,0,1,,1,POINT (4697157 -74140516)
2013,Enero,Arabia Saudita,0,1,,1,POINT (6170465 -7542726)
2013,Enero,Arabia Saudita,0,1,,1,POINT (10446304 -75516486)
2013,Enero,Arabia Saudita,0,1,,1,POINT (3451668 -76532004)
2013,Enero,Arabia Saudita,1,8,,9,POINT (4697157 -74140516)
2013,Enero,Argelia,0,6,,6,POINT (4697157 -74140516)
2013,Enero,Argentina,2,5,,7,POINT (-4191162 -69941498)
2013,Enero,Argentina,0,1,,1,POINT (0.33002 -76876446)
2013,Enero,Argentina,190,260,,450,POINT (0.81488 -77356)
2013,Enero,Argentina,1,1,,2,POINT (1800143 -78802679)
2013,Enero,Argentina,98,64,,162,POINT (10406342 -75527794)
2013,Enero,Argentina,659,480,,1139,POINT (10446304 -75516486)
2013,Enero,Argentina,17,28,,45,POINT (10886686 -74776479)
2013,Enero,Argentina,58,87,,145,POINT (11360029 -72129595)
2013,Enero,Argentina,255,197,,452,POINT (125862 -81702165)
2013,Enero,Argentina,67,86,,153,POINT (3451668 -76532004)
2013,Enero,Argentina,5648,5894,,11542,POINT (4697157 -74140516)
2013,Enero,Argentina,1,4,,5,POINT (4815189 -75736374)
2013,Enero,Argentina,176,241,,417,POINT (6170465 -7542726)
2013,Enero,Argentina,0,2,,2,POINT (6185536 -67484028)
2013,Enero,Argentina,21,42,,63,POINT (7819 -72453013)
2013,Enero,Argentina,1,5,,6,POINT (7927233 -72508188)
2013,Enero,Argentina,5,6,,11,POINT (863337 -7735002)
2013,Enero,República de Armenia,1,1,,2,POINT (7927233 -72508188)
2013,Enero,Aruba,3,0,,3,POINT (3451668 -76532004)
2013,Enero,Aruba,2,4,,6,POINT (4697157 -74140516)
2013,Enero,Aruba,1,2,,3,POINT (6170465 -7542726)
2013,Enero,Australia,5,8,,13,POINT (-4191162 -69941498)
2013,Enero,Australia,1,0,,1,POINT (0.33002 -76876446)
2013,Enero,Australia,32,44,,76,POINT (0.81488 -77356)
2013,Enero,Australia,35,42,,77,POINT (10406342 -75527794)
2013,Enero,Australia,38,49,,87,POINT (10446304 -75516486)
2013,Enero,Australia,7,10,,17,POINT (10886686 -74776479)
2013,Enero,Australia,2,4,,6,POINT (11360029 -72129595)
2013,Enero,Australia,0,1,,1,POINT (125862 -81702165)
2013,Enero,Australia,14,27,,41,POINT (3451668 -76532004)
2013,Enero,Australia,248,428,,676,POINT (4697157 -74140516)
2013,Enero,Australia,1,1,,2,POINT (4815189 -75736374)
2013,Enero,Australia,26,66,,92,POINT (6170465 -7542726)
2013,Enero,Australia,1,0,,1,POINT (7128047 -73181317)
2013,Enero,Australia,0,2,,2,POINT (7819 -72453013)
2013,Enero,Australia,0,1,,1,POINT (7927233 -72508188)
2013,Enero,Australia,3,13,,16,POINT (863337 -7735002)
2013,Enero,Austria,13,17,,30,POINT (0.81488 -77356)
2013,Enero,Austria,3,2,,5,POINT (10406342 -75527794)
2013,Enero,Austria,3,8,,11,POINT (10446304 -75516486)
2013,Enero,Austria,1,1,,2,POINT (10886686 -74776479)
2013,Enero,Austria,2,1,,3,POINT (11360029 -72129595)
2013,Enero,Austria,4,10,,14,POINT (3451668 -76532004)
2013,Enero,Austria,106,262,,368,POINT (4697157 -74140516)
2013,Enero,Austria,4,11,,15,POINT (6170465 -7542726)
2013,Enero,Austria,3,4,,7,POINT (7819 -72453013)
2013,Enero,Austria,2,1,,3,POINT (863337 -7735002)
2013,Enero,Azerbaiyán,1,1,,2,POINT (4697157 -74140516)
2013,Enero,Bahamas,0,2,,2,POINT (10446304 -75516486)
2013,Enero,Bahamas,2,1,,3,POINT (3451668 -76532004)
2013,Enero,Bahamas,0,3,,3,POINT (4697157 -74140516)
2013,Enero,Bahamas,1,0,,1,POINT (4815189 -75736374)
2013,Enero,Bahamas,0,1,,1,POINT (6170465 -7542726)
2013,Enero,Bahréin,0,1,,1,POINT (6170465 -7542726)
2013,Enero,Bangladesh,2,4,,6,POINT (4697157 -74140516)
2013,Enero,Bangladesh,0,1,,1,POINT (6170465 -7542726)
2013,Enero,Barbados,7,2,,9,POINT (4697157 -74140516)
2013,Enero,República de Belarús,4,3,,7,POINT (4697157 -74140516)
2013,Enero,República de Belarús,0,1,,1,POINT (6170465 -7542726)
2013,Enero,Bélgica,1,4,,5,POINT (-4191162 -69941498)
2013,Enero,Bélgica,0,1,,1,POINT (0.33002 -76876446)
2013,Enero,Bélgica,13,12,,25,POINT (0.81488 -77356)
2013,Enero,Bélgica,1,2,,3,POINT (10406342 -75527794)
2013,Enero,Bélgica,4,12,,16,POINT (10446304 -75516486)
2013,Enero,Bélgica,0,1,,1,POINT (10886686 -74776479)
2013,Enero,Bélgica,1,3,,4,POINT (11360029 -72129595)
2013,Enero,Bélgica,0,1,,1,POINT (125862 -81702165)
2013,Enero,Bélgica,8,23,,31,POINT (3451668 -76532004)
2013,Enero,Bélgica,105,307,,412,POINT (4697157 -74140516)
2013,Enero,Bélgica,9,14,,23,POINT (6170465 -7542726)
2013,Enero,Bélgica,1,0,,1,POINT (7128047 -73181317)
2013,Enero,Bélgica,1,1,,2,POINT (7819 -72453013)
2013,Enero,Bélgica,0,3,,3,POINT (863337 -7735002)
2013,Enero,Belice,1,0,,1,POINT (11360029 -72129595)
2013,Enero,Belice,2,6,,8,POINT (4697157 -74140516)
2013,Enero,Belice,0,2,,2,POINT (6170465 -7542726)
2013,Enero,Benín,0,1,,1,POINT (4697157 -74140516)
2013,Enero,Bolivia,38,34,,72,POINT (0.81488 -77356)
2013,Enero,Bolivia,0,2,,2,POINT (10406342 -75527794)
2013,Enero,Bolivia,16,19,,35,POINT (10446304 -75516486)
2013,Enero,Bolivia,2,1,,3,POINT (10886686 -74776479)
2013,Enero,Bolivia,0,1,,1,POINT (11360029 -72129595)
2013,Enero,Bolivia,1,1,,2,POINT (125862 -81702165)
2013,Enero,Bolivia,12,10,,22,POINT (3451668 -76532004)
2013,Enero,Bolivia,0,1,,1,POINT (445285 -75766353)
2013,Enero,Bolivia,437,539,,976,POINT (4697157 -74140516)
2013,Enero,Bolivia,12,24,,36,POINT (6170465 -7542726)
2013,Enero,Bolivia,1,0,,1,POINT (7088729 -70740253)
2013,Enero,Bolivia,0,5,,5,POINT (7819 -72453013)
2013,Enero,Bosnia y Herzegovina,0,2,,2,POINT (4697157 -74140516)
2013,Enero,Bosnia y Herzegovina,1,0,,1,POINT (6170465 -7542726)
2013,Enero,Brasil,98,92,,190,POINT (-4191162 -69941498)
2013,Enero,Brasil,27,57,,84,POINT (0.81488 -77356)
2013,Enero,Brasil,9,7,,16,POINT (10406342 -75527794)
2013,Enero,Brasil,136,124,,260,POINT (10446304 -75516486)
2013,Enero,Brasil,6,14,,20,POINT (10886686 -74776479)
2013,Enero,Brasil,10,32,,42,POINT (11360029 -72129595)
2013,Enero,Brasil,27,21,,48,POINT (125862 -81702165)
2013,Enero,Brasil,19,42,,61,POINT (3451668 -76532004)
2013,Enero,Brasil,0,2,,2,POINT (445285 -75766353)
2013,Enero,Brasil,2894,3920,,6814,POINT (4697157 -74140516)
2013,Enero,Brasil,79,92,,171,POINT (6170465 -7542726)
2013,Enero,Brasil,0,3,,3,POINT (6185536 -67484028)
2013,Enero,Brasil,1,2,,3,POINT (7128047 -73181317)
2013,Enero,Brasil,19,25,,44,POINT (7819 -72453013)
2013,Enero,Brasil,0,6,,6,POINT (7927233 -72508188)
2013,Enero,Brasil,0,1,,1,POINT (863337 -7735002)
2013,Enero,Bulgaria,0,1,,1,POINT (10406342 -75527794)
2013,Enero,Bulgaria,0,1,,1,POINT (3451668 -76532004)
2013,Enero,Bulgaria,15,12,,27,POINT (4697157 -74140516)
2013,Enero,Burkina Faso,1,1,,2,POINT (4697157 -74140516)
2013,Enero,Islas Caimán/Territorio Británico de Ultramar,4,17,,21,POINT (125862 -81702165)
2013,Enero,Camerún,0,6,,6,POINT (4697157 -74140516)
2013,Enero,Canadá,4,5,,9,POINT (-4191162 -69941498)
2013,Enero,Canadá,1,0,,1,POINT (0.33002 -76876446)
2013,Enero,Canadá,28,41,,69,POINT (0.81488 -77356)
2013,Enero,Canadá,20,33,,53,POINT (10406342 -75527794)
2013,Enero,Canadá,780,784,,1564,POINT (10446304 -75516486)
2013,Enero,Canadá,7,26,,33,POINT (10886686 -74776479)
2013,Enero,Canadá,0,3,,3,POINT (11247723 -74213989)
2013,Enero,Canadá,4,6,,10,POINT (11360029 -72129595)
2013,Enero,Canadá,0,1,,1,POINT (1152863 -72919186)
2013,Enero,Canadá,366,347,,713,POINT (125862 -81702165)
2013,Enero,Canadá,1,1,,2,POINT (133387613 -81372937)
2013,Enero,Canadá,39,55,,94,POINT (3451668 -76532004)
2013,Enero,Canadá,4,5,,9,POINT (445285 -75766353)
2013,Enero,Canadá,723,1381,,2104,POINT (4697157 -74140516)
2013,Enero,Canadá,1,9,,10,POINT (4815189 -75736374)
2013,Enero,Canadá,87,199,,286,POINT (6170465 -7542726)
2013,Enero,Canadá,1,6,,7,POINT (7128047 -73181317)
2013,Enero,Canadá,15,29,,44,POINT (7819 -72453013)
2013,Enero,Canadá,2,1,,3,POINT (7927233 -72508188)
2013,Enero,Canadá,5,8,,13,POINT (863337 -7735002)
2013,Enero,España,1,1,,2,POINT (0.33002 -76876446)
2013,Enero,España,10,14,,24,POINT (0.81488 -77356)
2013,Enero,España,3,7,,10,POINT (10406342 -75527794)
2013,Enero,España,1,6,,7,POINT (10446304 -75516486)
2013,Enero,España,2,8,,10,POINT (10886686 -74776479)
2013,Enero,España,68,137,,205,POINT (3451668 -76532004)
2013,Enero,España,1,1,,2,POINT (445285 -75766353)
2013,Enero,España,184,408,,592,POINT (4697157 -74140516)
2013,Enero,España,1,12,,13,POINT (4815189 -75736374)
2013,Enero,España,42,114,,156,POINT (6170465 -7542726)
2013,Enero,España,0,1,,1,POINT (7128047 -73181317)
2013,Enero,España,0,6,,6,POINT (7819 -72453013)
2013,Enero,España,1,0,,1,POINT (7927233 -72508188)
2013,Enero,República Democrática del Congo,0,2,,2,POINT (4697157 -74140516)
2013,Enero,República de Corea,1,0,,1,POINT (0.33002 -76876446)
2013,Enero,República de Corea,10,10,,20,POINT (0.81488 -77356)
2013,Enero,República de Corea,1,0,,1,POINT (10406342 -75527794)
2013,Enero,República de Corea,7,4,,11,POINT (10446304 -75516486)
2013,Enero,República de Corea,1,1,,2,POINT (10886686 -74776479)
2013,Enero,República de Corea,1,3,,4,POINT (3451668 -76532004)
2013,Enero,República de Corea,182,398,,580,POINT (4697157 -74140516)
2013,Enero,República de Corea,0,1,,1,POINT (4815189 -75736374)
2013,Enero,República de Corea,6,33,,39,POINT (6170465 -7542726)
2013,Enero,República de Corea,1,5,,6,POINT (7819 -72453013)
2013,Enero,Costa de Marfil,1,0,,1,POINT (4697157 -74140516)
2013,Enero,Costa Rica,0,2,,2,POINT (0.81488 -77356)
2013,Enero,Costa Rica,0,5,,5,POINT (10406342 -75527794)
2013,Enero,Costa Rica,64,42,,106,POINT (10446304 -75516486)
2013,Enero,Costa Rica,10,26,,36,POINT (10886686 -74776479)
2013,Enero,Costa Rica,0,1,,1,POINT (11247723 -74213989)
2013,Enero,Costa Rica,429,283,,712,POINT (125862 -81702165)
2013,Enero,Costa Rica,22,55,,77,POINT (3451668 -76532004)
2013,Enero,Costa Rica,0,3,,3,POINT (3884426 -77061029)
2013,Enero,Costa Rica,492,739,,1231,POINT (4697157 -74140516)
2013,Enero,Costa Rica,7,12,,19,POINT (4815189 -75736374)
2013,Enero,Costa Rica,57,119,,176,POINT (6170465 -7542726)
2013,Enero,Costa Rica,1,0,,1,POINT (6185536 -67484028)
2013,Enero,Costa Rica,3,1,,4,POINT (7128047 -73181317)
2013,Enero,Costa Rica,5,8,,13,POINT (7819 -72453013)
2013,Enero,Costa Rica,0,1,,1,POINT (863337 -7735002)
2013,Enero,Croacia,0,2,,2,POINT (0.81488 -77356)
2013,Enero,Croacia,0,3,,3,POINT (10406342 -75527794)
2013,Enero,Croacia,1,1,,2,POINT (10446304 -75516486)
2013,Enero,Croacia,1,2,,3,POINT (3451668 -76532004)
2013,Enero,Croacia,4,31,,35,POINT (4697157 -74140516)
2013,Enero,Croacia,1,0,,1,POINT (6170465 -7542726)
2013,Enero,Croacia,0,1,,1,POINT (7819 -72453013)
2013,Enero,Cuba,3,1,,4,POINT (0.81488 -77356)
2013,Enero,Cuba,10,11,,21,POINT (10446304 -75516486)
2013,Enero,Cuba,7,19,,26,POINT (10886686 -74776479)
2013,Enero,Cuba,0,1,,1,POINT (11360029 -72129595)
2013,Enero,Cuba,22,37,,59,POINT (3451668 -76532004)
2013,Enero,Cuba,0,1,,1,POINT (445285 -75766353)
2013,Enero,Cuba,97,163,,260,POINT (4697157 -74140516)
2013,Enero,Cuba,17,20,,37,POINT (6170465 -7542726)
2013,Enero,Cuba,1,1,,2,POINT (7128047 -73181317)
2013,Enero,Cuba,0,1,,1,POINT (7819 -72453013)
2013,Enero,Curazao,2,1,,3,POINT (4697157 -74140516)
2013,Enero,Curazao,2,1,,3,POINT (6170465 -7542726)
2013,Enero,República Checa,1,2,,3,POINT (-4191162 -69941498)
2013,Enero,República Checa,2,6,,8,POINT (0.81488 -77356)
2013,Enero,República Checa,1,3,,4,POINT (10446304 -75516486)
2013,Enero,República Checa,2,0,,2,POINT (11360029 -72129595)
2013,Enero,República Checa,3,0,,3,POINT (3451668 -76532004)
2013,Enero,República Checa,35,72,,107,POINT (4697157 -74140516)
2013,Enero,República Checa,0,1,,1,POINT (4815189 -75736374)
2013,Enero,República Checa,1,1,,2,POINT (6170465 -7542726)
2013,Enero,República Checa,0,1,,1,POINT (7819 -72453013)
2013,Enero,Chile,2,2,,4,POINT (-4191162 -69941498)
2013,Enero,Chile,55,98,,153,POINT (0.81488 -77356)
2013,Enero,Chile,13,12,,25,POINT (10406342 -75527794)
2013,Enero,Chile,213,154,,367,POINT (10446304 -75516486)
2013,Enero,Chile,6,15,,21,POINT (10886686 -74776479)
2013,Enero,Chile,5,6,,11,POINT (11360029 -72129595)
2013,Enero,Chile,97,84,,181,POINT (125862 -81702165)
2013,Enero,Chile,67,96,,163,POINT (3451668 -76532004)
2013,Enero,Chile,2398,3334,,5732,POINT (4697157 -74140516)
2013,Enero,Chile,2,2,,4,POINT (4815189 -75736374)
2013,Enero,Chile,116,152,,268,POINT (6170465 -7542726)
2013,Enero,Chile,0,2,,2,POINT (7088729 -70740253)
2013,Enero,Chile,3,3,,6,POINT (7128047 -73181317)
2013,Enero,Chile,9,21,,30,POINT (7819 -72453013)
2013,Enero,Chile,1,1,,2,POINT (7927233 -72508188)
2013,Enero,Chile,1,2,,3,POINT (863337 -7735002)
2013,Enero,China,1,2,,3,POINT (0.81488 -77356)
2013,Enero,China,1,0,,1,POINT (10406342 -75527794)
2013,Enero,China,1,3,,4,POINT (10446304 -75516486)
2013,Enero,China,4,0,,4,POINT (10886686 -74776479)
2013,Enero,China,2,0,,2,POINT (11360029 -72129595)
2013,Enero,China,2,4,,6,POINT (3451668 -76532004)
2013,Enero,China,128,374,,502,POINT (4697157 -74140516)
2013,Enero,China,0,1,,1,POINT (4815189 -75736374)
2013,Enero,China,4,5,,9,POINT (6170465 -7542726)
2013,Enero,China,1,0,,1,POINT (7128047 -73181317)
2013,Enero,China,3,3,,6,POINT (7819 -72453013)
2013,Enero,Taiwán,0,2,,2,POINT (0.81488 -77356)
2013,Enero,Taiwán,0,3,,3,POINT (10446304 -75516486)
2013,Enero,Taiwán,0,4,,4,POINT (10886686 -74776479)
2013,Enero,Taiwán,1,1,,2,POINT (11360029 -72129595)
2013,Enero,Taiwán,3,5,,8,POINT (3451668 -76532004)
2013,Enero,Taiwán,27,47,,74,POINT (4697157 -74140516)
2013,Enero,Taiwán,4,9,,13,POINT (6170465 -7542726)
2013,Enero,Chipre,0,1,,1,POINT (10970933 -74765343)
2013,Enero,Chipre,1,3,,4,POINT (4697157 -74140516)
2013,Enero,Dinamarca,0,1,,1,POINT (-4191162 -69941498)
2013,Enero,Dinamarca,1,5,,6,POINT (0.81488 -77356)
2013,Enero,Dinamarca,8,7,,15,POINT (10446304 -75516486)
2013,Enero,Dinamarca,0,1,,1,POINT (10886686 -74776479)
2013,Enero,Dinamarca,1,1,,2,POINT (11360029 -72129595)
2013,Enero,Dinamarca,3,4,,7,POINT (3451668 -76532004)
2013,Enero,Dinamarca,65,125,,190,POINT (4697157 -74140516)
2013,Enero,Dinamarca,2,10,,12,POINT (6170465 -7542726)
2013,Enero,Dinamarca,1,1,,2,POINT (7819 -72453013)
2013,Enero,Dinamarca,0,1,,1,POINT (863337 -7735002)
2013,Enero,Dominica,1,0,,1,POINT (0.81488 -77356)
2013,Enero,Dominica,0,1,,1,POINT (3451668 -76532004)
2013,Enero,Dominica,2,3,,5,POINT (4697157 -74140516)
2013,Enero,Dominica,1,0,,1,POINT (6170465 -7542726)
2013,Enero,Dominica,0,1,,1,POINT (7819 -72453013)
2013,Enero,Ecuador,0,1,,1,POINT (-4191162 -69941498)
2013,Enero,Ecuador,16,50,,66,POINT (0.33002 -76876446)
2013,Enero,Ecuador,905,1563,,2468,POINT (0.81488 -77356)
2013,Enero,Ecuador,1,5,,6,POINT (1800143 -78802679)
2013,Enero,Ecuador,1,32,,33,POINT (10406342 -75527794)
2013,Enero,Ecuador,6,13,,19,POINT (10446304 -75516486)
2013,Enero,Ecuador,10,12,,22,POINT (10886686 -74776479)
2013,Enero,Ecuador,3,20,,23,POINT (11360029 -72129595)
2013,Enero,Ecuador,0,5,,5,POINT (125744111 -81703935)
2013,Enero,Ecuador,261,311,,572,POINT (3451668 -76532004)
2013,Enero,Ecuador,1,0,,1,POINT (445285 -75766353)
2013,Enero,Ecuador,1581,2579,,4160,POINT (4697157 -74140516)
2013,Enero,Ecuador,3,7,,10,POINT (4815189 -75736374)
2013,Enero,Ecuador,285,429,,714,POINT (6170465 -7542726)
2013,Enero,Ecuador,1,1,,2,POINT (7088729 -70740253)
2013,Enero,Ecuador,5,7,,12,POINT (7128047 -73181317)
2013,Enero,Ecuador,113,156,,269,POINT (7819 -72453013)
2013,Enero,Ecuador,0,3,,3,POINT (7927233 -72508188)
2013,Enero,Egipto,0,1,,1,POINT (10446304 -75516486)
2013,Enero,Egipto,0,1,,1,POINT (3451668 -76532004)
2013,Enero,Egipto,4,19,,23,POINT (4697157 -74140516)
2013,Enero,Egipto,2,1,,3,POINT (6170465 -7542726)
2013,Enero,El Salvador,0,1,,1,POINT (0.81488 -77356)
2013,Enero,El Salvador,8,12,,20,POINT (10446304 -75516486)
2013,Enero,El Salvador,1,1,,2,POINT (10886686 -74776479)
2013,Enero,El Salvador,35,61,,96,POINT (3451668 -76532004)
2013,Enero,El Salvador,359,515,,874,POINT (4697157 -74140516)
2013,Enero,El Salvador,1,1,,2,POINT (4815189 -75736374)
2013,Enero,El Salvador,70,106,,176,POINT (6170465 -7542726)
2013,Enero,El Salvador,0,1,,1,POINT (7128047 -73181317)
2013,Enero,El Salvador,0,1,,1,POINT (863337 -7735002)
2013,Enero,Emiratos Árabes,0,9,,9,POINT (4697157 -74140516)
2013,Enero,España,3,4,,7,POINT (-4191162 -69941498)
2013,Enero,España,19,30,,49,POINT (0.81488 -77356)
2013,Enero,España,7,9,,16,POINT (10406342 -75527794)
2013,Enero,España,40,66,,106,POINT (10446304 -75516486)
2013,Enero,España,3,14,,17,POINT (10886686 -74776479)
2013,Enero,España,7,13,,20,POINT (11360029 -72129595)
2013,Enero,España,4,6,,10,POINT (125862 -81702165)
2013,Enero,España,160,334,,494,POINT (3451668 -76532004)
2013,Enero,España,1799,4256,,6055,POINT (4697157 -74140516)
2013,Enero,España,2,9,,11,POINT (4815189 -75736374)
2013,Enero,España,70,213,,283,POINT (6170465 -7542726)
2013,Enero,España,0,1,,1,POINT (6185536 -67484028)
2013,Enero,España,0,1,,1,POINT (7088729 -70740253)
2013,Enero,España,0,4,,4,POINT (7128047 -73181317)
2013,Enero,España,20,65,,85,POINT (7819 -72453013)
2013,Enero,España,0,9,,9,POINT (7927233 -72508188)
2013,Enero,España,0,2,,2,POINT (863337 -7735002)
2013,Enero,Eslovaquia,2,3,,5,POINT (0.81488 -77356)
2013,Enero,Eslovaquia,1,0,,1,POINT (10406342 -75527794)
2013,Enero,Eslovaquia,0,6,,6,POINT (10446304 -75516486)
2013,Enero,Eslovaquia,1,1,,2,POINT (3451668 -76532004)
2013,Enero,Eslovaquia,22,40,,62,POINT (4697157 -74140516)
2013,Enero,Eslovaquia,3,1,,4,POINT (6170465 -7542726)
2013,Enero,Eslovaquia,0,1,,1,POINT (7819 -72453013)
2013,Enero,Eslovenia,0,3,,3,POINT (10406342 -75527794)
2013,Enero,Eslovenia,1,0,,1,POINT (11360029 -72129595)
2013,Enero,Eslovenia,0,1,,1,POINT (3451668 -76532004)
2013,Enero,Eslovenia,23,30,,53,POINT (4697157 -74140516)
2013,Enero,Eslovenia,0,1,,1,POINT (7819 -72453013)
2013,Enero,Estados Unidos de América,9,23,,32,POINT (-4191162 -69941498)
2013,Enero,Estados Unidos de América,49,102,,151,POINT (0.81488 -77356)
2013,Enero,Estados Unidos de América,1,0,,1,POINT (1800143 -78802679)
2013,Enero,Estados Unidos de América,38,61,,99,POINT (10406342 -75527794)
2013,Enero,Estados Unidos de América,1042,1812,,2854,POINT (10446304 -75516486)
2013,Enero,Estados Unidos de América,191,370,,561,POINT (10886686 -74776479)
2013,Enero,Estados Unidos de América,0,7,,7,POINT (11247723 -74213989)
2013,Enero,Estados Unidos de América,10,22,,32,POINT (11360029 -72129595)
2013,Enero,Estados Unidos de América,0,1,,1,POINT (1152863 -72919186)
2013,Enero,Estados Unidos de América,4,3,,7,POINT (125744111 -81703935)
2013,Enero,Estados Unidos de América,18,30,,48,POINT (125862 -81702165)
2013,Enero,Estados Unidos de América,2,2,,4,POINT (133387613 -81372937)
2013,Enero,Estados Unidos de América,398,825,,1223,POINT (3451668 -76532004)
2013,Enero,Estados Unidos de América,39,88,,127,POINT (445285 -75766353)
2013,Enero,Estados Unidos de América,4407,8992,,13399,POINT (4697157 -74140516)
2013,Enero,Estados Unidos de América,72,112,,184,POINT (4815189 -75736374)
2013,Enero,Estados Unidos de América,736,2091,,2827,POINT (6170465 -7542726)
2013,Enero,Estados Unidos de América,0,1,,1,POINT (6185536 -67484028)
2013,Enero,Estados Unidos de América,1,2,,3,POINT (7088729 -70740253)
2013,Enero,Estados Unidos de América,21,34,,55,POINT (7128047 -73181317)
2013,Enero,Estados Unidos de América,50,97,,147,POINT (7819 -72453013)
2013,Enero,Estados Unidos de América,9,13,,22,POINT (7927233 -72508188)
2013,Enero,Estados Unidos de América,11,13,,24,POINT (863337 -7735002)
2013,Enero,Estonia,0,4,,4,POINT (10446304 -75516486)
2013,Enero,Estonia,0,1,,1,POINT (10970933 -74765343)
2013,Enero,Estonia,0,3,,3,POINT (3451668 -76532004)
2013,Enero,Estonia,15,9,,24,POINT (4697157 -74140516)
2013,Enero,Estonia,0,1,,1,POINT (7819 -72453013)
2013,Enero,Etiopia,2,1,,3,POINT (4697157 -74140516)
2013,Enero,Filipinas,0,2,,2,POINT (0.81488 -77356)
2013,Enero,Filipinas,0,17,,17,POINT (10406342 -75527794)
2013,Enero,Filipinas,1,8,,9,POINT (10446304 -75516486)
2013,Enero,Filipinas,0,4,,4,POINT (10886686 -74776479)
2013,Enero,Filipinas,0,6,,6,POINT (10970933 -74765343)
2013,Enero,Filipinas,0,9,,9,POINT (11247723 -74213989)
2013,Enero,Filipinas,1,3,,4,POINT (3451668 -76532004)
2013,Enero,Filipinas,0,6,,6,POINT (3884426 -77061029)
2013,Enero,Filipinas,19,41,,60,POINT (4697157 -74140516)
2013,Enero,Filipinas,1,4,,5,POINT (6170465 -7542726)
2013,Enero,Filipinas,1,0,,1,POINT (7819 -72453013)
2013,Enero,Filipinas,0,1,,1,POINT (9402597 -75681642)
2013,Enero,Finlandia,7,0,,7,POINT (0.81488 -77356)
2013,Enero,Finlandia,2,5,,7,POINT (10406342 -75527794)
2013,Enero,Finlandia,9,8,,17,POINT (10446304 -75516486)
2013,Enero,Finlandia,0,1,,1,POINT (10886686 -74776479)
2013,Enero,Finlandia,0,1,,1,POINT (11360029 -72129595)
2013,Enero,Finlandia,1,1,,2,POINT (3451668 -76532004)
2013,Enero,Finlandia,43,72,,115,POINT (4697157 -74140516)
2013,Enero,Finlandia,4,8,,12,POINT (6170465 -7542726)
2013,Enero,Finlandia,2,2,,4,POINT (7819 -72453013)
2013,Enero,Francia,9,10,,19,POINT (-4191162 -69941498)
2013,Enero,Francia,1,3,,4,POINT (0.33002 -76876446)
2013,Enero,Francia,54,74,,128,POINT (0.81488 -77356)
2013,Enero,Francia,2,1,,3,POINT (1800143 -78802679)
2013,Enero,Francia,11,29,,40,POINT (10406342 -75527794)
2013,Enero,Francia,24,40,,64,POINT (10446304 -75516486)
2013,Enero,Francia,2,6,,8,POINT (10886686 -74776479)
2013,Enero,Francia,0,3,,3,POINT (10970933 -74765343)
2013,Enero,Francia,1,4,,5,POINT (11247723 -74213989)
2013,Enero,Francia,11,10,,21,POINT (11360029 -72129595)
2013,Enero,Francia,1,2,,3,POINT (125862 -81702165)
2013,Enero,Francia,1,1,,2,POINT (133387613 -81372937)
2013,Enero,Francia,37,88,,125,POINT (3451668 -76532004)
2013,Enero,Francia,1173,1941,,3114,POINT (4697157 -74140516)
2013,Enero,Francia,3,6,,9,POINT (4815189 -75736374)
2013,Enero,Francia,35,62,,97,POINT (6170465 -7542726)
2013,Enero,Francia,0,1,,1,POINT (6185536 -67484028)
2013,Enero,Francia,0,1,,1,POINT (7088729 -70740253)
2013,Enero,Francia,1,1,,2,POINT (7128047 -73181317)
2013,Enero,Francia,8,11,,19,POINT (7819 -72453013)
2013,Enero,Francia,0,3,,3,POINT (7927233 -72508188)
2013,Enero,Francia,5,9,,14,POINT (863337 -7735002)
2013,Enero,Gabón,1,1,,2,POINT (4697157 -74140516)
2013,Enero,Georgia,2,0,,2,POINT (4697157 -74140516)
2013,Enero,Ghana,0,1,,1,POINT (11360029 -72129595)
2013,Enero,Ghana,0,2,,2,POINT (4697157 -74140516)
2013,Enero,Grecia,0,1,,1,POINT (10406342 -75527794)
2013,Enero,Grecia,0,2,,2,POINT (10446304 -75516486)
2013,Enero,Grecia,0,2,,2,POINT (11247723 -74213989)
2013,Enero,Grecia,0,1,,1,POINT (11360029 -72129595)
2013,Enero,Grecia,0,3,,3,POINT (3451668 -76532004)
2013,Enero,Grecia,9,46,,55,POINT (4697157 -74140516)
2013,Enero,Grecia,0,4,,4,POINT (6170465 -7542726)
2013,Enero,Grecia,0,2,,2,POINT (7819 -72453013)
2013,Enero,Grecia,0,2,,2,POINT (9402597 -75681642)
2013,Enero,Guatemala,0,2,,2,POINT (0.81488 -77356)
2013,Enero,Guatemala,0,1,,1,POINT (10406342 -75527794)
2013,Enero,Guatemala,15,29,,44,POINT (10446304 -75516486)
2013,Enero,Guatemala,2,10,,12,POINT (10886686 -74776479)
2013,Enero,Guatemala,0,1,,1,POINT (125862 -81702165)
2013,Enero,Guatemala,21,62,,83,POINT (3451668 -76532004)
2013,Enero,Guatemala,151,294,,445,POINT (4697157 -74140516)
2013,Enero,Guatemala,1,4,,5,POINT (4815189 -75736374)
2013,Enero,Guatemala,44,111,,155,POINT (6170465 -7542726)
2013,Enero,Guatemala,1,1,,2,POINT (7128047 -73181317)
2013,Enero,Guatemala,12,16,,28,POINT (7819 -72453013)
2013,Enero,Guatemala,3,2,,5,POINT (7927233 -72508188)
2013,Enero,Guatemala,1,1,,2,POINT (863337 -7735002)
2013,Enero,Guyana,0,1,,1,POINT (-4191162 -69941498)
2013,Enero,Guyana,0,1,,1,POINT (10446304 -75516486)
2013,Enero,Guyana,1,2,,3,POINT (3451668 -76532004)
2013,Enero,Guyana,4,10,,14,POINT (4697157 -74140516)
2013,Enero,Guyana,0,4,,4,POINT (6170465 -7542726)
2013,Enero,Guyana,2,0,,2,POINT (7128047 -73181317)
2013,Enero,Guinea Bissau,0,1,,1,POINT (4697157 -74140516)
2013,Enero,Guayana Francesa/Departamento de Ultramar Francés,0,1,,1,POINT (4697157 -74140516)
2013,Enero,Haití,0,2,,2,POINT (0.81488 -77356)
2013,Enero,Haití,1,0,,1,POINT (10446304 -75516486)
2013,Enero,Haití,0,1,,1,POINT (10886686 -74776479)
2013,Enero,Haití,2,16,,18,POINT (4697157 -74140516)
2013,Enero,Haití,0,1,,1,POINT (6170465 -7542726)
2013,Enero,Honduras,0,1,,1,POINT (0.81488 -77356)
2013,Enero,Honduras,10,15,,25,POINT (10446304 -75516486)
2013,Enero,Honduras,1,1,,2,POINT (10886686 -74776479)
2013,Enero,Honduras,1,0,,1,POINT (10970933 -74765343)
2013,Enero,Honduras,0,2,,2,POINT (125744111 -81703935)
2013,Enero,Honduras,2,4,,6,POINT (125862 -81702165)
2013,Enero,Honduras,14,23,,37,POINT (3451668 -76532004)
2013,Enero,Honduras,110,127,,237,POINT (4697157 -74140516)
2013,Enero,Honduras,0,1,,1,POINT (4815189 -75736374)
2013,Enero,Honduras,24,46,,70,POINT (6170465 -7542726)
2013,Enero,Honduras,1,0,,1,POINT (7819 -72453013)
2013,Enero,Honduras,1,0,,1,POINT (7927233 -72508188)
2013,Enero,Honduras,0,1,,1,POINT (806667 -767333)
2013,Enero,Honduras,0,2,,2,POINT (863337 -7735002)
2013,Enero,Hong Kong,0,2,,2,POINT (4697157 -74140516)
2013,Enero,Hungría,1,3,,4,POINT (0.81488 -77356)
2013,Enero,Hungría,4,1,,5,POINT (10446304 -75516486)
2013,Enero,Hungría,0,4,,4,POINT (3451668 -76532004)
2013,Enero,Hungría,13,36,,49,POINT (4697157 -74140516)
2013,Enero,Hungría,1,0,,1,POINT (7819 -72453013)
2013,Enero,India,0,5,,5,POINT (0.81488 -77356)
2013,Enero,India,2,9,,11,POINT (10446304 -75516486)
2013,Enero,India,1,2,,3,POINT (10886686 -74776479)
2013,Enero,India,5,16,,21,POINT (3451668 -76532004)
2013,Enero,India,34,190,,224,POINT (4697157 -74140516)
2013,Enero,India,0,1,,1,POINT (4815189 -75736374)
2013,Enero,India,5,44,,49,POINT (6170465 -7542726)
2013,Enero,Indonesia,0,6,,6,POINT (10406342 -75527794)
2013,Enero,Indonesia,1,2,,3,POINT (10446304 -75516486)
2013,Enero,Indonesia,3,14,,17,POINT (4697157 -74140516)
2013,Enero,Indonesia,1,1,,2,POINT (6170465 -7542726)
2013,Enero,Irán,0,1,,1,POINT (3451668 -76532004)
2013,Enero,Irán,4,5,,9,POINT (4697157 -74140516)
2013,Enero,Irán,0,2,,2,POINT (6170465 -7542726)
2013,Enero,República de Irlanda,0,4,,4,POINT (-4191162 -69941498)
2013,Enero,República de Irlanda,11,12,,23,POINT (0.81488 -77356)
2013,Enero,República de Irlanda,1,1,,2,POINT (10406342 -75527794)
2013,Enero,República de Irlanda,3,13,,16,POINT (10446304 -75516486)
2013,Enero,República de Irlanda,0,1,,1,POINT (3451668 -76532004)
2013,Enero,República de Irlanda,42,99,,141,POINT (4697157 -74140516)
2013,Enero,República de Irlanda,3,14,,17,POINT (6170465 -7542726)
2013,Enero,República de Irlanda,0,2,,2,POINT (7819 -72453013)
2013,Enero,República de Irlanda,0,1,,1,POINT (7927233 -72508188)
2013,Enero,República de Irlanda,2,2,,4,POINT (863337 -7735002)
2013,Enero,Islandia,2,7,,9,POINT (4697157 -74140516)
2013,Enero,Isla de Man,10,17,,27,POINT (0.81488 -77356)
2013,Enero,Isla de Man,5,12,,17,POINT (10446304 -75516486)
2013,Enero,Isla de Man,1,3,,4,POINT (10886686 -74776479)
2013,Enero,Isla de Man,14,22,,36,POINT (3451668 -76532004)
2013,Enero,Isla de Man,32,103,,135,POINT (4697157 -74140516)
2013,Enero,Isla de Man,0,1,,1,POINT (4815189 -75736374)
2013,Enero,Isla de Man,13,40,,53,POINT (6170465 -7542726)
2013,Enero,Isla de Man,1,2,,3,POINT (7819 -72453013)
2013,Enero,Isla de Man,2,3,,5,POINT (863337 -7735002)
2013,Enero,Isla Johnston,0,1,,1,POINT (4697157 -74140516)
2013,Enero,Israel,1,1,,2,POINT (-4191162 -69941498)
2013,Enero,Israel,1,2,,3,POINT (0.81488 -77356)
2013,Enero,Israel,0,1,,1,POINT (10406342 -75527794)
2013,Enero,Israel,2,18,,20,POINT (10446304 -75516486)
2013,Enero,Israel,6,14,,20,POINT (3451668 -76532004)
2013,Enero,Israel,86,372,,458,POINT (4697157 -74140516)
2013,Enero,Israel,1,34,,35,POINT (6170465 -7542726)
2013,Enero,Israel,0,1,,1,POINT (7128047 -73181317)
2013,Enero,Israel,0,1,,1,POINT (7819 -72453013)
2013,Enero,Islas Aland/Provincia de Finlandia,2,0,,2,POINT (4697157 -74140516)
2013,Enero,Italia,0,4,,4,POINT (-4191162 -69941498)
2013,Enero,Italia,0,2,,2,POINT (0.33002 -76876446)
2013,Enero,Italia,23,40,,63,POINT (0.81488 -77356)
2013,Enero,Italia,4,12,,16,POINT (10406342 -75527794)
2013,Enero,Italia,40,131,,171,POINT (10446304 -75516486)
2013,Enero,Italia,1,22,,23,POINT (10886686 -74776479)
2013,Enero,Italia,0,1,,1,POINT (10970933 -74765343)
2013,Enero,Italia,0,1,,1,POINT (11247723 -74213989)
2013,Enero,Italia,6,33,,39,POINT (11360029 -72129595)
2013,Enero,Italia,4,6,,10,POINT (125862 -81702165)
2013,Enero,Italia,1,1,,2,POINT (133387613 -81372937)
2013,Enero,Italia,22,109,,131,POINT (3451668 -76532004)
2013,Enero,Italia,0,1,,1,POINT (3884426 -77061029)
2013,Enero,Italia,555,1873,,2428,POINT (4697157 -74140516)
2013,Enero,Italia,0,4,,4,POINT (4815189 -75736374)
2013,Enero,Italia,39,116,,155,POINT (6170465 -7542726)
2013,Enero,Italia,1,3,,4,POINT (6185536 -67484028)
2013,Enero,Italia,0,2,,2,POINT (7128047 -73181317)
2013,Enero,Italia,3,20,,23,POINT (7819 -72453013)
2013,Enero,Italia,2,5,,7,POINT (7927233 -72508188)
2013,Enero,Italia,1,4,,5,POINT (863337 -7735002)
2013,Enero,Jamaica,0,1,,1,POINT (10406342 -75527794)
2013,Enero,Jamaica,0,1,,1,POINT (10446304 -75516486)
2013,Enero,Jamaica,0,1,,1,POINT (10886686 -74776479)
2013,Enero,Jamaica,3,2,,5,POINT (125862 -81702165)
2013,Enero,Jamaica,2,2,,4,POINT (3451668 -76532004)
2013,Enero,Jamaica,9,11,,20,POINT (4697157 -74140516)
2013,Enero,Jamaica,1,8,,9,POINT (6170465 -7542726)
2013,Enero,Jamaica,1,0,,1,POINT (7128047 -73181317)
2013,Enero,Jamaica,0,1,,1,POINT (7819 -72453013)
2013,Enero,Islas Marianas del Norte,0,1,,1,POINT (4697157 -74140516)
2013,Enero,Japón,1,1,,2,POINT (-4191162 -69941498)
2013,Enero,Japón,4,23,,27,POINT (0.81488 -77356)
2013,Enero,Japón,0,1,,1,POINT (10406342 -75527794)
2013,Enero,Japón,3,8,,11,POINT (10446304 -75516486)
2013,Enero,Japón,0,3,,3,POINT (10886686 -74776479)
2013,Enero,Japón,0,1,,1,POINT (11360029 -72129595)
2013,Enero,Japón,6,25,,31,POINT (3451668 -76532004)
2013,Enero,Japón,118,391,,509,POINT (4697157 -74140516)
2013,Enero,Japón,1,0,,1,POINT (4815189 -75736374)
2013,Enero,Japón,7,36,,43,POINT (6170465 -7542726)
2013,Enero,Japón,0,1,,1,POINT (7927233 -72508188)
2013,Enero,Japón,0,2,,2,POINT (863337 -7735002)
2013,Enero,Jordania,0,2,,2,POINT (4697157 -74140516)
2013,Enero,Kenia,1,0,,1,POINT (10446304 -75516486)
2013,Enero,Kenia,2,4,,6,POINT (4697157 -74140516)
2013,Enero,Kirguistán,3,1,,4,POINT (4697157 -74140516)
2013,Enero,Kuwait,0,1,,1,POINT (4697157 -74140516)
2013,Enero,Letonia,1,3,,4,POINT (10406342 -75527794)
2013,Enero,Letonia,1,2,,3,POINT (10446304 -75516486)
2013,Enero,Letonia,0,1,,1,POINT (3451668 -76532004)
2013,Enero,Letonia,7,20,,27,POINT (4697157 -74140516)
2013,Enero,Letonia,1,4,,5,POINT (6170465 -7542726)
2013,Enero,Lituania,1,0,,1,POINT (10446304 -75516486)
2013,Enero,Lituania,0,1,,1,POINT (11360029 -72129595)
2013,Enero,Lituania,3,0,,3,POINT (3451668 -76532004)
2013,Enero,Lituania,6,12,,18,POINT (4697157 -74140516)
2013,Enero,Lituania,1,0,,1,POINT (6170465 -7542726)
2013,Enero,Lituania,1,1,,2,POINT (863337 -7735002)
2013,Enero,Líbano,1,0,,1,POINT (10446304 -75516486)
2013,Enero,Líbano,2,2,,4,POINT (10886686 -74776479)
2013,Enero,Líbano,7,5,,12,POINT (11360029 -72129595)
2013,Enero,Líbano,1,3,,4,POINT (3451668 -76532004)
2013,Enero,Líbano,9,27,,36,POINT (4697157 -74140516)
2013,Enero,Líbano,1,0,,1,POINT (4815189 -75736374)
2013,Enero,Líbano,0,1,,1,POINT (6170465 -7542726)
2013,Enero,Líbano,0,1,,1,POINT (7128047 -73181317)
2013,Enero,Liechtenstein,1,0,,1,POINT (4697157 -74140516)
2013,Enero,Luxemburgo,7,12,,19,POINT (4697157 -74140516)
2013,Enero,Luxemburgo,1,1,,2,POINT (6170465 -7542726)
2013,Enero,Macedonia,0,2,,2,POINT (4697157 -74140516)
2013,Enero,Malasia,2,4,,6,POINT (10446304 -75516486)
2013,Enero,Malasia,7,8,,15,POINT (4697157 -74140516)
2013,Enero,Malasia,1,0,,1,POINT (7819 -72453013)
2013,Enero,Malawi,0,1,,1,POINT (4697157 -74140516)
2013,Enero,Malta,0,1,,1,POINT (4697157 -74140516)
2013,Enero,Marruecos,0,1,,1,POINT (3451668 -76532004)
2013,Enero,Marruecos,1,13,,14,POINT (4697157 -74140516)
2013,Enero,Mauricio,0,1,,1,POINT (10446304 -75516486)
2013,Enero,México,1,2,,3,POINT (-4191162 -69941498)
2013,Enero,México,15,21,,36,POINT (0.81488 -77356)
2013,Enero,México,6,8,,14,POINT (10406342 -75527794)
2013,Enero,México,61,154,,215,POINT (10446304 -75516486)
2013,Enero,México,16,33,,49,POINT (10886686 -74776479)
2013,Enero,México,1,5,,6,POINT (11360029 -72129595)
2013,Enero,México,1,1,,2,POINT (125862 -81702165)
2013,Enero,México,48,150,,198,POINT (3451668 -76532004)
2013,Enero,México,1731,3448,,5179,POINT (4697157 -74140516)
2013,Enero,México,2,14,,16,POINT (4815189 -75736374)
2013,Enero,México,113,410,,523,POINT (6170465 -7542726)
2013,Enero,México,3,2,,5,POINT (6185536 -67484028)
2013,Enero,México,0,1,,1,POINT (7088729 -70740253)
2013,Enero,México,2,6,,8,POINT (7128047 -73181317)
2013,Enero,México,22,33,,55,POINT (7819 -72453013)
2013,Enero,México,4,6,,10,POINT (7927233 -72508188)
2013,Enero,México,1,6,,7,POINT (863337 -7735002)
2013,Enero,República de Moldavia,1,0,,1,POINT (3451668 -76532004)
2013,Enero,República de Moldavia,1,0,,1,POINT (4697157 -74140516)
2013,Enero,Mónaco,0,2,,2,POINT (4697157 -74140516)
2013,Enero,Mongolia,2,0,,2,POINT (4697157 -74140516)
2013,Enero,Montenegro,2,0,,2,POINT (4697157 -74140516)
2013,Enero,Mozambique,0,4,,4,POINT (4697157 -74140516)
2013,Enero,Myanmar,0,2,,2,POINT (4697157 -74140516)
2013,Enero,Nepal,0,1,,1,POINT (10406342 -75527794)
2013,Enero,Nepal,0,2,,2,POINT (4697157 -74140516)
2013,Enero,Nicaragua,4,3,,7,POINT (10446304 -75516486)
2013,Enero,Nicaragua,0,2,,2,POINT (125744111 -81703935)
2013,Enero,Nicaragua,0,1,,1,POINT (125862 -81702165)
2013,Enero,Nicaragua,8,3,,11,POINT (3451668 -76532004)
2013,Enero,Nicaragua,64,52,,116,POINT (4697157 -74140516)
2013,Enero,Nicaragua,10,16,,26,POINT (6170465 -7542726)
2013,Enero,Nicaragua,2,1,,3,POINT (7128047 -73181317)
2013,Enero,Nicaragua,0,1,,1,POINT (7927233 -72508188)
2013,Enero,Nicaragua,1,0,,1,POINT (863337 -7735002)
2013,Enero,Nigeria,0,1,,1,POINT (0.81488 -77356)
2013,Enero,Nigeria,1,0,,1,POINT (10446304 -75516486)
2013,Enero,Nigeria,1,0,,1,POINT (3451668 -76532004)
2013,Enero,Nigeria,1,11,,12,POINT (4697157 -74140516)
2013,Enero,Noruega,1,1,,2,POINT (-4191162 -69941498)
2013,Enero,Noruega,5,4,,9,POINT (0.81488 -77356)
2013,Enero,Noruega,1,3,,4,POINT (10406342 -75527794)
2013,Enero,Noruega,13,18,,31,POINT (10446304 -75516486)
2013,Enero,Noruega,1,3,,4,POINT (11247723 -74213989)
2013,Enero,Noruega,3,3,,6,POINT (3451668 -76532004)
2013,Enero,Noruega,68,150,,218,POINT (4697157 -74140516)
2013,Enero,Noruega,0,1,,1,POINT (4815189 -75736374)
2013,Enero,Noruega,10,17,,27,POINT (6170465 -7542726)
2013,Enero,Noruega,0,1,,1,POINT (7819 -72453013)
2013,Enero,Noruega,0,1,,1,POINT (863337 -7735002)
2013,Enero,Nueva Zelanda,0,1,,1,POINT (-4191162 -69941498)
2013,Enero,Nueva Zelanda,7,12,,19,POINT (0.81488 -77356)
2013,Enero,Nueva Zelanda,6,5,,11,POINT (10446304 -75516486)
2013,Enero,Nueva Zelanda,3,2,,5,POINT (10886686 -74776479)
2013,Enero,Nueva Zelanda,3,0,,3,POINT (11360029 -72129595)
2013,Enero,Nueva Zelanda,1,3,,4,POINT (3451668 -76532004)
2013,Enero,Nueva Zelanda,23,49,,72,POINT (4697157 -74140516)
2013,Enero,Nueva Zelanda,4,8,,12,POINT (6170465 -7542726)
2013,Enero,Nueva Zelanda,1,0,,1,POINT (7819 -72453013)
2013,Enero,Nueva Zelanda,1,3,,4,POINT (863337 -7735002)
2013,Enero,Nueva Zelanda,0,1,,1,POINT (0.81488 -77356)
2013,Enero,Nueva Zelanda,2,2,,4,POINT (10406342 -75527794)
2013,Enero,Nueva Zelanda,1,1,,2,POINT (133387613 -81372937)
2013,Enero,Nueva Zelanda,3,2,,5,POINT (4697157 -74140516)
2013,Enero,Países Bajos,0,1,,1,POINT (-4191162 -69941498)
2013,Enero,Países Bajos,8,11,,19,POINT (0.81488 -77356)
2013,Enero,Países Bajos,3,10,,13,POINT (10446304 -75516486)
2013,Enero,Países Bajos,0,4,,4,POINT (10886686 -74776479)
2013,Enero,Países Bajos,0,1,,1,POINT (10970933 -74765343)
2013,Enero,Países Bajos,2,5,,7,POINT (11360029 -72129595)
2013,Enero,Países Bajos,14,22,,36,POINT (1152863 -72919186)
2013,Enero,Países Bajos,0,1,,1,POINT (125862 -81702165)
2013,Enero,Países Bajos,10,21,,31,POINT (3451668 -76532004)
2013,Enero,Países Bajos,13,20,,33,POINT (445285 -75766353)
2013,Enero,Países Bajos,160,246,,406,POINT (4697157 -74140516)
2013,Enero,Países Bajos,1,5,,6,POINT (4815189 -75736374)
2013,Enero,Países Bajos,103,154,,257,POINT (6170465 -7542726)
2013,Enero,Países Bajos,11,11,,22,POINT (7128047 -73181317)
2013,Enero,Países Bajos,0,1,,1,POINT (7819 -72453013)
2013,Enero,Países Bajos,0,1,,1,POINT (7927233 -72508188)
2013,Enero,Pakistán,0,2,,2,POINT (0.81488 -77356)
2013,Enero,Pakistán,1,9,,10,POINT (4697157 -74140516)
2013,Enero,Pakistán,0,2,,2,POINT (6170465 -7542726)
2013,Enero,Pakistán,0,1,,1,POINT (7819 -72453013)
2013,Enero,Panamá,0,1,,1,POINT (0.33002 -76876446)
2013,Enero,Panamá,1,0,,1,POINT (0.81488 -77356)
2013,Enero,Panamá,4,28,,32,POINT (10406342 -75527794)
2013,Enero,Panamá,120,193,,313,POINT (10446304 -75516486)
2013,Enero,Panamá,69,83,,152,POINT (10886686 -74776479)
2013,Enero,Panamá,0,10,,10,POINT (11247723 -74213989)
2013,Enero,Panamá,0,1,,1,POINT (11360029 -72129595)
2013,Enero,Panamá,0,2,,2,POINT (125744111 -81703935)
2013,Enero,Panamá,34,28,,62,POINT (125862 -81702165)
2013,Enero,Panamá,101,125,,226,POINT (3451668 -76532004)
2013,Enero,Panamá,531,767,,1298,POINT (4697157 -74140516)
2013,Enero,Panamá,81,114,,195,POINT (4815189 -75736374)
2013,Enero,Panamá,106,237,,343,POINT (6170465 -7542726)
2013,Enero,Panamá,6,5,,11,POINT (6222552 -77401154)
2013,Enero,Panamá,5,14,,19,POINT (7128047 -73181317)
2013,Enero,Panamá,7,8,,15,POINT (7819 -72453013)
2013,Enero,Panamá,6,8,,14,POINT (7927233 -72508188)
2013,Enero,Panamá,6,8,,14,POINT (863337 -7735002)
2013,Enero,Paraguay,0,4,,4,POINT (0.81488 -77356)
2013,Enero,Paraguay,4,9,,13,POINT (10446304 -75516486)
2013,Enero,Paraguay,1,1,,2,POINT (10886686 -74776479)
2013,Enero,Paraguay,1,0,,1,POINT (11360029 -72129595)
2013,Enero,Paraguay,27,16,,43,POINT (125862 -81702165)
2013,Enero,Paraguay,5,5,,10,POINT (3451668 -76532004)
2013,Enero,Paraguay,79,95,,174,POINT (4697157 -74140516)
2013,Enero,Paraguay,1,1,,2,POINT (4815189 -75736374)
2013,Enero,Paraguay,0,2,,2,POINT (6170465 -7542726)
2013,Enero,Paraguay,0,1,,1,POINT (7819 -72453013)
2013,Enero,Perú,31,29,,60,POINT (-4191162 -69941498)
2013,Enero,Perú,2,3,,5,POINT (0.33002 -76876446)
2013,Enero,Perú,262,481,,743,POINT (0.81488 -77356)
2013,Enero,Perú,0,1,,1,POINT (1800143 -78802679)
2013,Enero,Perú,1,7,,8,POINT (10406342 -75527794)
2013,Enero,Perú,176,167,,343,POINT (10446304 -75516486)
2013,Enero,Perú,36,38,,74,POINT (10886686 -74776479)
2013,Enero,Perú,0,2,,2,POINT (10970933 -74765343)
2013,Enero,Perú,3,2,,5,POINT (11360029 -72129595)
2013,Enero,Perú,66,51,,117,POINT (125862 -81702165)
2013,Enero,Perú,1,0,,1,POINT (133387613 -81372937)
2013,Enero,Perú,144,194,,338,POINT (3451668 -76532004)
2013,Enero,Perú,0,2,,2,POINT (445285 -75766353)
2013,Enero,Perú,1946,2810,,4756,POINT (4697157 -74140516)
2013,Enero,Perú,4,4,,8,POINT (4815189 -75736374)
2013,Enero,Perú,168,349,,517,POINT (6170465 -7542726)
2013,Enero,Perú,3,1,,4,POINT (6185536 -67484028)
2013,Enero,Perú,0,2,,2,POINT (7128047 -73181317)
2013,Enero,Perú,35,57,,92,POINT (7819 -72453013)
2013,Enero,Perú,0,1,,1,POINT (863337 -7735002)
2013,Enero,Polonia,0,1,,1,POINT (-4191162 -69941498)
2013,Enero,Polonia,9,6,,15,POINT (0.81488 -77356)
2013,Enero,Polonia,0,8,,8,POINT (10406342 -75527794)
2013,Enero,Polonia,2,7,,9,POINT (10446304 -75516486)
2013,Enero,Polonia,0,9,,9,POINT (10970933 -74765343)
2013,Enero,Polonia,1,4,,5,POINT (11360029 -72129595)
2013,Enero,Polonia,1,0,,1,POINT (125862 -81702165)
2013,Enero,Polonia,1,2,,3,POINT (3451668 -76532004)
2013,Enero,Polonia,0,4,,4,POINT (3884426 -77061029)
2013,Enero,Polonia,80,114,,194,POINT (4697157 -74140516)
2013,Enero,Polonia,3,1,,4,POINT (6170465 -7542726)
2013,Enero,Polonia,0,3,,3,POINT (7819 -72453013)
2013,Enero,Polonia,1,1,,2,POINT (7927233 -72508188)
2013,Enero,Portugal,5,19,,24,POINT (0.81488 -77356)
2013,Enero,Portugal,0,2,,2,POINT (10406342 -75527794)
2013,Enero,Portugal,1,20,,21,POINT (10446304 -75516486)
2013,Enero,Portugal,0,2,,2,POINT (10886686 -74776479)
2013,Enero,Portugal,0,3,,3,POINT (11360029 -72129595)
2013,Enero,Portugal,7,20,,27,POINT (3451668 -76532004)
2013,Enero,Portugal,111,373,,484,POINT (4697157 -74140516)
2013,Enero,Portugal,0,1,,1,POINT (4815189 -75736374)
2013,Enero,Portugal,6,28,,34,POINT (6170465 -7542726)
2013,Enero,Portugal,3,5,,8,POINT (7819 -72453013)
2013,Enero,Portugal,0,2,,2,POINT (7927233 -72508188)
2013,Enero,Puerto Rico/Territorio de Estados Unidos,1,1,,2,POINT (10446304 -75516486)
2013,Enero,Puerto Rico/Territorio de Estados Unidos,0,3,,3,POINT (4697157 -74140516)
2013,Enero,Qatar,2,22,,24,POINT (4697157 -74140516)
2013,Enero,Reino Unido de Gran Bretaña e Irlanda del Norte,3,2,,5,POINT (-4191162 -69941498)
2013,Enero,Reino Unido de Gran Bretaña e Irlanda del Norte,5,10,,15,POINT (0.81488 -77356)
2013,Enero,Reino Unido de Gran Bretaña e Irlanda del Norte,2,6,,8,POINT (10406342 -75527794)
2013,Enero,Reino Unido de Gran Bretaña e Irlanda del Norte,21,37,,58,POINT (10446304 -75516486)
2013,Enero,Reino Unido de Gran Bretaña e Irlanda del Norte,0,2,,2,POINT (10886686 -74776479)
2013,Enero,Reino Unido de Gran Bretaña e Irlanda del Norte,1,2,,3,POINT (11247723 -74213989)
2013,Enero,Reino Unido de Gran Bretaña e Irlanda del Norte,0,2,,2,POINT (11360029 -72129595)
2013,Enero,Reino Unido de Gran Bretaña e Irlanda del Norte,14,22,,36,POINT (3451668 -76532004)
2013,Enero,Reino Unido de Gran Bretaña e Irlanda del Norte,211,487,,698,POINT (4697157 -74140516)
2013,Enero,Reino Unido de Gran Bretaña e Irlanda del Norte,15,50,,65,POINT (6170465 -7542726)
2013,Enero,Reino Unido de Gran Bretaña e Irlanda del Norte,1,8,,9,POINT (7819 -72453013)
2013,Enero,Reino Unido de Gran Bretaña e Irlanda del Norte,0,1,,1,POINT (7927233 -72508188)
2013,Enero,República de Belarús,1,4,,5,POINT (4697157 -74140516)
2013,Enero,República Dominicana,1,4,,5,POINT (0.81488 -77356)
2013,Enero,República Dominicana,0,1,,1,POINT (10406342 -75527794)
2013,Enero,República Dominicana,16,24,,40,POINT (10446304 -75516486)
2013,Enero,República Dominicana,15,84,,99,POINT (10886686 -74776479)
2013,Enero,República Dominicana,1,3,,4,POINT (11360029 -72129595)
2013,Enero,República Dominicana,20,15,,35,POINT (3451668 -76532004)
2013,Enero,República Dominicana,200,260,,460,POINT (4697157 -74140516)
2013,Enero,República Dominicana,2,1,,3,POINT (4815189 -75736374)
2013,Enero,República Dominicana,29,44,,73,POINT (6170465 -7542726)
2013,Enero,República Dominicana,2,0,,2,POINT (7128047 -73181317)
2013,Enero,República Dominicana,1,2,,3,POINT (7819 -72453013)
2013,Enero,República Dominicana,4,2,,6,POINT (7927233 -72508188)
2013,Enero,República Checa,3,1,,4,POINT (10406342 -75527794)
2013,Enero,República Checa,1,0,,1,POINT (10446304 -75516486)
2013,Enero,República Checa,3,4,,7,POINT (4697157 -74140516)
2013,Enero,República Checa,1,1,,2,POINT (7819 -72453013)
2013,Enero,Rumania,2,1,,3,POINT (0.81488 -77356)
2013,Enero,Rumania,0,2,,2,POINT (10406342 -75527794)
2013,Enero,Rumania,2,3,,5,POINT (10446304 -75516486)
2013,Enero,Rumania,0,1,,1,POINT (10970933 -74765343)
2013,Enero,Rumania,1,1,,2,POINT (11360029 -72129595)
2013,Enero,Rumania,1,3,,4,POINT (3451668 -76532004)
2013,Enero,Rumania,29,39,,68,POINT (4697157 -74140516)
2013,Enero,Rumania,2,6,,8,POINT (6170465 -7542726)
2013,Enero,Rumania,0,1,,1,POINT (7819 -72453013)
2013,Enero,Federación de Rusia,1,4,,5,POINT (0.81488 -77356)
2013,Enero,Federación de Rusia,11,5,,16,POINT (10446304 -75516486)
2013,Enero,Federación de Rusia,1,2,,3,POINT (10886686 -74776479)
2013,Enero,Federación de Rusia,0,1,,1,POINT (11360029 -72129595)
2013,Enero,Federación de Rusia,2,0,,2,POINT (3451668 -76532004)
2013,Enero,Federación de Rusia,47,57,,104,POINT (4697157 -74140516)
2013,Enero,Federación de Rusia,1,0,,1,POINT (6170465 -7542726)
2013,Enero,Federación de Rusia,1,1,,2,POINT (7128047 -73181317)
2013,Enero,Federación de Rusia,1,0,,1,POINT (7819 -72453013)
2013,Enero,Federación de Rusia,1,0,,1,POINT (863337 -7735002)
2013,Enero,Federación de Rusia,0,1,,1,POINT (9402597 -75681642)
2013,Enero,Rwanda,0,1,,1,POINT (4697157 -74140516)
2013,Enero,Samoa Occidental,1,0,,1,POINT (4697157 -74140516)
2013,Enero,San  Vicente y las Granadinas,0,1,,1,POINT (10406342 -75527794)
2013,Enero,San  Vicente y las Granadinas,0,1,,1,POINT (10446304 -75516486)
2013,Enero,Santa Lucia,1,0,,1,POINT (10446304 -75516486)
2013,Enero,Santa Lucia,0,1,,1,POINT (125862 -81702165)
2013,Enero,Santa Lucia,1,0,,1,POINT (3451668 -76532004)
2013,Enero,Santa Lucia,2,0,,2,POINT (4697157 -74140516)
2013,Enero,Santa Lucia,6,3,,9,POINT (7128047 -73181317)
2013,Enero,Santa Sede/Ciudad del Vaticano,0,1,,1,POINT (4697157 -74140516)
2013,Enero,Senegal,0,1,,1,POINT (4697157 -74140516)
2013,Enero,Serbia,1,0,,1,POINT (10446304 -75516486)
2013,Enero,Serbia,1,0,,1,POINT (3451668 -76532004)
2013,Enero,Serbia,3,5,,8,POINT (4697157 -74140516)
2013,Enero,Sierra Leona,0,2,,2,POINT (4697157 -74140516)
2013,Enero,Singapur,1,1,,2,POINT (10446304 -75516486)
2013,Enero,Singapur,1,0,,1,POINT (3451668 -76532004)
2013,Enero,Singapur,13,24,,37,POINT (4697157 -74140516)
2013,Enero,Singapur,0,1,,1,POINT (6170465 -7542726)
2013,Enero,Singapur,1,0,,1,POINT (7128047 -73181317)
2013,Enero,República Árabe Siria,1,0,,1,POINT (10886686 -74776479)
2013,Enero,República Árabe Siria,1,2,,3,POINT (4697157 -74140516)
2013,Enero,Sri Lanka,0,9,,9,POINT (4697157 -74140516)
2013,Enero,Sudáfrica,1,0,,1,POINT (-4191162 -69941498)
2013,Enero,Sudáfrica,1,3,,4,POINT (10406342 -75527794)
2013,Enero,Sudáfrica,4,3,,7,POINT (10446304 -75516486)
2013,Enero,Sudáfrica,1,2,,3,POINT (10886686 -74776479)
2013,Enero,Sudáfrica,1,2,,3,POINT (11247723 -74213989)
2013,Enero,Sudáfrica,0,1,,1,POINT (3451668 -76532004)
2013,Enero,Sudáfrica,30,58,,88,POINT (4697157 -74140516)
2013,Enero,Sudáfrica,0,2,,2,POINT (4815189 -75736374)
2013,Enero,Sudáfrica,3,6,,9,POINT (6170465 -7542726)
2013,Enero,Suecia,0,5,,5,POINT (-4191162 -69941498)
2013,Enero,Suecia,6,12,,18,POINT (0.81488 -77356)
2013,Enero,Suecia,0,1,,1,POINT (1800143 -78802679)
2013,Enero,Suecia,9,10,,19,POINT (10406342 -75527794)
2013,Enero,Suecia,13,31,,44,POINT (10446304 -75516486)
2013,Enero,Suecia,1,1,,2,POINT (10886686 -74776479)
2013,Enero,Suecia,1,2,,3,POINT (11360029 -72129595)
2013,Enero,Suecia,0,1,,1,POINT (125744111 -81703935)
2013,Enero,Suecia,1,1,,2,POINT (125862 -81702165)
2013,Enero,Suecia,1,0,,1,POINT (133387613 -81372937)
2013,Enero,Suecia,7,10,,17,POINT (3451668 -76532004)
2013,Enero,Suecia,178,299,,477,POINT (4697157 -74140516)
2013,Enero,Suecia,9,29,,38,POINT (6170465 -7542726)
2013,Enero,Suecia,0,1,,1,POINT (7128047 -73181317)
2013,Enero,Suecia,1,5,,6,POINT (7819 -72453013)
2013,Enero,Suecia,2,2,,4,POINT (863337 -7735002)
2013,Enero,Suiza,5,7,,12,POINT (-4191162 -69941498)
2013,Enero,Suiza,0,1,,1,POINT (0.33002 -76876446)
2013,Enero,Suiza,27,28,,55,POINT (0.81488 -77356)
2013,Enero,Suiza,17,19,,36,POINT (10406342 -75527794)
2013,Enero,Suiza,15,30,,45,POINT (10446304 -75516486)
2013,Enero,Suiza,2,10,,12,POINT (10886686 -74776479)
2013,Enero,Suiza,8,5,,13,POINT (11360029 -72129595)
2013,Enero,Suiza,0,1,,1,POINT (125862 -81702165)
2013,Enero,Suiza,18,39,,57,POINT (3451668 -76532004)
2013,Enero,Suiza,317,538,,855,POINT (4697157 -74140516)
2013,Enero,Suiza,0,1,,1,POINT (4815189 -75736374)
2013,Enero,Suiza,15,43,,58,POINT (6170465 -7542726)
2013,Enero,Suiza,0,1,,1,POINT (7128047 -73181317)
2013,Enero,Suiza,4,5,,9,POINT (7819 -72453013)
2013,Enero,Suiza,2,1,,3,POINT (7927233 -72508188)
2013,Enero,Suiza,2,9,,11,POINT (863337 -7735002)
2013,Enero,Surinam,0,1,,1,POINT (-4191162 -69941498)
2013,Enero,Surinam,1,0,,1,POINT (10446304 -75516486)
2013,Enero,Surinam,1,0,,1,POINT (10886686 -74776479)
2013,Enero,Surinam,0,2,,2,POINT (3451668 -76532004)
2013,Enero,Surinam,8,10,,18,POINT (4697157 -74140516)
2013,Enero,Surinam,2,5,,7,POINT (6170465 -7542726)
2013,Enero,Surinam,0,1,,1,POINT (7927233 -72508188)
2013,Enero,Taiwán,1,0,,1,POINT (3451668 -76532004)
2013,Enero,Taiwán,2,2,,4,POINT (4697157 -74140516)
2013,Enero,Tailandia,0,4,,4,POINT (4697157 -74140516)
2013,Enero,Tailandia,1,1,,2,POINT (6170465 -7542726)
2013,Enero,Tíbet/Región Autónoma de China,0,1,,1,POINT (4697157 -74140516)
2013,Enero,Territorio Antártico Británico/Territorio Británico de Ultramar,1,1,,2,POINT (10406342 -75527794)
2013,Enero,Territorio Antártico Británico/Territorio Británico de Ultramar,3,1,,4,POINT (4697157 -74140516)
2013,Enero,Tanzania,1,2,,3,POINT (4697157 -74140516)
2013,Enero,Tanzania,0,1,,1,POINT (7819 -72453013)
2013,Enero,Togo,0,1,,1,POINT (10446304 -75516486)
2013,Enero,Togo,0,2,,2,POINT (4697157 -74140516)
2013,Enero,Trinidad y Tobago,1,11,,12,POINT (10446304 -75516486)
2013,Enero,Trinidad y Tobago,1,0,,1,POINT (11247723 -74213989)
2013,Enero,Trinidad y Tobago,0,1,,1,POINT (11360029 -72129595)
2013,Enero,Trinidad y Tobago,0,2,,2,POINT (125744111 -81703935)
2013,Enero,Trinidad y Tobago,5,13,,18,POINT (3451668 -76532004)
2013,Enero,Trinidad y Tobago,18,26,,44,POINT (4697157 -74140516)
2013,Enero,Trinidad y Tobago,0,2,,2,POINT (4815189 -75736374)
2013,Enero,Trinidad y Tobago,3,6,,9,POINT (6170465 -7542726)
2013,Enero,Trinidad y Tobago,0,8,,8,POINT (7128047 -73181317)
2013,Enero,Trinidad y Tobago,0,1,,1,POINT (7819 -72453013)
2013,Enero,Trinidad y Tobago,0,2,,2,POINT (7927233 -72508188)
2013,Enero,Túnez,3,1,,4,POINT (4697157 -74140516)
2013,Enero,Turquía,2,1,,3,POINT (-4191162 -69941498)
2013,Enero,Turquía,2,2,,4,POINT (0.81488 -77356)
2013,Enero,Turquía,0,1,,1,POINT (10406342 -75527794)
2013,Enero,Turquía,0,4,,4,POINT (10886686 -74776479)
2013,Enero,Turquía,50,107,,157,POINT (4697157 -74140516)
2013,Enero,Turquía,6,26,,32,POINT (6170465 -7542726)
2013,Enero,Turquía,1,4,,5,POINT (7819 -72453013)
2013,Enero,Turquía,1,1,,2,POINT (863337 -7735002)
2013,Enero,Turkmenistán,2,0,,2,POINT (4697157 -74140516)
2013,Enero,Ucrania,0,2,,2,POINT (0.81488 -77356)
2013,Enero,Ucrania,0,1,,1,POINT (10406342 -75527794)
2013,Enero,Ucrania,1,0,,1,POINT (10446304 -75516486)
2013,Enero,Ucrania,0,1,,1,POINT (10886686 -74776479)
2013,Enero,Ucrania,35,41,,76,POINT (4697157 -74140516)
2013,Enero,Ucrania,2,0,,2,POINT (6170465 -7542726)
2013,Enero,Uganda,0,2,,2,POINT (4697157 -74140516)
2013,Enero,Federación de Rusia,0,1,,1,POINT (-4191162 -69941498)
2013,Enero,Federación de Rusia,0,5,,5,POINT (0.81488 -77356)
2013,Enero,Federación de Rusia,0,8,,8,POINT (10406342 -75527794)
2013,Enero,Federación de Rusia,8,5,,13,POINT (10446304 -75516486)
2013,Enero,Federación de Rusia,2,0,,2,POINT (10886686 -74776479)
2013,Enero,Federación de Rusia,4,5,,9,POINT (11360029 -72129595)
2013,Enero,Federación de Rusia,2,2,,4,POINT (3451668 -76532004)
2013,Enero,Federación de Rusia,264,331,,595,POINT (4697157 -74140516)
2013,Enero,Federación de Rusia,0,2,,2,POINT (6170465 -7542726)
2013,Enero,Federación de Rusia,2,0,,2,POINT (7128047 -73181317)
2013,Enero,Federación de Rusia,1,0,,1,POINT (7819 -72453013)
2013,Enero,Federación de Rusia,1,1,,2,POINT (863337 -7735002)
2013,Enero,Uruguay,12,18,,30,POINT (0.81488 -77356)
2013,Enero,Uruguay,94,70,,164,POINT (10446304 -75516486)
2013,Enero,Uruguay,2,7,,9,POINT (10886686 -74776479)
2013,Enero,Uruguay,2,5,,7,POINT (11360029 -72129595)
2013,Enero,Uruguay,24,15,,39,POINT (125862 -81702165)
2013,Enero,Uruguay,24,25,,49,POINT (3451668 -76532004)
2013,Enero,Uruguay,140,228,,368,POINT (4697157 -74140516)
2013,Enero,Uruguay,1,4,,5,POINT (4815189 -75736374)
2013,Enero,Uruguay,10,35,,45,POINT (6170465 -7542726)
2013,Enero,Uruguay,0,1,,1,POINT (7128047 -73181317)
2013,Enero,Uruguay,2,7,,9,POINT (7819 -72453013)
2013,Enero,Uruguay,1,1,,2,POINT (7927233 -72508188)
2013,Enero,Uruguay,1,2,,3,POINT (863337 -7735002)
2013,Enero,Uzbekistán,1,0,,1,POINT (4697157 -74140516)
2013,Enero,Venezuela,218,230,,448,POINT (0.81488 -77356)
2013,Enero,Venezuela,6,6,,12,POINT (10406342 -75527794)
2013,Enero,Venezuela,110,161,,271,POINT (10446304 -75516486)
2013,Enero,Venezuela,59,90,,149,POINT (10886686 -74776479)
2013,Enero,Venezuela,1209,1878,,3087,POINT (11360029 -72129595)
2013,Enero,Venezuela,1,1,,2,POINT (1152863 -72919186)
2013,Enero,Venezuela,8,2,,10,POINT (125862 -81702165)
2013,Enero,Venezuela,86,111,,197,POINT (3451668 -76532004)
2013,Enero,Venezuela,1,1,,2,POINT (445285 -75766353)
2013,Enero,Venezuela,5877,6570,,12447,POINT (4697157 -74140516)
2013,Enero,Venezuela,3,19,,22,POINT (4815189 -75736374)
2013,Enero,Venezuela,358,415,,773,POINT (6170465 -7542726)
2013,Enero,Venezuela,134,204,,338,POINT (6185536 -67484028)
2013,Enero,Venezuela,57,104,,161,POINT (7088729 -70740253)
2013,Enero,Venezuela,4,3,,7,POINT (7128047 -73181317)
2013,Enero,Venezuela,1408,1586,,2994,POINT (7819 -72453013)
2013,Enero,Venezuela,238,262,,500,POINT (7927233 -72508188)
2013,Enero,Venezuela,1,2,,3,POINT (863337 -7735002)
2013,Enero,Vietnam,0,1,,1,POINT (10406342 -75527794)
2013,Enero,Vietnam,1,0,,1,POINT (4697157 -74140516)
2013,Enero,Yugoslavia,1,0,,1,POINT (4697157 -74140516)
2013,Enero,Zambia,0,1,,1,POINT (4697157 -74140516)
2013,Enero,Zimbabue,0,2,,2,POINT (4697157 -74140516)
2013,Enero,Reino Unido de Gran Bretaña e Irlanda del Norte,2,5,,7,POINT (-4191162 -69941498)
2013,Enero,Reino Unido de Gran Bretaña e Irlanda del Norte,29,38,,67,POINT (0.81488 -77356)
2013,Enero,Reino Unido de Gran Bretaña e Irlanda del Norte,20,38,,58,POINT (10406342 -75527794)
2013,Enero,Reino Unido de Gran Bretaña e Irlanda del Norte,17,32,,49,POINT (10446304 -75516486)
2013,Enero,Reino Unido de Gran Bretaña e Irlanda del Norte,0,2,,2,POINT (10886686 -74776479)
2013,Enero,Reino Unido de Gran Bretaña e Irlanda del Norte,6,7,,13,POINT (11247723 -74213989)
2013,Enero,Reino Unido de Gran Bretaña e Irlanda del Norte,5,2,,7,POINT (11360029 -72129595)
2013,Enero,Reino Unido de Gran Bretaña e Irlanda del Norte,0,1,,1,POINT (125744111 -81703935)
2013,Enero,Reino Unido de Gran Bretaña e Irlanda del Norte,1,5,,6,POINT (125862 -81702165)
2013,Enero,Reino Unido de Gran Bretaña e Irlanda del Norte,2,3,,5,POINT (133387613 -81372937)
2013,Enero,Reino Unido de Gran Bretaña e Irlanda del Norte,7,24,,31,POINT (3451668 -76532004)
2013,Enero,Reino Unido de Gran Bretaña e Irlanda del Norte,268,626,,894,POINT (4697157 -74140516)
2013,Enero,Reino Unido de Gran Bretaña e Irlanda del Norte,3,23,,26,POINT (6170465 -7542726)
2013,Enero,Reino Unido de Gran Bretaña e Irlanda del Norte,0,1,,1,POINT (6185536 -67484028)
2013,Enero,Reino Unido de Gran Bretaña e Irlanda del Norte,0,1,,1,POINT (7128047 -73181317)
2013,Enero,Reino Unido de Gran Bretaña e Irlanda del Norte,2,7,,9,POINT (7819 -72453013)
2013,Enero,Reino Unido de Gran Bretaña e Irlanda del Norte,9,8,,17,POINT (863337 -7735002)
2013,Enero,Países Bajos,0,2,,2,POINT (-4191162 -69941498)
2013,Enero,Países Bajos,16,15,,31,POINT (0.81488 -77356)
2013,Enero,Países Bajos,19,24,,43,POINT (10406342 -75527794)
2013,Enero,Países Bajos,11,37,,48,POINT (10446304 -75516486)
2013,Enero,Países Bajos,3,4,,7,POINT (10886686 -74776479)
2013,Enero,Países Bajos,2,6,,8,POINT (11360029 -72129595)
2013,Enero,Países Bajos,1,1,,2,POINT (125744111 -81703935)
2013,Enero,Países Bajos,1,2,,3,POINT (125862 -81702165)
2013,Enero,Países Bajos,13,29,,42,POINT (3451668 -76532004)
2013,Enero,Países Bajos,390,651,,1041,POINT (4697157 -74140516)
2013,Enero,Países Bajos,0,2,,2,POINT (4815189 -75736374)
2013,Enero,Países Bajos,90,112,,202,POINT (6170465 -7542726)
2013,Enero,Países Bajos,0,1,,1,POINT (7088729 -70740253)
2013,Enero,Países Bajos,1,3,,4,POINT (7128047 -73181317)
2013,Enero,Países Bajos,0,4,,4,POINT (7819 -72453013)
2013,Enero,Países Bajos,1,3,,4,POINT (7927233 -72508188)
2013,Enero,Países Bajos,7,3,,10,POINT (863337 -7735002)
2013,Enero,Desconocido,1,0,,1,POINT (4697157 -74140516)
2013,Enero,Lituania,1,1,,2,POINT (10406342 -75527794)
2013,Enero,Lituania,4,1,,5,POINT (4697157 -74140516)
2013,Enero,Reino Unido de Gran Bretaña e Irlanda del Norte,0,1,,1,POINT (3451668 -76532004)
2013,Enero,Reino Unido de Gran Bretaña e Irlanda del Norte,2,0,,2,POINT (4697157 -74140516)
2013,Enero,Reino Unido de Gran Bretaña e Irlanda del Norte,1,0,,1,POINT (7927233 -72508188)
2013,Enero,Reino Unido de Gran Bretaña e Irlanda del Norte,4,3,,7,POINT (10406342 -75527794)
2013,Enero,Reino Unido de Gran Bretaña e Irlanda del Norte,0,1,,1,POINT (10446304 -75516486)
2013,Enero,Reino Unido de Gran Bretaña e Irlanda del Norte,0,1,,1,POINT (11360029 -72129595)
2013,Enero,Reino Unido de Gran Bretaña e Irlanda del Norte,0,2,,2,POINT (133387613 -81372937)
2013,Enero,Reino Unido de Gran Bretaña e Irlanda del Norte,5,6,,11,POINT (4697157 -74140516)
2013,Enero,Reino Unido de Gran Bretaña e Irlanda del Norte,0,1,,1,POINT (7819 -72453013)
2013,Enero,Letonia,1,0,,1,POINT (4697157 -74140516)
2013,Enero,Marruecos,0,1,,1,POINT (4697157 -74140516)
2013,Febrero,Desconocido,31,68,,99,POINT (-4191162 -69941498)
2013,Febrero,Afganistán,0,1,,1,POINT (4697157 -74140516)
2013,Febrero,Albania,1,0,,1,POINT (10446304 -75516486)
2013,Febrero,Albania,2,0,,2,POINT (4697157 -74140516)
2013,Febrero,Alemania,0,1,,1,POINT (-4191162 -69941498)
2013,Febrero,Alemania,62,65,,127,POINT (0.81488 -77356)
2013,Febrero,Alemania,1,1,,2,POINT (1800143 -78802679)
2013,Febrero,Alemania,8,30,,38,POINT (10406342 -75527794)
2013,Febrero,Alemania,17,55,,72,POINT (10446304 -75516486)
2013,Febrero,Alemania,7,17,,24,POINT (10886686 -74776479)
2013,Febrero,Alemania,3,3,,6,POINT (11247723 -74213989)
2013,Febrero,Alemania,7,8,,15,POINT (11360029 -72129595)
2013,Febrero,Alemania,2,3,,5,POINT (125862 -81702165)
2013,Febrero,Alemania,38,73,,111,POINT (3451668 -76532004)
2013,Febrero,Alemania,0,1,,1,POINT (445285 -75766353)
2013,Febrero,Alemania,1323,2067,,3390,POINT (4697157 -74140516)
2013,Febrero,Alemania,1,5,,6,POINT (4815189 -75736374)
2013,Febrero,Alemania,40,113,,153,POINT (6170465 -7542726)
2013,Febrero,Alemania,2,0,,2,POINT (6185536 -67484028)
2013,Febrero,Alemania,0,1,,1,POINT (7128047 -73181317)
2013,Febrero,Alemania,2,11,,13,POINT (7819 -72453013)
2013,Febrero,Andorra,1,1,,2,POINT (10406342 -75527794)
2013,Febrero,Andorra,0,2,,2,POINT (10446304 -75516486)
2013,Febrero,Andorra,0,1,,1,POINT (10886686 -74776479)
2013,Febrero,Andorra,0,7,,7,POINT (4697157 -74140516)
2013,Febrero,Angola,0,1,,1,POINT (3451668 -76532004)
2013,Febrero,Angola,0,1,,1,POINT (4697157 -74140516)
2013,Febrero,Antigua y Barbuda,0,1,,1,POINT (10446304 -75516486)
2013,Febrero,Antigua y Barbuda,0,2,,2,POINT (4697157 -74140516)
2013,Febrero,Países Bajos,0,1,,1,POINT (10446304 -75516486)
2013,Febrero,Países Bajos,1,0,,1,POINT (6170465 -7542726)
2013,Febrero,Arabia Saudita,0,4,,4,POINT (4697157 -74140516)
2013,Febrero,Argelia,1,2,,3,POINT (4697157 -74140516)
2013,Febrero,Argentina,79,153,,232,POINT (0.81488 -77356)
2013,Febrero,Argentina,0,2,,2,POINT (1800143 -78802679)
2013,Febrero,Argentina,125,86,,211,POINT (10406342 -75527794)
2013,Febrero,Argentina,625,465,,1090,POINT (10446304 -75516486)
2013,Febrero,Argentina,14,30,,44,POINT (10886686 -74776479)
2013,Febrero,Argentina,21,52,,73,POINT (11360029 -72129595)
2013,Febrero,Argentina,235,166,,401,POINT (125862 -81702165)
2013,Febrero,Argentina,63,87,,150,POINT (3451668 -76532004)
2013,Febrero,Argentina,0,1,,1,POINT (445285 -75766353)
2013,Febrero,Argentina,3962,5120,,9082,POINT (4697157 -74140516)
2013,Febrero,Argentina,0,4,,4,POINT (4815189 -75736374)
2013,Febrero,Argentina,128,272,,400,POINT (6170465 -7542726)
2013,Febrero,Argentina,28,50,,78,POINT (7819 -72453013)
2013,Febrero,Argentina,0,5,,5,POINT (7927233 -72508188)
2013,Febrero,República de Armenia,2,1,,3,POINT (4697157 -74140516)
2013,Febrero,Aruba,1,0,,1,POINT (3451668 -76532004)
2013,Febrero,Aruba,5,2,,7,POINT (4697157 -74140516)
2013,Febrero,Aruba,4,6,,10,POINT (6170465 -7542726)
2013,Febrero,Australia,7,2,,9,POINT (-4191162 -69941498)
2013,Febrero,Australia,17,25,,42,POINT (0.81488 -77356)
2013,Febrero,Australia,12,31,,43,POINT (10406342 -75527794)
2013,Febrero,Australia,14,39,,53,POINT (10446304 -75516486)
2013,Febrero,Australia,7,15,,22,POINT (10886686 -74776479)
2013,Febrero,Australia,0,1,,1,POINT (11247723 -74213989)
2013,Febrero,Australia,1,3,,4,POINT (11360029 -72129595)
2013,Febrero,Australia,3,0,,3,POINT (125862 -81702165)
2013,Febrero,Australia,7,21,,28,POINT (3451668 -76532004)
2013,Febrero,Australia,203,392,,595,POINT (4697157 -74140516)
2013,Febrero,Australia,1,0,,1,POINT (4815189 -75736374)
2013,Febrero,Australia,16,62,,78,POINT (6170465 -7542726)
2013,Febrero,Australia,5,3,,8,POINT (7819 -72453013)
2013,Febrero,Austria,9,12,,21,POINT (0.81488 -77356)
2013,Febrero,Austria,0,2,,2,POINT (10406342 -75527794)
2013,Febrero,Austria,9,7,,16,POINT (10446304 -75516486)
2013,Febrero,Austria,0,1,,1,POINT (10886686 -74776479)
2013,Febrero,Austria,1,0,,1,POINT (11247723 -74213989)
2013,Febrero,Austria,0,4,,4,POINT (11360029 -72129595)
2013,Febrero,Austria,0,2,,2,POINT (125862 -81702165)
2013,Febrero,Austria,3,6,,9,POINT (3451668 -76532004)
2013,Febrero,Austria,101,222,,323,POINT (4697157 -74140516)
2013,Febrero,Austria,4,20,,24,POINT (6170465 -7542726)
2013,Febrero,Austria,0,2,,2,POINT (7819 -72453013)
2013,Febrero,Azerbaiyán,0,3,,3,POINT (4697157 -74140516)
2013,Febrero,Bahamas,3,1,,4,POINT (10446304 -75516486)
2013,Febrero,Bahamas,0,1,,1,POINT (10886686 -74776479)
2013,Febrero,Bahamas,0,2,,2,POINT (3451668 -76532004)
2013,Febrero,Bahamas,2,8,,10,POINT (4697157 -74140516)
2013,Febrero,Bahamas,0,1,,1,POINT (6170465 -7542726)
2013,Febrero,Bangladesh,0,20,,20,POINT (4697157 -74140516)
2013,Febrero,Barbados,1,1,,2,POINT (10446304 -75516486)
2013,Febrero,Barbados,0,2,,2,POINT (4697157 -74140516)
2013,Febrero,Barbados,1,0,,1,POINT (7819 -72453013)
2013,Febrero,República de Belarús,2,0,,2,POINT (4697157 -74140516)
2013,Febrero,Bélgica,7,12,,19,POINT (0.81488 -77356)
2013,Febrero,Bélgica,6,4,,10,POINT (10406342 -75527794)
2013,Febrero,Bélgica,4,13,,17,POINT (10446304 -75516486)
2013,Febrero,Bélgica,0,2,,2,POINT (10886686 -74776479)
2013,Febrero,Bélgica,1,0,,1,POINT (11360029 -72129595)
2013,Febrero,Bélgica,9,17,,26,POINT (3451668 -76532004)
2013,Febrero,Bélgica,133,275,,408,POINT (4697157 -74140516)
2013,Febrero,Bélgica,3,14,,17,POINT (6170465 -7542726)
2013,Febrero,Bélgica,0,1,,1,POINT (7128047 -73181317)
2013,Febrero,Bélgica,1,4,,5,POINT (7819 -72453013)
2013,Febrero,Belice,1,4,,5,POINT (10446304 -75516486)
2013,Febrero,Belice,0,1,,1,POINT (10886686 -74776479)
2013,Febrero,Belice,4,5,,9,POINT (4697157 -74140516)
2013,Febrero,Belice,0,2,,2,POINT (6170465 -7542726)
2013,Febrero,Benín,1,0,,1,POINT (4697157 -74140516)
2013,Febrero,Bermudas/Territorio Británico de Ultramar,2,1,,3,POINT (10886686 -74776479)
2013,Febrero,Bolivia,32,44,,76,POINT (0.81488 -77356)
2013,Febrero,Bolivia,25,13,,38,POINT (10406342 -75527794)
2013,Febrero,Bolivia,10,15,,25,POINT (10446304 -75516486)
2013,Febrero,Bolivia,3,2,,5,POINT (10886686 -74776479)
2013,Febrero,Bolivia,13,9,,22,POINT (125862 -81702165)
2013,Febrero,Bolivia,9,9,,18,POINT (3451668 -76532004)
2013,Febrero,Bolivia,965,755,,1720,POINT (4697157 -74140516)
2013,Febrero,Bolivia,0,3,,3,POINT (4815189 -75736374)
2013,Febrero,Bolivia,8,8,,16,POINT (6170465 -7542726)
2013,Febrero,Bolivia,1,1,,2,POINT (7128047 -73181317)
2013,Febrero,Bolivia,2,3,,5,POINT (7819 -72453013)
2013,Febrero,Bosnia y Herzegovina,1,1,,2,POINT (4697157 -74140516)
2013,Febrero,Brasil,43,33,,76,POINT (-4191162 -69941498)
2013,Febrero,Brasil,15,22,,37,POINT (0.81488 -77356)
2013,Febrero,Brasil,9,10,,19,POINT (10406342 -75527794)
2013,Febrero,Brasil,283,230,,513,POINT (10446304 -75516486)
2013,Febrero,Brasil,3,20,,23,POINT (10886686 -74776479)
2013,Febrero,Brasil,1,0,,1,POINT (11247723 -74213989)
2013,Febrero,Brasil,5,11,,16,POINT (11360029 -72129595)
2013,Febrero,Brasil,32,20,,52,POINT (125862 -81702165)
2013,Febrero,Brasil,21,49,,70,POINT (3451668 -76532004)
2013,Febrero,Brasil,1,0,,1,POINT (4076512 -73558456)
2013,Febrero,Brasil,2303,3206,,5509,POINT (4697157 -74140516)
2013,Febrero,Brasil,66,124,,190,POINT (6170465 -7542726)
2013,Febrero,Brasil,1,0,,1,POINT (6185536 -67484028)
2013,Febrero,Brasil,1,2,,3,POINT (7128047 -73181317)
2013,Febrero,Brasil,7,25,,32,POINT (7819 -72453013)
2013,Febrero,Brasil,2,7,,9,POINT (7927233 -72508188)
2013,Febrero,Bulgaria,2,1,,3,POINT (125862 -81702165)
2013,Febrero,Bulgaria,0,1,,1,POINT (3451668 -76532004)
2013,Febrero,Bulgaria,10,5,,15,POINT (4697157 -74140516)
2013,Febrero,Bulgaria,1,0,,1,POINT (7819 -72453013)
2013,Febrero,Burundi,0,1,,1,POINT (4697157 -74140516)
2013,Febrero,Islas Caimán/Territorio Británico de Ultramar,2,1,,3,POINT (10446304 -75516486)
2013,Febrero,Islas Caimán/Territorio Británico de Ultramar,0,1,,1,POINT (6170465 -7542726)
2013,Febrero,Camerún,0,1,,1,POINT (0.81488 -77356)
2013,Febrero,Camerún,1,0,,1,POINT (11360029 -72129595)
2013,Febrero,Camerún,1,0,,1,POINT (3451668 -76532004)
2013,Febrero,Camerún,1,2,,3,POINT (4697157 -74140516)
2013,Febrero,Canadá,0,3,,3,POINT (-4191162 -69941498)
2013,Febrero,Canadá,22,42,,64,POINT (0.81488 -77356)
2013,Febrero,Canadá,12,24,,36,POINT (10406342 -75527794)
2013,Febrero,Canadá,794,766,,1560,POINT (10446304 -75516486)
2013,Febrero,Canadá,14,21,,35,POINT (10886686 -74776479)
2013,Febrero,Canadá,1,1,,2,POINT (11247723 -74213989)
2013,Febrero,Canadá,2,6,,8,POINT (11360029 -72129595)
2013,Febrero,Canadá,354,321,,675,POINT (125862 -81702165)
2013,Febrero,Canadá,36,49,,85,POINT (3451668 -76532004)
2013,Febrero,Canadá,4,1,,5,POINT (445285 -75766353)
2013,Febrero,Canadá,701,1447,,2148,POINT (4697157 -74140516)
2013,Febrero,Canadá,0,4,,4,POINT (4815189 -75736374)
2013,Febrero,Canadá,108,180,,288,POINT (6170465 -7542726)
2013,Febrero,Canadá,0,1,,1,POINT (6222552 -77401154)
2013,Febrero,Canadá,0,4,,4,POINT (7128047 -73181317)
2013,Febrero,Canadá,7,10,,17,POINT (7819 -72453013)
2013,Febrero,Canadá,0,1,,1,POINT (7927233 -72508188)
2013,Febrero,España,8,4,,12,POINT (0.81488 -77356)
2013,Febrero,España,0,1,,1,POINT (1800143 -78802679)
2013,Febrero,España,5,8,,13,POINT (10406342 -75527794)
2013,Febrero,España,5,5,,10,POINT (10446304 -75516486)
2013,Febrero,España,3,19,,22,POINT (10886686 -74776479)
2013,Febrero,España,0,2,,2,POINT (11247723 -74213989)
2013,Febrero,España,2,1,,3,POINT (11360029 -72129595)
2013,Febrero,España,43,96,,139,POINT (3451668 -76532004)
2013,Febrero,España,126,306,,432,POINT (4697157 -74140516)
2013,Febrero,España,0,2,,2,POINT (4815189 -75736374)
2013,Febrero,España,29,118,,147,POINT (6170465 -7542726)
2013,Febrero,España,0,1,,1,POINT (7088729 -70740253)
2013,Febrero,España,0,1,,1,POINT (7819 -72453013)
2013,Febrero,España,0,1,,1,POINT (7927233 -72508188)
2013,Febrero,República Democrática del Congo,1,2,,3,POINT (4697157 -74140516)
2013,Febrero,República de Corea,0,1,,1,POINT (-4191162 -69941498)
2013,Febrero,República de Corea,3,1,,4,POINT (0.81488 -77356)
2013,Febrero,República de Corea,1,1,,2,POINT (10406342 -75527794)
2013,Febrero,República de Corea,1,3,,4,POINT (10446304 -75516486)
2013,Febrero,República de Corea,2,8,,10,POINT (3451668 -76532004)
2013,Febrero,República de Corea,115,374,,489,POINT (4697157 -74140516)
2013,Febrero,República de Corea,0,24,,24,POINT (6170465 -7542726)
2013,Febrero,República de Corea,3,6,,9,POINT (7819 -72453013)
2013,Febrero,República de Corea,1,1,,2,POINT (7927233 -72508188)
2013,Febrero,Costa de Marfil,0,3,,3,POINT (4697157 -74140516)
2013,Febrero,Costa Rica,2,3,,5,POINT (0.81488 -77356)
2013,Febrero,Costa Rica,27,31,,58,POINT (10446304 -75516486)
2013,Febrero,Costa Rica,14,17,,31,POINT (10886686 -74776479)
2013,Febrero,Costa Rica,1,0,,1,POINT (11360029 -72129595)
2013,Febrero,Costa Rica,309,231,,540,POINT (125862 -81702165)
2013,Febrero,Costa Rica,18,40,,58,POINT (3451668 -76532004)
2013,Febrero,Costa Rica,0,1,,1,POINT (445285 -75766353)
2013,Febrero,Costa Rica,524,724,,1248,POINT (4697157 -74140516)
2013,Febrero,Costa Rica,4,13,,17,POINT (4815189 -75736374)
2013,Febrero,Costa Rica,55,95,,150,POINT (6170465 -7542726)
2013,Febrero,Costa Rica,0,4,,4,POINT (7819 -72453013)
2013,Febrero,Costa Rica,2,0,,2,POINT (7927233 -72508188)
2013,Febrero,Croacia,1,2,,3,POINT (0.81488 -77356)
2013,Febrero,Croacia,0,2,,2,POINT (10406342 -75527794)
2013,Febrero,Croacia,1,1,,2,POINT (10446304 -75516486)
2013,Febrero,Croacia,1,0,,1,POINT (11360029 -72129595)
2013,Febrero,Croacia,15,19,,34,POINT (4697157 -74140516)
2013,Febrero,Croacia,1,2,,3,POINT (6170465 -7542726)
2013,Febrero,Croacia,0,1,,1,POINT (7819 -72453013)
2013,Febrero,Cuba,0,2,,2,POINT (0.81488 -77356)
2013,Febrero,Cuba,7,10,,17,POINT (10446304 -75516486)
2013,Febrero,Cuba,8,9,,17,POINT (10886686 -74776479)
2013,Febrero,Cuba,1,0,,1,POINT (125862 -81702165)
2013,Febrero,Cuba,13,11,,24,POINT (3451668 -76532004)
2013,Febrero,Cuba,0,1,,1,POINT (445285 -75766353)
2013,Febrero,Cuba,84,184,,268,POINT (4697157 -74140516)
2013,Febrero,Cuba,2,1,,3,POINT (4815189 -75736374)
2013,Febrero,Cuba,12,15,,27,POINT (6170465 -7542726)
2013,Febrero,Cuba,0,1,,1,POINT (7088729 -70740253)
2013,Febrero,Cuba,0,1,,1,POINT (7128047 -73181317)
2013,Febrero,Cuba,0,1,,1,POINT (7819 -72453013)
2013,Febrero,Cuba,1,1,,2,POINT (7927233 -72508188)
2013,Febrero,Curazao,2,1,,3,POINT (4697157 -74140516)
2013,Febrero,Curazao,12,12,,24,POINT (6170465 -7542726)
2013,Febrero,República Checa,8,15,,23,POINT (0.81488 -77356)
2013,Febrero,República Checa,2,2,,4,POINT (10446304 -75516486)
2013,Febrero,República Checa,1,1,,2,POINT (11360029 -72129595)
2013,Febrero,República Checa,29,61,,90,POINT (4697157 -74140516)
2013,Febrero,República Checa,0,3,,3,POINT (6170465 -7542726)
2013,Febrero,Chile,2,2,,4,POINT (-4191162 -69941498)
2013,Febrero,Chile,74,127,,201,POINT (0.81488 -77356)
2013,Febrero,Chile,0,3,,3,POINT (1800143 -78802679)
2013,Febrero,Chile,148,107,,255,POINT (10406342 -75527794)
2013,Febrero,Chile,266,263,,529,POINT (10446304 -75516486)
2013,Febrero,Chile,10,16,,26,POINT (10886686 -74776479)
2013,Febrero,Chile,1,4,,5,POINT (11247723 -74213989)
2013,Febrero,Chile,8,10,,18,POINT (11360029 -72129595)
2013,Febrero,Chile,119,85,,204,POINT (125862 -81702165)
2013,Febrero,Chile,61,99,,160,POINT (3451668 -76532004)
2013,Febrero,Chile,4014,4347,,8361,POINT (4697157 -74140516)
2013,Febrero,Chile,0,6,,6,POINT (4815189 -75736374)
2013,Febrero,Chile,135,240,,375,POINT (6170465 -7542726)
2013,Febrero,Chile,1,2,,3,POINT (7128047 -73181317)
2013,Febrero,Chile,13,23,,36,POINT (7819 -72453013)
2013,Febrero,Chile,0,2,,2,POINT (7927233 -72508188)
2013,Febrero,China,3,1,,4,POINT (0.81488 -77356)
2013,Febrero,China,3,8,,11,POINT (10446304 -75516486)
2013,Febrero,China,2,0,,2,POINT (10886686 -74776479)
2013,Febrero,China,1,0,,1,POINT (125862 -81702165)
2013,Febrero,China,4,9,,13,POINT (3451668 -76532004)
2013,Febrero,China,154,380,,534,POINT (4697157 -74140516)
2013,Febrero,China,9,9,,18,POINT (6170465 -7542726)
2013,Febrero,China,0,1,,1,POINT (7128047 -73181317)
2013,Febrero,China,2,3,,5,POINT (7819 -72453013)
2013,Febrero,China,0,1,,1,POINT (7927233 -72508188)
2013,Febrero,Taiwán,0,1,,1,POINT (0.81488 -77356)
2013,Febrero,Taiwán,1,2,,3,POINT (10446304 -75516486)
2013,Febrero,Taiwán,0,1,,1,POINT (10886686 -74776479)
2013,Febrero,Taiwán,1,1,,2,POINT (3451668 -76532004)
2013,Febrero,Taiwán,32,41,,73,POINT (4697157 -74140516)
2013,Febrero,Taiwán,0,1,,1,POINT (4815189 -75736374)
2013,Febrero,Taiwán,2,0,,2,POINT (6170465 -7542726)
2013,Febrero,Taiwán,0,1,,1,POINT (7128047 -73181317)
2013,Febrero,Chipre,0,5,,5,POINT (4697157 -74140516)
2013,Febrero,Dinamarca,1,0,,1,POINT (-4191162 -69941498)
2013,Febrero,Dinamarca,7,6,,13,POINT (0.81488 -77356)
2013,Febrero,Dinamarca,1,7,,8,POINT (10406342 -75527794)
2013,Febrero,Dinamarca,6,14,,20,POINT (10446304 -75516486)
2013,Febrero,Dinamarca,1,0,,1,POINT (10886686 -74776479)
2013,Febrero,Dinamarca,0,1,,1,POINT (11360029 -72129595)
2013,Febrero,Dinamarca,1,2,,3,POINT (3451668 -76532004)
2013,Febrero,Dinamarca,81,135,,216,POINT (4697157 -74140516)
2013,Febrero,Dinamarca,5,5,,10,POINT (6170465 -7542726)
2013,Febrero,Dinamarca,0,1,,1,POINT (7128047 -73181317)
2013,Febrero,Dinamarca,1,4,,5,POINT (7819 -72453013)
2013,Febrero,Dominica,3,2,,5,POINT (4697157 -74140516)
2013,Febrero,Dominica,1,0,,1,POINT (6170465 -7542726)
2013,Febrero,Ecuador,0,1,,1,POINT (-4191162 -69941498)
2013,Febrero,Ecuador,1543,1590,,3133,POINT (0.81488 -77356)
2013,Febrero,Ecuador,0,3,,3,POINT (1800143 -78802679)
2013,Febrero,Ecuador,6,34,,40,POINT (10406342 -75527794)
2013,Febrero,Ecuador,11,14,,25,POINT (10446304 -75516486)
2013,Febrero,Ecuador,8,12,,20,POINT (10886686 -74776479)
2013,Febrero,Ecuador,2,7,,9,POINT (11360029 -72129595)
2013,Febrero,Ecuador,4,3,,7,POINT (125862 -81702165)
2013,Febrero,Ecuador,419,466,,885,POINT (3451668 -76532004)
2013,Febrero,Ecuador,0,2,,2,POINT (445285 -75766353)
2013,Febrero,Ecuador,2091,2808,,4899,POINT (4697157 -74140516)
2013,Febrero,Ecuador,3,8,,11,POINT (4815189 -75736374)
2013,Febrero,Ecuador,383,447,,830,POINT (6170465 -7542726)
2013,Febrero,Ecuador,1,1,,2,POINT (6185536 -67484028)
2013,Febrero,Ecuador,0,3,,3,POINT (7128047 -73181317)
2013,Febrero,Ecuador,79,130,,209,POINT (7819 -72453013)
2013,Febrero,Ecuador,2,5,,7,POINT (7927233 -72508188)
2013,Febrero,Egipto,0,1,,1,POINT (10446304 -75516486)
2013,Febrero,Egipto,1,13,,14,POINT (4697157 -74140516)
2013,Febrero,Egipto,0,1,,1,POINT (7819 -72453013)
2013,Febrero,El Salvador,1,2,,3,POINT (0.81488 -77356)
2013,Febrero,El Salvador,0,2,,2,POINT (10406342 -75527794)
2013,Febrero,El Salvador,20,13,,33,POINT (10446304 -75516486)
2013,Febrero,El Salvador,0,3,,3,POINT (10886686 -74776479)
2013,Febrero,El Salvador,1,0,,1,POINT (11360029 -72129595)
2013,Febrero,El Salvador,2,0,,2,POINT (125862 -81702165)
2013,Febrero,El Salvador,24,39,,63,POINT (3451668 -76532004)
2013,Febrero,El Salvador,537,704,,1241,POINT (4697157 -74140516)
2013,Febrero,El Salvador,0,1,,1,POINT (4815189 -75736374)
2013,Febrero,El Salvador,41,92,,133,POINT (6170465 -7542726)
2013,Febrero,El Salvador,0,1,,1,POINT (6185536 -67484028)
2013,Febrero,Emiratos Árabes,1,5,,6,POINT (4697157 -74140516)
2013,Febrero,Emiratos Árabes,0,2,,2,POINT (6170465 -7542726)
2013,Febrero,España,3,4,,7,POINT (-4191162 -69941498)
2013,Febrero,España,23,26,,49,POINT (0.81488 -77356)
2013,Febrero,España,16,27,,43,POINT (10406342 -75527794)
2013,Febrero,España,31,80,,111,POINT (10446304 -75516486)
2013,Febrero,España,3,17,,20,POINT (10886686 -74776479)
2013,Febrero,España,1,2,,3,POINT (11247723 -74213989)
2013,Febrero,España,9,13,,22,POINT (11360029 -72129595)
2013,Febrero,España,4,6,,10,POINT (125862 -81702165)
2013,Febrero,España,145,339,,484,POINT (3451668 -76532004)
2013,Febrero,España,1489,4022,,5511,POINT (4697157 -74140516)
2013,Febrero,España,0,14,,14,POINT (4815189 -75736374)
2013,Febrero,España,81,190,,271,POINT (6170465 -7542726)
2013,Febrero,España,0,1,,1,POINT (7088729 -70740253)
2013,Febrero,España,12,44,,56,POINT (7819 -72453013)
2013,Febrero,España,3,10,,13,POINT (7927233 -72508188)
2013,Febrero,Eslovaquia,1,5,,6,POINT (0.81488 -77356)
2013,Febrero,Eslovaquia,1,0,,1,POINT (10446304 -75516486)
2013,Febrero,Eslovaquia,2,0,,2,POINT (10886686 -74776479)
2013,Febrero,Eslovaquia,1,1,,2,POINT (3451668 -76532004)
2013,Febrero,Eslovaquia,6,23,,29,POINT (4697157 -74140516)
2013,Febrero,Eslovaquia,0,1,,1,POINT (6170465 -7542726)
2013,Febrero,Eslovaquia,0,3,,3,POINT (7819 -72453013)
2013,Febrero,Eslovenia,0,1,,1,POINT (10406342 -75527794)
2013,Febrero,Eslovenia,12,7,,19,POINT (11360029 -72129595)
2013,Febrero,Eslovenia,1,1,,2,POINT (3451668 -76532004)
2013,Febrero,Eslovenia,14,28,,42,POINT (4697157 -74140516)
2013,Febrero,Estados Unidos de América,4,5,,9,POINT (-4191162 -69941498)
2013,Febrero,Estados Unidos de América,46,89,,135,POINT (0.81488 -77356)
2013,Febrero,Estados Unidos de América,26,40,,66,POINT (10406342 -75527794)
2013,Febrero,Estados Unidos de América,1335,2123,,3458,POINT (10446304 -75516486)
2013,Febrero,Estados Unidos de América,312,566,,878,POINT (10886686 -74776479)
2013,Febrero,Estados Unidos de América,3,6,,9,POINT (11247723 -74213989)
2013,Febrero,Estados Unidos de América,6,18,,24,POINT (11360029 -72129595)
2013,Febrero,Estados Unidos de América,0,1,,1,POINT (1152863 -72919186)
2013,Febrero,Estados Unidos de América,14,34,,48,POINT (125862 -81702165)
2013,Febrero,Estados Unidos de América,471,929,,1400,POINT (3451668 -76532004)
2013,Febrero,Estados Unidos de América,0,1,,1,POINT (3884426 -77061029)
2013,Febrero,Estados Unidos de América,67,126,,193,POINT (445285 -75766353)
2013,Febrero,Estados Unidos de América,4964,10882,,15846,POINT (4697157 -74140516)
2013,Febrero,Estados Unidos de América,32,67,,99,POINT (4815189 -75736374)
2013,Febrero,Estados Unidos de América,907,2474,,3381,POINT (6170465 -7542726)
2013,Febrero,Estados Unidos de América,0,1,,1,POINT (7088729 -70740253)
2013,Febrero,Estados Unidos de América,7,17,,24,POINT (7128047 -73181317)
2013,Febrero,Estados Unidos de América,21,44,,65,POINT (7819 -72453013)
2013,Febrero,Estados Unidos de América,7,10,,17,POINT (7927233 -72508188)
2013,Febrero,Estonia,0,1,,1,POINT (0.81488 -77356)
2013,Febrero,Estonia,1,0,,1,POINT (10446304 -75516486)
2013,Febrero,Estonia,1,0,,1,POINT (10886686 -74776479)
2013,Febrero,Estonia,0,1,,1,POINT (3451668 -76532004)
2013,Febrero,Estonia,15,11,,26,POINT (4697157 -74140516)
2013,Febrero,Estonia,2,2,,4,POINT (6170465 -7542726)
2013,Febrero,Etiopia,2,6,,8,POINT (4697157 -74140516)
2013,Febrero,Islas Fiji,0,1,,1,POINT (10886686 -74776479)
2013,Febrero,Islas Fiji,0,1,,1,POINT (4697157 -74140516)
2013,Febrero,Filipinas,0,1,,1,POINT (0.81488 -77356)
2013,Febrero,Filipinas,2,24,,26,POINT (10406342 -75527794)
2013,Febrero,Filipinas,1,17,,18,POINT (10446304 -75516486)
2013,Febrero,Filipinas,0,2,,2,POINT (10886686 -74776479)
2013,Febrero,Filipinas,0,1,,1,POINT (11247723 -74213989)
2013,Febrero,Filipinas,0,6,,6,POINT (3451668 -76532004)
2013,Febrero,Filipinas,0,5,,5,POINT (3884426 -77061029)
2013,Febrero,Filipinas,18,39,,57,POINT (4697157 -74140516)
2013,Febrero,Filipinas,2,0,,2,POINT (6170465 -7542726)
2013,Febrero,Filipinas,0,3,,3,POINT (7927233 -72508188)
2013,Febrero,Finlandia,5,6,,11,POINT (0.81488 -77356)
2013,Febrero,Finlandia,3,3,,6,POINT (10406342 -75527794)
2013,Febrero,Finlandia,5,1,,6,POINT (10446304 -75516486)
2013,Febrero,Finlandia,0,7,,7,POINT (10886686 -74776479)
2013,Febrero,Finlandia,2,2,,4,POINT (11360029 -72129595)
2013,Febrero,Finlandia,0,1,,1,POINT (125862 -81702165)
2013,Febrero,Finlandia,1,5,,6,POINT (3451668 -76532004)
2013,Febrero,Finlandia,32,75,,107,POINT (4697157 -74140516)
2013,Febrero,Finlandia,4,3,,7,POINT (6170465 -7542726)
2013,Febrero,Finlandia,0,1,,1,POINT (6185536 -67484028)
2013,Febrero,Finlandia,0,1,,1,POINT (7819 -72453013)
2013,Febrero,Francia,9,13,,22,POINT (-4191162 -69941498)
2013,Febrero,Francia,54,77,,131,POINT (0.81488 -77356)
2013,Febrero,Francia,12,16,,28,POINT (10406342 -75527794)
2013,Febrero,Francia,41,67,,108,POINT (10446304 -75516486)
2013,Febrero,Francia,5,7,,12,POINT (10886686 -74776479)
2013,Febrero,Francia,1,2,,3,POINT (11247723 -74213989)
2013,Febrero,Francia,6,15,,21,POINT (11360029 -72129595)
2013,Febrero,Francia,32,54,,86,POINT (3451668 -76532004)
2013,Febrero,Francia,0,1,,1,POINT (445285 -75766353)
2013,Febrero,Francia,954,1769,,2723,POINT (4697157 -74140516)
2013,Febrero,Francia,1,0,,1,POINT (4815189 -75736374)
2013,Febrero,Francia,41,87,,128,POINT (6170465 -7542726)
2013,Febrero,Francia,0,3,,3,POINT (7128047 -73181317)
2013,Febrero,Francia,2,17,,19,POINT (7819 -72453013)
2013,Febrero,Francia,0,2,,2,POINT (7927233 -72508188)
2013,Febrero,Gabón,1,0,,1,POINT (3451668 -76532004)
2013,Febrero,Gabón,1,2,,3,POINT (4697157 -74140516)
2013,Febrero,Gambia,0,2,,2,POINT (4697157 -74140516)
2013,Febrero,Georgia,1,0,,1,POINT (10446304 -75516486)
2013,Febrero,Georgia,6,2,,8,POINT (4697157 -74140516)
2013,Febrero,Ghana,1,0,,1,POINT (3451668 -76532004)
2013,Febrero,Ghana,0,5,,5,POINT (4697157 -74140516)
2013,Febrero,Granada,1,0,,1,POINT (4697157 -74140516)
2013,Febrero,Grecia,2,1,,3,POINT (0.81488 -77356)
2013,Febrero,Grecia,0,1,,1,POINT (10406342 -75527794)
2013,Febrero,Grecia,1,2,,3,POINT (10446304 -75516486)
2013,Febrero,Grecia,0,4,,4,POINT (3451668 -76532004)
2013,Febrero,Grecia,0,1,,1,POINT (3884426 -77061029)
2013,Febrero,Grecia,26,60,,86,POINT (4697157 -74140516)
2013,Febrero,Grecia,0,1,,1,POINT (4815189 -75736374)
2013,Febrero,Grecia,1,1,,2,POINT (6170465 -7542726)
2013,Febrero,Grecia,0,1,,1,POINT (7819 -72453013)
2013,Febrero,Grecia,0,1,,1,POINT (9402597 -75681642)
2013,Febrero,Guatemala,0,5,,5,POINT (0.81488 -77356)
2013,Febrero,Guatemala,0,2,,2,POINT (10406342 -75527794)
2013,Febrero,Guatemala,27,77,,104,POINT (10446304 -75516486)
2013,Febrero,Guatemala,4,17,,21,POINT (10886686 -74776479)
2013,Febrero,Guatemala,0,1,,1,POINT (11360029 -72129595)
2013,Febrero,Guatemala,2,1,,3,POINT (125862 -81702165)
2013,Febrero,Guatemala,16,42,,58,POINT (3451668 -76532004)
2013,Febrero,Guatemala,265,480,,745,POINT (4697157 -74140516)
2013,Febrero,Guatemala,0,8,,8,POINT (4815189 -75736374)
2013,Febrero,Guatemala,38,91,,129,POINT (6170465 -7542726)
2013,Febrero,Guatemala,0,4,,4,POINT (7819 -72453013)
2013,Febrero,Guatemala,1,0,,1,POINT (7927233 -72508188)
2013,Febrero,Guyana,1,0,,1,POINT (10886686 -74776479)
2013,Febrero,Guyana,7,1,,8,POINT (4697157 -74140516)
2013,Febrero,Guyana,2,3,,5,POINT (6170465 -7542726)
2013,Febrero,Guyana,0,1,,1,POINT (7128047 -73181317)
2013,Febrero,Guinea Ecuatorial,0,1,,1,POINT (4697157 -74140516)
2013,Febrero,Haití,2,0,,2,POINT (10446304 -75516486)
2013,Febrero,Haití,0,1,,1,POINT (125862 -81702165)
2013,Febrero,Haití,7,15,,22,POINT (4697157 -74140516)
2013,Febrero,Haití,6,2,,8,POINT (6170465 -7542726)
2013,Febrero,Haití,2,0,,2,POINT (7128047 -73181317)
2013,Febrero,Honduras,0,7,,7,POINT (10406342 -75527794)
2013,Febrero,Honduras,36,55,,91,POINT (10446304 -75516486)
2013,Febrero,Honduras,7,3,,10,POINT (10886686 -74776479)
2013,Febrero,Honduras,1,3,,4,POINT (125862 -81702165)
2013,Febrero,Honduras,12,18,,30,POINT (3451668 -76532004)
2013,Febrero,Honduras,150,171,,321,POINT (4697157 -74140516)
2013,Febrero,Honduras,1,1,,2,POINT (4815189 -75736374)
2013,Febrero,Honduras,21,26,,47,POINT (6170465 -7542726)
2013,Febrero,Honduras,0,1,,1,POINT (6185536 -67484028)
2013,Febrero,Honduras,0,2,,2,POINT (7819 -72453013)
2013,Febrero,Honduras,0,1,,1,POINT (7927233 -72508188)
2013,Febrero,Hungría,1,0,,1,POINT (0.81488 -77356)
2013,Febrero,Hungría,1,1,,2,POINT (10446304 -75516486)
2013,Febrero,Hungría,0,3,,3,POINT (3451668 -76532004)
2013,Febrero,Hungría,25,39,,64,POINT (4697157 -74140516)
2013,Febrero,Hungría,2,6,,8,POINT (6170465 -7542726)
2013,Febrero,India,5,3,,8,POINT (0.81488 -77356)
2013,Febrero,India,0,1,,1,POINT (10406342 -75527794)
2013,Febrero,India,0,2,,2,POINT (10886686 -74776479)
2013,Febrero,India,5,18,,23,POINT (3451668 -76532004)
2013,Febrero,India,31,247,,278,POINT (4697157 -74140516)
2013,Febrero,India,2,22,,24,POINT (6170465 -7542726)
2013,Febrero,Indonesia,1,0,,1,POINT (10406342 -75527794)
2013,Febrero,Indonesia,0,4,,4,POINT (10446304 -75516486)
2013,Febrero,Indonesia,8,18,,26,POINT (4697157 -74140516)
2013,Febrero,Indonesia,2,0,,2,POINT (6170465 -7542726)
2013,Febrero,Irán,3,10,,13,POINT (4697157 -74140516)
2013,Febrero,República de Irlanda,2,0,,2,POINT (-4191162 -69941498)
2013,Febrero,República de Irlanda,7,8,,15,POINT (0.81488 -77356)
2013,Febrero,República de Irlanda,1,1,,2,POINT (10406342 -75527794)
2013,Febrero,República de Irlanda,4,9,,13,POINT (10446304 -75516486)
2013,Febrero,República de Irlanda,1,1,,2,POINT (11360029 -72129595)
2013,Febrero,República de Irlanda,0,4,,4,POINT (3451668 -76532004)
2013,Febrero,República de Irlanda,35,97,,132,POINT (4697157 -74140516)
2013,Febrero,República de Irlanda,4,10,,14,POINT (6170465 -7542726)
2013,Febrero,República de Irlanda,0,1,,1,POINT (7819 -72453013)
2013,Febrero,Islandia,1,0,,1,POINT (10406342 -75527794)
2013,Febrero,Islandia,0,1,,1,POINT (3451668 -76532004)
2013,Febrero,Islandia,2,3,,5,POINT (4697157 -74140516)
2013,Febrero,Isla de Man,9,13,,22,POINT (0.81488 -77356)
2013,Febrero,Isla de Man,0,11,,11,POINT (10446304 -75516486)
2013,Febrero,Isla de Man,0,6,,6,POINT (10886686 -74776479)
2013,Febrero,Isla de Man,1,2,,3,POINT (11360029 -72129595)
2013,Febrero,Isla de Man,2,9,,11,POINT (3451668 -76532004)
2013,Febrero,Isla de Man,53,91,,144,POINT (4697157 -74140516)
2013,Febrero,Isla de Man,14,40,,54,POINT (6170465 -7542726)
2013,Febrero,Israel,4,8,,12,POINT (0.81488 -77356)
2013,Febrero,Israel,1,3,,4,POINT (10406342 -75527794)
2013,Febrero,Israel,2,38,,40,POINT (10446304 -75516486)
2013,Febrero,Israel,4,10,,14,POINT (3451668 -76532004)
2013,Febrero,Israel,73,369,,442,POINT (4697157 -74140516)
2013,Febrero,Israel,3,55,,58,POINT (6170465 -7542726)
2013,Febrero,Israel,1,0,,1,POINT (7819 -72453013)
2013,Febrero,Israel,0,2,,2,POINT (7927233 -72508188)
2013,Febrero,Islas Aland/Provincia de Finlandia,1,0,,1,POINT (4697157 -74140516)
2013,Febrero,Italia,1,2,,3,POINT (-4191162 -69941498)
2013,Febrero,Italia,6,25,,31,POINT (0.81488 -77356)
2013,Febrero,Italia,5,17,,22,POINT (10406342 -75527794)
2013,Febrero,Italia,74,115,,189,POINT (10446304 -75516486)
2013,Febrero,Italia,5,22,,27,POINT (10886686 -74776479)
2013,Febrero,Italia,0,1,,1,POINT (11247723 -74213989)
2013,Febrero,Italia,5,15,,20,POINT (11360029 -72129595)
2013,Febrero,Italia,2,4,,6,POINT (125862 -81702165)
2013,Febrero,Italia,17,88,,105,POINT (3451668 -76532004)
2013,Febrero,Italia,0,1,,1,POINT (445285 -75766353)
2013,Febrero,Italia,447,1597,,2044,POINT (4697157 -74140516)
2013,Febrero,Italia,0,5,,5,POINT (4815189 -75736374)
2013,Febrero,Italia,30,112,,142,POINT (6170465 -7542726)
2013,Febrero,Italia,0,1,,1,POINT (6185536 -67484028)
2013,Febrero,Italia,1,2,,3,POINT (7128047 -73181317)
2013,Febrero,Italia,7,25,,32,POINT (7819 -72453013)
2013,Febrero,Italia,0,5,,5,POINT (7927233 -72508188)
2013,Febrero,Jamaica,2,0,,2,POINT (10406342 -75527794)
2013,Febrero,Jamaica,4,3,,7,POINT (10446304 -75516486)
2013,Febrero,Jamaica,0,2,,2,POINT (10886686 -74776479)
2013,Febrero,Jamaica,0,1,,1,POINT (125862 -81702165)
2013,Febrero,Jamaica,2,2,,4,POINT (3451668 -76532004)
2013,Febrero,Jamaica,0,1,,1,POINT (3884426 -77061029)
2013,Febrero,Jamaica,11,16,,27,POINT (4697157 -74140516)
2013,Febrero,Jamaica,1,4,,5,POINT (6170465 -7542726)
2013,Febrero,Islas Salomón,1,0,,1,POINT (4697157 -74140516)
2013,Febrero,Japón,0,2,,2,POINT (-4191162 -69941498)
2013,Febrero,Japón,7,14,,21,POINT (0.81488 -77356)
2013,Febrero,Japón,1,3,,4,POINT (10406342 -75527794)
2013,Febrero,Japón,16,16,,32,POINT (10446304 -75516486)
2013,Febrero,Japón,0,2,,2,POINT (10886686 -74776479)
2013,Febrero,Japón,0,2,,2,POINT (11360029 -72129595)
2013,Febrero,Japón,1,21,,22,POINT (3451668 -76532004)
2013,Febrero,Japón,153,415,,568,POINT (4697157 -74140516)
2013,Febrero,Japón,0,1,,1,POINT (4815189 -75736374)
2013,Febrero,Japón,6,17,,23,POINT (6170465 -7542726)
2013,Febrero,Japón,0,2,,2,POINT (7128047 -73181317)
2013,Febrero,Japón,1,3,,4,POINT (7819 -72453013)
2013,Febrero,Jordania,4,7,,11,POINT (4697157 -74140516)
2013,Febrero,Kazajistán,1,0,,1,POINT (3451668 -76532004)
2013,Febrero,Kazajistán,3,3,,6,POINT (4697157 -74140516)
2013,Febrero,Kenia,2,0,,2,POINT (3451668 -76532004)
2013,Febrero,Kenia,2,10,,12,POINT (4697157 -74140516)
2013,Febrero,Kirguistán,1,0,,1,POINT (4697157 -74140516)
2013,Febrero,Kuwait,0,6,,6,POINT (4697157 -74140516)
2013,Febrero,República de Kosovo,0,1,,1,POINT (4697157 -74140516)
2013,Febrero,Letonia,0,1,,1,POINT (0.81488 -77356)
2013,Febrero,Letonia,0,2,,2,POINT (10406342 -75527794)
2013,Febrero,Letonia,8,10,,18,POINT (4697157 -74140516)
2013,Febrero,Letonia,0,3,,3,POINT (6170465 -7542726)
2013,Febrero,Letonia,1,0,,1,POINT (7819 -72453013)
2013,Febrero,Lituania,1,0,,1,POINT (-4191162 -69941498)
2013,Febrero,Lituania,1,0,,1,POINT (0.81488 -77356)
2013,Febrero,Lituania,0,2,,2,POINT (10406342 -75527794)
2013,Febrero,Lituania,0,1,,1,POINT (10446304 -75516486)
2013,Febrero,Lituania,0,2,,2,POINT (3451668 -76532004)
2013,Febrero,Lituania,7,20,,27,POINT (4697157 -74140516)
2013,Febrero,Lituania,1,0,,1,POINT (6170465 -7542726)
2013,Febrero,Lituania,0,2,,2,POINT (7819 -72453013)
2013,Febrero,Líbano,0,1,,1,POINT (0.81488 -77356)
2013,Febrero,Líbano,2,2,,4,POINT (10886686 -74776479)
2013,Febrero,Líbano,6,2,,8,POINT (11360029 -72129595)
2013,Febrero,Líbano,9,19,,28,POINT (4697157 -74140516)
2013,Febrero,Líbano,1,0,,1,POINT (6170465 -7542726)
2013,Febrero,Líbano,0,1,,1,POINT (7819 -72453013)
2013,Febrero,Liberia,1,1,,2,POINT (4697157 -74140516)
2013,Febrero,Liberia,1,0,,1,POINT (6170465 -7542726)
2013,Febrero,Libia,0,2,,2,POINT (4697157 -74140516)
2013,Febrero,Liechtenstein,1,0,,1,POINT (10446304 -75516486)
2013,Febrero,Liechtenstein,1,0,,1,POINT (4697157 -74140516)
2013,Febrero,Luxemburgo,2,0,,2,POINT (3451668 -76532004)
2013,Febrero,Luxemburgo,5,8,,13,POINT (4697157 -74140516)
2013,Febrero,Luxemburgo,2,1,,3,POINT (6170465 -7542726)
2013,Febrero,Macedonia,0,1,,1,POINT (4697157 -74140516)
2013,Febrero,Madagascar,1,0,,1,POINT (4697157 -74140516)
2013,Febrero,Malasia,0,2,,2,POINT (10446304 -75516486)
2013,Febrero,Malasia,13,18,,31,POINT (4697157 -74140516)
2013,Febrero,Malasia,3,1,,4,POINT (6170465 -7542726)
2013,Febrero,Malawi,1,0,,1,POINT (4697157 -74140516)
2013,Febrero,Malta,2,0,,2,POINT (0.81488 -77356)
2013,Febrero,Malta,2,4,,6,POINT (4697157 -74140516)
2013,Febrero,Marruecos,0,1,,1,POINT (0.81488 -77356)
2013,Febrero,Marruecos,4,3,,7,POINT (4697157 -74140516)
2013,Febrero,Mauricio,0,1,,1,POINT (4697157 -74140516)
2013,Febrero,Mauricio,0,1,,1,POINT (6170465 -7542726)
2013,Febrero,Mauritania,3,1,,4,POINT (4697157 -74140516)
2013,Febrero,México,3,13,,16,POINT (0.81488 -77356)
2013,Febrero,México,10,11,,21,POINT (10406342 -75527794)
2013,Febrero,México,82,170,,252,POINT (10446304 -75516486)
2013,Febrero,México,10,43,,53,POINT (10886686 -74776479)
2013,Febrero,México,0,5,,5,POINT (11360029 -72129595)
2013,Febrero,México,2,4,,6,POINT (125862 -81702165)
2013,Febrero,México,40,142,,182,POINT (3451668 -76532004)
2013,Febrero,México,1,1,,2,POINT (445285 -75766353)
2013,Febrero,México,1317,3672,,4989,POINT (4697157 -74140516)
2013,Febrero,México,4,9,,13,POINT (4815189 -75736374)
2013,Febrero,México,79,314,,393,POINT (6170465 -7542726)
2013,Febrero,México,3,6,,9,POINT (7128047 -73181317)
2013,Febrero,México,7,24,,31,POINT (7819 -72453013)
2013,Febrero,México,20,16,,36,POINT (7927233 -72508188)
2013,Febrero,República de Moldavia,0,3,,3,POINT (4697157 -74140516)
2013,Febrero,República de Moldavia,1,1,,2,POINT (6170465 -7542726)
2013,Febrero,Mongolia,1,0,,1,POINT (4697157 -74140516)
2013,Febrero,Mozambique,0,1,,1,POINT (4697157 -74140516)
2013,Febrero,Nepal,0,4,,4,POINT (4697157 -74140516)
2013,Febrero,Nicaragua,1,0,,1,POINT (0.81488 -77356)
2013,Febrero,Nicaragua,13,12,,25,POINT (10446304 -75516486)
2013,Febrero,Nicaragua,1,1,,2,POINT (10886686 -74776479)
2013,Febrero,Nicaragua,3,0,,3,POINT (125862 -81702165)
2013,Febrero,Nicaragua,3,2,,5,POINT (3451668 -76532004)
2013,Febrero,Nicaragua,40,53,,93,POINT (4697157 -74140516)
2013,Febrero,Nicaragua,0,1,,1,POINT (4815189 -75736374)
2013,Febrero,Nicaragua,6,10,,16,POINT (6170465 -7542726)
2013,Febrero,Nicaragua,1,0,,1,POINT (7128047 -73181317)
2013,Febrero,Nigeria,0,1,,1,POINT (10446304 -75516486)
2013,Febrero,Nigeria,0,1,,1,POINT (3451668 -76532004)
2013,Febrero,Nigeria,1,12,,13,POINT (4697157 -74140516)
2013,Febrero,Nigeria,1,1,,2,POINT (6170465 -7542726)
2013,Febrero,Nigeria,1,1,,2,POINT (7819 -72453013)
2013,Febrero,Níger,0,1,,1,POINT (4697157 -74140516)
2013,Febrero,Noruega,3,2,,5,POINT (0.81488 -77356)
2013,Febrero,Noruega,3,2,,5,POINT (10406342 -75527794)
2013,Febrero,Noruega,3,14,,17,POINT (10446304 -75516486)
2013,Febrero,Noruega,1,2,,3,POINT (10886686 -74776479)
2013,Febrero,Noruega,4,4,,8,POINT (11247723 -74213989)
2013,Febrero,Noruega,0,1,,1,POINT (11360029 -72129595)
2013,Febrero,Noruega,3,7,,10,POINT (3451668 -76532004)
2013,Febrero,Noruega,55,107,,162,POINT (4697157 -74140516)
2013,Febrero,Noruega,8,12,,20,POINT (6170465 -7542726)
2013,Febrero,Noruega,0,1,,1,POINT (7819 -72453013)
2013,Febrero,Nueva Zelanda,2,0,,2,POINT (-4191162 -69941498)
2013,Febrero,Nueva Zelanda,2,4,,6,POINT (0.81488 -77356)
2013,Febrero,Nueva Zelanda,0,1,,1,POINT (1800143 -78802679)
2013,Febrero,Nueva Zelanda,5,9,,14,POINT (10446304 -75516486)
2013,Febrero,Nueva Zelanda,2,1,,3,POINT (3451668 -76532004)
2013,Febrero,Nueva Zelanda,26,46,,72,POINT (4697157 -74140516)
2013,Febrero,Nueva Zelanda,0,7,,7,POINT (6170465 -7542726)
2013,Febrero,Nueva Zelanda,0,1,,1,POINT (7819 -72453013)
2013,Febrero,Omán,0,2,,2,POINT (4697157 -74140516)
2013,Febrero,Nueva Zelanda,0,1,,1,POINT (0.81488 -77356)
2013,Febrero,Nueva Zelanda,4,7,,11,POINT (10406342 -75527794)
2013,Febrero,Nueva Zelanda,0,5,,5,POINT (4697157 -74140516)
2013,Febrero,Nueva Zelanda,0,1,,1,POINT (6222552 -77401154)
2013,Febrero,Países Bajos,0,2,,2,POINT (-4191162 -69941498)
2013,Febrero,Países Bajos,6,12,,18,POINT (0.81488 -77356)
2013,Febrero,Países Bajos,1,10,,11,POINT (10446304 -75516486)
2013,Febrero,Países Bajos,3,1,,4,POINT (10886686 -74776479)
2013,Febrero,Países Bajos,2,7,,9,POINT (11360029 -72129595)
2013,Febrero,Países Bajos,10,15,,25,POINT (1152863 -72919186)
2013,Febrero,Países Bajos,5,14,,19,POINT (3451668 -76532004)
2013,Febrero,Países Bajos,15,22,,37,POINT (445285 -75766353)
2013,Febrero,Países Bajos,183,272,,455,POINT (4697157 -74140516)
2013,Febrero,Países Bajos,176,188,,364,POINT (6170465 -7542726)
2013,Febrero,Países Bajos,4,5,,9,POINT (7128047 -73181317)
2013,Febrero,Países Bajos,0,3,,3,POINT (7819 -72453013)
2013,Febrero,Pakistán,1,1,,2,POINT (10446304 -75516486)
2013,Febrero,Pakistán,0,20,,20,POINT (4697157 -74140516)
2013,Febrero,Pakistán,0,1,,1,POINT (6170465 -7542726)
2013,Febrero,Panamá,1,2,,3,POINT (0.81488 -77356)
2013,Febrero,Panamá,3,13,,16,POINT (10406342 -75527794)
2013,Febrero,Panamá,161,204,,365,POINT (10446304 -75516486)
2013,Febrero,Panamá,65,100,,165,POINT (10886686 -74776479)
2013,Febrero,Panamá,1,3,,4,POINT (11360029 -72129595)
2013,Febrero,Panamá,22,31,,53,POINT (125862 -81702165)
2013,Febrero,Panamá,103,140,,243,POINT (3451668 -76532004)
2013,Febrero,Panamá,589,773,,1362,POINT (4697157 -74140516)
2013,Febrero,Panamá,69,106,,175,POINT (4815189 -75736374)
2013,Febrero,Panamá,150,249,,399,POINT (6170465 -7542726)
2013,Febrero,Panamá,1,1,,2,POINT (6222552 -77401154)
2013,Febrero,Panamá,8,5,,13,POINT (7128047 -73181317)
2013,Febrero,Panamá,2,1,,3,POINT (7819 -72453013)
2013,Febrero,Panamá,3,10,,13,POINT (7927233 -72508188)
2013,Febrero,Paraguay,3,0,,3,POINT (10406342 -75527794)
2013,Febrero,Paraguay,25,17,,42,POINT (10446304 -75516486)
2013,Febrero,Paraguay,4,1,,5,POINT (10886686 -74776479)
2013,Febrero,Paraguay,0,1,,1,POINT (11360029 -72129595)
2013,Febrero,Paraguay,18,11,,29,POINT (125862 -81702165)
2013,Febrero,Paraguay,6,5,,11,POINT (3451668 -76532004)
2013,Febrero,Paraguay,126,166,,292,POINT (4697157 -74140516)
2013,Febrero,Paraguay,21,15,,36,POINT (6170465 -7542726)
2013,Febrero,Paraguay,1,1,,2,POINT (7088729 -70740253)
2013,Febrero,Paraguay,0,2,,2,POINT (7819 -72453013)
2013,Febrero,Perú,7,11,,18,POINT (-4191162 -69941498)
2013,Febrero,Perú,801,786,,1587,POINT (0.81488 -77356)
2013,Febrero,Perú,57,55,,112,POINT (10406342 -75527794)
2013,Febrero,Perú,373,291,,664,POINT (10446304 -75516486)
2013,Febrero,Perú,67,60,,127,POINT (10886686 -74776479)
2013,Febrero,Perú,0,5,,5,POINT (11247723 -74213989)
2013,Febrero,Perú,1,4,,5,POINT (11360029 -72129595)
2013,Febrero,Perú,143,102,,245,POINT (125862 -81702165)
2013,Febrero,Perú,223,231,,454,POINT (3451668 -76532004)
2013,Febrero,Perú,0,1,,1,POINT (445285 -75766353)
2013,Febrero,Perú,3614,3529,,7143,POINT (4697157 -74140516)
2013,Febrero,Perú,2,3,,5,POINT (4815189 -75736374)
2013,Febrero,Perú,271,373,,644,POINT (6170465 -7542726)
2013,Febrero,Perú,2,1,,3,POINT (6185536 -67484028)
2013,Febrero,Perú,10,9,,19,POINT (7128047 -73181317)
2013,Febrero,Perú,28,47,,75,POINT (7819 -72453013)
2013,Febrero,Perú,1,5,,6,POINT (7927233 -72508188)
2013,Febrero,Perú,0,1,,1,POINT (9402597 -75681642)
2013,Febrero,Palestina,2,1,,3,POINT (4697157 -74140516)
2013,Febrero,Polonia,0,1,,1,POINT (-4191162 -69941498)
2013,Febrero,Polonia,11,8,,19,POINT (0.81488 -77356)
2013,Febrero,Polonia,3,7,,10,POINT (10406342 -75527794)
2013,Febrero,Polonia,3,11,,14,POINT (10446304 -75516486)
2013,Febrero,Polonia,1,0,,1,POINT (10886686 -74776479)
2013,Febrero,Polonia,0,2,,2,POINT (11247723 -74213989)
2013,Febrero,Polonia,3,6,,9,POINT (11360029 -72129595)
2013,Febrero,Polonia,2,2,,4,POINT (3451668 -76532004)
2013,Febrero,Polonia,83,115,,198,POINT (4697157 -74140516)
2013,Febrero,Polonia,5,6,,11,POINT (6170465 -7542726)
2013,Febrero,Polonia,2,1,,3,POINT (7819 -72453013)
2013,Febrero,Polonia,0,2,,2,POINT (7927233 -72508188)
2013,Febrero,Portugal,3,4,,7,POINT (0.81488 -77356)
2013,Febrero,Portugal,0,2,,2,POINT (10406342 -75527794)
2013,Febrero,Portugal,6,6,,12,POINT (10446304 -75516486)
2013,Febrero,Portugal,8,8,,16,POINT (10886686 -74776479)
2013,Febrero,Portugal,2,2,,4,POINT (11360029 -72129595)
2013,Febrero,Portugal,2,10,,12,POINT (3451668 -76532004)
2013,Febrero,Portugal,99,282,,381,POINT (4697157 -74140516)
2013,Febrero,Portugal,5,20,,25,POINT (6170465 -7542726)
2013,Febrero,Portugal,0,3,,3,POINT (7819 -72453013)
2013,Febrero,Puerto Rico/Territorio de Estados Unidos,0,1,,1,POINT (4697157 -74140516)
2013,Febrero,Qatar,1,78,,79,POINT (4697157 -74140516)
2013,Febrero,Reino Unido de Gran Bretaña e Irlanda del Norte,5,8,,13,POINT (-4191162 -69941498)
2013,Febrero,Reino Unido de Gran Bretaña e Irlanda del Norte,3,1,,4,POINT (0.81488 -77356)
2013,Febrero,Reino Unido de Gran Bretaña e Irlanda del Norte,1,5,,6,POINT (10406342 -75527794)
2013,Febrero,Reino Unido de Gran Bretaña e Irlanda del Norte,24,36,,60,POINT (10446304 -75516486)
2013,Febrero,Reino Unido de Gran Bretaña e Irlanda del Norte,1,1,,2,POINT (10886686 -74776479)
2013,Febrero,Reino Unido de Gran Bretaña e Irlanda del Norte,4,2,,6,POINT (11247723 -74213989)
2013,Febrero,Reino Unido de Gran Bretaña e Irlanda del Norte,0,2,,2,POINT (11360029 -72129595)
2013,Febrero,Reino Unido de Gran Bretaña e Irlanda del Norte,8,19,,27,POINT (3451668 -76532004)
2013,Febrero,Reino Unido de Gran Bretaña e Irlanda del Norte,1,0,,1,POINT (445285 -75766353)
2013,Febrero,Reino Unido de Gran Bretaña e Irlanda del Norte,229,493,,722,POINT (4697157 -74140516)
2013,Febrero,Reino Unido de Gran Bretaña e Irlanda del Norte,10,44,,54,POINT (6170465 -7542726)
2013,Febrero,Reino Unido de Gran Bretaña e Irlanda del Norte,1,3,,4,POINT (7819 -72453013)
2013,Febrero,República de Belarús,0,1,,1,POINT (10446304 -75516486)
2013,Febrero,República de Belarús,3,0,,3,POINT (4697157 -74140516)
2013,Febrero,República Dominicana,2,8,,10,POINT (0.81488 -77356)
2013,Febrero,República Dominicana,1,9,,10,POINT (10406342 -75527794)
2013,Febrero,República Dominicana,9,28,,37,POINT (10446304 -75516486)
2013,Febrero,República Dominicana,10,34,,44,POINT (10886686 -74776479)
2013,Febrero,República Dominicana,0,5,,5,POINT (11360029 -72129595)
2013,Febrero,República Dominicana,0,1,,1,POINT (125862 -81702165)
2013,Febrero,República Dominicana,14,13,,27,POINT (3451668 -76532004)
2013,Febrero,República Dominicana,1,0,,1,POINT (445285 -75766353)
2013,Febrero,República Dominicana,289,390,,679,POINT (4697157 -74140516)
2013,Febrero,República Dominicana,3,5,,8,POINT (4815189 -75736374)
2013,Febrero,República Dominicana,31,46,,77,POINT (6170465 -7542726)
2013,Febrero,República Dominicana,1,6,,7,POINT (7128047 -73181317)
2013,Febrero,República Dominicana,0,2,,2,POINT (7819 -72453013)
2013,Febrero,República Dominicana,4,10,,14,POINT (7927233 -72508188)
2013,Febrero,República Checa,1,0,,1,POINT (10446304 -75516486)
2013,Febrero,República Checa,0,1,,1,POINT (11360029 -72129595)
2013,Febrero,República Checa,5,0,,5,POINT (4697157 -74140516)
2013,Febrero,República Checa,1,0,,1,POINT (6170465 -7542726)
2013,Febrero,República Democrática Popular de Corea,1,0,,1,POINT (-4191162 -69941498)
2013,Febrero,Rumania,2,2,,4,POINT (0.81488 -77356)
2013,Febrero,Rumania,1,1,,2,POINT (10406342 -75527794)
2013,Febrero,Rumania,4,0,,4,POINT (10446304 -75516486)
2013,Febrero,Rumania,0,1,,1,POINT (10886686 -74776479)
2013,Febrero,Rumania,2,1,,3,POINT (11360029 -72129595)
2013,Febrero,Rumania,2,3,,5,POINT (3451668 -76532004)
2013,Febrero,Rumania,31,60,,91,POINT (4697157 -74140516)
2013,Febrero,Rumania,1,6,,7,POINT (6170465 -7542726)
2013,Febrero,Rumania,0,1,,1,POINT (7819 -72453013)
2013,Febrero,Federación de Rusia,7,5,,12,POINT (0.81488 -77356)
2013,Febrero,Federación de Rusia,0,9,,9,POINT (10406342 -75527794)
2013,Febrero,Federación de Rusia,5,3,,8,POINT (10446304 -75516486)
2013,Febrero,Federación de Rusia,3,1,,4,POINT (3451668 -76532004)
2013,Febrero,Federación de Rusia,20,38,,58,POINT (4697157 -74140516)
2013,Febrero,Federación de Rusia,1,1,,2,POINT (6170465 -7542726)
2013,Febrero,Federación de Rusia,1,0,,1,POINT (7819 -72453013)
2013,Febrero,San Cristóbal y Nevis,0,2,,2,POINT (10446304 -75516486)
2013,Febrero,San Cristóbal y Nevis,0,1,,1,POINT (6170465 -7542726)
2013,Febrero,San  Vicente y las Granadinas,1,1,,2,POINT (10886686 -74776479)
2013,Febrero,San  Vicente y las Granadinas,0,1,,1,POINT (4697157 -74140516)
2013,Febrero,Santa Lucia,1,1,,2,POINT (4697157 -74140516)
2013,Febrero,Santa Lucia,0,1,,1,POINT (6170465 -7542726)
2013,Febrero,Senegal,0,1,,1,POINT (4697157 -74140516)
2013,Febrero,Serbia,1,3,,4,POINT (10446304 -75516486)
2013,Febrero,Serbia,0,5,,5,POINT (3451668 -76532004)
2013,Febrero,Serbia,7,8,,15,POINT (4697157 -74140516)
2013,Febrero,Serbia,1,0,,1,POINT (6170465 -7542726)
2013,Febrero,Singapur,0,1,,1,POINT (10406342 -75527794)
2013,Febrero,Singapur,1,1,,2,POINT (10446304 -75516486)
2013,Febrero,Singapur,8,12,,20,POINT (4697157 -74140516)
2013,Febrero,República Árabe Siria,0,1,,1,POINT (0.81488 -77356)
2013,Febrero,República Árabe Siria,1,0,,1,POINT (11360029 -72129595)
2013,Febrero,República Árabe Siria,0,1,,1,POINT (4697157 -74140516)
2013,Febrero,Sri Lanka,0,1,,1,POINT (3451668 -76532004)
2013,Febrero,Sri Lanka,0,4,,4,POINT (4697157 -74140516)
2013,Febrero,Sudáfrica,1,1,,2,POINT (0.81488 -77356)
2013,Febrero,Sudáfrica,2,2,,4,POINT (10446304 -75516486)
2013,Febrero,Sudáfrica,2,2,,4,POINT (10886686 -74776479)
2013,Febrero,Sudáfrica,1,0,,1,POINT (445285 -75766353)
2013,Febrero,Sudáfrica,16,64,,80,POINT (4697157 -74140516)
2013,Febrero,Sudáfrica,1,1,,2,POINT (6170465 -7542726)
2013,Febrero,Sudáfrica,0,1,,1,POINT (7819 -72453013)
2013,Febrero,Sudán,1,4,,5,POINT (4697157 -74140516)
2013,Febrero,Suecia,10,16,,26,POINT (0.81488 -77356)
2013,Febrero,Suecia,17,11,,28,POINT (10406342 -75527794)
2013,Febrero,Suecia,19,17,,36,POINT (10446304 -75516486)
2013,Febrero,Suecia,0,3,,3,POINT (10886686 -74776479)
2013,Febrero,Suecia,2,2,,4,POINT (11247723 -74213989)
2013,Febrero,Suecia,1,8,,9,POINT (11360029 -72129595)
2013,Febrero,Suecia,2,2,,4,POINT (125862 -81702165)
2013,Febrero,Suecia,5,7,,12,POINT (3451668 -76532004)
2013,Febrero,Suecia,185,272,,457,POINT (4697157 -74140516)
2013,Febrero,Suecia,8,30,,38,POINT (6170465 -7542726)
2013,Febrero,Suecia,0,3,,3,POINT (7819 -72453013)
2013,Febrero,Suiza,0,2,,2,POINT (-4191162 -69941498)
2013,Febrero,Suiza,24,22,,46,POINT (0.81488 -77356)
2013,Febrero,Suiza,7,9,,16,POINT (10406342 -75527794)
2013,Febrero,Suiza,19,38,,57,POINT (10446304 -75516486)
2013,Febrero,Suiza,2,5,,7,POINT (10886686 -74776479)
2013,Febrero,Suiza,4,6,,10,POINT (11247723 -74213989)
2013,Febrero,Suiza,3,7,,10,POINT (11360029 -72129595)
2013,Febrero,Suiza,19,42,,61,POINT (3451668 -76532004)
2013,Febrero,Suiza,319,556,,875,POINT (4697157 -74140516)
2013,Febrero,Suiza,0,4,,4,POINT (4815189 -75736374)
2013,Febrero,Suiza,16,58,,74,POINT (6170465 -7542726)
2013,Febrero,Suiza,4,4,,8,POINT (7819 -72453013)
2013,Febrero,Surinam,1,0,,1,POINT (10886686 -74776479)
2013,Febrero,Surinam,0,3,,3,POINT (3451668 -76532004)
2013,Febrero,Surinam,6,14,,20,POINT (4697157 -74140516)
2013,Febrero,Surinam,4,5,,9,POINT (6170465 -7542726)
2013,Febrero,Suazilandia,1,0,,1,POINT (3451668 -76532004)
2013,Febrero,Taiwán,1,0,,1,POINT (-4191162 -69941498)
2013,Febrero,Taiwán,0,1,,1,POINT (3884426 -77061029)
2013,Febrero,Taiwán,2,2,,4,POINT (4697157 -74140516)
2013,Febrero,República de Tayikistán,0,1,,1,POINT (4697157 -74140516)
2013,Febrero,Tailandia,1,0,,1,POINT (10446304 -75516486)
2013,Febrero,Tailandia,1,0,,1,POINT (3451668 -76532004)
2013,Febrero,Tailandia,14,14,,28,POINT (4697157 -74140516)
2013,Febrero,Tíbet/Región Autónoma de China,1,4,,5,POINT (4697157 -74140516)
2013,Febrero,Territorio Antártico Británico/Territorio Británico de Ultramar,1,0,,1,POINT (3451668 -76532004)
2013,Febrero,Territorio Antártico Británico/Territorio Británico de Ultramar,4,4,,8,POINT (4697157 -74140516)
2013,Febrero,Tanzania,1,4,,5,POINT (4697157 -74140516)
2013,Febrero,Togo,0,1,,1,POINT (10446304 -75516486)
2013,Febrero,Togo,0,1,,1,POINT (3451668 -76532004)
2013,Febrero,Trinidad y Tobago,0,1,,1,POINT (10406342 -75527794)
2013,Febrero,Trinidad y Tobago,4,10,,14,POINT (10446304 -75516486)
2013,Febrero,Trinidad y Tobago,1,0,,1,POINT (10886686 -74776479)
2013,Febrero,Trinidad y Tobago,3,6,,9,POINT (3451668 -76532004)
2013,Febrero,Trinidad y Tobago,13,31,,44,POINT (4697157 -74140516)
2013,Febrero,Trinidad y Tobago,1,1,,2,POINT (4815189 -75736374)
2013,Febrero,Trinidad y Tobago,2,3,,5,POINT (6170465 -7542726)
2013,Febrero,Túnez,0,1,,1,POINT (0.81488 -77356)
2013,Febrero,Túnez,0,1,,1,POINT (3451668 -76532004)
2013,Febrero,Túnez,0,2,,2,POINT (4697157 -74140516)
2013,Febrero,Turquía,0,2,,2,POINT (0.81488 -77356)
2013,Febrero,Turquía,1,0,,1,POINT (10406342 -75527794)
2013,Febrero,Turquía,1,0,,1,POINT (10446304 -75516486)
2013,Febrero,Turquía,0,1,,1,POINT (11247723 -74213989)
2013,Febrero,Turquía,0,2,,2,POINT (11360029 -72129595)
2013,Febrero,Turquía,2,4,,6,POINT (3451668 -76532004)
2013,Febrero,Turquía,17,56,,73,POINT (4697157 -74140516)
2013,Febrero,Turquía,2,2,,4,POINT (6170465 -7542726)
2013,Febrero,Turquía,0,2,,2,POINT (7819 -72453013)
2013,Febrero,Turquía,0,2,,2,POINT (9402597 -75681642)
2013,Febrero,Ucrania,1,1,,2,POINT (-4191162 -69941498)
2013,Febrero,Ucrania,1,1,,2,POINT (10406342 -75527794)
2013,Febrero,Ucrania,0,1,,1,POINT (11247723 -74213989)
2013,Febrero,Ucrania,1,0,,1,POINT (3451668 -76532004)
2013,Febrero,Ucrania,14,16,,30,POINT (4697157 -74140516)
2013,Febrero,Ucrania,3,1,,4,POINT (6170465 -7542726)
2013,Febrero,Uganda,0,1,,1,POINT (0.81488 -77356)
2013,Febrero,Uganda,2,1,,3,POINT (4697157 -74140516)
2013,Febrero,Federación de Rusia,4,2,,6,POINT (0.81488 -77356)
2013,Febrero,Federación de Rusia,0,5,,5,POINT (10406342 -75527794)
2013,Febrero,Federación de Rusia,1,2,,3,POINT (10446304 -75516486)
2013,Febrero,Federación de Rusia,3,1,,4,POINT (11360029 -72129595)
2013,Febrero,Federación de Rusia,0,4,,4,POINT (125862 -81702165)
2013,Febrero,Federación de Rusia,2,1,,3,POINT (3451668 -76532004)
2013,Febrero,Federación de Rusia,136,188,,324,POINT (4697157 -74140516)
2013,Febrero,Federación de Rusia,2,3,,5,POINT (6170465 -7542726)
2013,Febrero,Federación de Rusia,3,2,,5,POINT (7819 -72453013)
2013,Febrero,Federación de Rusia,0,1,,1,POINT (9402597 -75681642)
2013,Febrero,Uruguay,5,12,,17,POINT (0.81488 -77356)
2013,Febrero,Uruguay,21,10,,31,POINT (10406342 -75527794)
2013,Febrero,Uruguay,98,96,,194,POINT (10446304 -75516486)
2013,Febrero,Uruguay,22,18,,40,POINT (10886686 -74776479)
2013,Febrero,Uruguay,0,2,,2,POINT (11360029 -72129595)
2013,Febrero,Uruguay,31,29,,60,POINT (125862 -81702165)
2013,Febrero,Uruguay,4,8,,12,POINT (3451668 -76532004)
2013,Febrero,Uruguay,179,293,,472,POINT (4697157 -74140516)
2013,Febrero,Uruguay,0,2,,2,POINT (4815189 -75736374)
2013,Febrero,Uruguay,11,31,,42,POINT (6170465 -7542726)
2013,Febrero,Uruguay,1,0,,1,POINT (7128047 -73181317)
2013,Febrero,Uruguay,5,12,,17,POINT (7819 -72453013)
2013,Febrero,Uruguay,2,2,,4,POINT (7927233 -72508188)
2013,Febrero,Venezuela,86,94,,180,POINT (0.81488 -77356)
2013,Febrero,Venezuela,6,5,,11,POINT (10406342 -75527794)
2013,Febrero,Venezuela,97,175,,272,POINT (10446304 -75516486)
2013,Febrero,Venezuela,128,148,,276,POINT (10886686 -74776479)
2013,Febrero,Venezuela,1,0,,1,POINT (11247723 -74213989)
2013,Febrero,Venezuela,1714,2157,,3871,POINT (11360029 -72129595)
2013,Febrero,Venezuela,1,3,,4,POINT (1152863 -72919186)
2013,Febrero,Venezuela,18,10,,28,POINT (125862 -81702165)
2013,Febrero,Venezuela,58,74,,132,POINT (3451668 -76532004)
2013,Febrero,Venezuela,1,3,,4,POINT (445285 -75766353)
2013,Febrero,Venezuela,6493,7160,,13653,POINT (4697157 -74140516)
2013,Febrero,Venezuela,6,25,,31,POINT (4815189 -75736374)
2013,Febrero,Venezuela,417,477,,894,POINT (6170465 -7542726)
2013,Febrero,Venezuela,214,333,,547,POINT (6185536 -67484028)
2013,Febrero,Venezuela,45,72,,117,POINT (7088729 -70740253)
2013,Febrero,Venezuela,15,10,,25,POINT (7128047 -73181317)
2013,Febrero,Venezuela,1629,1570,,3199,POINT (7819 -72453013)
2013,Febrero,Venezuela,353,330,,683,POINT (7927233 -72508188)
2013,Febrero,Vietnam,1,0,,1,POINT (0.81488 -77356)
2013,Febrero,República Árabe de Yemen,0,1,,1,POINT (4697157 -74140516)
2013,Febrero,Zambia,0,1,,1,POINT (10446304 -75516486)
2013,Febrero,Zambia,0,1,,1,POINT (4697157 -74140516)
2013,Febrero,Zimbabue,0,1,,1,POINT (3451668 -76532004)
2013,Febrero,Reino Unido de Gran Bretaña e Irlanda del Norte,19,40,,59,POINT (0.81488 -77356)
2013,Febrero,Reino Unido de Gran Bretaña e Irlanda del Norte,12,20,,32,POINT (10406342 -75527794)
2013,Febrero,Reino Unido de Gran Bretaña e Irlanda del Norte,17,29,,46,POINT (10446304 -75516486)
2013,Febrero,Reino Unido de Gran Bretaña e Irlanda del Norte,1,3,,4,POINT (10886686 -74776479)
2013,Febrero,Reino Unido de Gran Bretaña e Irlanda del Norte,0,2,,2,POINT (11247723 -74213989)
2013,Febrero,Reino Unido de Gran Bretaña e Irlanda del Norte,4,5,,9,POINT (11360029 -72129595)
2013,Febrero,Reino Unido de Gran Bretaña e Irlanda del Norte,2,23,,25,POINT (3451668 -76532004)
2013,Febrero,Reino Unido de Gran Bretaña e Irlanda del Norte,307,654,,961,POINT (4697157 -74140516)
2013,Febrero,Reino Unido de Gran Bretaña e Irlanda del Norte,7,22,,29,POINT (6170465 -7542726)
2013,Febrero,Reino Unido de Gran Bretaña e Irlanda del Norte,2,9,,11,POINT (7819 -72453013)
2013,Febrero,Reino Unido de Gran Bretaña e Irlanda del Norte,0,1,,1,POINT (7927233 -72508188)
2013,Febrero,Países Bajos,17,16,,33,POINT (0.81488 -77356)
2013,Febrero,Países Bajos,7,15,,22,POINT (10406342 -75527794)
2013,Febrero,Países Bajos,19,30,,49,POINT (10446304 -75516486)
2013,Febrero,Países Bajos,3,5,,8,POINT (10886686 -74776479)
2013,Febrero,Países Bajos,0,2,,2,POINT (11247723 -74213989)
2013,Febrero,Países Bajos,4,5,,9,POINT (11360029 -72129595)
2013,Febrero,Países Bajos,1,4,,5,POINT (125862 -81702165)
2013,Febrero,Países Bajos,14,37,,51,POINT (3451668 -76532004)
2013,Febrero,Países Bajos,0,1,,1,POINT (3884426 -77061029)
2013,Febrero,Países Bajos,0,1,,1,POINT (445285 -75766353)
2013,Febrero,Países Bajos,371,690,,1061,POINT (4697157 -74140516)
2013,Febrero,Países Bajos,0,1,,1,POINT (4815189 -75736374)
2013,Febrero,Países Bajos,86,135,,221,POINT (6170465 -7542726)
2013,Febrero,Países Bajos,2,5,,7,POINT (7128047 -73181317)
2013,Febrero,Países Bajos,0,18,,18,POINT (7819 -72453013)
2013,Febrero,Desconocido,0,1,,1,POINT (4697157 -74140516)
2013,Febrero,Lituania,0,1,,1,POINT (10406342 -75527794)
2013,Febrero,Lituania,1,4,,5,POINT (4697157 -74140516)
2013,Febrero,Reino Unido de Gran Bretaña e Irlanda del Norte,1,1,,2,POINT (10406342 -75527794)
2013,Febrero,Reino Unido de Gran Bretaña e Irlanda del Norte,0,2,,2,POINT (4697157 -74140516)
2013,Febrero,Reino Unido de Gran Bretaña e Irlanda del Norte,0,1,,1,POINT (10406342 -75527794)
2013,Febrero,Reino Unido de Gran Bretaña e Irlanda del Norte,0,1,,1,POINT (10886686 -74776479)
2013,Febrero,Reino Unido de Gran Bretaña e Irlanda del Norte,0,2,,2,POINT (3451668 -76532004)
2013,Febrero,Reino Unido de Gran Bretaña e Irlanda del Norte,5,8,,13,POINT (4697157 -74140516)
2013,Febrero,Reino Unido de Gran Bretaña e Irlanda del Norte,0,1,,1,POINT (6170465 -7542726)
2013,Febrero,Reino Unido de Gran Bretaña e Irlanda del Norte,0,1,,1,POINT (7819 -72453013)
2013,Febrero,Letonia,0,1,,1,POINT (3884426 -77061029)
2013,Febrero,Marruecos,0,2,,2,POINT (4697157 -74140516)
2013,Febrero,República CentroÁfricana,0,1,,1,POINT (3451668 -76532004)
2013,Febrero,República CentroÁfricana,0,2,,2,POINT (4697157 -74140516)
2013,Marzo,Desconocido,0,1,,1,POINT (4697157 -74140516)
2013,Marzo,Albania,2,2,,4,POINT (4697157 -74140516)
2013,Marzo,Alemania,4,15,,19,POINT (-4191162 -69941498)
2013,Marzo,Alemania,62,62,,124,POINT (0.81488 -77356)
2013,Marzo,Alemania,10,22,,32,POINT (10406342 -75527794)
2013,Marzo,Alemania,46,85,,131,POINT (10446304 -75516486)
2013,Marzo,Alemania,8,13,,21,POINT (10886686 -74776479)
2013,Marzo,Alemania,13,19,,32,POINT (11360029 -72129595)
2013,Marzo,Alemania,0,1,,1,POINT (1152863 -72919186)
2013,Marzo,Alemania,2,2,,4,POINT (125744111 -81703935)
2013,Marzo,Alemania,1,4,,5,POINT (125862 -81702165)
2013,Marzo,Alemania,12,9,,21,POINT (133387613 -81372937)
2013,Marzo,Alemania,34,48,,82,POINT (3451668 -76532004)
2013,Marzo,Alemania,1421,2151,,3572,POINT (4697157 -74140516)
2013,Marzo,Alemania,0,4,,4,POINT (4815189 -75736374)
2013,Marzo,Alemania,47,95,,142,POINT (6170465 -7542726)
2013,Marzo,Alemania,1,0,,1,POINT (7128047 -73181317)
2013,Marzo,Alemania,8,18,,26,POINT (7819 -72453013)
2013,Marzo,Alemania,0,1,,1,POINT (7927233 -72508188)
2013,Marzo,Alemania,10,21,,31,POINT (863337 -7735002)
2013,Marzo,Andorra,2,8,,10,POINT (4697157 -74140516)
2013,Marzo,Andorra,0,1,,1,POINT (4815189 -75736374)
2013,Marzo,Angola,0,1,,1,POINT (4697157 -74140516)
2013,Marzo,Antigua y Barbuda,0,2,,2,POINT (4697157 -74140516)
2013,Marzo,Países Bajos,0,1,,1,POINT (3451668 -76532004)
2013,Marzo,Países Bajos,11,6,,17,POINT (6170465 -7542726)
2013,Marzo,Arabia Saudita,0,5,,5,POINT (4697157 -74140516)
2013,Marzo,Arabia Saudita,1,0,,1,POINT (6170465 -7542726)
2013,Marzo,Arabia Saudita,0,10,,10,POINT (4697157 -74140516)
2013,Marzo,Argelia,2,3,,5,POINT (4697157 -74140516)
2013,Marzo,Argentina,7,3,,10,POINT (-4191162 -69941498)
2013,Marzo,Argentina,77,122,,199,POINT (0.81488 -77356)
2013,Marzo,Argentina,149,126,,275,POINT (10406342 -75527794)
2013,Marzo,Argentina,933,707,,1640,POINT (10446304 -75516486)
2013,Marzo,Argentina,13,23,,36,POINT (10886686 -74776479)
2013,Marzo,Argentina,20,42,,62,POINT (11360029 -72129595)
2013,Marzo,Argentina,231,222,,453,POINT (125862 -81702165)
2013,Marzo,Argentina,36,70,,106,POINT (3451668 -76532004)
2013,Marzo,Argentina,3996,4900,,8896,POINT (4697157 -74140516)
2013,Marzo,Argentina,1,12,,13,POINT (4815189 -75736374)
2013,Marzo,Argentina,133,231,,364,POINT (6170465 -7542726)
2013,Marzo,Argentina,1,5,,6,POINT (7088729 -70740253)
2013,Marzo,Argentina,1,2,,3,POINT (7128047 -73181317)
2013,Marzo,Argentina,16,44,,60,POINT (7819 -72453013)
2013,Marzo,Argentina,0,7,,7,POINT (7927233 -72508188)
2013,Marzo,Argentina,1,14,,15,POINT (863337 -7735002)
2013,Marzo,República de Armenia,0,1,,1,POINT (4697157 -74140516)
2013,Marzo,Aruba,1,0,,1,POINT (4697157 -74140516)
2013,Marzo,Aruba,1,0,,1,POINT (6170465 -7542726)
2013,Marzo,Australia,7,5,,12,POINT (-4191162 -69941498)
2013,Marzo,Australia,13,27,,40,POINT (0.81488 -77356)
2013,Marzo,Australia,7,13,,20,POINT (10406342 -75527794)
2013,Marzo,Australia,34,43,,77,POINT (10446304 -75516486)
2013,Marzo,Australia,11,14,,25,POINT (10886686 -74776479)
2013,Marzo,Australia,1,3,,4,POINT (11247723 -74213989)
2013,Marzo,Australia,2,6,,8,POINT (11360029 -72129595)
2013,Marzo,Australia,1,1,,2,POINT (133387613 -81372937)
2013,Marzo,Australia,7,14,,21,POINT (3451668 -76532004)
2013,Marzo,Australia,204,382,,586,POINT (4697157 -74140516)
2013,Marzo,Australia,0,2,,2,POINT (4815189 -75736374)
2013,Marzo,Australia,10,40,,50,POINT (6170465 -7542726)
2013,Marzo,Australia,0,1,,1,POINT (7128047 -73181317)
2013,Marzo,Australia,0,2,,2,POINT (7819 -72453013)
2013,Marzo,Australia,2,1,,3,POINT (863337 -7735002)
2013,Marzo,Austria,4,2,,6,POINT (-4191162 -69941498)
2013,Marzo,Austria,9,5,,14,POINT (0.81488 -77356)
2013,Marzo,Austria,2,2,,4,POINT (10406342 -75527794)
2013,Marzo,Austria,6,14,,20,POINT (10446304 -75516486)
2013,Marzo,Austria,0,2,,2,POINT (10886686 -74776479)
2013,Marzo,Austria,1,1,,2,POINT (11247723 -74213989)
2013,Marzo,Austria,2,0,,2,POINT (11360029 -72129595)
2013,Marzo,Austria,2,3,,5,POINT (125862 -81702165)
2013,Marzo,Austria,1,0,,1,POINT (133387613 -81372937)
2013,Marzo,Austria,4,7,,11,POINT (3451668 -76532004)
2013,Marzo,Austria,90,227,,317,POINT (4697157 -74140516)
2013,Marzo,Austria,4,11,,15,POINT (6170465 -7542726)
2013,Marzo,Austria,1,3,,4,POINT (863337 -7735002)
2013,Marzo,Azerbaiyán,1,0,,1,POINT (4697157 -74140516)
2013,Marzo,Bahamas,0,1,,1,POINT (10446304 -75516486)
2013,Marzo,Bahamas,1,0,,1,POINT (10886686 -74776479)
2013,Marzo,Bahamas,2,3,,5,POINT (4697157 -74140516)
2013,Marzo,Bahamas,0,1,,1,POINT (6170465 -7542726)
2013,Marzo,Bangladesh,1,3,,4,POINT (4697157 -74140516)
2013,Marzo,Barbados,6,10,,16,POINT (4697157 -74140516)
2013,Marzo,República de Belarús,0,2,,2,POINT (4697157 -74140516)
2013,Marzo,Bélgica,1,3,,4,POINT (-4191162 -69941498)
2013,Marzo,Bélgica,12,10,,22,POINT (0.81488 -77356)
2013,Marzo,Bélgica,3,1,,4,POINT (10406342 -75527794)
2013,Marzo,Bélgica,2,7,,9,POINT (10446304 -75516486)
2013,Marzo,Bélgica,0,2,,2,POINT (10886686 -74776479)
2013,Marzo,Bélgica,2,0,,2,POINT (11360029 -72129595)
2013,Marzo,Bélgica,6,19,,25,POINT (3451668 -76532004)
2013,Marzo,Bélgica,105,265,,370,POINT (4697157 -74140516)
2013,Marzo,Bélgica,0,1,,1,POINT (4815189 -75736374)
2013,Marzo,Bélgica,7,8,,15,POINT (6170465 -7542726)
2013,Marzo,Bélgica,1,2,,3,POINT (7819 -72453013)
2013,Marzo,Bélgica,0,3,,3,POINT (863337 -7735002)
2013,Marzo,Belice,0,1,,1,POINT (10446304 -75516486)
2013,Marzo,Belice,0,1,,1,POINT (10886686 -74776479)
2013,Marzo,Belice,2,2,,4,POINT (3451668 -76532004)
2013,Marzo,Belice,2,7,,9,POINT (4697157 -74140516)
2013,Marzo,Belice,0,3,,3,POINT (6170465 -7542726)
2013,Marzo,Bermudas/Territorio Británico de Ultramar,2,0,,2,POINT (10446304 -75516486)
2013,Marzo,Bermudas/Territorio Británico de Ultramar,0,1,,1,POINT (3451668 -76532004)
2013,Marzo,Bermudas/Territorio Británico de Ultramar,1,0,,1,POINT (4697157 -74140516)
2013,Marzo,Bolivia,0,1,,1,POINT (-4191162 -69941498)
2013,Marzo,Bolivia,5,10,,15,POINT (0.81488 -77356)
2013,Marzo,Bolivia,6,2,,8,POINT (10406342 -75527794)
2013,Marzo,Bolivia,4,13,,17,POINT (10446304 -75516486)
2013,Marzo,Bolivia,4,40,,44,POINT (10886686 -74776479)
2013,Marzo,Bolivia,1,1,,2,POINT (125862 -81702165)
2013,Marzo,Bolivia,14,32,,46,POINT (3451668 -76532004)
2013,Marzo,Bolivia,242,387,,629,POINT (4697157 -74140516)
2013,Marzo,Bolivia,0,2,,2,POINT (4815189 -75736374)
2013,Marzo,Bolivia,8,40,,48,POINT (6170465 -7542726)
2013,Marzo,Bolivia,0,2,,2,POINT (6185536 -67484028)
2013,Marzo,Bolivia,1,0,,1,POINT (7128047 -73181317)
2013,Marzo,Bolivia,1,2,,3,POINT (7819 -72453013)
2013,Marzo,Bolivia,1,1,,2,POINT (7927233 -72508188)
2013,Marzo,Bolivia,1,0,,1,POINT (863337 -7735002)
2013,Marzo,Bosnia y Herzegovina,1,1,,2,POINT (4697157 -74140516)
2013,Marzo,Brasil,48,44,,92,POINT (-4191162 -69941498)
2013,Marzo,Brasil,6,9,,15,POINT (0.81488 -77356)
2013,Marzo,Brasil,16,14,,30,POINT (10406342 -75527794)
2013,Marzo,Brasil,247,180,,427,POINT (10446304 -75516486)
2013,Marzo,Brasil,11,13,,24,POINT (10886686 -74776479)
2013,Marzo,Brasil,12,13,,25,POINT (11360029 -72129595)
2013,Marzo,Brasil,42,26,,68,POINT (125862 -81702165)
2013,Marzo,Brasil,18,50,,68,POINT (3451668 -76532004)
2013,Marzo,Brasil,1721,3054,,4775,POINT (4697157 -74140516)
2013,Marzo,Brasil,0,4,,4,POINT (4815189 -75736374)
2013,Marzo,Brasil,29,102,,131,POINT (6170465 -7542726)
2013,Marzo,Brasil,0,3,,3,POINT (6185536 -67484028)
2013,Marzo,Brasil,1,0,,1,POINT (7128047 -73181317)
2013,Marzo,Brasil,7,20,,27,POINT (7819 -72453013)
2013,Marzo,Brasil,0,6,,6,POINT (7927233 -72508188)
2013,Marzo,Bulgaria,1,0,,1,POINT (0.81488 -77356)
2013,Marzo,Bulgaria,1,2,,3,POINT (11360029 -72129595)
2013,Marzo,Bulgaria,5,6,,11,POINT (4697157 -74140516)
2013,Marzo,Bulgaria,1,1,,2,POINT (6170465 -7542726)
2013,Marzo,Bután,0,1,,1,POINT (4697157 -74140516)
2013,Marzo,Islas Caimán/Territorio Británico de Ultramar,1,1,,2,POINT (10446304 -75516486)
2013,Marzo,Islas Caimán/Territorio Británico de Ultramar,0,16,,16,POINT (125862 -81702165)
2013,Marzo,Islas Caimán/Territorio Británico de Ultramar,0,1,,1,POINT (6170465 -7542726)
2013,Marzo,Camboya,0,1,,1,POINT (4697157 -74140516)
2013,Marzo,Camerún,0,1,,1,POINT (4697157 -74140516)
2013,Marzo,Canadá,3,5,,8,POINT (-4191162 -69941498)
2013,Marzo,Canadá,23,34,,57,POINT (0.81488 -77356)
2013,Marzo,Canadá,6,11,,17,POINT (10406342 -75527794)
2013,Marzo,Canadá,531,546,,1077,POINT (10446304 -75516486)
2013,Marzo,Canadá,7,15,,22,POINT (10886686 -74776479)
2013,Marzo,Canadá,1,1,,2,POINT (11247723 -74213989)
2013,Marzo,Canadá,2,5,,7,POINT (11360029 -72129595)
2013,Marzo,Canadá,374,325,,699,POINT (125862 -81702165)
2013,Marzo,Canadá,2,7,,9,POINT (133387613 -81372937)
2013,Marzo,Canadá,37,48,,85,POINT (3451668 -76532004)
2013,Marzo,Canadá,0,1,,1,POINT (445285 -75766353)
2013,Marzo,Canadá,797,1392,,2189,POINT (4697157 -74140516)
2013,Marzo,Canadá,1,5,,6,POINT (4815189 -75736374)
2013,Marzo,Canadá,46,133,,179,POINT (6170465 -7542726)
2013,Marzo,Canadá,0,2,,2,POINT (7128047 -73181317)
2013,Marzo,Canadá,2,9,,11,POINT (7819 -72453013)
2013,Marzo,Canadá,0,2,,2,POINT (7927233 -72508188)
2013,Marzo,Canadá,3,11,,14,POINT (863337 -7735002)
2013,Marzo,España,4,18,,22,POINT (0.81488 -77356)
2013,Marzo,España,3,5,,8,POINT (10406342 -75527794)
2013,Marzo,España,3,10,,13,POINT (10446304 -75516486)
2013,Marzo,España,2,5,,7,POINT (10886686 -74776479)
2013,Marzo,España,0,1,,1,POINT (125862 -81702165)
2013,Marzo,España,17,61,,78,POINT (3451668 -76532004)
2013,Marzo,España,0,1,,1,POINT (445285 -75766353)
2013,Marzo,España,139,360,,499,POINT (4697157 -74140516)
2013,Marzo,España,0,6,,6,POINT (4815189 -75736374)
2013,Marzo,España,50,124,,174,POINT (6170465 -7542726)
2013,Marzo,España,1,1,,2,POINT (7819 -72453013)
2013,Marzo,República Democrática del Congo,0,1,,1,POINT (4697157 -74140516)
2013,Marzo,República de Corea,1,2,,3,POINT (-4191162 -69941498)
2013,Marzo,República de Corea,5,7,,12,POINT (0.81488 -77356)
2013,Marzo,República de Corea,0,1,,1,POINT (10406342 -75527794)
2013,Marzo,República de Corea,4,2,,6,POINT (10446304 -75516486)
2013,Marzo,República de Corea,1,1,,2,POINT (11360029 -72129595)
2013,Marzo,República de Corea,6,9,,15,POINT (3451668 -76532004)
2013,Marzo,República de Corea,133,474,,607,POINT (4697157 -74140516)
2013,Marzo,República de Corea,4,21,,25,POINT (6170465 -7542726)
2013,Marzo,República de Corea,1,6,,7,POINT (7819 -72453013)
2013,Marzo,República de Corea,0,1,,1,POINT (863337 -7735002)
2013,Marzo,Costa Rica,1,0,,1,POINT (-4191162 -69941498)
2013,Marzo,Costa Rica,4,3,,7,POINT (0.81488 -77356)
2013,Marzo,Costa Rica,2,11,,13,POINT (10406342 -75527794)
2013,Marzo,Costa Rica,53,58,,111,POINT (10446304 -75516486)
2013,Marzo,Costa Rica,9,22,,31,POINT (10886686 -74776479)
2013,Marzo,Costa Rica,1,0,,1,POINT (11360029 -72129595)
2013,Marzo,Costa Rica,262,211,,473,POINT (125862 -81702165)
2013,Marzo,Costa Rica,27,59,,86,POINT (3451668 -76532004)
2013,Marzo,Costa Rica,491,782,,1273,POINT (4697157 -74140516)
2013,Marzo,Costa Rica,8,9,,17,POINT (4815189 -75736374)
2013,Marzo,Costa Rica,59,106,,165,POINT (6170465 -7542726)
2013,Marzo,Costa Rica,0,1,,1,POINT (6222552 -77401154)
2013,Marzo,Costa Rica,0,3,,3,POINT (7128047 -73181317)
2013,Marzo,Costa Rica,2,3,,5,POINT (7819 -72453013)
2013,Marzo,Costa Rica,1,3,,4,POINT (7927233 -72508188)
2013,Marzo,Costa Rica,0,1,,1,POINT (863337 -7735002)
2013,Marzo,Croacia,0,2,,2,POINT (0.81488 -77356)
2013,Marzo,Croacia,0,2,,2,POINT (10406342 -75527794)
2013,Marzo,Croacia,0,1,,1,POINT (10446304 -75516486)
2013,Marzo,Croacia,0,1,,1,POINT (11360029 -72129595)
2013,Marzo,Croacia,0,3,,3,POINT (3884426 -77061029)
2013,Marzo,Croacia,7,20,,27,POINT (4697157 -74140516)
2013,Marzo,Croacia,0,1,,1,POINT (4815189 -75736374)
2013,Marzo,Croacia,1,0,,1,POINT (6170465 -7542726)
2013,Marzo,Croacia,0,2,,2,POINT (9402597 -75681642)
2013,Marzo,Cuba,2,8,,10,POINT (0.81488 -77356)
2013,Marzo,Cuba,6,9,,15,POINT (10446304 -75516486)
2013,Marzo,Cuba,2,14,,16,POINT (10886686 -74776479)
2013,Marzo,Cuba,1,0,,1,POINT (11360029 -72129595)
2013,Marzo,Cuba,0,1,,1,POINT (125862 -81702165)
2013,Marzo,Cuba,8,17,,25,POINT (3451668 -76532004)
2013,Marzo,Cuba,86,133,,219,POINT (4697157 -74140516)
2013,Marzo,Cuba,14,15,,29,POINT (6170465 -7542726)
2013,Marzo,Cuba,1,0,,1,POINT (7128047 -73181317)
2013,Marzo,Cuba,1,0,,1,POINT (7819 -72453013)
2013,Marzo,Cuba,0,2,,2,POINT (7927233 -72508188)
2013,Marzo,Curazao,0,3,,3,POINT (4697157 -74140516)
2013,Marzo,Curazao,10,9,,19,POINT (6170465 -7542726)
2013,Marzo,República Checa,0,3,,3,POINT (-4191162 -69941498)
2013,Marzo,República Checa,1,2,,3,POINT (10446304 -75516486)
2013,Marzo,República Checa,0,2,,2,POINT (10886686 -74776479)
2013,Marzo,República Checa,0,1,,1,POINT (11360029 -72129595)
2013,Marzo,República Checa,1,2,,3,POINT (3451668 -76532004)
2013,Marzo,República Checa,33,30,,63,POINT (4697157 -74140516)
2013,Marzo,República Checa,1,2,,3,POINT (6170465 -7542726)
2013,Marzo,República Checa,1,3,,4,POINT (7819 -72453013)
2013,Marzo,Chile,2,3,,5,POINT (-4191162 -69941498)
2013,Marzo,Chile,25,40,,65,POINT (0.81488 -77356)
2013,Marzo,Chile,32,20,,52,POINT (10406342 -75527794)
2013,Marzo,Chile,167,167,,334,POINT (10446304 -75516486)
2013,Marzo,Chile,10,20,,30,POINT (10886686 -74776479)
2013,Marzo,Chile,9,14,,23,POINT (11360029 -72129595)
2013,Marzo,Chile,106,67,,173,POINT (125862 -81702165)
2013,Marzo,Chile,35,59,,94,POINT (3451668 -76532004)
2013,Marzo,Chile,0,2,,2,POINT (3884426 -77061029)
2013,Marzo,Chile,2044,3163,,5207,POINT (4697157 -74140516)
2013,Marzo,Chile,1,5,,6,POINT (4815189 -75736374)
2013,Marzo,Chile,80,149,,229,POINT (6170465 -7542726)
2013,Marzo,Chile,0,3,,3,POINT (6185536 -67484028)
2013,Marzo,Chile,1,1,,2,POINT (7128047 -73181317)
2013,Marzo,Chile,4,14,,18,POINT (7819 -72453013)
2013,Marzo,Chile,1,2,,3,POINT (7927233 -72508188)
2013,Marzo,Chile,2,3,,5,POINT (863337 -7735002)
2013,Marzo,China,1,4,,5,POINT (0.81488 -77356)
2013,Marzo,China,7,7,,14,POINT (10446304 -75516486)
2013,Marzo,China,4,7,,11,POINT (10886686 -74776479)
2013,Marzo,China,1,7,,8,POINT (10970933 -74765343)
2013,Marzo,China,2,9,,11,POINT (3451668 -76532004)
2013,Marzo,China,167,498,,665,POINT (4697157 -74140516)
2013,Marzo,China,3,10,,13,POINT (6170465 -7542726)
2013,Marzo,China,1,3,,4,POINT (7819 -72453013)
2013,Marzo,Taiwán,3,1,,4,POINT (0.81488 -77356)
2013,Marzo,Taiwán,0,2,,2,POINT (10446304 -75516486)
2013,Marzo,Taiwán,0,3,,3,POINT (10886686 -74776479)
2013,Marzo,Taiwán,3,4,,7,POINT (3451668 -76532004)
2013,Marzo,Taiwán,73,104,,177,POINT (4697157 -74140516)
2013,Marzo,Taiwán,2,0,,2,POINT (4815189 -75736374)
2013,Marzo,Taiwán,4,9,,13,POINT (6170465 -7542726)
2013,Marzo,Taiwán,2,4,,6,POINT (7819 -72453013)
2013,Marzo,Chipre,0,1,,1,POINT (0.81488 -77356)
2013,Marzo,Chipre,1,1,,2,POINT (4697157 -74140516)
2013,Marzo,Dinamarca,1,4,,5,POINT (-4191162 -69941498)
2013,Marzo,Dinamarca,9,7,,16,POINT (0.81488 -77356)
2013,Marzo,Dinamarca,1,0,,1,POINT (10406342 -75527794)
2013,Marzo,Dinamarca,7,12,,19,POINT (10446304 -75516486)
2013,Marzo,Dinamarca,0,2,,2,POINT (10886686 -74776479)
2013,Marzo,Dinamarca,2,4,,6,POINT (11360029 -72129595)
2013,Marzo,Dinamarca,1,4,,5,POINT (3451668 -76532004)
2013,Marzo,Dinamarca,61,130,,191,POINT (4697157 -74140516)
2013,Marzo,Dinamarca,0,1,,1,POINT (4815189 -75736374)
2013,Marzo,Dinamarca,3,12,,15,POINT (6170465 -7542726)
2013,Marzo,Dinamarca,0,4,,4,POINT (7819 -72453013)
2013,Marzo,Dinamarca,0,1,,1,POINT (7927233 -72508188)
2013,Marzo,Dominica,0,1,,1,POINT (10446304 -75516486)
2013,Marzo,Dominica,1,1,,2,POINT (4697157 -74140516)
2013,Marzo,Ecuador,0,1,,1,POINT (-4191162 -69941498)
2013,Marzo,Ecuador,1174,1595,,2769,POINT (0.81488 -77356)
2013,Marzo,Ecuador,4,29,,33,POINT (1800143 -78802679)
2013,Marzo,Ecuador,7,47,,54,POINT (10406342 -75527794)
2013,Marzo,Ecuador,10,17,,27,POINT (10446304 -75516486)
2013,Marzo,Ecuador,2,14,,16,POINT (10886686 -74776479)
2013,Marzo,Ecuador,12,12,,24,POINT (11360029 -72129595)
2013,Marzo,Ecuador,11,10,,21,POINT (125862 -81702165)
2013,Marzo,Ecuador,318,350,,668,POINT (3451668 -76532004)
2013,Marzo,Ecuador,0,3,,3,POINT (3884426 -77061029)
2013,Marzo,Ecuador,2,0,,2,POINT (445285 -75766353)
2013,Marzo,Ecuador,1538,2483,,4021,POINT (4697157 -74140516)
2013,Marzo,Ecuador,0,6,,6,POINT (4815189 -75736374)
2013,Marzo,Ecuador,295,334,,629,POINT (6170465 -7542726)
2013,Marzo,Ecuador,0,1,,1,POINT (6185536 -67484028)
2013,Marzo,Ecuador,2,9,,11,POINT (7128047 -73181317)
2013,Marzo,Ecuador,76,122,,198,POINT (7819 -72453013)
2013,Marzo,Ecuador,5,3,,8,POINT (7927233 -72508188)
2013,Marzo,Ecuador,0,5,,5,POINT (9402597 -75681642)
2013,Marzo,Egipto,0,12,,12,POINT (0.81488 -77356)
2013,Marzo,Egipto,0,1,,1,POINT (10886686 -74776479)
2013,Marzo,Egipto,1,19,,20,POINT (4697157 -74140516)
2013,Marzo,El Salvador,1,1,,2,POINT (0.81488 -77356)
2013,Marzo,El Salvador,18,18,,36,POINT (10446304 -75516486)
2013,Marzo,El Salvador,1,1,,2,POINT (10886686 -74776479)
2013,Marzo,El Salvador,37,46,,83,POINT (3451668 -76532004)
2013,Marzo,El Salvador,350,599,,949,POINT (4697157 -74140516)
2013,Marzo,El Salvador,2,0,,2,POINT (4815189 -75736374)
2013,Marzo,El Salvador,79,121,,200,POINT (6170465 -7542726)
2013,Marzo,El Salvador,1,1,,2,POINT (7819 -72453013)
2013,Marzo,El Salvador,1,0,,1,POINT (7927233 -72508188)
2013,Marzo,Emiratos Árabes,1,0,,1,POINT (10446304 -75516486)
2013,Marzo,España,3,1,,4,POINT (-4191162 -69941498)
2013,Marzo,España,27,40,,67,POINT (0.81488 -77356)
2013,Marzo,España,17,24,,41,POINT (10406342 -75527794)
2013,Marzo,España,51,110,,161,POINT (10446304 -75516486)
2013,Marzo,España,4,11,,15,POINT (10886686 -74776479)
2013,Marzo,España,0,1,,1,POINT (10970933 -74765343)
2013,Marzo,España,0,1,,1,POINT (11247723 -74213989)
2013,Marzo,España,15,20,,35,POINT (11360029 -72129595)
2013,Marzo,España,2,4,,6,POINT (125862 -81702165)
2013,Marzo,España,149,307,,456,POINT (3451668 -76532004)
2013,Marzo,España,1745,4005,,5750,POINT (4697157 -74140516)
2013,Marzo,España,1,7,,8,POINT (4815189 -75736374)
2013,Marzo,España,69,176,,245,POINT (6170465 -7542726)
2013,Marzo,España,0,1,,1,POINT (6185536 -67484028)
2013,Marzo,España,1,0,,1,POINT (7088729 -70740253)
2013,Marzo,España,1,5,,6,POINT (7128047 -73181317)
2013,Marzo,España,22,46,,68,POINT (7819 -72453013)
2013,Marzo,España,0,3,,3,POINT (7927233 -72508188)
2013,Marzo,España,6,8,,14,POINT (863337 -7735002)
2013,Marzo,Eslovaquia,0,1,,1,POINT (-4191162 -69941498)
2013,Marzo,Eslovaquia,0,1,,1,POINT (0.81488 -77356)
2013,Marzo,Eslovaquia,1,1,,2,POINT (10886686 -74776479)
2013,Marzo,Eslovaquia,0,1,,1,POINT (11360029 -72129595)
2013,Marzo,Eslovaquia,2,0,,2,POINT (133387613 -81372937)
2013,Marzo,Eslovaquia,0,2,,2,POINT (3451668 -76532004)
2013,Marzo,Eslovaquia,15,26,,41,POINT (4697157 -74140516)
2013,Marzo,Eslovaquia,0,2,,2,POINT (6170465 -7542726)
2013,Marzo,Eslovaquia,1,3,,4,POINT (7819 -72453013)
2013,Marzo,Eslovaquia,1,0,,1,POINT (863337 -7735002)
2013,Marzo,Eslovenia,0,3,,3,POINT (0.81488 -77356)
2013,Marzo,Eslovenia,0,1,,1,POINT (10406342 -75527794)
2013,Marzo,Eslovenia,3,4,,7,POINT (11360029 -72129595)
2013,Marzo,Eslovenia,9,29,,38,POINT (4697157 -74140516)
2013,Marzo,Estados Unidos de América,16,19,,35,POINT (-4191162 -69941498)
2013,Marzo,Estados Unidos de América,41,87,,128,POINT (0.81488 -77356)
2013,Marzo,Estados Unidos de América,1,0,,1,POINT (1800143 -78802679)
2013,Marzo,Estados Unidos de América,19,41,,60,POINT (10406342 -75527794)
2013,Marzo,Estados Unidos de América,1343,2156,,3499,POINT (10446304 -75516486)
2013,Marzo,Estados Unidos de América,322,484,,806,POINT (10886686 -74776479)
2013,Marzo,Estados Unidos de América,0,2,,2,POINT (10970933 -74765343)
2013,Marzo,Estados Unidos de América,5,9,,14,POINT (11247723 -74213989)
2013,Marzo,Estados Unidos de América,8,16,,24,POINT (11360029 -72129595)
2013,Marzo,Estados Unidos de América,0,1,,1,POINT (1152863 -72919186)
2013,Marzo,Estados Unidos de América,30,25,,55,POINT (125862 -81702165)
2013,Marzo,Estados Unidos de América,15,23,,38,POINT (133387613 -81372937)
2013,Marzo,Estados Unidos de América,722,1143,,1865,POINT (3451668 -76532004)
2013,Marzo,Estados Unidos de América,0,2,,2,POINT (3884426 -77061029)
2013,Marzo,Estados Unidos de América,104,139,,243,POINT (445285 -75766353)
2013,Marzo,Estados Unidos de América,5797,10789,,16586,POINT (4697157 -74140516)
2013,Marzo,Estados Unidos de América,80,110,,190,POINT (4815189 -75736374)
2013,Marzo,Estados Unidos de América,965,2212,,3177,POINT (6170465 -7542726)
2013,Marzo,Estados Unidos de América,0,2,,2,POINT (6185536 -67484028)
2013,Marzo,Estados Unidos de América,1,4,,5,POINT (7088729 -70740253)
2013,Marzo,Estados Unidos de América,12,26,,38,POINT (7128047 -73181317)
2013,Marzo,Estados Unidos de América,21,51,,72,POINT (7819 -72453013)
2013,Marzo,Estados Unidos de América,16,12,,28,POINT (7927233 -72508188)
2013,Marzo,Estados Unidos de América,7,15,,22,POINT (863337 -7735002)
2013,Marzo,Estonia,14,13,,27,POINT (4697157 -74140516)
2013,Marzo,Etiopia,2,3,,5,POINT (4697157 -74140516)
2013,Marzo,Islas Fiji,2,2,,4,POINT (10446304 -75516486)
2013,Marzo,Filipinas,0,2,,2,POINT (0.81488 -77356)
2013,Marzo,Filipinas,1,24,,25,POINT (10406342 -75527794)
2013,Marzo,Filipinas,3,13,,16,POINT (10446304 -75516486)
2013,Marzo,Filipinas,0,27,,27,POINT (10970933 -74765343)
2013,Marzo,Filipinas,0,1,,1,POINT (11247723 -74213989)
2013,Marzo,Filipinas,1,4,,5,POINT (3451668 -76532004)
2013,Marzo,Filipinas,0,18,,18,POINT (3884426 -77061029)
2013,Marzo,Filipinas,25,73,,98,POINT (4697157 -74140516)
2013,Marzo,Filipinas,1,1,,2,POINT (6170465 -7542726)
2013,Marzo,Filipinas,0,1,,1,POINT (7128047 -73181317)
2013,Marzo,Finlandia,4,5,,9,POINT (0.81488 -77356)
2013,Marzo,Finlandia,0,1,,1,POINT (10406342 -75527794)
2013,Marzo,Finlandia,0,8,,8,POINT (10446304 -75516486)
2013,Marzo,Finlandia,3,4,,7,POINT (3451668 -76532004)
2013,Marzo,Finlandia,37,54,,91,POINT (4697157 -74140516)
2013,Marzo,Finlandia,2,2,,4,POINT (6170465 -7542726)
2013,Marzo,Finlandia,1,1,,2,POINT (863337 -7735002)
2013,Marzo,Francia,10,17,,27,POINT (-4191162 -69941498)
2013,Marzo,Francia,34,61,,95,POINT (0.81488 -77356)
2013,Marzo,Francia,0,1,,1,POINT (1800143 -78802679)
2013,Marzo,Francia,11,27,,38,POINT (10406342 -75527794)
2013,Marzo,Francia,41,60,,101,POINT (10446304 -75516486)
2013,Marzo,Francia,5,10,,15,POINT (10886686 -74776479)
2013,Marzo,Francia,3,2,,5,POINT (11247723 -74213989)
2013,Marzo,Francia,14,14,,28,POINT (11360029 -72129595)
2013,Marzo,Francia,0,1,,1,POINT (1152863 -72919186)
2013,Marzo,Francia,2,4,,6,POINT (125862 -81702165)
2013,Marzo,Francia,3,2,,5,POINT (133387613 -81372937)
2013,Marzo,Francia,34,59,,93,POINT (3451668 -76532004)
2013,Marzo,Francia,870,1701,,2571,POINT (4697157 -74140516)
2013,Marzo,Francia,1,5,,6,POINT (4815189 -75736374)
2013,Marzo,Francia,50,79,,129,POINT (6170465 -7542726)
2013,Marzo,Francia,3,3,,6,POINT (7128047 -73181317)
2013,Marzo,Francia,7,11,,18,POINT (7819 -72453013)
2013,Marzo,Francia,0,2,,2,POINT (7927233 -72508188)
2013,Marzo,Francia,16,20,,36,POINT (863337 -7735002)
2013,Marzo,Gabón,1,1,,2,POINT (4697157 -74140516)
2013,Marzo,Georgia,2,0,,2,POINT (0.81488 -77356)
2013,Marzo,Georgia,3,3,,6,POINT (4697157 -74140516)
2013,Marzo,Ghana,0,1,,1,POINT (3451668 -76532004)
2013,Marzo,Ghana,2,3,,5,POINT (4697157 -74140516)
2013,Marzo,Grecia,1,2,,3,POINT (-4191162 -69941498)
2013,Marzo,Grecia,1,0,,1,POINT (0.81488 -77356)
2013,Marzo,Grecia,1,6,,7,POINT (10406342 -75527794)
2013,Marzo,Grecia,1,1,,2,POINT (10446304 -75516486)
2013,Marzo,Grecia,1,1,,2,POINT (10886686 -74776479)
2013,Marzo,Grecia,0,1,,1,POINT (11247723 -74213989)
2013,Marzo,Grecia,1,0,,1,POINT (11360029 -72129595)
2013,Marzo,Grecia,0,1,,1,POINT (125862 -81702165)
2013,Marzo,Grecia,2,2,,4,POINT (3451668 -76532004)
2013,Marzo,Grecia,17,46,,63,POINT (4697157 -74140516)
2013,Marzo,Grecia,2,2,,4,POINT (6170465 -7542726)
2013,Marzo,Grecia,0,2,,2,POINT (7819 -72453013)
2013,Marzo,Grecia,0,3,,3,POINT (7927233 -72508188)
2013,Marzo,Guatemala,0,8,,8,POINT (0.81488 -77356)
2013,Marzo,Guatemala,1,1,,2,POINT (10406342 -75527794)
2013,Marzo,Guatemala,42,57,,99,POINT (10446304 -75516486)
2013,Marzo,Guatemala,1,19,,20,POINT (10886686 -74776479)
2013,Marzo,Guatemala,0,1,,1,POINT (11360029 -72129595)
2013,Marzo,Guatemala,21,47,,68,POINT (3451668 -76532004)
2013,Marzo,Guatemala,3,0,,3,POINT (445285 -75766353)
2013,Marzo,Guatemala,158,375,,533,POINT (4697157 -74140516)
2013,Marzo,Guatemala,9,8,,17,POINT (4815189 -75736374)
2013,Marzo,Guatemala,30,106,,136,POINT (6170465 -7542726)
2013,Marzo,Guatemala,0,1,,1,POINT (6185536 -67484028)
2013,Marzo,Guatemala,2,4,,6,POINT (7819 -72453013)
2013,Marzo,Guatemala,1,0,,1,POINT (863337 -7735002)
2013,Marzo,Guyana,0,2,,2,POINT (10446304 -75516486)
2013,Marzo,Guyana,3,2,,5,POINT (10886686 -74776479)
2013,Marzo,Guyana,0,1,,1,POINT (11360029 -72129595)
2013,Marzo,Guyana,0,1,,1,POINT (3451668 -76532004)
2013,Marzo,Guyana,6,15,,21,POINT (4697157 -74140516)
2013,Marzo,Guyana,1,1,,2,POINT (6170465 -7542726)
2013,Marzo,Guinea,0,1,,1,POINT (6170465 -7542726)
2013,Marzo,Guayana Francesa/Departamento de Ultramar Francés,0,1,,1,POINT (4697157 -74140516)
2013,Marzo,Haití,1,1,,2,POINT (10446304 -75516486)
2013,Marzo,Haití,1,2,,3,POINT (3451668 -76532004)
2013,Marzo,Haití,2,11,,13,POINT (4697157 -74140516)
2013,Marzo,Haití,1,2,,3,POINT (6170465 -7542726)
2013,Marzo,Honduras,1,0,,1,POINT (0.81488 -77356)
2013,Marzo,Honduras,0,3,,3,POINT (10406342 -75527794)
2013,Marzo,Honduras,22,26,,48,POINT (10446304 -75516486)
2013,Marzo,Honduras,3,5,,8,POINT (10886686 -74776479)
2013,Marzo,Honduras,0,1,,1,POINT (10970933 -74765343)
2013,Marzo,Honduras,0,1,,1,POINT (125744111 -81703935)
2013,Marzo,Honduras,0,1,,1,POINT (125862 -81702165)
2013,Marzo,Honduras,12,46,,58,POINT (3451668 -76532004)
2013,Marzo,Honduras,120,131,,251,POINT (4697157 -74140516)
2013,Marzo,Honduras,20,25,,45,POINT (6170465 -7542726)
2013,Marzo,Honduras,2,0,,2,POINT (7819 -72453013)
2013,Marzo,Hungría,1,1,,2,POINT (0.81488 -77356)
2013,Marzo,Hungría,1,1,,2,POINT (10446304 -75516486)
2013,Marzo,Hungría,0,1,,1,POINT (10886686 -74776479)
2013,Marzo,Hungría,2,1,,3,POINT (3451668 -76532004)
2013,Marzo,Hungría,39,83,,122,POINT (4697157 -74140516)
2013,Marzo,Hungría,1,3,,4,POINT (6170465 -7542726)
2013,Marzo,Hungría,1,1,,2,POINT (7128047 -73181317)
2013,Marzo,Hungría,1,1,,2,POINT (7819 -72453013)
2013,Marzo,India,7,0,,7,POINT (0.81488 -77356)
2013,Marzo,India,0,4,,4,POINT (10446304 -75516486)
2013,Marzo,India,0,1,,1,POINT (10886686 -74776479)
2013,Marzo,India,0,1,,1,POINT (11360029 -72129595)
2013,Marzo,India,1,21,,22,POINT (3451668 -76532004)
2013,Marzo,India,0,6,,6,POINT (3884426 -77061029)
2013,Marzo,India,30,243,,273,POINT (4697157 -74140516)
2013,Marzo,India,2,22,,24,POINT (6170465 -7542726)
2013,Marzo,Indonesia,1,0,,1,POINT (10886686 -74776479)
2013,Marzo,Indonesia,0,4,,4,POINT (10970933 -74765343)
2013,Marzo,Indonesia,0,4,,4,POINT (3451668 -76532004)
2013,Marzo,Indonesia,9,8,,17,POINT (4697157 -74140516)
2013,Marzo,Indonesia,0,1,,1,POINT (6170465 -7542726)
2013,Marzo,Indonesia,0,2,,2,POINT (7819 -72453013)
2013,Marzo,Iraq,0,1,,1,POINT (10446304 -75516486)
2013,Marzo,Iraq,0,1,,1,POINT (4697157 -74140516)
2013,Marzo,Irán,0,1,,1,POINT (10446304 -75516486)
2013,Marzo,Irán,0,1,,1,POINT (3451668 -76532004)
2013,Marzo,Irán,4,35,,39,POINT (4697157 -74140516)
2013,Marzo,República de Irlanda,6,9,,15,POINT (0.81488 -77356)
2013,Marzo,República de Irlanda,0,5,,5,POINT (10406342 -75527794)
2013,Marzo,República de Irlanda,2,11,,13,POINT (10446304 -75516486)
2013,Marzo,República de Irlanda,2,0,,2,POINT (11360029 -72129595)
2013,Marzo,República de Irlanda,1,5,,6,POINT (3451668 -76532004)
2013,Marzo,República de Irlanda,46,110,,156,POINT (4697157 -74140516)
2013,Marzo,República de Irlanda,0,1,,1,POINT (4815189 -75736374)
2013,Marzo,República de Irlanda,6,8,,14,POINT (6170465 -7542726)
2013,Marzo,República de Irlanda,0,1,,1,POINT (7819 -72453013)
2013,Marzo,República de Irlanda,1,0,,1,POINT (863337 -7735002)
2013,Marzo,Islandia,1,0,,1,POINT (3451668 -76532004)
2013,Marzo,Isla de Man,9,16,,25,POINT (0.81488 -77356)
2013,Marzo,Isla de Man,5,7,,12,POINT (10446304 -75516486)
2013,Marzo,Isla de Man,4,6,,10,POINT (10886686 -74776479)
2013,Marzo,Isla de Man,2,14,,16,POINT (3451668 -76532004)
2013,Marzo,Isla de Man,48,136,,184,POINT (4697157 -74140516)
2013,Marzo,Isla de Man,1,0,,1,POINT (4815189 -75736374)
2013,Marzo,Isla de Man,9,22,,31,POINT (6170465 -7542726)
2013,Marzo,Isla Johnston,0,2,,2,POINT (4697157 -74140516)
2013,Marzo,Israel,0,6,,6,POINT (-4191162 -69941498)
2013,Marzo,Israel,3,4,,7,POINT (0.81488 -77356)
2013,Marzo,Israel,1,5,,6,POINT (10406342 -75527794)
2013,Marzo,Israel,8,25,,33,POINT (10446304 -75516486)
2013,Marzo,Israel,3,4,,7,POINT (3451668 -76532004)
2013,Marzo,Israel,71,388,,459,POINT (4697157 -74140516)
2013,Marzo,Israel,0,1,,1,POINT (4815189 -75736374)
2013,Marzo,Israel,9,47,,56,POINT (6170465 -7542726)
2013,Marzo,Israel,0,2,,2,POINT (863337 -7735002)
2013,Marzo,Islas Aland/Provincia de Finlandia,1,4,,5,POINT (4697157 -74140516)
2013,Marzo,Italia,0,4,,4,POINT (-4191162 -69941498)
2013,Marzo,Italia,8,16,,24,POINT (0.81488 -77356)
2013,Marzo,Italia,1,12,,13,POINT (10406342 -75527794)
2013,Marzo,Italia,36,73,,109,POINT (10446304 -75516486)
2013,Marzo,Italia,2,11,,13,POINT (10886686 -74776479)
2013,Marzo,Italia,0,1,,1,POINT (10970933 -74765343)
2013,Marzo,Italia,0,2,,2,POINT (11247723 -74213989)
2013,Marzo,Italia,4,9,,13,POINT (11360029 -72129595)
2013,Marzo,Italia,5,3,,8,POINT (125862 -81702165)
2013,Marzo,Italia,1,0,,1,POINT (133387613 -81372937)
2013,Marzo,Italia,16,75,,91,POINT (3451668 -76532004)
2013,Marzo,Italia,0,1,,1,POINT (445285 -75766353)
2013,Marzo,Italia,418,1358,,1776,POINT (4697157 -74140516)
2013,Marzo,Italia,1,4,,5,POINT (4815189 -75736374)
2013,Marzo,Italia,17,83,,100,POINT (6170465 -7542726)
2013,Marzo,Italia,1,0,,1,POINT (7128047 -73181317)
2013,Marzo,Italia,1,15,,16,POINT (7819 -72453013)
2013,Marzo,Italia,2,3,,5,POINT (7927233 -72508188)
2013,Marzo,Italia,2,6,,8,POINT (863337 -7735002)
2013,Marzo,Jamaica,0,1,,1,POINT (10406342 -75527794)
2013,Marzo,Jamaica,5,9,,14,POINT (10446304 -75516486)
2013,Marzo,Jamaica,0,3,,3,POINT (10886686 -74776479)
2013,Marzo,Jamaica,0,2,,2,POINT (125862 -81702165)
2013,Marzo,Jamaica,1,2,,3,POINT (3451668 -76532004)
2013,Marzo,Jamaica,0,1,,1,POINT (445285 -75766353)
2013,Marzo,Jamaica,16,19,,35,POINT (4697157 -74140516)
2013,Marzo,Jamaica,1,4,,5,POINT (6170465 -7542726)
2013,Marzo,Islas Salomón,1,0,,1,POINT (4697157 -74140516)
2013,Marzo,Japón,0,2,,2,POINT (-4191162 -69941498)
2013,Marzo,Japón,9,21,,30,POINT (0.81488 -77356)
2013,Marzo,Japón,0,1,,1,POINT (10406342 -75527794)
2013,Marzo,Japón,5,9,,14,POINT (10446304 -75516486)
2013,Marzo,Japón,0,2,,2,POINT (10886686 -74776479)
2013,Marzo,Japón,1,2,,3,POINT (11360029 -72129595)
2013,Marzo,Japón,0,1,,1,POINT (125862 -81702165)
2013,Marzo,Japón,12,21,,33,POINT (3451668 -76532004)
2013,Marzo,Japón,138,441,,579,POINT (4697157 -74140516)
2013,Marzo,Japón,6,26,,32,POINT (6170465 -7542726)
2013,Marzo,Japón,4,7,,11,POINT (7819 -72453013)
2013,Marzo,Japón,1,3,,4,POINT (863337 -7735002)
2013,Marzo,Jordania,1,0,,1,POINT (125862 -81702165)
2013,Marzo,Jordania,0,2,,2,POINT (4697157 -74140516)
2013,Marzo,Kazajistán,0,2,,2,POINT (10446304 -75516486)
2013,Marzo,Kazajistán,2,6,,8,POINT (4697157 -74140516)
2013,Marzo,Kenia,1,0,,1,POINT (3451668 -76532004)
2013,Marzo,Kenia,3,7,,10,POINT (4697157 -74140516)
2013,Marzo,Lesoto,0,2,,2,POINT (4697157 -74140516)
2013,Marzo,Letonia,0,1,,1,POINT (1800143 -78802679)
2013,Marzo,Letonia,0,1,,1,POINT (10406342 -75527794)
2013,Marzo,Letonia,4,5,,9,POINT (4697157 -74140516)
2013,Marzo,Letonia,0,1,,1,POINT (6170465 -7542726)
2013,Marzo,Lituania,2,2,,4,POINT (0.81488 -77356)
2013,Marzo,Lituania,0,1,,1,POINT (10406342 -75527794)
2013,Marzo,Lituania,1,2,,3,POINT (10446304 -75516486)
2013,Marzo,Lituania,13,9,,22,POINT (4697157 -74140516)
2013,Marzo,Lituania,0,1,,1,POINT (7819 -72453013)
2013,Marzo,Lituania,1,0,,1,POINT (7927233 -72508188)
2013,Marzo,Líbano,0,1,,1,POINT (0.81488 -77356)
2013,Marzo,Líbano,0,1,,1,POINT (10886686 -74776479)
2013,Marzo,Líbano,4,4,,8,POINT (11360029 -72129595)
2013,Marzo,Líbano,0,1,,1,POINT (3451668 -76532004)
2013,Marzo,Líbano,8,25,,33,POINT (4697157 -74140516)
2013,Marzo,Líbano,1,2,,3,POINT (6170465 -7542726)
2013,Marzo,Liechtenstein,0,1,,1,POINT (4697157 -74140516)
2013,Marzo,Luxemburgo,3,0,,3,POINT (0.81488 -77356)
2013,Marzo,Luxemburgo,0,1,,1,POINT (10446304 -75516486)
2013,Marzo,Luxemburgo,8,15,,23,POINT (4697157 -74140516)
2013,Marzo,Luxemburgo,0,1,,1,POINT (6170465 -7542726)
2013,Marzo,Macedonia,0,1,,1,POINT (4697157 -74140516)
2013,Marzo,Malasia,1,0,,1,POINT (10446304 -75516486)
2013,Marzo,Malasia,0,1,,1,POINT (11360029 -72129595)
2013,Marzo,Malasia,13,23,,36,POINT (4697157 -74140516)
2013,Marzo,Malasia,0,2,,2,POINT (6170465 -7542726)
2013,Marzo,Malasia,0,1,,1,POINT (7927233 -72508188)
2013,Marzo,Malasia,1,1,,2,POINT (863337 -7735002)
2013,Marzo,Malí,1,2,,3,POINT (4697157 -74140516)
2013,Marzo,Malta,1,6,,7,POINT (4697157 -74140516)
2013,Marzo,Marruecos,0,1,,1,POINT (3451668 -76532004)
2013,Marzo,Marruecos,3,7,,10,POINT (4697157 -74140516)
2013,Marzo,Mauricio,0,1,,1,POINT (6170465 -7542726)
2013,Marzo,México,4,1,,5,POINT (-4191162 -69941498)
2013,Marzo,México,10,11,,21,POINT (0.81488 -77356)
2013,Marzo,México,17,15,,32,POINT (10406342 -75527794)
2013,Marzo,México,136,208,,344,POINT (10446304 -75516486)
2013,Marzo,México,21,40,,61,POINT (10886686 -74776479)
2013,Marzo,México,0,1,,1,POINT (10970933 -74765343)
2013,Marzo,México,3,8,,11,POINT (11360029 -72129595)
2013,Marzo,México,2,4,,6,POINT (125862 -81702165)
2013,Marzo,México,0,1,,1,POINT (133387613 -81372937)
2013,Marzo,México,57,128,,185,POINT (3451668 -76532004)
2013,Marzo,México,0,2,,2,POINT (445285 -75766353)
2013,Marzo,México,1791,3954,,5745,POINT (4697157 -74140516)
2013,Marzo,México,4,15,,19,POINT (4815189 -75736374)
2013,Marzo,México,92,315,,407,POINT (6170465 -7542726)
2013,Marzo,México,0,2,,2,POINT (7088729 -70740253)
2013,Marzo,México,5,3,,8,POINT (7128047 -73181317)
2013,Marzo,México,7,20,,27,POINT (7819 -72453013)
2013,Marzo,México,3,1,,4,POINT (7927233 -72508188)
2013,Marzo,República de Moldavia,1,0,,1,POINT (4697157 -74140516)
2013,Marzo,Mónaco,0,1,,1,POINT (4697157 -74140516)
2013,Marzo,Mongolia,2,8,,10,POINT (4697157 -74140516)
2013,Marzo,Montenegro,0,1,,1,POINT (6170465 -7542726)
2013,Marzo,Myanmar,1,1,,2,POINT (4697157 -74140516)
2013,Marzo,Namibia,0,1,,1,POINT (4697157 -74140516)
2013,Marzo,Nepal,1,1,,2,POINT (4697157 -74140516)
2013,Marzo,Nicaragua,5,4,,9,POINT (10446304 -75516486)
2013,Marzo,Nicaragua,2,1,,3,POINT (10886686 -74776479)
2013,Marzo,Nicaragua,1,1,,2,POINT (125862 -81702165)
2013,Marzo,Nicaragua,5,8,,13,POINT (3451668 -76532004)
2013,Marzo,Nicaragua,43,52,,95,POINT (4697157 -74140516)
2013,Marzo,Nicaragua,1,0,,1,POINT (4815189 -75736374)
2013,Marzo,Nicaragua,4,8,,12,POINT (6170465 -7542726)
2013,Marzo,Nigeria,1,0,,1,POINT (10406342 -75527794)
2013,Marzo,Nigeria,1,0,,1,POINT (10446304 -75516486)
2013,Marzo,Nigeria,3,8,,11,POINT (4697157 -74140516)
2013,Marzo,Nigeria,0,1,,1,POINT (6170465 -7542726)
2013,Marzo,Noruega,1,1,,2,POINT (-4191162 -69941498)
2013,Marzo,Noruega,2,5,,7,POINT (0.81488 -77356)
2013,Marzo,Noruega,4,6,,10,POINT (10406342 -75527794)
2013,Marzo,Noruega,6,9,,15,POINT (10446304 -75516486)
2013,Marzo,Noruega,1,3,,4,POINT (10886686 -74776479)
2013,Marzo,Noruega,0,1,,1,POINT (11247723 -74213989)
2013,Marzo,Noruega,0,1,,1,POINT (11360029 -72129595)
2013,Marzo,Noruega,0,3,,3,POINT (133387613 -81372937)
2013,Marzo,Noruega,4,4,,8,POINT (3451668 -76532004)
2013,Marzo,Noruega,104,129,,233,POINT (4697157 -74140516)
2013,Marzo,Noruega,1,1,,2,POINT (4815189 -75736374)
2013,Marzo,Noruega,7,11,,18,POINT (6170465 -7542726)
2013,Marzo,Noruega,0,2,,2,POINT (7819 -72453013)
2013,Marzo,Noruega,0,1,,1,POINT (7927233 -72508188)
2013,Marzo,Noruega,0,1,,1,POINT (863337 -7735002)
2013,Marzo,Nueva Zelanda,7,10,,17,POINT (0.81488 -77356)
2013,Marzo,Nueva Zelanda,27,47,,74,POINT (10446304 -75516486)
2013,Marzo,Nueva Zelanda,1,1,,2,POINT (10886686 -74776479)
2013,Marzo,Nueva Zelanda,1,0,,1,POINT (11360029 -72129595)
2013,Marzo,Nueva Zelanda,3,0,,3,POINT (3451668 -76532004)
2013,Marzo,Nueva Zelanda,24,50,,74,POINT (4697157 -74140516)
2013,Marzo,Nueva Zelanda,1,8,,9,POINT (6170465 -7542726)
2013,Marzo,Nueva Zelanda,0,1,,1,POINT (7128047 -73181317)
2013,Marzo,Nueva Zelanda,0,2,,2,POINT (7819 -72453013)
2013,Marzo,Nueva Zelanda,0,1,,1,POINT (863337 -7735002)
2013,Marzo,Nueva Zelanda,1,2,,3,POINT (10406342 -75527794)
2013,Marzo,Nueva Zelanda,0,6,,6,POINT (10446304 -75516486)
2013,Marzo,Nueva Zelanda,1,0,,1,POINT (3451668 -76532004)
2013,Marzo,Nueva Zelanda,1,1,,2,POINT (4697157 -74140516)
2013,Marzo,Países Bajos,1,3,,4,POINT (-4191162 -69941498)
2013,Marzo,Países Bajos,13,12,,25,POINT (0.81488 -77356)
2013,Marzo,Países Bajos,0,1,,1,POINT (10406342 -75527794)
2013,Marzo,Países Bajos,2,3,,5,POINT (10446304 -75516486)
2013,Marzo,Países Bajos,4,2,,6,POINT (10886686 -74776479)
2013,Marzo,Países Bajos,5,2,,7,POINT (11360029 -72129595)
2013,Marzo,Países Bajos,28,31,,59,POINT (1152863 -72919186)
2013,Marzo,Países Bajos,6,8,,14,POINT (3451668 -76532004)
2013,Marzo,Países Bajos,0,2,,2,POINT (3884426 -77061029)
2013,Marzo,Países Bajos,13,23,,36,POINT (445285 -75766353)
2013,Marzo,Países Bajos,127,226,,353,POINT (4697157 -74140516)
2013,Marzo,Países Bajos,0,1,,1,POINT (4815189 -75736374)
2013,Marzo,Países Bajos,165,200,,365,POINT (6170465 -7542726)
2013,Marzo,Países Bajos,13,10,,23,POINT (7128047 -73181317)
2013,Marzo,Países Bajos,0,1,,1,POINT (7819 -72453013)
2013,Marzo,Pakistán,1,1,,2,POINT (10446304 -75516486)
2013,Marzo,Pakistán,2,9,,11,POINT (4697157 -74140516)
2013,Marzo,Pakistán,0,1,,1,POINT (6170465 -7542726)
2013,Marzo,Pakistán,0,1,,1,POINT (7819 -72453013)
2013,Marzo,Panamá,2,14,,16,POINT (10406342 -75527794)
2013,Marzo,Panamá,142,197,,339,POINT (10446304 -75516486)
2013,Marzo,Panamá,35,87,,122,POINT (10886686 -74776479)
2013,Marzo,Panamá,0,1,,1,POINT (11360029 -72129595)
2013,Marzo,Panamá,23,25,,48,POINT (125862 -81702165)
2013,Marzo,Panamá,86,127,,213,POINT (3451668 -76532004)
2013,Marzo,Panamá,373,665,,1038,POINT (4697157 -74140516)
2013,Marzo,Panamá,87,102,,189,POINT (4815189 -75736374)
2013,Marzo,Panamá,106,218,,324,POINT (6170465 -7542726)
2013,Marzo,Panamá,5,12,,17,POINT (7128047 -73181317)
2013,Marzo,Panamá,0,3,,3,POINT (7819 -72453013)
2013,Marzo,Panamá,2,5,,7,POINT (7927233 -72508188)
2013,Marzo,Panamá,1,5,,6,POINT (863337 -7735002)
2013,Marzo,Paraguay,1,0,,1,POINT (-4191162 -69941498)
2013,Marzo,Paraguay,0,1,,1,POINT (0.81488 -77356)
2013,Marzo,Paraguay,1,2,,3,POINT (10406342 -75527794)
2013,Marzo,Paraguay,16,26,,42,POINT (10446304 -75516486)
2013,Marzo,Paraguay,3,1,,4,POINT (10886686 -74776479)
2013,Marzo,Paraguay,0,1,,1,POINT (125862 -81702165)
2013,Marzo,Paraguay,0,1,,1,POINT (3451668 -76532004)
2013,Marzo,Paraguay,60,82,,142,POINT (4697157 -74140516)
2013,Marzo,Paraguay,5,5,,10,POINT (6170465 -7542726)
2013,Marzo,Paraguay,0,1,,1,POINT (6185536 -67484028)
2013,Marzo,Paraguay,0,3,,3,POINT (7819 -72453013)
2013,Marzo,Perú,19,17,,36,POINT (-4191162 -69941498)
2013,Marzo,Perú,136,284,,420,POINT (0.81488 -77356)
2013,Marzo,Perú,45,30,,75,POINT (10406342 -75527794)
2013,Marzo,Perú,252,234,,486,POINT (10446304 -75516486)
2013,Marzo,Perú,20,44,,64,POINT (10886686 -74776479)
2013,Marzo,Perú,0,2,,2,POINT (10970933 -74765343)
2013,Marzo,Perú,1,2,,3,POINT (11360029 -72129595)
2013,Marzo,Perú,136,102,,238,POINT (125862 -81702165)
2013,Marzo,Perú,123,175,,298,POINT (3451668 -76532004)
2013,Marzo,Perú,2242,3043,,5285,POINT (4697157 -74140516)
2013,Marzo,Perú,5,6,,11,POINT (4815189 -75736374)
2013,Marzo,Perú,143,347,,490,POINT (6170465 -7542726)
2013,Marzo,Perú,0,1,,1,POINT (6185536 -67484028)
2013,Marzo,Perú,0,1,,1,POINT (6222552 -77401154)
2013,Marzo,Perú,4,7,,11,POINT (7128047 -73181317)
2013,Marzo,Perú,29,52,,81,POINT (7819 -72453013)
2013,Marzo,Perú,0,1,,1,POINT (7927233 -72508188)
2013,Marzo,Perú,0,2,,2,POINT (863337 -7735002)
2013,Marzo,Palestina,2,3,,5,POINT (4697157 -74140516)
2013,Marzo,Polonia,1,2,,3,POINT (-4191162 -69941498)
2013,Marzo,Polonia,4,10,,14,POINT (0.81488 -77356)
2013,Marzo,Polonia,1,13,,14,POINT (10406342 -75527794)
2013,Marzo,Polonia,7,8,,15,POINT (10446304 -75516486)
2013,Marzo,Polonia,0,1,,1,POINT (10970933 -74765343)
2013,Marzo,Polonia,0,1,,1,POINT (11247723 -74213989)
2013,Marzo,Polonia,3,4,,7,POINT (11360029 -72129595)
2013,Marzo,Polonia,1,3,,4,POINT (3451668 -76532004)
2013,Marzo,Polonia,63,75,,138,POINT (4697157 -74140516)
2013,Marzo,Polonia,4,5,,9,POINT (6170465 -7542726)
2013,Marzo,Polonia,2,1,,3,POINT (7819 -72453013)
2013,Marzo,Polonia,0,1,,1,POINT (7927233 -72508188)
2013,Marzo,Portugal,0,1,,1,POINT (-4191162 -69941498)
2013,Marzo,Portugal,1,2,,3,POINT (10406342 -75527794)
2013,Marzo,Portugal,2,6,,8,POINT (10446304 -75516486)
2013,Marzo,Portugal,4,20,,24,POINT (3451668 -76532004)
2013,Marzo,Portugal,123,324,,447,POINT (4697157 -74140516)
2013,Marzo,Portugal,12,22,,34,POINT (4815189 -75736374)
2013,Marzo,Portugal,10,10,,20,POINT (6170465 -7542726)
2013,Marzo,Portugal,0,8,,8,POINT (7819 -72453013)
2013,Marzo,Puerto Rico/Territorio de Estados Unidos,1,0,,1,POINT (10446304 -75516486)
2013,Marzo,Puerto Rico/Territorio de Estados Unidos,1,0,,1,POINT (10886686 -74776479)
2013,Marzo,Puerto Rico/Territorio de Estados Unidos,0,1,,1,POINT (3451668 -76532004)
2013,Marzo,Puerto Rico/Territorio de Estados Unidos,1,0,,1,POINT (4697157 -74140516)
2013,Marzo,Puerto Rico/Territorio de Estados Unidos,2,0,,2,POINT (6170465 -7542726)
2013,Marzo,Reino Unido de Gran Bretaña e Irlanda del Norte,0,4,,4,POINT (-4191162 -69941498)
2013,Marzo,Reino Unido de Gran Bretaña e Irlanda del Norte,7,8,,15,POINT (0.81488 -77356)
2013,Marzo,Reino Unido de Gran Bretaña e Irlanda del Norte,6,6,,12,POINT (10406342 -75527794)
2013,Marzo,Reino Unido de Gran Bretaña e Irlanda del Norte,18,40,,58,POINT (10446304 -75516486)
2013,Marzo,Reino Unido de Gran Bretaña e Irlanda del Norte,0,7,,7,POINT (10886686 -74776479)
2013,Marzo,Reino Unido de Gran Bretaña e Irlanda del Norte,8,11,,19,POINT (11360029 -72129595)
2013,Marzo,Reino Unido de Gran Bretaña e Irlanda del Norte,1,2,,3,POINT (125862 -81702165)
2013,Marzo,Reino Unido de Gran Bretaña e Irlanda del Norte,10,22,,32,POINT (3451668 -76532004)
2013,Marzo,Reino Unido de Gran Bretaña e Irlanda del Norte,238,511,,749,POINT (4697157 -74140516)
2013,Marzo,Reino Unido de Gran Bretaña e Irlanda del Norte,11,30,,41,POINT (6170465 -7542726)
2013,Marzo,Reino Unido de Gran Bretaña e Irlanda del Norte,0,2,,2,POINT (7819 -72453013)
2013,Marzo,Reino Unido de Gran Bretaña e Irlanda del Norte,0,1,,1,POINT (7927233 -72508188)
2013,Marzo,República de Belarús,1,4,,5,POINT (4697157 -74140516)
2013,Marzo,República Dominicana,0,1,,1,POINT (-4191162 -69941498)
2013,Marzo,República Dominicana,4,7,,11,POINT (0.81488 -77356)
2013,Marzo,República Dominicana,14,20,,34,POINT (10446304 -75516486)
2013,Marzo,República Dominicana,6,16,,22,POINT (10886686 -74776479)
2013,Marzo,República Dominicana,1,5,,6,POINT (11360029 -72129595)
2013,Marzo,República Dominicana,1,0,,1,POINT (1152863 -72919186)
2013,Marzo,República Dominicana,16,23,,39,POINT (3451668 -76532004)
2013,Marzo,República Dominicana,0,1,,1,POINT (445285 -75766353)
2013,Marzo,República Dominicana,211,372,,583,POINT (4697157 -74140516)
2013,Marzo,República Dominicana,5,7,,12,POINT (4815189 -75736374)
2013,Marzo,República Dominicana,25,41,,66,POINT (6170465 -7542726)
2013,Marzo,República Dominicana,3,0,,3,POINT (7128047 -73181317)
2013,Marzo,República Dominicana,3,4,,7,POINT (7819 -72453013)
2013,Marzo,República Dominicana,11,11,,22,POINT (7927233 -72508188)
2013,Marzo,República Checa,2,0,,2,POINT (4697157 -74140516)
2013,Marzo,República Checa,1,0,,1,POINT (7819 -72453013)
2013,Marzo,Rumania,1,1,,2,POINT (0.81488 -77356)
2013,Marzo,Rumania,1,2,,3,POINT (10406342 -75527794)
2013,Marzo,Rumania,0,3,,3,POINT (10446304 -75516486)
2013,Marzo,Rumania,0,2,,2,POINT (11247723 -74213989)
2013,Marzo,Rumania,3,3,,6,POINT (3451668 -76532004)
2013,Marzo,Rumania,31,58,,89,POINT (4697157 -74140516)
2013,Marzo,Rumania,1,0,,1,POINT (4815189 -75736374)
2013,Marzo,Rumania,0,4,,4,POINT (6170465 -7542726)
2013,Marzo,Federación de Rusia,2,9,,11,POINT (0.81488 -77356)
2013,Marzo,Federación de Rusia,3,0,,3,POINT (3451668 -76532004)
2013,Marzo,Federación de Rusia,22,21,,43,POINT (4697157 -74140516)
2013,Marzo,Federación de Rusia,2,0,,2,POINT (6170465 -7542726)
2013,Marzo,San Cristóbal y Nevis,0,1,,1,POINT (10446304 -75516486)
2013,Marzo,San Cristóbal y Nevis,0,1,,1,POINT (4697157 -74140516)
2013,Marzo,San Marino,0,1,,1,POINT (11360029 -72129595)
2013,Marzo,San Marino,1,2,,3,POINT (4697157 -74140516)
2013,Marzo,San  Vicente y las Granadinas,0,1,,1,POINT (10446304 -75516486)
2013,Marzo,San  Vicente y las Granadinas,1,0,,1,POINT (3451668 -76532004)
2013,Marzo,San  Vicente y las Granadinas,1,1,,2,POINT (4697157 -74140516)
2013,Marzo,Santa Lucia,1,0,,1,POINT (10446304 -75516486)
2013,Marzo,Santa Lucia,3,1,,4,POINT (4697157 -74140516)
2013,Marzo,Santa Lucia,0,1,,1,POINT (7128047 -73181317)
2013,Marzo,Santa Sede/Ciudad del Vaticano,0,1,,1,POINT (4697157 -74140516)
2013,Marzo,Senegal,0,1,,1,POINT (4697157 -74140516)
2013,Marzo,Serbia,0,1,,1,POINT (0.81488 -77356)
2013,Marzo,Serbia,1,2,,3,POINT (10446304 -75516486)
2013,Marzo,Serbia,0,1,,1,POINT (3451668 -76532004)
2013,Marzo,Serbia,5,5,,10,POINT (4697157 -74140516)
2013,Marzo,Serbia,1,0,,1,POINT (6170465 -7542726)
2013,Marzo,Singapur,1,1,,2,POINT (10446304 -75516486)
2013,Marzo,Singapur,0,1,,1,POINT (10886686 -74776479)
2013,Marzo,Singapur,10,11,,21,POINT (4697157 -74140516)
2013,Marzo,Singapur,1,1,,2,POINT (6170465 -7542726)
2013,Marzo,República Árabe Siria,0,1,,1,POINT (11360029 -72129595)
2013,Marzo,República Árabe Siria,0,1,,1,POINT (6170465 -7542726)
2013,Marzo,Sri Lanka,2,1,,3,POINT (4697157 -74140516)
2013,Marzo,Sudáfrica,7,4,,11,POINT (-4191162 -69941498)
2013,Marzo,Sudáfrica,2,2,,4,POINT (0.81488 -77356)
2013,Marzo,Sudáfrica,0,1,,1,POINT (10406342 -75527794)
2013,Marzo,Sudáfrica,0,2,,2,POINT (10446304 -75516486)
2013,Marzo,Sudáfrica,0,5,,5,POINT (10886686 -74776479)
2013,Marzo,Sudáfrica,0,1,,1,POINT (11360029 -72129595)
2013,Marzo,Sudáfrica,1,2,,3,POINT (133387613 -81372937)
2013,Marzo,Sudáfrica,0,2,,2,POINT (3451668 -76532004)
2013,Marzo,Sudáfrica,35,60,,95,POINT (4697157 -74140516)
2013,Marzo,Sudáfrica,3,6,,9,POINT (6170465 -7542726)
2013,Marzo,Sudáfrica,1,1,,2,POINT (7819 -72453013)
2013,Marzo,Suecia,1,2,,3,POINT (-4191162 -69941498)
2013,Marzo,Suecia,9,10,,19,POINT (0.81488 -77356)
2013,Marzo,Suecia,1,8,,9,POINT (10406342 -75527794)
2013,Marzo,Suecia,8,13,,21,POINT (10446304 -75516486)
2013,Marzo,Suecia,2,3,,5,POINT (10886686 -74776479)
2013,Marzo,Suecia,0,1,,1,POINT (11247723 -74213989)
2013,Marzo,Suecia,1,1,,2,POINT (11360029 -72129595)
2013,Marzo,Suecia,1,3,,4,POINT (133387613 -81372937)
2013,Marzo,Suecia,7,7,,14,POINT (3451668 -76532004)
2013,Marzo,Suecia,126,211,,337,POINT (4697157 -74140516)
2013,Marzo,Suecia,4,18,,22,POINT (6170465 -7542726)
2013,Marzo,Suecia,5,6,,11,POINT (863337 -7735002)
2013,Marzo,Suiza,2,3,,5,POINT (-4191162 -69941498)
2013,Marzo,Suiza,18,18,,36,POINT (0.81488 -77356)
2013,Marzo,Suiza,6,11,,17,POINT (10406342 -75527794)
2013,Marzo,Suiza,13,21,,34,POINT (10446304 -75516486)
2013,Marzo,Suiza,1,7,,8,POINT (10886686 -74776479)
2013,Marzo,Suiza,0,1,,1,POINT (11247723 -74213989)
2013,Marzo,Suiza,0,1,,1,POINT (11360029 -72129595)
2013,Marzo,Suiza,1,2,,3,POINT (125862 -81702165)
2013,Marzo,Suiza,18,34,,52,POINT (3451668 -76532004)
2013,Marzo,Suiza,1,1,,2,POINT (445285 -75766353)
2013,Marzo,Suiza,302,510,,812,POINT (4697157 -74140516)
2013,Marzo,Suiza,18,33,,51,POINT (6170465 -7542726)
2013,Marzo,Suiza,0,1,,1,POINT (7128047 -73181317)
2013,Marzo,Suiza,5,3,,8,POINT (7819 -72453013)
2013,Marzo,Suiza,8,4,,12,POINT (863337 -7735002)
2013,Marzo,Surinam,0,3,,3,POINT (3451668 -76532004)
2013,Marzo,Surinam,3,16,,19,POINT (4697157 -74140516)
2013,Marzo,Surinam,3,6,,9,POINT (6170465 -7542726)
2013,Marzo,Taiwán,1,7,,8,POINT (4697157 -74140516)
2013,Marzo,Taiwán,0,1,,1,POINT (6170465 -7542726)
2013,Marzo,Taiwán,3,1,,4,POINT (7819 -72453013)
2013,Marzo,Tailandia,1,0,,1,POINT (10446304 -75516486)
2013,Marzo,Tailandia,3,4,,7,POINT (4697157 -74140516)
2013,Marzo,Tíbet/Región Autónoma de China,0,1,,1,POINT (3451668 -76532004)
2013,Marzo,Tíbet/Región Autónoma de China,0,1,,1,POINT (4697157 -74140516)
2013,Marzo,Territorio Antártico Británico/Territorio Británico de Ultramar,1,0,,1,POINT (10446304 -75516486)
2013,Marzo,Territorio Antártico Británico/Territorio Británico de Ultramar,2,3,,5,POINT (4697157 -74140516)
2013,Marzo,Territorio Antártico Británico/Territorio Británico de Ultramar,1,0,,1,POINT (6170465 -7542726)
2013,Marzo,Territorio Antártico Británico/Territorio Británico de Ultramar,1,0,,1,POINT (863337 -7735002)
2013,Marzo,Tanzania,1,1,,2,POINT (4697157 -74140516)
2013,Marzo,Trinidad y Tobago,3,8,,11,POINT (10446304 -75516486)
2013,Marzo,Trinidad y Tobago,2,3,,5,POINT (10886686 -74776479)
2013,Marzo,Trinidad y Tobago,2,2,,4,POINT (3451668 -76532004)
2013,Marzo,Trinidad y Tobago,14,44,,58,POINT (4697157 -74140516)
2013,Marzo,Trinidad y Tobago,0,1,,1,POINT (4815189 -75736374)
2013,Marzo,Trinidad y Tobago,1,2,,3,POINT (6170465 -7542726)
2013,Marzo,Trinidad y Tobago,1,4,,5,POINT (7128047 -73181317)
2013,Marzo,Trinidad y Tobago,0,1,,1,POINT (7819 -72453013)
2013,Marzo,Túnez,0,1,,1,POINT (0.81488 -77356)
2013,Marzo,Túnez,1,0,,1,POINT (4697157 -74140516)
2013,Marzo,Túnez,0,1,,1,POINT (6170465 -7542726)
2013,Marzo,Turquía,0,1,,1,POINT (-4191162 -69941498)
2013,Marzo,Turquía,2,3,,5,POINT (0.81488 -77356)
2013,Marzo,Turquía,0,1,,1,POINT (10406342 -75527794)
2013,Marzo,Turquía,3,4,,7,POINT (10446304 -75516486)
2013,Marzo,Turquía,0,2,,2,POINT (3451668 -76532004)
2013,Marzo,Turquía,15,54,,69,POINT (4697157 -74140516)
2013,Marzo,Turquía,0,2,,2,POINT (6170465 -7542726)
2013,Marzo,Turquía,1,1,,2,POINT (863337 -7735002)
2013,Marzo,Ucrania,0,2,,2,POINT (0.81488 -77356)
2013,Marzo,Ucrania,1,0,,1,POINT (10446304 -75516486)
2013,Marzo,Ucrania,0,2,,2,POINT (3451668 -76532004)
2013,Marzo,Ucrania,0,1,,1,POINT (3884426 -77061029)
2013,Marzo,Ucrania,18,18,,36,POINT (4697157 -74140516)
2013,Marzo,Uganda,0,1,,1,POINT (10446304 -75516486)
2013,Marzo,Uganda,0,2,,2,POINT (4697157 -74140516)
2013,Marzo,Federación de Rusia,0,2,,2,POINT (0.81488 -77356)
2013,Marzo,Federación de Rusia,2,3,,5,POINT (10406342 -75527794)
2013,Marzo,Federación de Rusia,1,3,,4,POINT (10446304 -75516486)
2013,Marzo,Federación de Rusia,1,0,,1,POINT (11360029 -72129595)
2013,Marzo,Federación de Rusia,0,3,,3,POINT (133387613 -81372937)
2013,Marzo,Federación de Rusia,3,2,,5,POINT (3451668 -76532004)
2013,Marzo,Federación de Rusia,114,166,,280,POINT (4697157 -74140516)
2013,Marzo,Federación de Rusia,3,3,,6,POINT (6170465 -7542726)
2013,Marzo,Federación de Rusia,1,2,,3,POINT (7819 -72453013)
2013,Marzo,Uruguay,4,9,,13,POINT (0.81488 -77356)
2013,Marzo,Uruguay,9,6,,15,POINT (10406342 -75527794)
2013,Marzo,Uruguay,76,65,,141,POINT (10446304 -75516486)
2013,Marzo,Uruguay,4,5,,9,POINT (10886686 -74776479)
2013,Marzo,Uruguay,1,4,,5,POINT (11360029 -72129595)
2013,Marzo,Uruguay,31,29,,60,POINT (125862 -81702165)
2013,Marzo,Uruguay,4,30,,34,POINT (3451668 -76532004)
2013,Marzo,Uruguay,145,284,,429,POINT (4697157 -74140516)
2013,Marzo,Uruguay,0,2,,2,POINT (4815189 -75736374)
2013,Marzo,Uruguay,21,40,,61,POINT (6170465 -7542726)
2013,Marzo,Uruguay,5,15,,20,POINT (7819 -72453013)
2013,Marzo,Uzbekistán,1,0,,1,POINT (4697157 -74140516)
2013,Marzo,Venezuela,0,2,,2,POINT (-4191162 -69941498)
2013,Marzo,Venezuela,68,95,,163,POINT (0.81488 -77356)
2013,Marzo,Venezuela,4,10,,14,POINT (10406342 -75527794)
2013,Marzo,Venezuela,104,139,,243,POINT (10446304 -75516486)
2013,Marzo,Venezuela,39,63,,102,POINT (10886686 -74776479)
2013,Marzo,Venezuela,1443,1824,,3267,POINT (11360029 -72129595)
2013,Marzo,Venezuela,2,1,,3,POINT (1152863 -72919186)
2013,Marzo,Venezuela,2,2,,4,POINT (125862 -81702165)
2013,Marzo,Venezuela,44,74,,118,POINT (3451668 -76532004)
2013,Marzo,Venezuela,0,2,,2,POINT (445285 -75766353)
2013,Marzo,Venezuela,5349,6141,,11490,POINT (4697157 -74140516)
2013,Marzo,Venezuela,6,11,,17,POINT (4815189 -75736374)
2013,Marzo,Venezuela,348,378,,726,POINT (6170465 -7542726)
2013,Marzo,Venezuela,151,260,,411,POINT (6185536 -67484028)
2013,Marzo,Venezuela,66,117,,183,POINT (7088729 -70740253)
2013,Marzo,Venezuela,3,4,,7,POINT (7128047 -73181317)
2013,Marzo,Venezuela,1257,1516,,2773,POINT (7819 -72453013)
2013,Marzo,Venezuela,195,208,,403,POINT (7927233 -72508188)
2013,Marzo,Vietnam,1,0,,1,POINT (11360029 -72129595)
2013,Marzo,Vietnam,1,4,,5,POINT (4697157 -74140516)
2013,Marzo,Vietnam,0,2,,2,POINT (6170465 -7542726)
2013,Marzo,Zambia,0,1,,1,POINT (4697157 -74140516)
2013,Marzo,Zimbabue,1,4,,5,POINT (4697157 -74140516)
2013,Marzo,Zimbabue,1,0,,1,POINT (6170465 -7542726)
2013,Marzo,Reino Unido de Gran Bretaña e Irlanda del Norte,6,10,,16,POINT (-4191162 -69941498)
2013,Marzo,Reino Unido de Gran Bretaña e Irlanda del Norte,19,33,,52,POINT (0.81488 -77356)
2013,Marzo,Reino Unido de Gran Bretaña e Irlanda del Norte,10,28,,38,POINT (10406342 -75527794)
2013,Marzo,Reino Unido de Gran Bretaña e Irlanda del Norte,24,48,,72,POINT (10446304 -75516486)
2013,Marzo,Reino Unido de Gran Bretaña e Irlanda del Norte,2,7,,9,POINT (10886686 -74776479)
2013,Marzo,Reino Unido de Gran Bretaña e Irlanda del Norte,0,1,,1,POINT (10970933 -74765343)
2013,Marzo,Reino Unido de Gran Bretaña e Irlanda del Norte,6,9,,15,POINT (11360029 -72129595)
2013,Marzo,Reino Unido de Gran Bretaña e Irlanda del Norte,1,1,,2,POINT (125744111 -81703935)
2013,Marzo,Reino Unido de Gran Bretaña e Irlanda del Norte,1,5,,6,POINT (125862 -81702165)
2013,Marzo,Reino Unido de Gran Bretaña e Irlanda del Norte,6,5,,11,POINT (133387613 -81372937)
2013,Marzo,Reino Unido de Gran Bretaña e Irlanda del Norte,8,26,,34,POINT (3451668 -76532004)
2013,Marzo,Reino Unido de Gran Bretaña e Irlanda del Norte,276,687,,963,POINT (4697157 -74140516)
2013,Marzo,Reino Unido de Gran Bretaña e Irlanda del Norte,11,23,,34,POINT (6170465 -7542726)
2013,Marzo,Reino Unido de Gran Bretaña e Irlanda del Norte,1,11,,12,POINT (7819 -72453013)
2013,Marzo,Reino Unido de Gran Bretaña e Irlanda del Norte,0,1,,1,POINT (7927233 -72508188)
2013,Marzo,Reino Unido de Gran Bretaña e Irlanda del Norte,6,13,,19,POINT (863337 -7735002)
2013,Marzo,Países Bajos,3,5,,8,POINT (-4191162 -69941498)
2013,Marzo,Países Bajos,14,19,,33,POINT (0.81488 -77356)
2013,Marzo,Países Bajos,5,6,,11,POINT (10406342 -75527794)
2013,Marzo,Países Bajos,14,47,,61,POINT (10446304 -75516486)
2013,Marzo,Países Bajos,1,5,,6,POINT (10886686 -74776479)
2013,Marzo,Países Bajos,4,4,,8,POINT (11247723 -74213989)
2013,Marzo,Países Bajos,2,4,,6,POINT (11360029 -72129595)
2013,Marzo,Países Bajos,1,2,,3,POINT (125862 -81702165)
2013,Marzo,Países Bajos,3,2,,5,POINT (133387613 -81372937)
2013,Marzo,Países Bajos,17,35,,52,POINT (3451668 -76532004)
2013,Marzo,Países Bajos,357,677,,1034,POINT (4697157 -74140516)
2013,Marzo,Países Bajos,0,3,,3,POINT (4815189 -75736374)
2013,Marzo,Países Bajos,107,146,,253,POINT (6170465 -7542726)
2013,Marzo,Países Bajos,5,3,,8,POINT (7128047 -73181317)
2013,Marzo,Países Bajos,2,30,,32,POINT (7819 -72453013)
2013,Marzo,Países Bajos,0,1,,1,POINT (7927233 -72508188)
2013,Marzo,Países Bajos,2,6,,8,POINT (863337 -7735002)
2013,Marzo,Desconocido,0,1,,1,POINT (4697157 -74140516)
2013,Marzo,Eslovenia,0,1,,1,POINT (4697157 -74140516)
2013,Marzo,Lituania,3,2,,5,POINT (4697157 -74140516)
2013,Marzo,Reino Unido de Gran Bretaña e Irlanda del Norte,0,1,,1,POINT (10406342 -75527794)
2013,Marzo,Reino Unido de Gran Bretaña e Irlanda del Norte,0,2,,2,POINT (0.81488 -77356)
2013,Marzo,Reino Unido de Gran Bretaña e Irlanda del Norte,1,1,,2,POINT (10446304 -75516486)
2013,Marzo,Reino Unido de Gran Bretaña e Irlanda del Norte,4,14,,18,POINT (4697157 -74140516)
2013,Marzo,Reino Unido de Gran Bretaña e Irlanda del Norte,0,1,,1,POINT (6170465 -7542726)
2013,Marzo,Reino Unido de Gran Bretaña e Irlanda del Norte,1,0,,1,POINT (6222552 -77401154)
2013,Marzo,Marruecos,1,1,,2,POINT (4697157 -74140516)
2013,Abril,Albania,1,0,,1,POINT (3451668 -76532004)
2013,Abril,Albania,5,2,,7,POINT (4697157 -74140516)
2013,Abril,Alemania,16,16,,32,POINT (-4191162 -69941498)
2013,Abril,Alemania,45,47,,92,POINT (0.81488 -77356)
2013,Abril,Alemania,15,19,,34,POINT (10406342 -75527794)
2013,Abril,Alemania,23,44,,67,POINT (10446304 -75516486)
2013,Abril,Alemania,5,16,,21,POINT (10886686 -74776479)
2013,Abril,Alemania,1,0,,1,POINT (11247723 -74213989)
2013,Abril,Alemania,9,8,,17,POINT (11360029 -72129595)
2013,Abril,Alemania,2,2,,4,POINT (125862 -81702165)
2013,Abril,Alemania,28,53,,81,POINT (3451668 -76532004)
2013,Abril,Alemania,940,1651,,2591,POINT (4697157 -74140516)
2013,Abril,Alemania,0,1,,1,POINT (4815189 -75736374)
2013,Abril,Alemania,30,69,,99,POINT (6170465 -7542726)
2013,Abril,Alemania,1,0,,1,POINT (6185536 -67484028)
2013,Abril,Alemania,0,1,,1,POINT (7128047 -73181317)
2013,Abril,Alemania,3,9,,12,POINT (7819 -72453013)
2013,Abril,Alemania,9,5,,14,POINT (863337 -7735002)
2013,Abril,Andorra,0,1,,1,POINT (10886686 -74776479)
2013,Abril,Andorra,2,10,,12,POINT (4697157 -74140516)
2013,Abril,Andorra,0,1,,1,POINT (6170465 -7542726)
2013,Abril,Antigua y Barbuda,0,1,,1,POINT (10886686 -74776479)
2013,Abril,Países Bajos,3,5,,8,POINT (6170465 -7542726)
2013,Abril,Arabia Saudita,0,5,,5,POINT (4697157 -74140516)
2013,Abril,Arabia Saudita,0,1,,1,POINT (4815189 -75736374)
2013,Abril,Argelia,1,3,,4,POINT (4697157 -74140516)
2013,Abril,Argentina,2,4,,6,POINT (-4191162 -69941498)
2013,Abril,Argentina,7,5,,12,POINT (0.33002 -76876446)
2013,Abril,Argentina,70,135,,205,POINT (0.81488 -77356)
2013,Abril,Argentina,2,3,,5,POINT (10406342 -75527794)
2013,Abril,Argentina,1,4,,5,POINT (10433609 -73247863)
2013,Abril,Argentina,977,604,,1581,POINT (10446304 -75516486)
2013,Abril,Argentina,8,30,,38,POINT (10886686 -74776479)
2013,Abril,Argentina,0,1,,1,POINT (11247723 -74213989)
2013,Abril,Argentina,12,30,,42,POINT (11360029 -72129595)
2013,Abril,Argentina,200,158,,358,POINT (125862 -81702165)
2013,Abril,Argentina,26,78,,104,POINT (3451668 -76532004)
2013,Abril,Argentina,0,1,,1,POINT (445285 -75766353)
2013,Abril,Argentina,3490,4782,,8272,POINT (4697157 -74140516)
2013,Abril,Argentina,1,5,,6,POINT (4815189 -75736374)
2013,Abril,Argentina,97,243,,340,POINT (6170465 -7542726)
2013,Abril,Argentina,0,4,,4,POINT (6185536 -67484028)
2013,Abril,Argentina,18,31,,49,POINT (7819 -72453013)
2013,Abril,Argentina,3,1,,4,POINT (7927233 -72508188)
2013,Abril,Argentina,1,7,,8,POINT (863337 -7735002)
2013,Abril,República de Armenia,0,1,,1,POINT (4697157 -74140516)
2013,Abril,Aruba,0,1,,1,POINT (3451668 -76532004)
2013,Abril,Aruba,2,6,,8,POINT (4697157 -74140516)
2013,Abril,Aruba,2,4,,6,POINT (6170465 -7542726)
2013,Abril,Australia,2,3,,5,POINT (-4191162 -69941498)
2013,Abril,Australia,35,42,,77,POINT (0.81488 -77356)
2013,Abril,Australia,8,13,,21,POINT (10406342 -75527794)
2013,Abril,Australia,17,39,,56,POINT (10446304 -75516486)
2013,Abril,Australia,3,6,,9,POINT (10886686 -74776479)
2013,Abril,Australia,3,3,,6,POINT (11360029 -72129595)
2013,Abril,Australia,1,1,,2,POINT (125862 -81702165)
2013,Abril,Australia,13,20,,33,POINT (3451668 -76532004)
2013,Abril,Australia,144,328,,472,POINT (4697157 -74140516)
2013,Abril,Australia,2,3,,5,POINT (4815189 -75736374)
2013,Abril,Australia,24,44,,68,POINT (6170465 -7542726)
2013,Abril,Australia,0,1,,1,POINT (7128047 -73181317)
2013,Abril,Australia,11,8,,19,POINT (7819 -72453013)
2013,Abril,Australia,1,3,,4,POINT (863337 -7735002)
2013,Abril,Austria,1,6,,7,POINT (0.81488 -77356)
2013,Abril,Austria,2,2,,4,POINT (10406342 -75527794)
2013,Abril,Austria,3,5,,8,POINT (10446304 -75516486)
2013,Abril,Austria,1,2,,3,POINT (10886686 -74776479)
2013,Abril,Austria,0,1,,1,POINT (11247723 -74213989)
2013,Abril,Austria,1,3,,4,POINT (125862 -81702165)
2013,Abril,Austria,2,6,,8,POINT (3451668 -76532004)
2013,Abril,Austria,0,1,,1,POINT (445285 -75766353)
2013,Abril,Austria,61,177,,238,POINT (4697157 -74140516)
2013,Abril,Austria,4,5,,9,POINT (6170465 -7542726)
2013,Abril,Austria,1,1,,2,POINT (863337 -7735002)
2013,Abril,Azerbaiyán,3,3,,6,POINT (4697157 -74140516)
2013,Abril,Bahamas,0,2,,2,POINT (10446304 -75516486)
2013,Abril,Bahamas,0,2,,2,POINT (10886686 -74776479)
2013,Abril,Bahamas,3,7,,10,POINT (4697157 -74140516)
2013,Abril,Bahamas,0,1,,1,POINT (6170465 -7542726)
2013,Abril,Bangladesh,0,1,,1,POINT (11360029 -72129595)
2013,Abril,Bangladesh,2,2,,4,POINT (4697157 -74140516)
2013,Abril,Bangladesh,0,1,,1,POINT (6170465 -7542726)
2013,Abril,Barbados,0,1,,1,POINT (0.81488 -77356)
2013,Abril,Barbados,1,0,,1,POINT (10886686 -74776479)
2013,Abril,Barbados,0,2,,2,POINT (3451668 -76532004)
2013,Abril,Barbados,1,3,,4,POINT (4697157 -74140516)
2013,Abril,Barbados,1,2,,3,POINT (6170465 -7542726)
2013,Abril,República de Belarús,1,1,,2,POINT (0.81488 -77356)
2013,Abril,República de Belarús,6,2,,8,POINT (4697157 -74140516)
2013,Abril,Bélgica,2,1,,3,POINT (-4191162 -69941498)
2013,Abril,Bélgica,5,14,,19,POINT (0.81488 -77356)
2013,Abril,Bélgica,1,3,,4,POINT (10406342 -75527794)
2013,Abril,Bélgica,2,15,,17,POINT (10446304 -75516486)
2013,Abril,Bélgica,1,2,,3,POINT (10886686 -74776479)
2013,Abril,Bélgica,0,12,,12,POINT (11247723 -74213989)
2013,Abril,Bélgica,0,2,,2,POINT (11360029 -72129595)
2013,Abril,Bélgica,2,15,,17,POINT (3451668 -76532004)
2013,Abril,Bélgica,83,277,,360,POINT (4697157 -74140516)
2013,Abril,Bélgica,7,10,,17,POINT (6170465 -7542726)
2013,Abril,Bélgica,3,2,,5,POINT (7819 -72453013)
2013,Abril,Belice,0,1,,1,POINT (10446304 -75516486)
2013,Abril,Belice,0,1,,1,POINT (3451668 -76532004)
2013,Abril,Belice,2,11,,13,POINT (4697157 -74140516)
2013,Abril,Belice,0,3,,3,POINT (6170465 -7542726)
2013,Abril,Bermudas/Territorio Británico de Ultramar,0,1,,1,POINT (3451668 -76532004)
2013,Abril,Bermudas/Territorio Británico de Ultramar,0,2,,2,POINT (4697157 -74140516)
2013,Abril,Bolivia,2,0,,2,POINT (-4191162 -69941498)
2013,Abril,Bolivia,4,10,,14,POINT (0.81488 -77356)
2013,Abril,Bolivia,1,0,,1,POINT (1800143 -78802679)
2013,Abril,Bolivia,1,0,,1,POINT (10433609 -73247863)
2013,Abril,Bolivia,20,21,,41,POINT (10446304 -75516486)
2013,Abril,Bolivia,3,5,,8,POINT (10886686 -74776479)
2013,Abril,Bolivia,0,2,,2,POINT (11360029 -72129595)
2013,Abril,Bolivia,1,3,,4,POINT (125862 -81702165)
2013,Abril,Bolivia,16,12,,28,POINT (3451668 -76532004)
2013,Abril,Bolivia,287,469,,756,POINT (4697157 -74140516)
2013,Abril,Bolivia,0,1,,1,POINT (4815189 -75736374)
2013,Abril,Bolivia,22,36,,58,POINT (6170465 -7542726)
2013,Abril,Bolivia,0,1,,1,POINT (6185536 -67484028)
2013,Abril,Bolivia,0,1,,1,POINT (7819 -72453013)
2013,Abril,Botsuana,0,3,,3,POINT (4697157 -74140516)
2013,Abril,Brasil,45,61,,106,POINT (-4191162 -69941498)
2013,Abril,Brasil,0,1,,1,POINT (0.33002 -76876446)
2013,Abril,Brasil,2,15,,17,POINT (0.81488 -77356)
2013,Abril,Brasil,104,127,,231,POINT (10446304 -75516486)
2013,Abril,Brasil,11,14,,25,POINT (10886686 -74776479)
2013,Abril,Brasil,3,8,,11,POINT (11360029 -72129595)
2013,Abril,Brasil,24,21,,45,POINT (125862 -81702165)
2013,Abril,Brasil,23,92,,115,POINT (3451668 -76532004)
2013,Abril,Brasil,2053,3701,,5754,POINT (4697157 -74140516)
2013,Abril,Brasil,0,3,,3,POINT (4815189 -75736374)
2013,Abril,Brasil,53,128,,181,POINT (6170465 -7542726)
2013,Abril,Brasil,1,0,,1,POINT (7128047 -73181317)
2013,Abril,Brasil,5,11,,16,POINT (7819 -72453013)
2013,Abril,Brasil,2,6,,8,POINT (7927233 -72508188)
2013,Abril,Brasil,1,3,,4,POINT (863337 -7735002)
2013,Abril,Bulgaria,0,1,,1,POINT (3451668 -76532004)
2013,Abril,Bulgaria,18,10,,28,POINT (4697157 -74140516)
2013,Abril,Bulgaria,1,1,,2,POINT (6170465 -7542726)
2013,Abril,Bután,0,1,,1,POINT (4697157 -74140516)
2013,Abril,Islas Caimán/Territorio Británico de Ultramar,1,1,,2,POINT (10446304 -75516486)
2013,Abril,Islas Caimán/Territorio Británico de Ultramar,4,6,,10,POINT (125862 -81702165)
2013,Abril,Islas Caimán/Territorio Británico de Ultramar,1,0,,1,POINT (4697157 -74140516)
2013,Abril,Camerún,2,2,,4,POINT (4697157 -74140516)
2013,Abril,Camerún,0,1,,1,POINT (6170465 -7542726)
2013,Abril,Canadá,5,10,,15,POINT (-4191162 -69941498)
2013,Abril,Canadá,17,22,,39,POINT (0.81488 -77356)
2013,Abril,Canadá,6,13,,19,POINT (10406342 -75527794)
2013,Abril,Canadá,63,100,,163,POINT (10446304 -75516486)
2013,Abril,Canadá,13,34,,47,POINT (10886686 -74776479)
2013,Abril,Canadá,1,5,,6,POINT (11360029 -72129595)
2013,Abril,Canadá,68,66,,134,POINT (125862 -81702165)
2013,Abril,Canadá,25,61,,86,POINT (3451668 -76532004)
2013,Abril,Canadá,4,6,,10,POINT (445285 -75766353)
2013,Abril,Canadá,547,1153,,1700,POINT (4697157 -74140516)
2013,Abril,Canadá,1,7,,8,POINT (4815189 -75736374)
2013,Abril,Canadá,48,154,,202,POINT (6170465 -7542726)
2013,Abril,Canadá,0,2,,2,POINT (7128047 -73181317)
2013,Abril,Canadá,4,4,,8,POINT (7819 -72453013)
2013,Abril,Canadá,0,1,,1,POINT (7927233 -72508188)
2013,Abril,Canadá,4,4,,8,POINT (863337 -7735002)
2013,Abril,Chad,0,2,,2,POINT (4697157 -74140516)
2013,Abril,España,3,7,,10,POINT (0.81488 -77356)
2013,Abril,España,1,1,,2,POINT (10406342 -75527794)
2013,Abril,España,3,7,,10,POINT (10446304 -75516486)
2013,Abril,España,2,14,,16,POINT (10886686 -74776479)
2013,Abril,España,1,1,,2,POINT (11247723 -74213989)
2013,Abril,España,27,69,,96,POINT (3451668 -76532004)
2013,Abril,España,88,314,,402,POINT (4697157 -74140516)
2013,Abril,España,0,3,,3,POINT (4815189 -75736374)
2013,Abril,España,38,127,,165,POINT (6170465 -7542726)
2013,Abril,España,0,1,,1,POINT (7128047 -73181317)
2013,Abril,España,0,1,,1,POINT (7927233 -72508188)
2013,Abril,República Democrática del Congo,0,1,,1,POINT (3451668 -76532004)
2013,Abril,República Democrática del Congo,0,2,,2,POINT (4697157 -74140516)
2013,Abril,República Democrática del Congo,0,1,,1,POINT (6170465 -7542726)
2013,Abril,República de Corea,1,0,,1,POINT (-4191162 -69941498)
2013,Abril,República de Corea,12,8,,20,POINT (0.81488 -77356)
2013,Abril,República de Corea,0,1,,1,POINT (10406342 -75527794)
2013,Abril,República de Corea,1,1,,2,POINT (10446304 -75516486)
2013,Abril,República de Corea,0,4,,4,POINT (10886686 -74776479)
2013,Abril,República de Corea,1,5,,6,POINT (3451668 -76532004)
2013,Abril,República de Corea,0,2,,2,POINT (3884426 -77061029)
2013,Abril,República de Corea,98,346,,444,POINT (4697157 -74140516)
2013,Abril,República de Corea,9,17,,26,POINT (6170465 -7542726)
2013,Abril,República de Corea,0,3,,3,POINT (7819 -72453013)
2013,Abril,Costa de Marfil,0,1,,1,POINT (4697157 -74140516)
2013,Abril,Costa Rica,0,1,,1,POINT (-4191162 -69941498)
2013,Abril,Costa Rica,1,0,,1,POINT (0.33002 -76876446)
2013,Abril,Costa Rica,2,5,,7,POINT (0.81488 -77356)
2013,Abril,Costa Rica,46,70,,116,POINT (10446304 -75516486)
2013,Abril,Costa Rica,12,23,,35,POINT (10886686 -74776479)
2013,Abril,Costa Rica,264,210,,474,POINT (125862 -81702165)
2013,Abril,Costa Rica,22,61,,83,POINT (3451668 -76532004)
2013,Abril,Costa Rica,1,1,,2,POINT (445285 -75766353)
2013,Abril,Costa Rica,451,758,,1209,POINT (4697157 -74140516)
2013,Abril,Costa Rica,2,5,,7,POINT (4815189 -75736374)
2013,Abril,Costa Rica,107,183,,290,POINT (6170465 -7542726)
2013,Abril,Costa Rica,2,2,,4,POINT (7819 -72453013)
2013,Abril,Costa Rica,2,4,,6,POINT (7927233 -72508188)
2013,Abril,Costa Rica,0,1,,1,POINT (863337 -7735002)
2013,Abril,Croacia,1,1,,2,POINT (0.81488 -77356)
2013,Abril,Croacia,0,1,,1,POINT (10406342 -75527794)
2013,Abril,Croacia,1,1,,2,POINT (10446304 -75516486)
2013,Abril,Croacia,1,22,,23,POINT (4697157 -74140516)
2013,Abril,Croacia,1,2,,3,POINT (6170465 -7542726)
2013,Abril,Cuba,0,2,,2,POINT (0.81488 -77356)
2013,Abril,Cuba,0,1,,1,POINT (10406342 -75527794)
2013,Abril,Cuba,1,0,,1,POINT (10433609 -73247863)
2013,Abril,Cuba,4,8,,12,POINT (10446304 -75516486)
2013,Abril,Cuba,5,22,,27,POINT (10886686 -74776479)
2013,Abril,Cuba,15,28,,43,POINT (3451668 -76532004)
2013,Abril,Cuba,2,0,,2,POINT (445285 -75766353)
2013,Abril,Cuba,65,143,,208,POINT (4697157 -74140516)
2013,Abril,Cuba,11,16,,27,POINT (6170465 -7542726)
2013,Abril,Cuba,0,1,,1,POINT (7128047 -73181317)
2013,Abril,Cuba,0,2,,2,POINT (7819 -72453013)
2013,Abril,Cuba,1,3,,4,POINT (7927233 -72508188)
2013,Abril,Curazao,1,2,,3,POINT (4697157 -74140516)
2013,Abril,Curazao,5,8,,13,POINT (6170465 -7542726)
2013,Abril,República Checa,2,1,,3,POINT (0.81488 -77356)
2013,Abril,República Checa,0,4,,4,POINT (10446304 -75516486)
2013,Abril,República Checa,0,1,,1,POINT (10886686 -74776479)
2013,Abril,República Checa,0,2,,2,POINT (11360029 -72129595)
2013,Abril,República Checa,2,1,,3,POINT (3451668 -76532004)
2013,Abril,República Checa,22,33,,55,POINT (4697157 -74140516)
2013,Abril,República Checa,1,2,,3,POINT (6170465 -7542726)
2013,Abril,República Checa,1,0,,1,POINT (7819 -72453013)
2013,Abril,Chile,3,1,,4,POINT (-4191162 -69941498)
2013,Abril,Chile,0,1,,1,POINT (0.33002 -76876446)
2013,Abril,Chile,20,49,,69,POINT (0.81488 -77356)
2013,Abril,Chile,5,6,,11,POINT (10406342 -75527794)
2013,Abril,Chile,86,63,,149,POINT (10446304 -75516486)
2013,Abril,Chile,7,23,,30,POINT (10886686 -74776479)
2013,Abril,Chile,4,12,,16,POINT (11360029 -72129595)
2013,Abril,Chile,41,32,,73,POINT (125862 -81702165)
2013,Abril,Chile,43,76,,119,POINT (3451668 -76532004)
2013,Abril,Chile,2449,3688,,6137,POINT (4697157 -74140516)
2013,Abril,Chile,1,5,,6,POINT (4815189 -75736374)
2013,Abril,Chile,37,88,,125,POINT (6170465 -7542726)
2013,Abril,Chile,0,1,,1,POINT (7128047 -73181317)
2013,Abril,Chile,8,20,,28,POINT (7819 -72453013)
2013,Abril,Chile,0,1,,1,POINT (7927233 -72508188)
2013,Abril,Chile,0,1,,1,POINT (863337 -7735002)
2013,Abril,China,3,4,,7,POINT (0.81488 -77356)
2013,Abril,China,1,6,,7,POINT (10446304 -75516486)
2013,Abril,China,2,3,,5,POINT (10886686 -74776479)
2013,Abril,China,0,1,,1,POINT (11360029 -72129595)
2013,Abril,China,7,10,,17,POINT (3451668 -76532004)
2013,Abril,China,180,625,,805,POINT (4697157 -74140516)
2013,Abril,China,14,16,,30,POINT (6170465 -7542726)
2013,Abril,Taiwán,0,2,,2,POINT (0.81488 -77356)
2013,Abril,Taiwán,2,3,,5,POINT (10446304 -75516486)
2013,Abril,Taiwán,1,2,,3,POINT (10886686 -74776479)
2013,Abril,Taiwán,1,2,,3,POINT (3451668 -76532004)
2013,Abril,Taiwán,31,55,,86,POINT (4697157 -74140516)
2013,Abril,Taiwán,0,1,,1,POINT (4815189 -75736374)
2013,Abril,Taiwán,3,10,,13,POINT (6170465 -7542726)
2013,Abril,Taiwán,0,1,,1,POINT (7128047 -73181317)
2013,Abril,Taiwán,3,0,,3,POINT (7819 -72453013)
2013,Abril,Chipre,0,6,,6,POINT (4697157 -74140516)
2013,Abril,Dinamarca,3,2,,5,POINT (-4191162 -69941498)
2013,Abril,Dinamarca,0,1,,1,POINT (0.33002 -76876446)
2013,Abril,Dinamarca,6,7,,13,POINT (0.81488 -77356)
2013,Abril,Dinamarca,2,0,,2,POINT (10406342 -75527794)
2013,Abril,Dinamarca,4,5,,9,POINT (10446304 -75516486)
2013,Abril,Dinamarca,2,1,,3,POINT (11360029 -72129595)
2013,Abril,Dinamarca,0,8,,8,POINT (3451668 -76532004)
2013,Abril,Dinamarca,42,91,,133,POINT (4697157 -74140516)
2013,Abril,Dinamarca,2,4,,6,POINT (4815189 -75736374)
2013,Abril,Dinamarca,1,6,,7,POINT (6170465 -7542726)
2013,Abril,Dinamarca,3,2,,5,POINT (863337 -7735002)
2013,Abril,Dominica,0,9,,9,POINT (4697157 -74140516)
2013,Abril,Dominica,0,1,,1,POINT (6170465 -7542726)
2013,Abril,Ecuador,0,2,,2,POINT (-4191162 -69941498)
2013,Abril,Ecuador,21,51,,72,POINT (0.33002 -76876446)
2013,Abril,Ecuador,876,1393,,2269,POINT (0.81488 -77356)
2013,Abril,Ecuador,2,55,,57,POINT (1800143 -78802679)
2013,Abril,Ecuador,1,2,,3,POINT (10406342 -75527794)
2013,Abril,Ecuador,102,74,,176,POINT (10446304 -75516486)
2013,Abril,Ecuador,9,19,,28,POINT (10886686 -74776479)
2013,Abril,Ecuador,7,13,,20,POINT (11360029 -72129595)
2013,Abril,Ecuador,18,15,,33,POINT (125862 -81702165)
2013,Abril,Ecuador,449,488,,937,POINT (3451668 -76532004)
2013,Abril,Ecuador,1,0,,1,POINT (3884426 -77061029)
2013,Abril,Ecuador,1,1,,2,POINT (445285 -75766353)
2013,Abril,Ecuador,1864,2936,,4800,POINT (4697157 -74140516)
2013,Abril,Ecuador,2,6,,8,POINT (4815189 -75736374)
2013,Abril,Ecuador,714,765,,1479,POINT (6170465 -7542726)
2013,Abril,Ecuador,1,1,,2,POINT (7128047 -73181317)
2013,Abril,Ecuador,131,145,,276,POINT (7819 -72453013)
2013,Abril,Ecuador,2,1,,3,POINT (7927233 -72508188)
2013,Abril,Ecuador,0,1,,1,POINT (863337 -7735002)
2013,Abril,Egipto,0,8,,8,POINT (0.81488 -77356)
2013,Abril,Egipto,4,17,,21,POINT (4697157 -74140516)
2013,Abril,Egipto,0,1,,1,POINT (6170465 -7542726)
2013,Abril,El Salvador,1,0,,1,POINT (-4191162 -69941498)
2013,Abril,El Salvador,0,1,,1,POINT (0.81488 -77356)
2013,Abril,El Salvador,0,1,,1,POINT (10433609 -73247863)
2013,Abril,El Salvador,10,22,,32,POINT (10446304 -75516486)
2013,Abril,El Salvador,1,4,,5,POINT (10886686 -74776479)
2013,Abril,El Salvador,0,1,,1,POINT (11360029 -72129595)
2013,Abril,El Salvador,55,70,,125,POINT (3451668 -76532004)
2013,Abril,El Salvador,480,670,,1150,POINT (4697157 -74140516)
2013,Abril,El Salvador,76,113,,189,POINT (6170465 -7542726)
2013,Abril,El Salvador,0,1,,1,POINT (7819 -72453013)
2013,Abril,El Salvador,1,1,,2,POINT (7927233 -72508188)
2013,Abril,El Salvador,0,1,,1,POINT (863337 -7735002)
2013,Abril,Emiratos Árabes,0,4,,4,POINT (4697157 -74140516)
2013,Abril,España,5,9,,14,POINT (-4191162 -69941498)
2013,Abril,España,1,3,,4,POINT (0.33002 -76876446)
2013,Abril,España,19,31,,50,POINT (0.81488 -77356)
2013,Abril,España,1,8,,9,POINT (10406342 -75527794)
2013,Abril,España,0,4,,4,POINT (10433609 -73247863)
2013,Abril,España,28,88,,116,POINT (10446304 -75516486)
2013,Abril,España,7,20,,27,POINT (10886686 -74776479)
2013,Abril,España,2,10,,12,POINT (11360029 -72129595)
2013,Abril,España,11,8,,19,POINT (125862 -81702165)
2013,Abril,España,141,286,,427,POINT (3451668 -76532004)
2013,Abril,España,1532,4411,,5943,POINT (4697157 -74140516)
2013,Abril,España,0,8,,8,POINT (4815189 -75736374)
2013,Abril,España,46,162,,208,POINT (6170465 -7542726)
2013,Abril,España,0,1,,1,POINT (6185536 -67484028)
2013,Abril,España,1,2,,3,POINT (7088729 -70740253)
2013,Abril,España,2,4,,6,POINT (7128047 -73181317)
2013,Abril,España,15,37,,52,POINT (7819 -72453013)
2013,Abril,España,0,6,,6,POINT (7927233 -72508188)
2013,Abril,España,2,5,,7,POINT (863337 -7735002)
2013,Abril,Eslovaquia,2,1,,3,POINT (0.81488 -77356)
2013,Abril,Eslovaquia,0,1,,1,POINT (10886686 -74776479)
2013,Abril,Eslovaquia,12,12,,24,POINT (4697157 -74140516)
2013,Abril,Eslovaquia,0,1,,1,POINT (6170465 -7542726)
2013,Abril,Eslovaquia,0,1,,1,POINT (863337 -7735002)
2013,Abril,Eslovenia,0,1,,1,POINT (10406342 -75527794)
2013,Abril,Eslovenia,0,3,,3,POINT (10446304 -75516486)
2013,Abril,Eslovenia,0,1,,1,POINT (11360029 -72129595)
2013,Abril,Eslovenia,1,1,,2,POINT (1152863 -72919186)
2013,Abril,Eslovenia,0,1,,1,POINT (3451668 -76532004)
2013,Abril,Eslovenia,13,29,,42,POINT (4697157 -74140516)
2013,Abril,Estados Unidos de América,13,31,,44,POINT (-4191162 -69941498)
2013,Abril,Estados Unidos de América,50,81,,131,POINT (0.81488 -77356)
2013,Abril,Estados Unidos de América,0,1,,1,POINT (1800143 -78802679)
2013,Abril,Estados Unidos de América,5,30,,35,POINT (10406342 -75527794)
2013,Abril,Estados Unidos de América,3,14,,17,POINT (10433609 -73247863)
2013,Abril,Estados Unidos de América,874,1908,,2782,POINT (10446304 -75516486)
2013,Abril,Estados Unidos de América,203,427,,630,POINT (10886686 -74776479)
2013,Abril,Estados Unidos de América,1,7,,8,POINT (11247723 -74213989)
2013,Abril,Estados Unidos de América,8,12,,20,POINT (11360029 -72129595)
2013,Abril,Estados Unidos de América,0,2,,2,POINT (1152863 -72919186)
2013,Abril,Estados Unidos de América,16,27,,43,POINT (125862 -81702165)
2013,Abril,Estados Unidos de América,9,12,,21,POINT (133387613 -81372937)
2013,Abril,Estados Unidos de América,547,1002,,1549,POINT (3451668 -76532004)
2013,Abril,Estados Unidos de América,76,118,,194,POINT (445285 -75766353)
2013,Abril,Estados Unidos de América,4719,10066,,14785,POINT (4697157 -74140516)
2013,Abril,Estados Unidos de América,23,52,,75,POINT (4815189 -75736374)
2013,Abril,Estados Unidos de América,799,2326,,3125,POINT (6170465 -7542726)
2013,Abril,Estados Unidos de América,1,1,,2,POINT (6185536 -67484028)
2013,Abril,Estados Unidos de América,3,17,,20,POINT (7128047 -73181317)
2013,Abril,Estados Unidos de América,17,43,,60,POINT (7819 -72453013)
2013,Abril,Estados Unidos de América,5,16,,21,POINT (7927233 -72508188)
2013,Abril,Estados Unidos de América,4,20,,24,POINT (863337 -7735002)
2013,Abril,Estonia,3,5,,8,POINT (4697157 -74140516)
2013,Abril,Estonia,0,1,,1,POINT (863337 -7735002)
2013,Abril,Etiopia,2,5,,7,POINT (4697157 -74140516)
2013,Abril,Filipinas,0,1,,1,POINT (0.81488 -77356)
2013,Abril,Filipinas,0,14,,14,POINT (10406342 -75527794)
2013,Abril,Filipinas,0,14,,14,POINT (10446304 -75516486)
2013,Abril,Filipinas,0,1,,1,POINT (10886686 -74776479)
2013,Abril,Filipinas,1,10,,11,POINT (11247723 -74213989)
2013,Abril,Filipinas,2,0,,2,POINT (125862 -81702165)
2013,Abril,Filipinas,2,5,,7,POINT (3451668 -76532004)
2013,Abril,Filipinas,0,13,,13,POINT (3884426 -77061029)
2013,Abril,Filipinas,19,41,,60,POINT (4697157 -74140516)
2013,Abril,Filipinas,1,2,,3,POINT (6170465 -7542726)
2013,Abril,Filipinas,0,2,,2,POINT (9402597 -75681642)
2013,Abril,Finlandia,0,1,,1,POINT (-4191162 -69941498)
2013,Abril,Finlandia,3,3,,6,POINT (0.81488 -77356)
2013,Abril,Finlandia,1,1,,2,POINT (10406342 -75527794)
2013,Abril,Finlandia,1,4,,5,POINT (10446304 -75516486)
2013,Abril,Finlandia,0,2,,2,POINT (10886686 -74776479)
2013,Abril,Finlandia,1,3,,4,POINT (11360029 -72129595)
2013,Abril,Finlandia,0,2,,2,POINT (3451668 -76532004)
2013,Abril,Finlandia,34,82,,116,POINT (4697157 -74140516)
2013,Abril,Finlandia,0,1,,1,POINT (6170465 -7542726)
2013,Abril,Finlandia,1,3,,4,POINT (863337 -7735002)
2013,Abril,Francia,6,18,,24,POINT (-4191162 -69941498)
2013,Abril,Francia,1,1,,2,POINT (0.33002 -76876446)
2013,Abril,Francia,39,57,,96,POINT (0.81488 -77356)
2013,Abril,Francia,1,1,,2,POINT (1800143 -78802679)
2013,Abril,Francia,6,11,,17,POINT (10406342 -75527794)
2013,Abril,Francia,15,30,,45,POINT (10446304 -75516486)
2013,Abril,Francia,1,9,,10,POINT (10886686 -74776479)
2013,Abril,Francia,1,9,,10,POINT (11247723 -74213989)
2013,Abril,Francia,5,10,,15,POINT (11360029 -72129595)
2013,Abril,Francia,0,1,,1,POINT (1152863 -72919186)
2013,Abril,Francia,25,48,,73,POINT (3451668 -76532004)
2013,Abril,Francia,793,1599,,2392,POINT (4697157 -74140516)
2013,Abril,Francia,0,3,,3,POINT (4815189 -75736374)
2013,Abril,Francia,25,61,,86,POINT (6170465 -7542726)
2013,Abril,Francia,0,1,,1,POINT (7128047 -73181317)
2013,Abril,Francia,6,10,,16,POINT (7819 -72453013)
2013,Abril,Francia,0,2,,2,POINT (7927233 -72508188)
2013,Abril,Francia,1,4,,5,POINT (863337 -7735002)
2013,Abril,Gabón,0,2,,2,POINT (4697157 -74140516)
2013,Abril,Gambia,1,0,,1,POINT (4697157 -74140516)
2013,Abril,Georgia,1,0,,1,POINT (10446304 -75516486)
2013,Abril,Georgia,1,1,,2,POINT (4697157 -74140516)
2013,Abril,Ghana,1,0,,1,POINT (3451668 -76532004)
2013,Abril,Ghana,0,1,,1,POINT (4697157 -74140516)
2013,Abril,Granada,1,0,,1,POINT (10446304 -75516486)
2013,Abril,Grecia,1,0,,1,POINT (-4191162 -69941498)
2013,Abril,Grecia,1,3,,4,POINT (10446304 -75516486)
2013,Abril,Grecia,1,1,,2,POINT (11360029 -72129595)
2013,Abril,Grecia,2,1,,3,POINT (3451668 -76532004)
2013,Abril,Grecia,12,48,,60,POINT (4697157 -74140516)
2013,Abril,Grecia,0,4,,4,POINT (6170465 -7542726)
2013,Abril,Grecia,0,1,,1,POINT (7128047 -73181317)
2013,Abril,Grecia,1,3,,4,POINT (7819 -72453013)
2013,Abril,Guatemala,0,4,,4,POINT (0.81488 -77356)
2013,Abril,Guatemala,0,1,,1,POINT (10433609 -73247863)
2013,Abril,Guatemala,38,60,,98,POINT (10446304 -75516486)
2013,Abril,Guatemala,3,16,,19,POINT (10886686 -74776479)
2013,Abril,Guatemala,1,2,,3,POINT (11360029 -72129595)
2013,Abril,Guatemala,1,1,,2,POINT (125862 -81702165)
2013,Abril,Guatemala,22,69,,91,POINT (3451668 -76532004)
2013,Abril,Guatemala,156,418,,574,POINT (4697157 -74140516)
2013,Abril,Guatemala,1,3,,4,POINT (4815189 -75736374)
2013,Abril,Guatemala,23,74,,97,POINT (6170465 -7542726)
2013,Abril,Guatemala,1,1,,2,POINT (7128047 -73181317)
2013,Abril,Guatemala,5,6,,11,POINT (7819 -72453013)
2013,Abril,Guatemala,4,2,,6,POINT (7927233 -72508188)
2013,Abril,Guyana,0,1,,1,POINT (3451668 -76532004)
2013,Abril,Guyana,2,16,,18,POINT (4697157 -74140516)
2013,Abril,Guyana,1,3,,4,POINT (6170465 -7542726)
2013,Abril,Guinea Ecuatorial,1,0,,1,POINT (4697157 -74140516)
2013,Abril,Haití,0,1,,1,POINT (10446304 -75516486)
2013,Abril,Haití,0,1,,1,POINT (3451668 -76532004)
2013,Abril,Haití,4,9,,13,POINT (4697157 -74140516)
2013,Abril,Haití,2,3,,5,POINT (6170465 -7542726)
2013,Abril,Honduras,0,3,,3,POINT (0.81488 -77356)
2013,Abril,Honduras,20,55,,75,POINT (10446304 -75516486)
2013,Abril,Honduras,0,2,,2,POINT (10886686 -74776479)
2013,Abril,Honduras,2,5,,7,POINT (125862 -81702165)
2013,Abril,Honduras,18,15,,33,POINT (3451668 -76532004)
2013,Abril,Honduras,113,180,,293,POINT (4697157 -74140516)
2013,Abril,Honduras,1,0,,1,POINT (4815189 -75736374)
2013,Abril,Honduras,11,25,,36,POINT (6170465 -7542726)
2013,Abril,Honduras,2,1,,3,POINT (7128047 -73181317)
2013,Abril,Honduras,0,1,,1,POINT (806667 -767333)
2013,Abril,Hungría,0,1,,1,POINT (-4191162 -69941498)
2013,Abril,Hungría,1,2,,3,POINT (10406342 -75527794)
2013,Abril,Hungría,1,2,,3,POINT (10446304 -75516486)
2013,Abril,Hungría,0,1,,1,POINT (11360029 -72129595)
2013,Abril,Hungría,0,2,,2,POINT (3451668 -76532004)
2013,Abril,Hungría,15,31,,46,POINT (4697157 -74140516)
2013,Abril,Hungría,0,3,,3,POINT (6170465 -7542726)
2013,Abril,Hungría,2,0,,2,POINT (7819 -72453013)
2013,Abril,Hungría,1,0,,1,POINT (863337 -7735002)
2013,Abril,India,0,3,,3,POINT (0.81488 -77356)
2013,Abril,India,2,9,,11,POINT (10446304 -75516486)
2013,Abril,India,0,6,,6,POINT (10886686 -74776479)
2013,Abril,India,0,1,,1,POINT (125862 -81702165)
2013,Abril,India,0,11,,11,POINT (3451668 -76532004)
2013,Abril,India,0,1,,1,POINT (3884426 -77061029)
2013,Abril,India,32,243,,275,POINT (4697157 -74140516)
2013,Abril,India,4,26,,30,POINT (6170465 -7542726)
2013,Abril,Indonesia,16,18,,34,POINT (4697157 -74140516)
2013,Abril,Indonesia,0,5,,5,POINT (7819 -72453013)
2013,Abril,Iraq,0,2,,2,POINT (10446304 -75516486)
2013,Abril,Iraq,0,16,,16,POINT (4697157 -74140516)
2013,Abril,Irán,1,10,,11,POINT (4697157 -74140516)
2013,Abril,República de Irlanda,2,1,,3,POINT (-4191162 -69941498)
2013,Abril,República de Irlanda,16,9,,25,POINT (0.81488 -77356)
2013,Abril,República de Irlanda,0,2,,2,POINT (10406342 -75527794)
2013,Abril,República de Irlanda,9,14,,23,POINT (10446304 -75516486)
2013,Abril,República de Irlanda,0,1,,1,POINT (10886686 -74776479)
2013,Abril,República de Irlanda,3,2,,5,POINT (11360029 -72129595)
2013,Abril,República de Irlanda,0,2,,2,POINT (3451668 -76532004)
2013,Abril,República de Irlanda,59,86,,145,POINT (4697157 -74140516)
2013,Abril,República de Irlanda,1,13,,14,POINT (6170465 -7542726)
2013,Abril,República de Irlanda,0,2,,2,POINT (863337 -7735002)
2013,Abril,Islandia,0,1,,1,POINT (-4191162 -69941498)
2013,Abril,Islandia,2,2,,4,POINT (0.81488 -77356)
2013,Abril,Islandia,2,0,,2,POINT (10406342 -75527794)
2013,Abril,Islandia,1,0,,1,POINT (3451668 -76532004)
2013,Abril,Islandia,1,6,,7,POINT (4697157 -74140516)
2013,Abril,Islandia,0,1,,1,POINT (6170465 -7542726)
2013,Abril,Isla de Man,36,30,,66,POINT (0.81488 -77356)
2013,Abril,Isla de Man,1,3,,4,POINT (10446304 -75516486)
2013,Abril,Isla de Man,0,5,,5,POINT (10886686 -74776479)
2013,Abril,Isla de Man,3,7,,10,POINT (3451668 -76532004)
2013,Abril,Isla de Man,2,0,,2,POINT (445285 -75766353)
2013,Abril,Isla de Man,50,102,,152,POINT (4697157 -74140516)
2013,Abril,Isla de Man,18,39,,57,POINT (6170465 -7542726)
2013,Abril,Israel,0,1,,1,POINT (-4191162 -69941498)
2013,Abril,Israel,11,25,,36,POINT (0.81488 -77356)
2013,Abril,Israel,8,47,,55,POINT (10446304 -75516486)
2013,Abril,Israel,0,3,,3,POINT (10886686 -74776479)
2013,Abril,Israel,2,4,,6,POINT (125862 -81702165)
2013,Abril,Israel,3,16,,19,POINT (3451668 -76532004)
2013,Abril,Israel,111,574,,685,POINT (4697157 -74140516)
2013,Abril,Israel,16,78,,94,POINT (6170465 -7542726)
2013,Abril,Israel,0,1,,1,POINT (7927233 -72508188)
2013,Abril,Israel,1,1,,2,POINT (863337 -7735002)
2013,Abril,Italia,1,8,,9,POINT (-4191162 -69941498)
2013,Abril,Italia,0,2,,2,POINT (0.33002 -76876446)
2013,Abril,Italia,12,18,,30,POINT (0.81488 -77356)
2013,Abril,Italia,1,8,,9,POINT (10406342 -75527794)
2013,Abril,Italia,27,60,,87,POINT (10446304 -75516486)
2013,Abril,Italia,2,9,,11,POINT (10886686 -74776479)
2013,Abril,Italia,0,2,,2,POINT (11247723 -74213989)
2013,Abril,Italia,2,7,,9,POINT (11360029 -72129595)
2013,Abril,Italia,3,5,,8,POINT (125862 -81702165)
2013,Abril,Italia,16,70,,86,POINT (3451668 -76532004)
2013,Abril,Italia,351,1490,,1841,POINT (4697157 -74140516)
2013,Abril,Italia,0,5,,5,POINT (4815189 -75736374)
2013,Abril,Italia,21,90,,111,POINT (6170465 -7542726)
2013,Abril,Italia,0,2,,2,POINT (6185536 -67484028)
2013,Abril,Italia,0,3,,3,POINT (7128047 -73181317)
2013,Abril,Italia,5,22,,27,POINT (7819 -72453013)
2013,Abril,Italia,1,0,,1,POINT (7927233 -72508188)
2013,Abril,Italia,0,6,,6,POINT (863337 -7735002)
2013,Abril,Islas del Canal,1,0,,1,POINT (4697157 -74140516)
2013,Abril,Jamaica,0,2,,2,POINT (0.81488 -77356)
2013,Abril,Jamaica,0,2,,2,POINT (10446304 -75516486)
2013,Abril,Jamaica,0,4,,4,POINT (10886686 -74776479)
2013,Abril,Jamaica,1,0,,1,POINT (11360029 -72129595)
2013,Abril,Jamaica,1,1,,2,POINT (3451668 -76532004)
2013,Abril,Jamaica,8,15,,23,POINT (4697157 -74140516)
2013,Abril,Jamaica,1,0,,1,POINT (4815189 -75736374)
2013,Abril,Jamaica,2,4,,6,POINT (6170465 -7542726)
2013,Abril,Jamaica,0,1,,1,POINT (7819 -72453013)
2013,Abril,Japón,1,1,,2,POINT (-4191162 -69941498)
2013,Abril,Japón,0,1,,1,POINT (0.33002 -76876446)
2013,Abril,Japón,23,30,,53,POINT (0.81488 -77356)
2013,Abril,Japón,0,1,,1,POINT (10406342 -75527794)
2013,Abril,Japón,3,23,,26,POINT (10446304 -75516486)
2013,Abril,Japón,0,3,,3,POINT (10886686 -74776479)
2013,Abril,Japón,1,0,,1,POINT (125862 -81702165)
2013,Abril,Japón,2,14,,16,POINT (3451668 -76532004)
2013,Abril,Japón,88,431,,519,POINT (4697157 -74140516)
2013,Abril,Japón,0,1,,1,POINT (4815189 -75736374)
2013,Abril,Japón,6,18,,24,POINT (6170465 -7542726)
2013,Abril,Japón,0,2,,2,POINT (7819 -72453013)
2013,Abril,Jordania,1,0,,1,POINT (10446304 -75516486)
2013,Abril,Jordania,2,3,,5,POINT (4697157 -74140516)
2013,Abril,Kenia,2,0,,2,POINT (3451668 -76532004)
2013,Abril,Kenia,0,6,,6,POINT (4697157 -74140516)
2013,Abril,Kuwait,0,1,,1,POINT (4697157 -74140516)
2013,Abril,Lesoto,1,2,,3,POINT (4697157 -74140516)
2013,Abril,Letonia,4,1,,5,POINT (0.81488 -77356)
2013,Abril,Letonia,1,0,,1,POINT (10446304 -75516486)
2013,Abril,Letonia,0,1,,1,POINT (11247723 -74213989)
2013,Abril,Letonia,6,13,,19,POINT (4697157 -74140516)
2013,Abril,Lituania,1,1,,2,POINT (0.81488 -77356)
2013,Abril,Lituania,0,3,,3,POINT (10406342 -75527794)
2013,Abril,Lituania,2,2,,4,POINT (10446304 -75516486)
2013,Abril,Lituania,1,0,,1,POINT (10886686 -74776479)
2013,Abril,Lituania,13,5,,18,POINT (4697157 -74140516)
2013,Abril,Líbano,0,1,,1,POINT (0.81488 -77356)
2013,Abril,Líbano,0,2,,2,POINT (10446304 -75516486)
2013,Abril,Líbano,1,1,,2,POINT (10886686 -74776479)
2013,Abril,Líbano,3,4,,7,POINT (11360029 -72129595)
2013,Abril,Líbano,0,1,,1,POINT (3451668 -76532004)
2013,Abril,Líbano,11,21,,32,POINT (4697157 -74140516)
2013,Abril,Líbano,2,2,,4,POINT (6170465 -7542726)
2013,Abril,Liberia,0,1,,1,POINT (4697157 -74140516)
2013,Abril,Libia,1,0,,1,POINT (4697157 -74140516)
2013,Abril,Luxemburgo,2,1,,3,POINT (0.81488 -77356)
2013,Abril,Luxemburgo,0,1,,1,POINT (10446304 -75516486)
2013,Abril,Luxemburgo,3,13,,16,POINT (4697157 -74140516)
2013,Abril,Macedonia,1,2,,3,POINT (4697157 -74140516)
2013,Abril,Madagascar,2,1,,3,POINT (4697157 -74140516)
2013,Abril,Malasia,2,3,,5,POINT (10446304 -75516486)
2013,Abril,Malasia,0,1,,1,POINT (11247723 -74213989)
2013,Abril,Malasia,0,1,,1,POINT (3451668 -76532004)
2013,Abril,Malasia,6,24,,30,POINT (4697157 -74140516)
2013,Abril,Malasia,2,6,,8,POINT (6170465 -7542726)
2013,Abril,Malta,1,5,,6,POINT (4697157 -74140516)
2013,Abril,Marruecos,0,1,,1,POINT (3451668 -76532004)
2013,Abril,Marruecos,2,14,,16,POINT (4697157 -74140516)
2013,Abril,Marruecos,0,1,,1,POINT (6170465 -7542726)
2013,Abril,Mauricio,0,1,,1,POINT (6170465 -7542726)
2013,Abril,Mauritania,0,1,,1,POINT (4697157 -74140516)
2013,Abril,México,0,1,,1,POINT (-4191162 -69941498)
2013,Abril,México,12,16,,28,POINT (0.81488 -77356)
2013,Abril,México,1,2,,3,POINT (10406342 -75527794)
2013,Abril,México,3,33,,36,POINT (10433609 -73247863)
2013,Abril,México,83,202,,285,POINT (10446304 -75516486)
2013,Abril,México,18,35,,53,POINT (10886686 -74776479)
2013,Abril,México,1,4,,5,POINT (11360029 -72129595)
2013,Abril,México,1,0,,1,POINT (125862 -81702165)
2013,Abril,México,43,164,,207,POINT (3451668 -76532004)
2013,Abril,México,0,1,,1,POINT (445285 -75766353)
2013,Abril,México,1610,4021,,5631,POINT (4697157 -74140516)
2013,Abril,México,8,10,,18,POINT (4815189 -75736374)
2013,Abril,México,108,316,,424,POINT (6170465 -7542726)
2013,Abril,México,0,1,,1,POINT (6185536 -67484028)
2013,Abril,México,1,0,,1,POINT (7088729 -70740253)
2013,Abril,México,3,6,,9,POINT (7128047 -73181317)
2013,Abril,México,13,23,,36,POINT (7819 -72453013)
2013,Abril,México,3,9,,12,POINT (7927233 -72508188)
2013,Abril,México,1,3,,4,POINT (863337 -7735002)
2013,Abril,República de Moldavia,1,1,,2,POINT (4697157 -74140516)
2013,Abril,Montenegro,1,1,,2,POINT (4697157 -74140516)
2013,Abril,Mozambique,2,4,,6,POINT (4697157 -74140516)
2013,Abril,Myanmar,0,1,,1,POINT (11247723 -74213989)
2013,Abril,Myanmar,0,1,,1,POINT (4697157 -74140516)
2013,Abril,Namibia,1,1,,2,POINT (4697157 -74140516)
2013,Abril,Nepal,0,1,,1,POINT (0.81488 -77356)
2013,Abril,Nicaragua,0,1,,1,POINT (0.81488 -77356)
2013,Abril,Nicaragua,1,4,,5,POINT (10446304 -75516486)
2013,Abril,Nicaragua,0,2,,2,POINT (10886686 -74776479)
2013,Abril,Nicaragua,3,1,,4,POINT (125862 -81702165)
2013,Abril,Nicaragua,8,7,,15,POINT (3451668 -76532004)
2013,Abril,Nicaragua,37,63,,100,POINT (4697157 -74140516)
2013,Abril,Nicaragua,4,7,,11,POINT (6170465 -7542726)
2013,Abril,Nigeria,0,1,,1,POINT (3451668 -76532004)
2013,Abril,Nigeria,2,10,,12,POINT (4697157 -74140516)
2013,Abril,Noruega,1,1,,2,POINT (-4191162 -69941498)
2013,Abril,Noruega,9,7,,16,POINT (0.81488 -77356)
2013,Abril,Noruega,0,3,,3,POINT (10406342 -75527794)
2013,Abril,Noruega,4,7,,11,POINT (10446304 -75516486)
2013,Abril,Noruega,1,0,,1,POINT (10886686 -74776479)
2013,Abril,Noruega,2,7,,9,POINT (3451668 -76532004)
2013,Abril,Noruega,56,106,,162,POINT (4697157 -74140516)
2013,Abril,Noruega,4,13,,17,POINT (6170465 -7542726)
2013,Abril,Noruega,1,1,,2,POINT (7128047 -73181317)
2013,Abril,Noruega,0,1,,1,POINT (7819 -72453013)
2013,Abril,Noruega,0,1,,1,POINT (863337 -7735002)
2013,Abril,Nueva Zelanda,0,4,,4,POINT (-4191162 -69941498)
2013,Abril,Nueva Zelanda,11,5,,16,POINT (0.81488 -77356)
2013,Abril,Nueva Zelanda,6,5,,11,POINT (10446304 -75516486)
2013,Abril,Nueva Zelanda,0,1,,1,POINT (10886686 -74776479)
2013,Abril,Nueva Zelanda,2,2,,4,POINT (11360029 -72129595)
2013,Abril,Nueva Zelanda,3,1,,4,POINT (3451668 -76532004)
2013,Abril,Nueva Zelanda,31,41,,72,POINT (4697157 -74140516)
2013,Abril,Nueva Zelanda,4,10,,14,POINT (6170465 -7542726)
2013,Abril,Nueva Zelanda,1,0,,1,POINT (7819 -72453013)
2013,Abril,Nueva Zelanda,1,2,,3,POINT (863337 -7735002)
2013,Abril,Nueva Zelanda,0,3,,3,POINT (0.81488 -77356)
2013,Abril,Nueva Zelanda,2,3,,5,POINT (10406342 -75527794)
2013,Abril,Nueva Zelanda,2,5,,7,POINT (4697157 -74140516)
2013,Abril,Países Bajos,5,10,,15,POINT (0.81488 -77356)
2013,Abril,Países Bajos,1,8,,9,POINT (10446304 -75516486)
2013,Abril,Países Bajos,5,13,,18,POINT (10886686 -74776479)
2013,Abril,Países Bajos,3,5,,8,POINT (11360029 -72129595)
2013,Abril,Países Bajos,28,37,,65,POINT (1152863 -72919186)
2013,Abril,Países Bajos,9,16,,25,POINT (3451668 -76532004)
2013,Abril,Países Bajos,15,15,,30,POINT (445285 -75766353)
2013,Abril,Países Bajos,153,250,,403,POINT (4697157 -74140516)
2013,Abril,Países Bajos,0,3,,3,POINT (4815189 -75736374)
2013,Abril,Países Bajos,263,302,,565,POINT (6170465 -7542726)
2013,Abril,Países Bajos,5,3,,8,POINT (7128047 -73181317)
2013,Abril,Países Bajos,1,0,,1,POINT (7819 -72453013)
2013,Abril,Pakistán,0,2,,2,POINT (0.81488 -77356)
2013,Abril,Pakistán,0,1,,1,POINT (3451668 -76532004)
2013,Abril,Pakistán,1,4,,5,POINT (4697157 -74140516)
2013,Abril,Palau,0,1,,1,POINT (4697157 -74140516)
2013,Abril,Panamá,0,1,,1,POINT (0.33002 -76876446)
2013,Abril,Panamá,1,0,,1,POINT (10406342 -75527794)
2013,Abril,Panamá,130,172,,302,POINT (10446304 -75516486)
2013,Abril,Panamá,46,79,,125,POINT (10886686 -74776479)
2013,Abril,Panamá,0,1,,1,POINT (11360029 -72129595)
2013,Abril,Panamá,29,29,,58,POINT (125862 -81702165)
2013,Abril,Panamá,87,157,,244,POINT (3451668 -76532004)
2013,Abril,Panamá,534,803,,1337,POINT (4697157 -74140516)
2013,Abril,Panamá,70,109,,179,POINT (4815189 -75736374)
2013,Abril,Panamá,115,236,,351,POINT (6170465 -7542726)
2013,Abril,Panamá,2,0,,2,POINT (6222552 -77401154)
2013,Abril,Panamá,4,11,,15,POINT (7128047 -73181317)
2013,Abril,Panamá,1,4,,5,POINT (7819 -72453013)
2013,Abril,Panamá,4,9,,13,POINT (7927233 -72508188)
2013,Abril,Panamá,1,6,,7,POINT (863337 -7735002)
2013,Abril,Paraguay,1,1,,2,POINT (0.81488 -77356)
2013,Abril,Paraguay,40,19,,59,POINT (10446304 -75516486)
2013,Abril,Paraguay,3,2,,5,POINT (10886686 -74776479)
2013,Abril,Paraguay,6,4,,10,POINT (125862 -81702165)
2013,Abril,Paraguay,3,5,,8,POINT (3451668 -76532004)
2013,Abril,Paraguay,73,130,,203,POINT (4697157 -74140516)
2013,Abril,Paraguay,5,11,,16,POINT (6170465 -7542726)
2013,Abril,Paraguay,0,1,,1,POINT (7128047 -73181317)
2013,Abril,Perú,16,20,,36,POINT (-4191162 -69941498)
2013,Abril,Perú,1,2,,3,POINT (0.33002 -76876446)
2013,Abril,Perú,107,294,,401,POINT (0.81488 -77356)
2013,Abril,Perú,0,3,,3,POINT (10406342 -75527794)
2013,Abril,Perú,160,203,,363,POINT (10446304 -75516486)
2013,Abril,Perú,3,17,,20,POINT (10886686 -74776479)
2013,Abril,Perú,3,15,,18,POINT (11360029 -72129595)
2013,Abril,Perú,78,56,,134,POINT (125862 -81702165)
2013,Abril,Perú,75,165,,240,POINT (3451668 -76532004)
2013,Abril,Perú,0,1,,1,POINT (445285 -75766353)
2013,Abril,Perú,2871,3834,,6705,POINT (4697157 -74140516)
2013,Abril,Perú,5,7,,12,POINT (4815189 -75736374)
2013,Abril,Perú,151,339,,490,POINT (6170465 -7542726)
2013,Abril,Perú,1,0,,1,POINT (6185536 -67484028)
2013,Abril,Perú,1,4,,5,POINT (7128047 -73181317)
2013,Abril,Perú,39,45,,84,POINT (7819 -72453013)
2013,Abril,Perú,0,3,,3,POINT (7927233 -72508188)
2013,Abril,Palestina,2,0,,2,POINT (0.81488 -77356)
2013,Abril,Palestina,2,2,,4,POINT (4697157 -74140516)
2013,Abril,Polonia,1,1,,2,POINT (-4191162 -69941498)
2013,Abril,Polonia,2,5,,7,POINT (0.81488 -77356)
2013,Abril,Polonia,1,6,,7,POINT (10406342 -75527794)
2013,Abril,Polonia,4,2,,6,POINT (10446304 -75516486)
2013,Abril,Polonia,0,1,,1,POINT (10886686 -74776479)
2013,Abril,Polonia,0,14,,14,POINT (11247723 -74213989)
2013,Abril,Polonia,1,2,,3,POINT (11360029 -72129595)
2013,Abril,Polonia,1,2,,3,POINT (3451668 -76532004)
2013,Abril,Polonia,58,108,,166,POINT (4697157 -74140516)
2013,Abril,Polonia,1,0,,1,POINT (4815189 -75736374)
2013,Abril,Polonia,0,3,,3,POINT (6170465 -7542726)
2013,Abril,Polonia,0,2,,2,POINT (7819 -72453013)
2013,Abril,Polonia,2,0,,2,POINT (863337 -7735002)
2013,Abril,Portugal,0,1,,1,POINT (-4191162 -69941498)
2013,Abril,Portugal,1,0,,1,POINT (0.33002 -76876446)
2013,Abril,Portugal,2,6,,8,POINT (0.81488 -77356)
2013,Abril,Portugal,1,1,,2,POINT (10406342 -75527794)
2013,Abril,Portugal,2,8,,10,POINT (10446304 -75516486)
2013,Abril,Portugal,0,1,,1,POINT (10886686 -74776479)
2013,Abril,Portugal,2,1,,3,POINT (125862 -81702165)
2013,Abril,Portugal,3,17,,20,POINT (3451668 -76532004)
2013,Abril,Portugal,124,406,,530,POINT (4697157 -74140516)
2013,Abril,Portugal,5,14,,19,POINT (6170465 -7542726)
2013,Abril,Portugal,1,4,,5,POINT (7819 -72453013)
2013,Abril,Portugal,1,1,,2,POINT (863337 -7735002)
2013,Abril,Puerto Rico/Territorio de Estados Unidos,0,1,,1,POINT (3451668 -76532004)
2013,Abril,Puerto Rico/Territorio de Estados Unidos,0,1,,1,POINT (6170465 -7542726)
2013,Abril,Qatar,0,2,,2,POINT (4697157 -74140516)
2013,Abril,Reino Unido de Gran Bretaña e Irlanda del Norte,5,6,,11,POINT (-4191162 -69941498)
2013,Abril,Reino Unido de Gran Bretaña e Irlanda del Norte,5,4,,9,POINT (0.81488 -77356)
2013,Abril,Reino Unido de Gran Bretaña e Irlanda del Norte,27,44,,71,POINT (10446304 -75516486)
2013,Abril,Reino Unido de Gran Bretaña e Irlanda del Norte,1,0,,1,POINT (10886686 -74776479)
2013,Abril,Reino Unido de Gran Bretaña e Irlanda del Norte,1,4,,5,POINT (11360029 -72129595)
2013,Abril,Reino Unido de Gran Bretaña e Irlanda del Norte,0,1,,1,POINT (125862 -81702165)
2013,Abril,Reino Unido de Gran Bretaña e Irlanda del Norte,3,13,,16,POINT (3451668 -76532004)
2013,Abril,Reino Unido de Gran Bretaña e Irlanda del Norte,1,0,,1,POINT (445285 -75766353)
2013,Abril,Reino Unido de Gran Bretaña e Irlanda del Norte,209,509,,718,POINT (4697157 -74140516)
2013,Abril,Reino Unido de Gran Bretaña e Irlanda del Norte,5,18,,23,POINT (6170465 -7542726)
2013,Abril,Reino Unido de Gran Bretaña e Irlanda del Norte,6,9,,15,POINT (7819 -72453013)
2013,Abril,República de Belarús,0,1,,1,POINT (4697157 -74140516)
2013,Abril,República Dominicana,1,9,,10,POINT (0.81488 -77356)
2013,Abril,República Dominicana,0,3,,3,POINT (10406342 -75527794)
2013,Abril,República Dominicana,23,24,,47,POINT (10446304 -75516486)
2013,Abril,República Dominicana,14,49,,63,POINT (10886686 -74776479)
2013,Abril,República Dominicana,0,2,,2,POINT (11360029 -72129595)
2013,Abril,República Dominicana,1,1,,2,POINT (125862 -81702165)
2013,Abril,República Dominicana,13,24,,37,POINT (3451668 -76532004)
2013,Abril,República Dominicana,0,2,,2,POINT (445285 -75766353)
2013,Abril,República Dominicana,201,337,,538,POINT (4697157 -74140516)
2013,Abril,República Dominicana,0,2,,2,POINT (4815189 -75736374)
2013,Abril,República Dominicana,50,45,,95,POINT (6170465 -7542726)
2013,Abril,República Dominicana,1,2,,3,POINT (7128047 -73181317)
2013,Abril,República Dominicana,4,4,,8,POINT (7819 -72453013)
2013,Abril,República Dominicana,0,3,,3,POINT (7927233 -72508188)
2013,Abril,República Checa,1,2,,3,POINT (4697157 -74140516)
2013,Abril,Rumania,1,0,,1,POINT (0.81488 -77356)
2013,Abril,Rumania,0,1,,1,POINT (10406342 -75527794)
2013,Abril,Rumania,0,2,,2,POINT (10446304 -75516486)
2013,Abril,Rumania,0,1,,1,POINT (10886686 -74776479)
2013,Abril,Rumania,3,2,,5,POINT (11360029 -72129595)
2013,Abril,Rumania,1,8,,9,POINT (3451668 -76532004)
2013,Abril,Rumania,22,66,,88,POINT (4697157 -74140516)
2013,Abril,Rumania,0,1,,1,POINT (7819 -72453013)
2013,Abril,Rumania,0,1,,1,POINT (9402597 -75681642)
2013,Abril,Federación de Rusia,2,5,,7,POINT (0.81488 -77356)
2013,Abril,Federación de Rusia,6,3,,9,POINT (10446304 -75516486)
2013,Abril,Federación de Rusia,0,1,,1,POINT (10886686 -74776479)
2013,Abril,Federación de Rusia,0,1,,1,POINT (11247723 -74213989)
2013,Abril,Federación de Rusia,0,1,,1,POINT (11360029 -72129595)
2013,Abril,Federación de Rusia,2,0,,2,POINT (3451668 -76532004)
2013,Abril,Federación de Rusia,18,28,,46,POINT (4697157 -74140516)
2013,Abril,Federación de Rusia,1,2,,3,POINT (6170465 -7542726)
2013,Abril,Federación de Rusia,1,0,,1,POINT (7819 -72453013)
2013,Abril,Federación de Rusia,0,1,,1,POINT (9402597 -75681642)
2013,Abril,San Cristóbal y Nevis,0,1,,1,POINT (125862 -81702165)
2013,Abril,San  Vicente y las Granadinas,1,0,,1,POINT (3451668 -76532004)
2013,Abril,San  Vicente y las Granadinas,0,1,,1,POINT (4697157 -74140516)
2013,Abril,San  Vicente y las Granadinas,0,1,,1,POINT (6170465 -7542726)
2013,Abril,Santa Lucia,2,1,,3,POINT (10446304 -75516486)
2013,Abril,Santa Lucia,1,1,,2,POINT (7128047 -73181317)
2013,Abril,Santa Lucia,0,1,,1,POINT (7927233 -72508188)
2013,Abril,Senegal,0,2,,2,POINT (4697157 -74140516)
2013,Abril,Serbia,1,0,,1,POINT (0.81488 -77356)
2013,Abril,Serbia,0,1,,1,POINT (10446304 -75516486)
2013,Abril,Serbia,1,1,,2,POINT (125862 -81702165)
2013,Abril,Serbia,2,4,,6,POINT (4697157 -74140516)
2013,Abril,Serbia,1,0,,1,POINT (6170465 -7542726)
2013,Abril,Singapur,1,0,,1,POINT (0.81488 -77356)
2013,Abril,Singapur,0,1,,1,POINT (10446304 -75516486)
2013,Abril,Singapur,0,1,,1,POINT (10886686 -74776479)
2013,Abril,Singapur,5,11,,16,POINT (4697157 -74140516)
2013,Abril,Singapur,2,0,,2,POINT (6170465 -7542726)
2013,Abril,República Árabe Siria,0,1,,1,POINT (4697157 -74140516)
2013,Abril,Sri Lanka,2,1,,3,POINT (4697157 -74140516)
2013,Abril,Sudáfrica,3,4,,7,POINT (0.81488 -77356)
2013,Abril,Sudáfrica,0,1,,1,POINT (10406342 -75527794)
2013,Abril,Sudáfrica,3,12,,15,POINT (10446304 -75516486)
2013,Abril,Sudáfrica,2,2,,4,POINT (10886686 -74776479)
2013,Abril,Sudáfrica,0,2,,2,POINT (11360029 -72129595)
2013,Abril,Sudáfrica,1,1,,2,POINT (3451668 -76532004)
2013,Abril,Sudáfrica,41,136,,177,POINT (4697157 -74140516)
2013,Abril,Sudáfrica,2,3,,5,POINT (6170465 -7542726)
2013,Abril,Sudáfrica,1,1,,2,POINT (863337 -7735002)
2013,Abril,Suecia,1,7,,8,POINT (-4191162 -69941498)
2013,Abril,Suecia,0,1,,1,POINT (0.33002 -76876446)
2013,Abril,Suecia,20,12,,32,POINT (0.81488 -77356)
2013,Abril,Suecia,1,0,,1,POINT (1800143 -78802679)
2013,Abril,Suecia,3,4,,7,POINT (10406342 -75527794)
2013,Abril,Suecia,6,6,,12,POINT (10446304 -75516486)
2013,Abril,Suecia,2,2,,4,POINT (11360029 -72129595)
2013,Abril,Suecia,2,13,,15,POINT (3451668 -76532004)
2013,Abril,Suecia,109,178,,287,POINT (4697157 -74140516)
2013,Abril,Suecia,0,1,,1,POINT (4815189 -75736374)
2013,Abril,Suecia,3,14,,17,POINT (6170465 -7542726)
2013,Abril,Suecia,0,3,,3,POINT (7819 -72453013)
2013,Abril,Suiza,4,3,,7,POINT (-4191162 -69941498)
2013,Abril,Suiza,2,1,,3,POINT (0.33002 -76876446)
2013,Abril,Suiza,19,30,,49,POINT (0.81488 -77356)
2013,Abril,Suiza,5,10,,15,POINT (10406342 -75527794)
2013,Abril,Suiza,10,17,,27,POINT (10446304 -75516486)
2013,Abril,Suiza,0,2,,2,POINT (10886686 -74776479)
2013,Abril,Suiza,2,2,,4,POINT (11247723 -74213989)
2013,Abril,Suiza,0,5,,5,POINT (11360029 -72129595)
2013,Abril,Suiza,3,3,,6,POINT (125862 -81702165)
2013,Abril,Suiza,14,28,,42,POINT (3451668 -76532004)
2013,Abril,Suiza,1,0,,1,POINT (445285 -75766353)
2013,Abril,Suiza,235,408,,643,POINT (4697157 -74140516)
2013,Abril,Suiza,16,32,,48,POINT (6170465 -7542726)
2013,Abril,Suiza,0,2,,2,POINT (7819 -72453013)
2013,Abril,Suiza,1,2,,3,POINT (863337 -7735002)
2013,Abril,Surinam,0,2,,2,POINT (10406342 -75527794)
2013,Abril,Surinam,0,1,,1,POINT (10446304 -75516486)
2013,Abril,Surinam,9,14,,23,POINT (4697157 -74140516)
2013,Abril,Surinam,8,17,,25,POINT (6170465 -7542726)
2013,Abril,Suazilandia,1,0,,1,POINT (4697157 -74140516)
2013,Abril,Taiwán,0,1,,1,POINT (10886686 -74776479)
2013,Abril,Taiwán,3,3,,6,POINT (4697157 -74140516)
2013,Abril,Taiwán,0,1,,1,POINT (6170465 -7542726)
2013,Abril,Taiwán,1,0,,1,POINT (7927233 -72508188)
2013,Abril,Tailandia,0,1,,1,POINT (10886686 -74776479)
2013,Abril,Tailandia,4,9,,13,POINT (4697157 -74140516)
2013,Abril,Tíbet/Región Autónoma de China,1,4,,5,POINT (4697157 -74140516)
2013,Abril,Territorio Antártico Británico/Territorio Británico de Ultramar,0,2,,2,POINT (0.81488 -77356)
2013,Abril,Territorio Antártico Británico/Territorio Británico de Ultramar,0,7,,7,POINT (4697157 -74140516)
2013,Abril,Tanzania,0,2,,2,POINT (4697157 -74140516)
2013,Abril,Trinidad y Tobago,2,9,,11,POINT (10446304 -75516486)
2013,Abril,Trinidad y Tobago,0,1,,1,POINT (10886686 -74776479)
2013,Abril,Trinidad y Tobago,0,1,,1,POINT (11360029 -72129595)
2013,Abril,Trinidad y Tobago,0,8,,8,POINT (3451668 -76532004)
2013,Abril,Trinidad y Tobago,12,45,,57,POINT (4697157 -74140516)
2013,Abril,Trinidad y Tobago,1,0,,1,POINT (4815189 -75736374)
2013,Abril,Trinidad y Tobago,2,7,,9,POINT (6170465 -7542726)
2013,Abril,Trinidad y Tobago,0,1,,1,POINT (7128047 -73181317)
2013,Abril,Trinidad y Tobago,0,2,,2,POINT (7819 -72453013)
2013,Abril,Trinidad y Tobago,0,1,,1,POINT (863337 -7735002)
2013,Abril,Túnez,1,2,,3,POINT (4697157 -74140516)
2013,Abril,Túnez,0,1,,1,POINT (6170465 -7542726)
2013,Abril,Turquía,1,0,,1,POINT (-4191162 -69941498)
2013,Abril,Turquía,0,2,,2,POINT (0.81488 -77356)
2013,Abril,Turquía,5,7,,12,POINT (10446304 -75516486)
2013,Abril,Turquía,1,0,,1,POINT (3451668 -76532004)
2013,Abril,Turquía,23,65,,88,POINT (4697157 -74140516)
2013,Abril,Turquía,2,6,,8,POINT (6170465 -7542726)
2013,Abril,Turquía,0,2,,2,POINT (7819 -72453013)
2013,Abril,Turquía,0,1,,1,POINT (863337 -7735002)
2013,Abril,Ucrania,1,3,,4,POINT (0.81488 -77356)
2013,Abril,Ucrania,1,0,,1,POINT (3451668 -76532004)
2013,Abril,Ucrania,18,26,,44,POINT (4697157 -74140516)
2013,Abril,Uganda,0,1,,1,POINT (3451668 -76532004)
2013,Abril,Uganda,0,2,,2,POINT (4697157 -74140516)
2013,Abril,Federación de Rusia,0,1,,1,POINT (-4191162 -69941498)
2013,Abril,Federación de Rusia,1,2,,3,POINT (0.81488 -77356)
2013,Abril,Federación de Rusia,0,1,,1,POINT (10406342 -75527794)
2013,Abril,Federación de Rusia,4,1,,5,POINT (10446304 -75516486)
2013,Abril,Federación de Rusia,0,1,,1,POINT (3451668 -76532004)
2013,Abril,Federación de Rusia,119,202,,321,POINT (4697157 -74140516)
2013,Abril,Federación de Rusia,2,2,,4,POINT (6170465 -7542726)
2013,Abril,Federación de Rusia,3,2,,5,POINT (7819 -72453013)
2013,Abril,Federación de Rusia,0,18,,18,POINT (9402597 -75681642)
2013,Abril,Uruguay,0,1,,1,POINT (-4191162 -69941498)
2013,Abril,Uruguay,3,9,,12,POINT (0.81488 -77356)
2013,Abril,Uruguay,83,63,,146,POINT (10446304 -75516486)
2013,Abril,Uruguay,1,6,,7,POINT (10886686 -74776479)
2013,Abril,Uruguay,0,3,,3,POINT (11360029 -72129595)
2013,Abril,Uruguay,42,31,,73,POINT (125862 -81702165)
2013,Abril,Uruguay,9,17,,26,POINT (3451668 -76532004)
2013,Abril,Uruguay,151,313,,464,POINT (4697157 -74140516)
2013,Abril,Uruguay,1,3,,4,POINT (4815189 -75736374)
2013,Abril,Uruguay,16,27,,43,POINT (6170465 -7542726)
2013,Abril,Uruguay,7,9,,16,POINT (7819 -72453013)
2013,Abril,Venezuela,1,3,,4,POINT (0.33002 -76876446)
2013,Abril,Venezuela,41,71,,112,POINT (0.81488 -77356)
2013,Abril,Venezuela,2,3,,5,POINT (10406342 -75527794)
2013,Abril,Venezuela,5,24,,29,POINT (10433609 -73247863)
2013,Abril,Venezuela,84,112,,196,POINT (10446304 -75516486)
2013,Abril,Venezuela,33,57,,90,POINT (10886686 -74776479)
2013,Abril,Venezuela,947,1321,,2268,POINT (11360029 -72129595)
2013,Abril,Venezuela,2,2,,4,POINT (1152863 -72919186)
2013,Abril,Venezuela,8,7,,15,POINT (125862 -81702165)
2013,Abril,Venezuela,52,79,,131,POINT (3451668 -76532004)
2013,Abril,Venezuela,4657,6221,,10878,POINT (4697157 -74140516)
2013,Abril,Venezuela,3,19,,22,POINT (4815189 -75736374)
2013,Abril,Venezuela,237,342,,579,POINT (6170465 -7542726)
2013,Abril,Venezuela,120,225,,345,POINT (6185536 -67484028)
2013,Abril,Venezuela,27,60,,87,POINT (7088729 -70740253)
2013,Abril,Venezuela,5,5,,10,POINT (7128047 -73181317)
2013,Abril,Venezuela,788,1014,,1802,POINT (7819 -72453013)
2013,Abril,Venezuela,119,132,,251,POINT (7927233 -72508188)
2013,Abril,Venezuela,0,1,,1,POINT (863337 -7735002)
2013,Abril,Vietnam,2,3,,5,POINT (4697157 -74140516)
2013,Abril,Islas Vírgenes Británicas/Territorio Británico de Ultramar,0,1,,1,POINT (3451668 -76532004)
2013,Abril,República Árabe de Yemen,1,0,,1,POINT (4697157 -74140516)
2013,Abril,República Árabe de Yemen,0,1,,1,POINT (6170465 -7542726)
2013,Abril,Yugoslavia,1,0,,1,POINT (4697157 -74140516)
2013,Abril,Zambia,4,3,,7,POINT (4697157 -74140516)
2013,Abril,Zimbabue,0,5,,5,POINT (4697157 -74140516)
2013,Abril,Reino Unido de Gran Bretaña e Irlanda del Norte,4,5,,9,POINT (-4191162 -69941498)
2013,Abril,Reino Unido de Gran Bretaña e Irlanda del Norte,36,47,,83,POINT (0.81488 -77356)
2013,Abril,Reino Unido de Gran Bretaña e Irlanda del Norte,13,9,,22,POINT (10406342 -75527794)
2013,Abril,Reino Unido de Gran Bretaña e Irlanda del Norte,8,21,,29,POINT (10446304 -75516486)
2013,Abril,Reino Unido de Gran Bretaña e Irlanda del Norte,0,2,,2,POINT (10886686 -74776479)
2013,Abril,Reino Unido de Gran Bretaña e Irlanda del Norte,0,1,,1,POINT (11247723 -74213989)
2013,Abril,Reino Unido de Gran Bretaña e Irlanda del Norte,5,15,,20,POINT (11360029 -72129595)
2013,Abril,Reino Unido de Gran Bretaña e Irlanda del Norte,0,1,,1,POINT (125862 -81702165)
2013,Abril,Reino Unido de Gran Bretaña e Irlanda del Norte,0,2,,2,POINT (133387613 -81372937)
2013,Abril,Reino Unido de Gran Bretaña e Irlanda del Norte,4,22,,26,POINT (3451668 -76532004)
2013,Abril,Reino Unido de Gran Bretaña e Irlanda del Norte,219,588,,807,POINT (4697157 -74140516)
2013,Abril,Reino Unido de Gran Bretaña e Irlanda del Norte,8,34,,42,POINT (6170465 -7542726)
2013,Abril,Reino Unido de Gran Bretaña e Irlanda del Norte,5,8,,13,POINT (7819 -72453013)
2013,Abril,Reino Unido de Gran Bretaña e Irlanda del Norte,1,0,,1,POINT (7927233 -72508188)
2013,Abril,Reino Unido de Gran Bretaña e Irlanda del Norte,2,4,,6,POINT (863337 -7735002)
2013,Abril,Países Bajos,1,3,,4,POINT (-4191162 -69941498)
2013,Abril,Países Bajos,20,13,,33,POINT (0.81488 -77356)
2013,Abril,Países Bajos,5,15,,20,POINT (10406342 -75527794)
2013,Abril,Países Bajos,13,39,,52,POINT (10446304 -75516486)
2013,Abril,Países Bajos,0,15,,15,POINT (10886686 -74776479)
2013,Abril,Países Bajos,0,4,,4,POINT (11247723 -74213989)
2013,Abril,Países Bajos,7,6,,13,POINT (11360029 -72129595)
2013,Abril,Países Bajos,1,1,,2,POINT (133387613 -81372937)
2013,Abril,Países Bajos,18,55,,73,POINT (3451668 -76532004)
2013,Abril,Países Bajos,348,701,,1049,POINT (4697157 -74140516)
2013,Abril,Países Bajos,72,96,,168,POINT (6170465 -7542726)
2013,Abril,Países Bajos,8,13,,21,POINT (7128047 -73181317)
2013,Abril,Países Bajos,2,17,,19,POINT (7819 -72453013)
2013,Abril,Países Bajos,0,2,,2,POINT (806667 -767333)
2013,Abril,Palestina,0,1,,1,POINT (4697157 -74140516)
2013,Abril,Lituania,0,1,,1,POINT (0.81488 -77356)
2013,Abril,Lituania,0,1,,1,POINT (10886686 -74776479)
2013,Abril,Lituania,1,1,,2,POINT (4697157 -74140516)
2013,Abril,Reino Unido de Gran Bretaña e Irlanda del Norte,0,1,,1,POINT (6170465 -7542726)
2013,Abril,Reino Unido de Gran Bretaña e Irlanda del Norte,0,1,,1,POINT (0.81488 -77356)
2013,Abril,Reino Unido de Gran Bretaña e Irlanda del Norte,1,2,,3,POINT (10406342 -75527794)
2013,Abril,Reino Unido de Gran Bretaña e Irlanda del Norte,1,0,,1,POINT (3451668 -76532004)
2013,Abril,Reino Unido de Gran Bretaña e Irlanda del Norte,7,16,,23,POINT (4697157 -74140516)
2013,Abril,Letonia,1,0,,1,POINT (4697157 -74140516)
2013,Abril,República CentroÁfricana,0,1,,1,POINT (10406342 -75527794)
2013,Abril,República CentroÁfricana,0,1,,1,POINT (4697157 -74140516)
2013,Abril,Desconocido,1,0,,1,POINT (3451668 -76532004)
2013,Mayo,Albania,0,1,,1,POINT (3451668 -76532004)
2013,Mayo,Albania,1,0,,1,POINT (4697157 -74140516)
2013,Mayo,Alemania,6,15,,21,POINT (-4191162 -69941498)
2013,Mayo,Alemania,56,75,,131,POINT (0.81488 -77356)
2013,Mayo,Alemania,3,5,,8,POINT (10406342 -75527794)
2013,Mayo,Alemania,23,41,,64,POINT (10446304 -75516486)
2013,Mayo,Alemania,2,11,,13,POINT (10886686 -74776479)
2013,Mayo,Alemania,2,8,,10,POINT (11360029 -72129595)
2013,Mayo,Alemania,0,1,,1,POINT (1152863 -72919186)
2013,Mayo,Alemania,1,2,,3,POINT (125862 -81702165)
2013,Mayo,Alemania,1,2,,3,POINT (133387613 -81372937)
2013,Mayo,Alemania,26,37,,63,POINT (3451668 -76532004)
2013,Mayo,Alemania,0,2,,2,POINT (3884426 -77061029)
2013,Mayo,Alemania,1002,1622,,2624,POINT (4697157 -74140516)
2013,Mayo,Alemania,0,1,,1,POINT (4815189 -75736374)
2013,Mayo,Alemania,32,66,,98,POINT (6170465 -7542726)
2013,Mayo,Alemania,0,1,,1,POINT (7128047 -73181317)
2013,Mayo,Alemania,3,8,,11,POINT (7819 -72453013)
2013,Mayo,Alemania,0,1,,1,POINT (806667 -767333)
2013,Mayo,Alemania,6,8,,14,POINT (863337 -7735002)
2013,Mayo,Andorra,0,1,,1,POINT (3451668 -76532004)
2013,Mayo,Andorra,2,11,,13,POINT (4697157 -74140516)
2013,Mayo,Angola,1,1,,2,POINT (3451668 -76532004)
2013,Mayo,Angola,0,1,,1,POINT (4697157 -74140516)
2013,Mayo,Antigua y Barbuda,0,1,,1,POINT (0.81488 -77356)
2013,Mayo,Antigua y Barbuda,0,1,,1,POINT (10886686 -74776479)
2013,Mayo,Arabia Saudita,0,1,,1,POINT (4697157 -74140516)
2013,Mayo,Arabia Saudita,0,1,,1,POINT (6170465 -7542726)
2013,Mayo,Arabia Saudita,1,0,,1,POINT (3451668 -76532004)
2013,Mayo,Arabia Saudita,0,4,,4,POINT (4697157 -74140516)
2013,Mayo,Argelia,0,2,,2,POINT (4697157 -74140516)
2013,Mayo,Argentina,6,7,,13,POINT (-4191162 -69941498)
2013,Mayo,Argentina,3,3,,6,POINT (0.33002 -76876446)
2013,Mayo,Argentina,73,105,,178,POINT (0.81488 -77356)
2013,Mayo,Argentina,231,160,,391,POINT (10406342 -75527794)
2013,Mayo,Argentina,867,564,,1431,POINT (10446304 -75516486)
2013,Mayo,Argentina,6,27,,33,POINT (10886686 -74776479)
2013,Mayo,Argentina,0,1,,1,POINT (11247723 -74213989)
2013,Mayo,Argentina,10,26,,36,POINT (11360029 -72129595)
2013,Mayo,Argentina,162,127,,289,POINT (125862 -81702165)
2013,Mayo,Argentina,0,1,,1,POINT (133387613 -81372937)
2013,Mayo,Argentina,29,66,,95,POINT (3451668 -76532004)
2013,Mayo,Argentina,2653,4269,,6922,POINT (4697157 -74140516)
2013,Mayo,Argentina,0,8,,8,POINT (4815189 -75736374)
2013,Mayo,Argentina,85,231,,316,POINT (6170465 -7542726)
2013,Mayo,Argentina,0,1,,1,POINT (6185536 -67484028)
2013,Mayo,Argentina,0,1,,1,POINT (7088729 -70740253)
2013,Mayo,Argentina,1,2,,3,POINT (7128047 -73181317)
2013,Mayo,Argentina,16,59,,75,POINT (7819 -72453013)
2013,Mayo,Argentina,1,2,,3,POINT (7927233 -72508188)
2013,Mayo,Argentina,10,7,,17,POINT (863337 -7735002)
2013,Mayo,República de Armenia,0,2,,2,POINT (4697157 -74140516)
2013,Mayo,Aruba,0,1,,1,POINT (1152863 -72919186)
2013,Mayo,Aruba,4,1,,5,POINT (4697157 -74140516)
2013,Mayo,Australia,2,3,,5,POINT (-4191162 -69941498)
2013,Mayo,Australia,1,0,,1,POINT (0.33002 -76876446)
2013,Mayo,Australia,47,76,,123,POINT (0.81488 -77356)
2013,Mayo,Australia,26,38,,64,POINT (10446304 -75516486)
2013,Mayo,Australia,4,8,,12,POINT (10886686 -74776479)
2013,Mayo,Australia,4,4,,8,POINT (11247723 -74213989)
2013,Mayo,Australia,4,6,,10,POINT (11360029 -72129595)
2013,Mayo,Australia,0,1,,1,POINT (133387613 -81372937)
2013,Mayo,Australia,6,12,,18,POINT (3451668 -76532004)
2013,Mayo,Australia,178,311,,489,POINT (4697157 -74140516)
2013,Mayo,Australia,0,2,,2,POINT (4815189 -75736374)
2013,Mayo,Australia,13,43,,56,POINT (6170465 -7542726)
2013,Mayo,Australia,0,1,,1,POINT (7128047 -73181317)
2013,Mayo,Australia,2,10,,12,POINT (7819 -72453013)
2013,Mayo,Australia,2,5,,7,POINT (863337 -7735002)
2013,Mayo,Austria,1,1,,2,POINT (-4191162 -69941498)
2013,Mayo,Austria,6,9,,15,POINT (0.81488 -77356)
2013,Mayo,Austria,1,5,,6,POINT (10446304 -75516486)
2013,Mayo,Austria,0,2,,2,POINT (10886686 -74776479)
2013,Mayo,Austria,1,1,,2,POINT (11360029 -72129595)
2013,Mayo,Austria,0,1,,1,POINT (125862 -81702165)
2013,Mayo,Austria,0,1,,1,POINT (3451668 -76532004)
2013,Mayo,Austria,57,147,,204,POINT (4697157 -74140516)
2013,Mayo,Austria,2,6,,8,POINT (6170465 -7542726)
2013,Mayo,Azerbaiyán,0,3,,3,POINT (4697157 -74140516)
2013,Mayo,Bahamas,7,8,,15,POINT (3451668 -76532004)
2013,Mayo,Bahamas,2,7,,9,POINT (4697157 -74140516)
2013,Mayo,Bahamas,0,5,,5,POINT (6170465 -7542726)
2013,Mayo,Bahréin,1,0,,1,POINT (4697157 -74140516)
2013,Mayo,Bangladesh,1,5,,6,POINT (4697157 -74140516)
2013,Mayo,Barbados,1,0,,1,POINT (10446304 -75516486)
2013,Mayo,Barbados,1,4,,5,POINT (4697157 -74140516)
2013,Mayo,República de Belarús,0,4,,4,POINT (4697157 -74140516)
2013,Mayo,Bélgica,0,1,,1,POINT (-4191162 -69941498)
2013,Mayo,Bélgica,7,13,,20,POINT (0.81488 -77356)
2013,Mayo,Bélgica,3,12,,15,POINT (10446304 -75516486)
2013,Mayo,Bélgica,1,2,,3,POINT (10886686 -74776479)
2013,Mayo,Bélgica,0,2,,2,POINT (11360029 -72129595)
2013,Mayo,Bélgica,3,30,,33,POINT (3451668 -76532004)
2013,Mayo,Bélgica,73,243,,316,POINT (4697157 -74140516)
2013,Mayo,Bélgica,0,1,,1,POINT (4815189 -75736374)
2013,Mayo,Bélgica,3,18,,21,POINT (6170465 -7542726)
2013,Mayo,Bélgica,1,3,,4,POINT (7819 -72453013)
2013,Mayo,Bélgica,1,1,,2,POINT (7927233 -72508188)
2013,Mayo,Bélgica,3,8,,11,POINT (863337 -7735002)
2013,Mayo,Belice,0,1,,1,POINT (10886686 -74776479)
2013,Mayo,Belice,5,15,,20,POINT (4697157 -74140516)
2013,Mayo,Belice,2,0,,2,POINT (6170465 -7542726)
2013,Mayo,Benín,0,1,,1,POINT (4697157 -74140516)
2013,Mayo,Bermudas/Territorio Británico de Ultramar,0,1,,1,POINT (10886686 -74776479)
2013,Mayo,Bermudas/Territorio Británico de Ultramar,0,1,,1,POINT (4697157 -74140516)
2013,Mayo,Bolivia,6,12,,18,POINT (0.81488 -77356)
2013,Mayo,Bolivia,3,3,,6,POINT (10406342 -75527794)
2013,Mayo,Bolivia,15,14,,29,POINT (10446304 -75516486)
2013,Mayo,Bolivia,0,1,,1,POINT (11360029 -72129595)
2013,Mayo,Bolivia,0,2,,2,POINT (125862 -81702165)
2013,Mayo,Bolivia,4,11,,15,POINT (3451668 -76532004)
2013,Mayo,Bolivia,277,472,,749,POINT (4697157 -74140516)
2013,Mayo,Bolivia,11,24,,35,POINT (6170465 -7542726)
2013,Mayo,Bolivia,0,1,,1,POINT (6185536 -67484028)
2013,Mayo,Bolivia,0,1,,1,POINT (7088729 -70740253)
2013,Mayo,Bolivia,0,3,,3,POINT (7819 -72453013)
2013,Mayo,Bolivia,1,0,,1,POINT (863337 -7735002)
2013,Mayo,Bosnia y Herzegovina,1,1,,2,POINT (4697157 -74140516)
2013,Mayo,Botsuana,1,1,,2,POINT (4697157 -74140516)
2013,Mayo,Brasil,71,77,,148,POINT (-4191162 -69941498)
2013,Mayo,Brasil,1,0,,1,POINT (0.33002 -76876446)
2013,Mayo,Brasil,10,21,,31,POINT (0.81488 -77356)
2013,Mayo,Brasil,1,0,,1,POINT (1800143 -78802679)
2013,Mayo,Brasil,15,15,,30,POINT (10406342 -75527794)
2013,Mayo,Brasil,177,144,,321,POINT (10446304 -75516486)
2013,Mayo,Brasil,3,15,,18,POINT (10886686 -74776479)
2013,Mayo,Brasil,7,13,,20,POINT (11360029 -72129595)
2013,Mayo,Brasil,41,40,,81,POINT (125862 -81702165)
2013,Mayo,Brasil,18,65,,83,POINT (3451668 -76532004)
2013,Mayo,Brasil,2567,4123,,6690,POINT (4697157 -74140516)
2013,Mayo,Brasil,4,1,,5,POINT (4815189 -75736374)
2013,Mayo,Brasil,49,127,,176,POINT (6170465 -7542726)
2013,Mayo,Brasil,1,0,,1,POINT (6185536 -67484028)
2013,Mayo,Brasil,12,41,,53,POINT (7819 -72453013)
2013,Mayo,Brasil,2,5,,7,POINT (7927233 -72508188)
2013,Mayo,Brasil,0,3,,3,POINT (863337 -7735002)
2013,Mayo,Bulgaria,1,1,,2,POINT (10446304 -75516486)
2013,Mayo,Bulgaria,1,0,,1,POINT (3451668 -76532004)
2013,Mayo,Bulgaria,0,1,,1,POINT (3884426 -77061029)
2013,Mayo,Bulgaria,5,6,,11,POINT (4697157 -74140516)
2013,Mayo,Bulgaria,1,1,,2,POINT (6170465 -7542726)
2013,Mayo,Burundi,0,1,,1,POINT (4697157 -74140516)
2013,Mayo,Bután,1,1,,2,POINT (4697157 -74140516)
2013,Mayo,Cabo Verde,0,1,,1,POINT (0.81488 -77356)
2013,Mayo,Islas Caimán/Territorio Británico de Ultramar,1,0,,1,POINT (3451668 -76532004)
2013,Mayo,Islas Caimán/Territorio Británico de Ultramar,1,1,,2,POINT (4697157 -74140516)
2013,Mayo,Camerún,1,0,,1,POINT (4697157 -74140516)
2013,Mayo,Canadá,3,3,,6,POINT (-4191162 -69941498)
2013,Mayo,Canadá,1,0,,1,POINT (0.33002 -76876446)
2013,Mayo,Canadá,17,24,,41,POINT (0.81488 -77356)
2013,Mayo,Canadá,67,133,,200,POINT (10446304 -75516486)
2013,Mayo,Canadá,5,24,,29,POINT (10886686 -74776479)
2013,Mayo,Canadá,0,3,,3,POINT (11247723 -74213989)
2013,Mayo,Canadá,2,2,,4,POINT (11360029 -72129595)
2013,Mayo,Canadá,1,6,,7,POINT (125862 -81702165)
2013,Mayo,Canadá,32,84,,116,POINT (3451668 -76532004)
2013,Mayo,Canadá,0,5,,5,POINT (445285 -75766353)
2013,Mayo,Canadá,643,1270,,1913,POINT (4697157 -74140516)
2013,Mayo,Canadá,5,2,,7,POINT (4815189 -75736374)
2013,Mayo,Canadá,46,147,,193,POINT (6170465 -7542726)
2013,Mayo,Canadá,0,1,,1,POINT (7128047 -73181317)
2013,Mayo,Canadá,2,8,,10,POINT (7819 -72453013)
2013,Mayo,Canadá,4,36,,40,POINT (7927233 -72508188)
2013,Mayo,Canadá,0,3,,3,POINT (863337 -7735002)
2013,Mayo,España,0,1,,1,POINT (0.33002 -76876446)
2013,Mayo,España,7,5,,12,POINT (0.81488 -77356)
2013,Mayo,España,2,1,,3,POINT (10406342 -75527794)
2013,Mayo,España,0,1,,1,POINT (10446304 -75516486)
2013,Mayo,España,2,12,,14,POINT (10886686 -74776479)
2013,Mayo,España,0,1,,1,POINT (11247723 -74213989)
2013,Mayo,España,1,1,,2,POINT (11360029 -72129595)
2013,Mayo,España,38,62,,100,POINT (3451668 -76532004)
2013,Mayo,España,102,292,,394,POINT (4697157 -74140516)
2013,Mayo,España,1,4,,5,POINT (4815189 -75736374)
2013,Mayo,España,32,124,,156,POINT (6170465 -7542726)
2013,Mayo,España,0,2,,2,POINT (7927233 -72508188)
2013,Mayo,República Democrática del Congo,1,2,,3,POINT (4697157 -74140516)
2013,Mayo,República Democrática del Congo,1,0,,1,POINT (6170465 -7542726)
2013,Mayo,República de Corea,1,0,,1,POINT (-4191162 -69941498)
2013,Mayo,República de Corea,11,8,,19,POINT (0.81488 -77356)
2013,Mayo,República de Corea,2,2,,4,POINT (10446304 -75516486)
2013,Mayo,República de Corea,0,8,,8,POINT (10886686 -74776479)
2013,Mayo,República de Corea,1,0,,1,POINT (11360029 -72129595)
2013,Mayo,República de Corea,0,3,,3,POINT (3451668 -76532004)
2013,Mayo,República de Corea,125,441,,566,POINT (4697157 -74140516)
2013,Mayo,República de Corea,3,20,,23,POINT (6170465 -7542726)
2013,Mayo,República de Corea,0,2,,2,POINT (7128047 -73181317)
2013,Mayo,República de Corea,3,12,,15,POINT (7819 -72453013)
2013,Mayo,Costa de Marfil,0,1,,1,POINT (4697157 -74140516)
2013,Mayo,Costa Rica,4,0,,4,POINT (0.81488 -77356)
2013,Mayo,Costa Rica,0,1,,1,POINT (10406342 -75527794)
2013,Mayo,Costa Rica,33,47,,80,POINT (10446304 -75516486)
2013,Mayo,Costa Rica,10,26,,36,POINT (10886686 -74776479)
2013,Mayo,Costa Rica,193,150,,343,POINT (125862 -81702165)
2013,Mayo,Costa Rica,28,68,,96,POINT (3451668 -76532004)
2013,Mayo,Costa Rica,1,0,,1,POINT (445285 -75766353)
2013,Mayo,Costa Rica,453,839,,1292,POINT (4697157 -74140516)
2013,Mayo,Costa Rica,1,1,,2,POINT (4815189 -75736374)
2013,Mayo,Costa Rica,80,176,,256,POINT (6170465 -7542726)
2013,Mayo,Costa Rica,1,0,,1,POINT (6185536 -67484028)
2013,Mayo,Costa Rica,1,0,,1,POINT (7128047 -73181317)
2013,Mayo,Costa Rica,0,4,,4,POINT (7819 -72453013)
2013,Mayo,Croacia,0,1,,1,POINT (10446304 -75516486)
2013,Mayo,Croacia,0,3,,3,POINT (3451668 -76532004)
2013,Mayo,Croacia,0,1,,1,POINT (3884426 -77061029)
2013,Mayo,Croacia,2,19,,21,POINT (4697157 -74140516)
2013,Mayo,Cuba,0,4,,4,POINT (0.81488 -77356)
2013,Mayo,Cuba,3,8,,11,POINT (10446304 -75516486)
2013,Mayo,Cuba,4,11,,15,POINT (10886686 -74776479)
2013,Mayo,Cuba,14,27,,41,POINT (3451668 -76532004)
2013,Mayo,Cuba,0,2,,2,POINT (445285 -75766353)
2013,Mayo,Cuba,89,132,,221,POINT (4697157 -74140516)
2013,Mayo,Cuba,12,38,,50,POINT (6170465 -7542726)
2013,Mayo,Cuba,0,1,,1,POINT (7819 -72453013)
2013,Mayo,Cuba,1,3,,4,POINT (7927233 -72508188)
2013,Mayo,Curazao,2,4,,6,POINT (4697157 -74140516)
2013,Mayo,Curazao,4,2,,6,POINT (6170465 -7542726)
2013,Mayo,República Checa,1,1,,2,POINT (-4191162 -69941498)
2013,Mayo,República Checa,1,5,,6,POINT (0.81488 -77356)
2013,Mayo,República Checa,3,2,,5,POINT (10446304 -75516486)
2013,Mayo,República Checa,0,1,,1,POINT (11360029 -72129595)
2013,Mayo,República Checa,0,1,,1,POINT (3451668 -76532004)
2013,Mayo,República Checa,16,26,,42,POINT (4697157 -74140516)
2013,Mayo,República Checa,1,1,,2,POINT (7819 -72453013)
2013,Mayo,Chile,2,3,,5,POINT (-4191162 -69941498)
2013,Mayo,Chile,3,1,,4,POINT (0.33002 -76876446)
2013,Mayo,Chile,37,53,,90,POINT (0.81488 -77356)
2013,Mayo,Chile,64,30,,94,POINT (10406342 -75527794)
2013,Mayo,Chile,90,94,,184,POINT (10446304 -75516486)
2013,Mayo,Chile,3,19,,22,POINT (10886686 -74776479)
2013,Mayo,Chile,6,14,,20,POINT (11360029 -72129595)
2013,Mayo,Chile,37,27,,64,POINT (125862 -81702165)
2013,Mayo,Chile,33,65,,98,POINT (3451668 -76532004)
2013,Mayo,Chile,2837,3907,,6744,POINT (4697157 -74140516)
2013,Mayo,Chile,1,3,,4,POINT (4815189 -75736374)
2013,Mayo,Chile,74,131,,205,POINT (6170465 -7542726)
2013,Mayo,Chile,2,3,,5,POINT (7128047 -73181317)
2013,Mayo,Chile,7,30,,37,POINT (7819 -72453013)
2013,Mayo,China,2,0,,2,POINT (0.81488 -77356)
2013,Mayo,China,6,11,,17,POINT (10446304 -75516486)
2013,Mayo,China,2,22,,24,POINT (10886686 -74776479)
2013,Mayo,China,0,2,,2,POINT (11247723 -74213989)
2013,Mayo,China,11,11,,22,POINT (3451668 -76532004)
2013,Mayo,China,148,545,,693,POINT (4697157 -74140516)
2013,Mayo,China,6,13,,19,POINT (6170465 -7542726)
2013,Mayo,China,0,2,,2,POINT (7819 -72453013)
2013,Mayo,Taiwán,0,1,,1,POINT (0.33002 -76876446)
2013,Mayo,Taiwán,1,3,,4,POINT (10446304 -75516486)
2013,Mayo,Taiwán,0,3,,3,POINT (10886686 -74776479)
2013,Mayo,Taiwán,3,6,,9,POINT (3451668 -76532004)
2013,Mayo,Taiwán,24,52,,76,POINT (4697157 -74140516)
2013,Mayo,Taiwán,7,15,,22,POINT (6170465 -7542726)
2013,Mayo,Taiwán,1,2,,3,POINT (7819 -72453013)
2013,Mayo,Chipre,0,3,,3,POINT (4697157 -74140516)
2013,Mayo,Dinamarca,1,0,,1,POINT (-4191162 -69941498)
2013,Mayo,Dinamarca,18,17,,35,POINT (0.81488 -77356)
2013,Mayo,Dinamarca,2,8,,10,POINT (10446304 -75516486)
2013,Mayo,Dinamarca,0,2,,2,POINT (10886686 -74776479)
2013,Mayo,Dinamarca,3,1,,4,POINT (11247723 -74213989)
2013,Mayo,Dinamarca,1,1,,2,POINT (11360029 -72129595)
2013,Mayo,Dinamarca,4,6,,10,POINT (3451668 -76532004)
2013,Mayo,Dinamarca,38,70,,108,POINT (4697157 -74140516)
2013,Mayo,Dinamarca,0,1,,1,POINT (4815189 -75736374)
2013,Mayo,Dinamarca,3,8,,11,POINT (6170465 -7542726)
2013,Mayo,Dominica,0,2,,2,POINT (4697157 -74140516)
2013,Mayo,Dominica,1,1,,2,POINT (6170465 -7542726)
2013,Mayo,Dominica,0,1,,1,POINT (7927233 -72508188)
2013,Mayo,Ecuador,1,3,,4,POINT (-4191162 -69941498)
2013,Mayo,Ecuador,15,55,,70,POINT (0.33002 -76876446)
2013,Mayo,Ecuador,903,1378,,2281,POINT (0.81488 -77356)
2013,Mayo,Ecuador,5,164,,169,POINT (1800143 -78802679)
2013,Mayo,Ecuador,4,6,,10,POINT (10406342 -75527794)
2013,Mayo,Ecuador,11,23,,34,POINT (10446304 -75516486)
2013,Mayo,Ecuador,2,8,,10,POINT (10886686 -74776479)
2013,Mayo,Ecuador,16,12,,28,POINT (11360029 -72129595)
2013,Mayo,Ecuador,4,6,,10,POINT (125862 -81702165)
2013,Mayo,Ecuador,383,450,,833,POINT (3451668 -76532004)
2013,Mayo,Ecuador,0,2,,2,POINT (3884426 -77061029)
2013,Mayo,Ecuador,1859,2872,,4731,POINT (4697157 -74140516)
2013,Mayo,Ecuador,0,7,,7,POINT (4815189 -75736374)
2013,Mayo,Ecuador,538,649,,1187,POINT (6170465 -7542726)
2013,Mayo,Ecuador,104,140,,244,POINT (7819 -72453013)
2013,Mayo,Ecuador,1,0,,1,POINT (863337 -7735002)
2013,Mayo,Egipto,5,16,,21,POINT (4697157 -74140516)
2013,Mayo,Egipto,0,1,,1,POINT (6170465 -7542726)
2013,Mayo,El Salvador,3,2,,5,POINT (0.81488 -77356)
2013,Mayo,El Salvador,16,23,,39,POINT (10446304 -75516486)
2013,Mayo,El Salvador,3,1,,4,POINT (10886686 -74776479)
2013,Mayo,El Salvador,45,73,,118,POINT (3451668 -76532004)
2013,Mayo,El Salvador,381,637,,1018,POINT (4697157 -74140516)
2013,Mayo,El Salvador,0,1,,1,POINT (4815189 -75736374)
2013,Mayo,El Salvador,39,64,,103,POINT (6170465 -7542726)
2013,Mayo,El Salvador,0,1,,1,POINT (7819 -72453013)
2013,Mayo,El Salvador,0,1,,1,POINT (7927233 -72508188)
2013,Mayo,Emiratos Árabes,4,2,,6,POINT (4697157 -74140516)
2013,Mayo,España,2,8,,10,POINT (-4191162 -69941498)
2013,Mayo,España,22,42,,64,POINT (0.81488 -77356)
2013,Mayo,España,11,8,,19,POINT (10406342 -75527794)
2013,Mayo,España,36,72,,108,POINT (10446304 -75516486)
2013,Mayo,España,2,13,,15,POINT (10886686 -74776479)
2013,Mayo,España,6,7,,13,POINT (11360029 -72129595)
2013,Mayo,España,6,4,,10,POINT (125862 -81702165)
2013,Mayo,España,0,1,,1,POINT (133387613 -81372937)
2013,Mayo,España,156,301,,457,POINT (3451668 -76532004)
2013,Mayo,España,1546,4440,,5986,POINT (4697157 -74140516)
2013,Mayo,España,2,8,,10,POINT (4815189 -75736374)
2013,Mayo,España,74,214,,288,POINT (6170465 -7542726)
2013,Mayo,España,0,1,,1,POINT (7088729 -70740253)
2013,Mayo,España,0,2,,2,POINT (7128047 -73181317)
2013,Mayo,España,16,44,,60,POINT (7819 -72453013)
2013,Mayo,España,1,1,,2,POINT (7927233 -72508188)
2013,Mayo,España,2,8,,10,POINT (863337 -7735002)
2013,Mayo,Eslovaquia,2,0,,2,POINT (10446304 -75516486)
2013,Mayo,Eslovaquia,2,0,,2,POINT (10886686 -74776479)
2013,Mayo,Eslovaquia,13,10,,23,POINT (4697157 -74140516)
2013,Mayo,Eslovaquia,0,1,,1,POINT (7819 -72453013)
2013,Mayo,Eslovenia,0,1,,1,POINT (0.81488 -77356)
2013,Mayo,Eslovenia,0,1,,1,POINT (10446304 -75516486)
2013,Mayo,Eslovenia,1,1,,2,POINT (11360029 -72129595)
2013,Mayo,Eslovenia,1,5,,6,POINT (3451668 -76532004)
2013,Mayo,Eslovenia,8,15,,23,POINT (4697157 -74140516)
2013,Mayo,Eslovenia,0,1,,1,POINT (863337 -7735002)
2013,Mayo,Estados Unidos de América,5,25,,30,POINT (-4191162 -69941498)
2013,Mayo,Estados Unidos de América,52,74,,126,POINT (0.81488 -77356)
2013,Mayo,Estados Unidos de América,1,1,,2,POINT (1800143 -78802679)
2013,Mayo,Estados Unidos de América,1,7,,8,POINT (10406342 -75527794)
2013,Mayo,Estados Unidos de América,1138,2103,,3241,POINT (10446304 -75516486)
2013,Mayo,Estados Unidos de América,340,574,,914,POINT (10886686 -74776479)
2013,Mayo,Estados Unidos de América,3,5,,8,POINT (11247723 -74213989)
2013,Mayo,Estados Unidos de América,1,10,,11,POINT (11360029 -72129595)
2013,Mayo,Estados Unidos de América,0,2,,2,POINT (1152863 -72919186)
2013,Mayo,Estados Unidos de América,7,18,,25,POINT (125862 -81702165)
2013,Mayo,Estados Unidos de América,7,7,,14,POINT (133387613 -81372937)
2013,Mayo,Estados Unidos de América,717,1242,,1959,POINT (3451668 -76532004)
2013,Mayo,Estados Unidos de América,72,127,,199,POINT (445285 -75766353)
2013,Mayo,Estados Unidos de América,5807,11372,,17179,POINT (4697157 -74140516)
2013,Mayo,Estados Unidos de América,75,124,,199,POINT (4815189 -75736374)
2013,Mayo,Estados Unidos de América,955,2500,,3455,POINT (6170465 -7542726)
2013,Mayo,Estados Unidos de América,1,1,,2,POINT (6185536 -67484028)
2013,Mayo,Estados Unidos de América,10,23,,33,POINT (7128047 -73181317)
2013,Mayo,Estados Unidos de América,24,49,,73,POINT (7819 -72453013)
2013,Mayo,Estados Unidos de América,8,11,,19,POINT (7927233 -72508188)
2013,Mayo,Estados Unidos de América,5,12,,17,POINT (863337 -7735002)
2013,Mayo,Estonia,1,1,,2,POINT (0.81488 -77356)
2013,Mayo,Estonia,3,0,,3,POINT (10446304 -75516486)
2013,Mayo,Estonia,0,1,,1,POINT (10886686 -74776479)
2013,Mayo,Estonia,1,0,,1,POINT (3451668 -76532004)
2013,Mayo,Estonia,6,6,,12,POINT (4697157 -74140516)
2013,Mayo,Estonia,1,0,,1,POINT (6170465 -7542726)
2013,Mayo,Etiopia,1,4,,5,POINT (4697157 -74140516)
2013,Mayo,Filipinas,0,1,,1,POINT (0.81488 -77356)
2013,Mayo,Filipinas,0,1,,1,POINT (10406342 -75527794)
2013,Mayo,Filipinas,2,10,,12,POINT (10446304 -75516486)
2013,Mayo,Filipinas,0,9,,9,POINT (10886686 -74776479)
2013,Mayo,Filipinas,0,8,,8,POINT (10970933 -74765343)
2013,Mayo,Filipinas,0,8,,8,POINT (11247723 -74213989)
2013,Mayo,Filipinas,0,15,,15,POINT (3451668 -76532004)
2013,Mayo,Filipinas,0,18,,18,POINT (3884426 -77061029)
2013,Mayo,Filipinas,13,66,,79,POINT (4697157 -74140516)
2013,Mayo,Filipinas,1,5,,6,POINT (6170465 -7542726)
2013,Mayo,Filipinas,0,10,,10,POINT (9402597 -75681642)
2013,Mayo,Finlandia,0,1,,1,POINT (-4191162 -69941498)
2013,Mayo,Finlandia,3,5,,8,POINT (0.81488 -77356)
2013,Mayo,Finlandia,0,1,,1,POINT (10446304 -75516486)
2013,Mayo,Finlandia,1,1,,2,POINT (3451668 -76532004)
2013,Mayo,Finlandia,45,98,,143,POINT (4697157 -74140516)
2013,Mayo,Finlandia,0,2,,2,POINT (6170465 -7542726)
2013,Mayo,Finlandia,1,0,,1,POINT (7819 -72453013)
2013,Mayo,Francia,8,19,,27,POINT (-4191162 -69941498)
2013,Mayo,Francia,0,2,,2,POINT (0.33002 -76876446)
2013,Mayo,Francia,39,63,,102,POINT (0.81488 -77356)
2013,Mayo,Francia,1,1,,2,POINT (1800143 -78802679)
2013,Mayo,Francia,4,7,,11,POINT (10406342 -75527794)
2013,Mayo,Francia,21,30,,51,POINT (10446304 -75516486)
2013,Mayo,Francia,2,14,,16,POINT (10886686 -74776479)
2013,Mayo,Francia,1,6,,7,POINT (11247723 -74213989)
2013,Mayo,Francia,1,7,,8,POINT (11360029 -72129595)
2013,Mayo,Francia,0,1,,1,POINT (125862 -81702165)
2013,Mayo,Francia,1,1,,2,POINT (133387613 -81372937)
2013,Mayo,Francia,28,56,,84,POINT (3451668 -76532004)
2013,Mayo,Francia,0,1,,1,POINT (3884426 -77061029)
2013,Mayo,Francia,730,1555,,2285,POINT (4697157 -74140516)
2013,Mayo,Francia,0,4,,4,POINT (4815189 -75736374)
2013,Mayo,Francia,30,73,,103,POINT (6170465 -7542726)
2013,Mayo,Francia,1,2,,3,POINT (7128047 -73181317)
2013,Mayo,Francia,7,18,,25,POINT (7819 -72453013)
2013,Mayo,Francia,4,8,,12,POINT (863337 -7735002)
2013,Mayo,Georgia,2,0,,2,POINT (4697157 -74140516)
2013,Mayo,Ghana,1,3,,4,POINT (4697157 -74140516)
2013,Mayo,Granada,0,1,,1,POINT (3451668 -76532004)
2013,Mayo,Granada,0,1,,1,POINT (6170465 -7542726)
2013,Mayo,Grecia,0,1,,1,POINT (-4191162 -69941498)
2013,Mayo,Grecia,0,1,,1,POINT (0.81488 -77356)
2013,Mayo,Grecia,1,4,,5,POINT (10446304 -75516486)
2013,Mayo,Grecia,0,1,,1,POINT (10970933 -74765343)
2013,Mayo,Grecia,0,4,,4,POINT (11360029 -72129595)
2013,Mayo,Grecia,1,3,,4,POINT (3451668 -76532004)
2013,Mayo,Grecia,17,48,,65,POINT (4697157 -74140516)
2013,Mayo,Grecia,1,3,,4,POINT (6170465 -7542726)
2013,Mayo,Grecia,0,1,,1,POINT (7819 -72453013)
2013,Mayo,Guatemala,0,5,,5,POINT (0.81488 -77356)
2013,Mayo,Guatemala,0,1,,1,POINT (10406342 -75527794)
2013,Mayo,Guatemala,27,33,,60,POINT (10446304 -75516486)
2013,Mayo,Guatemala,5,11,,16,POINT (10886686 -74776479)
2013,Mayo,Guatemala,0,4,,4,POINT (11360029 -72129595)
2013,Mayo,Guatemala,2,3,,5,POINT (125862 -81702165)
2013,Mayo,Guatemala,27,63,,90,POINT (3451668 -76532004)
2013,Mayo,Guatemala,163,462,,625,POINT (4697157 -74140516)
2013,Mayo,Guatemala,1,2,,3,POINT (4815189 -75736374)
2013,Mayo,Guatemala,36,96,,132,POINT (6170465 -7542726)
2013,Mayo,Guatemala,1,1,,2,POINT (7128047 -73181317)
2013,Mayo,Guatemala,7,15,,22,POINT (7819 -72453013)
2013,Mayo,Guatemala,1,2,,3,POINT (7927233 -72508188)
2013,Mayo,Guatemala,1,2,,3,POINT (863337 -7735002)
2013,Mayo,Guyana,0,2,,2,POINT (10446304 -75516486)
2013,Mayo,Guyana,0,2,,2,POINT (3451668 -76532004)
2013,Mayo,Guyana,5,7,,12,POINT (4697157 -74140516)
2013,Mayo,Guyana,0,1,,1,POINT (4815189 -75736374)
2013,Mayo,Guyana,1,3,,4,POINT (6170465 -7542726)
2013,Mayo,Haití,1,0,,1,POINT (0.81488 -77356)
2013,Mayo,Haití,0,1,,1,POINT (10446304 -75516486)
2013,Mayo,Haití,0,1,,1,POINT (10886686 -74776479)
2013,Mayo,Haití,4,23,,27,POINT (4697157 -74140516)
2013,Mayo,Haití,0,3,,3,POINT (6170465 -7542726)
2013,Mayo,Honduras,0,1,,1,POINT (0.81488 -77356)
2013,Mayo,Honduras,0,2,,2,POINT (10406342 -75527794)
2013,Mayo,Honduras,13,17,,30,POINT (10446304 -75516486)
2013,Mayo,Honduras,2,6,,8,POINT (10886686 -74776479)
2013,Mayo,Honduras,0,1,,1,POINT (10970933 -74765343)
2013,Mayo,Honduras,0,1,,1,POINT (11360029 -72129595)
2013,Mayo,Honduras,2,1,,3,POINT (125862 -81702165)
2013,Mayo,Honduras,15,36,,51,POINT (3451668 -76532004)
2013,Mayo,Honduras,99,174,,273,POINT (4697157 -74140516)
2013,Mayo,Honduras,1,2,,3,POINT (4815189 -75736374)
2013,Mayo,Honduras,17,33,,50,POINT (6170465 -7542726)
2013,Mayo,Honduras,0,1,,1,POINT (806667 -767333)
2013,Mayo,Honduras,1,3,,4,POINT (863337 -7735002)
2013,Mayo,Hungría,0,1,,1,POINT (-4191162 -69941498)
2013,Mayo,Hungría,3,0,,3,POINT (0.81488 -77356)
2013,Mayo,Hungría,0,1,,1,POINT (3451668 -76532004)
2013,Mayo,Hungría,16,19,,35,POINT (4697157 -74140516)
2013,Mayo,Hungría,0,1,,1,POINT (6170465 -7542726)
2013,Mayo,India,0,2,,2,POINT (0.81488 -77356)
2013,Mayo,India,3,8,,11,POINT (10446304 -75516486)
2013,Mayo,India,0,2,,2,POINT (10886686 -74776479)
2013,Mayo,India,5,17,,22,POINT (3451668 -76532004)
2013,Mayo,India,0,1,,1,POINT (3884426 -77061029)
2013,Mayo,India,32,250,,282,POINT (4697157 -74140516)
2013,Mayo,India,3,28,,31,POINT (6170465 -7542726)
2013,Mayo,India,0,1,,1,POINT (7927233 -72508188)
2013,Mayo,Indonesia,2,0,,2,POINT (0.81488 -77356)
2013,Mayo,Indonesia,0,1,,1,POINT (10446304 -75516486)
2013,Mayo,Indonesia,1,0,,1,POINT (3451668 -76532004)
2013,Mayo,Indonesia,11,29,,40,POINT (4697157 -74140516)
2013,Mayo,Iraq,1,1,,2,POINT (4697157 -74140516)
2013,Mayo,Irán,1,10,,11,POINT (4697157 -74140516)
2013,Mayo,República de Irlanda,1,0,,1,POINT (-4191162 -69941498)
2013,Mayo,República de Irlanda,8,18,,26,POINT (0.81488 -77356)
2013,Mayo,República de Irlanda,9,15,,24,POINT (10446304 -75516486)
2013,Mayo,República de Irlanda,2,0,,2,POINT (10886686 -74776479)
2013,Mayo,República de Irlanda,0,1,,1,POINT (11360029 -72129595)
2013,Mayo,República de Irlanda,0,1,,1,POINT (3451668 -76532004)
2013,Mayo,República de Irlanda,37,88,,125,POINT (4697157 -74140516)
2013,Mayo,República de Irlanda,3,14,,17,POINT (6170465 -7542726)
2013,Mayo,República de Irlanda,0,1,,1,POINT (7819 -72453013)
2013,Mayo,Islandia,1,1,,2,POINT (10446304 -75516486)
2013,Mayo,Islandia,2,2,,4,POINT (3451668 -76532004)
2013,Mayo,Islandia,7,7,,14,POINT (4697157 -74140516)
2013,Mayo,Isla de Man,21,22,,43,POINT (0.81488 -77356)
2013,Mayo,Isla de Man,3,6,,9,POINT (10446304 -75516486)
2013,Mayo,Isla de Man,1,6,,7,POINT (10886686 -74776479)
2013,Mayo,Isla de Man,4,11,,15,POINT (3451668 -76532004)
2013,Mayo,Isla de Man,34,89,,123,POINT (4697157 -74140516)
2013,Mayo,Isla de Man,13,34,,47,POINT (6170465 -7542726)
2013,Mayo,Israel,0,3,,3,POINT (-4191162 -69941498)
2013,Mayo,Israel,17,67,,84,POINT (0.81488 -77356)
2013,Mayo,Israel,7,30,,37,POINT (10446304 -75516486)
2013,Mayo,Israel,0,1,,1,POINT (10886686 -74776479)
2013,Mayo,Israel,0,1,,1,POINT (125862 -81702165)
2013,Mayo,Israel,6,15,,21,POINT (3451668 -76532004)
2013,Mayo,Israel,121,561,,682,POINT (4697157 -74140516)
2013,Mayo,Israel,0,1,,1,POINT (4815189 -75736374)
2013,Mayo,Israel,5,52,,57,POINT (6170465 -7542726)
2013,Mayo,Israel,1,5,,6,POINT (863337 -7735002)
2013,Mayo,Islas Aland/Provincia de Finlandia,0,2,,2,POINT (4697157 -74140516)
2013,Mayo,Italia,0,3,,3,POINT (-4191162 -69941498)
2013,Mayo,Italia,10,19,,29,POINT (0.81488 -77356)
2013,Mayo,Italia,0,1,,1,POINT (1800143 -78802679)
2013,Mayo,Italia,3,3,,6,POINT (10406342 -75527794)
2013,Mayo,Italia,33,50,,83,POINT (10446304 -75516486)
2013,Mayo,Italia,1,12,,13,POINT (10886686 -74776479)
2013,Mayo,Italia,2,1,,3,POINT (11247723 -74213989)
2013,Mayo,Italia,1,8,,9,POINT (11360029 -72129595)
2013,Mayo,Italia,0,1,,1,POINT (1152863 -72919186)
2013,Mayo,Italia,0,2,,2,POINT (125862 -81702165)
2013,Mayo,Italia,28,76,,104,POINT (3451668 -76532004)
2013,Mayo,Italia,336,1433,,1769,POINT (4697157 -74140516)
2013,Mayo,Italia,0,3,,3,POINT (4815189 -75736374)
2013,Mayo,Italia,16,77,,93,POINT (6170465 -7542726)
2013,Mayo,Italia,1,0,,1,POINT (7128047 -73181317)
2013,Mayo,Italia,5,14,,19,POINT (7819 -72453013)
2013,Mayo,Italia,0,1,,1,POINT (7927233 -72508188)
2013,Mayo,Italia,2,5,,7,POINT (863337 -7735002)
2013,Mayo,Islas del Canal,1,4,,5,POINT (10446304 -75516486)
2013,Mayo,Islas del Canal,0,1,,1,POINT (4697157 -74140516)
2013,Mayo,Jamaica,2,0,,2,POINT (10446304 -75516486)
2013,Mayo,Jamaica,0,2,,2,POINT (10886686 -74776479)
2013,Mayo,Jamaica,1,0,,1,POINT (11247723 -74213989)
2013,Mayo,Jamaica,0,1,,1,POINT (125862 -81702165)
2013,Mayo,Jamaica,1,1,,2,POINT (3451668 -76532004)
2013,Mayo,Jamaica,11,28,,39,POINT (4697157 -74140516)
2013,Mayo,Japón,2,5,,7,POINT (-4191162 -69941498)
2013,Mayo,Japón,26,20,,46,POINT (0.81488 -77356)
2013,Mayo,Japón,1,15,,16,POINT (10446304 -75516486)
2013,Mayo,Japón,0,8,,8,POINT (10886686 -74776479)
2013,Mayo,Japón,0,1,,1,POINT (125862 -81702165)
2013,Mayo,Japón,0,2,,2,POINT (133387613 -81372937)
2013,Mayo,Japón,4,24,,28,POINT (3451668 -76532004)
2013,Mayo,Japón,0,1,,1,POINT (3884426 -77061029)
2013,Mayo,Japón,75,410,,485,POINT (4697157 -74140516)
2013,Mayo,Japón,4,23,,27,POINT (6170465 -7542726)
2013,Mayo,Japón,1,4,,5,POINT (7819 -72453013)
2013,Mayo,Japón,0,1,,1,POINT (7927233 -72508188)
2013,Mayo,Japón,0,2,,2,POINT (863337 -7735002)
2013,Mayo,Jordania,0,1,,1,POINT (3451668 -76532004)
2013,Mayo,Jordania,1,6,,7,POINT (4697157 -74140516)
2013,Mayo,Kazajistán,1,0,,1,POINT (4697157 -74140516)
2013,Mayo,Kenia,0,1,,1,POINT (10446304 -75516486)
2013,Mayo,Kenia,3,0,,3,POINT (3451668 -76532004)
2013,Mayo,Kenia,2,1,,3,POINT (4697157 -74140516)
2013,Mayo,Kenia,0,1,,1,POINT (6170465 -7542726)
2013,Mayo,Kirguistán,0,1,,1,POINT (4697157 -74140516)
2013,Mayo,Kuwait,0,2,,2,POINT (10446304 -75516486)
2013,Mayo,Kuwait,1,1,,2,POINT (4697157 -74140516)
2013,Mayo,República de Kosovo,2,0,,2,POINT (4697157 -74140516)
2013,Mayo,Letonia,2,1,,3,POINT (10446304 -75516486)
2013,Mayo,Letonia,1,1,,2,POINT (125862 -81702165)
2013,Mayo,Letonia,1,13,,14,POINT (4697157 -74140516)
2013,Mayo,Lituania,1,2,,3,POINT (10446304 -75516486)
2013,Mayo,Lituania,0,1,,1,POINT (11360029 -72129595)
2013,Mayo,Lituania,7,9,,16,POINT (4697157 -74140516)
2013,Mayo,Lituania,2,0,,2,POINT (6170465 -7542726)
2013,Mayo,Líbano,1,1,,2,POINT (10886686 -74776479)
2013,Mayo,Líbano,8,2,,10,POINT (11360029 -72129595)
2013,Mayo,Líbano,1,3,,4,POINT (3451668 -76532004)
2013,Mayo,Líbano,9,25,,34,POINT (4697157 -74140516)
2013,Mayo,Líbano,0,1,,1,POINT (6170465 -7542726)
2013,Mayo,Liechtenstein,0,1,,1,POINT (4697157 -74140516)
2013,Mayo,Luxemburgo,1,8,,9,POINT (4697157 -74140516)
2013,Mayo,Macedonia,1,2,,3,POINT (4697157 -74140516)
2013,Mayo,Malasia,0,1,,1,POINT (10446304 -75516486)
2013,Mayo,Malasia,8,32,,40,POINT (4697157 -74140516)
2013,Mayo,Malasia,0,1,,1,POINT (6170465 -7542726)
2013,Mayo,Malasia,0,1,,1,POINT (7819 -72453013)
2013,Mayo,Malta,0,7,,7,POINT (4697157 -74140516)
2013,Mayo,Malta,0,1,,1,POINT (7819 -72453013)
2013,Mayo,Marruecos,2,6,,8,POINT (4697157 -74140516)
2013,Mayo,Mauricio,1,1,,2,POINT (6170465 -7542726)
2013,Mayo,México,0,4,,4,POINT (-4191162 -69941498)
2013,Mayo,México,2,0,,2,POINT (0.33002 -76876446)
2013,Mayo,México,6,12,,18,POINT (0.81488 -77356)
2013,Mayo,México,12,10,,22,POINT (10406342 -75527794)
2013,Mayo,México,281,345,,626,POINT (10446304 -75516486)
2013,Mayo,México,15,58,,73,POINT (10886686 -74776479)
2013,Mayo,México,1,4,,5,POINT (11360029 -72129595)
2013,Mayo,México,72,271,,343,POINT (3451668 -76532004)
2013,Mayo,México,0,2,,2,POINT (3884426 -77061029)
2013,Mayo,México,1,1,,2,POINT (445285 -75766353)
2013,Mayo,México,1650,4200,,5850,POINT (4697157 -74140516)
2013,Mayo,México,6,15,,21,POINT (4815189 -75736374)
2013,Mayo,México,123,351,,474,POINT (6170465 -7542726)
2013,Mayo,México,0,1,,1,POINT (6185536 -67484028)
2013,Mayo,México,2,3,,5,POINT (7128047 -73181317)
2013,Mayo,México,15,31,,46,POINT (7819 -72453013)
2013,Mayo,México,6,3,,9,POINT (7927233 -72508188)
2013,Mayo,México,1,2,,3,POINT (863337 -7735002)
2013,Mayo,República de Moldavia,0,1,,1,POINT (4697157 -74140516)
2013,Mayo,Mozambique,0,1,,1,POINT (3451668 -76532004)
2013,Mayo,Mozambique,1,0,,1,POINT (4697157 -74140516)
2013,Mayo,Nepal,0,1,,1,POINT (10446304 -75516486)
2013,Mayo,Nepal,1,1,,2,POINT (4697157 -74140516)
2013,Mayo,Nicaragua,4,7,,11,POINT (10446304 -75516486)
2013,Mayo,Nicaragua,1,0,,1,POINT (10886686 -74776479)
2013,Mayo,Nicaragua,2,3,,5,POINT (125862 -81702165)
2013,Mayo,Nicaragua,2,5,,7,POINT (3451668 -76532004)
2013,Mayo,Nicaragua,45,62,,107,POINT (4697157 -74140516)
2013,Mayo,Nicaragua,1,0,,1,POINT (4815189 -75736374)
2013,Mayo,Nicaragua,2,7,,9,POINT (6170465 -7542726)
2013,Mayo,Nicaragua,1,0,,1,POINT (7128047 -73181317)
2013,Mayo,Nigeria,0,1,,1,POINT (10446304 -75516486)
2013,Mayo,Nigeria,4,25,,29,POINT (4697157 -74140516)
2013,Mayo,Noruega,0,1,,1,POINT (-4191162 -69941498)
2013,Mayo,Noruega,8,5,,13,POINT (0.81488 -77356)
2013,Mayo,Noruega,1,4,,5,POINT (10446304 -75516486)
2013,Mayo,Noruega,0,3,,3,POINT (10886686 -74776479)
2013,Mayo,Noruega,0,1,,1,POINT (11360029 -72129595)
2013,Mayo,Noruega,4,6,,10,POINT (3451668 -76532004)
2013,Mayo,Noruega,36,59,,95,POINT (4697157 -74140516)
2013,Mayo,Noruega,1,8,,9,POINT (6170465 -7542726)
2013,Mayo,Noruega,2,0,,2,POINT (7128047 -73181317)
2013,Mayo,Noruega,2,0,,2,POINT (7819 -72453013)
2013,Mayo,Noruega,0,1,,1,POINT (863337 -7735002)
2013,Mayo,Nueva Zelanda,2,2,,4,POINT (-4191162 -69941498)
2013,Mayo,Nueva Zelanda,3,11,,14,POINT (0.81488 -77356)
2013,Mayo,Nueva Zelanda,3,11,,14,POINT (10446304 -75516486)
2013,Mayo,Nueva Zelanda,0,1,,1,POINT (10886686 -74776479)
2013,Mayo,Nueva Zelanda,0,2,,2,POINT (11360029 -72129595)
2013,Mayo,Nueva Zelanda,0,1,,1,POINT (1152863 -72919186)
2013,Mayo,Nueva Zelanda,2,3,,5,POINT (3451668 -76532004)
2013,Mayo,Nueva Zelanda,28,55,,83,POINT (4697157 -74140516)
2013,Mayo,Nueva Zelanda,0,1,,1,POINT (4815189 -75736374)
2013,Mayo,Nueva Zelanda,0,3,,3,POINT (6170465 -7542726)
2013,Mayo,Nueva Zelanda,0,1,,1,POINT (863337 -7735002)
2013,Mayo,Omán,4,4,,8,POINT (4697157 -74140516)
2013,Mayo,Nueva Zelanda,0,1,,1,POINT (-4191162 -69941498)
2013,Mayo,Nueva Zelanda,0,1,,1,POINT (3451668 -76532004)
2013,Mayo,Nueva Zelanda,2,5,,7,POINT (4697157 -74140516)
2013,Mayo,Países Bajos,1,1,,2,POINT (-4191162 -69941498)
2013,Mayo,Países Bajos,7,3,,10,POINT (0.81488 -77356)
2013,Mayo,Países Bajos,1,5,,6,POINT (10446304 -75516486)
2013,Mayo,Países Bajos,1,7,,8,POINT (10886686 -74776479)
2013,Mayo,Países Bajos,1,10,,11,POINT (11360029 -72129595)
2013,Mayo,Países Bajos,11,17,,28,POINT (1152863 -72919186)
2013,Mayo,Países Bajos,0,1,,1,POINT (125862 -81702165)
2013,Mayo,Países Bajos,13,12,,25,POINT (3451668 -76532004)
2013,Mayo,Países Bajos,0,1,,1,POINT (3884426 -77061029)
2013,Mayo,Países Bajos,1,0,,1,POINT (445285 -75766353)
2013,Mayo,Países Bajos,123,248,,371,POINT (4697157 -74140516)
2013,Mayo,Países Bajos,1,0,,1,POINT (4815189 -75736374)
2013,Mayo,Países Bajos,220,237,,457,POINT (6170465 -7542726)
2013,Mayo,Países Bajos,6,3,,9,POINT (7128047 -73181317)
2013,Mayo,Países Bajos,0,2,,2,POINT (7819 -72453013)
2013,Mayo,Países Bajos,0,1,,1,POINT (7927233 -72508188)
2013,Mayo,Pakistán,0,1,,1,POINT (3451668 -76532004)
2013,Mayo,Pakistán,0,7,,7,POINT (4697157 -74140516)
2013,Mayo,Palau,0,1,,1,POINT (4697157 -74140516)
2013,Mayo,Panamá,1,0,,1,POINT (-4191162 -69941498)
2013,Mayo,Panamá,0,1,,1,POINT (1800143 -78802679)
2013,Mayo,Panamá,351,413,,764,POINT (10446304 -75516486)
2013,Mayo,Panamá,39,76,,115,POINT (10886686 -74776479)
2013,Mayo,Panamá,0,1,,1,POINT (10970933 -74765343)
2013,Mayo,Panamá,1,4,,5,POINT (11360029 -72129595)
2013,Mayo,Panamá,36,30,,66,POINT (125862 -81702165)
2013,Mayo,Panamá,118,153,,271,POINT (3451668 -76532004)
2013,Mayo,Panamá,522,845,,1367,POINT (4697157 -74140516)
2013,Mayo,Panamá,76,85,,161,POINT (4815189 -75736374)
2013,Mayo,Panamá,115,233,,348,POINT (6170465 -7542726)
2013,Mayo,Panamá,5,18,,23,POINT (7128047 -73181317)
2013,Mayo,Panamá,3,4,,7,POINT (7819 -72453013)
2013,Mayo,Panamá,2,15,,17,POINT (7927233 -72508188)
2013,Mayo,Panamá,7,11,,18,POINT (863337 -7735002)
2013,Mayo,Paraguay,1,0,,1,POINT (-4191162 -69941498)
2013,Mayo,Paraguay,2,1,,3,POINT (0.81488 -77356)
2013,Mayo,Paraguay,30,32,,62,POINT (10446304 -75516486)
2013,Mayo,Paraguay,5,2,,7,POINT (125862 -81702165)
2013,Mayo,Paraguay,2,2,,4,POINT (3451668 -76532004)
2013,Mayo,Paraguay,61,93,,154,POINT (4697157 -74140516)
2013,Mayo,Paraguay,8,15,,23,POINT (6170465 -7542726)
2013,Mayo,Paraguay,0,1,,1,POINT (7927233 -72508188)
2013,Mayo,Perú,14,28,,42,POINT (-4191162 -69941498)
2013,Mayo,Perú,1,5,,6,POINT (0.33002 -76876446)
2013,Mayo,Perú,101,253,,354,POINT (0.81488 -77356)
2013,Mayo,Perú,0,1,,1,POINT (1800143 -78802679)
2013,Mayo,Perú,71,36,,107,POINT (10406342 -75527794)
2013,Mayo,Perú,114,99,,213,POINT (10446304 -75516486)
2013,Mayo,Perú,7,16,,23,POINT (10886686 -74776479)
2013,Mayo,Perú,0,1,,1,POINT (10970933 -74765343)
2013,Mayo,Perú,8,26,,34,POINT (11360029 -72129595)
2013,Mayo,Perú,44,31,,75,POINT (125862 -81702165)
2013,Mayo,Perú,118,178,,296,POINT (3451668 -76532004)
2013,Mayo,Perú,1,0,,1,POINT (445285 -75766353)
2013,Mayo,Perú,3144,3696,,6840,POINT (4697157 -74140516)
2013,Mayo,Perú,2,8,,10,POINT (4815189 -75736374)
2013,Mayo,Perú,221,390,,611,POINT (6170465 -7542726)
2013,Mayo,Perú,0,2,,2,POINT (6185536 -67484028)
2013,Mayo,Perú,2,2,,4,POINT (7128047 -73181317)
2013,Mayo,Perú,23,53,,76,POINT (7819 -72453013)
2013,Mayo,Perú,1,2,,3,POINT (7927233 -72508188)
2013,Mayo,Perú,0,1,,1,POINT (863337 -7735002)
2013,Mayo,Palestina,0,4,,4,POINT (4697157 -74140516)
2013,Mayo,Polonia,1,1,,2,POINT (-4191162 -69941498)
2013,Mayo,Polonia,11,9,,20,POINT (0.81488 -77356)
2013,Mayo,Polonia,2,2,,4,POINT (10446304 -75516486)
2013,Mayo,Polonia,0,1,,1,POINT (10970933 -74765343)
2013,Mayo,Polonia,0,3,,3,POINT (11360029 -72129595)
2013,Mayo,Polonia,0,1,,1,POINT (3451668 -76532004)
2013,Mayo,Polonia,37,82,,119,POINT (4697157 -74140516)
2013,Mayo,Polonia,3,4,,7,POINT (6170465 -7542726)
2013,Mayo,Polonia,0,2,,2,POINT (7819 -72453013)
2013,Mayo,Polonia,0,1,,1,POINT (806667 -767333)
2013,Mayo,Polonia,5,2,,7,POINT (863337 -7735002)
2013,Mayo,Portugal,0,1,,1,POINT (-4191162 -69941498)
2013,Mayo,Portugal,0,1,,1,POINT (0.33002 -76876446)
2013,Mayo,Portugal,1,4,,5,POINT (0.81488 -77356)
2013,Mayo,Portugal,0,1,,1,POINT (10406342 -75527794)
2013,Mayo,Portugal,2,10,,12,POINT (10446304 -75516486)
2013,Mayo,Portugal,1,0,,1,POINT (10886686 -74776479)
2013,Mayo,Portugal,0,1,,1,POINT (10970933 -74765343)
2013,Mayo,Portugal,1,0,,1,POINT (125862 -81702165)
2013,Mayo,Portugal,4,10,,14,POINT (3451668 -76532004)
2013,Mayo,Portugal,194,470,,664,POINT (4697157 -74140516)
2013,Mayo,Portugal,0,11,,11,POINT (6170465 -7542726)
2013,Mayo,Portugal,0,1,,1,POINT (7819 -72453013)
2013,Mayo,Portugal,1,0,,1,POINT (863337 -7735002)
2013,Mayo,Puerto Rico/Territorio de Estados Unidos,1,0,,1,POINT (10886686 -74776479)
2013,Mayo,Puerto Rico/Territorio de Estados Unidos,1,0,,1,POINT (3451668 -76532004)
2013,Mayo,Puerto Rico/Territorio de Estados Unidos,2,0,,2,POINT (6170465 -7542726)
2013,Mayo,Qatar,0,1,,1,POINT (10886686 -74776479)
2013,Mayo,Qatar,0,1,,1,POINT (4697157 -74140516)
2013,Mayo,Reino Unido de Gran Bretaña e Irlanda del Norte,6,13,,19,POINT (-4191162 -69941498)
2013,Mayo,Reino Unido de Gran Bretaña e Irlanda del Norte,20,38,,58,POINT (0.81488 -77356)
2013,Mayo,Reino Unido de Gran Bretaña e Irlanda del Norte,13,38,,51,POINT (10446304 -75516486)
2013,Mayo,Reino Unido de Gran Bretaña e Irlanda del Norte,0,4,,4,POINT (10886686 -74776479)
2013,Mayo,Reino Unido de Gran Bretaña e Irlanda del Norte,1,1,,2,POINT (11360029 -72129595)
2013,Mayo,Reino Unido de Gran Bretaña e Irlanda del Norte,0,1,,1,POINT (125862 -81702165)
2013,Mayo,Reino Unido de Gran Bretaña e Irlanda del Norte,6,18,,24,POINT (3451668 -76532004)
2013,Mayo,Reino Unido de Gran Bretaña e Irlanda del Norte,181,479,,660,POINT (4697157 -74140516)
2013,Mayo,Reino Unido de Gran Bretaña e Irlanda del Norte,10,25,,35,POINT (6170465 -7542726)
2013,Mayo,República de Belarús,1,0,,1,POINT (3451668 -76532004)
2013,Mayo,República de Belarús,1,3,,4,POINT (4697157 -74140516)
2013,Mayo,República Dominicana,1,15,,16,POINT (0.81488 -77356)
2013,Mayo,República Dominicana,17,47,,64,POINT (10446304 -75516486)
2013,Mayo,República Dominicana,8,17,,25,POINT (10886686 -74776479)
2013,Mayo,República Dominicana,2,3,,5,POINT (11360029 -72129595)
2013,Mayo,República Dominicana,0,2,,2,POINT (125862 -81702165)
2013,Mayo,República Dominicana,15,22,,37,POINT (3451668 -76532004)
2013,Mayo,República Dominicana,1,0,,1,POINT (445285 -75766353)
2013,Mayo,República Dominicana,212,354,,566,POINT (4697157 -74140516)
2013,Mayo,República Dominicana,0,1,,1,POINT (4815189 -75736374)
2013,Mayo,República Dominicana,45,80,,125,POINT (6170465 -7542726)
2013,Mayo,República Dominicana,1,0,,1,POINT (7128047 -73181317)
2013,Mayo,República Dominicana,0,3,,3,POINT (7819 -72453013)
2013,Mayo,República Dominicana,2,7,,9,POINT (7927233 -72508188)
2013,Mayo,República Checa,2,2,,4,POINT (4697157 -74140516)
2013,Mayo,Rumania,4,7,,11,POINT (10406342 -75527794)
2013,Mayo,Rumania,4,6,,10,POINT (10446304 -75516486)
2013,Mayo,Rumania,0,1,,1,POINT (10970933 -74765343)
2013,Mayo,Rumania,0,1,,1,POINT (11360029 -72129595)
2013,Mayo,Rumania,3,2,,5,POINT (3451668 -76532004)
2013,Mayo,Rumania,20,38,,58,POINT (4697157 -74140516)
2013,Mayo,Rumania,0,3,,3,POINT (6170465 -7542726)
2013,Mayo,Federación de Rusia,20,18,,38,POINT (0.81488 -77356)
2013,Mayo,Federación de Rusia,3,1,,4,POINT (10446304 -75516486)
2013,Mayo,Federación de Rusia,0,8,,8,POINT (10886686 -74776479)
2013,Mayo,Federación de Rusia,0,1,,1,POINT (11360029 -72129595)
2013,Mayo,Federación de Rusia,1,0,,1,POINT (3451668 -76532004)
2013,Mayo,Federación de Rusia,0,1,,1,POINT (3884426 -77061029)
2013,Mayo,Federación de Rusia,20,14,,34,POINT (4697157 -74140516)
2013,Mayo,Federación de Rusia,0,1,,1,POINT (6170465 -7542726)
2013,Mayo,Federación de Rusia,1,0,,1,POINT (7128047 -73181317)
2013,Mayo,Federación de Rusia,0,4,,4,POINT (9402597 -75681642)
2013,Mayo,San Cristóbal y Nevis,1,1,,2,POINT (10446304 -75516486)
2013,Mayo,San Cristóbal y Nevis,1,0,,1,POINT (3451668 -76532004)
2013,Mayo,San Cristóbal y Nevis,1,1,,2,POINT (6170465 -7542726)
2013,Mayo,San  Vicente y las Granadinas,0,1,,1,POINT (4697157 -74140516)
2013,Mayo,Santa Lucia,1,0,,1,POINT (10446304 -75516486)
2013,Mayo,Santa Lucia,1,1,,2,POINT (4697157 -74140516)
2013,Mayo,Santa Sede/Ciudad del Vaticano,0,3,,3,POINT (4697157 -74140516)
2013,Mayo,Senegal,0,1,,1,POINT (4697157 -74140516)
2013,Mayo,Serbia,1,1,,2,POINT (10446304 -75516486)
2013,Mayo,Serbia,0,1,,1,POINT (3451668 -76532004)
2013,Mayo,Serbia,3,7,,10,POINT (4697157 -74140516)
2013,Mayo,Serbia,0,1,,1,POINT (6170465 -7542726)
2013,Mayo,Singapur,3,1,,4,POINT (10446304 -75516486)
2013,Mayo,Singapur,1,0,,1,POINT (10886686 -74776479)
2013,Mayo,Singapur,6,11,,17,POINT (4697157 -74140516)
2013,Mayo,Singapur,3,4,,7,POINT (6170465 -7542726)
2013,Mayo,Singapur,0,1,,1,POINT (7819 -72453013)
2013,Mayo,República Árabe Siria,0,1,,1,POINT (4697157 -74140516)
2013,Mayo,Sri Lanka,3,5,,8,POINT (4697157 -74140516)
2013,Mayo,Sudáfrica,0,1,,1,POINT (0.81488 -77356)
2013,Mayo,Sudáfrica,2,2,,4,POINT (10446304 -75516486)
2013,Mayo,Sudáfrica,0,2,,2,POINT (10886686 -74776479)
2013,Mayo,Sudáfrica,2,1,,3,POINT (11247723 -74213989)
2013,Mayo,Sudáfrica,0,1,,1,POINT (11360029 -72129595)
2013,Mayo,Sudáfrica,25,69,,94,POINT (4697157 -74140516)
2013,Mayo,Sudáfrica,4,5,,9,POINT (6170465 -7542726)
2013,Mayo,Sudáfrica,1,0,,1,POINT (7819 -72453013)
2013,Mayo,Suecia,1,0,,1,POINT (-4191162 -69941498)
2013,Mayo,Suecia,8,16,,24,POINT (0.81488 -77356)
2013,Mayo,Suecia,2,5,,7,POINT (10446304 -75516486)
2013,Mayo,Suecia,0,3,,3,POINT (11247723 -74213989)
2013,Mayo,Suecia,7,9,,16,POINT (3451668 -76532004)
2013,Mayo,Suecia,96,160,,256,POINT (4697157 -74140516)
2013,Mayo,Suecia,3,10,,13,POINT (6170465 -7542726)
2013,Mayo,Suecia,0,1,,1,POINT (7128047 -73181317)
2013,Mayo,Suecia,0,2,,2,POINT (7819 -72453013)
2013,Mayo,Suiza,2,3,,5,POINT (-4191162 -69941498)
2013,Mayo,Suiza,2,0,,2,POINT (0.33002 -76876446)
2013,Mayo,Suiza,28,25,,53,POINT (0.81488 -77356)
2013,Mayo,Suiza,4,2,,6,POINT (10406342 -75527794)
2013,Mayo,Suiza,88,98,,186,POINT (10446304 -75516486)
2013,Mayo,Suiza,3,3,,6,POINT (10886686 -74776479)
2013,Mayo,Suiza,0,1,,1,POINT (11247723 -74213989)
2013,Mayo,Suiza,2,4,,6,POINT (11360029 -72129595)
2013,Mayo,Suiza,2,2,,4,POINT (125862 -81702165)
2013,Mayo,Suiza,15,32,,47,POINT (3451668 -76532004)
2013,Mayo,Suiza,168,380,,548,POINT (4697157 -74140516)
2013,Mayo,Suiza,1,0,,1,POINT (4815189 -75736374)
2013,Mayo,Suiza,15,32,,47,POINT (6170465 -7542726)
2013,Mayo,Suiza,0,1,,1,POINT (7128047 -73181317)
2013,Mayo,Suiza,1,3,,4,POINT (7819 -72453013)
2013,Mayo,Suiza,3,7,,10,POINT (863337 -7735002)
2013,Mayo,Surinam,1,0,,1,POINT (10446304 -75516486)
2013,Mayo,Surinam,0,1,,1,POINT (10886686 -74776479)
2013,Mayo,Surinam,4,14,,18,POINT (4697157 -74140516)
2013,Mayo,Surinam,7,9,,16,POINT (6170465 -7542726)
2013,Mayo,Surinam,0,1,,1,POINT (7128047 -73181317)
2013,Mayo,Taiwán,4,4,,8,POINT (4697157 -74140516)
2013,Mayo,Tailandia,1,1,,2,POINT (0.81488 -77356)
2013,Mayo,Tailandia,1,0,,1,POINT (10446304 -75516486)
2013,Mayo,Tailandia,5,3,,8,POINT (4697157 -74140516)
2013,Mayo,Tailandia,1,4,,5,POINT (6170465 -7542726)
2013,Mayo,Tíbet/Región Autónoma de China,2,1,,3,POINT (4697157 -74140516)
2013,Mayo,Territorio Antártico Británico/Territorio Británico de Ultramar,1,0,,1,POINT (10446304 -75516486)
2013,Mayo,Territorio Antártico Británico/Territorio Británico de Ultramar,0,1,,1,POINT (4697157 -74140516)
2013,Mayo,Tanzania,0,1,,1,POINT (10446304 -75516486)
2013,Mayo,Tanzania,0,3,,3,POINT (4697157 -74140516)
2013,Mayo,Togo,0,1,,1,POINT (10446304 -75516486)
2013,Mayo,Togo,0,2,,2,POINT (4697157 -74140516)
2013,Mayo,Trinidad y Tobago,2,7,,9,POINT (10446304 -75516486)
2013,Mayo,Trinidad y Tobago,0,1,,1,POINT (10886686 -74776479)
2013,Mayo,Trinidad y Tobago,0,1,,1,POINT (11360029 -72129595)
2013,Mayo,Trinidad y Tobago,1,2,,3,POINT (3451668 -76532004)
2013,Mayo,Trinidad y Tobago,11,35,,46,POINT (4697157 -74140516)
2013,Mayo,Trinidad y Tobago,0,2,,2,POINT (4815189 -75736374)
2013,Mayo,Trinidad y Tobago,2,10,,12,POINT (6170465 -7542726)
2013,Mayo,Trinidad y Tobago,1,1,,2,POINT (7128047 -73181317)
2013,Mayo,Trinidad y Tobago,0,1,,1,POINT (7819 -72453013)
2013,Mayo,Trinidad y Tobago,0,1,,1,POINT (7927233 -72508188)
2013,Mayo,Túnez,0,3,,3,POINT (4697157 -74140516)
2013,Mayo,Turquía,0,1,,1,POINT (0.81488 -77356)
2013,Mayo,Turquía,0,1,,1,POINT (10406342 -75527794)
2013,Mayo,Turquía,0,4,,4,POINT (10446304 -75516486)
2013,Mayo,Turquía,0,1,,1,POINT (10970933 -74765343)
2013,Mayo,Turquía,0,2,,2,POINT (3451668 -76532004)
2013,Mayo,Turquía,0,2,,2,POINT (3884426 -77061029)
2013,Mayo,Turquía,23,69,,92,POINT (4697157 -74140516)
2013,Mayo,Turquía,1,4,,5,POINT (6170465 -7542726)
2013,Mayo,Turquía,0,2,,2,POINT (7819 -72453013)
2013,Mayo,Turquía,0,2,,2,POINT (9402597 -75681642)
2013,Mayo,Turkmenistán,1,0,,1,POINT (4697157 -74140516)
2013,Mayo,Ucrania,0,1,,1,POINT (0.81488 -77356)
2013,Mayo,Ucrania,0,2,,2,POINT (10446304 -75516486)
2013,Mayo,Ucrania,0,1,,1,POINT (3451668 -76532004)
2013,Mayo,Ucrania,14,18,,32,POINT (4697157 -74140516)
2013,Mayo,Ucrania,0,2,,2,POINT (6170465 -7542726)
2013,Mayo,Uganda,1,2,,3,POINT (4697157 -74140516)
2013,Mayo,Federación de Rusia,1,0,,1,POINT (-4191162 -69941498)
2013,Mayo,Federación de Rusia,1,2,,3,POINT (0.81488 -77356)
2013,Mayo,Federación de Rusia,4,5,,9,POINT (10446304 -75516486)
2013,Mayo,Federación de Rusia,0,4,,4,POINT (10970933 -74765343)
2013,Mayo,Federación de Rusia,0,10,,10,POINT (11247723 -74213989)
2013,Mayo,Federación de Rusia,0,1,,1,POINT (11360029 -72129595)
2013,Mayo,Federación de Rusia,1,2,,3,POINT (3451668 -76532004)
2013,Mayo,Federación de Rusia,58,125,,183,POINT (4697157 -74140516)
2013,Mayo,Federación de Rusia,2,2,,4,POINT (6170465 -7542726)
2013,Mayo,Federación de Rusia,0,5,,5,POINT (7819 -72453013)
2013,Mayo,Uruguay,1,2,,3,POINT (-4191162 -69941498)
2013,Mayo,Uruguay,3,11,,14,POINT (0.81488 -77356)
2013,Mayo,Uruguay,1,2,,3,POINT (10406342 -75527794)
2013,Mayo,Uruguay,159,84,,243,POINT (10446304 -75516486)
2013,Mayo,Uruguay,0,1,,1,POINT (11360029 -72129595)
2013,Mayo,Uruguay,25,20,,45,POINT (125862 -81702165)
2013,Mayo,Uruguay,10,34,,44,POINT (3451668 -76532004)
2013,Mayo,Uruguay,167,332,,499,POINT (4697157 -74140516)
2013,Mayo,Uruguay,1,3,,4,POINT (4815189 -75736374)
2013,Mayo,Uruguay,25,40,,65,POINT (6170465 -7542726)
2013,Mayo,Uruguay,1,27,,28,POINT (7819 -72453013)
2013,Mayo,Uzbekistán,0,1,,1,POINT (10446304 -75516486)
2013,Mayo,Venezuela,1,1,,2,POINT (-4191162 -69941498)
2013,Mayo,Venezuela,0,1,,1,POINT (0.33002 -76876446)
2013,Mayo,Venezuela,40,57,,97,POINT (0.81488 -77356)
2013,Mayo,Venezuela,0,1,,1,POINT (10406342 -75527794)
2013,Mayo,Venezuela,117,178,,295,POINT (10446304 -75516486)
2013,Mayo,Venezuela,42,82,,124,POINT (10886686 -74776479)
2013,Mayo,Venezuela,0,1,,1,POINT (10970933 -74765343)
2013,Mayo,Venezuela,0,1,,1,POINT (11247723 -74213989)
2013,Mayo,Venezuela,909,1365,,2274,POINT (11360029 -72129595)
2013,Mayo,Venezuela,1,1,,2,POINT (1152863 -72919186)
2013,Mayo,Venezuela,4,4,,8,POINT (125862 -81702165)
2013,Mayo,Venezuela,46,102,,148,POINT (3451668 -76532004)
2013,Mayo,Venezuela,1,0,,1,POINT (445285 -75766353)
2013,Mayo,Venezuela,4629,6187,,10816,POINT (4697157 -74140516)
2013,Mayo,Venezuela,2,11,,13,POINT (4815189 -75736374)
2013,Mayo,Venezuela,267,440,,707,POINT (6170465 -7542726)
2013,Mayo,Venezuela,78,176,,254,POINT (6185536 -67484028)
2013,Mayo,Venezuela,52,67,,119,POINT (7088729 -70740253)
2013,Mayo,Venezuela,4,3,,7,POINT (7128047 -73181317)
2013,Mayo,Venezuela,905,1117,,2022,POINT (7819 -72453013)
2013,Mayo,Venezuela,100,151,,251,POINT (7927233 -72508188)
2013,Mayo,Vietnam,0,1,,1,POINT (4697157 -74140516)
2013,Mayo,Vietnam,0,12,,12,POINT (4815189 -75736374)
2013,Mayo,Islas Vírgenes Británicas/Territorio Británico de Ultramar,0,1,,1,POINT (3451668 -76532004)
2013,Mayo,Zimbabue,0,4,,4,POINT (4697157 -74140516)
2013,Mayo,Islas Turcas y Caicos/Territorio Británico de Ultramar,1,1,,2,POINT (4697157 -74140516)
2013,Mayo,Reino Unido de Gran Bretaña e Irlanda del Norte,7,7,,14,POINT (-4191162 -69941498)
2013,Mayo,Reino Unido de Gran Bretaña e Irlanda del Norte,81,89,,170,POINT (0.81488 -77356)
2013,Mayo,Reino Unido de Gran Bretaña e Irlanda del Norte,1,2,,3,POINT (10406342 -75527794)
2013,Mayo,Reino Unido de Gran Bretaña e Irlanda del Norte,16,40,,56,POINT (10446304 -75516486)
2013,Mayo,Reino Unido de Gran Bretaña e Irlanda del Norte,0,3,,3,POINT (10886686 -74776479)
2013,Mayo,Reino Unido de Gran Bretaña e Irlanda del Norte,0,1,,1,POINT (11247723 -74213989)
2013,Mayo,Reino Unido de Gran Bretaña e Irlanda del Norte,3,5,,8,POINT (11360029 -72129595)
2013,Mayo,Reino Unido de Gran Bretaña e Irlanda del Norte,0,1,,1,POINT (125862 -81702165)
2013,Mayo,Reino Unido de Gran Bretaña e Irlanda del Norte,2,2,,4,POINT (133387613 -81372937)
2013,Mayo,Reino Unido de Gran Bretaña e Irlanda del Norte,8,22,,30,POINT (3451668 -76532004)
2013,Mayo,Reino Unido de Gran Bretaña e Irlanda del Norte,210,530,,740,POINT (4697157 -74140516)
2013,Mayo,Reino Unido de Gran Bretaña e Irlanda del Norte,0,2,,2,POINT (4815189 -75736374)
2013,Mayo,Reino Unido de Gran Bretaña e Irlanda del Norte,8,17,,25,POINT (6170465 -7542726)
2013,Mayo,Reino Unido de Gran Bretaña e Irlanda del Norte,3,2,,5,POINT (7819 -72453013)
2013,Mayo,Reino Unido de Gran Bretaña e Irlanda del Norte,0,1,,1,POINT (7927233 -72508188)
2013,Mayo,Reino Unido de Gran Bretaña e Irlanda del Norte,9,10,,19,POINT (863337 -7735002)
2013,Mayo,Países Bajos,3,2,,5,POINT (-4191162 -69941498)
2013,Mayo,Países Bajos,20,26,,46,POINT (0.81488 -77356)
2013,Mayo,Países Bajos,9,37,,46,POINT (10446304 -75516486)
2013,Mayo,Países Bajos,0,4,,4,POINT (10886686 -74776479)
2013,Mayo,Países Bajos,3,2,,5,POINT (11247723 -74213989)
2013,Mayo,Países Bajos,2,2,,4,POINT (11360029 -72129595)
2013,Mayo,Países Bajos,1,1,,2,POINT (125862 -81702165)
2013,Mayo,Países Bajos,1,1,,2,POINT (133387613 -81372937)
2013,Mayo,Países Bajos,20,66,,86,POINT (3451668 -76532004)
2013,Mayo,Países Bajos,312,669,,981,POINT (4697157 -74140516)
2013,Mayo,Países Bajos,0,4,,4,POINT (4815189 -75736374)
2013,Mayo,Países Bajos,70,96,,166,POINT (6170465 -7542726)
2013,Mayo,Países Bajos,1,6,,7,POINT (7128047 -73181317)
2013,Mayo,Países Bajos,1,4,,5,POINT (7819 -72453013)
2013,Mayo,Países Bajos,0,3,,3,POINT (863337 -7735002)
2013,Mayo,Lituania,0,2,,2,POINT (10446304 -75516486)
2013,Mayo,Lituania,1,1,,2,POINT (4697157 -74140516)
2013,Mayo,Reino Unido de Gran Bretaña e Irlanda del Norte,1,1,,2,POINT (11247723 -74213989)
2013,Mayo,Reino Unido de Gran Bretaña e Irlanda del Norte,0,1,,1,POINT (0.81488 -77356)
2013,Mayo,Reino Unido de Gran Bretaña e Irlanda del Norte,0,1,,1,POINT (3451668 -76532004)
2013,Mayo,Reino Unido de Gran Bretaña e Irlanda del Norte,1,1,,2,POINT (0.81488 -77356)
2013,Mayo,Reino Unido de Gran Bretaña e Irlanda del Norte,0,3,,3,POINT (10446304 -75516486)
2013,Mayo,Reino Unido de Gran Bretaña e Irlanda del Norte,5,8,,13,POINT (4697157 -74140516)
2013,Mayo,Letonia,1,0,,1,POINT (4697157 -74140516)
2013,Mayo,Letonia,0,2,,2,POINT (9402597 -75681642)
2013,Mayo,Marruecos,0,1,,1,POINT (6170465 -7542726)
2013,Junio,Afganistán,0,3,,3,POINT (4697157 -74140516)
2013,Junio,Albania,0,2,,2,POINT (3451668 -76532004)
2013,Junio,Albania,1,2,,3,POINT (4697157 -74140516)
2013,Junio,Alemania,6,15,,21,POINT (-4191162 -69941498)
2013,Junio,Alemania,1,0,,1,POINT (0.33002 -76876446)
2013,Junio,Alemania,58,64,,122,POINT (0.81488 -77356)
2013,Junio,Alemania,0,1,,1,POINT (1800143 -78802679)
2013,Junio,Alemania,14,20,,34,POINT (10406342 -75527794)
2013,Junio,Alemania,22,35,,57,POINT (10446304 -75516486)
2013,Junio,Alemania,7,15,,22,POINT (10886686 -74776479)
2013,Junio,Alemania,1,1,,2,POINT (10970933 -74765343)
2013,Junio,Alemania,1,2,,3,POINT (11247723 -74213989)
2013,Junio,Alemania,5,5,,10,POINT (11360029 -72129595)
2013,Junio,Alemania,2,1,,3,POINT (125862 -81702165)
2013,Junio,Alemania,2,2,,4,POINT (133387613 -81372937)
2013,Junio,Alemania,26,51,,77,POINT (3451668 -76532004)
2013,Junio,Alemania,981,1511,,2492,POINT (4697157 -74140516)
2013,Junio,Alemania,32,81,,113,POINT (6170465 -7542726)
2013,Junio,Alemania,0,1,,1,POINT (7088729 -70740253)
2013,Junio,Alemania,1,3,,4,POINT (7128047 -73181317)
2013,Junio,Alemania,3,15,,18,POINT (7819 -72453013)
2013,Junio,Alemania,2,0,,2,POINT (7927233 -72508188)
2013,Junio,Alemania,5,5,,10,POINT (863337 -7735002)
2013,Junio,Andorra,0,8,,8,POINT (4697157 -74140516)
2013,Junio,Andorra,0,1,,1,POINT (4815189 -75736374)
2013,Junio,Andorra,0,2,,2,POINT (6170465 -7542726)
2013,Junio,Andorra,0,1,,1,POINT (7088729 -70740253)
2013,Junio,Angola,0,1,,1,POINT (3451668 -76532004)
2013,Junio,Angola,1,1,,2,POINT (4697157 -74140516)
2013,Junio,Antigua y Barbuda,0,2,,2,POINT (4697157 -74140516)
2013,Junio,Países Bajos,1,0,,1,POINT (7128047 -73181317)
2013,Junio,Arabia Saudita,1,1,,2,POINT (6170465 -7542726)
2013,Junio,Arabia Saudita,0,1,,1,POINT (10446304 -75516486)
2013,Junio,Arabia Saudita,0,9,,9,POINT (4697157 -74140516)
2013,Junio,Argelia,1,3,,4,POINT (4697157 -74140516)
2013,Junio,Argentina,3,4,,7,POINT (-4191162 -69941498)
2013,Junio,Argentina,3,9,,12,POINT (0.33002 -76876446)
2013,Junio,Argentina,70,144,,214,POINT (0.81488 -77356)
2013,Junio,Argentina,117,95,,212,POINT (10406342 -75527794)
2013,Junio,Argentina,699,463,,1162,POINT (10446304 -75516486)
2013,Junio,Argentina,5,30,,35,POINT (10886686 -74776479)
2013,Junio,Argentina,6,18,,24,POINT (11360029 -72129595)
2013,Junio,Argentina,217,171,,388,POINT (125862 -81702165)
2013,Junio,Argentina,0,1,,1,POINT (133387613 -81372937)
2013,Junio,Argentina,27,57,,84,POINT (3451668 -76532004)
2013,Junio,Argentina,1,1,,2,POINT (445285 -75766353)
2013,Junio,Argentina,2725,4243,,6968,POINT (4697157 -74140516)
2013,Junio,Argentina,0,3,,3,POINT (4815189 -75736374)
2013,Junio,Argentina,122,229,,351,POINT (6170465 -7542726)
2013,Junio,Argentina,2,3,,5,POINT (7128047 -73181317)
2013,Junio,Argentina,12,59,,71,POINT (7819 -72453013)
2013,Junio,Argentina,2,1,,3,POINT (7927233 -72508188)
2013,Junio,Argentina,2,13,,15,POINT (863337 -7735002)
2013,Junio,Aruba,4,6,,10,POINT (4697157 -74140516)
2013,Junio,Australia,7,10,,17,POINT (-4191162 -69941498)
2013,Junio,Australia,1,0,,1,POINT (0.33002 -76876446)
2013,Junio,Australia,43,44,,87,POINT (0.81488 -77356)
2013,Junio,Australia,21,30,,51,POINT (10406342 -75527794)
2013,Junio,Australia,25,20,,45,POINT (10446304 -75516486)
2013,Junio,Australia,1,9,,10,POINT (10886686 -74776479)
2013,Junio,Australia,2,1,,3,POINT (11360029 -72129595)
2013,Junio,Australia,0,2,,2,POINT (133387613 -81372937)
2013,Junio,Australia,9,19,,28,POINT (3451668 -76532004)
2013,Junio,Australia,0,1,,1,POINT (445285 -75766353)
2013,Junio,Australia,182,328,,510,POINT (4697157 -74140516)
2013,Junio,Australia,1,1,,2,POINT (4815189 -75736374)
2013,Junio,Australia,14,45,,59,POINT (6170465 -7542726)
2013,Junio,Australia,3,2,,5,POINT (7819 -72453013)
2013,Junio,Australia,1,4,,5,POINT (863337 -7735002)
2013,Junio,Austria,1,1,,2,POINT (-4191162 -69941498)
2013,Junio,Austria,6,2,,8,POINT (0.81488 -77356)
2013,Junio,Austria,1,3,,4,POINT (10406342 -75527794)
2013,Junio,Austria,5,5,,10,POINT (10446304 -75516486)
2013,Junio,Austria,2,1,,3,POINT (10886686 -74776479)
2013,Junio,Austria,0,1,,1,POINT (133387613 -81372937)
2013,Junio,Austria,1,10,,11,POINT (3451668 -76532004)
2013,Junio,Austria,67,162,,229,POINT (4697157 -74140516)
2013,Junio,Austria,1,14,,15,POINT (6170465 -7542726)
2013,Junio,Austria,0,1,,1,POINT (7819 -72453013)
2013,Junio,Austria,0,1,,1,POINT (7927233 -72508188)
2013,Junio,Austria,0,1,,1,POINT (863337 -7735002)
2013,Junio,Azerbaiyán,0,1,,1,POINT (3451668 -76532004)
2013,Junio,Azerbaiyán,1,1,,2,POINT (4697157 -74140516)
2013,Junio,Bahamas,1,0,,1,POINT (3451668 -76532004)
2013,Junio,Bahamas,5,3,,8,POINT (4697157 -74140516)
2013,Junio,Bahamas,0,2,,2,POINT (6170465 -7542726)
2013,Junio,Bangladesh,1,0,,1,POINT (3451668 -76532004)
2013,Junio,Bangladesh,0,1,,1,POINT (4697157 -74140516)
2013,Junio,Bangladesh,0,2,,2,POINT (7819 -72453013)
2013,Junio,Barbados,0,1,,1,POINT (10446304 -75516486)
2013,Junio,Barbados,0,1,,1,POINT (3451668 -76532004)
2013,Junio,Barbados,5,6,,11,POINT (4697157 -74140516)
2013,Junio,Barbados,0,2,,2,POINT (6170465 -7542726)
2013,Junio,República de Belarús,1,0,,1,POINT (10406342 -75527794)
2013,Junio,República de Belarús,1,0,,1,POINT (10446304 -75516486)
2013,Junio,República de Belarús,1,3,,4,POINT (4697157 -74140516)
2013,Junio,Bélgica,1,3,,4,POINT (-4191162 -69941498)
2013,Junio,Bélgica,14,13,,27,POINT (0.81488 -77356)
2013,Junio,Bélgica,1,4,,5,POINT (10406342 -75527794)
2013,Junio,Bélgica,3,5,,8,POINT (10446304 -75516486)
2013,Junio,Bélgica,0,1,,1,POINT (10970933 -74765343)
2013,Junio,Bélgica,0,1,,1,POINT (11360029 -72129595)
2013,Junio,Bélgica,1,2,,3,POINT (133387613 -81372937)
2013,Junio,Bélgica,8,46,,54,POINT (3451668 -76532004)
2013,Junio,Bélgica,154,275,,429,POINT (4697157 -74140516)
2013,Junio,Bélgica,17,25,,42,POINT (6170465 -7542726)
2013,Junio,Bélgica,2,1,,3,POINT (7819 -72453013)
2013,Junio,Bélgica,0,1,,1,POINT (863337 -7735002)
2013,Junio,Belice,0,3,,3,POINT (10446304 -75516486)
2013,Junio,Belice,0,1,,1,POINT (125862 -81702165)
2013,Junio,Belice,3,10,,13,POINT (4697157 -74140516)
2013,Junio,Belice,0,3,,3,POINT (6170465 -7542726)
2013,Junio,Bermudas/Territorio Británico de Ultramar,0,1,,1,POINT (3451668 -76532004)
2013,Junio,Bermudas/Territorio Británico de Ultramar,1,2,,3,POINT (4697157 -74140516)
2013,Junio,Bolivia,1,1,,2,POINT (-4191162 -69941498)
2013,Junio,Bolivia,0,1,,1,POINT (0.33002 -76876446)
2013,Junio,Bolivia,9,16,,25,POINT (0.81488 -77356)
2013,Junio,Bolivia,1,1,,2,POINT (10406342 -75527794)
2013,Junio,Bolivia,11,7,,18,POINT (10446304 -75516486)
2013,Junio,Bolivia,1,0,,1,POINT (10886686 -74776479)
2013,Junio,Bolivia,4,3,,7,POINT (125862 -81702165)
2013,Junio,Bolivia,7,19,,26,POINT (3451668 -76532004)
2013,Junio,Bolivia,0,1,,1,POINT (445285 -75766353)
2013,Junio,Bolivia,293,475,,768,POINT (4697157 -74140516)
2013,Junio,Bolivia,1,2,,3,POINT (4815189 -75736374)
2013,Junio,Bolivia,22,38,,60,POINT (6170465 -7542726)
2013,Junio,Bolivia,0,1,,1,POINT (6185536 -67484028)
2013,Junio,Bolivia,1,3,,4,POINT (7819 -72453013)
2013,Junio,Bolivia,0,1,,1,POINT (863337 -7735002)
2013,Junio,Bosnia y Herzegovina,2,8,,10,POINT (4697157 -74140516)
2013,Junio,Botsuana,0,2,,2,POINT (4697157 -74140516)
2013,Junio,Brasil,66,53,,119,POINT (-4191162 -69941498)
2013,Junio,Brasil,10,17,,27,POINT (0.81488 -77356)
2013,Junio,Brasil,41,24,,65,POINT (10406342 -75527794)
2013,Junio,Brasil,145,134,,279,POINT (10446304 -75516486)
2013,Junio,Brasil,7,28,,35,POINT (10886686 -74776479)
2013,Junio,Brasil,0,1,,1,POINT (11247723 -74213989)
2013,Junio,Brasil,11,11,,22,POINT (11360029 -72129595)
2013,Junio,Brasil,31,23,,54,POINT (125862 -81702165)
2013,Junio,Brasil,20,65,,85,POINT (3451668 -76532004)
2013,Junio,Brasil,2310,3694,,6004,POINT (4697157 -74140516)
2013,Junio,Brasil,0,3,,3,POINT (4815189 -75736374)
2013,Junio,Brasil,64,137,,201,POINT (6170465 -7542726)
2013,Junio,Brasil,0,1,,1,POINT (6185536 -67484028)
2013,Junio,Brasil,1,3,,4,POINT (7128047 -73181317)
2013,Junio,Brasil,7,41,,48,POINT (7819 -72453013)
2013,Junio,Brasil,1,2,,3,POINT (7927233 -72508188)
2013,Junio,Brasil,0,1,,1,POINT (863337 -7735002)
2013,Junio,Bulgaria,0,1,,1,POINT (10446304 -75516486)
2013,Junio,Bulgaria,10,8,,18,POINT (4697157 -74140516)
2013,Junio,Burkina Faso,1,1,,2,POINT (4697157 -74140516)
2013,Junio,Cabo Verde,0,1,,1,POINT (3451668 -76532004)
2013,Junio,Cabo Verde,0,1,,1,POINT (4697157 -74140516)
2013,Junio,Islas Caimán/Territorio Británico de Ultramar,0,1,,1,POINT (10886686 -74776479)
2013,Junio,Islas Caimán/Territorio Británico de Ultramar,2,4,,6,POINT (125862 -81702165)
2013,Junio,Islas Caimán/Territorio Británico de Ultramar,1,0,,1,POINT (4697157 -74140516)
2013,Junio,Camerún,1,0,,1,POINT (0.81488 -77356)
2013,Junio,Camerún,1,0,,1,POINT (11360029 -72129595)
2013,Junio,Camerún,0,1,,1,POINT (3451668 -76532004)
2013,Junio,Camerún,0,2,,2,POINT (4697157 -74140516)
2013,Junio,Camerún,0,1,,1,POINT (6170465 -7542726)
2013,Junio,Canadá,3,10,,13,POINT (-4191162 -69941498)
2013,Junio,Canadá,12,16,,28,POINT (0.81488 -77356)
2013,Junio,Canadá,6,9,,15,POINT (10406342 -75527794)
2013,Junio,Canadá,42,79,,121,POINT (10446304 -75516486)
2013,Junio,Canadá,8,27,,35,POINT (10886686 -74776479)
2013,Junio,Canadá,0,2,,2,POINT (11247723 -74213989)
2013,Junio,Canadá,1,4,,5,POINT (11360029 -72129595)
2013,Junio,Canadá,0,3,,3,POINT (125862 -81702165)
2013,Junio,Canadá,56,54,,110,POINT (3451668 -76532004)
2013,Junio,Canadá,2,1,,3,POINT (445285 -75766353)
2013,Junio,Canadá,687,1206,,1893,POINT (4697157 -74140516)
2013,Junio,Canadá,0,3,,3,POINT (4815189 -75736374)
2013,Junio,Canadá,70,150,,220,POINT (6170465 -7542726)
2013,Junio,Canadá,2,4,,6,POINT (7128047 -73181317)
2013,Junio,Canadá,6,10,,16,POINT (7819 -72453013)
2013,Junio,Canadá,3,0,,3,POINT (7927233 -72508188)
2013,Junio,Canadá,3,1,,4,POINT (863337 -7735002)
2013,Junio,España,0,1,,1,POINT (0.33002 -76876446)
2013,Junio,España,3,15,,18,POINT (0.81488 -77356)
2013,Junio,España,4,4,,8,POINT (10406342 -75527794)
2013,Junio,España,0,1,,1,POINT (10446304 -75516486)
2013,Junio,España,2,4,,6,POINT (10886686 -74776479)
2013,Junio,España,0,1,,1,POINT (11247723 -74213989)
2013,Junio,España,44,71,,115,POINT (3451668 -76532004)
2013,Junio,España,112,295,,407,POINT (4697157 -74140516)
2013,Junio,España,0,2,,2,POINT (4815189 -75736374)
2013,Junio,España,48,130,,178,POINT (6170465 -7542726)
2013,Junio,España,0,1,,1,POINT (7088729 -70740253)
2013,Junio,España,0,1,,1,POINT (7819 -72453013)
2013,Junio,República Democrática del Congo,1,0,,1,POINT (4697157 -74140516)
2013,Junio,República Democrática del Congo,0,2,,2,POINT (7819 -72453013)
2013,Junio,República de Corea,2,1,,3,POINT (-4191162 -69941498)
2013,Junio,República de Corea,6,7,,13,POINT (0.81488 -77356)
2013,Junio,República de Corea,4,8,,12,POINT (10446304 -75516486)
2013,Junio,República de Corea,0,1,,1,POINT (10886686 -74776479)
2013,Junio,República de Corea,0,1,,1,POINT (10970933 -74765343)
2013,Junio,República de Corea,1,0,,1,POINT (11360029 -72129595)
2013,Junio,República de Corea,1,0,,1,POINT (125862 -81702165)
2013,Junio,República de Corea,3,8,,11,POINT (3451668 -76532004)
2013,Junio,República de Corea,111,334,,445,POINT (4697157 -74140516)
2013,Junio,República de Corea,3,25,,28,POINT (6170465 -7542726)
2013,Junio,República de Corea,0,5,,5,POINT (7819 -72453013)
2013,Junio,Costa de Marfil,0,4,,4,POINT (4697157 -74140516)
2013,Junio,Costa Rica,1,2,,3,POINT (0.81488 -77356)
2013,Junio,Costa Rica,30,44,,74,POINT (10446304 -75516486)
2013,Junio,Costa Rica,11,25,,36,POINT (10886686 -74776479)
2013,Junio,Costa Rica,1,1,,2,POINT (11360029 -72129595)
2013,Junio,Costa Rica,224,188,,412,POINT (125862 -81702165)
2013,Junio,Costa Rica,25,58,,83,POINT (3451668 -76532004)
2013,Junio,Costa Rica,489,871,,1360,POINT (4697157 -74140516)
2013,Junio,Costa Rica,1,9,,10,POINT (4815189 -75736374)
2013,Junio,Costa Rica,83,152,,235,POINT (6170465 -7542726)
2013,Junio,Costa Rica,2,2,,4,POINT (7819 -72453013)
2013,Junio,Costa Rica,0,1,,1,POINT (7927233 -72508188)
2013,Junio,Costa Rica,0,1,,1,POINT (863337 -7735002)
2013,Junio,Croacia,0,3,,3,POINT (10406342 -75527794)
2013,Junio,Croacia,1,1,,2,POINT (10446304 -75516486)
2013,Junio,Croacia,0,9,,9,POINT (3451668 -76532004)
2013,Junio,Croacia,5,17,,22,POINT (4697157 -74140516)
2013,Junio,Croacia,0,2,,2,POINT (6170465 -7542726)
2013,Junio,Croacia,0,1,,1,POINT (7819 -72453013)
2013,Junio,Cuba,2,16,,18,POINT (10446304 -75516486)
2013,Junio,Cuba,4,5,,9,POINT (10886686 -74776479)
2013,Junio,Cuba,18,40,,58,POINT (3451668 -76532004)
2013,Junio,Cuba,84,138,,222,POINT (4697157 -74140516)
2013,Junio,Cuba,1,1,,2,POINT (4815189 -75736374)
2013,Junio,Cuba,12,15,,27,POINT (6170465 -7542726)
2013,Junio,Cuba,1,1,,2,POINT (7128047 -73181317)
2013,Junio,Cuba,0,1,,1,POINT (7819 -72453013)
2013,Junio,Cuba,1,1,,2,POINT (7927233 -72508188)
2013,Junio,Curazao,3,5,,8,POINT (4697157 -74140516)
2013,Junio,Curazao,2,1,,3,POINT (6170465 -7542726)
2013,Junio,República Checa,2,5,,7,POINT (0.81488 -77356)
2013,Junio,República Checa,0,1,,1,POINT (10446304 -75516486)
2013,Junio,República Checa,1,0,,1,POINT (11360029 -72129595)
2013,Junio,República Checa,17,28,,45,POINT (4697157 -74140516)
2013,Junio,República Checa,3,0,,3,POINT (6170465 -7542726)
2013,Junio,República Checa,1,0,,1,POINT (7819 -72453013)
2013,Junio,República Checa,0,3,,3,POINT (863337 -7735002)
2013,Junio,Chile,1,0,,1,POINT (-4191162 -69941498)
2013,Junio,Chile,27,53,,80,POINT (0.81488 -77356)
2013,Junio,Chile,46,41,,87,POINT (10406342 -75527794)
2013,Junio,Chile,88,66,,154,POINT (10446304 -75516486)
2013,Junio,Chile,3,13,,16,POINT (10886686 -74776479)
2013,Junio,Chile,4,12,,16,POINT (11360029 -72129595)
2013,Junio,Chile,41,25,,66,POINT (125862 -81702165)
2013,Junio,Chile,30,109,,139,POINT (3451668 -76532004)
2013,Junio,Chile,2499,3770,,6269,POINT (4697157 -74140516)
2013,Junio,Chile,0,5,,5,POINT (4815189 -75736374)
2013,Junio,Chile,39,87,,126,POINT (6170465 -7542726)
2013,Junio,Chile,1,1,,2,POINT (7128047 -73181317)
2013,Junio,Chile,7,31,,38,POINT (7819 -72453013)
2013,Junio,Chile,0,2,,2,POINT (7927233 -72508188)
2013,Junio,Chile,1,1,,2,POINT (863337 -7735002)
2013,Junio,China,1,0,,1,POINT (-4191162 -69941498)
2013,Junio,China,3,2,,5,POINT (0.81488 -77356)
2013,Junio,China,4,3,,7,POINT (10446304 -75516486)
2013,Junio,China,2,4,,6,POINT (10886686 -74776479)
2013,Junio,China,4,11,,15,POINT (3451668 -76532004)
2013,Junio,China,161,440,,601,POINT (4697157 -74140516)
2013,Junio,China,6,12,,18,POINT (6170465 -7542726)
2013,Junio,China,1,1,,2,POINT (7927233 -72508188)
2013,Junio,Taiwán,1,3,,4,POINT (10886686 -74776479)
2013,Junio,Taiwán,3,5,,8,POINT (3451668 -76532004)
2013,Junio,Taiwán,43,61,,104,POINT (4697157 -74140516)
2013,Junio,Taiwán,0,1,,1,POINT (4815189 -75736374)
2013,Junio,Taiwán,5,8,,13,POINT (6170465 -7542726)
2013,Junio,Taiwán,0,1,,1,POINT (7819 -72453013)
2013,Junio,Chipre,0,2,,2,POINT (4697157 -74140516)
2013,Junio,Chipre,0,1,,1,POINT (6170465 -7542726)
2013,Junio,Dinamarca,0,5,,5,POINT (-4191162 -69941498)
2013,Junio,Dinamarca,8,5,,13,POINT (0.81488 -77356)
2013,Junio,Dinamarca,0,2,,2,POINT (10406342 -75527794)
2013,Junio,Dinamarca,3,7,,10,POINT (10446304 -75516486)
2013,Junio,Dinamarca,1,0,,1,POINT (10886686 -74776479)
2013,Junio,Dinamarca,0,5,,5,POINT (3451668 -76532004)
2013,Junio,Dinamarca,51,111,,162,POINT (4697157 -74140516)
2013,Junio,Dinamarca,7,17,,24,POINT (6170465 -7542726)
2013,Junio,Dominica,0,1,,1,POINT (10406342 -75527794)
2013,Junio,Dominica,0,1,,1,POINT (11360029 -72129595)
2013,Junio,Dominica,0,3,,3,POINT (4697157 -74140516)
2013,Junio,Ecuador,0,1,,1,POINT (-4191162 -69941498)
2013,Junio,Ecuador,22,66,,88,POINT (0.33002 -76876446)
2013,Junio,Ecuador,764,1506,,2270,POINT (0.81488 -77356)
2013,Junio,Ecuador,1,141,,142,POINT (1800143 -78802679)
2013,Junio,Ecuador,11,51,,62,POINT (10406342 -75527794)
2013,Junio,Ecuador,18,23,,41,POINT (10446304 -75516486)
2013,Junio,Ecuador,1,5,,6,POINT (10886686 -74776479)
2013,Junio,Ecuador,11,12,,23,POINT (11360029 -72129595)
2013,Junio,Ecuador,5,6,,11,POINT (125862 -81702165)
2013,Junio,Ecuador,303,371,,674,POINT (3451668 -76532004)
2013,Junio,Ecuador,0,2,,2,POINT (445285 -75766353)
2013,Junio,Ecuador,1566,2670,,4236,POINT (4697157 -74140516)
2013,Junio,Ecuador,0,1,,1,POINT (4815189 -75736374)
2013,Junio,Ecuador,367,445,,812,POINT (6170465 -7542726)
2013,Junio,Ecuador,0,1,,1,POINT (7088729 -70740253)
2013,Junio,Ecuador,94,144,,238,POINT (7819 -72453013)
2013,Junio,Ecuador,0,7,,7,POINT (7927233 -72508188)
2013,Junio,Egipto,0,1,,1,POINT (0.81488 -77356)
2013,Junio,Egipto,2,14,,16,POINT (4697157 -74140516)
2013,Junio,El Salvador,1,0,,1,POINT (-4191162 -69941498)
2013,Junio,El Salvador,0,2,,2,POINT (10406342 -75527794)
2013,Junio,El Salvador,7,6,,13,POINT (10446304 -75516486)
2013,Junio,El Salvador,1,4,,5,POINT (10886686 -74776479)
2013,Junio,El Salvador,2,2,,4,POINT (125862 -81702165)
2013,Junio,El Salvador,52,73,,125,POINT (3451668 -76532004)
2013,Junio,El Salvador,0,1,,1,POINT (445285 -75766353)
2013,Junio,El Salvador,373,633,,1006,POINT (4697157 -74140516)
2013,Junio,El Salvador,32,56,,88,POINT (6170465 -7542726)
2013,Junio,El Salvador,0,1,,1,POINT (7128047 -73181317)
2013,Junio,El Salvador,0,1,,1,POINT (7819 -72453013)
2013,Junio,El Salvador,0,1,,1,POINT (863337 -7735002)
2013,Junio,Emiratos Árabes,0,1,,1,POINT (3451668 -76532004)
2013,Junio,Emiratos Árabes,2,11,,13,POINT (4697157 -74140516)
2013,Junio,España,4,3,,7,POINT (-4191162 -69941498)
2013,Junio,España,1,2,,3,POINT (0.33002 -76876446)
2013,Junio,España,20,33,,53,POINT (0.81488 -77356)
2013,Junio,España,10,26,,36,POINT (10406342 -75527794)
2013,Junio,España,22,53,,75,POINT (10446304 -75516486)
2013,Junio,España,5,15,,20,POINT (10886686 -74776479)
2013,Junio,España,2,2,,4,POINT (10970933 -74765343)
2013,Junio,España,0,1,,1,POINT (11247723 -74213989)
2013,Junio,España,1,10,,11,POINT (11360029 -72129595)
2013,Junio,España,1,0,,1,POINT (1152863 -72919186)
2013,Junio,España,4,7,,11,POINT (125862 -81702165)
2013,Junio,España,258,400,,658,POINT (3451668 -76532004)
2013,Junio,España,1,1,,2,POINT (445285 -75766353)
2013,Junio,España,1929,4588,,6517,POINT (4697157 -74140516)
2013,Junio,España,1,7,,8,POINT (4815189 -75736374)
2013,Junio,España,80,201,,281,POINT (6170465 -7542726)
2013,Junio,España,2,2,,4,POINT (7088729 -70740253)
2013,Junio,España,2,4,,6,POINT (7128047 -73181317)
2013,Junio,España,17,46,,63,POINT (7819 -72453013)
2013,Junio,España,3,1,,4,POINT (863337 -7735002)
2013,Junio,Eslovaquia,2,3,,5,POINT (0.81488 -77356)
2013,Junio,Eslovaquia,1,1,,2,POINT (10406342 -75527794)
2013,Junio,Eslovaquia,1,0,,1,POINT (10446304 -75516486)
2013,Junio,Eslovaquia,7,18,,25,POINT (4697157 -74140516)
2013,Junio,Eslovaquia,0,4,,4,POINT (6170465 -7542726)
2013,Junio,Eslovenia,0,2,,2,POINT (10406342 -75527794)
2013,Junio,Eslovenia,0,1,,1,POINT (11360029 -72129595)
2013,Junio,Eslovenia,0,2,,2,POINT (3451668 -76532004)
2013,Junio,Eslovenia,11,21,,32,POINT (4697157 -74140516)
2013,Junio,Estados Unidos de América,13,31,,44,POINT (-4191162 -69941498)
2013,Junio,Estados Unidos de América,0,1,,1,POINT (0.33002 -76876446)
2013,Junio,Estados Unidos de América,57,84,,141,POINT (0.81488 -77356)
2013,Junio,Estados Unidos de América,22,59,,81,POINT (10406342 -75527794)
2013,Junio,Estados Unidos de América,1461,2179,,3640,POINT (10446304 -75516486)
2013,Junio,Estados Unidos de América,505,778,,1283,POINT (10886686 -74776479)
2013,Junio,Estados Unidos de América,6,10,,16,POINT (11360029 -72129595)
2013,Junio,Estados Unidos de América,0,1,,1,POINT (1152863 -72919186)
2013,Junio,Estados Unidos de América,16,20,,36,POINT (125862 -81702165)
2013,Junio,Estados Unidos de América,1,4,,5,POINT (133387613 -81372937)
2013,Junio,Estados Unidos de América,1526,1916,,3442,POINT (3451668 -76532004)
2013,Junio,Estados Unidos de América,162,165,,327,POINT (445285 -75766353)
2013,Junio,Estados Unidos de América,8580,13489,,22069,POINT (4697157 -74140516)
2013,Junio,Estados Unidos de América,182,212,,394,POINT (4815189 -75736374)
2013,Junio,Estados Unidos de América,2105,3378,,5483,POINT (6170465 -7542726)
2013,Junio,Estados Unidos de América,1,4,,5,POINT (7088729 -70740253)
2013,Junio,Estados Unidos de América,43,56,,99,POINT (7128047 -73181317)
2013,Junio,Estados Unidos de América,30,39,,69,POINT (7819 -72453013)
2013,Junio,Estados Unidos de América,21,19,,40,POINT (7927233 -72508188)
2013,Junio,Estados Unidos de América,5,7,,12,POINT (863337 -7735002)
2013,Junio,Estonia,0,1,,1,POINT (0.81488 -77356)
2013,Junio,Estonia,1,0,,1,POINT (10406342 -75527794)
2013,Junio,Estonia,3,0,,3,POINT (4697157 -74140516)
2013,Junio,Estonia,1,0,,1,POINT (6170465 -7542726)
2013,Junio,Etiopia,0,4,,4,POINT (4697157 -74140516)
2013,Junio,Filipinas,0,25,,25,POINT (10406342 -75527794)
2013,Junio,Filipinas,1,21,,22,POINT (10446304 -75516486)
2013,Junio,Filipinas,0,21,,21,POINT (10970933 -74765343)
2013,Junio,Filipinas,0,7,,7,POINT (11247723 -74213989)
2013,Junio,Filipinas,0,17,,17,POINT (3451668 -76532004)
2013,Junio,Filipinas,0,1,,1,POINT (3884426 -77061029)
2013,Junio,Filipinas,17,75,,92,POINT (4697157 -74140516)
2013,Junio,Filipinas,2,3,,5,POINT (6170465 -7542726)
2013,Junio,Filipinas,0,1,,1,POINT (7819 -72453013)
2013,Junio,Filipinas,0,5,,5,POINT (9402597 -75681642)
2013,Junio,Finlandia,4,3,,7,POINT (0.81488 -77356)
2013,Junio,Finlandia,1,0,,1,POINT (10406342 -75527794)
2013,Junio,Finlandia,2,2,,4,POINT (10886686 -74776479)
2013,Junio,Finlandia,0,1,,1,POINT (3451668 -76532004)
2013,Junio,Finlandia,36,40,,76,POINT (4697157 -74140516)
2013,Junio,Finlandia,0,2,,2,POINT (6170465 -7542726)
2013,Junio,Finlandia,1,0,,1,POINT (7819 -72453013)
2013,Junio,Francia,8,7,,15,POINT (-4191162 -69941498)
2013,Junio,Francia,1,2,,3,POINT (0.33002 -76876446)
2013,Junio,Francia,51,65,,116,POINT (0.81488 -77356)
2013,Junio,Francia,6,15,,21,POINT (10406342 -75527794)
2013,Junio,Francia,13,15,,28,POINT (10446304 -75516486)
2013,Junio,Francia,3,4,,7,POINT (10886686 -74776479)
2013,Junio,Francia,0,1,,1,POINT (10970933 -74765343)
2013,Junio,Francia,1,0,,1,POINT (11247723 -74213989)
2013,Junio,Francia,4,5,,9,POINT (11360029 -72129595)
2013,Junio,Francia,0,1,,1,POINT (125744111 -81703935)
2013,Junio,Francia,2,3,,5,POINT (125862 -81702165)
2013,Junio,Francia,2,4,,6,POINT (133387613 -81372937)
2013,Junio,Francia,28,48,,76,POINT (3451668 -76532004)
2013,Junio,Francia,864,1588,,2452,POINT (4697157 -74140516)
2013,Junio,Francia,0,2,,2,POINT (4815189 -75736374)
2013,Junio,Francia,41,86,,127,POINT (6170465 -7542726)
2013,Junio,Francia,5,8,,13,POINT (7819 -72453013)
2013,Junio,Francia,3,8,,11,POINT (863337 -7735002)
2013,Junio,Georgia,1,1,,2,POINT (4697157 -74140516)
2013,Junio,Granada,0,1,,1,POINT (3451668 -76532004)
2013,Junio,Granada,0,2,,2,POINT (4697157 -74140516)
2013,Junio,Grecia,0,2,,2,POINT (10406342 -75527794)
2013,Junio,Grecia,0,1,,1,POINT (10446304 -75516486)
2013,Junio,Grecia,0,1,,1,POINT (10886686 -74776479)
2013,Junio,Grecia,0,1,,1,POINT (10970933 -74765343)
2013,Junio,Grecia,0,1,,1,POINT (11247723 -74213989)
2013,Junio,Grecia,0,3,,3,POINT (3451668 -76532004)
2013,Junio,Grecia,0,1,,1,POINT (3884426 -77061029)
2013,Junio,Grecia,13,50,,63,POINT (4697157 -74140516)
2013,Junio,Grecia,3,3,,6,POINT (6170465 -7542726)
2013,Junio,Grecia,0,2,,2,POINT (7819 -72453013)
2013,Junio,Guatemala,2,0,,2,POINT (0.81488 -77356)
2013,Junio,Guatemala,2,4,,6,POINT (10406342 -75527794)
2013,Junio,Guatemala,32,51,,83,POINT (10446304 -75516486)
2013,Junio,Guatemala,3,12,,15,POINT (10886686 -74776479)
2013,Junio,Guatemala,0,1,,1,POINT (11360029 -72129595)
2013,Junio,Guatemala,6,6,,12,POINT (125862 -81702165)
2013,Junio,Guatemala,19,79,,98,POINT (3451668 -76532004)
2013,Junio,Guatemala,210,439,,649,POINT (4697157 -74140516)
2013,Junio,Guatemala,3,1,,4,POINT (4815189 -75736374)
2013,Junio,Guatemala,73,129,,202,POINT (6170465 -7542726)
2013,Junio,Guatemala,4,0,,4,POINT (7128047 -73181317)
2013,Junio,Guatemala,9,43,,52,POINT (7819 -72453013)
2013,Junio,Guatemala,6,38,,44,POINT (7927233 -72508188)
2013,Junio,Guatemala,0,4,,4,POINT (863337 -7735002)
2013,Junio,Guyana,0,2,,2,POINT (10446304 -75516486)
2013,Junio,Guyana,0,1,,1,POINT (10886686 -74776479)
2013,Junio,Guyana,9,12,,21,POINT (4697157 -74140516)
2013,Junio,Guyana,0,2,,2,POINT (4815189 -75736374)
2013,Junio,Guyana,1,2,,3,POINT (6170465 -7542726)
2013,Junio,Guayana Francesa/Departamento de Ultramar Francés,0,1,,1,POINT (4697157 -74140516)
2013,Junio,Haití,1,1,,2,POINT (10446304 -75516486)
2013,Junio,Haití,0,1,,1,POINT (10886686 -74776479)
2013,Junio,Haití,0,2,,2,POINT (3451668 -76532004)
2013,Junio,Haití,6,9,,15,POINT (4697157 -74140516)
2013,Junio,Haití,2,1,,3,POINT (6170465 -7542726)
2013,Junio,Honduras,1,0,,1,POINT (0.81488 -77356)
2013,Junio,Honduras,1,7,,8,POINT (10406342 -75527794)
2013,Junio,Honduras,12,18,,30,POINT (10446304 -75516486)
2013,Junio,Honduras,6,7,,13,POINT (10886686 -74776479)
2013,Junio,Honduras,0,1,,1,POINT (10970933 -74765343)
2013,Junio,Honduras,1,2,,3,POINT (125862 -81702165)
2013,Junio,Honduras,16,32,,48,POINT (3451668 -76532004)
2013,Junio,Honduras,0,1,,1,POINT (445285 -75766353)
2013,Junio,Honduras,121,206,,327,POINT (4697157 -74140516)
2013,Junio,Honduras,19,28,,47,POINT (6170465 -7542726)
2013,Junio,Honduras,1,0,,1,POINT (7128047 -73181317)
2013,Junio,Honduras,2,0,,2,POINT (7819 -72453013)
2013,Junio,Honduras,1,0,,1,POINT (7927233 -72508188)
2013,Junio,Honduras,0,1,,1,POINT (863337 -7735002)
2013,Junio,Hong Kong,2,0,,2,POINT (4697157 -74140516)
2013,Junio,Hungría,1,1,,2,POINT (0.81488 -77356)
2013,Junio,Hungría,10,17,,27,POINT (4697157 -74140516)
2013,Junio,Hungría,1,0,,1,POINT (6170465 -7542726)
2013,Junio,India,3,2,,5,POINT (0.81488 -77356)
2013,Junio,India,0,1,,1,POINT (10406342 -75527794)
2013,Junio,India,0,4,,4,POINT (10446304 -75516486)
2013,Junio,India,2,5,,7,POINT (10886686 -74776479)
2013,Junio,India,0,1,,1,POINT (10970933 -74765343)
2013,Junio,India,0,1,,1,POINT (11247723 -74213989)
2013,Junio,India,0,2,,2,POINT (125862 -81702165)
2013,Junio,India,5,44,,49,POINT (3451668 -76532004)
2013,Junio,India,33,220,,253,POINT (4697157 -74140516)
2013,Junio,India,5,23,,28,POINT (6170465 -7542726)
2013,Junio,Indonesia,1,0,,1,POINT (10446304 -75516486)
2013,Junio,Indonesia,0,3,,3,POINT (3451668 -76532004)
2013,Junio,Indonesia,9,34,,43,POINT (4697157 -74140516)
2013,Junio,Iraq,0,1,,1,POINT (4697157 -74140516)
2013,Junio,Irán,9,16,,25,POINT (4697157 -74140516)
2013,Junio,Irán,0,1,,1,POINT (6170465 -7542726)
2013,Junio,República de Irlanda,2,2,,4,POINT (-4191162 -69941498)
2013,Junio,República de Irlanda,1,0,,1,POINT (0.33002 -76876446)
2013,Junio,República de Irlanda,31,17,,48,POINT (0.81488 -77356)
2013,Junio,República de Irlanda,4,4,,8,POINT (10406342 -75527794)
2013,Junio,República de Irlanda,5,8,,13,POINT (10446304 -75516486)
2013,Junio,República de Irlanda,1,4,,5,POINT (11360029 -72129595)
2013,Junio,República de Irlanda,1,1,,2,POINT (125862 -81702165)
2013,Junio,República de Irlanda,0,2,,2,POINT (3451668 -76532004)
2013,Junio,República de Irlanda,81,114,,195,POINT (4697157 -74140516)
2013,Junio,República de Irlanda,9,6,,15,POINT (6170465 -7542726)
2013,Junio,República de Irlanda,2,0,,2,POINT (7819 -72453013)
2013,Junio,República de Irlanda,0,1,,1,POINT (7927233 -72508188)
2013,Junio,República de Irlanda,0,1,,1,POINT (863337 -7735002)
2013,Junio,Islandia,0,1,,1,POINT (3451668 -76532004)
2013,Junio,Islandia,5,3,,8,POINT (4697157 -74140516)
2013,Junio,Islandia,1,0,,1,POINT (7819 -72453013)
2013,Junio,Isla de Man,0,1,,1,POINT (-4191162 -69941498)
2013,Junio,Isla de Man,22,32,,54,POINT (0.81488 -77356)
2013,Junio,Isla de Man,3,9,,12,POINT (10446304 -75516486)
2013,Junio,Isla de Man,0,1,,1,POINT (10886686 -74776479)
2013,Junio,Isla de Man,2,11,,13,POINT (3451668 -76532004)
2013,Junio,Isla de Man,30,72,,102,POINT (4697157 -74140516)
2013,Junio,Isla de Man,18,37,,55,POINT (6170465 -7542726)
2013,Junio,Isla Johnston,0,1,,1,POINT (3451668 -76532004)
2013,Junio,Israel,2,0,,2,POINT (-4191162 -69941498)
2013,Junio,Israel,22,85,,107,POINT (0.81488 -77356)
2013,Junio,Israel,1,7,,8,POINT (10406342 -75527794)
2013,Junio,Israel,1,22,,23,POINT (10446304 -75516486)
2013,Junio,Israel,0,1,,1,POINT (10886686 -74776479)
2013,Junio,Israel,0,1,,1,POINT (11247723 -74213989)
2013,Junio,Israel,10,16,,26,POINT (3451668 -76532004)
2013,Junio,Israel,94,388,,482,POINT (4697157 -74140516)
2013,Junio,Israel,7,32,,39,POINT (6170465 -7542726)
2013,Junio,Israel,0,2,,2,POINT (7927233 -72508188)
2013,Junio,Israel,1,3,,4,POINT (863337 -7735002)
2013,Junio,Isla Wake,12,5,,17,POINT (7927233 -72508188)
2013,Junio,Italia,1,1,,2,POINT (-4191162 -69941498)
2013,Junio,Italia,12,31,,43,POINT (0.81488 -77356)
2013,Junio,Italia,6,6,,12,POINT (10406342 -75527794)
2013,Junio,Italia,17,43,,60,POINT (10446304 -75516486)
2013,Junio,Italia,5,11,,16,POINT (10886686 -74776479)
2013,Junio,Italia,1,3,,4,POINT (11247723 -74213989)
2013,Junio,Italia,3,9,,12,POINT (11360029 -72129595)
2013,Junio,Italia,9,5,,14,POINT (125862 -81702165)
2013,Junio,Italia,34,82,,116,POINT (3451668 -76532004)
2013,Junio,Italia,429,1351,,1780,POINT (4697157 -74140516)
2013,Junio,Italia,0,2,,2,POINT (4815189 -75736374)
2013,Junio,Italia,22,55,,77,POINT (6170465 -7542726)
2013,Junio,Italia,0,1,,1,POINT (7088729 -70740253)
2013,Junio,Italia,0,3,,3,POINT (7128047 -73181317)
2013,Junio,Italia,4,13,,17,POINT (7819 -72453013)
2013,Junio,Italia,0,1,,1,POINT (7927233 -72508188)
2013,Junio,Italia,1,7,,8,POINT (863337 -7735002)
2013,Junio,Islas del Canal,0,1,,1,POINT (10886686 -74776479)
2013,Junio,Islas del Canal,1,1,,2,POINT (863337 -7735002)
2013,Junio,Jamaica,1,5,,6,POINT (10446304 -75516486)
2013,Junio,Jamaica,0,1,,1,POINT (10886686 -74776479)
2013,Junio,Jamaica,2,11,,13,POINT (125862 -81702165)
2013,Junio,Jamaica,3,5,,8,POINT (3451668 -76532004)
2013,Junio,Jamaica,13,20,,33,POINT (4697157 -74140516)
2013,Junio,Jamaica,0,1,,1,POINT (4815189 -75736374)
2013,Junio,Jamaica,3,5,,8,POINT (6170465 -7542726)
2013,Junio,Japón,1,2,,3,POINT (-4191162 -69941498)
2013,Junio,Japón,13,19,,32,POINT (0.81488 -77356)
2013,Junio,Japón,1,2,,3,POINT (10406342 -75527794)
2013,Junio,Japón,3,6,,9,POINT (10446304 -75516486)
2013,Junio,Japón,2,6,,8,POINT (10886686 -74776479)
2013,Junio,Japón,1,1,,2,POINT (11360029 -72129595)
2013,Junio,Japón,5,17,,22,POINT (3451668 -76532004)
2013,Junio,Japón,82,400,,482,POINT (4697157 -74140516)
2013,Junio,Japón,2,36,,38,POINT (6170465 -7542726)
2013,Junio,Japón,4,2,,6,POINT (7819 -72453013)
2013,Junio,Japón,1,1,,2,POINT (863337 -7735002)
2013,Junio,Jordania,0,1,,1,POINT (3451668 -76532004)
2013,Junio,Jordania,1,1,,2,POINT (4697157 -74140516)
2013,Junio,Jordania,0,1,,1,POINT (6170465 -7542726)
2013,Junio,Kazajistán,4,1,,5,POINT (4697157 -74140516)
2013,Junio,Kazajistán,0,1,,1,POINT (6170465 -7542726)
2013,Junio,Kenia,1,0,,1,POINT (3451668 -76532004)
2013,Junio,Kenia,2,8,,10,POINT (4697157 -74140516)
2013,Junio,Kenia,0,1,,1,POINT (6170465 -7542726)
2013,Junio,Kenia,1,1,,2,POINT (7819 -72453013)
2013,Junio,Kirguistán,0,1,,1,POINT (4697157 -74140516)
2013,Junio,Kuwait,1,3,,4,POINT (4697157 -74140516)
2013,Junio,República de Kosovo,0,1,,1,POINT (4697157 -74140516)
2013,Junio,Letonia,0,1,,1,POINT (10406342 -75527794)
2013,Junio,Letonia,9,3,,12,POINT (4697157 -74140516)
2013,Junio,Letonia,1,0,,1,POINT (6170465 -7542726)
2013,Junio,Letonia,0,1,,1,POINT (7819 -72453013)
2013,Junio,Lituania,1,1,,2,POINT (0.81488 -77356)
2013,Junio,Lituania,0,2,,2,POINT (10406342 -75527794)
2013,Junio,Lituania,1,2,,3,POINT (10446304 -75516486)
2013,Junio,Lituania,0,1,,1,POINT (3451668 -76532004)
2013,Junio,Lituania,8,11,,19,POINT (4697157 -74140516)
2013,Junio,Lituania,2,0,,2,POINT (6170465 -7542726)
2013,Junio,Líbano,0,1,,1,POINT (0.81488 -77356)
2013,Junio,Líbano,0,2,,2,POINT (10886686 -74776479)
2013,Junio,Líbano,5,5,,10,POINT (11360029 -72129595)
2013,Junio,Líbano,0,1,,1,POINT (3451668 -76532004)
2013,Junio,Líbano,14,34,,48,POINT (4697157 -74140516)
2013,Junio,Líbano,1,1,,2,POINT (6170465 -7542726)
2013,Junio,Líbano,0,1,,1,POINT (7128047 -73181317)
2013,Junio,Libia,0,1,,1,POINT (4697157 -74140516)
2013,Junio,Luxemburgo,1,6,,7,POINT (4697157 -74140516)
2013,Junio,Macedonia,0,1,,1,POINT (10446304 -75516486)
2013,Junio,Macedonia,0,2,,2,POINT (4697157 -74140516)
2013,Junio,Madagascar,0,1,,1,POINT (4697157 -74140516)
2013,Junio,Malasia,1,0,,1,POINT (-4191162 -69941498)
2013,Junio,Malasia,2,1,,3,POINT (0.81488 -77356)
2013,Junio,Malasia,0,1,,1,POINT (10446304 -75516486)
2013,Junio,Malasia,0,1,,1,POINT (3451668 -76532004)
2013,Junio,Malasia,6,20,,26,POINT (4697157 -74140516)
2013,Junio,Malasia,0,1,,1,POINT (6170465 -7542726)
2013,Junio,Malasia,1,0,,1,POINT (863337 -7735002)
2013,Junio,Malí,0,1,,1,POINT (4697157 -74140516)
2013,Junio,Malta,1,1,,2,POINT (4697157 -74140516)
2013,Junio,Marruecos,3,7,,10,POINT (4697157 -74140516)
2013,Junio,Marruecos,0,2,,2,POINT (6170465 -7542726)
2013,Junio,Mauricio,1,1,,2,POINT (4697157 -74140516)
2013,Junio,México,2,0,,2,POINT (-4191162 -69941498)
2013,Junio,México,1,1,,2,POINT (0.33002 -76876446)
2013,Junio,México,17,19,,36,POINT (0.81488 -77356)
2013,Junio,México,7,17,,24,POINT (10406342 -75527794)
2013,Junio,México,94,193,,287,POINT (10446304 -75516486)
2013,Junio,México,19,56,,75,POINT (10886686 -74776479)
2013,Junio,México,1,5,,6,POINT (11360029 -72129595)
2013,Junio,México,1,3,,4,POINT (125862 -81702165)
2013,Junio,México,75,199,,274,POINT (3451668 -76532004)
2013,Junio,México,0,1,,1,POINT (445285 -75766353)
2013,Junio,México,1881,4328,,6209,POINT (4697157 -74140516)
2013,Junio,México,3,22,,25,POINT (4815189 -75736374)
2013,Junio,México,177,477,,654,POINT (6170465 -7542726)
2013,Junio,México,0,1,,1,POINT (7088729 -70740253)
2013,Junio,México,3,3,,6,POINT (7128047 -73181317)
2013,Junio,México,6,27,,33,POINT (7819 -72453013)
2013,Junio,México,2,2,,4,POINT (7927233 -72508188)
2013,Junio,México,1,4,,5,POINT (863337 -7735002)
2013,Junio,República de Moldavia,1,1,,2,POINT (4697157 -74140516)
2013,Junio,República de Moldavia,1,0,,1,POINT (6170465 -7542726)
2013,Junio,Mónaco,0,1,,1,POINT (4697157 -74140516)
2013,Junio,Montenegro,0,1,,1,POINT (4697157 -74140516)
2013,Junio,Mozambique,0,1,,1,POINT (0.33002 -76876446)
2013,Junio,Mozambique,0,1,,1,POINT (4697157 -74140516)
2013,Junio,Myanmar,2,3,,5,POINT (4697157 -74140516)
2013,Junio,Nepal,0,1,,1,POINT (10446304 -75516486)
2013,Junio,Nepal,4,4,,8,POINT (4697157 -74140516)
2013,Junio,Nepal,0,1,,1,POINT (6170465 -7542726)
2013,Junio,Nicaragua,1,0,,1,POINT (0.81488 -77356)
2013,Junio,Nicaragua,4,7,,11,POINT (10446304 -75516486)
2013,Junio,Nicaragua,0,2,,2,POINT (10886686 -74776479)
2013,Junio,Nicaragua,0,1,,1,POINT (125744111 -81703935)
2013,Junio,Nicaragua,1,0,,1,POINT (125862 -81702165)
2013,Junio,Nicaragua,9,7,,16,POINT (3451668 -76532004)
2013,Junio,Nicaragua,48,60,,108,POINT (4697157 -74140516)
2013,Junio,Nicaragua,6,11,,17,POINT (6170465 -7542726)
2013,Junio,Nigeria,1,0,,1,POINT (10446304 -75516486)
2013,Junio,Nigeria,1,2,,3,POINT (4697157 -74140516)
2013,Junio,Noruega,0,1,,1,POINT (-4191162 -69941498)
2013,Junio,Noruega,2,2,,4,POINT (10406342 -75527794)
2013,Junio,Noruega,5,7,,12,POINT (10446304 -75516486)
2013,Junio,Noruega,3,4,,7,POINT (10886686 -74776479)
2013,Junio,Noruega,0,2,,2,POINT (11247723 -74213989)
2013,Junio,Noruega,1,0,,1,POINT (125862 -81702165)
2013,Junio,Noruega,6,9,,15,POINT (3451668 -76532004)
2013,Junio,Noruega,79,120,,199,POINT (4697157 -74140516)
2013,Junio,Noruega,0,1,,1,POINT (4815189 -75736374)
2013,Junio,Noruega,8,17,,25,POINT (6170465 -7542726)
2013,Junio,Nueva Zelanda,1,0,,1,POINT (-4191162 -69941498)
2013,Junio,Nueva Zelanda,3,14,,17,POINT (0.81488 -77356)
2013,Junio,Nueva Zelanda,5,3,,8,POINT (10446304 -75516486)
2013,Junio,Nueva Zelanda,0,1,,1,POINT (10886686 -74776479)
2013,Junio,Nueva Zelanda,0,1,,1,POINT (3451668 -76532004)
2013,Junio,Nueva Zelanda,25,54,,79,POINT (4697157 -74140516)
2013,Junio,Nueva Zelanda,2,6,,8,POINT (6170465 -7542726)
2013,Junio,Nueva Zelanda,0,1,,1,POINT (7819 -72453013)
2013,Junio,Nueva Zelanda,0,2,,2,POINT (863337 -7735002)
2013,Junio,Nueva Zelanda,1,1,,2,POINT (0.81488 -77356)
2013,Junio,Nueva Zelanda,2,6,,8,POINT (10406342 -75527794)
2013,Junio,Nueva Zelanda,1,2,,3,POINT (10446304 -75516486)
2013,Junio,Nueva Zelanda,1,0,,1,POINT (10886686 -74776479)
2013,Junio,Nueva Zelanda,1,4,,5,POINT (4697157 -74140516)
2013,Junio,Nueva Zelanda,1,0,,1,POINT (863337 -7735002)
2013,Junio,Países Bajos,0,2,,2,POINT (-4191162 -69941498)
2013,Junio,Países Bajos,3,6,,9,POINT (0.81488 -77356)
2013,Junio,Países Bajos,2,3,,5,POINT (10446304 -75516486)
2013,Junio,Países Bajos,1,5,,6,POINT (10886686 -74776479)
2013,Junio,Países Bajos,5,8,,13,POINT (11360029 -72129595)
2013,Junio,Países Bajos,22,19,,41,POINT (1152863 -72919186)
2013,Junio,Países Bajos,6,19,,25,POINT (3451668 -76532004)
2013,Junio,Países Bajos,190,229,,419,POINT (4697157 -74140516)
2013,Junio,Países Bajos,208,238,,446,POINT (6170465 -7542726)
2013,Junio,Países Bajos,4,2,,6,POINT (7128047 -73181317)
2013,Junio,Países Bajos,0,1,,1,POINT (7819 -72453013)
2013,Junio,Pakistán,0,1,,1,POINT (0.81488 -77356)
2013,Junio,Pakistán,1,0,,1,POINT (10446304 -75516486)
2013,Junio,Pakistán,1,9,,10,POINT (4697157 -74140516)
2013,Junio,Pakistán,0,1,,1,POINT (7819 -72453013)
2013,Junio,Panamá,1,3,,4,POINT (0.81488 -77356)
2013,Junio,Panamá,1,14,,15,POINT (10406342 -75527794)
2013,Junio,Panamá,105,132,,237,POINT (10446304 -75516486)
2013,Junio,Panamá,47,81,,128,POINT (10886686 -74776479)
2013,Junio,Panamá,0,1,,1,POINT (125744111 -81703935)
2013,Junio,Panamá,19,20,,39,POINT (125862 -81702165)
2013,Junio,Panamá,91,156,,247,POINT (3451668 -76532004)
2013,Junio,Panamá,432,778,,1210,POINT (4697157 -74140516)
2013,Junio,Panamá,72,82,,154,POINT (4815189 -75736374)
2013,Junio,Panamá,103,234,,337,POINT (6170465 -7542726)
2013,Junio,Panamá,0,1,,1,POINT (6185536 -67484028)
2013,Junio,Panamá,6,8,,14,POINT (7128047 -73181317)
2013,Junio,Panamá,0,2,,2,POINT (7819 -72453013)
2013,Junio,Panamá,6,7,,13,POINT (7927233 -72508188)
2013,Junio,Panamá,2,3,,5,POINT (863337 -7735002)
2013,Junio,Paraguay,0,2,,2,POINT (0.81488 -77356)
2013,Junio,Paraguay,6,7,,13,POINT (10446304 -75516486)
2013,Junio,Paraguay,0,1,,1,POINT (10886686 -74776479)
2013,Junio,Paraguay,1,2,,3,POINT (11360029 -72129595)
2013,Junio,Paraguay,7,5,,12,POINT (125862 -81702165)
2013,Junio,Paraguay,5,5,,10,POINT (3451668 -76532004)
2013,Junio,Paraguay,132,237,,369,POINT (4697157 -74140516)
2013,Junio,Paraguay,5,10,,15,POINT (6170465 -7542726)
2013,Junio,Paraguay,2,23,,25,POINT (7819 -72453013)
2013,Junio,Perú,14,39,,53,POINT (-4191162 -69941498)
2013,Junio,Perú,2,7,,9,POINT (0.33002 -76876446)
2013,Junio,Perú,98,332,,430,POINT (0.81488 -77356)
2013,Junio,Perú,24,21,,45,POINT (10406342 -75527794)
2013,Junio,Perú,137,117,,254,POINT (10446304 -75516486)
2013,Junio,Perú,22,167,,189,POINT (10886686 -74776479)
2013,Junio,Perú,0,1,,1,POINT (10970933 -74765343)
2013,Junio,Perú,11,29,,40,POINT (11360029 -72129595)
2013,Junio,Perú,69,45,,114,POINT (125862 -81702165)
2013,Junio,Perú,91,206,,297,POINT (3451668 -76532004)
2013,Junio,Perú,2126,3122,,5248,POINT (4697157 -74140516)
2013,Junio,Perú,2,4,,6,POINT (4815189 -75736374)
2013,Junio,Perú,225,451,,676,POINT (6170465 -7542726)
2013,Junio,Perú,1,1,,2,POINT (7088729 -70740253)
2013,Junio,Perú,0,2,,2,POINT (7128047 -73181317)
2013,Junio,Perú,39,78,,117,POINT (7819 -72453013)
2013,Junio,Perú,4,11,,15,POINT (7927233 -72508188)
2013,Junio,Perú,1,0,,1,POINT (863337 -7735002)
2013,Junio,Palestina,1,2,,3,POINT (4697157 -74140516)
2013,Junio,Polonia,2,1,,3,POINT (-4191162 -69941498)
2013,Junio,Polonia,8,3,,11,POINT (0.81488 -77356)
2013,Junio,Polonia,3,5,,8,POINT (10406342 -75527794)
2013,Junio,Polonia,0,2,,2,POINT (10446304 -75516486)
2013,Junio,Polonia,0,3,,3,POINT (10970933 -74765343)
2013,Junio,Polonia,0,5,,5,POINT (3451668 -76532004)
2013,Junio,Polonia,0,1,,1,POINT (3884426 -77061029)
2013,Junio,Polonia,42,54,,96,POINT (4697157 -74140516)
2013,Junio,Polonia,1,0,,1,POINT (4815189 -75736374)
2013,Junio,Polonia,4,2,,6,POINT (6170465 -7542726)
2013,Junio,Polonia,1,2,,3,POINT (7819 -72453013)
2013,Junio,Polonia,0,1,,1,POINT (806667 -767333)
2013,Junio,Polonia,2,1,,3,POINT (863337 -7735002)
2013,Junio,Portugal,1,1,,2,POINT (-4191162 -69941498)
2013,Junio,Portugal,0,3,,3,POINT (0.81488 -77356)
2013,Junio,Portugal,5,6,,11,POINT (10446304 -75516486)
2013,Junio,Portugal,0,1,,1,POINT (11360029 -72129595)
2013,Junio,Portugal,1,8,,9,POINT (3451668 -76532004)
2013,Junio,Portugal,85,303,,388,POINT (4697157 -74140516)
2013,Junio,Portugal,0,1,,1,POINT (4815189 -75736374)
2013,Junio,Portugal,4,13,,17,POINT (6170465 -7542726)
2013,Junio,Portugal,1,5,,6,POINT (7819 -72453013)
2013,Junio,Portugal,0,2,,2,POINT (7927233 -72508188)
2013,Junio,Portugal,0,1,,1,POINT (863337 -7735002)
2013,Junio,Puerto Rico/Territorio de Estados Unidos,1,0,,1,POINT (10446304 -75516486)
2013,Junio,Puerto Rico/Territorio de Estados Unidos,1,0,,1,POINT (10886686 -74776479)
2013,Junio,Puerto Rico/Territorio de Estados Unidos,0,1,,1,POINT (3451668 -76532004)
2013,Junio,Puerto Rico/Territorio de Estados Unidos,1,0,,1,POINT (4697157 -74140516)
2013,Junio,Qatar,0,1,,1,POINT (0.81488 -77356)
2013,Junio,Qatar,1,3,,4,POINT (4697157 -74140516)
2013,Junio,Qatar,0,1,,1,POINT (6170465 -7542726)
2013,Junio,Reino Unido de Gran Bretaña e Irlanda del Norte,4,7,,11,POINT (-4191162 -69941498)
2013,Junio,Reino Unido de Gran Bretaña e Irlanda del Norte,7,10,,17,POINT (0.81488 -77356)
2013,Junio,Reino Unido de Gran Bretaña e Irlanda del Norte,2,6,,8,POINT (10406342 -75527794)
2013,Junio,Reino Unido de Gran Bretaña e Irlanda del Norte,14,22,,36,POINT (10446304 -75516486)
2013,Junio,Reino Unido de Gran Bretaña e Irlanda del Norte,1,1,,2,POINT (10886686 -74776479)
2013,Junio,Reino Unido de Gran Bretaña e Irlanda del Norte,0,1,,1,POINT (11247723 -74213989)
2013,Junio,Reino Unido de Gran Bretaña e Irlanda del Norte,4,4,,8,POINT (11360029 -72129595)
2013,Junio,Reino Unido de Gran Bretaña e Irlanda del Norte,0,3,,3,POINT (1152863 -72919186)
2013,Junio,Reino Unido de Gran Bretaña e Irlanda del Norte,12,22,,34,POINT (3451668 -76532004)
2013,Junio,Reino Unido de Gran Bretaña e Irlanda del Norte,234,498,,732,POINT (4697157 -74140516)
2013,Junio,Reino Unido de Gran Bretaña e Irlanda del Norte,1,1,,2,POINT (4815189 -75736374)
2013,Junio,Reino Unido de Gran Bretaña e Irlanda del Norte,10,23,,33,POINT (6170465 -7542726)
2013,Junio,Reino Unido de Gran Bretaña e Irlanda del Norte,0,4,,4,POINT (7819 -72453013)
2013,Junio,Reino Unido de Gran Bretaña e Irlanda del Norte,1,0,,1,POINT (7927233 -72508188)
2013,Junio,República de Belarús,1,0,,1,POINT (10446304 -75516486)
2013,Junio,República de Belarús,0,1,,1,POINT (4697157 -74140516)
2013,Junio,República Dominicana,2,7,,9,POINT (0.81488 -77356)
2013,Junio,República Dominicana,0,1,,1,POINT (10406342 -75527794)
2013,Junio,República Dominicana,40,39,,79,POINT (10446304 -75516486)
2013,Junio,República Dominicana,7,52,,59,POINT (10886686 -74776479)
2013,Junio,República Dominicana,0,2,,2,POINT (11360029 -72129595)
2013,Junio,República Dominicana,0,2,,2,POINT (1152863 -72919186)
2013,Junio,República Dominicana,0,2,,2,POINT (125862 -81702165)
2013,Junio,República Dominicana,15,46,,61,POINT (3451668 -76532004)
2013,Junio,República Dominicana,198,357,,555,POINT (4697157 -74140516)
2013,Junio,República Dominicana,2,0,,2,POINT (4815189 -75736374)
2013,Junio,República Dominicana,35,59,,94,POINT (6170465 -7542726)
2013,Junio,República Dominicana,2,5,,7,POINT (7128047 -73181317)
2013,Junio,República Dominicana,0,3,,3,POINT (7819 -72453013)
2013,Junio,República Dominicana,0,1,,1,POINT (7927233 -72508188)
2013,Junio,República Checa,0,1,,1,POINT (10406342 -75527794)
2013,Junio,República Checa,1,0,,1,POINT (10886686 -74776479)
2013,Junio,República Checa,6,6,,12,POINT (4697157 -74140516)
2013,Junio,República Checa,1,0,,1,POINT (7819 -72453013)
2013,Junio,Rumania,1,1,,2,POINT (0.81488 -77356)
2013,Junio,Rumania,0,5,,5,POINT (10406342 -75527794)
2013,Junio,Rumania,1,0,,1,POINT (10446304 -75516486)
2013,Junio,Rumania,1,1,,2,POINT (10886686 -74776479)
2013,Junio,Rumania,0,1,,1,POINT (10970933 -74765343)
2013,Junio,Rumania,1,3,,4,POINT (3451668 -76532004)
2013,Junio,Rumania,25,55,,80,POINT (4697157 -74140516)
2013,Junio,Rumania,3,6,,9,POINT (6170465 -7542726)
2013,Junio,Rumania,0,1,,1,POINT (7819 -72453013)
2013,Junio,Federación de Rusia,1,1,,2,POINT (0.81488 -77356)
2013,Junio,Federación de Rusia,0,1,,1,POINT (10406342 -75527794)
2013,Junio,Federación de Rusia,1,1,,2,POINT (10446304 -75516486)
2013,Junio,Federación de Rusia,0,4,,4,POINT (11360029 -72129595)
2013,Junio,Federación de Rusia,0,3,,3,POINT (3451668 -76532004)
2013,Junio,Federación de Rusia,1,0,,1,POINT (445285 -75766353)
2013,Junio,Federación de Rusia,15,18,,33,POINT (4697157 -74140516)
2013,Junio,Federación de Rusia,2,4,,6,POINT (6170465 -7542726)
2013,Junio,Federación de Rusia,1,1,,2,POINT (7128047 -73181317)
2013,Junio,Federación de Rusia,0,2,,2,POINT (863337 -7735002)
2013,Junio,Federación de Rusia,0,1,,1,POINT (9402597 -75681642)
2013,Junio,Rwanda,0,1,,1,POINT (3451668 -76532004)
2013,Junio,Rwanda,0,1,,1,POINT (4697157 -74140516)
2013,Junio,San Cristóbal y Nevis,0,6,,6,POINT (4697157 -74140516)
2013,Junio,San Cristóbal y Nevis,1,0,,1,POINT (6170465 -7542726)
2013,Junio,Samoa Occidental,1,0,,1,POINT (4697157 -74140516)
2013,Junio,San  Vicente y las Granadinas,1,5,,6,POINT (4697157 -74140516)
2013,Junio,San  Vicente y las Granadinas,0,1,,1,POINT (6170465 -7542726)
2013,Junio,Santa Lucia,1,0,,1,POINT (10446304 -75516486)
2013,Junio,Santa Lucia,0,1,,1,POINT (10886686 -74776479)
2013,Junio,Santa Lucia,0,1,,1,POINT (125862 -81702165)
2013,Junio,Santa Lucia,2,1,,3,POINT (4697157 -74140516)
2013,Junio,Santa Lucia,0,1,,1,POINT (6170465 -7542726)
2013,Junio,Senegal,1,1,,2,POINT (4697157 -74140516)
2013,Junio,Serbia,1,1,,2,POINT (10406342 -75527794)
2013,Junio,Serbia,0,1,,1,POINT (10446304 -75516486)
2013,Junio,Serbia,3,7,,10,POINT (4697157 -74140516)
2013,Junio,Serbia,1,1,,2,POINT (6170465 -7542726)
2013,Junio,Singapur,2,1,,3,POINT (10446304 -75516486)
2013,Junio,Singapur,0,1,,1,POINT (10886686 -74776479)
2013,Junio,Singapur,9,22,,31,POINT (4697157 -74140516)
2013,Junio,Singapur,5,0,,5,POINT (6170465 -7542726)
2013,Junio,República Árabe Siria,1,0,,1,POINT (10446304 -75516486)
2013,Junio,República Árabe Siria,1,1,,2,POINT (4697157 -74140516)
2013,Junio,República Árabe Siria,0,1,,1,POINT (863337 -7735002)
2013,Junio,Sri Lanka,1,2,,3,POINT (4697157 -74140516)
2013,Junio,Sri Lanka,0,1,,1,POINT (6170465 -7542726)
2013,Junio,Sudáfrica,2,2,,4,POINT (-4191162 -69941498)
2013,Junio,Sudáfrica,0,4,,4,POINT (0.81488 -77356)
2013,Junio,Sudáfrica,3,0,,3,POINT (10406342 -75527794)
2013,Junio,Sudáfrica,1,5,,6,POINT (10446304 -75516486)
2013,Junio,Sudáfrica,1,0,,1,POINT (10886686 -74776479)
2013,Junio,Sudáfrica,2,0,,2,POINT (3451668 -76532004)
2013,Junio,Sudáfrica,22,68,,90,POINT (4697157 -74140516)
2013,Junio,Sudáfrica,2,5,,7,POINT (6170465 -7542726)
2013,Junio,Suecia,2,11,,13,POINT (-4191162 -69941498)
2013,Junio,Suecia,5,10,,15,POINT (0.81488 -77356)
2013,Junio,Suecia,3,4,,7,POINT (10406342 -75527794)
2013,Junio,Suecia,9,10,,19,POINT (10446304 -75516486)
2013,Junio,Suecia,0,3,,3,POINT (10886686 -74776479)
2013,Junio,Suecia,0,1,,1,POINT (11247723 -74213989)
2013,Junio,Suecia,1,1,,2,POINT (11360029 -72129595)
2013,Junio,Suecia,11,9,,20,POINT (3451668 -76532004)
2013,Junio,Suecia,160,223,,383,POINT (4697157 -74140516)
2013,Junio,Suecia,7,24,,31,POINT (6170465 -7542726)
2013,Junio,Suecia,0,1,,1,POINT (7128047 -73181317)
2013,Junio,Suecia,0,1,,1,POINT (863337 -7735002)
2013,Junio,Suiza,2,5,,7,POINT (-4191162 -69941498)
2013,Junio,Suiza,0,1,,1,POINT (0.33002 -76876446)
2013,Junio,Suiza,16,23,,39,POINT (0.81488 -77356)
2013,Junio,Suiza,6,12,,18,POINT (10406342 -75527794)
2013,Junio,Suiza,16,14,,30,POINT (10446304 -75516486)
2013,Junio,Suiza,0,3,,3,POINT (10886686 -74776479)
2013,Junio,Suiza,5,1,,6,POINT (11360029 -72129595)
2013,Junio,Suiza,1,0,,1,POINT (125862 -81702165)
2013,Junio,Suiza,12,44,,56,POINT (3451668 -76532004)
2013,Junio,Suiza,263,458,,721,POINT (4697157 -74140516)
2013,Junio,Suiza,0,1,,1,POINT (4815189 -75736374)
2013,Junio,Suiza,15,35,,50,POINT (6170465 -7542726)
2013,Junio,Suiza,2,3,,5,POINT (7819 -72453013)
2013,Junio,Suiza,0,1,,1,POINT (863337 -7735002)
2013,Junio,Surinam,11,13,,24,POINT (4697157 -74140516)
2013,Junio,Surinam,3,4,,7,POINT (6170465 -7542726)
2013,Junio,Taiwán,2,2,,4,POINT (10406342 -75527794)
2013,Junio,Taiwán,1,2,,3,POINT (3451668 -76532004)
2013,Junio,Taiwán,3,4,,7,POINT (4697157 -74140516)
2013,Junio,República de Tayikistán,0,1,,1,POINT (4697157 -74140516)
2013,Junio,Tailandia,0,1,,1,POINT (10406342 -75527794)
2013,Junio,Tailandia,1,0,,1,POINT (10446304 -75516486)
2013,Junio,Tailandia,1,3,,4,POINT (4697157 -74140516)
2013,Junio,Territorio Antártico Británico/Territorio Británico de Ultramar,1,0,,1,POINT (0.81488 -77356)
2013,Junio,Territorio Antártico Británico/Territorio Británico de Ultramar,1,0,,1,POINT (10886686 -74776479)
2013,Junio,Territorio Antártico Británico/Territorio Británico de Ultramar,0,2,,2,POINT (4697157 -74140516)
2013,Junio,Tanzania,0,2,,2,POINT (4697157 -74140516)
2013,Junio,Trinidad y Tobago,0,1,,1,POINT (-4191162 -69941498)
2013,Junio,Trinidad y Tobago,3,6,,9,POINT (10446304 -75516486)
2013,Junio,Trinidad y Tobago,0,2,,2,POINT (10886686 -74776479)
2013,Junio,Trinidad y Tobago,0,1,,1,POINT (11360029 -72129595)
2013,Junio,Trinidad y Tobago,2,1,,3,POINT (3451668 -76532004)
2013,Junio,Trinidad y Tobago,22,49,,71,POINT (4697157 -74140516)
2013,Junio,Trinidad y Tobago,3,8,,11,POINT (6170465 -7542726)
2013,Junio,Trinidad y Tobago,0,2,,2,POINT (7819 -72453013)
2013,Junio,Trinidad y Tobago,0,1,,1,POINT (7927233 -72508188)
2013,Junio,Túnez,2,1,,3,POINT (4697157 -74140516)
2013,Junio,Túnez,0,1,,1,POINT (6170465 -7542726)
2013,Junio,Turquía,1,0,,1,POINT (-4191162 -69941498)
2013,Junio,Turquía,0,1,,1,POINT (0.81488 -77356)
2013,Junio,Turquía,0,4,,4,POINT (10406342 -75527794)
2013,Junio,Turquía,0,4,,4,POINT (10446304 -75516486)
2013,Junio,Turquía,0,2,,2,POINT (10886686 -74776479)
2013,Junio,Turquía,0,1,,1,POINT (10970933 -74765343)
2013,Junio,Turquía,0,8,,8,POINT (3451668 -76532004)
2013,Junio,Turquía,28,75,,103,POINT (4697157 -74140516)
2013,Junio,Turquía,0,2,,2,POINT (6170465 -7542726)
2013,Junio,Turquía,0,1,,1,POINT (7819 -72453013)
2013,Junio,Ucrania,0,3,,3,POINT (0.81488 -77356)
2013,Junio,Ucrania,1,0,,1,POINT (3451668 -76532004)
2013,Junio,Ucrania,18,14,,32,POINT (4697157 -74140516)
2013,Junio,Ucrania,1,1,,2,POINT (6170465 -7542726)
2013,Junio,Ucrania,0,1,,1,POINT (9402597 -75681642)
2013,Junio,Uganda,0,3,,3,POINT (4697157 -74140516)
2013,Junio,Federación de Rusia,1,0,,1,POINT (0.81488 -77356)
2013,Junio,Federación de Rusia,1,4,,5,POINT (10446304 -75516486)
2013,Junio,Federación de Rusia,0,2,,2,POINT (10970933 -74765343)
2013,Junio,Federación de Rusia,0,1,,1,POINT (3451668 -76532004)
2013,Junio,Federación de Rusia,83,110,,193,POINT (4697157 -74140516)
2013,Junio,Federación de Rusia,4,6,,10,POINT (6170465 -7542726)
2013,Junio,Federación de Rusia,3,2,,5,POINT (7819 -72453013)
2013,Junio,Federación de Rusia,0,18,,18,POINT (9402597 -75681642)
2013,Junio,Uruguay,4,13,,17,POINT (0.81488 -77356)
2013,Junio,Uruguay,5,2,,7,POINT (10406342 -75527794)
2013,Junio,Uruguay,70,61,,131,POINT (10446304 -75516486)
2013,Junio,Uruguay,3,3,,6,POINT (10886686 -74776479)
2013,Junio,Uruguay,4,6,,10,POINT (11360029 -72129595)
2013,Junio,Uruguay,36,26,,62,POINT (125862 -81702165)
2013,Junio,Uruguay,13,17,,30,POINT (3451668 -76532004)
2013,Junio,Uruguay,0,1,,1,POINT (445285 -75766353)
2013,Junio,Uruguay,234,402,,636,POINT (4697157 -74140516)
2013,Junio,Uruguay,0,2,,2,POINT (4815189 -75736374)
2013,Junio,Uruguay,23,47,,70,POINT (6170465 -7542726)
2013,Junio,Uruguay,5,33,,38,POINT (7819 -72453013)
2013,Junio,Uruguay,0,1,,1,POINT (863337 -7735002)
2013,Junio,Venezuela,0,2,,2,POINT (-4191162 -69941498)
2013,Junio,Venezuela,0,1,,1,POINT (0.33002 -76876446)
2013,Junio,Venezuela,44,57,,101,POINT (0.81488 -77356)
2013,Junio,Venezuela,4,41,,45,POINT (10406342 -75527794)
2013,Junio,Venezuela,75,116,,191,POINT (10446304 -75516486)
2013,Junio,Venezuela,31,76,,107,POINT (10886686 -74776479)
2013,Junio,Venezuela,0,1,,1,POINT (11247723 -74213989)
2013,Junio,Venezuela,994,1553,,2547,POINT (11360029 -72129595)
2013,Junio,Venezuela,0,1,,1,POINT (1152863 -72919186)
2013,Junio,Venezuela,7,7,,14,POINT (125862 -81702165)
2013,Junio,Venezuela,84,95,,179,POINT (3451668 -76532004)
2013,Junio,Venezuela,4884,6240,,11124,POINT (4697157 -74140516)
2013,Junio,Venezuela,1,7,,8,POINT (4815189 -75736374)
2013,Junio,Venezuela,332,457,,789,POINT (6170465 -7542726)
2013,Junio,Venezuela,132,198,,330,POINT (6185536 -67484028)
2013,Junio,Venezuela,76,149,,225,POINT (7088729 -70740253)
2013,Junio,Venezuela,5,0,,5,POINT (7128047 -73181317)
2013,Junio,Venezuela,991,1247,,2238,POINT (7819 -72453013)
2013,Junio,Venezuela,116,131,,247,POINT (7927233 -72508188)
2013,Junio,Vietnam,1,1,,2,POINT (4697157 -74140516)
2013,Junio,República Árabe de Yemen,0,1,,1,POINT (4697157 -74140516)
2013,Junio,Zambia,0,1,,1,POINT (4697157 -74140516)
2013,Junio,Zimbabue,0,2,,2,POINT (4697157 -74140516)
2013,Junio,Reino Unido de Gran Bretaña e Irlanda del Norte,3,9,,12,POINT (-4191162 -69941498)
2013,Junio,Reino Unido de Gran Bretaña e Irlanda del Norte,51,63,,114,POINT (0.81488 -77356)
2013,Junio,Reino Unido de Gran Bretaña e Irlanda del Norte,18,27,,45,POINT (10406342 -75527794)
2013,Junio,Reino Unido de Gran Bretaña e Irlanda del Norte,9,16,,25,POINT (10446304 -75516486)
2013,Junio,Reino Unido de Gran Bretaña e Irlanda del Norte,2,1,,3,POINT (10886686 -74776479)
2013,Junio,Reino Unido de Gran Bretaña e Irlanda del Norte,0,2,,2,POINT (11247723 -74213989)
2013,Junio,Reino Unido de Gran Bretaña e Irlanda del Norte,1,0,,1,POINT (11360029 -72129595)
2013,Junio,Reino Unido de Gran Bretaña e Irlanda del Norte,0,1,,1,POINT (125862 -81702165)
2013,Junio,Reino Unido de Gran Bretaña e Irlanda del Norte,10,24,,34,POINT (3451668 -76532004)
2013,Junio,Reino Unido de Gran Bretaña e Irlanda del Norte,262,516,,778,POINT (4697157 -74140516)
2013,Junio,Reino Unido de Gran Bretaña e Irlanda del Norte,9,41,,50,POINT (6170465 -7542726)
2013,Junio,Reino Unido de Gran Bretaña e Irlanda del Norte,0,1,,1,POINT (7128047 -73181317)
2013,Junio,Reino Unido de Gran Bretaña e Irlanda del Norte,1,7,,8,POINT (7819 -72453013)
2013,Junio,Reino Unido de Gran Bretaña e Irlanda del Norte,0,1,,1,POINT (7927233 -72508188)
2013,Junio,Reino Unido de Gran Bretaña e Irlanda del Norte,1,5,,6,POINT (863337 -7735002)
2013,Junio,Países Bajos,0,2,,2,POINT (-4191162 -69941498)
2013,Junio,Países Bajos,20,18,,38,POINT (0.81488 -77356)
2013,Junio,Países Bajos,11,11,,22,POINT (10406342 -75527794)
2013,Junio,Países Bajos,13,27,,40,POINT (10446304 -75516486)
2013,Junio,Países Bajos,6,10,,16,POINT (10886686 -74776479)
2013,Junio,Países Bajos,0,2,,2,POINT (11247723 -74213989)
2013,Junio,Países Bajos,0,1,,1,POINT (11360029 -72129595)
2013,Junio,Países Bajos,1,0,,1,POINT (125862 -81702165)
2013,Junio,Países Bajos,12,37,,49,POINT (3451668 -76532004)
2013,Junio,Países Bajos,412,710,,1122,POINT (4697157 -74140516)
2013,Junio,Países Bajos,1,1,,2,POINT (4815189 -75736374)
2013,Junio,Países Bajos,67,99,,166,POINT (6170465 -7542726)
2013,Junio,Países Bajos,3,6,,9,POINT (7128047 -73181317)
2013,Junio,Países Bajos,4,9,,13,POINT (7819 -72453013)
2013,Junio,Países Bajos,1,2,,3,POINT (863337 -7735002)
2013,Junio,Desconocido,0,1,,1,POINT (10886686 -74776479)
2013,Junio,Eslovenia,0,1,,1,POINT (4697157 -74140516)
2013,Junio,Lituania,1,0,,1,POINT (0.81488 -77356)
2013,Junio,Lituania,0,1,,1,POINT (10446304 -75516486)
2013,Junio,Reino Unido de Gran Bretaña e Irlanda del Norte,1,0,,1,POINT (0.81488 -77356)
2013,Junio,Reino Unido de Gran Bretaña e Irlanda del Norte,1,0,,1,POINT (4697157 -74140516)
2013,Junio,Reino Unido de Gran Bretaña e Irlanda del Norte,1,1,,2,POINT (863337 -7735002)
2013,Junio,Reino Unido de Gran Bretaña e Irlanda del Norte,2,1,,3,POINT (0.81488 -77356)
2013,Junio,Reino Unido de Gran Bretaña e Irlanda del Norte,0,8,,8,POINT (4697157 -74140516)
2013,Junio,Marruecos,0,1,,1,POINT (4697157 -74140516)
2013,Junio,Desconocido,0,1,,1,POINT (4697157 -74140516)
2013,Julio,Afganistán,0,1,,1,POINT (4697157 -74140516)
2013,Julio,Afganistán,0,1,,1,POINT (4815189 -75736374)
2013,Julio,Albania,0,1,,1,POINT (11360029 -72129595)
2013,Julio,Albania,2,0,,2,POINT (4697157 -74140516)
2013,Julio,Albania,0,1,,1,POINT (7128047 -73181317)
2013,Julio,Alemania,14,16,,30,POINT (-4191162 -69941498)
2013,Julio,Alemania,1,1,,2,POINT (0.33002 -76876446)
2013,Julio,Alemania,87,74,,161,POINT (0.81488 -77356)
2013,Julio,Alemania,0,1,,1,POINT (1800143 -78802679)
2013,Julio,Alemania,18,38,,56,POINT (10406342 -75527794)
2013,Julio,Alemania,28,50,,78,POINT (10446304 -75516486)
2013,Julio,Alemania,10,15,,25,POINT (10886686 -74776479)
2013,Julio,Alemania,1,3,,4,POINT (11247723 -74213989)
2013,Julio,Alemania,7,12,,19,POINT (11360029 -72129595)
2013,Julio,Alemania,1,3,,4,POINT (125862 -81702165)
2013,Julio,Alemania,97,183,,280,POINT (3451668 -76532004)
2013,Julio,Alemania,1495,2127,,3622,POINT (4697157 -74140516)
2013,Julio,Alemania,0,1,,1,POINT (4815189 -75736374)
2013,Julio,Alemania,84,141,,225,POINT (6170465 -7542726)
2013,Julio,Alemania,0,1,,1,POINT (6185536 -67484028)
2013,Julio,Alemania,4,3,,7,POINT (7128047 -73181317)
2013,Julio,Alemania,7,15,,22,POINT (7819 -72453013)
2013,Julio,Alemania,3,5,,8,POINT (863337 -7735002)
2013,Julio,Andorra,0,1,,1,POINT (10886686 -74776479)
2013,Julio,Andorra,2,10,,12,POINT (4697157 -74140516)
2013,Julio,Andorra,0,1,,1,POINT (6170465 -7542726)
2013,Julio,Angola,0,1,,1,POINT (10446304 -75516486)
2013,Julio,Angola,0,1,,1,POINT (3451668 -76532004)
2013,Julio,Angola,1,0,,1,POINT (4697157 -74140516)
2013,Julio,Antigua y Barbuda,0,1,,1,POINT (10406342 -75527794)
2013,Julio,Antigua y Barbuda,2,2,,4,POINT (4697157 -74140516)
2013,Julio,Países Bajos,6,3,,9,POINT (6170465 -7542726)
2013,Julio,Arabia Saudita,1,5,,6,POINT (4697157 -74140516)
2013,Julio,Arabia Saudita,1,0,,1,POINT (11360029 -72129595)
2013,Julio,Arabia Saudita,1,11,,12,POINT (4697157 -74140516)
2013,Julio,Argelia,2,8,,10,POINT (4697157 -74140516)
2013,Julio,Argentina,7,6,,13,POINT (-4191162 -69941498)
2013,Julio,Argentina,2,5,,7,POINT (0.33002 -76876446)
2013,Julio,Argentina,76,124,,200,POINT (0.81488 -77356)
2013,Julio,Argentina,117,84,,201,POINT (10406342 -75527794)
2013,Julio,Argentina,441,327,,768,POINT (10446304 -75516486)
2013,Julio,Argentina,7,21,,28,POINT (10886686 -74776479)
2013,Julio,Argentina,26,16,,42,POINT (11360029 -72129595)
2013,Julio,Argentina,160,116,,276,POINT (125862 -81702165)
2013,Julio,Argentina,55,88,,143,POINT (3451668 -76532004)
2013,Julio,Argentina,3505,4909,,8414,POINT (4697157 -74140516)
2013,Julio,Argentina,0,5,,5,POINT (4815189 -75736374)
2013,Julio,Argentina,119,240,,359,POINT (6170465 -7542726)
2013,Julio,Argentina,0,1,,1,POINT (6185536 -67484028)
2013,Julio,Argentina,3,2,,5,POINT (7128047 -73181317)
2013,Julio,Argentina,26,32,,58,POINT (7819 -72453013)
2013,Julio,Argentina,0,3,,3,POINT (7927233 -72508188)
2013,Julio,Argentina,3,8,,11,POINT (863337 -7735002)
2013,Julio,República de Armenia,0,9,,9,POINT (4697157 -74140516)
2013,Julio,Aruba,3,0,,3,POINT (11360029 -72129595)
2013,Julio,Aruba,4,3,,7,POINT (4697157 -74140516)
2013,Julio,Australia,5,6,,11,POINT (-4191162 -69941498)
2013,Julio,Australia,2,1,,3,POINT (0.33002 -76876446)
2013,Julio,Australia,30,50,,80,POINT (0.81488 -77356)
2013,Julio,Australia,24,41,,65,POINT (10406342 -75527794)
2013,Julio,Australia,29,31,,60,POINT (10446304 -75516486)
2013,Julio,Australia,6,7,,13,POINT (10886686 -74776479)
2013,Julio,Australia,2,1,,3,POINT (11360029 -72129595)
2013,Julio,Australia,13,10,,23,POINT (125862 -81702165)
2013,Julio,Australia,56,79,,135,POINT (3451668 -76532004)
2013,Julio,Australia,212,369,,581,POINT (4697157 -74140516)
2013,Julio,Australia,15,62,,77,POINT (6170465 -7542726)
2013,Julio,Australia,0,1,,1,POINT (7128047 -73181317)
2013,Julio,Australia,0,3,,3,POINT (7819 -72453013)
2013,Julio,Australia,2,3,,5,POINT (863337 -7735002)
2013,Julio,Austria,1,1,,2,POINT (-4191162 -69941498)
2013,Julio,Austria,6,13,,19,POINT (0.81488 -77356)
2013,Julio,Austria,6,4,,10,POINT (10406342 -75527794)
2013,Julio,Austria,2,5,,7,POINT (10446304 -75516486)
2013,Julio,Austria,0,1,,1,POINT (10886686 -74776479)
2013,Julio,Austria,28,27,,55,POINT (3451668 -76532004)
2013,Julio,Austria,198,271,,469,POINT (4697157 -74140516)
2013,Julio,Austria,4,13,,17,POINT (6170465 -7542726)
2013,Julio,Austria,0,2,,2,POINT (7819 -72453013)
2013,Julio,Austria,1,0,,1,POINT (863337 -7735002)
2013,Julio,Azerbaiyán,0,6,,6,POINT (3451668 -76532004)
2013,Julio,Azerbaiyán,2,8,,10,POINT (4697157 -74140516)
2013,Julio,Bahamas,2,2,,4,POINT (10446304 -75516486)
2013,Julio,Bahamas,0,3,,3,POINT (10886686 -74776479)
2013,Julio,Bahamas,0,2,,2,POINT (3451668 -76532004)
2013,Julio,Bahamas,4,5,,9,POINT (4697157 -74140516)
2013,Julio,Bahamas,1,0,,1,POINT (6170465 -7542726)
2013,Julio,Bangladesh,1,9,,10,POINT (4697157 -74140516)
2013,Julio,Bangladesh,0,1,,1,POINT (6170465 -7542726)
2013,Julio,Barbados,3,2,,5,POINT (10446304 -75516486)
2013,Julio,Barbados,0,1,,1,POINT (10886686 -74776479)
2013,Julio,Barbados,15,9,,24,POINT (4697157 -74140516)
2013,Julio,Barbados,5,9,,14,POINT (6170465 -7542726)
2013,Julio,Barbados,1,0,,1,POINT (7819 -72453013)
2013,Julio,República de Belarús,0,4,,4,POINT (10886686 -74776479)
2013,Julio,República de Belarús,0,1,,1,POINT (3451668 -76532004)
2013,Julio,República de Belarús,12,8,,20,POINT (4697157 -74140516)
2013,Julio,Bélgica,3,5,,8,POINT (-4191162 -69941498)
2013,Julio,Bélgica,10,13,,23,POINT (0.81488 -77356)
2013,Julio,Bélgica,1,3,,4,POINT (10406342 -75527794)
2013,Julio,Bélgica,3,7,,10,POINT (10446304 -75516486)
2013,Julio,Bélgica,1,2,,3,POINT (10886686 -74776479)
2013,Julio,Bélgica,0,11,,11,POINT (11247723 -74213989)
2013,Julio,Bélgica,0,1,,1,POINT (11360029 -72129595)
2013,Julio,Bélgica,68,107,,175,POINT (3451668 -76532004)
2013,Julio,Bélgica,222,377,,599,POINT (4697157 -74140516)
2013,Julio,Bélgica,35,61,,96,POINT (6170465 -7542726)
2013,Julio,Bélgica,0,1,,1,POINT (7128047 -73181317)
2013,Julio,Bélgica,0,4,,4,POINT (7819 -72453013)
2013,Julio,Bélgica,2,5,,7,POINT (863337 -7735002)
2013,Julio,Belice,2,2,,4,POINT (10446304 -75516486)
2013,Julio,Belice,4,0,,4,POINT (3451668 -76532004)
2013,Julio,Belice,11,13,,24,POINT (4697157 -74140516)
2013,Julio,Belice,0,1,,1,POINT (6170465 -7542726)
2013,Julio,Belice,1,0,,1,POINT (7819 -72453013)
2013,Julio,Benín,1,0,,1,POINT (10886686 -74776479)
2013,Julio,Bermudas/Territorio Británico de Ultramar,0,1,,1,POINT (10446304 -75516486)
2013,Julio,Bermudas/Territorio Británico de Ultramar,1,4,,5,POINT (3451668 -76532004)
2013,Julio,Bermudas/Territorio Británico de Ultramar,0,1,,1,POINT (6170465 -7542726)
2013,Julio,Bolivia,1,1,,2,POINT (0.33002 -76876446)
2013,Julio,Bolivia,11,11,,22,POINT (0.81488 -77356)
2013,Julio,Bolivia,4,3,,7,POINT (10406342 -75527794)
2013,Julio,Bolivia,23,27,,50,POINT (10446304 -75516486)
2013,Julio,Bolivia,2,2,,4,POINT (10886686 -74776479)
2013,Julio,Bolivia,0,1,,1,POINT (125862 -81702165)
2013,Julio,Bolivia,8,18,,26,POINT (3451668 -76532004)
2013,Julio,Bolivia,340,479,,819,POINT (4697157 -74140516)
2013,Julio,Bolivia,1,2,,3,POINT (4815189 -75736374)
2013,Julio,Bolivia,15,33,,48,POINT (6170465 -7542726)
2013,Julio,Bolivia,0,1,,1,POINT (7088729 -70740253)
2013,Julio,Bolivia,1,4,,5,POINT (7819 -72453013)
2013,Julio,Bosnia y Herzegovina,2,7,,9,POINT (4697157 -74140516)
2013,Julio,Brasil,68,63,,131,POINT (-4191162 -69941498)
2013,Julio,Brasil,38,38,,76,POINT (0.81488 -77356)
2013,Julio,Brasil,65,45,,110,POINT (10406342 -75527794)
2013,Julio,Brasil,227,215,,442,POINT (10446304 -75516486)
2013,Julio,Brasil,9,25,,34,POINT (10886686 -74776479)
2013,Julio,Brasil,1,13,,14,POINT (11360029 -72129595)
2013,Julio,Brasil,31,20,,51,POINT (125862 -81702165)
2013,Julio,Brasil,35,111,,146,POINT (3451668 -76532004)
2013,Julio,Brasil,3051,4410,,7461,POINT (4697157 -74140516)
2013,Julio,Brasil,4,7,,11,POINT (4815189 -75736374)
2013,Julio,Brasil,100,199,,299,POINT (6170465 -7542726)
2013,Julio,Brasil,0,1,,1,POINT (6185536 -67484028)
2013,Julio,Brasil,3,2,,5,POINT (7128047 -73181317)
2013,Julio,Brasil,12,18,,30,POINT (7819 -72453013)
2013,Julio,Brasil,1,2,,3,POINT (7927233 -72508188)
2013,Julio,Brasil,1,1,,2,POINT (863337 -7735002)
2013,Julio,Bulgaria,1,1,,2,POINT (0.81488 -77356)
2013,Julio,Bulgaria,4,1,,5,POINT (3451668 -76532004)
2013,Julio,Bulgaria,14,18,,32,POINT (4697157 -74140516)
2013,Julio,Burkina Faso,1,0,,1,POINT (0.81488 -77356)
2013,Julio,Burkina Faso,1,1,,2,POINT (4697157 -74140516)
2013,Julio,Islas Caimán/Territorio Británico de Ultramar,3,1,,4,POINT (125862 -81702165)
2013,Julio,Islas Caimán/Territorio Británico de Ultramar,2,2,,4,POINT (4697157 -74140516)
2013,Julio,Camboya,0,1,,1,POINT (4697157 -74140516)
2013,Julio,Camerún,0,1,,1,POINT (3451668 -76532004)
2013,Julio,Camerún,0,1,,1,POINT (4697157 -74140516)
2013,Julio,Camerún,0,1,,1,POINT (7819 -72453013)
2013,Julio,Canadá,3,3,,6,POINT (-4191162 -69941498)
2013,Julio,Canadá,30,26,,56,POINT (0.81488 -77356)
2013,Julio,Canadá,13,14,,27,POINT (10406342 -75527794)
2013,Julio,Canadá,55,77,,132,POINT (10446304 -75516486)
2013,Julio,Canadá,10,25,,35,POINT (10886686 -74776479)
2013,Julio,Canadá,1,9,,10,POINT (11360029 -72129595)
2013,Julio,Canadá,4,2,,6,POINT (125862 -81702165)
2013,Julio,Canadá,58,100,,158,POINT (3451668 -76532004)
2013,Julio,Canadá,2,7,,9,POINT (445285 -75766353)
2013,Julio,Canadá,863,1517,,2380,POINT (4697157 -74140516)
2013,Julio,Canadá,4,10,,14,POINT (4815189 -75736374)
2013,Julio,Canadá,145,291,,436,POINT (6170465 -7542726)
2013,Julio,Canadá,1,2,,3,POINT (7128047 -73181317)
2013,Julio,Canadá,8,2,,10,POINT (7819 -72453013)
2013,Julio,Canadá,1,1,,2,POINT (7927233 -72508188)
2013,Julio,Canadá,2,0,,2,POINT (863337 -7735002)
2013,Julio,España,2,0,,2,POINT (-4191162 -69941498)
2013,Julio,España,19,16,,35,POINT (0.81488 -77356)
2013,Julio,España,3,2,,5,POINT (10406342 -75527794)
2013,Julio,España,1,5,,6,POINT (10446304 -75516486)
2013,Julio,España,1,12,,13,POINT (10886686 -74776479)
2013,Julio,España,45,93,,138,POINT (3451668 -76532004)
2013,Julio,España,126,263,,389,POINT (4697157 -74140516)
2013,Julio,España,43,104,,147,POINT (6170465 -7542726)
2013,Julio,España,1,2,,3,POINT (7819 -72453013)
2013,Julio,España,0,1,,1,POINT (7927233 -72508188)
2013,Julio,República Del Congo,0,2,,2,POINT (4697157 -74140516)
2013,Julio,República Democrática del Congo,0,2,,2,POINT (0.81488 -77356)
2013,Julio,República Democrática del Congo,1,2,,3,POINT (4697157 -74140516)
2013,Julio,República de Corea,3,12,,15,POINT (0.81488 -77356)
2013,Julio,República de Corea,0,1,,1,POINT (10406342 -75527794)
2013,Julio,República de Corea,2,1,,3,POINT (10446304 -75516486)
2013,Julio,República de Corea,0,1,,1,POINT (10886686 -74776479)
2013,Julio,República de Corea,1,0,,1,POINT (11360029 -72129595)
2013,Julio,República de Corea,3,6,,9,POINT (3451668 -76532004)
2013,Julio,República de Corea,149,372,,521,POINT (4697157 -74140516)
2013,Julio,República de Corea,8,29,,37,POINT (6170465 -7542726)
2013,Julio,República de Corea,0,1,,1,POINT (7128047 -73181317)
2013,Julio,República de Corea,5,6,,11,POINT (7819 -72453013)
2013,Julio,República de Corea,1,4,,5,POINT (863337 -7735002)
2013,Julio,Costa de Marfil,1,1,,2,POINT (4697157 -74140516)
2013,Julio,Costa Rica,3,1,,4,POINT (0.81488 -77356)
2013,Julio,Costa Rica,1,2,,3,POINT (10406342 -75527794)
2013,Julio,Costa Rica,68,74,,142,POINT (10446304 -75516486)
2013,Julio,Costa Rica,10,26,,36,POINT (10886686 -74776479)
2013,Julio,Costa Rica,390,273,,663,POINT (125862 -81702165)
2013,Julio,Costa Rica,30,55,,85,POINT (3451668 -76532004)
2013,Julio,Costa Rica,595,940,,1535,POINT (4697157 -74140516)
2013,Julio,Costa Rica,2,2,,4,POINT (4815189 -75736374)
2013,Julio,Costa Rica,159,216,,375,POINT (6170465 -7542726)
2013,Julio,Costa Rica,1,2,,3,POINT (7128047 -73181317)
2013,Julio,Costa Rica,2,4,,6,POINT (7819 -72453013)
2013,Julio,Costa Rica,1,1,,2,POINT (7927233 -72508188)
2013,Julio,Costa Rica,0,1,,1,POINT (863337 -7735002)
2013,Julio,Croacia,0,2,,2,POINT (10406342 -75527794)
2013,Julio,Croacia,0,1,,1,POINT (10446304 -75516486)
2013,Julio,Croacia,3,12,,15,POINT (3451668 -76532004)
2013,Julio,Croacia,9,37,,46,POINT (4697157 -74140516)
2013,Julio,Croacia,1,2,,3,POINT (6170465 -7542726)
2013,Julio,Croacia,0,1,,1,POINT (7819 -72453013)
2013,Julio,Croacia,0,1,,1,POINT (9402597 -75681642)
2013,Julio,Cuba,0,1,,1,POINT (-4191162 -69941498)
2013,Julio,Cuba,6,3,,9,POINT (0.81488 -77356)
2013,Julio,Cuba,1,0,,1,POINT (10406342 -75527794)
2013,Julio,Cuba,9,22,,31,POINT (10446304 -75516486)
2013,Julio,Cuba,5,11,,16,POINT (10886686 -74776479)
2013,Julio,Cuba,0,1,,1,POINT (11360029 -72129595)
2013,Julio,Cuba,26,24,,50,POINT (3451668 -76532004)
2013,Julio,Cuba,0,1,,1,POINT (445285 -75766353)
2013,Julio,Cuba,109,245,,354,POINT (4697157 -74140516)
2013,Julio,Cuba,1,3,,4,POINT (4815189 -75736374)
2013,Julio,Cuba,17,31,,48,POINT (6170465 -7542726)
2013,Julio,Cuba,5,4,,9,POINT (7128047 -73181317)
2013,Julio,Cuba,2,0,,2,POINT (7819 -72453013)
2013,Julio,Cuba,2,1,,3,POINT (7927233 -72508188)
2013,Julio,Curazao,4,2,,6,POINT (4697157 -74140516)
2013,Julio,Curazao,0,5,,5,POINT (6170465 -7542726)
2013,Julio,República Checa,0,2,,2,POINT (0.81488 -77356)
2013,Julio,República Checa,1,4,,5,POINT (11360029 -72129595)
2013,Julio,República Checa,18,64,,82,POINT (3451668 -76532004)
2013,Julio,República Checa,32,64,,96,POINT (4697157 -74140516)
2013,Julio,República Checa,1,0,,1,POINT (4815189 -75736374)
2013,Julio,República Checa,2,5,,7,POINT (6170465 -7542726)
2013,Julio,República Checa,1,1,,2,POINT (7819 -72453013)
2013,Julio,República Checa,1,1,,2,POINT (863337 -7735002)
2013,Julio,Chile,6,6,,12,POINT (-4191162 -69941498)
2013,Julio,Chile,31,59,,90,POINT (0.81488 -77356)
2013,Julio,Chile,57,42,,99,POINT (10406342 -75527794)
2013,Julio,Chile,95,88,,183,POINT (10446304 -75516486)
2013,Julio,Chile,1,12,,13,POINT (10886686 -74776479)
2013,Julio,Chile,3,10,,13,POINT (11360029 -72129595)
2013,Julio,Chile,54,42,,96,POINT (125862 -81702165)
2013,Julio,Chile,31,65,,96,POINT (3451668 -76532004)
2013,Julio,Chile,3645,4431,,8076,POINT (4697157 -74140516)
2013,Julio,Chile,1,0,,1,POINT (4815189 -75736374)
2013,Julio,Chile,69,130,,199,POINT (6170465 -7542726)
2013,Julio,Chile,0,1,,1,POINT (7088729 -70740253)
2013,Julio,Chile,0,1,,1,POINT (7128047 -73181317)
2013,Julio,Chile,8,20,,28,POINT (7819 -72453013)
2013,Julio,Chile,1,2,,3,POINT (7927233 -72508188)
2013,Julio,Chile,2,1,,3,POINT (863337 -7735002)
2013,Julio,China,1,0,,1,POINT (0.81488 -77356)
2013,Julio,China,0,1,,1,POINT (10406342 -75527794)
2013,Julio,China,3,3,,6,POINT (10446304 -75516486)
2013,Julio,China,1,2,,3,POINT (10886686 -74776479)
2013,Julio,China,1,1,,2,POINT (11360029 -72129595)
2013,Julio,China,10,22,,32,POINT (3451668 -76532004)
2013,Julio,China,249,496,,745,POINT (4697157 -74140516)
2013,Julio,China,0,1,,1,POINT (4815189 -75736374)
2013,Julio,China,17,21,,38,POINT (6170465 -7542726)
2013,Julio,China,2,2,,4,POINT (7819 -72453013)
2013,Julio,Taiwán,1,0,,1,POINT (0.81488 -77356)
2013,Julio,Taiwán,2,2,,4,POINT (10886686 -74776479)
2013,Julio,Taiwán,44,43,,87,POINT (3451668 -76532004)
2013,Julio,Taiwán,41,82,,123,POINT (4697157 -74140516)
2013,Julio,Taiwán,7,10,,17,POINT (6170465 -7542726)
2013,Julio,Chipre,1,0,,1,POINT (3451668 -76532004)
2013,Julio,Chipre,0,15,,15,POINT (4697157 -74140516)
2013,Julio,Chipre,0,2,,2,POINT (6170465 -7542726)
2013,Julio,Chipre,0,1,,1,POINT (9402597 -75681642)
2013,Julio,Dinamarca,5,7,,12,POINT (0.81488 -77356)
2013,Julio,Dinamarca,0,2,,2,POINT (10406342 -75527794)
2013,Julio,Dinamarca,1,5,,6,POINT (10446304 -75516486)
2013,Julio,Dinamarca,4,7,,11,POINT (10886686 -74776479)
2013,Julio,Dinamarca,0,1,,1,POINT (10970933 -74765343)
2013,Julio,Dinamarca,1,0,,1,POINT (11360029 -72129595)
2013,Julio,Dinamarca,1,0,,1,POINT (125862 -81702165)
2013,Julio,Dinamarca,5,26,,31,POINT (3451668 -76532004)
2013,Julio,Dinamarca,93,159,,252,POINT (4697157 -74140516)
2013,Julio,Dinamarca,0,1,,1,POINT (4815189 -75736374)
2013,Julio,Dinamarca,7,10,,17,POINT (6170465 -7542726)
2013,Julio,Dinamarca,2,2,,4,POINT (7819 -72453013)
2013,Julio,Dominica,0,4,,4,POINT (4697157 -74140516)
2013,Julio,Ecuador,0,4,,4,POINT (-4191162 -69941498)
2013,Julio,Ecuador,34,92,,126,POINT (0.33002 -76876446)
2013,Julio,Ecuador,1604,2232,,3836,POINT (0.81488 -77356)
2013,Julio,Ecuador,6,119,,125,POINT (1800143 -78802679)
2013,Julio,Ecuador,16,84,,100,POINT (10406342 -75527794)
2013,Julio,Ecuador,29,32,,61,POINT (10446304 -75516486)
2013,Julio,Ecuador,3,8,,11,POINT (10886686 -74776479)
2013,Julio,Ecuador,13,16,,29,POINT (11360029 -72129595)
2013,Julio,Ecuador,12,15,,27,POINT (125862 -81702165)
2013,Julio,Ecuador,348,402,,750,POINT (3451668 -76532004)
2013,Julio,Ecuador,0,1,,1,POINT (3884426 -77061029)
2013,Julio,Ecuador,1858,2864,,4722,POINT (4697157 -74140516)
2013,Julio,Ecuador,438,516,,954,POINT (6170465 -7542726)
2013,Julio,Ecuador,0,1,,1,POINT (6185536 -67484028)
2013,Julio,Ecuador,0,1,,1,POINT (7088729 -70740253)
2013,Julio,Ecuador,2,3,,5,POINT (7128047 -73181317)
2013,Julio,Ecuador,128,220,,348,POINT (7819 -72453013)
2013,Julio,Ecuador,2,2,,4,POINT (7927233 -72508188)
2013,Julio,Ecuador,1,0,,1,POINT (863337 -7735002)
2013,Julio,Egipto,0,1,,1,POINT (10446304 -75516486)
2013,Julio,Egipto,2,5,,7,POINT (3451668 -76532004)
2013,Julio,Egipto,9,24,,33,POINT (4697157 -74140516)
2013,Julio,Egipto,0,1,,1,POINT (6170465 -7542726)
2013,Julio,El Salvador,1,2,,3,POINT (0.81488 -77356)
2013,Julio,El Salvador,18,18,,36,POINT (10446304 -75516486)
2013,Julio,El Salvador,2,3,,5,POINT (10886686 -74776479)
2013,Julio,El Salvador,3,3,,6,POINT (125862 -81702165)
2013,Julio,El Salvador,40,63,,103,POINT (3451668 -76532004)
2013,Julio,El Salvador,0,1,,1,POINT (445285 -75766353)
2013,Julio,El Salvador,482,778,,1260,POINT (4697157 -74140516)
2013,Julio,El Salvador,1,1,,2,POINT (4815189 -75736374)
2013,Julio,El Salvador,50,76,,126,POINT (6170465 -7542726)
2013,Julio,El Salvador,1,0,,1,POINT (7128047 -73181317)
2013,Julio,El Salvador,0,1,,1,POINT (7927233 -72508188)
2013,Julio,El Salvador,0,3,,3,POINT (863337 -7735002)
2013,Julio,Emiratos Árabes,0,2,,2,POINT (3451668 -76532004)
2013,Julio,Emiratos Árabes,1,0,,1,POINT (4697157 -74140516)
2013,Julio,España,6,10,,16,POINT (-4191162 -69941498)
2013,Julio,España,0,1,,1,POINT (0.33002 -76876446)
2013,Julio,España,21,34,,55,POINT (0.81488 -77356)
2013,Julio,España,1,0,,1,POINT (1800143 -78802679)
2013,Julio,España,2,16,,18,POINT (10406342 -75527794)
2013,Julio,España,32,81,,113,POINT (10446304 -75516486)
2013,Julio,España,7,16,,23,POINT (10886686 -74776479)
2013,Julio,España,1,1,,2,POINT (11247723 -74213989)
2013,Julio,España,5,13,,18,POINT (11360029 -72129595)
2013,Julio,España,8,10,,18,POINT (125862 -81702165)
2013,Julio,España,232,412,,644,POINT (3451668 -76532004)
2013,Julio,España,1962,4582,,6544,POINT (4697157 -74140516)
2013,Julio,España,1,6,,7,POINT (4815189 -75736374)
2013,Julio,España,120,257,,377,POINT (6170465 -7542726)
2013,Julio,España,0,1,,1,POINT (7088729 -70740253)
2013,Julio,España,1,2,,3,POINT (7128047 -73181317)
2013,Julio,España,20,46,,66,POINT (7819 -72453013)
2013,Julio,España,3,4,,7,POINT (7927233 -72508188)
2013,Julio,España,5,6,,11,POINT (863337 -7735002)
2013,Julio,Eritrea,1,1,,2,POINT (4697157 -74140516)
2013,Julio,Eslovaquia,1,1,,2,POINT (10406342 -75527794)
2013,Julio,Eslovaquia,2,1,,3,POINT (10446304 -75516486)
2013,Julio,Eslovaquia,1,0,,1,POINT (11360029 -72129595)
2013,Julio,Eslovaquia,12,14,,26,POINT (3451668 -76532004)
2013,Julio,Eslovaquia,7,22,,29,POINT (4697157 -74140516)
2013,Julio,Eslovaquia,2,0,,2,POINT (6170465 -7542726)
2013,Julio,Eslovenia,1,1,,2,POINT (0.81488 -77356)
2013,Julio,Eslovenia,0,2,,2,POINT (10406342 -75527794)
2013,Julio,Eslovenia,2,1,,3,POINT (10446304 -75516486)
2013,Julio,Eslovenia,1,10,,11,POINT (3451668 -76532004)
2013,Julio,Eslovenia,16,27,,43,POINT (4697157 -74140516)
2013,Julio,Eslovenia,1,0,,1,POINT (7819 -72453013)
2013,Julio,Estados Unidos de América,50,53,,103,POINT (-4191162 -69941498)
2013,Julio,Estados Unidos de América,1,2,,3,POINT (0.33002 -76876446)
2013,Julio,Estados Unidos de América,90,121,,211,POINT (0.81488 -77356)
2013,Julio,Estados Unidos de América,40,63,,103,POINT (10406342 -75527794)
2013,Julio,Estados Unidos de América,1474,2050,,3524,POINT (10446304 -75516486)
2013,Julio,Estados Unidos de América,361,591,,952,POINT (10886686 -74776479)
2013,Julio,Estados Unidos de América,0,2,,2,POINT (10970933 -74765343)
2013,Julio,Estados Unidos de América,4,4,,8,POINT (11247723 -74213989)
2013,Julio,Estados Unidos de América,11,22,,33,POINT (11360029 -72129595)
2013,Julio,Estados Unidos de América,34,38,,72,POINT (125862 -81702165)
2013,Julio,Estados Unidos de América,1264,1817,,3081,POINT (3451668 -76532004)
2013,Julio,Estados Unidos de América,143,171,,314,POINT (445285 -75766353)
2013,Julio,Estados Unidos de América,7841,12776,,20617,POINT (4697157 -74140516)
2013,Julio,Estados Unidos de América,169,164,,333,POINT (4815189 -75736374)
2013,Julio,Estados Unidos de América,2491,4279,,6770,POINT (6170465 -7542726)
2013,Julio,Estados Unidos de América,38,43,,81,POINT (7128047 -73181317)
2013,Julio,Estados Unidos de América,43,64,,107,POINT (7819 -72453013)
2013,Julio,Estados Unidos de América,26,23,,49,POINT (7927233 -72508188)
2013,Julio,Estados Unidos de América,4,6,,10,POINT (863337 -7735002)
2013,Julio,Estonia,0,1,,1,POINT (10446304 -75516486)
2013,Julio,Estonia,0,2,,2,POINT (10886686 -74776479)
2013,Julio,Estonia,4,5,,9,POINT (3451668 -76532004)
2013,Julio,Estonia,11,18,,29,POINT (4697157 -74140516)
2013,Julio,Estonia,2,1,,3,POINT (6170465 -7542726)
2013,Julio,Etiopia,3,0,,3,POINT (4697157 -74140516)
2013,Julio,Filipinas,0,65,,65,POINT (10406342 -75527794)
2013,Julio,Filipinas,1,27,,28,POINT (10446304 -75516486)
2013,Julio,Filipinas,0,17,,17,POINT (10886686 -74776479)
2013,Julio,Filipinas,0,53,,53,POINT (10970933 -74765343)
2013,Julio,Filipinas,0,26,,26,POINT (11247723 -74213989)
2013,Julio,Filipinas,3,23,,26,POINT (3451668 -76532004)
2013,Julio,Filipinas,0,20,,20,POINT (3884426 -77061029)
2013,Julio,Filipinas,21,82,,103,POINT (4697157 -74140516)
2013,Julio,Filipinas,4,4,,8,POINT (6170465 -7542726)
2013,Julio,Filipinas,0,4,,4,POINT (9402597 -75681642)
2013,Julio,Finlandia,2,2,,4,POINT (-4191162 -69941498)
2013,Julio,Finlandia,2,2,,4,POINT (0.81488 -77356)
2013,Julio,Finlandia,2,1,,3,POINT (10406342 -75527794)
2013,Julio,Finlandia,1,0,,1,POINT (10446304 -75516486)
2013,Julio,Finlandia,1,0,,1,POINT (11360029 -72129595)
2013,Julio,Finlandia,7,6,,13,POINT (3451668 -76532004)
2013,Julio,Finlandia,40,54,,94,POINT (4697157 -74140516)
2013,Julio,Finlandia,2,1,,3,POINT (6170465 -7542726)
2013,Julio,Finlandia,1,0,,1,POINT (7819 -72453013)
2013,Julio,Francia,9,13,,22,POINT (-4191162 -69941498)
2013,Julio,Francia,63,94,,157,POINT (0.81488 -77356)
2013,Julio,Francia,0,1,,1,POINT (1800143 -78802679)
2013,Julio,Francia,14,48,,62,POINT (10406342 -75527794)
2013,Julio,Francia,22,33,,55,POINT (10446304 -75516486)
2013,Julio,Francia,2,8,,10,POINT (10886686 -74776479)
2013,Julio,Francia,4,23,,27,POINT (10970933 -74765343)
2013,Julio,Francia,0,1,,1,POINT (11247723 -74213989)
2013,Julio,Francia,7,21,,28,POINT (11360029 -72129595)
2013,Julio,Francia,2,2,,4,POINT (125862 -81702165)
2013,Julio,Francia,68,146,,214,POINT (3451668 -76532004)
2013,Julio,Francia,1585,2582,,4167,POINT (4697157 -74140516)
2013,Julio,Francia,0,1,,1,POINT (4815189 -75736374)
2013,Julio,Francia,100,141,,241,POINT (6170465 -7542726)
2013,Julio,Francia,9,15,,24,POINT (7819 -72453013)
2013,Julio,Francia,6,9,,15,POINT (863337 -7735002)
2013,Julio,Georgia,0,1,,1,POINT (10406342 -75527794)
2013,Julio,Georgia,2,8,,10,POINT (4697157 -74140516)
2013,Julio,Ghana,1,1,,2,POINT (4697157 -74140516)
2013,Julio,Granada,1,3,,4,POINT (4697157 -74140516)
2013,Julio,Granada,1,0,,1,POINT (6170465 -7542726)
2013,Julio,Grecia,1,0,,1,POINT (0.81488 -77356)
2013,Julio,Grecia,0,3,,3,POINT (10406342 -75527794)
2013,Julio,Grecia,0,3,,3,POINT (10446304 -75516486)
2013,Julio,Grecia,0,9,,9,POINT (3451668 -76532004)
2013,Julio,Grecia,13,52,,65,POINT (4697157 -74140516)
2013,Julio,Grecia,0,7,,7,POINT (6170465 -7542726)
2013,Julio,Grecia,0,2,,2,POINT (7819 -72453013)
2013,Julio,Grecia,0,2,,2,POINT (863337 -7735002)
2013,Julio,Grecia,0,2,,2,POINT (9402597 -75681642)
2013,Julio,Guatemala,0,1,,1,POINT (0.81488 -77356)
2013,Julio,Guatemala,0,1,,1,POINT (10406342 -75527794)
2013,Julio,Guatemala,20,41,,61,POINT (10446304 -75516486)
2013,Julio,Guatemala,2,7,,9,POINT (10886686 -74776479)
2013,Julio,Guatemala,0,2,,2,POINT (11360029 -72129595)
2013,Julio,Guatemala,2,2,,4,POINT (125862 -81702165)
2013,Julio,Guatemala,39,63,,102,POINT (3451668 -76532004)
2013,Julio,Guatemala,202,490,,692,POINT (4697157 -74140516)
2013,Julio,Guatemala,2,1,,3,POINT (4815189 -75736374)
2013,Julio,Guatemala,77,183,,260,POINT (6170465 -7542726)
2013,Julio,Guatemala,1,2,,3,POINT (7128047 -73181317)
2013,Julio,Guatemala,10,14,,24,POINT (7819 -72453013)
2013,Julio,Guatemala,1,0,,1,POINT (7927233 -72508188)
2013,Julio,Guatemala,0,1,,1,POINT (863337 -7735002)
2013,Julio,Guyana,0,2,,2,POINT (-4191162 -69941498)
2013,Julio,Guyana,1,5,,6,POINT (10446304 -75516486)
2013,Julio,Guyana,3,0,,3,POINT (3451668 -76532004)
2013,Julio,Guyana,3,7,,10,POINT (4697157 -74140516)
2013,Julio,Guyana,2,2,,4,POINT (6170465 -7542726)
2013,Julio,Guinea,0,1,,1,POINT (6170465 -7542726)
2013,Julio,Guinea Ecuatorial,2,1,,3,POINT (4697157 -74140516)
2013,Julio,Guinea Bissau,0,1,,1,POINT (7927233 -72508188)
2013,Julio,Haití,1,3,,4,POINT (10446304 -75516486)
2013,Julio,Haití,6,14,,20,POINT (4697157 -74140516)
2013,Julio,Haití,0,3,,3,POINT (6170465 -7542726)
2013,Julio,Honduras,2,3,,5,POINT (0.81488 -77356)
2013,Julio,Honduras,2,7,,9,POINT (10406342 -75527794)
2013,Julio,Honduras,8,30,,38,POINT (10446304 -75516486)
2013,Julio,Honduras,3,6,,9,POINT (10886686 -74776479)
2013,Julio,Honduras,2,1,,3,POINT (125862 -81702165)
2013,Julio,Honduras,9,12,,21,POINT (3451668 -76532004)
2013,Julio,Honduras,151,231,,382,POINT (4697157 -74140516)
2013,Julio,Honduras,2,1,,3,POINT (4815189 -75736374)
2013,Julio,Honduras,59,68,,127,POINT (6170465 -7542726)
2013,Julio,Honduras,2,0,,2,POINT (7819 -72453013)
2013,Julio,Honduras,0,3,,3,POINT (806667 -767333)
2013,Julio,Honduras,1,3,,4,POINT (863337 -7735002)
2013,Julio,Honduras,0,3,,3,POINT (9402597 -75681642)
2013,Julio,Hungría,1,0,,1,POINT (10406342 -75527794)
2013,Julio,Hungría,19,23,,42,POINT (3451668 -76532004)
2013,Julio,Hungría,51,63,,114,POINT (4697157 -74140516)
2013,Julio,Hungría,1,3,,4,POINT (6170465 -7542726)
2013,Julio,India,1,0,,1,POINT (-4191162 -69941498)
2013,Julio,India,0,1,,1,POINT (0.81488 -77356)
2013,Julio,India,1,10,,11,POINT (10446304 -75516486)
2013,Julio,India,1,5,,6,POINT (10886686 -74776479)
2013,Julio,India,0,1,,1,POINT (125862 -81702165)
2013,Julio,India,4,17,,21,POINT (3451668 -76532004)
2013,Julio,India,50,279,,329,POINT (4697157 -74140516)
2013,Julio,India,8,33,,41,POINT (6170465 -7542726)
2013,Julio,Indonesia,0,3,,3,POINT (0.81488 -77356)
2013,Julio,Indonesia,0,1,,1,POINT (10406342 -75527794)
2013,Julio,Indonesia,0,1,,1,POINT (10446304 -75516486)
2013,Julio,Indonesia,1,4,,5,POINT (3451668 -76532004)
2013,Julio,Indonesia,14,34,,48,POINT (4697157 -74140516)
2013,Julio,Indonesia,1,2,,3,POINT (6170465 -7542726)
2013,Julio,Iraq,0,1,,1,POINT (10446304 -75516486)
2013,Julio,Irán,0,1,,1,POINT (10446304 -75516486)
2013,Julio,Irán,8,41,,49,POINT (4697157 -74140516)
2013,Julio,Irán,0,2,,2,POINT (6170465 -7542726)
2013,Julio,República de Irlanda,1,1,,2,POINT (-4191162 -69941498)
2013,Julio,República de Irlanda,17,11,,28,POINT (0.81488 -77356)
2013,Julio,República de Irlanda,2,7,,9,POINT (10406342 -75527794)
2013,Julio,República de Irlanda,2,16,,18,POINT (10446304 -75516486)
2013,Julio,República de Irlanda,0,1,,1,POINT (125862 -81702165)
2013,Julio,República de Irlanda,6,11,,17,POINT (3451668 -76532004)
2013,Julio,República de Irlanda,115,166,,281,POINT (4697157 -74140516)
2013,Julio,República de Irlanda,9,12,,21,POINT (6170465 -7542726)
2013,Julio,República de Irlanda,0,3,,3,POINT (7819 -72453013)
2013,Julio,República de Irlanda,1,1,,2,POINT (863337 -7735002)
2013,Julio,Islandia,0,2,,2,POINT (10406342 -75527794)
2013,Julio,Islandia,3,9,,12,POINT (4697157 -74140516)
2013,Julio,Islandia,2,1,,3,POINT (6170465 -7542726)
2013,Julio,Isla de Man,24,32,,56,POINT (0.81488 -77356)
2013,Julio,Isla de Man,2,4,,6,POINT (10446304 -75516486)
2013,Julio,Isla de Man,30,51,,81,POINT (3451668 -76532004)
2013,Julio,Isla de Man,64,132,,196,POINT (4697157 -74140516)
2013,Julio,Isla de Man,27,54,,81,POINT (6170465 -7542726)
2013,Julio,Islas Pitcairn/Territorio Británico de Ultramar,0,1,,1,POINT (4697157 -74140516)
2013,Julio,Isla Johnston,2,0,,2,POINT (4697157 -74140516)
2013,Julio,Israel,1,9,,10,POINT (-4191162 -69941498)
2013,Julio,Israel,19,57,,76,POINT (0.81488 -77356)
2013,Julio,Israel,1,7,,8,POINT (10406342 -75527794)
2013,Julio,Israel,6,27,,33,POINT (10446304 -75516486)
2013,Julio,Israel,0,1,,1,POINT (10886686 -74776479)
2013,Julio,Israel,1,0,,1,POINT (125862 -81702165)
2013,Julio,Israel,8,38,,46,POINT (3451668 -76532004)
2013,Julio,Israel,110,461,,571,POINT (4697157 -74140516)
2013,Julio,Israel,11,65,,76,POINT (6170465 -7542726)
2013,Julio,Israel,0,1,,1,POINT (7128047 -73181317)
2013,Julio,Islas Aland/Provincia de Finlandia,0,1,,1,POINT (4697157 -74140516)
2013,Julio,Isla Wake,4,2,,6,POINT (7927233 -72508188)
2013,Julio,Italia,0,9,,9,POINT (-4191162 -69941498)
2013,Julio,Italia,1,0,,1,POINT (0.33002 -76876446)
2013,Julio,Italia,12,27,,39,POINT (0.81488 -77356)
2013,Julio,Italia,3,9,,12,POINT (10406342 -75527794)
2013,Julio,Italia,28,67,,95,POINT (10446304 -75516486)
2013,Julio,Italia,6,14,,20,POINT (10886686 -74776479)
2013,Julio,Italia,0,1,,1,POINT (11247723 -74213989)
2013,Julio,Italia,6,19,,25,POINT (11360029 -72129595)
2013,Julio,Italia,1,2,,3,POINT (125862 -81702165)
2013,Julio,Italia,74,166,,240,POINT (3451668 -76532004)
2013,Julio,Italia,558,1537,,2095,POINT (4697157 -74140516)
2013,Julio,Italia,1,3,,4,POINT (4815189 -75736374)
2013,Julio,Italia,38,105,,143,POINT (6170465 -7542726)
2013,Julio,Italia,0,1,,1,POINT (6185536 -67484028)
2013,Julio,Italia,0,3,,3,POINT (7128047 -73181317)
2013,Julio,Italia,1,18,,19,POINT (7819 -72453013)
2013,Julio,Italia,0,1,,1,POINT (7927233 -72508188)
2013,Julio,Italia,2,3,,5,POINT (863337 -7735002)
2013,Julio,Islas del Canal,1,0,,1,POINT (10446304 -75516486)
2013,Julio,Islas del Canal,0,7,,7,POINT (10886686 -74776479)
2013,Julio,Jamaica,7,5,,12,POINT (10446304 -75516486)
2013,Julio,Jamaica,2,5,,7,POINT (10886686 -74776479)
2013,Julio,Jamaica,2,1,,3,POINT (3451668 -76532004)
2013,Julio,Jamaica,18,15,,33,POINT (4697157 -74140516)
2013,Julio,Jamaica,0,2,,2,POINT (4815189 -75736374)
2013,Julio,Jamaica,9,8,,17,POINT (6170465 -7542726)
2013,Julio,Jamaica,0,1,,1,POINT (7128047 -73181317)
2013,Julio,Jamaica,1,0,,1,POINT (7819 -72453013)
2013,Julio,Islas Salomón,1,0,,1,POINT (3451668 -76532004)
2013,Julio,Japón,1,0,,1,POINT (-4191162 -69941498)
2013,Julio,Japón,9,15,,24,POINT (0.81488 -77356)
2013,Julio,Japón,3,11,,14,POINT (10446304 -75516486)
2013,Julio,Japón,0,6,,6,POINT (10886686 -74776479)
2013,Julio,Japón,1,1,,2,POINT (11360029 -72129595)
2013,Julio,Japón,1,1,,2,POINT (125862 -81702165)
2013,Julio,Japón,26,66,,92,POINT (3451668 -76532004)
2013,Julio,Japón,143,501,,644,POINT (4697157 -74140516)
2013,Julio,Japón,7,24,,31,POINT (6170465 -7542726)
2013,Julio,Japón,0,1,,1,POINT (7128047 -73181317)
2013,Julio,Japón,7,6,,13,POINT (7819 -72453013)
2013,Julio,Jordania,2,2,,4,POINT (10446304 -75516486)
2013,Julio,Jordania,1,6,,7,POINT (4697157 -74140516)
2013,Julio,Kazajistán,0,9,,9,POINT (10886686 -74776479)
2013,Julio,Kazajistán,4,2,,6,POINT (3451668 -76532004)
2013,Julio,Kazajistán,1,1,,2,POINT (4697157 -74140516)
2013,Julio,Kenia,8,10,,18,POINT (4697157 -74140516)
2013,Julio,Kirguistán,1,10,,11,POINT (4697157 -74140516)
2013,Julio,Kuwait,0,1,,1,POINT (4697157 -74140516)
2013,Julio,República de Kosovo,1,7,,8,POINT (4697157 -74140516)
2013,Julio,República de Kosovo,0,1,,1,POINT (6170465 -7542726)
2013,Julio,Letonia,0,1,,1,POINT (10406342 -75527794)
2013,Julio,Letonia,0,1,,1,POINT (10446304 -75516486)
2013,Julio,Letonia,0,1,,1,POINT (10970933 -74765343)
2013,Julio,Letonia,0,11,,11,POINT (3451668 -76532004)
2013,Julio,Letonia,12,36,,48,POINT (4697157 -74140516)
2013,Julio,Letonia,2,1,,3,POINT (6170465 -7542726)
2013,Julio,Lituania,0,1,,1,POINT (0.81488 -77356)
2013,Julio,Lituania,0,1,,1,POINT (10406342 -75527794)
2013,Julio,Lituania,0,1,,1,POINT (11360029 -72129595)
2013,Julio,Lituania,3,1,,4,POINT (3451668 -76532004)
2013,Julio,Lituania,12,15,,27,POINT (4697157 -74140516)
2013,Julio,Lituania,0,1,,1,POINT (6170465 -7542726)
2013,Julio,Lituania,2,0,,2,POINT (7819 -72453013)
2013,Julio,Líbano,1,0,,1,POINT (10446304 -75516486)
2013,Julio,Líbano,0,2,,2,POINT (10886686 -74776479)
2013,Julio,Líbano,6,2,,8,POINT (11360029 -72129595)
2013,Julio,Líbano,2,5,,7,POINT (3451668 -76532004)
2013,Julio,Líbano,16,23,,39,POINT (4697157 -74140516)
2013,Julio,Líbano,0,1,,1,POINT (6170465 -7542726)
2013,Julio,Liechtenstein,1,0,,1,POINT (3451668 -76532004)
2013,Julio,Liechtenstein,4,5,,9,POINT (4697157 -74140516)
2013,Julio,Luxemburgo,0,2,,2,POINT (-4191162 -69941498)
2013,Julio,Luxemburgo,1,0,,1,POINT (0.81488 -77356)
2013,Julio,Luxemburgo,2,1,,3,POINT (3451668 -76532004)
2013,Julio,Luxemburgo,6,22,,28,POINT (4697157 -74140516)
2013,Julio,Macedonia,0,1,,1,POINT (3451668 -76532004)
2013,Julio,Macedonia,2,10,,12,POINT (4697157 -74140516)
2013,Julio,Madagascar,2,1,,3,POINT (4697157 -74140516)
2013,Julio,Malasia,0,1,,1,POINT (10446304 -75516486)
2013,Julio,Malasia,0,8,,8,POINT (10886686 -74776479)
2013,Julio,Malasia,0,2,,2,POINT (11247723 -74213989)
2013,Julio,Malasia,3,6,,9,POINT (3451668 -76532004)
2013,Julio,Malasia,16,29,,45,POINT (4697157 -74140516)
2013,Julio,Malasia,0,4,,4,POINT (6170465 -7542726)
2013,Julio,Malta,1,4,,5,POINT (4697157 -74140516)
2013,Julio,Marruecos,0,1,,1,POINT (0.81488 -77356)
2013,Julio,Marruecos,4,17,,21,POINT (4697157 -74140516)
2013,Julio,Mauricio,0,2,,2,POINT (3451668 -76532004)
2013,Julio,Mauricio,1,1,,2,POINT (4697157 -74140516)
2013,Julio,Mauricio,0,1,,1,POINT (6170465 -7542726)
2013,Julio,Mauritania,0,1,,1,POINT (4697157 -74140516)
2013,Julio,México,0,4,,4,POINT (-4191162 -69941498)
2013,Julio,México,0,1,,1,POINT (0.33002 -76876446)
2013,Julio,México,13,31,,44,POINT (0.81488 -77356)
2013,Julio,México,0,1,,1,POINT (1800143 -78802679)
2013,Julio,México,16,21,,37,POINT (10406342 -75527794)
2013,Julio,México,239,339,,578,POINT (10446304 -75516486)
2013,Julio,México,35,37,,72,POINT (10886686 -74776479)
2013,Julio,México,2,18,,20,POINT (11360029 -72129595)
2013,Julio,México,7,10,,17,POINT (125862 -81702165)
2013,Julio,México,113,212,,325,POINT (3451668 -76532004)
2013,Julio,México,3046,5547,,8593,POINT (4697157 -74140516)
2013,Julio,México,7,15,,22,POINT (4815189 -75736374)
2013,Julio,México,418,741,,1159,POINT (6170465 -7542726)
2013,Julio,México,2,0,,2,POINT (6185536 -67484028)
2013,Julio,México,18,20,,38,POINT (7128047 -73181317)
2013,Julio,México,24,49,,73,POINT (7819 -72453013)
2013,Julio,México,28,70,,98,POINT (7927233 -72508188)
2013,Julio,México,1,4,,5,POINT (863337 -7735002)
2013,Julio,Mayotte/Colectividad Territorial Francesa,0,1,,1,POINT (4697157 -74140516)
2013,Julio,República de Moldavia,4,5,,9,POINT (4697157 -74140516)
2013,Julio,Mónaco,1,0,,1,POINT (4697157 -74140516)
2013,Julio,Mongolia,1,14,,15,POINT (3451668 -76532004)
2013,Julio,Mongolia,4,11,,15,POINT (4697157 -74140516)
2013,Julio,Montenegro,2,3,,5,POINT (3451668 -76532004)
2013,Julio,Montenegro,4,4,,8,POINT (4697157 -74140516)
2013,Julio,Namibia,0,1,,1,POINT (4697157 -74140516)
2013,Julio,Nepal,1,1,,2,POINT (4697157 -74140516)
2013,Julio,Nicaragua,0,1,,1,POINT (0.81488 -77356)
2013,Julio,Nicaragua,3,8,,11,POINT (10446304 -75516486)
2013,Julio,Nicaragua,3,2,,5,POINT (10886686 -74776479)
2013,Julio,Nicaragua,1,3,,4,POINT (125862 -81702165)
2013,Julio,Nicaragua,5,1,,6,POINT (3451668 -76532004)
2013,Julio,Nicaragua,58,77,,135,POINT (4697157 -74140516)
2013,Julio,Nicaragua,2,1,,3,POINT (4815189 -75736374)
2013,Julio,Nicaragua,15,15,,30,POINT (6170465 -7542726)
2013,Julio,Nicaragua,0,1,,1,POINT (7128047 -73181317)
2013,Julio,Nicaragua,1,0,,1,POINT (7927233 -72508188)
2013,Julio,Nigeria,1,1,,2,POINT (10446304 -75516486)
2013,Julio,Nigeria,0,1,,1,POINT (10886686 -74776479)
2013,Julio,Nigeria,4,9,,13,POINT (4697157 -74140516)
2013,Julio,Nigeria,0,1,,1,POINT (6170465 -7542726)
2013,Julio,Noruega,3,2,,5,POINT (-4191162 -69941498)
2013,Julio,Noruega,4,9,,13,POINT (0.81488 -77356)
2013,Julio,Noruega,3,6,,9,POINT (10406342 -75527794)
2013,Julio,Noruega,12,22,,34,POINT (10446304 -75516486)
2013,Julio,Noruega,2,5,,7,POINT (10886686 -74776479)
2013,Julio,Noruega,1,4,,5,POINT (11247723 -74213989)
2013,Julio,Noruega,9,14,,23,POINT (3451668 -76532004)
2013,Julio,Noruega,136,192,,328,POINT (4697157 -74140516)
2013,Julio,Noruega,10,12,,22,POINT (6170465 -7542726)
2013,Julio,Noruega,0,1,,1,POINT (7819 -72453013)
2013,Julio,Noruega,0,2,,2,POINT (863337 -7735002)
2013,Julio,Nueva Caledonia/Territorio francés,1,0,,1,POINT (4697157 -74140516)
2013,Julio,Nueva Zelanda,11,14,,25,POINT (0.81488 -77356)
2013,Julio,Nueva Zelanda,5,7,,12,POINT (10446304 -75516486)
2013,Julio,Nueva Zelanda,0,1,,1,POINT (11360029 -72129595)
2013,Julio,Nueva Zelanda,9,12,,21,POINT (3451668 -76532004)
2013,Julio,Nueva Zelanda,1,0,,1,POINT (445285 -75766353)
2013,Julio,Nueva Zelanda,47,63,,110,POINT (4697157 -74140516)
2013,Julio,Nueva Zelanda,0,1,,1,POINT (4815189 -75736374)
2013,Julio,Nueva Zelanda,3,10,,13,POINT (6170465 -7542726)
2013,Julio,Papúa Nueva Guinea,1,0,,1,POINT (10446304 -75516486)
2013,Julio,Nueva Zelanda,7,14,,21,POINT (10406342 -75527794)
2013,Julio,Nueva Zelanda,0,1,,1,POINT (10886686 -74776479)
2013,Julio,Nueva Zelanda,0,2,,2,POINT (3451668 -76532004)
2013,Julio,Nueva Zelanda,1,4,,5,POINT (4697157 -74140516)
2013,Julio,Países Bajos,0,3,,3,POINT (-4191162 -69941498)
2013,Julio,Países Bajos,7,15,,22,POINT (0.81488 -77356)
2013,Julio,Países Bajos,7,20,,27,POINT (10446304 -75516486)
2013,Julio,Países Bajos,0,1,,1,POINT (10886686 -74776479)
2013,Julio,Países Bajos,12,20,,32,POINT (11360029 -72129595)
2013,Julio,Países Bajos,42,50,,92,POINT (1152863 -72919186)
2013,Julio,Países Bajos,26,45,,71,POINT (3451668 -76532004)
2013,Julio,Países Bajos,300,379,,679,POINT (4697157 -74140516)
2013,Julio,Países Bajos,0,3,,3,POINT (4815189 -75736374)
2013,Julio,Países Bajos,298,302,,600,POINT (6170465 -7542726)
2013,Julio,Países Bajos,6,3,,9,POINT (7128047 -73181317)
2013,Julio,Países Bajos,5,0,,5,POINT (7819 -72453013)
2013,Julio,Pakistán,0,3,,3,POINT (0.81488 -77356)
2013,Julio,Pakistán,0,2,,2,POINT (10446304 -75516486)
2013,Julio,Pakistán,0,1,,1,POINT (3451668 -76532004)
2013,Julio,Pakistán,3,13,,16,POINT (4697157 -74140516)
2013,Julio,Panamá,1,1,,2,POINT (0.81488 -77356)
2013,Julio,Panamá,0,1,,1,POINT (1800143 -78802679)
2013,Julio,Panamá,2,12,,14,POINT (10406342 -75527794)
2013,Julio,Panamá,100,174,,274,POINT (10446304 -75516486)
2013,Julio,Panamá,51,143,,194,POINT (10886686 -74776479)
2013,Julio,Panamá,1,2,,3,POINT (11360029 -72129595)
2013,Julio,Panamá,24,31,,55,POINT (125862 -81702165)
2013,Julio,Panamá,72,122,,194,POINT (3451668 -76532004)
2013,Julio,Panamá,0,1,,1,POINT (445285 -75766353)
2013,Julio,Panamá,583,945,,1528,POINT (4697157 -74140516)
2013,Julio,Panamá,67,95,,162,POINT (4815189 -75736374)
2013,Julio,Panamá,151,280,,431,POINT (6170465 -7542726)
2013,Julio,Panamá,6,9,,15,POINT (7128047 -73181317)
2013,Julio,Panamá,0,7,,7,POINT (7819 -72453013)
2013,Julio,Panamá,6,15,,21,POINT (7927233 -72508188)
2013,Julio,Panamá,5,5,,10,POINT (863337 -7735002)
2013,Julio,Papúa Nueva Guinea,0,1,,1,POINT (4697157 -74140516)
2013,Julio,Paraguay,0,4,,4,POINT (-4191162 -69941498)
2013,Julio,Paraguay,0,2,,2,POINT (0.81488 -77356)
2013,Julio,Paraguay,17,22,,39,POINT (10446304 -75516486)
2013,Julio,Paraguay,1,4,,5,POINT (10886686 -74776479)
2013,Julio,Paraguay,0,1,,1,POINT (11360029 -72129595)
2013,Julio,Paraguay,3,3,,6,POINT (125862 -81702165)
2013,Julio,Paraguay,8,9,,17,POINT (3451668 -76532004)
2013,Julio,Paraguay,131,349,,480,POINT (4697157 -74140516)
2013,Julio,Paraguay,10,23,,33,POINT (6170465 -7542726)
2013,Julio,Paraguay,0,4,,4,POINT (7819 -72453013)
2013,Julio,Perú,55,96,,151,POINT (-4191162 -69941498)
2013,Julio,Perú,3,3,,6,POINT (0.33002 -76876446)
2013,Julio,Perú,163,398,,561,POINT (0.81488 -77356)
2013,Julio,Perú,18,16,,34,POINT (10406342 -75527794)
2013,Julio,Perú,127,130,,257,POINT (10446304 -75516486)
2013,Julio,Perú,9,16,,25,POINT (10886686 -74776479)
2013,Julio,Perú,16,33,,49,POINT (11360029 -72129595)
2013,Julio,Perú,76,53,,129,POINT (125862 -81702165)
2013,Julio,Perú,107,134,,241,POINT (3451668 -76532004)
2013,Julio,Perú,3064,3694,,6758,POINT (4697157 -74140516)
2013,Julio,Perú,2,2,,4,POINT (4815189 -75736374)
2013,Julio,Perú,308,402,,710,POINT (6170465 -7542726)
2013,Julio,Perú,1,0,,1,POINT (7088729 -70740253)
2013,Julio,Perú,0,2,,2,POINT (7128047 -73181317)
2013,Julio,Perú,36,89,,125,POINT (7819 -72453013)
2013,Julio,Perú,0,2,,2,POINT (7927233 -72508188)
2013,Julio,Palestina,1,1,,2,POINT (4697157 -74140516)
2013,Julio,Polonia,8,4,,12,POINT (0.81488 -77356)
2013,Julio,Polonia,1,15,,16,POINT (10406342 -75527794)
2013,Julio,Polonia,2,7,,9,POINT (10446304 -75516486)
2013,Julio,Polonia,0,1,,1,POINT (10886686 -74776479)
2013,Julio,Polonia,0,2,,2,POINT (10970933 -74765343)
2013,Julio,Polonia,0,11,,11,POINT (11247723 -74213989)
2013,Julio,Polonia,2,1,,3,POINT (11360029 -72129595)
2013,Julio,Polonia,14,19,,33,POINT (3451668 -76532004)
2013,Julio,Polonia,0,2,,2,POINT (3884426 -77061029)
2013,Julio,Polonia,75,108,,183,POINT (4697157 -74140516)
2013,Julio,Polonia,4,5,,9,POINT (6170465 -7542726)
2013,Julio,Polonia,3,1,,4,POINT (7819 -72453013)
2013,Julio,Polonia,0,2,,2,POINT (806667 -767333)
2013,Julio,Polonia,1,1,,2,POINT (863337 -7735002)
2013,Julio,Portugal,0,3,,3,POINT (-4191162 -69941498)
2013,Julio,Portugal,4,5,,9,POINT (0.81488 -77356)
2013,Julio,Portugal,0,1,,1,POINT (1800143 -78802679)
2013,Julio,Portugal,0,1,,1,POINT (10406342 -75527794)
2013,Julio,Portugal,1,6,,7,POINT (10446304 -75516486)
2013,Julio,Portugal,2,3,,5,POINT (10886686 -74776479)
2013,Julio,Portugal,1,2,,3,POINT (11360029 -72129595)
2013,Julio,Portugal,0,2,,2,POINT (125862 -81702165)
2013,Julio,Portugal,4,18,,22,POINT (3451668 -76532004)
2013,Julio,Portugal,115,361,,476,POINT (4697157 -74140516)
2013,Julio,Portugal,12,40,,52,POINT (6170465 -7542726)
2013,Julio,Portugal,0,1,,1,POINT (6185536 -67484028)
2013,Julio,Portugal,0,1,,1,POINT (7088729 -70740253)
2013,Julio,Portugal,4,2,,6,POINT (7819 -72453013)
2013,Julio,Portugal,0,2,,2,POINT (7927233 -72508188)
2013,Julio,Portugal,0,1,,1,POINT (863337 -7735002)
2013,Julio,Puerto Rico/Territorio de Estados Unidos,1,1,,2,POINT (3451668 -76532004)
2013,Julio,Puerto Rico/Territorio de Estados Unidos,0,2,,2,POINT (4697157 -74140516)
2013,Julio,Qatar,0,2,,2,POINT (3451668 -76532004)
2013,Julio,Qatar,0,14,,14,POINT (4697157 -74140516)
2013,Julio,Reino Unido de Gran Bretaña e Irlanda del Norte,3,5,,8,POINT (-4191162 -69941498)
2013,Julio,Reino Unido de Gran Bretaña e Irlanda del Norte,18,31,,49,POINT (0.81488 -77356)
2013,Julio,Reino Unido de Gran Bretaña e Irlanda del Norte,7,3,,10,POINT (10406342 -75527794)
2013,Julio,Reino Unido de Gran Bretaña e Irlanda del Norte,26,52,,78,POINT (10446304 -75516486)
2013,Julio,Reino Unido de Gran Bretaña e Irlanda del Norte,0,2,,2,POINT (10886686 -74776479)
2013,Julio,Reino Unido de Gran Bretaña e Irlanda del Norte,7,12,,19,POINT (11360029 -72129595)
2013,Julio,Reino Unido de Gran Bretaña e Irlanda del Norte,37,72,,109,POINT (3451668 -76532004)
2013,Julio,Reino Unido de Gran Bretaña e Irlanda del Norte,0,1,,1,POINT (445285 -75766353)
2013,Julio,Reino Unido de Gran Bretaña e Irlanda del Norte,340,722,,1062,POINT (4697157 -74140516)
2013,Julio,Reino Unido de Gran Bretaña e Irlanda del Norte,0,1,,1,POINT (4815189 -75736374)
2013,Julio,Reino Unido de Gran Bretaña e Irlanda del Norte,26,73,,99,POINT (6170465 -7542726)
2013,Julio,Reino Unido de Gran Bretaña e Irlanda del Norte,0,2,,2,POINT (7819 -72453013)
2013,Julio,República de Belarús,2,2,,4,POINT (10886686 -74776479)
2013,Julio,República de Belarús,9,1,,10,POINT (4697157 -74140516)
2013,Julio,República de Belarús,0,1,,1,POINT (6170465 -7542726)
2013,Julio,República Dominicana,2,8,,10,POINT (0.81488 -77356)
2013,Julio,República Dominicana,2,0,,2,POINT (10406342 -75527794)
2013,Julio,República Dominicana,29,41,,70,POINT (10446304 -75516486)
2013,Julio,República Dominicana,13,52,,65,POINT (10886686 -74776479)
2013,Julio,República Dominicana,1,1,,2,POINT (11360029 -72129595)
2013,Julio,República Dominicana,23,23,,46,POINT (3451668 -76532004)
2013,Julio,República Dominicana,212,414,,626,POINT (4697157 -74140516)
2013,Julio,República Dominicana,1,5,,6,POINT (4815189 -75736374)
2013,Julio,República Dominicana,58,73,,131,POINT (6170465 -7542726)
2013,Julio,República Dominicana,1,1,,2,POINT (7128047 -73181317)
2013,Julio,República Dominicana,1,0,,1,POINT (7927233 -72508188)
2013,Julio,República Dominicana,0,2,,2,POINT (863337 -7735002)
2013,Julio,República Checa,0,3,,3,POINT (3451668 -76532004)
2013,Julio,República Checa,2,4,,6,POINT (4697157 -74140516)
2013,Julio,República Checa,1,0,,1,POINT (6170465 -7542726)
2013,Julio,República Democrática Popular de Corea,0,8,,8,POINT (4697157 -74140516)
2013,Julio,Rumania,4,3,,7,POINT (0.81488 -77356)
2013,Julio,Rumania,0,3,,3,POINT (10406342 -75527794)
2013,Julio,Rumania,0,2,,2,POINT (10886686 -74776479)
2013,Julio,Rumania,0,1,,1,POINT (11247723 -74213989)
2013,Julio,Rumania,2,2,,4,POINT (11360029 -72129595)
2013,Julio,Rumania,0,1,,1,POINT (125862 -81702165)
2013,Julio,Rumania,14,6,,20,POINT (3451668 -76532004)
2013,Julio,Rumania,32,46,,78,POINT (4697157 -74140516)
2013,Julio,Rumania,3,2,,5,POINT (6170465 -7542726)
2013,Julio,Rumania,0,1,,1,POINT (7819 -72453013)
2013,Julio,Federación de Rusia,1,1,,2,POINT (0.81488 -77356)
2013,Julio,Federación de Rusia,0,3,,3,POINT (10406342 -75527794)
2013,Julio,Federación de Rusia,2,2,,4,POINT (10446304 -75516486)
2013,Julio,Federación de Rusia,0,2,,2,POINT (10886686 -74776479)
2013,Julio,Federación de Rusia,2,2,,4,POINT (11360029 -72129595)
2013,Julio,Federación de Rusia,7,13,,20,POINT (3451668 -76532004)
2013,Julio,Federación de Rusia,36,30,,66,POINT (4697157 -74140516)
2013,Julio,Federación de Rusia,5,1,,6,POINT (6170465 -7542726)
2013,Julio,San Cristóbal y Nevis,0,3,,3,POINT (3451668 -76532004)
2013,Julio,San Cristóbal y Nevis,1,1,,2,POINT (6170465 -7542726)
2013,Julio,San  Vicente y las Granadinas,0,1,,1,POINT (0.81488 -77356)
2013,Julio,San  Vicente y las Granadinas,0,1,,1,POINT (10446304 -75516486)
2013,Julio,San  Vicente y las Granadinas,0,2,,2,POINT (4697157 -74140516)
2013,Julio,San  Vicente y las Granadinas,0,1,,1,POINT (6170465 -7542726)
2013,Julio,Santa Lucia,0,1,,1,POINT (10446304 -75516486)
2013,Julio,Santa Lucia,0,4,,4,POINT (3451668 -76532004)
2013,Julio,Santa Lucia,3,6,,9,POINT (4697157 -74140516)
2013,Julio,Santa Sede/Ciudad del Vaticano,0,1,,1,POINT (3451668 -76532004)
2013,Julio,Santa Sede/Ciudad del Vaticano,0,2,,2,POINT (4697157 -74140516)
2013,Julio,Santo Tomé y Príncipe,0,1,,1,POINT (4697157 -74140516)
2013,Julio,Senegal,1,1,,2,POINT (10446304 -75516486)
2013,Julio,Senegal,1,4,,5,POINT (4697157 -74140516)
2013,Julio,Serbia,1,0,,1,POINT (0.81488 -77356)
2013,Julio,Serbia,1,0,,1,POINT (10446304 -75516486)
2013,Julio,Serbia,1,2,,3,POINT (3451668 -76532004)
2013,Julio,Serbia,7,18,,25,POINT (4697157 -74140516)
2013,Julio,Serbia,1,0,,1,POINT (6170465 -7542726)
2013,Julio,Singapur,0,1,,1,POINT (10446304 -75516486)
2013,Julio,Singapur,24,38,,62,POINT (4697157 -74140516)
2013,Julio,Singapur,0,3,,3,POINT (6170465 -7542726)
2013,Julio,Singapur,0,1,,1,POINT (7819 -72453013)
2013,Julio,Singapur,0,1,,1,POINT (863337 -7735002)
2013,Julio,República Árabe Siria,0,4,,4,POINT (4697157 -74140516)
2013,Julio,Sri Lanka,2,3,,5,POINT (3451668 -76532004)
2013,Julio,Sri Lanka,1,7,,8,POINT (4697157 -74140516)
2013,Julio,Sudáfrica,0,1,,1,POINT (-4191162 -69941498)
2013,Julio,Sudáfrica,1,4,,5,POINT (0.81488 -77356)
2013,Julio,Sudáfrica,4,0,,4,POINT (10406342 -75527794)
2013,Julio,Sudáfrica,1,2,,3,POINT (10446304 -75516486)
2013,Julio,Sudáfrica,26,43,,69,POINT (3451668 -76532004)
2013,Julio,Sudáfrica,25,81,,106,POINT (4697157 -74140516)
2013,Julio,Sudáfrica,2,4,,6,POINT (6170465 -7542726)
2013,Julio,Sudáfrica,0,1,,1,POINT (7819 -72453013)
2013,Julio,Suecia,2,2,,4,POINT (-4191162 -69941498)
2013,Julio,Suecia,3,4,,7,POINT (0.81488 -77356)
2013,Julio,Suecia,5,3,,8,POINT (10406342 -75527794)
2013,Julio,Suecia,4,8,,12,POINT (10446304 -75516486)
2013,Julio,Suecia,0,3,,3,POINT (10886686 -74776479)
2013,Julio,Suecia,1,1,,2,POINT (11360029 -72129595)
2013,Julio,Suecia,19,33,,52,POINT (3451668 -76532004)
2013,Julio,Suecia,126,251,,377,POINT (4697157 -74140516)
2013,Julio,Suecia,1,1,,2,POINT (4815189 -75736374)
2013,Julio,Suecia,6,16,,22,POINT (6170465 -7542726)
2013,Julio,Suecia,0,1,,1,POINT (7128047 -73181317)
2013,Julio,Suiza,2,6,,8,POINT (-4191162 -69941498)
2013,Julio,Suiza,1,0,,1,POINT (0.33002 -76876446)
2013,Julio,Suiza,31,34,,65,POINT (0.81488 -77356)
2013,Julio,Suiza,13,15,,28,POINT (10406342 -75527794)
2013,Julio,Suiza,23,20,,43,POINT (10446304 -75516486)
2013,Julio,Suiza,3,5,,8,POINT (10886686 -74776479)
2013,Julio,Suiza,1,3,,4,POINT (11360029 -72129595)
2013,Julio,Suiza,75,138,,213,POINT (3451668 -76532004)
2013,Julio,Suiza,541,805,,1346,POINT (4697157 -74140516)
2013,Julio,Suiza,43,63,,106,POINT (6170465 -7542726)
2013,Julio,Suiza,1,0,,1,POINT (7088729 -70740253)
2013,Julio,Suiza,0,1,,1,POINT (7128047 -73181317)
2013,Julio,Suiza,3,4,,7,POINT (7819 -72453013)
2013,Julio,Suiza,0,1,,1,POINT (7927233 -72508188)
2013,Julio,Suiza,0,2,,2,POINT (863337 -7735002)
2013,Julio,Surinam,0,1,,1,POINT (3451668 -76532004)
2013,Julio,Surinam,5,30,,35,POINT (4697157 -74140516)
2013,Julio,Surinam,3,2,,5,POINT (6170465 -7542726)
2013,Julio,Taiwán,0,3,,3,POINT (10446304 -75516486)
2013,Julio,Taiwán,1,3,,4,POINT (3451668 -76532004)
2013,Julio,Taiwán,3,2,,5,POINT (4697157 -74140516)
2013,Julio,Taiwán,1,1,,2,POINT (4815189 -75736374)
2013,Julio,República de Tayikistán,0,1,,1,POINT (4697157 -74140516)
2013,Julio,Tailandia,1,0,,1,POINT (10406342 -75527794)
2013,Julio,Tailandia,4,7,,11,POINT (3451668 -76532004)
2013,Julio,Tailandia,13,23,,36,POINT (4697157 -74140516)
2013,Julio,Tíbet/Región Autónoma de China,2,1,,3,POINT (4697157 -74140516)
2013,Julio,Territorio Antártico Británico/Territorio Británico de Ultramar,3,2,,5,POINT (4697157 -74140516)
2013,Julio,Territorio Antártico Británico/Territorio Británico de Ultramar,0,1,,1,POINT (6170465 -7542726)
2013,Julio,Territorio Antártico Británico/Territorio Británico de Ultramar,1,2,,3,POINT (7819 -72453013)
2013,Julio,Tanzania,0,1,,1,POINT (4697157 -74140516)
2013,Julio,Tanzania,0,1,,1,POINT (7819 -72453013)
2013,Julio,República Democrática de Timor Oriental,0,1,,1,POINT (4697157 -74140516)
2013,Julio,Trinidad y Tobago,46,28,,74,POINT (10446304 -75516486)
2013,Julio,Trinidad y Tobago,7,10,,17,POINT (10886686 -74776479)
2013,Julio,Trinidad y Tobago,5,5,,10,POINT (11360029 -72129595)
2013,Julio,Trinidad y Tobago,9,34,,43,POINT (3451668 -76532004)
2013,Julio,Trinidad y Tobago,26,49,,75,POINT (4697157 -74140516)
2013,Julio,Trinidad y Tobago,0,1,,1,POINT (4815189 -75736374)
2013,Julio,Trinidad y Tobago,6,9,,15,POINT (6170465 -7542726)
2013,Julio,Trinidad y Tobago,3,2,,5,POINT (7128047 -73181317)
2013,Julio,Túnez,7,12,,19,POINT (4697157 -74140516)
2013,Julio,Túnez,0,1,,1,POINT (6170465 -7542726)
2013,Julio,Turkmenistán,0,6,,6,POINT (4697157 -74140516)
2013,Julio,Turquía,0,1,,1,POINT (-4191162 -69941498)
2013,Julio,Turquía,0,1,,1,POINT (0.81488 -77356)
2013,Julio,Turquía,0,1,,1,POINT (10406342 -75527794)
2013,Julio,Turquía,0,3,,3,POINT (10446304 -75516486)
2013,Julio,Turquía,0,1,,1,POINT (10970933 -74765343)
2013,Julio,Turquía,1,0,,1,POINT (11360029 -72129595)
2013,Julio,Turquía,5,20,,25,POINT (3451668 -76532004)
2013,Julio,Turquía,31,88,,119,POINT (4697157 -74140516)
2013,Julio,Turquía,1,11,,12,POINT (6170465 -7542726)
2013,Julio,Turquía,0,1,,1,POINT (7819 -72453013)
2013,Julio,Turkmenistán,0,7,,7,POINT (4697157 -74140516)
2013,Julio,Ucrania,0,2,,2,POINT (10406342 -75527794)
2013,Julio,Ucrania,3,8,,11,POINT (10446304 -75516486)
2013,Julio,Ucrania,0,1,,1,POINT (10886686 -74776479)
2013,Julio,Ucrania,0,1,,1,POINT (10970933 -74765343)
2013,Julio,Ucrania,0,7,,7,POINT (11247723 -74213989)
2013,Julio,Ucrania,11,18,,29,POINT (3451668 -76532004)
2013,Julio,Ucrania,0,1,,1,POINT (3884426 -77061029)
2013,Julio,Ucrania,73,92,,165,POINT (4697157 -74140516)
2013,Julio,Ucrania,1,1,,2,POINT (6170465 -7542726)
2013,Julio,Uganda,2,3,,5,POINT (3451668 -76532004)
2013,Julio,Uganda,2,7,,9,POINT (4697157 -74140516)
2013,Julio,Federación de Rusia,1,2,,3,POINT (-4191162 -69941498)
2013,Julio,Federación de Rusia,2,4,,6,POINT (0.81488 -77356)
2013,Julio,Federación de Rusia,1,5,,6,POINT (10406342 -75527794)
2013,Julio,Federación de Rusia,0,1,,1,POINT (10446304 -75516486)
2013,Julio,Federación de Rusia,0,1,,1,POINT (10886686 -74776479)
2013,Julio,Federación de Rusia,0,1,,1,POINT (10970933 -74765343)
2013,Julio,Federación de Rusia,0,14,,14,POINT (11247723 -74213989)
2013,Julio,Federación de Rusia,5,13,,18,POINT (3451668 -76532004)
2013,Julio,Federación de Rusia,153,273,,426,POINT (4697157 -74140516)
2013,Julio,Federación de Rusia,4,3,,7,POINT (6170465 -7542726)
2013,Julio,Federación de Rusia,1,1,,2,POINT (7819 -72453013)
2013,Julio,Uruguay,4,4,,8,POINT (0.81488 -77356)
2013,Julio,Uruguay,2,1,,3,POINT (10406342 -75527794)
2013,Julio,Uruguay,72,43,,115,POINT (10446304 -75516486)
2013,Julio,Uruguay,2,9,,11,POINT (10886686 -74776479)
2013,Julio,Uruguay,2,2,,4,POINT (11360029 -72129595)
2013,Julio,Uruguay,25,22,,47,POINT (125862 -81702165)
2013,Julio,Uruguay,15,36,,51,POINT (3451668 -76532004)
2013,Julio,Uruguay,163,358,,521,POINT (4697157 -74140516)
2013,Julio,Uruguay,0,3,,3,POINT (4815189 -75736374)
2013,Julio,Uruguay,26,60,,86,POINT (6170465 -7542726)
2013,Julio,Uruguay,5,8,,13,POINT (7819 -72453013)
2013,Julio,Venezuela,0,1,,1,POINT (0.33002 -76876446)
2013,Julio,Venezuela,69,115,,184,POINT (0.81488 -77356)
2013,Julio,Venezuela,6,9,,15,POINT (10406342 -75527794)
2013,Julio,Venezuela,88,168,,256,POINT (10446304 -75516486)
2013,Julio,Venezuela,45,128,,173,POINT (10886686 -74776479)
2013,Julio,Venezuela,0,2,,2,POINT (11247723 -74213989)
2013,Julio,Venezuela,1367,1949,,3316,POINT (11360029 -72129595)
2013,Julio,Venezuela,1,0,,1,POINT (1152863 -72919186)
2013,Julio,Venezuela,7,6,,13,POINT (125862 -81702165)
2013,Julio,Venezuela,88,177,,265,POINT (3451668 -76532004)
2013,Julio,Venezuela,5972,6774,,12746,POINT (4697157 -74140516)
2013,Julio,Venezuela,4,11,,15,POINT (4815189 -75736374)
2013,Julio,Venezuela,476,614,,1090,POINT (6170465 -7542726)
2013,Julio,Venezuela,151,259,,410,POINT (6185536 -67484028)
2013,Julio,Venezuela,31,53,,84,POINT (7088729 -70740253)
2013,Julio,Venezuela,7,9,,16,POINT (7128047 -73181317)
2013,Julio,Venezuela,1625,1944,,3569,POINT (7819 -72453013)
2013,Julio,Venezuela,195,278,,473,POINT (7927233 -72508188)
2013,Julio,Venezuela,0,2,,2,POINT (863337 -7735002)
2013,Julio,Vietnam,10,24,,34,POINT (4697157 -74140516)
2013,Julio,Zambia,0,1,,1,POINT (4697157 -74140516)
2013,Julio,Zimbabue,1,1,,2,POINT (4697157 -74140516)
2013,Julio,Reino Unido de Gran Bretaña e Irlanda del Norte,12,12,,24,POINT (-4191162 -69941498)
2013,Julio,Reino Unido de Gran Bretaña e Irlanda del Norte,54,68,,122,POINT (0.81488 -77356)
2013,Julio,Reino Unido de Gran Bretaña e Irlanda del Norte,11,24,,35,POINT (10406342 -75527794)
2013,Julio,Reino Unido de Gran Bretaña e Irlanda del Norte,3,8,,11,POINT (10446304 -75516486)
2013,Julio,Reino Unido de Gran Bretaña e Irlanda del Norte,0,1,,1,POINT (10886686 -74776479)
2013,Julio,Reino Unido de Gran Bretaña e Irlanda del Norte,0,2,,2,POINT (10970933 -74765343)
2013,Julio,Reino Unido de Gran Bretaña e Irlanda del Norte,2,1,,3,POINT (125862 -81702165)
2013,Julio,Reino Unido de Gran Bretaña e Irlanda del Norte,34,74,,108,POINT (3451668 -76532004)
2013,Julio,Reino Unido de Gran Bretaña e Irlanda del Norte,394,651,,1045,POINT (4697157 -74140516)
2013,Julio,Reino Unido de Gran Bretaña e Irlanda del Norte,18,33,,51,POINT (6170465 -7542726)
2013,Julio,Reino Unido de Gran Bretaña e Irlanda del Norte,1,0,,1,POINT (7088729 -70740253)
2013,Julio,Reino Unido de Gran Bretaña e Irlanda del Norte,0,1,,1,POINT (7128047 -73181317)
2013,Julio,Reino Unido de Gran Bretaña e Irlanda del Norte,4,14,,18,POINT (7819 -72453013)
2013,Julio,Reino Unido de Gran Bretaña e Irlanda del Norte,2,9,,11,POINT (863337 -7735002)
2013,Julio,Países Bajos,5,4,,9,POINT (-4191162 -69941498)
2013,Julio,Países Bajos,16,32,,48,POINT (0.81488 -77356)
2013,Julio,Países Bajos,14,6,,20,POINT (10406342 -75527794)
2013,Julio,Países Bajos,7,8,,15,POINT (10446304 -75516486)
2013,Julio,Países Bajos,12,33,,45,POINT (10886686 -74776479)
2013,Julio,Países Bajos,0,4,,4,POINT (11247723 -74213989)
2013,Julio,Países Bajos,0,1,,1,POINT (11360029 -72129595)
2013,Julio,Países Bajos,2,0,,2,POINT (125862 -81702165)
2013,Julio,Países Bajos,59,101,,160,POINT (3451668 -76532004)
2013,Julio,Países Bajos,744,1068,,1812,POINT (4697157 -74140516)
2013,Julio,Países Bajos,127,135,,262,POINT (6170465 -7542726)
2013,Julio,Países Bajos,2,9,,11,POINT (7128047 -73181317)
2013,Julio,Países Bajos,18,9,,27,POINT (7819 -72453013)
2013,Julio,Países Bajos,1,3,,4,POINT (7927233 -72508188)
2013,Julio,Países Bajos,1,0,,1,POINT (863337 -7735002)
2013,Julio,Desconocido,0,1,,1,POINT (4697157 -74140516)
2013,Julio,Lituania,0,1,,1,POINT (10446304 -75516486)
2013,Julio,Lituania,1,2,,3,POINT (3451668 -76532004)
2013,Julio,Lituania,1,2,,3,POINT (4697157 -74140516)
2013,Julio,Lituania,1,0,,1,POINT (7819 -72453013)
2013,Julio,Reino Unido de Gran Bretaña e Irlanda del Norte,0,2,,2,POINT (4697157 -74140516)
2013,Julio,Reino Unido de Gran Bretaña e Irlanda del Norte,2,5,,7,POINT (10406342 -75527794)
2013,Julio,Reino Unido de Gran Bretaña e Irlanda del Norte,1,1,,2,POINT (3451668 -76532004)
2013,Julio,Reino Unido de Gran Bretaña e Irlanda del Norte,2,9,,11,POINT (4697157 -74140516)
2013,Julio,Reino Unido de Gran Bretaña e Irlanda del Norte,0,1,,1,POINT (6170465 -7542726)
2013,Julio,Reino Unido de Gran Bretaña e Irlanda del Norte,0,3,,3,POINT (7819 -72453013)
2013,Julio,Letonia,0,7,,7,POINT (10406342 -75527794)
2013,Julio,Letonia,0,1,,1,POINT (3451668 -76532004)
2013,Julio,Marruecos,1,0,,1,POINT (4697157 -74140516)
2013,Julio,República CentroÁfricana,0,1,,1,POINT (10446304 -75516486)
2013,Julio,República CentroÁfricana,0,1,,1,POINT (4697157 -74140516)
2013,Agosto,Desconocido,0,1,,1,POINT (4697157 -74140516)
2013,Agosto,Albania,3,5,,8,POINT (4697157 -74140516)
2013,Agosto,Alemania,13,22,,35,POINT (-4191162 -69941498)
2013,Agosto,Alemania,45,57,,102,POINT (0.81488 -77356)
2013,Agosto,Alemania,1,0,,1,POINT (1800143 -78802679)
2013,Agosto,Alemania,20,33,,53,POINT (10406342 -75527794)
2013,Agosto,Alemania,35,55,,90,POINT (10446304 -75516486)
2013,Agosto,Alemania,9,17,,26,POINT (10886686 -74776479)
2013,Agosto,Alemania,8,13,,21,POINT (11360029 -72129595)
2013,Agosto,Alemania,0,2,,2,POINT (125862 -81702165)
2013,Agosto,Alemania,49,62,,111,POINT (3451668 -76532004)
2013,Agosto,Alemania,1621,2174,,3795,POINT (4697157 -74140516)
2013,Agosto,Alemania,3,2,,5,POINT (4815189 -75736374)
2013,Agosto,Alemania,61,115,,176,POINT (6170465 -7542726)
2013,Agosto,Alemania,2,2,,4,POINT (7128047 -73181317)
2013,Agosto,Alemania,5,16,,21,POINT (7819 -72453013)
2013,Agosto,Alemania,1,0,,1,POINT (7927233 -72508188)
2013,Agosto,Alemania,6,2,,8,POINT (863337 -7735002)
2013,Agosto,Andorra,0,4,,4,POINT (10446304 -75516486)
2013,Agosto,Andorra,0,1,,1,POINT (11360029 -72129595)
2013,Agosto,Andorra,3,10,,13,POINT (4697157 -74140516)
2013,Agosto,Angola,1,1,,2,POINT (4697157 -74140516)
2013,Agosto,Antigua y Barbuda,0,1,,1,POINT (10446304 -75516486)
2013,Agosto,Antigua y Barbuda,1,2,,3,POINT (4697157 -74140516)
2013,Agosto,Antigua y Barbuda,0,1,,1,POINT (6170465 -7542726)
2013,Agosto,Países Bajos,0,1,,1,POINT (6170465 -7542726)
2013,Agosto,Arabia Saudita,0,1,,1,POINT (4697157 -74140516)
2013,Agosto,Arabia Saudita,0,2,,2,POINT (6170465 -7542726)
2013,Agosto,Arabia Saudita,0,2,,2,POINT (4697157 -74140516)
2013,Agosto,Argelia,1,2,,3,POINT (4697157 -74140516)
2013,Agosto,Argentina,0,2,,2,POINT (-4191162 -69941498)
2013,Agosto,Argentina,2,3,,5,POINT (0.33002 -76876446)
2013,Agosto,Argentina,33,76,,109,POINT (0.81488 -77356)
2013,Agosto,Argentina,0,2,,2,POINT (1800143 -78802679)
2013,Agosto,Argentina,153,119,,272,POINT (10406342 -75527794)
2013,Agosto,Argentina,783,605,,1388,POINT (10446304 -75516486)
2013,Agosto,Argentina,19,39,,58,POINT (10886686 -74776479)
2013,Agosto,Argentina,12,25,,37,POINT (11360029 -72129595)
2013,Agosto,Argentina,201,186,,387,POINT (125862 -81702165)
2013,Agosto,Argentina,43,100,,143,POINT (3451668 -76532004)
2013,Agosto,Argentina,2966,4493,,7459,POINT (4697157 -74140516)
2013,Agosto,Argentina,14,22,,36,POINT (4815189 -75736374)
2013,Agosto,Argentina,139,256,,395,POINT (6170465 -7542726)
2013,Agosto,Argentina,2,5,,7,POINT (7128047 -73181317)
2013,Agosto,Argentina,24,35,,59,POINT (7819 -72453013)
2013,Agosto,Argentina,1,6,,7,POINT (7927233 -72508188)
2013,Agosto,Argentina,0,3,,3,POINT (806667 -767333)
2013,Agosto,Argentina,8,7,,15,POINT (863337 -7735002)
2013,Agosto,República de Armenia,1,2,,3,POINT (4697157 -74140516)
2013,Agosto,Aruba,1,1,,2,POINT (10886686 -74776479)
2013,Agosto,Aruba,3,3,,6,POINT (4697157 -74140516)
2013,Agosto,Australia,8,7,,15,POINT (-4191162 -69941498)
2013,Agosto,Australia,26,27,,53,POINT (0.81488 -77356)
2013,Agosto,Australia,32,29,,61,POINT (10406342 -75527794)
2013,Agosto,Australia,23,26,,49,POINT (10446304 -75516486)
2013,Agosto,Australia,3,11,,14,POINT (10886686 -74776479)
2013,Agosto,Australia,0,1,,1,POINT (11247723 -74213989)
2013,Agosto,Australia,0,7,,7,POINT (11360029 -72129595)
2013,Agosto,Australia,6,19,,25,POINT (3451668 -76532004)
2013,Agosto,Australia,204,334,,538,POINT (4697157 -74140516)
2013,Agosto,Australia,0,2,,2,POINT (4815189 -75736374)
2013,Agosto,Australia,22,61,,83,POINT (6170465 -7542726)
2013,Agosto,Australia,2,1,,3,POINT (7128047 -73181317)
2013,Agosto,Australia,3,1,,4,POINT (7819 -72453013)
2013,Agosto,Australia,0,1,,1,POINT (7927233 -72508188)
2013,Agosto,Australia,2,6,,8,POINT (863337 -7735002)
2013,Agosto,Austria,2,2,,4,POINT (-4191162 -69941498)
2013,Agosto,Austria,7,10,,17,POINT (0.81488 -77356)
2013,Agosto,Austria,5,8,,13,POINT (10406342 -75527794)
2013,Agosto,Austria,8,6,,14,POINT (10446304 -75516486)
2013,Agosto,Austria,1,0,,1,POINT (10886686 -74776479)
2013,Agosto,Austria,3,0,,3,POINT (11360029 -72129595)
2013,Agosto,Austria,11,10,,21,POINT (3451668 -76532004)
2013,Agosto,Austria,134,215,,349,POINT (4697157 -74140516)
2013,Agosto,Austria,6,12,,18,POINT (6170465 -7542726)
2013,Agosto,Austria,1,1,,2,POINT (7819 -72453013)
2013,Agosto,Austria,1,1,,2,POINT (863337 -7735002)
2013,Agosto,Azerbaiyán,0,2,,2,POINT (4697157 -74140516)
2013,Agosto,Bahamas,0,2,,2,POINT (10446304 -75516486)
2013,Agosto,Bahamas,0,3,,3,POINT (10886686 -74776479)
2013,Agosto,Bahamas,1,2,,3,POINT (3451668 -76532004)
2013,Agosto,Bahamas,3,1,,4,POINT (4697157 -74140516)
2013,Agosto,Bahamas,4,8,,12,POINT (6170465 -7542726)
2013,Agosto,Bangladesh,1,0,,1,POINT (-4191162 -69941498)
2013,Agosto,Bangladesh,0,1,,1,POINT (4697157 -74140516)
2013,Agosto,Bangladesh,0,1,,1,POINT (6170465 -7542726)
2013,Agosto,Barbados,1,2,,3,POINT (4697157 -74140516)
2013,Agosto,Barbados,7,12,,19,POINT (6170465 -7542726)
2013,Agosto,República de Belarús,1,0,,1,POINT (11360029 -72129595)
2013,Agosto,República de Belarús,1,0,,1,POINT (4697157 -74140516)
2013,Agosto,Bélgica,5,1,,6,POINT (-4191162 -69941498)
2013,Agosto,Bélgica,10,11,,21,POINT (0.81488 -77356)
2013,Agosto,Bélgica,3,3,,6,POINT (10406342 -75527794)
2013,Agosto,Bélgica,3,6,,9,POINT (10446304 -75516486)
2013,Agosto,Bélgica,2,5,,7,POINT (10886686 -74776479)
2013,Agosto,Bélgica,2,3,,5,POINT (11360029 -72129595)
2013,Agosto,Bélgica,9,30,,39,POINT (3451668 -76532004)
2013,Agosto,Bélgica,126,266,,392,POINT (4697157 -74140516)
2013,Agosto,Bélgica,14,27,,41,POINT (6170465 -7542726)
2013,Agosto,Bélgica,0,1,,1,POINT (7128047 -73181317)
2013,Agosto,Bélgica,0,1,,1,POINT (7819 -72453013)
2013,Agosto,Bélgica,0,1,,1,POINT (863337 -7735002)
2013,Agosto,Belice,0,1,,1,POINT (10446304 -75516486)
2013,Agosto,Belice,0,1,,1,POINT (125862 -81702165)
2013,Agosto,Belice,7,15,,22,POINT (4697157 -74140516)
2013,Agosto,Belice,2,1,,3,POINT (6170465 -7542726)
2013,Agosto,Belice,2,0,,2,POINT (7819 -72453013)
2013,Agosto,Bermudas/Territorio Británico de Ultramar,0,3,,3,POINT (6170465 -7542726)
2013,Agosto,Bolivia,1,0,,1,POINT (-4191162 -69941498)
2013,Agosto,Bolivia,4,8,,12,POINT (0.81488 -77356)
2013,Agosto,Bolivia,1,1,,2,POINT (10406342 -75527794)
2013,Agosto,Bolivia,28,23,,51,POINT (10446304 -75516486)
2013,Agosto,Bolivia,3,5,,8,POINT (10886686 -74776479)
2013,Agosto,Bolivia,2,2,,4,POINT (11360029 -72129595)
2013,Agosto,Bolivia,5,3,,8,POINT (125862 -81702165)
2013,Agosto,Bolivia,21,22,,43,POINT (3451668 -76532004)
2013,Agosto,Bolivia,303,416,,719,POINT (4697157 -74140516)
2013,Agosto,Bolivia,0,1,,1,POINT (4815189 -75736374)
2013,Agosto,Bolivia,14,29,,43,POINT (6170465 -7542726)
2013,Agosto,Bolivia,1,5,,6,POINT (7819 -72453013)
2013,Agosto,Bosnia y Herzegovina,3,0,,3,POINT (4697157 -74140516)
2013,Agosto,Bosnia y Herzegovina,1,0,,1,POINT (6170465 -7542726)
2013,Agosto,Botsuana,1,0,,1,POINT (4697157 -74140516)
2013,Agosto,Brasil,64,75,,139,POINT (-4191162 -69941498)
2013,Agosto,Brasil,0,2,,2,POINT (0.33002 -76876446)
2013,Agosto,Brasil,7,25,,32,POINT (0.81488 -77356)
2013,Agosto,Brasil,0,1,,1,POINT (1800143 -78802679)
2013,Agosto,Brasil,66,51,,117,POINT (10406342 -75527794)
2013,Agosto,Brasil,206,190,,396,POINT (10446304 -75516486)
2013,Agosto,Brasil,9,20,,29,POINT (10886686 -74776479)
2013,Agosto,Brasil,2,9,,11,POINT (11360029 -72129595)
2013,Agosto,Brasil,33,20,,53,POINT (125862 -81702165)
2013,Agosto,Brasil,27,64,,91,POINT (3451668 -76532004)
2013,Agosto,Brasil,2636,4057,,6693,POINT (4697157 -74140516)
2013,Agosto,Brasil,0,1,,1,POINT (4815189 -75736374)
2013,Agosto,Brasil,81,170,,251,POINT (6170465 -7542726)
2013,Agosto,Brasil,1,2,,3,POINT (7128047 -73181317)
2013,Agosto,Brasil,4,26,,30,POINT (7819 -72453013)
2013,Agosto,Brasil,0,1,,1,POINT (7927233 -72508188)
2013,Agosto,Brasil,1,2,,3,POINT (863337 -7735002)
2013,Agosto,Bulgaria,0,1,,1,POINT (3451668 -76532004)
2013,Agosto,Bulgaria,0,1,,1,POINT (3884426 -77061029)
2013,Agosto,Bulgaria,7,14,,21,POINT (4697157 -74140516)
2013,Agosto,Bulgaria,1,0,,1,POINT (6170465 -7542726)
2013,Agosto,Bulgaria,1,0,,1,POINT (7819 -72453013)
2013,Agosto,Bulgaria,1,1,,2,POINT (7927233 -72508188)
2013,Agosto,Bulgaria,0,1,,1,POINT (9402597 -75681642)
2013,Agosto,Burkina Faso,0,1,,1,POINT (6170465 -7542726)
2013,Agosto,Burundi,1,4,,5,POINT (4697157 -74140516)
2013,Agosto,Bután,1,0,,1,POINT (6170465 -7542726)
2013,Agosto,Islas Caimán/Territorio Británico de Ultramar,0,1,,1,POINT (10446304 -75516486)
2013,Agosto,Islas Caimán/Territorio Británico de Ultramar,1,0,,1,POINT (10886686 -74776479)
2013,Agosto,Islas Caimán/Territorio Británico de Ultramar,1,1,,2,POINT (125862 -81702165)
2013,Agosto,Islas Caimán/Territorio Británico de Ultramar,2,0,,2,POINT (6170465 -7542726)
2013,Agosto,Camboya,3,4,,7,POINT (4697157 -74140516)
2013,Agosto,Canadá,5,4,,9,POINT (-4191162 -69941498)
2013,Agosto,Canadá,10,7,,17,POINT (0.81488 -77356)
2013,Agosto,Canadá,9,13,,22,POINT (10406342 -75527794)
2013,Agosto,Canadá,40,53,,93,POINT (10446304 -75516486)
2013,Agosto,Canadá,9,25,,34,POINT (10886686 -74776479)
2013,Agosto,Canadá,1,4,,5,POINT (11360029 -72129595)
2013,Agosto,Canadá,4,4,,8,POINT (125862 -81702165)
2013,Agosto,Canadá,42,62,,104,POINT (3451668 -76532004)
2013,Agosto,Canadá,3,2,,5,POINT (445285 -75766353)
2013,Agosto,Canadá,820,1357,,2177,POINT (4697157 -74140516)
2013,Agosto,Canadá,1,1,,2,POINT (4815189 -75736374)
2013,Agosto,Canadá,151,272,,423,POINT (6170465 -7542726)
2013,Agosto,Canadá,0,2,,2,POINT (7128047 -73181317)
2013,Agosto,Canadá,2,10,,12,POINT (7819 -72453013)
2013,Agosto,Canadá,0,1,,1,POINT (7927233 -72508188)
2013,Agosto,Canadá,1,0,,1,POINT (806667 -767333)
2013,Agosto,Canadá,2,1,,3,POINT (863337 -7735002)
2013,Agosto,España,0,1,,1,POINT (0.33002 -76876446)
2013,Agosto,España,2,7,,9,POINT (0.81488 -77356)
2013,Agosto,España,0,1,,1,POINT (10406342 -75527794)
2013,Agosto,España,3,9,,12,POINT (10886686 -74776479)
2013,Agosto,España,49,99,,148,POINT (3451668 -76532004)
2013,Agosto,España,148,280,,428,POINT (4697157 -74140516)
2013,Agosto,España,53,115,,168,POINT (6170465 -7542726)
2013,Agosto,España,1,0,,1,POINT (7128047 -73181317)
2013,Agosto,España,4,1,,5,POINT (7927233 -72508188)
2013,Agosto,República Democrática del Congo,1,0,,1,POINT (3451668 -76532004)
2013,Agosto,República Democrática del Congo,4,5,,9,POINT (4697157 -74140516)
2013,Agosto,República Democrática del Congo,0,1,,1,POINT (6170465 -7542726)
2013,Agosto,República de Corea,2,1,,3,POINT (-4191162 -69941498)
2013,Agosto,República de Corea,7,16,,23,POINT (0.81488 -77356)
2013,Agosto,República de Corea,0,1,,1,POINT (1800143 -78802679)
2013,Agosto,República de Corea,1,3,,4,POINT (10446304 -75516486)
2013,Agosto,República de Corea,1,0,,1,POINT (10886686 -74776479)
2013,Agosto,República de Corea,0,1,,1,POINT (11360029 -72129595)
2013,Agosto,República de Corea,0,8,,8,POINT (3451668 -76532004)
2013,Agosto,República de Corea,250,434,,684,POINT (4697157 -74140516)
2013,Agosto,República de Corea,8,17,,25,POINT (6170465 -7542726)
2013,Agosto,República de Corea,0,2,,2,POINT (7128047 -73181317)
2013,Agosto,República de Corea,2,7,,9,POINT (7819 -72453013)
2013,Agosto,República de Corea,0,1,,1,POINT (7927233 -72508188)
2013,Agosto,Costa de Marfil,0,1,,1,POINT (3451668 -76532004)
2013,Agosto,Costa Rica,1,2,,3,POINT (0.81488 -77356)
2013,Agosto,Costa Rica,1,0,,1,POINT (10406342 -75527794)
2013,Agosto,Costa Rica,62,52,,114,POINT (10446304 -75516486)
2013,Agosto,Costa Rica,9,11,,20,POINT (10886686 -74776479)
2013,Agosto,Costa Rica,1,2,,3,POINT (11360029 -72129595)
2013,Agosto,Costa Rica,205,144,,349,POINT (125862 -81702165)
2013,Agosto,Costa Rica,29,50,,79,POINT (3451668 -76532004)
2013,Agosto,Costa Rica,578,885,,1463,POINT (4697157 -74140516)
2013,Agosto,Costa Rica,6,17,,23,POINT (4815189 -75736374)
2013,Agosto,Costa Rica,113,234,,347,POINT (6170465 -7542726)
2013,Agosto,Costa Rica,1,0,,1,POINT (6185536 -67484028)
2013,Agosto,Costa Rica,0,1,,1,POINT (7128047 -73181317)
2013,Agosto,Costa Rica,1,0,,1,POINT (7819 -72453013)
2013,Agosto,Costa Rica,1,1,,2,POINT (7927233 -72508188)
2013,Agosto,Costa Rica,1,1,,2,POINT (863337 -7735002)
2013,Agosto,Croacia,0,1,,1,POINT (0.81488 -77356)
2013,Agosto,Croacia,0,1,,1,POINT (10406342 -75527794)
2013,Agosto,Croacia,1,0,,1,POINT (10446304 -75516486)
2013,Agosto,Croacia,1,1,,2,POINT (11360029 -72129595)
2013,Agosto,Croacia,0,7,,7,POINT (3451668 -76532004)
2013,Agosto,Croacia,8,15,,23,POINT (4697157 -74140516)
2013,Agosto,Cuba,0,3,,3,POINT (0.81488 -77356)
2013,Agosto,Cuba,8,12,,20,POINT (10446304 -75516486)
2013,Agosto,Cuba,7,10,,17,POINT (10886686 -74776479)
2013,Agosto,Cuba,0,1,,1,POINT (11360029 -72129595)
2013,Agosto,Cuba,4,1,,5,POINT (125862 -81702165)
2013,Agosto,Cuba,15,21,,36,POINT (3451668 -76532004)
2013,Agosto,Cuba,114,233,,347,POINT (4697157 -74140516)
2013,Agosto,Cuba,1,2,,3,POINT (4815189 -75736374)
2013,Agosto,Cuba,16,52,,68,POINT (6170465 -7542726)
2013,Agosto,Cuba,0,2,,2,POINT (7128047 -73181317)
2013,Agosto,Cuba,2,1,,3,POINT (7819 -72453013)
2013,Agosto,Cuba,0,1,,1,POINT (7927233 -72508188)
2013,Agosto,Curazao,7,3,,10,POINT (4697157 -74140516)
2013,Agosto,República Checa,3,0,,3,POINT (0.81488 -77356)
2013,Agosto,República Checa,0,1,,1,POINT (10406342 -75527794)
2013,Agosto,República Checa,0,1,,1,POINT (10886686 -74776479)
2013,Agosto,República Checa,1,1,,2,POINT (11360029 -72129595)
2013,Agosto,República Checa,2,1,,3,POINT (3451668 -76532004)
2013,Agosto,República Checa,21,37,,58,POINT (4697157 -74140516)
2013,Agosto,República Checa,2,2,,4,POINT (6170465 -7542726)
2013,Agosto,República Checa,0,1,,1,POINT (7819 -72453013)
2013,Agosto,Chile,1,2,,3,POINT (-4191162 -69941498)
2013,Agosto,Chile,25,71,,96,POINT (0.81488 -77356)
2013,Agosto,Chile,50,32,,82,POINT (10406342 -75527794)
2013,Agosto,Chile,93,88,,181,POINT (10446304 -75516486)
2013,Agosto,Chile,3,17,,20,POINT (10886686 -74776479)
2013,Agosto,Chile,0,1,,1,POINT (11247723 -74213989)
2013,Agosto,Chile,8,12,,20,POINT (11360029 -72129595)
2013,Agosto,Chile,32,31,,63,POINT (125862 -81702165)
2013,Agosto,Chile,51,60,,111,POINT (3451668 -76532004)
2013,Agosto,Chile,3055,4040,,7095,POINT (4697157 -74140516)
2013,Agosto,Chile,1,0,,1,POINT (4815189 -75736374)
2013,Agosto,Chile,70,191,,261,POINT (6170465 -7542726)
2013,Agosto,Chile,0,1,,1,POINT (7088729 -70740253)
2013,Agosto,Chile,0,1,,1,POINT (7128047 -73181317)
2013,Agosto,Chile,6,7,,13,POINT (7819 -72453013)
2013,Agosto,Chile,0,1,,1,POINT (7927233 -72508188)
2013,Agosto,Chile,0,2,,2,POINT (863337 -7735002)
2013,Agosto,China,0,1,,1,POINT (-4191162 -69941498)
2013,Agosto,China,1,1,,2,POINT (0.81488 -77356)
2013,Agosto,China,9,5,,14,POINT (10446304 -75516486)
2013,Agosto,China,5,1,,6,POINT (10886686 -74776479)
2013,Agosto,China,0,1,,1,POINT (11360029 -72129595)
2013,Agosto,China,6,7,,13,POINT (3451668 -76532004)
2013,Agosto,China,160,401,,561,POINT (4697157 -74140516)
2013,Agosto,China,7,10,,17,POINT (6170465 -7542726)
2013,Agosto,China,1,0,,1,POINT (7128047 -73181317)
2013,Agosto,Taiwán,4,0,,4,POINT (0.81488 -77356)
2013,Agosto,Taiwán,1,2,,3,POINT (10886686 -74776479)
2013,Agosto,Taiwán,0,1,,1,POINT (3451668 -76532004)
2013,Agosto,Taiwán,42,66,,108,POINT (4697157 -74140516)
2013,Agosto,Taiwán,9,11,,20,POINT (6170465 -7542726)
2013,Agosto,Taiwán,0,1,,1,POINT (7128047 -73181317)
2013,Agosto,Chipre,0,5,,5,POINT (4697157 -74140516)
2013,Agosto,Dinamarca,1,2,,3,POINT (-4191162 -69941498)
2013,Agosto,Dinamarca,3,3,,6,POINT (0.81488 -77356)
2013,Agosto,Dinamarca,1,1,,2,POINT (10406342 -75527794)
2013,Agosto,Dinamarca,2,3,,5,POINT (10446304 -75516486)
2013,Agosto,Dinamarca,1,2,,3,POINT (10886686 -74776479)
2013,Agosto,Dinamarca,0,1,,1,POINT (10970933 -74765343)
2013,Agosto,Dinamarca,0,1,,1,POINT (11247723 -74213989)
2013,Agosto,Dinamarca,0,1,,1,POINT (11360029 -72129595)
2013,Agosto,Dinamarca,4,6,,10,POINT (3451668 -76532004)
2013,Agosto,Dinamarca,40,89,,129,POINT (4697157 -74140516)
2013,Agosto,Dinamarca,9,13,,22,POINT (6170465 -7542726)
2013,Agosto,Dinamarca,1,0,,1,POINT (7088729 -70740253)
2013,Agosto,Dinamarca,0,3,,3,POINT (863337 -7735002)
2013,Agosto,Dominica,0,2,,2,POINT (4697157 -74140516)
2013,Agosto,Dominica,1,1,,2,POINT (6170465 -7542726)
2013,Agosto,Ecuador,24,44,,68,POINT (0.33002 -76876446)
2013,Agosto,Ecuador,1142,1564,,2706,POINT (0.81488 -77356)
2013,Agosto,Ecuador,1,143,,144,POINT (1800143 -78802679)
2013,Agosto,Ecuador,48,53,,101,POINT (10406342 -75527794)
2013,Agosto,Ecuador,22,38,,60,POINT (10446304 -75516486)
2013,Agosto,Ecuador,5,4,,9,POINT (10886686 -74776479)
2013,Agosto,Ecuador,14,21,,35,POINT (11360029 -72129595)
2013,Agosto,Ecuador,0,1,,1,POINT (125744111 -81703935)
2013,Agosto,Ecuador,4,0,,4,POINT (125862 -81702165)
2013,Agosto,Ecuador,596,582,,1178,POINT (3451668 -76532004)
2013,Agosto,Ecuador,2088,2894,,4982,POINT (4697157 -74140516)
2013,Agosto,Ecuador,2,1,,3,POINT (4815189 -75736374)
2013,Agosto,Ecuador,675,807,,1482,POINT (6170465 -7542726)
2013,Agosto,Ecuador,0,1,,1,POINT (7128047 -73181317)
2013,Agosto,Ecuador,95,154,,249,POINT (7819 -72453013)
2013,Agosto,Ecuador,2,2,,4,POINT (7927233 -72508188)
2013,Agosto,Ecuador,0,3,,3,POINT (863337 -7735002)
2013,Agosto,Egipto,1,1,,2,POINT (0.81488 -77356)
2013,Agosto,Egipto,5,13,,18,POINT (4697157 -74140516)
2013,Agosto,Egipto,0,1,,1,POINT (6170465 -7542726)
2013,Agosto,El Salvador,1,0,,1,POINT (-4191162 -69941498)
2013,Agosto,El Salvador,1,2,,3,POINT (0.81488 -77356)
2013,Agosto,El Salvador,48,19,,67,POINT (10446304 -75516486)
2013,Agosto,El Salvador,2,0,,2,POINT (10886686 -74776479)
2013,Agosto,El Salvador,50,34,,84,POINT (125862 -81702165)
2013,Agosto,El Salvador,57,78,,135,POINT (3451668 -76532004)
2013,Agosto,El Salvador,0,1,,1,POINT (445285 -75766353)
2013,Agosto,El Salvador,516,732,,1248,POINT (4697157 -74140516)
2013,Agosto,El Salvador,1,0,,1,POINT (4815189 -75736374)
2013,Agosto,El Salvador,49,65,,114,POINT (6170465 -7542726)
2013,Agosto,El Salvador,0,1,,1,POINT (6185536 -67484028)
2013,Agosto,El Salvador,1,0,,1,POINT (7927233 -72508188)
2013,Agosto,El Salvador,0,2,,2,POINT (863337 -7735002)
2013,Agosto,Emiratos Árabes,1,9,,10,POINT (4697157 -74140516)
2013,Agosto,Emiratos Árabes,0,1,,1,POINT (6170465 -7542726)
2013,Agosto,España,7,11,,18,POINT (-4191162 -69941498)
2013,Agosto,España,1,0,,1,POINT (0.33002 -76876446)
2013,Agosto,España,32,44,,76,POINT (0.81488 -77356)
2013,Agosto,España,0,1,,1,POINT (1800143 -78802679)
2013,Agosto,España,29,39,,68,POINT (10406342 -75527794)
2013,Agosto,España,66,110,,176,POINT (10446304 -75516486)
2013,Agosto,España,1,15,,16,POINT (10886686 -74776479)
2013,Agosto,España,7,16,,23,POINT (11360029 -72129595)
2013,Agosto,España,6,3,,9,POINT (125862 -81702165)
2013,Agosto,España,192,336,,528,POINT (3451668 -76532004)
2013,Agosto,España,2,0,,2,POINT (445285 -75766353)
2013,Agosto,España,2340,4522,,6862,POINT (4697157 -74140516)
2013,Agosto,España,0,12,,12,POINT (4815189 -75736374)
2013,Agosto,España,140,267,,407,POINT (6170465 -7542726)
2013,Agosto,España,0,1,,1,POINT (7088729 -70740253)
2013,Agosto,España,1,4,,5,POINT (7128047 -73181317)
2013,Agosto,España,35,49,,84,POINT (7819 -72453013)
2013,Agosto,España,1,3,,4,POINT (7927233 -72508188)
2013,Agosto,España,2,7,,9,POINT (863337 -7735002)
2013,Agosto,Eslovaquia,1,3,,4,POINT (0.81488 -77356)
2013,Agosto,Eslovaquia,1,0,,1,POINT (10406342 -75527794)
2013,Agosto,Eslovaquia,0,1,,1,POINT (10446304 -75516486)
2013,Agosto,Eslovaquia,0,1,,1,POINT (11360029 -72129595)
2013,Agosto,Eslovaquia,0,2,,2,POINT (3451668 -76532004)
2013,Agosto,Eslovaquia,15,10,,25,POINT (4697157 -74140516)
2013,Agosto,Eslovaquia,0,1,,1,POINT (6170465 -7542726)
2013,Agosto,Eslovenia,1,2,,3,POINT (10406342 -75527794)
2013,Agosto,Eslovenia,8,1,,9,POINT (11360029 -72129595)
2013,Agosto,Eslovenia,11,15,,26,POINT (4697157 -74140516)
2013,Agosto,Estados Unidos de América,24,37,,61,POINT (-4191162 -69941498)
2013,Agosto,Estados Unidos de América,2,0,,2,POINT (0.33002 -76876446)
2013,Agosto,Estados Unidos de América,47,82,,129,POINT (0.81488 -77356)
2013,Agosto,Estados Unidos de América,0,1,,1,POINT (1800143 -78802679)
2013,Agosto,Estados Unidos de América,45,47,,92,POINT (10406342 -75527794)
2013,Agosto,Estados Unidos de América,1232,1770,,3002,POINT (10446304 -75516486)
2013,Agosto,Estados Unidos de América,290,503,,793,POINT (10886686 -74776479)
2013,Agosto,Estados Unidos de América,0,1,,1,POINT (10970933 -74765343)
2013,Agosto,Estados Unidos de América,3,5,,8,POINT (11247723 -74213989)
2013,Agosto,Estados Unidos de América,7,20,,27,POINT (11360029 -72129595)
2013,Agosto,Estados Unidos de América,16,30,,46,POINT (125862 -81702165)
2013,Agosto,Estados Unidos de América,900,1481,,2381,POINT (3451668 -76532004)
2013,Agosto,Estados Unidos de América,91,136,,227,POINT (445285 -75766353)
2013,Agosto,Estados Unidos de América,6695,12117,,18812,POINT (4697157 -74140516)
2013,Agosto,Estados Unidos de América,124,172,,296,POINT (4815189 -75736374)
2013,Agosto,Estados Unidos de América,1820,3996,,5816,POINT (6170465 -7542726)
2013,Agosto,Estados Unidos de América,1,0,,1,POINT (6185536 -67484028)
2013,Agosto,Estados Unidos de América,41,63,,104,POINT (7128047 -73181317)
2013,Agosto,Estados Unidos de América,46,52,,98,POINT (7819 -72453013)
2013,Agosto,Estados Unidos de América,13,21,,34,POINT (7927233 -72508188)
2013,Agosto,Estados Unidos de América,6,10,,16,POINT (863337 -7735002)
2013,Agosto,Estonia,0,1,,1,POINT (10446304 -75516486)
2013,Agosto,Estonia,5,4,,9,POINT (4697157 -74140516)
2013,Agosto,Estonia,0,1,,1,POINT (6170465 -7542726)
2013,Agosto,Etiopia,0,1,,1,POINT (3451668 -76532004)
2013,Agosto,Etiopia,2,5,,7,POINT (4697157 -74140516)
2013,Agosto,Islas Fiji,1,0,,1,POINT (4697157 -74140516)
2013,Agosto,Filipinas,0,25,,25,POINT (10406342 -75527794)
2013,Agosto,Filipinas,2,13,,15,POINT (10446304 -75516486)
2013,Agosto,Filipinas,0,1,,1,POINT (10886686 -74776479)
2013,Agosto,Filipinas,0,36,,36,POINT (10970933 -74765343)
2013,Agosto,Filipinas,0,38,,38,POINT (11247723 -74213989)
2013,Agosto,Filipinas,1,7,,8,POINT (3451668 -76532004)
2013,Agosto,Filipinas,0,14,,14,POINT (3884426 -77061029)
2013,Agosto,Filipinas,16,78,,94,POINT (4697157 -74140516)
2013,Agosto,Filipinas,0,1,,1,POINT (6170465 -7542726)
2013,Agosto,Filipinas,0,1,,1,POINT (9402597 -75681642)
2013,Agosto,Finlandia,2,1,,3,POINT (10406342 -75527794)
2013,Agosto,Finlandia,1,2,,3,POINT (10446304 -75516486)
2013,Agosto,Finlandia,0,2,,2,POINT (10886686 -74776479)
2013,Agosto,Finlandia,1,0,,1,POINT (11360029 -72129595)
2013,Agosto,Finlandia,1,2,,3,POINT (3451668 -76532004)
2013,Agosto,Finlandia,26,54,,80,POINT (4697157 -74140516)
2013,Agosto,Finlandia,0,5,,5,POINT (6170465 -7542726)
2013,Agosto,Finlandia,0,1,,1,POINT (7819 -72453013)
2013,Agosto,Finlandia,1,0,,1,POINT (863337 -7735002)
2013,Agosto,Francia,3,8,,11,POINT (-4191162 -69941498)
2013,Agosto,Francia,1,1,,2,POINT (0.33002 -76876446)
2013,Agosto,Francia,37,75,,112,POINT (0.81488 -77356)
2013,Agosto,Francia,8,10,,18,POINT (10406342 -75527794)
2013,Agosto,Francia,29,38,,67,POINT (10446304 -75516486)
2013,Agosto,Francia,2,21,,23,POINT (10886686 -74776479)
2013,Agosto,Francia,0,27,,27,POINT (10970933 -74765343)
2013,Agosto,Francia,2,3,,5,POINT (11247723 -74213989)
2013,Agosto,Francia,9,9,,18,POINT (11360029 -72129595)
2013,Agosto,Francia,0,1,,1,POINT (125862 -81702165)
2013,Agosto,Francia,60,106,,166,POINT (3451668 -76532004)
2013,Agosto,Francia,1414,2334,,3748,POINT (4697157 -74140516)
2013,Agosto,Francia,2,2,,4,POINT (4815189 -75736374)
2013,Agosto,Francia,54,115,,169,POINT (6170465 -7542726)
2013,Agosto,Francia,0,1,,1,POINT (7088729 -70740253)
2013,Agosto,Francia,1,2,,3,POINT (7128047 -73181317)
2013,Agosto,Francia,3,27,,30,POINT (7819 -72453013)
2013,Agosto,Francia,2,1,,3,POINT (7927233 -72508188)
2013,Agosto,Francia,7,5,,12,POINT (863337 -7735002)
2013,Agosto,Gabón,2,2,,4,POINT (4697157 -74140516)
2013,Agosto,Georgia,4,1,,5,POINT (4697157 -74140516)
2013,Agosto,Ghana,1,0,,1,POINT (3451668 -76532004)
2013,Agosto,Ghana,2,2,,4,POINT (4697157 -74140516)
2013,Agosto,Ghana,0,2,,2,POINT (6170465 -7542726)
2013,Agosto,Granada,0,2,,2,POINT (6170465 -7542726)
2013,Agosto,Grecia,3,0,,3,POINT (0.81488 -77356)
2013,Agosto,Grecia,1,2,,3,POINT (10406342 -75527794)
2013,Agosto,Grecia,5,4,,9,POINT (10446304 -75516486)
2013,Agosto,Grecia,0,1,,1,POINT (10886686 -74776479)
2013,Agosto,Grecia,1,3,,4,POINT (10970933 -74765343)
2013,Agosto,Grecia,0,1,,1,POINT (11360029 -72129595)
2013,Agosto,Grecia,0,1,,1,POINT (125862 -81702165)
2013,Agosto,Grecia,1,1,,2,POINT (3451668 -76532004)
2013,Agosto,Grecia,19,44,,63,POINT (4697157 -74140516)
2013,Agosto,Grecia,1,2,,3,POINT (6170465 -7542726)
2013,Agosto,Grecia,3,2,,5,POINT (7819 -72453013)
2013,Agosto,Guatemala,0,1,,1,POINT (0.81488 -77356)
2013,Agosto,Guatemala,0,2,,2,POINT (10406342 -75527794)
2013,Agosto,Guatemala,50,47,,97,POINT (10446304 -75516486)
2013,Agosto,Guatemala,3,11,,14,POINT (10886686 -74776479)
2013,Agosto,Guatemala,0,1,,1,POINT (11360029 -72129595)
2013,Agosto,Guatemala,3,1,,4,POINT (125862 -81702165)
2013,Agosto,Guatemala,12,84,,96,POINT (3451668 -76532004)
2013,Agosto,Guatemala,0,1,,1,POINT (445285 -75766353)
2013,Agosto,Guatemala,168,378,,546,POINT (4697157 -74140516)
2013,Agosto,Guatemala,1,1,,2,POINT (4815189 -75736374)
2013,Agosto,Guatemala,63,189,,252,POINT (6170465 -7542726)
2013,Agosto,Guatemala,1,1,,2,POINT (7128047 -73181317)
2013,Agosto,Guatemala,5,3,,8,POINT (7819 -72453013)
2013,Agosto,Guyana,1,1,,2,POINT (10446304 -75516486)
2013,Agosto,Guyana,0,1,,1,POINT (11360029 -72129595)
2013,Agosto,Guyana,0,1,,1,POINT (3451668 -76532004)
2013,Agosto,Guyana,3,6,,9,POINT (4697157 -74140516)
2013,Agosto,Guyana,1,5,,6,POINT (6170465 -7542726)
2013,Agosto,Guinea,0,1,,1,POINT (4697157 -74140516)
2013,Agosto,Guinea Bissau,0,1,,1,POINT (7819 -72453013)
2013,Agosto,Guayana Francesa/Departamento de Ultramar Francés,0,1,,1,POINT (4697157 -74140516)
2013,Agosto,Haití,0,1,,1,POINT (10446304 -75516486)
2013,Agosto,Haití,1,1,,2,POINT (3451668 -76532004)
2013,Agosto,Haití,4,13,,17,POINT (4697157 -74140516)
2013,Agosto,Haití,1,1,,2,POINT (6170465 -7542726)
2013,Agosto,Honduras,3,1,,4,POINT (-4191162 -69941498)
2013,Agosto,Honduras,2,9,,11,POINT (10406342 -75527794)
2013,Agosto,Honduras,16,22,,38,POINT (10446304 -75516486)
2013,Agosto,Honduras,2,2,,4,POINT (10886686 -74776479)
2013,Agosto,Honduras,0,1,,1,POINT (10970933 -74765343)
2013,Agosto,Honduras,2,14,,16,POINT (125744111 -81703935)
2013,Agosto,Honduras,3,0,,3,POINT (125862 -81702165)
2013,Agosto,Honduras,7,16,,23,POINT (3451668 -76532004)
2013,Agosto,Honduras,0,1,,1,POINT (445285 -75766353)
2013,Agosto,Honduras,164,205,,369,POINT (4697157 -74140516)
2013,Agosto,Honduras,1,4,,5,POINT (4815189 -75736374)
2013,Agosto,Honduras,53,71,,124,POINT (6170465 -7542726)
2013,Agosto,Honduras,1,0,,1,POINT (7128047 -73181317)
2013,Agosto,Honduras,2,0,,2,POINT (7819 -72453013)
2013,Agosto,Honduras,2,2,,4,POINT (7927233 -72508188)
2013,Agosto,Honduras,0,2,,2,POINT (806667 -767333)
2013,Agosto,Hong Kong,0,1,,1,POINT (4697157 -74140516)
2013,Agosto,Hungría,0,1,,1,POINT (0.81488 -77356)
2013,Agosto,Hungría,1,1,,2,POINT (10406342 -75527794)
2013,Agosto,Hungría,1,1,,2,POINT (10446304 -75516486)
2013,Agosto,Hungría,0,1,,1,POINT (3451668 -76532004)
2013,Agosto,Hungría,22,22,,44,POINT (4697157 -74140516)
2013,Agosto,Hungría,0,2,,2,POINT (6170465 -7542726)
2013,Agosto,India,2,0,,2,POINT (-4191162 -69941498)
2013,Agosto,India,0,1,,1,POINT (0.81488 -77356)
2013,Agosto,India,0,1,,1,POINT (10406342 -75527794)
2013,Agosto,India,4,10,,14,POINT (10446304 -75516486)
2013,Agosto,India,0,6,,6,POINT (10886686 -74776479)
2013,Agosto,India,0,2,,2,POINT (10970933 -74765343)
2013,Agosto,India,0,1,,1,POINT (125862 -81702165)
2013,Agosto,India,0,14,,14,POINT (3451668 -76532004)
2013,Agosto,India,0,1,,1,POINT (3884426 -77061029)
2013,Agosto,India,59,260,,319,POINT (4697157 -74140516)
2013,Agosto,India,0,2,,2,POINT (4815189 -75736374)
2013,Agosto,India,8,34,,42,POINT (6170465 -7542726)
2013,Agosto,Indonesia,1,2,,3,POINT (10406342 -75527794)
2013,Agosto,Indonesia,0,1,,1,POINT (10446304 -75516486)
2013,Agosto,Indonesia,0,2,,2,POINT (3451668 -76532004)
2013,Agosto,Indonesia,19,20,,39,POINT (4697157 -74140516)
2013,Agosto,Iraq,0,1,,1,POINT (10446304 -75516486)
2013,Agosto,Iraq,2,18,,20,POINT (4697157 -74140516)
2013,Agosto,Irán,9,12,,21,POINT (4697157 -74140516)
2013,Agosto,República de Irlanda,1,7,,8,POINT (-4191162 -69941498)
2013,Agosto,República de Irlanda,22,26,,48,POINT (0.81488 -77356)
2013,Agosto,República de Irlanda,5,8,,13,POINT (10406342 -75527794)
2013,Agosto,República de Irlanda,6,14,,20,POINT (10446304 -75516486)
2013,Agosto,República de Irlanda,0,1,,1,POINT (10886686 -74776479)
2013,Agosto,República de Irlanda,0,1,,1,POINT (11360029 -72129595)
2013,Agosto,República de Irlanda,2,1,,3,POINT (3451668 -76532004)
2013,Agosto,República de Irlanda,70,100,,170,POINT (4697157 -74140516)
2013,Agosto,República de Irlanda,3,11,,14,POINT (6170465 -7542726)
2013,Agosto,República de Irlanda,0,4,,4,POINT (7819 -72453013)
2013,Agosto,República de Irlanda,1,2,,3,POINT (863337 -7735002)
2013,Agosto,Islandia,5,2,,7,POINT (4697157 -74140516)
2013,Agosto,Isla de Man,9,11,,20,POINT (0.81488 -77356)
2013,Agosto,Isla de Man,6,17,,23,POINT (3451668 -76532004)
2013,Agosto,Isla de Man,50,98,,148,POINT (4697157 -74140516)
2013,Agosto,Isla de Man,21,51,,72,POINT (6170465 -7542726)
2013,Agosto,Isla Johnston,0,1,,1,POINT (3451668 -76532004)
2013,Agosto,Isla Johnston,1,0,,1,POINT (6170465 -7542726)
2013,Agosto,Israel,1,6,,7,POINT (-4191162 -69941498)
2013,Agosto,Israel,11,30,,41,POINT (0.81488 -77356)
2013,Agosto,Israel,1,2,,3,POINT (10406342 -75527794)
2013,Agosto,Israel,5,26,,31,POINT (10446304 -75516486)
2013,Agosto,Israel,0,1,,1,POINT (10886686 -74776479)
2013,Agosto,Israel,0,1,,1,POINT (125862 -81702165)
2013,Agosto,Israel,14,24,,38,POINT (3451668 -76532004)
2013,Agosto,Israel,133,462,,595,POINT (4697157 -74140516)
2013,Agosto,Israel,5,32,,37,POINT (6170465 -7542726)
2013,Agosto,Israel,1,5,,6,POINT (863337 -7735002)
2013,Agosto,Islas Aland/Provincia de Finlandia,1,0,,1,POINT (4697157 -74140516)
2013,Agosto,Isla Wake,2,1,,3,POINT (7927233 -72508188)
2013,Agosto,Italia,5,7,,12,POINT (-4191162 -69941498)
2013,Agosto,Italia,0,1,,1,POINT (0.33002 -76876446)
2013,Agosto,Italia,10,21,,31,POINT (0.81488 -77356)
2013,Agosto,Italia,12,16,,28,POINT (10406342 -75527794)
2013,Agosto,Italia,43,103,,146,POINT (10446304 -75516486)
2013,Agosto,Italia,4,21,,25,POINT (10886686 -74776479)
2013,Agosto,Italia,3,16,,19,POINT (11360029 -72129595)
2013,Agosto,Italia,8,7,,15,POINT (125862 -81702165)
2013,Agosto,Italia,28,92,,120,POINT (3451668 -76532004)
2013,Agosto,Italia,692,1807,,2499,POINT (4697157 -74140516)
2013,Agosto,Italia,0,3,,3,POINT (4815189 -75736374)
2013,Agosto,Italia,50,121,,171,POINT (6170465 -7542726)
2013,Agosto,Italia,0,2,,2,POINT (6185536 -67484028)
2013,Agosto,Italia,1,0,,1,POINT (7088729 -70740253)
2013,Agosto,Italia,11,26,,37,POINT (7819 -72453013)
2013,Agosto,Italia,0,2,,2,POINT (7927233 -72508188)
2013,Agosto,Italia,6,6,,12,POINT (863337 -7735002)
2013,Agosto,Islas del Canal,1,8,,9,POINT (10886686 -74776479)
2013,Agosto,Islas del Canal,1,0,,1,POINT (7819 -72453013)
2013,Agosto,Jamaica,2,4,,6,POINT (10446304 -75516486)
2013,Agosto,Jamaica,0,1,,1,POINT (10886686 -74776479)
2013,Agosto,Jamaica,0,1,,1,POINT (3451668 -76532004)
2013,Agosto,Jamaica,14,17,,31,POINT (4697157 -74140516)
2013,Agosto,Jamaica,8,20,,28,POINT (6170465 -7542726)
2013,Agosto,Japón,0,1,,1,POINT (-4191162 -69941498)
2013,Agosto,Japón,6,14,,20,POINT (0.81488 -77356)
2013,Agosto,Japón,2,1,,3,POINT (10406342 -75527794)
2013,Agosto,Japón,6,8,,14,POINT (10446304 -75516486)
2013,Agosto,Japón,1,6,,7,POINT (10886686 -74776479)
2013,Agosto,Japón,1,2,,3,POINT (11360029 -72129595)
2013,Agosto,Japón,9,19,,28,POINT (3451668 -76532004)
2013,Agosto,Japón,136,461,,597,POINT (4697157 -74140516)
2013,Agosto,Japón,1,1,,2,POINT (4815189 -75736374)
2013,Agosto,Japón,9,37,,46,POINT (6170465 -7542726)
2013,Agosto,Japón,2,9,,11,POINT (7819 -72453013)
2013,Agosto,Japón,0,1,,1,POINT (7927233 -72508188)
2013,Agosto,Jordania,0,1,,1,POINT (10446304 -75516486)
2013,Agosto,Jordania,1,1,,2,POINT (4697157 -74140516)
2013,Agosto,Kazajistán,1,0,,1,POINT (4697157 -74140516)
2013,Agosto,Kenia,0,2,,2,POINT (3451668 -76532004)
2013,Agosto,Kenia,5,6,,11,POINT (4697157 -74140516)
2013,Agosto,Kenia,0,1,,1,POINT (6170465 -7542726)
2013,Agosto,Kenia,1,1,,2,POINT (7819 -72453013)
2013,Agosto,Kirguistán,1,1,,2,POINT (4697157 -74140516)
2013,Agosto,Kuwait,0,2,,2,POINT (4697157 -74140516)
2013,Agosto,República Democrática Popular  Lao,2,2,,4,POINT (4697157 -74140516)
2013,Agosto,Letonia,0,1,,1,POINT (10446304 -75516486)
2013,Agosto,Letonia,5,3,,8,POINT (4697157 -74140516)
2013,Agosto,Lituania,0,1,,1,POINT (-4191162 -69941498)
2013,Agosto,Lituania,8,2,,10,POINT (4697157 -74140516)
2013,Agosto,Lituania,1,0,,1,POINT (6170465 -7542726)
2013,Agosto,Líbano,0,2,,2,POINT (0.81488 -77356)
2013,Agosto,Líbano,1,1,,2,POINT (10886686 -74776479)
2013,Agosto,Líbano,3,4,,7,POINT (11360029 -72129595)
2013,Agosto,Líbano,1,0,,1,POINT (125862 -81702165)
2013,Agosto,Líbano,10,27,,37,POINT (4697157 -74140516)
2013,Agosto,Líbano,0,1,,1,POINT (7927233 -72508188)
2013,Agosto,Liberia,1,0,,1,POINT (11360029 -72129595)
2013,Agosto,Libia,1,0,,1,POINT (10446304 -75516486)
2013,Agosto,Libia,1,0,,1,POINT (11360029 -72129595)
2013,Agosto,Liechtenstein,1,0,,1,POINT (3451668 -76532004)
2013,Agosto,Liechtenstein,0,1,,1,POINT (4697157 -74140516)
2013,Agosto,Luxemburgo,1,0,,1,POINT (-4191162 -69941498)
2013,Agosto,Luxemburgo,6,15,,21,POINT (4697157 -74140516)
2013,Agosto,Luxemburgo,0,1,,1,POINT (863337 -7735002)
2013,Agosto,Macedonia,2,2,,4,POINT (4697157 -74140516)
2013,Agosto,Madagascar,0,1,,1,POINT (4697157 -74140516)
2013,Agosto,Malasia,1,2,,3,POINT (10446304 -75516486)
2013,Agosto,Malasia,1,1,,2,POINT (3451668 -76532004)
2013,Agosto,Malasia,10,17,,27,POINT (4697157 -74140516)
2013,Agosto,Malasia,1,0,,1,POINT (6170465 -7542726)
2013,Agosto,Malawi,0,1,,1,POINT (3451668 -76532004)
2013,Agosto,Maldivas,0,1,,1,POINT (806667 -767333)
2013,Agosto,Malta,3,0,,3,POINT (4697157 -74140516)
2013,Agosto,Malta,0,1,,1,POINT (6170465 -7542726)
2013,Agosto,Marruecos,2,8,,10,POINT (4697157 -74140516)
2013,Agosto,Mauritania,0,1,,1,POINT (10446304 -75516486)
2013,Agosto,Mauritania,0,1,,1,POINT (4697157 -74140516)
2013,Agosto,México,1,3,,4,POINT (-4191162 -69941498)
2013,Agosto,México,2,0,,2,POINT (0.33002 -76876446)
2013,Agosto,México,7,12,,19,POINT (0.81488 -77356)
2013,Agosto,México,0,1,,1,POINT (1800143 -78802679)
2013,Agosto,México,31,26,,57,POINT (10406342 -75527794)
2013,Agosto,México,99,171,,270,POINT (10446304 -75516486)
2013,Agosto,México,16,46,,62,POINT (10886686 -74776479)
2013,Agosto,México,5,8,,13,POINT (11360029 -72129595)
2013,Agosto,México,2,5,,7,POINT (125862 -81702165)
2013,Agosto,México,75,158,,233,POINT (3451668 -76532004)
2013,Agosto,México,2,0,,2,POINT (445285 -75766353)
2013,Agosto,México,2594,5323,,7917,POINT (4697157 -74140516)
2013,Agosto,México,3,17,,20,POINT (4815189 -75736374)
2013,Agosto,México,274,655,,929,POINT (6170465 -7542726)
2013,Agosto,México,1,1,,2,POINT (7088729 -70740253)
2013,Agosto,México,3,7,,10,POINT (7128047 -73181317)
2013,Agosto,México,27,53,,80,POINT (7819 -72453013)
2013,Agosto,México,2,21,,23,POINT (7927233 -72508188)
2013,Agosto,México,0,3,,3,POINT (863337 -7735002)
2013,Agosto,Mayotte/Colectividad Territorial Francesa,0,1,,1,POINT (4697157 -74140516)
2013,Agosto,Mónaco,4,4,,8,POINT (4697157 -74140516)
2013,Agosto,Mongolia,0,1,,1,POINT (4697157 -74140516)
2013,Agosto,Montenegro,1,0,,1,POINT (3451668 -76532004)
2013,Agosto,Mozambique,0,1,,1,POINT (4697157 -74140516)
2013,Agosto,Myanmar,1,3,,4,POINT (4697157 -74140516)
2013,Agosto,Namibia,0,1,,1,POINT (4697157 -74140516)
2013,Agosto,Nepal,1,1,,2,POINT (4697157 -74140516)
2013,Agosto,Nicaragua,3,4,,7,POINT (10446304 -75516486)
2013,Agosto,Nicaragua,1,0,,1,POINT (10886686 -74776479)
2013,Agosto,Nicaragua,2,0,,2,POINT (125862 -81702165)
2013,Agosto,Nicaragua,6,11,,17,POINT (3451668 -76532004)
2013,Agosto,Nicaragua,36,108,,144,POINT (4697157 -74140516)
2013,Agosto,Nicaragua,18,15,,33,POINT (6170465 -7542726)
2013,Agosto,Nigeria,0,1,,1,POINT (10446304 -75516486)
2013,Agosto,Nigeria,0,6,,6,POINT (4697157 -74140516)
2013,Agosto,Nigeria,1,1,,2,POINT (6170465 -7542726)
2013,Agosto,Noruega,1,1,,2,POINT (-4191162 -69941498)
2013,Agosto,Noruega,0,2,,2,POINT (0.81488 -77356)
2013,Agosto,Noruega,2,1,,3,POINT (10406342 -75527794)
2013,Agosto,Noruega,3,11,,14,POINT (10446304 -75516486)
2013,Agosto,Noruega,0,1,,1,POINT (11360029 -72129595)
2013,Agosto,Noruega,0,4,,4,POINT (3451668 -76532004)
2013,Agosto,Noruega,42,83,,125,POINT (4697157 -74140516)
2013,Agosto,Noruega,0,1,,1,POINT (4815189 -75736374)
2013,Agosto,Noruega,4,6,,10,POINT (6170465 -7542726)
2013,Agosto,Noruega,0,1,,1,POINT (7819 -72453013)
2013,Agosto,Noruega,1,0,,1,POINT (863337 -7735002)
2013,Agosto,Nueva Zelanda,1,1,,2,POINT (-4191162 -69941498)
2013,Agosto,Nueva Zelanda,6,10,,16,POINT (0.81488 -77356)
2013,Agosto,Nueva Zelanda,14,11,,25,POINT (10446304 -75516486)
2013,Agosto,Nueva Zelanda,1,0,,1,POINT (10886686 -74776479)
2013,Agosto,Nueva Zelanda,0,1,,1,POINT (125862 -81702165)
2013,Agosto,Nueva Zelanda,0,1,,1,POINT (3451668 -76532004)
2013,Agosto,Nueva Zelanda,26,62,,88,POINT (4697157 -74140516)
2013,Agosto,Nueva Zelanda,5,13,,18,POINT (6170465 -7542726)
2013,Agosto,Nueva Zelanda,0,1,,1,POINT (7819 -72453013)
2013,Agosto,Nueva Zelanda,1,1,,2,POINT (863337 -7735002)
2013,Agosto,Papúa Nueva Guinea,0,1,,1,POINT (4697157 -74140516)
2013,Agosto,Nueva Zelanda,8,12,,20,POINT (10406342 -75527794)
2013,Agosto,Nueva Zelanda,2,2,,4,POINT (10886686 -74776479)
2013,Agosto,Nueva Zelanda,2,1,,3,POINT (4697157 -74140516)
2013,Agosto,Nueva Zelanda,0,1,,1,POINT (7819 -72453013)
2013,Agosto,Países Bajos,2,5,,7,POINT (0.81488 -77356)
2013,Agosto,Países Bajos,19,36,,55,POINT (10446304 -75516486)
2013,Agosto,Países Bajos,1,5,,6,POINT (10886686 -74776479)
2013,Agosto,Países Bajos,9,13,,22,POINT (11360029 -72129595)
2013,Agosto,Países Bajos,13,9,,22,POINT (1152863 -72919186)
2013,Agosto,Países Bajos,5,17,,22,POINT (3451668 -76532004)
2013,Agosto,Países Bajos,174,251,,425,POINT (4697157 -74140516)
2013,Agosto,Países Bajos,1,5,,6,POINT (4815189 -75736374)
2013,Agosto,Países Bajos,127,164,,291,POINT (6170465 -7542726)
2013,Agosto,Países Bajos,6,6,,12,POINT (7128047 -73181317)
2013,Agosto,Países Bajos,0,1,,1,POINT (7819 -72453013)
2013,Agosto,Pakistán,0,1,,1,POINT (0.81488 -77356)
2013,Agosto,Pakistán,0,1,,1,POINT (10406342 -75527794)
2013,Agosto,Pakistán,4,10,,14,POINT (4697157 -74140516)
2013,Agosto,Pakistán,0,1,,1,POINT (6170465 -7542726)
2013,Agosto,Panamá,0,1,,1,POINT (-4191162 -69941498)
2013,Agosto,Panamá,0,1,,1,POINT (0.81488 -77356)
2013,Agosto,Panamá,0,16,,16,POINT (10406342 -75527794)
2013,Agosto,Panamá,105,141,,246,POINT (10446304 -75516486)
2013,Agosto,Panamá,35,85,,120,POINT (10886686 -74776479)
2013,Agosto,Panamá,0,1,,1,POINT (125744111 -81703935)
2013,Agosto,Panamá,14,30,,44,POINT (125862 -81702165)
2013,Agosto,Panamá,88,181,,269,POINT (3451668 -76532004)
2013,Agosto,Panamá,576,958,,1534,POINT (4697157 -74140516)
2013,Agosto,Panamá,87,107,,194,POINT (4815189 -75736374)
2013,Agosto,Panamá,164,316,,480,POINT (6170465 -7542726)
2013,Agosto,Panamá,9,12,,21,POINT (7128047 -73181317)
2013,Agosto,Panamá,7,8,,15,POINT (7819 -72453013)
2013,Agosto,Panamá,9,12,,21,POINT (7927233 -72508188)
2013,Agosto,Panamá,3,8,,11,POINT (863337 -7735002)
2013,Agosto,Paraguay,0,1,,1,POINT (0.81488 -77356)
2013,Agosto,Paraguay,9,15,,24,POINT (10446304 -75516486)
2013,Agosto,Paraguay,0,1,,1,POINT (10886686 -74776479)
2013,Agosto,Paraguay,1,0,,1,POINT (11360029 -72129595)
2013,Agosto,Paraguay,3,0,,3,POINT (125862 -81702165)
2013,Agosto,Paraguay,7,8,,15,POINT (3451668 -76532004)
2013,Agosto,Paraguay,75,86,,161,POINT (4697157 -74140516)
2013,Agosto,Paraguay,22,63,,85,POINT (6170465 -7542726)
2013,Agosto,Paraguay,0,1,,1,POINT (7819 -72453013)
2013,Agosto,Perú,13,12,,25,POINT (-4191162 -69941498)
2013,Agosto,Perú,1,3,,4,POINT (0.33002 -76876446)
2013,Agosto,Perú,211,349,,560,POINT (0.81488 -77356)
2013,Agosto,Perú,56,56,,112,POINT (10406342 -75527794)
2013,Agosto,Perú,180,153,,333,POINT (10446304 -75516486)
2013,Agosto,Perú,25,31,,56,POINT (10886686 -74776479)
2013,Agosto,Perú,0,2,,2,POINT (10970933 -74765343)
2013,Agosto,Perú,14,34,,48,POINT (11360029 -72129595)
2013,Agosto,Perú,139,77,,216,POINT (125862 -81702165)
2013,Agosto,Perú,122,169,,291,POINT (3451668 -76532004)
2013,Agosto,Perú,0,1,,1,POINT (445285 -75766353)
2013,Agosto,Perú,3054,3773,,6827,POINT (4697157 -74140516)
2013,Agosto,Perú,1,8,,9,POINT (4815189 -75736374)
2013,Agosto,Perú,311,684,,995,POINT (6170465 -7542726)
2013,Agosto,Perú,1,0,,1,POINT (7088729 -70740253)
2013,Agosto,Perú,5,9,,14,POINT (7128047 -73181317)
2013,Agosto,Perú,47,78,,125,POINT (7819 -72453013)
2013,Agosto,Perú,3,7,,10,POINT (7927233 -72508188)
2013,Agosto,Perú,0,1,,1,POINT (863337 -7735002)
2013,Agosto,Palestina,2,1,,3,POINT (4697157 -74140516)
2013,Agosto,Polonia,2,1,,3,POINT (-4191162 -69941498)
2013,Agosto,Polonia,1,4,,5,POINT (0.81488 -77356)
2013,Agosto,Polonia,2,3,,5,POINT (10406342 -75527794)
2013,Agosto,Polonia,0,4,,4,POINT (10446304 -75516486)
2013,Agosto,Polonia,2,5,,7,POINT (10886686 -74776479)
2013,Agosto,Polonia,0,3,,3,POINT (10970933 -74765343)
2013,Agosto,Polonia,2,2,,4,POINT (11360029 -72129595)
2013,Agosto,Polonia,4,1,,5,POINT (3451668 -76532004)
2013,Agosto,Polonia,88,92,,180,POINT (4697157 -74140516)
2013,Agosto,Polonia,3,8,,11,POINT (6170465 -7542726)
2013,Agosto,Polonia,2,3,,5,POINT (7819 -72453013)
2013,Agosto,Portugal,2,6,,8,POINT (0.81488 -77356)
2013,Agosto,Portugal,1,2,,3,POINT (10406342 -75527794)
2013,Agosto,Portugal,3,9,,12,POINT (10446304 -75516486)
2013,Agosto,Portugal,0,4,,4,POINT (10886686 -74776479)
2013,Agosto,Portugal,0,2,,2,POINT (11360029 -72129595)
2013,Agosto,Portugal,0,1,,1,POINT (125862 -81702165)
2013,Agosto,Portugal,5,19,,24,POINT (3451668 -76532004)
2013,Agosto,Portugal,116,299,,415,POINT (4697157 -74140516)
2013,Agosto,Portugal,5,15,,20,POINT (6170465 -7542726)
2013,Agosto,Portugal,2,5,,7,POINT (7819 -72453013)
2013,Agosto,Portugal,0,1,,1,POINT (863337 -7735002)
2013,Agosto,Puerto Rico/Territorio de Estados Unidos,1,1,,2,POINT (10446304 -75516486)
2013,Agosto,Qatar,0,1,,1,POINT (4697157 -74140516)
2013,Agosto,Reino Unido de Gran Bretaña e Irlanda del Norte,6,6,,12,POINT (-4191162 -69941498)
2013,Agosto,Reino Unido de Gran Bretaña e Irlanda del Norte,10,11,,21,POINT (0.81488 -77356)
2013,Agosto,Reino Unido de Gran Bretaña e Irlanda del Norte,13,18,,31,POINT (10406342 -75527794)
2013,Agosto,Reino Unido de Gran Bretaña e Irlanda del Norte,26,47,,73,POINT (10446304 -75516486)
2013,Agosto,Reino Unido de Gran Bretaña e Irlanda del Norte,1,0,,1,POINT (10886686 -74776479)
2013,Agosto,Reino Unido de Gran Bretaña e Irlanda del Norte,8,4,,12,POINT (11360029 -72129595)
2013,Agosto,Reino Unido de Gran Bretaña e Irlanda del Norte,16,28,,44,POINT (3451668 -76532004)
2013,Agosto,Reino Unido de Gran Bretaña e Irlanda del Norte,300,600,,900,POINT (4697157 -74140516)
2013,Agosto,Reino Unido de Gran Bretaña e Irlanda del Norte,0,1,,1,POINT (4815189 -75736374)
2013,Agosto,Reino Unido de Gran Bretaña e Irlanda del Norte,17,49,,66,POINT (6170465 -7542726)
2013,Agosto,Reino Unido de Gran Bretaña e Irlanda del Norte,0,4,,4,POINT (7819 -72453013)
2013,Agosto,Reino Unido de Gran Bretaña e Irlanda del Norte,0,1,,1,POINT (7927233 -72508188)
2013,Agosto,Reino Unido de Gran Bretaña e Irlanda del Norte,0,1,,1,POINT (863337 -7735002)
2013,Agosto,República de Belarús,1,2,,3,POINT (4697157 -74140516)
2013,Agosto,República Dominicana,4,5,,9,POINT (0.81488 -77356)
2013,Agosto,República Dominicana,6,2,,8,POINT (10406342 -75527794)
2013,Agosto,República Dominicana,18,31,,49,POINT (10446304 -75516486)
2013,Agosto,República Dominicana,10,18,,28,POINT (10886686 -74776479)
2013,Agosto,República Dominicana,0,5,,5,POINT (11360029 -72129595)
2013,Agosto,República Dominicana,10,28,,38,POINT (3451668 -76532004)
2013,Agosto,República Dominicana,282,407,,689,POINT (4697157 -74140516)
2013,Agosto,República Dominicana,7,24,,31,POINT (4815189 -75736374)
2013,Agosto,República Dominicana,38,114,,152,POINT (6170465 -7542726)
2013,Agosto,República Dominicana,1,0,,1,POINT (7128047 -73181317)
2013,Agosto,República Dominicana,6,6,,12,POINT (7819 -72453013)
2013,Agosto,República Dominicana,4,5,,9,POINT (7927233 -72508188)
2013,Agosto,República Checa,0,1,,1,POINT (3451668 -76532004)
2013,Agosto,República Checa,0,1,,1,POINT (4697157 -74140516)
2013,Agosto,Rumania,0,1,,1,POINT (-4191162 -69941498)
2013,Agosto,Rumania,0,1,,1,POINT (0.81488 -77356)
2013,Agosto,Rumania,0,2,,2,POINT (10406342 -75527794)
2013,Agosto,Rumania,0,2,,2,POINT (10446304 -75516486)
2013,Agosto,Rumania,0,2,,2,POINT (10886686 -74776479)
2013,Agosto,Rumania,4,4,,8,POINT (3451668 -76532004)
2013,Agosto,Rumania,0,1,,1,POINT (3884426 -77061029)
2013,Agosto,Rumania,25,47,,72,POINT (4697157 -74140516)
2013,Agosto,Rumania,1,1,,2,POINT (7819 -72453013)
2013,Agosto,Rumania,0,1,,1,POINT (9402597 -75681642)
2013,Agosto,Federación de Rusia,2,3,,5,POINT (0.81488 -77356)
2013,Agosto,Federación de Rusia,4,5,,9,POINT (10406342 -75527794)
2013,Agosto,Federación de Rusia,5,3,,8,POINT (10446304 -75516486)
2013,Agosto,Federación de Rusia,2,0,,2,POINT (10886686 -74776479)
2013,Agosto,Federación de Rusia,2,2,,4,POINT (11360029 -72129595)
2013,Agosto,Federación de Rusia,2,1,,3,POINT (3451668 -76532004)
2013,Agosto,Federación de Rusia,13,17,,30,POINT (4697157 -74140516)
2013,Agosto,Federación de Rusia,0,1,,1,POINT (6170465 -7542726)
2013,Agosto,Federación de Rusia,1,0,,1,POINT (7819 -72453013)
2013,Agosto,Federación de Rusia,0,3,,3,POINT (806667 -767333)
2013,Agosto,Federación de Rusia,0,4,,4,POINT (9402597 -75681642)
2013,Agosto,Rwanda,2,0,,2,POINT (3451668 -76532004)
2013,Agosto,Rwanda,0,1,,1,POINT (6170465 -7542726)
2013,Agosto,San Cristóbal y Nevis,2,12,,14,POINT (6170465 -7542726)
2013,Agosto,San  Vicente y las Granadinas,0,1,,1,POINT (4697157 -74140516)
2013,Agosto,San  Vicente y las Granadinas,1,4,,5,POINT (6170465 -7542726)
2013,Agosto,Santa Lucia,1,1,,2,POINT (10446304 -75516486)
2013,Agosto,Santa Lucia,1,0,,1,POINT (4697157 -74140516)
2013,Agosto,Santa Lucia,1,0,,1,POINT (6170465 -7542726)
2013,Agosto,Santa Sede/Ciudad del Vaticano,0,2,,2,POINT (4697157 -74140516)
2013,Agosto,Senegal,0,1,,1,POINT (0.81488 -77356)
2013,Agosto,Senegal,0,4,,4,POINT (4697157 -74140516)
2013,Agosto,Serbia,7,9,,16,POINT (4697157 -74140516)
2013,Agosto,Singapur,0,1,,1,POINT (0.81488 -77356)
2013,Agosto,Singapur,0,1,,1,POINT (10446304 -75516486)
2013,Agosto,Singapur,0,1,,1,POINT (11247723 -74213989)
2013,Agosto,Singapur,8,21,,29,POINT (4697157 -74140516)
2013,Agosto,Singapur,0,4,,4,POINT (6170465 -7542726)
2013,Agosto,República Árabe Siria,1,1,,2,POINT (11360029 -72129595)
2013,Agosto,República Árabe Siria,0,7,,7,POINT (4697157 -74140516)
2013,Agosto,Sri Lanka,0,1,,1,POINT (3451668 -76532004)
2013,Agosto,Sri Lanka,0,1,,1,POINT (4697157 -74140516)
2013,Agosto,Sri Lanka,0,1,,1,POINT (6170465 -7542726)
2013,Agosto,Sudáfrica,1,3,,4,POINT (0.81488 -77356)
2013,Agosto,Sudáfrica,1,3,,4,POINT (10406342 -75527794)
2013,Agosto,Sudáfrica,4,5,,9,POINT (10446304 -75516486)
2013,Agosto,Sudáfrica,1,4,,5,POINT (10886686 -74776479)
2013,Agosto,Sudáfrica,0,1,,1,POINT (11247723 -74213989)
2013,Agosto,Sudáfrica,2,0,,2,POINT (3451668 -76532004)
2013,Agosto,Sudáfrica,35,78,,113,POINT (4697157 -74140516)
2013,Agosto,Sudáfrica,1,3,,4,POINT (6170465 -7542726)
2013,Agosto,Sudáfrica,2,3,,5,POINT (7819 -72453013)
2013,Agosto,Sudán,0,1,,1,POINT (4697157 -74140516)
2013,Agosto,Suecia,1,1,,2,POINT (-4191162 -69941498)
2013,Agosto,Suecia,4,1,,5,POINT (0.81488 -77356)
2013,Agosto,Suecia,7,3,,10,POINT (10406342 -75527794)
2013,Agosto,Suecia,1,5,,6,POINT (10446304 -75516486)
2013,Agosto,Suecia,0,5,,5,POINT (10886686 -74776479)
2013,Agosto,Suecia,1,0,,1,POINT (11360029 -72129595)
2013,Agosto,Suecia,7,7,,14,POINT (3451668 -76532004)
2013,Agosto,Suecia,85,147,,232,POINT (4697157 -74140516)
2013,Agosto,Suecia,9,13,,22,POINT (6170465 -7542726)
2013,Agosto,Suecia,1,1,,2,POINT (7128047 -73181317)
2013,Agosto,Suecia,0,3,,3,POINT (7819 -72453013)
2013,Agosto,Suecia,1,0,,1,POINT (7927233 -72508188)
2013,Agosto,Suecia,0,2,,2,POINT (863337 -7735002)
2013,Agosto,Suiza,7,10,,17,POINT (-4191162 -69941498)
2013,Agosto,Suiza,0,1,,1,POINT (0.33002 -76876446)
2013,Agosto,Suiza,20,18,,38,POINT (0.81488 -77356)
2013,Agosto,Suiza,9,13,,22,POINT (10406342 -75527794)
2013,Agosto,Suiza,15,18,,33,POINT (10446304 -75516486)
2013,Agosto,Suiza,2,2,,4,POINT (10886686 -74776479)
2013,Agosto,Suiza,1,4,,5,POINT (11360029 -72129595)
2013,Agosto,Suiza,0,1,,1,POINT (1152863 -72919186)
2013,Agosto,Suiza,10,25,,35,POINT (3451668 -76532004)
2013,Agosto,Suiza,280,415,,695,POINT (4697157 -74140516)
2013,Agosto,Suiza,1,1,,2,POINT (4815189 -75736374)
2013,Agosto,Suiza,19,41,,60,POINT (6170465 -7542726)
2013,Agosto,Suiza,1,2,,3,POINT (7819 -72453013)
2013,Agosto,Suiza,0,4,,4,POINT (863337 -7735002)
2013,Agosto,Surinam,15,12,,27,POINT (4697157 -74140516)
2013,Agosto,Surinam,31,15,,46,POINT (6170465 -7542726)
2013,Agosto,Taiwán,3,3,,6,POINT (10406342 -75527794)
2013,Agosto,Taiwán,10,7,,17,POINT (10446304 -75516486)
2013,Agosto,Taiwán,2,2,,4,POINT (4697157 -74140516)
2013,Agosto,Tailandia,0,1,,1,POINT (0.81488 -77356)
2013,Agosto,Tailandia,0,1,,1,POINT (10970933 -74765343)
2013,Agosto,Tailandia,5,8,,13,POINT (4697157 -74140516)
2013,Agosto,Tailandia,0,1,,1,POINT (4815189 -75736374)
2013,Agosto,Tailandia,1,0,,1,POINT (6170465 -7542726)
2013,Agosto,Territorio Antártico Británico/Territorio Británico de Ultramar,0,1,,1,POINT (0.81488 -77356)
2013,Agosto,Territorio Antártico Británico/Territorio Británico de Ultramar,1,2,,3,POINT (4697157 -74140516)
2013,Agosto,Territorio Antártico Británico/Territorio Británico de Ultramar,0,1,,1,POINT (6170465 -7542726)
2013,Agosto,Trinidad y Tobago,1,6,,7,POINT (10446304 -75516486)
2013,Agosto,Trinidad y Tobago,4,2,,6,POINT (3451668 -76532004)
2013,Agosto,Trinidad y Tobago,24,33,,57,POINT (4697157 -74140516)
2013,Agosto,Trinidad y Tobago,6,25,,31,POINT (6170465 -7542726)
2013,Agosto,Trinidad y Tobago,0,1,,1,POINT (7819 -72453013)
2013,Agosto,Trinidad y Tobago,0,2,,2,POINT (7927233 -72508188)
2013,Agosto,Túnez,2,5,,7,POINT (4697157 -74140516)
2013,Agosto,Turquía,0,1,,1,POINT (0.81488 -77356)
2013,Agosto,Turquía,1,4,,5,POINT (10446304 -75516486)
2013,Agosto,Turquía,1,0,,1,POINT (10886686 -74776479)
2013,Agosto,Turquía,0,2,,2,POINT (3451668 -76532004)
2013,Agosto,Turquía,0,2,,2,POINT (3884426 -77061029)
2013,Agosto,Turquía,32,57,,89,POINT (4697157 -74140516)
2013,Agosto,Turquía,0,10,,10,POINT (6170465 -7542726)
2013,Agosto,Turquía,0,3,,3,POINT (7819 -72453013)
2013,Agosto,Ucrania,0,5,,5,POINT (3451668 -76532004)
2013,Agosto,Ucrania,0,2,,2,POINT (3884426 -77061029)
2013,Agosto,Ucrania,18,32,,50,POINT (4697157 -74140516)
2013,Agosto,Ucrania,0,1,,1,POINT (6170465 -7542726)
2013,Agosto,Uganda,6,4,,10,POINT (4697157 -74140516)
2013,Agosto,Federación de Rusia,1,2,,3,POINT (-4191162 -69941498)
2013,Agosto,Federación de Rusia,1,1,,2,POINT (0.81488 -77356)
2013,Agosto,Federación de Rusia,0,1,,1,POINT (10406342 -75527794)
2013,Agosto,Federación de Rusia,0,1,,1,POINT (11247723 -74213989)
2013,Agosto,Federación de Rusia,3,2,,5,POINT (3451668 -76532004)
2013,Agosto,Federación de Rusia,88,101,,189,POINT (4697157 -74140516)
2013,Agosto,Federación de Rusia,10,7,,17,POINT (7819 -72453013)
2013,Agosto,Federación de Rusia,0,1,,1,POINT (9402597 -75681642)
2013,Agosto,Myanmar,1,0,,1,POINT (4697157 -74140516)
2013,Agosto,Uruguay,4,7,,11,POINT (0.81488 -77356)
2013,Agosto,Uruguay,3,2,,5,POINT (10406342 -75527794)
2013,Agosto,Uruguay,87,66,,153,POINT (10446304 -75516486)
2013,Agosto,Uruguay,2,5,,7,POINT (10886686 -74776479)
2013,Agosto,Uruguay,0,3,,3,POINT (11360029 -72129595)
2013,Agosto,Uruguay,35,33,,68,POINT (125862 -81702165)
2013,Agosto,Uruguay,10,21,,31,POINT (3451668 -76532004)
2013,Agosto,Uruguay,167,327,,494,POINT (4697157 -74140516)
2013,Agosto,Uruguay,0,4,,4,POINT (4815189 -75736374)
2013,Agosto,Uruguay,14,58,,72,POINT (6170465 -7542726)
2013,Agosto,Uruguay,4,5,,9,POINT (7819 -72453013)
2013,Agosto,Uruguay,0,2,,2,POINT (863337 -7735002)
2013,Agosto,Uzbekistán,1,0,,1,POINT (3451668 -76532004)
2013,Agosto,Uzbekistán,1,0,,1,POINT (6170465 -7542726)
2013,Agosto,Venezuela,0,1,,1,POINT (-4191162 -69941498)
2013,Agosto,Venezuela,2,0,,2,POINT (0.33002 -76876446)
2013,Agosto,Venezuela,44,77,,121,POINT (0.81488 -77356)
2013,Agosto,Venezuela,21,30,,51,POINT (10406342 -75527794)
2013,Agosto,Venezuela,79,113,,192,POINT (10446304 -75516486)
2013,Agosto,Venezuela,38,109,,147,POINT (10886686 -74776479)
2013,Agosto,Venezuela,2147,2313,,4460,POINT (11360029 -72129595)
2013,Agosto,Venezuela,0,1,,1,POINT (1152863 -72919186)
2013,Agosto,Venezuela,6,5,,11,POINT (125862 -81702165)
2013,Agosto,Venezuela,71,100,,171,POINT (3451668 -76532004)
2013,Agosto,Venezuela,6306,6796,,13102,POINT (4697157 -74140516)
2013,Agosto,Venezuela,2,9,,11,POINT (4815189 -75736374)
2013,Agosto,Venezuela,481,589,,1070,POINT (6170465 -7542726)
2013,Agosto,Venezuela,23,49,,72,POINT (6185536 -67484028)
2013,Agosto,Venezuela,122,164,,286,POINT (7088729 -70740253)
2013,Agosto,Venezuela,6,3,,9,POINT (7128047 -73181317)
2013,Agosto,Venezuela,1945,2330,,4275,POINT (7819 -72453013)
2013,Agosto,Venezuela,252,316,,568,POINT (7927233 -72508188)
2013,Agosto,Vietnam,1,8,,9,POINT (4697157 -74140516)
2013,Agosto,Islas Vírgenes Británicas/Territorio Británico de Ultramar,0,1,,1,POINT (6170465 -7542726)
2013,Agosto,República Árabe de Yemen,1,0,,1,POINT (4697157 -74140516)
2013,Agosto,Zambia,1,1,,2,POINT (4697157 -74140516)
2013,Agosto,Zimbabue,0,3,,3,POINT (4697157 -74140516)
2013,Agosto,Anguila/Territorio Británico de Ultramar,0,1,,1,POINT (10446304 -75516486)
2013,Agosto,Reino Unido de Gran Bretaña e Irlanda del Norte,10,14,,24,POINT (-4191162 -69941498)
2013,Agosto,Reino Unido de Gran Bretaña e Irlanda del Norte,26,39,,65,POINT (0.81488 -77356)
2013,Agosto,Reino Unido de Gran Bretaña e Irlanda del Norte,26,13,,39,POINT (10406342 -75527794)
2013,Agosto,Reino Unido de Gran Bretaña e Irlanda del Norte,1,6,,7,POINT (10886686 -74776479)
2013,Agosto,Reino Unido de Gran Bretaña e Irlanda del Norte,0,4,,4,POINT (10970933 -74765343)
2013,Agosto,Reino Unido de Gran Bretaña e Irlanda del Norte,3,15,,18,POINT (11247723 -74213989)
2013,Agosto,Reino Unido de Gran Bretaña e Irlanda del Norte,10,26,,36,POINT (3451668 -76532004)
2013,Agosto,Reino Unido de Gran Bretaña e Irlanda del Norte,273,578,,851,POINT (4697157 -74140516)
2013,Agosto,Reino Unido de Gran Bretaña e Irlanda del Norte,17,39,,56,POINT (6170465 -7542726)
2013,Agosto,Reino Unido de Gran Bretaña e Irlanda del Norte,2,3,,5,POINT (7819 -72453013)
2013,Agosto,Reino Unido de Gran Bretaña e Irlanda del Norte,2,9,,11,POINT (863337 -7735002)
2013,Agosto,Países Bajos,0,1,,1,POINT (-4191162 -69941498)
2013,Agosto,Países Bajos,14,18,,32,POINT (0.81488 -77356)
2013,Agosto,Países Bajos,3,12,,15,POINT (10406342 -75527794)
2013,Agosto,Países Bajos,2,2,,4,POINT (10446304 -75516486)
2013,Agosto,Países Bajos,2,17,,19,POINT (10886686 -74776479)
2013,Agosto,Países Bajos,0,1,,1,POINT (11247723 -74213989)
2013,Agosto,Países Bajos,3,5,,8,POINT (125862 -81702165)
2013,Agosto,Países Bajos,11,45,,56,POINT (3451668 -76532004)
2013,Agosto,Países Bajos,410,662,,1072,POINT (4697157 -74140516)
2013,Agosto,Países Bajos,72,93,,165,POINT (6170465 -7542726)
2013,Agosto,Países Bajos,3,1,,4,POINT (7128047 -73181317)
2013,Agosto,Países Bajos,1,5,,6,POINT (7819 -72453013)
2013,Agosto,Países Bajos,0,1,,1,POINT (7927233 -72508188)
2013,Agosto,Países Bajos,3,4,,7,POINT (863337 -7735002)
2013,Agosto,Lituania,1,0,,1,POINT (3451668 -76532004)
2013,Agosto,Lituania,0,4,,4,POINT (4697157 -74140516)
2013,Agosto,Reino Unido de Gran Bretaña e Irlanda del Norte,0,2,,2,POINT (10406342 -75527794)
2013,Agosto,Reino Unido de Gran Bretaña e Irlanda del Norte,0,1,,1,POINT (10886686 -74776479)
2013,Agosto,Reino Unido de Gran Bretaña e Irlanda del Norte,4,8,,12,POINT (10406342 -75527794)
2013,Agosto,Reino Unido de Gran Bretaña e Irlanda del Norte,1,0,,1,POINT (3451668 -76532004)
2013,Agosto,Reino Unido de Gran Bretaña e Irlanda del Norte,1,6,,7,POINT (4697157 -74140516)
2013,Agosto,Reino Unido de Gran Bretaña e Irlanda del Norte,1,0,,1,POINT (7819 -72453013)
2013,Agosto,Letonia,1,0,,1,POINT (4697157 -74140516)
2013,Septiembre,Albania,0,1,,1,POINT (3451668 -76532004)
2013,Septiembre,Albania,2,2,,4,POINT (4697157 -74140516)
2013,Septiembre,Albania,0,1,,1,POINT (6170465 -7542726)
2013,Septiembre,Alemania,7,13,,20,POINT (-4191162 -69941498)
2013,Septiembre,Alemania,34,40,,74,POINT (0.81488 -77356)
2013,Septiembre,Alemania,18,27,,45,POINT (10406342 -75527794)
2013,Septiembre,Alemania,20,35,,55,POINT (10446304 -75516486)
2013,Septiembre,Alemania,2,6,,8,POINT (10886686 -74776479)
2013,Septiembre,Alemania,0,1,,1,POINT (10970933 -74765343)
2013,Septiembre,Alemania,2,2,,4,POINT (11247723 -74213989)
2013,Septiembre,Alemania,8,12,,20,POINT (11360029 -72129595)
2013,Septiembre,Alemania,1,0,,1,POINT (1152863 -72919186)
2013,Septiembre,Alemania,0,1,,1,POINT (125862 -81702165)
2013,Septiembre,Alemania,33,54,,87,POINT (3451668 -76532004)
2013,Septiembre,Alemania,1,0,,1,POINT (3884426 -77061029)
2013,Septiembre,Alemania,1070,1744,,2814,POINT (4697157 -74140516)
2013,Septiembre,Alemania,0,4,,4,POINT (4815189 -75736374)
2013,Septiembre,Alemania,39,93,,132,POINT (6170465 -7542726)
2013,Septiembre,Alemania,0,1,,1,POINT (7128047 -73181317)
2013,Septiembre,Alemania,3,8,,11,POINT (7819 -72453013)
2013,Septiembre,Alemania,5,6,,11,POINT (863337 -7735002)
2013,Septiembre,Andorra,1,5,,6,POINT (4697157 -74140516)
2013,Septiembre,Antigua y Barbuda,0,7,,7,POINT (10446304 -75516486)
2013,Septiembre,Antigua y Barbuda,3,2,,5,POINT (4697157 -74140516)
2013,Septiembre,Antigua y Barbuda,1,0,,1,POINT (6170465 -7542726)
2013,Septiembre,Países Bajos,1,0,,1,POINT (6170465 -7542726)
2013,Septiembre,Arabia Saudita,0,2,,2,POINT (4697157 -74140516)
2013,Septiembre,Arabia Saudita,0,2,,2,POINT (10446304 -75516486)
2013,Septiembre,Arabia Saudita,0,9,,9,POINT (4697157 -74140516)
2013,Septiembre,Arabia Saudita,0,1,,1,POINT (4815189 -75736374)
2013,Septiembre,Argelia,1,3,,4,POINT (4697157 -74140516)
2013,Septiembre,Argentina,4,4,,8,POINT (-4191162 -69941498)
2013,Septiembre,Argentina,6,2,,8,POINT (0.33002 -76876446)
2013,Septiembre,Argentina,45,80,,125,POINT (0.81488 -77356)
2013,Septiembre,Argentina,119,100,,219,POINT (10406342 -75527794)
2013,Septiembre,Argentina,898,627,,1525,POINT (10446304 -75516486)
2013,Septiembre,Argentina,11,30,,41,POINT (10886686 -74776479)
2013,Septiembre,Argentina,18,25,,43,POINT (11360029 -72129595)
2013,Septiembre,Argentina,194,139,,333,POINT (125862 -81702165)
2013,Septiembre,Argentina,38,74,,112,POINT (3451668 -76532004)
2013,Septiembre,Argentina,0,1,,1,POINT (445285 -75766353)
2013,Septiembre,Argentina,2892,4297,,7189,POINT (4697157 -74140516)
2013,Septiembre,Argentina,8,12,,20,POINT (4815189 -75736374)
2013,Septiembre,Argentina,100,236,,336,POINT (6170465 -7542726)
2013,Septiembre,Argentina,0,2,,2,POINT (7128047 -73181317)
2013,Septiembre,Argentina,21,36,,57,POINT (7819 -72453013)
2013,Septiembre,Argentina,1,4,,5,POINT (863337 -7735002)
2013,Septiembre,República de Armenia,1,1,,2,POINT (4697157 -74140516)
2013,Septiembre,Aruba,1,0,,1,POINT (10886686 -74776479)
2013,Septiembre,Aruba,1,0,,1,POINT (4697157 -74140516)
2013,Septiembre,Australia,5,6,,11,POINT (-4191162 -69941498)
2013,Septiembre,Australia,23,31,,54,POINT (0.81488 -77356)
2013,Septiembre,Australia,15,27,,42,POINT (10406342 -75527794)
2013,Septiembre,Australia,33,40,,73,POINT (10446304 -75516486)
2013,Septiembre,Australia,5,12,,17,POINT (10886686 -74776479)
2013,Septiembre,Australia,0,1,,1,POINT (11247723 -74213989)
2013,Septiembre,Australia,1,0,,1,POINT (125862 -81702165)
2013,Septiembre,Australia,10,18,,28,POINT (3451668 -76532004)
2013,Septiembre,Australia,171,312,,483,POINT (4697157 -74140516)
2013,Septiembre,Australia,0,2,,2,POINT (4815189 -75736374)
2013,Septiembre,Australia,12,46,,58,POINT (6170465 -7542726)
2013,Septiembre,Australia,0,1,,1,POINT (7128047 -73181317)
2013,Septiembre,Australia,0,4,,4,POINT (7819 -72453013)
2013,Septiembre,Australia,0,1,,1,POINT (7927233 -72508188)
2013,Septiembre,Australia,3,7,,10,POINT (863337 -7735002)
2013,Septiembre,Austria,4,0,,4,POINT (0.81488 -77356)
2013,Septiembre,Austria,2,4,,6,POINT (10406342 -75527794)
2013,Septiembre,Austria,1,2,,3,POINT (10446304 -75516486)
2013,Septiembre,Austria,0,3,,3,POINT (10886686 -74776479)
2013,Septiembre,Austria,3,5,,8,POINT (11360029 -72129595)
2013,Septiembre,Austria,2,3,,5,POINT (3451668 -76532004)
2013,Septiembre,Austria,68,180,,248,POINT (4697157 -74140516)
2013,Septiembre,Austria,3,15,,18,POINT (6170465 -7542726)
2013,Septiembre,Austria,3,0,,3,POINT (7819 -72453013)
2013,Septiembre,Austria,1,0,,1,POINT (863337 -7735002)
2013,Septiembre,Azerbaiyán,1,0,,1,POINT (4697157 -74140516)
2013,Septiembre,Bahamas,1,5,,6,POINT (10446304 -75516486)
2013,Septiembre,Bahamas,3,8,,11,POINT (4697157 -74140516)
2013,Septiembre,Bahamas,0,2,,2,POINT (6170465 -7542726)
2013,Septiembre,Bangladesh,0,3,,3,POINT (10446304 -75516486)
2013,Septiembre,Bangladesh,0,3,,3,POINT (4697157 -74140516)
2013,Septiembre,Bangladesh,1,0,,1,POINT (6170465 -7542726)
2013,Septiembre,Barbados,7,9,,16,POINT (10446304 -75516486)
2013,Septiembre,Barbados,0,8,,8,POINT (3451668 -76532004)
2013,Septiembre,Barbados,1,3,,4,POINT (4697157 -74140516)
2013,Septiembre,Barbados,1,0,,1,POINT (4815189 -75736374)
2013,Septiembre,Barbados,2,0,,2,POINT (6170465 -7542726)
2013,Septiembre,República de Belarús,1,4,,5,POINT (0.81488 -77356)
2013,Septiembre,República de Belarús,0,3,,3,POINT (4697157 -74140516)
2013,Septiembre,Bélgica,5,2,,7,POINT (0.81488 -77356)
2013,Septiembre,Bélgica,2,6,,8,POINT (10406342 -75527794)
2013,Septiembre,Bélgica,0,6,,6,POINT (10446304 -75516486)
2013,Septiembre,Bélgica,0,1,,1,POINT (10886686 -74776479)
2013,Septiembre,Bélgica,0,9,,9,POINT (11247723 -74213989)
2013,Septiembre,Bélgica,1,1,,2,POINT (11360029 -72129595)
2013,Septiembre,Bélgica,5,31,,36,POINT (3451668 -76532004)
2013,Septiembre,Bélgica,112,299,,411,POINT (4697157 -74140516)
2013,Septiembre,Bélgica,0,1,,1,POINT (4815189 -75736374)
2013,Septiembre,Bélgica,8,14,,22,POINT (6170465 -7542726)
2013,Septiembre,Bélgica,1,3,,4,POINT (7819 -72453013)
2013,Septiembre,Belice,0,4,,4,POINT (10446304 -75516486)
2013,Septiembre,Belice,4,19,,23,POINT (4697157 -74140516)
2013,Septiembre,Belice,0,1,,1,POINT (4815189 -75736374)
2013,Septiembre,Belice,0,1,,1,POINT (6170465 -7542726)
2013,Septiembre,Belice,0,2,,2,POINT (863337 -7735002)
2013,Septiembre,Benín,1,0,,1,POINT (4697157 -74140516)
2013,Septiembre,Bermudas/Territorio Británico de Ultramar,0,1,,1,POINT (10446304 -75516486)
2013,Septiembre,Bermudas/Territorio Británico de Ultramar,0,2,,2,POINT (3451668 -76532004)
2013,Septiembre,Bolivia,1,1,,2,POINT (-4191162 -69941498)
2013,Septiembre,Bolivia,9,27,,36,POINT (0.81488 -77356)
2013,Septiembre,Bolivia,3,3,,6,POINT (10406342 -75527794)
2013,Septiembre,Bolivia,20,36,,56,POINT (10446304 -75516486)
2013,Septiembre,Bolivia,2,0,,2,POINT (10886686 -74776479)
2013,Septiembre,Bolivia,1,0,,1,POINT (11360029 -72129595)
2013,Septiembre,Bolivia,1,1,,2,POINT (125862 -81702165)
2013,Septiembre,Bolivia,7,5,,12,POINT (3451668 -76532004)
2013,Septiembre,Bolivia,303,431,,734,POINT (4697157 -74140516)
2013,Septiembre,Bolivia,0,2,,2,POINT (4815189 -75736374)
2013,Septiembre,Bolivia,18,21,,39,POINT (6170465 -7542726)
2013,Septiembre,Bolivia,1,0,,1,POINT (7128047 -73181317)
2013,Septiembre,Bolivia,0,5,,5,POINT (7819 -72453013)
2013,Septiembre,Bolivia,1,0,,1,POINT (863337 -7735002)
2013,Septiembre,Botsuana,1,2,,3,POINT (4697157 -74140516)
2013,Septiembre,Brasil,68,82,,150,POINT (-4191162 -69941498)
2013,Septiembre,Brasil,12,19,,31,POINT (0.81488 -77356)
2013,Septiembre,Brasil,68,51,,119,POINT (10406342 -75527794)
2013,Septiembre,Brasil,259,235,,494,POINT (10446304 -75516486)
2013,Septiembre,Brasil,7,24,,31,POINT (10886686 -74776479)
2013,Septiembre,Brasil,1,3,,4,POINT (11247723 -74213989)
2013,Septiembre,Brasil,6,16,,22,POINT (11360029 -72129595)
2013,Septiembre,Brasil,26,9,,35,POINT (125862 -81702165)
2013,Septiembre,Brasil,15,92,,107,POINT (3451668 -76532004)
2013,Septiembre,Brasil,3085,4488,,7573,POINT (4697157 -74140516)
2013,Septiembre,Brasil,5,4,,9,POINT (4815189 -75736374)
2013,Septiembre,Brasil,89,212,,301,POINT (6170465 -7542726)
2013,Septiembre,Brasil,1,0,,1,POINT (7128047 -73181317)
2013,Septiembre,Brasil,9,14,,23,POINT (7819 -72453013)
2013,Septiembre,Brasil,0,1,,1,POINT (7927233 -72508188)
2013,Septiembre,Bulgaria,0,1,,1,POINT (10970933 -74765343)
2013,Septiembre,Bulgaria,10,13,,23,POINT (4697157 -74140516)
2013,Septiembre,Burkina Faso,0,1,,1,POINT (10446304 -75516486)
2013,Septiembre,Burkina Faso,0,1,,1,POINT (3451668 -76532004)
2013,Septiembre,Burkina Faso,2,7,,9,POINT (4697157 -74140516)
2013,Septiembre,Islas Caimán/Territorio Británico de Ultramar,1,0,,1,POINT (10886686 -74776479)
2013,Septiembre,Camerún,0,2,,2,POINT (10446304 -75516486)
2013,Septiembre,Camerún,0,4,,4,POINT (4697157 -74140516)
2013,Septiembre,Canadá,2,2,,4,POINT (-4191162 -69941498)
2013,Septiembre,Canadá,8,13,,21,POINT (0.81488 -77356)
2013,Septiembre,Canadá,10,35,,45,POINT (10406342 -75527794)
2013,Septiembre,Canadá,30,97,,127,POINT (10446304 -75516486)
2013,Septiembre,Canadá,3,19,,22,POINT (10886686 -74776479)
2013,Septiembre,Canadá,0,1,,1,POINT (10970933 -74765343)
2013,Septiembre,Canadá,1,0,,1,POINT (11247723 -74213989)
2013,Septiembre,Canadá,0,4,,4,POINT (125862 -81702165)
2013,Septiembre,Canadá,24,34,,58,POINT (3451668 -76532004)
2013,Septiembre,Canadá,2,1,,3,POINT (445285 -75766353)
2013,Septiembre,Canadá,508,1176,,1684,POINT (4697157 -74140516)
2013,Septiembre,Canadá,1,3,,4,POINT (4815189 -75736374)
2013,Septiembre,Canadá,55,168,,223,POINT (6170465 -7542726)
2013,Septiembre,Canadá,1,1,,2,POINT (7128047 -73181317)
2013,Septiembre,Canadá,0,3,,3,POINT (7819 -72453013)
2013,Septiembre,Canadá,0,1,,1,POINT (7927233 -72508188)
2013,Septiembre,Canadá,5,3,,8,POINT (863337 -7735002)
2013,Septiembre,Chad,0,2,,2,POINT (4697157 -74140516)
2013,Septiembre,España,5,9,,14,POINT (0.81488 -77356)
2013,Septiembre,España,1,7,,8,POINT (10886686 -74776479)
2013,Septiembre,España,0,1,,1,POINT (125744111 -81703935)
2013,Septiembre,España,0,1,,1,POINT (125862 -81702165)
2013,Septiembre,España,86,113,,199,POINT (3451668 -76532004)
2013,Septiembre,España,41,91,,132,POINT (4697157 -74140516)
2013,Septiembre,España,38,151,,189,POINT (6170465 -7542726)
2013,Septiembre,España,0,1,,1,POINT (7819 -72453013)
2013,Septiembre,República Democrática del Congo,0,2,,2,POINT (4697157 -74140516)
2013,Septiembre,República Democrática del Congo,1,0,,1,POINT (6170465 -7542726)
2013,Septiembre,República de Corea,0,1,,1,POINT (-4191162 -69941498)
2013,Septiembre,República de Corea,3,2,,5,POINT (0.81488 -77356)
2013,Septiembre,República de Corea,1,3,,4,POINT (10406342 -75527794)
2013,Septiembre,República de Corea,0,3,,3,POINT (10446304 -75516486)
2013,Septiembre,República de Corea,0,1,,1,POINT (10886686 -74776479)
2013,Septiembre,República de Corea,0,1,,1,POINT (11360029 -72129595)
2013,Septiembre,República de Corea,0,12,,12,POINT (3451668 -76532004)
2013,Septiembre,República de Corea,113,365,,478,POINT (4697157 -74140516)
2013,Septiembre,República de Corea,1,0,,1,POINT (4815189 -75736374)
2013,Septiembre,República de Corea,4,14,,18,POINT (6170465 -7542726)
2013,Septiembre,República de Corea,4,6,,10,POINT (7819 -72453013)
2013,Septiembre,Costa de Marfil,1,7,,8,POINT (4697157 -74140516)
2013,Septiembre,Costa Rica,0,3,,3,POINT (0.81488 -77356)
2013,Septiembre,Costa Rica,1,2,,3,POINT (10406342 -75527794)
2013,Septiembre,Costa Rica,36,46,,82,POINT (10446304 -75516486)
2013,Septiembre,Costa Rica,13,32,,45,POINT (10886686 -74776479)
2013,Septiembre,Costa Rica,272,197,,469,POINT (125862 -81702165)
2013,Septiembre,Costa Rica,14,57,,71,POINT (3451668 -76532004)
2013,Septiembre,Costa Rica,521,873,,1394,POINT (4697157 -74140516)
2013,Septiembre,Costa Rica,2,8,,10,POINT (4815189 -75736374)
2013,Septiembre,Costa Rica,85,198,,283,POINT (6170465 -7542726)
2013,Septiembre,Costa Rica,1,1,,2,POINT (7128047 -73181317)
2013,Septiembre,Costa Rica,2,2,,4,POINT (7819 -72453013)
2013,Septiembre,Costa Rica,0,1,,1,POINT (806667 -767333)
2013,Septiembre,Costa Rica,2,2,,4,POINT (863337 -7735002)
2013,Septiembre,Croacia,0,1,,1,POINT (10446304 -75516486)
2013,Septiembre,Croacia,0,1,,1,POINT (11247723 -74213989)
2013,Septiembre,Croacia,0,4,,4,POINT (3451668 -76532004)
2013,Septiembre,Croacia,5,22,,27,POINT (4697157 -74140516)
2013,Septiembre,Croacia,1,2,,3,POINT (6170465 -7542726)
2013,Septiembre,Cuba,7,14,,21,POINT (10446304 -75516486)
2013,Septiembre,Cuba,8,35,,43,POINT (10886686 -74776479)
2013,Septiembre,Cuba,0,1,,1,POINT (11360029 -72129595)
2013,Septiembre,Cuba,1,0,,1,POINT (125862 -81702165)
2013,Septiembre,Cuba,5,16,,21,POINT (3451668 -76532004)
2013,Septiembre,Cuba,0,1,,1,POINT (445285 -75766353)
2013,Septiembre,Cuba,91,165,,256,POINT (4697157 -74140516)
2013,Septiembre,Cuba,0,1,,1,POINT (4815189 -75736374)
2013,Septiembre,Cuba,5,30,,35,POINT (6170465 -7542726)
2013,Septiembre,Cuba,1,0,,1,POINT (6185536 -67484028)
2013,Septiembre,Cuba,1,2,,3,POINT (7128047 -73181317)
2013,Septiembre,Cuba,1,1,,2,POINT (7927233 -72508188)
2013,Septiembre,Curazao,1,2,,3,POINT (4697157 -74140516)
2013,Septiembre,Curazao,1,2,,3,POINT (6170465 -7542726)
2013,Septiembre,República Checa,0,1,,1,POINT (0.81488 -77356)
2013,Septiembre,República Checa,1,1,,2,POINT (10446304 -75516486)
2013,Septiembre,República Checa,1,2,,3,POINT (11360029 -72129595)
2013,Septiembre,República Checa,29,39,,68,POINT (4697157 -74140516)
2013,Septiembre,República Checa,1,3,,4,POINT (6170465 -7542726)
2013,Septiembre,Chile,3,2,,5,POINT (-4191162 -69941498)
2013,Septiembre,Chile,0,1,,1,POINT (0.33002 -76876446)
2013,Septiembre,Chile,19,43,,62,POINT (0.81488 -77356)
2013,Septiembre,Chile,218,161,,379,POINT (10406342 -75527794)
2013,Septiembre,Chile,156,133,,289,POINT (10446304 -75516486)
2013,Septiembre,Chile,9,23,,32,POINT (10886686 -74776479)
2013,Septiembre,Chile,1,11,,12,POINT (11360029 -72129595)
2013,Septiembre,Chile,33,20,,53,POINT (125862 -81702165)
2013,Septiembre,Chile,36,83,,119,POINT (3451668 -76532004)
2013,Septiembre,Chile,0,1,,1,POINT (3884426 -77061029)
2013,Septiembre,Chile,2953,3797,,6750,POINT (4697157 -74140516)
2013,Septiembre,Chile,2,3,,5,POINT (4815189 -75736374)
2013,Septiembre,Chile,76,172,,248,POINT (6170465 -7542726)
2013,Septiembre,Chile,0,1,,1,POINT (7088729 -70740253)
2013,Septiembre,Chile,1,2,,3,POINT (7128047 -73181317)
2013,Septiembre,Chile,9,19,,28,POINT (7819 -72453013)
2013,Septiembre,China,0,1,,1,POINT (-4191162 -69941498)
2013,Septiembre,China,2,3,,5,POINT (0.81488 -77356)
2013,Septiembre,China,1,5,,6,POINT (10446304 -75516486)
2013,Septiembre,China,0,6,,6,POINT (10886686 -74776479)
2013,Septiembre,China,0,2,,2,POINT (11247723 -74213989)
2013,Septiembre,China,0,2,,2,POINT (11360029 -72129595)
2013,Septiembre,China,2,9,,11,POINT (3451668 -76532004)
2013,Septiembre,China,113,341,,454,POINT (4697157 -74140516)
2013,Septiembre,China,10,14,,24,POINT (6170465 -7542726)
2013,Septiembre,China,0,1,,1,POINT (7819 -72453013)
2013,Septiembre,Taiwán,1,2,,3,POINT (0.81488 -77356)
2013,Septiembre,Taiwán,0,2,,2,POINT (10886686 -74776479)
2013,Septiembre,Taiwán,0,2,,2,POINT (3451668 -76532004)
2013,Septiembre,Taiwán,15,12,,27,POINT (4697157 -74140516)
2013,Septiembre,Taiwán,5,9,,14,POINT (6170465 -7542726)
2013,Septiembre,Chipre,2,3,,5,POINT (4697157 -74140516)
2013,Septiembre,Dinamarca,1,2,,3,POINT (0.81488 -77356)
2013,Septiembre,Dinamarca,1,2,,3,POINT (10406342 -75527794)
2013,Septiembre,Dinamarca,2,2,,4,POINT (10446304 -75516486)
2013,Septiembre,Dinamarca,0,1,,1,POINT (10886686 -74776479)
2013,Septiembre,Dinamarca,0,1,,1,POINT (11360029 -72129595)
2013,Septiembre,Dinamarca,0,4,,4,POINT (3451668 -76532004)
2013,Septiembre,Dinamarca,38,109,,147,POINT (4697157 -74140516)
2013,Septiembre,Dinamarca,1,2,,3,POINT (6170465 -7542726)
2013,Septiembre,Dinamarca,0,1,,1,POINT (7128047 -73181317)
2013,Septiembre,Dinamarca,0,1,,1,POINT (7819 -72453013)
2013,Septiembre,Dominica,3,1,,4,POINT (10446304 -75516486)
2013,Septiembre,Dominica,2,4,,6,POINT (4697157 -74140516)
2013,Septiembre,Ecuador,12,60,,72,POINT (0.33002 -76876446)
2013,Septiembre,Ecuador,951,1675,,2626,POINT (0.81488 -77356)
2013,Septiembre,Ecuador,2,116,,118,POINT (1800143 -78802679)
2013,Septiembre,Ecuador,4,21,,25,POINT (10406342 -75527794)
2013,Septiembre,Ecuador,46,174,,220,POINT (10446304 -75516486)
2013,Septiembre,Ecuador,81,307,,388,POINT (10886686 -74776479)
2013,Septiembre,Ecuador,15,14,,29,POINT (11360029 -72129595)
2013,Septiembre,Ecuador,3,8,,11,POINT (125862 -81702165)
2013,Septiembre,Ecuador,451,511,,962,POINT (3451668 -76532004)
2013,Septiembre,Ecuador,0,1,,1,POINT (445285 -75766353)
2013,Septiembre,Ecuador,1837,2883,,4720,POINT (4697157 -74140516)
2013,Septiembre,Ecuador,1,4,,5,POINT (4815189 -75736374)
2013,Septiembre,Ecuador,432,592,,1024,POINT (6170465 -7542726)
2013,Septiembre,Ecuador,1,0,,1,POINT (7128047 -73181317)
2013,Septiembre,Ecuador,140,199,,339,POINT (7819 -72453013)
2013,Septiembre,Ecuador,1,5,,6,POINT (7927233 -72508188)
2013,Septiembre,Ecuador,0,1,,1,POINT (863337 -7735002)
2013,Septiembre,Egipto,0,1,,1,POINT (10406342 -75527794)
2013,Septiembre,Egipto,0,3,,3,POINT (10446304 -75516486)
2013,Septiembre,Egipto,2,0,,2,POINT (3451668 -76532004)
2013,Septiembre,Egipto,1,21,,22,POINT (4697157 -74140516)
2013,Septiembre,El Salvador,0,2,,2,POINT (10406342 -75527794)
2013,Septiembre,El Salvador,16,20,,36,POINT (10446304 -75516486)
2013,Septiembre,El Salvador,2,4,,6,POINT (10886686 -74776479)
2013,Septiembre,El Salvador,0,1,,1,POINT (125862 -81702165)
2013,Septiembre,El Salvador,44,74,,118,POINT (3451668 -76532004)
2013,Septiembre,El Salvador,442,689,,1131,POINT (4697157 -74140516)
2013,Septiembre,El Salvador,0,1,,1,POINT (4815189 -75736374)
2013,Septiembre,El Salvador,31,71,,102,POINT (6170465 -7542726)
2013,Septiembre,El Salvador,0,1,,1,POINT (7102626 -77762647)
2013,Septiembre,El Salvador,0,2,,2,POINT (7128047 -73181317)
2013,Septiembre,Emiratos Árabes,1,9,,10,POINT (4697157 -74140516)
2013,Septiembre,España,3,7,,10,POINT (-4191162 -69941498)
2013,Septiembre,España,21,42,,63,POINT (0.81488 -77356)
2013,Septiembre,España,13,20,,33,POINT (10406342 -75527794)
2013,Septiembre,España,47,73,,120,POINT (10446304 -75516486)
2013,Septiembre,España,3,24,,27,POINT (10886686 -74776479)
2013,Septiembre,España,4,8,,12,POINT (11360029 -72129595)
2013,Septiembre,España,3,1,,4,POINT (125744111 -81703935)
2013,Septiembre,España,8,5,,13,POINT (125862 -81702165)
2013,Septiembre,España,160,312,,472,POINT (3451668 -76532004)
2013,Septiembre,España,0,1,,1,POINT (445285 -75766353)
2013,Septiembre,España,1766,5013,,6779,POINT (4697157 -74140516)
2013,Septiembre,España,0,9,,9,POINT (4815189 -75736374)
2013,Septiembre,España,72,187,,259,POINT (6170465 -7542726)
2013,Septiembre,España,2,0,,2,POINT (7088729 -70740253)
2013,Septiembre,España,0,3,,3,POINT (7128047 -73181317)
2013,Septiembre,España,4,25,,29,POINT (7819 -72453013)
2013,Septiembre,España,0,2,,2,POINT (7927233 -72508188)
2013,Septiembre,España,2,7,,9,POINT (863337 -7735002)
2013,Septiembre,Eslovaquia,1,0,,1,POINT (10406342 -75527794)
2013,Septiembre,Eslovaquia,1,5,,6,POINT (10446304 -75516486)
2013,Septiembre,Eslovaquia,0,1,,1,POINT (10886686 -74776479)
2013,Septiembre,Eslovaquia,1,1,,2,POINT (11360029 -72129595)
2013,Septiembre,Eslovaquia,1,0,,1,POINT (3451668 -76532004)
2013,Septiembre,Eslovaquia,8,13,,21,POINT (4697157 -74140516)
2013,Septiembre,Eslovaquia,0,1,,1,POINT (7819 -72453013)
2013,Septiembre,Eslovaquia,0,1,,1,POINT (863337 -7735002)
2013,Septiembre,Eslovenia,0,1,,1,POINT (10406342 -75527794)
2013,Septiembre,Eslovenia,0,1,,1,POINT (10446304 -75516486)
2013,Septiembre,Eslovenia,0,2,,2,POINT (11360029 -72129595)
2013,Septiembre,Eslovenia,5,19,,24,POINT (4697157 -74140516)
2013,Septiembre,Estados Unidos de América,8,27,,35,POINT (-4191162 -69941498)
2013,Septiembre,Estados Unidos de América,23,47,,70,POINT (0.81488 -77356)
2013,Septiembre,Estados Unidos de América,23,40,,63,POINT (10406342 -75527794)
2013,Septiembre,Estados Unidos de América,806,1695,,2501,POINT (10446304 -75516486)
2013,Septiembre,Estados Unidos de América,159,442,,601,POINT (10886686 -74776479)
2013,Septiembre,Estados Unidos de América,1,1,,2,POINT (10970933 -74765343)
2013,Septiembre,Estados Unidos de América,0,4,,4,POINT (11247723 -74213989)
2013,Septiembre,Estados Unidos de América,5,8,,13,POINT (11360029 -72129595)
2013,Septiembre,Estados Unidos de América,0,3,,3,POINT (1152863 -72919186)
2013,Septiembre,Estados Unidos de América,0,3,,3,POINT (125744111 -81703935)
2013,Septiembre,Estados Unidos de América,13,21,,34,POINT (125862 -81702165)
2013,Septiembre,Estados Unidos de América,1,1,,2,POINT (133387613 -81372937)
2013,Septiembre,Estados Unidos de América,456,875,,1331,POINT (3451668 -76532004)
2013,Septiembre,Estados Unidos de América,52,83,,135,POINT (445285 -75766353)
2013,Septiembre,Estados Unidos de América,4176,9603,,13779,POINT (4697157 -74140516)
2013,Septiembre,Estados Unidos de América,51,114,,165,POINT (4815189 -75736374)
2013,Septiembre,Estados Unidos de América,829,2344,,3173,POINT (6170465 -7542726)
2013,Septiembre,Estados Unidos de América,1,4,,5,POINT (7088729 -70740253)
2013,Septiembre,Estados Unidos de América,0,1,,1,POINT (7102626 -77762647)
2013,Septiembre,Estados Unidos de América,12,35,,47,POINT (7128047 -73181317)
2013,Septiembre,Estados Unidos de América,17,41,,58,POINT (7819 -72453013)
2013,Septiembre,Estados Unidos de América,11,11,,22,POINT (7927233 -72508188)
2013,Septiembre,Estados Unidos de América,8,10,,18,POINT (863337 -7735002)
2013,Septiembre,Estonia,0,1,,1,POINT (10886686 -74776479)
2013,Septiembre,Estonia,5,4,,9,POINT (4697157 -74140516)
2013,Septiembre,Etiopia,3,7,,10,POINT (4697157 -74140516)
2013,Septiembre,Filipinas,0,1,,1,POINT (0.81488 -77356)
2013,Septiembre,Filipinas,0,1,,1,POINT (1800143 -78802679)
2013,Septiembre,Filipinas,0,61,,61,POINT (10406342 -75527794)
2013,Septiembre,Filipinas,1,30,,31,POINT (10446304 -75516486)
2013,Septiembre,Filipinas,0,7,,7,POINT (10886686 -74776479)
2013,Septiembre,Filipinas,0,28,,28,POINT (10970933 -74765343)
2013,Septiembre,Filipinas,0,2,,2,POINT (11247723 -74213989)
2013,Septiembre,Filipinas,1,12,,13,POINT (3451668 -76532004)
2013,Septiembre,Filipinas,0,16,,16,POINT (3884426 -77061029)
2013,Septiembre,Filipinas,19,100,,119,POINT (4697157 -74140516)
2013,Septiembre,Filipinas,3,3,,6,POINT (6170465 -7542726)
2013,Septiembre,Filipinas,1,0,,1,POINT (7128047 -73181317)
2013,Septiembre,Filipinas,0,1,,1,POINT (806667 -767333)
2013,Septiembre,Finlandia,1,0,,1,POINT (-4191162 -69941498)
2013,Septiembre,Finlandia,1,0,,1,POINT (0.81488 -77356)
2013,Septiembre,Finlandia,0,3,,3,POINT (10886686 -74776479)
2013,Septiembre,Finlandia,1,1,,2,POINT (11360029 -72129595)
2013,Septiembre,Finlandia,0,1,,1,POINT (3451668 -76532004)
2013,Septiembre,Finlandia,24,54,,78,POINT (4697157 -74140516)
2013,Septiembre,Finlandia,1,6,,7,POINT (6170465 -7542726)
2013,Septiembre,Francia,8,9,,17,POINT (-4191162 -69941498)
2013,Septiembre,Francia,0,1,,1,POINT (0.33002 -76876446)
2013,Septiembre,Francia,17,26,,43,POINT (0.81488 -77356)
2013,Septiembre,Francia,6,13,,19,POINT (10406342 -75527794)
2013,Septiembre,Francia,23,49,,72,POINT (10446304 -75516486)
2013,Septiembre,Francia,1,8,,9,POINT (10886686 -74776479)
2013,Septiembre,Francia,1,1,,2,POINT (11247723 -74213989)
2013,Septiembre,Francia,2,6,,8,POINT (11360029 -72129595)
2013,Septiembre,Francia,2,1,,3,POINT (1152863 -72919186)
2013,Septiembre,Francia,0,1,,1,POINT (125862 -81702165)
2013,Septiembre,Francia,25,61,,86,POINT (3451668 -76532004)
2013,Septiembre,Francia,0,1,,1,POINT (445285 -75766353)
2013,Septiembre,Francia,687,1484,,2171,POINT (4697157 -74140516)
2013,Septiembre,Francia,0,3,,3,POINT (4815189 -75736374)
2013,Septiembre,Francia,34,93,,127,POINT (6170465 -7542726)
2013,Septiembre,Francia,3,12,,15,POINT (7819 -72453013)
2013,Septiembre,Francia,0,2,,2,POINT (7927233 -72508188)
2013,Septiembre,Francia,3,5,,8,POINT (863337 -7735002)
2013,Septiembre,Gabón,1,4,,5,POINT (4697157 -74140516)
2013,Septiembre,Georgia,1,0,,1,POINT (0.81488 -77356)
2013,Septiembre,Georgia,0,1,,1,POINT (10970933 -74765343)
2013,Septiembre,Ghana,0,2,,2,POINT (10446304 -75516486)
2013,Septiembre,Ghana,1,5,,6,POINT (4697157 -74140516)
2013,Septiembre,Gibraltar/Territorio Británico de Ultramar,1,0,,1,POINT (4697157 -74140516)
2013,Septiembre,Granada,2,1,,3,POINT (10446304 -75516486)
2013,Septiembre,Granada,3,1,,4,POINT (4697157 -74140516)
2013,Septiembre,Grecia,0,5,,5,POINT (10406342 -75527794)
2013,Septiembre,Grecia,0,1,,1,POINT (10886686 -74776479)
2013,Septiembre,Grecia,1,9,,10,POINT (10970933 -74765343)
2013,Septiembre,Grecia,0,3,,3,POINT (3451668 -76532004)
2013,Septiembre,Grecia,21,49,,70,POINT (4697157 -74140516)
2013,Septiembre,Grecia,1,1,,2,POINT (6170465 -7542726)
2013,Septiembre,Grecia,3,2,,5,POINT (7927233 -72508188)
2013,Septiembre,Guatemala,2,6,,8,POINT (0.81488 -77356)
2013,Septiembre,Guatemala,1,2,,3,POINT (10406342 -75527794)
2013,Septiembre,Guatemala,24,45,,69,POINT (10446304 -75516486)
2013,Septiembre,Guatemala,3,4,,7,POINT (10886686 -74776479)
2013,Septiembre,Guatemala,1,0,,1,POINT (11360029 -72129595)
2013,Septiembre,Guatemala,28,31,,59,POINT (125862 -81702165)
2013,Septiembre,Guatemala,32,86,,118,POINT (3451668 -76532004)
2013,Septiembre,Guatemala,0,2,,2,POINT (445285 -75766353)
2013,Septiembre,Guatemala,203,454,,657,POINT (4697157 -74140516)
2013,Septiembre,Guatemala,0,6,,6,POINT (4815189 -75736374)
2013,Septiembre,Guatemala,30,84,,114,POINT (6170465 -7542726)
2013,Septiembre,Guatemala,1,6,,7,POINT (7128047 -73181317)
2013,Septiembre,Guatemala,0,8,,8,POINT (7819 -72453013)
2013,Septiembre,Guatemala,1,0,,1,POINT (7927233 -72508188)
2013,Septiembre,Guyana,0,1,,1,POINT (-4191162 -69941498)
2013,Septiembre,Guyana,0,1,,1,POINT (0.81488 -77356)
2013,Septiembre,Guyana,0,1,,1,POINT (10406342 -75527794)
2013,Septiembre,Guyana,1,0,,1,POINT (10446304 -75516486)
2013,Septiembre,Guyana,0,1,,1,POINT (3451668 -76532004)
2013,Septiembre,Guyana,10,12,,22,POINT (4697157 -74140516)
2013,Septiembre,Guyana,2,4,,6,POINT (6170465 -7542726)
2013,Septiembre,Guinea Ecuatorial,1,1,,2,POINT (4697157 -74140516)
2013,Septiembre,Haití,2,2,,4,POINT (10446304 -75516486)
2013,Septiembre,Haití,0,2,,2,POINT (10886686 -74776479)
2013,Septiembre,Haití,3,5,,8,POINT (3451668 -76532004)
2013,Septiembre,Haití,3,21,,24,POINT (4697157 -74140516)
2013,Septiembre,Haití,3,7,,10,POINT (6170465 -7542726)
2013,Septiembre,Honduras,0,5,,5,POINT (10406342 -75527794)
2013,Septiembre,Honduras,25,29,,54,POINT (10446304 -75516486)
2013,Septiembre,Honduras,2,11,,13,POINT (10886686 -74776479)
2013,Septiembre,Honduras,0,5,,5,POINT (125744111 -81703935)
2013,Septiembre,Honduras,0,1,,1,POINT (125862 -81702165)
2013,Septiembre,Honduras,18,35,,53,POINT (3451668 -76532004)
2013,Septiembre,Honduras,166,216,,382,POINT (4697157 -74140516)
2013,Septiembre,Honduras,0,2,,2,POINT (4815189 -75736374)
2013,Septiembre,Honduras,17,37,,54,POINT (6170465 -7542726)
2013,Septiembre,Honduras,0,2,,2,POINT (7128047 -73181317)
2013,Septiembre,Honduras,1,0,,1,POINT (7819 -72453013)
2013,Septiembre,Honduras,0,2,,2,POINT (7927233 -72508188)
2013,Septiembre,Honduras,0,2,,2,POINT (806667 -767333)
2013,Septiembre,Honduras,1,0,,1,POINT (863337 -7735002)
2013,Septiembre,Hong Kong,0,1,,1,POINT (4697157 -74140516)
2013,Septiembre,Hungría,1,1,,2,POINT (10406342 -75527794)
2013,Septiembre,Hungría,1,4,,5,POINT (10446304 -75516486)
2013,Septiembre,Hungría,2,1,,3,POINT (3451668 -76532004)
2013,Septiembre,Hungría,19,24,,43,POINT (4697157 -74140516)
2013,Septiembre,Hungría,0,1,,1,POINT (4815189 -75736374)
2013,Septiembre,Hungría,0,3,,3,POINT (6170465 -7542726)
2013,Septiembre,India,0,2,,2,POINT (10406342 -75527794)
2013,Septiembre,India,1,10,,11,POINT (10446304 -75516486)
2013,Septiembre,India,0,7,,7,POINT (10886686 -74776479)
2013,Septiembre,India,0,1,,1,POINT (10970933 -74765343)
2013,Septiembre,India,0,1,,1,POINT (11360029 -72129595)
2013,Septiembre,India,4,8,,12,POINT (3451668 -76532004)
2013,Septiembre,India,27,197,,224,POINT (4697157 -74140516)
2013,Septiembre,India,0,1,,1,POINT (4815189 -75736374)
2013,Septiembre,India,3,29,,32,POINT (6170465 -7542726)
2013,Septiembre,Indonesia,0,1,,1,POINT (10406342 -75527794)
2013,Septiembre,Indonesia,0,1,,1,POINT (10446304 -75516486)
2013,Septiembre,Indonesia,0,6,,6,POINT (10886686 -74776479)
2013,Septiembre,Indonesia,0,11,,11,POINT (10970933 -74765343)
2013,Septiembre,Indonesia,1,0,,1,POINT (3451668 -76532004)
2013,Septiembre,Indonesia,9,19,,28,POINT (4697157 -74140516)
2013,Septiembre,Iraq,0,1,,1,POINT (4697157 -74140516)
2013,Septiembre,Irán,1,1,,2,POINT (10446304 -75516486)
2013,Septiembre,Irán,0,1,,1,POINT (3451668 -76532004)
2013,Septiembre,Irán,3,6,,9,POINT (4697157 -74140516)
2013,Septiembre,República de Irlanda,2,0,,2,POINT (-4191162 -69941498)
2013,Septiembre,República de Irlanda,5,5,,10,POINT (0.81488 -77356)
2013,Septiembre,República de Irlanda,5,9,,14,POINT (10406342 -75527794)
2013,Septiembre,República de Irlanda,3,10,,13,POINT (10446304 -75516486)
2013,Septiembre,República de Irlanda,0,1,,1,POINT (10886686 -74776479)
2013,Septiembre,República de Irlanda,1,5,,6,POINT (3451668 -76532004)
2013,Septiembre,República de Irlanda,63,127,,190,POINT (4697157 -74140516)
2013,Septiembre,República de Irlanda,7,20,,27,POINT (6170465 -7542726)
2013,Septiembre,República de Irlanda,1,2,,3,POINT (863337 -7735002)
2013,Septiembre,Islandia,1,0,,1,POINT (10446304 -75516486)
2013,Septiembre,Islandia,0,10,,10,POINT (10970933 -74765343)
2013,Septiembre,Islandia,1,3,,4,POINT (4697157 -74140516)
2013,Septiembre,Islandia,0,11,,11,POINT (7819 -72453013)
2013,Septiembre,Islandia,0,10,,10,POINT (7927233 -72508188)
2013,Septiembre,Isla de Man,3,9,,12,POINT (0.81488 -77356)
2013,Septiembre,Isla de Man,4,14,,18,POINT (3451668 -76532004)
2013,Septiembre,Isla de Man,12,23,,35,POINT (4697157 -74140516)
2013,Septiembre,Isla de Man,21,42,,63,POINT (6170465 -7542726)
2013,Septiembre,Isla de Man,1,0,,1,POINT (7128047 -73181317)
2013,Septiembre,Isla Johnston,0,2,,2,POINT (6170465 -7542726)
2013,Septiembre,Israel,1,2,,3,POINT (-4191162 -69941498)
2013,Septiembre,Israel,4,18,,22,POINT (0.81488 -77356)
2013,Septiembre,Israel,1,4,,5,POINT (10406342 -75527794)
2013,Septiembre,Israel,5,40,,45,POINT (10446304 -75516486)
2013,Septiembre,Israel,2,1,,3,POINT (10886686 -74776479)
2013,Septiembre,Israel,3,2,,5,POINT (125862 -81702165)
2013,Septiembre,Israel,11,16,,27,POINT (3451668 -76532004)
2013,Septiembre,Israel,73,312,,385,POINT (4697157 -74140516)
2013,Septiembre,Israel,4,27,,31,POINT (6170465 -7542726)
2013,Septiembre,Israel,0,4,,4,POINT (863337 -7735002)
2013,Septiembre,Italia,1,2,,3,POINT (-4191162 -69941498)
2013,Septiembre,Italia,9,15,,24,POINT (0.81488 -77356)
2013,Septiembre,Italia,4,5,,9,POINT (10406342 -75527794)
2013,Septiembre,Italia,16,51,,67,POINT (10446304 -75516486)
2013,Septiembre,Italia,2,9,,11,POINT (10886686 -74776479)
2013,Septiembre,Italia,3,12,,15,POINT (11360029 -72129595)
2013,Septiembre,Italia,9,9,,18,POINT (125862 -81702165)
2013,Septiembre,Italia,21,85,,106,POINT (3451668 -76532004)
2013,Septiembre,Italia,350,1347,,1697,POINT (4697157 -74140516)
2013,Septiembre,Italia,0,2,,2,POINT (4815189 -75736374)
2013,Septiembre,Italia,26,99,,125,POINT (6170465 -7542726)
2013,Septiembre,Italia,1,0,,1,POINT (7088729 -70740253)
2013,Septiembre,Italia,0,3,,3,POINT (7128047 -73181317)
2013,Septiembre,Italia,3,14,,17,POINT (7819 -72453013)
2013,Septiembre,Italia,3,0,,3,POINT (7927233 -72508188)
2013,Septiembre,Italia,0,2,,2,POINT (863337 -7735002)
2013,Septiembre,Islas del Canal,1,6,,7,POINT (10886686 -74776479)
2013,Septiembre,Islas del Canal,0,1,,1,POINT (7819 -72453013)
2013,Septiembre,Jamaica,6,6,,12,POINT (10446304 -75516486)
2013,Septiembre,Jamaica,0,2,,2,POINT (125862 -81702165)
2013,Septiembre,Jamaica,2,5,,7,POINT (3451668 -76532004)
2013,Septiembre,Jamaica,11,24,,35,POINT (4697157 -74140516)
2013,Septiembre,Jamaica,1,0,,1,POINT (4815189 -75736374)
2013,Septiembre,Jamaica,0,7,,7,POINT (6170465 -7542726)
2013,Septiembre,Jamaica,0,1,,1,POINT (7819 -72453013)
2013,Septiembre,Japón,0,1,,1,POINT (-4191162 -69941498)
2013,Septiembre,Japón,3,6,,9,POINT (0.81488 -77356)
2013,Septiembre,Japón,3,16,,19,POINT (10446304 -75516486)
2013,Septiembre,Japón,1,8,,9,POINT (10886686 -74776479)
2013,Septiembre,Japón,1,1,,2,POINT (125862 -81702165)
2013,Septiembre,Japón,5,12,,17,POINT (3451668 -76532004)
2013,Septiembre,Japón,104,418,,522,POINT (4697157 -74140516)
2013,Septiembre,Japón,3,1,,4,POINT (4815189 -75736374)
2013,Septiembre,Japón,9,32,,41,POINT (6170465 -7542726)
2013,Septiembre,Japón,2,1,,3,POINT (7128047 -73181317)
2013,Septiembre,Japón,3,2,,5,POINT (7819 -72453013)
2013,Septiembre,Japón,1,2,,3,POINT (863337 -7735002)
2013,Septiembre,Jordania,0,5,,5,POINT (4697157 -74140516)
2013,Septiembre,Kazajistán,0,2,,2,POINT (0.81488 -77356)
2013,Septiembre,Kazajistán,4,4,,8,POINT (4697157 -74140516)
2013,Septiembre,Kenia,0,1,,1,POINT (10446304 -75516486)
2013,Septiembre,Kenia,0,1,,1,POINT (3451668 -76532004)
2013,Septiembre,Kenia,9,13,,22,POINT (4697157 -74140516)
2013,Septiembre,Kenia,0,2,,2,POINT (6170465 -7542726)
2013,Septiembre,Kirguistán,0,1,,1,POINT (4697157 -74140516)
2013,Septiembre,Kuwait,0,4,,4,POINT (10446304 -75516486)
2013,Septiembre,Kuwait,0,2,,2,POINT (4697157 -74140516)
2013,Septiembre,República de Kosovo,1,0,,1,POINT (4697157 -74140516)
2013,Septiembre,Letonia,0,1,,1,POINT (10406342 -75527794)
2013,Septiembre,Letonia,2,1,,3,POINT (10446304 -75516486)
2013,Septiembre,Letonia,1,1,,2,POINT (3451668 -76532004)
2013,Septiembre,Letonia,6,5,,11,POINT (4697157 -74140516)
2013,Septiembre,Lituania,1,0,,1,POINT (-4191162 -69941498)
2013,Septiembre,Lituania,1,1,,2,POINT (10446304 -75516486)
2013,Septiembre,Lituania,13,10,,23,POINT (4697157 -74140516)
2013,Septiembre,Lituania,2,1,,3,POINT (6170465 -7542726)
2013,Septiembre,Líbano,3,5,,8,POINT (11360029 -72129595)
2013,Septiembre,Líbano,1,2,,3,POINT (3451668 -76532004)
2013,Septiembre,Líbano,21,27,,48,POINT (4697157 -74140516)
2013,Septiembre,Líbano,0,1,,1,POINT (6170465 -7542726)
2013,Septiembre,Liberia,1,0,,1,POINT (4697157 -74140516)
2013,Septiembre,Liechtenstein,3,2,,5,POINT (4697157 -74140516)
2013,Septiembre,Luxemburgo,0,1,,1,POINT (10446304 -75516486)
2013,Septiembre,Luxemburgo,3,8,,11,POINT (4697157 -74140516)
2013,Septiembre,Macedonia,1,1,,2,POINT (4697157 -74140516)
2013,Septiembre,Madagascar,0,1,,1,POINT (4697157 -74140516)
2013,Septiembre,Malasia,2,2,,4,POINT (10446304 -75516486)
2013,Septiembre,Malasia,1,0,,1,POINT (10886686 -74776479)
2013,Septiembre,Malasia,0,1,,1,POINT (11247723 -74213989)
2013,Septiembre,Malasia,7,25,,32,POINT (4697157 -74140516)
2013,Septiembre,Malasia,1,0,,1,POINT (4815189 -75736374)
2013,Septiembre,Malasia,1,0,,1,POINT (6170465 -7542726)
2013,Septiembre,Malasia,1,0,,1,POINT (7819 -72453013)
2013,Septiembre,Malawi,1,2,,3,POINT (3451668 -76532004)
2013,Septiembre,Malí,2,2,,4,POINT (4697157 -74140516)
2013,Septiembre,Malta,1,0,,1,POINT (125862 -81702165)
2013,Septiembre,Malta,3,2,,5,POINT (4697157 -74140516)
2013,Septiembre,Marruecos,0,1,,1,POINT (11247723 -74213989)
2013,Septiembre,Marruecos,7,7,,14,POINT (4697157 -74140516)
2013,Septiembre,Mauricio,1,0,,1,POINT (4697157 -74140516)
2013,Septiembre,Mauritania,3,1,,4,POINT (4697157 -74140516)
2013,Septiembre,México,3,1,,4,POINT (-4191162 -69941498)
2013,Septiembre,México,12,19,,31,POINT (0.81488 -77356)
2013,Septiembre,México,17,30,,47,POINT (10406342 -75527794)
2013,Septiembre,México,113,233,,346,POINT (10446304 -75516486)
2013,Septiembre,México,32,61,,93,POINT (10886686 -74776479)
2013,Septiembre,México,3,5,,8,POINT (11360029 -72129595)
2013,Septiembre,México,2,2,,4,POINT (125862 -81702165)
2013,Septiembre,México,42,135,,177,POINT (3451668 -76532004)
2013,Septiembre,México,1,0,,1,POINT (445285 -75766353)
2013,Septiembre,México,2528,5245,,7773,POINT (4697157 -74140516)
2013,Septiembre,México,3,18,,21,POINT (4815189 -75736374)
2013,Septiembre,México,107,363,,470,POINT (6170465 -7542726)
2013,Septiembre,México,3,7,,10,POINT (7128047 -73181317)
2013,Septiembre,México,9,26,,35,POINT (7819 -72453013)
2013,Septiembre,México,3,6,,9,POINT (7927233 -72508188)
2013,Septiembre,México,10,13,,23,POINT (863337 -7735002)
2013,Septiembre,República de Moldavia,4,0,,4,POINT (4697157 -74140516)
2013,Septiembre,Mongolia,2,0,,2,POINT (4697157 -74140516)
2013,Septiembre,Mozambique,1,0,,1,POINT (3451668 -76532004)
2013,Septiembre,Mozambique,1,3,,4,POINT (4697157 -74140516)
2013,Septiembre,Namibia,2,5,,7,POINT (4697157 -74140516)
2013,Septiembre,Nepal,0,1,,1,POINT (3451668 -76532004)
2013,Septiembre,Nepal,0,2,,2,POINT (4697157 -74140516)
2013,Septiembre,Nicaragua,1,5,,6,POINT (10406342 -75527794)
2013,Septiembre,Nicaragua,7,13,,20,POINT (10446304 -75516486)
2013,Septiembre,Nicaragua,0,1,,1,POINT (10886686 -74776479)
2013,Septiembre,Nicaragua,0,1,,1,POINT (125744111 -81703935)
2013,Septiembre,Nicaragua,4,0,,4,POINT (125862 -81702165)
2013,Septiembre,Nicaragua,4,11,,15,POINT (3451668 -76532004)
2013,Septiembre,Nicaragua,46,80,,126,POINT (4697157 -74140516)
2013,Septiembre,Nicaragua,1,1,,2,POINT (4815189 -75736374)
2013,Septiembre,Nicaragua,12,18,,30,POINT (6170465 -7542726)
2013,Septiembre,Nicaragua,1,1,,2,POINT (7128047 -73181317)
2013,Septiembre,Nicaragua,1,0,,1,POINT (7927233 -72508188)
2013,Septiembre,Nigeria,0,2,,2,POINT (10446304 -75516486)
2013,Septiembre,Nigeria,0,1,,1,POINT (3451668 -76532004)
2013,Septiembre,Nigeria,3,16,,19,POINT (4697157 -74140516)
2013,Septiembre,Nigeria,0,1,,1,POINT (7819 -72453013)
2013,Septiembre,Níger,0,5,,5,POINT (4697157 -74140516)
2013,Septiembre,Noruega,0,6,,6,POINT (10406342 -75527794)
2013,Septiembre,Noruega,1,9,,10,POINT (10446304 -75516486)
2013,Septiembre,Noruega,0,1,,1,POINT (10886686 -74776479)
2013,Septiembre,Noruega,0,7,,7,POINT (3451668 -76532004)
2013,Septiembre,Noruega,35,92,,127,POINT (4697157 -74140516)
2013,Septiembre,Noruega,3,4,,7,POINT (6170465 -7542726)
2013,Septiembre,Noruega,1,1,,2,POINT (7819 -72453013)
2013,Septiembre,Nueva Zelanda,1,2,,3,POINT (-4191162 -69941498)
2013,Septiembre,Nueva Zelanda,5,8,,13,POINT (0.81488 -77356)
2013,Septiembre,Nueva Zelanda,2,7,,9,POINT (10446304 -75516486)
2013,Septiembre,Nueva Zelanda,1,4,,5,POINT (3451668 -76532004)
2013,Septiembre,Nueva Zelanda,24,58,,82,POINT (4697157 -74140516)
2013,Septiembre,Nueva Zelanda,0,8,,8,POINT (6170465 -7542726)
2013,Septiembre,Nueva Zelanda,1,0,,1,POINT (863337 -7735002)
2013,Septiembre,Omán,0,1,,1,POINT (4697157 -74140516)
2013,Septiembre,Nueva Zelanda,0,6,,6,POINT (10406342 -75527794)
2013,Septiembre,Nueva Zelanda,0,1,,1,POINT (10886686 -74776479)
2013,Septiembre,Nueva Zelanda,0,1,,1,POINT (3451668 -76532004)
2013,Septiembre,Nueva Zelanda,1,1,,2,POINT (4697157 -74140516)
2013,Septiembre,Nueva Zelanda,0,1,,1,POINT (7819 -72453013)
2013,Septiembre,Nueva Zelanda,0,1,,1,POINT (7927233 -72508188)
2013,Septiembre,Países Bajos,0,3,,3,POINT (0.81488 -77356)
2013,Septiembre,Países Bajos,1,1,,2,POINT (10406342 -75527794)
2013,Septiembre,Países Bajos,9,50,,59,POINT (10446304 -75516486)
2013,Septiembre,Países Bajos,0,3,,3,POINT (10886686 -74776479)
2013,Septiembre,Países Bajos,2,5,,7,POINT (11360029 -72129595)
2013,Septiembre,Países Bajos,6,15,,21,POINT (1152863 -72919186)
2013,Septiembre,Países Bajos,7,26,,33,POINT (3451668 -76532004)
2013,Septiembre,Países Bajos,373,676,,1049,POINT (4697157 -74140516)
2013,Septiembre,Países Bajos,0,5,,5,POINT (4815189 -75736374)
2013,Septiembre,Países Bajos,183,252,,435,POINT (6170465 -7542726)
2013,Septiembre,Países Bajos,4,2,,6,POINT (7128047 -73181317)
2013,Septiembre,Pakistán,0,2,,2,POINT (0.81488 -77356)
2013,Septiembre,Pakistán,0,1,,1,POINT (10446304 -75516486)
2013,Septiembre,Pakistán,0,1,,1,POINT (3451668 -76532004)
2013,Septiembre,Pakistán,0,7,,7,POINT (4697157 -74140516)
2013,Septiembre,Panamá,1,18,,19,POINT (10406342 -75527794)
2013,Septiembre,Panamá,140,201,,341,POINT (10446304 -75516486)
2013,Septiembre,Panamá,51,96,,147,POINT (10886686 -74776479)
2013,Septiembre,Panamá,0,1,,1,POINT (10970933 -74765343)
2013,Septiembre,Panamá,1,2,,3,POINT (11247723 -74213989)
2013,Septiembre,Panamá,0,2,,2,POINT (11360029 -72129595)
2013,Septiembre,Panamá,0,4,,4,POINT (125744111 -81703935)
2013,Septiembre,Panamá,55,36,,91,POINT (125862 -81702165)
2013,Septiembre,Panamá,139,129,,268,POINT (3451668 -76532004)
2013,Septiembre,Panamá,0,3,,3,POINT (3884426 -77061029)
2013,Septiembre,Panamá,550,812,,1362,POINT (4697157 -74140516)
2013,Septiembre,Panamá,67,97,,164,POINT (4815189 -75736374)
2013,Septiembre,Panamá,146,260,,406,POINT (6170465 -7542726)
2013,Septiembre,Panamá,1,0,,1,POINT (7088729 -70740253)
2013,Septiembre,Panamá,0,1,,1,POINT (7102626 -77762647)
2013,Septiembre,Panamá,12,15,,27,POINT (7128047 -73181317)
2013,Septiembre,Panamá,1,1,,2,POINT (7819 -72453013)
2013,Septiembre,Panamá,4,9,,13,POINT (7927233 -72508188)
2013,Septiembre,Panamá,3,5,,8,POINT (863337 -7735002)
2013,Septiembre,Paraguay,0,2,,2,POINT (0.81488 -77356)
2013,Septiembre,Paraguay,1,1,,2,POINT (10406342 -75527794)
2013,Septiembre,Paraguay,44,46,,90,POINT (10446304 -75516486)
2013,Septiembre,Paraguay,0,5,,5,POINT (10886686 -74776479)
2013,Septiembre,Paraguay,4,1,,5,POINT (125862 -81702165)
2013,Septiembre,Paraguay,3,5,,8,POINT (3451668 -76532004)
2013,Septiembre,Paraguay,73,106,,179,POINT (4697157 -74140516)
2013,Septiembre,Paraguay,10,33,,43,POINT (6170465 -7542726)
2013,Septiembre,Paraguay,0,1,,1,POINT (7819 -72453013)
2013,Septiembre,Perú,6,20,,26,POINT (-4191162 -69941498)
2013,Septiembre,Perú,163,373,,536,POINT (0.81488 -77356)
2013,Septiembre,Perú,1,0,,1,POINT (1800143 -78802679)
2013,Septiembre,Perú,15,9,,24,POINT (10406342 -75527794)
2013,Septiembre,Perú,273,231,,504,POINT (10446304 -75516486)
2013,Septiembre,Perú,26,39,,65,POINT (10886686 -74776479)
2013,Septiembre,Perú,0,1,,1,POINT (10970933 -74765343)
2013,Septiembre,Perú,0,2,,2,POINT (11247723 -74213989)
2013,Septiembre,Perú,15,50,,65,POINT (11360029 -72129595)
2013,Septiembre,Perú,0,3,,3,POINT (125744111 -81703935)
2013,Septiembre,Perú,167,98,,265,POINT (125862 -81702165)
2013,Septiembre,Perú,83,171,,254,POINT (3451668 -76532004)
2013,Septiembre,Perú,0,1,,1,POINT (3884426 -77061029)
2013,Septiembre,Perú,0,1,,1,POINT (445285 -75766353)
2013,Septiembre,Perú,2414,3201,,5615,POINT (4697157 -74140516)
2013,Septiembre,Perú,4,6,,10,POINT (4815189 -75736374)
2013,Septiembre,Perú,251,426,,677,POINT (6170465 -7542726)
2013,Septiembre,Perú,0,2,,2,POINT (6185536 -67484028)
2013,Septiembre,Perú,1,0,,1,POINT (7088729 -70740253)
2013,Septiembre,Perú,2,5,,7,POINT (7128047 -73181317)
2013,Septiembre,Perú,65,97,,162,POINT (7819 -72453013)
2013,Septiembre,Perú,0,7,,7,POINT (7927233 -72508188)
2013,Septiembre,Perú,0,1,,1,POINT (863337 -7735002)
2013,Septiembre,Palestina,0,1,,1,POINT (4697157 -74140516)
2013,Septiembre,Polonia,1,2,,3,POINT (-4191162 -69941498)
2013,Septiembre,Polonia,3,4,,7,POINT (0.81488 -77356)
2013,Septiembre,Polonia,1,3,,4,POINT (10406342 -75527794)
2013,Septiembre,Polonia,1,6,,7,POINT (10446304 -75516486)
2013,Septiembre,Polonia,1,1,,2,POINT (10886686 -74776479)
2013,Septiembre,Polonia,0,2,,2,POINT (10970933 -74765343)
2013,Septiembre,Polonia,1,1,,2,POINT (3451668 -76532004)
2013,Septiembre,Polonia,1,0,,1,POINT (3884426 -77061029)
2013,Septiembre,Polonia,59,96,,155,POINT (4697157 -74140516)
2013,Septiembre,Polonia,2,3,,5,POINT (6170465 -7542726)
2013,Septiembre,Polonia,0,1,,1,POINT (7128047 -73181317)
2013,Septiembre,Polonia,1,0,,1,POINT (7819 -72453013)
2013,Septiembre,Polonia,0,1,,1,POINT (806667 -767333)
2013,Septiembre,Polonia,0,1,,1,POINT (863337 -7735002)
2013,Septiembre,Portugal,0,1,,1,POINT (-4191162 -69941498)
2013,Septiembre,Portugal,2,4,,6,POINT (0.81488 -77356)
2013,Septiembre,Portugal,0,1,,1,POINT (1800143 -78802679)
2013,Septiembre,Portugal,0,1,,1,POINT (10406342 -75527794)
2013,Septiembre,Portugal,0,7,,7,POINT (10446304 -75516486)
2013,Septiembre,Portugal,1,1,,2,POINT (11360029 -72129595)
2013,Septiembre,Portugal,1,1,,2,POINT (125862 -81702165)
2013,Septiembre,Portugal,5,17,,22,POINT (3451668 -76532004)
2013,Septiembre,Portugal,87,335,,422,POINT (4697157 -74140516)
2013,Septiembre,Portugal,5,8,,13,POINT (6170465 -7542726)
2013,Septiembre,Portugal,2,4,,6,POINT (7819 -72453013)
2013,Septiembre,Qatar,0,1,,1,POINT (4697157 -74140516)
2013,Septiembre,Qatar,0,1,,1,POINT (6170465 -7542726)
2013,Septiembre,Reino Unido de Gran Bretaña e Irlanda del Norte,4,7,,11,POINT (-4191162 -69941498)
2013,Septiembre,Reino Unido de Gran Bretaña e Irlanda del Norte,5,5,,10,POINT (0.81488 -77356)
2013,Septiembre,Reino Unido de Gran Bretaña e Irlanda del Norte,0,2,,2,POINT (10406342 -75527794)
2013,Septiembre,Reino Unido de Gran Bretaña e Irlanda del Norte,45,108,,153,POINT (10446304 -75516486)
2013,Septiembre,Reino Unido de Gran Bretaña e Irlanda del Norte,2,8,,10,POINT (10886686 -74776479)
2013,Septiembre,Reino Unido de Gran Bretaña e Irlanda del Norte,1,2,,3,POINT (10970933 -74765343)
2013,Septiembre,Reino Unido de Gran Bretaña e Irlanda del Norte,1,0,,1,POINT (11360029 -72129595)
2013,Septiembre,Reino Unido de Gran Bretaña e Irlanda del Norte,1,19,,20,POINT (3451668 -76532004)
2013,Septiembre,Reino Unido de Gran Bretaña e Irlanda del Norte,1,0,,1,POINT (445285 -75766353)
2013,Septiembre,Reino Unido de Gran Bretaña e Irlanda del Norte,373,966,,1339,POINT (4697157 -74140516)
2013,Septiembre,Reino Unido de Gran Bretaña e Irlanda del Norte,2,3,,5,POINT (4815189 -75736374)
2013,Septiembre,Reino Unido de Gran Bretaña e Irlanda del Norte,2,40,,42,POINT (6170465 -7542726)
2013,Septiembre,Reino Unido de Gran Bretaña e Irlanda del Norte,0,1,,1,POINT (7128047 -73181317)
2013,Septiembre,Reino Unido de Gran Bretaña e Irlanda del Norte,3,2,,5,POINT (7819 -72453013)
2013,Septiembre,Reino Unido de Gran Bretaña e Irlanda del Norte,0,5,,5,POINT (7927233 -72508188)
2013,Septiembre,Reino Unido de Gran Bretaña e Irlanda del Norte,4,7,,11,POINT (863337 -7735002)
2013,Septiembre,República CentroÁfricana,5,0,,5,POINT (4697157 -74140516)
2013,Septiembre,República de Belarús,1,0,,1,POINT (4697157 -74140516)
2013,Septiembre,República Dominicana,4,9,,13,POINT (0.81488 -77356)
2013,Septiembre,República Dominicana,1,1,,2,POINT (10406342 -75527794)
2013,Septiembre,República Dominicana,35,42,,77,POINT (10446304 -75516486)
2013,Septiembre,República Dominicana,30,42,,72,POINT (10886686 -74776479)
2013,Septiembre,República Dominicana,1,2,,3,POINT (11360029 -72129595)
2013,Septiembre,República Dominicana,2,2,,4,POINT (125862 -81702165)
2013,Septiembre,República Dominicana,20,36,,56,POINT (3451668 -76532004)
2013,Septiembre,República Dominicana,215,370,,585,POINT (4697157 -74140516)
2013,Septiembre,República Dominicana,2,0,,2,POINT (4815189 -75736374)
2013,Septiembre,República Dominicana,39,65,,104,POINT (6170465 -7542726)
2013,Septiembre,República Dominicana,2,21,,23,POINT (7128047 -73181317)
2013,Septiembre,República Dominicana,1,4,,5,POINT (7819 -72453013)
2013,Septiembre,República Dominicana,1,4,,5,POINT (7927233 -72508188)
2013,Septiembre,República Checa,1,1,,2,POINT (3451668 -76532004)
2013,Septiembre,República Checa,0,1,,1,POINT (4697157 -74140516)
2013,Septiembre,República Democrática Popular de Corea,0,1,,1,POINT (4697157 -74140516)
2013,Septiembre,Rumania,1,0,,1,POINT (10406342 -75527794)
2013,Septiembre,Rumania,1,1,,2,POINT (10446304 -75516486)
2013,Septiembre,Rumania,0,1,,1,POINT (11247723 -74213989)
2013,Septiembre,Rumania,2,0,,2,POINT (3451668 -76532004)
2013,Septiembre,Rumania,28,53,,81,POINT (4697157 -74140516)
2013,Septiembre,Rumania,1,0,,1,POINT (4815189 -75736374)
2013,Septiembre,Rumania,4,3,,7,POINT (6170465 -7542726)
2013,Septiembre,Rumania,0,1,,1,POINT (7819 -72453013)
2013,Septiembre,Federación de Rusia,5,12,,17,POINT (0.81488 -77356)
2013,Septiembre,Federación de Rusia,0,1,,1,POINT (10406342 -75527794)
2013,Septiembre,Federación de Rusia,3,9,,12,POINT (10446304 -75516486)
2013,Septiembre,Federación de Rusia,1,1,,2,POINT (10886686 -74776479)
2013,Septiembre,Federación de Rusia,0,1,,1,POINT (11360029 -72129595)
2013,Septiembre,Federación de Rusia,1,1,,2,POINT (3451668 -76532004)
2013,Septiembre,Federación de Rusia,100,135,,235,POINT (4697157 -74140516)
2013,Septiembre,Federación de Rusia,1,0,,1,POINT (6170465 -7542726)
2013,Septiembre,Federación de Rusia,1,0,,1,POINT (7819 -72453013)
2013,Septiembre,Federación de Rusia,0,1,,1,POINT (806667 -767333)
2013,Septiembre,Federación de Rusia,0,1,,1,POINT (863337 -7735002)
2013,Septiembre,San Cristóbal y Nevis,0,1,,1,POINT (10886686 -74776479)
2013,Septiembre,San Cristóbal y Nevis,0,1,,1,POINT (133387613 -81372937)
2013,Septiembre,San Cristóbal y Nevis,0,1,,1,POINT (3451668 -76532004)
2013,Septiembre,San Cristóbal y Nevis,3,5,,8,POINT (4697157 -74140516)
2013,Septiembre,San Cristóbal y Nevis,0,1,,1,POINT (6170465 -7542726)
2013,Septiembre,San  Vicente y las Granadinas,1,2,,3,POINT (10446304 -75516486)
2013,Septiembre,San  Vicente y las Granadinas,1,2,,3,POINT (4697157 -74140516)
2013,Septiembre,Santa Lucia,1,2,,3,POINT (10446304 -75516486)
2013,Septiembre,Santa Lucia,3,7,,10,POINT (4697157 -74140516)
2013,Septiembre,Senegal,0,1,,1,POINT (3451668 -76532004)
2013,Septiembre,Senegal,3,7,,10,POINT (4697157 -74140516)
2013,Septiembre,Serbia,1,0,,1,POINT (10446304 -75516486)
2013,Septiembre,Serbia,3,3,,6,POINT (4697157 -74140516)
2013,Septiembre,Seychelles,1,0,,1,POINT (10446304 -75516486)
2013,Septiembre,Singapur,0,1,,1,POINT (10406342 -75527794)
2013,Septiembre,Singapur,1,0,,1,POINT (10446304 -75516486)
2013,Septiembre,Singapur,7,24,,31,POINT (4697157 -74140516)
2013,Septiembre,Singapur,2,2,,4,POINT (6170465 -7542726)
2013,Septiembre,República Árabe Siria,1,0,,1,POINT (10886686 -74776479)
2013,Septiembre,Sri Lanka,1,0,,1,POINT (3451668 -76532004)
2013,Septiembre,Sri Lanka,1,1,,2,POINT (4697157 -74140516)
2013,Septiembre,Sri Lanka,0,1,,1,POINT (6170465 -7542726)
2013,Septiembre,Sudáfrica,0,1,,1,POINT (-4191162 -69941498)
2013,Septiembre,Sudáfrica,0,1,,1,POINT (10406342 -75527794)
2013,Septiembre,Sudáfrica,2,7,,9,POINT (10446304 -75516486)
2013,Septiembre,Sudáfrica,0,3,,3,POINT (3451668 -76532004)
2013,Septiembre,Sudáfrica,39,69,,108,POINT (4697157 -74140516)
2013,Septiembre,Sudáfrica,1,4,,5,POINT (6170465 -7542726)
2013,Septiembre,Sudán,1,2,,3,POINT (4697157 -74140516)
2013,Septiembre,Suecia,3,3,,6,POINT (0.81488 -77356)
2013,Septiembre,Suecia,0,3,,3,POINT (10406342 -75527794)
2013,Septiembre,Suecia,0,3,,3,POINT (10446304 -75516486)
2013,Septiembre,Suecia,5,0,,5,POINT (10886686 -74776479)
2013,Septiembre,Suecia,2,8,,10,POINT (3451668 -76532004)
2013,Septiembre,Suecia,97,172,,269,POINT (4697157 -74140516)
2013,Septiembre,Suecia,7,21,,28,POINT (6170465 -7542726)
2013,Septiembre,Suecia,0,1,,1,POINT (7128047 -73181317)
2013,Septiembre,Suecia,0,1,,1,POINT (7819 -72453013)
2013,Septiembre,Suiza,2,3,,5,POINT (-4191162 -69941498)
2013,Septiembre,Suiza,8,11,,19,POINT (0.81488 -77356)
2013,Septiembre,Suiza,5,9,,14,POINT (10406342 -75527794)
2013,Septiembre,Suiza,10,21,,31,POINT (10446304 -75516486)
2013,Septiembre,Suiza,1,4,,5,POINT (10886686 -74776479)
2013,Septiembre,Suiza,1,3,,4,POINT (11360029 -72129595)
2013,Septiembre,Suiza,1,1,,2,POINT (125862 -81702165)
2013,Septiembre,Suiza,0,1,,1,POINT (133387613 -81372937)
2013,Septiembre,Suiza,12,25,,37,POINT (3451668 -76532004)
2013,Septiembre,Suiza,213,416,,629,POINT (4697157 -74140516)
2013,Septiembre,Suiza,14,31,,45,POINT (6170465 -7542726)
2013,Septiembre,Suiza,0,4,,4,POINT (7819 -72453013)
2013,Septiembre,Suiza,1,4,,5,POINT (863337 -7735002)
2013,Septiembre,Surinam,1,0,,1,POINT (10886686 -74776479)
2013,Septiembre,Surinam,0,1,,1,POINT (3451668 -76532004)
2013,Septiembre,Surinam,13,25,,38,POINT (4697157 -74140516)
2013,Septiembre,Surinam,1,0,,1,POINT (4815189 -75736374)
2013,Septiembre,Surinam,11,9,,20,POINT (6170465 -7542726)
2013,Septiembre,Taiwán,4,8,,12,POINT (10446304 -75516486)
2013,Septiembre,Taiwán,12,35,,47,POINT (4697157 -74140516)
2013,Septiembre,Taiwán,1,1,,2,POINT (4815189 -75736374)
2013,Septiembre,Tailandia,4,6,,10,POINT (4697157 -74140516)
2013,Septiembre,Tailandia,0,2,,2,POINT (6170465 -7542726)
2013,Septiembre,Territorio Antártico Británico/Territorio Británico de Ultramar,0,1,,1,POINT (10406342 -75527794)
2013,Septiembre,Territorio Antártico Británico/Territorio Británico de Ultramar,0,1,,1,POINT (3451668 -76532004)
2013,Septiembre,Territorio Antártico Británico/Territorio Británico de Ultramar,1,0,,1,POINT (4697157 -74140516)
2013,Septiembre,Tanzania,1,3,,4,POINT (10446304 -75516486)
2013,Septiembre,Tanzania,0,1,,1,POINT (3451668 -76532004)
2013,Septiembre,Tanzania,2,2,,4,POINT (4697157 -74140516)
2013,Septiembre,Togo,0,4,,4,POINT (4697157 -74140516)
2013,Septiembre,Trinidad y Tobago,28,19,,47,POINT (10446304 -75516486)
2013,Septiembre,Trinidad y Tobago,0,3,,3,POINT (10886686 -74776479)
2013,Septiembre,Trinidad y Tobago,0,1,,1,POINT (10970933 -74765343)
2013,Septiembre,Trinidad y Tobago,0,1,,1,POINT (125862 -81702165)
2013,Septiembre,Trinidad y Tobago,11,15,,26,POINT (3451668 -76532004)
2013,Septiembre,Trinidad y Tobago,34,40,,74,POINT (4697157 -74140516)
2013,Septiembre,Trinidad y Tobago,0,1,,1,POINT (4815189 -75736374)
2013,Septiembre,Trinidad y Tobago,5,2,,7,POINT (6170465 -7542726)
2013,Septiembre,Trinidad y Tobago,0,1,,1,POINT (7128047 -73181317)
2013,Septiembre,Trinidad y Tobago,0,2,,2,POINT (7819 -72453013)
2013,Septiembre,Trinidad y Tobago,1,1,,2,POINT (7927233 -72508188)
2013,Septiembre,Túnez,1,2,,3,POINT (4697157 -74140516)
2013,Septiembre,Turquía,0,1,,1,POINT (-4191162 -69941498)
2013,Septiembre,Turquía,0,1,,1,POINT (0.81488 -77356)
2013,Septiembre,Turquía,0,1,,1,POINT (10406342 -75527794)
2013,Septiembre,Turquía,3,11,,14,POINT (10446304 -75516486)
2013,Septiembre,Turquía,0,4,,4,POINT (3451668 -76532004)
2013,Septiembre,Turquía,22,131,,153,POINT (4697157 -74140516)
2013,Septiembre,Turquía,2,3,,5,POINT (6170465 -7542726)
2013,Septiembre,Turquía,0,1,,1,POINT (7819 -72453013)
2013,Septiembre,Turquía,0,14,,14,POINT (9402597 -75681642)
2013,Septiembre,Turkmenistán,1,0,,1,POINT (4697157 -74140516)
2013,Septiembre,Ucrania,1,8,,9,POINT (10406342 -75527794)
2013,Septiembre,Ucrania,0,13,,13,POINT (10886686 -74776479)
2013,Septiembre,Ucrania,0,21,,21,POINT (10970933 -74765343)
2013,Septiembre,Ucrania,0,2,,2,POINT (11247723 -74213989)
2013,Septiembre,Ucrania,0,2,,2,POINT (3451668 -76532004)
2013,Septiembre,Ucrania,20,26,,46,POINT (4697157 -74140516)
2013,Septiembre,Ucrania,0,1,,1,POINT (6170465 -7542726)
2013,Septiembre,Uganda,0,1,,1,POINT (10446304 -75516486)
2013,Septiembre,Uganda,4,1,,5,POINT (3451668 -76532004)
2013,Septiembre,Uganda,3,7,,10,POINT (4697157 -74140516)
2013,Septiembre,Federación de Rusia,7,10,,17,POINT (0.81488 -77356)
2013,Septiembre,Federación de Rusia,1,4,,5,POINT (10406342 -75527794)
2013,Septiembre,Federación de Rusia,0,1,,1,POINT (10886686 -74776479)
2013,Septiembre,Federación de Rusia,1,8,,9,POINT (10970933 -74765343)
2013,Septiembre,Federación de Rusia,2,0,,2,POINT (3451668 -76532004)
2013,Septiembre,Federación de Rusia,41,32,,73,POINT (4697157 -74140516)
2013,Septiembre,Federación de Rusia,2,4,,6,POINT (6170465 -7542726)
2013,Septiembre,Federación de Rusia,1,2,,3,POINT (7819 -72453013)
2013,Septiembre,Uruguay,0,5,,5,POINT (-4191162 -69941498)
2013,Septiembre,Uruguay,0,7,,7,POINT (0.81488 -77356)
2013,Septiembre,Uruguay,2,3,,5,POINT (10406342 -75527794)
2013,Septiembre,Uruguay,100,90,,190,POINT (10446304 -75516486)
2013,Septiembre,Uruguay,4,4,,8,POINT (10886686 -74776479)
2013,Septiembre,Uruguay,1,4,,5,POINT (11360029 -72129595)
2013,Septiembre,Uruguay,33,23,,56,POINT (125862 -81702165)
2013,Septiembre,Uruguay,9,19,,28,POINT (3451668 -76532004)
2013,Septiembre,Uruguay,163,349,,512,POINT (4697157 -74140516)
2013,Septiembre,Uruguay,1,1,,2,POINT (4815189 -75736374)
2013,Septiembre,Uruguay,13,34,,47,POINT (6170465 -7542726)
2013,Septiembre,Uruguay,1,4,,5,POINT (7819 -72453013)
2013,Septiembre,Uzbekistán,0,3,,3,POINT (4697157 -74140516)
2013,Septiembre,Venezuela,0,2,,2,POINT (-4191162 -69941498)
2013,Septiembre,Venezuela,193,234,,427,POINT (0.81488 -77356)
2013,Septiembre,Venezuela,6,9,,15,POINT (10406342 -75527794)
2013,Septiembre,Venezuela,81,140,,221,POINT (10446304 -75516486)
2013,Septiembre,Venezuela,32,100,,132,POINT (10886686 -74776479)
2013,Septiembre,Venezuela,6,5,,11,POINT (10970933 -74765343)
2013,Septiembre,Venezuela,1130,1867,,2997,POINT (11360029 -72129595)
2013,Septiembre,Venezuela,2,4,,6,POINT (1152863 -72919186)
2013,Septiembre,Venezuela,4,2,,6,POINT (125862 -81702165)
2013,Septiembre,Venezuela,47,70,,117,POINT (3451668 -76532004)
2013,Septiembre,Venezuela,0,2,,2,POINT (445285 -75766353)
2013,Septiembre,Venezuela,5626,6289,,11915,POINT (4697157 -74140516)
2013,Septiembre,Venezuela,3,15,,18,POINT (4815189 -75736374)
2013,Septiembre,Venezuela,347,463,,810,POINT (6170465 -7542726)
2013,Septiembre,Venezuela,10,49,,59,POINT (6185536 -67484028)
2013,Septiembre,Venezuela,25,48,,73,POINT (7088729 -70740253)
2013,Septiembre,Venezuela,10,11,,21,POINT (7128047 -73181317)
2013,Septiembre,Venezuela,1235,1549,,2784,POINT (7819 -72453013)
2013,Septiembre,Venezuela,199,269,,468,POINT (7927233 -72508188)
2013,Septiembre,Vietnam,6,20,,26,POINT (4697157 -74140516)
2013,Septiembre,Islas Vírgenes Británicas/Territorio Británico de Ultramar,1,0,,1,POINT (10446304 -75516486)
2013,Septiembre,Yugoslavia,1,0,,1,POINT (4697157 -74140516)
2013,Septiembre,Zambia,0,1,,1,POINT (10446304 -75516486)
2013,Septiembre,Zambia,0,1,,1,POINT (3451668 -76532004)
2013,Septiembre,Zambia,1,5,,6,POINT (4697157 -74140516)
2013,Septiembre,Zimbabue,1,0,,1,POINT (0.81488 -77356)
2013,Septiembre,Zimbabue,0,3,,3,POINT (10446304 -75516486)
2013,Septiembre,Zimbabue,0,1,,1,POINT (3451668 -76532004)
2013,Septiembre,Zimbabue,2,1,,3,POINT (4697157 -74140516)
2013,Septiembre,Países Bajos,0,1,,1,POINT (10446304 -75516486)
2013,Septiembre,Reino Unido de Gran Bretaña e Irlanda del Norte,2,5,,7,POINT (-4191162 -69941498)
2013,Septiembre,Reino Unido de Gran Bretaña e Irlanda del Norte,17,28,,45,POINT (0.81488 -77356)
2013,Septiembre,Reino Unido de Gran Bretaña e Irlanda del Norte,15,23,,38,POINT (10406342 -75527794)
2013,Septiembre,Reino Unido de Gran Bretaña e Irlanda del Norte,0,5,,5,POINT (10886686 -74776479)
2013,Septiembre,Reino Unido de Gran Bretaña e Irlanda del Norte,0,12,,12,POINT (10970933 -74765343)
2013,Septiembre,Reino Unido de Gran Bretaña e Irlanda del Norte,1,1,,2,POINT (125862 -81702165)
2013,Septiembre,Reino Unido de Gran Bretaña e Irlanda del Norte,5,21,,26,POINT (3451668 -76532004)
2013,Septiembre,Reino Unido de Gran Bretaña e Irlanda del Norte,73,238,,311,POINT (4697157 -74140516)
2013,Septiembre,Reino Unido de Gran Bretaña e Irlanda del Norte,9,12,,21,POINT (6170465 -7542726)
2013,Septiembre,Reino Unido de Gran Bretaña e Irlanda del Norte,0,1,,1,POINT (7128047 -73181317)
2013,Septiembre,Reino Unido de Gran Bretaña e Irlanda del Norte,3,10,,13,POINT (7819 -72453013)
2013,Septiembre,Reino Unido de Gran Bretaña e Irlanda del Norte,1,1,,2,POINT (863337 -7735002)
2013,Septiembre,Países Bajos,1,3,,4,POINT (-4191162 -69941498)
2013,Septiembre,Países Bajos,5,6,,11,POINT (0.81488 -77356)
2013,Septiembre,Países Bajos,5,11,,16,POINT (10406342 -75527794)
2013,Septiembre,Países Bajos,2,4,,6,POINT (10446304 -75516486)
2013,Septiembre,Países Bajos,3,15,,18,POINT (10886686 -74776479)
2013,Septiembre,Países Bajos,0,4,,4,POINT (11247723 -74213989)
2013,Septiembre,Países Bajos,14,32,,46,POINT (3451668 -76532004)
2013,Septiembre,Países Bajos,144,262,,406,POINT (4697157 -74140516)
2013,Septiembre,Países Bajos,58,80,,138,POINT (6170465 -7542726)
2013,Septiembre,Países Bajos,1,2,,3,POINT (7128047 -73181317)
2013,Septiembre,Países Bajos,0,5,,5,POINT (7819 -72453013)
2013,Septiembre,Países Bajos,0,1,,1,POINT (863337 -7735002)
2013,Septiembre,Lituania,1,0,,1,POINT (4697157 -74140516)
2013,Septiembre,Reino Unido de Gran Bretaña e Irlanda del Norte,1,0,,1,POINT (10886686 -74776479)
2013,Septiembre,Reino Unido de Gran Bretaña e Irlanda del Norte,0,1,,1,POINT (7819 -72453013)
2013,Septiembre,Reino Unido de Gran Bretaña e Irlanda del Norte,4,8,,12,POINT (10406342 -75527794)
2013,Septiembre,Reino Unido de Gran Bretaña e Irlanda del Norte,2,3,,5,POINT (4697157 -74140516)
2013,Septiembre,Reino Unido de Gran Bretaña e Irlanda del Norte,0,1,,1,POINT (7819 -72453013)
2013,Septiembre,Letonia,0,1,,1,POINT (9402597 -75681642)
2013,Septiembre,Desconocido,4,21,,25,POINT (4697157 -74140516)
2013,Septiembre,República CentroÁfricana,0,1,,1,POINT (4697157 -74140516)
2013,Septiembre,Desconocido,0,3,,3,POINT (4697157 -74140516)
2013,Octubre,Afganistán,2,2,,4,POINT (4697157 -74140516)
2013,Octubre,Albania,0,2,,2,POINT (0.81488 -77356)
2013,Octubre,Alemania,7,11,,18,POINT (-4191162 -69941498)
2013,Octubre,Alemania,23,25,,48,POINT (0.81488 -77356)
2013,Octubre,Alemania,35,42,,77,POINT (10406342 -75527794)
2013,Octubre,Alemania,23,41,,64,POINT (10446304 -75516486)
2013,Octubre,Alemania,4,12,,16,POINT (10886686 -74776479)
2013,Octubre,Alemania,1,1,,2,POINT (10970933 -74765343)
2013,Octubre,Alemania,0,3,,3,POINT (11247723 -74213989)
2013,Octubre,Alemania,2,14,,16,POINT (11360029 -72129595)
2013,Octubre,Alemania,1,6,,7,POINT (125862 -81702165)
2013,Octubre,Alemania,28,39,,67,POINT (3451668 -76532004)
2013,Octubre,Alemania,1171,1970,,3141,POINT (4697157 -74140516)
2013,Octubre,Alemania,1,0,,1,POINT (4815189 -75736374)
2013,Octubre,Alemania,34,93,,127,POINT (6170465 -7542726)
2013,Octubre,Alemania,0,12,,12,POINT (7819 -72453013)
2013,Octubre,Alemania,0,2,,2,POINT (7927233 -72508188)
2013,Octubre,Andorra,2,17,,19,POINT (4697157 -74140516)
2013,Octubre,Angola,1,11,,12,POINT (10446304 -75516486)
2013,Octubre,Angola,2,20,,22,POINT (4697157 -74140516)
2013,Octubre,Antigua y Barbuda,2,9,,11,POINT (4697157 -74140516)
2013,Octubre,Arabia Saudita,0,1,,1,POINT (4697157 -74140516)
2013,Octubre,Arabia Saudita,0,1,,1,POINT (10446304 -75516486)
2013,Octubre,Arabia Saudita,0,7,,7,POINT (4697157 -74140516)
2013,Octubre,Arabia Saudita,0,1,,1,POINT (6170465 -7542726)
2013,Octubre,Argelia,0,1,,1,POINT (0.81488 -77356)
2013,Octubre,Argelia,0,1,,1,POINT (10406342 -75527794)
2013,Octubre,Argelia,0,7,,7,POINT (4697157 -74140516)
2013,Octubre,Argelia,0,1,,1,POINT (7819 -72453013)
2013,Octubre,Argentina,3,6,,9,POINT (-4191162 -69941498)
2013,Octubre,Argentina,0,3,,3,POINT (0.33002 -76876446)
2013,Octubre,Argentina,47,102,,149,POINT (0.81488 -77356)
2013,Octubre,Argentina,123,98,,221,POINT (10406342 -75527794)
2013,Octubre,Argentina,895,587,,1482,POINT (10446304 -75516486)
2013,Octubre,Argentina,13,38,,51,POINT (10886686 -74776479)
2013,Octubre,Argentina,8,23,,31,POINT (11360029 -72129595)
2013,Octubre,Argentina,2,2,,4,POINT (1152863 -72919186)
2013,Octubre,Argentina,225,182,,407,POINT (125862 -81702165)
2013,Octubre,Argentina,37,71,,108,POINT (3451668 -76532004)
2013,Octubre,Argentina,2601,4189,,6790,POINT (4697157 -74140516)
2013,Octubre,Argentina,1,6,,7,POINT (4815189 -75736374)
2013,Octubre,Argentina,87,198,,285,POINT (6170465 -7542726)
2013,Octubre,Argentina,0,4,,4,POINT (7128047 -73181317)
2013,Octubre,Argentina,12,25,,37,POINT (7819 -72453013)
2013,Octubre,Argentina,2,10,,12,POINT (7927233 -72508188)
2013,Octubre,Argentina,0,2,,2,POINT (863337 -7735002)
2013,Octubre,República de Armenia,0,1,,1,POINT (4697157 -74140516)
2013,Octubre,República de Armenia,0,1,,1,POINT (6170465 -7542726)
2013,Octubre,Aruba,1,3,,4,POINT (4697157 -74140516)
2013,Octubre,Australia,6,7,,13,POINT (-4191162 -69941498)
2013,Octubre,Australia,14,20,,34,POINT (0.81488 -77356)
2013,Octubre,Australia,18,31,,49,POINT (10406342 -75527794)
2013,Octubre,Australia,33,36,,69,POINT (10446304 -75516486)
2013,Octubre,Australia,3,6,,9,POINT (10886686 -74776479)
2013,Octubre,Australia,2,2,,4,POINT (11247723 -74213989)
2013,Octubre,Australia,1,4,,5,POINT (11360029 -72129595)
2013,Octubre,Australia,9,14,,23,POINT (3451668 -76532004)
2013,Octubre,Australia,172,333,,505,POINT (4697157 -74140516)
2013,Octubre,Australia,1,3,,4,POINT (4815189 -75736374)
2013,Octubre,Australia,20,50,,70,POINT (6170465 -7542726)
2013,Octubre,Australia,1,4,,5,POINT (7819 -72453013)
2013,Octubre,Austria,0,1,,1,POINT (-4191162 -69941498)
2013,Octubre,Austria,5,4,,9,POINT (0.81488 -77356)
2013,Octubre,Austria,0,4,,4,POINT (10406342 -75527794)
2013,Octubre,Austria,5,6,,11,POINT (10446304 -75516486)
2013,Octubre,Austria,1,2,,3,POINT (10886686 -74776479)
2013,Octubre,Austria,1,0,,1,POINT (11247723 -74213989)
2013,Octubre,Austria,1,6,,7,POINT (3451668 -76532004)
2013,Octubre,Austria,74,186,,260,POINT (4697157 -74140516)
2013,Octubre,Austria,7,9,,16,POINT (6170465 -7542726)
2013,Octubre,Austria,0,1,,1,POINT (7819 -72453013)
2013,Octubre,Azerbaiyán,0,2,,2,POINT (10446304 -75516486)
2013,Octubre,Azerbaiyán,2,2,,4,POINT (4697157 -74140516)
2013,Octubre,Bahamas,0,2,,2,POINT (10446304 -75516486)
2013,Octubre,Bahamas,0,1,,1,POINT (10886686 -74776479)
2013,Octubre,Bahamas,1,4,,5,POINT (4697157 -74140516)
2013,Octubre,Bahamas,1,1,,2,POINT (4815189 -75736374)
2013,Octubre,Bahamas,2,2,,4,POINT (6170465 -7542726)
2013,Octubre,Bahréin,0,2,,2,POINT (10446304 -75516486)
2013,Octubre,Bahréin,0,3,,3,POINT (4697157 -74140516)
2013,Octubre,Bangladesh,0,2,,2,POINT (10446304 -75516486)
2013,Octubre,Bangladesh,0,2,,2,POINT (4697157 -74140516)
2013,Octubre,Barbados,0,1,,1,POINT (10446304 -75516486)
2013,Octubre,Barbados,0,2,,2,POINT (3451668 -76532004)
2013,Octubre,Barbados,4,14,,18,POINT (4697157 -74140516)
2013,Octubre,República de Belarús,0,1,,1,POINT (10446304 -75516486)
2013,Octubre,República de Belarús,1,0,,1,POINT (3451668 -76532004)
2013,Octubre,República de Belarús,1,4,,5,POINT (4697157 -74140516)
2013,Octubre,Bélgica,3,3,,6,POINT (-4191162 -69941498)
2013,Octubre,Bélgica,1,0,,1,POINT (0.33002 -76876446)
2013,Octubre,Bélgica,6,6,,12,POINT (0.81488 -77356)
2013,Octubre,Bélgica,0,1,,1,POINT (10406342 -75527794)
2013,Octubre,Bélgica,2,6,,8,POINT (10446304 -75516486)
2013,Octubre,Bélgica,2,3,,5,POINT (10886686 -74776479)
2013,Octubre,Bélgica,0,16,,16,POINT (11247723 -74213989)
2013,Octubre,Bélgica,5,28,,33,POINT (3451668 -76532004)
2013,Octubre,Bélgica,0,6,,6,POINT (3884426 -77061029)
2013,Octubre,Bélgica,1,1,,2,POINT (445285 -75766353)
2013,Octubre,Bélgica,128,312,,440,POINT (4697157 -74140516)
2013,Octubre,Bélgica,0,3,,3,POINT (4815189 -75736374)
2013,Octubre,Bélgica,4,20,,24,POINT (6170465 -7542726)
2013,Octubre,Bélgica,1,2,,3,POINT (7819 -72453013)
2013,Octubre,Belice,0,1,,1,POINT (10446304 -75516486)
2013,Octubre,Belice,0,1,,1,POINT (11360029 -72129595)
2013,Octubre,Belice,5,13,,18,POINT (4697157 -74140516)
2013,Octubre,Benín,2,2,,4,POINT (4697157 -74140516)
2013,Octubre,Bermudas/Territorio Británico de Ultramar,1,0,,1,POINT (10446304 -75516486)
2013,Octubre,Bermudas/Territorio Británico de Ultramar,0,2,,2,POINT (3451668 -76532004)
2013,Octubre,Bermudas/Territorio Británico de Ultramar,0,1,,1,POINT (4697157 -74140516)
2013,Octubre,Bolivia,1,0,,1,POINT (-4191162 -69941498)
2013,Octubre,Bolivia,1,0,,1,POINT (0.33002 -76876446)
2013,Octubre,Bolivia,14,15,,29,POINT (0.81488 -77356)
2013,Octubre,Bolivia,0,1,,1,POINT (10406342 -75527794)
2013,Octubre,Bolivia,11,13,,24,POINT (10446304 -75516486)
2013,Octubre,Bolivia,0,3,,3,POINT (10886686 -74776479)
2013,Octubre,Bolivia,1,0,,1,POINT (11360029 -72129595)
2013,Octubre,Bolivia,1,1,,2,POINT (125862 -81702165)
2013,Octubre,Bolivia,2,6,,8,POINT (3451668 -76532004)
2013,Octubre,Bolivia,0,1,,1,POINT (445285 -75766353)
2013,Octubre,Bolivia,289,454,,743,POINT (4697157 -74140516)
2013,Octubre,Bolivia,0,3,,3,POINT (4815189 -75736374)
2013,Octubre,Bolivia,14,22,,36,POINT (6170465 -7542726)
2013,Octubre,Bolivia,0,2,,2,POINT (7819 -72453013)
2013,Octubre,Bolivia,0,3,,3,POINT (7927233 -72508188)
2013,Octubre,Bosnia y Herzegovina,2,1,,3,POINT (4697157 -74140516)
2013,Octubre,Botsuana,0,2,,2,POINT (10446304 -75516486)
2013,Octubre,Botsuana,0,3,,3,POINT (4697157 -74140516)
2013,Octubre,Brasil,59,83,,142,POINT (-4191162 -69941498)
2013,Octubre,Brasil,12,13,,25,POINT (0.81488 -77356)
2013,Octubre,Brasil,111,84,,195,POINT (10406342 -75527794)
2013,Octubre,Brasil,209,166,,375,POINT (10446304 -75516486)
2013,Octubre,Brasil,10,33,,43,POINT (10886686 -74776479)
2013,Octubre,Brasil,9,6,,15,POINT (11360029 -72129595)
2013,Octubre,Brasil,24,15,,39,POINT (125862 -81702165)
2013,Octubre,Brasil,35,84,,119,POINT (3451668 -76532004)
2013,Octubre,Brasil,2868,4306,,7174,POINT (4697157 -74140516)
2013,Octubre,Brasil,3,12,,15,POINT (4815189 -75736374)
2013,Octubre,Brasil,80,167,,247,POINT (6170465 -7542726)
2013,Octubre,Brasil,1,2,,3,POINT (7088729 -70740253)
2013,Octubre,Brasil,1,3,,4,POINT (7128047 -73181317)
2013,Octubre,Brasil,18,25,,43,POINT (7819 -72453013)
2013,Octubre,Brasil,0,3,,3,POINT (7927233 -72508188)
2013,Octubre,Brunei Darussalam,0,5,,5,POINT (4697157 -74140516)
2013,Octubre,Bulgaria,0,3,,3,POINT (10406342 -75527794)
2013,Octubre,Bulgaria,1,0,,1,POINT (10446304 -75516486)
2013,Octubre,Bulgaria,0,1,,1,POINT (10970933 -74765343)
2013,Octubre,Bulgaria,1,0,,1,POINT (3451668 -76532004)
2013,Octubre,Bulgaria,7,17,,24,POINT (4697157 -74140516)
2013,Octubre,Bulgaria,2,1,,3,POINT (7819 -72453013)
2013,Octubre,Burkina Faso,0,2,,2,POINT (4697157 -74140516)
2013,Octubre,Burundi,0,1,,1,POINT (10446304 -75516486)
2013,Octubre,Burundi,0,2,,2,POINT (4697157 -74140516)
2013,Octubre,Bután,0,2,,2,POINT (4697157 -74140516)
2013,Octubre,Cabo Verde,1,0,,1,POINT (4697157 -74140516)
2013,Octubre,Islas Caimán/Territorio Británico de Ultramar,2,1,,3,POINT (125862 -81702165)
2013,Octubre,Camboya,0,1,,1,POINT (10446304 -75516486)
2013,Octubre,Camerún,0,1,,1,POINT (10446304 -75516486)
2013,Octubre,Camerún,4,8,,12,POINT (4697157 -74140516)
2013,Octubre,Canadá,2,2,,4,POINT (-4191162 -69941498)
2013,Octubre,Canadá,10,8,,18,POINT (0.81488 -77356)
2013,Octubre,Canadá,13,17,,30,POINT (10406342 -75527794)
2013,Octubre,Canadá,95,126,,221,POINT (10446304 -75516486)
2013,Octubre,Canadá,2,12,,14,POINT (10886686 -74776479)
2013,Octubre,Canadá,1,0,,1,POINT (11247723 -74213989)
2013,Octubre,Canadá,1,8,,9,POINT (11360029 -72129595)
2013,Octubre,Canadá,2,5,,7,POINT (125862 -81702165)
2013,Octubre,Canadá,17,41,,58,POINT (3451668 -76532004)
2013,Octubre,Canadá,0,1,,1,POINT (3884426 -77061029)
2013,Octubre,Canadá,2,1,,3,POINT (445285 -75766353)
2013,Octubre,Canadá,572,1225,,1797,POINT (4697157 -74140516)
2013,Octubre,Canadá,1,4,,5,POINT (4815189 -75736374)
2013,Octubre,Canadá,34,104,,138,POINT (6170465 -7542726)
2013,Octubre,Canadá,0,2,,2,POINT (7128047 -73181317)
2013,Octubre,Canadá,4,4,,8,POINT (7819 -72453013)
2013,Octubre,Canadá,1,2,,3,POINT (7927233 -72508188)
2013,Octubre,Chad,0,1,,1,POINT (4697157 -74140516)
2013,Octubre,España,0,1,,1,POINT (0.81488 -77356)
2013,Octubre,España,2,3,,5,POINT (10406342 -75527794)
2013,Octubre,España,0,1,,1,POINT (10886686 -74776479)
2013,Octubre,España,11,22,,33,POINT (3451668 -76532004)
2013,Octubre,España,13,27,,40,POINT (4697157 -74140516)
2013,Octubre,España,4,9,,13,POINT (7819 -72453013)
2013,Octubre,República Del Congo,0,2,,2,POINT (4697157 -74140516)
2013,Octubre,Comoras,0,2,,2,POINT (4697157 -74140516)
2013,Octubre,República Democrática del Congo,0,2,,2,POINT (10446304 -75516486)
2013,Octubre,República Democrática del Congo,3,17,,20,POINT (4697157 -74140516)
2013,Octubre,República Democrática del Congo,1,0,,1,POINT (7819 -72453013)
2013,Octubre,República de Corea,2,4,,6,POINT (0.81488 -77356)
2013,Octubre,República de Corea,0,2,,2,POINT (10406342 -75527794)
2013,Octubre,República de Corea,2,11,,13,POINT (10446304 -75516486)
2013,Octubre,República de Corea,0,4,,4,POINT (10886686 -74776479)
2013,Octubre,República de Corea,0,1,,1,POINT (11360029 -72129595)
2013,Octubre,República de Corea,3,13,,16,POINT (3451668 -76532004)
2013,Octubre,República de Corea,133,417,,550,POINT (4697157 -74140516)
2013,Octubre,República de Corea,0,2,,2,POINT (4815189 -75736374)
2013,Octubre,República de Corea,6,26,,32,POINT (6170465 -7542726)
2013,Octubre,República de Corea,1,3,,4,POINT (7819 -72453013)
2013,Octubre,Costa de Marfil,1,6,,7,POINT (4697157 -74140516)
2013,Octubre,Costa Rica,0,1,,1,POINT (-4191162 -69941498)
2013,Octubre,Costa Rica,1,0,,1,POINT (0.81488 -77356)
2013,Octubre,Costa Rica,0,2,,2,POINT (10406342 -75527794)
2013,Octubre,Costa Rica,39,57,,96,POINT (10446304 -75516486)
2013,Octubre,Costa Rica,12,22,,34,POINT (10886686 -74776479)
2013,Octubre,Costa Rica,2,6,,8,POINT (125862 -81702165)
2013,Octubre,Costa Rica,20,45,,65,POINT (3451668 -76532004)
2013,Octubre,Costa Rica,1,0,,1,POINT (445285 -75766353)
2013,Octubre,Costa Rica,464,781,,1245,POINT (4697157 -74140516)
2013,Octubre,Costa Rica,5,2,,7,POINT (4815189 -75736374)
2013,Octubre,Costa Rica,71,173,,244,POINT (6170465 -7542726)
2013,Octubre,Costa Rica,3,1,,4,POINT (7128047 -73181317)
2013,Octubre,Costa Rica,1,2,,3,POINT (7819 -72453013)
2013,Octubre,Costa Rica,0,1,,1,POINT (7927233 -72508188)
2013,Octubre,Croacia,0,1,,1,POINT (-4191162 -69941498)
2013,Octubre,Croacia,0,1,,1,POINT (10446304 -75516486)
2013,Octubre,Croacia,0,1,,1,POINT (3451668 -76532004)
2013,Octubre,Croacia,0,6,,6,POINT (3884426 -77061029)
2013,Octubre,Croacia,3,36,,39,POINT (4697157 -74140516)
2013,Octubre,Croacia,0,1,,1,POINT (4815189 -75736374)
2013,Octubre,Croacia,0,1,,1,POINT (6170465 -7542726)
2013,Octubre,Cuba,0,1,,1,POINT (-4191162 -69941498)
2013,Octubre,Cuba,0,3,,3,POINT (10406342 -75527794)
2013,Octubre,Cuba,2,11,,13,POINT (10446304 -75516486)
2013,Octubre,Cuba,4,11,,15,POINT (10886686 -74776479)
2013,Octubre,Cuba,16,20,,36,POINT (3451668 -76532004)
2013,Octubre,Cuba,1,0,,1,POINT (3884426 -77061029)
2013,Octubre,Cuba,0,1,,1,POINT (445285 -75766353)
2013,Octubre,Cuba,108,200,,308,POINT (4697157 -74140516)
2013,Octubre,Cuba,1,3,,4,POINT (4815189 -75736374)
2013,Octubre,Cuba,15,26,,41,POINT (6170465 -7542726)
2013,Octubre,Cuba,0,1,,1,POINT (7128047 -73181317)
2013,Octubre,Cuba,0,2,,2,POINT (7927233 -72508188)
2013,Octubre,Curazao,0,1,,1,POINT (3451668 -76532004)
2013,Octubre,Curazao,0,1,,1,POINT (4697157 -74140516)
2013,Octubre,República Checa,4,9,,13,POINT (0.81488 -77356)
2013,Octubre,República Checa,1,0,,1,POINT (10446304 -75516486)
2013,Octubre,República Checa,0,1,,1,POINT (10886686 -74776479)
2013,Octubre,República Checa,1,0,,1,POINT (3451668 -76532004)
2013,Octubre,República Checa,32,49,,81,POINT (4697157 -74140516)
2013,Octubre,República Checa,2,2,,4,POINT (6170465 -7542726)
2013,Octubre,República Checa,0,1,,1,POINT (7819 -72453013)
2013,Octubre,Chile,1,2,,3,POINT (-4191162 -69941498)
2013,Octubre,Chile,1,1,,2,POINT (0.33002 -76876446)
2013,Octubre,Chile,43,60,,103,POINT (0.81488 -77356)
2013,Octubre,Chile,43,25,,68,POINT (10406342 -75527794)
2013,Octubre,Chile,85,178,,263,POINT (10446304 -75516486)
2013,Octubre,Chile,25,347,,372,POINT (10886686 -74776479)
2013,Octubre,Chile,1,6,,7,POINT (11360029 -72129595)
2013,Octubre,Chile,28,19,,47,POINT (125862 -81702165)
2013,Octubre,Chile,24,57,,81,POINT (3451668 -76532004)
2013,Octubre,Chile,1,0,,1,POINT (445285 -75766353)
2013,Octubre,Chile,3015,4802,,7817,POINT (4697157 -74140516)
2013,Octubre,Chile,0,2,,2,POINT (4815189 -75736374)
2013,Octubre,Chile,44,118,,162,POINT (6170465 -7542726)
2013,Octubre,Chile,3,23,,26,POINT (7819 -72453013)
2013,Octubre,Chile,1,3,,4,POINT (7927233 -72508188)
2013,Octubre,China,1,1,,2,POINT (0.81488 -77356)
2013,Octubre,China,2,8,,10,POINT (10406342 -75527794)
2013,Octubre,China,0,11,,11,POINT (10446304 -75516486)
2013,Octubre,China,2,0,,2,POINT (10886686 -74776479)
2013,Octubre,China,2,5,,7,POINT (3451668 -76532004)
2013,Octubre,China,2,7,,9,POINT (3884426 -77061029)
2013,Octubre,China,150,457,,607,POINT (4697157 -74140516)
2013,Octubre,China,0,1,,1,POINT (4815189 -75736374)
2013,Octubre,China,8,8,,16,POINT (6170465 -7542726)
2013,Octubre,Taiwán,0,1,,1,POINT (3451668 -76532004)
2013,Octubre,Taiwán,5,5,,10,POINT (4697157 -74140516)
2013,Octubre,Taiwán,0,1,,1,POINT (6170465 -7542726)
2013,Octubre,Taiwán,2,0,,2,POINT (7819 -72453013)
2013,Octubre,Chipre,0,1,,1,POINT (10970933 -74765343)
2013,Octubre,Chipre,1,3,,4,POINT (4697157 -74140516)
2013,Octubre,Dinamarca,2,8,,10,POINT (10446304 -75516486)
2013,Octubre,Dinamarca,0,1,,1,POINT (10886686 -74776479)
2013,Octubre,Dinamarca,0,1,,1,POINT (11360029 -72129595)
2013,Octubre,Dinamarca,0,8,,8,POINT (3451668 -76532004)
2013,Octubre,Dinamarca,44,98,,142,POINT (4697157 -74140516)
2013,Octubre,Dinamarca,5,9,,14,POINT (6170465 -7542726)
2013,Octubre,Dominica,2,4,,6,POINT (4697157 -74140516)
2013,Octubre,Dominica,0,1,,1,POINT (4815189 -75736374)
2013,Octubre,Ecuador,29,63,,92,POINT (0.33002 -76876446)
2013,Octubre,Ecuador,1444,2111,,3555,POINT (0.81488 -77356)
2013,Octubre,Ecuador,2,119,,121,POINT (1800143 -78802679)
2013,Octubre,Ecuador,3,15,,18,POINT (10406342 -75527794)
2013,Octubre,Ecuador,8,27,,35,POINT (10446304 -75516486)
2013,Octubre,Ecuador,3,12,,15,POINT (10886686 -74776479)
2013,Octubre,Ecuador,14,15,,29,POINT (11360029 -72129595)
2013,Octubre,Ecuador,0,1,,1,POINT (125744111 -81703935)
2013,Octubre,Ecuador,5,4,,9,POINT (125862 -81702165)
2013,Octubre,Ecuador,539,613,,1152,POINT (3451668 -76532004)
2013,Octubre,Ecuador,1716,2624,,4340,POINT (4697157 -74140516)
2013,Octubre,Ecuador,0,1,,1,POINT (4815189 -75736374)
2013,Octubre,Ecuador,477,545,,1022,POINT (6170465 -7542726)
2013,Octubre,Ecuador,0,1,,1,POINT (7088729 -70740253)
2013,Octubre,Ecuador,0,1,,1,POINT (7128047 -73181317)
2013,Octubre,Ecuador,146,222,,368,POINT (7819 -72453013)
2013,Octubre,Ecuador,1,3,,4,POINT (7927233 -72508188)
2013,Octubre,Ecuador,1,0,,1,POINT (863337 -7735002)
2013,Octubre,Egipto,1,2,,3,POINT (10446304 -75516486)
2013,Octubre,Egipto,4,13,,17,POINT (4697157 -74140516)
2013,Octubre,Egipto,0,1,,1,POINT (6170465 -7542726)
2013,Octubre,El Salvador,0,2,,2,POINT (0.81488 -77356)
2013,Octubre,El Salvador,11,13,,24,POINT (10446304 -75516486)
2013,Octubre,El Salvador,3,4,,7,POINT (10886686 -74776479)
2013,Octubre,El Salvador,55,95,,150,POINT (3451668 -76532004)
2013,Octubre,El Salvador,498,821,,1319,POINT (4697157 -74140516)
2013,Octubre,El Salvador,0,2,,2,POINT (4815189 -75736374)
2013,Octubre,El Salvador,26,43,,69,POINT (6170465 -7542726)
2013,Octubre,El Salvador,0,2,,2,POINT (7819 -72453013)
2013,Octubre,El Salvador,0,1,,1,POINT (7927233 -72508188)
2013,Octubre,Emiratos Árabes,0,2,,2,POINT (10446304 -75516486)
2013,Octubre,Emiratos Árabes,3,10,,13,POINT (4697157 -74140516)
2013,Octubre,España,1,5,,6,POINT (-4191162 -69941498)
2013,Octubre,España,0,1,,1,POINT (0.33002 -76876446)
2013,Octubre,España,26,49,,75,POINT (0.81488 -77356)
2013,Octubre,España,25,27,,52,POINT (10406342 -75527794)
2013,Octubre,España,34,71,,105,POINT (10446304 -75516486)
2013,Octubre,España,8,26,,34,POINT (10886686 -74776479)
2013,Octubre,España,0,2,,2,POINT (10970933 -74765343)
2013,Octubre,España,6,15,,21,POINT (11360029 -72129595)
2013,Octubre,España,2,3,,5,POINT (125862 -81702165)
2013,Octubre,España,186,329,,515,POINT (3451668 -76532004)
2013,Octubre,España,0,2,,2,POINT (445285 -75766353)
2013,Octubre,España,1920,5298,,7218,POINT (4697157 -74140516)
2013,Octubre,España,2,8,,10,POINT (4815189 -75736374)
2013,Octubre,España,123,373,,496,POINT (6170465 -7542726)
2013,Octubre,España,0,1,,1,POINT (6185536 -67484028)
2013,Octubre,España,1,0,,1,POINT (7128047 -73181317)
2013,Octubre,España,11,39,,50,POINT (7819 -72453013)
2013,Octubre,España,2,4,,6,POINT (7927233 -72508188)
2013,Octubre,España,0,1,,1,POINT (806667 -767333)
2013,Octubre,España,0,1,,1,POINT (863337 -7735002)
2013,Octubre,Eslovaquia,0,1,,1,POINT (-4191162 -69941498)
2013,Octubre,Eslovaquia,0,1,,1,POINT (10406342 -75527794)
2013,Octubre,Eslovaquia,1,0,,1,POINT (3451668 -76532004)
2013,Octubre,Eslovaquia,9,19,,28,POINT (4697157 -74140516)
2013,Octubre,Eslovaquia,0,1,,1,POINT (4815189 -75736374)
2013,Octubre,Eslovaquia,0,3,,3,POINT (6170465 -7542726)
2013,Octubre,Eslovenia,1,0,,1,POINT (0.81488 -77356)
2013,Octubre,Eslovenia,0,1,,1,POINT (10406342 -75527794)
2013,Octubre,Eslovenia,0,1,,1,POINT (10446304 -75516486)
2013,Octubre,Eslovenia,12,19,,31,POINT (4697157 -74140516)
2013,Octubre,Eslovenia,0,2,,2,POINT (6170465 -7542726)
2013,Octubre,Estados Unidos de América,5,16,,21,POINT (-4191162 -69941498)
2013,Octubre,Estados Unidos de América,32,52,,84,POINT (0.81488 -77356)
2013,Octubre,Estados Unidos de América,28,70,,98,POINT (10406342 -75527794)
2013,Octubre,Estados Unidos de América,790,1573,,2363,POINT (10446304 -75516486)
2013,Octubre,Estados Unidos de América,216,394,,610,POINT (10886686 -74776479)
2013,Octubre,Estados Unidos de América,1,4,,5,POINT (11247723 -74213989)
2013,Octubre,Estados Unidos de América,9,8,,17,POINT (11360029 -72129595)
2013,Octubre,Estados Unidos de América,0,2,,2,POINT (125744111 -81703935)
2013,Octubre,Estados Unidos de América,7,8,,15,POINT (125862 -81702165)
2013,Octubre,Estados Unidos de América,458,837,,1295,POINT (3451668 -76532004)
2013,Octubre,Estados Unidos de América,0,1,,1,POINT (3884426 -77061029)
2013,Octubre,Estados Unidos de América,82,102,,184,POINT (445285 -75766353)
2013,Octubre,Estados Unidos de América,4523,9878,,14401,POINT (4697157 -74140516)
2013,Octubre,Estados Unidos de América,53,89,,142,POINT (4815189 -75736374)
2013,Octubre,Estados Unidos de América,882,2458,,3340,POINT (6170465 -7542726)
2013,Octubre,Estados Unidos de América,14,20,,34,POINT (7128047 -73181317)
2013,Octubre,Estados Unidos de América,26,54,,80,POINT (7819 -72453013)
2013,Octubre,Estados Unidos de América,7,27,,34,POINT (7927233 -72508188)
2013,Octubre,Estados Unidos de América,2,3,,5,POINT (806667 -767333)
2013,Octubre,Estonia,2,1,,3,POINT (-4191162 -69941498)
2013,Octubre,Estonia,2,7,,9,POINT (4697157 -74140516)
2013,Octubre,Estonia,0,1,,1,POINT (863337 -7735002)
2013,Octubre,Etiopia,0,3,,3,POINT (10446304 -75516486)
2013,Octubre,Etiopia,1,9,,10,POINT (4697157 -74140516)
2013,Octubre,Islas Fiji,0,1,,1,POINT (10446304 -75516486)
2013,Octubre,Islas Fiji,1,0,,1,POINT (10886686 -74776479)
2013,Octubre,Islas Fiji,0,5,,5,POINT (4697157 -74140516)
2013,Octubre,Filipinas,2,1,,3,POINT (0.81488 -77356)
2013,Octubre,Filipinas,1,78,,79,POINT (10406342 -75527794)
2013,Octubre,Filipinas,0,45,,45,POINT (10446304 -75516486)
2013,Octubre,Filipinas,0,3,,3,POINT (10886686 -74776479)
2013,Octubre,Filipinas,0,10,,10,POINT (10970933 -74765343)
2013,Octubre,Filipinas,0,10,,10,POINT (11247723 -74213989)
2013,Octubre,Filipinas,0,7,,7,POINT (3451668 -76532004)
2013,Octubre,Filipinas,0,32,,32,POINT (3884426 -77061029)
2013,Octubre,Filipinas,24,71,,95,POINT (4697157 -74140516)
2013,Octubre,Filipinas,0,5,,5,POINT (9402597 -75681642)
2013,Octubre,Finlandia,0,1,,1,POINT (0.33002 -76876446)
2013,Octubre,Finlandia,2,1,,3,POINT (0.81488 -77356)
2013,Octubre,Finlandia,0,1,,1,POINT (10406342 -75527794)
2013,Octubre,Finlandia,1,2,,3,POINT (10446304 -75516486)
2013,Octubre,Finlandia,0,2,,2,POINT (10886686 -74776479)
2013,Octubre,Finlandia,0,1,,1,POINT (1152863 -72919186)
2013,Octubre,Finlandia,2,4,,6,POINT (3451668 -76532004)
2013,Octubre,Finlandia,30,57,,87,POINT (4697157 -74140516)
2013,Octubre,Finlandia,0,1,,1,POINT (6170465 -7542726)
2013,Octubre,Finlandia,1,1,,2,POINT (7819 -72453013)
2013,Octubre,Francia,5,15,,20,POINT (-4191162 -69941498)
2013,Octubre,Francia,31,46,,77,POINT (0.81488 -77356)
2013,Octubre,Francia,16,31,,47,POINT (10406342 -75527794)
2013,Octubre,Francia,20,49,,69,POINT (10446304 -75516486)
2013,Octubre,Francia,4,9,,13,POINT (10886686 -74776479)
2013,Octubre,Francia,2,2,,4,POINT (11247723 -74213989)
2013,Octubre,Francia,2,4,,6,POINT (11360029 -72129595)
2013,Octubre,Francia,2,0,,2,POINT (125862 -81702165)
2013,Octubre,Francia,27,63,,90,POINT (3451668 -76532004)
2013,Octubre,Francia,849,1745,,2594,POINT (4697157 -74140516)
2013,Octubre,Francia,0,5,,5,POINT (4815189 -75736374)
2013,Octubre,Francia,38,91,,129,POINT (6170465 -7542726)
2013,Octubre,Francia,1,1,,2,POINT (6222552 -77401154)
2013,Octubre,Francia,0,1,,1,POINT (7128047 -73181317)
2013,Octubre,Francia,8,15,,23,POINT (7819 -72453013)
2013,Octubre,Francia,0,1,,1,POINT (7927233 -72508188)
2013,Octubre,Gabón,0,3,,3,POINT (4697157 -74140516)
2013,Octubre,Georgia,0,1,,1,POINT (10406342 -75527794)
2013,Octubre,Georgia,1,1,,2,POINT (10446304 -75516486)
2013,Octubre,Georgia,0,2,,2,POINT (4697157 -74140516)
2013,Octubre,Georgia,0,1,,1,POINT (6170465 -7542726)
2013,Octubre,Georgia,0,1,,1,POINT (9402597 -75681642)
2013,Octubre,Ghana,0,4,,4,POINT (10446304 -75516486)
2013,Octubre,Ghana,0,1,,1,POINT (4697157 -74140516)
2013,Octubre,Granada,0,1,,1,POINT (10446304 -75516486)
2013,Octubre,Grecia,1,0,,1,POINT (-4191162 -69941498)
2013,Octubre,Grecia,0,3,,3,POINT (10406342 -75527794)
2013,Octubre,Grecia,0,6,,6,POINT (10446304 -75516486)
2013,Octubre,Grecia,0,4,,4,POINT (10970933 -74765343)
2013,Octubre,Grecia,2,1,,3,POINT (3451668 -76532004)
2013,Octubre,Grecia,17,54,,71,POINT (4697157 -74140516)
2013,Octubre,Grecia,1,1,,2,POINT (6170465 -7542726)
2013,Octubre,Grecia,1,2,,3,POINT (9402597 -75681642)
2013,Octubre,Guatemala,0,1,,1,POINT (0.81488 -77356)
2013,Octubre,Guatemala,1,2,,3,POINT (10406342 -75527794)
2013,Octubre,Guatemala,26,34,,60,POINT (10446304 -75516486)
2013,Octubre,Guatemala,8,31,,39,POINT (10886686 -74776479)
2013,Octubre,Guatemala,1,0,,1,POINT (10970933 -74765343)
2013,Octubre,Guatemala,0,3,,3,POINT (11360029 -72129595)
2013,Octubre,Guatemala,10,4,,14,POINT (125862 -81702165)
2013,Octubre,Guatemala,14,41,,55,POINT (3451668 -76532004)
2013,Octubre,Guatemala,1,0,,1,POINT (445285 -75766353)
2013,Octubre,Guatemala,243,511,,754,POINT (4697157 -74140516)
2013,Octubre,Guatemala,2,4,,6,POINT (4815189 -75736374)
2013,Octubre,Guatemala,29,76,,105,POINT (6170465 -7542726)
2013,Octubre,Guatemala,0,1,,1,POINT (7128047 -73181317)
2013,Octubre,Guatemala,2,4,,6,POINT (7819 -72453013)
2013,Octubre,Guatemala,0,1,,1,POINT (7927233 -72508188)
2013,Octubre,Guyana,0,3,,3,POINT (10446304 -75516486)
2013,Octubre,Guyana,0,1,,1,POINT (3451668 -76532004)
2013,Octubre,Guyana,3,5,,8,POINT (4697157 -74140516)
2013,Octubre,Guyana,0,1,,1,POINT (4815189 -75736374)
2013,Octubre,Guyana,2,2,,4,POINT (6170465 -7542726)
2013,Octubre,Guyana,0,2,,2,POINT (7819 -72453013)
2013,Octubre,Guinea,0,4,,4,POINT (4697157 -74140516)
2013,Octubre,Guinea Ecuatorial,1,0,,1,POINT (4697157 -74140516)
2013,Octubre,Guinea Bissau,0,2,,2,POINT (3451668 -76532004)
2013,Octubre,Haití,0,2,,2,POINT (10406342 -75527794)
2013,Octubre,Haití,0,3,,3,POINT (10446304 -75516486)
2013,Octubre,Haití,1,3,,4,POINT (10886686 -74776479)
2013,Octubre,Haití,2,14,,16,POINT (4697157 -74140516)
2013,Octubre,Haití,0,15,,15,POINT (6170465 -7542726)
2013,Octubre,Honduras,2,1,,3,POINT (0.81488 -77356)
2013,Octubre,Honduras,0,4,,4,POINT (10406342 -75527794)
2013,Octubre,Honduras,28,44,,72,POINT (10446304 -75516486)
2013,Octubre,Honduras,4,4,,8,POINT (10886686 -74776479)
2013,Octubre,Honduras,0,2,,2,POINT (10970933 -74765343)
2013,Octubre,Honduras,0,15,,15,POINT (125744111 -81703935)
2013,Octubre,Honduras,0,2,,2,POINT (133387613 -81372937)
2013,Octubre,Honduras,8,28,,36,POINT (3451668 -76532004)
2013,Octubre,Honduras,124,198,,322,POINT (4697157 -74140516)
2013,Octubre,Honduras,5,3,,8,POINT (4815189 -75736374)
2013,Octubre,Honduras,25,39,,64,POINT (6170465 -7542726)
2013,Octubre,Honduras,0,1,,1,POINT (7128047 -73181317)
2013,Octubre,Honduras,1,1,,2,POINT (7819 -72453013)
2013,Octubre,Honduras,0,2,,2,POINT (806667 -767333)
2013,Octubre,Hong Kong,0,1,,1,POINT (4697157 -74140516)
2013,Octubre,Hungría,2,2,,4,POINT (0.81488 -77356)
2013,Octubre,Hungría,0,1,,1,POINT (10406342 -75527794)
2013,Octubre,Hungría,0,1,,1,POINT (10446304 -75516486)
2013,Octubre,Hungría,0,2,,2,POINT (3451668 -76532004)
2013,Octubre,Hungría,16,33,,49,POINT (4697157 -74140516)
2013,Octubre,Hungría,0,5,,5,POINT (6170465 -7542726)
2013,Octubre,Hungría,2,1,,3,POINT (7819 -72453013)
2013,Octubre,India,0,3,,3,POINT (0.81488 -77356)
2013,Octubre,India,2,3,,5,POINT (10406342 -75527794)
2013,Octubre,India,1,16,,17,POINT (10446304 -75516486)
2013,Octubre,India,0,4,,4,POINT (10886686 -74776479)
2013,Octubre,India,1,0,,1,POINT (10970933 -74765343)
2013,Octubre,India,0,2,,2,POINT (11247723 -74213989)
2013,Octubre,India,0,1,,1,POINT (125862 -81702165)
2013,Octubre,India,5,10,,15,POINT (3451668 -76532004)
2013,Octubre,India,34,227,,261,POINT (4697157 -74140516)
2013,Octubre,India,1,22,,23,POINT (6170465 -7542726)
2013,Octubre,India,0,2,,2,POINT (9402597 -75681642)
2013,Octubre,Indonesia,0,2,,2,POINT (0.81488 -77356)
2013,Octubre,Indonesia,0,13,,13,POINT (10406342 -75527794)
2013,Octubre,Indonesia,1,11,,12,POINT (10446304 -75516486)
2013,Octubre,Indonesia,0,1,,1,POINT (11247723 -74213989)
2013,Octubre,Indonesia,0,3,,3,POINT (3451668 -76532004)
2013,Octubre,Indonesia,0,8,,8,POINT (3884426 -77061029)
2013,Octubre,Indonesia,6,18,,24,POINT (4697157 -74140516)
2013,Octubre,Indonesia,0,1,,1,POINT (6170465 -7542726)
2013,Octubre,Iraq,0,9,,9,POINT (4697157 -74140516)
2013,Octubre,Irán,3,25,,28,POINT (4697157 -74140516)
2013,Octubre,Irán,0,1,,1,POINT (6170465 -7542726)
2013,Octubre,República de Irlanda,0,4,,4,POINT (-4191162 -69941498)
2013,Octubre,República de Irlanda,13,7,,20,POINT (0.81488 -77356)
2013,Octubre,República de Irlanda,2,4,,6,POINT (10406342 -75527794)
2013,Octubre,República de Irlanda,7,10,,17,POINT (10446304 -75516486)
2013,Octubre,República de Irlanda,5,3,,8,POINT (3451668 -76532004)
2013,Octubre,República de Irlanda,32,97,,129,POINT (4697157 -74140516)
2013,Octubre,República de Irlanda,4,15,,19,POINT (6170465 -7542726)
2013,Octubre,República de Irlanda,0,1,,1,POINT (7819 -72453013)
2013,Octubre,Islandia,1,2,,3,POINT (10446304 -75516486)
2013,Octubre,Islandia,1,0,,1,POINT (3451668 -76532004)
2013,Octubre,Islandia,3,5,,8,POINT (4697157 -74140516)
2013,Octubre,Isla de Man,1,1,,2,POINT (0.81488 -77356)
2013,Octubre,Isla de Man,1,0,,1,POINT (10886686 -74776479)
2013,Octubre,Isla de Man,1,2,,3,POINT (3451668 -76532004)
2013,Octubre,Isla de Man,6,8,,14,POINT (4697157 -74140516)
2013,Octubre,Isla de Man,0,1,,1,POINT (7128047 -73181317)
2013,Octubre,Israel,0,2,,2,POINT (-4191162 -69941498)
2013,Octubre,Israel,3,13,,16,POINT (0.81488 -77356)
2013,Octubre,Israel,0,2,,2,POINT (10406342 -75527794)
2013,Octubre,Israel,3,36,,39,POINT (10446304 -75516486)
2013,Octubre,Israel,0,1,,1,POINT (10886686 -74776479)
2013,Octubre,Israel,2,7,,9,POINT (3451668 -76532004)
2013,Octubre,Israel,61,405,,466,POINT (4697157 -74140516)
2013,Octubre,Israel,1,33,,34,POINT (6170465 -7542726)
2013,Octubre,Italia,5,14,,19,POINT (-4191162 -69941498)
2013,Octubre,Italia,0,1,,1,POINT (0.33002 -76876446)
2013,Octubre,Italia,6,16,,22,POINT (0.81488 -77356)
2013,Octubre,Italia,4,7,,11,POINT (10406342 -75527794)
2013,Octubre,Italia,23,61,,84,POINT (10446304 -75516486)
2013,Octubre,Italia,3,11,,14,POINT (10886686 -74776479)
2013,Octubre,Italia,1,2,,3,POINT (11247723 -74213989)
2013,Octubre,Italia,0,5,,5,POINT (11360029 -72129595)
2013,Octubre,Italia,0,1,,1,POINT (125744111 -81703935)
2013,Octubre,Italia,0,3,,3,POINT (125862 -81702165)
2013,Octubre,Italia,15,61,,76,POINT (3451668 -76532004)
2013,Octubre,Italia,404,1615,,2019,POINT (4697157 -74140516)
2013,Octubre,Italia,0,3,,3,POINT (4815189 -75736374)
2013,Octubre,Italia,38,94,,132,POINT (6170465 -7542726)
2013,Octubre,Italia,0,1,,1,POINT (7128047 -73181317)
2013,Octubre,Italia,7,20,,27,POINT (7819 -72453013)
2013,Octubre,Italia,1,4,,5,POINT (7927233 -72508188)
2013,Octubre,Islas del Canal,0,1,,1,POINT (10886686 -74776479)
2013,Octubre,Islas del Canal,1,1,,2,POINT (7819 -72453013)
2013,Octubre,Jamaica,1,5,,6,POINT (10446304 -75516486)
2013,Octubre,Jamaica,2,0,,2,POINT (10886686 -74776479)
2013,Octubre,Jamaica,1,2,,3,POINT (125862 -81702165)
2013,Octubre,Jamaica,1,3,,4,POINT (3451668 -76532004)
2013,Octubre,Jamaica,8,30,,38,POINT (4697157 -74140516)
2013,Octubre,Jamaica,2,3,,5,POINT (6170465 -7542726)
2013,Octubre,Japón,1,0,,1,POINT (-4191162 -69941498)
2013,Octubre,Japón,5,8,,13,POINT (0.81488 -77356)
2013,Octubre,Japón,2,2,,4,POINT (10406342 -75527794)
2013,Octubre,Japón,3,17,,20,POINT (10446304 -75516486)
2013,Octubre,Japón,1,9,,10,POINT (10886686 -74776479)
2013,Octubre,Japón,1,0,,1,POINT (11360029 -72129595)
2013,Octubre,Japón,2,0,,2,POINT (125862 -81702165)
2013,Octubre,Japón,5,10,,15,POINT (3451668 -76532004)
2013,Octubre,Japón,97,397,,494,POINT (4697157 -74140516)
2013,Octubre,Japón,0,1,,1,POINT (4815189 -75736374)
2013,Octubre,Japón,7,37,,44,POINT (6170465 -7542726)
2013,Octubre,Japón,0,2,,2,POINT (7128047 -73181317)
2013,Octubre,Japón,2,3,,5,POINT (7819 -72453013)
2013,Octubre,Jordania,0,2,,2,POINT (3451668 -76532004)
2013,Octubre,Jordania,1,5,,6,POINT (4697157 -74140516)
2013,Octubre,Kazajistán,0,1,,1,POINT (4697157 -74140516)
2013,Octubre,Kenia,0,1,,1,POINT (0.33002 -76876446)
2013,Octubre,Kenia,2,1,,3,POINT (10446304 -75516486)
2013,Octubre,Kenia,2,11,,13,POINT (4697157 -74140516)
2013,Octubre,Kenia,0,1,,1,POINT (6170465 -7542726)
2013,Octubre,Kirguistán,2,1,,3,POINT (4697157 -74140516)
2013,Octubre,Kuwait,0,10,,10,POINT (4697157 -74140516)
2013,Octubre,República de Kosovo,1,0,,1,POINT (4697157 -74140516)
2013,Octubre,Lesoto,0,4,,4,POINT (10446304 -75516486)
2013,Octubre,Letonia,0,6,,6,POINT (10446304 -75516486)
2013,Octubre,Letonia,0,2,,2,POINT (10970933 -74765343)
2013,Octubre,Letonia,6,5,,11,POINT (4697157 -74140516)
2013,Octubre,Letonia,3,0,,3,POINT (6170465 -7542726)
2013,Octubre,Lituania,1,4,,5,POINT (10446304 -75516486)
2013,Octubre,Lituania,4,4,,8,POINT (4697157 -74140516)
2013,Octubre,Lituania,1,0,,1,POINT (6170465 -7542726)
2013,Octubre,Lituania,0,1,,1,POINT (7819 -72453013)
2013,Octubre,Líbano,0,3,,3,POINT (10886686 -74776479)
2013,Octubre,Líbano,6,7,,13,POINT (11360029 -72129595)
2013,Octubre,Líbano,0,1,,1,POINT (3451668 -76532004)
2013,Octubre,Líbano,11,24,,35,POINT (4697157 -74140516)
2013,Octubre,Liberia,0,1,,1,POINT (4697157 -74140516)
2013,Octubre,Libia,0,1,,1,POINT (4697157 -74140516)
2013,Octubre,Liechtenstein,1,3,,4,POINT (4697157 -74140516)
2013,Octubre,Luxemburgo,0,1,,1,POINT (0.81488 -77356)
2013,Octubre,Luxemburgo,1,0,,1,POINT (10446304 -75516486)
2013,Octubre,Luxemburgo,4,15,,19,POINT (4697157 -74140516)
2013,Octubre,Luxemburgo,0,1,,1,POINT (6170465 -7542726)
2013,Octubre,Macedonia,0,1,,1,POINT (10446304 -75516486)
2013,Octubre,Macedonia,2,0,,2,POINT (4697157 -74140516)
2013,Octubre,Madagascar,1,0,,1,POINT (3451668 -76532004)
2013,Octubre,Madagascar,1,2,,3,POINT (4697157 -74140516)
2013,Octubre,Malasia,0,2,,2,POINT (10406342 -75527794)
2013,Octubre,Malasia,1,5,,6,POINT (10446304 -75516486)
2013,Octubre,Malasia,0,1,,1,POINT (11247723 -74213989)
2013,Octubre,Malasia,0,1,,1,POINT (3451668 -76532004)
2013,Octubre,Malasia,10,23,,33,POINT (4697157 -74140516)
2013,Octubre,Malasia,0,1,,1,POINT (6170465 -7542726)
2013,Octubre,Malasia,1,0,,1,POINT (7819 -72453013)
2013,Octubre,Malawi,1,1,,2,POINT (10446304 -75516486)
2013,Octubre,Malawi,1,4,,5,POINT (4697157 -74140516)
2013,Octubre,Malí,0,3,,3,POINT (4697157 -74140516)
2013,Octubre,Malta,2,8,,10,POINT (4697157 -74140516)
2013,Octubre,Marruecos,1,1,,2,POINT (10406342 -75527794)
2013,Octubre,Marruecos,0,1,,1,POINT (3451668 -76532004)
2013,Octubre,Marruecos,2,6,,8,POINT (4697157 -74140516)
2013,Octubre,Marruecos,1,0,,1,POINT (6170465 -7542726)
2013,Octubre,Islas Marshall,0,1,,1,POINT (4697157 -74140516)
2013,Octubre,Mauritania,0,2,,2,POINT (4697157 -74140516)
2013,Octubre,México,0,2,,2,POINT (-4191162 -69941498)
2013,Octubre,México,0,1,,1,POINT (0.33002 -76876446)
2013,Octubre,México,10,14,,24,POINT (0.81488 -77356)
2013,Octubre,México,0,1,,1,POINT (1800143 -78802679)
2013,Octubre,México,7,10,,17,POINT (10406342 -75527794)
2013,Octubre,México,84,183,,267,POINT (10446304 -75516486)
2013,Octubre,México,11,35,,46,POINT (10886686 -74776479)
2013,Octubre,México,13,11,,24,POINT (11360029 -72129595)
2013,Octubre,México,0,1,,1,POINT (125862 -81702165)
2013,Octubre,México,48,115,,163,POINT (3451668 -76532004)
2013,Octubre,México,2371,5217,,7588,POINT (4697157 -74140516)
2013,Octubre,México,2,37,,39,POINT (4815189 -75736374)
2013,Octubre,México,106,319,,425,POINT (6170465 -7542726)
2013,Octubre,México,0,1,,1,POINT (6185536 -67484028)
2013,Octubre,México,1,4,,5,POINT (7128047 -73181317)
2013,Octubre,México,14,63,,77,POINT (7819 -72453013)
2013,Octubre,México,0,3,,3,POINT (7927233 -72508188)
2013,Octubre,República de Moldavia,2,3,,5,POINT (4697157 -74140516)
2013,Octubre,Mónaco,2,3,,5,POINT (4697157 -74140516)
2013,Octubre,Mongolia,1,0,,1,POINT (10446304 -75516486)
2013,Octubre,Mongolia,1,3,,4,POINT (4697157 -74140516)
2013,Octubre,Montenegro,0,1,,1,POINT (10406342 -75527794)
2013,Octubre,Montenegro,0,1,,1,POINT (4697157 -74140516)
2013,Octubre,Mozambique,0,1,,1,POINT (0.33002 -76876446)
2013,Octubre,Mozambique,0,7,,7,POINT (4697157 -74140516)
2013,Octubre,Myanmar,0,3,,3,POINT (4697157 -74140516)
2013,Octubre,Namibia,2,6,,8,POINT (4697157 -74140516)
2013,Octubre,Nepal,0,1,,1,POINT (3451668 -76532004)
2013,Octubre,Nepal,0,4,,4,POINT (4697157 -74140516)
2013,Octubre,Nepal,0,1,,1,POINT (6170465 -7542726)
2013,Octubre,Nicaragua,0,5,,5,POINT (10406342 -75527794)
2013,Octubre,Nicaragua,8,6,,14,POINT (10446304 -75516486)
2013,Octubre,Nicaragua,1,6,,7,POINT (10886686 -74776479)
2013,Octubre,Nicaragua,0,2,,2,POINT (125744111 -81703935)
2013,Octubre,Nicaragua,0,1,,1,POINT (125862 -81702165)
2013,Octubre,Nicaragua,13,16,,29,POINT (3451668 -76532004)
2013,Octubre,Nicaragua,68,99,,167,POINT (4697157 -74140516)
2013,Octubre,Nicaragua,1,1,,2,POINT (4815189 -75736374)
2013,Octubre,Nicaragua,12,13,,25,POINT (6170465 -7542726)
2013,Octubre,Nicaragua,1,0,,1,POINT (7128047 -73181317)
2013,Octubre,Nigeria,0,5,,5,POINT (10446304 -75516486)
2013,Octubre,Nigeria,2,8,,10,POINT (4697157 -74140516)
2013,Octubre,Nigeria,0,1,,1,POINT (6170465 -7542726)
2013,Octubre,Níger,0,2,,2,POINT (10446304 -75516486)
2013,Octubre,Níger,0,1,,1,POINT (4697157 -74140516)
2013,Octubre,Noruega,1,2,,3,POINT (-4191162 -69941498)
2013,Octubre,Noruega,3,0,,3,POINT (0.81488 -77356)
2013,Octubre,Noruega,2,3,,5,POINT (10406342 -75527794)
2013,Octubre,Noruega,2,8,,10,POINT (10446304 -75516486)
2013,Octubre,Noruega,0,3,,3,POINT (10886686 -74776479)
2013,Octubre,Noruega,0,1,,1,POINT (11360029 -72129595)
2013,Octubre,Noruega,0,4,,4,POINT (3451668 -76532004)
2013,Octubre,Noruega,56,110,,166,POINT (4697157 -74140516)
2013,Octubre,Noruega,3,8,,11,POINT (6170465 -7542726)
2013,Octubre,Nueva Caledonia/Territorio francés,0,1,,1,POINT (4697157 -74140516)
2013,Octubre,Nueva Zelanda,0,1,,1,POINT (-4191162 -69941498)
2013,Octubre,Nueva Zelanda,7,8,,15,POINT (0.81488 -77356)
2013,Octubre,Nueva Zelanda,3,9,,12,POINT (10446304 -75516486)
2013,Octubre,Nueva Zelanda,0,2,,2,POINT (10886686 -74776479)
2013,Octubre,Nueva Zelanda,0,1,,1,POINT (11360029 -72129595)
2013,Octubre,Nueva Zelanda,2,5,,7,POINT (3451668 -76532004)
2013,Octubre,Nueva Zelanda,27,49,,76,POINT (4697157 -74140516)
2013,Octubre,Nueva Zelanda,1,1,,2,POINT (4815189 -75736374)
2013,Octubre,Nueva Zelanda,2,7,,9,POINT (6170465 -7542726)
2013,Octubre,Nueva Zelanda,0,1,,1,POINT (7819 -72453013)
2013,Octubre,Omán,0,3,,3,POINT (4697157 -74140516)
2013,Octubre,Nueva Zelanda,1,8,,9,POINT (10406342 -75527794)
2013,Octubre,Nueva Zelanda,0,1,,1,POINT (10886686 -74776479)
2013,Octubre,Nueva Zelanda,1,0,,1,POINT (11247723 -74213989)
2013,Octubre,Nueva Zelanda,0,4,,4,POINT (7819 -72453013)
2013,Octubre,Países Bajos,17,15,,32,POINT (0.81488 -77356)
2013,Octubre,Países Bajos,2,1,,3,POINT (10406342 -75527794)
2013,Octubre,Países Bajos,10,48,,58,POINT (10446304 -75516486)
2013,Octubre,Países Bajos,3,21,,24,POINT (10886686 -74776479)
2013,Octubre,Países Bajos,1,8,,9,POINT (11360029 -72129595)
2013,Octubre,Países Bajos,7,24,,31,POINT (1152863 -72919186)
2013,Octubre,Países Bajos,15,48,,63,POINT (3451668 -76532004)
2013,Octubre,Países Bajos,0,8,,8,POINT (3884426 -77061029)
2013,Octubre,Países Bajos,612,1004,,1616,POINT (4697157 -74140516)
2013,Octubre,Países Bajos,0,5,,5,POINT (4815189 -75736374)
2013,Octubre,Países Bajos,282,334,,616,POINT (6170465 -7542726)
2013,Octubre,Países Bajos,8,8,,16,POINT (7128047 -73181317)
2013,Octubre,Países Bajos,0,2,,2,POINT (7819 -72453013)
2013,Octubre,Pakistán,0,1,,1,POINT (0.81488 -77356)
2013,Octubre,Pakistán,0,3,,3,POINT (10446304 -75516486)
2013,Octubre,Pakistán,0,9,,9,POINT (4697157 -74140516)
2013,Octubre,Panamá,2,16,,18,POINT (10406342 -75527794)
2013,Octubre,Panamá,101,179,,280,POINT (10446304 -75516486)
2013,Octubre,Panamá,43,78,,121,POINT (10886686 -74776479)
2013,Octubre,Panamá,1,1,,2,POINT (11360029 -72129595)
2013,Octubre,Panamá,0,2,,2,POINT (125744111 -81703935)
2013,Octubre,Panamá,16,32,,48,POINT (125862 -81702165)
2013,Octubre,Panamá,72,144,,216,POINT (3451668 -76532004)
2013,Octubre,Panamá,550,886,,1436,POINT (4697157 -74140516)
2013,Octubre,Panamá,75,135,,210,POINT (4815189 -75736374)
2013,Octubre,Panamá,109,236,,345,POINT (6170465 -7542726)
2013,Octubre,Panamá,1,0,,1,POINT (6222552 -77401154)
2013,Octubre,Panamá,1,1,,2,POINT (7102626 -77762647)
2013,Octubre,Panamá,5,17,,22,POINT (7128047 -73181317)
2013,Octubre,Panamá,4,9,,13,POINT (7819 -72453013)
2013,Octubre,Panamá,4,11,,15,POINT (7927233 -72508188)
2013,Octubre,Panamá,0,9,,9,POINT (806667 -767333)
2013,Octubre,Paraguay,1,2,,3,POINT (0.81488 -77356)
2013,Octubre,Paraguay,0,1,,1,POINT (10406342 -75527794)
2013,Octubre,Paraguay,12,13,,25,POINT (10446304 -75516486)
2013,Octubre,Paraguay,0,8,,8,POINT (10886686 -74776479)
2013,Octubre,Paraguay,3,1,,4,POINT (11360029 -72129595)
2013,Octubre,Paraguay,10,4,,14,POINT (125862 -81702165)
2013,Octubre,Paraguay,5,10,,15,POINT (3451668 -76532004)
2013,Octubre,Paraguay,76,121,,197,POINT (4697157 -74140516)
2013,Octubre,Paraguay,8,4,,12,POINT (6170465 -7542726)
2013,Octubre,Paraguay,1,1,,2,POINT (7819 -72453013)
2013,Octubre,Perú,25,26,,51,POINT (-4191162 -69941498)
2013,Octubre,Perú,2,6,,8,POINT (0.33002 -76876446)
2013,Octubre,Perú,200,362,,562,POINT (0.81488 -77356)
2013,Octubre,Perú,40,30,,70,POINT (10406342 -75527794)
2013,Octubre,Perú,150,126,,276,POINT (10446304 -75516486)
2013,Octubre,Perú,6,17,,23,POINT (10886686 -74776479)
2013,Octubre,Perú,10,41,,51,POINT (11360029 -72129595)
2013,Octubre,Perú,129,98,,227,POINT (125862 -81702165)
2013,Octubre,Perú,117,199,,316,POINT (3451668 -76532004)
2013,Octubre,Perú,2879,3415,,6294,POINT (4697157 -74140516)
2013,Octubre,Perú,0,4,,4,POINT (4815189 -75736374)
2013,Octubre,Perú,241,404,,645,POINT (6170465 -7542726)
2013,Octubre,Perú,0,2,,2,POINT (6185536 -67484028)
2013,Octubre,Perú,1,0,,1,POINT (7088729 -70740253)
2013,Octubre,Perú,7,8,,15,POINT (7128047 -73181317)
2013,Octubre,Perú,50,110,,160,POINT (7819 -72453013)
2013,Octubre,Perú,4,11,,15,POINT (7927233 -72508188)
2013,Octubre,Perú,0,1,,1,POINT (863337 -7735002)
2013,Octubre,Palestina,3,3,,6,POINT (4697157 -74140516)
2013,Octubre,Polonia,2,1,,3,POINT (-4191162 -69941498)
2013,Octubre,Polonia,2,5,,7,POINT (0.81488 -77356)
2013,Octubre,Polonia,0,13,,13,POINT (10406342 -75527794)
2013,Octubre,Polonia,0,5,,5,POINT (10446304 -75516486)
2013,Octubre,Polonia,1,2,,3,POINT (10886686 -74776479)
2013,Octubre,Polonia,1,2,,3,POINT (3451668 -76532004)
2013,Octubre,Polonia,75,87,,162,POINT (4697157 -74140516)
2013,Octubre,Polonia,3,5,,8,POINT (6170465 -7542726)
2013,Octubre,Polonia,2,0,,2,POINT (6185536 -67484028)
2013,Octubre,Polonia,0,2,,2,POINT (806667 -767333)
2013,Octubre,Portugal,0,2,,2,POINT (10406342 -75527794)
2013,Octubre,Portugal,3,9,,12,POINT (10446304 -75516486)
2013,Octubre,Portugal,1,1,,2,POINT (10886686 -74776479)
2013,Octubre,Portugal,1,2,,3,POINT (11360029 -72129595)
2013,Octubre,Portugal,3,12,,15,POINT (3451668 -76532004)
2013,Octubre,Portugal,158,387,,545,POINT (4697157 -74140516)
2013,Octubre,Portugal,1,2,,3,POINT (4815189 -75736374)
2013,Octubre,Portugal,2,11,,13,POINT (6170465 -7542726)
2013,Octubre,Portugal,3,0,,3,POINT (6185536 -67484028)
2013,Octubre,Portugal,0,5,,5,POINT (7819 -72453013)
2013,Octubre,Portugal,0,1,,1,POINT (7927233 -72508188)
2013,Octubre,Puerto Rico/Territorio de Estados Unidos,0,2,,2,POINT (10886686 -74776479)
2013,Octubre,Qatar,0,4,,4,POINT (4697157 -74140516)
2013,Octubre,Qatar,0,1,,1,POINT (6170465 -7542726)
2013,Octubre,Reino Unido de Gran Bretaña e Irlanda del Norte,1,4,,5,POINT (-4191162 -69941498)
2013,Octubre,Reino Unido de Gran Bretaña e Irlanda del Norte,20,28,,48,POINT (0.81488 -77356)
2013,Octubre,Reino Unido de Gran Bretaña e Irlanda del Norte,3,7,,10,POINT (10406342 -75527794)
2013,Octubre,Reino Unido de Gran Bretaña e Irlanda del Norte,33,66,,99,POINT (10446304 -75516486)
2013,Octubre,Reino Unido de Gran Bretaña e Irlanda del Norte,3,9,,12,POINT (10886686 -74776479)
2013,Octubre,Reino Unido de Gran Bretaña e Irlanda del Norte,5,7,,12,POINT (11360029 -72129595)
2013,Octubre,Reino Unido de Gran Bretaña e Irlanda del Norte,16,39,,55,POINT (3451668 -76532004)
2013,Octubre,Reino Unido de Gran Bretaña e Irlanda del Norte,0,1,,1,POINT (3884426 -77061029)
2013,Octubre,Reino Unido de Gran Bretaña e Irlanda del Norte,2,0,,2,POINT (445285 -75766353)
2013,Octubre,Reino Unido de Gran Bretaña e Irlanda del Norte,454,1181,,1635,POINT (4697157 -74140516)
2013,Octubre,Reino Unido de Gran Bretaña e Irlanda del Norte,1,2,,3,POINT (4815189 -75736374)
2013,Octubre,Reino Unido de Gran Bretaña e Irlanda del Norte,35,83,,118,POINT (6170465 -7542726)
2013,Octubre,Reino Unido de Gran Bretaña e Irlanda del Norte,1,0,,1,POINT (7128047 -73181317)
2013,Octubre,Reino Unido de Gran Bretaña e Irlanda del Norte,1,0,,1,POINT (7819 -72453013)
2013,Octubre,República Dominicana,5,8,,13,POINT (0.81488 -77356)
2013,Octubre,República Dominicana,2,3,,5,POINT (10406342 -75527794)
2013,Octubre,República Dominicana,28,43,,71,POINT (10446304 -75516486)
2013,Octubre,República Dominicana,11,12,,23,POINT (10886686 -74776479)
2013,Octubre,República Dominicana,1,3,,4,POINT (11360029 -72129595)
2013,Octubre,República Dominicana,19,25,,44,POINT (3451668 -76532004)
2013,Octubre,República Dominicana,223,327,,550,POINT (4697157 -74140516)
2013,Octubre,República Dominicana,4,3,,7,POINT (4815189 -75736374)
2013,Octubre,República Dominicana,25,36,,61,POINT (6170465 -7542726)
2013,Octubre,República Dominicana,1,0,,1,POINT (7102626 -77762647)
2013,Octubre,República Dominicana,0,3,,3,POINT (7128047 -73181317)
2013,Octubre,República Dominicana,0,1,,1,POINT (7819 -72453013)
2013,Octubre,República Dominicana,1,0,,1,POINT (7927233 -72508188)
2013,Octubre,República Checa,1,1,,2,POINT (10406342 -75527794)
2013,Octubre,Rumania,0,1,,1,POINT (0.81488 -77356)
2013,Octubre,Rumania,2,2,,4,POINT (10406342 -75527794)
2013,Octubre,Rumania,1,2,,3,POINT (10446304 -75516486)
2013,Octubre,Rumania,0,3,,3,POINT (10970933 -74765343)
2013,Octubre,Rumania,1,1,,2,POINT (11360029 -72129595)
2013,Octubre,Rumania,0,1,,1,POINT (3451668 -76532004)
2013,Octubre,Rumania,37,81,,118,POINT (4697157 -74140516)
2013,Octubre,Rumania,9,9,,18,POINT (6170465 -7542726)
2013,Octubre,Rumania,1,1,,2,POINT (7819 -72453013)
2013,Octubre,Federación de Rusia,11,11,,22,POINT (0.81488 -77356)
2013,Octubre,Federación de Rusia,7,3,,10,POINT (10406342 -75527794)
2013,Octubre,Federación de Rusia,1,4,,5,POINT (10446304 -75516486)
2013,Octubre,Federación de Rusia,0,1,,1,POINT (11360029 -72129595)
2013,Octubre,Federación de Rusia,1,2,,3,POINT (3451668 -76532004)
2013,Octubre,Federación de Rusia,0,1,,1,POINT (3884426 -77061029)
2013,Octubre,Federación de Rusia,1,0,,1,POINT (445285 -75766353)
2013,Octubre,Federación de Rusia,141,213,,354,POINT (4697157 -74140516)
2013,Octubre,Federación de Rusia,1,5,,6,POINT (6170465 -7542726)
2013,Octubre,Rwanda,0,3,,3,POINT (4697157 -74140516)
2013,Octubre,Sahara Occidental/Desierto Sahara,0,1,,1,POINT (4697157 -74140516)
2013,Octubre,San Cristóbal y Nevis,0,1,,1,POINT (11360029 -72129595)
2013,Octubre,San Cristóbal y Nevis,0,1,,1,POINT (4697157 -74140516)
2013,Octubre,San Cristóbal y Nevis,1,1,,2,POINT (6170465 -7542726)
2013,Octubre,Samoa Occidental,1,0,,1,POINT (4697157 -74140516)
2013,Octubre,San Marino,1,0,,1,POINT (4697157 -74140516)
2013,Octubre,San  Vicente y las Granadinas,1,4,,5,POINT (10446304 -75516486)
2013,Octubre,San  Vicente y las Granadinas,0,1,,1,POINT (4697157 -74140516)
2013,Octubre,Santa Lucia,1,0,,1,POINT (10406342 -75527794)
2013,Octubre,Santa Lucia,2,1,,3,POINT (4697157 -74140516)
2013,Octubre,Santa Lucia,1,0,,1,POINT (6170465 -7542726)
2013,Octubre,Santa Sede/Ciudad del Vaticano,0,1,,1,POINT (10446304 -75516486)
2013,Octubre,Santa Sede/Ciudad del Vaticano,0,1,,1,POINT (4697157 -74140516)
2013,Octubre,Senegal,0,1,,1,POINT (10886686 -74776479)
2013,Octubre,Senegal,0,3,,3,POINT (4697157 -74140516)
2013,Octubre,Serbia,0,1,,1,POINT (10406342 -75527794)
2013,Octubre,Serbia,6,15,,21,POINT (4697157 -74140516)
2013,Octubre,Sierra Leona,0,2,,2,POINT (10446304 -75516486)
2013,Octubre,Singapur,2,12,,14,POINT (10446304 -75516486)
2013,Octubre,Singapur,22,27,,49,POINT (4697157 -74140516)
2013,Octubre,Singapur,1,2,,3,POINT (6170465 -7542726)
2013,Octubre,República Árabe Siria,0,3,,3,POINT (4697157 -74140516)
2013,Octubre,Sri Lanka,1,0,,1,POINT (3451668 -76532004)
2013,Octubre,Sri Lanka,2,4,,6,POINT (4697157 -74140516)
2013,Octubre,Sri Lanka,0,1,,1,POINT (6170465 -7542726)
2013,Octubre,Sudáfrica,0,1,,1,POINT (-4191162 -69941498)
2013,Octubre,Sudáfrica,3,4,,7,POINT (0.81488 -77356)
2013,Octubre,Sudáfrica,2,3,,5,POINT (10406342 -75527794)
2013,Octubre,Sudáfrica,1,5,,6,POINT (10446304 -75516486)
2013,Octubre,Sudáfrica,0,1,,1,POINT (10886686 -74776479)
2013,Octubre,Sudáfrica,0,5,,5,POINT (3451668 -76532004)
2013,Octubre,Sudáfrica,25,67,,92,POINT (4697157 -74140516)
2013,Octubre,Sudáfrica,0,1,,1,POINT (6170465 -7542726)
2013,Octubre,Sudáfrica,1,0,,1,POINT (7819 -72453013)
2013,Octubre,Sudán,0,6,,6,POINT (10446304 -75516486)
2013,Octubre,Sudán,0,10,,10,POINT (4697157 -74140516)
2013,Octubre,Suecia,4,0,,4,POINT (-4191162 -69941498)
2013,Octubre,Suecia,3,5,,8,POINT (0.81488 -77356)
2013,Octubre,Suecia,4,6,,10,POINT (10406342 -75527794)
2013,Octubre,Suecia,8,15,,23,POINT (10446304 -75516486)
2013,Octubre,Suecia,2,2,,4,POINT (11247723 -74213989)
2013,Octubre,Suecia,9,8,,17,POINT (3451668 -76532004)
2013,Octubre,Suecia,100,209,,309,POINT (4697157 -74140516)
2013,Octubre,Suecia,0,1,,1,POINT (4815189 -75736374)
2013,Octubre,Suecia,5,17,,22,POINT (6170465 -7542726)
2013,Octubre,Suecia,0,2,,2,POINT (7128047 -73181317)
2013,Octubre,Suecia,5,5,,10,POINT (7819 -72453013)
2013,Octubre,Suiza,9,11,,20,POINT (-4191162 -69941498)
2013,Octubre,Suiza,16,18,,34,POINT (0.81488 -77356)
2013,Octubre,Suiza,13,12,,25,POINT (10406342 -75527794)
2013,Octubre,Suiza,13,21,,34,POINT (10446304 -75516486)
2013,Octubre,Suiza,6,8,,14,POINT (10886686 -74776479)
2013,Octubre,Suiza,2,3,,5,POINT (11360029 -72129595)
2013,Octubre,Suiza,18,29,,47,POINT (3451668 -76532004)
2013,Octubre,Suiza,266,502,,768,POINT (4697157 -74140516)
2013,Octubre,Suiza,0,1,,1,POINT (4815189 -75736374)
2013,Octubre,Suiza,27,41,,68,POINT (6170465 -7542726)
2013,Octubre,Suiza,2,3,,5,POINT (7819 -72453013)
2013,Octubre,Surinam,0,2,,2,POINT (3451668 -76532004)
2013,Octubre,Surinam,10,17,,27,POINT (4697157 -74140516)
2013,Octubre,Surinam,0,10,,10,POINT (6170465 -7542726)
2013,Octubre,Suazilandia,1,1,,2,POINT (10446304 -75516486)
2013,Octubre,Taiwán,3,1,,4,POINT (10446304 -75516486)
2013,Octubre,Taiwán,0,3,,3,POINT (10886686 -74776479)
2013,Octubre,Taiwán,0,1,,1,POINT (11360029 -72129595)
2013,Octubre,Taiwán,1,3,,4,POINT (3451668 -76532004)
2013,Octubre,Taiwán,34,56,,90,POINT (4697157 -74140516)
2013,Octubre,Taiwán,0,2,,2,POINT (4815189 -75736374)
2013,Octubre,Taiwán,2,11,,13,POINT (6170465 -7542726)
2013,Octubre,Tailandia,2,3,,5,POINT (10446304 -75516486)
2013,Octubre,Tailandia,5,5,,10,POINT (4697157 -74140516)
2013,Octubre,Tailandia,1,0,,1,POINT (6170465 -7542726)
2013,Octubre,Tíbet/Región Autónoma de China,1,0,,1,POINT (4697157 -74140516)
2013,Octubre,Territorio Antártico Británico/Territorio Británico de Ultramar,0,2,,2,POINT (4697157 -74140516)
2013,Octubre,Tanzania,1,4,,5,POINT (10446304 -75516486)
2013,Octubre,Tanzania,2,0,,2,POINT (4697157 -74140516)
2013,Octubre,Togo,0,1,,1,POINT (4697157 -74140516)
2013,Octubre,Trinidad y Tobago,5,11,,16,POINT (10446304 -75516486)
2013,Octubre,Trinidad y Tobago,1,0,,1,POINT (10886686 -74776479)
2013,Octubre,Trinidad y Tobago,0,1,,1,POINT (11247723 -74213989)
2013,Octubre,Trinidad y Tobago,0,1,,1,POINT (11360029 -72129595)
2013,Octubre,Trinidad y Tobago,0,27,,27,POINT (3451668 -76532004)
2013,Octubre,Trinidad y Tobago,43,51,,94,POINT (4697157 -74140516)
2013,Octubre,Trinidad y Tobago,1,4,,5,POINT (6170465 -7542726)
2013,Octubre,Trinidad y Tobago,5,7,,12,POINT (7128047 -73181317)
2013,Octubre,Trinidad y Tobago,0,1,,1,POINT (7927233 -72508188)
2013,Octubre,Túnez,0,2,,2,POINT (4697157 -74140516)
2013,Octubre,Turquía,0,1,,1,POINT (0.81488 -77356)
2013,Octubre,Turquía,0,5,,5,POINT (10406342 -75527794)
2013,Octubre,Turquía,1,5,,6,POINT (10446304 -75516486)
2013,Octubre,Turquía,1,0,,1,POINT (10886686 -74776479)
2013,Octubre,Turquía,6,4,,10,POINT (3451668 -76532004)
2013,Octubre,Turquía,0,1,,1,POINT (3884426 -77061029)
2013,Octubre,Turquía,32,86,,118,POINT (4697157 -74140516)
2013,Octubre,Turquía,1,3,,4,POINT (6170465 -7542726)
2013,Octubre,Turquía,0,2,,2,POINT (7819 -72453013)
2013,Octubre,Turquía,0,1,,1,POINT (9402597 -75681642)
2013,Octubre,Turkmenistán,0,3,,3,POINT (4697157 -74140516)
2013,Octubre,Ucrania,0,3,,3,POINT (10970933 -74765343)
2013,Octubre,Ucrania,24,24,,48,POINT (4697157 -74140516)
2013,Octubre,Ucrania,0,1,,1,POINT (6170465 -7542726)
2013,Octubre,Ucrania,1,0,,1,POINT (7927233 -72508188)
2013,Octubre,Uganda,1,1,,2,POINT (10446304 -75516486)
2013,Octubre,Uganda,2,8,,10,POINT (4697157 -74140516)
2013,Octubre,Federación de Rusia,0,2,,2,POINT (10406342 -75527794)
2013,Octubre,Federación de Rusia,0,1,,1,POINT (10970933 -74765343)
2013,Octubre,Federación de Rusia,23,9,,32,POINT (4697157 -74140516)
2013,Octubre,Federación de Rusia,0,2,,2,POINT (7819 -72453013)
2013,Octubre,Federación de Rusia,0,2,,2,POINT (9402597 -75681642)
2013,Octubre,Uruguay,3,3,,6,POINT (0.81488 -77356)
2013,Octubre,Uruguay,1,2,,3,POINT (10406342 -75527794)
2013,Octubre,Uruguay,76,66,,142,POINT (10446304 -75516486)
2013,Octubre,Uruguay,2,5,,7,POINT (10886686 -74776479)
2013,Octubre,Uruguay,2,0,,2,POINT (11360029 -72129595)
2013,Octubre,Uruguay,26,19,,45,POINT (125862 -81702165)
2013,Octubre,Uruguay,13,29,,42,POINT (3451668 -76532004)
2013,Octubre,Uruguay,148,316,,464,POINT (4697157 -74140516)
2013,Octubre,Uruguay,0,4,,4,POINT (4815189 -75736374)
2013,Octubre,Uruguay,18,30,,48,POINT (6170465 -7542726)
2013,Octubre,Uruguay,2,2,,4,POINT (7819 -72453013)
2013,Octubre,Uruguay,0,5,,5,POINT (7927233 -72508188)
2013,Octubre,Uzbekistán,1,0,,1,POINT (4697157 -74140516)
2013,Octubre,Venezuela,0,2,,2,POINT (-4191162 -69941498)
2013,Octubre,Venezuela,1,3,,4,POINT (0.33002 -76876446)
2013,Octubre,Venezuela,214,252,,466,POINT (0.81488 -77356)
2013,Octubre,Venezuela,7,26,,33,POINT (10406342 -75527794)
2013,Octubre,Venezuela,59,122,,181,POINT (10446304 -75516486)
2013,Octubre,Venezuela,33,86,,119,POINT (10886686 -74776479)
2013,Octubre,Venezuela,0,1,,1,POINT (10970933 -74765343)
2013,Octubre,Venezuela,1208,1953,,3161,POINT (11360029 -72129595)
2013,Octubre,Venezuela,0,2,,2,POINT (1152863 -72919186)
2013,Octubre,Venezuela,2,5,,7,POINT (125862 -81702165)
2013,Octubre,Venezuela,67,87,,154,POINT (3451668 -76532004)
2013,Octubre,Venezuela,0,1,,1,POINT (445285 -75766353)
2013,Octubre,Venezuela,5535,6683,,12218,POINT (4697157 -74140516)
2013,Octubre,Venezuela,1,10,,11,POINT (4815189 -75736374)
2013,Octubre,Venezuela,583,579,,1162,POINT (6170465 -7542726)
2013,Octubre,Venezuela,17,81,,98,POINT (6185536 -67484028)
2013,Octubre,Venezuela,119,159,,278,POINT (7088729 -70740253)
2013,Octubre,Venezuela,2,7,,9,POINT (7128047 -73181317)
2013,Octubre,Venezuela,1749,2071,,3820,POINT (7819 -72453013)
2013,Octubre,Venezuela,248,326,,574,POINT (7927233 -72508188)
2013,Octubre,Vietnam,1,0,,1,POINT (10446304 -75516486)
2013,Octubre,Vietnam,1,0,,1,POINT (3451668 -76532004)
2013,Octubre,Vietnam,1,8,,9,POINT (4697157 -74140516)
2013,Octubre,República Árabe de Yemen,0,1,,1,POINT (10446304 -75516486)
2013,Octubre,Zambia,3,2,,5,POINT (10446304 -75516486)
2013,Octubre,Zambia,0,1,,1,POINT (4697157 -74140516)
2013,Octubre,Zimbabue,2,2,,4,POINT (10446304 -75516486)
2013,Octubre,Zimbabue,1,3,,4,POINT (4697157 -74140516)
2013,Octubre,Islas Turcas y Caicos/Territorio Británico de Ultramar,0,1,,1,POINT (10446304 -75516486)
2013,Octubre,Islas Turcas y Caicos/Territorio Británico de Ultramar,1,1,,2,POINT (4697157 -74140516)
2013,Octubre,Reino Unido de Gran Bretaña e Irlanda del Norte,5,6,,11,POINT (-4191162 -69941498)
2013,Octubre,Reino Unido de Gran Bretaña e Irlanda del Norte,3,8,,11,POINT (0.81488 -77356)
2013,Octubre,Reino Unido de Gran Bretaña e Irlanda del Norte,7,20,,27,POINT (10406342 -75527794)
2013,Octubre,Reino Unido de Gran Bretaña e Irlanda del Norte,0,1,,1,POINT (11247723 -74213989)
2013,Octubre,Reino Unido de Gran Bretaña e Irlanda del Norte,0,4,,4,POINT (3451668 -76532004)
2013,Octubre,Reino Unido de Gran Bretaña e Irlanda del Norte,0,1,,1,POINT (3884426 -77061029)
2013,Octubre,Reino Unido de Gran Bretaña e Irlanda del Norte,15,51,,66,POINT (4697157 -74140516)
2013,Octubre,Reino Unido de Gran Bretaña e Irlanda del Norte,0,2,,2,POINT (6170465 -7542726)
2013,Octubre,Reino Unido de Gran Bretaña e Irlanda del Norte,3,1,,4,POINT (7819 -72453013)
2013,Octubre,Países Bajos,0,1,,1,POINT (-4191162 -69941498)
2013,Octubre,Países Bajos,2,2,,4,POINT (0.81488 -77356)
2013,Octubre,Países Bajos,13,26,,39,POINT (10406342 -75527794)
2013,Octubre,Países Bajos,1,4,,5,POINT (10446304 -75516486)
2013,Octubre,Países Bajos,0,2,,2,POINT (10886686 -74776479)
2013,Octubre,Países Bajos,1,0,,1,POINT (125862 -81702165)
2013,Octubre,Países Bajos,6,7,,13,POINT (3451668 -76532004)
2013,Octubre,Países Bajos,71,103,,174,POINT (4697157 -74140516)
2013,Octubre,Países Bajos,17,21,,38,POINT (6170465 -7542726)
2013,Octubre,Países Bajos,0,1,,1,POINT (7128047 -73181317)
2013,Octubre,Países Bajos,4,6,,10,POINT (7819 -72453013)
2013,Octubre,Países Bajos,0,1,,1,POINT (7927233 -72508188)
2013,Octubre,Lituania,1,0,,1,POINT (7819 -72453013)
2013,Octubre,Reino Unido de Gran Bretaña e Irlanda del Norte,0,4,,4,POINT (11247723 -74213989)
2013,Octubre,Reino Unido de Gran Bretaña e Irlanda del Norte,0,2,,2,POINT (10886686 -74776479)
2013,Octubre,Reino Unido de Gran Bretaña e Irlanda del Norte,5,5,,10,POINT (10406342 -75527794)
2013,Octubre,Letonia,0,1,,1,POINT (10406342 -75527794)
2013,Octubre,Desconocido,2,1,,3,POINT (10446304 -75516486)
2013,Octubre,Desconocido,1,1,,2,POINT (3451668 -76532004)
2013,Octubre,Desconocido,36,65,,101,POINT (4697157 -74140516)
2013,Octubre,Desconocido,7,3,,10,POINT (6170465 -7542726)
2013,Octubre,República CentroÁfricana,0,1,,1,POINT (4697157 -74140516)
2013,Noviembre,Afganistán,0,1,,1,POINT (4697157 -74140516)
2013,Noviembre,Albania,0,2,,2,POINT (4697157 -74140516)
2013,Noviembre,Albania,0,1,,1,POINT (7819 -72453013)
2013,Noviembre,Alemania,9,19,,28,POINT (-4191162 -69941498)
2013,Noviembre,Alemania,28,32,,60,POINT (0.81488 -77356)
2013,Noviembre,Alemania,22,28,,50,POINT (10406342 -75527794)
2013,Noviembre,Alemania,12,44,,56,POINT (10446304 -75516486)
2013,Noviembre,Alemania,7,13,,20,POINT (10886686 -74776479)
2013,Noviembre,Alemania,3,4,,7,POINT (11247723 -74213989)
2013,Noviembre,Alemania,6,7,,13,POINT (11360029 -72129595)
2013,Noviembre,Alemania,2,10,,12,POINT (125862 -81702165)
2013,Noviembre,Alemania,1,3,,4,POINT (133387613 -81372937)
2013,Noviembre,Alemania,27,49,,76,POINT (3451668 -76532004)
2013,Noviembre,Alemania,1215,2143,,3358,POINT (4697157 -74140516)
2013,Noviembre,Alemania,1,2,,3,POINT (4815189 -75736374)
2013,Noviembre,Alemania,40,100,,140,POINT (6170465 -7542726)
2013,Noviembre,Alemania,0,3,,3,POINT (7128047 -73181317)
2013,Noviembre,Alemania,8,10,,18,POINT (7819 -72453013)
2013,Noviembre,Andorra,0,7,,7,POINT (4697157 -74140516)
2013,Noviembre,Andorra,0,1,,1,POINT (6170465 -7542726)
2013,Noviembre,Angola,3,1,,4,POINT (4697157 -74140516)
2013,Noviembre,Antigua y Barbuda,1,1,,2,POINT (4697157 -74140516)
2013,Noviembre,Antigua y Barbuda,0,3,,3,POINT (6170465 -7542726)
2013,Noviembre,Países Bajos,1,0,,1,POINT (4697157 -74140516)
2013,Noviembre,Arabia Saudita,0,6,,6,POINT (4697157 -74140516)
2013,Noviembre,Argelia,1,3,,4,POINT (4697157 -74140516)
2013,Noviembre,Argelia,0,1,,1,POINT (6170465 -7542726)
2013,Noviembre,Argentina,2,3,,5,POINT (-4191162 -69941498)
2013,Noviembre,Argentina,1,2,,3,POINT (0.33002 -76876446)
2013,Noviembre,Argentina,54,93,,147,POINT (0.81488 -77356)
2013,Noviembre,Argentina,1,1,,2,POINT (1800143 -78802679)
2013,Noviembre,Argentina,190,154,,344,POINT (10406342 -75527794)
2013,Noviembre,Argentina,870,641,,1511,POINT (10446304 -75516486)
2013,Noviembre,Argentina,14,39,,53,POINT (10886686 -74776479)
2013,Noviembre,Argentina,1,3,,4,POINT (11247723 -74213989)
2013,Noviembre,Argentina,11,23,,34,POINT (11360029 -72129595)
2013,Noviembre,Argentina,194,138,,332,POINT (125862 -81702165)
2013,Noviembre,Argentina,65,90,,155,POINT (3451668 -76532004)
2013,Noviembre,Argentina,2994,4927,,7921,POINT (4697157 -74140516)
2013,Noviembre,Argentina,4,6,,10,POINT (4815189 -75736374)
2013,Noviembre,Argentina,107,251,,358,POINT (6170465 -7542726)
2013,Noviembre,Argentina,12,37,,49,POINT (7819 -72453013)
2013,Noviembre,Argentina,0,8,,8,POINT (7927233 -72508188)
2013,Noviembre,República de Armenia,1,1,,2,POINT (4697157 -74140516)
2013,Noviembre,Aruba,0,1,,1,POINT (4697157 -74140516)
2013,Noviembre,Australia,6,5,,11,POINT (-4191162 -69941498)
2013,Noviembre,Australia,27,35,,62,POINT (0.81488 -77356)
2013,Noviembre,Australia,30,40,,70,POINT (10406342 -75527794)
2013,Noviembre,Australia,18,28,,46,POINT (10446304 -75516486)
2013,Noviembre,Australia,2,16,,18,POINT (10886686 -74776479)
2013,Noviembre,Australia,2,1,,3,POINT (11247723 -74213989)
2013,Noviembre,Australia,3,0,,3,POINT (11360029 -72129595)
2013,Noviembre,Australia,3,1,,4,POINT (125862 -81702165)
2013,Noviembre,Australia,1,3,,4,POINT (133387613 -81372937)
2013,Noviembre,Australia,13,17,,30,POINT (3451668 -76532004)
2013,Noviembre,Australia,1,1,,2,POINT (445285 -75766353)
2013,Noviembre,Australia,272,388,,660,POINT (4697157 -74140516)
2013,Noviembre,Australia,0,5,,5,POINT (4815189 -75736374)
2013,Noviembre,Australia,31,63,,94,POINT (6170465 -7542726)
2013,Noviembre,Australia,0,1,,1,POINT (7128047 -73181317)
2013,Noviembre,Australia,0,4,,4,POINT (7819 -72453013)
2013,Noviembre,Australia,3,3,,6,POINT (863337 -7735002)
2013,Noviembre,Austria,3,1,,4,POINT (-4191162 -69941498)
2013,Noviembre,Austria,7,6,,13,POINT (0.81488 -77356)
2013,Noviembre,Austria,6,4,,10,POINT (10406342 -75527794)
2013,Noviembre,Austria,8,16,,24,POINT (10446304 -75516486)
2013,Noviembre,Austria,0,3,,3,POINT (10886686 -74776479)
2013,Noviembre,Austria,0,1,,1,POINT (11360029 -72129595)
2013,Noviembre,Austria,0,1,,1,POINT (125862 -81702165)
2013,Noviembre,Austria,1,6,,7,POINT (3451668 -76532004)
2013,Noviembre,Austria,104,205,,309,POINT (4697157 -74140516)
2013,Noviembre,Austria,1,10,,11,POINT (6170465 -7542726)
2013,Noviembre,Austria,0,2,,2,POINT (7128047 -73181317)
2013,Noviembre,Austria,1,1,,2,POINT (7819 -72453013)
2013,Noviembre,Azerbaiyán,0,2,,2,POINT (4697157 -74140516)
2013,Noviembre,Bahamas,0,1,,1,POINT (10446304 -75516486)
2013,Noviembre,Bahamas,0,1,,1,POINT (10970933 -74765343)
2013,Noviembre,Bahamas,0,1,,1,POINT (11360029 -72129595)
2013,Noviembre,Bahamas,1,0,,1,POINT (125744111 -81703935)
2013,Noviembre,Bahamas,3,2,,5,POINT (3451668 -76532004)
2013,Noviembre,Bahamas,0,4,,4,POINT (4697157 -74140516)
2013,Noviembre,Bahamas,4,5,,9,POINT (6170465 -7542726)
2013,Noviembre,Bahréin,1,1,,2,POINT (4697157 -74140516)
2013,Noviembre,Bangladesh,0,1,,1,POINT (4697157 -74140516)
2013,Noviembre,Barbados,0,1,,1,POINT (3451668 -76532004)
2013,Noviembre,Barbados,2,2,,4,POINT (4697157 -74140516)
2013,Noviembre,Barbados,3,3,,6,POINT (6170465 -7542726)
2013,Noviembre,Barbados,0,1,,1,POINT (7819 -72453013)
2013,Noviembre,República de Belarús,1,0,,1,POINT (0.81488 -77356)
2013,Noviembre,República de Belarús,1,0,,1,POINT (6170465 -7542726)
2013,Noviembre,Bélgica,1,1,,2,POINT (-4191162 -69941498)
2013,Noviembre,Bélgica,8,6,,14,POINT (0.81488 -77356)
2013,Noviembre,Bélgica,1,2,,3,POINT (10406342 -75527794)
2013,Noviembre,Bélgica,1,10,,11,POINT (10446304 -75516486)
2013,Noviembre,Bélgica,0,1,,1,POINT (11247723 -74213989)
2013,Noviembre,Bélgica,1,0,,1,POINT (11360029 -72129595)
2013,Noviembre,Bélgica,0,1,,1,POINT (125862 -81702165)
2013,Noviembre,Bélgica,11,35,,46,POINT (3451668 -76532004)
2013,Noviembre,Bélgica,121,335,,456,POINT (4697157 -74140516)
2013,Noviembre,Bélgica,5,23,,28,POINT (6170465 -7542726)
2013,Noviembre,Bélgica,3,2,,5,POINT (7819 -72453013)
2013,Noviembre,Belice,0,1,,1,POINT (10446304 -75516486)
2013,Noviembre,Belice,0,1,,1,POINT (125862 -81702165)
2013,Noviembre,Belice,1,2,,3,POINT (3451668 -76532004)
2013,Noviembre,Belice,3,10,,13,POINT (4697157 -74140516)
2013,Noviembre,Belice,0,1,,1,POINT (4815189 -75736374)
2013,Noviembre,Belice,2,4,,6,POINT (6170465 -7542726)
2013,Noviembre,Bermudas/Territorio Británico de Ultramar,0,1,,1,POINT (10446304 -75516486)
2013,Noviembre,Bermudas/Territorio Británico de Ultramar,0,1,,1,POINT (3451668 -76532004)
2013,Noviembre,Bermudas/Territorio Británico de Ultramar,0,2,,2,POINT (4697157 -74140516)
2013,Noviembre,Bolivia,20,14,,34,POINT (0.81488 -77356)
2013,Noviembre,Bolivia,1,0,,1,POINT (10406342 -75527794)
2013,Noviembre,Bolivia,30,38,,68,POINT (10446304 -75516486)
2013,Noviembre,Bolivia,0,3,,3,POINT (10886686 -74776479)
2013,Noviembre,Bolivia,1,2,,3,POINT (11360029 -72129595)
2013,Noviembre,Bolivia,4,41,,45,POINT (125862 -81702165)
2013,Noviembre,Bolivia,24,40,,64,POINT (3451668 -76532004)
2013,Noviembre,Bolivia,442,621,,1063,POINT (4697157 -74140516)
2013,Noviembre,Bolivia,1,3,,4,POINT (4815189 -75736374)
2013,Noviembre,Bolivia,34,29,,63,POINT (6170465 -7542726)
2013,Noviembre,Bolivia,0,1,,1,POINT (6185536 -67484028)
2013,Noviembre,Bolivia,4,10,,14,POINT (7819 -72453013)
2013,Noviembre,Bolivia,0,2,,2,POINT (7927233 -72508188)
2013,Noviembre,Bolivia,0,1,,1,POINT (863337 -7735002)
2013,Noviembre,Bosnia y Herzegovina,2,0,,2,POINT (4697157 -74140516)
2013,Noviembre,Brasil,61,78,,139,POINT (-4191162 -69941498)
2013,Noviembre,Brasil,12,21,,33,POINT (0.81488 -77356)
2013,Noviembre,Brasil,114,94,,208,POINT (10406342 -75527794)
2013,Noviembre,Brasil,255,219,,474,POINT (10446304 -75516486)
2013,Noviembre,Brasil,15,24,,39,POINT (10886686 -74776479)
2013,Noviembre,Brasil,5,17,,22,POINT (11360029 -72129595)
2013,Noviembre,Brasil,24,8,,32,POINT (125862 -81702165)
2013,Noviembre,Brasil,46,112,,158,POINT (3451668 -76532004)
2013,Noviembre,Brasil,3040,4562,,7602,POINT (4697157 -74140516)
2013,Noviembre,Brasil,6,5,,11,POINT (4815189 -75736374)
2013,Noviembre,Brasil,82,232,,314,POINT (6170465 -7542726)
2013,Noviembre,Brasil,1,5,,6,POINT (7128047 -73181317)
2013,Noviembre,Brasil,12,14,,26,POINT (7819 -72453013)
2013,Noviembre,Brasil,3,4,,7,POINT (7927233 -72508188)
2013,Noviembre,Brasil,0,1,,1,POINT (863337 -7735002)
2013,Noviembre,Bulgaria,0,1,,1,POINT (0.81488 -77356)
2013,Noviembre,Bulgaria,0,1,,1,POINT (11247723 -74213989)
2013,Noviembre,Bulgaria,0,1,,1,POINT (3451668 -76532004)
2013,Noviembre,Bulgaria,13,12,,25,POINT (4697157 -74140516)
2013,Noviembre,Bulgaria,1,2,,3,POINT (6170465 -7542726)
2013,Noviembre,Bulgaria,1,0,,1,POINT (863337 -7735002)
2013,Noviembre,Burkina Faso,0,2,,2,POINT (4697157 -74140516)
2013,Noviembre,Burundi,1,0,,1,POINT (3451668 -76532004)
2013,Noviembre,Bután,0,1,,1,POINT (4697157 -74140516)
2013,Noviembre,Islas Caimán/Territorio Británico de Ultramar,1,0,,1,POINT (10886686 -74776479)
2013,Noviembre,Islas Caimán/Territorio Británico de Ultramar,1,0,,1,POINT (125862 -81702165)
2013,Noviembre,Islas Caimán/Territorio Británico de Ultramar,1,0,,1,POINT (4697157 -74140516)
2013,Noviembre,Islas Caimán/Territorio Británico de Ultramar,0,1,,1,POINT (6170465 -7542726)
2013,Noviembre,Camboya,0,2,,2,POINT (4697157 -74140516)
2013,Noviembre,Antártida,0,1,,1,POINT (4697157 -74140516)
2013,Noviembre,Camerún,1,1,,2,POINT (4697157 -74140516)
2013,Noviembre,Canadá,1,1,,2,POINT (-4191162 -69941498)
2013,Noviembre,Canadá,14,24,,38,POINT (0.81488 -77356)
2013,Noviembre,Canadá,13,20,,33,POINT (10406342 -75527794)
2013,Noviembre,Canadá,144,187,,331,POINT (10446304 -75516486)
2013,Noviembre,Canadá,6,17,,23,POINT (10886686 -74776479)
2013,Noviembre,Canadá,1,10,,11,POINT (10970933 -74765343)
2013,Noviembre,Canadá,1,1,,2,POINT (11247723 -74213989)
2013,Noviembre,Canadá,2,5,,7,POINT (11360029 -72129595)
2013,Noviembre,Canadá,4,3,,7,POINT (125862 -81702165)
2013,Noviembre,Canadá,2,1,,3,POINT (133387613 -81372937)
2013,Noviembre,Canadá,32,63,,95,POINT (3451668 -76532004)
2013,Noviembre,Canadá,1,5,,6,POINT (445285 -75766353)
2013,Noviembre,Canadá,722,1508,,2230,POINT (4697157 -74140516)
2013,Noviembre,Canadá,5,7,,12,POINT (4815189 -75736374)
2013,Noviembre,Canadá,75,173,,248,POINT (6170465 -7542726)
2013,Noviembre,Canadá,3,3,,6,POINT (7128047 -73181317)
2013,Noviembre,Canadá,2,10,,12,POINT (7819 -72453013)
2013,Noviembre,Canadá,1,1,,2,POINT (7927233 -72508188)
2013,Noviembre,España,0,1,,1,POINT (7088729 -70740253)
2013,Noviembre,España,1,5,,6,POINT (7819 -72453013)
2013,Noviembre,República Democrática del Congo,2,1,,3,POINT (4697157 -74140516)
2013,Noviembre,República de Corea,3,1,,4,POINT (-4191162 -69941498)
2013,Noviembre,República de Corea,3,5,,8,POINT (0.81488 -77356)
2013,Noviembre,República de Corea,0,1,,1,POINT (1800143 -78802679)
2013,Noviembre,República de Corea,0,3,,3,POINT (10406342 -75527794)
2013,Noviembre,República de Corea,2,5,,7,POINT (10446304 -75516486)
2013,Noviembre,República de Corea,5,10,,15,POINT (3451668 -76532004)
2013,Noviembre,República de Corea,157,448,,605,POINT (4697157 -74140516)
2013,Noviembre,República de Corea,1,4,,5,POINT (4815189 -75736374)
2013,Noviembre,República de Corea,3,22,,25,POINT (6170465 -7542726)
2013,Noviembre,República de Corea,1,2,,3,POINT (7128047 -73181317)
2013,Noviembre,República de Corea,0,7,,7,POINT (7819 -72453013)
2013,Noviembre,Costa de Marfil,0,7,,7,POINT (4697157 -74140516)
2013,Noviembre,Costa Rica,0,1,,1,POINT (-4191162 -69941498)
2013,Noviembre,Costa Rica,0,2,,2,POINT (0.81488 -77356)
2013,Noviembre,Costa Rica,0,6,,6,POINT (10406342 -75527794)
2013,Noviembre,Costa Rica,48,45,,93,POINT (10446304 -75516486)
2013,Noviembre,Costa Rica,14,21,,35,POINT (10886686 -74776479)
2013,Noviembre,Costa Rica,1,4,,5,POINT (11360029 -72129595)
2013,Noviembre,Costa Rica,10,8,,18,POINT (125862 -81702165)
2013,Noviembre,Costa Rica,19,45,,64,POINT (3451668 -76532004)
2013,Noviembre,Costa Rica,1,0,,1,POINT (445285 -75766353)
2013,Noviembre,Costa Rica,531,906,,1437,POINT (4697157 -74140516)
2013,Noviembre,Costa Rica,5,0,,5,POINT (4815189 -75736374)
2013,Noviembre,Costa Rica,97,205,,302,POINT (6170465 -7542726)
2013,Noviembre,Costa Rica,1,1,,2,POINT (7128047 -73181317)
2013,Noviembre,Costa Rica,5,1,,6,POINT (7819 -72453013)
2013,Noviembre,Costa Rica,0,1,,1,POINT (7927233 -72508188)
2013,Noviembre,Costa Rica,0,1,,1,POINT (863337 -7735002)
2013,Noviembre,Croacia,0,1,,1,POINT (-4191162 -69941498)
2013,Noviembre,Croacia,0,2,,2,POINT (0.81488 -77356)
2013,Noviembre,Croacia,0,1,,1,POINT (10406342 -75527794)
2013,Noviembre,Croacia,0,1,,1,POINT (10446304 -75516486)
2013,Noviembre,Croacia,0,4,,4,POINT (10970933 -74765343)
2013,Noviembre,Croacia,0,1,,1,POINT (3451668 -76532004)
2013,Noviembre,Croacia,0,34,,34,POINT (4697157 -74140516)
2013,Noviembre,Croacia,1,0,,1,POINT (863337 -7735002)
2013,Noviembre,Croacia,0,2,,2,POINT (9402597 -75681642)
2013,Noviembre,Cuba,2,0,,2,POINT (-4191162 -69941498)
2013,Noviembre,Cuba,0,3,,3,POINT (0.81488 -77356)
2013,Noviembre,Cuba,0,1,,1,POINT (10406342 -75527794)
2013,Noviembre,Cuba,1,8,,9,POINT (10446304 -75516486)
2013,Noviembre,Cuba,6,8,,14,POINT (10886686 -74776479)
2013,Noviembre,Cuba,0,1,,1,POINT (11360029 -72129595)
2013,Noviembre,Cuba,16,36,,52,POINT (3451668 -76532004)
2013,Noviembre,Cuba,0,1,,1,POINT (445285 -75766353)
2013,Noviembre,Cuba,84,166,,250,POINT (4697157 -74140516)
2013,Noviembre,Cuba,1,1,,2,POINT (4815189 -75736374)
2013,Noviembre,Cuba,17,33,,50,POINT (6170465 -7542726)
2013,Noviembre,Cuba,1,1,,2,POINT (7128047 -73181317)
2013,Noviembre,Cuba,2,3,,5,POINT (7819 -72453013)
2013,Noviembre,Cuba,0,3,,3,POINT (7927233 -72508188)
2013,Noviembre,Curazao,0,1,,1,POINT (4697157 -74140516)
2013,Noviembre,República Checa,2,1,,3,POINT (0.81488 -77356)
2013,Noviembre,República Checa,0,1,,1,POINT (10406342 -75527794)
2013,Noviembre,República Checa,0,2,,2,POINT (10446304 -75516486)
2013,Noviembre,República Checa,1,0,,1,POINT (10886686 -74776479)
2013,Noviembre,República Checa,1,1,,2,POINT (11360029 -72129595)
2013,Noviembre,República Checa,0,2,,2,POINT (3451668 -76532004)
2013,Noviembre,República Checa,52,67,,119,POINT (4697157 -74140516)
2013,Noviembre,República Checa,1,3,,4,POINT (6170465 -7542726)
2013,Noviembre,República Checa,0,1,,1,POINT (863337 -7735002)
2013,Noviembre,Chile,1,5,,6,POINT (-4191162 -69941498)
2013,Noviembre,Chile,1,2,,3,POINT (0.33002 -76876446)
2013,Noviembre,Chile,28,51,,79,POINT (0.81488 -77356)
2013,Noviembre,Chile,0,2,,2,POINT (1800143 -78802679)
2013,Noviembre,Chile,121,80,,201,POINT (10406342 -75527794)
2013,Noviembre,Chile,48,35,,83,POINT (10446304 -75516486)
2013,Noviembre,Chile,8,20,,28,POINT (10886686 -74776479)
2013,Noviembre,Chile,0,2,,2,POINT (10970933 -74765343)
2013,Noviembre,Chile,0,1,,1,POINT (11247723 -74213989)
2013,Noviembre,Chile,5,5,,10,POINT (11360029 -72129595)
2013,Noviembre,Chile,20,16,,36,POINT (125862 -81702165)
2013,Noviembre,Chile,43,84,,127,POINT (3451668 -76532004)
2013,Noviembre,Chile,2361,3695,,6056,POINT (4697157 -74140516)
2013,Noviembre,Chile,1,1,,2,POINT (4815189 -75736374)
2013,Noviembre,Chile,33,125,,158,POINT (6170465 -7542726)
2013,Noviembre,Chile,0,5,,5,POINT (7088729 -70740253)
2013,Noviembre,Chile,2,0,,2,POINT (7128047 -73181317)
2013,Noviembre,Chile,9,21,,30,POINT (7819 -72453013)
2013,Noviembre,Chile,2,6,,8,POINT (7927233 -72508188)
2013,Noviembre,Chile,1,2,,3,POINT (863337 -7735002)
2013,Noviembre,China,1,1,,2,POINT (0.81488 -77356)
2013,Noviembre,China,1,1,,2,POINT (10406342 -75527794)
2013,Noviembre,China,6,8,,14,POINT (10446304 -75516486)
2013,Noviembre,China,0,2,,2,POINT (10886686 -74776479)
2013,Noviembre,China,1,0,,1,POINT (11360029 -72129595)
2013,Noviembre,China,3,7,,10,POINT (3451668 -76532004)
2013,Noviembre,China,182,482,,664,POINT (4697157 -74140516)
2013,Noviembre,China,0,1,,1,POINT (4815189 -75736374)
2013,Noviembre,China,12,26,,38,POINT (6170465 -7542726)
2013,Noviembre,China,1,1,,2,POINT (7128047 -73181317)
2013,Noviembre,China,0,1,,1,POINT (7819 -72453013)
2013,Noviembre,Chipre,1,0,,1,POINT (3451668 -76532004)
2013,Noviembre,Chipre,1,4,,5,POINT (4697157 -74140516)
2013,Noviembre,Dinamarca,5,7,,12,POINT (0.81488 -77356)
2013,Noviembre,Dinamarca,2,1,,3,POINT (10406342 -75527794)
2013,Noviembre,Dinamarca,0,9,,9,POINT (10446304 -75516486)
2013,Noviembre,Dinamarca,0,1,,1,POINT (10886686 -74776479)
2013,Noviembre,Dinamarca,0,1,,1,POINT (11360029 -72129595)
2013,Noviembre,Dinamarca,0,6,,6,POINT (3451668 -76532004)
2013,Noviembre,Dinamarca,0,1,,1,POINT (445285 -75766353)
2013,Noviembre,Dinamarca,41,100,,141,POINT (4697157 -74140516)
2013,Noviembre,Dinamarca,0,2,,2,POINT (4815189 -75736374)
2013,Noviembre,Dinamarca,5,10,,15,POINT (6170465 -7542726)
2013,Noviembre,Dinamarca,2,1,,3,POINT (7819 -72453013)
2013,Noviembre,Dinamarca,0,1,,1,POINT (7927233 -72508188)
2013,Noviembre,Dominica,0,1,,1,POINT (10446304 -75516486)
2013,Noviembre,Dominica,0,1,,1,POINT (11360029 -72129595)
2013,Noviembre,Dominica,1,1,,2,POINT (4697157 -74140516)
2013,Noviembre,Dominica,0,1,,1,POINT (6170465 -7542726)
2013,Noviembre,Ecuador,28,83,,111,POINT (0.33002 -76876446)
2013,Noviembre,Ecuador,1352,1962,,3314,POINT (0.81488 -77356)
2013,Noviembre,Ecuador,13,113,,126,POINT (1800143 -78802679)
2013,Noviembre,Ecuador,1,43,,44,POINT (10406342 -75527794)
2013,Noviembre,Ecuador,6,25,,31,POINT (10446304 -75516486)
2013,Noviembre,Ecuador,1,11,,12,POINT (10886686 -74776479)
2013,Noviembre,Ecuador,15,11,,26,POINT (11360029 -72129595)
2013,Noviembre,Ecuador,2,1,,3,POINT (125862 -81702165)
2013,Noviembre,Ecuador,390,509,,899,POINT (3451668 -76532004)
2013,Noviembre,Ecuador,1420,2501,,3921,POINT (4697157 -74140516)
2013,Noviembre,Ecuador,3,4,,7,POINT (4815189 -75736374)
2013,Noviembre,Ecuador,423,530,,953,POINT (6170465 -7542726)
2013,Noviembre,Ecuador,0,2,,2,POINT (7088729 -70740253)
2013,Noviembre,Ecuador,155,222,,377,POINT (7819 -72453013)
2013,Noviembre,Ecuador,3,8,,11,POINT (7927233 -72508188)
2013,Noviembre,Egipto,0,1,,1,POINT (10446304 -75516486)
2013,Noviembre,Egipto,2,7,,9,POINT (4697157 -74140516)
2013,Noviembre,El Salvador,1,0,,1,POINT (0.81488 -77356)
2013,Noviembre,El Salvador,13,23,,36,POINT (10446304 -75516486)
2013,Noviembre,El Salvador,1,3,,4,POINT (10886686 -74776479)
2013,Noviembre,El Salvador,63,86,,149,POINT (3451668 -76532004)
2013,Noviembre,El Salvador,576,838,,1414,POINT (4697157 -74140516)
2013,Noviembre,El Salvador,0,3,,3,POINT (4815189 -75736374)
2013,Noviembre,El Salvador,45,69,,114,POINT (6170465 -7542726)
2013,Noviembre,Emiratos Árabes,0,2,,2,POINT (4697157 -74140516)
2013,Noviembre,España,4,8,,12,POINT (-4191162 -69941498)
2013,Noviembre,España,0,2,,2,POINT (0.33002 -76876446)
2013,Noviembre,España,23,51,,74,POINT (0.81488 -77356)
2013,Noviembre,España,48,59,,107,POINT (10406342 -75527794)
2013,Noviembre,España,50,118,,168,POINT (10446304 -75516486)
2013,Noviembre,España,8,27,,35,POINT (10886686 -74776479)
2013,Noviembre,España,6,9,,15,POINT (11360029 -72129595)
2013,Noviembre,España,0,1,,1,POINT (125744111 -81703935)
2013,Noviembre,España,6,5,,11,POINT (125862 -81702165)
2013,Noviembre,España,0,1,,1,POINT (133387613 -81372937)
2013,Noviembre,España,208,349,,557,POINT (3451668 -76532004)
2013,Noviembre,España,1,1,,2,POINT (445285 -75766353)
2013,Noviembre,España,2155,5950,,8105,POINT (4697157 -74140516)
2013,Noviembre,España,3,23,,26,POINT (4815189 -75736374)
2013,Noviembre,España,172,454,,626,POINT (6170465 -7542726)
2013,Noviembre,España,2,2,,4,POINT (7128047 -73181317)
2013,Noviembre,España,6,40,,46,POINT (7819 -72453013)
2013,Noviembre,España,6,4,,10,POINT (7927233 -72508188)
2013,Noviembre,España,0,5,,5,POINT (863337 -7735002)
2013,Noviembre,Eslovaquia,1,0,,1,POINT (-4191162 -69941498)
2013,Noviembre,Eslovaquia,1,0,,1,POINT (0.81488 -77356)
2013,Noviembre,Eslovaquia,1,0,,1,POINT (10406342 -75527794)
2013,Noviembre,Eslovaquia,1,0,,1,POINT (10446304 -75516486)
2013,Noviembre,Eslovaquia,1,0,,1,POINT (10886686 -74776479)
2013,Noviembre,Eslovaquia,0,1,,1,POINT (10970933 -74765343)
2013,Noviembre,Eslovaquia,0,1,,1,POINT (125862 -81702165)
2013,Noviembre,Eslovaquia,0,1,,1,POINT (3451668 -76532004)
2013,Noviembre,Eslovaquia,11,29,,40,POINT (4697157 -74140516)
2013,Noviembre,Eslovaquia,0,1,,1,POINT (6170465 -7542726)
2013,Noviembre,Eslovenia,0,1,,1,POINT (0.81488 -77356)
2013,Noviembre,Eslovenia,0,2,,2,POINT (10406342 -75527794)
2013,Noviembre,Eslovenia,0,1,,1,POINT (3451668 -76532004)
2013,Noviembre,Eslovenia,19,29,,48,POINT (4697157 -74140516)
2013,Noviembre,Eslovenia,0,6,,6,POINT (6170465 -7542726)
2013,Noviembre,Estados Unidos de América,4,11,,15,POINT (-4191162 -69941498)
2013,Noviembre,Estados Unidos de América,38,51,,89,POINT (0.81488 -77356)
2013,Noviembre,Estados Unidos de América,38,74,,112,POINT (10406342 -75527794)
2013,Noviembre,Estados Unidos de América,856,1763,,2619,POINT (10446304 -75516486)
2013,Noviembre,Estados Unidos de América,241,443,,684,POINT (10886686 -74776479)
2013,Noviembre,Estados Unidos de América,7,2,,9,POINT (11247723 -74213989)
2013,Noviembre,Estados Unidos de América,9,19,,28,POINT (11360029 -72129595)
2013,Noviembre,Estados Unidos de América,1,0,,1,POINT (1152863 -72919186)
2013,Noviembre,Estados Unidos de América,0,4,,4,POINT (125744111 -81703935)
2013,Noviembre,Estados Unidos de América,15,16,,31,POINT (125862 -81702165)
2013,Noviembre,Estados Unidos de América,3,6,,9,POINT (133387613 -81372937)
2013,Noviembre,Estados Unidos de América,602,1003,,1605,POINT (3451668 -76532004)
2013,Noviembre,Estados Unidos de América,68,138,,206,POINT (445285 -75766353)
2013,Noviembre,Estados Unidos de América,5440,10883,,16323,POINT (4697157 -74140516)
2013,Noviembre,Estados Unidos de América,75,106,,181,POINT (4815189 -75736374)
2013,Noviembre,Estados Unidos de América,1187,2954,,4141,POINT (6170465 -7542726)
2013,Noviembre,Estados Unidos de América,2,3,,5,POINT (6185536 -67484028)
2013,Noviembre,Estados Unidos de América,16,23,,39,POINT (7128047 -73181317)
2013,Noviembre,Estados Unidos de América,26,51,,77,POINT (7819 -72453013)
2013,Noviembre,Estados Unidos de América,24,19,,43,POINT (7927233 -72508188)
2013,Noviembre,Estados Unidos de América,2,3,,5,POINT (863337 -7735002)
2013,Noviembre,Estonia,0,1,,1,POINT (10406342 -75527794)
2013,Noviembre,Estonia,0,2,,2,POINT (10446304 -75516486)
2013,Noviembre,Estonia,4,4,,8,POINT (4697157 -74140516)
2013,Noviembre,Estonia,2,0,,2,POINT (6170465 -7542726)
2013,Noviembre,Etiopia,0,1,,1,POINT (10446304 -75516486)
2013,Noviembre,Etiopia,0,1,,1,POINT (3451668 -76532004)
2013,Noviembre,Etiopia,0,1,,1,POINT (4697157 -74140516)
2013,Noviembre,Islas Fiji,0,1,,1,POINT (10886686 -74776479)
2013,Noviembre,Filipinas,0,1,,1,POINT (0.81488 -77356)
2013,Noviembre,Filipinas,3,41,,44,POINT (10406342 -75527794)
2013,Noviembre,Filipinas,1,33,,34,POINT (10446304 -75516486)
2013,Noviembre,Filipinas,1,8,,9,POINT (10886686 -74776479)
2013,Noviembre,Filipinas,0,8,,8,POINT (10970933 -74765343)
2013,Noviembre,Filipinas,0,14,,14,POINT (11247723 -74213989)
2013,Noviembre,Filipinas,1,4,,5,POINT (3451668 -76532004)
2013,Noviembre,Filipinas,0,4,,4,POINT (3884426 -77061029)
2013,Noviembre,Filipinas,18,61,,79,POINT (4697157 -74140516)
2013,Noviembre,Filipinas,5,5,,10,POINT (6170465 -7542726)
2013,Noviembre,Filipinas,0,1,,1,POINT (9402597 -75681642)
2013,Noviembre,Finlandia,4,2,,6,POINT (0.81488 -77356)
2013,Noviembre,Finlandia,0,1,,1,POINT (10406342 -75527794)
2013,Noviembre,Finlandia,4,5,,9,POINT (10446304 -75516486)
2013,Noviembre,Finlandia,1,1,,2,POINT (10886686 -74776479)
2013,Noviembre,Finlandia,1,0,,1,POINT (11360029 -72129595)
2013,Noviembre,Finlandia,2,2,,4,POINT (3451668 -76532004)
2013,Noviembre,Finlandia,1,0,,1,POINT (445285 -75766353)
2013,Noviembre,Finlandia,42,62,,104,POINT (4697157 -74140516)
2013,Noviembre,Finlandia,4,4,,8,POINT (6170465 -7542726)
2013,Noviembre,Francia,2,6,,8,POINT (-4191162 -69941498)
2013,Noviembre,Francia,0,1,,1,POINT (0.33002 -76876446)
2013,Noviembre,Francia,22,28,,50,POINT (0.81488 -77356)
2013,Noviembre,Francia,10,12,,22,POINT (10406342 -75527794)
2013,Noviembre,Francia,31,53,,84,POINT (10446304 -75516486)
2013,Noviembre,Francia,3,15,,18,POINT (10886686 -74776479)
2013,Noviembre,Francia,1,1,,2,POINT (10970933 -74765343)
2013,Noviembre,Francia,3,4,,7,POINT (11247723 -74213989)
2013,Noviembre,Francia,5,17,,22,POINT (11360029 -72129595)
2013,Noviembre,Francia,2,0,,2,POINT (125862 -81702165)
2013,Noviembre,Francia,1,1,,2,POINT (133387613 -81372937)
2013,Noviembre,Francia,39,70,,109,POINT (3451668 -76532004)
2013,Noviembre,Francia,817,1752,,2569,POINT (4697157 -74140516)
2013,Noviembre,Francia,1,4,,5,POINT (4815189 -75736374)
2013,Noviembre,Francia,27,105,,132,POINT (6170465 -7542726)
2013,Noviembre,Francia,5,7,,12,POINT (7819 -72453013)
2013,Noviembre,Francia,0,3,,3,POINT (863337 -7735002)
2013,Noviembre,Georgia,1,0,,1,POINT (4697157 -74140516)
2013,Noviembre,Georgia,0,1,,1,POINT (9402597 -75681642)
2013,Noviembre,Ghana,1,0,,1,POINT (10446304 -75516486)
2013,Noviembre,Ghana,0,6,,6,POINT (4697157 -74140516)
2013,Noviembre,Ghana,0,1,,1,POINT (6170465 -7542726)
2013,Noviembre,Granada,0,1,,1,POINT (4697157 -74140516)
2013,Noviembre,Grecia,0,2,,2,POINT (10406342 -75527794)
2013,Noviembre,Grecia,0,1,,1,POINT (10446304 -75516486)
2013,Noviembre,Grecia,0,1,,1,POINT (10886686 -74776479)
2013,Noviembre,Grecia,0,1,,1,POINT (10970933 -74765343)
2013,Noviembre,Grecia,0,1,,1,POINT (3451668 -76532004)
2013,Noviembre,Grecia,14,59,,73,POINT (4697157 -74140516)
2013,Noviembre,Grecia,0,8,,8,POINT (6170465 -7542726)
2013,Noviembre,Grecia,0,2,,2,POINT (9402597 -75681642)
2013,Noviembre,Guatemala,1,4,,5,POINT (0.81488 -77356)
2013,Noviembre,Guatemala,36,44,,80,POINT (10446304 -75516486)
2013,Noviembre,Guatemala,9,20,,29,POINT (10886686 -74776479)
2013,Noviembre,Guatemala,1,2,,3,POINT (11360029 -72129595)
2013,Noviembre,Guatemala,3,3,,6,POINT (125862 -81702165)
2013,Noviembre,Guatemala,17,50,,67,POINT (3451668 -76532004)
2013,Noviembre,Guatemala,370,659,,1029,POINT (4697157 -74140516)
2013,Noviembre,Guatemala,4,2,,6,POINT (4815189 -75736374)
2013,Noviembre,Guatemala,49,124,,173,POINT (6170465 -7542726)
2013,Noviembre,Guatemala,0,3,,3,POINT (7128047 -73181317)
2013,Noviembre,Guatemala,1,8,,9,POINT (7819 -72453013)
2013,Noviembre,Guatemala,0,2,,2,POINT (7927233 -72508188)
2013,Noviembre,Guyana,0,1,,1,POINT (10446304 -75516486)
2013,Noviembre,Guyana,4,4,,8,POINT (3451668 -76532004)
2013,Noviembre,Guyana,1,7,,8,POINT (4697157 -74140516)
2013,Noviembre,Guyana,0,3,,3,POINT (6170465 -7542726)
2013,Noviembre,Guyana,1,1,,2,POINT (7819 -72453013)
2013,Noviembre,Guinea,0,1,,1,POINT (3451668 -76532004)
2013,Noviembre,Guinea Bissau,0,1,,1,POINT (4697157 -74140516)
2013,Noviembre,Haití,0,1,,1,POINT (10446304 -75516486)
2013,Noviembre,Haití,1,0,,1,POINT (10886686 -74776479)
2013,Noviembre,Haití,0,3,,3,POINT (3451668 -76532004)
2013,Noviembre,Haití,7,26,,33,POINT (4697157 -74140516)
2013,Noviembre,Haití,3,6,,9,POINT (6170465 -7542726)
2013,Noviembre,Honduras,2,0,,2,POINT (0.81488 -77356)
2013,Noviembre,Honduras,0,1,,1,POINT (1800143 -78802679)
2013,Noviembre,Honduras,0,3,,3,POINT (10406342 -75527794)
2013,Noviembre,Honduras,9,27,,36,POINT (10446304 -75516486)
2013,Noviembre,Honduras,7,5,,12,POINT (10886686 -74776479)
2013,Noviembre,Honduras,1,5,,6,POINT (11360029 -72129595)
2013,Noviembre,Honduras,17,24,,41,POINT (3451668 -76532004)
2013,Noviembre,Honduras,115,207,,322,POINT (4697157 -74140516)
2013,Noviembre,Honduras,1,0,,1,POINT (4815189 -75736374)
2013,Noviembre,Honduras,19,35,,54,POINT (6170465 -7542726)
2013,Noviembre,Honduras,0,1,,1,POINT (7819 -72453013)
2013,Noviembre,Honduras,0,1,,1,POINT (863337 -7735002)
2013,Noviembre,Hong Kong,0,1,,1,POINT (4697157 -74140516)
2013,Noviembre,Hungría,0,1,,1,POINT (-4191162 -69941498)
2013,Noviembre,Hungría,0,1,,1,POINT (0.81488 -77356)
2013,Noviembre,Hungría,0,1,,1,POINT (10406342 -75527794)
2013,Noviembre,Hungría,3,0,,3,POINT (10446304 -75516486)
2013,Noviembre,Hungría,0,3,,3,POINT (1152863 -72919186)
2013,Noviembre,Hungría,0,1,,1,POINT (125862 -81702165)
2013,Noviembre,Hungría,0,1,,1,POINT (3451668 -76532004)
2013,Noviembre,Hungría,25,46,,71,POINT (4697157 -74140516)
2013,Noviembre,Hungría,1,2,,3,POINT (6170465 -7542726)
2013,Noviembre,Hungría,1,0,,1,POINT (7819 -72453013)
2013,Noviembre,India,0,1,,1,POINT (0.81488 -77356)
2013,Noviembre,India,0,7,,7,POINT (10406342 -75527794)
2013,Noviembre,India,2,11,,13,POINT (10446304 -75516486)
2013,Noviembre,India,1,1,,2,POINT (10886686 -74776479)
2013,Noviembre,India,0,2,,2,POINT (10970933 -74765343)
2013,Noviembre,India,0,1,,1,POINT (125862 -81702165)
2013,Noviembre,India,3,10,,13,POINT (3451668 -76532004)
2013,Noviembre,India,0,2,,2,POINT (3884426 -77061029)
2013,Noviembre,India,0,1,,1,POINT (445285 -75766353)
2013,Noviembre,India,30,231,,261,POINT (4697157 -74140516)
2013,Noviembre,India,0,2,,2,POINT (4815189 -75736374)
2013,Noviembre,India,3,29,,32,POINT (6170465 -7542726)
2013,Noviembre,Indonesia,0,1,,1,POINT (0.81488 -77356)
2013,Noviembre,Indonesia,0,3,,3,POINT (10406342 -75527794)
2013,Noviembre,Indonesia,1,0,,1,POINT (10446304 -75516486)
2013,Noviembre,Indonesia,0,1,,1,POINT (3451668 -76532004)
2013,Noviembre,Indonesia,11,24,,35,POINT (4697157 -74140516)
2013,Noviembre,Indonesia,0,2,,2,POINT (6170465 -7542726)
2013,Noviembre,Iraq,1,0,,1,POINT (10886686 -74776479)
2013,Noviembre,Iraq,0,3,,3,POINT (4697157 -74140516)
2013,Noviembre,Irán,1,0,,1,POINT (0.81488 -77356)
2013,Noviembre,Irán,4,17,,21,POINT (4697157 -74140516)
2013,Noviembre,Irán,1,0,,1,POINT (7819 -72453013)
2013,Noviembre,República de Irlanda,11,8,,19,POINT (0.81488 -77356)
2013,Noviembre,República de Irlanda,5,5,,10,POINT (10406342 -75527794)
2013,Noviembre,República de Irlanda,11,15,,26,POINT (10446304 -75516486)
2013,Noviembre,República de Irlanda,0,1,,1,POINT (10886686 -74776479)
2013,Noviembre,República de Irlanda,0,2,,2,POINT (11360029 -72129595)
2013,Noviembre,República de Irlanda,1,2,,3,POINT (3451668 -76532004)
2013,Noviembre,República de Irlanda,59,131,,190,POINT (4697157 -74140516)
2013,Noviembre,República de Irlanda,1,11,,12,POINT (6170465 -7542726)
2013,Noviembre,República de Irlanda,0,1,,1,POINT (7088729 -70740253)
2013,Noviembre,Islandia,1,1,,2,POINT (10406342 -75527794)
2013,Noviembre,Islandia,6,3,,9,POINT (4697157 -74140516)
2013,Noviembre,Islandia,0,1,,1,POINT (6170465 -7542726)
2013,Noviembre,Israel,3,11,,14,POINT (0.81488 -77356)
2013,Noviembre,Israel,1,2,,3,POINT (10406342 -75527794)
2013,Noviembre,Israel,1,17,,18,POINT (10446304 -75516486)
2013,Noviembre,Israel,0,2,,2,POINT (10886686 -74776479)
2013,Noviembre,Israel,2,0,,2,POINT (125862 -81702165)
2013,Noviembre,Israel,7,8,,15,POINT (3451668 -76532004)
2013,Noviembre,Israel,49,357,,406,POINT (4697157 -74140516)
2013,Noviembre,Israel,0,1,,1,POINT (4815189 -75736374)
2013,Noviembre,Israel,4,31,,35,POINT (6170465 -7542726)
2013,Noviembre,Italia,1,7,,8,POINT (-4191162 -69941498)
2013,Noviembre,Italia,7,34,,41,POINT (0.81488 -77356)
2013,Noviembre,Italia,5,6,,11,POINT (10406342 -75527794)
2013,Noviembre,Italia,29,84,,113,POINT (10446304 -75516486)
2013,Noviembre,Italia,3,15,,18,POINT (10886686 -74776479)
2013,Noviembre,Italia,0,1,,1,POINT (11247723 -74213989)
2013,Noviembre,Italia,0,12,,12,POINT (11360029 -72129595)
2013,Noviembre,Italia,0,1,,1,POINT (125744111 -81703935)
2013,Noviembre,Italia,5,8,,13,POINT (125862 -81702165)
2013,Noviembre,Italia,16,67,,83,POINT (3451668 -76532004)
2013,Noviembre,Italia,0,1,,1,POINT (445285 -75766353)
2013,Noviembre,Italia,470,1856,,2326,POINT (4697157 -74140516)
2013,Noviembre,Italia,1,6,,7,POINT (4815189 -75736374)
2013,Noviembre,Italia,19,95,,114,POINT (6170465 -7542726)
2013,Noviembre,Italia,0,1,,1,POINT (6185536 -67484028)
2013,Noviembre,Italia,1,2,,3,POINT (7088729 -70740253)
2013,Noviembre,Italia,0,1,,1,POINT (7128047 -73181317)
2013,Noviembre,Italia,12,16,,28,POINT (7819 -72453013)
2013,Noviembre,Italia,2,3,,5,POINT (7927233 -72508188)
2013,Noviembre,Italia,0,1,,1,POINT (863337 -7735002)
2013,Noviembre,Italia,0,2,,2,POINT (9402597 -75681642)
2013,Noviembre,Jamaica,1,1,,2,POINT (10446304 -75516486)
2013,Noviembre,Jamaica,1,1,,2,POINT (11360029 -72129595)
2013,Noviembre,Jamaica,2,1,,3,POINT (3451668 -76532004)
2013,Noviembre,Jamaica,8,20,,28,POINT (4697157 -74140516)
2013,Noviembre,Jamaica,5,19,,24,POINT (6170465 -7542726)
2013,Noviembre,Japón,0,1,,1,POINT (-4191162 -69941498)
2013,Noviembre,Japón,6,10,,16,POINT (0.81488 -77356)
2013,Noviembre,Japón,0,3,,3,POINT (10406342 -75527794)
2013,Noviembre,Japón,4,26,,30,POINT (10446304 -75516486)
2013,Noviembre,Japón,1,14,,15,POINT (10886686 -74776479)
2013,Noviembre,Japón,0,2,,2,POINT (11360029 -72129595)
2013,Noviembre,Japón,0,1,,1,POINT (125862 -81702165)
2013,Noviembre,Japón,4,18,,22,POINT (3451668 -76532004)
2013,Noviembre,Japón,102,456,,558,POINT (4697157 -74140516)
2013,Noviembre,Japón,5,33,,38,POINT (6170465 -7542726)
2013,Noviembre,Japón,0,1,,1,POINT (6185536 -67484028)
2013,Noviembre,Japón,4,6,,10,POINT (7819 -72453013)
2013,Noviembre,Japón,0,1,,1,POINT (7927233 -72508188)
2013,Noviembre,Jordania,0,1,,1,POINT (0.81488 -77356)
2013,Noviembre,Jordania,1,6,,7,POINT (4697157 -74140516)
2013,Noviembre,Kazajistán,3,6,,9,POINT (4697157 -74140516)
2013,Noviembre,Kenia,1,3,,4,POINT (3451668 -76532004)
2013,Noviembre,Kenia,1,7,,8,POINT (4697157 -74140516)
2013,Noviembre,Kirguistán,1,1,,2,POINT (4697157 -74140516)
2013,Noviembre,Kuwait,0,2,,2,POINT (4697157 -74140516)
2013,Noviembre,Letonia,1,0,,1,POINT (0.81488 -77356)
2013,Noviembre,Letonia,0,2,,2,POINT (10406342 -75527794)
2013,Noviembre,Letonia,0,1,,1,POINT (10886686 -74776479)
2013,Noviembre,Letonia,14,11,,25,POINT (4697157 -74140516)
2013,Noviembre,Letonia,2,3,,5,POINT (6170465 -7542726)
2013,Noviembre,Lituania,0,1,,1,POINT (0.81488 -77356)
2013,Noviembre,Lituania,1,1,,2,POINT (10406342 -75527794)
2013,Noviembre,Lituania,0,1,,1,POINT (10446304 -75516486)
2013,Noviembre,Lituania,1,1,,2,POINT (3451668 -76532004)
2013,Noviembre,Lituania,23,8,,31,POINT (4697157 -74140516)
2013,Noviembre,Lituania,2,0,,2,POINT (6170465 -7542726)
2013,Noviembre,Líbano,1,2,,3,POINT (10886686 -74776479)
2013,Noviembre,Líbano,4,0,,4,POINT (11360029 -72129595)
2013,Noviembre,Líbano,11,33,,44,POINT (4697157 -74140516)
2013,Noviembre,Liechtenstein,0,2,,2,POINT (4697157 -74140516)
2013,Noviembre,Liechtenstein,0,1,,1,POINT (6170465 -7542726)
2013,Noviembre,Luxemburgo,7,5,,12,POINT (4697157 -74140516)
2013,Noviembre,Luxemburgo,0,1,,1,POINT (6170465 -7542726)
2013,Noviembre,Madagascar,0,1,,1,POINT (4697157 -74140516)
2013,Noviembre,Malasia,3,2,,5,POINT (10446304 -75516486)
2013,Noviembre,Malasia,0,1,,1,POINT (10886686 -74776479)
2013,Noviembre,Malasia,0,1,,1,POINT (3451668 -76532004)
2013,Noviembre,Malasia,13,18,,31,POINT (4697157 -74140516)
2013,Noviembre,Malasia,1,0,,1,POINT (6170465 -7542726)
2013,Noviembre,Malasia,1,0,,1,POINT (7819 -72453013)
2013,Noviembre,Malta,0,1,,1,POINT (3451668 -76532004)
2013,Noviembre,Malta,1,3,,4,POINT (4697157 -74140516)
2013,Noviembre,Malta,0,1,,1,POINT (6170465 -7542726)
2013,Noviembre,Malta,0,1,,1,POINT (7819 -72453013)
2013,Noviembre,Marruecos,0,1,,1,POINT (10446304 -75516486)
2013,Noviembre,Marruecos,4,13,,17,POINT (4697157 -74140516)
2013,Noviembre,Mauricio,1,1,,2,POINT (4697157 -74140516)
2013,Noviembre,Mauritania,0,2,,2,POINT (4697157 -74140516)
2013,Noviembre,México,1,0,,1,POINT (-4191162 -69941498)
2013,Noviembre,México,12,25,,37,POINT (0.81488 -77356)
2013,Noviembre,México,367,242,,609,POINT (10406342 -75527794)
2013,Noviembre,México,327,321,,648,POINT (10446304 -75516486)
2013,Noviembre,México,37,81,,118,POINT (10886686 -74776479)
2013,Noviembre,México,4,14,,18,POINT (11360029 -72129595)
2013,Noviembre,México,4,2,,6,POINT (125862 -81702165)
2013,Noviembre,México,58,157,,215,POINT (3451668 -76532004)
2013,Noviembre,México,0,1,,1,POINT (445285 -75766353)
2013,Noviembre,México,2656,5610,,8266,POINT (4697157 -74140516)
2013,Noviembre,México,2,13,,15,POINT (4815189 -75736374)
2013,Noviembre,México,151,500,,651,POINT (6170465 -7542726)
2013,Noviembre,México,1,2,,3,POINT (6185536 -67484028)
2013,Noviembre,México,4,8,,12,POINT (7128047 -73181317)
2013,Noviembre,México,26,61,,87,POINT (7819 -72453013)
2013,Noviembre,México,4,13,,17,POINT (7927233 -72508188)
2013,Noviembre,México,1,0,,1,POINT (863337 -7735002)
2013,Noviembre,República de Moldavia,4,1,,5,POINT (4697157 -74140516)
2013,Noviembre,Mónaco,1,0,,1,POINT (0.81488 -77356)
2013,Noviembre,Mónaco,2,1,,3,POINT (4697157 -74140516)
2013,Noviembre,Mongolia,0,1,,1,POINT (6170465 -7542726)
2013,Noviembre,Mozambique,0,2,,2,POINT (4697157 -74140516)
2013,Noviembre,Myanmar,0,1,,1,POINT (10406342 -75527794)
2013,Noviembre,Namibia,0,1,,1,POINT (4697157 -74140516)
2013,Noviembre,Nepal,0,1,,1,POINT (3451668 -76532004)
2013,Noviembre,Nepal,0,1,,1,POINT (4697157 -74140516)
2013,Noviembre,Nicaragua,0,2,,2,POINT (10406342 -75527794)
2013,Noviembre,Nicaragua,9,4,,13,POINT (10446304 -75516486)
2013,Noviembre,Nicaragua,1,5,,6,POINT (10886686 -74776479)
2013,Noviembre,Nicaragua,0,7,,7,POINT (125744111 -81703935)
2013,Noviembre,Nicaragua,0,1,,1,POINT (125862 -81702165)
2013,Noviembre,Nicaragua,5,4,,9,POINT (3451668 -76532004)
2013,Noviembre,Nicaragua,72,88,,160,POINT (4697157 -74140516)
2013,Noviembre,Nicaragua,11,13,,24,POINT (4815189 -75736374)
2013,Noviembre,Nicaragua,4,13,,17,POINT (6170465 -7542726)
2013,Noviembre,Nicaragua,1,0,,1,POINT (7819 -72453013)
2013,Noviembre,Nigeria,3,9,,12,POINT (4697157 -74140516)
2013,Noviembre,Nigeria,1,1,,2,POINT (6170465 -7542726)
2013,Noviembre,Noruega,1,2,,3,POINT (0.81488 -77356)
2013,Noviembre,Noruega,1,4,,5,POINT (10406342 -75527794)
2013,Noviembre,Noruega,1,21,,22,POINT (10446304 -75516486)
2013,Noviembre,Noruega,0,4,,4,POINT (10886686 -74776479)
2013,Noviembre,Noruega,1,1,,2,POINT (125862 -81702165)
2013,Noviembre,Noruega,2,1,,3,POINT (3451668 -76532004)
2013,Noviembre,Noruega,56,134,,190,POINT (4697157 -74140516)
2013,Noviembre,Noruega,0,1,,1,POINT (4815189 -75736374)
2013,Noviembre,Noruega,2,3,,5,POINT (6170465 -7542726)
2013,Noviembre,Nueva Zelanda,8,8,,16,POINT (0.81488 -77356)
2013,Noviembre,Nueva Zelanda,6,6,,12,POINT (10406342 -75527794)
2013,Noviembre,Nueva Zelanda,3,7,,10,POINT (10446304 -75516486)
2013,Noviembre,Nueva Zelanda,1,2,,3,POINT (10886686 -74776479)
2013,Noviembre,Nueva Zelanda,1,1,,2,POINT (125862 -81702165)
2013,Noviembre,Nueva Zelanda,2,2,,4,POINT (3451668 -76532004)
2013,Noviembre,Nueva Zelanda,32,79,,111,POINT (4697157 -74140516)
2013,Noviembre,Nueva Zelanda,7,11,,18,POINT (6170465 -7542726)
2013,Noviembre,Nueva Zelanda,3,2,,5,POINT (7819 -72453013)
2013,Noviembre,Nueva Zelanda,0,1,,1,POINT (863337 -7735002)
2013,Noviembre,Nueva Zelanda,1,1,,2,POINT (-4191162 -69941498)
2013,Noviembre,Países Bajos,0,1,,1,POINT (-4191162 -69941498)
2013,Noviembre,Países Bajos,13,24,,37,POINT (0.81488 -77356)
2013,Noviembre,Países Bajos,8,22,,30,POINT (10406342 -75527794)
2013,Noviembre,Países Bajos,14,52,,66,POINT (10446304 -75516486)
2013,Noviembre,Países Bajos,4,15,,19,POINT (10886686 -74776479)
2013,Noviembre,Países Bajos,2,7,,9,POINT (11360029 -72129595)
2013,Noviembre,Países Bajos,10,10,,20,POINT (1152863 -72919186)
2013,Noviembre,Países Bajos,17,42,,59,POINT (3451668 -76532004)
2013,Noviembre,Países Bajos,519,1000,,1519,POINT (4697157 -74140516)
2013,Noviembre,Países Bajos,1,2,,3,POINT (4815189 -75736374)
2013,Noviembre,Países Bajos,224,360,,584,POINT (6170465 -7542726)
2013,Noviembre,Países Bajos,1,4,,5,POINT (7128047 -73181317)
2013,Noviembre,Países Bajos,1,3,,4,POINT (7819 -72453013)
2013,Noviembre,Países Bajos,0,1,,1,POINT (7927233 -72508188)
2013,Noviembre,Países Bajos,1,2,,3,POINT (863337 -7735002)
2013,Noviembre,Pakistán,1,0,,1,POINT (10446304 -75516486)
2013,Noviembre,Pakistán,0,1,,1,POINT (11360029 -72129595)
2013,Noviembre,Pakistán,0,1,,1,POINT (3451668 -76532004)
2013,Noviembre,Pakistán,1,14,,15,POINT (4697157 -74140516)
2013,Noviembre,Pakistán,0,3,,3,POINT (7819 -72453013)
2013,Noviembre,Panamá,0,2,,2,POINT (0.81488 -77356)
2013,Noviembre,Panamá,2,22,,24,POINT (10406342 -75527794)
2013,Noviembre,Panamá,140,217,,357,POINT (10446304 -75516486)
2013,Noviembre,Panamá,43,74,,117,POINT (10886686 -74776479)
2013,Noviembre,Panamá,1,4,,5,POINT (11360029 -72129595)
2013,Noviembre,Panamá,53,48,,101,POINT (125862 -81702165)
2013,Noviembre,Panamá,101,127,,228,POINT (3451668 -76532004)
2013,Noviembre,Panamá,695,938,,1633,POINT (4697157 -74140516)
2013,Noviembre,Panamá,81,143,,224,POINT (4815189 -75736374)
2013,Noviembre,Panamá,145,300,,445,POINT (6170465 -7542726)
2013,Noviembre,Panamá,10,9,,19,POINT (7128047 -73181317)
2013,Noviembre,Panamá,1,9,,10,POINT (7819 -72453013)
2013,Noviembre,Panamá,3,14,,17,POINT (7927233 -72508188)
2013,Noviembre,Panamá,1,0,,1,POINT (806667 -767333)
2013,Noviembre,Panamá,0,2,,2,POINT (863337 -7735002)
2013,Noviembre,Paraguay,18,11,,29,POINT (10446304 -75516486)
2013,Noviembre,Paraguay,3,4,,7,POINT (10886686 -74776479)
2013,Noviembre,Paraguay,4,2,,6,POINT (11360029 -72129595)
2013,Noviembre,Paraguay,5,4,,9,POINT (125862 -81702165)
2013,Noviembre,Paraguay,8,17,,25,POINT (3451668 -76532004)
2013,Noviembre,Paraguay,94,109,,203,POINT (4697157 -74140516)
2013,Noviembre,Paraguay,15,49,,64,POINT (6170465 -7542726)
2013,Noviembre,Perú,20,25,,45,POINT (-4191162 -69941498)
2013,Noviembre,Perú,0,2,,2,POINT (0.33002 -76876446)
2013,Noviembre,Perú,171,378,,549,POINT (0.81488 -77356)
2013,Noviembre,Perú,0,1,,1,POINT (1800143 -78802679)
2013,Noviembre,Perú,48,32,,80,POINT (10406342 -75527794)
2013,Noviembre,Perú,193,171,,364,POINT (10446304 -75516486)
2013,Noviembre,Perú,15,21,,36,POINT (10886686 -74776479)
2013,Noviembre,Perú,0,2,,2,POINT (11247723 -74213989)
2013,Noviembre,Perú,8,35,,43,POINT (11360029 -72129595)
2013,Noviembre,Perú,61,49,,110,POINT (125862 -81702165)
2013,Noviembre,Perú,152,249,,401,POINT (3451668 -76532004)
2013,Noviembre,Perú,2224,3250,,5474,POINT (4697157 -74140516)
2013,Noviembre,Perú,9,17,,26,POINT (4815189 -75736374)
2013,Noviembre,Perú,210,436,,646,POINT (6170465 -7542726)
2013,Noviembre,Perú,0,1,,1,POINT (6185536 -67484028)
2013,Noviembre,Perú,0,2,,2,POINT (7128047 -73181317)
2013,Noviembre,Perú,95,124,,219,POINT (7819 -72453013)
2013,Noviembre,Perú,4,12,,16,POINT (7927233 -72508188)
2013,Noviembre,Palestina,0,1,,1,POINT (4697157 -74140516)
2013,Noviembre,Polonia,7,8,,15,POINT (-4191162 -69941498)
2013,Noviembre,Polonia,2,2,,4,POINT (0.81488 -77356)
2013,Noviembre,Polonia,4,5,,9,POINT (10406342 -75527794)
2013,Noviembre,Polonia,10,19,,29,POINT (10446304 -75516486)
2013,Noviembre,Polonia,1,0,,1,POINT (10886686 -74776479)
2013,Noviembre,Polonia,0,1,,1,POINT (11247723 -74213989)
2013,Noviembre,Polonia,1,2,,3,POINT (11360029 -72129595)
2013,Noviembre,Polonia,80,119,,199,POINT (4697157 -74140516)
2013,Noviembre,Polonia,1,4,,5,POINT (6170465 -7542726)
2013,Noviembre,Portugal,1,0,,1,POINT (-4191162 -69941498)
2013,Noviembre,Portugal,2,6,,8,POINT (0.81488 -77356)
2013,Noviembre,Portugal,2,4,,6,POINT (10406342 -75527794)
2013,Noviembre,Portugal,5,10,,15,POINT (10446304 -75516486)
2013,Noviembre,Portugal,0,1,,1,POINT (10886686 -74776479)
2013,Noviembre,Portugal,3,3,,6,POINT (11360029 -72129595)
2013,Noviembre,Portugal,0,1,,1,POINT (125862 -81702165)
2013,Noviembre,Portugal,3,17,,20,POINT (3451668 -76532004)
2013,Noviembre,Portugal,121,376,,497,POINT (4697157 -74140516)
2013,Noviembre,Portugal,0,2,,2,POINT (4815189 -75736374)
2013,Noviembre,Portugal,5,20,,25,POINT (6170465 -7542726)
2013,Noviembre,Portugal,1,5,,6,POINT (7819 -72453013)
2013,Noviembre,Puerto Rico/Territorio de Estados Unidos,1,0,,1,POINT (3451668 -76532004)
2013,Noviembre,Qatar,0,1,,1,POINT (4697157 -74140516)
2013,Noviembre,Reino Unido de Gran Bretaña e Irlanda del Norte,1,1,,2,POINT (-4191162 -69941498)
2013,Noviembre,Reino Unido de Gran Bretaña e Irlanda del Norte,25,46,,71,POINT (0.81488 -77356)
2013,Noviembre,Reino Unido de Gran Bretaña e Irlanda del Norte,16,28,,44,POINT (10406342 -75527794)
2013,Noviembre,Reino Unido de Gran Bretaña e Irlanda del Norte,34,71,,105,POINT (10446304 -75516486)
2013,Noviembre,Reino Unido de Gran Bretaña e Irlanda del Norte,4,10,,14,POINT (10886686 -74776479)
2013,Noviembre,Reino Unido de Gran Bretaña e Irlanda del Norte,0,1,,1,POINT (11247723 -74213989)
2013,Noviembre,Reino Unido de Gran Bretaña e Irlanda del Norte,6,3,,9,POINT (11360029 -72129595)
2013,Noviembre,Reino Unido de Gran Bretaña e Irlanda del Norte,0,1,,1,POINT (1152863 -72919186)
2013,Noviembre,Reino Unido de Gran Bretaña e Irlanda del Norte,0,1,,1,POINT (133387613 -81372937)
2013,Noviembre,Reino Unido de Gran Bretaña e Irlanda del Norte,16,44,,60,POINT (3451668 -76532004)
2013,Noviembre,Reino Unido de Gran Bretaña e Irlanda del Norte,1,1,,2,POINT (445285 -75766353)
2013,Noviembre,Reino Unido de Gran Bretaña e Irlanda del Norte,589,1313,,1902,POINT (4697157 -74140516)
2013,Noviembre,Reino Unido de Gran Bretaña e Irlanda del Norte,2,4,,6,POINT (4815189 -75736374)
2013,Noviembre,Reino Unido de Gran Bretaña e Irlanda del Norte,30,112,,142,POINT (6170465 -7542726)
2013,Noviembre,Reino Unido de Gran Bretaña e Irlanda del Norte,1,0,,1,POINT (7088729 -70740253)
2013,Noviembre,Reino Unido de Gran Bretaña e Irlanda del Norte,0,1,,1,POINT (7128047 -73181317)
2013,Noviembre,Reino Unido de Gran Bretaña e Irlanda del Norte,1,2,,3,POINT (7819 -72453013)
2013,Noviembre,Reino Unido de Gran Bretaña e Irlanda del Norte,2,2,,4,POINT (863337 -7735002)
2013,Noviembre,República Dominicana,2,3,,5,POINT (0.81488 -77356)
2013,Noviembre,República Dominicana,0,1,,1,POINT (1800143 -78802679)
2013,Noviembre,República Dominicana,2,8,,10,POINT (10406342 -75527794)
2013,Noviembre,República Dominicana,23,71,,94,POINT (10446304 -75516486)
2013,Noviembre,República Dominicana,12,29,,41,POINT (10886686 -74776479)
2013,Noviembre,República Dominicana,1,2,,3,POINT (11360029 -72129595)
2013,Noviembre,República Dominicana,0,1,,1,POINT (125862 -81702165)
2013,Noviembre,República Dominicana,19,30,,49,POINT (3451668 -76532004)
2013,Noviembre,República Dominicana,227,416,,643,POINT (4697157 -74140516)
2013,Noviembre,República Dominicana,0,3,,3,POINT (4815189 -75736374)
2013,Noviembre,República Dominicana,39,75,,114,POINT (6170465 -7542726)
2013,Noviembre,República Dominicana,0,2,,2,POINT (7128047 -73181317)
2013,Noviembre,República Dominicana,1,7,,8,POINT (7819 -72453013)
2013,Noviembre,República Dominicana,0,1,,1,POINT (7927233 -72508188)
2013,Noviembre,República Dominicana,0,1,,1,POINT (863337 -7735002)
2013,Noviembre,República Checa,0,1,,1,POINT (-4191162 -69941498)
2013,Noviembre,República Checa,1,1,,2,POINT (0.33002 -76876446)
2013,Noviembre,República Checa,0,1,,1,POINT (11247723 -74213989)
2013,Noviembre,República Democrática Popular de Corea,0,1,,1,POINT (4697157 -74140516)
2013,Noviembre,Rumania,0,1,,1,POINT (0.81488 -77356)
2013,Noviembre,Rumania,2,9,,11,POINT (10406342 -75527794)
2013,Noviembre,Rumania,2,0,,2,POINT (10446304 -75516486)
2013,Noviembre,Rumania,2,4,,6,POINT (3451668 -76532004)
2013,Noviembre,Rumania,0,1,,1,POINT (3884426 -77061029)
2013,Noviembre,Rumania,31,59,,90,POINT (4697157 -74140516)
2013,Noviembre,Rumania,1,2,,3,POINT (6170465 -7542726)
2013,Noviembre,Rumania,1,1,,2,POINT (7819 -72453013)
2013,Noviembre,Rumania,0,2,,2,POINT (9402597 -75681642)
2013,Noviembre,Federación de Rusia,3,7,,10,POINT (0.81488 -77356)
2013,Noviembre,Federación de Rusia,2,5,,7,POINT (10406342 -75527794)
2013,Noviembre,Federación de Rusia,5,9,,14,POINT (10446304 -75516486)
2013,Noviembre,Federación de Rusia,3,0,,3,POINT (10886686 -74776479)
2013,Noviembre,Federación de Rusia,3,9,,12,POINT (11360029 -72129595)
2013,Noviembre,Federación de Rusia,0,1,,1,POINT (125862 -81702165)
2013,Noviembre,Federación de Rusia,5,5,,10,POINT (3451668 -76532004)
2013,Noviembre,Federación de Rusia,0,1,,1,POINT (3884426 -77061029)
2013,Noviembre,Federación de Rusia,172,238,,410,POINT (4697157 -74140516)
2013,Noviembre,Federación de Rusia,7,6,,13,POINT (6170465 -7542726)
2013,Noviembre,Federación de Rusia,3,4,,7,POINT (7819 -72453013)
2013,Noviembre,Federación de Rusia,2,0,,2,POINT (7927233 -72508188)
2013,Noviembre,Federación de Rusia,0,1,,1,POINT (863337 -7735002)
2013,Noviembre,San Cristóbal y Nevis,1,0,,1,POINT (6170465 -7542726)
2013,Noviembre,Samoa Occidental,1,0,,1,POINT (4697157 -74140516)
2013,Noviembre,San Marino,0,1,,1,POINT (4697157 -74140516)
2013,Noviembre,San  Vicente y las Granadinas,1,0,,1,POINT (125862 -81702165)
2013,Noviembre,San  Vicente y las Granadinas,0,1,,1,POINT (4697157 -74140516)
2013,Noviembre,San  Vicente y las Granadinas,0,1,,1,POINT (6170465 -7542726)
2013,Noviembre,Santa Lucia,0,1,,1,POINT (10446304 -75516486)
2013,Noviembre,Santa Lucia,4,0,,4,POINT (4697157 -74140516)
2013,Noviembre,Santa Lucia,0,1,,1,POINT (6170465 -7542726)
2013,Noviembre,Senegal,0,2,,2,POINT (4697157 -74140516)
2013,Noviembre,Serbia,0,2,,2,POINT (10446304 -75516486)
2013,Noviembre,Serbia,2,11,,13,POINT (4697157 -74140516)
2013,Noviembre,Serbia,1,0,,1,POINT (6170465 -7542726)
2013,Noviembre,Singapur,1,0,,1,POINT (0.81488 -77356)
2013,Noviembre,Singapur,0,2,,2,POINT (10406342 -75527794)
2013,Noviembre,Singapur,3,1,,4,POINT (10446304 -75516486)
2013,Noviembre,Singapur,9,11,,20,POINT (4697157 -74140516)
2013,Noviembre,Singapur,0,2,,2,POINT (6170465 -7542726)
2013,Noviembre,República Árabe Siria,0,1,,1,POINT (4697157 -74140516)
2013,Noviembre,Sri Lanka,0,1,,1,POINT (4697157 -74140516)
2013,Noviembre,Sudáfrica,0,1,,1,POINT (-4191162 -69941498)
2013,Noviembre,Sudáfrica,0,1,,1,POINT (0.81488 -77356)
2013,Noviembre,Sudáfrica,2,4,,6,POINT (10406342 -75527794)
2013,Noviembre,Sudáfrica,0,5,,5,POINT (10446304 -75516486)
2013,Noviembre,Sudáfrica,0,3,,3,POINT (10886686 -74776479)
2013,Noviembre,Sudáfrica,1,3,,4,POINT (10970933 -74765343)
2013,Noviembre,Sudáfrica,1,1,,2,POINT (11360029 -72129595)
2013,Noviembre,Sudáfrica,2,0,,2,POINT (125862 -81702165)
2013,Noviembre,Sudáfrica,0,2,,2,POINT (133387613 -81372937)
2013,Noviembre,Sudáfrica,2,2,,4,POINT (3451668 -76532004)
2013,Noviembre,Sudáfrica,48,108,,156,POINT (4697157 -74140516)
2013,Noviembre,Sudáfrica,2,7,,9,POINT (6170465 -7542726)
2013,Noviembre,Sudáfrica,0,2,,2,POINT (7819 -72453013)
2013,Noviembre,Sudáfrica,1,1,,2,POINT (863337 -7735002)
2013,Noviembre,Sudán,0,1,,1,POINT (4697157 -74140516)
2013,Noviembre,Suecia,1,2,,3,POINT (-4191162 -69941498)
2013,Noviembre,Suecia,8,14,,22,POINT (0.81488 -77356)
2013,Noviembre,Suecia,4,5,,9,POINT (10406342 -75527794)
2013,Noviembre,Suecia,7,19,,26,POINT (10446304 -75516486)
2013,Noviembre,Suecia,2,2,,4,POINT (10886686 -74776479)
2013,Noviembre,Suecia,2,2,,4,POINT (11247723 -74213989)
2013,Noviembre,Suecia,0,1,,1,POINT (11360029 -72129595)
2013,Noviembre,Suecia,19,15,,34,POINT (3451668 -76532004)
2013,Noviembre,Suecia,142,250,,392,POINT (4697157 -74140516)
2013,Noviembre,Suecia,14,19,,33,POINT (6170465 -7542726)
2013,Noviembre,Suecia,0,1,,1,POINT (6185536 -67484028)
2013,Noviembre,Suecia,0,1,,1,POINT (7128047 -73181317)
2013,Noviembre,Suecia,2,4,,6,POINT (7819 -72453013)
2013,Noviembre,Suiza,2,4,,6,POINT (-4191162 -69941498)
2013,Noviembre,Suiza,18,27,,45,POINT (0.81488 -77356)
2013,Noviembre,Suiza,6,8,,14,POINT (10406342 -75527794)
2013,Noviembre,Suiza,11,27,,38,POINT (10446304 -75516486)
2013,Noviembre,Suiza,3,4,,7,POINT (10886686 -74776479)
2013,Noviembre,Suiza,2,1,,3,POINT (11247723 -74213989)
2013,Noviembre,Suiza,2,3,,5,POINT (11360029 -72129595)
2013,Noviembre,Suiza,1,1,,2,POINT (125862 -81702165)
2013,Noviembre,Suiza,15,20,,35,POINT (3451668 -76532004)
2013,Noviembre,Suiza,1,0,,1,POINT (445285 -75766353)
2013,Noviembre,Suiza,264,497,,761,POINT (4697157 -74140516)
2013,Noviembre,Suiza,0,1,,1,POINT (4815189 -75736374)
2013,Noviembre,Suiza,21,46,,67,POINT (6170465 -7542726)
2013,Noviembre,Suiza,8,6,,14,POINT (7819 -72453013)
2013,Noviembre,Suiza,2,1,,3,POINT (7927233 -72508188)
2013,Noviembre,Surinam,2,1,,3,POINT (10446304 -75516486)
2013,Noviembre,Surinam,1,1,,2,POINT (3451668 -76532004)
2013,Noviembre,Surinam,14,17,,31,POINT (4697157 -74140516)
2013,Noviembre,Surinam,5,14,,19,POINT (6170465 -7542726)
2013,Noviembre,Taiwán,2,2,,4,POINT (0.81488 -77356)
2013,Noviembre,Taiwán,1,4,,5,POINT (10446304 -75516486)
2013,Noviembre,Taiwán,1,3,,4,POINT (10886686 -74776479)
2013,Noviembre,Taiwán,1,4,,5,POINT (3451668 -76532004)
2013,Noviembre,Taiwán,37,78,,115,POINT (4697157 -74140516)
2013,Noviembre,Taiwán,0,1,,1,POINT (4815189 -75736374)
2013,Noviembre,Taiwán,9,11,,20,POINT (6170465 -7542726)
2013,Noviembre,Tailandia,1,0,,1,POINT (10446304 -75516486)
2013,Noviembre,Tailandia,10,7,,17,POINT (4697157 -74140516)
2013,Noviembre,Tanzania,0,1,,1,POINT (4697157 -74140516)
2013,Noviembre,Togo,0,1,,1,POINT (10446304 -75516486)
2013,Noviembre,Trinidad y Tobago,0,1,,1,POINT (-4191162 -69941498)
2013,Noviembre,Trinidad y Tobago,0,1,,1,POINT (0.81488 -77356)
2013,Noviembre,Trinidad y Tobago,4,5,,9,POINT (10446304 -75516486)
2013,Noviembre,Trinidad y Tobago,1,2,,3,POINT (10886686 -74776479)
2013,Noviembre,Trinidad y Tobago,0,1,,1,POINT (125862 -81702165)
2013,Noviembre,Trinidad y Tobago,3,10,,13,POINT (3451668 -76532004)
2013,Noviembre,Trinidad y Tobago,8,30,,38,POINT (4697157 -74140516)
2013,Noviembre,Trinidad y Tobago,9,19,,28,POINT (6170465 -7542726)
2013,Noviembre,Trinidad y Tobago,0,3,,3,POINT (7819 -72453013)
2013,Noviembre,Trinidad y Tobago,0,1,,1,POINT (7927233 -72508188)
2013,Noviembre,Túnez,0,1,,1,POINT (3451668 -76532004)
2013,Noviembre,Túnez,1,2,,3,POINT (4697157 -74140516)
2013,Noviembre,Turquía,0,2,,2,POINT (0.81488 -77356)
2013,Noviembre,Turquía,1,5,,6,POINT (10406342 -75527794)
2013,Noviembre,Turquía,4,8,,12,POINT (10446304 -75516486)
2013,Noviembre,Turquía,0,1,,1,POINT (10886686 -74776479)
2013,Noviembre,Turquía,0,4,,4,POINT (10970933 -74765343)
2013,Noviembre,Turquía,23,117,,140,POINT (4697157 -74140516)
2013,Noviembre,Turquía,0,10,,10,POINT (6170465 -7542726)
2013,Noviembre,Turquía,0,1,,1,POINT (7819 -72453013)
2013,Noviembre,Ucrania,0,3,,3,POINT (10406342 -75527794)
2013,Noviembre,Ucrania,1,1,,2,POINT (10446304 -75516486)
2013,Noviembre,Ucrania,0,1,,1,POINT (10970933 -74765343)
2013,Noviembre,Ucrania,0,3,,3,POINT (11247723 -74213989)
2013,Noviembre,Ucrania,1,1,,2,POINT (3451668 -76532004)
2013,Noviembre,Ucrania,0,3,,3,POINT (3884426 -77061029)
2013,Noviembre,Ucrania,12,44,,56,POINT (4697157 -74140516)
2013,Noviembre,Ucrania,5,1,,6,POINT (6170465 -7542726)
2013,Noviembre,Uganda,0,1,,1,POINT (3451668 -76532004)
2013,Noviembre,Uganda,0,1,,1,POINT (4697157 -74140516)
2013,Noviembre,Federación de Rusia,0,3,,3,POINT (-4191162 -69941498)
2013,Noviembre,Federación de Rusia,1,1,,2,POINT (1800143 -78802679)
2013,Noviembre,Federación de Rusia,0,1,,1,POINT (10970933 -74765343)
2013,Noviembre,Federación de Rusia,0,1,,1,POINT (7819 -72453013)
2013,Noviembre,Uruguay,6,9,,15,POINT (0.81488 -77356)
2013,Noviembre,Uruguay,35,18,,53,POINT (10406342 -75527794)
2013,Noviembre,Uruguay,100,68,,168,POINT (10446304 -75516486)
2013,Noviembre,Uruguay,5,8,,13,POINT (10886686 -74776479)
2013,Noviembre,Uruguay,20,19,,39,POINT (125862 -81702165)
2013,Noviembre,Uruguay,21,32,,53,POINT (3451668 -76532004)
2013,Noviembre,Uruguay,139,285,,424,POINT (4697157 -74140516)
2013,Noviembre,Uruguay,0,3,,3,POINT (4815189 -75736374)
2013,Noviembre,Uruguay,29,66,,95,POINT (6170465 -7542726)
2013,Noviembre,Uruguay,0,2,,2,POINT (7128047 -73181317)
2013,Noviembre,Uruguay,2,3,,5,POINT (7819 -72453013)
2013,Noviembre,Uruguay,0,1,,1,POINT (7927233 -72508188)
2013,Noviembre,Venezuela,2,0,,2,POINT (-4191162 -69941498)
2013,Noviembre,Venezuela,172,241,,413,POINT (0.81488 -77356)
2013,Noviembre,Venezuela,9,34,,43,POINT (10406342 -75527794)
2013,Noviembre,Venezuela,80,133,,213,POINT (10446304 -75516486)
2013,Noviembre,Venezuela,37,91,,128,POINT (10886686 -74776479)
2013,Noviembre,Venezuela,0,1,,1,POINT (10970933 -74765343)
2013,Noviembre,Venezuela,1016,1966,,2982,POINT (11360029 -72129595)
2013,Noviembre,Venezuela,2,3,,5,POINT (1152863 -72919186)
2013,Noviembre,Venezuela,0,1,,1,POINT (125744111 -81703935)
2013,Noviembre,Venezuela,4,3,,7,POINT (125862 -81702165)
2013,Noviembre,Venezuela,77,133,,210,POINT (3451668 -76532004)
2013,Noviembre,Venezuela,0,1,,1,POINT (445285 -75766353)
2013,Noviembre,Venezuela,5512,6300,,11812,POINT (4697157 -74140516)
2013,Noviembre,Venezuela,2,10,,12,POINT (4815189 -75736374)
2013,Noviembre,Venezuela,795,783,,1578,POINT (6170465 -7542726)
2013,Noviembre,Venezuela,136,189,,325,POINT (6185536 -67484028)
2013,Noviembre,Venezuela,69,132,,201,POINT (7088729 -70740253)
2013,Noviembre,Venezuela,2,10,,12,POINT (7128047 -73181317)
2013,Noviembre,Venezuela,1678,2290,,3968,POINT (7819 -72453013)
2013,Noviembre,Venezuela,388,536,,924,POINT (7927233 -72508188)
2013,Noviembre,Venezuela,0,1,,1,POINT (863337 -7735002)
2013,Noviembre,Vietnam,3,4,,7,POINT (4697157 -74140516)
2013,Noviembre,República Árabe de Yemen,0,1,,1,POINT (4697157 -74140516)
2013,Noviembre,Zimbabue,0,1,,1,POINT (0.81488 -77356)
2013,Noviembre,Zimbabue,0,1,,1,POINT (6170465 -7542726)
2013,Noviembre,Zimbabue,1,0,,1,POINT (7819 -72453013)
2013,Noviembre,Reino Unido de Gran Bretaña e Irlanda del Norte,3,3,,6,POINT (-4191162 -69941498)
2013,Noviembre,Reino Unido de Gran Bretaña e Irlanda del Norte,2,2,,4,POINT (10406342 -75527794)
2013,Noviembre,Reino Unido de Gran Bretaña e Irlanda del Norte,3,1,,4,POINT (11247723 -74213989)
2013,Noviembre,Reino Unido de Gran Bretaña e Irlanda del Norte,2,1,,3,POINT (125744111 -81703935)
2013,Noviembre,Reino Unido de Gran Bretaña e Irlanda del Norte,0,1,,1,POINT (7819 -72453013)
2013,Noviembre,Países Bajos,1,3,,4,POINT (-4191162 -69941498)
2013,Noviembre,Países Bajos,0,1,,1,POINT (0.81488 -77356)
2013,Noviembre,Países Bajos,3,4,,7,POINT (10406342 -75527794)
2013,Noviembre,Países Bajos,1,2,,3,POINT (10446304 -75516486)
2013,Noviembre,Países Bajos,1,2,,3,POINT (11247723 -74213989)
2013,Noviembre,Países Bajos,1,2,,3,POINT (1152863 -72919186)
2013,Noviembre,Países Bajos,1,0,,1,POINT (125862 -81702165)
2013,Noviembre,Países Bajos,2,4,,6,POINT (3451668 -76532004)
2013,Noviembre,Países Bajos,4,5,,9,POINT (4697157 -74140516)
2013,Noviembre,Países Bajos,0,1,,1,POINT (6170465 -7542726)
2013,Noviembre,Países Bajos,0,3,,3,POINT (7128047 -73181317)
2013,Noviembre,Países Bajos,2,4,,6,POINT (7819 -72453013)
2013,Noviembre,Reino Unido de Gran Bretaña e Irlanda del Norte,0,1,,1,POINT (10406342 -75527794)
2013,Noviembre,Desconocido,4,3,,7,POINT (10446304 -75516486)
2013,Noviembre,Desconocido,0,3,,3,POINT (10886686 -74776479)
2013,Noviembre,Desconocido,1,4,,5,POINT (3451668 -76532004)
2013,Noviembre,Desconocido,38,71,,109,POINT (4697157 -74140516)
2013,Noviembre,Desconocido,5,2,,7,POINT (6170465 -7542726)
2013,Noviembre,República CentroÁfricana,0,1,,1,POINT (4697157 -74140516)
2013,Diciembre,Albania,0,1,,1,POINT (0.81488 -77356)
2013,Diciembre,Albania,0,1,,1,POINT (3451668 -76532004)
2013,Diciembre,Albania,0,2,,2,POINT (4697157 -74140516)
2013,Diciembre,Albania,0,1,,1,POINT (6170465 -7542726)
2013,Diciembre,Alemania,15,15,,30,POINT (-4191162 -69941498)
2013,Diciembre,Alemania,1,1,,2,POINT (0.33002 -76876446)
2013,Diciembre,Alemania,44,52,,96,POINT (0.81488 -77356)
2013,Diciembre,Alemania,27,31,,58,POINT (10406342 -75527794)
2013,Diciembre,Alemania,31,63,,94,POINT (10446304 -75516486)
2013,Diciembre,Alemania,9,22,,31,POINT (10886686 -74776479)
2013,Diciembre,Alemania,4,5,,9,POINT (11247723 -74213989)
2013,Diciembre,Alemania,7,10,,17,POINT (11360029 -72129595)
2013,Diciembre,Alemania,5,3,,8,POINT (125862 -81702165)
2013,Diciembre,Alemania,48,92,,140,POINT (3451668 -76532004)
2013,Diciembre,Alemania,0,1,,1,POINT (445285 -75766353)
2013,Diciembre,Alemania,1329,2079,,3408,POINT (4697157 -74140516)
2013,Diciembre,Alemania,0,3,,3,POINT (4815189 -75736374)
2013,Diciembre,Alemania,49,127,,176,POINT (6170465 -7542726)
2013,Diciembre,Alemania,2,2,,4,POINT (7128047 -73181317)
2013,Diciembre,Alemania,9,14,,23,POINT (7819 -72453013)
2013,Diciembre,Alemania,7,8,,15,POINT (863337 -7735002)
2013,Diciembre,Andorra,0,4,,4,POINT (4697157 -74140516)
2013,Diciembre,Angola,1,0,,1,POINT (3451668 -76532004)
2013,Diciembre,Antigua y Barbuda,0,7,,7,POINT (4697157 -74140516)
2013,Diciembre,Arabia Saudita,1,3,,4,POINT (10446304 -75516486)
2013,Diciembre,Arabia Saudita,1,20,,21,POINT (4697157 -74140516)
2013,Diciembre,Arabia Saudita,0,2,,2,POINT (6170465 -7542726)
2013,Diciembre,Arabia Saudita,0,1,,1,POINT (7927233 -72508188)
2013,Diciembre,Argelia,3,3,,6,POINT (4697157 -74140516)
2013,Diciembre,Argelia,0,1,,1,POINT (7819 -72453013)
2013,Diciembre,Argentina,0,4,,4,POINT (-4191162 -69941498)
2013,Diciembre,Argentina,0,1,,1,POINT (0.33002 -76876446)
2013,Diciembre,Argentina,60,133,,193,POINT (0.81488 -77356)
2013,Diciembre,Argentina,44,21,,65,POINT (10406342 -75527794)
2013,Diciembre,Argentina,586,445,,1031,POINT (10446304 -75516486)
2013,Diciembre,Argentina,7,32,,39,POINT (10886686 -74776479)
2013,Diciembre,Argentina,16,30,,46,POINT (11360029 -72129595)
2013,Diciembre,Argentina,237,221,,458,POINT (125862 -81702165)
2013,Diciembre,Argentina,63,108,,171,POINT (3451668 -76532004)
2013,Diciembre,Argentina,2590,3677,,6267,POINT (4697157 -74140516)
2013,Diciembre,Argentina,108,210,,318,POINT (6170465 -7542726)
2013,Diciembre,Argentina,1,0,,1,POINT (7088729 -70740253)
2013,Diciembre,Argentina,2,3,,5,POINT (7128047 -73181317)
2013,Diciembre,Argentina,8,24,,32,POINT (7819 -72453013)
2013,Diciembre,Argentina,1,9,,10,POINT (7927233 -72508188)
2013,Diciembre,Argentina,3,7,,10,POINT (863337 -7735002)
2013,Diciembre,República de Armenia,0,1,,1,POINT (7819 -72453013)
2013,Diciembre,Australia,9,9,,18,POINT (-4191162 -69941498)
2013,Diciembre,Australia,40,40,,80,POINT (0.81488 -77356)
2013,Diciembre,Australia,23,31,,54,POINT (10406342 -75527794)
2013,Diciembre,Australia,51,81,,132,POINT (10446304 -75516486)
2013,Diciembre,Australia,4,12,,16,POINT (10886686 -74776479)
2013,Diciembre,Australia,2,2,,4,POINT (11247723 -74213989)
2013,Diciembre,Australia,0,6,,6,POINT (11360029 -72129595)
2013,Diciembre,Australia,4,1,,5,POINT (125862 -81702165)
2013,Diciembre,Australia,19,33,,52,POINT (3451668 -76532004)
2013,Diciembre,Australia,291,557,,848,POINT (4697157 -74140516)
2013,Diciembre,Australia,5,7,,12,POINT (4815189 -75736374)
2013,Diciembre,Australia,42,81,,123,POINT (6170465 -7542726)
2013,Diciembre,Australia,1,3,,4,POINT (7128047 -73181317)
2013,Diciembre,Australia,3,3,,6,POINT (7819 -72453013)
2013,Diciembre,Australia,0,1,,1,POINT (7927233 -72508188)
2013,Diciembre,Australia,2,8,,10,POINT (863337 -7735002)
2013,Diciembre,Austria,0,2,,2,POINT (-4191162 -69941498)
2013,Diciembre,Austria,5,6,,11,POINT (0.81488 -77356)
2013,Diciembre,Austria,4,6,,10,POINT (10406342 -75527794)
2013,Diciembre,Austria,14,17,,31,POINT (10446304 -75516486)
2013,Diciembre,Austria,2,1,,3,POINT (10886686 -74776479)
2013,Diciembre,Austria,0,2,,2,POINT (11360029 -72129595)
2013,Diciembre,Austria,0,1,,1,POINT (125862 -81702165)
2013,Diciembre,Austria,2,8,,10,POINT (3451668 -76532004)
2013,Diciembre,Austria,105,219,,324,POINT (4697157 -74140516)
2013,Diciembre,Austria,5,16,,21,POINT (6170465 -7542726)
2013,Diciembre,Austria,2,5,,7,POINT (7819 -72453013)
2013,Diciembre,Austria,0,1,,1,POINT (863337 -7735002)
2013,Diciembre,Azerbaiyán,3,0,,3,POINT (4697157 -74140516)
2013,Diciembre,Bahamas,0,1,,1,POINT (4697157 -74140516)
2013,Diciembre,Bahamas,0,1,,1,POINT (4815189 -75736374)
2013,Diciembre,Bahamas,0,3,,3,POINT (6170465 -7542726)
2013,Diciembre,Bahréin,3,1,,4,POINT (4697157 -74140516)
2013,Diciembre,Bangladesh,0,3,,3,POINT (4697157 -74140516)
2013,Diciembre,Barbados,2,0,,2,POINT (10406342 -75527794)
2013,Diciembre,Barbados,0,1,,1,POINT (10446304 -75516486)
2013,Diciembre,Barbados,0,1,,1,POINT (3451668 -76532004)
2013,Diciembre,Barbados,8,4,,12,POINT (4697157 -74140516)
2013,Diciembre,Barbados,3,0,,3,POINT (6170465 -7542726)
2013,Diciembre,República de Belarús,1,1,,2,POINT (0.81488 -77356)
2013,Diciembre,República de Belarús,1,0,,1,POINT (11247723 -74213989)
2013,Diciembre,República de Belarús,1,0,,1,POINT (3451668 -76532004)
2013,Diciembre,República de Belarús,0,1,,1,POINT (6170465 -7542726)
2013,Diciembre,Bélgica,1,0,,1,POINT (-4191162 -69941498)
2013,Diciembre,Bélgica,12,13,,25,POINT (0.81488 -77356)
2013,Diciembre,Bélgica,2,6,,8,POINT (10406342 -75527794)
2013,Diciembre,Bélgica,12,14,,26,POINT (10446304 -75516486)
2013,Diciembre,Bélgica,1,3,,4,POINT (10886686 -74776479)
2013,Diciembre,Bélgica,1,9,,10,POINT (11247723 -74213989)
2013,Diciembre,Bélgica,0,1,,1,POINT (11360029 -72129595)
2013,Diciembre,Bélgica,1,0,,1,POINT (125862 -81702165)
2013,Diciembre,Bélgica,5,27,,32,POINT (3451668 -76532004)
2013,Diciembre,Bélgica,118,346,,464,POINT (4697157 -74140516)
2013,Diciembre,Bélgica,1,3,,4,POINT (4815189 -75736374)
2013,Diciembre,Bélgica,13,28,,41,POINT (6170465 -7542726)
2013,Diciembre,Bélgica,0,1,,1,POINT (7819 -72453013)
2013,Diciembre,Bélgica,0,2,,2,POINT (7927233 -72508188)
2013,Diciembre,Bélgica,2,3,,5,POINT (863337 -7735002)
2013,Diciembre,Belice,0,1,,1,POINT (10446304 -75516486)
2013,Diciembre,Belice,3,1,,4,POINT (10886686 -74776479)
2013,Diciembre,Belice,0,1,,1,POINT (11360029 -72129595)
2013,Diciembre,Belice,1,0,,1,POINT (3451668 -76532004)
2013,Diciembre,Belice,6,11,,17,POINT (4697157 -74140516)
2013,Diciembre,Belice,1,1,,2,POINT (6170465 -7542726)
2013,Diciembre,Benín,3,0,,3,POINT (11360029 -72129595)
2013,Diciembre,Benín,0,1,,1,POINT (4697157 -74140516)
2013,Diciembre,Bermudas/Territorio Británico de Ultramar,0,2,,2,POINT (4697157 -74140516)
2013,Diciembre,Bolivia,1,0,,1,POINT (-4191162 -69941498)
2013,Diciembre,Bolivia,13,19,,32,POINT (0.81488 -77356)
2013,Diciembre,Bolivia,7,4,,11,POINT (10406342 -75527794)
2013,Diciembre,Bolivia,18,26,,44,POINT (10446304 -75516486)
2013,Diciembre,Bolivia,3,2,,5,POINT (10886686 -74776479)
2013,Diciembre,Bolivia,2,1,,3,POINT (11360029 -72129595)
2013,Diciembre,Bolivia,24,17,,41,POINT (125862 -81702165)
2013,Diciembre,Bolivia,16,22,,38,POINT (3451668 -76532004)
2013,Diciembre,Bolivia,501,448,,949,POINT (4697157 -74140516)
2013,Diciembre,Bolivia,1,1,,2,POINT (4815189 -75736374)
2013,Diciembre,Bolivia,21,22,,43,POINT (6170465 -7542726)
2013,Diciembre,Bolivia,8,13,,21,POINT (7819 -72453013)
2013,Diciembre,Bolivia,1,6,,7,POINT (7927233 -72508188)
2013,Diciembre,Bosnia y Herzegovina,0,1,,1,POINT (4697157 -74140516)
2013,Diciembre,Brasil,92,121,,213,POINT (-4191162 -69941498)
2013,Diciembre,Brasil,18,17,,35,POINT (0.81488 -77356)
2013,Diciembre,Brasil,68,61,,129,POINT (10406342 -75527794)
2013,Diciembre,Brasil,335,269,,604,POINT (10446304 -75516486)
2013,Diciembre,Brasil,17,24,,41,POINT (10886686 -74776479)
2013,Diciembre,Brasil,16,20,,36,POINT (11360029 -72129595)
2013,Diciembre,Brasil,55,41,,96,POINT (125862 -81702165)
2013,Diciembre,Brasil,46,84,,130,POINT (3451668 -76532004)
2013,Diciembre,Brasil,3168,3922,,7090,POINT (4697157 -74140516)
2013,Diciembre,Brasil,0,4,,4,POINT (4815189 -75736374)
2013,Diciembre,Brasil,69,137,,206,POINT (6170465 -7542726)
2013,Diciembre,Brasil,0,3,,3,POINT (6185536 -67484028)
2013,Diciembre,Brasil,1,0,,1,POINT (7088729 -70740253)
2013,Diciembre,Brasil,0,3,,3,POINT (7128047 -73181317)
2013,Diciembre,Brasil,12,27,,39,POINT (7819 -72453013)
2013,Diciembre,Brasil,4,4,,8,POINT (7927233 -72508188)
2013,Diciembre,Brasil,1,0,,1,POINT (863337 -7735002)
2013,Diciembre,Bulgaria,0,1,,1,POINT (10406342 -75527794)
2013,Diciembre,Bulgaria,1,2,,3,POINT (10446304 -75516486)
2013,Diciembre,Bulgaria,1,2,,3,POINT (3451668 -76532004)
2013,Diciembre,Bulgaria,0,1,,1,POINT (3884426 -77061029)
2013,Diciembre,Bulgaria,13,12,,25,POINT (4697157 -74140516)
2013,Diciembre,Bulgaria,1,3,,4,POINT (6170465 -7542726)
2013,Diciembre,Bulgaria,1,0,,1,POINT (863337 -7735002)
2013,Diciembre,Burkina Faso,0,1,,1,POINT (4697157 -74140516)
2013,Diciembre,Burundi,0,1,,1,POINT (4697157 -74140516)
2013,Diciembre,Cabo Verde,0,1,,1,POINT (4697157 -74140516)
2013,Diciembre,Islas Caimán/Territorio Británico de Ultramar,2,9,,11,POINT (125862 -81702165)
2013,Diciembre,Islas Caimán/Territorio Británico de Ultramar,2,1,,3,POINT (4697157 -74140516)
2013,Diciembre,Camboya,0,1,,1,POINT (4697157 -74140516)
2013,Diciembre,Camerún,0,1,,1,POINT (4697157 -74140516)
2013,Diciembre,Canadá,3,4,,7,POINT (-4191162 -69941498)
2013,Diciembre,Canadá,1,2,,3,POINT (0.33002 -76876446)
2013,Diciembre,Canadá,13,21,,34,POINT (0.81488 -77356)
2013,Diciembre,Canadá,9,17,,26,POINT (10406342 -75527794)
2013,Diciembre,Canadá,561,615,,1176,POINT (10446304 -75516486)
2013,Diciembre,Canadá,19,57,,76,POINT (10886686 -74776479)
2013,Diciembre,Canadá,0,3,,3,POINT (11360029 -72129595)
2013,Diciembre,Canadá,212,228,,440,POINT (125862 -81702165)
2013,Diciembre,Canadá,89,133,,222,POINT (3451668 -76532004)
2013,Diciembre,Canadá,25,22,,47,POINT (445285 -75766353)
2013,Diciembre,Canadá,1167,1963,,3130,POINT (4697157 -74140516)
2013,Diciembre,Canadá,13,10,,23,POINT (4815189 -75736374)
2013,Diciembre,Canadá,211,327,,538,POINT (6170465 -7542726)
2013,Diciembre,Canadá,3,9,,12,POINT (7128047 -73181317)
2013,Diciembre,Canadá,3,8,,11,POINT (7819 -72453013)
2013,Diciembre,Canadá,3,7,,10,POINT (7927233 -72508188)
2013,Diciembre,Canadá,6,7,,13,POINT (863337 -7735002)
2013,Diciembre,República Democrática del Congo,0,1,,1,POINT (11360029 -72129595)
2013,Diciembre,República Democrática del Congo,2,4,,6,POINT (4697157 -74140516)
2013,Diciembre,República Democrática del Congo,2,0,,2,POINT (6170465 -7542726)
2013,Diciembre,República de Corea,2,1,,3,POINT (-4191162 -69941498)
2013,Diciembre,República de Corea,5,10,,15,POINT (0.81488 -77356)
2013,Diciembre,República de Corea,5,2,,7,POINT (10446304 -75516486)
2013,Diciembre,República de Corea,0,5,,5,POINT (11360029 -72129595)
2013,Diciembre,República de Corea,1,1,,2,POINT (125862 -81702165)
2013,Diciembre,República de Corea,3,9,,12,POINT (3451668 -76532004)
2013,Diciembre,República de Corea,159,303,,462,POINT (4697157 -74140516)
2013,Diciembre,República de Corea,12,22,,34,POINT (6170465 -7542726)
2013,Diciembre,República de Corea,0,1,,1,POINT (7128047 -73181317)
2013,Diciembre,República de Corea,2,3,,5,POINT (7819 -72453013)
2013,Diciembre,República de Corea,0,1,,1,POINT (863337 -7735002)
2013,Diciembre,Costa de Marfil,1,0,,1,POINT (4697157 -74140516)
2013,Diciembre,Costa Rica,1,8,,9,POINT (0.81488 -77356)
2013,Diciembre,Costa Rica,0,2,,2,POINT (10406342 -75527794)
2013,Diciembre,Costa Rica,53,62,,115,POINT (10446304 -75516486)
2013,Diciembre,Costa Rica,25,37,,62,POINT (10886686 -74776479)
2013,Diciembre,Costa Rica,2,2,,4,POINT (11360029 -72129595)
2013,Diciembre,Costa Rica,371,305,,676,POINT (125862 -81702165)
2013,Diciembre,Costa Rica,39,70,,109,POINT (3451668 -76532004)
2013,Diciembre,Costa Rica,679,889,,1568,POINT (4697157 -74140516)
2013,Diciembre,Costa Rica,5,13,,18,POINT (4815189 -75736374)
2013,Diciembre,Costa Rica,144,232,,376,POINT (6170465 -7542726)
2013,Diciembre,Costa Rica,1,2,,3,POINT (7128047 -73181317)
2013,Diciembre,Costa Rica,0,5,,5,POINT (7819 -72453013)
2013,Diciembre,Costa Rica,4,4,,8,POINT (7927233 -72508188)
2013,Diciembre,Costa Rica,1,0,,1,POINT (863337 -7735002)
2013,Diciembre,Croacia,1,0,,1,POINT (-4191162 -69941498)
2013,Diciembre,Croacia,0,2,,2,POINT (10406342 -75527794)
2013,Diciembre,Croacia,0,1,,1,POINT (10446304 -75516486)
2013,Diciembre,Croacia,0,6,,6,POINT (11247723 -74213989)
2013,Diciembre,Croacia,7,27,,34,POINT (4697157 -74140516)
2013,Diciembre,Croacia,0,1,,1,POINT (6170465 -7542726)
2013,Diciembre,Croacia,0,1,,1,POINT (7819 -72453013)
2013,Diciembre,Cuba,0,1,,1,POINT (-4191162 -69941498)
2013,Diciembre,Cuba,0,5,,5,POINT (0.81488 -77356)
2013,Diciembre,Cuba,5,13,,18,POINT (10446304 -75516486)
2013,Diciembre,Cuba,7,11,,18,POINT (10886686 -74776479)
2013,Diciembre,Cuba,1,0,,1,POINT (125862 -81702165)
2013,Diciembre,Cuba,11,44,,55,POINT (3451668 -76532004)
2013,Diciembre,Cuba,97,172,,269,POINT (4697157 -74140516)
2013,Diciembre,Cuba,16,33,,49,POINT (6170465 -7542726)
2013,Diciembre,Cuba,0,1,,1,POINT (7128047 -73181317)
2013,Diciembre,Cuba,0,2,,2,POINT (7819 -72453013)
2013,Diciembre,Curazao,3,4,,7,POINT (4697157 -74140516)
2013,Diciembre,República Checa,0,2,,2,POINT (-4191162 -69941498)
2013,Diciembre,República Checa,4,6,,10,POINT (0.81488 -77356)
2013,Diciembre,República Checa,1,4,,5,POINT (10406342 -75527794)
2013,Diciembre,República Checa,1,0,,1,POINT (10446304 -75516486)
2013,Diciembre,República Checa,1,0,,1,POINT (10886686 -74776479)
2013,Diciembre,República Checa,1,1,,2,POINT (11360029 -72129595)
2013,Diciembre,República Checa,2,5,,7,POINT (3451668 -76532004)
2013,Diciembre,República Checa,28,30,,58,POINT (4697157 -74140516)
2013,Diciembre,República Checa,5,3,,8,POINT (6170465 -7542726)
2013,Diciembre,República Checa,0,2,,2,POINT (7128047 -73181317)
2013,Diciembre,República Checa,0,2,,2,POINT (7819 -72453013)
2013,Diciembre,Chile,2,2,,4,POINT (-4191162 -69941498)
2013,Diciembre,Chile,42,97,,139,POINT (0.81488 -77356)
2013,Diciembre,Chile,10,9,,19,POINT (10406342 -75527794)
2013,Diciembre,Chile,49,63,,112,POINT (10446304 -75516486)
2013,Diciembre,Chile,5,14,,19,POINT (10886686 -74776479)
2013,Diciembre,Chile,2,6,,8,POINT (11360029 -72129595)
2013,Diciembre,Chile,22,19,,41,POINT (125862 -81702165)
2013,Diciembre,Chile,88,145,,233,POINT (3451668 -76532004)
2013,Diciembre,Chile,0,1,,1,POINT (445285 -75766353)
2013,Diciembre,Chile,1703,2650,,4353,POINT (4697157 -74140516)
2013,Diciembre,Chile,0,1,,1,POINT (4815189 -75736374)
2013,Diciembre,Chile,36,125,,161,POINT (6170465 -7542726)
2013,Diciembre,Chile,1,2,,3,POINT (7088729 -70740253)
2013,Diciembre,Chile,0,2,,2,POINT (7128047 -73181317)
2013,Diciembre,Chile,11,24,,35,POINT (7819 -72453013)
2013,Diciembre,China,1,0,,1,POINT (-4191162 -69941498)
2013,Diciembre,China,0,2,,2,POINT (0.81488 -77356)
2013,Diciembre,China,4,5,,9,POINT (10446304 -75516486)
2013,Diciembre,China,1,4,,5,POINT (10886686 -74776479)
2013,Diciembre,China,1,1,,2,POINT (11360029 -72129595)
2013,Diciembre,China,3,6,,9,POINT (3451668 -76532004)
2013,Diciembre,China,0,1,,1,POINT (3884426 -77061029)
2013,Diciembre,China,1,1,,2,POINT (445285 -75766353)
2013,Diciembre,China,127,383,,510,POINT (4697157 -74140516)
2013,Diciembre,China,9,5,,14,POINT (6170465 -7542726)
2013,Diciembre,China,0,1,,1,POINT (7819 -72453013)
2013,Diciembre,Chipre,1,3,,4,POINT (10446304 -75516486)
2013,Diciembre,Chipre,0,8,,8,POINT (4697157 -74140516)
2013,Diciembre,Dinamarca,2,2,,4,POINT (-4191162 -69941498)
2013,Diciembre,Dinamarca,2,2,,4,POINT (0.81488 -77356)
2013,Diciembre,Dinamarca,3,4,,7,POINT (10406342 -75527794)
2013,Diciembre,Dinamarca,5,7,,12,POINT (10446304 -75516486)
2013,Diciembre,Dinamarca,0,2,,2,POINT (10886686 -74776479)
2013,Diciembre,Dinamarca,1,1,,2,POINT (11360029 -72129595)
2013,Diciembre,Dinamarca,2,9,,11,POINT (3451668 -76532004)
2013,Diciembre,Dinamarca,77,141,,218,POINT (4697157 -74140516)
2013,Diciembre,Dinamarca,10,19,,29,POINT (6170465 -7542726)
2013,Diciembre,Dinamarca,0,2,,2,POINT (7819 -72453013)
2013,Diciembre,Dominica,0,3,,3,POINT (4697157 -74140516)
2013,Diciembre,Ecuador,0,4,,4,POINT (-4191162 -69941498)
2013,Diciembre,Ecuador,30,94,,124,POINT (0.33002 -76876446)
2013,Diciembre,Ecuador,1659,2555,,4214,POINT (0.81488 -77356)
2013,Diciembre,Ecuador,7,2,,9,POINT (1800143 -78802679)
2013,Diciembre,Ecuador,2,18,,20,POINT (10406342 -75527794)
2013,Diciembre,Ecuador,12,16,,28,POINT (10446304 -75516486)
2013,Diciembre,Ecuador,7,12,,19,POINT (10886686 -74776479)
2013,Diciembre,Ecuador,28,44,,72,POINT (11360029 -72129595)
2013,Diciembre,Ecuador,3,4,,7,POINT (125862 -81702165)
2013,Diciembre,Ecuador,454,541,,995,POINT (3451668 -76532004)
2013,Diciembre,Ecuador,0,1,,1,POINT (445285 -75766353)
2013,Diciembre,Ecuador,1743,2544,,4287,POINT (4697157 -74140516)
2013,Diciembre,Ecuador,2,1,,3,POINT (4815189 -75736374)
2013,Diciembre,Ecuador,621,662,,1283,POINT (6170465 -7542726)
2013,Diciembre,Ecuador,1,2,,3,POINT (7128047 -73181317)
2013,Diciembre,Ecuador,279,390,,669,POINT (7819 -72453013)
2013,Diciembre,Ecuador,2,2,,4,POINT (7927233 -72508188)
2013,Diciembre,Ecuador,0,2,,2,POINT (863337 -7735002)
2013,Diciembre,Egipto,0,1,,1,POINT (10446304 -75516486)
2013,Diciembre,Egipto,1,0,,1,POINT (125862 -81702165)
2013,Diciembre,Egipto,1,12,,13,POINT (4697157 -74140516)
2013,Diciembre,El Salvador,1,2,,3,POINT (10406342 -75527794)
2013,Diciembre,El Salvador,9,9,,18,POINT (10446304 -75516486)
2013,Diciembre,El Salvador,6,7,,13,POINT (10886686 -74776479)
2013,Diciembre,El Salvador,0,1,,1,POINT (11247723 -74213989)
2013,Diciembre,El Salvador,0,1,,1,POINT (11360029 -72129595)
2013,Diciembre,El Salvador,0,1,,1,POINT (125862 -81702165)
2013,Diciembre,El Salvador,61,101,,162,POINT (3451668 -76532004)
2013,Diciembre,El Salvador,0,1,,1,POINT (445285 -75766353)
2013,Diciembre,El Salvador,418,610,,1028,POINT (4697157 -74140516)
2013,Diciembre,El Salvador,1,2,,3,POINT (4815189 -75736374)
2013,Diciembre,El Salvador,34,53,,87,POINT (6170465 -7542726)
2013,Diciembre,El Salvador,2,1,,3,POINT (7819 -72453013)
2013,Diciembre,Emiratos Árabes,3,2,,5,POINT (3451668 -76532004)
2013,Diciembre,Emiratos Árabes,1,2,,3,POINT (4697157 -74140516)
2013,Diciembre,Emiratos Árabes,0,1,,1,POINT (6170465 -7542726)
2013,Diciembre,España,5,6,,11,POINT (-4191162 -69941498)
2013,Diciembre,España,0,1,,1,POINT (0.33002 -76876446)
2013,Diciembre,España,31,54,,85,POINT (0.81488 -77356)
2013,Diciembre,España,18,28,,46,POINT (10406342 -75527794)
2013,Diciembre,España,62,95,,157,POINT (10446304 -75516486)
2013,Diciembre,España,16,38,,54,POINT (10886686 -74776479)
2013,Diciembre,España,9,15,,24,POINT (11360029 -72129595)
2013,Diciembre,España,2,6,,8,POINT (125862 -81702165)
2013,Diciembre,España,1,0,,1,POINT (133387613 -81372937)
2013,Diciembre,España,198,417,,615,POINT (3451668 -76532004)
2013,Diciembre,España,1,1,,2,POINT (445285 -75766353)
2013,Diciembre,España,2321,5031,,7352,POINT (4697157 -74140516)
2013,Diciembre,España,4,8,,12,POINT (4815189 -75736374)
2013,Diciembre,España,171,362,,533,POINT (6170465 -7542726)
2013,Diciembre,España,2,1,,3,POINT (7088729 -70740253)
2013,Diciembre,España,0,4,,4,POINT (7128047 -73181317)
2013,Diciembre,España,13,44,,57,POINT (7819 -72453013)
2013,Diciembre,España,6,3,,9,POINT (7927233 -72508188)
2013,Diciembre,España,2,3,,5,POINT (863337 -7735002)
2013,Diciembre,Eslovaquia,1,0,,1,POINT (0.81488 -77356)
2013,Diciembre,Eslovaquia,1,1,,2,POINT (10406342 -75527794)
2013,Diciembre,Eslovaquia,2,1,,3,POINT (10446304 -75516486)
2013,Diciembre,Eslovaquia,0,2,,2,POINT (11360029 -72129595)
2013,Diciembre,Eslovaquia,1,0,,1,POINT (3451668 -76532004)
2013,Diciembre,Eslovaquia,5,6,,11,POINT (4697157 -74140516)
2013,Diciembre,Eslovaquia,2,3,,5,POINT (6170465 -7542726)
2013,Diciembre,Eslovaquia,0,1,,1,POINT (863337 -7735002)
2013,Diciembre,Eslovenia,1,1,,2,POINT (0.81488 -77356)
2013,Diciembre,Eslovenia,0,2,,2,POINT (10406342 -75527794)
2013,Diciembre,Eslovenia,0,2,,2,POINT (10886686 -74776479)
2013,Diciembre,Eslovenia,2,1,,3,POINT (3451668 -76532004)
2013,Diciembre,Eslovenia,17,29,,46,POINT (4697157 -74140516)
2013,Diciembre,Eslovenia,0,1,,1,POINT (6170465 -7542726)
2013,Diciembre,Eslovenia,1,0,,1,POINT (863337 -7735002)
2013,Diciembre,Estados Unidos de América,8,9,,17,POINT (-4191162 -69941498)
2013,Diciembre,Estados Unidos de América,45,90,,135,POINT (0.81488 -77356)
2013,Diciembre,Estados Unidos de América,53,78,,131,POINT (10406342 -75527794)
2013,Diciembre,Estados Unidos de América,1670,2615,,4285,POINT (10446304 -75516486)
2013,Diciembre,Estados Unidos de América,489,721,,1210,POINT (10886686 -74776479)
2013,Diciembre,Estados Unidos de América,2,8,,10,POINT (10970933 -74765343)
2013,Diciembre,Estados Unidos de América,3,3,,6,POINT (11247723 -74213989)
2013,Diciembre,Estados Unidos de América,7,13,,20,POINT (11360029 -72129595)
2013,Diciembre,Estados Unidos de América,52,65,,117,POINT (125862 -81702165)
2013,Diciembre,Estados Unidos de América,4,5,,9,POINT (133387613 -81372937)
2013,Diciembre,Estados Unidos de América,1434,2241,,3675,POINT (3451668 -76532004)
2013,Diciembre,Estados Unidos de América,107,145,,252,POINT (445285 -75766353)
2013,Diciembre,Estados Unidos de América,8663,14673,,23336,POINT (4697157 -74140516)
2013,Diciembre,Estados Unidos de América,205,275,,480,POINT (4815189 -75736374)
2013,Diciembre,Estados Unidos de América,2347,4330,,6677,POINT (6170465 -7542726)
2013,Diciembre,Estados Unidos de América,1,5,,6,POINT (7088729 -70740253)
2013,Diciembre,Estados Unidos de América,42,81,,123,POINT (7128047 -73181317)
2013,Diciembre,Estados Unidos de América,20,59,,79,POINT (7819 -72453013)
2013,Diciembre,Estados Unidos de América,48,56,,104,POINT (7927233 -72508188)
2013,Diciembre,Estados Unidos de América,4,12,,16,POINT (863337 -7735002)
2013,Diciembre,Estonia,0,1,,1,POINT (0.81488 -77356)
2013,Diciembre,Estonia,1,0,,1,POINT (3451668 -76532004)
2013,Diciembre,Estonia,5,8,,13,POINT (4697157 -74140516)
2013,Diciembre,Estonia,1,1,,2,POINT (6170465 -7542726)
2013,Diciembre,Estonia,0,1,,1,POINT (7819 -72453013)
2013,Diciembre,Estonia,0,1,,1,POINT (863337 -7735002)
2013,Diciembre,Filipinas,1,1,,2,POINT (0.81488 -77356)
2013,Diciembre,Filipinas,3,42,,45,POINT (10406342 -75527794)
2013,Diciembre,Filipinas,0,5,,5,POINT (10446304 -75516486)
2013,Diciembre,Filipinas,1,5,,6,POINT (10886686 -74776479)
2013,Diciembre,Filipinas,0,20,,20,POINT (10970933 -74765343)
2013,Diciembre,Filipinas,0,15,,15,POINT (11247723 -74213989)
2013,Diciembre,Filipinas,1,2,,3,POINT (3451668 -76532004)
2013,Diciembre,Filipinas,0,3,,3,POINT (3884426 -77061029)
2013,Diciembre,Filipinas,18,65,,83,POINT (4697157 -74140516)
2013,Diciembre,Filipinas,1,3,,4,POINT (6170465 -7542726)
2013,Diciembre,Finlandia,1,1,,2,POINT (-4191162 -69941498)
2013,Diciembre,Finlandia,1,0,,1,POINT (0.81488 -77356)
2013,Diciembre,Finlandia,3,0,,3,POINT (10406342 -75527794)
2013,Diciembre,Finlandia,4,5,,9,POINT (10446304 -75516486)
2013,Diciembre,Finlandia,0,3,,3,POINT (10886686 -74776479)
2013,Diciembre,Finlandia,0,1,,1,POINT (11117206 -74232675)
2013,Diciembre,Finlandia,1,5,,6,POINT (3451668 -76532004)
2013,Diciembre,Finlandia,58,91,,149,POINT (4697157 -74140516)
2013,Diciembre,Finlandia,6,8,,14,POINT (6170465 -7542726)
2013,Diciembre,Finlandia,1,0,,1,POINT (863337 -7735002)
2013,Diciembre,Francia,1,8,,9,POINT (-4191162 -69941498)
2013,Diciembre,Francia,0,1,,1,POINT (0.33002 -76876446)
2013,Diciembre,Francia,32,61,,93,POINT (0.81488 -77356)
2013,Diciembre,Francia,6,11,,17,POINT (10406342 -75527794)
2013,Diciembre,Francia,39,60,,99,POINT (10446304 -75516486)
2013,Diciembre,Francia,5,9,,14,POINT (10886686 -74776479)
2013,Diciembre,Francia,1,1,,2,POINT (11247723 -74213989)
2013,Diciembre,Francia,8,16,,24,POINT (11360029 -72129595)
2013,Diciembre,Francia,1,3,,4,POINT (125862 -81702165)
2013,Diciembre,Francia,3,3,,6,POINT (133387613 -81372937)
2013,Diciembre,Francia,43,86,,129,POINT (3451668 -76532004)
2013,Diciembre,Francia,1,0,,1,POINT (445285 -75766353)
2013,Diciembre,Francia,1291,2266,,3557,POINT (4697157 -74140516)
2013,Diciembre,Francia,3,4,,7,POINT (4815189 -75736374)
2013,Diciembre,Francia,74,128,,202,POINT (6170465 -7542726)
2013,Diciembre,Francia,1,0,,1,POINT (7088729 -70740253)
2013,Diciembre,Francia,0,2,,2,POINT (7128047 -73181317)
2013,Diciembre,Francia,4,12,,16,POINT (7819 -72453013)
2013,Diciembre,Francia,2,4,,6,POINT (7927233 -72508188)
2013,Diciembre,Francia,8,16,,24,POINT (863337 -7735002)
2013,Diciembre,Gabón,0,1,,1,POINT (4697157 -74140516)
2013,Diciembre,Georgia,1,0,,1,POINT (0.81488 -77356)
2013,Diciembre,Georgia,1,2,,3,POINT (4697157 -74140516)
2013,Diciembre,Ghana,1,0,,1,POINT (0.81488 -77356)
2013,Diciembre,Ghana,1,0,,1,POINT (4697157 -74140516)
2013,Diciembre,Granada,0,1,,1,POINT (10406342 -75527794)
2013,Diciembre,Granada,0,2,,2,POINT (4697157 -74140516)
2013,Diciembre,Granada,0,1,,1,POINT (7927233 -72508188)
2013,Diciembre,Grecia,4,2,,6,POINT (0.81488 -77356)
2013,Diciembre,Grecia,0,6,,6,POINT (10406342 -75527794)
2013,Diciembre,Grecia,4,4,,8,POINT (10446304 -75516486)
2013,Diciembre,Grecia,0,1,,1,POINT (10886686 -74776479)
2013,Diciembre,Grecia,0,1,,1,POINT (10970933 -74765343)
2013,Diciembre,Grecia,0,1,,1,POINT (11360029 -72129595)
2013,Diciembre,Grecia,2,3,,5,POINT (3451668 -76532004)
2013,Diciembre,Grecia,25,62,,87,POINT (4697157 -74140516)
2013,Diciembre,Grecia,3,3,,6,POINT (6170465 -7542726)
2013,Diciembre,Grecia,0,1,,1,POINT (863337 -7735002)
2013,Diciembre,Guatemala,1,6,,7,POINT (0.81488 -77356)
2013,Diciembre,Guatemala,0,5,,5,POINT (10406342 -75527794)
2013,Diciembre,Guatemala,51,50,,101,POINT (10446304 -75516486)
2013,Diciembre,Guatemala,6,7,,13,POINT (10886686 -74776479)
2013,Diciembre,Guatemala,0,1,,1,POINT (10970933 -74765343)
2013,Diciembre,Guatemala,0,1,,1,POINT (11360029 -72129595)
2013,Diciembre,Guatemala,13,12,,25,POINT (125862 -81702165)
2013,Diciembre,Guatemala,23,52,,75,POINT (3451668 -76532004)
2013,Diciembre,Guatemala,293,532,,825,POINT (4697157 -74140516)
2013,Diciembre,Guatemala,2,7,,9,POINT (4815189 -75736374)
2013,Diciembre,Guatemala,42,93,,135,POINT (6170465 -7542726)
2013,Diciembre,Guatemala,3,4,,7,POINT (7128047 -73181317)
2013,Diciembre,Guatemala,4,6,,10,POINT (7819 -72453013)
2013,Diciembre,Guatemala,1,4,,5,POINT (7927233 -72508188)
2013,Diciembre,Guyana,1,0,,1,POINT (0.81488 -77356)
2013,Diciembre,Guyana,2,1,,3,POINT (10446304 -75516486)
2013,Diciembre,Guyana,0,1,,1,POINT (3451668 -76532004)
2013,Diciembre,Guyana,10,16,,26,POINT (4697157 -74140516)
2013,Diciembre,Guyana,0,1,,1,POINT (6170465 -7542726)
2013,Diciembre,Guinea Ecuatorial,0,2,,2,POINT (4697157 -74140516)
2013,Diciembre,Haití,2,2,,4,POINT (0.81488 -77356)
2013,Diciembre,Haití,3,16,,19,POINT (10446304 -75516486)
2013,Diciembre,Haití,0,1,,1,POINT (10886686 -74776479)
2013,Diciembre,Haití,7,11,,18,POINT (3451668 -76532004)
2013,Diciembre,Haití,3,7,,10,POINT (4697157 -74140516)
2013,Diciembre,Haití,2,1,,3,POINT (6170465 -7542726)
2013,Diciembre,Honduras,1,2,,3,POINT (0.81488 -77356)
2013,Diciembre,Honduras,0,6,,6,POINT (10406342 -75527794)
2013,Diciembre,Honduras,21,36,,57,POINT (10446304 -75516486)
2013,Diciembre,Honduras,3,8,,11,POINT (10886686 -74776479)
2013,Diciembre,Honduras,0,1,,1,POINT (10970933 -74765343)
2013,Diciembre,Honduras,1,1,,2,POINT (11360029 -72129595)
2013,Diciembre,Honduras,1,0,,1,POINT (125862 -81702165)
2013,Diciembre,Honduras,17,21,,38,POINT (3451668 -76532004)
2013,Diciembre,Honduras,0,1,,1,POINT (445285 -75766353)
2013,Diciembre,Honduras,141,177,,318,POINT (4697157 -74140516)
2013,Diciembre,Honduras,2,2,,4,POINT (4815189 -75736374)
2013,Diciembre,Honduras,39,40,,79,POINT (6170465 -7542726)
2013,Diciembre,Honduras,3,0,,3,POINT (7128047 -73181317)
2013,Diciembre,Honduras,0,2,,2,POINT (806667 -767333)
2013,Diciembre,Honduras,1,1,,2,POINT (863337 -7735002)
2013,Diciembre,Hungría,2,2,,4,POINT (0.81488 -77356)
2013,Diciembre,Hungría,2,1,,3,POINT (10446304 -75516486)
2013,Diciembre,Hungría,0,2,,2,POINT (3451668 -76532004)
2013,Diciembre,Hungría,26,33,,59,POINT (4697157 -74140516)
2013,Diciembre,Hungría,1,0,,1,POINT (4815189 -75736374)
2013,Diciembre,Hungría,2,2,,4,POINT (6170465 -7542726)
2013,Diciembre,Hungría,1,0,,1,POINT (7819 -72453013)
2013,Diciembre,India,0,2,,2,POINT (0.81488 -77356)
2013,Diciembre,India,0,3,,3,POINT (10406342 -75527794)
2013,Diciembre,India,5,7,,12,POINT (10446304 -75516486)
2013,Diciembre,India,0,11,,11,POINT (10886686 -74776479)
2013,Diciembre,India,0,1,,1,POINT (10970933 -74765343)
2013,Diciembre,India,0,1,,1,POINT (11247723 -74213989)
2013,Diciembre,India,0,1,,1,POINT (11360029 -72129595)
2013,Diciembre,India,0,1,,1,POINT (125862 -81702165)
2013,Diciembre,India,1,7,,8,POINT (3451668 -76532004)
2013,Diciembre,India,51,205,,256,POINT (4697157 -74140516)
2013,Diciembre,India,5,14,,19,POINT (6170465 -7542726)
2013,Diciembre,India,1,0,,1,POINT (7819 -72453013)
2013,Diciembre,Indonesia,0,4,,4,POINT (10406342 -75527794)
2013,Diciembre,Indonesia,0,2,,2,POINT (10446304 -75516486)
2013,Diciembre,Indonesia,0,1,,1,POINT (3451668 -76532004)
2013,Diciembre,Indonesia,13,31,,44,POINT (4697157 -74140516)
2013,Diciembre,Iraq,0,2,,2,POINT (4697157 -74140516)
2013,Diciembre,Irán,0,1,,1,POINT (-4191162 -69941498)
2013,Diciembre,Irán,0,1,,1,POINT (3451668 -76532004)
2013,Diciembre,Irán,1,13,,14,POINT (4697157 -74140516)
2013,Diciembre,Irán,0,1,,1,POINT (6170465 -7542726)
2013,Diciembre,República de Irlanda,2,1,,3,POINT (-4191162 -69941498)
2013,Diciembre,República de Irlanda,3,4,,7,POINT (0.81488 -77356)
2013,Diciembre,República de Irlanda,4,3,,7,POINT (10406342 -75527794)
2013,Diciembre,República de Irlanda,2,9,,11,POINT (10446304 -75516486)
2013,Diciembre,República de Irlanda,1,4,,5,POINT (3451668 -76532004)
2013,Diciembre,República de Irlanda,70,131,,201,POINT (4697157 -74140516)
2013,Diciembre,República de Irlanda,5,15,,20,POINT (6170465 -7542726)
2013,Diciembre,República de Irlanda,0,1,,1,POINT (7088729 -70740253)
2013,Diciembre,República de Irlanda,0,4,,4,POINT (7819 -72453013)
2013,Diciembre,República de Irlanda,0,2,,2,POINT (863337 -7735002)
2013,Diciembre,Islandia,0,1,,1,POINT (-4191162 -69941498)
2013,Diciembre,Islandia,2,1,,3,POINT (0.81488 -77356)
2013,Diciembre,Islandia,0,1,,1,POINT (10446304 -75516486)
2013,Diciembre,Islandia,10,13,,23,POINT (4697157 -74140516)
2013,Diciembre,Islandia,0,1,,1,POINT (6170465 -7542726)
2013,Diciembre,Israel,0,6,,6,POINT (0.81488 -77356)
2013,Diciembre,Israel,2,2,,4,POINT (10406342 -75527794)
2013,Diciembre,Israel,3,40,,43,POINT (10446304 -75516486)
2013,Diciembre,Israel,0,5,,5,POINT (10886686 -74776479)
2013,Diciembre,Israel,0,18,,18,POINT (3451668 -76532004)
2013,Diciembre,Israel,0,1,,1,POINT (445285 -75766353)
2013,Diciembre,Israel,63,325,,388,POINT (4697157 -74140516)
2013,Diciembre,Israel,0,1,,1,POINT (4815189 -75736374)
2013,Diciembre,Israel,1,38,,39,POINT (6170465 -7542726)
2013,Diciembre,Israel,2,1,,3,POINT (7128047 -73181317)
2013,Diciembre,Israel,0,1,,1,POINT (7927233 -72508188)
2013,Diciembre,Italia,1,4,,5,POINT (-4191162 -69941498)
2013,Diciembre,Italia,1,0,,1,POINT (0.33002 -76876446)
2013,Diciembre,Italia,9,18,,27,POINT (0.81488 -77356)
2013,Diciembre,Italia,2,13,,15,POINT (10406342 -75527794)
2013,Diciembre,Italia,40,130,,170,POINT (10446304 -75516486)
2013,Diciembre,Italia,2,16,,18,POINT (10886686 -74776479)
2013,Diciembre,Italia,0,1,,1,POINT (11247723 -74213989)
2013,Diciembre,Italia,12,17,,29,POINT (11360029 -72129595)
2013,Diciembre,Italia,2,6,,8,POINT (125862 -81702165)
2013,Diciembre,Italia,29,76,,105,POINT (3451668 -76532004)
2013,Diciembre,Italia,1,0,,1,POINT (445285 -75766353)
2013,Diciembre,Italia,544,1674,,2218,POINT (4697157 -74140516)
2013,Diciembre,Italia,1,2,,3,POINT (4815189 -75736374)
2013,Diciembre,Italia,43,127,,170,POINT (6170465 -7542726)
2013,Diciembre,Italia,0,3,,3,POINT (6185536 -67484028)
2013,Diciembre,Italia,1,3,,4,POINT (7088729 -70740253)
2013,Diciembre,Italia,3,3,,6,POINT (7128047 -73181317)
2013,Diciembre,Italia,10,29,,39,POINT (7819 -72453013)
2013,Diciembre,Italia,4,2,,6,POINT (7927233 -72508188)
2013,Diciembre,Italia,1,5,,6,POINT (863337 -7735002)
2013,Diciembre,Jamaica,1,0,,1,POINT (10406342 -75527794)
2013,Diciembre,Jamaica,0,2,,2,POINT (10446304 -75516486)
2013,Diciembre,Jamaica,3,6,,9,POINT (10886686 -74776479)
2013,Diciembre,Jamaica,1,1,,2,POINT (125862 -81702165)
2013,Diciembre,Jamaica,1,1,,2,POINT (3451668 -76532004)
2013,Diciembre,Jamaica,5,9,,14,POINT (4697157 -74140516)
2013,Diciembre,Jamaica,0,1,,1,POINT (4815189 -75736374)
2013,Diciembre,Jamaica,0,3,,3,POINT (6170465 -7542726)
2013,Diciembre,Jamaica,0,1,,1,POINT (7927233 -72508188)
2013,Diciembre,Japón,0,1,,1,POINT (-4191162 -69941498)
2013,Diciembre,Japón,11,5,,16,POINT (0.81488 -77356)
2013,Diciembre,Japón,1,3,,4,POINT (10406342 -75527794)
2013,Diciembre,Japón,4,8,,12,POINT (10446304 -75516486)
2013,Diciembre,Japón,0,1,,1,POINT (10886686 -74776479)
2013,Diciembre,Japón,0,1,,1,POINT (11360029 -72129595)
2013,Diciembre,Japón,20,14,,34,POINT (3451668 -76532004)
2013,Diciembre,Japón,134,364,,498,POINT (4697157 -74140516)
2013,Diciembre,Japón,0,1,,1,POINT (4815189 -75736374)
2013,Diciembre,Japón,6,42,,48,POINT (6170465 -7542726)
2013,Diciembre,Japón,0,5,,5,POINT (7819 -72453013)
2013,Diciembre,Japón,0,2,,2,POINT (7927233 -72508188)
2013,Diciembre,Japón,2,4,,6,POINT (863337 -7735002)
2013,Diciembre,Jordania,1,0,,1,POINT (0.81488 -77356)
2013,Diciembre,Jordania,1,3,,4,POINT (4697157 -74140516)
2013,Diciembre,Jordania,0,3,,3,POINT (6170465 -7542726)
2013,Diciembre,Kazajistán,4,1,,5,POINT (4697157 -74140516)
2013,Diciembre,Kenia,1,3,,4,POINT (10446304 -75516486)
2013,Diciembre,Kenia,1,0,,1,POINT (11360029 -72129595)
2013,Diciembre,Kenia,6,9,,15,POINT (4697157 -74140516)
2013,Diciembre,Kenia,0,1,,1,POINT (6170465 -7542726)
2013,Diciembre,Kirguistán,0,1,,1,POINT (4697157 -74140516)
2013,Diciembre,Kuwait,0,11,,11,POINT (10446304 -75516486)
2013,Diciembre,Kuwait,1,0,,1,POINT (10886686 -74776479)
2013,Diciembre,Kuwait,1,1,,2,POINT (3451668 -76532004)
2013,Diciembre,Kuwait,0,3,,3,POINT (4697157 -74140516)
2013,Diciembre,República de Kosovo,2,1,,3,POINT (4697157 -74140516)
2013,Diciembre,República Democrática Popular  Lao,1,0,,1,POINT (4697157 -74140516)
2013,Diciembre,Letonia,5,4,,9,POINT (4697157 -74140516)
2013,Diciembre,Letonia,2,1,,3,POINT (6170465 -7542726)
2013,Diciembre,Lituania,2,0,,2,POINT (0.81488 -77356)
2013,Diciembre,Lituania,0,1,,1,POINT (10406342 -75527794)
2013,Diciembre,Lituania,2,1,,3,POINT (10446304 -75516486)
2013,Diciembre,Lituania,0,1,,1,POINT (10886686 -74776479)
2013,Diciembre,Lituania,0,3,,3,POINT (10970933 -74765343)
2013,Diciembre,Lituania,1,0,,1,POINT (11360029 -72129595)
2013,Diciembre,Lituania,2,0,,2,POINT (3451668 -76532004)
2013,Diciembre,Lituania,15,14,,29,POINT (4697157 -74140516)
2013,Diciembre,Lituania,0,1,,1,POINT (6170465 -7542726)
2013,Diciembre,Líbano,1,2,,3,POINT (10886686 -74776479)
2013,Diciembre,Líbano,0,1,,1,POINT (11247723 -74213989)
2013,Diciembre,Líbano,2,2,,4,POINT (11360029 -72129595)
2013,Diciembre,Líbano,1,3,,4,POINT (3451668 -76532004)
2013,Diciembre,Líbano,11,18,,29,POINT (4697157 -74140516)
2013,Diciembre,Líbano,0,1,,1,POINT (6170465 -7542726)
2013,Diciembre,Liberia,1,2,,3,POINT (4697157 -74140516)
2013,Diciembre,Libia,0,2,,2,POINT (4697157 -74140516)
2013,Diciembre,Liechtenstein,0,4,,4,POINT (4697157 -74140516)
2013,Diciembre,Liechtenstein,0,1,,1,POINT (6170465 -7542726)
2013,Diciembre,Liechtenstein,1,1,,2,POINT (863337 -7735002)
2013,Diciembre,Luxemburgo,1,0,,1,POINT (0.81488 -77356)
2013,Diciembre,Luxemburgo,1,0,,1,POINT (10406342 -75527794)
2013,Diciembre,Luxemburgo,0,1,,1,POINT (3451668 -76532004)
2013,Diciembre,Luxemburgo,2,8,,10,POINT (4697157 -74140516)
2013,Diciembre,Luxemburgo,1,0,,1,POINT (6170465 -7542726)
2013,Diciembre,Macedonia,0,1,,1,POINT (10446304 -75516486)
2013,Diciembre,Macedonia,0,1,,1,POINT (4697157 -74140516)
2013,Diciembre,Malasia,2,0,,2,POINT (0.81488 -77356)
2013,Diciembre,Malasia,20,28,,48,POINT (4697157 -74140516)
2013,Diciembre,Malasia,0,1,,1,POINT (6170465 -7542726)
2013,Diciembre,Malta,1,0,,1,POINT (10446304 -75516486)
2013,Diciembre,Malta,1,2,,3,POINT (11360029 -72129595)
2013,Diciembre,Malta,2,4,,6,POINT (4697157 -74140516)
2013,Diciembre,Marruecos,2,0,,2,POINT (10446304 -75516486)
2013,Diciembre,Marruecos,0,1,,1,POINT (3451668 -76532004)
2013,Diciembre,Marruecos,7,7,,14,POINT (4697157 -74140516)
2013,Diciembre,Marruecos,0,1,,1,POINT (7819 -72453013)
2013,Diciembre,Mauricio,0,2,,2,POINT (4697157 -74140516)
2013,Diciembre,Mauritania,0,3,,3,POINT (4697157 -74140516)
2013,Diciembre,Mauritania,0,1,,1,POINT (6170465 -7542726)
2013,Diciembre,México,1,1,,2,POINT (-4191162 -69941498)
2013,Diciembre,México,2,0,,2,POINT (0.33002 -76876446)
2013,Diciembre,México,31,41,,72,POINT (0.81488 -77356)
2013,Diciembre,México,5,18,,23,POINT (10406342 -75527794)
2013,Diciembre,México,167,187,,354,POINT (10446304 -75516486)
2013,Diciembre,México,30,69,,99,POINT (10886686 -74776479)
2013,Diciembre,México,21,43,,64,POINT (11360029 -72129595)
2013,Diciembre,México,1,3,,4,POINT (125862 -81702165)
2013,Diciembre,México,75,210,,285,POINT (3451668 -76532004)
2013,Diciembre,México,0,1,,1,POINT (445285 -75766353)
2013,Diciembre,México,2827,4926,,7753,POINT (4697157 -74140516)
2013,Diciembre,México,5,13,,18,POINT (4815189 -75736374)
2013,Diciembre,México,123,314,,437,POINT (6170465 -7542726)
2013,Diciembre,México,0,1,,1,POINT (6185536 -67484028)
2013,Diciembre,México,4,8,,12,POINT (7128047 -73181317)
2013,Diciembre,México,16,45,,61,POINT (7819 -72453013)
2013,Diciembre,México,12,13,,25,POINT (7927233 -72508188)
2013,Diciembre,México,1,4,,5,POINT (863337 -7735002)
2013,Diciembre,República de Moldavia,1,0,,1,POINT (3451668 -76532004)
2013,Diciembre,República de Moldavia,1,0,,1,POINT (4697157 -74140516)
2013,Diciembre,Mónaco,2,1,,3,POINT (133387613 -81372937)
2013,Diciembre,Mónaco,1,1,,2,POINT (4697157 -74140516)
2013,Diciembre,Mongolia,0,1,,1,POINT (4697157 -74140516)
2013,Diciembre,Montenegro,0,1,,1,POINT (10406342 -75527794)
2013,Diciembre,Montenegro,0,1,,1,POINT (4697157 -74140516)
2013,Diciembre,Montenegro,2,3,,5,POINT (6170465 -7542726)
2013,Diciembre,Mozambique,3,1,,4,POINT (4697157 -74140516)
2013,Diciembre,Myanmar,0,29,,29,POINT (10446304 -75516486)
2013,Diciembre,Myanmar,0,10,,10,POINT (3884426 -77061029)
2013,Diciembre,Myanmar,0,14,,14,POINT (4697157 -74140516)
2013,Diciembre,Nepal,0,1,,1,POINT (10406342 -75527794)
2013,Diciembre,Nepal,0,3,,3,POINT (4697157 -74140516)
2013,Diciembre,Nicaragua,0,11,,11,POINT (10406342 -75527794)
2013,Diciembre,Nicaragua,6,7,,13,POINT (10446304 -75516486)
2013,Diciembre,Nicaragua,4,0,,4,POINT (10886686 -74776479)
2013,Diciembre,Nicaragua,2,3,,5,POINT (125862 -81702165)
2013,Diciembre,Nicaragua,1,3,,4,POINT (3451668 -76532004)
2013,Diciembre,Nicaragua,37,65,,102,POINT (4697157 -74140516)
2013,Diciembre,Nicaragua,2,0,,2,POINT (4815189 -75736374)
2013,Diciembre,Nicaragua,10,13,,23,POINT (6170465 -7542726)
2013,Diciembre,Nicaragua,0,1,,1,POINT (7819 -72453013)
2013,Diciembre,Nicaragua,0,1,,1,POINT (7927233 -72508188)
2013,Diciembre,Nigeria,1,1,,2,POINT (10446304 -75516486)
2013,Diciembre,Nigeria,0,1,,1,POINT (10886686 -74776479)
2013,Diciembre,Nigeria,0,1,,1,POINT (10970933 -74765343)
2013,Diciembre,Nigeria,3,8,,11,POINT (4697157 -74140516)
2013,Diciembre,Noruega,1,1,,2,POINT (-4191162 -69941498)
2013,Diciembre,Noruega,2,4,,6,POINT (0.81488 -77356)
2013,Diciembre,Noruega,2,2,,4,POINT (10406342 -75527794)
2013,Diciembre,Noruega,13,11,,24,POINT (10446304 -75516486)
2013,Diciembre,Noruega,0,2,,2,POINT (10886686 -74776479)
2013,Diciembre,Noruega,0,2,,2,POINT (10970933 -74765343)
2013,Diciembre,Noruega,0,1,,1,POINT (11360029 -72129595)
2013,Diciembre,Noruega,0,2,,2,POINT (125862 -81702165)
2013,Diciembre,Noruega,3,8,,11,POINT (3451668 -76532004)
2013,Diciembre,Noruega,150,206,,356,POINT (4697157 -74140516)
2013,Diciembre,Noruega,14,18,,32,POINT (6170465 -7542726)
2013,Diciembre,Noruega,0,3,,3,POINT (7128047 -73181317)
2013,Diciembre,Noruega,0,1,,1,POINT (7927233 -72508188)
2013,Diciembre,Noruega,1,3,,4,POINT (863337 -7735002)
2013,Diciembre,Nueva Zelanda,1,0,,1,POINT (-4191162 -69941498)
2013,Diciembre,Nueva Zelanda,5,6,,11,POINT (0.81488 -77356)
2013,Diciembre,Nueva Zelanda,4,5,,9,POINT (10406342 -75527794)
2013,Diciembre,Nueva Zelanda,5,9,,14,POINT (10446304 -75516486)
2013,Diciembre,Nueva Zelanda,0,1,,1,POINT (10886686 -74776479)
2013,Diciembre,Nueva Zelanda,0,1,,1,POINT (125862 -81702165)
2013,Diciembre,Nueva Zelanda,1,2,,3,POINT (3451668 -76532004)
2013,Diciembre,Nueva Zelanda,53,86,,139,POINT (4697157 -74140516)
2013,Diciembre,Nueva Zelanda,3,10,,13,POINT (6170465 -7542726)
2013,Diciembre,Nueva Zelanda,0,1,,1,POINT (7819 -72453013)
2013,Diciembre,Nueva Zelanda,3,2,,5,POINT (7927233 -72508188)
2013,Diciembre,Nueva Zelanda,0,2,,2,POINT (863337 -7735002)
2013,Diciembre,Países Bajos,3,3,,6,POINT (-4191162 -69941498)
2013,Diciembre,Países Bajos,1,0,,1,POINT (0.33002 -76876446)
2013,Diciembre,Países Bajos,17,14,,31,POINT (0.81488 -77356)
2013,Diciembre,Países Bajos,0,1,,1,POINT (1800143 -78802679)
2013,Diciembre,Países Bajos,12,7,,19,POINT (10406342 -75527794)
2013,Diciembre,Países Bajos,22,57,,79,POINT (10446304 -75516486)
2013,Diciembre,Países Bajos,11,31,,42,POINT (10886686 -74776479)
2013,Diciembre,Países Bajos,4,10,,14,POINT (11360029 -72129595)
2013,Diciembre,Países Bajos,15,38,,53,POINT (1152863 -72919186)
2013,Diciembre,Países Bajos,0,1,,1,POINT (125862 -81702165)
2013,Diciembre,Países Bajos,37,72,,109,POINT (3451668 -76532004)
2013,Diciembre,Países Bajos,690,1292,,1982,POINT (4697157 -74140516)
2013,Diciembre,Países Bajos,1,2,,3,POINT (4815189 -75736374)
2013,Diciembre,Países Bajos,206,314,,520,POINT (6170465 -7542726)
2013,Diciembre,Países Bajos,0,1,,1,POINT (7088729 -70740253)
2013,Diciembre,Países Bajos,7,13,,20,POINT (7128047 -73181317)
2013,Diciembre,Países Bajos,0,5,,5,POINT (7819 -72453013)
2013,Diciembre,Países Bajos,1,2,,3,POINT (863337 -7735002)
2013,Diciembre,Pakistán,1,8,,9,POINT (4697157 -74140516)
2013,Diciembre,Pakistán,1,3,,4,POINT (6170465 -7542726)
2013,Diciembre,Panamá,3,1,,4,POINT (0.81488 -77356)
2013,Diciembre,Panamá,1,20,,21,POINT (10406342 -75527794)
2013,Diciembre,Panamá,178,217,,395,POINT (10446304 -75516486)
2013,Diciembre,Panamá,68,131,,199,POINT (10886686 -74776479)
2013,Diciembre,Panamá,0,1,,1,POINT (10970933 -74765343)
2013,Diciembre,Panamá,0,2,,2,POINT (11247723 -74213989)
2013,Diciembre,Panamá,2,3,,5,POINT (11360029 -72129595)
2013,Diciembre,Panamá,30,32,,62,POINT (125862 -81702165)
2013,Diciembre,Panamá,173,262,,435,POINT (3451668 -76532004)
2013,Diciembre,Panamá,604,927,,1531,POINT (4697157 -74140516)
2013,Diciembre,Panamá,44,92,,136,POINT (4815189 -75736374)
2013,Diciembre,Panamá,179,309,,488,POINT (6170465 -7542726)
2013,Diciembre,Panamá,7,20,,27,POINT (7128047 -73181317)
2013,Diciembre,Panamá,1,17,,18,POINT (7819 -72453013)
2013,Diciembre,Panamá,13,26,,39,POINT (7927233 -72508188)
2013,Diciembre,Panamá,8,11,,19,POINT (863337 -7735002)
2013,Diciembre,Paraguay,1,0,,1,POINT (10406342 -75527794)
2013,Diciembre,Paraguay,21,26,,47,POINT (10446304 -75516486)
2013,Diciembre,Paraguay,2,2,,4,POINT (10886686 -74776479)
2013,Diciembre,Paraguay,1,1,,2,POINT (11360029 -72129595)
2013,Diciembre,Paraguay,9,13,,22,POINT (125862 -81702165)
2013,Diciembre,Paraguay,7,3,,10,POINT (3451668 -76532004)
2013,Diciembre,Paraguay,71,53,,124,POINT (4697157 -74140516)
2013,Diciembre,Paraguay,1,0,,1,POINT (4815189 -75736374)
2013,Diciembre,Paraguay,8,8,,16,POINT (6170465 -7542726)
2013,Diciembre,Paraguay,1,0,,1,POINT (7088729 -70740253)
2013,Diciembre,Paraguay,0,1,,1,POINT (7819 -72453013)
2013,Diciembre,Perú,59,74,,133,POINT (-4191162 -69941498)
2013,Diciembre,Perú,0,4,,4,POINT (0.33002 -76876446)
2013,Diciembre,Perú,217,417,,634,POINT (0.81488 -77356)
2013,Diciembre,Perú,24,29,,53,POINT (10406342 -75527794)
2013,Diciembre,Perú,132,107,,239,POINT (10446304 -75516486)
2013,Diciembre,Perú,9,30,,39,POINT (10886686 -74776479)
2013,Diciembre,Perú,0,2,,2,POINT (10970933 -74765343)
2013,Diciembre,Perú,43,44,,87,POINT (11360029 -72129595)
2013,Diciembre,Perú,1,0,,1,POINT (1152863 -72919186)
2013,Diciembre,Perú,88,52,,140,POINT (125862 -81702165)
2013,Diciembre,Perú,126,203,,329,POINT (3451668 -76532004)
2013,Diciembre,Perú,0,1,,1,POINT (3884426 -77061029)
2013,Diciembre,Perú,0,1,,1,POINT (445285 -75766353)
2013,Diciembre,Perú,1969,2680,,4649,POINT (4697157 -74140516)
2013,Diciembre,Perú,2,5,,7,POINT (4815189 -75736374)
2013,Diciembre,Perú,255,424,,679,POINT (6170465 -7542726)
2013,Diciembre,Perú,0,1,,1,POINT (6185536 -67484028)
2013,Diciembre,Perú,1,4,,5,POINT (7128047 -73181317)
2013,Diciembre,Perú,75,150,,225,POINT (7819 -72453013)
2013,Diciembre,Perú,2,2,,4,POINT (7927233 -72508188)
2013,Diciembre,Perú,0,2,,2,POINT (863337 -7735002)
2013,Diciembre,Palestina,0,1,,1,POINT (4697157 -74140516)
2013,Diciembre,Polonia,2,2,,4,POINT (0.81488 -77356)
2013,Diciembre,Polonia,1,6,,7,POINT (10406342 -75527794)
2013,Diciembre,Polonia,9,4,,13,POINT (10446304 -75516486)
2013,Diciembre,Polonia,0,6,,6,POINT (10970933 -74765343)
2013,Diciembre,Polonia,0,1,,1,POINT (11360029 -72129595)
2013,Diciembre,Polonia,2,0,,2,POINT (125862 -81702165)
2013,Diciembre,Polonia,1,4,,5,POINT (3451668 -76532004)
2013,Diciembre,Polonia,0,5,,5,POINT (3884426 -77061029)
2013,Diciembre,Polonia,69,127,,196,POINT (4697157 -74140516)
2013,Diciembre,Polonia,2,6,,8,POINT (6170465 -7542726)
2013,Diciembre,Polonia,0,1,,1,POINT (7128047 -73181317)
2013,Diciembre,Polonia,1,4,,5,POINT (7819 -72453013)
2013,Diciembre,Polonia,0,1,,1,POINT (806667 -767333)
2013,Diciembre,Polonia,1,1,,2,POINT (863337 -7735002)
2013,Diciembre,Portugal,0,1,,1,POINT (-4191162 -69941498)
2013,Diciembre,Portugal,0,4,,4,POINT (0.81488 -77356)
2013,Diciembre,Portugal,2,3,,5,POINT (10406342 -75527794)
2013,Diciembre,Portugal,0,14,,14,POINT (10446304 -75516486)
2013,Diciembre,Portugal,0,2,,2,POINT (10886686 -74776479)
2013,Diciembre,Portugal,2,4,,6,POINT (11360029 -72129595)
2013,Diciembre,Portugal,0,3,,3,POINT (125862 -81702165)
2013,Diciembre,Portugal,6,23,,29,POINT (3451668 -76532004)
2013,Diciembre,Portugal,112,327,,439,POINT (4697157 -74140516)
2013,Diciembre,Portugal,3,18,,21,POINT (6170465 -7542726)
2013,Diciembre,Portugal,0,3,,3,POINT (7819 -72453013)
2013,Diciembre,Portugal,1,0,,1,POINT (7927233 -72508188)
2013,Diciembre,Puerto Rico/Territorio de Estados Unidos,0,1,,1,POINT (10446304 -75516486)
2013,Diciembre,Puerto Rico/Territorio de Estados Unidos,2,0,,2,POINT (4697157 -74140516)
2013,Diciembre,Qatar,0,4,,4,POINT (4697157 -74140516)
2013,Diciembre,Reino Unido de Gran Bretaña e Irlanda del Norte,3,13,,16,POINT (-4191162 -69941498)
2013,Diciembre,Reino Unido de Gran Bretaña e Irlanda del Norte,1,0,,1,POINT (0.33002 -76876446)
2013,Diciembre,Reino Unido de Gran Bretaña e Irlanda del Norte,41,57,,98,POINT (0.81488 -77356)
2013,Diciembre,Reino Unido de Gran Bretaña e Irlanda del Norte,29,32,,61,POINT (10406342 -75527794)
2013,Diciembre,Reino Unido de Gran Bretaña e Irlanda del Norte,45,106,,151,POINT (10446304 -75516486)
2013,Diciembre,Reino Unido de Gran Bretaña e Irlanda del Norte,6,17,,23,POINT (10886686 -74776479)
2013,Diciembre,Reino Unido de Gran Bretaña e Irlanda del Norte,2,3,,5,POINT (11117206 -74232675)
2013,Diciembre,Reino Unido de Gran Bretaña e Irlanda del Norte,3,2,,5,POINT (11360029 -72129595)
2013,Diciembre,Reino Unido de Gran Bretaña e Irlanda del Norte,0,3,,3,POINT (125862 -81702165)
2013,Diciembre,Reino Unido de Gran Bretaña e Irlanda del Norte,41,91,,132,POINT (3451668 -76532004)
2013,Diciembre,Reino Unido de Gran Bretaña e Irlanda del Norte,1,1,,2,POINT (445285 -75766353)
2013,Diciembre,Reino Unido de Gran Bretaña e Irlanda del Norte,717,1562,,2279,POINT (4697157 -74140516)
2013,Diciembre,Reino Unido de Gran Bretaña e Irlanda del Norte,2,8,,10,POINT (4815189 -75736374)
2013,Diciembre,Reino Unido de Gran Bretaña e Irlanda del Norte,52,121,,173,POINT (6170465 -7542726)
2013,Diciembre,Reino Unido de Gran Bretaña e Irlanda del Norte,0,2,,2,POINT (7128047 -73181317)
2013,Diciembre,Reino Unido de Gran Bretaña e Irlanda del Norte,0,12,,12,POINT (7819 -72453013)
2013,Diciembre,Reino Unido de Gran Bretaña e Irlanda del Norte,1,5,,6,POINT (863337 -7735002)
2013,Diciembre,República Dominicana,1,10,,11,POINT (0.81488 -77356)
2013,Diciembre,República Dominicana,2,1,,3,POINT (10406342 -75527794)
2013,Diciembre,República Dominicana,14,32,,46,POINT (10446304 -75516486)
2013,Diciembre,República Dominicana,20,21,,41,POINT (10886686 -74776479)
2013,Diciembre,República Dominicana,0,4,,4,POINT (11360029 -72129595)
2013,Diciembre,República Dominicana,1,1,,2,POINT (1152863 -72919186)
2013,Diciembre,República Dominicana,0,3,,3,POINT (125862 -81702165)
2013,Diciembre,República Dominicana,18,39,,57,POINT (3451668 -76532004)
2013,Diciembre,República Dominicana,0,1,,1,POINT (445285 -75766353)
2013,Diciembre,República Dominicana,231,307,,538,POINT (4697157 -74140516)
2013,Diciembre,República Dominicana,2,0,,2,POINT (4815189 -75736374)
2013,Diciembre,República Dominicana,32,53,,85,POINT (6170465 -7542726)
2013,Diciembre,República Dominicana,2,4,,6,POINT (7128047 -73181317)
2013,Diciembre,República Dominicana,0,3,,3,POINT (7819 -72453013)
2013,Diciembre,República Dominicana,0,3,,3,POINT (7927233 -72508188)
2013,Diciembre,Rumania,0,1,,1,POINT (-4191162 -69941498)
2013,Diciembre,Rumania,1,5,,6,POINT (10406342 -75527794)
2013,Diciembre,Rumania,3,7,,10,POINT (10446304 -75516486)
2013,Diciembre,Rumania,0,1,,1,POINT (10886686 -74776479)
2013,Diciembre,Rumania,0,2,,2,POINT (11360029 -72129595)
2013,Diciembre,Rumania,4,1,,5,POINT (3451668 -76532004)
2013,Diciembre,Rumania,43,73,,116,POINT (4697157 -74140516)
2013,Diciembre,Rumania,6,4,,10,POINT (6170465 -7542726)
2013,Diciembre,Rumania,0,2,,2,POINT (7819 -72453013)
2013,Diciembre,Federación de Rusia,0,1,,1,POINT (-4191162 -69941498)
2013,Diciembre,Federación de Rusia,3,7,,10,POINT (0.81488 -77356)
2013,Diciembre,Federación de Rusia,1,10,,11,POINT (10406342 -75527794)
2013,Diciembre,Federación de Rusia,9,7,,16,POINT (10446304 -75516486)
2013,Diciembre,Federación de Rusia,0,1,,1,POINT (10886686 -74776479)
2013,Diciembre,Federación de Rusia,0,1,,1,POINT (10970933 -74765343)
2013,Diciembre,Federación de Rusia,2,7,,9,POINT (11360029 -72129595)
2013,Diciembre,Federación de Rusia,2,1,,3,POINT (125862 -81702165)
2013,Diciembre,Federación de Rusia,9,4,,13,POINT (3451668 -76532004)
2013,Diciembre,Federación de Rusia,0,2,,2,POINT (3884426 -77061029)
2013,Diciembre,Federación de Rusia,131,162,,293,POINT (4697157 -74140516)
2013,Diciembre,Federación de Rusia,5,4,,9,POINT (6170465 -7542726)
2013,Diciembre,Federación de Rusia,5,6,,11,POINT (7819 -72453013)
2013,Diciembre,Federación de Rusia,0,1,,1,POINT (863337 -7735002)
2013,Diciembre,Rwanda,0,1,,1,POINT (4697157 -74140516)
2013,Diciembre,San Cristóbal y Nevis,1,1,,2,POINT (4697157 -74140516)
2013,Diciembre,Santa Lucia,0,1,,1,POINT (10406342 -75527794)
2013,Diciembre,Santa Lucia,3,7,,10,POINT (4697157 -74140516)
2013,Diciembre,Santa Sede/Ciudad del Vaticano,0,1,,1,POINT (4697157 -74140516)
2013,Diciembre,Senegal,0,2,,2,POINT (4697157 -74140516)
2013,Diciembre,Serbia,0,1,,1,POINT (10446304 -75516486)
2013,Diciembre,Serbia,10,3,,13,POINT (4697157 -74140516)
2013,Diciembre,Serbia,1,1,,2,POINT (6170465 -7542726)
2013,Diciembre,Singapur,0,1,,1,POINT (-4191162 -69941498)
2013,Diciembre,Singapur,1,0,,1,POINT (0.81488 -77356)
2013,Diciembre,Singapur,0,1,,1,POINT (10406342 -75527794)
2013,Diciembre,Singapur,1,1,,2,POINT (10446304 -75516486)
2013,Diciembre,Singapur,13,28,,41,POINT (4697157 -74140516)
2013,Diciembre,Singapur,0,1,,1,POINT (6170465 -7542726)
2013,Diciembre,República Árabe Siria,1,1,,2,POINT (3451668 -76532004)
2013,Diciembre,República Árabe Siria,0,1,,1,POINT (4697157 -74140516)
2013,Diciembre,República Árabe Siria,0,1,,1,POINT (6170465 -7542726)
2013,Diciembre,Somalia,1,0,,1,POINT (4697157 -74140516)
2013,Diciembre,Sri Lanka,1,0,,1,POINT (3451668 -76532004)
2013,Diciembre,Sri Lanka,0,5,,5,POINT (4697157 -74140516)
2013,Diciembre,Sudáfrica,1,0,,1,POINT (0.81488 -77356)
2013,Diciembre,Sudáfrica,2,3,,5,POINT (10406342 -75527794)
2013,Diciembre,Sudáfrica,0,1,,1,POINT (10446304 -75516486)
2013,Diciembre,Sudáfrica,1,1,,2,POINT (10886686 -74776479)
2013,Diciembre,Sudáfrica,1,1,,2,POINT (10970933 -74765343)
2013,Diciembre,Sudáfrica,1,3,,4,POINT (3451668 -76532004)
2013,Diciembre,Sudáfrica,35,44,,79,POINT (4697157 -74140516)
2013,Diciembre,Sudáfrica,1,6,,7,POINT (6170465 -7542726)
2013,Diciembre,Sudán,0,2,,2,POINT (4697157 -74140516)
2013,Diciembre,Suecia,3,2,,5,POINT (-4191162 -69941498)
2013,Diciembre,Suecia,5,15,,20,POINT (0.81488 -77356)
2013,Diciembre,Suecia,7,9,,16,POINT (10406342 -75527794)
2013,Diciembre,Suecia,19,20,,39,POINT (10446304 -75516486)
2013,Diciembre,Suecia,4,9,,13,POINT (10886686 -74776479)
2013,Diciembre,Suecia,1,1,,2,POINT (11247723 -74213989)
2013,Diciembre,Suecia,1,1,,2,POINT (11360029 -72129595)
2013,Diciembre,Suecia,0,1,,1,POINT (1152863 -72919186)
2013,Diciembre,Suecia,29,46,,75,POINT (3451668 -76532004)
2013,Diciembre,Suecia,300,460,,760,POINT (4697157 -74140516)
2013,Diciembre,Suecia,0,3,,3,POINT (4815189 -75736374)
2013,Diciembre,Suecia,17,38,,55,POINT (6170465 -7542726)
2013,Diciembre,Suecia,1,3,,4,POINT (7128047 -73181317)
2013,Diciembre,Suecia,1,2,,3,POINT (7819 -72453013)
2013,Diciembre,Suecia,1,0,,1,POINT (863337 -7735002)
2013,Diciembre,Suiza,7,5,,12,POINT (-4191162 -69941498)
2013,Diciembre,Suiza,1,0,,1,POINT (0.33002 -76876446)
2013,Diciembre,Suiza,18,21,,39,POINT (0.81488 -77356)
2013,Diciembre,Suiza,0,1,,1,POINT (1800143 -78802679)
2013,Diciembre,Suiza,9,9,,18,POINT (10406342 -75527794)
2013,Diciembre,Suiza,13,25,,38,POINT (10446304 -75516486)
2013,Diciembre,Suiza,5,10,,15,POINT (10886686 -74776479)
2013,Diciembre,Suiza,1,3,,4,POINT (11360029 -72129595)
2013,Diciembre,Suiza,0,1,,1,POINT (133387613 -81372937)
2013,Diciembre,Suiza,15,50,,65,POINT (3451668 -76532004)
2013,Diciembre,Suiza,419,762,,1181,POINT (4697157 -74140516)
2013,Diciembre,Suiza,0,3,,3,POINT (4815189 -75736374)
2013,Diciembre,Suiza,29,65,,94,POINT (6170465 -7542726)
2013,Diciembre,Suiza,1,3,,4,POINT (7819 -72453013)
2013,Diciembre,Suiza,1,0,,1,POINT (7927233 -72508188)
2013,Diciembre,Suiza,3,2,,5,POINT (863337 -7735002)
2013,Diciembre,Surinam,0,1,,1,POINT (3451668 -76532004)
2013,Diciembre,Surinam,20,25,,45,POINT (4697157 -74140516)
2013,Diciembre,Surinam,23,16,,39,POINT (6170465 -7542726)
2013,Diciembre,Surinam,0,1,,1,POINT (7819 -72453013)
2013,Diciembre,Taiwán,0,1,,1,POINT (-4191162 -69941498)
2013,Diciembre,Taiwán,2,4,,6,POINT (0.81488 -77356)
2013,Diciembre,Taiwán,1,2,,3,POINT (10446304 -75516486)
2013,Diciembre,Taiwán,3,6,,9,POINT (3451668 -76532004)
2013,Diciembre,Taiwán,41,41,,82,POINT (4697157 -74140516)
2013,Diciembre,Taiwán,1,0,,1,POINT (4815189 -75736374)
2013,Diciembre,Taiwán,2,7,,9,POINT (6170465 -7542726)
2013,Diciembre,Taiwán,0,1,,1,POINT (7128047 -73181317)
2013,Diciembre,Taiwán,1,0,,1,POINT (7819 -72453013)
2013,Diciembre,Tailandia,1,0,,1,POINT (0.81488 -77356)
2013,Diciembre,Tailandia,1,0,,1,POINT (10446304 -75516486)
2013,Diciembre,Tailandia,1,0,,1,POINT (11247723 -74213989)
2013,Diciembre,Tailandia,4,5,,9,POINT (4697157 -74140516)
2013,Diciembre,Tanzania,3,0,,3,POINT (4697157 -74140516)
2013,Diciembre,Tonga,0,5,,5,POINT (4697157 -74140516)
2013,Diciembre,Trinidad y Tobago,0,1,,1,POINT (-4191162 -69941498)
2013,Diciembre,Trinidad y Tobago,6,8,,14,POINT (10446304 -75516486)
2013,Diciembre,Trinidad y Tobago,1,1,,2,POINT (10886686 -74776479)
2013,Diciembre,Trinidad y Tobago,0,1,,1,POINT (125862 -81702165)
2013,Diciembre,Trinidad y Tobago,1,8,,9,POINT (3451668 -76532004)
2013,Diciembre,Trinidad y Tobago,19,43,,62,POINT (4697157 -74140516)
2013,Diciembre,Trinidad y Tobago,1,1,,2,POINT (4815189 -75736374)
2013,Diciembre,Trinidad y Tobago,4,13,,17,POINT (6170465 -7542726)
2013,Diciembre,Trinidad y Tobago,0,3,,3,POINT (7128047 -73181317)
2013,Diciembre,Trinidad y Tobago,1,0,,1,POINT (7819 -72453013)
2013,Diciembre,Trinidad y Tobago,0,3,,3,POINT (7927233 -72508188)
2013,Diciembre,Túnez,0,2,,2,POINT (3451668 -76532004)
2013,Diciembre,Turquía,1,0,,1,POINT (0.81488 -77356)
2013,Diciembre,Turquía,0,2,,2,POINT (10406342 -75527794)
2013,Diciembre,Turquía,0,1,,1,POINT (10446304 -75516486)
2013,Diciembre,Turquía,0,1,,1,POINT (10886686 -74776479)
2013,Diciembre,Turquía,0,1,,1,POINT (10970933 -74765343)
2013,Diciembre,Turquía,0,3,,3,POINT (11247723 -74213989)
2013,Diciembre,Turquía,0,1,,1,POINT (11360029 -72129595)
2013,Diciembre,Turquía,1,1,,2,POINT (125862 -81702165)
2013,Diciembre,Turquía,1,3,,4,POINT (3451668 -76532004)
2013,Diciembre,Turquía,21,62,,83,POINT (4697157 -74140516)
2013,Diciembre,Turquía,0,1,,1,POINT (4815189 -75736374)
2013,Diciembre,Turquía,0,2,,2,POINT (6170465 -7542726)
2013,Diciembre,Turquía,0,1,,1,POINT (7819 -72453013)
2013,Diciembre,Tuvalu,0,4,,4,POINT (10406342 -75527794)
2013,Diciembre,Turkmenistán,1,0,,1,POINT (4697157 -74140516)
2013,Diciembre,Ucrania,0,1,,1,POINT (0.81488 -77356)
2013,Diciembre,Ucrania,1,4,,5,POINT (10406342 -75527794)
2013,Diciembre,Ucrania,1,7,,8,POINT (10446304 -75516486)
2013,Diciembre,Ucrania,0,1,,1,POINT (10970933 -74765343)
2013,Diciembre,Ucrania,0,5,,5,POINT (3884426 -77061029)
2013,Diciembre,Ucrania,17,28,,45,POINT (4697157 -74140516)
2013,Diciembre,Ucrania,2,0,,2,POINT (6170465 -7542726)
2013,Diciembre,Uganda,0,1,,1,POINT (10446304 -75516486)
2013,Diciembre,Uganda,0,1,,1,POINT (10886686 -74776479)
2013,Diciembre,Uganda,4,6,,10,POINT (4697157 -74140516)
2013,Diciembre,Federación de Rusia,0,1,,1,POINT (10970933 -74765343)
2013,Diciembre,Federación de Rusia,0,1,,1,POINT (11247723 -74213989)
2013,Diciembre,Uruguay,4,10,,14,POINT (0.81488 -77356)
2013,Diciembre,Uruguay,2,1,,3,POINT (10406342 -75527794)
2013,Diciembre,Uruguay,53,45,,98,POINT (10446304 -75516486)
2013,Diciembre,Uruguay,20,20,,40,POINT (125862 -81702165)
2013,Diciembre,Uruguay,7,22,,29,POINT (3451668 -76532004)
2013,Diciembre,Uruguay,0,1,,1,POINT (445285 -75766353)
2013,Diciembre,Uruguay,111,234,,345,POINT (4697157 -74140516)
2013,Diciembre,Uruguay,24,42,,66,POINT (6170465 -7542726)
2013,Diciembre,Uruguay,0,2,,2,POINT (7128047 -73181317)
2013,Diciembre,Uruguay,1,4,,5,POINT (7819 -72453013)
2013,Diciembre,Uruguay,0,2,,2,POINT (7927233 -72508188)
2013,Diciembre,Uzbekistán,1,1,,2,POINT (4697157 -74140516)
2013,Diciembre,Venezuela,0,1,,1,POINT (0.33002 -76876446)
2013,Diciembre,Venezuela,149,218,,367,POINT (0.81488 -77356)
2013,Diciembre,Venezuela,13,30,,43,POINT (10406342 -75527794)
2013,Diciembre,Venezuela,139,168,,307,POINT (10446304 -75516486)
2013,Diciembre,Venezuela,67,115,,182,POINT (10886686 -74776479)
2013,Diciembre,Venezuela,2996,4237,,7233,POINT (11360029 -72129595)
2013,Diciembre,Venezuela,7,6,,13,POINT (1152863 -72919186)
2013,Diciembre,Venezuela,4,4,,8,POINT (125862 -81702165)
2013,Diciembre,Venezuela,118,130,,248,POINT (3451668 -76532004)
2013,Diciembre,Venezuela,0,1,,1,POINT (3884426 -77061029)
2013,Diciembre,Venezuela,0,3,,3,POINT (445285 -75766353)
2013,Diciembre,Venezuela,6548,7145,,13693,POINT (4697157 -74140516)
2013,Diciembre,Venezuela,12,13,,25,POINT (4815189 -75736374)
2013,Diciembre,Venezuela,834,784,,1618,POINT (6170465 -7542726)
2013,Diciembre,Venezuela,48,105,,153,POINT (6185536 -67484028)
2013,Diciembre,Venezuela,165,271,,436,POINT (7088729 -70740253)
2013,Diciembre,Venezuela,8,11,,19,POINT (7128047 -73181317)
2013,Diciembre,Venezuela,2803,3371,,6174,POINT (7819 -72453013)
2013,Diciembre,Venezuela,454,552,,1006,POINT (7927233 -72508188)
2013,Diciembre,Venezuela,0,1,,1,POINT (863337 -7735002)
2013,Diciembre,Vietnam,2,1,,3,POINT (4697157 -74140516)
2013,Diciembre,República Árabe de Yemen,0,1,,1,POINT (4697157 -74140516)
2013,Diciembre,Zambia,0,1,,1,POINT (10446304 -75516486)
2013,Diciembre,Zambia,0,1,,1,POINT (4697157 -74140516)
2013,Diciembre,Zimbabue,1,1,,2,POINT (3451668 -76532004)
2013,Diciembre,Anguila/Territorio Británico de Ultramar,0,1,,1,POINT (4697157 -74140516)
2013,Diciembre,Reino Unido de Gran Bretaña e Irlanda del Norte,0,4,,4,POINT (10970933 -74765343)
2013,Diciembre,Países Bajos,0,2,,2,POINT (10406342 -75527794)
2013,Diciembre,Países Bajos,2,1,,3,POINT (10446304 -75516486)
2013,Diciembre,Países Bajos,0,1,,1,POINT (10886686 -74776479)
2013,Diciembre,Países Bajos,1,7,,8,POINT (11247723 -74213989)
2013,Diciembre,Países Bajos,2,6,,8,POINT (3451668 -76532004)
2013,Diciembre,Países Bajos,12,33,,45,POINT (4697157 -74140516)
2013,Diciembre,Lituania,0,1,,1,POINT (10970933 -74765343)
2013,Diciembre,Reino Unido de Gran Bretaña e Irlanda del Norte,4,4,,8,POINT (11247723 -74213989)
2013,Diciembre,Desconocido,0,2,,2,POINT (0.81488 -77356)
2013,Diciembre,Desconocido,0,2,,2,POINT (10446304 -75516486)
2013,Diciembre,Desconocido,1,3,,4,POINT (3451668 -76532004)
2013,Diciembre,Desconocido,28,73,,101,POINT (4697157 -74140516)
2013,Diciembre,Desconocido,1,5,,6,POINT (6170465 -7542726)
2013,Diciembre,Desconocido,1,0,,1,POINT (7088729 -70740253)
2013,Diciembre,Desconocido,0,1,,1,POINT (7128047 -73181317)
2013,Diciembre,Desconocido,0,1,,1,POINT (7819 -72453013)
2013,Diciembre,República CentroÁfricana,0,1,,1,POINT (3451668 -76532004)
2014,Enero,Afganistán,1,2,,3,POINT (4697157 -74140516)
2014,Enero,Afganistán,0,1,,1,POINT (6170465 -7542726)
2014,Enero,Alemania,4,5,,9,POINT (10446304 -75516486)
2014,Enero,Alemania,5,1,,6,POINT (10886686 -74776479)
2014,Enero,Alemania,13,14,,27,POINT (3451668 -76532004)
2014,Enero,Alemania,1411,2306,,3717,POINT (4697157 -74140516)
2014,Enero,Alemania,4,16,,20,POINT (6170465 -7542726)
2014,Enero,Angola,0,1,,1,POINT (3451668 -76532004)
2014,Enero,Países Bajos,12,8,,20,POINT (10406342 -75527794)
2014,Enero,Países Bajos,2,9,,11,POINT (10446304 -75516486)
2014,Enero,Países Bajos,2,3,,5,POINT (10886686 -74776479)
2014,Enero,Países Bajos,0,1,,1,POINT (125862 -81702165)
2014,Enero,Países Bajos,10,32,,42,POINT (3451668 -76532004)
2014,Enero,Países Bajos,37,81,,118,POINT (4697157 -74140516)
2014,Enero,Países Bajos,1,3,,4,POINT (4815189 -75736374)
2014,Enero,Países Bajos,34,66,,100,POINT (6170465 -7542726)
2014,Enero,Países Bajos,0,1,,1,POINT (7128047 -73181317)
2014,Enero,Arabia Saudita,0,1,,1,POINT (4697157 -74140516)
2014,Enero,Argelia,1,0,,1,POINT (125862 -81702165)
2014,Enero,Argelia,2,1,,3,POINT (4697157 -74140516)
2014,Enero,Argelia,1,0,,1,POINT (6170465 -7542726)
2014,Enero,Argentina,12,13,,25,POINT (0.81488 -77356)
2014,Enero,Argentina,143,96,,239,POINT (10446304 -75516486)
2014,Enero,Argentina,13,15,,28,POINT (10886686 -74776479)
2014,Enero,Argentina,70,41,,111,POINT (125862 -81702165)
2014,Enero,Argentina,73,90,,163,POINT (3451668 -76532004)
2014,Enero,Argentina,3231,3239,,6470,POINT (4697157 -74140516)
2014,Enero,Argentina,0,1,,1,POINT (4815189 -75736374)
2014,Enero,Argentina,178,201,,379,POINT (6170465 -7542726)
2014,Enero,Argentina,1,2,,3,POINT (7128047 -73181317)
2014,Enero,Aruba,62,67,,129,POINT (10406342 -75527794)
2014,Enero,Aruba,0,4,,4,POINT (10886686 -74776479)
2014,Enero,Aruba,0,2,,2,POINT (10970933 -74765343)
2014,Enero,Aruba,2,2,,4,POINT (11247723 -74213989)
2014,Enero,Aruba,16,11,,27,POINT (1152863 -72919186)
2014,Enero,Aruba,6,8,,14,POINT (3451668 -76532004)
2014,Enero,Aruba,459,590,,1049,POINT (4697157 -74140516)
2014,Enero,Aruba,10,17,,27,POINT (6170465 -7542726)
2014,Enero,Aruba,2,2,,4,POINT (7128047 -73181317)
2014,Enero,Australia,3,3,,6,POINT (10446304 -75516486)
2014,Enero,Australia,1,3,,4,POINT (10886686 -74776479)
2014,Enero,Australia,2,5,,7,POINT (3451668 -76532004)
2014,Enero,Australia,20,30,,50,POINT (4697157 -74140516)
2014,Enero,Australia,3,0,,3,POINT (4815189 -75736374)
2014,Enero,Australia,4,9,,13,POINT (6170465 -7542726)
2014,Enero,Australia,1,1,,2,POINT (7128047 -73181317)
2014,Enero,Austria,0,1,,1,POINT (10886686 -74776479)
2014,Enero,Austria,0,2,,2,POINT (3451668 -76532004)
2014,Enero,Austria,15,39,,54,POINT (4697157 -74140516)
2014,Enero,Austria,0,1,,1,POINT (6170465 -7542726)
2014,Enero,Azerbaiyán,0,1,,1,POINT (4697157 -74140516)
2014,Enero,Bahamas,0,3,,3,POINT (10406342 -75527794)
2014,Enero,Bahamas,9,12,,21,POINT (10446304 -75516486)
2014,Enero,Bahamas,0,2,,2,POINT (10886686 -74776479)
2014,Enero,Bahamas,0,2,,2,POINT (4697157 -74140516)
2014,Enero,Bahamas,1,0,,1,POINT (4815189 -75736374)
2014,Enero,Bahamas,2,1,,3,POINT (6170465 -7542726)
2014,Enero,Bahréin,0,1,,1,POINT (4697157 -74140516)
2014,Enero,Barbados,0,1,,1,POINT (3451668 -76532004)
2014,Enero,Barbados,1,1,,2,POINT (4697157 -74140516)
2014,Enero,Barbados,0,1,,1,POINT (6170465 -7542726)
2014,Enero,Barbados,0,1,,1,POINT (7128047 -73181317)
2014,Enero,República de Belarús,1,1,,2,POINT (4697157 -74140516)
2014,Enero,República de Belarús,0,1,,1,POINT (7819 -72453013)
2014,Enero,Bélgica,0,2,,2,POINT (10446304 -75516486)
2014,Enero,Bélgica,1,2,,3,POINT (10886686 -74776479)
2014,Enero,Bélgica,0,9,,9,POINT (3451668 -76532004)
2014,Enero,Bélgica,26,49,,75,POINT (4697157 -74140516)
2014,Enero,Bélgica,4,2,,6,POINT (6170465 -7542726)
2014,Enero,Bermudas/Territorio Británico de Ultramar,0,1,,1,POINT (11247723 -74213989)
2014,Enero,Bermudas/Territorio Británico de Ultramar,0,2,,2,POINT (4697157 -74140516)
2014,Enero,Bolivia,0,1,,1,POINT (0.81488 -77356)
2014,Enero,Bolivia,9,11,,20,POINT (10446304 -75516486)
2014,Enero,Bolivia,3,0,,3,POINT (10886686 -74776479)
2014,Enero,Bolivia,6,3,,9,POINT (125862 -81702165)
2014,Enero,Bolivia,8,13,,21,POINT (3451668 -76532004)
2014,Enero,Bolivia,417,494,,911,POINT (4697157 -74140516)
2014,Enero,Bolivia,16,21,,37,POINT (6170465 -7542726)
2014,Enero,Brasil,119,178,,297,POINT (-4191162 -69941498)
2014,Enero,Brasil,2,4,,6,POINT (0.81488 -77356)
2014,Enero,Brasil,0,3,,3,POINT (10406342 -75527794)
2014,Enero,Brasil,68,55,,123,POINT (10446304 -75516486)
2014,Enero,Brasil,5,16,,21,POINT (10886686 -74776479)
2014,Enero,Brasil,6,7,,13,POINT (125862 -81702165)
2014,Enero,Brasil,74,91,,165,POINT (3451668 -76532004)
2014,Enero,Brasil,3247,4436,,7683,POINT (4697157 -74140516)
2014,Enero,Brasil,1,2,,3,POINT (4815189 -75736374)
2014,Enero,Brasil,61,91,,152,POINT (6170465 -7542726)
2014,Enero,Brasil,1,4,,5,POINT (7128047 -73181317)
2014,Enero,Brunei Darussalam,2,0,,2,POINT (4697157 -74140516)
2014,Enero,Bulgaria,4,1,,5,POINT (4697157 -74140516)
2014,Enero,Burkina Faso,1,0,,1,POINT (3451668 -76532004)
2014,Enero,Cabo Verde,0,9,,9,POINT (4697157 -74140516)
2014,Enero,Islas Caimán/Territorio Británico de Ultramar,3,5,,8,POINT (10406342 -75527794)
2014,Enero,Islas Caimán/Territorio Británico de Ultramar,0,1,,1,POINT (10446304 -75516486)
2014,Enero,Islas Caimán/Territorio Británico de Ultramar,1,0,,1,POINT (10886686 -74776479)
2014,Enero,Islas Caimán/Territorio Británico de Ultramar,2,1,,3,POINT (125862 -81702165)
2014,Enero,Islas Caimán/Territorio Británico de Ultramar,1,5,,6,POINT (4697157 -74140516)
2014,Enero,Canadá,784,750,,1534,POINT (10446304 -75516486)
2014,Enero,Canadá,6,9,,15,POINT (10886686 -74776479)
2014,Enero,Canadá,471,461,,932,POINT (125862 -81702165)
2014,Enero,Canadá,14,36,,50,POINT (3451668 -76532004)
2014,Enero,Canadá,0,1,,1,POINT (445285 -75766353)
2014,Enero,Canadá,530,898,,1428,POINT (4697157 -74140516)
2014,Enero,Canadá,2,7,,9,POINT (4815189 -75736374)
2014,Enero,Canadá,21,53,,74,POINT (6170465 -7542726)
2014,Enero,Canadá,0,1,,1,POINT (7927233 -72508188)
2014,Enero,Chad,0,2,,2,POINT (4697157 -74140516)
2014,Enero,España,0,2,,2,POINT (10406342 -75527794)
2014,Enero,España,5,4,,9,POINT (10446304 -75516486)
2014,Enero,España,1,1,,2,POINT (10886686 -74776479)
2014,Enero,España,215,401,,616,POINT (3451668 -76532004)
2014,Enero,España,2964,6129,,9093,POINT (4697157 -74140516)
2014,Enero,España,0,2,,2,POINT (4815189 -75736374)
2014,Enero,España,139,382,,521,POINT (6170465 -7542726)
2014,Enero,España,0,1,,1,POINT (7128047 -73181317)
2014,Enero,República de Corea,18,17,,35,POINT (4697157 -74140516)
2014,Enero,Costa de Marfil,1,0,,1,POINT (10446304 -75516486)
2014,Enero,Costa de Marfil,3,1,,4,POINT (4697157 -74140516)
2014,Enero,Costa de Marfil,0,2,,2,POINT (6170465 -7542726)
2014,Enero,Costa Rica,59,57,,116,POINT (10406342 -75527794)
2014,Enero,Costa Rica,16,17,,33,POINT (10446304 -75516486)
2014,Enero,Costa Rica,14,14,,28,POINT (10886686 -74776479)
2014,Enero,Costa Rica,0,2,,2,POINT (10970933 -74765343)
2014,Enero,Costa Rica,642,474,,1116,POINT (125862 -81702165)
2014,Enero,Costa Rica,7,24,,31,POINT (3451668 -76532004)
2014,Enero,Costa Rica,595,874,,1469,POINT (4697157 -74140516)
2014,Enero,Costa Rica,4,3,,7,POINT (4815189 -75736374)
2014,Enero,Costa Rica,37,65,,102,POINT (6170465 -7542726)
2014,Enero,Costa Rica,2,3,,5,POINT (7927233 -72508188)
2014,Enero,Croacia,0,1,,1,POINT (3451668 -76532004)
2014,Enero,Croacia,0,6,,6,POINT (4697157 -74140516)
2014,Enero,Cuba,113,103,,216,POINT (10446304 -75516486)
2014,Enero,Cuba,7,10,,17,POINT (10886686 -74776479)
2014,Enero,Cuba,15,17,,32,POINT (3451668 -76532004)
2014,Enero,Cuba,192,281,,473,POINT (4697157 -74140516)
2014,Enero,Cuba,3,5,,8,POINT (4815189 -75736374)
2014,Enero,Cuba,15,16,,31,POINT (6170465 -7542726)
2014,Enero,Cuba,2,1,,3,POINT (7128047 -73181317)
2014,Enero,Cuba,1,2,,3,POINT (7927233 -72508188)
2014,Enero,Curazao,1,2,,3,POINT (10406342 -75527794)
2014,Enero,Curazao,1,12,,13,POINT (10446304 -75516486)
2014,Enero,Curazao,0,4,,4,POINT (10886686 -74776479)
2014,Enero,Curazao,1,1,,2,POINT (3451668 -76532004)
2014,Enero,Curazao,154,227,,381,POINT (4697157 -74140516)
2014,Enero,Curazao,131,179,,310,POINT (6170465 -7542726)
2014,Enero,República Checa,5,7,,12,POINT (4697157 -74140516)
2014,Enero,Chile,0,7,,7,POINT (0.81488 -77356)
2014,Enero,Chile,20,24,,44,POINT (10446304 -75516486)
2014,Enero,Chile,3,18,,21,POINT (10886686 -74776479)
2014,Enero,Chile,23,19,,42,POINT (125862 -81702165)
2014,Enero,Chile,68,96,,164,POINT (3451668 -76532004)
2014,Enero,Chile,3381,3693,,7074,POINT (4697157 -74140516)
2014,Enero,Chile,86,109,,195,POINT (6170465 -7542726)
2014,Enero,China,1,0,,1,POINT (10446304 -75516486)
2014,Enero,China,0,3,,3,POINT (3451668 -76532004)
2014,Enero,China,20,50,,70,POINT (4697157 -74140516)
2014,Enero,China,1,2,,3,POINT (6170465 -7542726)
2014,Enero,Chipre,0,1,,1,POINT (6170465 -7542726)
2014,Enero,Dinamarca,1,1,,2,POINT (10446304 -75516486)
2014,Enero,Dinamarca,0,4,,4,POINT (3451668 -76532004)
2014,Enero,Dinamarca,11,18,,29,POINT (4697157 -74140516)
2014,Enero,Dinamarca,0,2,,2,POINT (6170465 -7542726)
2014,Enero,Ecuador,32,100,,132,POINT (0.33002 -76876446)
2014,Enero,Ecuador,2624,4073,,6697,POINT (0.81488 -77356)
2014,Enero,Ecuador,10,12,,22,POINT (1800143 -78802679)
2014,Enero,Ecuador,0,7,,7,POINT (10446304 -75516486)
2014,Enero,Ecuador,1,2,,3,POINT (10886686 -74776479)
2014,Enero,Ecuador,2,1,,3,POINT (125862 -81702165)
2014,Enero,Ecuador,367,448,,815,POINT (3451668 -76532004)
2014,Enero,Ecuador,2101,3587,,5688,POINT (4697157 -74140516)
2014,Enero,Ecuador,2,1,,3,POINT (4815189 -75736374)
2014,Enero,Ecuador,440,603,,1043,POINT (6170465 -7542726)
2014,Enero,Ecuador,2,2,,4,POINT (7927233 -72508188)
2014,Enero,Egipto,3,2,,5,POINT (4697157 -74140516)
2014,Enero,El Salvador,1,3,,4,POINT (10446304 -75516486)
2014,Enero,El Salvador,1,2,,3,POINT (10886686 -74776479)
2014,Enero,El Salvador,82,132,,214,POINT (3451668 -76532004)
2014,Enero,El Salvador,710,1173,,1883,POINT (4697157 -74140516)
2014,Enero,El Salvador,1,0,,1,POINT (4815189 -75736374)
2014,Enero,El Salvador,93,188,,281,POINT (6170465 -7542726)
2014,Enero,El Salvador,0,1,,1,POINT (7128047 -73181317)
2014,Enero,El Salvador,1,0,,1,POINT (7927233 -72508188)
2014,Enero,Emiratos Árabes,1,5,,6,POINT (4697157 -74140516)
2014,Enero,Eslovaquia,4,2,,6,POINT (4697157 -74140516)
2014,Enero,Eslovenia,0,5,,5,POINT (4697157 -74140516)
2014,Enero,Estados Unidos de América,4,15,,19,POINT (10406342 -75527794)
2014,Enero,Estados Unidos de América,1208,2102,,3310,POINT (10446304 -75516486)
2014,Enero,Estados Unidos de América,204,379,,583,POINT (10886686 -74776479)
2014,Enero,Estados Unidos de América,0,10,,10,POINT (10970933 -74765343)
2014,Enero,Estados Unidos de América,3,3,,6,POINT (125862 -81702165)
2014,Enero,Estados Unidos de América,562,939,,1501,POINT (3451668 -76532004)
2014,Enero,Estados Unidos de América,64,110,,174,POINT (445285 -75766353)
2014,Enero,Estados Unidos de América,6635,12485,,19120,POINT (4697157 -74140516)
2014,Enero,Estados Unidos de América,46,100,,146,POINT (4815189 -75736374)
2014,Enero,Estados Unidos de América,1149,2797,,3946,POINT (6170465 -7542726)
2014,Enero,Estados Unidos de América,4,13,,17,POINT (7128047 -73181317)
2014,Enero,Estados Unidos de América,14,22,,36,POINT (7927233 -72508188)
2014,Enero,Estonia,0,3,,3,POINT (6170465 -7542726)
2014,Enero,Filipinas,0,1,,1,POINT (10446304 -75516486)
2014,Enero,Filipinas,0,1,,1,POINT (3451668 -76532004)
2014,Enero,Filipinas,1,8,,9,POINT (4697157 -74140516)
2014,Enero,Finlandia,0,1,,1,POINT (10886686 -74776479)
2014,Enero,Finlandia,1,4,,5,POINT (3451668 -76532004)
2014,Enero,Finlandia,4,6,,10,POINT (4697157 -74140516)
2014,Enero,Finlandia,0,1,,1,POINT (6170465 -7542726)
2014,Enero,Francia,3,2,,5,POINT (10446304 -75516486)
2014,Enero,Francia,1,0,,1,POINT (10886686 -74776479)
2014,Enero,Francia,21,22,,43,POINT (3451668 -76532004)
2014,Enero,Francia,1226,2148,,3374,POINT (4697157 -74140516)
2014,Enero,Francia,7,25,,32,POINT (6170465 -7542726)
2014,Enero,Francia,0,1,,1,POINT (7927233 -72508188)
2014,Enero,Georgia,1,1,,2,POINT (4697157 -74140516)
2014,Enero,Grecia,1,1,,2,POINT (3451668 -76532004)
2014,Enero,Grecia,1,5,,6,POINT (4697157 -74140516)
2014,Enero,Guatemala,4,2,,6,POINT (10446304 -75516486)
2014,Enero,Guatemala,1,6,,7,POINT (10886686 -74776479)
2014,Enero,Guatemala,12,28,,40,POINT (3451668 -76532004)
2014,Enero,Guatemala,151,337,,488,POINT (4697157 -74140516)
2014,Enero,Guatemala,1,3,,4,POINT (4815189 -75736374)
2014,Enero,Guatemala,22,55,,77,POINT (6170465 -7542726)
2014,Enero,Guatemala,1,3,,4,POINT (7927233 -72508188)
2014,Enero,Guyana,0,5,,5,POINT (4697157 -74140516)
2014,Enero,Guyana,2,0,,2,POINT (6170465 -7542726)
2014,Enero,Guinea,1,0,,1,POINT (0.81488 -77356)
2014,Enero,Guinea Ecuatorial,0,1,,1,POINT (4697157 -74140516)
2014,Enero,Guadalupe/Territorio Francés,0,1,,1,POINT (3451668 -76532004)
2014,Enero,Guayana Francesa/Departamento de Ultramar Francés,1,3,,4,POINT (4697157 -74140516)
2014,Enero,Haití,0,19,,19,POINT (4697157 -74140516)
2014,Enero,Haití,1,1,,2,POINT (6170465 -7542726)
2014,Enero,Honduras,1,2,,3,POINT (10446304 -75516486)
2014,Enero,Honduras,3,8,,11,POINT (10886686 -74776479)
2014,Enero,Honduras,1,5,,6,POINT (125862 -81702165)
2014,Enero,Honduras,13,18,,31,POINT (133387613 -81372937)
2014,Enero,Honduras,6,12,,18,POINT (3451668 -76532004)
2014,Enero,Honduras,39,49,,88,POINT (4697157 -74140516)
2014,Enero,Honduras,1,1,,2,POINT (4815189 -75736374)
2014,Enero,Honduras,11,31,,42,POINT (6170465 -7542726)
2014,Enero,Honduras,1,0,,1,POINT (7128047 -73181317)
2014,Enero,Honduras,2,1,,3,POINT (7927233 -72508188)
2014,Enero,Hong Kong,0,1,,1,POINT (10446304 -75516486)
2014,Enero,Hong Kong,2,2,,4,POINT (4697157 -74140516)
2014,Enero,Hungría,0,2,,2,POINT (10446304 -75516486)
2014,Enero,Hungría,2,2,,4,POINT (4697157 -74140516)
2014,Enero,India,1,1,,2,POINT (10886686 -74776479)
2014,Enero,India,0,2,,2,POINT (3451668 -76532004)
2014,Enero,India,6,26,,32,POINT (4697157 -74140516)
2014,Enero,India,2,6,,8,POINT (6170465 -7542726)
2014,Enero,Indonesia,0,1,,1,POINT (10446304 -75516486)
2014,Enero,Indonesia,0,1,,1,POINT (10886686 -74776479)
2014,Enero,Iraq,0,1,,1,POINT (4697157 -74140516)
2014,Enero,República de Irlanda,1,1,,2,POINT (10446304 -75516486)
2014,Enero,República de Irlanda,2,10,,12,POINT (4697157 -74140516)
2014,Enero,República de Irlanda,0,1,,1,POINT (6170465 -7542726)
2014,Enero,Islandia,0,3,,3,POINT (4697157 -74140516)
2014,Enero,Israel,0,3,,3,POINT (10446304 -75516486)
2014,Enero,Israel,1,4,,5,POINT (3451668 -76532004)
2014,Enero,Israel,12,58,,70,POINT (4697157 -74140516)
2014,Enero,Israel,2,2,,4,POINT (6170465 -7542726)
2014,Enero,Islas Aland/Provincia de Finlandia,0,1,,1,POINT (4697157 -74140516)
2014,Enero,Italia,5,11,,16,POINT (10446304 -75516486)
2014,Enero,Italia,1,0,,1,POINT (10886686 -74776479)
2014,Enero,Italia,9,39,,48,POINT (3451668 -76532004)
2014,Enero,Italia,106,319,,425,POINT (4697157 -74140516)
2014,Enero,Italia,6,20,,26,POINT (6170465 -7542726)
2014,Enero,Jamaica,0,2,,2,POINT (10406342 -75527794)
2014,Enero,Jamaica,1,1,,2,POINT (10446304 -75516486)
2014,Enero,Jamaica,0,1,,1,POINT (10886686 -74776479)
2014,Enero,Jamaica,1,1,,2,POINT (3451668 -76532004)
2014,Enero,Jamaica,2,6,,8,POINT (4697157 -74140516)
2014,Enero,Jamaica,0,1,,1,POINT (4815189 -75736374)
2014,Enero,Jamaica,1,0,,1,POINT (6170465 -7542726)
2014,Enero,Japón,0,1,,1,POINT (10446304 -75516486)
2014,Enero,Japón,0,2,,2,POINT (10886686 -74776479)
2014,Enero,Japón,1,2,,3,POINT (3451668 -76532004)
2014,Enero,Japón,11,26,,37,POINT (4697157 -74140516)
2014,Enero,Japón,0,5,,5,POINT (6170465 -7542726)
2014,Enero,Jordania,0,1,,1,POINT (4697157 -74140516)
2014,Enero,Kazajistán,0,1,,1,POINT (10886686 -74776479)
2014,Enero,Letonia,1,3,,4,POINT (4697157 -74140516)
2014,Enero,Líbano,1,2,,3,POINT (4697157 -74140516)
2014,Enero,Luxemburgo,0,1,,1,POINT (6170465 -7542726)
2014,Enero,Malasia,0,1,,1,POINT (4697157 -74140516)
2014,Enero,Malasia,0,1,,1,POINT (6170465 -7542726)
2014,Enero,Malta,1,2,,3,POINT (4697157 -74140516)
2014,Enero,Marruecos,0,2,,2,POINT (4697157 -74140516)
2014,Enero,Martinica/Departamento de Ultramar Francés,1,0,,1,POINT (4697157 -74140516)
2014,Enero,México,1,30,,31,POINT (10406342 -75527794)
2014,Enero,México,33,69,,102,POINT (10446304 -75516486)
2014,Enero,México,4,16,,20,POINT (10886686 -74776479)
2014,Enero,México,32,80,,112,POINT (3451668 -76532004)
2014,Enero,México,2802,5198,,8000,POINT (4697157 -74140516)
2014,Enero,México,3,6,,9,POINT (4815189 -75736374)
2014,Enero,México,64,215,,279,POINT (6170465 -7542726)
2014,Enero,México,1,2,,3,POINT (7128047 -73181317)
2014,Enero,México,15,10,,25,POINT (7927233 -72508188)
2014,Enero,República de Moldavia,0,1,,1,POINT (4697157 -74140516)
2014,Enero,Mónaco,1,0,,1,POINT (4697157 -74140516)
2014,Enero,Montenegro,0,1,,1,POINT (10886686 -74776479)
2014,Enero,Nicaragua,2,3,,5,POINT (10446304 -75516486)
2014,Enero,Nicaragua,3,1,,4,POINT (10886686 -74776479)
2014,Enero,Nicaragua,3,2,,5,POINT (3451668 -76532004)
2014,Enero,Nicaragua,10,31,,41,POINT (4697157 -74140516)
2014,Enero,Nicaragua,0,1,,1,POINT (4815189 -75736374)
2014,Enero,Nicaragua,4,9,,13,POINT (6170465 -7542726)
2014,Enero,Nicaragua,0,1,,1,POINT (7927233 -72508188)
2014,Enero,Nigeria,0,3,,3,POINT (4697157 -74140516)
2014,Enero,Nigeria,0,1,,1,POINT (6170465 -7542726)
2014,Enero,Noruega,2,3,,5,POINT (10446304 -75516486)
2014,Enero,Noruega,1,0,,1,POINT (10886686 -74776479)
2014,Enero,Noruega,7,4,,11,POINT (3451668 -76532004)
2014,Enero,Noruega,13,19,,32,POINT (4697157 -74140516)
2014,Enero,Noruega,0,1,,1,POINT (4815189 -75736374)
2014,Enero,Noruega,1,2,,3,POINT (6170465 -7542726)
2014,Enero,Nueva Zelanda,0,1,,1,POINT (10886686 -74776479)
2014,Enero,Nueva Zelanda,0,1,,1,POINT (3451668 -76532004)
2014,Enero,Nueva Zelanda,1,1,,2,POINT (4697157 -74140516)
2014,Enero,Nueva Zelanda,2,0,,2,POINT (6170465 -7542726)
2014,Enero,Omán,0,1,,1,POINT (4697157 -74140516)
2014,Enero,Papúa Nueva Guinea,0,1,,1,POINT (4697157 -74140516)
2014,Enero,Panamá,540,726,,1266,POINT (10406342 -75527794)
2014,Enero,Panamá,1902,2251,,4153,POINT (10446304 -75516486)
2014,Enero,Panamá,187,345,,532,POINT (10886686 -74776479)
2014,Enero,Panamá,0,14,,14,POINT (10970933 -74765343)
2014,Enero,Panamá,610,512,,1122,POINT (125862 -81702165)
2014,Enero,Panamá,7,15,,22,POINT (133387613 -81372937)
2014,Enero,Panamá,313,467,,780,POINT (3451668 -76532004)
2014,Enero,Panamá,0,5,,5,POINT (3884426 -77061029)
2014,Enero,Panamá,2356,3686,,6042,POINT (4697157 -74140516)
2014,Enero,Panamá,53,116,,169,POINT (4815189 -75736374)
2014,Enero,Panamá,538,1108,,1646,POINT (6170465 -7542726)
2014,Enero,Panamá,4,0,,4,POINT (6222552 -77401154)
2014,Enero,Panamá,5,9,,14,POINT (7102626 -77762647)
2014,Enero,Panamá,36,58,,94,POINT (7128047 -73181317)
2014,Enero,Panamá,97,132,,229,POINT (7927233 -72508188)
2014,Enero,Panamá,98,159,,257,POINT (863337 -7735002)
2014,Enero,Paraguay,1,0,,1,POINT (0.81488 -77356)
2014,Enero,Paraguay,2,0,,2,POINT (10446304 -75516486)
2014,Enero,Paraguay,3,8,,11,POINT (10886686 -74776479)
2014,Enero,Paraguay,8,4,,12,POINT (125862 -81702165)
2014,Enero,Paraguay,4,6,,10,POINT (3451668 -76532004)
2014,Enero,Paraguay,22,21,,43,POINT (4697157 -74140516)
2014,Enero,Paraguay,5,5,,10,POINT (6170465 -7542726)
2014,Enero,Paraguay,0,1,,1,POINT (7128047 -73181317)
2014,Enero,Paraguay,1,0,,1,POINT (7927233 -72508188)
2014,Enero,Perú,155,201,,356,POINT (-4191162 -69941498)
2014,Enero,Perú,17,34,,51,POINT (0.81488 -77356)
2014,Enero,Perú,42,24,,66,POINT (10446304 -75516486)
2014,Enero,Perú,14,29,,43,POINT (10886686 -74776479)
2014,Enero,Perú,42,32,,74,POINT (125862 -81702165)
2014,Enero,Perú,320,408,,728,POINT (3451668 -76532004)
2014,Enero,Perú,4089,5255,,9344,POINT (4697157 -74140516)
2014,Enero,Perú,3,6,,9,POINT (4815189 -75736374)
2014,Enero,Perú,442,638,,1080,POINT (6170465 -7542726)
2014,Enero,Perú,2,2,,4,POINT (7128047 -73181317)
2014,Enero,Perú,2,17,,19,POINT (7927233 -72508188)
2014,Enero,Polonia,0,2,,2,POINT (3451668 -76532004)
2014,Enero,Polonia,28,23,,51,POINT (4697157 -74140516)
2014,Enero,Portugal,1,2,,3,POINT (3451668 -76532004)
2014,Enero,Portugal,19,56,,75,POINT (4697157 -74140516)
2014,Enero,Portugal,0,10,,10,POINT (6170465 -7542726)
2014,Enero,Puerto Rico/Territorio de Estados Unidos,2,17,,19,POINT (10446304 -75516486)
2014,Enero,Puerto Rico/Territorio de Estados Unidos,4,19,,23,POINT (10886686 -74776479)
2014,Enero,Puerto Rico/Territorio de Estados Unidos,19,89,,108,POINT (3451668 -76532004)
2014,Enero,Puerto Rico/Territorio de Estados Unidos,142,196,,338,POINT (4697157 -74140516)
2014,Enero,Puerto Rico/Territorio de Estados Unidos,6,20,,26,POINT (4815189 -75736374)
2014,Enero,Puerto Rico/Territorio de Estados Unidos,20,36,,56,POINT (6170465 -7542726)
2014,Enero,Puerto Rico/Territorio de Estados Unidos,1,1,,2,POINT (7128047 -73181317)
2014,Enero,Puerto Rico/Territorio de Estados Unidos,1,1,,2,POINT (7927233 -72508188)
2014,Enero,Qatar,0,1,,1,POINT (6170465 -7542726)
2014,Enero,Reino Unido de Gran Bretaña e Irlanda del Norte,7,9,,16,POINT (10446304 -75516486)
2014,Enero,Reino Unido de Gran Bretaña e Irlanda del Norte,0,1,,1,POINT (10886686 -74776479)
2014,Enero,Reino Unido de Gran Bretaña e Irlanda del Norte,5,16,,21,POINT (3451668 -76532004)
2014,Enero,Reino Unido de Gran Bretaña e Irlanda del Norte,97,180,,277,POINT (4697157 -74140516)
2014,Enero,Reino Unido de Gran Bretaña e Irlanda del Norte,10,22,,32,POINT (6170465 -7542726)
2014,Enero,Federación de Rusia,1,1,,2,POINT (10886686 -74776479)
2014,Enero,Federación de Rusia,62,91,,153,POINT (4697157 -74140516)
2014,Enero,Federación de Rusia,0,2,,2,POINT (6170465 -7542726)
2014,Enero,República Dominicana,5,15,,20,POINT (10446304 -75516486)
2014,Enero,República Dominicana,9,33,,42,POINT (10886686 -74776479)
2014,Enero,República Dominicana,0,2,,2,POINT (10970933 -74765343)
2014,Enero,República Dominicana,0,16,,16,POINT (11117206 -74232675)
2014,Enero,República Dominicana,0,4,,4,POINT (125862 -81702165)
2014,Enero,República Dominicana,17,20,,37,POINT (3451668 -76532004)
2014,Enero,República Dominicana,322,510,,832,POINT (4697157 -74140516)
2014,Enero,República Dominicana,2,8,,10,POINT (4815189 -75736374)
2014,Enero,República Dominicana,15,56,,71,POINT (6170465 -7542726)
2014,Enero,República Dominicana,0,1,,1,POINT (7128047 -73181317)
2014,Enero,Rumania,4,5,,9,POINT (4697157 -74140516)
2014,Enero,Rwanda,0,1,,1,POINT (4697157 -74140516)
2014,Enero,San  Vicente y las Granadinas,0,1,,1,POINT (10446304 -75516486)
2014,Enero,Senegal,1,0,,1,POINT (4697157 -74140516)
2014,Enero,Singapur,2,4,,6,POINT (4697157 -74140516)
2014,Enero,Sudáfrica,1,6,,7,POINT (4697157 -74140516)
2014,Enero,Sudáfrica,1,2,,3,POINT (6170465 -7542726)
2014,Enero,Suecia,3,1,,4,POINT (10446304 -75516486)
2014,Enero,Suecia,1,0,,1,POINT (10886686 -74776479)
2014,Enero,Suecia,2,2,,4,POINT (3451668 -76532004)
2014,Enero,Suecia,33,53,,86,POINT (4697157 -74140516)
2014,Enero,Suecia,4,0,,4,POINT (6170465 -7542726)
2014,Enero,Suiza,2,3,,5,POINT (10446304 -75516486)
2014,Enero,Suiza,1,0,,1,POINT (10886686 -74776479)
2014,Enero,Suiza,12,14,,26,POINT (3451668 -76532004)
2014,Enero,Suiza,58,91,,149,POINT (4697157 -74140516)
2014,Enero,Suiza,7,12,,19,POINT (6170465 -7542726)
2014,Enero,Surinam,1,3,,4,POINT (4697157 -74140516)
2014,Enero,Surinam,0,6,,6,POINT (4815189 -75736374)
2014,Enero,Surinam,3,3,,6,POINT (6170465 -7542726)
2014,Enero,Taiwán,0,1,,1,POINT (10446304 -75516486)
2014,Enero,Taiwán,1,0,,1,POINT (3451668 -76532004)
2014,Enero,Taiwán,2,3,,5,POINT (4697157 -74140516)
2014,Enero,Tailandia,0,1,,1,POINT (4697157 -74140516)
2014,Enero,Togo,0,1,,1,POINT (4697157 -74140516)
2014,Enero,Trinidad y Tobago,2,0,,2,POINT (10446304 -75516486)
2014,Enero,Trinidad y Tobago,3,4,,7,POINT (3451668 -76532004)
2014,Enero,Trinidad y Tobago,4,9,,13,POINT (4697157 -74140516)
2014,Enero,Trinidad y Tobago,1,2,,3,POINT (6170465 -7542726)
2014,Enero,Trinidad y Tobago,1,1,,2,POINT (7927233 -72508188)
2014,Enero,Turquía,0,3,,3,POINT (10886686 -74776479)
2014,Enero,Turquía,0,1,,1,POINT (3451668 -76532004)
2014,Enero,Turquía,2,9,,11,POINT (4697157 -74140516)
2014,Enero,Turquía,2,4,,6,POINT (6170465 -7542726)
2014,Enero,Ucrania,0,1,,1,POINT (3451668 -76532004)
2014,Enero,Ucrania,1,4,,5,POINT (4697157 -74140516)
2014,Enero,Uruguay,5,10,,15,POINT (10446304 -75516486)
2014,Enero,Uruguay,2,1,,3,POINT (10886686 -74776479)
2014,Enero,Uruguay,9,6,,15,POINT (125862 -81702165)
2014,Enero,Uruguay,10,18,,28,POINT (3451668 -76532004)
2014,Enero,Uruguay,42,64,,106,POINT (4697157 -74140516)
2014,Enero,Uruguay,17,27,,44,POINT (6170465 -7542726)
2014,Enero,Venezuela,2,11,,13,POINT (10406342 -75527794)
2014,Enero,Venezuela,22,48,,70,POINT (10446304 -75516486)
2014,Enero,Venezuela,29,67,,96,POINT (10886686 -74776479)
2014,Enero,Venezuela,0,3,,3,POINT (11117206 -74232675)
2014,Enero,Venezuela,1689,2919,,4608,POINT (11360029 -72129595)
2014,Enero,Venezuela,40,48,,88,POINT (3451668 -76532004)
2014,Enero,Venezuela,4501,5321,,9822,POINT (4697157 -74140516)
2014,Enero,Venezuela,3,18,,21,POINT (4815189 -75736374)
2014,Enero,Venezuela,365,440,,805,POINT (6170465 -7542726)
2014,Enero,Venezuela,45,75,,120,POINT (6185536 -67484028)
2014,Enero,Venezuela,79,183,,262,POINT (7088729 -70740253)
2014,Enero,Venezuela,0,2,,2,POINT (7128047 -73181317)
2014,Enero,Venezuela,2849,3141,,5990,POINT (7819 -72453013)
2014,Enero,Venezuela,140,181,,321,POINT (7927233 -72508188)
2014,Enero,Desconocido,28,27,,55,POINT (10406342 -75527794)
2014,Enero,Desconocido,0,7,,7,POINT (4697157 -74140516)
2014,Enero,Desconocido,1,0,,1,POINT (6170465 -7542726)
2014,Enero,Desconocido,0,5,,5,POINT (7128047 -73181317)
2014,Enero,Desconocido,1,2,,3,POINT (863337 -7735002)
2014,Enero,Desconocido,0,12,,12,POINT (9402597 -75681642)
2014,Febrero,Desconocido,0,11,,11,POINT (125744111 -81703935)
2014,Febrero,Desconocido,1,1,,2,POINT (6185536 -67484028)
2014,Febrero,Desconocido,1,2,,3,POINT (7128047 -73181317)
2014,Febrero,Desconocido,0,7,,7,POINT (9402597 -75681642)
2014,Febrero,Afganistán,0,1,,1,POINT (10406342 -75527794)
2014,Febrero,Afganistán,1,1,,2,POINT (4697157 -74140516)
2014,Febrero,Albania,1,0,,1,POINT (4697157 -74140516)
2014,Febrero,Alemania,0,3,,3,POINT (10446304 -75516486)
2014,Febrero,Alemania,4,5,,9,POINT (10886686 -74776479)
2014,Febrero,Alemania,7,17,,24,POINT (3451668 -76532004)
2014,Febrero,Alemania,1467,2334,,3801,POINT (4697157 -74140516)
2014,Febrero,Alemania,5,16,,21,POINT (6170465 -7542726)
2014,Febrero,Andorra,0,1,,1,POINT (4697157 -74140516)
2014,Febrero,Antigua y Barbuda,0,3,,3,POINT (10406342 -75527794)
2014,Febrero,Antigua y Barbuda,0,6,,6,POINT (4697157 -74140516)
2014,Febrero,Países Bajos,11,4,,15,POINT (10406342 -75527794)
2014,Febrero,Países Bajos,0,7,,7,POINT (10446304 -75516486)
2014,Febrero,Países Bajos,1,2,,3,POINT (10886686 -74776479)
2014,Febrero,Países Bajos,8,22,,30,POINT (3451668 -76532004)
2014,Febrero,Países Bajos,30,84,,114,POINT (4697157 -74140516)
2014,Febrero,Países Bajos,2,0,,2,POINT (4815189 -75736374)
2014,Febrero,Países Bajos,33,44,,77,POINT (6170465 -7542726)
2014,Febrero,Países Bajos,6,1,,7,POINT (7128047 -73181317)
2014,Febrero,Argelia,1,0,,1,POINT (4697157 -74140516)
2014,Febrero,Argentina,7,10,,17,POINT (0.81488 -77356)
2014,Febrero,Argentina,198,138,,336,POINT (10446304 -75516486)
2014,Febrero,Argentina,13,18,,31,POINT (10886686 -74776479)
2014,Febrero,Argentina,60,50,,110,POINT (125862 -81702165)
2014,Febrero,Argentina,42,46,,88,POINT (3451668 -76532004)
2014,Febrero,Argentina,2244,2728,,4972,POINT (4697157 -74140516)
2014,Febrero,Argentina,0,1,,1,POINT (4815189 -75736374)
2014,Febrero,Argentina,65,95,,160,POINT (6170465 -7542726)
2014,Febrero,República de Armenia,0,1,,1,POINT (4697157 -74140516)
2014,Febrero,Aruba,103,74,,177,POINT (10406342 -75527794)
2014,Febrero,Aruba,2,3,,5,POINT (10446304 -75516486)
2014,Febrero,Aruba,1,1,,2,POINT (10886686 -74776479)
2014,Febrero,Aruba,11,13,,24,POINT (1152863 -72919186)
2014,Febrero,Aruba,1,6,,7,POINT (3451668 -76532004)
2014,Febrero,Aruba,348,450,,798,POINT (4697157 -74140516)
2014,Febrero,Aruba,7,3,,10,POINT (6170465 -7542726)
2014,Febrero,Aruba,6,6,,12,POINT (7128047 -73181317)
2014,Febrero,Australia,1,2,,3,POINT (10446304 -75516486)
2014,Febrero,Australia,1,1,,2,POINT (10886686 -74776479)
2014,Febrero,Australia,5,7,,12,POINT (3451668 -76532004)
2014,Febrero,Australia,12,21,,33,POINT (4697157 -74140516)
2014,Febrero,Australia,8,16,,24,POINT (6170465 -7542726)
2014,Febrero,Austria,0,1,,1,POINT (10446304 -75516486)
2014,Febrero,Austria,1,1,,2,POINT (3451668 -76532004)
2014,Febrero,Austria,18,28,,46,POINT (4697157 -74140516)
2014,Febrero,Austria,1,1,,2,POINT (6170465 -7542726)
2014,Febrero,Bahamas,0,3,,3,POINT (10446304 -75516486)
2014,Febrero,Bahamas,0,2,,2,POINT (10886686 -74776479)
2014,Febrero,Bahamas,0,5,,5,POINT (4697157 -74140516)
2014,Febrero,Bahréin,0,1,,1,POINT (4697157 -74140516)
2014,Febrero,República de Belarús,1,0,,1,POINT (4697157 -74140516)
2014,Febrero,Bélgica,1,2,,3,POINT (10886686 -74776479)
2014,Febrero,Bélgica,0,11,,11,POINT (3451668 -76532004)
2014,Febrero,Bélgica,26,49,,75,POINT (4697157 -74140516)
2014,Febrero,Bélgica,1,8,,9,POINT (6170465 -7542726)
2014,Febrero,Belice,0,5,,5,POINT (4697157 -74140516)
2014,Febrero,Bolivia,1,4,,5,POINT (0.81488 -77356)
2014,Febrero,Bolivia,1,6,,7,POINT (10446304 -75516486)
2014,Febrero,Bolivia,2,0,,2,POINT (10886686 -74776479)
2014,Febrero,Bolivia,5,1,,6,POINT (125862 -81702165)
2014,Febrero,Bolivia,2,7,,9,POINT (3451668 -76532004)
2014,Febrero,Bolivia,203,317,,520,POINT (4697157 -74140516)
2014,Febrero,Bolivia,0,1,,1,POINT (4815189 -75736374)
2014,Febrero,Bolivia,11,19,,30,POINT (6170465 -7542726)
2014,Febrero,Bolivia,0,1,,1,POINT (7128047 -73181317)
2014,Febrero,Brasil,129,149,,278,POINT (-4191162 -69941498)
2014,Febrero,Brasil,0,1,,1,POINT (0.81488 -77356)
2014,Febrero,Brasil,0,2,,2,POINT (10406342 -75527794)
2014,Febrero,Brasil,141,96,,237,POINT (10446304 -75516486)
2014,Febrero,Brasil,9,11,,20,POINT (10886686 -74776479)
2014,Febrero,Brasil,23,15,,38,POINT (125862 -81702165)
2014,Febrero,Brasil,26,69,,95,POINT (3451668 -76532004)
2014,Febrero,Brasil,2724,4317,,7041,POINT (4697157 -74140516)
2014,Febrero,Brasil,43,66,,109,POINT (6170465 -7542726)
2014,Febrero,Brasil,2,0,,2,POINT (7128047 -73181317)
2014,Febrero,Brunei Darussalam,0,1,,1,POINT (4697157 -74140516)
2014,Febrero,Bulgaria,1,1,,2,POINT (4697157 -74140516)
2014,Febrero,Islas Caimán/Territorio Británico de Ultramar,2,2,,4,POINT (10406342 -75527794)
2014,Febrero,Islas Caimán/Territorio Británico de Ultramar,0,8,,8,POINT (10446304 -75516486)
2014,Febrero,Islas Caimán/Territorio Británico de Ultramar,0,2,,2,POINT (4697157 -74140516)
2014,Febrero,Canadá,725,705,,1430,POINT (10446304 -75516486)
2014,Febrero,Canadá,6,10,,16,POINT (10886686 -74776479)
2014,Febrero,Canadá,387,352,,739,POINT (125862 -81702165)
2014,Febrero,Canadá,15,26,,41,POINT (3451668 -76532004)
2014,Febrero,Canadá,0,3,,3,POINT (3884426 -77061029)
2014,Febrero,Canadá,501,847,,1348,POINT (4697157 -74140516)
2014,Febrero,Canadá,0,3,,3,POINT (4815189 -75736374)
2014,Febrero,Canadá,24,72,,96,POINT (6170465 -7542726)
2014,Febrero,Canadá,0,3,,3,POINT (7128047 -73181317)
2014,Febrero,España,2,6,,8,POINT (10406342 -75527794)
2014,Febrero,España,3,6,,9,POINT (10446304 -75516486)
2014,Febrero,España,2,3,,5,POINT (10886686 -74776479)
2014,Febrero,España,0,1,,1,POINT (125862 -81702165)
2014,Febrero,España,209,362,,571,POINT (3451668 -76532004)
2014,Febrero,España,2511,5392,,7903,POINT (4697157 -74140516)
2014,Febrero,España,1,1,,2,POINT (4815189 -75736374)
2014,Febrero,España,117,292,,409,POINT (6170465 -7542726)
2014,Febrero,España,1,0,,1,POINT (7128047 -73181317)
2014,Febrero,República Democrática del Congo,0,1,,1,POINT (4697157 -74140516)
2014,Febrero,República de Corea,1,1,,2,POINT (3451668 -76532004)
2014,Febrero,República de Corea,8,15,,23,POINT (4697157 -74140516)
2014,Febrero,República de Corea,0,3,,3,POINT (6170465 -7542726)
2014,Febrero,Costa de Marfil,0,4,,4,POINT (4697157 -74140516)
2014,Febrero,Costa de Marfil,1,0,,1,POINT (7927233 -72508188)
2014,Febrero,Costa Rica,37,39,,76,POINT (10406342 -75527794)
2014,Febrero,Costa Rica,15,17,,32,POINT (10446304 -75516486)
2014,Febrero,Costa Rica,5,13,,18,POINT (10886686 -74776479)
2014,Febrero,Costa Rica,173,154,,327,POINT (125862 -81702165)
2014,Febrero,Costa Rica,15,20,,35,POINT (3451668 -76532004)
2014,Febrero,Costa Rica,613,966,,1579,POINT (4697157 -74140516)
2014,Febrero,Costa Rica,3,2,,5,POINT (4815189 -75736374)
2014,Febrero,Costa Rica,24,98,,122,POINT (6170465 -7542726)
2014,Febrero,Costa Rica,0,2,,2,POINT (7927233 -72508188)
2014,Febrero,Croacia,1,13,,14,POINT (10406342 -75527794)
2014,Febrero,Croacia,2,5,,7,POINT (4697157 -74140516)
2014,Febrero,Cuba,3,8,,11,POINT (10446304 -75516486)
2014,Febrero,Cuba,1,5,,6,POINT (10886686 -74776479)
2014,Febrero,Cuba,3,16,,19,POINT (3451668 -76532004)
2014,Febrero,Cuba,137,246,,383,POINT (4697157 -74140516)
2014,Febrero,Cuba,0,2,,2,POINT (4815189 -75736374)
2014,Febrero,Cuba,10,15,,25,POINT (6170465 -7542726)
2014,Febrero,Cuba,1,1,,2,POINT (7128047 -73181317)
2014,Febrero,Cuba,0,1,,1,POINT (7927233 -72508188)
2014,Febrero,Curazao,2,7,,9,POINT (10406342 -75527794)
2014,Febrero,Curazao,0,1,,1,POINT (10886686 -74776479)
2014,Febrero,Curazao,192,263,,455,POINT (4697157 -74140516)
2014,Febrero,Curazao,159,186,,345,POINT (6170465 -7542726)
2014,Febrero,República Checa,1,1,,2,POINT (10446304 -75516486)
2014,Febrero,República Checa,10,9,,19,POINT (4697157 -74140516)
2014,Febrero,Chile,2,3,,5,POINT (0.81488 -77356)
2014,Febrero,Chile,33,50,,83,POINT (10446304 -75516486)
2014,Febrero,Chile,2,2,,4,POINT (10886686 -74776479)
2014,Febrero,Chile,37,23,,60,POINT (125862 -81702165)
2014,Febrero,Chile,47,71,,118,POINT (3451668 -76532004)
2014,Febrero,Chile,3837,4187,,8024,POINT (4697157 -74140516)
2014,Febrero,Chile,92,133,,225,POINT (6170465 -7542726)
2014,Febrero,China,0,1,,1,POINT (10446304 -75516486)
2014,Febrero,China,1,4,,5,POINT (3451668 -76532004)
2014,Febrero,China,30,65,,95,POINT (4697157 -74140516)
2014,Febrero,China,1,2,,3,POINT (6170465 -7542726)
2014,Febrero,Chipre,0,1,,1,POINT (4697157 -74140516)
2014,Febrero,Dinamarca,1,4,,5,POINT (10446304 -75516486)
2014,Febrero,Dinamarca,2,11,,13,POINT (3451668 -76532004)
2014,Febrero,Dinamarca,12,22,,34,POINT (4697157 -74140516)
2014,Febrero,Dinamarca,1,2,,3,POINT (6170465 -7542726)
2014,Febrero,Dominica,0,1,,1,POINT (4697157 -74140516)
2014,Febrero,Ecuador,34,83,,117,POINT (0.33002 -76876446)
2014,Febrero,Ecuador,2420,3262,,5682,POINT (0.81488 -77356)
2014,Febrero,Ecuador,3,24,,27,POINT (1800143 -78802679)
2014,Febrero,Ecuador,0,1,,1,POINT (10406342 -75527794)
2014,Febrero,Ecuador,6,18,,24,POINT (10446304 -75516486)
2014,Febrero,Ecuador,10,15,,25,POINT (10886686 -74776479)
2014,Febrero,Ecuador,8,4,,12,POINT (125862 -81702165)
2014,Febrero,Ecuador,506,544,,1050,POINT (3451668 -76532004)
2014,Febrero,Ecuador,0,1,,1,POINT (3884426 -77061029)
2014,Febrero,Ecuador,1934,3575,,5509,POINT (4697157 -74140516)
2014,Febrero,Ecuador,0,1,,1,POINT (4815189 -75736374)
2014,Febrero,Ecuador,399,534,,933,POINT (6170465 -7542726)
2014,Febrero,Egipto,0,3,,3,POINT (4697157 -74140516)
2014,Febrero,Egipto,1,0,,1,POINT (6170465 -7542726)
2014,Febrero,El Salvador,0,1,,1,POINT (10446304 -75516486)
2014,Febrero,El Salvador,0,1,,1,POINT (10886686 -74776479)
2014,Febrero,El Salvador,62,53,,115,POINT (125862 -81702165)
2014,Febrero,El Salvador,59,135,,194,POINT (3451668 -76532004)
2014,Febrero,El Salvador,702,1269,,1971,POINT (4697157 -74140516)
2014,Febrero,El Salvador,0,1,,1,POINT (4815189 -75736374)
2014,Febrero,El Salvador,81,184,,265,POINT (6170465 -7542726)
2014,Febrero,Emiratos Árabes,1,1,,2,POINT (4697157 -74140516)
2014,Febrero,Eslovaquia,1,1,,2,POINT (3451668 -76532004)
2014,Febrero,Eslovaquia,2,3,,5,POINT (4697157 -74140516)
2014,Febrero,Eslovenia,0,1,,1,POINT (3451668 -76532004)
2014,Febrero,Eslovenia,1,2,,3,POINT (4697157 -74140516)
2014,Febrero,Estados Unidos de América,6,33,,39,POINT (10406342 -75527794)
2014,Febrero,Estados Unidos de América,1582,2286,,3868,POINT (10446304 -75516486)
2014,Febrero,Estados Unidos de América,307,556,,863,POINT (10886686 -74776479)
2014,Febrero,Estados Unidos de América,0,1,,1,POINT (125744111 -81703935)
2014,Febrero,Estados Unidos de América,2,6,,8,POINT (125862 -81702165)
2014,Febrero,Estados Unidos de América,666,1108,,1774,POINT (3451668 -76532004)
2014,Febrero,Estados Unidos de América,0,1,,1,POINT (3884426 -77061029)
2014,Febrero,Estados Unidos de América,71,128,,199,POINT (445285 -75766353)
2014,Febrero,Estados Unidos de América,7281,14173,,21454,POINT (4697157 -74140516)
2014,Febrero,Estados Unidos de América,36,47,,83,POINT (4815189 -75736374)
2014,Febrero,Estados Unidos de América,1183,2963,,4146,POINT (6170465 -7542726)
2014,Febrero,Estados Unidos de América,7,17,,24,POINT (7128047 -73181317)
2014,Febrero,Estados Unidos de América,0,7,,7,POINT (7927233 -72508188)
2014,Febrero,Estonia,2,0,,2,POINT (4697157 -74140516)
2014,Febrero,Filipinas,1,2,,3,POINT (10446304 -75516486)
2014,Febrero,Filipinas,0,4,,4,POINT (10886686 -74776479)
2014,Febrero,Filipinas,0,5,,5,POINT (3451668 -76532004)
2014,Febrero,Filipinas,2,15,,17,POINT (4697157 -74140516)
2014,Febrero,Finlandia,1,0,,1,POINT (3451668 -76532004)
2014,Febrero,Finlandia,4,13,,17,POINT (4697157 -74140516)
2014,Febrero,Francia,0,1,,1,POINT (10406342 -75527794)
2014,Febrero,Francia,5,7,,12,POINT (10446304 -75516486)
2014,Febrero,Francia,2,2,,4,POINT (10886686 -74776479)
2014,Febrero,Francia,12,26,,38,POINT (3451668 -76532004)
2014,Febrero,Francia,1130,2220,,3350,POINT (4697157 -74140516)
2014,Febrero,Francia,5,15,,20,POINT (6170465 -7542726)
2014,Febrero,Georgia,0,1,,1,POINT (4697157 -74140516)
2014,Febrero,Ghana,0,1,,1,POINT (4697157 -74140516)
2014,Febrero,Granada,0,1,,1,POINT (4697157 -74140516)
2014,Febrero,Grecia,1,0,,1,POINT (10446304 -75516486)
2014,Febrero,Grecia,1,0,,1,POINT (3451668 -76532004)
2014,Febrero,Grecia,2,7,,9,POINT (4697157 -74140516)
2014,Febrero,Grecia,1,3,,4,POINT (6170465 -7542726)
2014,Febrero,Guatemala,4,10,,14,POINT (10446304 -75516486)
2014,Febrero,Guatemala,1,1,,2,POINT (10886686 -74776479)
2014,Febrero,Guatemala,9,16,,25,POINT (3451668 -76532004)
2014,Febrero,Guatemala,139,303,,442,POINT (4697157 -74140516)
2014,Febrero,Guatemala,1,1,,2,POINT (4815189 -75736374)
2014,Febrero,Guatemala,15,47,,62,POINT (6170465 -7542726)
2014,Febrero,Guatemala,0,1,,1,POINT (7128047 -73181317)
2014,Febrero,Guyana,0,1,,1,POINT (10406342 -75527794)
2014,Febrero,Guyana,0,1,,1,POINT (4697157 -74140516)
2014,Febrero,Guadalupe/Territorio Francés,0,1,,1,POINT (10886686 -74776479)
2014,Febrero,Guadalupe/Territorio Francés,1,4,,5,POINT (4697157 -74140516)
2014,Febrero,Guayana Francesa/Departamento de Ultramar Francés,2,0,,2,POINT (4697157 -74140516)
2014,Febrero,Haití,0,4,,4,POINT (10406342 -75527794)
2014,Febrero,Haití,0,1,,1,POINT (10446304 -75516486)
2014,Febrero,Haití,3,15,,18,POINT (4697157 -74140516)
2014,Febrero,Haití,1,2,,3,POINT (6170465 -7542726)
2014,Febrero,Honduras,0,1,,1,POINT (10446304 -75516486)
2014,Febrero,Honduras,5,3,,8,POINT (10886686 -74776479)
2014,Febrero,Honduras,0,5,,5,POINT (125862 -81702165)
2014,Febrero,Honduras,6,2,,8,POINT (3451668 -76532004)
2014,Febrero,Honduras,17,31,,48,POINT (4697157 -74140516)
2014,Febrero,Honduras,2,2,,4,POINT (4815189 -75736374)
2014,Febrero,Honduras,20,15,,35,POINT (6170465 -7542726)
2014,Febrero,Honduras,0,1,,1,POINT (7128047 -73181317)
2014,Febrero,Hong Kong,2,5,,7,POINT (4697157 -74140516)
2014,Febrero,Hungría,0,5,,5,POINT (4697157 -74140516)
2014,Febrero,India,7,21,,28,POINT (4697157 -74140516)
2014,Febrero,India,0,3,,3,POINT (6170465 -7542726)
2014,Febrero,Indonesia,0,2,,2,POINT (10446304 -75516486)
2014,Febrero,Indonesia,0,1,,1,POINT (10886686 -74776479)
2014,Febrero,Indonesia,1,4,,5,POINT (4697157 -74140516)
2014,Febrero,Irán,0,1,,1,POINT (4697157 -74140516)
2014,Febrero,República de Irlanda,1,1,,2,POINT (10446304 -75516486)
2014,Febrero,República de Irlanda,0,1,,1,POINT (3451668 -76532004)
2014,Febrero,República de Irlanda,6,12,,18,POINT (4697157 -74140516)
2014,Febrero,República de Irlanda,0,2,,2,POINT (6170465 -7542726)
2014,Febrero,Islandia,1,0,,1,POINT (3451668 -76532004)
2014,Febrero,Israel,0,1,,1,POINT (10446304 -75516486)
2014,Febrero,Israel,0,3,,3,POINT (3451668 -76532004)
2014,Febrero,Israel,6,53,,59,POINT (4697157 -74140516)
2014,Febrero,Israel,0,2,,2,POINT (6170465 -7542726)
2014,Febrero,Italia,5,7,,12,POINT (10446304 -75516486)
2014,Febrero,Italia,3,2,,5,POINT (10886686 -74776479)
2014,Febrero,Italia,5,12,,17,POINT (3451668 -76532004)
2014,Febrero,Italia,79,229,,308,POINT (4697157 -74140516)
2014,Febrero,Italia,10,8,,18,POINT (6170465 -7542726)
2014,Febrero,Italia,0,1,,1,POINT (7128047 -73181317)
2014,Febrero,Jamaica,0,3,,3,POINT (10406342 -75527794)
2014,Febrero,Jamaica,3,8,,11,POINT (10446304 -75516486)
2014,Febrero,Jamaica,1,3,,4,POINT (10886686 -74776479)
2014,Febrero,Jamaica,3,2,,5,POINT (3451668 -76532004)
2014,Febrero,Jamaica,0,4,,4,POINT (4697157 -74140516)
2014,Febrero,Japón,1,1,,2,POINT (10446304 -75516486)
2014,Febrero,Japón,0,1,,1,POINT (10886686 -74776479)
2014,Febrero,Japón,2,12,,14,POINT (3451668 -76532004)
2014,Febrero,Japón,10,23,,33,POINT (4697157 -74140516)
2014,Febrero,Japón,0,1,,1,POINT (4815189 -75736374)
2014,Febrero,Japón,1,1,,2,POINT (6170465 -7542726)
2014,Febrero,Japón,0,1,,1,POINT (7128047 -73181317)
2014,Febrero,Jordania,1,0,,1,POINT (4697157 -74140516)
2014,Febrero,Kazajistán,0,1,,1,POINT (4697157 -74140516)
2014,Febrero,Kazajistán,0,2,,2,POINT (6170465 -7542726)
2014,Febrero,Kenia,0,2,,2,POINT (4697157 -74140516)
2014,Febrero,República Democrática Popular  Lao,3,1,,4,POINT (4697157 -74140516)
2014,Febrero,Letonia,0,7,,7,POINT (4697157 -74140516)
2014,Febrero,Lituania,1,0,,1,POINT (3451668 -76532004)
2014,Febrero,Lituania,0,2,,2,POINT (4697157 -74140516)
2014,Febrero,Líbano,2,2,,4,POINT (4697157 -74140516)
2014,Febrero,Luxemburgo,3,4,,7,POINT (4697157 -74140516)
2014,Febrero,Malasia,2,1,,3,POINT (3451668 -76532004)
2014,Febrero,Malasia,3,2,,5,POINT (4697157 -74140516)
2014,Febrero,Malta,0,1,,1,POINT (4697157 -74140516)
2014,Febrero,Marruecos,0,1,,1,POINT (4697157 -74140516)
2014,Febrero,México,0,3,,3,POINT (10406342 -75527794)
2014,Febrero,México,33,73,,106,POINT (10446304 -75516486)
2014,Febrero,México,14,29,,43,POINT (10886686 -74776479)
2014,Febrero,México,1,4,,5,POINT (125744111 -81703935)
2014,Febrero,México,28,84,,112,POINT (3451668 -76532004)
2014,Febrero,México,2560,5658,,8218,POINT (4697157 -74140516)
2014,Febrero,México,2,8,,10,POINT (4815189 -75736374)
2014,Febrero,México,52,174,,226,POINT (6170465 -7542726)
2014,Febrero,México,3,4,,7,POINT (7128047 -73181317)
2014,Febrero,México,1,0,,1,POINT (7927233 -72508188)
2014,Febrero,Mónaco,0,1,,1,POINT (4697157 -74140516)
2014,Febrero,Montenegro,0,1,,1,POINT (6170465 -7542726)
2014,Febrero,Mozambique,0,1,,1,POINT (4697157 -74140516)
2014,Febrero,Myanmar,0,3,,3,POINT (4697157 -74140516)
2014,Febrero,Nepal,0,1,,1,POINT (4697157 -74140516)
2014,Febrero,Nicaragua,2,5,,7,POINT (10446304 -75516486)
2014,Febrero,Nicaragua,1,1,,2,POINT (10886686 -74776479)
2014,Febrero,Nicaragua,0,1,,1,POINT (125862 -81702165)
2014,Febrero,Nicaragua,3,5,,8,POINT (3451668 -76532004)
2014,Febrero,Nicaragua,18,21,,39,POINT (4697157 -74140516)
2014,Febrero,Nicaragua,0,2,,2,POINT (4815189 -75736374)
2014,Febrero,Nicaragua,5,7,,12,POINT (6170465 -7542726)
2014,Febrero,Nicaragua,0,1,,1,POINT (7927233 -72508188)
2014,Febrero,Nigeria,0,2,,2,POINT (4697157 -74140516)
2014,Febrero,Noruega,0,3,,3,POINT (10446304 -75516486)
2014,Febrero,Noruega,1,3,,4,POINT (3451668 -76532004)
2014,Febrero,Noruega,10,31,,41,POINT (4697157 -74140516)
2014,Febrero,Noruega,0,2,,2,POINT (4815189 -75736374)
2014,Febrero,Noruega,1,2,,3,POINT (6170465 -7542726)
2014,Febrero,Nueva Zelanda,0,3,,3,POINT (3451668 -76532004)
2014,Febrero,Nueva Zelanda,3,2,,5,POINT (4697157 -74140516)
2014,Febrero,Nueva Zelanda,0,1,,1,POINT (6170465 -7542726)
2014,Febrero,Pakistán,0,1,,1,POINT (3451668 -76532004)
2014,Febrero,Panamá,929,950,,1879,POINT (10406342 -75527794)
2014,Febrero,Panamá,1976,2146,,4122,POINT (10446304 -75516486)
2014,Febrero,Panamá,258,484,,742,POINT (10886686 -74776479)
2014,Febrero,Panamá,0,1,,1,POINT (125744111 -81703935)
2014,Febrero,Panamá,578,503,,1081,POINT (125862 -81702165)
2014,Febrero,Panamá,3,10,,13,POINT (133387613 -81372937)
2014,Febrero,Panamá,196,492,,688,POINT (3451668 -76532004)
2014,Febrero,Panamá,0,8,,8,POINT (3884426 -77061029)
2014,Febrero,Panamá,2140,4156,,6296,POINT (4697157 -74140516)
2014,Febrero,Panamá,59,109,,168,POINT (4815189 -75736374)
2014,Febrero,Panamá,434,1149,,1583,POINT (6170465 -7542726)
2014,Febrero,Panamá,0,3,,3,POINT (6222552 -77401154)
2014,Febrero,Panamá,3,12,,15,POINT (7102626 -77762647)
2014,Febrero,Panamá,26,66,,92,POINT (7128047 -73181317)
2014,Febrero,Panamá,60,78,,138,POINT (7927233 -72508188)
2014,Febrero,Panamá,1,1,,2,POINT (806667 -767333)
2014,Febrero,Panamá,101,144,,245,POINT (863337 -7735002)
2014,Febrero,Paraguay,6,5,,11,POINT (10446304 -75516486)
2014,Febrero,Paraguay,3,2,,5,POINT (10886686 -74776479)
2014,Febrero,Paraguay,8,8,,16,POINT (125862 -81702165)
2014,Febrero,Paraguay,8,29,,37,POINT (3451668 -76532004)
2014,Febrero,Paraguay,21,32,,53,POINT (4697157 -74140516)
2014,Febrero,Paraguay,5,5,,10,POINT (6170465 -7542726)
2014,Febrero,Paraguay,3,1,,4,POINT (7128047 -73181317)
2014,Febrero,Perú,124,182,,306,POINT (-4191162 -69941498)
2014,Febrero,Perú,5,13,,18,POINT (0.81488 -77356)
2014,Febrero,Perú,1,6,,7,POINT (10406342 -75527794)
2014,Febrero,Perú,83,50,,133,POINT (10446304 -75516486)
2014,Febrero,Perú,23,34,,57,POINT (10886686 -74776479)
2014,Febrero,Perú,60,45,,105,POINT (125862 -81702165)
2014,Febrero,Perú,186,298,,484,POINT (3451668 -76532004)
2014,Febrero,Perú,5276,6750,,12026,POINT (4697157 -74140516)
2014,Febrero,Perú,0,6,,6,POINT (4815189 -75736374)
2014,Febrero,Perú,557,743,,1300,POINT (6170465 -7542726)
2014,Febrero,Perú,0,3,,3,POINT (7128047 -73181317)
2014,Febrero,Perú,1,2,,3,POINT (7927233 -72508188)
2014,Febrero,Polonia,5,1,,6,POINT (10446304 -75516486)
2014,Febrero,Polonia,1,0,,1,POINT (3451668 -76532004)
2014,Febrero,Polonia,18,16,,34,POINT (4697157 -74140516)
2014,Febrero,Polonia,2,1,,3,POINT (6170465 -7542726)
2014,Febrero,Portugal,0,3,,3,POINT (3451668 -76532004)
2014,Febrero,Portugal,14,31,,45,POINT (4697157 -74140516)
2014,Febrero,Portugal,0,3,,3,POINT (6170465 -7542726)
2014,Febrero,Puerto Rico/Territorio de Estados Unidos,0,1,,1,POINT (10406342 -75527794)
2014,Febrero,Puerto Rico/Territorio de Estados Unidos,2,14,,16,POINT (10446304 -75516486)
2014,Febrero,Puerto Rico/Territorio de Estados Unidos,3,20,,23,POINT (10886686 -74776479)
2014,Febrero,Puerto Rico/Territorio de Estados Unidos,14,35,,49,POINT (3451668 -76532004)
2014,Febrero,Puerto Rico/Territorio de Estados Unidos,128,217,,345,POINT (4697157 -74140516)
2014,Febrero,Puerto Rico/Territorio de Estados Unidos,1,1,,2,POINT (4815189 -75736374)
2014,Febrero,Puerto Rico/Territorio de Estados Unidos,14,44,,58,POINT (6170465 -7542726)
2014,Febrero,Puerto Rico/Territorio de Estados Unidos,1,1,,2,POINT (7128047 -73181317)
2014,Febrero,Reino Unido de Gran Bretaña e Irlanda del Norte,3,9,,12,POINT (10446304 -75516486)
2014,Febrero,Reino Unido de Gran Bretaña e Irlanda del Norte,1,2,,3,POINT (10886686 -74776479)
2014,Febrero,Reino Unido de Gran Bretaña e Irlanda del Norte,9,16,,25,POINT (3451668 -76532004)
2014,Febrero,Reino Unido de Gran Bretaña e Irlanda del Norte,118,172,,290,POINT (4697157 -74140516)
2014,Febrero,Reino Unido de Gran Bretaña e Irlanda del Norte,0,1,,1,POINT (4815189 -75736374)
2014,Febrero,Reino Unido de Gran Bretaña e Irlanda del Norte,6,13,,19,POINT (6170465 -7542726)
2014,Febrero,Federación de Rusia,2,0,,2,POINT (10446304 -75516486)
2014,Febrero,Federación de Rusia,24,28,,52,POINT (4697157 -74140516)
2014,Febrero,República Dominicana,5,8,,13,POINT (10446304 -75516486)
2014,Febrero,República Dominicana,21,56,,77,POINT (10886686 -74776479)
2014,Febrero,República Dominicana,7,19,,26,POINT (3451668 -76532004)
2014,Febrero,República Dominicana,274,533,,807,POINT (4697157 -74140516)
2014,Febrero,República Dominicana,2,1,,3,POINT (4815189 -75736374)
2014,Febrero,República Dominicana,12,47,,59,POINT (6170465 -7542726)
2014,Febrero,República Dominicana,1,2,,3,POINT (7128047 -73181317)
2014,Febrero,República Dominicana,1,0,,1,POINT (7927233 -72508188)
2014,Febrero,República Democrática Popular de Corea,1,1,,2,POINT (4697157 -74140516)
2014,Febrero,Rumania,2,3,,5,POINT (4697157 -74140516)
2014,Febrero,San Cristóbal y Nevis,0,1,,1,POINT (4697157 -74140516)
2014,Febrero,San  Vicente y las Granadinas,0,4,,4,POINT (10446304 -75516486)
2014,Febrero,Santa Lucia,0,1,,1,POINT (4697157 -74140516)
2014,Febrero,Serbia,1,0,,1,POINT (4697157 -74140516)
2014,Febrero,Singapur,0,1,,1,POINT (10446304 -75516486)
2014,Febrero,Singapur,0,1,,1,POINT (10886686 -74776479)
2014,Febrero,Singapur,0,4,,4,POINT (4697157 -74140516)
2014,Febrero,Sudáfrica,1,0,,1,POINT (10446304 -75516486)
2014,Febrero,Sudáfrica,1,0,,1,POINT (3451668 -76532004)
2014,Febrero,Sudáfrica,3,8,,11,POINT (4697157 -74140516)
2014,Febrero,Suecia,4,1,,5,POINT (10446304 -75516486)
2014,Febrero,Suecia,4,3,,7,POINT (3451668 -76532004)
2014,Febrero,Suecia,29,42,,71,POINT (4697157 -74140516)
2014,Febrero,Suecia,0,1,,1,POINT (6170465 -7542726)
2014,Febrero,Suiza,2,3,,5,POINT (10446304 -75516486)
2014,Febrero,Suiza,3,10,,13,POINT (3451668 -76532004)
2014,Febrero,Suiza,53,75,,128,POINT (4697157 -74140516)
2014,Febrero,Suiza,7,18,,25,POINT (6170465 -7542726)
2014,Febrero,Surinam,0,1,,1,POINT (10406342 -75527794)
2014,Febrero,Surinam,1,1,,2,POINT (4697157 -74140516)
2014,Febrero,Surinam,1,1,,2,POINT (6170465 -7542726)
2014,Febrero,Surinam,1,1,,2,POINT (7128047 -73181317)
2014,Febrero,Taiwán,1,4,,5,POINT (4697157 -74140516)
2014,Febrero,Taiwán,1,2,,3,POINT (6170465 -7542726)
2014,Febrero,Tailandia,2,0,,2,POINT (4697157 -74140516)
2014,Febrero,Trinidad y Tobago,0,3,,3,POINT (10446304 -75516486)
2014,Febrero,Trinidad y Tobago,0,2,,2,POINT (10886686 -74776479)
2014,Febrero,Trinidad y Tobago,1,3,,4,POINT (3451668 -76532004)
2014,Febrero,Trinidad y Tobago,13,15,,28,POINT (4697157 -74140516)
2014,Febrero,Trinidad y Tobago,0,2,,2,POINT (4815189 -75736374)
2014,Febrero,Trinidad y Tobago,0,4,,4,POINT (6170465 -7542726)
2014,Febrero,Trinidad y Tobago,0,5,,5,POINT (7128047 -73181317)
2014,Febrero,Túnez,0,1,,1,POINT (4697157 -74140516)
2014,Febrero,Turquía,0,1,,1,POINT (10446304 -75516486)
2014,Febrero,Turquía,0,1,,1,POINT (3451668 -76532004)
2014,Febrero,Turquía,5,10,,15,POINT (4697157 -74140516)
2014,Febrero,Turquía,1,1,,2,POINT (6170465 -7542726)
2014,Febrero,Ucrania,0,2,,2,POINT (10446304 -75516486)
2014,Febrero,Ucrania,0,8,,8,POINT (4697157 -74140516)
2014,Febrero,Uganda,0,1,,1,POINT (3451668 -76532004)
2014,Febrero,Uganda,0,1,,1,POINT (4697157 -74140516)
2014,Febrero,Uruguay,0,1,,1,POINT (0.81488 -77356)
2014,Febrero,Uruguay,30,25,,55,POINT (10446304 -75516486)
2014,Febrero,Uruguay,14,15,,29,POINT (125862 -81702165)
2014,Febrero,Uruguay,4,22,,26,POINT (3451668 -76532004)
2014,Febrero,Uruguay,38,45,,83,POINT (4697157 -74140516)
2014,Febrero,Uruguay,10,22,,32,POINT (6170465 -7542726)
2014,Febrero,Uruguay,1,2,,3,POINT (7128047 -73181317)
2014,Febrero,Venezuela,0,19,,19,POINT (10406342 -75527794)
2014,Febrero,Venezuela,9,44,,53,POINT (10446304 -75516486)
2014,Febrero,Venezuela,44,76,,120,POINT (10886686 -74776479)
2014,Febrero,Venezuela,1646,2334,,3980,POINT (11360029 -72129595)
2014,Febrero,Venezuela,11,19,,30,POINT (3451668 -76532004)
2014,Febrero,Venezuela,3035,4130,,7165,POINT (4697157 -74140516)
2014,Febrero,Venezuela,3,3,,6,POINT (4815189 -75736374)
2014,Febrero,Venezuela,193,268,,461,POINT (6170465 -7542726)
2014,Febrero,Venezuela,43,90,,133,POINT (6185536 -67484028)
2014,Febrero,Venezuela,55,84,,139,POINT (7088729 -70740253)
2014,Febrero,Venezuela,1,4,,5,POINT (7128047 -73181317)
2014,Febrero,Venezuela,1558,2162,,3720,POINT (7819 -72453013)
2014,Febrero,Venezuela,89,132,,221,POINT (7927233 -72508188)
2014,Febrero,Vietnam,0,2,,2,POINT (4697157 -74140516)
2014,Febrero,República Árabe de Yemen,0,1,,1,POINT (4697157 -74140516)
2014,Febrero,Desconocido,1,22,,23,POINT (125744111 -81703935)
2014,Febrero,Desconocido,0,1,,1,POINT (133387613 -81372937)
2014,Marzo,Desconocido,0,4,,4,POINT (10406342 -75527794)
2014,Marzo,Desconocido,1,0,,1,POINT (11247723 -74213989)
2014,Marzo,Desconocido,8,20,,28,POINT (125744111 -81703935)
2014,Marzo,Desconocido,3,1,,4,POINT (133387613 -81372937)
2014,Marzo,Desconocido,1,12,,13,POINT (4697157 -74140516)
2014,Marzo,Desconocido,0,8,,8,POINT (6170465 -7542726)
2014,Marzo,Desconocido,0,18,,18,POINT (9402597 -75681642)
2014,Marzo,Afganistán,1,0,,1,POINT (10406342 -75527794)
2014,Marzo,Alemania,2,2,,4,POINT (10446304 -75516486)
2014,Marzo,Alemania,0,5,,5,POINT (10886686 -74776479)
2014,Marzo,Alemania,0,1,,1,POINT (125862 -81702165)
2014,Marzo,Alemania,3,7,,10,POINT (3451668 -76532004)
2014,Marzo,Alemania,1214,2424,,3638,POINT (4697157 -74140516)
2014,Marzo,Alemania,10,11,,21,POINT (6170465 -7542726)
2014,Marzo,Andorra,0,1,,1,POINT (4697157 -74140516)
2014,Marzo,Angola,0,1,,1,POINT (3451668 -76532004)
2014,Marzo,Angola,0,1,,1,POINT (4697157 -74140516)
2014,Marzo,Países Bajos,0,4,,4,POINT (10406342 -75527794)
2014,Marzo,Países Bajos,5,4,,9,POINT (10446304 -75516486)
2014,Marzo,Países Bajos,0,8,,8,POINT (10886686 -74776479)
2014,Marzo,Países Bajos,8,24,,32,POINT (3451668 -76532004)
2014,Marzo,Países Bajos,39,76,,115,POINT (4697157 -74140516)
2014,Marzo,Países Bajos,1,1,,2,POINT (4815189 -75736374)
2014,Marzo,Países Bajos,55,60,,115,POINT (6170465 -7542726)
2014,Marzo,Países Bajos,9,5,,14,POINT (7128047 -73181317)
2014,Marzo,Arabia Saudita,1,5,,6,POINT (4697157 -74140516)
2014,Marzo,Argelia,1,0,,1,POINT (3451668 -76532004)
2014,Marzo,Argelia,0,1,,1,POINT (4697157 -74140516)
2014,Marzo,Argentina,1,1,,2,POINT (10406342 -75527794)
2014,Marzo,Argentina,244,195,,439,POINT (10446304 -75516486)
2014,Marzo,Argentina,9,12,,21,POINT (10886686 -74776479)
2014,Marzo,Argentina,172,132,,304,POINT (125862 -81702165)
2014,Marzo,Argentina,19,59,,78,POINT (3451668 -76532004)
2014,Marzo,Argentina,2592,3293,,5885,POINT (4697157 -74140516)
2014,Marzo,Argentina,1,0,,1,POINT (4815189 -75736374)
2014,Marzo,Argentina,77,116,,193,POINT (6170465 -7542726)
2014,Marzo,Argentina,0,1,,1,POINT (7927233 -72508188)
2014,Marzo,Aruba,93,95,,188,POINT (10406342 -75527794)
2014,Marzo,Aruba,0,3,,3,POINT (10886686 -74776479)
2014,Marzo,Aruba,2,10,,12,POINT (11247723 -74213989)
2014,Marzo,Aruba,0,2,,2,POINT (1152863 -72919186)
2014,Marzo,Aruba,2,2,,4,POINT (3451668 -76532004)
2014,Marzo,Aruba,521,656,,1177,POINT (4697157 -74140516)
2014,Marzo,Aruba,0,1,,1,POINT (4815189 -75736374)
2014,Marzo,Aruba,9,8,,17,POINT (6170465 -7542726)
2014,Marzo,Aruba,2,9,,11,POINT (7128047 -73181317)
2014,Marzo,Australia,1,4,,5,POINT (10446304 -75516486)
2014,Marzo,Australia,0,3,,3,POINT (10886686 -74776479)
2014,Marzo,Australia,3,5,,8,POINT (3451668 -76532004)
2014,Marzo,Australia,16,33,,49,POINT (4697157 -74140516)
2014,Marzo,Australia,11,18,,29,POINT (6170465 -7542726)
2014,Marzo,Austria,0,2,,2,POINT (10446304 -75516486)
2014,Marzo,Austria,5,34,,39,POINT (4697157 -74140516)
2014,Marzo,Austria,1,2,,3,POINT (6170465 -7542726)
2014,Marzo,Azerbaiyán,1,3,,4,POINT (4697157 -74140516)
2014,Marzo,Bahamas,6,10,,16,POINT (10446304 -75516486)
2014,Marzo,Bahamas,1,0,,1,POINT (10886686 -74776479)
2014,Marzo,Bahamas,0,5,,5,POINT (4697157 -74140516)
2014,Marzo,Bahamas,0,1,,1,POINT (6170465 -7542726)
2014,Marzo,Barbados,1,1,,2,POINT (10446304 -75516486)
2014,Marzo,Barbados,1,3,,4,POINT (4697157 -74140516)
2014,Marzo,Barbados,0,1,,1,POINT (6170465 -7542726)
2014,Marzo,República de Belarús,1,0,,1,POINT (4697157 -74140516)
2014,Marzo,Bélgica,1,1,,2,POINT (10446304 -75516486)
2014,Marzo,Bélgica,2,3,,5,POINT (10886686 -74776479)
2014,Marzo,Bélgica,0,3,,3,POINT (11247723 -74213989)
2014,Marzo,Bélgica,0,7,,7,POINT (3451668 -76532004)
2014,Marzo,Bélgica,22,28,,50,POINT (4697157 -74140516)
2014,Marzo,Bélgica,2,4,,6,POINT (6170465 -7542726)
2014,Marzo,Belice,2,2,,4,POINT (3451668 -76532004)
2014,Marzo,Belice,0,1,,1,POINT (4697157 -74140516)
2014,Marzo,Bermudas/Territorio Británico de Ultramar,1,0,,1,POINT (10446304 -75516486)
2014,Marzo,Bermudas/Territorio Británico de Ultramar,0,1,,1,POINT (6170465 -7542726)
2014,Marzo,Bolivia,2,5,,7,POINT (10446304 -75516486)
2014,Marzo,Bolivia,2,2,,4,POINT (10886686 -74776479)
2014,Marzo,Bolivia,3,6,,9,POINT (125862 -81702165)
2014,Marzo,Bolivia,5,8,,13,POINT (3451668 -76532004)
2014,Marzo,Bolivia,250,407,,657,POINT (4697157 -74140516)
2014,Marzo,Bolivia,1,2,,3,POINT (4815189 -75736374)
2014,Marzo,Bolivia,19,16,,35,POINT (6170465 -7542726)
2014,Marzo,Bosnia y Herzegovina,1,0,,1,POINT (6170465 -7542726)
2014,Marzo,Brasil,141,184,,325,POINT (-4191162 -69941498)
2014,Marzo,Brasil,98,73,,171,POINT (10446304 -75516486)
2014,Marzo,Brasil,9,13,,22,POINT (10886686 -74776479)
2014,Marzo,Brasil,0,3,,3,POINT (11247723 -74213989)
2014,Marzo,Brasil,39,24,,63,POINT (125862 -81702165)
2014,Marzo,Brasil,13,82,,95,POINT (3451668 -76532004)
2014,Marzo,Brasil,2983,5117,,8100,POINT (4697157 -74140516)
2014,Marzo,Brasil,2,5,,7,POINT (4815189 -75736374)
2014,Marzo,Brasil,71,174,,245,POINT (6170465 -7542726)
2014,Marzo,Brasil,0,3,,3,POINT (7128047 -73181317)
2014,Marzo,Brunei Darussalam,0,2,,2,POINT (4697157 -74140516)
2014,Marzo,Bulgaria,0,1,,1,POINT (3451668 -76532004)
2014,Marzo,Bulgaria,2,3,,5,POINT (4697157 -74140516)
2014,Marzo,Cabo Verde,0,1,,1,POINT (4697157 -74140516)
2014,Marzo,Islas Caimán/Territorio Británico de Ultramar,4,8,,12,POINT (10446304 -75516486)
2014,Marzo,Islas Caimán/Territorio Británico de Ultramar,0,1,,1,POINT (133387613 -81372937)
2014,Marzo,Islas Caimán/Territorio Británico de Ultramar,1,9,,10,POINT (4697157 -74140516)
2014,Marzo,Camboya,0,1,,1,POINT (11360029 -72129595)
2014,Marzo,Camerún,1,0,,1,POINT (4697157 -74140516)
2014,Marzo,Canadá,493,483,,976,POINT (10446304 -75516486)
2014,Marzo,Canadá,1,7,,8,POINT (10886686 -74776479)
2014,Marzo,Canadá,424,373,,797,POINT (125862 -81702165)
2014,Marzo,Canadá,13,24,,37,POINT (3451668 -76532004)
2014,Marzo,Canadá,0,7,,7,POINT (3884426 -77061029)
2014,Marzo,Canadá,463,807,,1270,POINT (4697157 -74140516)
2014,Marzo,Canadá,0,4,,4,POINT (4815189 -75736374)
2014,Marzo,Canadá,32,55,,87,POINT (6170465 -7542726)
2014,Marzo,Canadá,1,0,,1,POINT (7128047 -73181317)
2014,Marzo,Canadá,0,2,,2,POINT (7927233 -72508188)
2014,Marzo,España,2,5,,7,POINT (10446304 -75516486)
2014,Marzo,España,1,2,,3,POINT (10886686 -74776479)
2014,Marzo,España,1,0,,1,POINT (125862 -81702165)
2014,Marzo,España,141,275,,416,POINT (3451668 -76532004)
2014,Marzo,España,2236,5453,,7689,POINT (4697157 -74140516)
2014,Marzo,España,2,0,,2,POINT (4815189 -75736374)
2014,Marzo,España,95,226,,321,POINT (6170465 -7542726)
2014,Marzo,España,0,1,,1,POINT (7128047 -73181317)
2014,Marzo,República de Corea,1,1,,2,POINT (3451668 -76532004)
2014,Marzo,República de Corea,0,1,,1,POINT (3884426 -77061029)
2014,Marzo,República de Corea,7,17,,24,POINT (4697157 -74140516)
2014,Marzo,República de Corea,0,1,,1,POINT (4815189 -75736374)
2014,Marzo,República de Corea,0,3,,3,POINT (6170465 -7542726)
2014,Marzo,Costa de Marfil,4,4,,8,POINT (4697157 -74140516)
2014,Marzo,Costa Rica,68,62,,130,POINT (10406342 -75527794)
2014,Marzo,Costa Rica,9,21,,30,POINT (10446304 -75516486)
2014,Marzo,Costa Rica,7,20,,27,POINT (10886686 -74776479)
2014,Marzo,Costa Rica,0,1,,1,POINT (11247723 -74213989)
2014,Marzo,Costa Rica,6,4,,10,POINT (125862 -81702165)
2014,Marzo,Costa Rica,12,35,,47,POINT (3451668 -76532004)
2014,Marzo,Costa Rica,595,1155,,1750,POINT (4697157 -74140516)
2014,Marzo,Costa Rica,1,3,,4,POINT (4815189 -75736374)
2014,Marzo,Costa Rica,40,82,,122,POINT (6170465 -7542726)
2014,Marzo,Costa Rica,0,1,,1,POINT (7128047 -73181317)
2014,Marzo,Croacia,0,1,,1,POINT (10886686 -74776479)
2014,Marzo,Croacia,0,6,,6,POINT (4697157 -74140516)
2014,Marzo,Cuba,2,5,,7,POINT (10446304 -75516486)
2014,Marzo,Cuba,1,3,,4,POINT (10886686 -74776479)
2014,Marzo,Cuba,9,20,,29,POINT (3451668 -76532004)
2014,Marzo,Cuba,146,258,,404,POINT (4697157 -74140516)
2014,Marzo,Cuba,0,1,,1,POINT (4815189 -75736374)
2014,Marzo,Cuba,10,11,,21,POINT (6170465 -7542726)
2014,Marzo,Cuba,0,1,,1,POINT (7927233 -72508188)
2014,Marzo,Curazao,0,1,,1,POINT (10886686 -74776479)
2014,Marzo,Curazao,0,1,,1,POINT (11247723 -74213989)
2014,Marzo,Curazao,161,225,,386,POINT (4697157 -74140516)
2014,Marzo,Curazao,151,200,,351,POINT (6170465 -7542726)
2014,Marzo,República Checa,0,1,,1,POINT (10886686 -74776479)
2014,Marzo,República Checa,4,8,,12,POINT (4697157 -74140516)
2014,Marzo,Chile,37,34,,71,POINT (10446304 -75516486)
2014,Marzo,Chile,8,15,,23,POINT (10886686 -74776479)
2014,Marzo,Chile,73,44,,117,POINT (125862 -81702165)
2014,Marzo,Chile,51,187,,238,POINT (3451668 -76532004)
2014,Marzo,Chile,3321,4425,,7746,POINT (4697157 -74140516)
2014,Marzo,Chile,69,118,,187,POINT (6170465 -7542726)
2014,Marzo,China,1,0,,1,POINT (10886686 -74776479)
2014,Marzo,China,35,75,,110,POINT (4697157 -74140516)
2014,Marzo,China,2,1,,3,POINT (6170465 -7542726)
2014,Marzo,Chipre,0,1,,1,POINT (3451668 -76532004)
2014,Marzo,Chipre,0,1,,1,POINT (4697157 -74140516)
2014,Marzo,Dinamarca,1,0,,1,POINT (10886686 -74776479)
2014,Marzo,Dinamarca,0,3,,3,POINT (3451668 -76532004)
2014,Marzo,Dinamarca,1,18,,19,POINT (4697157 -74140516)
2014,Marzo,Dominica,1,0,,1,POINT (4697157 -74140516)
2014,Marzo,Dominica,0,1,,1,POINT (6170465 -7542726)
2014,Marzo,Ecuador,35,77,,112,POINT (0.33002 -76876446)
2014,Marzo,Ecuador,2346,3818,,6164,POINT (0.81488 -77356)
2014,Marzo,Ecuador,5,30,,35,POINT (1800143 -78802679)
2014,Marzo,Ecuador,0,1,,1,POINT (10406342 -75527794)
2014,Marzo,Ecuador,5,10,,15,POINT (10446304 -75516486)
2014,Marzo,Ecuador,7,8,,15,POINT (10886686 -74776479)
2014,Marzo,Ecuador,256,190,,446,POINT (125862 -81702165)
2014,Marzo,Ecuador,524,617,,1141,POINT (3451668 -76532004)
2014,Marzo,Ecuador,2247,4025,,6272,POINT (4697157 -74140516)
2014,Marzo,Ecuador,411,582,,993,POINT (6170465 -7542726)
2014,Marzo,Ecuador,1,2,,3,POINT (7128047 -73181317)
2014,Marzo,El Salvador,1,3,,4,POINT (10446304 -75516486)
2014,Marzo,El Salvador,1,3,,4,POINT (10886686 -74776479)
2014,Marzo,El Salvador,2,2,,4,POINT (125862 -81702165)
2014,Marzo,El Salvador,98,178,,276,POINT (3451668 -76532004)
2014,Marzo,El Salvador,645,1159,,1804,POINT (4697157 -74140516)
2014,Marzo,El Salvador,1,0,,1,POINT (4815189 -75736374)
2014,Marzo,El Salvador,96,197,,293,POINT (6170465 -7542726)
2014,Marzo,Emiratos Árabes,1,5,,6,POINT (4697157 -74140516)
2014,Marzo,Eslovaquia,2,4,,6,POINT (4697157 -74140516)
2014,Marzo,Eslovenia,0,1,,1,POINT (10446304 -75516486)
2014,Marzo,Eslovenia,0,1,,1,POINT (10886686 -74776479)
2014,Marzo,Eslovenia,1,3,,4,POINT (4697157 -74140516)
2014,Marzo,Estados Unidos de América,5,19,,24,POINT (10406342 -75527794)
2014,Marzo,Estados Unidos de América,1455,2305,,3760,POINT (10446304 -75516486)
2014,Marzo,Estados Unidos de América,321,511,,832,POINT (10886686 -74776479)
2014,Marzo,Estados Unidos de América,4,7,,11,POINT (11117206 -74232675)
2014,Marzo,Estados Unidos de América,0,10,,10,POINT (11247723 -74213989)
2014,Marzo,Estados Unidos de América,12,7,,19,POINT (125862 -81702165)
2014,Marzo,Estados Unidos de América,830,1228,,2058,POINT (3451668 -76532004)
2014,Marzo,Estados Unidos de América,0,3,,3,POINT (3884426 -77061029)
2014,Marzo,Estados Unidos de América,117,127,,244,POINT (445285 -75766353)
2014,Marzo,Estados Unidos de América,7662,14779,,22441,POINT (4697157 -74140516)
2014,Marzo,Estados Unidos de América,31,47,,78,POINT (4815189 -75736374)
2014,Marzo,Estados Unidos de América,1723,3656,,5379,POINT (6170465 -7542726)
2014,Marzo,Estados Unidos de América,5,13,,18,POINT (7128047 -73181317)
2014,Marzo,Estados Unidos de América,6,10,,16,POINT (7927233 -72508188)
2014,Marzo,Estados Unidos de América,0,1,,1,POINT (806667 -767333)
2014,Marzo,Estonia,1,3,,4,POINT (4697157 -74140516)
2014,Marzo,Filipinas,0,4,,4,POINT (10886686 -74776479)
2014,Marzo,Filipinas,0,1,,1,POINT (3451668 -76532004)
2014,Marzo,Filipinas,1,7,,8,POINT (4697157 -74140516)
2014,Marzo,Finlandia,2,1,,3,POINT (3451668 -76532004)
2014,Marzo,Finlandia,5,5,,10,POINT (4697157 -74140516)
2014,Marzo,Francia,1,1,,2,POINT (10446304 -75516486)
2014,Marzo,Francia,1,0,,1,POINT (10886686 -74776479)
2014,Marzo,Francia,10,14,,24,POINT (3451668 -76532004)
2014,Marzo,Francia,1076,2211,,3287,POINT (4697157 -74140516)
2014,Marzo,Francia,1,1,,2,POINT (4815189 -75736374)
2014,Marzo,Francia,3,8,,11,POINT (6170465 -7542726)
2014,Marzo,Francia,0,1,,1,POINT (7128047 -73181317)
2014,Marzo,Gambia,0,1,,1,POINT (4697157 -74140516)
2014,Marzo,Granada,1,1,,2,POINT (11247723 -74213989)
2014,Marzo,Grecia,0,1,,1,POINT (1800143 -78802679)
2014,Marzo,Grecia,1,9,,10,POINT (4697157 -74140516)
2014,Marzo,Guatemala,3,9,,12,POINT (10446304 -75516486)
2014,Marzo,Guatemala,2,4,,6,POINT (10886686 -74776479)
2014,Marzo,Guatemala,2,3,,5,POINT (125862 -81702165)
2014,Marzo,Guatemala,11,22,,33,POINT (3451668 -76532004)
2014,Marzo,Guatemala,143,337,,480,POINT (4697157 -74140516)
2014,Marzo,Guatemala,1,2,,3,POINT (4815189 -75736374)
2014,Marzo,Guatemala,23,47,,70,POINT (6170465 -7542726)
2014,Marzo,Guatemala,0,1,,1,POINT (7128047 -73181317)
2014,Marzo,Guatemala,0,2,,2,POINT (7927233 -72508188)
2014,Marzo,Guyana,0,1,,1,POINT (10446304 -75516486)
2014,Marzo,Guyana,0,1,,1,POINT (10886686 -74776479)
2014,Marzo,Guyana,0,1,,1,POINT (4697157 -74140516)
2014,Marzo,Guyana,1,0,,1,POINT (6170465 -7542726)
2014,Marzo,Guinea Ecuatorial,1,1,,2,POINT (4697157 -74140516)
2014,Marzo,Guadalupe/Territorio Francés,2,3,,5,POINT (4697157 -74140516)
2014,Marzo,Guayana Francesa/Departamento de Ultramar Francés,0,1,,1,POINT (4697157 -74140516)
2014,Marzo,Haití,7,19,,26,POINT (4697157 -74140516)
2014,Marzo,Haití,0,2,,2,POINT (6170465 -7542726)
2014,Marzo,Honduras,0,1,,1,POINT (10446304 -75516486)
2014,Marzo,Honduras,1,4,,5,POINT (10886686 -74776479)
2014,Marzo,Honduras,1,7,,8,POINT (125862 -81702165)
2014,Marzo,Honduras,1,1,,2,POINT (133387613 -81372937)
2014,Marzo,Honduras,6,7,,13,POINT (3451668 -76532004)
2014,Marzo,Honduras,22,63,,85,POINT (4697157 -74140516)
2014,Marzo,Honduras,0,1,,1,POINT (4815189 -75736374)
2014,Marzo,Honduras,17,14,,31,POINT (6170465 -7542726)
2014,Marzo,Hong Kong,0,3,,3,POINT (4697157 -74140516)
2014,Marzo,Hong Kong,1,1,,2,POINT (6170465 -7542726)
2014,Marzo,Hungría,5,9,,14,POINT (4697157 -74140516)
2014,Marzo,Hungría,0,1,,1,POINT (6170465 -7542726)
2014,Marzo,India,0,1,,1,POINT (10886686 -74776479)
2014,Marzo,India,0,6,,6,POINT (3451668 -76532004)
2014,Marzo,India,4,30,,34,POINT (4697157 -74140516)
2014,Marzo,India,0,1,,1,POINT (6170465 -7542726)
2014,Marzo,Irán,0,2,,2,POINT (4697157 -74140516)
2014,Marzo,República de Irlanda,1,1,,2,POINT (3451668 -76532004)
2014,Marzo,República de Irlanda,5,11,,16,POINT (4697157 -74140516)
2014,Marzo,República de Irlanda,1,2,,3,POINT (6170465 -7542726)
2014,Marzo,Islandia,1,0,,1,POINT (4697157 -74140516)
2014,Marzo,Israel,0,2,,2,POINT (3451668 -76532004)
2014,Marzo,Israel,6,65,,71,POINT (4697157 -74140516)
2014,Marzo,Israel,0,1,,1,POINT (6170465 -7542726)
2014,Marzo,Italia,48,76,,124,POINT (10446304 -75516486)
2014,Marzo,Italia,1,3,,4,POINT (10886686 -74776479)
2014,Marzo,Italia,2,17,,19,POINT (3451668 -76532004)
2014,Marzo,Italia,42,197,,239,POINT (4697157 -74140516)
2014,Marzo,Italia,1,0,,1,POINT (4815189 -75736374)
2014,Marzo,Italia,3,2,,5,POINT (6170465 -7542726)
2014,Marzo,Jamaica,1,0,,1,POINT (10886686 -74776479)
2014,Marzo,Jamaica,0,2,,2,POINT (125862 -81702165)
2014,Marzo,Jamaica,1,1,,2,POINT (3451668 -76532004)
2014,Marzo,Jamaica,6,13,,19,POINT (4697157 -74140516)
2014,Marzo,Jamaica,0,2,,2,POINT (6170465 -7542726)
2014,Marzo,Japón,0,2,,2,POINT (10886686 -74776479)
2014,Marzo,Japón,3,2,,5,POINT (3451668 -76532004)
2014,Marzo,Japón,17,26,,43,POINT (4697157 -74140516)
2014,Marzo,Japón,2,3,,5,POINT (6170465 -7542726)
2014,Marzo,Japón,0,1,,1,POINT (7128047 -73181317)
2014,Marzo,Kenia,1,1,,2,POINT (3451668 -76532004)
2014,Marzo,Kenia,1,1,,2,POINT (6170465 -7542726)
2014,Marzo,Lituania,1,2,,3,POINT (4697157 -74140516)
2014,Marzo,Líbano,2,2,,4,POINT (4697157 -74140516)
2014,Marzo,Luxemburgo,0,2,,2,POINT (4697157 -74140516)
2014,Marzo,Malasia,1,2,,3,POINT (4697157 -74140516)
2014,Marzo,Malasia,0,1,,1,POINT (6170465 -7542726)
2014,Marzo,México,21,56,,77,POINT (10446304 -75516486)
2014,Marzo,México,12,34,,46,POINT (10886686 -74776479)
2014,Marzo,México,7,6,,13,POINT (125862 -81702165)
2014,Marzo,México,23,72,,95,POINT (3451668 -76532004)
2014,Marzo,México,0,14,,14,POINT (3884426 -77061029)
2014,Marzo,México,2553,6130,,8683,POINT (4697157 -74140516)
2014,Marzo,México,5,4,,9,POINT (4815189 -75736374)
2014,Marzo,México,60,236,,296,POINT (6170465 -7542726)
2014,Marzo,México,2,1,,3,POINT (7128047 -73181317)
2014,Marzo,México,3,0,,3,POINT (7927233 -72508188)
2014,Marzo,Nicaragua,4,0,,4,POINT (10446304 -75516486)
2014,Marzo,Nicaragua,2,1,,3,POINT (10886686 -74776479)
2014,Marzo,Nicaragua,6,9,,15,POINT (3451668 -76532004)
2014,Marzo,Nicaragua,17,25,,42,POINT (4697157 -74140516)
2014,Marzo,Nicaragua,4,14,,18,POINT (6170465 -7542726)
2014,Marzo,Nicaragua,0,1,,1,POINT (7927233 -72508188)
2014,Marzo,Noruega,1,1,,2,POINT (3451668 -76532004)
2014,Marzo,Noruega,12,18,,30,POINT (4697157 -74140516)
2014,Marzo,Noruega,0,1,,1,POINT (6170465 -7542726)
2014,Marzo,Nueva Zelanda,1,0,,1,POINT (10446304 -75516486)
2014,Marzo,Nueva Zelanda,0,4,,4,POINT (4697157 -74140516)
2014,Marzo,Nueva Zelanda,1,0,,1,POINT (4815189 -75736374)
2014,Marzo,Nueva Zelanda,1,1,,2,POINT (6170465 -7542726)
2014,Marzo,Palau,0,1,,1,POINT (4697157 -74140516)
2014,Marzo,Panamá,769,656,,1425,POINT (10406342 -75527794)
2014,Marzo,Panamá,2254,2524,,4778,POINT (10446304 -75516486)
2014,Marzo,Panamá,177,412,,589,POINT (10886686 -74776479)
2014,Marzo,Panamá,0,1,,1,POINT (11117206 -74232675)
2014,Marzo,Panamá,0,4,,4,POINT (11247723 -74213989)
2014,Marzo,Panamá,594,455,,1049,POINT (125862 -81702165)
2014,Marzo,Panamá,4,9,,13,POINT (133387613 -81372937)
2014,Marzo,Panamá,250,571,,821,POINT (3451668 -76532004)
2014,Marzo,Panamá,0,12,,12,POINT (3884426 -77061029)
2014,Marzo,Panamá,2086,4212,,6298,POINT (4697157 -74140516)
2014,Marzo,Panamá,60,126,,186,POINT (4815189 -75736374)
2014,Marzo,Panamá,463,1156,,1619,POINT (6170465 -7542726)
2014,Marzo,Panamá,1,0,,1,POINT (6222552 -77401154)
2014,Marzo,Panamá,5,12,,17,POINT (7102626 -77762647)
2014,Marzo,Panamá,23,52,,75,POINT (7128047 -73181317)
2014,Marzo,Panamá,50,83,,133,POINT (7927233 -72508188)
2014,Marzo,Panamá,95,153,,248,POINT (863337 -7735002)
2014,Marzo,Paraguay,16,10,,26,POINT (10446304 -75516486)
2014,Marzo,Paraguay,2,2,,4,POINT (10886686 -74776479)
2014,Marzo,Paraguay,14,11,,25,POINT (125862 -81702165)
2014,Marzo,Paraguay,7,7,,14,POINT (3451668 -76532004)
2014,Marzo,Paraguay,16,24,,40,POINT (4697157 -74140516)
2014,Marzo,Paraguay,2,0,,2,POINT (4815189 -75736374)
2014,Marzo,Paraguay,10,11,,21,POINT (6170465 -7542726)
2014,Marzo,Perú,110,187,,297,POINT (-4191162 -69941498)
2014,Marzo,Perú,0,1,,1,POINT (0.81488 -77356)
2014,Marzo,Perú,1,0,,1,POINT (10406342 -75527794)
2014,Marzo,Perú,55,51,,106,POINT (10446304 -75516486)
2014,Marzo,Perú,10,25,,35,POINT (10886686 -74776479)
2014,Marzo,Perú,129,81,,210,POINT (125862 -81702165)
2014,Marzo,Perú,184,312,,496,POINT (3451668 -76532004)
2014,Marzo,Perú,0,1,,1,POINT (3884426 -77061029)
2014,Marzo,Perú,5388,7277,,12665,POINT (4697157 -74140516)
2014,Marzo,Perú,0,2,,2,POINT (4815189 -75736374)
2014,Marzo,Perú,409,743,,1152,POINT (6170465 -7542726)
2014,Marzo,Perú,0,1,,1,POINT (7128047 -73181317)
2014,Marzo,Polonia,0,1,,1,POINT (10886686 -74776479)
2014,Marzo,Polonia,12,14,,26,POINT (4697157 -74140516)
2014,Marzo,Portugal,0,9,,9,POINT (3451668 -76532004)
2014,Marzo,Portugal,17,51,,68,POINT (4697157 -74140516)
2014,Marzo,Portugal,0,1,,1,POINT (6170465 -7542726)
2014,Marzo,Puerto Rico/Territorio de Estados Unidos,0,8,,8,POINT (10406342 -75527794)
2014,Marzo,Puerto Rico/Territorio de Estados Unidos,6,29,,35,POINT (10446304 -75516486)
2014,Marzo,Puerto Rico/Territorio de Estados Unidos,0,12,,12,POINT (10886686 -74776479)
2014,Marzo,Puerto Rico/Territorio de Estados Unidos,13,43,,56,POINT (3451668 -76532004)
2014,Marzo,Puerto Rico/Territorio de Estados Unidos,119,188,,307,POINT (4697157 -74140516)
2014,Marzo,Puerto Rico/Territorio de Estados Unidos,0,1,,1,POINT (4815189 -75736374)
2014,Marzo,Puerto Rico/Territorio de Estados Unidos,16,50,,66,POINT (6170465 -7542726)
2014,Marzo,Puerto Rico/Territorio de Estados Unidos,0,1,,1,POINT (7927233 -72508188)
2014,Marzo,Reino Unido de Gran Bretaña e Irlanda del Norte,6,7,,13,POINT (10446304 -75516486)
2014,Marzo,Reino Unido de Gran Bretaña e Irlanda del Norte,1,6,,7,POINT (3451668 -76532004)
2014,Marzo,Reino Unido de Gran Bretaña e Irlanda del Norte,89,168,,257,POINT (4697157 -74140516)
2014,Marzo,Reino Unido de Gran Bretaña e Irlanda del Norte,11,19,,30,POINT (6170465 -7542726)
2014,Marzo,República CentroÁfricana,0,1,,1,POINT (4697157 -74140516)
2014,Marzo,Federación de Rusia,0,1,,1,POINT (10886686 -74776479)
2014,Marzo,Federación de Rusia,15,34,,49,POINT (4697157 -74140516)
2014,Marzo,Federación de Rusia,2,0,,2,POINT (6170465 -7542726)
2014,Marzo,República Dominicana,0,1,,1,POINT (10406342 -75527794)
2014,Marzo,República Dominicana,7,14,,21,POINT (10446304 -75516486)
2014,Marzo,República Dominicana,7,24,,31,POINT (10886686 -74776479)
2014,Marzo,República Dominicana,0,1,,1,POINT (11247723 -74213989)
2014,Marzo,República Dominicana,4,5,,9,POINT (125862 -81702165)
2014,Marzo,República Dominicana,9,22,,31,POINT (3451668 -76532004)
2014,Marzo,República Dominicana,292,590,,882,POINT (4697157 -74140516)
2014,Marzo,República Dominicana,1,2,,3,POINT (4815189 -75736374)
2014,Marzo,República Dominicana,11,31,,42,POINT (6170465 -7542726)
2014,Marzo,Rumania,3,4,,7,POINT (4697157 -74140516)
2014,Marzo,San  Vicente y las Granadinas,0,1,,1,POINT (10446304 -75516486)
2014,Marzo,Santa Elena/Territorio Británico de Ultramar,1,0,,1,POINT (4697157 -74140516)
2014,Marzo,Senegal,0,1,,1,POINT (4697157 -74140516)
2014,Marzo,Singapur,0,1,,1,POINT (10886686 -74776479)
2014,Marzo,Singapur,3,3,,6,POINT (4697157 -74140516)
2014,Marzo,Singapur,1,0,,1,POINT (6170465 -7542726)
2014,Marzo,Sudáfrica,1,1,,2,POINT (10446304 -75516486)
2014,Marzo,Sudáfrica,3,8,,11,POINT (4697157 -74140516)
2014,Marzo,Sudáfrica,0,1,,1,POINT (6170465 -7542726)
2014,Marzo,Suecia,1,1,,2,POINT (10446304 -75516486)
2014,Marzo,Suecia,1,0,,1,POINT (3451668 -76532004)
2014,Marzo,Suecia,17,35,,52,POINT (4697157 -74140516)
2014,Marzo,Suecia,0,2,,2,POINT (6170465 -7542726)
2014,Marzo,Suiza,4,2,,6,POINT (10446304 -75516486)
2014,Marzo,Suiza,2,6,,8,POINT (3451668 -76532004)
2014,Marzo,Suiza,45,74,,119,POINT (4697157 -74140516)
2014,Marzo,Suiza,2,4,,6,POINT (6170465 -7542726)
2014,Marzo,Surinam,0,1,,1,POINT (10446304 -75516486)
2014,Marzo,Surinam,2,2,,4,POINT (4697157 -74140516)
2014,Marzo,Surinam,5,16,,21,POINT (6170465 -7542726)
2014,Marzo,Suazilandia,0,1,,1,POINT (6170465 -7542726)
2014,Marzo,Taiwán,0,1,,1,POINT (3451668 -76532004)
2014,Marzo,Taiwán,3,8,,11,POINT (4697157 -74140516)
2014,Marzo,Tailandia,3,2,,5,POINT (4697157 -74140516)
2014,Marzo,Trinidad y Tobago,1,1,,2,POINT (10446304 -75516486)
2014,Marzo,Trinidad y Tobago,0,1,,1,POINT (10886686 -74776479)
2014,Marzo,Trinidad y Tobago,0,10,,10,POINT (3451668 -76532004)
2014,Marzo,Trinidad y Tobago,2,11,,13,POINT (4697157 -74140516)
2014,Marzo,Trinidad y Tobago,0,1,,1,POINT (6170465 -7542726)
2014,Marzo,Turquía,4,14,,18,POINT (4697157 -74140516)
2014,Marzo,Ucrania,3,7,,10,POINT (4697157 -74140516)
2014,Marzo,Uganda,0,1,,1,POINT (4697157 -74140516)
2014,Marzo,Uruguay,25,19,,44,POINT (10446304 -75516486)
2014,Marzo,Uruguay,0,1,,1,POINT (10886686 -74776479)
2014,Marzo,Uruguay,41,38,,79,POINT (125862 -81702165)
2014,Marzo,Uruguay,10,12,,22,POINT (3451668 -76532004)
2014,Marzo,Uruguay,37,72,,109,POINT (4697157 -74140516)
2014,Marzo,Uruguay,1,1,,2,POINT (4815189 -75736374)
2014,Marzo,Uruguay,24,38,,62,POINT (6170465 -7542726)
2014,Marzo,Venezuela,0,2,,2,POINT (10406342 -75527794)
2014,Marzo,Venezuela,31,75,,106,POINT (10446304 -75516486)
2014,Marzo,Venezuela,22,61,,83,POINT (10886686 -74776479)
2014,Marzo,Venezuela,0,1,,1,POINT (11247723 -74213989)
2014,Marzo,Venezuela,1061,1865,,2926,POINT (11360029 -72129595)
2014,Marzo,Venezuela,2,7,,9,POINT (125862 -81702165)
2014,Marzo,Venezuela,13,27,,40,POINT (3451668 -76532004)
2014,Marzo,Venezuela,2743,3709,,6452,POINT (4697157 -74140516)
2014,Marzo,Venezuela,4,3,,7,POINT (4815189 -75736374)
2014,Marzo,Venezuela,135,214,,349,POINT (6170465 -7542726)
2014,Marzo,Venezuela,69,135,,204,POINT (6185536 -67484028)
2014,Marzo,Venezuela,85,164,,249,POINT (7088729 -70740253)
2014,Marzo,Venezuela,5,7,,12,POINT (7128047 -73181317)
2014,Marzo,Venezuela,1159,1827,,2986,POINT (7819 -72453013)
2014,Marzo,Venezuela,64,79,,143,POINT (7927233 -72508188)
2014,Marzo,Vietnam,0,1,,1,POINT (4697157 -74140516)
2014,Marzo,Islas Turcas y Caicos/Territorio Británico de Ultramar,0,1,,1,POINT (10446304 -75516486)
2014,Abril,Desconocido,5,56,,61,POINT (4697157 -74140516)
2014,Abril,Afganistán,0,1,,1,POINT (4697157 -74140516)
2014,Abril,Afganistán,1,1,,2,POINT (6170465 -7542726)
2014,Abril,Albania,1,0,,1,POINT (4697157 -74140516)
2014,Abril,Alemania,0,1,,1,POINT (10406342 -75527794)
2014,Abril,Alemania,0,8,,8,POINT (10446304 -75516486)
2014,Abril,Alemania,3,2,,5,POINT (10886686 -74776479)
2014,Abril,Alemania,9,8,,17,POINT (3451668 -76532004)
2014,Abril,Alemania,1367,2077,,3444,POINT (4697157 -74140516)
2014,Abril,Alemania,10,17,,27,POINT (6170465 -7542726)
2014,Abril,Angola,1,0,,1,POINT (3451668 -76532004)
2014,Abril,Angola,0,1,,1,POINT (4697157 -74140516)
2014,Abril,Angola,0,5,,5,POINT (6170465 -7542726)
2014,Abril,Países Bajos,2,1,,3,POINT (10446304 -75516486)
2014,Abril,Países Bajos,1,5,,6,POINT (10886686 -74776479)
2014,Abril,Países Bajos,0,1,,1,POINT (11247723 -74213989)
2014,Abril,Países Bajos,17,18,,35,POINT (3451668 -76532004)
2014,Abril,Países Bajos,33,51,,84,POINT (4697157 -74140516)
2014,Abril,Países Bajos,43,43,,86,POINT (6170465 -7542726)
2014,Abril,Países Bajos,1,1,,2,POINT (7128047 -73181317)
2014,Abril,Arabia Saudita,0,4,,4,POINT (4697157 -74140516)
2014,Abril,Arabia Saudita,0,1,,1,POINT (6170465 -7542726)
2014,Abril,Argelia,3,1,,4,POINT (4697157 -74140516)
2014,Abril,Argentina,0,2,,2,POINT (0.81488 -77356)
2014,Abril,Argentina,0,5,,5,POINT (10406342 -75527794)
2014,Abril,Argentina,225,135,,360,POINT (10446304 -75516486)
2014,Abril,Argentina,3,5,,8,POINT (10886686 -74776479)
2014,Abril,Argentina,80,77,,157,POINT (125862 -81702165)
2014,Abril,Argentina,41,67,,108,POINT (3451668 -76532004)
2014,Abril,Argentina,1760,2559,,4319,POINT (4697157 -74140516)
2014,Abril,Argentina,2,3,,5,POINT (4815189 -75736374)
2014,Abril,Argentina,104,119,,223,POINT (6170465 -7542726)
2014,Abril,Argentina,1,0,,1,POINT (7128047 -73181317)
2014,Abril,Aruba,76,63,,139,POINT (10406342 -75527794)
2014,Abril,Aruba,5,4,,9,POINT (10446304 -75516486)
2014,Abril,Aruba,2,2,,4,POINT (10886686 -74776479)
2014,Abril,Aruba,2,4,,6,POINT (11247723 -74213989)
2014,Abril,Aruba,3,1,,4,POINT (1152863 -72919186)
2014,Abril,Aruba,3,6,,9,POINT (3451668 -76532004)
2014,Abril,Aruba,542,633,,1175,POINT (4697157 -74140516)
2014,Abril,Aruba,7,11,,18,POINT (6170465 -7542726)
2014,Abril,Aruba,2,2,,4,POINT (7128047 -73181317)
2014,Abril,Australia,0,3,,3,POINT (10446304 -75516486)
2014,Abril,Australia,1,1,,2,POINT (10886686 -74776479)
2014,Abril,Australia,3,2,,5,POINT (3451668 -76532004)
2014,Abril,Australia,14,25,,39,POINT (4697157 -74140516)
2014,Abril,Australia,1,1,,2,POINT (4815189 -75736374)
2014,Abril,Australia,5,6,,11,POINT (6170465 -7542726)
2014,Abril,Austria,2,3,,5,POINT (10446304 -75516486)
2014,Abril,Austria,0,1,,1,POINT (3451668 -76532004)
2014,Abril,Austria,22,27,,49,POINT (4697157 -74140516)
2014,Abril,Austria,2,3,,5,POINT (6170465 -7542726)
2014,Abril,Azerbaiyán,1,0,,1,POINT (10446304 -75516486)
2014,Abril,Bahamas,0,2,,2,POINT (10886686 -74776479)
2014,Abril,Bahamas,0,1,,1,POINT (3451668 -76532004)
2014,Abril,Bahamas,2,15,,17,POINT (6170465 -7542726)
2014,Abril,Bahréin,1,0,,1,POINT (4697157 -74140516)
2014,Abril,Bangladesh,0,1,,1,POINT (4697157 -74140516)
2014,Abril,Bangladesh,0,2,,2,POINT (6170465 -7542726)
2014,Abril,Barbados,2,0,,2,POINT (10446304 -75516486)
2014,Abril,Barbados,0,1,,1,POINT (4697157 -74140516)
2014,Abril,República de Belarús,1,0,,1,POINT (11360029 -72129595)
2014,Abril,República de Belarús,1,0,,1,POINT (4697157 -74140516)
2014,Abril,República de Belarús,0,1,,1,POINT (7819 -72453013)
2014,Abril,Bélgica,0,4,,4,POINT (10886686 -74776479)
2014,Abril,Bélgica,0,1,,1,POINT (11247723 -74213989)
2014,Abril,Bélgica,1,6,,7,POINT (3451668 -76532004)
2014,Abril,Bélgica,16,40,,56,POINT (4697157 -74140516)
2014,Abril,Bélgica,4,4,,8,POINT (6170465 -7542726)
2014,Abril,Belice,1,4,,5,POINT (10446304 -75516486)
2014,Abril,Belice,0,1,,1,POINT (4697157 -74140516)
2014,Abril,Belice,0,1,,1,POINT (6170465 -7542726)
2014,Abril,Bolivia,4,2,,6,POINT (10446304 -75516486)
2014,Abril,Bolivia,1,1,,2,POINT (10886686 -74776479)
2014,Abril,Bolivia,9,4,,13,POINT (125862 -81702165)
2014,Abril,Bolivia,10,13,,23,POINT (3451668 -76532004)
2014,Abril,Bolivia,207,339,,546,POINT (4697157 -74140516)
2014,Abril,Bolivia,0,1,,1,POINT (4815189 -75736374)
2014,Abril,Bolivia,26,30,,56,POINT (6170465 -7542726)
2014,Abril,Botsuana,0,1,,1,POINT (6170465 -7542726)
2014,Abril,Brasil,106,124,,230,POINT (-4191162 -69941498)
2014,Abril,Brasil,113,80,,193,POINT (10446304 -75516486)
2014,Abril,Brasil,3,8,,11,POINT (10886686 -74776479)
2014,Abril,Brasil,64,48,,112,POINT (125862 -81702165)
2014,Abril,Brasil,20,51,,71,POINT (3451668 -76532004)
2014,Abril,Brasil,3158,4872,,8030,POINT (4697157 -74140516)
2014,Abril,Brasil,4,2,,6,POINT (4815189 -75736374)
2014,Abril,Brasil,98,166,,264,POINT (6170465 -7542726)
2014,Abril,Brunei Darussalam,0,1,,1,POINT (4697157 -74140516)
2014,Abril,Bulgaria,0,1,,1,POINT (10446304 -75516486)
2014,Abril,Bulgaria,0,1,,1,POINT (4697157 -74140516)
2014,Abril,Burkina Faso,2,1,,3,POINT (4697157 -74140516)
2014,Abril,Burundi,0,2,,2,POINT (3451668 -76532004)
2014,Abril,Bután,0,2,,2,POINT (6170465 -7542726)
2014,Abril,Cabo Verde,5,6,,11,POINT (10446304 -75516486)
2014,Abril,Cabo Verde,0,1,,1,POINT (4697157 -74140516)
2014,Abril,Islas Caimán/Territorio Británico de Ultramar,7,28,,35,POINT (125862 -81702165)
2014,Abril,Camboya,0,1,,1,POINT (4697157 -74140516)
2014,Abril,Camerún,0,2,,2,POINT (4697157 -74140516)
2014,Abril,Camerún,1,2,,3,POINT (6170465 -7542726)
2014,Abril,Canadá,10,15,,25,POINT (10446304 -75516486)
2014,Abril,Canadá,8,8,,16,POINT (10886686 -74776479)
2014,Abril,Canadá,2,1,,3,POINT (125862 -81702165)
2014,Abril,Canadá,14,24,,38,POINT (3451668 -76532004)
2014,Abril,Canadá,478,718,,1196,POINT (4697157 -74140516)
2014,Abril,Canadá,0,2,,2,POINT (4815189 -75736374)
2014,Abril,Canadá,29,62,,91,POINT (6170465 -7542726)
2014,Abril,Chad,0,1,,1,POINT (4697157 -74140516)
2014,Abril,España,4,5,,9,POINT (10446304 -75516486)
2014,Abril,España,0,4,,4,POINT (10886686 -74776479)
2014,Abril,España,192,362,,554,POINT (3451668 -76532004)
2014,Abril,España,2525,5035,,7560,POINT (4697157 -74140516)
2014,Abril,España,170,362,,532,POINT (6170465 -7542726)
2014,Abril,República de Corea,0,3,,3,POINT (10446304 -75516486)
2014,Abril,República de Corea,0,1,,1,POINT (3451668 -76532004)
2014,Abril,República de Corea,8,18,,26,POINT (4697157 -74140516)
2014,Abril,República de Corea,3,3,,6,POINT (6170465 -7542726)
2014,Abril,Costa de Marfil,2,7,,9,POINT (4697157 -74140516)
2014,Abril,Costa Rica,0,15,,15,POINT (10406342 -75527794)
2014,Abril,Costa Rica,11,12,,23,POINT (10446304 -75516486)
2014,Abril,Costa Rica,7,14,,21,POINT (10886686 -74776479)
2014,Abril,Costa Rica,226,176,,402,POINT (125862 -81702165)
2014,Abril,Costa Rica,13,29,,42,POINT (3451668 -76532004)
2014,Abril,Costa Rica,590,1034,,1624,POINT (4697157 -74140516)
2014,Abril,Costa Rica,1,5,,6,POINT (4815189 -75736374)
2014,Abril,Costa Rica,34,62,,96,POINT (6170465 -7542726)
2014,Abril,Costa Rica,1,0,,1,POINT (7927233 -72508188)
2014,Abril,Croacia,4,22,,26,POINT (4697157 -74140516)
2014,Abril,Cuba,2,3,,5,POINT (10446304 -75516486)
2014,Abril,Cuba,3,8,,11,POINT (10886686 -74776479)
2014,Abril,Cuba,0,2,,2,POINT (10970933 -74765343)
2014,Abril,Cuba,20,53,,73,POINT (3451668 -76532004)
2014,Abril,Cuba,131,225,,356,POINT (4697157 -74140516)
2014,Abril,Cuba,1,7,,8,POINT (4815189 -75736374)
2014,Abril,Cuba,9,12,,21,POINT (6170465 -7542726)
2014,Abril,Curazao,2,2,,4,POINT (10406342 -75527794)
2014,Abril,Curazao,0,2,,2,POINT (10446304 -75516486)
2014,Abril,Curazao,2,0,,2,POINT (10886686 -74776479)
2014,Abril,Curazao,7,11,,18,POINT (11247723 -74213989)
2014,Abril,Curazao,0,9,,9,POINT (125862 -81702165)
2014,Abril,Curazao,3,1,,4,POINT (3451668 -76532004)
2014,Abril,Curazao,207,255,,462,POINT (4697157 -74140516)
2014,Abril,Curazao,232,269,,501,POINT (6170465 -7542726)
2014,Abril,República Checa,0,2,,2,POINT (10446304 -75516486)
2014,Abril,República Checa,7,9,,16,POINT (4697157 -74140516)
2014,Abril,República Checa,1,0,,1,POINT (6170465 -7542726)
2014,Abril,Chile,32,23,,55,POINT (10446304 -75516486)
2014,Abril,Chile,2,7,,9,POINT (10886686 -74776479)
2014,Abril,Chile,50,42,,92,POINT (125862 -81702165)
2014,Abril,Chile,39,72,,111,POINT (3451668 -76532004)
2014,Abril,Chile,2644,3623,,6267,POINT (4697157 -74140516)
2014,Abril,Chile,0,5,,5,POINT (4815189 -75736374)
2014,Abril,Chile,64,114,,178,POINT (6170465 -7542726)
2014,Abril,Chile,0,1,,1,POINT (7128047 -73181317)
2014,Abril,China,0,1,,1,POINT (10446304 -75516486)
2014,Abril,China,1,1,,2,POINT (3451668 -76532004)
2014,Abril,China,0,1,,1,POINT (3884426 -77061029)
2014,Abril,China,31,120,,151,POINT (4697157 -74140516)
2014,Abril,China,2,8,,10,POINT (6170465 -7542726)
2014,Abril,Dinamarca,0,1,,1,POINT (10446304 -75516486)
2014,Abril,Dinamarca,0,1,,1,POINT (10886686 -74776479)
2014,Abril,Dinamarca,0,1,,1,POINT (3451668 -76532004)
2014,Abril,Dinamarca,8,10,,18,POINT (4697157 -74140516)
2014,Abril,Dinamarca,2,0,,2,POINT (6170465 -7542726)
2014,Abril,Dominica,0,1,,1,POINT (10446304 -75516486)
2014,Abril,Ecuador,46,78,,124,POINT (0.33002 -76876446)
2014,Abril,Ecuador,2391,3762,,6153,POINT (0.81488 -77356)
2014,Abril,Ecuador,3,20,,23,POINT (1800143 -78802679)
2014,Abril,Ecuador,2,10,,12,POINT (10446304 -75516486)
2014,Abril,Ecuador,3,10,,13,POINT (10886686 -74776479)
2014,Abril,Ecuador,14,12,,26,POINT (125862 -81702165)
2014,Abril,Ecuador,562,588,,1150,POINT (3451668 -76532004)
2014,Abril,Ecuador,2618,3861,,6479,POINT (4697157 -74140516)
2014,Abril,Ecuador,0,3,,3,POINT (4815189 -75736374)
2014,Abril,Ecuador,475,486,,961,POINT (6170465 -7542726)
2014,Abril,Ecuador,49,47,,96,POINT (6222552 -77401154)
2014,Abril,Ecuador,1,0,,1,POINT (7128047 -73181317)
2014,Abril,Egipto,0,1,,1,POINT (3451668 -76532004)
2014,Abril,Egipto,2,2,,4,POINT (4697157 -74140516)
2014,Abril,El Salvador,1,3,,4,POINT (10446304 -75516486)
2014,Abril,El Salvador,0,6,,6,POINT (10886686 -74776479)
2014,Abril,El Salvador,10,13,,23,POINT (125862 -81702165)
2014,Abril,El Salvador,70,133,,203,POINT (3451668 -76532004)
2014,Abril,El Salvador,634,1033,,1667,POINT (4697157 -74140516)
2014,Abril,El Salvador,103,175,,278,POINT (6170465 -7542726)
2014,Abril,Emiratos Árabes,0,1,,1,POINT (3451668 -76532004)
2014,Abril,Emiratos Árabes,1,5,,6,POINT (4697157 -74140516)
2014,Abril,Emiratos Árabes,1,0,,1,POINT (6170465 -7542726)
2014,Abril,Eritrea,0,1,,1,POINT (3451668 -76532004)
2014,Abril,Eslovaquia,1,0,,1,POINT (125862 -81702165)
2014,Abril,Eslovaquia,0,2,,2,POINT (3451668 -76532004)
2014,Abril,Eslovaquia,1,1,,2,POINT (4697157 -74140516)
2014,Abril,Eslovenia,5,4,,9,POINT (4697157 -74140516)
2014,Abril,Estados Unidos de América,6,25,,31,POINT (10406342 -75527794)
2014,Abril,Estados Unidos de América,1083,1760,,2843,POINT (10446304 -75516486)
2014,Abril,Estados Unidos de América,205,383,,588,POINT (10886686 -74776479)
2014,Abril,Estados Unidos de América,0,14,,14,POINT (10970933 -74765343)
2014,Abril,Estados Unidos de América,1,16,,17,POINT (11247723 -74213989)
2014,Abril,Estados Unidos de América,4,11,,15,POINT (125862 -81702165)
2014,Abril,Estados Unidos de América,601,1019,,1620,POINT (3451668 -76532004)
2014,Abril,Estados Unidos de América,0,4,,4,POINT (3884426 -77061029)
2014,Abril,Estados Unidos de América,79,105,,184,POINT (445285 -75766353)
2014,Abril,Estados Unidos de América,5964,11542,,17506,POINT (4697157 -74140516)
2014,Abril,Estados Unidos de América,62,69,,131,POINT (4815189 -75736374)
2014,Abril,Estados Unidos de América,1522,3332,,4854,POINT (6170465 -7542726)
2014,Abril,Estados Unidos de América,7,19,,26,POINT (7128047 -73181317)
2014,Abril,Estados Unidos de América,3,4,,7,POINT (7927233 -72508188)
2014,Abril,Estonia,1,1,,2,POINT (4697157 -74140516)
2014,Abril,Etiopia,0,1,,1,POINT (3451668 -76532004)
2014,Abril,Etiopia,0,2,,2,POINT (4697157 -74140516)
2014,Abril,Etiopia,1,4,,5,POINT (6170465 -7542726)
2014,Abril,Islas Fiji,1,2,,3,POINT (6170465 -7542726)
2014,Abril,Filipinas,1,5,,6,POINT (10886686 -74776479)
2014,Abril,Filipinas,2,4,,6,POINT (3451668 -76532004)
2014,Abril,Filipinas,3,10,,13,POINT (4697157 -74140516)
2014,Abril,Filipinas,1,2,,3,POINT (6170465 -7542726)
2014,Abril,Finlandia,2,5,,7,POINT (10446304 -75516486)
2014,Abril,Finlandia,1,1,,2,POINT (3451668 -76532004)
2014,Abril,Finlandia,1,4,,5,POINT (4697157 -74140516)
2014,Abril,Francia,2,1,,3,POINT (10446304 -75516486)
2014,Abril,Francia,12,19,,31,POINT (3451668 -76532004)
2014,Abril,Francia,1082,1947,,3029,POINT (4697157 -74140516)
2014,Abril,Francia,17,23,,40,POINT (6170465 -7542726)
2014,Abril,Ghana,0,11,,11,POINT (4697157 -74140516)
2014,Abril,Ghana,5,9,,14,POINT (6170465 -7542726)
2014,Abril,Granada,0,1,,1,POINT (10446304 -75516486)
2014,Abril,Grecia,0,1,,1,POINT (3451668 -76532004)
2014,Abril,Grecia,0,2,,2,POINT (3884426 -77061029)
2014,Abril,Grecia,3,4,,7,POINT (4697157 -74140516)
2014,Abril,Guatemala,12,22,,34,POINT (10446304 -75516486)
2014,Abril,Guatemala,0,2,,2,POINT (10886686 -74776479)
2014,Abril,Guatemala,16,19,,35,POINT (125862 -81702165)
2014,Abril,Guatemala,16,51,,67,POINT (3451668 -76532004)
2014,Abril,Guatemala,0,1,,1,POINT (3884426 -77061029)
2014,Abril,Guatemala,168,309,,477,POINT (4697157 -74140516)
2014,Abril,Guatemala,2,1,,3,POINT (4815189 -75736374)
2014,Abril,Guatemala,16,28,,44,POINT (6170465 -7542726)
2014,Abril,Guyana,2,0,,2,POINT (4697157 -74140516)
2014,Abril,Guyana,1,2,,3,POINT (6170465 -7542726)
2014,Abril,Guadalupe/Territorio Francés,1,2,,3,POINT (4697157 -74140516)
2014,Abril,Haití,2,3,,5,POINT (4697157 -74140516)
2014,Abril,Haití,1,2,,3,POINT (6170465 -7542726)
2014,Abril,Honduras,0,7,,7,POINT (10406342 -75527794)
2014,Abril,Honduras,5,6,,11,POINT (10446304 -75516486)
2014,Abril,Honduras,3,1,,4,POINT (10886686 -74776479)
2014,Abril,Honduras,0,1,,1,POINT (10970933 -74765343)
2014,Abril,Honduras,4,9,,13,POINT (133387613 -81372937)
2014,Abril,Honduras,7,7,,14,POINT (3451668 -76532004)
2014,Abril,Honduras,43,33,,76,POINT (4697157 -74140516)
2014,Abril,Honduras,0,1,,1,POINT (4815189 -75736374)
2014,Abril,Honduras,13,17,,30,POINT (6170465 -7542726)
2014,Abril,Hong Kong,0,1,,1,POINT (6170465 -7542726)
2014,Abril,Hungría,0,1,,1,POINT (4697157 -74140516)
2014,Abril,India,0,3,,3,POINT (10446304 -75516486)
2014,Abril,India,0,1,,1,POINT (10886686 -74776479)
2014,Abril,India,1,0,,1,POINT (3451668 -76532004)
2014,Abril,India,4,20,,24,POINT (4697157 -74140516)
2014,Abril,India,0,1,,1,POINT (4815189 -75736374)
2014,Abril,India,6,4,,10,POINT (6170465 -7542726)
2014,Abril,Indonesia,2,1,,3,POINT (10446304 -75516486)
2014,Abril,Indonesia,0,1,,1,POINT (3451668 -76532004)
2014,Abril,Indonesia,0,4,,4,POINT (4697157 -74140516)
2014,Abril,Indonesia,3,4,,7,POINT (6170465 -7542726)
2014,Abril,República de Irlanda,2,1,,3,POINT (10446304 -75516486)
2014,Abril,República de Irlanda,0,3,,3,POINT (11247723 -74213989)
2014,Abril,República de Irlanda,0,1,,1,POINT (125862 -81702165)
2014,Abril,República de Irlanda,0,1,,1,POINT (3451668 -76532004)
2014,Abril,República de Irlanda,4,8,,12,POINT (4697157 -74140516)
2014,Abril,República de Irlanda,0,1,,1,POINT (4815189 -75736374)
2014,Abril,República de Irlanda,1,0,,1,POINT (6170465 -7542726)
2014,Abril,Islandia,1,0,,1,POINT (4697157 -74140516)
2014,Abril,Israel,0,2,,2,POINT (10446304 -75516486)
2014,Abril,Israel,0,1,,1,POINT (10886686 -74776479)
2014,Abril,Israel,1,4,,5,POINT (3451668 -76532004)
2014,Abril,Israel,17,59,,76,POINT (4697157 -74140516)
2014,Abril,Israel,1,2,,3,POINT (6170465 -7542726)
2014,Abril,Italia,1,4,,5,POINT (10446304 -75516486)
2014,Abril,Italia,0,2,,2,POINT (10886686 -74776479)
2014,Abril,Italia,0,7,,7,POINT (3451668 -76532004)
2014,Abril,Italia,65,194,,259,POINT (4697157 -74140516)
2014,Abril,Italia,7,14,,21,POINT (6170465 -7542726)
2014,Abril,Jamaica,0,2,,2,POINT (10406342 -75527794)
2014,Abril,Jamaica,1,2,,3,POINT (10446304 -75516486)
2014,Abril,Jamaica,0,3,,3,POINT (3451668 -76532004)
2014,Abril,Jamaica,0,3,,3,POINT (4697157 -74140516)
2014,Abril,Jamaica,1,2,,3,POINT (6170465 -7542726)
2014,Abril,Japón,0,1,,1,POINT (10446304 -75516486)
2014,Abril,Japón,2,5,,7,POINT (3451668 -76532004)
2014,Abril,Japón,11,17,,28,POINT (4697157 -74140516)
2014,Abril,Japón,0,1,,1,POINT (4815189 -75736374)
2014,Abril,Japón,2,9,,11,POINT (6170465 -7542726)
2014,Abril,Kazajistán,1,0,,1,POINT (4697157 -74140516)
2014,Abril,Kenia,3,2,,5,POINT (3451668 -76532004)
2014,Abril,Kenia,4,6,,10,POINT (4697157 -74140516)
2014,Abril,Kenia,8,15,,23,POINT (6170465 -7542726)
2014,Abril,Kiribati,2,0,,2,POINT (6170465 -7542726)
2014,Abril,Lesoto,1,0,,1,POINT (4697157 -74140516)
2014,Abril,Lituania,0,1,,1,POINT (4697157 -74140516)
2014,Abril,Líbano,1,4,,5,POINT (4697157 -74140516)
2014,Abril,Líbano,0,1,,1,POINT (6170465 -7542726)
2014,Abril,Libia,0,2,,2,POINT (3451668 -76532004)
2014,Abril,Liechtenstein,2,0,,2,POINT (4697157 -74140516)
2014,Abril,Luxemburgo,0,1,,1,POINT (6170465 -7542726)
2014,Abril,Madagascar,1,1,,2,POINT (6170465 -7542726)
2014,Abril,Malasia,1,3,,4,POINT (4697157 -74140516)
2014,Abril,Marruecos,0,2,,2,POINT (3451668 -76532004)
2014,Abril,Marruecos,1,1,,2,POINT (6170465 -7542726)
2014,Abril,México,0,1,,1,POINT (10406342 -75527794)
2014,Abril,México,43,51,,94,POINT (10446304 -75516486)
2014,Abril,México,17,33,,50,POINT (10886686 -74776479)
2014,Abril,México,0,1,,1,POINT (10970933 -74765343)
2014,Abril,México,0,1,,1,POINT (11247723 -74213989)
2014,Abril,México,5,3,,8,POINT (125862 -81702165)
2014,Abril,México,31,85,,116,POINT (3451668 -76532004)
2014,Abril,México,0,2,,2,POINT (3884426 -77061029)
2014,Abril,México,3227,5629,,8856,POINT (4697157 -74140516)
2014,Abril,México,2,4,,6,POINT (4815189 -75736374)
2014,Abril,México,105,260,,365,POINT (6170465 -7542726)
2014,Abril,México,5,3,,8,POINT (7128047 -73181317)
2014,Abril,México,1,1,,2,POINT (7927233 -72508188)
2014,Abril,Mozambique,0,1,,1,POINT (4697157 -74140516)
2014,Abril,Mozambique,1,1,,2,POINT (6170465 -7542726)
2014,Abril,Myanmar,0,1,,1,POINT (4697157 -74140516)
2014,Abril,Myanmar,1,5,,6,POINT (6170465 -7542726)
2014,Abril,Nauru,1,0,,1,POINT (10406342 -75527794)
2014,Abril,Namibia,0,2,,2,POINT (4697157 -74140516)
2014,Abril,Nepal,0,3,,3,POINT (4697157 -74140516)
2014,Abril,Nicaragua,1,6,,7,POINT (10446304 -75516486)
2014,Abril,Nicaragua,0,2,,2,POINT (10886686 -74776479)
2014,Abril,Nicaragua,0,1,,1,POINT (125862 -81702165)
2014,Abril,Nicaragua,1,4,,5,POINT (3451668 -76532004)
2014,Abril,Nicaragua,13,18,,31,POINT (4697157 -74140516)
2014,Abril,Nicaragua,0,1,,1,POINT (4815189 -75736374)
2014,Abril,Nicaragua,6,6,,12,POINT (6170465 -7542726)
2014,Abril,Nigeria,1,1,,2,POINT (3451668 -76532004)
2014,Abril,Nigeria,1,5,,6,POINT (4697157 -74140516)
2014,Abril,Nigeria,0,1,,1,POINT (6170465 -7542726)
2014,Abril,Níger,0,1,,1,POINT (4697157 -74140516)
2014,Abril,Noruega,1,0,,1,POINT (10446304 -75516486)
2014,Abril,Noruega,1,2,,3,POINT (3451668 -76532004)
2014,Abril,Noruega,14,7,,21,POINT (4697157 -74140516)
2014,Abril,Noruega,2,4,,6,POINT (6170465 -7542726)
2014,Abril,Nueva Zelanda,1,0,,1,POINT (10886686 -74776479)
2014,Abril,Nueva Zelanda,0,3,,3,POINT (3451668 -76532004)
2014,Abril,Nueva Zelanda,2,6,,8,POINT (4697157 -74140516)
2014,Abril,Nueva Zelanda,0,1,,1,POINT (6170465 -7542726)
2014,Abril,Panamá,603,685,,1288,POINT (10406342 -75527794)
2014,Abril,Panamá,1853,2169,,4022,POINT (10446304 -75516486)
2014,Abril,Panamá,161,356,,517,POINT (10886686 -74776479)
2014,Abril,Panamá,0,15,,15,POINT (10970933 -74765343)
2014,Abril,Panamá,0,1,,1,POINT (11247723 -74213989)
2014,Abril,Panamá,1121,956,,2077,POINT (125862 -81702165)
2014,Abril,Panamá,19,28,,47,POINT (133387613 -81372937)
2014,Abril,Panamá,301,582,,883,POINT (3451668 -76532004)
2014,Abril,Panamá,0,48,,48,POINT (3884426 -77061029)
2014,Abril,Panamá,1977,3607,,5584,POINT (4697157 -74140516)
2014,Abril,Panamá,71,140,,211,POINT (4815189 -75736374)
2014,Abril,Panamá,566,1289,,1855,POINT (6170465 -7542726)
2014,Abril,Panamá,2,1,,3,POINT (6222552 -77401154)
2014,Abril,Panamá,1,4,,5,POINT (7102626 -77762647)
2014,Abril,Panamá,46,61,,107,POINT (7128047 -73181317)
2014,Abril,Panamá,78,97,,175,POINT (7927233 -72508188)
2014,Abril,Panamá,0,3,,3,POINT (806667 -767333)
2014,Abril,Panamá,1,3,,4,POINT (863337 -7735002)
2014,Abril,Paraguay,7,6,,13,POINT (10446304 -75516486)
2014,Abril,Paraguay,1,0,,1,POINT (10886686 -74776479)
2014,Abril,Paraguay,17,9,,26,POINT (125862 -81702165)
2014,Abril,Paraguay,4,7,,11,POINT (3451668 -76532004)
2014,Abril,Paraguay,16,13,,29,POINT (4697157 -74140516)
2014,Abril,Paraguay,9,19,,28,POINT (6170465 -7542726)
2014,Abril,Perú,123,143,,266,POINT (-4191162 -69941498)
2014,Abril,Perú,0,2,,2,POINT (0.81488 -77356)
2014,Abril,Perú,46,31,,77,POINT (10446304 -75516486)
2014,Abril,Perú,7,11,,18,POINT (10886686 -74776479)
2014,Abril,Perú,176,111,,287,POINT (125862 -81702165)
2014,Abril,Perú,191,339,,530,POINT (3451668 -76532004)
2014,Abril,Perú,3737,5538,,9275,POINT (4697157 -74140516)
2014,Abril,Perú,3,3,,6,POINT (4815189 -75736374)
2014,Abril,Perú,384,708,,1092,POINT (6170465 -7542726)
2014,Abril,Perú,2,1,,3,POINT (7128047 -73181317)
2014,Abril,Palestina,1,1,,2,POINT (4697157 -74140516)
2014,Abril,Polonia,3,2,,5,POINT (10446304 -75516486)
2014,Abril,Polonia,10,11,,21,POINT (4697157 -74140516)
2014,Abril,Portugal,0,2,,2,POINT (3451668 -76532004)
2014,Abril,Portugal,14,33,,47,POINT (4697157 -74140516)
2014,Abril,Portugal,0,3,,3,POINT (6170465 -7542726)
2014,Abril,Puerto Rico/Territorio de Estados Unidos,5,36,,41,POINT (10446304 -75516486)
2014,Abril,Puerto Rico/Territorio de Estados Unidos,6,20,,26,POINT (10886686 -74776479)
2014,Abril,Puerto Rico/Territorio de Estados Unidos,1,1,,2,POINT (11247723 -74213989)
2014,Abril,Puerto Rico/Territorio de Estados Unidos,24,63,,87,POINT (3451668 -76532004)
2014,Abril,Puerto Rico/Territorio de Estados Unidos,188,236,,424,POINT (4697157 -74140516)
2014,Abril,Puerto Rico/Territorio de Estados Unidos,0,5,,5,POINT (4815189 -75736374)
2014,Abril,Puerto Rico/Territorio de Estados Unidos,36,57,,93,POINT (6170465 -7542726)
2014,Abril,Puerto Rico/Territorio de Estados Unidos,3,1,,4,POINT (7128047 -73181317)
2014,Abril,Reino Unido de Gran Bretaña e Irlanda del Norte,4,6,,10,POINT (10446304 -75516486)
2014,Abril,Reino Unido de Gran Bretaña e Irlanda del Norte,2,2,,4,POINT (10886686 -74776479)
2014,Abril,Reino Unido de Gran Bretaña e Irlanda del Norte,4,17,,21,POINT (3451668 -76532004)
2014,Abril,Reino Unido de Gran Bretaña e Irlanda del Norte,109,205,,314,POINT (4697157 -74140516)
2014,Abril,Reino Unido de Gran Bretaña e Irlanda del Norte,18,27,,45,POINT (6170465 -7542726)
2014,Abril,Federación de Rusia,9,18,,27,POINT (4697157 -74140516)
2014,Abril,Federación de Rusia,3,1,,4,POINT (6170465 -7542726)
2014,Abril,República Dominicana,0,1,,1,POINT (10406342 -75527794)
2014,Abril,República Dominicana,7,11,,18,POINT (10446304 -75516486)
2014,Abril,República Dominicana,9,31,,40,POINT (10886686 -74776479)
2014,Abril,República Dominicana,0,2,,2,POINT (10970933 -74765343)
2014,Abril,República Dominicana,0,2,,2,POINT (11117206 -74232675)
2014,Abril,República Dominicana,3,5,,8,POINT (125862 -81702165)
2014,Abril,República Dominicana,6,14,,20,POINT (3451668 -76532004)
2014,Abril,República Dominicana,352,593,,945,POINT (4697157 -74140516)
2014,Abril,República Dominicana,5,7,,12,POINT (4815189 -75736374)
2014,Abril,República Dominicana,20,45,,65,POINT (6170465 -7542726)
2014,Abril,República Democrática Popular de Corea,0,1,,1,POINT (4697157 -74140516)
2014,Abril,Rumania,2,1,,3,POINT (4697157 -74140516)
2014,Abril,Rumania,0,1,,1,POINT (6170465 -7542726)
2014,Abril,Samoa Occidental,1,1,,2,POINT (6170465 -7542726)
2014,Abril,San  Vicente y las Granadinas,1,1,,2,POINT (11247723 -74213989)
2014,Abril,Senegal,0,1,,1,POINT (6170465 -7542726)
2014,Abril,Serbia,0,2,,2,POINT (4697157 -74140516)
2014,Abril,Singapur,1,2,,3,POINT (4697157 -74140516)
2014,Abril,Sudáfrica,0,1,,1,POINT (3451668 -76532004)
2014,Abril,Sudáfrica,9,7,,16,POINT (4697157 -74140516)
2014,Abril,Sudáfrica,4,8,,12,POINT (6170465 -7542726)
2014,Abril,Sudán,2,2,,4,POINT (4697157 -74140516)
2014,Abril,Sudán,2,2,,4,POINT (6170465 -7542726)
2014,Abril,Suecia,1,3,,4,POINT (10446304 -75516486)
2014,Abril,Suecia,3,0,,3,POINT (3451668 -76532004)
2014,Abril,Suecia,12,33,,45,POINT (4697157 -74140516)
2014,Abril,Suecia,6,10,,16,POINT (6170465 -7542726)
2014,Abril,Suiza,1,2,,3,POINT (10446304 -75516486)
2014,Abril,Suiza,2,6,,8,POINT (3451668 -76532004)
2014,Abril,Suiza,58,65,,123,POINT (4697157 -74140516)
2014,Abril,Suiza,3,6,,9,POINT (6170465 -7542726)
2014,Abril,Surinam,0,1,,1,POINT (10406342 -75527794)
2014,Abril,Surinam,1,4,,5,POINT (4697157 -74140516)
2014,Abril,Surinam,1,2,,3,POINT (6170465 -7542726)
2014,Abril,Taiwán,2,1,,3,POINT (4697157 -74140516)
2014,Abril,Taiwán,0,2,,2,POINT (4815189 -75736374)
2014,Abril,Taiwán,1,0,,1,POINT (7128047 -73181317)
2014,Abril,Tailandia,1,1,,2,POINT (4697157 -74140516)
2014,Abril,Tailandia,1,0,,1,POINT (6170465 -7542726)
2014,Abril,Tanzania,0,4,,4,POINT (3451668 -76532004)
2014,Abril,Tanzania,0,2,,2,POINT (4697157 -74140516)
2014,Abril,Tanzania,3,2,,5,POINT (6170465 -7542726)
2014,Abril,Togo,0,2,,2,POINT (4697157 -74140516)
2014,Abril,Togo,0,1,,1,POINT (6170465 -7542726)
2014,Abril,Trinidad y Tobago,0,2,,2,POINT (10406342 -75527794)
2014,Abril,Trinidad y Tobago,1,0,,1,POINT (10446304 -75516486)
2014,Abril,Trinidad y Tobago,1,1,,2,POINT (10886686 -74776479)
2014,Abril,Trinidad y Tobago,0,1,,1,POINT (11117206 -74232675)
2014,Abril,Trinidad y Tobago,2,5,,7,POINT (3451668 -76532004)
2014,Abril,Trinidad y Tobago,4,13,,17,POINT (4697157 -74140516)
2014,Abril,Trinidad y Tobago,4,4,,8,POINT (6170465 -7542726)
2014,Abril,Túnez,1,0,,1,POINT (6170465 -7542726)
2014,Abril,Turquía,0,1,,1,POINT (3451668 -76532004)
2014,Abril,Turquía,3,8,,11,POINT (4697157 -74140516)
2014,Abril,Turquía,1,1,,2,POINT (6170465 -7542726)
2014,Abril,Ucrania,2,5,,7,POINT (4697157 -74140516)
2014,Abril,Ucrania,1,2,,3,POINT (6170465 -7542726)
2014,Abril,Uganda,0,2,,2,POINT (4697157 -74140516)
2014,Abril,Uganda,0,1,,1,POINT (6170465 -7542726)
2014,Abril,Uruguay,22,18,,40,POINT (10446304 -75516486)
2014,Abril,Uruguay,2,2,,4,POINT (10886686 -74776479)
2014,Abril,Uruguay,17,14,,31,POINT (125862 -81702165)
2014,Abril,Uruguay,2,11,,13,POINT (3451668 -76532004)
2014,Abril,Uruguay,31,59,,90,POINT (4697157 -74140516)
2014,Abril,Uruguay,20,51,,71,POINT (6170465 -7542726)
2014,Abril,Venezuela,0,9,,9,POINT (10406342 -75527794)
2014,Abril,Venezuela,14,58,,72,POINT (10446304 -75516486)
2014,Abril,Venezuela,18,73,,91,POINT (10886686 -74776479)
2014,Abril,Venezuela,0,2,,2,POINT (10970933 -74765343)
2014,Abril,Venezuela,0,2,,2,POINT (11247723 -74213989)
2014,Abril,Venezuela,1885,2916,,4801,POINT (11360029 -72129595)
2014,Abril,Venezuela,4,5,,9,POINT (125862 -81702165)
2014,Abril,Venezuela,9,18,,27,POINT (3451668 -76532004)
2014,Abril,Venezuela,3862,4057,,7919,POINT (4697157 -74140516)
2014,Abril,Venezuela,5,8,,13,POINT (4815189 -75736374)
2014,Abril,Venezuela,260,317,,577,POINT (6170465 -7542726)
2014,Abril,Venezuela,21,34,,55,POINT (6185536 -67484028)
2014,Abril,Venezuela,65,124,,189,POINT (7088729 -70740253)
2014,Abril,Venezuela,4,13,,17,POINT (7128047 -73181317)
2014,Abril,Venezuela,1845,2486,,4331,POINT (7819 -72453013)
2014,Abril,Venezuela,119,134,,253,POINT (7927233 -72508188)
2014,Abril,República Árabe de Yemen,1,1,,2,POINT (4697157 -74140516)
2014,Abril,Zambia,0,1,,1,POINT (4697157 -74140516)
2014,Abril,Zimbabue,0,1,,1,POINT (6170465 -7542726)
2014,Abril,Desconocido,1,4,,5,POINT (10406342 -75527794)
2014,Abril,Desconocido,8,34,,42,POINT (125744111 -81703935)
2014,Abril,Desconocido,1,1,,2,POINT (125862 -81702165)
2014,Abril,Desconocido,0,1,,1,POINT (3884426 -77061029)
2014,Abril,Desconocido,0,6,,6,POINT (4697157 -74140516)
2014,Abril,Desconocido,3,11,,14,POINT (6170465 -7542726)
2014,Mayo,Albania,2,0,,2,POINT (4697157 -74140516)
2014,Mayo,Alemania,1,2,,3,POINT (10446304 -75516486)
2014,Mayo,Alemania,1,1,,2,POINT (10886686 -74776479)
2014,Mayo,Alemania,5,9,,14,POINT (3451668 -76532004)
2014,Mayo,Alemania,957,1816,,2773,POINT (4697157 -74140516)
2014,Mayo,Alemania,2,8,,10,POINT (6170465 -7542726)
2014,Mayo,Alemania,0,1,,1,POINT (7128047 -73181317)
2014,Mayo,Andorra,1,0,,1,POINT (4697157 -74140516)
2014,Mayo,Angola,0,1,,1,POINT (4697157 -74140516)
2014,Mayo,Países Bajos,1,1,,2,POINT (10406342 -75527794)
2014,Mayo,Países Bajos,2,8,,10,POINT (10446304 -75516486)
2014,Mayo,Países Bajos,0,3,,3,POINT (10886686 -74776479)
2014,Mayo,Países Bajos,1,2,,3,POINT (11247723 -74213989)
2014,Mayo,Países Bajos,7,13,,20,POINT (3451668 -76532004)
2014,Mayo,Países Bajos,29,54,,83,POINT (4697157 -74140516)
2014,Mayo,Países Bajos,38,62,,100,POINT (6170465 -7542726)
2014,Mayo,Países Bajos,6,2,,8,POINT (7128047 -73181317)
2014,Mayo,Arabia Saudita,3,0,,3,POINT (4697157 -74140516)
2014,Mayo,Argelia,0,4,,4,POINT (4697157 -74140516)
2014,Mayo,Argentina,0,1,,1,POINT (0.81488 -77356)
2014,Mayo,Argentina,139,124,,263,POINT (10446304 -75516486)
2014,Mayo,Argentina,2,2,,4,POINT (10886686 -74776479)
2014,Mayo,Argentina,51,29,,80,POINT (125862 -81702165)
2014,Mayo,Argentina,26,74,,100,POINT (3451668 -76532004)
2014,Mayo,Argentina,0,7,,7,POINT (3884426 -77061029)
2014,Mayo,Argentina,1762,2636,,4398,POINT (4697157 -74140516)
2014,Mayo,Argentina,0,1,,1,POINT (4815189 -75736374)
2014,Mayo,Argentina,69,144,,213,POINT (6170465 -7542726)
2014,Mayo,Argentina,0,1,,1,POINT (7927233 -72508188)
2014,Mayo,Aruba,61,52,,113,POINT (10406342 -75527794)
2014,Mayo,Aruba,2,0,,2,POINT (10886686 -74776479)
2014,Mayo,Aruba,0,2,,2,POINT (10970933 -74765343)
2014,Mayo,Aruba,6,14,,20,POINT (11247723 -74213989)
2014,Mayo,Aruba,3,0,,3,POINT (3451668 -76532004)
2014,Mayo,Aruba,556,662,,1218,POINT (4697157 -74140516)
2014,Mayo,Aruba,5,9,,14,POINT (6170465 -7542726)
2014,Mayo,Aruba,1,1,,2,POINT (7128047 -73181317)
2014,Mayo,Australia,2,3,,5,POINT (10446304 -75516486)
2014,Mayo,Australia,1,4,,5,POINT (10886686 -74776479)
2014,Mayo,Australia,4,3,,7,POINT (3451668 -76532004)
2014,Mayo,Australia,14,29,,43,POINT (4697157 -74140516)
2014,Mayo,Australia,0,2,,2,POINT (4815189 -75736374)
2014,Mayo,Australia,7,12,,19,POINT (6170465 -7542726)
2014,Mayo,Austria,0,1,,1,POINT (10886686 -74776479)
2014,Mayo,Austria,0,1,,1,POINT (3451668 -76532004)
2014,Mayo,Austria,9,20,,29,POINT (4697157 -74140516)
2014,Mayo,Bahamas,0,1,,1,POINT (10446304 -75516486)
2014,Mayo,Bahamas,0,2,,2,POINT (10886686 -74776479)
2014,Mayo,Bahamas,1,0,,1,POINT (3451668 -76532004)
2014,Mayo,Bahamas,1,6,,7,POINT (6170465 -7542726)
2014,Mayo,Bahréin,0,1,,1,POINT (4697157 -74140516)
2014,Mayo,Barbados,1,4,,5,POINT (4697157 -74140516)
2014,Mayo,República de Belarús,3,0,,3,POINT (4697157 -74140516)
2014,Mayo,Bélgica,0,5,,5,POINT (10886686 -74776479)
2014,Mayo,Bélgica,0,1,,1,POINT (11247723 -74213989)
2014,Mayo,Bélgica,2,3,,5,POINT (3451668 -76532004)
2014,Mayo,Bélgica,13,31,,44,POINT (4697157 -74140516)
2014,Mayo,Bélgica,2,2,,4,POINT (6170465 -7542726)
2014,Mayo,Belice,0,2,,2,POINT (10446304 -75516486)
2014,Mayo,Belice,1,4,,5,POINT (4697157 -74140516)
2014,Mayo,Belice,0,1,,1,POINT (6170465 -7542726)
2014,Mayo,Benín,0,1,,1,POINT (4697157 -74140516)
2014,Mayo,Bermudas/Territorio Británico de Ultramar,0,1,,1,POINT (6170465 -7542726)
2014,Mayo,Bolivia,1,1,,2,POINT (10446304 -75516486)
2014,Mayo,Bolivia,2,1,,3,POINT (125862 -81702165)
2014,Mayo,Bolivia,4,7,,11,POINT (3451668 -76532004)
2014,Mayo,Bolivia,289,408,,697,POINT (4697157 -74140516)
2014,Mayo,Bolivia,17,30,,47,POINT (6170465 -7542726)
2014,Mayo,Botsuana,0,1,,1,POINT (4697157 -74140516)
2014,Mayo,Brasil,105,127,,232,POINT (-4191162 -69941498)
2014,Mayo,Brasil,0,8,,8,POINT (10406342 -75527794)
2014,Mayo,Brasil,87,64,,151,POINT (10446304 -75516486)
2014,Mayo,Brasil,4,11,,15,POINT (10886686 -74776479)
2014,Mayo,Brasil,23,17,,40,POINT (125862 -81702165)
2014,Mayo,Brasil,13,62,,75,POINT (3451668 -76532004)
2014,Mayo,Brasil,2577,4569,,7146,POINT (4697157 -74140516)
2014,Mayo,Brasil,1,1,,2,POINT (4815189 -75736374)
2014,Mayo,Brasil,57,107,,164,POINT (6170465 -7542726)
2014,Mayo,Brasil,0,1,,1,POINT (7128047 -73181317)
2014,Mayo,Bulgaria,1,0,,1,POINT (10886686 -74776479)
2014,Mayo,Bulgaria,1,4,,5,POINT (4697157 -74140516)
2014,Mayo,Burkina Faso,1,0,,1,POINT (4697157 -74140516)
2014,Mayo,Islas Caimán/Territorio Británico de Ultramar,1,1,,2,POINT (10406342 -75527794)
2014,Mayo,Islas Caimán/Territorio Británico de Ultramar,1,0,,1,POINT (133387613 -81372937)
2014,Mayo,Islas Caimán/Territorio Británico de Ultramar,0,1,,1,POINT (3451668 -76532004)
2014,Mayo,Camerún,0,1,,1,POINT (4697157 -74140516)
2014,Mayo,Canadá,3,6,,9,POINT (10446304 -75516486)
2014,Mayo,Canadá,2,7,,9,POINT (10886686 -74776479)
2014,Mayo,Canadá,13,22,,35,POINT (3451668 -76532004)
2014,Mayo,Canadá,394,737,,1131,POINT (4697157 -74140516)
2014,Mayo,Canadá,0,2,,2,POINT (4815189 -75736374)
2014,Mayo,Canadá,36,87,,123,POINT (6170465 -7542726)
2014,Mayo,Canadá,0,1,,1,POINT (7128047 -73181317)
2014,Mayo,Canadá,1,0,,1,POINT (7927233 -72508188)
2014,Mayo,España,1,27,,28,POINT (10406342 -75527794)
2014,Mayo,España,2,3,,5,POINT (10446304 -75516486)
2014,Mayo,España,0,2,,2,POINT (10886686 -74776479)
2014,Mayo,España,1,51,,52,POINT (10970933 -74765343)
2014,Mayo,España,162,311,,473,POINT (3451668 -76532004)
2014,Mayo,España,2020,4642,,6662,POINT (4697157 -74140516)
2014,Mayo,España,1,1,,2,POINT (4815189 -75736374)
2014,Mayo,España,120,237,,357,POINT (6170465 -7542726)
2014,Mayo,España,0,1,,1,POINT (4815189 -75736374)
2014,Mayo,España,3,10,,13,POINT (6170465 -7542726)
2014,Mayo,República de Corea,1,1,,2,POINT (3451668 -76532004)
2014,Mayo,República de Corea,5,21,,26,POINT (4697157 -74140516)
2014,Mayo,República de Corea,1,1,,2,POINT (6170465 -7542726)
2014,Mayo,Costa de Marfil,0,12,,12,POINT (11247723 -74213989)
2014,Mayo,Costa de Marfil,2,2,,4,POINT (4697157 -74140516)
2014,Mayo,Costa Rica,3,13,,16,POINT (10406342 -75527794)
2014,Mayo,Costa Rica,6,11,,17,POINT (10446304 -75516486)
2014,Mayo,Costa Rica,8,15,,23,POINT (10886686 -74776479)
2014,Mayo,Costa Rica,2,5,,7,POINT (125862 -81702165)
2014,Mayo,Costa Rica,7,34,,41,POINT (3451668 -76532004)
2014,Mayo,Costa Rica,559,1005,,1564,POINT (4697157 -74140516)
2014,Mayo,Costa Rica,1,2,,3,POINT (4815189 -75736374)
2014,Mayo,Costa Rica,56,59,,115,POINT (6170465 -7542726)
2014,Mayo,Costa Rica,1,1,,2,POINT (7128047 -73181317)
2014,Mayo,Costa Rica,1,1,,2,POINT (7927233 -72508188)
2014,Mayo,Croacia,0,2,,2,POINT (10886686 -74776479)
2014,Mayo,Croacia,0,1,,1,POINT (3451668 -76532004)
2014,Mayo,Cuba,1,2,,3,POINT (10446304 -75516486)
2014,Mayo,Cuba,5,11,,16,POINT (10886686 -74776479)
2014,Mayo,Cuba,2,4,,6,POINT (11247723 -74213989)
2014,Mayo,Cuba,11,13,,24,POINT (3451668 -76532004)
2014,Mayo,Cuba,165,278,,443,POINT (4697157 -74140516)
2014,Mayo,Cuba,0,2,,2,POINT (4815189 -75736374)
2014,Mayo,Cuba,9,22,,31,POINT (6170465 -7542726)
2014,Mayo,Cuba,1,1,,2,POINT (7927233 -72508188)
2014,Mayo,Curazao,2,6,,8,POINT (10406342 -75527794)
2014,Mayo,Curazao,3,10,,13,POINT (10886686 -74776479)
2014,Mayo,Curazao,11,12,,23,POINT (11247723 -74213989)
2014,Mayo,Curazao,194,247,,441,POINT (4697157 -74140516)
2014,Mayo,Curazao,166,240,,406,POINT (6170465 -7542726)
2014,Mayo,República Checa,5,3,,8,POINT (4697157 -74140516)
2014,Mayo,Chile,22,97,,119,POINT (10406342 -75527794)
2014,Mayo,Chile,18,20,,38,POINT (10446304 -75516486)
2014,Mayo,Chile,1,7,,8,POINT (10886686 -74776479)
2014,Mayo,Chile,14,10,,24,POINT (125862 -81702165)
2014,Mayo,Chile,28,59,,87,POINT (3451668 -76532004)
2014,Mayo,Chile,3343,4421,,7764,POINT (4697157 -74140516)
2014,Mayo,Chile,1,0,,1,POINT (4815189 -75736374)
2014,Mayo,Chile,67,136,,203,POINT (6170465 -7542726)
2014,Mayo,Chile,0,1,,1,POINT (7128047 -73181317)
2014,Mayo,China,0,1,,1,POINT (10886686 -74776479)
2014,Mayo,China,0,1,,1,POINT (11247723 -74213989)
2014,Mayo,China,0,5,,5,POINT (3884426 -77061029)
2014,Mayo,China,31,94,,125,POINT (4697157 -74140516)
2014,Mayo,China,1,1,,2,POINT (6170465 -7542726)
2014,Mayo,Dinamarca,1,0,,1,POINT (10446304 -75516486)
2014,Mayo,Dinamarca,3,6,,9,POINT (4697157 -74140516)
2014,Mayo,Dinamarca,2,2,,4,POINT (6170465 -7542726)
2014,Mayo,Ecuador,29,70,,99,POINT (0.33002 -76876446)
2014,Mayo,Ecuador,1892,3293,,5185,POINT (0.81488 -77356)
2014,Mayo,Ecuador,9,225,,234,POINT (1800143 -78802679)
2014,Mayo,Ecuador,17,237,,254,POINT (10406342 -75527794)
2014,Mayo,Ecuador,3,3,,6,POINT (10446304 -75516486)
2014,Mayo,Ecuador,1,9,,10,POINT (10886686 -74776479)
2014,Mayo,Ecuador,4,3,,7,POINT (125862 -81702165)
2014,Mayo,Ecuador,408,535,,943,POINT (3451668 -76532004)
2014,Mayo,Ecuador,0,1,,1,POINT (3884426 -77061029)
2014,Mayo,Ecuador,1950,3856,,5806,POINT (4697157 -74140516)
2014,Mayo,Ecuador,0,1,,1,POINT (4815189 -75736374)
2014,Mayo,Ecuador,409,654,,1063,POINT (6170465 -7542726)
2014,Mayo,Ecuador,2,1,,3,POINT (7927233 -72508188)
2014,Mayo,Egipto,2,4,,6,POINT (4697157 -74140516)
2014,Mayo,El Salvador,1,5,,6,POINT (10446304 -75516486)
2014,Mayo,El Salvador,3,3,,6,POINT (125862 -81702165)
2014,Mayo,El Salvador,82,140,,222,POINT (3451668 -76532004)
2014,Mayo,El Salvador,725,1286,,2011,POINT (4697157 -74140516)
2014,Mayo,El Salvador,0,1,,1,POINT (4815189 -75736374)
2014,Mayo,El Salvador,88,205,,293,POINT (6170465 -7542726)
2014,Mayo,Emiratos Árabes,0,3,,3,POINT (4697157 -74140516)
2014,Mayo,Eslovaquia,3,1,,4,POINT (4697157 -74140516)
2014,Mayo,Eslovenia,0,4,,4,POINT (4697157 -74140516)
2014,Mayo,Estados Unidos de América,0,1,,1,POINT (1800143 -78802679)
2014,Mayo,Estados Unidos de América,2,15,,17,POINT (10406342 -75527794)
2014,Mayo,Estados Unidos de América,0,8,,8,POINT (10433609 -73247863)
2014,Mayo,Estados Unidos de América,1187,1867,,3054,POINT (10446304 -75516486)
2014,Mayo,Estados Unidos de América,290,546,,836,POINT (10886686 -74776479)
2014,Mayo,Estados Unidos de América,0,8,,8,POINT (11247723 -74213989)
2014,Mayo,Estados Unidos de América,3,9,,12,POINT (125862 -81702165)
2014,Mayo,Estados Unidos de América,787,1229,,2016,POINT (3451668 -76532004)
2014,Mayo,Estados Unidos de América,0,6,,6,POINT (3884426 -77061029)
2014,Mayo,Estados Unidos de América,79,119,,198,POINT (445285 -75766353)
2014,Mayo,Estados Unidos de América,6746,13656,,20402,POINT (4697157 -74140516)
2014,Mayo,Estados Unidos de América,61,84,,145,POINT (4815189 -75736374)
2014,Mayo,Estados Unidos de América,1532,3617,,5149,POINT (6170465 -7542726)
2014,Mayo,Estados Unidos de América,9,24,,33,POINT (7128047 -73181317)
2014,Mayo,Estados Unidos de América,22,20,,42,POINT (7927233 -72508188)
2014,Mayo,Estonia,1,2,,3,POINT (4697157 -74140516)
2014,Mayo,Filipinas,0,4,,4,POINT (10446304 -75516486)
2014,Mayo,Filipinas,1,9,,10,POINT (10886686 -74776479)
2014,Mayo,Filipinas,0,4,,4,POINT (10970933 -74765343)
2014,Mayo,Filipinas,0,5,,5,POINT (3451668 -76532004)
2014,Mayo,Filipinas,1,10,,11,POINT (4697157 -74140516)
2014,Mayo,Finlandia,0,1,,1,POINT (10446304 -75516486)
2014,Mayo,Finlandia,3,6,,9,POINT (4697157 -74140516)
2014,Mayo,Francia,1,0,,1,POINT (0.81488 -77356)
2014,Mayo,Francia,3,2,,5,POINT (10446304 -75516486)
2014,Mayo,Francia,1,1,,2,POINT (10886686 -74776479)
2014,Mayo,Francia,2,7,,9,POINT (3451668 -76532004)
2014,Mayo,Francia,928,2019,,2947,POINT (4697157 -74140516)
2014,Mayo,Francia,0,1,,1,POINT (4815189 -75736374)
2014,Mayo,Francia,7,11,,18,POINT (6170465 -7542726)
2014,Mayo,Francia,0,1,,1,POINT (7102626 -77762647)
2014,Mayo,Georgia,0,1,,1,POINT (4697157 -74140516)
2014,Mayo,Grecia,1,4,,5,POINT (4697157 -74140516)
2014,Mayo,Guatemala,4,3,,7,POINT (10446304 -75516486)
2014,Mayo,Guatemala,0,2,,2,POINT (10886686 -74776479)
2014,Mayo,Guatemala,6,4,,10,POINT (125862 -81702165)
2014,Mayo,Guatemala,7,20,,27,POINT (3451668 -76532004)
2014,Mayo,Guatemala,115,293,,408,POINT (4697157 -74140516)
2014,Mayo,Guatemala,0,2,,2,POINT (4815189 -75736374)
2014,Mayo,Guatemala,19,56,,75,POINT (6170465 -7542726)
2014,Mayo,Guatemala,2,0,,2,POINT (7927233 -72508188)
2014,Mayo,Guyana,0,1,,1,POINT (3451668 -76532004)
2014,Mayo,Guyana,1,0,,1,POINT (4697157 -74140516)
2014,Mayo,Guadalupe/Territorio Francés,0,2,,2,POINT (4697157 -74140516)
2014,Mayo,Guadalupe/Territorio Francés,0,1,,1,POINT (6170465 -7542726)
2014,Mayo,Guayana Francesa/Departamento de Ultramar Francés,0,1,,1,POINT (6170465 -7542726)
2014,Mayo,Haití,0,8,,8,POINT (10406342 -75527794)
2014,Mayo,Haití,0,18,,18,POINT (10446304 -75516486)
2014,Mayo,Haití,0,1,,1,POINT (4697157 -74140516)
2014,Mayo,Honduras,2,9,,11,POINT (10446304 -75516486)
2014,Mayo,Honduras,3,3,,6,POINT (10886686 -74776479)
2014,Mayo,Honduras,1,13,,14,POINT (125862 -81702165)
2014,Mayo,Honduras,2,6,,8,POINT (133387613 -81372937)
2014,Mayo,Honduras,5,20,,25,POINT (3451668 -76532004)
2014,Mayo,Honduras,40,65,,105,POINT (4697157 -74140516)
2014,Mayo,Honduras,1,0,,1,POINT (4815189 -75736374)
2014,Mayo,Honduras,10,19,,29,POINT (6170465 -7542726)
2014,Mayo,Honduras,0,2,,2,POINT (7927233 -72508188)
2014,Mayo,Hong Kong,1,9,,10,POINT (4697157 -74140516)
2014,Mayo,Hong Kong,0,1,,1,POINT (6170465 -7542726)
2014,Mayo,Hungría,1,3,,4,POINT (4697157 -74140516)
2014,Mayo,India,0,1,,1,POINT (10886686 -74776479)
2014,Mayo,India,0,3,,3,POINT (3451668 -76532004)
2014,Mayo,India,2,18,,20,POINT (4697157 -74140516)
2014,Mayo,India,6,6,,12,POINT (6170465 -7542726)
2014,Mayo,Indonesia,2,1,,3,POINT (4697157 -74140516)
2014,Mayo,República de Irlanda,1,1,,2,POINT (10446304 -75516486)
2014,Mayo,República de Irlanda,0,1,,1,POINT (10886686 -74776479)
2014,Mayo,República de Irlanda,3,13,,16,POINT (4697157 -74140516)
2014,Mayo,República de Irlanda,0,1,,1,POINT (4815189 -75736374)
2014,Mayo,Islandia,1,0,,1,POINT (4697157 -74140516)
2014,Mayo,Israel,1,0,,1,POINT (10446304 -75516486)
2014,Mayo,Israel,9,47,,56,POINT (4697157 -74140516)
2014,Mayo,Israel,0,3,,3,POINT (6170465 -7542726)
2014,Mayo,Italia,0,3,,3,POINT (10886686 -74776479)
2014,Mayo,Italia,0,1,,1,POINT (11247723 -74213989)
2014,Mayo,Italia,6,16,,22,POINT (3451668 -76532004)
2014,Mayo,Italia,68,194,,262,POINT (4697157 -74140516)
2014,Mayo,Italia,0,3,,3,POINT (4815189 -75736374)
2014,Mayo,Italia,1,12,,13,POINT (6170465 -7542726)
2014,Mayo,Italia,0,1,,1,POINT (7927233 -72508188)
2014,Mayo,Jamaica,0,5,,5,POINT (10406342 -75527794)
2014,Mayo,Jamaica,0,3,,3,POINT (10446304 -75516486)
2014,Mayo,Jamaica,0,2,,2,POINT (10886686 -74776479)
2014,Mayo,Jamaica,1,0,,1,POINT (3451668 -76532004)
2014,Mayo,Jamaica,1,16,,17,POINT (4697157 -74140516)
2014,Mayo,Jamaica,2,1,,3,POINT (6170465 -7542726)
2014,Mayo,Jamaica,0,1,,1,POINT (7128047 -73181317)
2014,Mayo,Japón,0,1,,1,POINT (10886686 -74776479)
2014,Mayo,Japón,0,1,,1,POINT (3451668 -76532004)
2014,Mayo,Japón,10,21,,31,POINT (4697157 -74140516)
2014,Mayo,Japón,0,4,,4,POINT (6170465 -7542726)
2014,Mayo,Jordania,2,0,,2,POINT (4697157 -74140516)
2014,Mayo,Kazajistán,1,1,,2,POINT (4697157 -74140516)
2014,Mayo,Kenia,2,0,,2,POINT (3451668 -76532004)
2014,Mayo,Kenia,2,2,,4,POINT (4697157 -74140516)
2014,Mayo,Líbano,3,8,,11,POINT (4697157 -74140516)
2014,Mayo,Luxemburgo,0,1,,1,POINT (4697157 -74140516)
2014,Mayo,Malasia,1,3,,4,POINT (4697157 -74140516)
2014,Mayo,Marruecos,0,1,,1,POINT (10446304 -75516486)
2014,Mayo,Marruecos,1,2,,3,POINT (4697157 -74140516)
2014,Mayo,Martinica/Departamento de Ultramar Francés,1,2,,3,POINT (10406342 -75527794)
2014,Mayo,Martinica/Departamento de Ultramar Francés,1,2,,3,POINT (11247723 -74213989)
2014,Mayo,México,2,11,,13,POINT (10406342 -75527794)
2014,Mayo,México,22,46,,68,POINT (10446304 -75516486)
2014,Mayo,México,5,18,,23,POINT (10886686 -74776479)
2014,Mayo,México,0,4,,4,POINT (10970933 -74765343)
2014,Mayo,México,0,1,,1,POINT (125862 -81702165)
2014,Mayo,México,24,78,,102,POINT (3451668 -76532004)
2014,Mayo,México,3009,6373,,9382,POINT (4697157 -74140516)
2014,Mayo,México,4,6,,10,POINT (4815189 -75736374)
2014,Mayo,México,43,156,,199,POINT (6170465 -7542726)
2014,Mayo,México,0,2,,2,POINT (7128047 -73181317)
2014,Mayo,México,1,1,,2,POINT (7927233 -72508188)
2014,Mayo,Myanmar,3,0,,3,POINT (4697157 -74140516)
2014,Mayo,Nicaragua,2,1,,3,POINT (10446304 -75516486)
2014,Mayo,Nicaragua,0,1,,1,POINT (10886686 -74776479)
2014,Mayo,Nicaragua,2,1,,3,POINT (133387613 -81372937)
2014,Mayo,Nicaragua,2,4,,6,POINT (3451668 -76532004)
2014,Mayo,Nicaragua,24,27,,51,POINT (4697157 -74140516)
2014,Mayo,Nicaragua,2,2,,4,POINT (4815189 -75736374)
2014,Mayo,Nicaragua,1,6,,7,POINT (6170465 -7542726)
2014,Mayo,Nigeria,0,2,,2,POINT (4697157 -74140516)
2014,Mayo,Noruega,0,1,,1,POINT (10446304 -75516486)
2014,Mayo,Noruega,0,3,,3,POINT (10886686 -74776479)
2014,Mayo,Noruega,0,1,,1,POINT (3451668 -76532004)
2014,Mayo,Noruega,5,11,,16,POINT (4697157 -74140516)
2014,Mayo,Nueva Zelanda,1,0,,1,POINT (3451668 -76532004)
2014,Mayo,Nueva Zelanda,2,13,,15,POINT (4697157 -74140516)
2014,Mayo,Papúa Nueva Guinea,0,1,,1,POINT (4697157 -74140516)
2014,Mayo,Panamá,1006,962,,1968,POINT (10406342 -75527794)
2014,Mayo,Panamá,1623,2037,,3660,POINT (10446304 -75516486)
2014,Mayo,Panamá,226,473,,699,POINT (10886686 -74776479)
2014,Mayo,Panamá,1,25,,26,POINT (10970933 -74765343)
2014,Mayo,Panamá,2,5,,7,POINT (11247723 -74213989)
2014,Mayo,Panamá,1385,1050,,2435,POINT (125862 -81702165)
2014,Mayo,Panamá,6,9,,15,POINT (133387613 -81372937)
2014,Mayo,Panamá,253,514,,767,POINT (3451668 -76532004)
2014,Mayo,Panamá,0,18,,18,POINT (3884426 -77061029)
2014,Mayo,Panamá,1943,3981,,5924,POINT (4697157 -74140516)
2014,Mayo,Panamá,69,131,,200,POINT (4815189 -75736374)
2014,Mayo,Panamá,446,1273,,1719,POINT (6170465 -7542726)
2014,Mayo,Panamá,0,2,,2,POINT (6222552 -77401154)
2014,Mayo,Panamá,2,10,,12,POINT (7102626 -77762647)
2014,Mayo,Panamá,24,57,,81,POINT (7128047 -73181317)
2014,Mayo,Panamá,90,111,,201,POINT (7927233 -72508188)
2014,Mayo,Panamá,0,1,,1,POINT (806667 -767333)
2014,Mayo,Panamá,69,143,,212,POINT (863337 -7735002)
2014,Mayo,Paraguay,2,1,,3,POINT (10446304 -75516486)
2014,Mayo,Paraguay,12,7,,19,POINT (125862 -81702165)
2014,Mayo,Paraguay,4,4,,8,POINT (3451668 -76532004)
2014,Mayo,Paraguay,13,31,,44,POINT (4697157 -74140516)
2014,Mayo,Paraguay,5,8,,13,POINT (6170465 -7542726)
2014,Mayo,Perú,182,239,,421,POINT (-4191162 -69941498)
2014,Mayo,Perú,21,21,,42,POINT (10446304 -75516486)
2014,Mayo,Perú,4,14,,18,POINT (10886686 -74776479)
2014,Mayo,Perú,133,72,,205,POINT (125862 -81702165)
2014,Mayo,Perú,208,330,,538,POINT (3451668 -76532004)
2014,Mayo,Perú,4592,6795,,11387,POINT (4697157 -74140516)
2014,Mayo,Perú,1,2,,3,POINT (4815189 -75736374)
2014,Mayo,Perú,340,639,,979,POINT (6170465 -7542726)
2014,Mayo,Perú,1,2,,3,POINT (7128047 -73181317)
2014,Mayo,Perú,0,2,,2,POINT (7927233 -72508188)
2014,Mayo,Polonia,8,18,,26,POINT (4697157 -74140516)
2014,Mayo,Portugal,1,3,,4,POINT (3451668 -76532004)
2014,Mayo,Portugal,10,30,,40,POINT (4697157 -74140516)
2014,Mayo,Puerto Rico/Territorio de Estados Unidos,0,7,,7,POINT (10433609 -73247863)
2014,Mayo,Puerto Rico/Territorio de Estados Unidos,3,23,,26,POINT (10446304 -75516486)
2014,Mayo,Puerto Rico/Territorio de Estados Unidos,2,25,,27,POINT (10886686 -74776479)
2014,Mayo,Puerto Rico/Territorio de Estados Unidos,1,3,,4,POINT (11247723 -74213989)
2014,Mayo,Puerto Rico/Territorio de Estados Unidos,9,29,,38,POINT (3451668 -76532004)
2014,Mayo,Puerto Rico/Territorio de Estados Unidos,158,224,,382,POINT (4697157 -74140516)
2014,Mayo,Puerto Rico/Territorio de Estados Unidos,2,13,,15,POINT (4815189 -75736374)
2014,Mayo,Puerto Rico/Territorio de Estados Unidos,20,58,,78,POINT (6170465 -7542726)
2014,Mayo,Puerto Rico/Territorio de Estados Unidos,1,3,,4,POINT (7128047 -73181317)
2014,Mayo,Puerto Rico/Territorio de Estados Unidos,2,1,,3,POINT (7927233 -72508188)
2014,Mayo,Qatar,0,1,,1,POINT (4697157 -74140516)
2014,Mayo,Reino Unido de Gran Bretaña e Irlanda del Norte,2,7,,9,POINT (10446304 -75516486)
2014,Mayo,Reino Unido de Gran Bretaña e Irlanda del Norte,2,3,,5,POINT (10886686 -74776479)
2014,Mayo,Reino Unido de Gran Bretaña e Irlanda del Norte,2,6,,8,POINT (3451668 -76532004)
2014,Mayo,Reino Unido de Gran Bretaña e Irlanda del Norte,65,144,,209,POINT (4697157 -74140516)
2014,Mayo,Reino Unido de Gran Bretaña e Irlanda del Norte,4,8,,12,POINT (6170465 -7542726)
2014,Mayo,Federación de Rusia,1,0,,1,POINT (10446304 -75516486)
2014,Mayo,Federación de Rusia,1,0,,1,POINT (3451668 -76532004)
2014,Mayo,Federación de Rusia,16,24,,40,POINT (4697157 -74140516)
2014,Mayo,República Dominicana,3,4,,7,POINT (10446304 -75516486)
2014,Mayo,República Dominicana,1,16,,17,POINT (10886686 -74776479)
2014,Mayo,República Dominicana,0,3,,3,POINT (10970933 -74765343)
2014,Mayo,República Dominicana,1,4,,5,POINT (11247723 -74213989)
2014,Mayo,República Dominicana,1,0,,1,POINT (125862 -81702165)
2014,Mayo,República Dominicana,9,19,,28,POINT (3451668 -76532004)
2014,Mayo,República Dominicana,334,511,,845,POINT (4697157 -74140516)
2014,Mayo,República Dominicana,2,2,,4,POINT (4815189 -75736374)
2014,Mayo,República Dominicana,17,39,,56,POINT (6170465 -7542726)
2014,Mayo,República Democrática Popular de Corea,0,1,,1,POINT (4697157 -74140516)
2014,Mayo,Rumania,2,0,,2,POINT (10406342 -75527794)
2014,Mayo,Rumania,4,6,,10,POINT (4697157 -74140516)
2014,Mayo,Santa Sede/Ciudad del Vaticano,1,1,,2,POINT (4697157 -74140516)
2014,Mayo,Senegal,2,9,,11,POINT (4697157 -74140516)
2014,Mayo,Serbia,1,0,,1,POINT (4697157 -74140516)
2014,Mayo,Singapur,1,3,,4,POINT (4697157 -74140516)
2014,Mayo,Sudáfrica,1,6,,7,POINT (4697157 -74140516)
2014,Mayo,Suecia,0,1,,1,POINT (10446304 -75516486)
2014,Mayo,Suecia,0,3,,3,POINT (10886686 -74776479)
2014,Mayo,Suecia,0,2,,2,POINT (3451668 -76532004)
2014,Mayo,Suecia,10,18,,28,POINT (4697157 -74140516)
2014,Mayo,Suecia,0,2,,2,POINT (6170465 -7542726)
2014,Mayo,Suiza,2,2,,4,POINT (10446304 -75516486)
2014,Mayo,Suiza,4,6,,10,POINT (3451668 -76532004)
2014,Mayo,Suiza,30,71,,101,POINT (4697157 -74140516)
2014,Mayo,Suiza,0,6,,6,POINT (6170465 -7542726)
2014,Mayo,Surinam,0,1,,1,POINT (10406342 -75527794)
2014,Mayo,Surinam,0,1,,1,POINT (4697157 -74140516)
2014,Mayo,Surinam,2,8,,10,POINT (6170465 -7542726)
2014,Mayo,Taiwán,2,0,,2,POINT (4697157 -74140516)
2014,Mayo,Tailandia,3,1,,4,POINT (4697157 -74140516)
2014,Mayo,Trinidad y Tobago,0,1,,1,POINT (10446304 -75516486)
2014,Mayo,Trinidad y Tobago,0,1,,1,POINT (10886686 -74776479)
2014,Mayo,Trinidad y Tobago,0,12,,12,POINT (11247723 -74213989)
2014,Mayo,Trinidad y Tobago,2,6,,8,POINT (3451668 -76532004)
2014,Mayo,Trinidad y Tobago,2,5,,7,POINT (4697157 -74140516)
2014,Mayo,Trinidad y Tobago,1,12,,13,POINT (6170465 -7542726)
2014,Mayo,Túnez,0,1,,1,POINT (3451668 -76532004)
2014,Mayo,Túnez,0,1,,1,POINT (6170465 -7542726)
2014,Mayo,Turquía,1,6,,7,POINT (4697157 -74140516)
2014,Mayo,Turquía,0,3,,3,POINT (6170465 -7542726)
2014,Mayo,Ucrania,0,1,,1,POINT (10446304 -75516486)
2014,Mayo,Ucrania,0,1,,1,POINT (10970933 -74765343)
2014,Mayo,Ucrania,0,2,,2,POINT (4697157 -74140516)
2014,Mayo,Uruguay,22,8,,30,POINT (10446304 -75516486)
2014,Mayo,Uruguay,1,2,,3,POINT (10886686 -74776479)
2014,Mayo,Uruguay,8,8,,16,POINT (125862 -81702165)
2014,Mayo,Uruguay,6,11,,17,POINT (3451668 -76532004)
2014,Mayo,Uruguay,37,51,,88,POINT (4697157 -74140516)
2014,Mayo,Uruguay,14,85,,99,POINT (6170465 -7542726)
2014,Mayo,Uruguay,0,1,,1,POINT (7927233 -72508188)
2014,Mayo,Venezuela,0,17,,17,POINT (10406342 -75527794)
2014,Mayo,Venezuela,4,6,,10,POINT (10433609 -73247863)
2014,Mayo,Venezuela,11,32,,43,POINT (10446304 -75516486)
2014,Mayo,Venezuela,14,48,,62,POINT (10886686 -74776479)
2014,Mayo,Venezuela,0,1,,1,POINT (10970933 -74765343)
2014,Mayo,Venezuela,0,1,,1,POINT (11247723 -74213989)
2014,Mayo,Venezuela,1033,1669,,2702,POINT (11360029 -72129595)
2014,Mayo,Venezuela,1,0,,1,POINT (125862 -81702165)
2014,Mayo,Venezuela,19,42,,61,POINT (3451668 -76532004)
2014,Mayo,Venezuela,3038,4216,,7254,POINT (4697157 -74140516)
2014,Mayo,Venezuela,4,10,,14,POINT (4815189 -75736374)
2014,Mayo,Venezuela,246,445,,691,POINT (6170465 -7542726)
2014,Mayo,Venezuela,15,29,,44,POINT (6185536 -67484028)
2014,Mayo,Venezuela,27,35,,62,POINT (7088729 -70740253)
2014,Mayo,Venezuela,0,2,,2,POINT (7128047 -73181317)
2014,Mayo,Venezuela,1303,1879,,3182,POINT (7819 -72453013)
2014,Mayo,Venezuela,104,120,,224,POINT (7927233 -72508188)
2014,Mayo,Vietnam,0,1,,1,POINT (3451668 -76532004)
2014,Mayo,Zimbabue,0,1,,1,POINT (4697157 -74140516)
2014,Mayo,Desconocido,0,2,,2,POINT (10406342 -75527794)
2014,Mayo,Desconocido,17,62,,79,POINT (125744111 -81703935)
2014,Mayo,Desconocido,0,1,,1,POINT (133387613 -81372937)
2014,Mayo,Desconocido,0,19,,19,POINT (4697157 -74140516)
2014,Mayo,Desconocido,0,1,,1,POINT (9402597 -75681642)
2014,Junio,Desconocido,0,79,,79,POINT (1152863 -72919186)
2014,Junio,Desconocido,7,22,,29,POINT (125744111 -81703935)
2014,Junio,Desconocido,0,1,,1,POINT (133387613 -81372937)
2014,Junio,Desconocido,0,1,,1,POINT (3884426 -77061029)
2014,Junio,Desconocido,1,30,,31,POINT (4697157 -74140516)
2014,Junio,Desconocido,6,9,,15,POINT (6170465 -7542726)
2014,Junio,Desconocido,1,0,,1,POINT (863337 -7735002)
2014,Junio,Afganistán,1,1,,2,POINT (4697157 -74140516)
2014,Junio,Alemania,0,1,,1,POINT (10446304 -75516486)
2014,Junio,Alemania,1,4,,5,POINT (10886686 -74776479)
2014,Junio,Alemania,0,1,,1,POINT (125862 -81702165)
2014,Junio,Alemania,3,5,,8,POINT (3451668 -76532004)
2014,Junio,Alemania,1176,2080,,3256,POINT (4697157 -74140516)
2014,Junio,Alemania,1,7,,8,POINT (6170465 -7542726)
2014,Junio,Antigua y Barbuda,0,3,,3,POINT (10406342 -75527794)
2014,Junio,Países Bajos,1,2,,3,POINT (10446304 -75516486)
2014,Junio,Países Bajos,2,5,,7,POINT (10886686 -74776479)
2014,Junio,Países Bajos,0,3,,3,POINT (11247723 -74213989)
2014,Junio,Países Bajos,4,7,,11,POINT (3451668 -76532004)
2014,Junio,Países Bajos,35,62,,97,POINT (4697157 -74140516)
2014,Junio,Países Bajos,0,1,,1,POINT (4815189 -75736374)
2014,Junio,Países Bajos,31,36,,67,POINT (6170465 -7542726)
2014,Junio,Países Bajos,3,2,,5,POINT (7128047 -73181317)
2014,Junio,Arabia Saudita,1,1,,2,POINT (4697157 -74140516)
2014,Junio,Argelia,2,2,,4,POINT (4697157 -74140516)
2014,Junio,Argentina,2,11,,13,POINT (0.81488 -77356)
2014,Junio,Argentina,90,56,,146,POINT (10446304 -75516486)
2014,Junio,Argentina,5,7,,12,POINT (10886686 -74776479)
2014,Junio,Argentina,72,75,,147,POINT (125862 -81702165)
2014,Junio,Argentina,15,31,,46,POINT (3451668 -76532004)
2014,Junio,Argentina,0,3,,3,POINT (3884426 -77061029)
2014,Junio,Argentina,1459,2283,,3742,POINT (4697157 -74140516)
2014,Junio,Argentina,1,0,,1,POINT (4815189 -75736374)
2014,Junio,Argentina,52,115,,167,POINT (6170465 -7542726)
2014,Junio,Argentina,2,2,,4,POINT (7128047 -73181317)
2014,Junio,Aruba,0,6,,6,POINT (10406342 -75527794)
2014,Junio,Aruba,1,2,,3,POINT (10886686 -74776479)
2014,Junio,Aruba,2,5,,7,POINT (11247723 -74213989)
2014,Junio,Aruba,4,2,,6,POINT (3451668 -76532004)
2014,Junio,Aruba,577,691,,1268,POINT (4697157 -74140516)
2014,Junio,Aruba,0,1,,1,POINT (4815189 -75736374)
2014,Junio,Aruba,4,4,,8,POINT (6170465 -7542726)
2014,Junio,Aruba,5,1,,6,POINT (7128047 -73181317)
2014,Junio,Australia,1,0,,1,POINT (0.81488 -77356)
2014,Junio,Australia,1,1,,2,POINT (10446304 -75516486)
2014,Junio,Australia,1,2,,3,POINT (10886686 -74776479)
2014,Junio,Australia,2,4,,6,POINT (3451668 -76532004)
2014,Junio,Australia,23,31,,54,POINT (4697157 -74140516)
2014,Junio,Australia,8,14,,22,POINT (6170465 -7542726)
2014,Junio,Austria,0,1,,1,POINT (3451668 -76532004)
2014,Junio,Austria,11,17,,28,POINT (4697157 -74140516)
2014,Junio,Bahamas,0,1,,1,POINT (10446304 -75516486)
2014,Junio,Bahamas,0,1,,1,POINT (3451668 -76532004)
2014,Junio,Bahamas,3,3,,6,POINT (4697157 -74140516)
2014,Junio,Bahréin,0,3,,3,POINT (4697157 -74140516)
2014,Junio,Bahréin,0,1,,1,POINT (6170465 -7542726)
2014,Junio,Barbados,0,1,,1,POINT (4697157 -74140516)
2014,Junio,República de Belarús,0,2,,2,POINT (4697157 -74140516)
2014,Junio,Bélgica,0,2,,2,POINT (10886686 -74776479)
2014,Junio,Bélgica,0,1,,1,POINT (125862 -81702165)
2014,Junio,Bélgica,0,2,,2,POINT (3451668 -76532004)
2014,Junio,Bélgica,18,28,,46,POINT (4697157 -74140516)
2014,Junio,Bélgica,7,9,,16,POINT (6170465 -7542726)
2014,Junio,Belice,0,3,,3,POINT (4697157 -74140516)
2014,Junio,Bolivia,0,3,,3,POINT (0.81488 -77356)
2014,Junio,Bolivia,5,8,,13,POINT (10446304 -75516486)
2014,Junio,Bolivia,1,1,,2,POINT (10886686 -74776479)
2014,Junio,Bolivia,7,7,,14,POINT (3451668 -76532004)
2014,Junio,Bolivia,320,420,,740,POINT (4697157 -74140516)
2014,Junio,Bolivia,14,15,,29,POINT (6170465 -7542726)
2014,Junio,Bolivia,1,0,,1,POINT (7128047 -73181317)
2014,Junio,Brasil,132,208,,340,POINT (-4191162 -69941498)
2014,Junio,Brasil,0,1,,1,POINT (0.81488 -77356)
2014,Junio,Brasil,65,55,,120,POINT (10446304 -75516486)
2014,Junio,Brasil,5,6,,11,POINT (10886686 -74776479)
2014,Junio,Brasil,64,50,,114,POINT (125862 -81702165)
2014,Junio,Brasil,17,22,,39,POINT (3451668 -76532004)
2014,Junio,Brasil,1764,3473,,5237,POINT (4697157 -74140516)
2014,Junio,Brasil,1,2,,3,POINT (4815189 -75736374)
2014,Junio,Brasil,26,96,,122,POINT (6170465 -7542726)
2014,Junio,Brasil,0,1,,1,POINT (7128047 -73181317)
2014,Junio,Brasil,1,1,,2,POINT (7927233 -72508188)
2014,Junio,Bulgaria,1,2,,3,POINT (4697157 -74140516)
2014,Junio,Islas Caimán/Territorio Británico de Ultramar,2,5,,7,POINT (10406342 -75527794)
2014,Junio,Islas Caimán/Territorio Británico de Ultramar,0,1,,1,POINT (133387613 -81372937)
2014,Junio,Islas Caimán/Territorio Británico de Ultramar,0,3,,3,POINT (4697157 -74140516)
2014,Junio,Canadá,9,10,,19,POINT (10446304 -75516486)
2014,Junio,Canadá,8,6,,14,POINT (10886686 -74776479)
2014,Junio,Canadá,25,28,,53,POINT (3451668 -76532004)
2014,Junio,Canadá,1,0,,1,POINT (445285 -75766353)
2014,Junio,Canadá,491,778,,1269,POINT (4697157 -74140516)
2014,Junio,Canadá,6,4,,10,POINT (4815189 -75736374)
2014,Junio,Canadá,30,60,,90,POINT (6170465 -7542726)
2014,Junio,Canadá,1,4,,5,POINT (7128047 -73181317)
2014,Junio,Canadá,2,1,,3,POINT (7927233 -72508188)
2014,Junio,España,0,2,,2,POINT (10406342 -75527794)
2014,Junio,España,0,1,,1,POINT (10446304 -75516486)
2014,Junio,España,0,2,,2,POINT (10886686 -74776479)
2014,Junio,España,224,389,,613,POINT (3451668 -76532004)
2014,Junio,España,2558,4825,,7383,POINT (4697157 -74140516)
2014,Junio,España,2,1,,3,POINT (4815189 -75736374)
2014,Junio,España,153,304,,457,POINT (6170465 -7542726)
2014,Junio,España,0,1,,1,POINT (7128047 -73181317)
2014,Junio,España,3,5,,8,POINT (863337 -7735002)
2014,Junio,República de Corea,0,2,,2,POINT (10886686 -74776479)
2014,Junio,República de Corea,7,17,,24,POINT (4697157 -74140516)
2014,Junio,República de Corea,0,1,,1,POINT (6170465 -7542726)
2014,Junio,Costa de Marfil,5,2,,7,POINT (4697157 -74140516)
2014,Junio,Costa Rica,4,7,,11,POINT (10406342 -75527794)
2014,Junio,Costa Rica,14,21,,35,POINT (10446304 -75516486)
2014,Junio,Costa Rica,7,22,,29,POINT (10886686 -74776479)
2014,Junio,Costa Rica,3,2,,5,POINT (125862 -81702165)
2014,Junio,Costa Rica,5,13,,18,POINT (3451668 -76532004)
2014,Junio,Costa Rica,595,1035,,1630,POINT (4697157 -74140516)
2014,Junio,Costa Rica,0,4,,4,POINT (4815189 -75736374)
2014,Junio,Costa Rica,30,60,,90,POINT (6170465 -7542726)
2014,Junio,Costa Rica,0,2,,2,POINT (7128047 -73181317)
2014,Junio,Croacia,0,1,,1,POINT (10886686 -74776479)
2014,Junio,Croacia,1,17,,18,POINT (4697157 -74140516)
2014,Junio,Cuba,2,1,,3,POINT (10446304 -75516486)
2014,Junio,Cuba,5,1,,6,POINT (10886686 -74776479)
2014,Junio,Cuba,11,24,,35,POINT (3451668 -76532004)
2014,Junio,Cuba,140,215,,355,POINT (4697157 -74140516)
2014,Junio,Cuba,2,0,,2,POINT (4815189 -75736374)
2014,Junio,Cuba,3,4,,7,POINT (6170465 -7542726)
2014,Junio,Cuba,2,0,,2,POINT (7128047 -73181317)
2014,Junio,Cuba,1,0,,1,POINT (7927233 -72508188)
2014,Junio,Curazao,1,1,,2,POINT (10406342 -75527794)
2014,Junio,Curazao,17,36,,53,POINT (10886686 -74776479)
2014,Junio,Curazao,4,9,,13,POINT (11247723 -74213989)
2014,Junio,Curazao,191,248,,439,POINT (4697157 -74140516)
2014,Junio,Curazao,124,191,,315,POINT (6170465 -7542726)
2014,Junio,República Checa,4,2,,6,POINT (4697157 -74140516)
2014,Junio,Chile,4,4,,8,POINT (0.81488 -77356)
2014,Junio,Chile,16,10,,26,POINT (10446304 -75516486)
2014,Junio,Chile,0,3,,3,POINT (10886686 -74776479)
2014,Junio,Chile,0,1,,1,POINT (10970933 -74765343)
2014,Junio,Chile,49,26,,75,POINT (125862 -81702165)
2014,Junio,Chile,19,31,,50,POINT (3451668 -76532004)
2014,Junio,Chile,1922,3284,,5206,POINT (4697157 -74140516)
2014,Junio,Chile,23,55,,78,POINT (6170465 -7542726)
2014,Junio,China,0,1,,1,POINT (3451668 -76532004)
2014,Junio,China,35,64,,99,POINT (4697157 -74140516)
2014,Junio,Dinamarca,1,1,,2,POINT (10886686 -74776479)
2014,Junio,Dinamarca,6,11,,17,POINT (4697157 -74140516)
2014,Junio,Dinamarca,0,1,,1,POINT (6170465 -7542726)
2014,Junio,Dominica,0,1,,1,POINT (6170465 -7542726)
2014,Junio,Ecuador,37,93,,130,POINT (0.33002 -76876446)
2014,Junio,Ecuador,1875,3110,,4985,POINT (0.81488 -77356)
2014,Junio,Ecuador,5,111,,116,POINT (1800143 -78802679)
2014,Junio,Ecuador,0,1,,1,POINT (10406342 -75527794)
2014,Junio,Ecuador,2,9,,11,POINT (10446304 -75516486)
2014,Junio,Ecuador,1,0,,1,POINT (10886686 -74776479)
2014,Junio,Ecuador,3,0,,3,POINT (125862 -81702165)
2014,Junio,Ecuador,385,478,,863,POINT (3451668 -76532004)
2014,Junio,Ecuador,2427,4044,,6471,POINT (4697157 -74140516)
2014,Junio,Ecuador,371,510,,881,POINT (6170465 -7542726)
2014,Junio,Ecuador,0,1,,1,POINT (7128047 -73181317)
2014,Junio,Egipto,0,4,,4,POINT (4697157 -74140516)
2014,Junio,El Salvador,5,4,,9,POINT (10446304 -75516486)
2014,Junio,El Salvador,0,2,,2,POINT (10886686 -74776479)
2014,Junio,El Salvador,111,156,,267,POINT (3451668 -76532004)
2014,Junio,El Salvador,727,1147,,1874,POINT (4697157 -74140516)
2014,Junio,El Salvador,0,1,,1,POINT (4815189 -75736374)
2014,Junio,El Salvador,103,202,,305,POINT (6170465 -7542726)
2014,Junio,Emiratos Árabes,4,7,,11,POINT (4697157 -74140516)
2014,Junio,Eslovaquia,5,2,,7,POINT (4697157 -74140516)
2014,Junio,Eslovaquia,0,1,,1,POINT (6170465 -7542726)
2014,Junio,Eslovenia,0,1,,1,POINT (4697157 -74140516)
2014,Junio,Eslovenia,1,0,,1,POINT (6170465 -7542726)
2014,Junio,Estados Unidos de América,4,36,,40,POINT (10406342 -75527794)
2014,Junio,Estados Unidos de América,1484,2223,,3707,POINT (10446304 -75516486)
2014,Junio,Estados Unidos de América,495,674,,1169,POINT (10886686 -74776479)
2014,Junio,Estados Unidos de América,0,1,,1,POINT (11117206 -74232675)
2014,Junio,Estados Unidos de América,0,8,,8,POINT (11247723 -74213989)
2014,Junio,Estados Unidos de América,4,10,,14,POINT (125862 -81702165)
2014,Junio,Estados Unidos de América,1458,1906,,3364,POINT (3451668 -76532004)
2014,Junio,Estados Unidos de América,0,3,,3,POINT (3884426 -77061029)
2014,Junio,Estados Unidos de América,174,190,,364,POINT (445285 -75766353)
2014,Junio,Estados Unidos de América,10253,16837,,27090,POINT (4697157 -74140516)
2014,Junio,Estados Unidos de América,167,181,,348,POINT (4815189 -75736374)
2014,Junio,Estados Unidos de América,2502,4216,,6718,POINT (6170465 -7542726)
2014,Junio,Estados Unidos de América,23,33,,56,POINT (7128047 -73181317)
2014,Junio,Estados Unidos de América,30,37,,67,POINT (7927233 -72508188)
2014,Junio,Estados Unidos de América,0,23,,23,POINT (9402597 -75681642)
2014,Junio,Filipinas,0,1,,1,POINT (10446304 -75516486)
2014,Junio,Filipinas,0,3,,3,POINT (10886686 -74776479)
2014,Junio,Filipinas,1,0,,1,POINT (3451668 -76532004)
2014,Junio,Filipinas,3,13,,16,POINT (4697157 -74140516)
2014,Junio,Filipinas,1,1,,2,POINT (6170465 -7542726)
2014,Junio,Finlandia,0,2,,2,POINT (3451668 -76532004)
2014,Junio,Finlandia,6,6,,12,POINT (4697157 -74140516)
2014,Junio,Francia,0,1,,1,POINT (0.81488 -77356)
2014,Junio,Francia,0,1,,1,POINT (10406342 -75527794)
2014,Junio,Francia,0,1,,1,POINT (10446304 -75516486)
2014,Junio,Francia,3,8,,11,POINT (3451668 -76532004)
2014,Junio,Francia,1055,1940,,2995,POINT (4697157 -74140516)
2014,Junio,Francia,1,0,,1,POINT (4815189 -75736374)
2014,Junio,Francia,7,10,,17,POINT (6170465 -7542726)
2014,Junio,Grecia,1,3,,4,POINT (4697157 -74140516)
2014,Junio,Guatemala,5,3,,8,POINT (10446304 -75516486)
2014,Junio,Guatemala,5,3,,8,POINT (10886686 -74776479)
2014,Junio,Guatemala,2,0,,2,POINT (125862 -81702165)
2014,Junio,Guatemala,8,26,,34,POINT (3451668 -76532004)
2014,Junio,Guatemala,163,351,,514,POINT (4697157 -74140516)
2014,Junio,Guatemala,0,3,,3,POINT (4815189 -75736374)
2014,Junio,Guatemala,13,58,,71,POINT (6170465 -7542726)
2014,Junio,Guatemala,1,0,,1,POINT (7927233 -72508188)
2014,Junio,Guyana,1,0,,1,POINT (3451668 -76532004)
2014,Junio,Guyana,2,2,,4,POINT (4697157 -74140516)
2014,Junio,Guadalupe/Territorio Francés,0,1,,1,POINT (10886686 -74776479)
2014,Junio,Guadalupe/Territorio Francés,0,2,,2,POINT (4697157 -74140516)
2014,Junio,Haití,4,17,,21,POINT (10446304 -75516486)
2014,Junio,Haití,0,1,,1,POINT (10886686 -74776479)
2014,Junio,Haití,0,1,,1,POINT (3451668 -76532004)
2014,Junio,Haití,1,2,,3,POINT (4697157 -74140516)
2014,Junio,Haití,0,2,,2,POINT (6170465 -7542726)
2014,Junio,Honduras,1,0,,1,POINT (10446304 -75516486)
2014,Junio,Honduras,1,4,,5,POINT (10886686 -74776479)
2014,Junio,Honduras,0,8,,8,POINT (125862 -81702165)
2014,Junio,Honduras,6,11,,17,POINT (3451668 -76532004)
2014,Junio,Honduras,36,61,,97,POINT (4697157 -74140516)
2014,Junio,Honduras,0,2,,2,POINT (4815189 -75736374)
2014,Junio,Honduras,12,17,,29,POINT (6170465 -7542726)
2014,Junio,Honduras,1,0,,1,POINT (7927233 -72508188)
2014,Junio,Hong Kong,0,1,,1,POINT (10446304 -75516486)
2014,Junio,Hong Kong,4,8,,12,POINT (4697157 -74140516)
2014,Junio,Hungría,0,1,,1,POINT (4697157 -74140516)
2014,Junio,India,0,1,,1,POINT (10446304 -75516486)
2014,Junio,India,0,1,,1,POINT (10886686 -74776479)
2014,Junio,India,0,1,,1,POINT (3451668 -76532004)
2014,Junio,India,10,30,,40,POINT (4697157 -74140516)
2014,Junio,India,0,1,,1,POINT (6170465 -7542726)
2014,Junio,Indonesia,2,5,,7,POINT (4697157 -74140516)
2014,Junio,Iraq,0,1,,1,POINT (4697157 -74140516)
2014,Junio,Irán,0,1,,1,POINT (4697157 -74140516)
2014,Junio,Irán,1,0,,1,POINT (6170465 -7542726)
2014,Junio,República de Irlanda,1,1,,2,POINT (10886686 -74776479)
2014,Junio,República de Irlanda,8,11,,19,POINT (4697157 -74140516)
2014,Junio,República de Irlanda,1,1,,2,POINT (6170465 -7542726)
2014,Junio,Israel,0,1,,1,POINT (10446304 -75516486)
2014,Junio,Israel,0,2,,2,POINT (3451668 -76532004)
2014,Junio,Israel,16,79,,95,POINT (4697157 -74140516)
2014,Junio,Israel,1,2,,3,POINT (6170465 -7542726)
2014,Junio,Italia,0,2,,2,POINT (10446304 -75516486)
2014,Junio,Italia,1,1,,2,POINT (125862 -81702165)
2014,Junio,Italia,5,10,,15,POINT (3451668 -76532004)
2014,Junio,Italia,115,221,,336,POINT (4697157 -74140516)
2014,Junio,Italia,0,1,,1,POINT (4815189 -75736374)
2014,Junio,Italia,7,7,,14,POINT (6170465 -7542726)
2014,Junio,Jamaica,1,0,,1,POINT (10406342 -75527794)
2014,Junio,Jamaica,1,1,,2,POINT (10446304 -75516486)
2014,Junio,Jamaica,0,2,,2,POINT (10886686 -74776479)
2014,Junio,Jamaica,0,2,,2,POINT (10970933 -74765343)
2014,Junio,Jamaica,1,3,,4,POINT (11247723 -74213989)
2014,Junio,Jamaica,1,5,,6,POINT (125862 -81702165)
2014,Junio,Jamaica,0,1,,1,POINT (3451668 -76532004)
2014,Junio,Jamaica,4,16,,20,POINT (4697157 -74140516)
2014,Junio,Jamaica,0,1,,1,POINT (6170465 -7542726)
2014,Junio,Jamaica,0,1,,1,POINT (7927233 -72508188)
2014,Junio,Japón,2,0,,2,POINT (10886686 -74776479)
2014,Junio,Japón,1,1,,2,POINT (3451668 -76532004)
2014,Junio,Japón,13,19,,32,POINT (4697157 -74140516)
2014,Junio,Japón,1,1,,2,POINT (6170465 -7542726)
2014,Junio,Jordania,0,1,,1,POINT (4697157 -74140516)
2014,Junio,Letonia,0,1,,1,POINT (10446304 -75516486)
2014,Junio,Líbano,3,5,,8,POINT (4697157 -74140516)
2014,Junio,Liechtenstein,1,0,,1,POINT (4697157 -74140516)
2014,Junio,Luxemburgo,1,2,,3,POINT (4697157 -74140516)
2014,Junio,Malasia,0,1,,1,POINT (10446304 -75516486)
2014,Junio,Malasia,1,1,,2,POINT (4697157 -74140516)
2014,Junio,Malta,1,0,,1,POINT (4697157 -74140516)
2014,Junio,Malta,0,1,,1,POINT (4815189 -75736374)
2014,Junio,Marruecos,0,2,,2,POINT (11247723 -74213989)
2014,Junio,Marruecos,0,1,,1,POINT (4697157 -74140516)
2014,Junio,Mauritania,0,2,,2,POINT (4697157 -74140516)
2014,Junio,Martinica/Departamento de Ultramar Francés,0,2,,2,POINT (4697157 -74140516)
2014,Junio,Martinica/Departamento de Ultramar Francés,0,1,,1,POINT (6170465 -7542726)
2014,Junio,México,0,2,,2,POINT (10406342 -75527794)
2014,Junio,México,9,28,,37,POINT (10446304 -75516486)
2014,Junio,México,13,25,,38,POINT (10886686 -74776479)
2014,Junio,México,8,10,,18,POINT (125862 -81702165)
2014,Junio,México,2,7,,9,POINT (133387613 -81372937)
2014,Junio,México,20,62,,82,POINT (3451668 -76532004)
2014,Junio,México,3342,6183,,9525,POINT (4697157 -74140516)
2014,Junio,México,1,6,,7,POINT (4815189 -75736374)
2014,Junio,México,56,116,,172,POINT (6170465 -7542726)
2014,Junio,México,3,3,,6,POINT (7128047 -73181317)
2014,Junio,México,2,3,,5,POINT (7927233 -72508188)
2014,Junio,Mónaco,2,1,,3,POINT (4697157 -74140516)
2014,Junio,Nicaragua,1,1,,2,POINT (10446304 -75516486)
2014,Junio,Nicaragua,0,2,,2,POINT (10886686 -74776479)
2014,Junio,Nicaragua,1,3,,4,POINT (3451668 -76532004)
2014,Junio,Nicaragua,23,18,,41,POINT (4697157 -74140516)
2014,Junio,Nicaragua,4,2,,6,POINT (6170465 -7542726)
2014,Junio,Nigeria,2,4,,6,POINT (4697157 -74140516)
2014,Junio,Noruega,0,1,,1,POINT (10446304 -75516486)
2014,Junio,Noruega,1,0,,1,POINT (10886686 -74776479)
2014,Junio,Noruega,2,2,,4,POINT (3451668 -76532004)
2014,Junio,Noruega,23,14,,37,POINT (4697157 -74140516)
2014,Junio,Noruega,5,6,,11,POINT (6170465 -7542726)
2014,Junio,Nueva Zelanda,0,1,,1,POINT (3451668 -76532004)
2014,Junio,Nueva Zelanda,4,4,,8,POINT (4697157 -74140516)
2014,Junio,Nueva Zelanda,0,2,,2,POINT (4815189 -75736374)
2014,Junio,Omán,0,1,,1,POINT (4697157 -74140516)
2014,Junio,Papúa Nueva Guinea,0,1,,1,POINT (4697157 -74140516)
2014,Junio,Panamá,115,231,,346,POINT (10406342 -75527794)
2014,Junio,Panamá,1573,1781,,3354,POINT (10446304 -75516486)
2014,Junio,Panamá,201,448,,649,POINT (10886686 -74776479)
2014,Junio,Panamá,1,45,,46,POINT (10970933 -74765343)
2014,Junio,Panamá,1,4,,5,POINT (11247723 -74213989)
2014,Junio,Panamá,1321,1035,,2356,POINT (125862 -81702165)
2014,Junio,Panamá,0,10,,10,POINT (133387613 -81372937)
2014,Junio,Panamá,625,911,,1536,POINT (3451668 -76532004)
2014,Junio,Panamá,0,29,,29,POINT (3884426 -77061029)
2014,Junio,Panamá,2170,3790,,5960,POINT (4697157 -74140516)
2014,Junio,Panamá,115,203,,318,POINT (4815189 -75736374)
2014,Junio,Panamá,504,1167,,1671,POINT (6170465 -7542726)
2014,Junio,Panamá,1,5,,6,POINT (7102626 -77762647)
2014,Junio,Panamá,55,87,,142,POINT (7128047 -73181317)
2014,Junio,Panamá,82,101,,183,POINT (7927233 -72508188)
2014,Junio,Panamá,0,10,,10,POINT (806667 -767333)
2014,Junio,Panamá,61,111,,172,POINT (863337 -7735002)
2014,Junio,Paraguay,0,2,,2,POINT (10446304 -75516486)
2014,Junio,Paraguay,3,1,,4,POINT (125862 -81702165)
2014,Junio,Paraguay,4,2,,6,POINT (3451668 -76532004)
2014,Junio,Paraguay,27,40,,67,POINT (4697157 -74140516)
2014,Junio,Paraguay,2,14,,16,POINT (6170465 -7542726)
2014,Junio,Perú,151,251,,402,POINT (-4191162 -69941498)
2014,Junio,Perú,7,32,,39,POINT (0.81488 -77356)
2014,Junio,Perú,20,16,,36,POINT (10446304 -75516486)
2014,Junio,Perú,2,3,,5,POINT (10886686 -74776479)
2014,Junio,Perú,73,47,,120,POINT (125862 -81702165)
2014,Junio,Perú,190,311,,501,POINT (3451668 -76532004)
2014,Junio,Perú,4061,6014,,10075,POINT (4697157 -74140516)
2014,Junio,Perú,1,1,,2,POINT (4815189 -75736374)
2014,Junio,Perú,275,538,,813,POINT (6170465 -7542726)
2014,Junio,Perú,1,1,,2,POINT (7128047 -73181317)
2014,Junio,Perú,0,4,,4,POINT (7927233 -72508188)
2014,Junio,Polonia,1,0,,1,POINT (10886686 -74776479)
2014,Junio,Polonia,28,46,,74,POINT (4697157 -74140516)
2014,Junio,Polonia,1,0,,1,POINT (6170465 -7542726)
2014,Junio,Portugal,0,2,,2,POINT (3451668 -76532004)
2014,Junio,Portugal,30,62,,92,POINT (4697157 -74140516)
2014,Junio,Portugal,3,3,,6,POINT (6170465 -7542726)
2014,Junio,Puerto Rico/Territorio de Estados Unidos,0,1,,1,POINT (10406342 -75527794)
2014,Junio,Puerto Rico/Territorio de Estados Unidos,4,19,,23,POINT (10446304 -75516486)
2014,Junio,Puerto Rico/Territorio de Estados Unidos,5,15,,20,POINT (10886686 -74776479)
2014,Junio,Puerto Rico/Territorio de Estados Unidos,0,1,,1,POINT (125862 -81702165)
2014,Junio,Puerto Rico/Territorio de Estados Unidos,15,27,,42,POINT (3451668 -76532004)
2014,Junio,Puerto Rico/Territorio de Estados Unidos,278,326,,604,POINT (4697157 -74140516)
2014,Junio,Puerto Rico/Territorio de Estados Unidos,29,24,,53,POINT (4815189 -75736374)
2014,Junio,Puerto Rico/Territorio de Estados Unidos,28,64,,92,POINT (6170465 -7542726)
2014,Junio,Puerto Rico/Territorio de Estados Unidos,0,1,,1,POINT (7128047 -73181317)
2014,Junio,Puerto Rico/Territorio de Estados Unidos,1,1,,2,POINT (7927233 -72508188)
2014,Junio,Reino Unido de Gran Bretaña e Irlanda del Norte,2,0,,2,POINT (10446304 -75516486)
2014,Junio,Reino Unido de Gran Bretaña e Irlanda del Norte,0,2,,2,POINT (10886686 -74776479)
2014,Junio,Reino Unido de Gran Bretaña e Irlanda del Norte,0,2,,2,POINT (11247723 -74213989)
2014,Junio,Reino Unido de Gran Bretaña e Irlanda del Norte,7,7,,14,POINT (3451668 -76532004)
2014,Junio,Reino Unido de Gran Bretaña e Irlanda del Norte,92,178,,270,POINT (4697157 -74140516)
2014,Junio,Reino Unido de Gran Bretaña e Irlanda del Norte,5,6,,11,POINT (6170465 -7542726)
2014,Junio,Reino Unido de Gran Bretaña e Irlanda del Norte,1,0,,1,POINT (7128047 -73181317)
2014,Junio,Federación de Rusia,1,0,,1,POINT (10886686 -74776479)
2014,Junio,Federación de Rusia,16,19,,35,POINT (4697157 -74140516)
2014,Junio,Federación de Rusia,2,1,,3,POINT (6170465 -7542726)
2014,Junio,República Dominicana,24,20,,44,POINT (10406342 -75527794)
2014,Junio,República Dominicana,6,4,,10,POINT (10446304 -75516486)
2014,Junio,República Dominicana,1,18,,19,POINT (10886686 -74776479)
2014,Junio,República Dominicana,2,4,,6,POINT (11247723 -74213989)
2014,Junio,República Dominicana,21,24,,45,POINT (3451668 -76532004)
2014,Junio,República Dominicana,422,631,,1053,POINT (4697157 -74140516)
2014,Junio,República Dominicana,2,2,,4,POINT (4815189 -75736374)
2014,Junio,República Dominicana,22,22,,44,POINT (6170465 -7542726)
2014,Junio,República Dominicana,0,1,,1,POINT (7128047 -73181317)
2014,Junio,República Democrática Popular de Corea,0,1,,1,POINT (4697157 -74140516)
2014,Junio,Rumania,0,2,,2,POINT (4697157 -74140516)
2014,Junio,Senegal,2,0,,2,POINT (4697157 -74140516)
2014,Junio,Serbia,1,1,,2,POINT (4697157 -74140516)
2014,Junio,Singapur,5,1,,6,POINT (4697157 -74140516)
2014,Junio,República Árabe Siria,0,1,,1,POINT (4697157 -74140516)
2014,Junio,Sudáfrica,1,0,,1,POINT (3451668 -76532004)
2014,Junio,Sudáfrica,1,6,,7,POINT (4697157 -74140516)
2014,Junio,Sudán,1,0,,1,POINT (4697157 -74140516)
2014,Junio,Sudán,0,1,,1,POINT (6170465 -7542726)
2014,Junio,Suecia,1,0,,1,POINT (10886686 -74776479)
2014,Junio,Suecia,3,4,,7,POINT (3451668 -76532004)
2014,Junio,Suecia,28,25,,53,POINT (4697157 -74140516)
2014,Junio,Suecia,2,3,,5,POINT (6170465 -7542726)
2014,Junio,Suiza,0,4,,4,POINT (10446304 -75516486)
2014,Junio,Suiza,0,2,,2,POINT (10886686 -74776479)
2014,Junio,Suiza,6,2,,8,POINT (3451668 -76532004)
2014,Junio,Suiza,57,92,,149,POINT (4697157 -74140516)
2014,Junio,Suiza,7,4,,11,POINT (6170465 -7542726)
2014,Junio,Surinam,0,3,,3,POINT (10406342 -75527794)
2014,Junio,Surinam,2,4,,6,POINT (4697157 -74140516)
2014,Junio,Surinam,2,1,,3,POINT (6170465 -7542726)
2014,Junio,Taiwán,1,0,,1,POINT (10446304 -75516486)
2014,Junio,Taiwán,2,4,,6,POINT (4697157 -74140516)
2014,Junio,Taiwán,1,1,,2,POINT (6170465 -7542726)
2014,Junio,Tailandia,3,3,,6,POINT (4697157 -74140516)
2014,Junio,Trinidad y Tobago,0,32,,32,POINT (10406342 -75527794)
2014,Junio,Trinidad y Tobago,135,106,,241,POINT (10446304 -75516486)
2014,Junio,Trinidad y Tobago,0,3,,3,POINT (10886686 -74776479)
2014,Junio,Trinidad y Tobago,0,19,,19,POINT (11247723 -74213989)
2014,Junio,Trinidad y Tobago,1,0,,1,POINT (3451668 -76532004)
2014,Junio,Trinidad y Tobago,5,43,,48,POINT (4697157 -74140516)
2014,Junio,Trinidad y Tobago,0,4,,4,POINT (6170465 -7542726)
2014,Junio,Trinidad y Tobago,3,6,,9,POINT (7128047 -73181317)
2014,Junio,Túnez,1,1,,2,POINT (4697157 -74140516)
2014,Junio,Turquía,0,2,,2,POINT (10886686 -74776479)
2014,Junio,Turquía,5,14,,19,POINT (4697157 -74140516)
2014,Junio,Ucrania,1,3,,4,POINT (4697157 -74140516)
2014,Junio,Uruguay,1,1,,2,POINT (0.81488 -77356)
2014,Junio,Uruguay,15,11,,26,POINT (10446304 -75516486)
2014,Junio,Uruguay,0,1,,1,POINT (10886686 -74776479)
2014,Junio,Uruguay,4,6,,10,POINT (125862 -81702165)
2014,Junio,Uruguay,3,3,,6,POINT (3451668 -76532004)
2014,Junio,Uruguay,36,75,,111,POINT (4697157 -74140516)
2014,Junio,Uruguay,14,29,,43,POINT (6170465 -7542726)
2014,Junio,Vanuatu,1,1,,2,POINT (4697157 -74140516)
2014,Junio,Venezuela,0,18,,18,POINT (10406342 -75527794)
2014,Junio,Venezuela,4,10,,14,POINT (10446304 -75516486)
2014,Junio,Venezuela,20,56,,76,POINT (10886686 -74776479)
2014,Junio,Venezuela,0,2,,2,POINT (10970933 -74765343)
2014,Junio,Venezuela,1,2,,3,POINT (11117206 -74232675)
2014,Junio,Venezuela,1189,1867,,3056,POINT (11360029 -72129595)
2014,Junio,Venezuela,9,18,,27,POINT (3451668 -76532004)
2014,Junio,Venezuela,4483,5441,,9924,POINT (4697157 -74140516)
2014,Junio,Venezuela,1,1,,2,POINT (4815189 -75736374)
2014,Junio,Venezuela,64,104,,168,POINT (6170465 -7542726)
2014,Junio,Venezuela,35,51,,86,POINT (6185536 -67484028)
2014,Junio,Venezuela,82,169,,251,POINT (7088729 -70740253)
2014,Junio,Venezuela,4,12,,16,POINT (7128047 -73181317)
2014,Junio,Venezuela,1494,2076,,3570,POINT (7819 -72453013)
2014,Junio,Venezuela,156,172,,328,POINT (7927233 -72508188)
2014,Junio,Vietnam,0,1,,1,POINT (4697157 -74140516)
2014,Junio,Zambia,2,0,,2,POINT (3451668 -76532004)
2014,Junio,Zimbabue,0,1,,1,POINT (4697157 -74140516)
2014,Junio,Islas Turcas y Caicos/Territorio Británico de Ultramar,0,1,,1,POINT (10886686 -74776479)
2014,Junio,Desconocido,0,1,,1,POINT (4697157 -74140516)
2014,Junio,Desconocido,6,14,,20,POINT (863337 -7735002)
2014,Julio,Afganistán,0,1,,1,POINT (4697157 -74140516)
2014,Julio,Afganistán,0,1,,1,POINT (6170465 -7542726)
2014,Julio,Alemania,2,3,,5,POINT (10446304 -75516486)
2014,Julio,Alemania,5,3,,8,POINT (10886686 -74776479)
2014,Julio,Alemania,0,1,,1,POINT (10970933 -74765343)
2014,Julio,Alemania,17,12,,29,POINT (3451668 -76532004)
2014,Julio,Alemania,1666,2309,,3975,POINT (4697157 -74140516)
2014,Julio,Alemania,0,1,,1,POINT (4815189 -75736374)
2014,Julio,Alemania,12,25,,37,POINT (6170465 -7542726)
2014,Julio,Andorra,1,1,,2,POINT (4697157 -74140516)
2014,Julio,Antigua y Barbuda,0,3,,3,POINT (10406342 -75527794)
2014,Julio,Países Bajos,21,14,,35,POINT (10406342 -75527794)
2014,Julio,Países Bajos,1,2,,3,POINT (10446304 -75516486)
2014,Julio,Países Bajos,2,7,,9,POINT (10886686 -74776479)
2014,Julio,Países Bajos,1,1,,2,POINT (11247723 -74213989)
2014,Julio,Países Bajos,6,8,,14,POINT (3451668 -76532004)
2014,Julio,Países Bajos,89,129,,218,POINT (4697157 -74140516)
2014,Julio,Países Bajos,2,4,,6,POINT (4815189 -75736374)
2014,Julio,Países Bajos,43,66,,109,POINT (6170465 -7542726)
2014,Julio,Países Bajos,5,4,,9,POINT (7128047 -73181317)
2014,Julio,Arabia Saudita,1,3,,4,POINT (4697157 -74140516)
2014,Julio,Argelia,3,8,,11,POINT (4697157 -74140516)
2014,Julio,Argelia,0,1,,1,POINT (6170465 -7542726)
2014,Julio,Argentina,2,0,,2,POINT (0.81488 -77356)
2014,Julio,Argentina,0,18,,18,POINT (10406342 -75527794)
2014,Julio,Argentina,66,60,,126,POINT (10446304 -75516486)
2014,Julio,Argentina,10,14,,24,POINT (10886686 -74776479)
2014,Julio,Argentina,23,14,,37,POINT (125862 -81702165)
2014,Julio,Argentina,36,51,,87,POINT (3451668 -76532004)
2014,Julio,Argentina,0,10,,10,POINT (3884426 -77061029)
2014,Julio,Argentina,2252,2743,,4995,POINT (4697157 -74140516)
2014,Julio,Argentina,3,3,,6,POINT (4815189 -75736374)
2014,Julio,Argentina,74,138,,212,POINT (6170465 -7542726)
2014,Julio,Aruba,62,57,,119,POINT (10406342 -75527794)
2014,Julio,Aruba,0,1,,1,POINT (10446304 -75516486)
2014,Julio,Aruba,2,5,,7,POINT (10886686 -74776479)
2014,Julio,Aruba,4,9,,13,POINT (11247723 -74213989)
2014,Julio,Aruba,6,4,,10,POINT (3451668 -76532004)
2014,Julio,Aruba,888,967,,1855,POINT (4697157 -74140516)
2014,Julio,Aruba,2,1,,3,POINT (4815189 -75736374)
2014,Julio,Aruba,2,9,,11,POINT (6170465 -7542726)
2014,Julio,Aruba,4,2,,6,POINT (7128047 -73181317)
2014,Julio,Australia,4,5,,9,POINT (10446304 -75516486)
2014,Julio,Australia,2,0,,2,POINT (10886686 -74776479)
2014,Julio,Australia,1,3,,4,POINT (3451668 -76532004)
2014,Julio,Australia,24,25,,49,POINT (4697157 -74140516)
2014,Julio,Australia,11,16,,27,POINT (6170465 -7542726)
2014,Julio,Austria,0,1,,1,POINT (10886686 -74776479)
2014,Julio,Austria,2,2,,4,POINT (3451668 -76532004)
2014,Julio,Austria,32,30,,62,POINT (4697157 -74140516)
2014,Julio,Austria,0,2,,2,POINT (6170465 -7542726)
2014,Julio,Bahamas,0,2,,2,POINT (10446304 -75516486)
2014,Julio,Bahamas,0,1,,1,POINT (125862 -81702165)
2014,Julio,Bahamas,2,6,,8,POINT (4697157 -74140516)
2014,Julio,Bahamas,0,2,,2,POINT (6170465 -7542726)
2014,Julio,Bahréin,1,0,,1,POINT (10446304 -75516486)
2014,Julio,Barbados,0,2,,2,POINT (10446304 -75516486)
2014,Julio,Barbados,1,0,,1,POINT (6170465 -7542726)
2014,Julio,Barbados,1,0,,1,POINT (7128047 -73181317)
2014,Julio,República de Belarús,1,2,,3,POINT (11360029 -72129595)
2014,Julio,República de Belarús,1,1,,2,POINT (4697157 -74140516)
2014,Julio,Bélgica,0,6,,6,POINT (10886686 -74776479)
2014,Julio,Bélgica,0,2,,2,POINT (11247723 -74213989)
2014,Julio,Bélgica,1,6,,7,POINT (3451668 -76532004)
2014,Julio,Bélgica,52,56,,108,POINT (4697157 -74140516)
2014,Julio,Bélgica,3,11,,14,POINT (6170465 -7542726)
2014,Julio,Belice,0,1,,1,POINT (3451668 -76532004)
2014,Julio,Belice,1,4,,5,POINT (4697157 -74140516)
2014,Julio,Bermudas/Territorio Británico de Ultramar,1,3,,4,POINT (10446304 -75516486)
2014,Julio,Bolivia,5,2,,7,POINT (10446304 -75516486)
2014,Julio,Bolivia,0,2,,2,POINT (10886686 -74776479)
2014,Julio,Bolivia,5,3,,8,POINT (3451668 -76532004)
2014,Julio,Bolivia,385,503,,888,POINT (4697157 -74140516)
2014,Julio,Bolivia,11,19,,30,POINT (6170465 -7542726)
2014,Julio,Botsuana,0,2,,2,POINT (4697157 -74140516)
2014,Julio,Brasil,151,252,,403,POINT (-4191162 -69941498)
2014,Julio,Brasil,4,13,,17,POINT (-4214082 -69941431)
2014,Julio,Brasil,0,6,,6,POINT (10406342 -75527794)
2014,Julio,Brasil,93,62,,155,POINT (10446304 -75516486)
2014,Julio,Brasil,8,29,,37,POINT (10886686 -74776479)
2014,Julio,Brasil,46,46,,92,POINT (125862 -81702165)
2014,Julio,Brasil,15,46,,61,POINT (3451668 -76532004)
2014,Julio,Brasil,3079,4811,,7890,POINT (4697157 -74140516)
2014,Julio,Brasil,5,3,,8,POINT (4815189 -75736374)
2014,Julio,Brasil,102,189,,291,POINT (6170465 -7542726)
2014,Julio,Brasil,0,1,,1,POINT (7128047 -73181317)
2014,Julio,Brasil,1,1,,2,POINT (7927233 -72508188)
2014,Julio,Brunei Darussalam,0,1,,1,POINT (4697157 -74140516)
2014,Julio,Bulgaria,2,1,,3,POINT (4697157 -74140516)
2014,Julio,Burkina Faso,0,1,,1,POINT (4697157 -74140516)
2014,Julio,Islas Caimán/Territorio Británico de Ultramar,0,3,,3,POINT (125862 -81702165)
2014,Julio,Islas Caimán/Territorio Británico de Ultramar,0,2,,2,POINT (133387613 -81372937)
2014,Julio,Islas Caimán/Territorio Británico de Ultramar,0,1,,1,POINT (4697157 -74140516)
2014,Julio,Camerún,0,1,,1,POINT (4697157 -74140516)
2014,Julio,Canadá,0,19,,19,POINT (10406342 -75527794)
2014,Julio,Canadá,4,8,,12,POINT (10446304 -75516486)
2014,Julio,Canadá,2,5,,7,POINT (10886686 -74776479)
2014,Julio,Canadá,3,0,,3,POINT (125862 -81702165)
2014,Julio,Canadá,16,28,,44,POINT (3451668 -76532004)
2014,Julio,Canadá,735,1130,,1865,POINT (4697157 -74140516)
2014,Julio,Canadá,3,5,,8,POINT (4815189 -75736374)
2014,Julio,Canadá,99,111,,210,POINT (6170465 -7542726)
2014,Julio,Canadá,0,5,,5,POINT (7128047 -73181317)
2014,Julio,Canadá,0,1,,1,POINT (7927233 -72508188)
2014,Julio,España,0,3,,3,POINT (10406342 -75527794)
2014,Julio,España,2,4,,6,POINT (10446304 -75516486)
2014,Julio,España,0,2,,2,POINT (10886686 -74776479)
2014,Julio,España,292,401,,693,POINT (3451668 -76532004)
2014,Julio,España,2635,4550,,7185,POINT (4697157 -74140516)
2014,Julio,España,0,3,,3,POINT (4815189 -75736374)
2014,Julio,España,198,352,,550,POINT (6170465 -7542726)
2014,Julio,España,1,0,,1,POINT (7128047 -73181317)
2014,Julio,España,0,1,,1,POINT (7927233 -72508188)
2014,Julio,Comoras,1,1,,2,POINT (4697157 -74140516)
2014,Julio,República de Corea,11,12,,23,POINT (4697157 -74140516)
2014,Julio,República de Corea,2,5,,7,POINT (6170465 -7542726)
2014,Julio,Costa de Marfil,0,6,,6,POINT (4697157 -74140516)
2014,Julio,Costa Rica,9,17,,26,POINT (10446304 -75516486)
2014,Julio,Costa Rica,9,17,,26,POINT (10886686 -74776479)
2014,Julio,Costa Rica,0,6,,6,POINT (11247723 -74213989)
2014,Julio,Costa Rica,6,7,,13,POINT (125862 -81702165)
2014,Julio,Costa Rica,4,13,,17,POINT (3451668 -76532004)
2014,Julio,Costa Rica,0,3,,3,POINT (3884426 -77061029)
2014,Julio,Costa Rica,583,1016,,1599,POINT (4697157 -74140516)
2014,Julio,Costa Rica,7,13,,20,POINT (4815189 -75736374)
2014,Julio,Costa Rica,58,71,,129,POINT (6170465 -7542726)
2014,Julio,Costa Rica,0,1,,1,POINT (7128047 -73181317)
2014,Julio,Costa Rica,0,1,,1,POINT (7927233 -72508188)
2014,Julio,Costa Rica,0,2,,2,POINT (806667 -767333)
2014,Julio,Croacia,0,1,,1,POINT (10446304 -75516486)
2014,Julio,Croacia,0,1,,1,POINT (10886686 -74776479)
2014,Julio,Croacia,2,4,,6,POINT (4697157 -74140516)
2014,Julio,Cuba,9,4,,13,POINT (10446304 -75516486)
2014,Julio,Cuba,7,6,,13,POINT (10886686 -74776479)
2014,Julio,Cuba,12,11,,23,POINT (3451668 -76532004)
2014,Julio,Cuba,190,316,,506,POINT (4697157 -74140516)
2014,Julio,Cuba,0,1,,1,POINT (4815189 -75736374)
2014,Julio,Cuba,11,7,,18,POINT (6170465 -7542726)
2014,Julio,Cuba,0,1,,1,POINT (7128047 -73181317)
2014,Julio,Cuba,1,1,,2,POINT (7927233 -72508188)
2014,Julio,Curazao,1,1,,2,POINT (10406342 -75527794)
2014,Julio,Curazao,77,76,,153,POINT (10886686 -74776479)
2014,Julio,Curazao,4,9,,13,POINT (11247723 -74213989)
2014,Julio,Curazao,1,3,,4,POINT (3451668 -76532004)
2014,Julio,Curazao,237,328,,565,POINT (4697157 -74140516)
2014,Julio,Curazao,243,269,,512,POINT (6170465 -7542726)
2014,Julio,República Checa,0,1,,1,POINT (10446304 -75516486)
2014,Julio,República Checa,7,4,,11,POINT (4697157 -74140516)
2014,Julio,Chile,11,9,,20,POINT (10446304 -75516486)
2014,Julio,Chile,6,6,,12,POINT (10886686 -74776479)
2014,Julio,Chile,23,24,,47,POINT (125862 -81702165)
2014,Julio,Chile,28,35,,63,POINT (3451668 -76532004)
2014,Julio,Chile,3526,4367,,7893,POINT (4697157 -74140516)
2014,Julio,Chile,1,1,,2,POINT (4815189 -75736374)
2014,Julio,Chile,30,89,,119,POINT (6170465 -7542726)
2014,Julio,China,1,0,,1,POINT (10446304 -75516486)
2014,Julio,China,1,0,,1,POINT (10886686 -74776479)
2014,Julio,China,1,1,,2,POINT (3451668 -76532004)
2014,Julio,China,30,79,,109,POINT (4697157 -74140516)
2014,Julio,China,1,2,,3,POINT (6170465 -7542726)
2014,Julio,Dinamarca,1,0,,1,POINT (125862 -81702165)
2014,Julio,Dinamarca,1,2,,3,POINT (3451668 -76532004)
2014,Julio,Dinamarca,8,9,,17,POINT (4697157 -74140516)
2014,Julio,Dinamarca,3,2,,5,POINT (6170465 -7542726)
2014,Julio,Dominica,1,0,,1,POINT (3451668 -76532004)
2014,Julio,Ecuador,72,127,,199,POINT (0.33002 -76876446)
2014,Julio,Ecuador,3148,4243,,7391,POINT (0.81488 -77356)
2014,Julio,Ecuador,6,260,,266,POINT (1800143 -78802679)
2014,Julio,Ecuador,0,10,,10,POINT (10406342 -75527794)
2014,Julio,Ecuador,51,29,,80,POINT (10446304 -75516486)
2014,Julio,Ecuador,3,8,,11,POINT (10886686 -74776479)
2014,Julio,Ecuador,2,2,,4,POINT (125862 -81702165)
2014,Julio,Ecuador,618,758,,1376,POINT (3451668 -76532004)
2014,Julio,Ecuador,0,5,,5,POINT (3884426 -77061029)
2014,Julio,Ecuador,2942,4534,,7476,POINT (4697157 -74140516)
2014,Julio,Ecuador,0,3,,3,POINT (4815189 -75736374)
2014,Julio,Ecuador,581,642,,1223,POINT (6170465 -7542726)
2014,Julio,Ecuador,2,2,,4,POINT (7927233 -72508188)
2014,Julio,Egipto,0,2,,2,POINT (10406342 -75527794)
2014,Julio,Egipto,3,2,,5,POINT (4697157 -74140516)
2014,Julio,El Salvador,2,5,,7,POINT (10446304 -75516486)
2014,Julio,El Salvador,1,2,,3,POINT (10886686 -74776479)
2014,Julio,El Salvador,106,159,,265,POINT (3451668 -76532004)
2014,Julio,El Salvador,746,1178,,1924,POINT (4697157 -74140516)
2014,Julio,El Salvador,1,0,,1,POINT (4815189 -75736374)
2014,Julio,El Salvador,123,231,,354,POINT (6170465 -7542726)
2014,Julio,Emiratos Árabes,4,4,,8,POINT (4697157 -74140516)
2014,Julio,Eritrea,0,2,,2,POINT (4697157 -74140516)
2014,Julio,Eslovaquia,2,2,,4,POINT (4697157 -74140516)
2014,Julio,Eslovenia,4,3,,7,POINT (4697157 -74140516)
2014,Julio,Eslovenia,0,1,,1,POINT (6170465 -7542726)
2014,Julio,Estados Unidos de América,1,18,,19,POINT (10406342 -75527794)
2014,Julio,Estados Unidos de América,1804,2664,,4468,POINT (10446304 -75516486)
2014,Julio,Estados Unidos de América,448,622,,1070,POINT (10886686 -74776479)
2014,Julio,Estados Unidos de América,0,1,,1,POINT (10970933 -74765343)
2014,Julio,Estados Unidos de América,0,4,,4,POINT (11247723 -74213989)
2014,Julio,Estados Unidos de América,14,22,,36,POINT (125862 -81702165)
2014,Julio,Estados Unidos de América,1385,1751,,3136,POINT (3451668 -76532004)
2014,Julio,Estados Unidos de América,0,3,,3,POINT (3884426 -77061029)
2014,Julio,Estados Unidos de América,197,198,,395,POINT (445285 -75766353)
2014,Julio,Estados Unidos de América,10238,16690,,26928,POINT (4697157 -74140516)
2014,Julio,Estados Unidos de América,188,183,,371,POINT (4815189 -75736374)
2014,Julio,Estados Unidos de América,2694,4564,,7258,POINT (6170465 -7542726)
2014,Julio,Estados Unidos de América,32,31,,63,POINT (7128047 -73181317)
2014,Julio,Estados Unidos de América,26,37,,63,POINT (7927233 -72508188)
2014,Julio,Estados Unidos de América,0,14,,14,POINT (9402597 -75681642)
2014,Julio,Estonia,1,1,,2,POINT (3451668 -76532004)
2014,Julio,Estonia,2,0,,2,POINT (4697157 -74140516)
2014,Julio,Etiopia,0,1,,1,POINT (4697157 -74140516)
2014,Julio,Islas Fiji,0,1,,1,POINT (4697157 -74140516)
2014,Julio,Filipinas,0,1,,1,POINT (10446304 -75516486)
2014,Julio,Filipinas,0,3,,3,POINT (10886686 -74776479)
2014,Julio,Filipinas,0,3,,3,POINT (3451668 -76532004)
2014,Julio,Filipinas,1,3,,4,POINT (4697157 -74140516)
2014,Julio,Finlandia,1,1,,2,POINT (10446304 -75516486)
2014,Julio,Finlandia,1,1,,2,POINT (10886686 -74776479)
2014,Julio,Finlandia,0,4,,4,POINT (3884426 -77061029)
2014,Julio,Finlandia,4,1,,5,POINT (4697157 -74140516)
2014,Julio,Finlandia,0,1,,1,POINT (6170465 -7542726)
2014,Julio,Francia,2,4,,6,POINT (10446304 -75516486)
2014,Julio,Francia,7,10,,17,POINT (10886686 -74776479)
2014,Julio,Francia,10,16,,26,POINT (3451668 -76532004)
2014,Julio,Francia,1474,2399,,3873,POINT (4697157 -74140516)
2014,Julio,Francia,3,2,,5,POINT (4815189 -75736374)
2014,Julio,Francia,11,29,,40,POINT (6170465 -7542726)
2014,Julio,Francia,2,3,,5,POINT (7128047 -73181317)
2014,Julio,Gabón,0,1,,1,POINT (4697157 -74140516)
2014,Julio,Georgia,0,1,,1,POINT (3451668 -76532004)
2014,Julio,Georgia,3,0,,3,POINT (4697157 -74140516)
2014,Julio,Granada,2,1,,3,POINT (4697157 -74140516)
2014,Julio,Grecia,7,13,,20,POINT (4697157 -74140516)
2014,Julio,Guatemala,5,6,,11,POINT (10446304 -75516486)
2014,Julio,Guatemala,4,7,,11,POINT (10886686 -74776479)
2014,Julio,Guatemala,3,0,,3,POINT (125862 -81702165)
2014,Julio,Guatemala,11,31,,42,POINT (3451668 -76532004)
2014,Julio,Guatemala,187,342,,529,POINT (4697157 -74140516)
2014,Julio,Guatemala,0,5,,5,POINT (4815189 -75736374)
2014,Julio,Guatemala,22,32,,54,POINT (6170465 -7542726)
2014,Julio,Guatemala,0,1,,1,POINT (7927233 -72508188)
2014,Julio,Guyana,2,3,,5,POINT (4697157 -74140516)
2014,Julio,Guinea,2,0,,2,POINT (4697157 -74140516)
2014,Julio,Guinea Ecuatorial,0,1,,1,POINT (4697157 -74140516)
2014,Julio,Guadalupe/Territorio Francés,0,1,,1,POINT (10886686 -74776479)
2014,Julio,Guadalupe/Territorio Francés,3,4,,7,POINT (4697157 -74140516)
2014,Julio,Guayana Francesa/Departamento de Ultramar Francés,0,1,,1,POINT (4697157 -74140516)
2014,Julio,Guayana Francesa/Departamento de Ultramar Francés,1,0,,1,POINT (6170465 -7542726)
2014,Julio,Haití,0,11,,11,POINT (10406342 -75527794)
2014,Julio,Haití,0,1,,1,POINT (10446304 -75516486)
2014,Julio,Haití,1,0,,1,POINT (3451668 -76532004)
2014,Julio,Haití,0,9,,9,POINT (4697157 -74140516)
2014,Julio,Haití,0,1,,1,POINT (4815189 -75736374)
2014,Julio,Haití,2,0,,2,POINT (6170465 -7542726)
2014,Julio,Honduras,1,4,,5,POINT (10446304 -75516486)
2014,Julio,Honduras,1,2,,3,POINT (10886686 -74776479)
2014,Julio,Honduras,1,1,,2,POINT (125862 -81702165)
2014,Julio,Honduras,1,2,,3,POINT (3451668 -76532004)
2014,Julio,Honduras,27,61,,88,POINT (4697157 -74140516)
2014,Julio,Honduras,2,3,,5,POINT (4815189 -75736374)
2014,Julio,Honduras,20,16,,36,POINT (6170465 -7542726)
2014,Julio,Honduras,0,1,,1,POINT (7927233 -72508188)
2014,Julio,Hong Kong,1,0,,1,POINT (10446304 -75516486)
2014,Julio,Hong Kong,4,1,,5,POINT (4697157 -74140516)
2014,Julio,Hungría,2,1,,3,POINT (10446304 -75516486)
2014,Julio,Hungría,4,4,,8,POINT (4697157 -74140516)
2014,Julio,India,0,1,,1,POINT (10886686 -74776479)
2014,Julio,India,0,2,,2,POINT (3451668 -76532004)
2014,Julio,India,5,24,,29,POINT (4697157 -74140516)
2014,Julio,India,0,2,,2,POINT (4815189 -75736374)
2014,Julio,India,1,1,,2,POINT (6170465 -7542726)
2014,Julio,Indonesia,0,1,,1,POINT (3451668 -76532004)
2014,Julio,República de Irlanda,1,0,,1,POINT (10446304 -75516486)
2014,Julio,República de Irlanda,12,12,,24,POINT (4697157 -74140516)
2014,Julio,República de Irlanda,0,1,,1,POINT (6170465 -7542726)
2014,Julio,Israel,0,1,,1,POINT (10446304 -75516486)
2014,Julio,Israel,0,1,,1,POINT (10886686 -74776479)
2014,Julio,Israel,0,1,,1,POINT (3451668 -76532004)
2014,Julio,Israel,18,45,,63,POINT (4697157 -74140516)
2014,Julio,Israel,0,1,,1,POINT (6170465 -7542726)
2014,Julio,Islas Aland/Provincia de Finlandia,0,1,,1,POINT (4697157 -74140516)
2014,Julio,Italia,0,5,,5,POINT (10446304 -75516486)
2014,Julio,Italia,3,5,,8,POINT (10886686 -74776479)
2014,Julio,Italia,2,9,,11,POINT (3451668 -76532004)
2014,Julio,Italia,81,165,,246,POINT (4697157 -74140516)
2014,Julio,Italia,7,15,,22,POINT (6170465 -7542726)
2014,Julio,Jamaica,0,1,,1,POINT (10406342 -75527794)
2014,Julio,Jamaica,1,5,,6,POINT (10446304 -75516486)
2014,Julio,Jamaica,0,2,,2,POINT (10886686 -74776479)
2014,Julio,Jamaica,0,1,,1,POINT (11117206 -74232675)
2014,Julio,Jamaica,1,1,,2,POINT (3451668 -76532004)
2014,Julio,Jamaica,3,17,,20,POINT (4697157 -74140516)
2014,Julio,Jamaica,2,0,,2,POINT (6170465 -7542726)
2014,Julio,Jamaica,2,1,,3,POINT (7128047 -73181317)
2014,Julio,Japón,0,1,,1,POINT (10886686 -74776479)
2014,Julio,Japón,0,2,,2,POINT (3451668 -76532004)
2014,Julio,Japón,59,216,,275,POINT (4697157 -74140516)
2014,Julio,Japón,0,1,,1,POINT (4815189 -75736374)
2014,Julio,Japón,3,1,,4,POINT (6170465 -7542726)
2014,Julio,Jordania,0,1,,1,POINT (4697157 -74140516)
2014,Julio,Kenia,0,1,,1,POINT (4697157 -74140516)
2014,Julio,República Democrática Popular  Lao,2,0,,2,POINT (4697157 -74140516)
2014,Julio,Letonia,0,1,,1,POINT (10886686 -74776479)
2014,Julio,Letonia,2,3,,5,POINT (4697157 -74140516)
2014,Julio,Lituania,2,1,,3,POINT (4697157 -74140516)
2014,Julio,Líbano,4,4,,8,POINT (4697157 -74140516)
2014,Julio,Luxemburgo,4,1,,5,POINT (4697157 -74140516)
2014,Julio,Malasia,0,3,,3,POINT (4697157 -74140516)
2014,Julio,Malasia,0,1,,1,POINT (6170465 -7542726)
2014,Julio,Malta,1,1,,2,POINT (4697157 -74140516)
2014,Julio,Marruecos,0,1,,1,POINT (11247723 -74213989)
2014,Julio,Marruecos,0,1,,1,POINT (4697157 -74140516)
2014,Julio,Mauritania,0,1,,1,POINT (4697157 -74140516)
2014,Julio,México,0,1,,1,POINT (10406342 -75527794)
2014,Julio,México,31,48,,79,POINT (10446304 -75516486)
2014,Julio,México,27,38,,65,POINT (10886686 -74776479)
2014,Julio,México,5,8,,13,POINT (125862 -81702165)
2014,Julio,México,36,45,,81,POINT (3451668 -76532004)
2014,Julio,México,4500,7360,,11860,POINT (4697157 -74140516)
2014,Julio,México,15,20,,35,POINT (4815189 -75736374)
2014,Julio,México,162,238,,400,POINT (6170465 -7542726)
2014,Julio,México,5,4,,9,POINT (7128047 -73181317)
2014,Julio,México,5,7,,12,POINT (7927233 -72508188)
2014,Julio,Mónaco,0,10,,10,POINT (4697157 -74140516)
2014,Julio,Nicaragua,3,0,,3,POINT (10446304 -75516486)
2014,Julio,Nicaragua,1,1,,2,POINT (10886686 -74776479)
2014,Julio,Nicaragua,0,1,,1,POINT (125862 -81702165)
2014,Julio,Nicaragua,2,3,,5,POINT (3451668 -76532004)
2014,Julio,Nicaragua,24,21,,45,POINT (4697157 -74140516)
2014,Julio,Nicaragua,1,1,,2,POINT (4815189 -75736374)
2014,Julio,Nicaragua,12,9,,21,POINT (6170465 -7542726)
2014,Julio,Nigeria,10,9,,19,POINT (3451668 -76532004)
2014,Julio,Nigeria,2,2,,4,POINT (4697157 -74140516)
2014,Julio,Nigeria,0,1,,1,POINT (6170465 -7542726)
2014,Julio,Noruega,1,1,,2,POINT (10446304 -75516486)
2014,Julio,Noruega,0,1,,1,POINT (10886686 -74776479)
2014,Julio,Noruega,15,23,,38,POINT (4697157 -74140516)
2014,Julio,Noruega,1,1,,2,POINT (6170465 -7542726)
2014,Julio,Nueva Zelanda,1,0,,1,POINT (10446304 -75516486)
2014,Julio,Nueva Zelanda,0,1,,1,POINT (3451668 -76532004)
2014,Julio,Nueva Zelanda,2,8,,10,POINT (4697157 -74140516)
2014,Julio,Nueva Zelanda,0,1,,1,POINT (6170465 -7542726)
2014,Julio,Omán,1,0,,1,POINT (4697157 -74140516)
2014,Julio,Papúa Nueva Guinea,0,1,,1,POINT (4697157 -74140516)
2014,Julio,Panamá,443,507,,950,POINT (10406342 -75527794)
2014,Julio,Panamá,1730,2129,,3859,POINT (10446304 -75516486)
2014,Julio,Panamá,231,425,,656,POINT (10886686 -74776479)
2014,Julio,Panamá,1,17,,18,POINT (10970933 -74765343)
2014,Julio,Panamá,889,793,,1682,POINT (125862 -81702165)
2014,Julio,Panamá,5,7,,12,POINT (133387613 -81372937)
2014,Julio,Panamá,629,936,,1565,POINT (3451668 -76532004)
2014,Julio,Panamá,0,33,,33,POINT (3884426 -77061029)
2014,Julio,Panamá,2344,4333,,6677,POINT (4697157 -74140516)
2014,Julio,Panamá,171,171,,342,POINT (4815189 -75736374)
2014,Julio,Panamá,905,1709,,2614,POINT (6170465 -7542726)
2014,Julio,Panamá,4,4,,8,POINT (7102626 -77762647)
2014,Julio,Panamá,55,82,,137,POINT (7128047 -73181317)
2014,Julio,Panamá,89,134,,223,POINT (7927233 -72508188)
2014,Julio,Panamá,0,2,,2,POINT (806667 -767333)
2014,Julio,Paraguay,2,2,,4,POINT (10446304 -75516486)
2014,Julio,Paraguay,1,4,,5,POINT (10886686 -74776479)
2014,Julio,Paraguay,5,2,,7,POINT (125862 -81702165)
2014,Julio,Paraguay,4,4,,8,POINT (3451668 -76532004)
2014,Julio,Paraguay,12,39,,51,POINT (4697157 -74140516)
2014,Julio,Paraguay,33,18,,51,POINT (6170465 -7542726)
2014,Julio,Perú,210,310,,520,POINT (-4191162 -69941498)
2014,Julio,Perú,27,52,,79,POINT (-4214082 -69941431)
2014,Julio,Perú,1,4,,5,POINT (0.33002 -76876446)
2014,Julio,Perú,5,8,,13,POINT (0.81488 -77356)
2014,Julio,Perú,26,28,,54,POINT (10446304 -75516486)
2014,Julio,Perú,8,14,,22,POINT (10886686 -74776479)
2014,Julio,Perú,51,19,,70,POINT (125862 -81702165)
2014,Julio,Perú,304,417,,721,POINT (3451668 -76532004)
2014,Julio,Perú,6334,8132,,14466,POINT (4697157 -74140516)
2014,Julio,Perú,2,3,,5,POINT (4815189 -75736374)
2014,Julio,Perú,536,650,,1186,POINT (6170465 -7542726)
2014,Julio,Perú,1,2,,3,POINT (7128047 -73181317)
2014,Julio,Perú,2,0,,2,POINT (7927233 -72508188)
2014,Julio,Polonia,1,1,,2,POINT (10886686 -74776479)
2014,Julio,Polonia,1,0,,1,POINT (3451668 -76532004)
2014,Julio,Polonia,20,14,,34,POINT (4697157 -74140516)
2014,Julio,Polonia,1,0,,1,POINT (6170465 -7542726)
2014,Julio,Portugal,2,2,,4,POINT (3451668 -76532004)
2014,Julio,Portugal,1007,1214,,2221,POINT (4697157 -74140516)
2014,Julio,Portugal,10,17,,27,POINT (6170465 -7542726)
2014,Julio,Puerto Rico/Territorio de Estados Unidos,0,7,,7,POINT (10406342 -75527794)
2014,Julio,Puerto Rico/Territorio de Estados Unidos,3,31,,34,POINT (10446304 -75516486)
2014,Julio,Puerto Rico/Territorio de Estados Unidos,3,12,,15,POINT (10886686 -74776479)
2014,Julio,Puerto Rico/Territorio de Estados Unidos,0,1,,1,POINT (125862 -81702165)
2014,Julio,Puerto Rico/Territorio de Estados Unidos,14,13,,27,POINT (3451668 -76532004)
2014,Julio,Puerto Rico/Territorio de Estados Unidos,339,395,,734,POINT (4697157 -74140516)
2014,Julio,Puerto Rico/Territorio de Estados Unidos,11,4,,15,POINT (4815189 -75736374)
2014,Julio,Puerto Rico/Territorio de Estados Unidos,20,62,,82,POINT (6170465 -7542726)
2014,Julio,Puerto Rico/Territorio de Estados Unidos,7,12,,19,POINT (7128047 -73181317)
2014,Julio,Puerto Rico/Territorio de Estados Unidos,1,1,,2,POINT (7927233 -72508188)
2014,Julio,Reino Unido de Gran Bretaña e Irlanda del Norte,4,2,,6,POINT (10446304 -75516486)
2014,Julio,Reino Unido de Gran Bretaña e Irlanda del Norte,1,1,,2,POINT (10886686 -74776479)
2014,Julio,Reino Unido de Gran Bretaña e Irlanda del Norte,5,17,,22,POINT (3451668 -76532004)
2014,Julio,Reino Unido de Gran Bretaña e Irlanda del Norte,580,860,,1440,POINT (4697157 -74140516)
2014,Julio,Reino Unido de Gran Bretaña e Irlanda del Norte,13,11,,24,POINT (6170465 -7542726)
2014,Julio,Federación de Rusia,0,1,,1,POINT (3451668 -76532004)
2014,Julio,Federación de Rusia,19,19,,38,POINT (4697157 -74140516)
2014,Julio,Federación de Rusia,3,2,,5,POINT (6170465 -7542726)
2014,Julio,República Dominicana,1,15,,16,POINT (10406342 -75527794)
2014,Julio,República Dominicana,5,5,,10,POINT (10446304 -75516486)
2014,Julio,República Dominicana,6,21,,27,POINT (10886686 -74776479)
2014,Julio,República Dominicana,0,1,,1,POINT (125862 -81702165)
2014,Julio,República Dominicana,17,14,,31,POINT (3451668 -76532004)
2014,Julio,República Dominicana,451,725,,1176,POINT (4697157 -74140516)
2014,Julio,República Dominicana,1,1,,2,POINT (4815189 -75736374)
2014,Julio,República Dominicana,47,33,,80,POINT (6170465 -7542726)
2014,Julio,República Dominicana,1,0,,1,POINT (7128047 -73181317)
2014,Julio,República Dominicana,0,1,,1,POINT (7927233 -72508188)
2014,Julio,Reunión,2,0,,2,POINT (4697157 -74140516)
2014,Julio,República Democrática Popular de Corea,0,1,,1,POINT (4697157 -74140516)
2014,Julio,Rumania,1,2,,3,POINT (4697157 -74140516)
2014,Julio,San  Vicente y las Granadinas,0,1,,1,POINT (10446304 -75516486)
2014,Julio,San  Vicente y las Granadinas,0,1,,1,POINT (3451668 -76532004)
2014,Julio,Serbia,1,0,,1,POINT (4697157 -74140516)
2014,Julio,Singapur,0,1,,1,POINT (3451668 -76532004)
2014,Julio,Singapur,0,2,,2,POINT (4697157 -74140516)
2014,Julio,Singapur,1,2,,3,POINT (6170465 -7542726)
2014,Julio,Sudáfrica,0,1,,1,POINT (10886686 -74776479)
2014,Julio,Sudáfrica,6,9,,15,POINT (4697157 -74140516)
2014,Julio,Suecia,1,1,,2,POINT (3451668 -76532004)
2014,Julio,Suecia,24,31,,55,POINT (4697157 -74140516)
2014,Julio,Suecia,0,1,,1,POINT (4815189 -75736374)
2014,Julio,Suecia,4,2,,6,POINT (6170465 -7542726)
2014,Julio,Suecia,0,3,,3,POINT (10446304 -75516486)
2014,Julio,Suecia,0,1,,1,POINT (10886686 -74776479)
2014,Julio,Suecia,1,0,,1,POINT (125862 -81702165)
2014,Julio,Suecia,5,3,,8,POINT (3451668 -76532004)
2014,Julio,Suecia,114,146,,260,POINT (4697157 -74140516)
2014,Julio,Suecia,6,10,,16,POINT (6170465 -7542726)
2014,Julio,Surinam,0,3,,3,POINT (10406342 -75527794)
2014,Julio,Surinam,15,11,,26,POINT (4697157 -74140516)
2014,Julio,Surinam,1,2,,3,POINT (6170465 -7542726)
2014,Julio,Taiwán,1,2,,3,POINT (10886686 -74776479)
2014,Julio,Taiwán,6,3,,9,POINT (4697157 -74140516)
2014,Julio,Tailandia,1,0,,1,POINT (10446304 -75516486)
2014,Julio,Tailandia,0,1,,1,POINT (10886686 -74776479)
2014,Julio,Tailandia,1,1,,2,POINT (4697157 -74140516)
2014,Julio,Trinidad y Tobago,0,1,,1,POINT (10406342 -75527794)
2014,Julio,Trinidad y Tobago,0,1,,1,POINT (10446304 -75516486)
2014,Julio,Trinidad y Tobago,0,1,,1,POINT (10886686 -74776479)
2014,Julio,Trinidad y Tobago,0,1,,1,POINT (11247723 -74213989)
2014,Julio,Trinidad y Tobago,9,6,,15,POINT (3451668 -76532004)
2014,Julio,Trinidad y Tobago,4,17,,21,POINT (4697157 -74140516)
2014,Julio,Trinidad y Tobago,2,1,,3,POINT (4815189 -75736374)
2014,Julio,Trinidad y Tobago,4,8,,12,POINT (6170465 -7542726)
2014,Julio,Trinidad y Tobago,2,1,,3,POINT (7128047 -73181317)
2014,Julio,Trinidad y Tobago,1,1,,2,POINT (7927233 -72508188)
2014,Julio,Túnez,0,1,,1,POINT (4697157 -74140516)
2014,Julio,Turquía,0,4,,4,POINT (10446304 -75516486)
2014,Julio,Turquía,1,0,,1,POINT (10886686 -74776479)
2014,Julio,Turquía,0,1,,1,POINT (10970933 -74765343)
2014,Julio,Turquía,7,6,,13,POINT (4697157 -74140516)
2014,Julio,Turquía,2,4,,6,POINT (6170465 -7542726)
2014,Julio,Ucrania,4,4,,8,POINT (4697157 -74140516)
2014,Julio,Ucrania,0,1,,1,POINT (6170465 -7542726)
2014,Julio,Uganda,0,1,,1,POINT (4697157 -74140516)
2014,Julio,Uruguay,26,17,,43,POINT (10446304 -75516486)
2014,Julio,Uruguay,1,2,,3,POINT (10886686 -74776479)
2014,Julio,Uruguay,13,16,,29,POINT (125862 -81702165)
2014,Julio,Uruguay,7,15,,22,POINT (3451668 -76532004)
2014,Julio,Uruguay,57,81,,138,POINT (4697157 -74140516)
2014,Julio,Uruguay,41,32,,73,POINT (6170465 -7542726)
2014,Julio,Venezuela,0,44,,44,POINT (10406342 -75527794)
2014,Julio,Venezuela,23,105,,128,POINT (10446304 -75516486)
2014,Julio,Venezuela,15,50,,65,POINT (10886686 -74776479)
2014,Julio,Venezuela,0,12,,12,POINT (11117206 -74232675)
2014,Julio,Venezuela,0,2,,2,POINT (11247723 -74213989)
2014,Julio,Venezuela,1692,2297,,3989,POINT (11360029 -72129595)
2014,Julio,Venezuela,3,22,,25,POINT (3451668 -76532004)
2014,Julio,Venezuela,4963,5311,,10274,POINT (4697157 -74140516)
2014,Julio,Venezuela,0,1,,1,POINT (4815189 -75736374)
2014,Julio,Venezuela,94,157,,251,POINT (6170465 -7542726)
2014,Julio,Venezuela,13,23,,36,POINT (6185536 -67484028)
2014,Julio,Venezuela,55,88,,143,POINT (7088729 -70740253)
2014,Julio,Venezuela,2817,3509,,6326,POINT (7819 -72453013)
2014,Julio,Venezuela,274,278,,552,POINT (7927233 -72508188)
2014,Julio,Vietnam,0,2,,2,POINT (4697157 -74140516)
2014,Julio,Islas Vírgenes Estadounidenses/Territorio de Estados Unidos,0,1,,1,POINT (6170465 -7542726)
2014,Julio,Zimbabue,0,1,,1,POINT (4697157 -74140516)
2014,Julio,Anguila/Territorio Británico de Ultramar,0,1,,1,POINT (4697157 -74140516)
2014,Julio,Islas Turcas y Caicos/Territorio Británico de Ultramar,1,1,,2,POINT (4697157 -74140516)
2014,Julio,Desconocido,1,43,,44,POINT (125744111 -81703935)
2014,Julio,Desconocido,4,7,,11,POINT (133387613 -81372937)
2014,Julio,Desconocido,2,36,,38,POINT (4697157 -74140516)
2014,Julio,Desconocido,0,2,,2,POINT (6185536 -67484028)
2014,Julio,Desconocido,2,3,,5,POINT (863337 -7735002)
2014,Agosto,Afganistán,0,1,,1,POINT (4697157 -74140516)
2014,Agosto,Alemania,1,3,,4,POINT (10446304 -75516486)
2014,Agosto,Alemania,1,7,,8,POINT (10886686 -74776479)
2014,Agosto,Alemania,0,1,,1,POINT (125862 -81702165)
2014,Agosto,Alemania,7,6,,13,POINT (3451668 -76532004)
2014,Agosto,Alemania,1723,2409,,4132,POINT (4697157 -74140516)
2014,Agosto,Alemania,1,1,,2,POINT (4815189 -75736374)
2014,Agosto,Alemania,19,27,,46,POINT (6170465 -7542726)
2014,Agosto,Alemania,2,3,,5,POINT (7128047 -73181317)
2014,Agosto,Angola,0,2,,2,POINT (4697157 -74140516)
2014,Agosto,Antigua y Barbuda,0,1,,1,POINT (10406342 -75527794)
2014,Agosto,Antigua y Barbuda,0,1,,1,POINT (4697157 -74140516)
2014,Agosto,Antigua y Barbuda,1,0,,1,POINT (6170465 -7542726)
2014,Agosto,Países Bajos,72,43,,115,POINT (10406342 -75527794)
2014,Agosto,Países Bajos,0,1,,1,POINT (10446304 -75516486)
2014,Agosto,Países Bajos,2,5,,7,POINT (10886686 -74776479)
2014,Agosto,Países Bajos,5,10,,15,POINT (3451668 -76532004)
2014,Agosto,Países Bajos,34,55,,89,POINT (4697157 -74140516)
2014,Agosto,Países Bajos,0,1,,1,POINT (4815189 -75736374)
2014,Agosto,Países Bajos,35,41,,76,POINT (6170465 -7542726)
2014,Agosto,Países Bajos,1,5,,6,POINT (7128047 -73181317)
2014,Agosto,Países Bajos,1,1,,2,POINT (7927233 -72508188)
2014,Agosto,Arabia Saudita,0,1,,1,POINT (4697157 -74140516)
2014,Agosto,Argelia,5,5,,10,POINT (4697157 -74140516)
2014,Agosto,Argelia,1,0,,1,POINT (863337 -7735002)
2014,Agosto,Argentina,0,5,,5,POINT (10406342 -75527794)
2014,Agosto,Argentina,120,121,,241,POINT (10446304 -75516486)
2014,Agosto,Argentina,7,12,,19,POINT (10886686 -74776479)
2014,Agosto,Argentina,139,95,,234,POINT (125862 -81702165)
2014,Agosto,Argentina,21,50,,71,POINT (3451668 -76532004)
2014,Agosto,Argentina,0,13,,13,POINT (3884426 -77061029)
2014,Agosto,Argentina,1936,2846,,4782,POINT (4697157 -74140516)
2014,Agosto,Argentina,1,3,,4,POINT (4815189 -75736374)
2014,Agosto,Argentina,73,143,,216,POINT (6170465 -7542726)
2014,Agosto,Argentina,1,0,,1,POINT (7128047 -73181317)
2014,Agosto,Argentina,2,2,,4,POINT (7927233 -72508188)
2014,Agosto,Aruba,90,60,,150,POINT (10406342 -75527794)
2014,Agosto,Aruba,0,3,,3,POINT (10446304 -75516486)
2014,Agosto,Aruba,2,3,,5,POINT (10886686 -74776479)
2014,Agosto,Aruba,2,7,,9,POINT (11247723 -74213989)
2014,Agosto,Aruba,5,4,,9,POINT (3451668 -76532004)
2014,Agosto,Aruba,552,760,,1312,POINT (4697157 -74140516)
2014,Agosto,Aruba,2,4,,6,POINT (6170465 -7542726)
2014,Agosto,Aruba,2,2,,4,POINT (7128047 -73181317)
2014,Agosto,Australia,1,0,,1,POINT (10446304 -75516486)
2014,Agosto,Australia,1,4,,5,POINT (10886686 -74776479)
2014,Agosto,Australia,2,5,,7,POINT (3451668 -76532004)
2014,Agosto,Australia,18,34,,52,POINT (4697157 -74140516)
2014,Agosto,Australia,0,1,,1,POINT (4815189 -75736374)
2014,Agosto,Australia,2,14,,16,POINT (6170465 -7542726)
2014,Agosto,Austria,0,1,,1,POINT (3451668 -76532004)
2014,Agosto,Austria,19,23,,42,POINT (4697157 -74140516)
2014,Agosto,Austria,0,2,,2,POINT (6170465 -7542726)
2014,Agosto,Bahamas,1,3,,4,POINT (4697157 -74140516)
2014,Agosto,Bahamas,0,1,,1,POINT (6170465 -7542726)
2014,Agosto,Bahréin,1,1,,2,POINT (4697157 -74140516)
2014,Agosto,Bahréin,0,1,,1,POINT (6170465 -7542726)
2014,Agosto,Barbados,0,2,,2,POINT (3451668 -76532004)
2014,Agosto,Barbados,2,2,,4,POINT (4697157 -74140516)
2014,Agosto,Barbados,0,1,,1,POINT (6170465 -7542726)
2014,Agosto,República de Belarús,1,0,,1,POINT (11360029 -72129595)
2014,Agosto,República de Belarús,1,0,,1,POINT (4697157 -74140516)
2014,Agosto,República de Belarús,0,1,,1,POINT (7819 -72453013)
2014,Agosto,Bélgica,1,1,,2,POINT (10446304 -75516486)
2014,Agosto,Bélgica,0,2,,2,POINT (10886686 -74776479)
2014,Agosto,Bélgica,0,1,,1,POINT (11247723 -74213989)
2014,Agosto,Bélgica,1,1,,2,POINT (3451668 -76532004)
2014,Agosto,Bélgica,23,36,,59,POINT (4697157 -74140516)
2014,Agosto,Bélgica,2,3,,5,POINT (6170465 -7542726)
2014,Agosto,Belice,0,1,,1,POINT (3451668 -76532004)
2014,Agosto,Belice,1,3,,4,POINT (4697157 -74140516)
2014,Agosto,Belice,1,3,,4,POINT (6170465 -7542726)
2014,Agosto,Benín,0,1,,1,POINT (4697157 -74140516)
2014,Agosto,Bolivia,8,9,,17,POINT (10446304 -75516486)
2014,Agosto,Bolivia,8,7,,15,POINT (125862 -81702165)
2014,Agosto,Bolivia,8,6,,14,POINT (3451668 -76532004)
2014,Agosto,Bolivia,403,504,,907,POINT (4697157 -74140516)
2014,Agosto,Bolivia,18,34,,52,POINT (6170465 -7542726)
2014,Agosto,Bolivia,1,0,,1,POINT (7927233 -72508188)
2014,Agosto,Brasil,140,174,,314,POINT (-4191162 -69941498)
2014,Agosto,Brasil,1,11,,12,POINT (-4214082 -69941431)
2014,Agosto,Brasil,0,3,,3,POINT (10406342 -75527794)
2014,Agosto,Brasil,131,106,,237,POINT (10446304 -75516486)
2014,Agosto,Brasil,2,7,,9,POINT (10886686 -74776479)
2014,Agosto,Brasil,68,62,,130,POINT (125862 -81702165)
2014,Agosto,Brasil,21,38,,59,POINT (3451668 -76532004)
2014,Agosto,Brasil,3444,5482,,8926,POINT (4697157 -74140516)
2014,Agosto,Brasil,0,2,,2,POINT (4815189 -75736374)
2014,Agosto,Brasil,92,136,,228,POINT (6170465 -7542726)
2014,Agosto,Brasil,0,1,,1,POINT (7128047 -73181317)
2014,Agosto,Brunei Darussalam,0,1,,1,POINT (4697157 -74140516)
2014,Agosto,Bulgaria,1,3,,4,POINT (4697157 -74140516)
2014,Agosto,Cabo Verde,2,2,,4,POINT (4697157 -74140516)
2014,Agosto,Islas Caimán/Territorio Británico de Ultramar,1,9,,10,POINT (10406342 -75527794)
2014,Agosto,Islas Caimán/Territorio Británico de Ultramar,0,2,,2,POINT (125862 -81702165)
2014,Agosto,Islas Caimán/Territorio Británico de Ultramar,0,1,,1,POINT (3451668 -76532004)
2014,Agosto,Islas Caimán/Territorio Británico de Ultramar,1,2,,3,POINT (4697157 -74140516)
2014,Agosto,Islas Caimán/Territorio Británico de Ultramar,0,1,,1,POINT (6170465 -7542726)
2014,Agosto,Camboya,1,0,,1,POINT (4697157 -74140516)
2014,Agosto,Canadá,2,2,,4,POINT (10446304 -75516486)
2014,Agosto,Canadá,4,10,,14,POINT (10886686 -74776479)
2014,Agosto,Canadá,1,0,,1,POINT (125862 -81702165)
2014,Agosto,Canadá,23,29,,52,POINT (3451668 -76532004)
2014,Agosto,Canadá,634,986,,1620,POINT (4697157 -74140516)
2014,Agosto,Canadá,2,3,,5,POINT (4815189 -75736374)
2014,Agosto,Canadá,32,72,,104,POINT (6170465 -7542726)
2014,Agosto,Canadá,5,8,,13,POINT (7128047 -73181317)
2014,Agosto,Canadá,0,1,,1,POINT (7927233 -72508188)
2014,Agosto,España,0,2,,2,POINT (10406342 -75527794)
2014,Agosto,España,0,1,,1,POINT (10446304 -75516486)
2014,Agosto,España,2,3,,5,POINT (10886686 -74776479)
2014,Agosto,España,0,8,,8,POINT (11247723 -74213989)
2014,Agosto,España,193,342,,535,POINT (3451668 -76532004)
2014,Agosto,España,3305,5155,,8460,POINT (4697157 -74140516)
2014,Agosto,España,0,3,,3,POINT (4815189 -75736374)
2014,Agosto,España,217,387,,604,POINT (6170465 -7542726)
2014,Agosto,España,0,1,,1,POINT (7128047 -73181317)
2014,Agosto,España,1,0,,1,POINT (7819 -72453013)
2014,Agosto,República de Corea,6,37,,43,POINT (4697157 -74140516)
2014,Agosto,República de Corea,1,8,,9,POINT (6170465 -7542726)
2014,Agosto,Costa de Marfil,1,7,,8,POINT (4697157 -74140516)
2014,Agosto,Costa Rica,6,7,,13,POINT (10446304 -75516486)
2014,Agosto,Costa Rica,9,12,,21,POINT (10886686 -74776479)
2014,Agosto,Costa Rica,121,82,,203,POINT (125862 -81702165)
2014,Agosto,Costa Rica,8,19,,27,POINT (3451668 -76532004)
2014,Agosto,Costa Rica,611,1116,,1727,POINT (4697157 -74140516)
2014,Agosto,Costa Rica,3,11,,14,POINT (4815189 -75736374)
2014,Agosto,Costa Rica,38,86,,124,POINT (6170465 -7542726)
2014,Agosto,Costa Rica,0,1,,1,POINT (7128047 -73181317)
2014,Agosto,Costa Rica,1,5,,6,POINT (7927233 -72508188)
2014,Agosto,Croacia,1,8,,9,POINT (4697157 -74140516)
2014,Agosto,Cuba,3,3,,6,POINT (10446304 -75516486)
2014,Agosto,Cuba,6,21,,27,POINT (10886686 -74776479)
2014,Agosto,Cuba,1,1,,2,POINT (125862 -81702165)
2014,Agosto,Cuba,9,13,,22,POINT (3451668 -76532004)
2014,Agosto,Cuba,235,341,,576,POINT (4697157 -74140516)
2014,Agosto,Cuba,1,2,,3,POINT (4815189 -75736374)
2014,Agosto,Cuba,8,11,,19,POINT (6170465 -7542726)
2014,Agosto,Cuba,1,5,,6,POINT (7128047 -73181317)
2014,Agosto,Cuba,0,1,,1,POINT (7927233 -72508188)
2014,Agosto,Curazao,2,21,,23,POINT (10406342 -75527794)
2014,Agosto,Curazao,38,66,,104,POINT (10886686 -74776479)
2014,Agosto,Curazao,1,1,,2,POINT (10970933 -74765343)
2014,Agosto,Curazao,1,1,,2,POINT (11117206 -74232675)
2014,Agosto,Curazao,6,7,,13,POINT (11247723 -74213989)
2014,Agosto,Curazao,1,2,,3,POINT (3451668 -76532004)
2014,Agosto,Curazao,166,242,,408,POINT (4697157 -74140516)
2014,Agosto,Curazao,114,176,,290,POINT (6170465 -7542726)
2014,Agosto,República Checa,3,7,,10,POINT (4697157 -74140516)
2014,Agosto,Chile,16,18,,34,POINT (10446304 -75516486)
2014,Agosto,Chile,2,3,,5,POINT (10886686 -74776479)
2014,Agosto,Chile,33,23,,56,POINT (125862 -81702165)
2014,Agosto,Chile,15,30,,45,POINT (3451668 -76532004)
2014,Agosto,Chile,3919,5030,,8949,POINT (4697157 -74140516)
2014,Agosto,Chile,0,1,,1,POINT (4815189 -75736374)
2014,Agosto,Chile,36,76,,112,POINT (6170465 -7542726)
2014,Agosto,Chile,0,1,,1,POINT (7128047 -73181317)
2014,Agosto,China,1,3,,4,POINT (3451668 -76532004)
2014,Agosto,China,35,94,,129,POINT (4697157 -74140516)
2014,Agosto,China,1,0,,1,POINT (4815189 -75736374)
2014,Agosto,Dinamarca,7,8,,15,POINT (4697157 -74140516)
2014,Agosto,Dinamarca,3,2,,5,POINT (6170465 -7542726)
2014,Agosto,Dominica,1,1,,2,POINT (6170465 -7542726)
2014,Agosto,Ecuador,71,118,,189,POINT (0.33002 -76876446)
2014,Agosto,Ecuador,3290,4755,,8045,POINT (0.81488 -77356)
2014,Agosto,Ecuador,4,236,,240,POINT (1800143 -78802679)
2014,Agosto,Ecuador,1,4,,5,POINT (10406342 -75527794)
2014,Agosto,Ecuador,134,77,,211,POINT (10446304 -75516486)
2014,Agosto,Ecuador,0,4,,4,POINT (10886686 -74776479)
2014,Agosto,Ecuador,4,3,,7,POINT (125862 -81702165)
2014,Agosto,Ecuador,685,844,,1529,POINT (3451668 -76532004)
2014,Agosto,Ecuador,0,1,,1,POINT (3884426 -77061029)
2014,Agosto,Ecuador,3263,4884,,8147,POINT (4697157 -74140516)
2014,Agosto,Ecuador,718,750,,1468,POINT (6170465 -7542726)
2014,Agosto,Ecuador,1,2,,3,POINT (7927233 -72508188)
2014,Agosto,Egipto,3,6,,9,POINT (4697157 -74140516)
2014,Agosto,El Salvador,5,11,,16,POINT (10446304 -75516486)
2014,Agosto,El Salvador,48,46,,94,POINT (125862 -81702165)
2014,Agosto,El Salvador,120,207,,327,POINT (3451668 -76532004)
2014,Agosto,El Salvador,884,1309,,2193,POINT (4697157 -74140516)
2014,Agosto,El Salvador,123,241,,364,POINT (6170465 -7542726)
2014,Agosto,Emiratos Árabes,1,2,,3,POINT (4697157 -74140516)
2014,Agosto,Eritrea,1,1,,2,POINT (4697157 -74140516)
2014,Agosto,Eslovaquia,1,2,,3,POINT (4697157 -74140516)
2014,Agosto,Eslovenia,1,5,,6,POINT (4697157 -74140516)
2014,Agosto,Estados Unidos de América,1,30,,31,POINT (10406342 -75527794)
2014,Agosto,Estados Unidos de América,2088,2768,,4856,POINT (10446304 -75516486)
2014,Agosto,Estados Unidos de América,289,498,,787,POINT (10886686 -74776479)
2014,Agosto,Estados Unidos de América,0,1,,1,POINT (10970933 -74765343)
2014,Agosto,Estados Unidos de América,0,2,,2,POINT (11247723 -74213989)
2014,Agosto,Estados Unidos de América,13,15,,28,POINT (125862 -81702165)
2014,Agosto,Estados Unidos de América,925,1340,,2265,POINT (3451668 -76532004)
2014,Agosto,Estados Unidos de América,108,163,,271,POINT (445285 -75766353)
2014,Agosto,Estados Unidos de América,8803,15370,,24173,POINT (4697157 -74140516)
2014,Agosto,Estados Unidos de América,107,167,,274,POINT (4815189 -75736374)
2014,Agosto,Estados Unidos de América,1800,4183,,5983,POINT (6170465 -7542726)
2014,Agosto,Estados Unidos de América,15,22,,37,POINT (7128047 -73181317)
2014,Agosto,Estados Unidos de América,62,62,,124,POINT (7927233 -72508188)
2014,Agosto,Estados Unidos de América,1,11,,12,POINT (9402597 -75681642)
2014,Agosto,Etiopia,0,1,,1,POINT (4697157 -74140516)
2014,Agosto,Filipinas,0,3,,3,POINT (10886686 -74776479)
2014,Agosto,Filipinas,1,0,,1,POINT (10970933 -74765343)
2014,Agosto,Filipinas,0,3,,3,POINT (3451668 -76532004)
2014,Agosto,Filipinas,0,1,,1,POINT (3884426 -77061029)
2014,Agosto,Filipinas,7,11,,18,POINT (4697157 -74140516)
2014,Agosto,Filipinas,0,1,,1,POINT (4815189 -75736374)
2014,Agosto,Filipinas,0,1,,1,POINT (9402597 -75681642)
2014,Agosto,Finlandia,6,6,,12,POINT (4697157 -74140516)
2014,Agosto,Francia,0,1,,1,POINT (10406342 -75527794)
2014,Agosto,Francia,0,6,,6,POINT (10446304 -75516486)
2014,Agosto,Francia,1,0,,1,POINT (10886686 -74776479)
2014,Agosto,Francia,0,1,,1,POINT (125862 -81702165)
2014,Agosto,Francia,10,22,,32,POINT (3451668 -76532004)
2014,Agosto,Francia,1375,2357,,3732,POINT (4697157 -74140516)
2014,Agosto,Francia,0,3,,3,POINT (4815189 -75736374)
2014,Agosto,Francia,5,16,,21,POINT (6170465 -7542726)
2014,Agosto,Ghana,1,3,,4,POINT (4697157 -74140516)
2014,Agosto,Granada,0,1,,1,POINT (6170465 -7542726)
2014,Agosto,Grecia,0,1,,1,POINT (3451668 -76532004)
2014,Agosto,Grecia,4,7,,11,POINT (4697157 -74140516)
2014,Agosto,Guatemala,0,8,,8,POINT (10406342 -75527794)
2014,Agosto,Guatemala,6,8,,14,POINT (10446304 -75516486)
2014,Agosto,Guatemala,0,7,,7,POINT (10886686 -74776479)
2014,Agosto,Guatemala,22,38,,60,POINT (3451668 -76532004)
2014,Agosto,Guatemala,0,5,,5,POINT (3884426 -77061029)
2014,Agosto,Guatemala,190,459,,649,POINT (4697157 -74140516)
2014,Agosto,Guatemala,4,3,,7,POINT (4815189 -75736374)
2014,Agosto,Guatemala,34,93,,127,POINT (6170465 -7542726)
2014,Agosto,Guatemala,1,3,,4,POINT (7128047 -73181317)
2014,Agosto,Guatemala,7,0,,7,POINT (7927233 -72508188)
2014,Agosto,Guyana,1,0,,1,POINT (10446304 -75516486)
2014,Agosto,Guyana,0,2,,2,POINT (4697157 -74140516)
2014,Agosto,Guyana,0,3,,3,POINT (6170465 -7542726)
2014,Agosto,Guadalupe/Territorio Francés,0,3,,3,POINT (4697157 -74140516)
2014,Agosto,Haití,0,1,,1,POINT (3451668 -76532004)
2014,Agosto,Haití,5,11,,16,POINT (4697157 -74140516)
2014,Agosto,Haití,0,1,,1,POINT (6170465 -7542726)
2014,Agosto,Haití,0,1,,1,POINT (7927233 -72508188)
2014,Agosto,Honduras,2,5,,7,POINT (10446304 -75516486)
2014,Agosto,Honduras,1,6,,7,POINT (10886686 -74776479)
2014,Agosto,Honduras,1,1,,2,POINT (133387613 -81372937)
2014,Agosto,Honduras,2,6,,8,POINT (3451668 -76532004)
2014,Agosto,Honduras,51,97,,148,POINT (4697157 -74140516)
2014,Agosto,Honduras,1,0,,1,POINT (4815189 -75736374)
2014,Agosto,Honduras,12,20,,32,POINT (6170465 -7542726)
2014,Agosto,Hong Kong,2,6,,8,POINT (4697157 -74140516)
2014,Agosto,Hungría,1,2,,3,POINT (4697157 -74140516)
2014,Agosto,India,1,2,,3,POINT (10446304 -75516486)
2014,Agosto,India,0,1,,1,POINT (10886686 -74776479)
2014,Agosto,India,0,1,,1,POINT (3451668 -76532004)
2014,Agosto,India,4,15,,19,POINT (4697157 -74140516)
2014,Agosto,Indonesia,3,1,,4,POINT (4697157 -74140516)
2014,Agosto,Indonesia,0,3,,3,POINT (6170465 -7542726)
2014,Agosto,Irán,0,1,,1,POINT (4697157 -74140516)
2014,Agosto,República de Irlanda,0,1,,1,POINT (10446304 -75516486)
2014,Agosto,República de Irlanda,5,6,,11,POINT (4697157 -74140516)
2014,Agosto,República de Irlanda,0,2,,2,POINT (6170465 -7542726)
2014,Agosto,Israel,0,2,,2,POINT (10446304 -75516486)
2014,Agosto,Israel,4,6,,10,POINT (3451668 -76532004)
2014,Agosto,Israel,9,48,,57,POINT (4697157 -74140516)
2014,Agosto,Israel,0,1,,1,POINT (6170465 -7542726)
2014,Agosto,Italia,3,10,,13,POINT (10446304 -75516486)
2014,Agosto,Italia,2,2,,4,POINT (10886686 -74776479)
2014,Agosto,Italia,0,1,,1,POINT (11360029 -72129595)
2014,Agosto,Italia,5,14,,19,POINT (3451668 -76532004)
2014,Agosto,Italia,129,259,,388,POINT (4697157 -74140516)
2014,Agosto,Italia,2,1,,3,POINT (4815189 -75736374)
2014,Agosto,Italia,7,18,,25,POINT (6170465 -7542726)
2014,Agosto,Italia,0,1,,1,POINT (7128047 -73181317)
2014,Agosto,Jamaica,0,3,,3,POINT (10406342 -75527794)
2014,Agosto,Jamaica,0,1,,1,POINT (10446304 -75516486)
2014,Agosto,Jamaica,0,1,,1,POINT (10886686 -74776479)
2014,Agosto,Jamaica,0,1,,1,POINT (11247723 -74213989)
2014,Agosto,Jamaica,1,2,,3,POINT (3451668 -76532004)
2014,Agosto,Jamaica,3,6,,9,POINT (4697157 -74140516)
2014,Agosto,Jamaica,0,1,,1,POINT (4815189 -75736374)
2014,Agosto,Jamaica,4,7,,11,POINT (6170465 -7542726)
2014,Agosto,Jamaica,0,1,,1,POINT (7128047 -73181317)
2014,Agosto,Japón,0,2,,2,POINT (10886686 -74776479)
2014,Agosto,Japón,1,2,,3,POINT (3451668 -76532004)
2014,Agosto,Japón,16,35,,51,POINT (4697157 -74140516)
2014,Agosto,Japón,2,5,,7,POINT (6170465 -7542726)
2014,Agosto,Jordania,1,0,,1,POINT (4697157 -74140516)
2014,Agosto,Kazajistán,0,2,,2,POINT (4697157 -74140516)
2014,Agosto,Kenia,2,1,,3,POINT (3451668 -76532004)
2014,Agosto,Kenia,1,1,,2,POINT (4697157 -74140516)
2014,Agosto,Kuwait,3,2,,5,POINT (4697157 -74140516)
2014,Agosto,Letonia,1,0,,1,POINT (4697157 -74140516)
2014,Agosto,Líbano,0,1,,1,POINT (10886686 -74776479)
2014,Agosto,Líbano,1,3,,4,POINT (4697157 -74140516)
2014,Agosto,Luxemburgo,1,2,,3,POINT (4697157 -74140516)
2014,Agosto,Malasia,3,5,,8,POINT (4697157 -74140516)
2014,Agosto,Malawi,0,1,,1,POINT (3451668 -76532004)
2014,Agosto,Malí,0,3,,3,POINT (4697157 -74140516)
2014,Agosto,Malta,1,1,,2,POINT (4697157 -74140516)
2014,Agosto,Marruecos,0,1,,1,POINT (3451668 -76532004)
2014,Agosto,Marruecos,0,2,,2,POINT (4697157 -74140516)
2014,Agosto,Martinica/Departamento de Ultramar Francés,0,1,,1,POINT (11247723 -74213989)
2014,Agosto,Martinica/Departamento de Ultramar Francés,0,1,,1,POINT (4697157 -74140516)
2014,Agosto,México,0,4,,4,POINT (10406342 -75527794)
2014,Agosto,México,25,33,,58,POINT (10446304 -75516486)
2014,Agosto,México,9,23,,32,POINT (10886686 -74776479)
2014,Agosto,México,3,7,,10,POINT (125862 -81702165)
2014,Agosto,México,28,73,,101,POINT (3451668 -76532004)
2014,Agosto,México,3260,6291,,9551,POINT (4697157 -74140516)
2014,Agosto,México,2,5,,7,POINT (4815189 -75736374)
2014,Agosto,México,56,205,,261,POINT (6170465 -7542726)
2014,Agosto,México,0,3,,3,POINT (7128047 -73181317)
2014,Agosto,México,11,32,,43,POINT (7927233 -72508188)
2014,Agosto,Nicaragua,5,3,,8,POINT (10446304 -75516486)
2014,Agosto,Nicaragua,0,2,,2,POINT (10886686 -74776479)
2014,Agosto,Nicaragua,1,6,,7,POINT (3451668 -76532004)
2014,Agosto,Nicaragua,22,32,,54,POINT (4697157 -74140516)
2014,Agosto,Nicaragua,3,6,,9,POINT (6170465 -7542726)
2014,Agosto,Nicaragua,1,0,,1,POINT (7128047 -73181317)
2014,Agosto,Nicaragua,0,1,,1,POINT (7927233 -72508188)
2014,Agosto,Nigeria,2,4,,6,POINT (4697157 -74140516)
2014,Agosto,Noruega,0,1,,1,POINT (10886686 -74776479)
2014,Agosto,Noruega,2,1,,3,POINT (3451668 -76532004)
2014,Agosto,Noruega,5,6,,11,POINT (4697157 -74140516)
2014,Agosto,Nueva Zelanda,1,0,,1,POINT (3451668 -76532004)
2014,Agosto,Nueva Zelanda,3,7,,10,POINT (4697157 -74140516)
2014,Agosto,Omán,0,2,,2,POINT (4697157 -74140516)
2014,Agosto,Papúa Nueva Guinea,1,0,,1,POINT (4697157 -74140516)
2014,Agosto,Panamá,1048,878,,1926,POINT (10406342 -75527794)
2014,Agosto,Panamá,1952,2186,,4138,POINT (10446304 -75516486)
2014,Agosto,Panamá,163,397,,560,POINT (10886686 -74776479)
2014,Agosto,Panamá,0,12,,12,POINT (10970933 -74765343)
2014,Agosto,Panamá,0,2,,2,POINT (11247723 -74213989)
2014,Agosto,Panamá,884,704,,1588,POINT (125862 -81702165)
2014,Agosto,Panamá,396,817,,1213,POINT (3451668 -76532004)
2014,Agosto,Panamá,0,2,,2,POINT (3884426 -77061029)
2014,Agosto,Panamá,3007,4996,,8003,POINT (4697157 -74140516)
2014,Agosto,Panamá,66,168,,234,POINT (4815189 -75736374)
2014,Agosto,Panamá,1183,2324,,3507,POINT (6170465 -7542726)
2014,Agosto,Panamá,0,1,,1,POINT (6222552 -77401154)
2014,Agosto,Panamá,17,35,,52,POINT (7102626 -77762647)
2014,Agosto,Panamá,34,87,,121,POINT (7128047 -73181317)
2014,Agosto,Panamá,138,176,,314,POINT (7927233 -72508188)
2014,Agosto,Panamá,0,2,,2,POINT (806667 -767333)
2014,Agosto,Panamá,59,80,,139,POINT (863337 -7735002)
2014,Agosto,Paraguay,4,5,,9,POINT (10446304 -75516486)
2014,Agosto,Paraguay,2,0,,2,POINT (10886686 -74776479)
2014,Agosto,Paraguay,4,3,,7,POINT (125862 -81702165)
2014,Agosto,Paraguay,4,8,,12,POINT (3451668 -76532004)
2014,Agosto,Paraguay,40,45,,85,POINT (4697157 -74140516)
2014,Agosto,Paraguay,10,16,,26,POINT (6170465 -7542726)
2014,Agosto,Paraguay,1,1,,2,POINT (7128047 -73181317)
2014,Agosto,Perú,156,219,,375,POINT (-4191162 -69941498)
2014,Agosto,Perú,15,22,,37,POINT (-4214082 -69941431)
2014,Agosto,Perú,1,1,,2,POINT (0.81488 -77356)
2014,Agosto,Perú,0,1,,1,POINT (10406342 -75527794)
2014,Agosto,Perú,16,16,,32,POINT (10446304 -75516486)
2014,Agosto,Perú,1,10,,11,POINT (10886686 -74776479)
2014,Agosto,Perú,124,88,,212,POINT (125862 -81702165)
2014,Agosto,Perú,269,392,,661,POINT (3451668 -76532004)
2014,Agosto,Perú,6704,8334,,15038,POINT (4697157 -74140516)
2014,Agosto,Perú,1,2,,3,POINT (4815189 -75736374)
2014,Agosto,Perú,564,1002,,1566,POINT (6170465 -7542726)
2014,Agosto,Perú,0,1,,1,POINT (7128047 -73181317)
2014,Agosto,Polonia,0,2,,2,POINT (10446304 -75516486)
2014,Agosto,Polonia,5,12,,17,POINT (4697157 -74140516)
2014,Agosto,Polonia,2,0,,2,POINT (6170465 -7542726)
2014,Agosto,Portugal,0,1,,1,POINT (10446304 -75516486)
2014,Agosto,Portugal,0,1,,1,POINT (11247723 -74213989)
2014,Agosto,Portugal,0,2,,2,POINT (3451668 -76532004)
2014,Agosto,Portugal,605,799,,1404,POINT (4697157 -74140516)
2014,Agosto,Portugal,1,0,,1,POINT (6170465 -7542726)
2014,Agosto,Puerto Rico/Territorio de Estados Unidos,0,7,,7,POINT (10406342 -75527794)
2014,Agosto,Puerto Rico/Territorio de Estados Unidos,2,15,,17,POINT (10446304 -75516486)
2014,Agosto,Puerto Rico/Territorio de Estados Unidos,6,46,,52,POINT (10886686 -74776479)
2014,Agosto,Puerto Rico/Territorio de Estados Unidos,1,0,,1,POINT (125862 -81702165)
2014,Agosto,Puerto Rico/Territorio de Estados Unidos,24,29,,53,POINT (3451668 -76532004)
2014,Agosto,Puerto Rico/Territorio de Estados Unidos,235,325,,560,POINT (4697157 -74140516)
2014,Agosto,Puerto Rico/Territorio de Estados Unidos,2,2,,4,POINT (4815189 -75736374)
2014,Agosto,Puerto Rico/Territorio de Estados Unidos,29,138,,167,POINT (6170465 -7542726)
2014,Agosto,Puerto Rico/Territorio de Estados Unidos,0,1,,1,POINT (7128047 -73181317)
2014,Agosto,Puerto Rico/Territorio de Estados Unidos,1,0,,1,POINT (7927233 -72508188)
2014,Agosto,Qatar,0,12,,12,POINT (4697157 -74140516)
2014,Agosto,Reino Unido de Gran Bretaña e Irlanda del Norte,2,4,,6,POINT (10446304 -75516486)
2014,Agosto,Reino Unido de Gran Bretaña e Irlanda del Norte,0,3,,3,POINT (10886686 -74776479)
2014,Agosto,Reino Unido de Gran Bretaña e Irlanda del Norte,2,7,,9,POINT (3451668 -76532004)
2014,Agosto,Reino Unido de Gran Bretaña e Irlanda del Norte,399,609,,1008,POINT (4697157 -74140516)
2014,Agosto,Reino Unido de Gran Bretaña e Irlanda del Norte,1,1,,2,POINT (4815189 -75736374)
2014,Agosto,Reino Unido de Gran Bretaña e Irlanda del Norte,10,12,,22,POINT (6170465 -7542726)
2014,Agosto,Reino Unido de Gran Bretaña e Irlanda del Norte,1,2,,3,POINT (7128047 -73181317)
2014,Agosto,República CentroÁfricana,1,0,,1,POINT (4697157 -74140516)
2014,Agosto,Federación de Rusia,0,1,,1,POINT (11247723 -74213989)
2014,Agosto,Federación de Rusia,18,20,,38,POINT (4697157 -74140516)
2014,Agosto,Federación de Rusia,0,1,,1,POINT (6170465 -7542726)
2014,Agosto,Federación de Rusia,0,1,,1,POINT (9402597 -75681642)
2014,Agosto,República Dominicana,1,5,,6,POINT (10406342 -75527794)
2014,Agosto,República Dominicana,3,6,,9,POINT (10446304 -75516486)
2014,Agosto,República Dominicana,8,48,,56,POINT (10886686 -74776479)
2014,Agosto,República Dominicana,1,0,,1,POINT (125862 -81702165)
2014,Agosto,República Dominicana,9,23,,32,POINT (3451668 -76532004)
2014,Agosto,República Dominicana,475,700,,1175,POINT (4697157 -74140516)
2014,Agosto,República Dominicana,3,3,,6,POINT (4815189 -75736374)
2014,Agosto,República Dominicana,49,84,,133,POINT (6170465 -7542726)
2014,Agosto,República Dominicana,1,3,,4,POINT (7128047 -73181317)
2014,Agosto,República Dominicana,1,4,,5,POINT (7927233 -72508188)
2014,Agosto,Reunión,1,1,,2,POINT (4697157 -74140516)
2014,Agosto,República Democrática Popular de Corea,0,2,,2,POINT (4697157 -74140516)
2014,Agosto,Rumania,4,4,,8,POINT (4697157 -74140516)
2014,Agosto,Rwanda,0,1,,1,POINT (3451668 -76532004)
2014,Agosto,San Marino,1,0,,1,POINT (6170465 -7542726)
2014,Agosto,San  Vicente y las Granadinas,2,1,,3,POINT (10886686 -74776479)
2014,Agosto,Santa Lucia,0,1,,1,POINT (4697157 -74140516)
2014,Agosto,Santa Lucia,2,0,,2,POINT (6170465 -7542726)
2014,Agosto,Senegal,0,2,,2,POINT (4697157 -74140516)
2014,Agosto,Singapur,2,3,,5,POINT (4697157 -74140516)
2014,Agosto,Singapur,0,1,,1,POINT (6170465 -7542726)
2014,Agosto,Sudáfrica,0,1,,1,POINT (10886686 -74776479)
2014,Agosto,Sudáfrica,6,9,,15,POINT (4697157 -74140516)
2014,Agosto,Suecia,0,2,,2,POINT (10886686 -74776479)
2014,Agosto,Suecia,1,0,,1,POINT (3451668 -76532004)
2014,Agosto,Suecia,11,14,,25,POINT (4697157 -74140516)
2014,Agosto,Suecia,1,2,,3,POINT (6170465 -7542726)
2014,Agosto,Suiza,2,2,,4,POINT (10446304 -75516486)
2014,Agosto,Suiza,1,0,,1,POINT (10886686 -74776479)
2014,Agosto,Suiza,7,6,,13,POINT (3451668 -76532004)
2014,Agosto,Suiza,39,75,,114,POINT (4697157 -74140516)
2014,Agosto,Suiza,2,7,,9,POINT (6170465 -7542726)
2014,Agosto,Surinam,0,2,,2,POINT (3451668 -76532004)
2014,Agosto,Surinam,3,1,,4,POINT (4697157 -74140516)
2014,Agosto,Surinam,2,3,,5,POINT (6170465 -7542726)
2014,Agosto,Taiwán,1,0,,1,POINT (10446304 -75516486)
2014,Agosto,Taiwán,0,4,,4,POINT (4697157 -74140516)
2014,Agosto,Taiwán,0,2,,2,POINT (6170465 -7542726)
2014,Agosto,Taiwán,0,2,,2,POINT (7927233 -72508188)
2014,Agosto,Tailandia,0,3,,3,POINT (4697157 -74140516)
2014,Agosto,Trinidad y Tobago,4,7,,11,POINT (3451668 -76532004)
2014,Agosto,Trinidad y Tobago,3,9,,12,POINT (4697157 -74140516)
2014,Agosto,Trinidad y Tobago,2,4,,6,POINT (4815189 -75736374)
2014,Agosto,Trinidad y Tobago,1,10,,11,POINT (6170465 -7542726)
2014,Agosto,Trinidad y Tobago,4,2,,6,POINT (7128047 -73181317)
2014,Agosto,Trinidad y Tobago,1,1,,2,POINT (7927233 -72508188)
2014,Agosto,Túnez,2,0,,2,POINT (4697157 -74140516)
2014,Agosto,Turquía,2,0,,2,POINT (10446304 -75516486)
2014,Agosto,Turquía,4,8,,12,POINT (4697157 -74140516)
2014,Agosto,Turquía,0,1,,1,POINT (6170465 -7542726)
2014,Agosto,Ucrania,0,1,,1,POINT (10446304 -75516486)
2014,Agosto,Ucrania,2,3,,5,POINT (4697157 -74140516)
2014,Agosto,Ucrania,1,0,,1,POINT (6170465 -7542726)
2014,Agosto,Uganda,2,1,,3,POINT (3451668 -76532004)
2014,Agosto,Uruguay,24,13,,37,POINT (10446304 -75516486)
2014,Agosto,Uruguay,0,2,,2,POINT (10886686 -74776479)
2014,Agosto,Uruguay,42,22,,64,POINT (125862 -81702165)
2014,Agosto,Uruguay,11,14,,25,POINT (3451668 -76532004)
2014,Agosto,Uruguay,44,77,,121,POINT (4697157 -74140516)
2014,Agosto,Uruguay,0,1,,1,POINT (4815189 -75736374)
2014,Agosto,Uruguay,20,43,,63,POINT (6170465 -7542726)
2014,Agosto,Venezuela,1,19,,20,POINT (10406342 -75527794)
2014,Agosto,Venezuela,18,83,,101,POINT (10446304 -75516486)
2014,Agosto,Venezuela,10,43,,53,POINT (10886686 -74776479)
2014,Agosto,Venezuela,3,5,,8,POINT (11117206 -74232675)
2014,Agosto,Venezuela,2767,3257,,6024,POINT (11360029 -72129595)
2014,Agosto,Venezuela,1,3,,4,POINT (125862 -81702165)
2014,Agosto,Venezuela,1,6,,7,POINT (3451668 -76532004)
2014,Agosto,Venezuela,4499,4398,,8897,POINT (4697157 -74140516)
2014,Agosto,Venezuela,2,2,,4,POINT (4815189 -75736374)
2014,Agosto,Venezuela,84,184,,268,POINT (6170465 -7542726)
2014,Agosto,Venezuela,32,207,,239,POINT (6185536 -67484028)
2014,Agosto,Venezuela,177,289,,466,POINT (7088729 -70740253)
2014,Agosto,Venezuela,16,19,,35,POINT (7128047 -73181317)
2014,Agosto,Venezuela,4781,5584,,10365,POINT (7819 -72453013)
2014,Agosto,Venezuela,586,722,,1308,POINT (7927233 -72508188)
2014,Agosto,Vietnam,0,1,,1,POINT (3884426 -77061029)
2014,Agosto,Islas Vírgenes Británicas/Territorio Británico de Ultramar,0,1,,1,POINT (4697157 -74140516)
2014,Agosto,Zimbabue,0,1,,1,POINT (3451668 -76532004)
2014,Agosto,Desconocido,6,38,,44,POINT (125744111 -81703935)
2014,Agosto,Desconocido,0,3,,3,POINT (3451668 -76532004)
2014,Agosto,Desconocido,0,22,,22,POINT (4697157 -74140516)
2014,Agosto,Desconocido,3,7,,10,POINT (6185536 -67484028)
2014,Septiembre,Afganistán,0,2,,2,POINT (4697157 -74140516)
2014,Septiembre,Alemania,1,0,,1,POINT (10446304 -75516486)
2014,Septiembre,Alemania,1,1,,2,POINT (10886686 -74776479)
2014,Septiembre,Alemania,3,6,,9,POINT (3451668 -76532004)
2014,Septiembre,Alemania,1176,2350,,3526,POINT (4697157 -74140516)
2014,Septiembre,Alemania,0,1,,1,POINT (4815189 -75736374)
2014,Septiembre,Alemania,10,9,,19,POINT (6170465 -7542726)
2014,Septiembre,Angola,0,2,,2,POINT (4697157 -74140516)
2014,Septiembre,Antigua y Barbuda,0,1,,1,POINT (4697157 -74140516)
2014,Septiembre,Países Bajos,22,15,,37,POINT (10406342 -75527794)
2014,Septiembre,Países Bajos,0,1,,1,POINT (10446304 -75516486)
2014,Septiembre,Países Bajos,0,1,,1,POINT (10886686 -74776479)
2014,Septiembre,Países Bajos,1,0,,1,POINT (11247723 -74213989)
2014,Septiembre,Países Bajos,1,10,,11,POINT (3451668 -76532004)
2014,Septiembre,Países Bajos,37,92,,129,POINT (4697157 -74140516)
2014,Septiembre,Países Bajos,2,0,,2,POINT (4815189 -75736374)
2014,Septiembre,Países Bajos,55,55,,110,POINT (6170465 -7542726)
2014,Septiembre,Países Bajos,1,2,,3,POINT (7128047 -73181317)
2014,Septiembre,Arabia Saudita,0,2,,2,POINT (4697157 -74140516)
2014,Septiembre,Argelia,0,1,,1,POINT (3451668 -76532004)
2014,Septiembre,Argelia,5,3,,8,POINT (4697157 -74140516)
2014,Septiembre,Argentina,1,0,,1,POINT (0.81488 -77356)
2014,Septiembre,Argentina,86,63,,149,POINT (10446304 -75516486)
2014,Septiembre,Argentina,3,4,,7,POINT (10886686 -74776479)
2014,Septiembre,Argentina,80,62,,142,POINT (125862 -81702165)
2014,Septiembre,Argentina,35,63,,98,POINT (3451668 -76532004)
2014,Septiembre,Argentina,0,1,,1,POINT (3884426 -77061029)
2014,Septiembre,Argentina,1877,2743,,4620,POINT (4697157 -74140516)
2014,Septiembre,Argentina,120,168,,288,POINT (6170465 -7542726)
2014,Septiembre,Aruba,87,118,,205,POINT (10406342 -75527794)
2014,Septiembre,Aruba,1,5,,6,POINT (10886686 -74776479)
2014,Septiembre,Aruba,7,58,,65,POINT (11247723 -74213989)
2014,Septiembre,Aruba,6,5,,11,POINT (3451668 -76532004)
2014,Septiembre,Aruba,459,516,,975,POINT (4697157 -74140516)
2014,Septiembre,Aruba,6,8,,14,POINT (6170465 -7542726)
2014,Septiembre,Aruba,2,2,,4,POINT (7128047 -73181317)
2014,Septiembre,Australia,1,2,,3,POINT (10446304 -75516486)
2014,Septiembre,Australia,0,2,,2,POINT (3451668 -76532004)
2014,Septiembre,Australia,22,31,,53,POINT (4697157 -74140516)
2014,Septiembre,Australia,9,16,,25,POINT (6170465 -7542726)
2014,Septiembre,Australia,0,1,,1,POINT (7927233 -72508188)
2014,Septiembre,Austria,0,1,,1,POINT (3451668 -76532004)
2014,Septiembre,Austria,16,18,,34,POINT (4697157 -74140516)
2014,Septiembre,Austria,0,1,,1,POINT (6170465 -7542726)
2014,Septiembre,Bahamas,2,37,,39,POINT (10406342 -75527794)
2014,Septiembre,Bahamas,0,1,,1,POINT (10886686 -74776479)
2014,Septiembre,Bahamas,1,0,,1,POINT (3451668 -76532004)
2014,Septiembre,Bahamas,1,0,,1,POINT (4697157 -74140516)
2014,Septiembre,Bahamas,0,1,,1,POINT (4815189 -75736374)
2014,Septiembre,Bahamas,0,1,,1,POINT (6170465 -7542726)
2014,Septiembre,Bahréin,0,1,,1,POINT (4697157 -74140516)
2014,Septiembre,Barbados,0,4,,4,POINT (3451668 -76532004)
2014,Septiembre,Barbados,1,0,,1,POINT (4697157 -74140516)
2014,Septiembre,República de Belarús,1,0,,1,POINT (11360029 -72129595)
2014,Septiembre,República de Belarús,0,1,,1,POINT (7819 -72453013)
2014,Septiembre,Bélgica,0,3,,3,POINT (10446304 -75516486)
2014,Septiembre,Bélgica,0,1,,1,POINT (11247723 -74213989)
2014,Septiembre,Bélgica,1,1,,2,POINT (3451668 -76532004)
2014,Septiembre,Bélgica,23,41,,64,POINT (4697157 -74140516)
2014,Septiembre,Bélgica,0,3,,3,POINT (6170465 -7542726)
2014,Septiembre,Belice,1,0,,1,POINT (3451668 -76532004)
2014,Septiembre,Belice,1,1,,2,POINT (4697157 -74140516)
2014,Septiembre,Belice,0,1,,1,POINT (6170465 -7542726)
2014,Septiembre,Benín,3,1,,4,POINT (4697157 -74140516)
2014,Septiembre,Bermudas/Territorio Británico de Ultramar,1,0,,1,POINT (4697157 -74140516)
2014,Septiembre,Bolivia,1,0,,1,POINT (10886686 -74776479)
2014,Septiembre,Bolivia,5,2,,7,POINT (125862 -81702165)
2014,Septiembre,Bolivia,7,7,,14,POINT (3451668 -76532004)
2014,Septiembre,Bolivia,367,488,,855,POINT (4697157 -74140516)
2014,Septiembre,Bolivia,0,1,,1,POINT (4815189 -75736374)
2014,Septiembre,Bolivia,17,23,,40,POINT (6170465 -7542726)
2014,Septiembre,Botsuana,0,1,,1,POINT (4697157 -74140516)
2014,Septiembre,Brasil,142,155,,297,POINT (-4191162 -69941498)
2014,Septiembre,Brasil,0,1,,1,POINT (0.81488 -77356)
2014,Septiembre,Brasil,0,6,,6,POINT (10406342 -75527794)
2014,Septiembre,Brasil,108,94,,202,POINT (10446304 -75516486)
2014,Septiembre,Brasil,2,7,,9,POINT (10886686 -74776479)
2014,Septiembre,Brasil,0,1,,1,POINT (11247723 -74213989)
2014,Septiembre,Brasil,95,71,,166,POINT (125862 -81702165)
2014,Septiembre,Brasil,18,42,,60,POINT (3451668 -76532004)
2014,Septiembre,Brasil,3751,5485,,9236,POINT (4697157 -74140516)
2014,Septiembre,Brasil,0,6,,6,POINT (4815189 -75736374)
2014,Septiembre,Brasil,120,208,,328,POINT (6170465 -7542726)
2014,Septiembre,Bulgaria,1,2,,3,POINT (4697157 -74140516)
2014,Septiembre,Islas Caimán/Territorio Británico de Ultramar,0,3,,3,POINT (10446304 -75516486)
2014,Septiembre,Islas Caimán/Territorio Británico de Ultramar,1,2,,3,POINT (10886686 -74776479)
2014,Septiembre,Islas Caimán/Territorio Británico de Ultramar,0,2,,2,POINT (4697157 -74140516)
2014,Septiembre,Islas Caimán/Territorio Británico de Ultramar,0,1,,1,POINT (4815189 -75736374)
2014,Septiembre,Islas Caimán/Territorio Británico de Ultramar,0,1,,1,POINT (6170465 -7542726)
2014,Septiembre,Canadá,0,12,,12,POINT (10406342 -75527794)
2014,Septiembre,Canadá,2,3,,5,POINT (10446304 -75516486)
2014,Septiembre,Canadá,0,6,,6,POINT (10886686 -74776479)
2014,Septiembre,Canadá,0,1,,1,POINT (125862 -81702165)
2014,Septiembre,Canadá,13,13,,26,POINT (3451668 -76532004)
2014,Septiembre,Canadá,0,2,,2,POINT (3884426 -77061029)
2014,Septiembre,Canadá,398,658,,1056,POINT (4697157 -74140516)
2014,Septiembre,Canadá,3,4,,7,POINT (4815189 -75736374)
2014,Septiembre,Canadá,43,63,,106,POINT (6170465 -7542726)
2014,Septiembre,Canadá,0,1,,1,POINT (7128047 -73181317)
2014,Septiembre,Canadá,6,3,,9,POINT (7927233 -72508188)
2014,Septiembre,España,0,1,,1,POINT (10406342 -75527794)
2014,Septiembre,España,0,1,,1,POINT (10446304 -75516486)
2014,Septiembre,España,0,1,,1,POINT (10886686 -74776479)
2014,Septiembre,España,154,212,,366,POINT (3451668 -76532004)
2014,Septiembre,España,2433,5093,,7526,POINT (4697157 -74140516)
2014,Septiembre,España,1,0,,1,POINT (4815189 -75736374)
2014,Septiembre,España,111,240,,351,POINT (6170465 -7542726)
2014,Septiembre,España,0,2,,2,POINT (7128047 -73181317)
2014,Septiembre,España,0,4,,4,POINT (125744111 -81703935)
2014,Septiembre,España,1,3,,4,POINT (4697157 -74140516)
2014,Septiembre,España,1,1,,2,POINT (7819 -72453013)
2014,Septiembre,República Democrática del Congo,0,1,,1,POINT (4697157 -74140516)
2014,Septiembre,República de Corea,0,1,,1,POINT (3451668 -76532004)
2014,Septiembre,República de Corea,6,20,,26,POINT (4697157 -74140516)
2014,Septiembre,República de Corea,0,5,,5,POINT (6170465 -7542726)
2014,Septiembre,Costa de Marfil,3,4,,7,POINT (4697157 -74140516)
2014,Septiembre,Costa Rica,1,8,,9,POINT (10406342 -75527794)
2014,Septiembre,Costa Rica,2,3,,5,POINT (10446304 -75516486)
2014,Septiembre,Costa Rica,3,13,,16,POINT (10886686 -74776479)
2014,Septiembre,Costa Rica,0,1,,1,POINT (11247723 -74213989)
2014,Septiembre,Costa Rica,162,127,,289,POINT (125862 -81702165)
2014,Septiembre,Costa Rica,9,34,,43,POINT (3451668 -76532004)
2014,Septiembre,Costa Rica,596,1012,,1608,POINT (4697157 -74140516)
2014,Septiembre,Costa Rica,1,5,,6,POINT (4815189 -75736374)
2014,Septiembre,Costa Rica,40,79,,119,POINT (6170465 -7542726)
2014,Septiembre,Costa Rica,0,3,,3,POINT (7128047 -73181317)
2014,Septiembre,Costa Rica,1,3,,4,POINT (7927233 -72508188)
2014,Septiembre,Croacia,0,4,,4,POINT (4697157 -74140516)
2014,Septiembre,Cuba,4,12,,16,POINT (10886686 -74776479)
2014,Septiembre,Cuba,1,3,,4,POINT (125862 -81702165)
2014,Septiembre,Cuba,6,6,,12,POINT (3451668 -76532004)
2014,Septiembre,Cuba,189,265,,454,POINT (4697157 -74140516)
2014,Septiembre,Cuba,0,1,,1,POINT (4815189 -75736374)
2014,Septiembre,Cuba,12,20,,32,POINT (6170465 -7542726)
2014,Septiembre,Cuba,1,3,,4,POINT (7128047 -73181317)
2014,Septiembre,Cuba,0,2,,2,POINT (7927233 -72508188)
2014,Septiembre,Curazao,0,1,,1,POINT (10406342 -75527794)
2014,Septiembre,Curazao,48,61,,109,POINT (10886686 -74776479)
2014,Septiembre,Curazao,2,2,,4,POINT (11247723 -74213989)
2014,Septiembre,Curazao,2,13,,15,POINT (125862 -81702165)
2014,Septiembre,Curazao,1,1,,2,POINT (3451668 -76532004)
2014,Septiembre,Curazao,247,346,,593,POINT (4697157 -74140516)
2014,Septiembre,Curazao,160,218,,378,POINT (6170465 -7542726)
2014,Septiembre,Curazao,1,5,,6,POINT (7128047 -73181317)
2014,Septiembre,República Checa,2,8,,10,POINT (4697157 -74140516)
2014,Septiembre,Chile,1,0,,1,POINT (0.81488 -77356)
2014,Septiembre,Chile,20,92,,112,POINT (10446304 -75516486)
2014,Septiembre,Chile,0,4,,4,POINT (10886686 -74776479)
2014,Septiembre,Chile,21,16,,37,POINT (125862 -81702165)
2014,Septiembre,Chile,14,25,,39,POINT (3451668 -76532004)
2014,Septiembre,Chile,3987,5166,,9153,POINT (4697157 -74140516)
2014,Septiembre,Chile,0,1,,1,POINT (4815189 -75736374)
2014,Septiembre,Chile,34,90,,124,POINT (6170465 -7542726)
2014,Septiembre,Chile,0,2,,2,POINT (7927233 -72508188)
2014,Septiembre,China,0,2,,2,POINT (10886686 -74776479)
2014,Septiembre,China,28,89,,117,POINT (4697157 -74140516)
2014,Septiembre,China,0,2,,2,POINT (6170465 -7542726)
2014,Septiembre,Chipre,0,1,,1,POINT (4697157 -74140516)
2014,Septiembre,Dinamarca,1,0,,1,POINT (10886686 -74776479)
2014,Septiembre,Dinamarca,0,1,,1,POINT (3451668 -76532004)
2014,Septiembre,Dinamarca,5,12,,17,POINT (4697157 -74140516)
2014,Septiembre,Dinamarca,0,2,,2,POINT (6170465 -7542726)
2014,Septiembre,Dominica,0,1,,1,POINT (4697157 -74140516)
2014,Septiembre,Ecuador,41,83,,124,POINT (0.33002 -76876446)
2014,Septiembre,Ecuador,2157,3504,,5661,POINT (0.81488 -77356)
2014,Septiembre,Ecuador,6,237,,243,POINT (1800143 -78802679)
2014,Septiembre,Ecuador,1,7,,8,POINT (10446304 -75516486)
2014,Septiembre,Ecuador,2,6,,8,POINT (10886686 -74776479)
2014,Septiembre,Ecuador,7,12,,19,POINT (125862 -81702165)
2014,Septiembre,Ecuador,568,688,,1256,POINT (3451668 -76532004)
2014,Septiembre,Ecuador,2672,4410,,7082,POINT (4697157 -74140516)
2014,Septiembre,Ecuador,0,1,,1,POINT (4815189 -75736374)
2014,Septiembre,Ecuador,477,600,,1077,POINT (6170465 -7542726)
2014,Septiembre,Ecuador,2,0,,2,POINT (7128047 -73181317)
2014,Septiembre,Ecuador,1,0,,1,POINT (7927233 -72508188)
2014,Septiembre,Egipto,1,3,,4,POINT (4697157 -74140516)
2014,Septiembre,El Salvador,1,3,,4,POINT (10886686 -74776479)
2014,Septiembre,El Salvador,2,9,,11,POINT (125862 -81702165)
2014,Septiembre,El Salvador,98,161,,259,POINT (3451668 -76532004)
2014,Septiembre,El Salvador,817,1218,,2035,POINT (4697157 -74140516)
2014,Septiembre,El Salvador,0,1,,1,POINT (4815189 -75736374)
2014,Septiembre,El Salvador,90,207,,297,POINT (6170465 -7542726)
2014,Septiembre,El Salvador,1,0,,1,POINT (7128047 -73181317)
2014,Septiembre,El Salvador,2,2,,4,POINT (7927233 -72508188)
2014,Septiembre,Emiratos Árabes,1,0,,1,POINT (3451668 -76532004)
2014,Septiembre,Emiratos Árabes,1,2,,3,POINT (4697157 -74140516)
2014,Septiembre,Emiratos Árabes,1,0,,1,POINT (6170465 -7542726)
2014,Septiembre,Eslovaquia,1,0,,1,POINT (3451668 -76532004)
2014,Septiembre,Eslovaquia,2,1,,3,POINT (4697157 -74140516)
2014,Septiembre,Eslovaquia,0,2,,2,POINT (4697157 -74140516)
2014,Septiembre,Eslovaquia,0,1,,1,POINT (6170465 -7542726)
2014,Septiembre,Estados Unidos de América,1,38,,39,POINT (10406342 -75527794)
2014,Septiembre,Estados Unidos de América,858,1630,,2488,POINT (10446304 -75516486)
2014,Septiembre,Estados Unidos de América,182,408,,590,POINT (10886686 -74776479)
2014,Septiembre,Estados Unidos de América,0,11,,11,POINT (10970933 -74765343)
2014,Septiembre,Estados Unidos de América,1,27,,28,POINT (11247723 -74213989)
2014,Septiembre,Estados Unidos de América,6,6,,12,POINT (125862 -81702165)
2014,Septiembre,Estados Unidos de América,567,906,,1473,POINT (3451668 -76532004)
2014,Septiembre,Estados Unidos de América,0,1,,1,POINT (3884426 -77061029)
2014,Septiembre,Estados Unidos de América,66,123,,189,POINT (445285 -75766353)
2014,Septiembre,Estados Unidos de América,6245,13081,,19326,POINT (4697157 -74140516)
2014,Septiembre,Estados Unidos de América,38,59,,97,POINT (4815189 -75736374)
2014,Septiembre,Estados Unidos de América,992,2818,,3810,POINT (6170465 -7542726)
2014,Septiembre,Estados Unidos de América,7,16,,23,POINT (7128047 -73181317)
2014,Septiembre,Estados Unidos de América,73,111,,184,POINT (7927233 -72508188)
2014,Septiembre,Estados Unidos de América,0,9,,9,POINT (9402597 -75681642)
2014,Septiembre,Etiopia,1,1,,2,POINT (4697157 -74140516)
2014,Septiembre,Filipinas,0,2,,2,POINT (10446304 -75516486)
2014,Septiembre,Filipinas,0,5,,5,POINT (10886686 -74776479)
2014,Septiembre,Filipinas,0,2,,2,POINT (11247723 -74213989)
2014,Septiembre,Filipinas,1,10,,11,POINT (4697157 -74140516)
2014,Septiembre,Filipinas,1,0,,1,POINT (6170465 -7542726)
2014,Septiembre,Finlandia,4,11,,15,POINT (4697157 -74140516)
2014,Septiembre,Finlandia,0,1,,1,POINT (6170465 -7542726)
2014,Septiembre,Francia,2,2,,4,POINT (10886686 -74776479)
2014,Septiembre,Francia,0,1,,1,POINT (11247723 -74213989)
2014,Septiembre,Francia,3,5,,8,POINT (3451668 -76532004)
2014,Septiembre,Francia,720,1404,,2124,POINT (4697157 -74140516)
2014,Septiembre,Francia,5,18,,23,POINT (6170465 -7542726)
2014,Septiembre,Ghana,0,1,,1,POINT (1800143 -78802679)
2014,Septiembre,Ghana,0,1,,1,POINT (4697157 -74140516)
2014,Septiembre,Grecia,1,2,,3,POINT (3451668 -76532004)
2014,Septiembre,Grecia,5,6,,11,POINT (4697157 -74140516)
2014,Septiembre,Guatemala,0,1,,1,POINT (10446304 -75516486)
2014,Septiembre,Guatemala,1,11,,12,POINT (10886686 -74776479)
2014,Septiembre,Guatemala,1,1,,2,POINT (125862 -81702165)
2014,Septiembre,Guatemala,8,37,,45,POINT (3451668 -76532004)
2014,Septiembre,Guatemala,0,2,,2,POINT (3884426 -77061029)
2014,Septiembre,Guatemala,180,354,,534,POINT (4697157 -74140516)
2014,Septiembre,Guatemala,0,2,,2,POINT (4815189 -75736374)
2014,Septiembre,Guatemala,9,53,,62,POINT (6170465 -7542726)
2014,Septiembre,Guatemala,0,1,,1,POINT (7128047 -73181317)
2014,Septiembre,Guatemala,4,4,,8,POINT (7927233 -72508188)
2014,Septiembre,Guyana,1,0,,1,POINT (3451668 -76532004)
2014,Septiembre,Guyana,0,2,,2,POINT (4697157 -74140516)
2014,Septiembre,Guyana,0,2,,2,POINT (6170465 -7542726)
2014,Septiembre,Guadalupe/Territorio Francés,1,2,,3,POINT (4697157 -74140516)
2014,Septiembre,Guadalupe/Territorio Francés,1,0,,1,POINT (6170465 -7542726)
2014,Septiembre,Haití,1,2,,3,POINT (3451668 -76532004)
2014,Septiembre,Haití,0,3,,3,POINT (4697157 -74140516)
2014,Septiembre,Haití,1,2,,3,POINT (6170465 -7542726)
2014,Septiembre,Honduras,5,4,,9,POINT (10446304 -75516486)
2014,Septiembre,Honduras,2,22,,24,POINT (10886686 -74776479)
2014,Septiembre,Honduras,0,13,,13,POINT (125744111 -81703935)
2014,Septiembre,Honduras,4,7,,11,POINT (125862 -81702165)
2014,Septiembre,Honduras,2,6,,8,POINT (133387613 -81372937)
2014,Septiembre,Honduras,8,7,,15,POINT (3451668 -76532004)
2014,Septiembre,Honduras,36,55,,91,POINT (4697157 -74140516)
2014,Septiembre,Honduras,1,0,,1,POINT (4815189 -75736374)
2014,Septiembre,Honduras,13,31,,44,POINT (6170465 -7542726)
2014,Septiembre,Honduras,0,1,,1,POINT (7128047 -73181317)
2014,Septiembre,Hong Kong,1,0,,1,POINT (10446304 -75516486)
2014,Septiembre,Hong Kong,0,1,,1,POINT (10886686 -74776479)
2014,Septiembre,Hong Kong,1,0,,1,POINT (3451668 -76532004)
2014,Septiembre,Hong Kong,3,7,,10,POINT (4697157 -74140516)
2014,Septiembre,Hungría,1,2,,3,POINT (4697157 -74140516)
2014,Septiembre,Hungría,1,0,,1,POINT (6170465 -7542726)
2014,Septiembre,India,0,1,,1,POINT (10446304 -75516486)
2014,Septiembre,India,0,1,,1,POINT (10886686 -74776479)
2014,Septiembre,India,0,1,,1,POINT (3451668 -76532004)
2014,Septiembre,India,2,15,,17,POINT (4697157 -74140516)
2014,Septiembre,Indonesia,0,1,,1,POINT (10886686 -74776479)
2014,Septiembre,Indonesia,0,3,,3,POINT (4697157 -74140516)
2014,Septiembre,República de Irlanda,6,13,,19,POINT (4697157 -74140516)
2014,Septiembre,Israel,0,1,,1,POINT (10446304 -75516486)
2014,Septiembre,Israel,0,1,,1,POINT (10886686 -74776479)
2014,Septiembre,Israel,2,2,,4,POINT (3451668 -76532004)
2014,Septiembre,Israel,10,55,,65,POINT (4697157 -74140516)
2014,Septiembre,Israel,0,3,,3,POINT (6170465 -7542726)
2014,Septiembre,Italia,1,0,,1,POINT (10886686 -74776479)
2014,Septiembre,Italia,3,11,,14,POINT (3451668 -76532004)
2014,Septiembre,Italia,69,221,,290,POINT (4697157 -74140516)
2014,Septiembre,Italia,2,7,,9,POINT (6170465 -7542726)
2014,Septiembre,Italia,1,0,,1,POINT (7128047 -73181317)
2014,Septiembre,Jamaica,0,1,,1,POINT (10406342 -75527794)
2014,Septiembre,Jamaica,0,2,,2,POINT (10446304 -75516486)
2014,Septiembre,Jamaica,0,3,,3,POINT (10886686 -74776479)
2014,Septiembre,Jamaica,2,5,,7,POINT (4697157 -74140516)
2014,Septiembre,Jamaica,0,1,,1,POINT (4815189 -75736374)
2014,Septiembre,Jamaica,1,2,,3,POINT (6170465 -7542726)
2014,Septiembre,Japón,1,0,,1,POINT (10446304 -75516486)
2014,Septiembre,Japón,0,1,,1,POINT (10886686 -74776479)
2014,Septiembre,Japón,0,1,,1,POINT (3451668 -76532004)
2014,Septiembre,Japón,12,25,,37,POINT (4697157 -74140516)
2014,Septiembre,Japón,1,2,,3,POINT (6170465 -7542726)
2014,Septiembre,Jordania,1,1,,2,POINT (4697157 -74140516)
2014,Septiembre,Kenia,3,3,,6,POINT (4697157 -74140516)
2014,Septiembre,Kenia,0,1,,1,POINT (6170465 -7542726)
2014,Septiembre,Lituania,2,2,,4,POINT (4697157 -74140516)
2014,Septiembre,Líbano,0,1,,1,POINT (10886686 -74776479)
2014,Septiembre,Líbano,6,5,,11,POINT (4697157 -74140516)
2014,Septiembre,Luxemburgo,0,1,,1,POINT (4697157 -74140516)
2014,Septiembre,Luxemburgo,0,1,,1,POINT (7927233 -72508188)
2014,Septiembre,Malasia,1,4,,5,POINT (4697157 -74140516)
2014,Septiembre,Marruecos,1,0,,1,POINT (4697157 -74140516)
2014,Septiembre,Mauritania,0,1,,1,POINT (6170465 -7542726)
2014,Septiembre,México,0,1,,1,POINT (10406342 -75527794)
2014,Septiembre,México,8,25,,33,POINT (10446304 -75516486)
2014,Septiembre,México,20,22,,42,POINT (10886686 -74776479)
2014,Septiembre,México,1,2,,3,POINT (125862 -81702165)
2014,Septiembre,México,26,58,,84,POINT (3451668 -76532004)
2014,Septiembre,México,3287,6592,,9879,POINT (4697157 -74140516)
2014,Septiembre,México,2,8,,10,POINT (4815189 -75736374)
2014,Septiembre,México,87,244,,331,POINT (6170465 -7542726)
2014,Septiembre,México,0,5,,5,POINT (7128047 -73181317)
2014,Septiembre,México,26,27,,53,POINT (7927233 -72508188)
2014,Septiembre,República de Moldavia,1,0,,1,POINT (4697157 -74140516)
2014,Septiembre,Mónaco,0,1,,1,POINT (4697157 -74140516)
2014,Septiembre,Myanmar,0,1,,1,POINT (3451668 -76532004)
2014,Septiembre,Nauru,0,1,,1,POINT (6170465 -7542726)
2014,Septiembre,Namibia,1,0,,1,POINT (4697157 -74140516)
2014,Septiembre,Nepal,0,2,,2,POINT (4697157 -74140516)
2014,Septiembre,Nicaragua,1,3,,4,POINT (10886686 -74776479)
2014,Septiembre,Nicaragua,4,14,,18,POINT (3451668 -76532004)
2014,Septiembre,Nicaragua,18,24,,42,POINT (4697157 -74140516)
2014,Septiembre,Nicaragua,0,1,,1,POINT (4815189 -75736374)
2014,Septiembre,Nicaragua,4,11,,15,POINT (6170465 -7542726)
2014,Septiembre,Noruega,2,0,,2,POINT (10886686 -74776479)
2014,Septiembre,Noruega,0,3,,3,POINT (3451668 -76532004)
2014,Septiembre,Noruega,7,13,,20,POINT (4697157 -74140516)
2014,Septiembre,Noruega,0,1,,1,POINT (6170465 -7542726)
2014,Septiembre,Nueva Zelanda,0,1,,1,POINT (10886686 -74776479)
2014,Septiembre,Nueva Zelanda,1,2,,3,POINT (3451668 -76532004)
2014,Septiembre,Nueva Zelanda,7,7,,14,POINT (4697157 -74140516)
2014,Septiembre,Nueva Zelanda,0,1,,1,POINT (6170465 -7542726)
2014,Septiembre,Pakistán,0,1,,1,POINT (4697157 -74140516)
2014,Septiembre,Panamá,917,835,,1752,POINT (10406342 -75527794)
2014,Septiembre,Panamá,1709,1955,,3664,POINT (10446304 -75516486)
2014,Septiembre,Panamá,116,385,,501,POINT (10886686 -74776479)
2014,Septiembre,Panamá,0,4,,4,POINT (10970933 -74765343)
2014,Septiembre,Panamá,0,1,,1,POINT (11247723 -74213989)
2014,Septiembre,Panamá,799,684,,1483,POINT (125862 -81702165)
2014,Septiembre,Panamá,316,660,,976,POINT (3451668 -76532004)
2014,Septiembre,Panamá,0,16,,16,POINT (3884426 -77061029)
2014,Septiembre,Panamá,2556,4673,,7229,POINT (4697157 -74140516)
2014,Septiembre,Panamá,49,90,,139,POINT (4815189 -75736374)
2014,Septiembre,Panamá,852,1609,,2461,POINT (6170465 -7542726)
2014,Septiembre,Panamá,4,3,,7,POINT (7102626 -77762647)
2014,Septiembre,Panamá,21,54,,75,POINT (7128047 -73181317)
2014,Septiembre,Panamá,191,245,,436,POINT (7927233 -72508188)
2014,Septiembre,Panamá,0,9,,9,POINT (806667 -767333)
2014,Septiembre,Panamá,35,64,,99,POINT (863337 -7735002)
2014,Septiembre,Paraguay,1,0,,1,POINT (10446304 -75516486)
2014,Septiembre,Paraguay,7,12,,19,POINT (125862 -81702165)
2014,Septiembre,Paraguay,3,6,,9,POINT (3451668 -76532004)
2014,Septiembre,Paraguay,32,54,,86,POINT (4697157 -74140516)
2014,Septiembre,Paraguay,17,48,,65,POINT (6170465 -7542726)
2014,Septiembre,Paraguay,0,7,,7,POINT (7927233 -72508188)
2014,Septiembre,Perú,64,117,,181,POINT (-4191162 -69941498)
2014,Septiembre,Perú,1,0,,1,POINT (0.81488 -77356)
2014,Septiembre,Perú,5,8,,13,POINT (10446304 -75516486)
2014,Septiembre,Perú,2,3,,5,POINT (10886686 -74776479)
2014,Septiembre,Perú,112,87,,199,POINT (125862 -81702165)
2014,Septiembre,Perú,236,375,,611,POINT (3451668 -76532004)
2014,Septiembre,Perú,0,1,,1,POINT (3884426 -77061029)
2014,Septiembre,Perú,5233,7052,,12285,POINT (4697157 -74140516)
2014,Septiembre,Perú,367,684,,1051,POINT (6170465 -7542726)
2014,Septiembre,Perú,1,0,,1,POINT (7128047 -73181317)
2014,Septiembre,Perú,0,1,,1,POINT (7927233 -72508188)
2014,Septiembre,Polonia,10,13,,23,POINT (4697157 -74140516)
2014,Septiembre,Polonia,1,0,,1,POINT (6170465 -7542726)
2014,Septiembre,Portugal,0,1,,1,POINT (10886686 -74776479)
2014,Septiembre,Portugal,407,617,,1024,POINT (4697157 -74140516)
2014,Septiembre,Portugal,0,1,,1,POINT (4815189 -75736374)
2014,Septiembre,Polinesia Francesa/Colectividad de Ultramar Francesa,1,0,,1,POINT (4697157 -74140516)
2014,Septiembre,Puerto Rico/Territorio de Estados Unidos,3,28,,31,POINT (10886686 -74776479)
2014,Septiembre,Puerto Rico/Territorio de Estados Unidos,3,8,,11,POINT (125862 -81702165)
2014,Septiembre,Puerto Rico/Territorio de Estados Unidos,15,16,,31,POINT (3451668 -76532004)
2014,Septiembre,Puerto Rico/Territorio de Estados Unidos,168,273,,441,POINT (4697157 -74140516)
2014,Septiembre,Puerto Rico/Territorio de Estados Unidos,2,2,,4,POINT (4815189 -75736374)
2014,Septiembre,Puerto Rico/Territorio de Estados Unidos,14,42,,56,POINT (6170465 -7542726)
2014,Septiembre,Puerto Rico/Territorio de Estados Unidos,2,15,,17,POINT (7128047 -73181317)
2014,Septiembre,Qatar,1,0,,1,POINT (4697157 -74140516)
2014,Septiembre,Reino Unido de Gran Bretaña e Irlanda del Norte,0,2,,2,POINT (10446304 -75516486)
2014,Septiembre,Reino Unido de Gran Bretaña e Irlanda del Norte,0,2,,2,POINT (10886686 -74776479)
2014,Septiembre,Reino Unido de Gran Bretaña e Irlanda del Norte,0,1,,1,POINT (11247723 -74213989)
2014,Septiembre,Reino Unido de Gran Bretaña e Irlanda del Norte,3,5,,8,POINT (3451668 -76532004)
2014,Septiembre,Reino Unido de Gran Bretaña e Irlanda del Norte,376,680,,1056,POINT (4697157 -74140516)
2014,Septiembre,Reino Unido de Gran Bretaña e Irlanda del Norte,1,1,,2,POINT (4815189 -75736374)
2014,Septiembre,Reino Unido de Gran Bretaña e Irlanda del Norte,6,15,,21,POINT (6170465 -7542726)
2014,Septiembre,Reino Unido de Gran Bretaña e Irlanda del Norte,0,1,,1,POINT (7128047 -73181317)
2014,Septiembre,Federación de Rusia,0,1,,1,POINT (3451668 -76532004)
2014,Septiembre,Federación de Rusia,21,31,,52,POINT (4697157 -74140516)
2014,Septiembre,Federación de Rusia,1,0,,1,POINT (6170465 -7542726)
2014,Septiembre,República Dominicana,0,3,,3,POINT (10406342 -75527794)
2014,Septiembre,República Dominicana,2,4,,6,POINT (10446304 -75516486)
2014,Septiembre,República Dominicana,6,13,,19,POINT (10886686 -74776479)
2014,Septiembre,República Dominicana,7,8,,15,POINT (125862 -81702165)
2014,Septiembre,República Dominicana,16,15,,31,POINT (3451668 -76532004)
2014,Septiembre,República Dominicana,329,597,,926,POINT (4697157 -74140516)
2014,Septiembre,República Dominicana,2,6,,8,POINT (4815189 -75736374)
2014,Septiembre,República Dominicana,10,45,,55,POINT (6170465 -7542726)
2014,Septiembre,República Dominicana,0,6,,6,POINT (7128047 -73181317)
2014,Septiembre,República Dominicana,0,1,,1,POINT (7927233 -72508188)
2014,Septiembre,Reunión,1,1,,2,POINT (4697157 -74140516)
2014,Septiembre,República Democrática Popular de Corea,0,1,,1,POINT (4697157 -74140516)
2014,Septiembre,Rumania,2,9,,11,POINT (4697157 -74140516)
2014,Septiembre,Rumania,1,1,,2,POINT (6170465 -7542726)
2014,Septiembre,Santa Sede/Ciudad del Vaticano,0,2,,2,POINT (4697157 -74140516)
2014,Septiembre,Serbia,1,0,,1,POINT (4697157 -74140516)
2014,Septiembre,Singapur,1,3,,4,POINT (4697157 -74140516)
2014,Septiembre,Singapur,0,3,,3,POINT (6170465 -7542726)
2014,Septiembre,Sudáfrica,6,10,,16,POINT (4697157 -74140516)
2014,Septiembre,Sudáfrica,0,1,,1,POINT (6170465 -7542726)
2014,Septiembre,Suecia,0,1,,1,POINT (3451668 -76532004)
2014,Septiembre,Suecia,14,21,,35,POINT (4697157 -74140516)
2014,Septiembre,Suecia,0,2,,2,POINT (6170465 -7542726)
2014,Septiembre,Suiza,0,1,,1,POINT (10886686 -74776479)
2014,Septiembre,Suiza,3,6,,9,POINT (3451668 -76532004)
2014,Septiembre,Suiza,46,56,,102,POINT (4697157 -74140516)
2014,Septiembre,Suiza,4,7,,11,POINT (6170465 -7542726)
2014,Septiembre,Surinam,1,1,,2,POINT (4697157 -74140516)
2014,Septiembre,Surinam,8,7,,15,POINT (6170465 -7542726)
2014,Septiembre,Taiwán,0,1,,1,POINT (3451668 -76532004)
2014,Septiembre,Taiwán,0,5,,5,POINT (4697157 -74140516)
2014,Septiembre,Taiwán,1,0,,1,POINT (6170465 -7542726)
2014,Septiembre,Tailandia,1,1,,2,POINT (4697157 -74140516)
2014,Septiembre,Tanzania,1,3,,4,POINT (4697157 -74140516)
2014,Septiembre,Trinidad y Tobago,0,16,,16,POINT (10406342 -75527794)
2014,Septiembre,Trinidad y Tobago,1,4,,5,POINT (3451668 -76532004)
2014,Septiembre,Trinidad y Tobago,2,7,,9,POINT (4697157 -74140516)
2014,Septiembre,Trinidad y Tobago,0,3,,3,POINT (4815189 -75736374)
2014,Septiembre,Trinidad y Tobago,2,4,,6,POINT (6170465 -7542726)
2014,Septiembre,Turquía,0,8,,8,POINT (10970933 -74765343)
2014,Septiembre,Turquía,4,14,,18,POINT (4697157 -74140516)
2014,Septiembre,Ucrania,0,7,,7,POINT (3451668 -76532004)
2014,Septiembre,Ucrania,1,2,,3,POINT (4697157 -74140516)
2014,Septiembre,Uruguay,11,9,,20,POINT (10446304 -75516486)
2014,Septiembre,Uruguay,1,1,,2,POINT (10886686 -74776479)
2014,Septiembre,Uruguay,16,13,,29,POINT (125862 -81702165)
2014,Septiembre,Uruguay,23,23,,46,POINT (3451668 -76532004)
2014,Septiembre,Uruguay,35,98,,133,POINT (4697157 -74140516)
2014,Septiembre,Uruguay,38,59,,97,POINT (6170465 -7542726)
2014,Septiembre,Uruguay,0,1,,1,POINT (7128047 -73181317)
2014,Septiembre,Venezuela,0,3,,3,POINT (10406342 -75527794)
2014,Septiembre,Venezuela,9,42,,51,POINT (10446304 -75516486)
2014,Septiembre,Venezuela,5,73,,78,POINT (10886686 -74776479)
2014,Septiembre,Venezuela,0,1,,1,POINT (11247723 -74213989)
2014,Septiembre,Venezuela,1527,2192,,3719,POINT (11360029 -72129595)
2014,Septiembre,Venezuela,2,3,,5,POINT (125862 -81702165)
2014,Septiembre,Venezuela,14,17,,31,POINT (3451668 -76532004)
2014,Septiembre,Venezuela,3421,3870,,7291,POINT (4697157 -74140516)
2014,Septiembre,Venezuela,1,1,,2,POINT (4815189 -75736374)
2014,Septiembre,Venezuela,29,75,,104,POINT (6170465 -7542726)
2014,Septiembre,Venezuela,22,40,,62,POINT (6185536 -67484028)
2014,Septiembre,Venezuela,69,85,,154,POINT (7088729 -70740253)
2014,Septiembre,Venezuela,3,2,,5,POINT (7128047 -73181317)
2014,Septiembre,Venezuela,3120,4014,,7134,POINT (7819 -72453013)
2014,Septiembre,Venezuela,393,399,,792,POINT (7927233 -72508188)
2014,Septiembre,Zimbabue,0,1,,1,POINT (4697157 -74140516)
2014,Septiembre,Desconocido,0,1,,1,POINT (12165168 -71983761)
2014,Septiembre,Desconocido,3,22,,25,POINT (125744111 -81703935)
2014,Septiembre,Desconocido,0,1,,1,POINT (3451668 -76532004)
2014,Septiembre,Desconocido,2,44,,46,POINT (4697157 -74140516)
2014,Septiembre,Desconocido,0,1,,1,POINT (863337 -7735002)
2014,Octubre,Afganistán,0,1,,1,POINT (4697157 -74140516)
2014,Octubre,Alemania,1,2,,3,POINT (10446304 -75516486)
2014,Octubre,Alemania,3,6,,9,POINT (10886686 -74776479)
2014,Octubre,Alemania,0,2,,2,POINT (11247723 -74213989)
2014,Octubre,Alemania,5,5,,10,POINT (3451668 -76532004)
2014,Octubre,Alemania,1366,2354,,3720,POINT (4697157 -74140516)
2014,Octubre,Alemania,1,0,,1,POINT (4815189 -75736374)
2014,Octubre,Alemania,13,18,,31,POINT (6170465 -7542726)
2014,Octubre,Antigua y Barbuda,0,1,,1,POINT (10406342 -75527794)
2014,Octubre,Antigua y Barbuda,0,2,,2,POINT (10886686 -74776479)
2014,Octubre,Antigua y Barbuda,1,2,,3,POINT (4697157 -74140516)
2014,Octubre,Países Bajos,4,4,,8,POINT (10446304 -75516486)
2014,Octubre,Países Bajos,0,5,,5,POINT (10886686 -74776479)
2014,Octubre,Países Bajos,7,26,,33,POINT (3451668 -76532004)
2014,Octubre,Países Bajos,45,77,,122,POINT (4697157 -74140516)
2014,Octubre,Países Bajos,0,5,,5,POINT (4815189 -75736374)
2014,Octubre,Países Bajos,66,80,,146,POINT (6170465 -7542726)
2014,Octubre,Países Bajos,7,4,,11,POINT (7128047 -73181317)
2014,Octubre,Arabia Saudita,0,1,,1,POINT (4697157 -74140516)
2014,Octubre,Argelia,0,1,,1,POINT (3451668 -76532004)
2014,Octubre,Argelia,4,7,,11,POINT (4697157 -74140516)
2014,Octubre,Argentina,1,2,,3,POINT (0.81488 -77356)
2014,Octubre,Argentina,0,1,,1,POINT (10406342 -75527794)
2014,Octubre,Argentina,138,105,,243,POINT (10446304 -75516486)
2014,Octubre,Argentina,5,3,,8,POINT (10886686 -74776479)
2014,Octubre,Argentina,81,66,,147,POINT (125862 -81702165)
2014,Octubre,Argentina,35,71,,106,POINT (3451668 -76532004)
2014,Octubre,Argentina,1720,2683,,4403,POINT (4697157 -74140516)
2014,Octubre,Argentina,0,6,,6,POINT (4815189 -75736374)
2014,Octubre,Argentina,97,165,,262,POINT (6170465 -7542726)
2014,Octubre,Argentina,1,1,,2,POINT (7128047 -73181317)
2014,Octubre,Argentina,1,2,,3,POINT (7927233 -72508188)
2014,Octubre,Aruba,42,41,,83,POINT (10406342 -75527794)
2014,Octubre,Aruba,5,1,,6,POINT (10886686 -74776479)
2014,Octubre,Aruba,0,3,,3,POINT (10970933 -74765343)
2014,Octubre,Aruba,12,18,,30,POINT (11247723 -74213989)
2014,Octubre,Aruba,1,4,,5,POINT (3451668 -76532004)
2014,Octubre,Aruba,487,608,,1095,POINT (4697157 -74140516)
2014,Octubre,Aruba,2,11,,13,POINT (6170465 -7542726)
2014,Octubre,Aruba,2,1,,3,POINT (7128047 -73181317)
2014,Octubre,Aruba,1,1,,2,POINT (7927233 -72508188)
2014,Octubre,Australia,0,2,,2,POINT (10446304 -75516486)
2014,Octubre,Australia,0,3,,3,POINT (10886686 -74776479)
2014,Octubre,Australia,0,3,,3,POINT (3451668 -76532004)
2014,Octubre,Australia,18,25,,43,POINT (4697157 -74140516)
2014,Octubre,Australia,10,14,,24,POINT (6170465 -7542726)
2014,Octubre,Austria,1,0,,1,POINT (10446304 -75516486)
2014,Octubre,Austria,13,17,,30,POINT (4697157 -74140516)
2014,Octubre,Azerbaiyán,1,1,,2,POINT (4697157 -74140516)
2014,Octubre,Bahamas,1,4,,5,POINT (4697157 -74140516)
2014,Octubre,Bahamas,1,0,,1,POINT (4815189 -75736374)
2014,Octubre,Bahamas,1,1,,2,POINT (6170465 -7542726)
2014,Octubre,Bahréin,1,1,,2,POINT (4697157 -74140516)
2014,Octubre,Bahréin,1,0,,1,POINT (6170465 -7542726)
2014,Octubre,Bahréin,1,0,,1,POINT (7819 -72453013)
2014,Octubre,Bangladesh,0,1,,1,POINT (4697157 -74140516)
2014,Octubre,Barbados,0,2,,2,POINT (4697157 -74140516)
2014,Octubre,República de Belarús,1,1,,2,POINT (11360029 -72129595)
2014,Octubre,República de Belarús,0,2,,2,POINT (7819 -72453013)
2014,Octubre,Bélgica,1,1,,2,POINT (10446304 -75516486)
2014,Octubre,Bélgica,4,4,,8,POINT (3451668 -76532004)
2014,Octubre,Bélgica,26,59,,85,POINT (4697157 -74140516)
2014,Octubre,Bélgica,0,4,,4,POINT (6170465 -7542726)
2014,Octubre,Belice,1,1,,2,POINT (4697157 -74140516)
2014,Octubre,Belice,0,1,,1,POINT (6170465 -7542726)
2014,Octubre,Bermudas/Territorio Británico de Ultramar,0,1,,1,POINT (4697157 -74140516)
2014,Octubre,Bermudas/Territorio Británico de Ultramar,1,2,,3,POINT (6170465 -7542726)
2014,Octubre,Bolivia,9,2,,11,POINT (10446304 -75516486)
2014,Octubre,Bolivia,13,8,,21,POINT (125862 -81702165)
2014,Octubre,Bolivia,15,15,,30,POINT (3451668 -76532004)
2014,Octubre,Bolivia,426,564,,990,POINT (4697157 -74140516)
2014,Octubre,Bolivia,14,41,,55,POINT (6170465 -7542726)
2014,Octubre,Brasil,84,115,,199,POINT (-4191162 -69941498)
2014,Octubre,Brasil,0,3,,3,POINT (-4214082 -69941431)
2014,Octubre,Brasil,1,0,,1,POINT (0.81488 -77356)
2014,Octubre,Brasil,0,12,,12,POINT (10406342 -75527794)
2014,Octubre,Brasil,98,84,,182,POINT (10446304 -75516486)
2014,Octubre,Brasil,3,8,,11,POINT (10886686 -74776479)
2014,Octubre,Brasil,0,1,,1,POINT (11247723 -74213989)
2014,Octubre,Brasil,65,53,,118,POINT (125862 -81702165)
2014,Octubre,Brasil,34,72,,106,POINT (3451668 -76532004)
2014,Octubre,Brasil,3673,5270,,8943,POINT (4697157 -74140516)
2014,Octubre,Brasil,3,31,,34,POINT (4815189 -75736374)
2014,Octubre,Brasil,138,191,,329,POINT (6170465 -7542726)
2014,Octubre,Brasil,1,2,,3,POINT (7128047 -73181317)
2014,Octubre,Brasil,3,4,,7,POINT (7927233 -72508188)
2014,Octubre,Bulgaria,0,3,,3,POINT (4697157 -74140516)
2014,Octubre,Islas Caimán/Territorio Británico de Ultramar,0,1,,1,POINT (10406342 -75527794)
2014,Octubre,Islas Caimán/Territorio Británico de Ultramar,0,11,,11,POINT (10886686 -74776479)
2014,Octubre,Islas Caimán/Territorio Británico de Ultramar,0,8,,8,POINT (4697157 -74140516)
2014,Octubre,Canadá,1,0,,1,POINT (-4191162 -69941498)
2014,Octubre,Canadá,5,4,,9,POINT (10446304 -75516486)
2014,Octubre,Canadá,2,12,,14,POINT (10886686 -74776479)
2014,Octubre,Canadá,0,4,,4,POINT (10970933 -74765343)
2014,Octubre,Canadá,1,2,,3,POINT (125862 -81702165)
2014,Octubre,Canadá,16,31,,47,POINT (3451668 -76532004)
2014,Octubre,Canadá,493,756,,1249,POINT (4697157 -74140516)
2014,Octubre,Canadá,3,5,,8,POINT (4815189 -75736374)
2014,Octubre,Canadá,45,83,,128,POINT (6170465 -7542726)
2014,Octubre,Canadá,1,5,,6,POINT (7128047 -73181317)
2014,Octubre,Canadá,3,3,,6,POINT (7927233 -72508188)
2014,Octubre,España,1,1,,2,POINT (10406342 -75527794)
2014,Octubre,España,1,1,,2,POINT (10446304 -75516486)
2014,Octubre,España,0,4,,4,POINT (10886686 -74776479)
2014,Octubre,España,1,0,,1,POINT (125862 -81702165)
2014,Octubre,España,146,312,,458,POINT (3451668 -76532004)
2014,Octubre,España,2388,5126,,7514,POINT (4697157 -74140516)
2014,Octubre,España,0,4,,4,POINT (4815189 -75736374)
2014,Octubre,España,137,334,,471,POINT (6170465 -7542726)
2014,Octubre,España,2,0,,2,POINT (7927233 -72508188)
2014,Octubre,República de Corea,1,0,,1,POINT (3451668 -76532004)
2014,Octubre,República de Corea,0,3,,3,POINT (3884426 -77061029)
2014,Octubre,República de Corea,22,33,,55,POINT (4697157 -74140516)
2014,Octubre,República de Corea,0,1,,1,POINT (4815189 -75736374)
2014,Octubre,República de Corea,0,2,,2,POINT (6170465 -7542726)
2014,Octubre,Costa de Marfil,1,2,,3,POINT (4697157 -74140516)
2014,Octubre,Costa Rica,10,27,,37,POINT (10406342 -75527794)
2014,Octubre,Costa Rica,4,11,,15,POINT (10446304 -75516486)
2014,Octubre,Costa Rica,3,8,,11,POINT (10886686 -74776479)
2014,Octubre,Costa Rica,0,1,,1,POINT (11247723 -74213989)
2014,Octubre,Costa Rica,1,15,,16,POINT (125744111 -81703935)
2014,Octubre,Costa Rica,7,13,,20,POINT (125862 -81702165)
2014,Octubre,Costa Rica,31,46,,77,POINT (3451668 -76532004)
2014,Octubre,Costa Rica,0,1,,1,POINT (3884426 -77061029)
2014,Octubre,Costa Rica,599,1107,,1706,POINT (4697157 -74140516)
2014,Octubre,Costa Rica,4,9,,13,POINT (4815189 -75736374)
2014,Octubre,Costa Rica,54,119,,173,POINT (6170465 -7542726)
2014,Octubre,Costa Rica,4,2,,6,POINT (7128047 -73181317)
2014,Octubre,Costa Rica,5,10,,15,POINT (7927233 -72508188)
2014,Octubre,Croacia,3,6,,9,POINT (4697157 -74140516)
2014,Octubre,Cuba,0,6,,6,POINT (10446304 -75516486)
2014,Octubre,Cuba,2,6,,8,POINT (10886686 -74776479)
2014,Octubre,Cuba,0,1,,1,POINT (10970933 -74765343)
2014,Octubre,Cuba,0,8,,8,POINT (125862 -81702165)
2014,Octubre,Cuba,19,17,,36,POINT (3451668 -76532004)
2014,Octubre,Cuba,183,309,,492,POINT (4697157 -74140516)
2014,Octubre,Cuba,1,2,,3,POINT (4815189 -75736374)
2014,Octubre,Cuba,9,22,,31,POINT (6170465 -7542726)
2014,Octubre,Cuba,1,4,,5,POINT (7128047 -73181317)
2014,Octubre,Cuba,0,5,,5,POINT (7927233 -72508188)
2014,Octubre,Cuba,0,2,,2,POINT (806667 -767333)
2014,Octubre,Curazao,0,3,,3,POINT (10406342 -75527794)
2014,Octubre,Curazao,4,7,,11,POINT (10446304 -75516486)
2014,Octubre,Curazao,49,82,,131,POINT (10886686 -74776479)
2014,Octubre,Curazao,1,3,,4,POINT (11247723 -74213989)
2014,Octubre,Curazao,332,428,,760,POINT (4697157 -74140516)
2014,Octubre,Curazao,185,196,,381,POINT (6170465 -7542726)
2014,Octubre,Curazao,0,1,,1,POINT (7128047 -73181317)
2014,Octubre,República Checa,7,7,,14,POINT (4697157 -74140516)
2014,Octubre,República Checa,0,1,,1,POINT (4815189 -75736374)
2014,Octubre,Chile,1,1,,2,POINT (0.81488 -77356)
2014,Octubre,Chile,0,1,,1,POINT (1800143 -78802679)
2014,Octubre,Chile,18,8,,26,POINT (10446304 -75516486)
2014,Octubre,Chile,1,3,,4,POINT (10886686 -74776479)
2014,Octubre,Chile,17,7,,24,POINT (125862 -81702165)
2014,Octubre,Chile,41,64,,105,POINT (3451668 -76532004)
2014,Octubre,Chile,0,10,,10,POINT (3884426 -77061029)
2014,Octubre,Chile,3776,5119,,8895,POINT (4697157 -74140516)
2014,Octubre,Chile,0,1,,1,POINT (4815189 -75736374)
2014,Octubre,Chile,38,72,,110,POINT (6170465 -7542726)
2014,Octubre,Chile,0,1,,1,POINT (7128047 -73181317)
2014,Octubre,China,0,1,,1,POINT (3451668 -76532004)
2014,Octubre,China,32,100,,132,POINT (4697157 -74140516)
2014,Octubre,China,0,2,,2,POINT (6170465 -7542726)
2014,Octubre,Chipre,1,0,,1,POINT (6170465 -7542726)
2014,Octubre,Dinamarca,0,1,,1,POINT (10886686 -74776479)
2014,Octubre,Dinamarca,0,2,,2,POINT (3451668 -76532004)
2014,Octubre,Dinamarca,7,6,,13,POINT (4697157 -74140516)
2014,Octubre,Dinamarca,0,1,,1,POINT (6170465 -7542726)
2014,Octubre,Dominica,2,0,,2,POINT (4697157 -74140516)
2014,Octubre,Ecuador,46,129,,175,POINT (0.33002 -76876446)
2014,Octubre,Ecuador,2454,3755,,6209,POINT (0.81488 -77356)
2014,Octubre,Ecuador,13,329,,342,POINT (1800143 -78802679)
2014,Octubre,Ecuador,0,2,,2,POINT (10406342 -75527794)
2014,Octubre,Ecuador,0,3,,3,POINT (10446304 -75516486)
2014,Octubre,Ecuador,2,9,,11,POINT (10886686 -74776479)
2014,Octubre,Ecuador,7,7,,14,POINT (125862 -81702165)
2014,Octubre,Ecuador,507,744,,1251,POINT (3451668 -76532004)
2014,Octubre,Ecuador,0,4,,4,POINT (3884426 -77061029)
2014,Octubre,Ecuador,2569,4433,,7002,POINT (4697157 -74140516)
2014,Octubre,Ecuador,2,1,,3,POINT (4815189 -75736374)
2014,Octubre,Ecuador,471,670,,1141,POINT (6170465 -7542726)
2014,Octubre,Ecuador,10,9,,19,POINT (7927233 -72508188)
2014,Octubre,Egipto,0,2,,2,POINT (4697157 -74140516)
2014,Octubre,El Salvador,4,4,,8,POINT (10446304 -75516486)
2014,Octubre,El Salvador,0,1,,1,POINT (10886686 -74776479)
2014,Octubre,El Salvador,1,1,,2,POINT (125862 -81702165)
2014,Octubre,El Salvador,93,147,,240,POINT (3451668 -76532004)
2014,Octubre,El Salvador,639,1019,,1658,POINT (4697157 -74140516)
2014,Octubre,El Salvador,1,0,,1,POINT (4815189 -75736374)
2014,Octubre,El Salvador,80,199,,279,POINT (6170465 -7542726)
2014,Octubre,El Salvador,0,1,,1,POINT (7128047 -73181317)
2014,Octubre,Emiratos Árabes,1,7,,8,POINT (4697157 -74140516)
2014,Octubre,Emiratos Árabes,0,1,,1,POINT (6170465 -7542726)
2014,Octubre,Eslovaquia,0,2,,2,POINT (4697157 -74140516)
2014,Octubre,Eslovenia,1,0,,1,POINT (4697157 -74140516)
2014,Octubre,Estados Unidos de América,4,25,,29,POINT (10406342 -75527794)
2014,Octubre,Estados Unidos de América,1000,1791,,2791,POINT (10446304 -75516486)
2014,Octubre,Estados Unidos de América,174,418,,592,POINT (10886686 -74776479)
2014,Octubre,Estados Unidos de América,0,17,,17,POINT (10970933 -74765343)
2014,Octubre,Estados Unidos de América,0,10,,10,POINT (11247723 -74213989)
2014,Octubre,Estados Unidos de América,1,8,,9,POINT (125862 -81702165)
2014,Octubre,Estados Unidos de América,0,1,,1,POINT (133387613 -81372937)
2014,Octubre,Estados Unidos de América,570,979,,1549,POINT (3451668 -76532004)
2014,Octubre,Estados Unidos de América,91,139,,230,POINT (445285 -75766353)
2014,Octubre,Estados Unidos de América,6438,13248,,19686,POINT (4697157 -74140516)
2014,Octubre,Estados Unidos de América,57,95,,152,POINT (4815189 -75736374)
2014,Octubre,Estados Unidos de América,1027,2889,,3916,POINT (6170465 -7542726)
2014,Octubre,Estados Unidos de América,12,32,,44,POINT (7128047 -73181317)
2014,Octubre,Estados Unidos de América,89,61,,150,POINT (7927233 -72508188)
2014,Octubre,Estados Unidos de América,0,4,,4,POINT (806667 -767333)
2014,Octubre,Estados Unidos de América,0,8,,8,POINT (9402597 -75681642)
2014,Octubre,Estonia,0,1,,1,POINT (3451668 -76532004)
2014,Octubre,Estonia,4,4,,8,POINT (4697157 -74140516)
2014,Octubre,Estonia,0,1,,1,POINT (6170465 -7542726)
2014,Octubre,Filipinas,0,1,,1,POINT (10446304 -75516486)
2014,Octubre,Filipinas,0,1,,1,POINT (10886686 -74776479)
2014,Octubre,Filipinas,0,6,,6,POINT (3451668 -76532004)
2014,Octubre,Filipinas,0,1,,1,POINT (3884426 -77061029)
2014,Octubre,Filipinas,1,23,,24,POINT (4697157 -74140516)
2014,Octubre,Finlandia,6,7,,13,POINT (4697157 -74140516)
2014,Octubre,Finlandia,1,0,,1,POINT (7927233 -72508188)
2014,Octubre,Francia,0,1,,1,POINT (10406342 -75527794)
2014,Octubre,Francia,1,1,,2,POINT (10886686 -74776479)
2014,Octubre,Francia,4,12,,16,POINT (3451668 -76532004)
2014,Octubre,Francia,1263,2330,,3593,POINT (4697157 -74140516)
2014,Octubre,Francia,6,17,,23,POINT (6170465 -7542726)
2014,Octubre,Francia,0,1,,1,POINT (7927233 -72508188)
2014,Octubre,Gabón,0,1,,1,POINT (4697157 -74140516)
2014,Octubre,Ghana,1,2,,3,POINT (4697157 -74140516)
2014,Octubre,Grecia,2,2,,4,POINT (4697157 -74140516)
2014,Octubre,Guatemala,3,13,,16,POINT (10446304 -75516486)
2014,Octubre,Guatemala,0,4,,4,POINT (10886686 -74776479)
2014,Octubre,Guatemala,1,2,,3,POINT (125862 -81702165)
2014,Octubre,Guatemala,32,60,,92,POINT (3451668 -76532004)
2014,Octubre,Guatemala,0,6,,6,POINT (3884426 -77061029)
2014,Octubre,Guatemala,194,450,,644,POINT (4697157 -74140516)
2014,Octubre,Guatemala,2,6,,8,POINT (4815189 -75736374)
2014,Octubre,Guatemala,19,72,,91,POINT (6170465 -7542726)
2014,Octubre,Guatemala,1,2,,3,POINT (7128047 -73181317)
2014,Octubre,Guatemala,0,4,,4,POINT (7927233 -72508188)
2014,Octubre,Guyana,1,0,,1,POINT (4697157 -74140516)
2014,Octubre,Guadalupe/Territorio Francés,0,1,,1,POINT (3451668 -76532004)
2014,Octubre,Guadalupe/Territorio Francés,0,1,,1,POINT (4697157 -74140516)
2014,Octubre,Guayana Francesa/Departamento de Ultramar Francés,0,1,,1,POINT (10406342 -75527794)
2014,Octubre,Guayana Francesa/Departamento de Ultramar Francés,0,1,,1,POINT (4697157 -74140516)
2014,Octubre,Haití,0,1,,1,POINT (10886686 -74776479)
2014,Octubre,Haití,1,0,,1,POINT (3451668 -76532004)
2014,Octubre,Haití,2,18,,20,POINT (4697157 -74140516)
2014,Octubre,Haití,2,2,,4,POINT (6170465 -7542726)
2014,Octubre,Honduras,1,2,,3,POINT (10446304 -75516486)
2014,Octubre,Honduras,0,28,,28,POINT (10886686 -74776479)
2014,Octubre,Honduras,0,6,,6,POINT (125744111 -81703935)
2014,Octubre,Honduras,1,2,,3,POINT (125862 -81702165)
2014,Octubre,Honduras,0,3,,3,POINT (133387613 -81372937)
2014,Octubre,Honduras,8,11,,19,POINT (3451668 -76532004)
2014,Octubre,Honduras,32,63,,95,POINT (4697157 -74140516)
2014,Octubre,Honduras,1,1,,2,POINT (4815189 -75736374)
2014,Octubre,Honduras,18,30,,48,POINT (6170465 -7542726)
2014,Octubre,Honduras,0,1,,1,POINT (7128047 -73181317)
2014,Octubre,Honduras,1,0,,1,POINT (7927233 -72508188)
2014,Octubre,Hong Kong,1,7,,8,POINT (4697157 -74140516)
2014,Octubre,Hong Kong,0,1,,1,POINT (6170465 -7542726)
2014,Octubre,Hungría,5,4,,9,POINT (4697157 -74140516)
2014,Octubre,India,0,2,,2,POINT (10886686 -74776479)
2014,Octubre,India,3,17,,20,POINT (4697157 -74140516)
2014,Octubre,India,0,1,,1,POINT (4815189 -75736374)
2014,Octubre,India,0,2,,2,POINT (6170465 -7542726)
2014,Octubre,Indonesia,1,4,,5,POINT (4697157 -74140516)
2014,Octubre,Irán,0,3,,3,POINT (4697157 -74140516)
2014,Octubre,República de Irlanda,0,1,,1,POINT (10446304 -75516486)
2014,Octubre,República de Irlanda,3,10,,13,POINT (4697157 -74140516)
2014,Octubre,República de Irlanda,0,1,,1,POINT (6170465 -7542726)
2014,Octubre,Israel,0,2,,2,POINT (10446304 -75516486)
2014,Octubre,Israel,0,1,,1,POINT (10886686 -74776479)
2014,Octubre,Israel,1,3,,4,POINT (3451668 -76532004)
2014,Octubre,Israel,12,99,,111,POINT (4697157 -74140516)
2014,Octubre,Israel,2,6,,8,POINT (6170465 -7542726)
2014,Octubre,Italia,0,2,,2,POINT (10446304 -75516486)
2014,Octubre,Italia,1,2,,3,POINT (10886686 -74776479)
2014,Octubre,Italia,6,17,,23,POINT (3451668 -76532004)
2014,Octubre,Italia,59,206,,265,POINT (4697157 -74140516)
2014,Octubre,Italia,5,27,,32,POINT (6170465 -7542726)
2014,Octubre,Italia,0,1,,1,POINT (7128047 -73181317)
2014,Octubre,Jamaica,0,7,,7,POINT (10406342 -75527794)
2014,Octubre,Jamaica,1,2,,3,POINT (10446304 -75516486)
2014,Octubre,Jamaica,0,1,,1,POINT (10886686 -74776479)
2014,Octubre,Jamaica,0,1,,1,POINT (125862 -81702165)
2014,Octubre,Jamaica,3,5,,8,POINT (3451668 -76532004)
2014,Octubre,Jamaica,5,8,,13,POINT (4697157 -74140516)
2014,Octubre,Jamaica,1,2,,3,POINT (6170465 -7542726)
2014,Octubre,Japón,0,1,,1,POINT (10886686 -74776479)
2014,Octubre,Japón,2,6,,8,POINT (3451668 -76532004)
2014,Octubre,Japón,8,29,,37,POINT (4697157 -74140516)
2014,Octubre,Japón,0,1,,1,POINT (4815189 -75736374)
2014,Octubre,Japón,1,3,,4,POINT (6170465 -7542726)
2014,Octubre,Jordania,1,1,,2,POINT (4697157 -74140516)
2014,Octubre,Kazajistán,0,2,,2,POINT (4697157 -74140516)
2014,Octubre,Kenia,2,2,,4,POINT (3451668 -76532004)
2014,Octubre,Kenia,0,3,,3,POINT (4697157 -74140516)
2014,Octubre,República de Kosovo,0,1,,1,POINT (4697157 -74140516)
2014,Octubre,Letonia,0,1,,1,POINT (4697157 -74140516)
2014,Octubre,Lituania,4,5,,9,POINT (4697157 -74140516)
2014,Octubre,Líbano,6,6,,12,POINT (4697157 -74140516)
2014,Octubre,Luxemburgo,0,2,,2,POINT (4697157 -74140516)
2014,Octubre,Malasia,2,1,,3,POINT (4697157 -74140516)
2014,Octubre,Malasia,1,0,,1,POINT (6170465 -7542726)
2014,Octubre,Malta,2,1,,3,POINT (4697157 -74140516)
2014,Octubre,México,0,1,,1,POINT (10406342 -75527794)
2014,Octubre,México,10,28,,38,POINT (10446304 -75516486)
2014,Octubre,México,11,37,,48,POINT (10886686 -74776479)
2014,Octubre,México,0,1,,1,POINT (11247723 -74213989)
2014,Octubre,México,1,4,,5,POINT (125862 -81702165)
2014,Octubre,México,84,157,,241,POINT (3451668 -76532004)
2014,Octubre,México,3024,6400,,9424,POINT (4697157 -74140516)
2014,Octubre,México,5,16,,21,POINT (4815189 -75736374)
2014,Octubre,México,122,251,,373,POINT (6170465 -7542726)
2014,Octubre,México,7,15,,22,POINT (7128047 -73181317)
2014,Octubre,México,10,16,,26,POINT (7927233 -72508188)
2014,Octubre,Mónaco,0,2,,2,POINT (4697157 -74140516)
2014,Octubre,Namibia,1,1,,2,POINT (4697157 -74140516)
2014,Octubre,Nicaragua,0,3,,3,POINT (10446304 -75516486)
2014,Octubre,Nicaragua,1,1,,2,POINT (10886686 -74776479)
2014,Octubre,Nicaragua,0,5,,5,POINT (3451668 -76532004)
2014,Octubre,Nicaragua,29,42,,71,POINT (4697157 -74140516)
2014,Octubre,Nicaragua,2,1,,3,POINT (4815189 -75736374)
2014,Octubre,Nicaragua,7,25,,32,POINT (6170465 -7542726)
2014,Octubre,Nicaragua,3,24,,27,POINT (7927233 -72508188)
2014,Octubre,Nigeria,0,2,,2,POINT (4697157 -74140516)
2014,Octubre,Nigeria,0,5,,5,POINT (6170465 -7542726)
2014,Octubre,Noruega,13,26,,39,POINT (4697157 -74140516)
2014,Octubre,Noruega,1,1,,2,POINT (6170465 -7542726)
2014,Octubre,Nueva Zelanda,0,2,,2,POINT (10446304 -75516486)
2014,Octubre,Nueva Zelanda,1,3,,4,POINT (3451668 -76532004)
2014,Octubre,Nueva Zelanda,4,6,,10,POINT (4697157 -74140516)
2014,Octubre,Omán,0,1,,1,POINT (4697157 -74140516)
2014,Octubre,Panamá,796,765,,1561,POINT (10406342 -75527794)
2014,Octubre,Panamá,1848,2320,,4168,POINT (10446304 -75516486)
2014,Octubre,Panamá,219,455,,674,POINT (10886686 -74776479)
2014,Octubre,Panamá,0,14,,14,POINT (10970933 -74765343)
2014,Octubre,Panamá,3,5,,8,POINT (11247723 -74213989)
2014,Octubre,Panamá,1,3,,4,POINT (125744111 -81703935)
2014,Octubre,Panamá,1124,877,,2001,POINT (125862 -81702165)
2014,Octubre,Panamá,1,2,,3,POINT (133387613 -81372937)
2014,Octubre,Panamá,304,684,,988,POINT (3451668 -76532004)
2014,Octubre,Panamá,0,28,,28,POINT (3884426 -77061029)
2014,Octubre,Panamá,2670,5003,,7673,POINT (4697157 -74140516)
2014,Octubre,Panamá,58,142,,200,POINT (4815189 -75736374)
2014,Octubre,Panamá,781,1620,,2401,POINT (6170465 -7542726)
2014,Octubre,Panamá,0,1,,1,POINT (6222552 -77401154)
2014,Octubre,Panamá,2,7,,9,POINT (7102626 -77762647)
2014,Octubre,Panamá,21,32,,53,POINT (7128047 -73181317)
2014,Octubre,Panamá,97,143,,240,POINT (7927233 -72508188)
2014,Octubre,Panamá,0,1,,1,POINT (806667 -767333)
2014,Octubre,Panamá,42,69,,111,POINT (863337 -7735002)
2014,Octubre,Panamá,0,1,,1,POINT (9402597 -75681642)
2014,Octubre,Paraguay,8,8,,16,POINT (10446304 -75516486)
2014,Octubre,Paraguay,2,1,,3,POINT (10886686 -74776479)
2014,Octubre,Paraguay,11,10,,21,POINT (125862 -81702165)
2014,Octubre,Paraguay,12,32,,44,POINT (3451668 -76532004)
2014,Octubre,Paraguay,36,50,,86,POINT (4697157 -74140516)
2014,Octubre,Paraguay,12,13,,25,POINT (6170465 -7542726)
2014,Octubre,Paraguay,1,0,,1,POINT (7927233 -72508188)
2014,Octubre,Perú,73,101,,174,POINT (-4191162 -69941498)
2014,Octubre,Perú,1,3,,4,POINT (-4214082 -69941431)
2014,Octubre,Perú,2,11,,13,POINT (0.81488 -77356)
2014,Octubre,Perú,11,10,,21,POINT (10446304 -75516486)
2014,Octubre,Perú,1,3,,4,POINT (10886686 -74776479)
2014,Octubre,Perú,221,186,,407,POINT (125862 -81702165)
2014,Octubre,Perú,263,375,,638,POINT (3451668 -76532004)
2014,Octubre,Perú,5623,7864,,13487,POINT (4697157 -74140516)
2014,Octubre,Perú,3,0,,3,POINT (4815189 -75736374)
2014,Octubre,Perú,319,552,,871,POINT (6170465 -7542726)
2014,Octubre,Perú,1,0,,1,POINT (7128047 -73181317)
2014,Octubre,Perú,2,2,,4,POINT (7927233 -72508188)
2014,Octubre,Polonia,16,26,,42,POINT (4697157 -74140516)
2014,Octubre,Portugal,2,2,,4,POINT (10446304 -75516486)
2014,Octubre,Portugal,0,1,,1,POINT (10886686 -74776479)
2014,Octubre,Portugal,1,2,,3,POINT (3451668 -76532004)
2014,Octubre,Portugal,308,589,,897,POINT (4697157 -74140516)
2014,Octubre,Portugal,2,4,,6,POINT (6170465 -7542726)
2014,Octubre,Puerto Rico/Territorio de Estados Unidos,3,6,,9,POINT (10446304 -75516486)
2014,Octubre,Puerto Rico/Territorio de Estados Unidos,2,17,,19,POINT (10886686 -74776479)
2014,Octubre,Puerto Rico/Territorio de Estados Unidos,18,37,,55,POINT (3451668 -76532004)
2014,Octubre,Puerto Rico/Territorio de Estados Unidos,184,273,,457,POINT (4697157 -74140516)
2014,Octubre,Puerto Rico/Territorio de Estados Unidos,0,8,,8,POINT (4815189 -75736374)
2014,Octubre,Puerto Rico/Territorio de Estados Unidos,21,58,,79,POINT (6170465 -7542726)
2014,Octubre,Puerto Rico/Territorio de Estados Unidos,0,2,,2,POINT (7128047 -73181317)
2014,Octubre,Puerto Rico/Territorio de Estados Unidos,0,2,,2,POINT (7927233 -72508188)
2014,Octubre,Reino Unido de Gran Bretaña e Irlanda del Norte,1,3,,4,POINT (10406342 -75527794)
2014,Octubre,Reino Unido de Gran Bretaña e Irlanda del Norte,2,1,,3,POINT (10446304 -75516486)
2014,Octubre,Reino Unido de Gran Bretaña e Irlanda del Norte,1,10,,11,POINT (10886686 -74776479)
2014,Octubre,Reino Unido de Gran Bretaña e Irlanda del Norte,0,1,,1,POINT (11247723 -74213989)
2014,Octubre,Reino Unido de Gran Bretaña e Irlanda del Norte,4,20,,24,POINT (3451668 -76532004)
2014,Octubre,Reino Unido de Gran Bretaña e Irlanda del Norte,380,746,,1126,POINT (4697157 -74140516)
2014,Octubre,Reino Unido de Gran Bretaña e Irlanda del Norte,0,1,,1,POINT (4815189 -75736374)
2014,Octubre,Reino Unido de Gran Bretaña e Irlanda del Norte,4,13,,17,POINT (6170465 -7542726)
2014,Octubre,República CentroÁfricana,1,1,,2,POINT (4697157 -74140516)
2014,Octubre,Federación de Rusia,0,1,,1,POINT (10446304 -75516486)
2014,Octubre,Federación de Rusia,0,1,,1,POINT (10886686 -74776479)
2014,Octubre,Federación de Rusia,0,1,,1,POINT (11247723 -74213989)
2014,Octubre,Federación de Rusia,19,30,,49,POINT (4697157 -74140516)
2014,Octubre,Federación de Rusia,2,1,,3,POINT (4815189 -75736374)
2014,Octubre,República Dominicana,1,8,,9,POINT (10406342 -75527794)
2014,Octubre,República Dominicana,6,10,,16,POINT (10446304 -75516486)
2014,Octubre,República Dominicana,4,17,,21,POINT (10886686 -74776479)
2014,Octubre,República Dominicana,0,1,,1,POINT (125862 -81702165)
2014,Octubre,República Dominicana,19,25,,44,POINT (3451668 -76532004)
2014,Octubre,República Dominicana,423,670,,1093,POINT (4697157 -74140516)
2014,Octubre,República Dominicana,1,3,,4,POINT (4815189 -75736374)
2014,Octubre,República Dominicana,24,76,,100,POINT (6170465 -7542726)
2014,Octubre,República Dominicana,0,1,,1,POINT (7128047 -73181317)
2014,Octubre,República Dominicana,0,6,,6,POINT (7927233 -72508188)
2014,Octubre,Rumania,2,7,,9,POINT (4697157 -74140516)
2014,Octubre,San  Vicente y las Granadinas,1,0,,1,POINT (10446304 -75516486)
2014,Octubre,Santa Lucia,0,1,,1,POINT (4697157 -74140516)
2014,Octubre,Serbia,0,1,,1,POINT (4697157 -74140516)
2014,Octubre,Singapur,1,3,,4,POINT (4697157 -74140516)
2014,Octubre,Sudáfrica,2,5,,7,POINT (4697157 -74140516)
2014,Octubre,Sudán,0,1,,1,POINT (4697157 -74140516)
2014,Octubre,Suecia,0,1,,1,POINT (10446304 -75516486)
2014,Octubre,Suecia,17,24,,41,POINT (4697157 -74140516)
2014,Octubre,Suecia,0,1,,1,POINT (7927233 -72508188)
2014,Octubre,Suiza,2,0,,2,POINT (10446304 -75516486)
2014,Octubre,Suiza,0,1,,1,POINT (10886686 -74776479)
2014,Octubre,Suiza,0,6,,6,POINT (3451668 -76532004)
2014,Octubre,Suiza,45,83,,128,POINT (4697157 -74140516)
2014,Octubre,Suiza,4,7,,11,POINT (6170465 -7542726)
2014,Octubre,Surinam,0,2,,2,POINT (10406342 -75527794)
2014,Octubre,Surinam,1,0,,1,POINT (3451668 -76532004)
2014,Octubre,Surinam,2,3,,5,POINT (4697157 -74140516)
2014,Octubre,Surinam,5,4,,9,POINT (6170465 -7542726)
2014,Octubre,Taiwán,2,5,,7,POINT (4697157 -74140516)
2014,Octubre,Taiwán,0,5,,5,POINT (6170465 -7542726)
2014,Octubre,Tailandia,2,3,,5,POINT (3451668 -76532004)
2014,Octubre,Tailandia,1,3,,4,POINT (4697157 -74140516)
2014,Octubre,Tailandia,0,1,,1,POINT (6170465 -7542726)
2014,Octubre,Trinidad y Tobago,0,1,,1,POINT (10406342 -75527794)
2014,Octubre,Trinidad y Tobago,2,0,,2,POINT (10446304 -75516486)
2014,Octubre,Trinidad y Tobago,1,3,,4,POINT (10886686 -74776479)
2014,Octubre,Trinidad y Tobago,0,14,,14,POINT (10970933 -74765343)
2014,Octubre,Trinidad y Tobago,9,22,,31,POINT (3451668 -76532004)
2014,Octubre,Trinidad y Tobago,7,16,,23,POINT (4697157 -74140516)
2014,Octubre,Trinidad y Tobago,0,2,,2,POINT (4815189 -75736374)
2014,Octubre,Trinidad y Tobago,1,4,,5,POINT (6170465 -7542726)
2014,Octubre,Trinidad y Tobago,2,0,,2,POINT (7128047 -73181317)
2014,Octubre,Turquía,1,0,,1,POINT (10886686 -74776479)
2014,Octubre,Turquía,1,0,,1,POINT (3451668 -76532004)
2014,Octubre,Turquía,3,14,,17,POINT (4697157 -74140516)
2014,Octubre,Turquía,0,4,,4,POINT (6170465 -7542726)
2014,Octubre,Ucrania,0,1,,1,POINT (3451668 -76532004)
2014,Octubre,Ucrania,5,7,,12,POINT (4697157 -74140516)
2014,Octubre,Ucrania,1,0,,1,POINT (6170465 -7542726)
2014,Octubre,Uganda,1,0,,1,POINT (4697157 -74140516)
2014,Octubre,Uruguay,21,9,,30,POINT (10446304 -75516486)
2014,Octubre,Uruguay,1,2,,3,POINT (10886686 -74776479)
2014,Octubre,Uruguay,20,16,,36,POINT (125862 -81702165)
2014,Octubre,Uruguay,22,24,,46,POINT (3451668 -76532004)
2014,Octubre,Uruguay,45,94,,139,POINT (4697157 -74140516)
2014,Octubre,Uruguay,65,75,,140,POINT (6170465 -7542726)
2014,Octubre,Uruguay,0,1,,1,POINT (7927233 -72508188)
2014,Octubre,Venezuela,0,11,,11,POINT (10406342 -75527794)
2014,Octubre,Venezuela,7,35,,42,POINT (10446304 -75516486)
2014,Octubre,Venezuela,19,74,,93,POINT (10886686 -74776479)
2014,Octubre,Venezuela,0,3,,3,POINT (10970933 -74765343)
2014,Octubre,Venezuela,1236,2044,,3280,POINT (11360029 -72129595)
2014,Octubre,Venezuela,18,38,,56,POINT (3451668 -76532004)
2014,Octubre,Venezuela,3765,4607,,8372,POINT (4697157 -74140516)
2014,Octubre,Venezuela,0,2,,2,POINT (4815189 -75736374)
2014,Octubre,Venezuela,68,92,,160,POINT (6170465 -7542726)
2014,Octubre,Venezuela,224,423,,647,POINT (6185536 -67484028)
2014,Octubre,Venezuela,108,155,,263,POINT (7088729 -70740253)
2014,Octubre,Venezuela,0,3,,3,POINT (7128047 -73181317)
2014,Octubre,Venezuela,2798,3919,,6717,POINT (7819 -72453013)
2014,Octubre,Venezuela,282,386,,668,POINT (7927233 -72508188)
2014,Octubre,Venezuela,0,2,,2,POINT (9402597 -75681642)
2014,Octubre,Islas Turcas y Caicos/Territorio Británico de Ultramar,2,2,,4,POINT (4697157 -74140516)
2014,Octubre,Desconocido,2,34,,36,POINT (4697157 -74140516)
2014,Octubre,Desconocido,0,1,,1,POINT (6170465 -7542726)
2014,Octubre,Desconocido,0,1,,1,POINT (6185536 -67484028)
2014,Noviembre,Afganistán,0,2,,2,POINT (4697157 -74140516)
2014,Noviembre,Albania,0,1,,1,POINT (4697157 -74140516)
2014,Noviembre,Alemania,0,1,,1,POINT (0.81488 -77356)
2014,Noviembre,Alemania,0,2,,2,POINT (10446304 -75516486)
2014,Noviembre,Alemania,2,1,,3,POINT (10886686 -74776479)
2014,Noviembre,Alemania,1,0,,1,POINT (125862 -81702165)
2014,Noviembre,Alemania,4,7,,11,POINT (3451668 -76532004)
2014,Noviembre,Alemania,1439,2705,,4144,POINT (4697157 -74140516)
2014,Noviembre,Alemania,0,2,,2,POINT (4815189 -75736374)
2014,Noviembre,Alemania,8,10,,18,POINT (6170465 -7542726)
2014,Noviembre,Andorra,0,1,,1,POINT (4697157 -74140516)
2014,Noviembre,Antigua y Barbuda,0,7,,7,POINT (10406342 -75527794)
2014,Noviembre,Antigua y Barbuda,1,1,,2,POINT (6170465 -7542726)
2014,Noviembre,Países Bajos,8,3,,11,POINT (10406342 -75527794)
2014,Noviembre,Países Bajos,0,4,,4,POINT (10446304 -75516486)
2014,Noviembre,Países Bajos,0,1,,1,POINT (10886686 -74776479)
2014,Noviembre,Países Bajos,0,1,,1,POINT (125862 -81702165)
2014,Noviembre,Países Bajos,8,18,,26,POINT (3451668 -76532004)
2014,Noviembre,Países Bajos,71,110,,181,POINT (4697157 -74140516)
2014,Noviembre,Países Bajos,0,3,,3,POINT (4815189 -75736374)
2014,Noviembre,Países Bajos,44,70,,114,POINT (6170465 -7542726)
2014,Noviembre,Países Bajos,1,3,,4,POINT (7128047 -73181317)
2014,Noviembre,Argelia,3,4,,7,POINT (4697157 -74140516)
2014,Noviembre,Argelia,1,0,,1,POINT (6170465 -7542726)
2014,Noviembre,Argentina,0,1,,1,POINT (0.81488 -77356)
2014,Noviembre,Argentina,101,86,,187,POINT (10446304 -75516486)
2014,Noviembre,Argentina,7,8,,15,POINT (10886686 -74776479)
2014,Noviembre,Argentina,68,53,,121,POINT (125862 -81702165)
2014,Noviembre,Argentina,69,86,,155,POINT (3451668 -76532004)
2014,Noviembre,Argentina,2024,3082,,5106,POINT (4697157 -74140516)
2014,Noviembre,Argentina,1,1,,2,POINT (4815189 -75736374)
2014,Noviembre,Argentina,104,171,,275,POINT (6170465 -7542726)
2014,Noviembre,Argentina,4,2,,6,POINT (7128047 -73181317)
2014,Noviembre,Argentina,1,2,,3,POINT (7927233 -72508188)
2014,Noviembre,Aruba,54,62,,116,POINT (10406342 -75527794)
2014,Noviembre,Aruba,0,8,,8,POINT (10446304 -75516486)
2014,Noviembre,Aruba,3,3,,6,POINT (10886686 -74776479)
2014,Noviembre,Aruba,0,3,,3,POINT (10970933 -74765343)
2014,Noviembre,Aruba,18,21,,39,POINT (11247723 -74213989)
2014,Noviembre,Aruba,3,5,,8,POINT (3451668 -76532004)
2014,Noviembre,Aruba,396,516,,912,POINT (4697157 -74140516)
2014,Noviembre,Aruba,3,4,,7,POINT (6170465 -7542726)
2014,Noviembre,Aruba,0,2,,2,POINT (7128047 -73181317)
2014,Noviembre,Aruba,0,1,,1,POINT (7927233 -72508188)
2014,Noviembre,Australia,1,2,,3,POINT (10446304 -75516486)
2014,Noviembre,Australia,1,3,,4,POINT (10886686 -74776479)
2014,Noviembre,Australia,4,9,,13,POINT (3451668 -76532004)
2014,Noviembre,Australia,39,44,,83,POINT (4697157 -74140516)
2014,Noviembre,Australia,1,1,,2,POINT (4815189 -75736374)
2014,Noviembre,Australia,24,18,,42,POINT (6170465 -7542726)
2014,Noviembre,Australia,0,2,,2,POINT (7128047 -73181317)
2014,Noviembre,Austria,1,1,,2,POINT (3451668 -76532004)
2014,Noviembre,Austria,12,40,,52,POINT (4697157 -74140516)
2014,Noviembre,Austria,0,1,,1,POINT (6170465 -7542726)
2014,Noviembre,Bahamas,0,2,,2,POINT (11247723 -74213989)
2014,Noviembre,Bahamas,1,0,,1,POINT (3451668 -76532004)
2014,Noviembre,Bahamas,0,1,,1,POINT (4697157 -74140516)
2014,Noviembre,Bahamas,0,2,,2,POINT (6170465 -7542726)
2014,Noviembre,Barbados,0,1,,1,POINT (3451668 -76532004)
2014,Noviembre,República de Belarús,2,0,,2,POINT (4697157 -74140516)
2014,Noviembre,República de Belarús,0,2,,2,POINT (7819 -72453013)
2014,Noviembre,Bélgica,0,2,,2,POINT (10446304 -75516486)
2014,Noviembre,Bélgica,2,2,,4,POINT (3451668 -76532004)
2014,Noviembre,Bélgica,22,43,,65,POINT (4697157 -74140516)
2014,Noviembre,Bélgica,1,8,,9,POINT (6170465 -7542726)
2014,Noviembre,Belice,1,0,,1,POINT (3451668 -76532004)
2014,Noviembre,Belice,0,2,,2,POINT (4697157 -74140516)
2014,Noviembre,Benín,1,0,,1,POINT (4697157 -74140516)
2014,Noviembre,Bolivia,1,0,,1,POINT (0.81488 -77356)
2014,Noviembre,Bolivia,5,2,,7,POINT (10446304 -75516486)
2014,Noviembre,Bolivia,0,3,,3,POINT (10886686 -74776479)
2014,Noviembre,Bolivia,3,3,,6,POINT (125862 -81702165)
2014,Noviembre,Bolivia,8,16,,24,POINT (3451668 -76532004)
2014,Noviembre,Bolivia,442,522,,964,POINT (4697157 -74140516)
2014,Noviembre,Bolivia,0,1,,1,POINT (4815189 -75736374)
2014,Noviembre,Bolivia,34,46,,80,POINT (6170465 -7542726)
2014,Noviembre,Bolivia,0,1,,1,POINT (7128047 -73181317)
2014,Noviembre,Botsuana,1,0,,1,POINT (4697157 -74140516)
2014,Noviembre,Brasil,111,131,,242,POINT (-4191162 -69941498)
2014,Noviembre,Brasil,1,3,,4,POINT (-4214082 -69941431)
2014,Noviembre,Brasil,1,9,,10,POINT (10406342 -75527794)
2014,Noviembre,Brasil,73,49,,122,POINT (10446304 -75516486)
2014,Noviembre,Brasil,2,17,,19,POINT (10886686 -74776479)
2014,Noviembre,Brasil,81,61,,142,POINT (125862 -81702165)
2014,Noviembre,Brasil,53,71,,124,POINT (3451668 -76532004)
2014,Noviembre,Brasil,3865,5661,,9526,POINT (4697157 -74140516)
2014,Noviembre,Brasil,0,2,,2,POINT (4815189 -75736374)
2014,Noviembre,Brasil,122,229,,351,POINT (6170465 -7542726)
2014,Noviembre,Brasil,9,9,,18,POINT (7128047 -73181317)
2014,Noviembre,Brasil,0,2,,2,POINT (7927233 -72508188)
2014,Noviembre,Brunei Darussalam,1,0,,1,POINT (4697157 -74140516)
2014,Noviembre,Bulgaria,2,5,,7,POINT (4697157 -74140516)
2014,Noviembre,Burkina Faso,2,1,,3,POINT (4697157 -74140516)
2014,Noviembre,Islas Caimán/Territorio Británico de Ultramar,2,4,,6,POINT (10406342 -75527794)
2014,Noviembre,Islas Caimán/Territorio Británico de Ultramar,0,2,,2,POINT (10886686 -74776479)
2014,Noviembre,Islas Caimán/Territorio Británico de Ultramar,0,6,,6,POINT (4697157 -74140516)
2014,Noviembre,Islas Caimán/Territorio Británico de Ultramar,0,1,,1,POINT (4815189 -75736374)
2014,Noviembre,Camerún,0,1,,1,POINT (6170465 -7542726)
2014,Noviembre,Canadá,9,12,,21,POINT (10446304 -75516486)
2014,Noviembre,Canadá,3,6,,9,POINT (10886686 -74776479)
2014,Noviembre,Canadá,23,20,,43,POINT (3451668 -76532004)
2014,Noviembre,Canadá,508,826,,1334,POINT (4697157 -74140516)
2014,Noviembre,Canadá,3,6,,9,POINT (4815189 -75736374)
2014,Noviembre,Canadá,60,114,,174,POINT (6170465 -7542726)
2014,Noviembre,Canadá,4,3,,7,POINT (7128047 -73181317)
2014,Noviembre,Canadá,6,4,,10,POINT (7927233 -72508188)
2014,Noviembre,España,0,5,,5,POINT (10406342 -75527794)
2014,Noviembre,España,3,2,,5,POINT (10446304 -75516486)
2014,Noviembre,España,0,3,,3,POINT (10886686 -74776479)
2014,Noviembre,España,200,300,,500,POINT (3451668 -76532004)
2014,Noviembre,España,2500,5581,,8081,POINT (4697157 -74140516)
2014,Noviembre,España,2,4,,6,POINT (4815189 -75736374)
2014,Noviembre,España,136,342,,478,POINT (6170465 -7542726)
2014,Noviembre,España,0,1,,1,POINT (7927233 -72508188)
2014,Noviembre,España,0,36,,36,POINT (4697157 -74140516)
2014,Noviembre,España,0,1,,1,POINT (6170465 -7542726)
2014,Noviembre,República de Corea,0,1,,1,POINT (10886686 -74776479)
2014,Noviembre,República de Corea,2,23,,25,POINT (4697157 -74140516)
2014,Noviembre,República de Corea,0,1,,1,POINT (6170465 -7542726)
2014,Noviembre,Costa de Marfil,0,1,,1,POINT (3451668 -76532004)
2014,Noviembre,Costa de Marfil,1,1,,2,POINT (4697157 -74140516)
2014,Noviembre,Noviembre,2,16,,18,POINT (10406342 -75527794)
2014,Noviembre,Noviembre,8,13,,21,POINT (10446304 -75516486)
2014,Noviembre,Noviembre,5,9,,14,POINT (10886686 -74776479)
2014,Noviembre,Noviembre,0,1,,1,POINT (10970933 -74765343)
2014,Noviembre,Noviembre,0,2,,2,POINT (125744111 -81703935)
2014,Noviembre,Noviembre,2,4,,6,POINT (125862 -81702165)
2014,Noviembre,Noviembre,20,34,,54,POINT (3451668 -76532004)
2014,Noviembre,Noviembre,621,1126,,1747,POINT (4697157 -74140516)
2014,Noviembre,Noviembre,3,22,,25,POINT (4815189 -75736374)
2014,Noviembre,Noviembre,80,168,,248,POINT (6170465 -7542726)
2014,Noviembre,Noviembre,1,1,,2,POINT (7128047 -73181317)
2014,Noviembre,Noviembre,3,4,,7,POINT (7927233 -72508188)
2014,Noviembre,Croacia,0,1,,1,POINT (10446304 -75516486)
2014,Noviembre,Croacia,2,9,,11,POINT (4697157 -74140516)
2014,Noviembre,Cuba,104,97,,201,POINT (10446304 -75516486)
2014,Noviembre,Cuba,4,12,,16,POINT (10886686 -74776479)
2014,Noviembre,Cuba,0,3,,3,POINT (11247723 -74213989)
2014,Noviembre,Cuba,2,5,,7,POINT (125862 -81702165)
2014,Noviembre,Cuba,20,18,,38,POINT (3451668 -76532004)
2014,Noviembre,Cuba,224,394,,618,POINT (4697157 -74140516)
2014,Noviembre,Cuba,3,1,,4,POINT (4815189 -75736374)
2014,Noviembre,Cuba,12,16,,28,POINT (6170465 -7542726)
2014,Noviembre,Cuba,0,2,,2,POINT (7128047 -73181317)
2014,Noviembre,Cuba,21,21,,42,POINT (7927233 -72508188)
2014,Noviembre,Curazao,3,3,,6,POINT (10406342 -75527794)
2014,Noviembre,Curazao,50,47,,97,POINT (10886686 -74776479)
2014,Noviembre,Curazao,0,1,,1,POINT (10970933 -74765343)
2014,Noviembre,Curazao,8,10,,18,POINT (11247723 -74213989)
2014,Noviembre,Curazao,0,2,,2,POINT (3451668 -76532004)
2014,Noviembre,Curazao,290,387,,677,POINT (4697157 -74140516)
2014,Noviembre,Curazao,141,218,,359,POINT (6170465 -7542726)
2014,Noviembre,Curazao,1,1,,2,POINT (7128047 -73181317)
2014,Noviembre,República Checa,5,14,,19,POINT (4697157 -74140516)
2014,Noviembre,República Checa,0,3,,3,POINT (6170465 -7542726)
2014,Noviembre,Chile,1,1,,2,POINT (0.81488 -77356)
2014,Noviembre,Chile,10,13,,23,POINT (10446304 -75516486)
2014,Noviembre,Chile,1,2,,3,POINT (10886686 -74776479)
2014,Noviembre,Chile,16,18,,34,POINT (125862 -81702165)
2014,Noviembre,Chile,15,39,,54,POINT (3451668 -76532004)
2014,Noviembre,Chile,3743,5161,,8904,POINT (4697157 -74140516)
2014,Noviembre,Chile,3,0,,3,POINT (4815189 -75736374)
2014,Noviembre,Chile,30,83,,113,POINT (6170465 -7542726)
2014,Noviembre,Chile,2,0,,2,POINT (7128047 -73181317)
2014,Noviembre,Chile,1,0,,1,POINT (7927233 -72508188)
2014,Noviembre,China,0,1,,1,POINT (3451668 -76532004)
2014,Noviembre,China,30,135,,165,POINT (4697157 -74140516)
2014,Noviembre,China,0,2,,2,POINT (6170465 -7542726)
2014,Noviembre,Chipre,0,1,,1,POINT (4697157 -74140516)
2014,Noviembre,Chipre,0,1,,1,POINT (6170465 -7542726)
2014,Noviembre,Dinamarca,0,2,,2,POINT (10886686 -74776479)
2014,Noviembre,Dinamarca,0,1,,1,POINT (3451668 -76532004)
2014,Noviembre,Dinamarca,8,10,,18,POINT (4697157 -74140516)
2014,Noviembre,Dinamarca,1,3,,4,POINT (6170465 -7542726)
2014,Noviembre,Dominica,1,0,,1,POINT (4697157 -74140516)
2014,Noviembre,Ecuador,52,102,,154,POINT (0.33002 -76876446)
2014,Noviembre,Ecuador,2385,3518,,5903,POINT (0.81488 -77356)
2014,Noviembre,Ecuador,4,137,,141,POINT (1800143 -78802679)
2014,Noviembre,Ecuador,2,9,,11,POINT (10446304 -75516486)
2014,Noviembre,Ecuador,2,5,,7,POINT (10886686 -74776479)
2014,Noviembre,Ecuador,1,2,,3,POINT (125862 -81702165)
2014,Noviembre,Ecuador,548,538,,1086,POINT (3451668 -76532004)
2014,Noviembre,Ecuador,0,1,,1,POINT (3884426 -77061029)
2014,Noviembre,Ecuador,2748,4855,,7603,POINT (4697157 -74140516)
2014,Noviembre,Ecuador,1,2,,3,POINT (4815189 -75736374)
2014,Noviembre,Ecuador,462,633,,1095,POINT (6170465 -7542726)
2014,Noviembre,Ecuador,0,2,,2,POINT (7128047 -73181317)
2014,Noviembre,Ecuador,16,22,,38,POINT (7927233 -72508188)
2014,Noviembre,Egipto,2,3,,5,POINT (4697157 -74140516)
2014,Noviembre,El Salvador,2,3,,5,POINT (10446304 -75516486)
2014,Noviembre,El Salvador,1,2,,3,POINT (10886686 -74776479)
2014,Noviembre,El Salvador,2,4,,6,POINT (125862 -81702165)
2014,Noviembre,El Salvador,82,162,,244,POINT (3451668 -76532004)
2014,Noviembre,El Salvador,652,1048,,1700,POINT (4697157 -74140516)
2014,Noviembre,El Salvador,95,240,,335,POINT (6170465 -7542726)
2014,Noviembre,Emiratos Árabes,0,5,,5,POINT (4697157 -74140516)
2014,Noviembre,Eslovaquia,0,1,,1,POINT (3451668 -76532004)
2014,Noviembre,Eslovaquia,2,1,,3,POINT (4697157 -74140516)
2014,Noviembre,Eslovenia,3,5,,8,POINT (4697157 -74140516)
2014,Noviembre,Estados Unidos de América,2,25,,27,POINT (10406342 -75527794)
2014,Noviembre,Estados Unidos de América,1590,2617,,4207,POINT (10446304 -75516486)
2014,Noviembre,Estados Unidos de América,183,405,,588,POINT (10886686 -74776479)
2014,Noviembre,Estados Unidos de América,0,3,,3,POINT (10970933 -74765343)
2014,Noviembre,Estados Unidos de América,0,27,,27,POINT (11247723 -74213989)
2014,Noviembre,Estados Unidos de América,7,9,,16,POINT (125862 -81702165)
2014,Noviembre,Estados Unidos de América,695,1209,,1904,POINT (3451668 -76532004)
2014,Noviembre,Estados Unidos de América,0,1,,1,POINT (3884426 -77061029)
2014,Noviembre,Estados Unidos de América,65,87,,152,POINT (445285 -75766353)
2014,Noviembre,Estados Unidos de América,7129,14301,,21430,POINT (4697157 -74140516)
2014,Noviembre,Estados Unidos de América,106,142,,248,POINT (4815189 -75736374)
2014,Noviembre,Estados Unidos de América,1514,3542,,5056,POINT (6170465 -7542726)
2014,Noviembre,Estados Unidos de América,18,48,,66,POINT (7128047 -73181317)
2014,Noviembre,Estados Unidos de América,50,54,,104,POINT (7927233 -72508188)
2014,Noviembre,Estados Unidos de América,0,1,,1,POINT (806667 -767333)
2014,Noviembre,Estados Unidos de América,0,12,,12,POINT (9402597 -75681642)
2014,Noviembre,Estonia,0,2,,2,POINT (4697157 -74140516)
2014,Noviembre,Filipinas,0,3,,3,POINT (10446304 -75516486)
2014,Noviembre,Filipinas,0,2,,2,POINT (10886686 -74776479)
2014,Noviembre,Filipinas,3,5,,8,POINT (3451668 -76532004)
2014,Noviembre,Filipinas,0,3,,3,POINT (3884426 -77061029)
2014,Noviembre,Filipinas,3,9,,12,POINT (4697157 -74140516)
2014,Noviembre,Finlandia,2,2,,4,POINT (3451668 -76532004)
2014,Noviembre,Finlandia,9,11,,20,POINT (4697157 -74140516)
2014,Noviembre,Finlandia,0,1,,1,POINT (6170465 -7542726)
2014,Noviembre,Francia,0,1,,1,POINT (10446304 -75516486)
2014,Noviembre,Francia,0,2,,2,POINT (10886686 -74776479)
2014,Noviembre,Francia,6,12,,18,POINT (3451668 -76532004)
2014,Noviembre,Francia,1179,2242,,3421,POINT (4697157 -74140516)
2014,Noviembre,Francia,0,2,,2,POINT (4815189 -75736374)
2014,Noviembre,Francia,14,26,,40,POINT (6170465 -7542726)
2014,Noviembre,Georgia,1,0,,1,POINT (4697157 -74140516)
2014,Noviembre,Granada,1,3,,4,POINT (11247723 -74213989)
2014,Noviembre,Grecia,1,5,,6,POINT (4697157 -74140516)
2014,Noviembre,Guatemala,7,25,,32,POINT (10446304 -75516486)
2014,Noviembre,Guatemala,4,6,,10,POINT (10886686 -74776479)
2014,Noviembre,Guatemala,1,2,,3,POINT (125862 -81702165)
2014,Noviembre,Guatemala,20,29,,49,POINT (3451668 -76532004)
2014,Noviembre,Guatemala,242,469,,711,POINT (4697157 -74140516)
2014,Noviembre,Guatemala,0,4,,4,POINT (4815189 -75736374)
2014,Noviembre,Guatemala,31,107,,138,POINT (6170465 -7542726)
2014,Noviembre,Guatemala,0,1,,1,POINT (7128047 -73181317)
2014,Noviembre,Guatemala,4,9,,13,POINT (7927233 -72508188)
2014,Noviembre,Guyana,0,2,,2,POINT (10886686 -74776479)
2014,Noviembre,Guyana,2,1,,3,POINT (3451668 -76532004)
2014,Noviembre,Guyana,0,4,,4,POINT (4697157 -74140516)
2014,Noviembre,Guinea,0,1,,1,POINT (4697157 -74140516)
2014,Noviembre,Guadalupe/Territorio Francés,0,2,,2,POINT (4697157 -74140516)
2014,Noviembre,Haití,0,11,,11,POINT (10446304 -75516486)
2014,Noviembre,Haití,1,0,,1,POINT (3451668 -76532004)
2014,Noviembre,Haití,1,0,,1,POINT (6170465 -7542726)
2014,Noviembre,Honduras,1,3,,4,POINT (10446304 -75516486)
2014,Noviembre,Honduras,3,5,,8,POINT (10886686 -74776479)
2014,Noviembre,Honduras,1,15,,16,POINT (125744111 -81703935)
2014,Noviembre,Honduras,0,3,,3,POINT (125862 -81702165)
2014,Noviembre,Honduras,4,2,,6,POINT (133387613 -81372937)
2014,Noviembre,Honduras,6,4,,10,POINT (3451668 -76532004)
2014,Noviembre,Honduras,38,102,,140,POINT (4697157 -74140516)
2014,Noviembre,Honduras,0,1,,1,POINT (4815189 -75736374)
2014,Noviembre,Honduras,33,37,,70,POINT (6170465 -7542726)
2014,Noviembre,Honduras,1,1,,2,POINT (7927233 -72508188)
2014,Noviembre,Hong Kong,3,4,,7,POINT (4697157 -74140516)
2014,Noviembre,Hong Kong,0,1,,1,POINT (6170465 -7542726)
2014,Noviembre,Hungría,10,7,,17,POINT (4697157 -74140516)
2014,Noviembre,India,0,1,,1,POINT (10886686 -74776479)
2014,Noviembre,India,0,12,,12,POINT (3451668 -76532004)
2014,Noviembre,India,5,22,,27,POINT (4697157 -74140516)
2014,Noviembre,India,0,1,,1,POINT (6170465 -7542726)
2014,Noviembre,Indonesia,1,2,,3,POINT (3451668 -76532004)
2014,Noviembre,Indonesia,3,11,,14,POINT (4697157 -74140516)
2014,Noviembre,Irán,0,3,,3,POINT (4697157 -74140516)
2014,Noviembre,República de Irlanda,0,1,,1,POINT (3451668 -76532004)
2014,Noviembre,República de Irlanda,4,8,,12,POINT (4697157 -74140516)
2014,Noviembre,Islandia,0,1,,1,POINT (4697157 -74140516)
2014,Noviembre,Israel,0,1,,1,POINT (3451668 -76532004)
2014,Noviembre,Israel,15,92,,107,POINT (4697157 -74140516)
2014,Noviembre,Israel,1,4,,5,POINT (6170465 -7542726)
2014,Noviembre,Italia,0,3,,3,POINT (10446304 -75516486)
2014,Noviembre,Italia,0,2,,2,POINT (10886686 -74776479)
2014,Noviembre,Italia,0,1,,1,POINT (11247723 -74213989)
2014,Noviembre,Italia,6,19,,25,POINT (3451668 -76532004)
2014,Noviembre,Italia,92,301,,393,POINT (4697157 -74140516)
2014,Noviembre,Italia,5,19,,24,POINT (6170465 -7542726)
2014,Noviembre,Italia,0,2,,2,POINT (7128047 -73181317)
2014,Noviembre,Jamaica,0,7,,7,POINT (10406342 -75527794)
2014,Noviembre,Jamaica,0,1,,1,POINT (10446304 -75516486)
2014,Noviembre,Jamaica,0,3,,3,POINT (10886686 -74776479)
2014,Noviembre,Jamaica,0,3,,3,POINT (125744111 -81703935)
2014,Noviembre,Jamaica,2,7,,9,POINT (125862 -81702165)
2014,Noviembre,Jamaica,2,13,,15,POINT (4697157 -74140516)
2014,Noviembre,Jamaica,0,1,,1,POINT (6170465 -7542726)
2014,Noviembre,Jamaica,0,2,,2,POINT (7128047 -73181317)
2014,Noviembre,Japón,0,3,,3,POINT (3451668 -76532004)
2014,Noviembre,Japón,8,22,,30,POINT (4697157 -74140516)
2014,Noviembre,Japón,0,1,,1,POINT (4815189 -75736374)
2014,Noviembre,Japón,2,6,,8,POINT (6170465 -7542726)
2014,Noviembre,Kazajistán,1,1,,2,POINT (4697157 -74140516)
2014,Noviembre,Kenia,0,1,,1,POINT (3451668 -76532004)
2014,Noviembre,Kenia,4,4,,8,POINT (4697157 -74140516)
2014,Noviembre,Kirguistán,1,0,,1,POINT (3451668 -76532004)
2014,Noviembre,República de Kosovo,1,1,,2,POINT (4697157 -74140516)
2014,Noviembre,Letonia,4,2,,6,POINT (4697157 -74140516)
2014,Noviembre,Lituania,4,1,,5,POINT (4697157 -74140516)
2014,Noviembre,Líbano,2,6,,8,POINT (4697157 -74140516)
2014,Noviembre,Luxemburgo,0,2,,2,POINT (4697157 -74140516)
2014,Noviembre,Malasia,1,3,,4,POINT (4697157 -74140516)
2014,Noviembre,México,0,3,,3,POINT (10406342 -75527794)
2014,Noviembre,México,17,26,,43,POINT (10446304 -75516486)
2014,Noviembre,México,10,30,,40,POINT (10886686 -74776479)
2014,Noviembre,México,1,2,,3,POINT (10970933 -74765343)
2014,Noviembre,México,0,1,,1,POINT (11247723 -74213989)
2014,Noviembre,México,0,11,,11,POINT (125744111 -81703935)
2014,Noviembre,México,1,2,,3,POINT (125862 -81702165)
2014,Noviembre,México,1,2,,3,POINT (133387613 -81372937)
2014,Noviembre,México,45,118,,163,POINT (3451668 -76532004)
2014,Noviembre,México,3069,6504,,9573,POINT (4697157 -74140516)
2014,Noviembre,México,2,19,,21,POINT (4815189 -75736374)
2014,Noviembre,México,105,294,,399,POINT (6170465 -7542726)
2014,Noviembre,México,4,4,,8,POINT (7128047 -73181317)
2014,Noviembre,México,14,18,,32,POINT (7927233 -72508188)
2014,Noviembre,Mónaco,1,1,,2,POINT (4697157 -74140516)
2014,Noviembre,Micronesia,0,1,,1,POINT (3451668 -76532004)
2014,Noviembre,Nicaragua,1,1,,2,POINT (10446304 -75516486)
2014,Noviembre,Nicaragua,0,2,,2,POINT (10886686 -74776479)
2014,Noviembre,Nicaragua,0,1,,1,POINT (133387613 -81372937)
2014,Noviembre,Nicaragua,5,9,,14,POINT (3451668 -76532004)
2014,Noviembre,Nicaragua,24,29,,53,POINT (4697157 -74140516)
2014,Noviembre,Nicaragua,0,2,,2,POINT (4815189 -75736374)
2014,Noviembre,Nicaragua,3,23,,26,POINT (6170465 -7542726)
2014,Noviembre,Nicaragua,1,0,,1,POINT (7128047 -73181317)
2014,Noviembre,Nicaragua,0,3,,3,POINT (7927233 -72508188)
2014,Noviembre,Nigeria,1,1,,2,POINT (4697157 -74140516)
2014,Noviembre,Noruega,0,1,,1,POINT (10446304 -75516486)
2014,Noviembre,Noruega,0,1,,1,POINT (10970933 -74765343)
2014,Noviembre,Noruega,1,0,,1,POINT (3451668 -76532004)
2014,Noviembre,Noruega,11,26,,37,POINT (4697157 -74140516)
2014,Noviembre,Noruega,0,1,,1,POINT (6170465 -7542726)
2014,Noviembre,Nueva Zelanda,0,1,,1,POINT (3451668 -76532004)
2014,Noviembre,Nueva Zelanda,1,5,,6,POINT (4697157 -74140516)
2014,Noviembre,Nueva Zelanda,0,1,,1,POINT (6170465 -7542726)
2014,Noviembre,Pakistán,0,3,,3,POINT (4697157 -74140516)
2014,Noviembre,Panamá,1016,1071,,2087,POINT (10406342 -75527794)
2014,Noviembre,Panamá,1879,2115,,3994,POINT (10446304 -75516486)
2014,Noviembre,Panamá,176,432,,608,POINT (10886686 -74776479)
2014,Noviembre,Panamá,0,6,,6,POINT (10970933 -74765343)
2014,Noviembre,Panamá,2,8,,10,POINT (11247723 -74213989)
2014,Noviembre,Panamá,5,19,,24,POINT (125744111 -81703935)
2014,Noviembre,Panamá,1043,832,,1875,POINT (125862 -81702165)
2014,Noviembre,Panamá,8,13,,21,POINT (133387613 -81372937)
2014,Noviembre,Panamá,331,726,,1057,POINT (3451668 -76532004)
2014,Noviembre,Panamá,0,23,,23,POINT (3884426 -77061029)
2014,Noviembre,Panamá,2682,4857,,7539,POINT (4697157 -74140516)
2014,Noviembre,Panamá,55,127,,182,POINT (4815189 -75736374)
2014,Noviembre,Panamá,967,1694,,2661,POINT (6170465 -7542726)
2014,Noviembre,Panamá,2,2,,4,POINT (7102626 -77762647)
2014,Noviembre,Panamá,34,51,,85,POINT (7128047 -73181317)
2014,Noviembre,Panamá,90,129,,219,POINT (7927233 -72508188)
2014,Noviembre,Panamá,0,3,,3,POINT (806667 -767333)
2014,Noviembre,Panamá,80,117,,197,POINT (863337 -7735002)
2014,Noviembre,Paraguay,6,5,,11,POINT (10446304 -75516486)
2014,Noviembre,Paraguay,4,0,,4,POINT (10886686 -74776479)
2014,Noviembre,Paraguay,16,14,,30,POINT (125862 -81702165)
2014,Noviembre,Paraguay,7,20,,27,POINT (3451668 -76532004)
2014,Noviembre,Paraguay,58,51,,109,POINT (4697157 -74140516)
2014,Noviembre,Paraguay,19,30,,49,POINT (6170465 -7542726)
2014,Noviembre,Paraguay,2,1,,3,POINT (7128047 -73181317)
2014,Noviembre,Perú,57,112,,169,POINT (-4191162 -69941498)
2014,Noviembre,Perú,7,6,,13,POINT (-4214082 -69941431)
2014,Noviembre,Perú,2,6,,8,POINT (0.81488 -77356)
2014,Noviembre,Perú,5,8,,13,POINT (10446304 -75516486)
2014,Noviembre,Perú,3,16,,19,POINT (10886686 -74776479)
2014,Noviembre,Perú,0,4,,4,POINT (11247723 -74213989)
2014,Noviembre,Perú,103,76,,179,POINT (125862 -81702165)
2014,Noviembre,Perú,234,378,,612,POINT (3451668 -76532004)
2014,Noviembre,Perú,1,78,,79,POINT (3884426 -77061029)
2014,Noviembre,Perú,4906,7378,,12284,POINT (4697157 -74140516)
2014,Noviembre,Perú,0,3,,3,POINT (4815189 -75736374)
2014,Noviembre,Perú,288,542,,830,POINT (6170465 -7542726)
2014,Noviembre,Perú,3,3,,6,POINT (7128047 -73181317)
2014,Noviembre,Perú,5,5,,10,POINT (7927233 -72508188)
2014,Noviembre,Polonia,28,26,,54,POINT (4697157 -74140516)
2014,Noviembre,Portugal,0,2,,2,POINT (10406342 -75527794)
2014,Noviembre,Portugal,0,2,,2,POINT (3451668 -76532004)
2014,Noviembre,Portugal,327,617,,944,POINT (4697157 -74140516)
2014,Noviembre,Portugal,0,1,,1,POINT (6170465 -7542726)
2014,Noviembre,Puerto Rico/Territorio de Estados Unidos,0,1,,1,POINT (10406342 -75527794)
2014,Noviembre,Puerto Rico/Territorio de Estados Unidos,6,5,,11,POINT (10446304 -75516486)
2014,Noviembre,Puerto Rico/Territorio de Estados Unidos,1,37,,38,POINT (10886686 -74776479)
2014,Noviembre,Puerto Rico/Territorio de Estados Unidos,0,1,,1,POINT (125862 -81702165)
2014,Noviembre,Puerto Rico/Territorio de Estados Unidos,28,34,,62,POINT (3451668 -76532004)
2014,Noviembre,Puerto Rico/Territorio de Estados Unidos,166,309,,475,POINT (4697157 -74140516)
2014,Noviembre,Puerto Rico/Territorio de Estados Unidos,16,17,,33,POINT (4815189 -75736374)
2014,Noviembre,Puerto Rico/Territorio de Estados Unidos,16,56,,72,POINT (6170465 -7542726)
2014,Noviembre,Puerto Rico/Territorio de Estados Unidos,0,3,,3,POINT (7128047 -73181317)
2014,Noviembre,Puerto Rico/Territorio de Estados Unidos,0,2,,2,POINT (9402597 -75681642)
2014,Noviembre,Reino Unido de Gran Bretaña e Irlanda del Norte,0,1,,1,POINT (10406342 -75527794)
2014,Noviembre,Reino Unido de Gran Bretaña e Irlanda del Norte,0,2,,2,POINT (10446304 -75516486)
2014,Noviembre,Reino Unido de Gran Bretaña e Irlanda del Norte,0,1,,1,POINT (10886686 -74776479)
2014,Noviembre,Reino Unido de Gran Bretaña e Irlanda del Norte,0,1,,1,POINT (11247723 -74213989)
2014,Noviembre,Reino Unido de Gran Bretaña e Irlanda del Norte,37,56,,93,POINT (3451668 -76532004)
2014,Noviembre,Reino Unido de Gran Bretaña e Irlanda del Norte,411,759,,1170,POINT (4697157 -74140516)
2014,Noviembre,Reino Unido de Gran Bretaña e Irlanda del Norte,1,1,,2,POINT (4815189 -75736374)
2014,Noviembre,Reino Unido de Gran Bretaña e Irlanda del Norte,13,11,,24,POINT (6170465 -7542726)
2014,Noviembre,República CentroÁfricana,1,0,,1,POINT (4697157 -74140516)
2014,Noviembre,Federación de Rusia,1,0,,1,POINT (3451668 -76532004)
2014,Noviembre,Federación de Rusia,0,4,,4,POINT (3884426 -77061029)
2014,Noviembre,Federación de Rusia,24,36,,60,POINT (4697157 -74140516)
2014,Noviembre,Federación de Rusia,1,1,,2,POINT (6170465 -7542726)
2014,Noviembre,República Dominicana,0,3,,3,POINT (10406342 -75527794)
2014,Noviembre,República Dominicana,10,16,,26,POINT (10446304 -75516486)
2014,Noviembre,República Dominicana,6,27,,33,POINT (10886686 -74776479)
2014,Noviembre,República Dominicana,0,2,,2,POINT (10970933 -74765343)
2014,Noviembre,República Dominicana,0,3,,3,POINT (125862 -81702165)
2014,Noviembre,República Dominicana,10,14,,24,POINT (3451668 -76532004)
2014,Noviembre,República Dominicana,440,696,,1136,POINT (4697157 -74140516)
2014,Noviembre,República Dominicana,4,3,,7,POINT (4815189 -75736374)
2014,Noviembre,República Dominicana,40,56,,96,POINT (6170465 -7542726)
2014,Noviembre,República Dominicana,0,4,,4,POINT (7128047 -73181317)
2014,Noviembre,República Dominicana,0,2,,2,POINT (7927233 -72508188)
2014,Noviembre,Reunión,0,1,,1,POINT (4697157 -74140516)
2014,Noviembre,Rumania,0,1,,1,POINT (10446304 -75516486)
2014,Noviembre,Rumania,4,11,,15,POINT (4697157 -74140516)
2014,Noviembre,Rumania,0,1,,1,POINT (6170465 -7542726)
2014,Noviembre,San Cristóbal y Nevis,0,1,,1,POINT (4697157 -74140516)
2014,Noviembre,Santa Lucia,2,4,,6,POINT (4697157 -74140516)
2014,Noviembre,Serbia,1,1,,2,POINT (4697157 -74140516)
2014,Noviembre,Singapur,1,4,,5,POINT (4697157 -74140516)
2014,Noviembre,Sri Lanka,0,1,,1,POINT (3451668 -76532004)
2014,Noviembre,Sudáfrica,4,17,,21,POINT (4697157 -74140516)
2014,Noviembre,Sudáfrica,0,1,,1,POINT (6170465 -7542726)
2014,Noviembre,Suecia,1,0,,1,POINT (10446304 -75516486)
2014,Noviembre,Suecia,0,5,,5,POINT (3451668 -76532004)
2014,Noviembre,Suecia,18,27,,45,POINT (4697157 -74140516)
2014,Noviembre,Suecia,2,2,,4,POINT (6170465 -7542726)
2014,Noviembre,Suiza,1,0,,1,POINT (10446304 -75516486)
2014,Noviembre,Suiza,1,0,,1,POINT (10886686 -74776479)
2014,Noviembre,Suiza,2,5,,7,POINT (3451668 -76532004)
2014,Noviembre,Suiza,40,99,,139,POINT (4697157 -74140516)
2014,Noviembre,Suiza,4,8,,12,POINT (6170465 -7542726)
2014,Noviembre,Surinam,0,1,,1,POINT (10406342 -75527794)
2014,Noviembre,Surinam,0,1,,1,POINT (3451668 -76532004)
2014,Noviembre,Surinam,2,3,,5,POINT (4697157 -74140516)
2014,Noviembre,Surinam,0,2,,2,POINT (6170465 -7542726)
2014,Noviembre,Taiwán,0,5,,5,POINT (4697157 -74140516)
2014,Noviembre,Taiwán,1,0,,1,POINT (6170465 -7542726)
2014,Noviembre,Tailandia,0,1,,1,POINT (4697157 -74140516)
2014,Noviembre,Trinidad y Tobago,0,4,,4,POINT (3451668 -76532004)
2014,Noviembre,Trinidad y Tobago,5,9,,14,POINT (4697157 -74140516)
2014,Noviembre,Trinidad y Tobago,0,1,,1,POINT (4815189 -75736374)
2014,Noviembre,Trinidad y Tobago,0,4,,4,POINT (6170465 -7542726)
2014,Noviembre,Trinidad y Tobago,4,6,,10,POINT (7128047 -73181317)
2014,Noviembre,Trinidad y Tobago,1,2,,3,POINT (7927233 -72508188)
2014,Noviembre,Turquía,10,15,,25,POINT (4697157 -74140516)
2014,Noviembre,Turquía,1,5,,6,POINT (6170465 -7542726)
2014,Noviembre,Turquía,0,7,,7,POINT (7927233 -72508188)
2014,Noviembre,Ucrania,0,2,,2,POINT (4697157 -74140516)
2014,Noviembre,Uruguay,0,1,,1,POINT (0.81488 -77356)
2014,Noviembre,Uruguay,0,1,,1,POINT (10406342 -75527794)
2014,Noviembre,Uruguay,15,14,,29,POINT (10446304 -75516486)
2014,Noviembre,Uruguay,2,1,,3,POINT (10886686 -74776479)
2014,Noviembre,Uruguay,12,6,,18,POINT (125862 -81702165)
2014,Noviembre,Uruguay,14,18,,32,POINT (3451668 -76532004)
2014,Noviembre,Uruguay,36,73,,109,POINT (4697157 -74140516)
2014,Noviembre,Uruguay,0,1,,1,POINT (4815189 -75736374)
2014,Noviembre,Uruguay,28,48,,76,POINT (6170465 -7542726)
2014,Noviembre,Venezuela,0,12,,12,POINT (10406342 -75527794)
2014,Noviembre,Venezuela,19,78,,97,POINT (10446304 -75516486)
2014,Noviembre,Venezuela,10,55,,65,POINT (10886686 -74776479)
2014,Noviembre,Venezuela,0,1,,1,POINT (10970933 -74765343)
2014,Noviembre,Venezuela,1185,1999,,3184,POINT (11360029 -72129595)
2014,Noviembre,Venezuela,0,2,,2,POINT (125862 -81702165)
2014,Noviembre,Venezuela,12,33,,45,POINT (3451668 -76532004)
2014,Noviembre,Venezuela,3854,4413,,8267,POINT (4697157 -74140516)
2014,Noviembre,Venezuela,1,3,,4,POINT (4815189 -75736374)
2014,Noviembre,Venezuela,37,115,,152,POINT (6170465 -7542726)
2014,Noviembre,Venezuela,383,611,,994,POINT (6185536 -67484028)
2014,Noviembre,Venezuela,83,143,,226,POINT (7088729 -70740253)
2014,Noviembre,Venezuela,2893,3899,,6792,POINT (7819 -72453013)
2014,Noviembre,Venezuela,241,327,,568,POINT (7927233 -72508188)
2014,Noviembre,Vietnam,0,1,,1,POINT (10886686 -74776479)
2014,Noviembre,Vietnam,0,1,,1,POINT (4697157 -74140516)
2014,Noviembre,Islas Vírgenes Británicas/Territorio Británico de Ultramar,2,1,,3,POINT (4697157 -74140516)
2014,Noviembre,Islas Vírgenes Estadounidenses/Territorio de Estados Unidos,0,1,,1,POINT (4697157 -74140516)
2014,Noviembre,Desconocido,0,2,,2,POINT (3451668 -76532004)
2014,Noviembre,Desconocido,1,33,,34,POINT (4697157 -74140516)
2014,Diciembre,Afganistán,0,1,,1,POINT (4697157 -74140516)
2014,Diciembre,Albania,0,1,,1,POINT (4697157 -74140516)
2014,Diciembre,Alemania,0,3,,3,POINT (10446304 -75516486)
2014,Diciembre,Alemania,2,4,,6,POINT (10886686 -74776479)
2014,Diciembre,Alemania,18,23,,41,POINT (3451668 -76532004)
2014,Diciembre,Alemania,1410,2340,,3750,POINT (4697157 -74140516)
2014,Diciembre,Alemania,22,20,,42,POINT (6170465 -7542726)
2014,Diciembre,Alemania,2,1,,3,POINT (7128047 -73181317)
2014,Diciembre,Alemania,0,1,,1,POINT (7927233 -72508188)
2014,Diciembre,Angola,0,1,,1,POINT (10406342 -75527794)
2014,Diciembre,Angola,1,0,,1,POINT (4697157 -74140516)
2014,Diciembre,Antigua y Barbuda,0,1,,1,POINT (10446304 -75516486)
2014,Diciembre,Antigua y Barbuda,0,1,,1,POINT (6170465 -7542726)
2014,Diciembre,Antigua y Barbuda,0,1,,1,POINT (7927233 -72508188)
2014,Diciembre,Países Bajos,10,5,,15,POINT (10406342 -75527794)
2014,Diciembre,Países Bajos,1,1,,2,POINT (10446304 -75516486)
2014,Diciembre,Países Bajos,4,5,,9,POINT (10886686 -74776479)
2014,Diciembre,Países Bajos,5,18,,23,POINT (3451668 -76532004)
2014,Diciembre,Países Bajos,89,146,,235,POINT (4697157 -74140516)
2014,Diciembre,Países Bajos,1,4,,5,POINT (4815189 -75736374)
2014,Diciembre,Países Bajos,44,81,,125,POINT (6170465 -7542726)
2014,Diciembre,Países Bajos,0,4,,4,POINT (7128047 -73181317)
2014,Diciembre,Arabia Saudita,3,3,,6,POINT (4697157 -74140516)
2014,Diciembre,Argelia,1,0,,1,POINT (3451668 -76532004)
2014,Diciembre,Argelia,2,0,,2,POINT (4697157 -74140516)
2014,Diciembre,Argentina,4,3,,7,POINT (0.81488 -77356)
2014,Diciembre,Argentina,47,37,,84,POINT (10446304 -75516486)
2014,Diciembre,Argentina,15,14,,29,POINT (10886686 -74776479)
2014,Diciembre,Argentina,60,52,,112,POINT (125862 -81702165)
2014,Diciembre,Argentina,52,81,,133,POINT (3451668 -76532004)
2014,Diciembre,Argentina,1944,2692,,4636,POINT (4697157 -74140516)
2014,Diciembre,Argentina,136,508,,644,POINT (6170465 -7542726)
2014,Diciembre,Argentina,0,1,,1,POINT (7128047 -73181317)
2014,Diciembre,Argentina,1,3,,4,POINT (7927233 -72508188)
2014,Diciembre,Aruba,27,56,,83,POINT (10406342 -75527794)
2014,Diciembre,Aruba,11,6,,17,POINT (10446304 -75516486)
2014,Diciembre,Aruba,7,10,,17,POINT (10886686 -74776479)
2014,Diciembre,Aruba,0,1,,1,POINT (10970933 -74765343)
2014,Diciembre,Aruba,7,21,,28,POINT (11247723 -74213989)
2014,Diciembre,Aruba,5,2,,7,POINT (3451668 -76532004)
2014,Diciembre,Aruba,402,616,,1018,POINT (4697157 -74140516)
2014,Diciembre,Aruba,0,1,,1,POINT (4815189 -75736374)
2014,Diciembre,Aruba,7,19,,26,POINT (6170465 -7542726)
2014,Diciembre,Aruba,6,1,,7,POINT (7128047 -73181317)
2014,Diciembre,Aruba,3,2,,5,POINT (7927233 -72508188)
2014,Diciembre,Australia,0,2,,2,POINT (10446304 -75516486)
2014,Diciembre,Australia,0,5,,5,POINT (10886686 -74776479)
2014,Diciembre,Australia,11,18,,29,POINT (3451668 -76532004)
2014,Diciembre,Australia,57,76,,133,POINT (4697157 -74140516)
2014,Diciembre,Australia,0,1,,1,POINT (4815189 -75736374)
2014,Diciembre,Australia,11,25,,36,POINT (6170465 -7542726)
2014,Diciembre,Australia,0,3,,3,POINT (7128047 -73181317)
2014,Diciembre,Austria,0,1,,1,POINT (10446304 -75516486)
2014,Diciembre,Austria,2,0,,2,POINT (3451668 -76532004)
2014,Diciembre,Austria,19,33,,52,POINT (4697157 -74140516)
2014,Diciembre,Austria,0,1,,1,POINT (6170465 -7542726)
2014,Diciembre,Azerbaiyán,0,1,,1,POINT (4697157 -74140516)
2014,Diciembre,Bahamas,0,9,,9,POINT (10406342 -75527794)
2014,Diciembre,Bahamas,0,1,,1,POINT (10446304 -75516486)
2014,Diciembre,Bahréin,1,1,,2,POINT (10446304 -75516486)
2014,Diciembre,Bahréin,0,1,,1,POINT (11360029 -72129595)
2014,Diciembre,Bahréin,0,2,,2,POINT (6170465 -7542726)
2014,Diciembre,Barbados,0,1,,1,POINT (4697157 -74140516)
2014,Diciembre,Barbados,0,1,,1,POINT (4815189 -75736374)
2014,Diciembre,República de Belarús,1,1,,2,POINT (11360029 -72129595)
2014,Diciembre,República de Belarús,0,1,,1,POINT (4697157 -74140516)
2014,Diciembre,Bélgica,0,1,,1,POINT (10886686 -74776479)
2014,Diciembre,Bélgica,0,2,,2,POINT (11247723 -74213989)
2014,Diciembre,Bélgica,5,6,,11,POINT (3451668 -76532004)
2014,Diciembre,Bélgica,28,51,,79,POINT (4697157 -74140516)
2014,Diciembre,Bélgica,1,6,,7,POINT (6170465 -7542726)
2014,Diciembre,Bélgica,0,1,,1,POINT (7128047 -73181317)
2014,Diciembre,Belice,0,1,,1,POINT (3451668 -76532004)
2014,Diciembre,Belice,1,1,,2,POINT (4697157 -74140516)
2014,Diciembre,Belice,0,1,,1,POINT (6170465 -7542726)
2014,Diciembre,Benín,1,0,,1,POINT (125862 -81702165)
2014,Diciembre,Benín,1,0,,1,POINT (4697157 -74140516)
2014,Diciembre,Bermudas/Territorio Británico de Ultramar,0,1,,1,POINT (6170465 -7542726)
2014,Diciembre,Bolivia,2,2,,4,POINT (0.81488 -77356)
2014,Diciembre,Bolivia,13,6,,19,POINT (10446304 -75516486)
2014,Diciembre,Bolivia,4,3,,7,POINT (10886686 -74776479)
2014,Diciembre,Bolivia,3,1,,4,POINT (125862 -81702165)
2014,Diciembre,Bolivia,9,13,,22,POINT (3451668 -76532004)
2014,Diciembre,Bolivia,479,548,,1027,POINT (4697157 -74140516)
2014,Diciembre,Bolivia,13,27,,40,POINT (6170465 -7542726)
2014,Diciembre,Bolivia,0,1,,1,POINT (7128047 -73181317)
2014,Diciembre,Bolivia,0,1,,1,POINT (7927233 -72508188)
2014,Diciembre,Bosnia y Herzegovina,0,1,,1,POINT (4697157 -74140516)
2014,Diciembre,Brasil,144,137,,281,POINT (-4191162 -69941498)
2014,Diciembre,Brasil,6,9,,15,POINT (-4214082 -69941431)
2014,Diciembre,Brasil,0,2,,2,POINT (0.81488 -77356)
2014,Diciembre,Brasil,0,5,,5,POINT (10406342 -75527794)
2014,Diciembre,Brasil,49,32,,81,POINT (10446304 -75516486)
2014,Diciembre,Brasil,18,30,,48,POINT (10886686 -74776479)
2014,Diciembre,Brasil,187,138,,325,POINT (125862 -81702165)
2014,Diciembre,Brasil,46,62,,108,POINT (3451668 -76532004)
2014,Diciembre,Brasil,3585,4642,,8227,POINT (4697157 -74140516)
2014,Diciembre,Brasil,2,7,,9,POINT (4815189 -75736374)
2014,Diciembre,Brasil,93,141,,234,POINT (6170465 -7542726)
2014,Diciembre,Brasil,5,4,,9,POINT (7128047 -73181317)
2014,Diciembre,Brasil,3,20,,23,POINT (7927233 -72508188)
2014,Diciembre,Bulgaria,1,5,,6,POINT (4697157 -74140516)
2014,Diciembre,Islas Caimán/Territorio Británico de Ultramar,6,7,,13,POINT (10406342 -75527794)
2014,Diciembre,Islas Caimán/Territorio Británico de Ultramar,0,1,,1,POINT (10886686 -74776479)
2014,Diciembre,Islas Caimán/Territorio Británico de Ultramar,1,1,,2,POINT (125744111 -81703935)
2014,Diciembre,Islas Caimán/Territorio Británico de Ultramar,2,6,,8,POINT (125862 -81702165)
2014,Diciembre,Islas Caimán/Territorio Británico de Ultramar,0,1,,1,POINT (3451668 -76532004)
2014,Diciembre,Islas Caimán/Territorio Británico de Ultramar,0,5,,5,POINT (4697157 -74140516)
2014,Diciembre,Canadá,0,3,,3,POINT (10406342 -75527794)
2014,Diciembre,Canadá,198,213,,411,POINT (10446304 -75516486)
2014,Diciembre,Canadá,14,34,,48,POINT (10886686 -74776479)
2014,Diciembre,Canadá,170,167,,337,POINT (125862 -81702165)
2014,Diciembre,Canadá,101,99,,200,POINT (3451668 -76532004)
2014,Diciembre,Canadá,3,4,,7,POINT (445285 -75766353)
2014,Diciembre,Canadá,787,1103,,1890,POINT (4697157 -74140516)
2014,Diciembre,Canadá,20,29,,49,POINT (4815189 -75736374)
2014,Diciembre,Canadá,168,273,,441,POINT (6170465 -7542726)
2014,Diciembre,Canadá,15,25,,40,POINT (7128047 -73181317)
2014,Diciembre,Canadá,8,15,,23,POINT (7927233 -72508188)
2014,Diciembre,España,2,1,,3,POINT (10446304 -75516486)
2014,Diciembre,España,0,2,,2,POINT (10886686 -74776479)
2014,Diciembre,España,2,3,,5,POINT (125862 -81702165)
2014,Diciembre,España,230,360,,590,POINT (3451668 -76532004)
2014,Diciembre,España,2840,5170,,8010,POINT (4697157 -74140516)
2014,Diciembre,España,1,3,,4,POINT (4815189 -75736374)
2014,Diciembre,España,156,354,,510,POINT (6170465 -7542726)
2014,Diciembre,España,0,1,,1,POINT (7128047 -73181317)
2014,Diciembre,España,2,1,,3,POINT (7927233 -72508188)
2014,Diciembre,España,1,0,,1,POINT (6170465 -7542726)
2014,Diciembre,República de Corea,15,25,,40,POINT (4697157 -74140516)
2014,Diciembre,República de Corea,0,1,,1,POINT (4815189 -75736374)
2014,Diciembre,República de Corea,0,1,,1,POINT (6170465 -7542726)
2014,Diciembre,República de Corea,0,1,,1,POINT (7927233 -72508188)
2014,Diciembre,Costa de Marfil,0,1,,1,POINT (3451668 -76532004)
2014,Diciembre,Costa de Marfil,1,6,,7,POINT (4697157 -74140516)
2014,Diciembre,Costa Rica,1,3,,4,POINT (10406342 -75527794)
2014,Diciembre,Costa Rica,6,6,,12,POINT (10446304 -75516486)
2014,Diciembre,Costa Rica,21,17,,38,POINT (10886686 -74776479)
2014,Diciembre,Costa Rica,0,3,,3,POINT (11117206 -74232675)
2014,Diciembre,Costa Rica,462,340,,802,POINT (125862 -81702165)
2014,Diciembre,Costa Rica,40,32,,72,POINT (3451668 -76532004)
2014,Diciembre,Costa Rica,815,1125,,1940,POINT (4697157 -74140516)
2014,Diciembre,Costa Rica,4,26,,30,POINT (4815189 -75736374)
2014,Diciembre,Costa Rica,106,117,,223,POINT (6170465 -7542726)
2014,Diciembre,Costa Rica,5,10,,15,POINT (7128047 -73181317)
2014,Diciembre,Costa Rica,11,2,,13,POINT (7927233 -72508188)
2014,Diciembre,Croacia,0,1,,1,POINT (10406342 -75527794)
2014,Diciembre,Croacia,0,1,,1,POINT (3451668 -76532004)
2014,Diciembre,Croacia,1,1,,2,POINT (4697157 -74140516)
2014,Diciembre,Cuba,3,4,,7,POINT (10446304 -75516486)
2014,Diciembre,Cuba,5,10,,15,POINT (10886686 -74776479)
2014,Diciembre,Cuba,7,6,,13,POINT (3451668 -76532004)
2014,Diciembre,Cuba,290,456,,746,POINT (4697157 -74140516)
2014,Diciembre,Cuba,0,1,,1,POINT (4815189 -75736374)
2014,Diciembre,Cuba,16,11,,27,POINT (6170465 -7542726)
2014,Diciembre,Cuba,2,0,,2,POINT (7128047 -73181317)
2014,Diciembre,Cuba,1,2,,3,POINT (7927233 -72508188)
2014,Diciembre,Curazao,0,3,,3,POINT (10406342 -75527794)
2014,Diciembre,Curazao,59,107,,166,POINT (10886686 -74776479)
2014,Diciembre,Curazao,13,15,,28,POINT (11247723 -74213989)
2014,Diciembre,Curazao,1,4,,5,POINT (3451668 -76532004)
2014,Diciembre,Curazao,330,532,,862,POINT (4697157 -74140516)
2014,Diciembre,Curazao,193,306,,499,POINT (6170465 -7542726)
2014,Diciembre,Curazao,1,1,,2,POINT (7128047 -73181317)
2014,Diciembre,República Checa,1,1,,2,POINT (125862 -81702165)
2014,Diciembre,República Checa,0,4,,4,POINT (4697157 -74140516)
2014,Diciembre,Chile,6,7,,13,POINT (0.81488 -77356)
2014,Diciembre,Chile,5,2,,7,POINT (10446304 -75516486)
2014,Diciembre,Chile,5,10,,15,POINT (10886686 -74776479)
2014,Diciembre,Chile,22,30,,52,POINT (125862 -81702165)
2014,Diciembre,Chile,38,71,,109,POINT (3451668 -76532004)
2014,Diciembre,Chile,0,2,,2,POINT (3884426 -77061029)
2014,Diciembre,Chile,3373,4454,,7827,POINT (4697157 -74140516)
2014,Diciembre,Chile,1,3,,4,POINT (4815189 -75736374)
2014,Diciembre,Chile,32,76,,108,POINT (6170465 -7542726)
2014,Diciembre,Chile,0,2,,2,POINT (7128047 -73181317)
2014,Diciembre,Chile,1,2,,3,POINT (7927233 -72508188)
2014,Diciembre,China,0,2,,2,POINT (10886686 -74776479)
2014,Diciembre,China,0,4,,4,POINT (10970933 -74765343)
2014,Diciembre,China,1,3,,4,POINT (3451668 -76532004)
2014,Diciembre,China,0,1,,1,POINT (3884426 -77061029)
2014,Diciembre,China,33,88,,121,POINT (4697157 -74140516)
2014,Diciembre,Dinamarca,0,2,,2,POINT (3451668 -76532004)
2014,Diciembre,Dinamarca,12,24,,36,POINT (4697157 -74140516)
2014,Diciembre,Dinamarca,0,1,,1,POINT (6170465 -7542726)
2014,Diciembre,Dinamarca,2,1,,3,POINT (7128047 -73181317)
2014,Diciembre,Dominica,0,1,,1,POINT (4697157 -74140516)
2014,Diciembre,Ecuador,74,164,,238,POINT (0.33002 -76876446)
2014,Diciembre,Ecuador,1,1,,2,POINT (0.812436 -77847006)
2014,Diciembre,Ecuador,3208,5077,,8285,POINT (0.81488 -77356)
2014,Diciembre,Ecuador,13,47,,60,POINT (1800143 -78802679)
2014,Diciembre,Ecuador,0,1,,1,POINT (10406342 -75527794)
2014,Diciembre,Ecuador,0,5,,5,POINT (10446304 -75516486)
2014,Diciembre,Ecuador,0,2,,2,POINT (125862 -81702165)
2014,Diciembre,Ecuador,522,719,,1241,POINT (3451668 -76532004)
2014,Diciembre,Ecuador,3245,4586,,7831,POINT (4697157 -74140516)
2014,Diciembre,Ecuador,1,2,,3,POINT (4815189 -75736374)
2014,Diciembre,Ecuador,403,486,,889,POINT (6170465 -7542726)
2014,Diciembre,Ecuador,5,1,,6,POINT (7128047 -73181317)
2014,Diciembre,Ecuador,9,17,,26,POINT (7927233 -72508188)
2014,Diciembre,Egipto,0,1,,1,POINT (11247723 -74213989)
2014,Diciembre,Egipto,0,4,,4,POINT (4697157 -74140516)
2014,Diciembre,El Salvador,1,2,,3,POINT (10886686 -74776479)
2014,Diciembre,El Salvador,1,2,,3,POINT (125862 -81702165)
2014,Diciembre,El Salvador,121,193,,314,POINT (3451668 -76532004)
2014,Diciembre,El Salvador,768,1100,,1868,POINT (4697157 -74140516)
2014,Diciembre,El Salvador,1,1,,2,POINT (4815189 -75736374)
2014,Diciembre,El Salvador,110,197,,307,POINT (6170465 -7542726)
2014,Diciembre,El Salvador,1,1,,2,POINT (7128047 -73181317)
2014,Diciembre,El Salvador,1,1,,2,POINT (7927233 -72508188)
2014,Diciembre,Emiratos Árabes,3,0,,3,POINT (125862 -81702165)
2014,Diciembre,Emiratos Árabes,0,7,,7,POINT (4697157 -74140516)
2014,Diciembre,Emiratos Árabes,0,2,,2,POINT (6170465 -7542726)
2014,Diciembre,Eslovaquia,1,4,,5,POINT (4697157 -74140516)
2014,Diciembre,Eslovaquia,2,0,,2,POINT (7128047 -73181317)
2014,Diciembre,Eslovenia,2,2,,4,POINT (4697157 -74140516)
2014,Diciembre,Eslovenia,1,0,,1,POINT (6170465 -7542726)
2014,Diciembre,Estados Unidos de América,0,1,,1,POINT (1800143 -78802679)
2014,Diciembre,Estados Unidos de América,0,23,,23,POINT (10406342 -75527794)
2014,Diciembre,Estados Unidos de América,2759,4050,,6809,POINT (10446304 -75516486)
2014,Diciembre,Estados Unidos de América,383,690,,1073,POINT (10886686 -74776479)
2014,Diciembre,Estados Unidos de América,0,8,,8,POINT (10970933 -74765343)
2014,Diciembre,Estados Unidos de América,2,29,,31,POINT (11247723 -74213989)
2014,Diciembre,Estados Unidos de América,22,37,,59,POINT (125862 -81702165)
2014,Diciembre,Estados Unidos de América,1635,2391,,4026,POINT (3451668 -76532004)
2014,Diciembre,Estados Unidos de América,0,5,,5,POINT (3884426 -77061029)
2014,Diciembre,Estados Unidos de América,114,184,,298,POINT (445285 -75766353)
2014,Diciembre,Estados Unidos de América,11542,18813,,30355,POINT (4697157 -74140516)
2014,Diciembre,Estados Unidos de América,228,341,,569,POINT (4815189 -75736374)
2014,Diciembre,Estados Unidos de América,2886,5145,,8031,POINT (6170465 -7542726)
2014,Diciembre,Estados Unidos de América,52,100,,152,POINT (7128047 -73181317)
2014,Diciembre,Estados Unidos de América,95,107,,202,POINT (7927233 -72508188)
2014,Diciembre,Estonia,3,2,,5,POINT (4697157 -74140516)
2014,Diciembre,Islas Fiji,1,1,,2,POINT (4697157 -74140516)
2014,Diciembre,Filipinas,0,1,,1,POINT (10446304 -75516486)
2014,Diciembre,Filipinas,0,7,,7,POINT (10886686 -74776479)
2014,Diciembre,Filipinas,1,0,,1,POINT (3451668 -76532004)
2014,Diciembre,Filipinas,2,10,,12,POINT (4697157 -74140516)
2014,Diciembre,Filipinas,0,2,,2,POINT (9402597 -75681642)
2014,Diciembre,Finlandia,1,2,,3,POINT (3451668 -76532004)
2014,Diciembre,Finlandia,14,9,,23,POINT (4697157 -74140516)
2014,Diciembre,Finlandia,0,1,,1,POINT (6170465 -7542726)
2014,Diciembre,Francia,2,3,,5,POINT (10886686 -74776479)
2014,Diciembre,Francia,1,0,,1,POINT (125862 -81702165)
2014,Diciembre,Francia,17,23,,40,POINT (3451668 -76532004)
2014,Diciembre,Francia,1402,2369,,3771,POINT (4697157 -74140516)
2014,Diciembre,Francia,0,2,,2,POINT (4815189 -75736374)
2014,Diciembre,Francia,11,34,,45,POINT (6170465 -7542726)
2014,Diciembre,Francia,0,1,,1,POINT (7128047 -73181317)
2014,Diciembre,Francia,4,3,,7,POINT (7927233 -72508188)
2014,Diciembre,Georgia,1,0,,1,POINT (4697157 -74140516)
2014,Diciembre,Georgia,0,1,,1,POINT (9402597 -75681642)
2014,Diciembre,Ghana,0,2,,2,POINT (4697157 -74140516)
2014,Diciembre,Grecia,0,1,,1,POINT (10446304 -75516486)
2014,Diciembre,Grecia,5,8,,13,POINT (4697157 -74140516)
2014,Diciembre,Guatemala,2,1,,3,POINT (10446304 -75516486)
2014,Diciembre,Guatemala,3,3,,6,POINT (10886686 -74776479)
2014,Diciembre,Guatemala,0,1,,1,POINT (10970933 -74765343)
2014,Diciembre,Guatemala,2,3,,5,POINT (125862 -81702165)
2014,Diciembre,Guatemala,15,39,,54,POINT (3451668 -76532004)
2014,Diciembre,Guatemala,0,2,,2,POINT (3884426 -77061029)
2014,Diciembre,Guatemala,283,406,,689,POINT (4697157 -74140516)
2014,Diciembre,Guatemala,0,1,,1,POINT (4815189 -75736374)
2014,Diciembre,Guatemala,28,57,,85,POINT (6170465 -7542726)
2014,Diciembre,Guatemala,3,3,,6,POINT (7128047 -73181317)
2014,Diciembre,Guatemala,8,10,,18,POINT (7927233 -72508188)
2014,Diciembre,Guyana,0,1,,1,POINT (10886686 -74776479)
2014,Diciembre,Guyana,1,0,,1,POINT (3451668 -76532004)
2014,Diciembre,Guyana,0,1,,1,POINT (4697157 -74140516)
2014,Diciembre,Guyana,1,1,,2,POINT (6170465 -7542726)
2014,Diciembre,Guinea Ecuatorial,0,1,,1,POINT (4697157 -74140516)
2014,Diciembre,Guadalupe/Territorio Francés,1,2,,3,POINT (4697157 -74140516)
2014,Diciembre,Guayana Francesa/Departamento de Ultramar Francés,0,1,,1,POINT (3451668 -76532004)
2014,Diciembre,Guayana Francesa/Departamento de Ultramar Francés,0,1,,1,POINT (4697157 -74140516)
2014,Diciembre,Haití,0,12,,12,POINT (10446304 -75516486)
2014,Diciembre,Haití,1,1,,2,POINT (10886686 -74776479)
2014,Diciembre,Haití,2,3,,5,POINT (4697157 -74140516)
2014,Diciembre,Haití,1,0,,1,POINT (4815189 -75736374)
2014,Diciembre,Haití,2,0,,2,POINT (6170465 -7542726)
2014,Diciembre,Honduras,1,2,,3,POINT (10446304 -75516486)
2014,Diciembre,Honduras,3,4,,7,POINT (10886686 -74776479)
2014,Diciembre,Honduras,7,9,,16,POINT (133387613 -81372937)
2014,Diciembre,Honduras,17,14,,31,POINT (3451668 -76532004)
2014,Diciembre,Honduras,32,42,,74,POINT (4697157 -74140516)
2014,Diciembre,Honduras,1,0,,1,POINT (4815189 -75736374)
2014,Diciembre,Honduras,25,21,,46,POINT (6170465 -7542726)
2014,Diciembre,Honduras,1,0,,1,POINT (7128047 -73181317)
2014,Diciembre,Honduras,4,4,,8,POINT (7927233 -72508188)
2014,Diciembre,Hong Kong,0,2,,2,POINT (4697157 -74140516)
2014,Diciembre,Hong Kong,0,1,,1,POINT (7927233 -72508188)
2014,Diciembre,Hungría,2,1,,3,POINT (10886686 -74776479)
2014,Diciembre,Hungría,2,5,,7,POINT (4697157 -74140516)
2014,Diciembre,Hungría,1,1,,2,POINT (6170465 -7542726)
2014,Diciembre,India,0,1,,1,POINT (10446304 -75516486)
2014,Diciembre,India,0,1,,1,POINT (10886686 -74776479)
2014,Diciembre,India,3,13,,16,POINT (4697157 -74140516)
2014,Diciembre,India,0,1,,1,POINT (6170465 -7542726)
2014,Diciembre,Indonesia,0,1,,1,POINT (1800143 -78802679)
2014,Diciembre,Indonesia,0,1,,1,POINT (3451668 -76532004)
2014,Diciembre,Indonesia,0,5,,5,POINT (4697157 -74140516)
2014,Diciembre,Iraq,0,2,,2,POINT (4697157 -74140516)
2014,Diciembre,Irán,1,2,,3,POINT (4697157 -74140516)
2014,Diciembre,República de Irlanda,1,1,,2,POINT (3451668 -76532004)
2014,Diciembre,República de Irlanda,7,17,,24,POINT (4697157 -74140516)
2014,Diciembre,República de Irlanda,1,1,,2,POINT (6170465 -7542726)
2014,Diciembre,Islandia,0,2,,2,POINT (4697157 -74140516)
2014,Diciembre,Israel,0,2,,2,POINT (10886686 -74776479)
2014,Diciembre,Israel,0,4,,4,POINT (11247723 -74213989)
2014,Diciembre,Israel,10,57,,67,POINT (4697157 -74140516)
2014,Diciembre,Israel,1,4,,5,POINT (6170465 -7542726)
2014,Diciembre,Italia,0,1,,1,POINT (10446304 -75516486)
2014,Diciembre,Italia,1,1,,2,POINT (10886686 -74776479)
2014,Diciembre,Italia,79,75,,154,POINT (125862 -81702165)
2014,Diciembre,Italia,14,18,,32,POINT (3451668 -76532004)
2014,Diciembre,Italia,106,294,,400,POINT (4697157 -74140516)
2014,Diciembre,Italia,1,2,,3,POINT (4815189 -75736374)
2014,Diciembre,Italia,10,25,,35,POINT (6170465 -7542726)
2014,Diciembre,Italia,0,1,,1,POINT (7128047 -73181317)
2014,Diciembre,Italia,4,2,,6,POINT (7927233 -72508188)
2014,Diciembre,Jamaica,0,1,,1,POINT (10406342 -75527794)
2014,Diciembre,Jamaica,0,6,,6,POINT (10446304 -75516486)
2014,Diciembre,Jamaica,2,1,,3,POINT (3451668 -76532004)
2014,Diciembre,Jamaica,1,5,,6,POINT (4697157 -74140516)
2014,Diciembre,Jamaica,2,1,,3,POINT (6170465 -7542726)
2014,Diciembre,Jamaica,1,27,,28,POINT (7927233 -72508188)
2014,Diciembre,Japón,1,0,,1,POINT (10886686 -74776479)
2014,Diciembre,Japón,5,6,,11,POINT (3451668 -76532004)
2014,Diciembre,Japón,13,26,,39,POINT (4697157 -74140516)
2014,Diciembre,Japón,1,4,,5,POINT (6170465 -7542726)
2014,Diciembre,Kazajistán,0,1,,1,POINT (4697157 -74140516)
2014,Diciembre,Kenia,1,0,,1,POINT (4697157 -74140516)
2014,Diciembre,Kirguistán,0,4,,4,POINT (4697157 -74140516)
2014,Diciembre,República Democrática Popular  Lao,0,1,,1,POINT (4697157 -74140516)
2014,Diciembre,Letonia,0,1,,1,POINT (4697157 -74140516)
2014,Diciembre,Lituania,0,2,,2,POINT (4697157 -74140516)
2014,Diciembre,Líbano,2,0,,2,POINT (10886686 -74776479)
2014,Diciembre,Líbano,0,1,,1,POINT (3451668 -76532004)
2014,Diciembre,Líbano,1,9,,10,POINT (4697157 -74140516)
2014,Diciembre,Liechtenstein,1,1,,2,POINT (6170465 -7542726)
2014,Diciembre,Luxemburgo,2,1,,3,POINT (4697157 -74140516)
2014,Diciembre,Luxemburgo,1,1,,2,POINT (6170465 -7542726)
2014,Diciembre,Macao,0,1,,1,POINT (4697157 -74140516)
2014,Diciembre,Malasia,1,7,,8,POINT (4697157 -74140516)
2014,Diciembre,Malasia,0,1,,1,POINT (6170465 -7542726)
2014,Diciembre,Malta,0,1,,1,POINT (4697157 -74140516)
2014,Diciembre,Marruecos,9,8,,17,POINT (10446304 -75516486)
2014,Diciembre,Marruecos,1,3,,4,POINT (4697157 -74140516)
2014,Diciembre,Martinica/Departamento de Ultramar Francés,0,1,,1,POINT (3451668 -76532004)
2014,Diciembre,México,0,3,,3,POINT (10406342 -75527794)
2014,Diciembre,México,18,29,,47,POINT (10446304 -75516486)
2014,Diciembre,México,11,41,,52,POINT (10886686 -74776479)
2014,Diciembre,México,0,2,,2,POINT (10970933 -74765343)
2014,Diciembre,México,6,7,,13,POINT (125862 -81702165)
2014,Diciembre,México,61,120,,181,POINT (3451668 -76532004)
2014,Diciembre,México,0,2,,2,POINT (3884426 -77061029)
2014,Diciembre,México,4041,6333,,10374,POINT (4697157 -74140516)
2014,Diciembre,México,11,15,,26,POINT (4815189 -75736374)
2014,Diciembre,México,109,243,,352,POINT (6170465 -7542726)
2014,Diciembre,México,17,19,,36,POINT (7128047 -73181317)
2014,Diciembre,México,23,25,,48,POINT (7927233 -72508188)
2014,Diciembre,Mozambique,0,1,,1,POINT (4697157 -74140516)
2014,Diciembre,Nepal,1,0,,1,POINT (4697157 -74140516)
2014,Diciembre,Nicaragua,1,9,,10,POINT (10446304 -75516486)
2014,Diciembre,Nicaragua,0,1,,1,POINT (10886686 -74776479)
2014,Diciembre,Nicaragua,1,8,,9,POINT (125744111 -81703935)
2014,Diciembre,Nicaragua,1,4,,5,POINT (125862 -81702165)
2014,Diciembre,Nicaragua,2,2,,4,POINT (133387613 -81372937)
2014,Diciembre,Nicaragua,0,5,,5,POINT (3451668 -76532004)
2014,Diciembre,Nicaragua,0,4,,4,POINT (3884426 -77061029)
2014,Diciembre,Nicaragua,17,18,,35,POINT (4697157 -74140516)
2014,Diciembre,Nicaragua,1,0,,1,POINT (4815189 -75736374)
2014,Diciembre,Nicaragua,2,7,,9,POINT (6170465 -7542726)
2014,Diciembre,Nicaragua,0,1,,1,POINT (7927233 -72508188)
2014,Diciembre,Noruega,1,0,,1,POINT (10446304 -75516486)
2014,Diciembre,Noruega,0,1,,1,POINT (10886686 -74776479)
2014,Diciembre,Noruega,3,3,,6,POINT (3451668 -76532004)
2014,Diciembre,Noruega,21,14,,35,POINT (4697157 -74140516)
2014,Diciembre,Noruega,4,7,,11,POINT (6170465 -7542726)
2014,Diciembre,Nueva Zelanda,0,2,,2,POINT (3451668 -76532004)
2014,Diciembre,Nueva Zelanda,6,6,,12,POINT (4697157 -74140516)
2014,Diciembre,Nueva Zelanda,0,2,,2,POINT (6170465 -7542726)
2014,Diciembre,Omán,0,1,,1,POINT (4697157 -74140516)
2014,Diciembre,Panamá,918,1294,,2212,POINT (10406342 -75527794)
2014,Diciembre,Panamá,2093,2370,,4463,POINT (10446304 -75516486)
2014,Diciembre,Panamá,262,487,,749,POINT (10886686 -74776479)
2014,Diciembre,Panamá,0,2,,2,POINT (10970933 -74765343)
2014,Diciembre,Panamá,2,3,,5,POINT (11247723 -74213989)
2014,Diciembre,Panamá,1,10,,11,POINT (125744111 -81703935)
2014,Diciembre,Panamá,1172,1021,,2193,POINT (125862 -81702165)
2014,Diciembre,Panamá,5,8,,13,POINT (133387613 -81372937)
2014,Diciembre,Panamá,516,1000,,1516,POINT (3451668 -76532004)
2014,Diciembre,Panamá,2,46,,48,POINT (3884426 -77061029)
2014,Diciembre,Panamá,2778,4753,,7531,POINT (4697157 -74140516)
2014,Diciembre,Panamá,74,160,,234,POINT (4815189 -75736374)
2014,Diciembre,Panamá,949,1716,,2665,POINT (6170465 -7542726)
2014,Diciembre,Panamá,0,1,,1,POINT (6222552 -77401154)
2014,Diciembre,Panamá,10,7,,17,POINT (7102626 -77762647)
2014,Diciembre,Panamá,43,76,,119,POINT (7128047 -73181317)
2014,Diciembre,Panamá,267,310,,577,POINT (7927233 -72508188)
2014,Diciembre,Panamá,0,4,,4,POINT (806667 -767333)
2014,Diciembre,Panamá,65,122,,187,POINT (863337 -7735002)
2014,Diciembre,Paraguay,0,1,,1,POINT (0.81488 -77356)
2014,Diciembre,Paraguay,1,1,,2,POINT (10446304 -75516486)
2014,Diciembre,Paraguay,2,1,,3,POINT (10886686 -74776479)
2014,Diciembre,Paraguay,11,6,,17,POINT (125862 -81702165)
2014,Diciembre,Paraguay,6,0,,6,POINT (3451668 -76532004)
2014,Diciembre,Paraguay,25,19,,44,POINT (4697157 -74140516)
2014,Diciembre,Paraguay,1,0,,1,POINT (4815189 -75736374)
2014,Diciembre,Paraguay,7,39,,46,POINT (6170465 -7542726)
2014,Diciembre,Paraguay,0,1,,1,POINT (7128047 -73181317)
2014,Diciembre,Perú,64,83,,147,POINT (-4191162 -69941498)
2014,Diciembre,Perú,10,10,,20,POINT (-4214082 -69941431)
2014,Diciembre,Perú,7,22,,29,POINT (0.81488 -77356)
2014,Diciembre,Perú,6,5,,11,POINT (10446304 -75516486)
2014,Diciembre,Perú,2,6,,8,POINT (10886686 -74776479)
2014,Diciembre,Perú,123,95,,218,POINT (125862 -81702165)
2014,Diciembre,Perú,268,375,,643,POINT (3451668 -76532004)
2014,Diciembre,Perú,4563,6120,,10683,POINT (4697157 -74140516)
2014,Diciembre,Perú,4,5,,9,POINT (4815189 -75736374)
2014,Diciembre,Perú,260,414,,674,POINT (6170465 -7542726)
2014,Diciembre,Perú,1,0,,1,POINT (7128047 -73181317)
2014,Diciembre,Perú,5,7,,12,POINT (7927233 -72508188)
2014,Diciembre,Polonia,0,2,,2,POINT (10886686 -74776479)
2014,Diciembre,Polonia,15,10,,25,POINT (4697157 -74140516)
2014,Diciembre,Portugal,0,3,,3,POINT (10970933 -74765343)
2014,Diciembre,Portugal,1,5,,6,POINT (3451668 -76532004)
2014,Diciembre,Portugal,404,680,,1084,POINT (4697157 -74140516)
2014,Diciembre,Portugal,0,1,,1,POINT (4815189 -75736374)
2014,Diciembre,Portugal,4,1,,5,POINT (6170465 -7542726)
2014,Diciembre,Puerto Rico/Territorio de Estados Unidos,2,1,,3,POINT (10446304 -75516486)
2014,Diciembre,Puerto Rico/Territorio de Estados Unidos,12,30,,42,POINT (10886686 -74776479)
2014,Diciembre,Puerto Rico/Territorio de Estados Unidos,19,82,,101,POINT (3451668 -76532004)
2014,Diciembre,Puerto Rico/Territorio de Estados Unidos,328,403,,731,POINT (4697157 -74140516)
2014,Diciembre,Puerto Rico/Territorio de Estados Unidos,8,9,,17,POINT (4815189 -75736374)
2014,Diciembre,Puerto Rico/Territorio de Estados Unidos,47,106,,153,POINT (6170465 -7542726)
2014,Diciembre,Puerto Rico/Territorio de Estados Unidos,4,8,,12,POINT (7128047 -73181317)
2014,Diciembre,Puerto Rico/Territorio de Estados Unidos,4,5,,9,POINT (7927233 -72508188)
2014,Diciembre,Qatar,0,1,,1,POINT (7128047 -73181317)
2014,Diciembre,Reino Unido de Gran Bretaña e Irlanda del Norte,0,2,,2,POINT (10446304 -75516486)
2014,Diciembre,Reino Unido de Gran Bretaña e Irlanda del Norte,1,6,,7,POINT (10886686 -74776479)
2014,Diciembre,Reino Unido de Gran Bretaña e Irlanda del Norte,14,33,,47,POINT (3451668 -76532004)
2014,Diciembre,Reino Unido de Gran Bretaña e Irlanda del Norte,573,1006,,1579,POINT (4697157 -74140516)
2014,Diciembre,Reino Unido de Gran Bretaña e Irlanda del Norte,0,1,,1,POINT (4815189 -75736374)
2014,Diciembre,Reino Unido de Gran Bretaña e Irlanda del Norte,15,25,,40,POINT (6170465 -7542726)
2014,Diciembre,Reino Unido de Gran Bretaña e Irlanda del Norte,1,1,,2,POINT (7128047 -73181317)
2014,Diciembre,Reino Unido de Gran Bretaña e Irlanda del Norte,0,1,,1,POINT (7927233 -72508188)
2014,Diciembre,Federación de Rusia,0,1,,1,POINT (10970933 -74765343)
2014,Diciembre,Federación de Rusia,19,24,,43,POINT (4697157 -74140516)
2014,Diciembre,Federación de Rusia,0,1,,1,POINT (4815189 -75736374)
2014,Diciembre,República Dominicana,0,5,,5,POINT (10406342 -75527794)
2014,Diciembre,República Dominicana,5,12,,17,POINT (10446304 -75516486)
2014,Diciembre,República Dominicana,12,25,,37,POINT (10886686 -74776479)
2014,Diciembre,República Dominicana,0,5,,5,POINT (10970933 -74765343)
2014,Diciembre,República Dominicana,0,3,,3,POINT (125862 -81702165)
2014,Diciembre,República Dominicana,9,38,,47,POINT (3451668 -76532004)
2014,Diciembre,República Dominicana,325,576,,901,POINT (4697157 -74140516)
2014,Diciembre,República Dominicana,5,6,,11,POINT (4815189 -75736374)
2014,Diciembre,República Dominicana,20,43,,63,POINT (6170465 -7542726)
2014,Diciembre,República Dominicana,1,7,,8,POINT (7128047 -73181317)
2014,Diciembre,República Dominicana,1,6,,7,POINT (7927233 -72508188)
2014,Diciembre,República Democrática Popular de Corea,1,0,,1,POINT (4697157 -74140516)
2014,Diciembre,Rumania,0,1,,1,POINT (10446304 -75516486)
2014,Diciembre,Rumania,2,0,,2,POINT (4697157 -74140516)
2014,Diciembre,San  Vicente y las Granadinas,0,1,,1,POINT (6170465 -7542726)
2014,Diciembre,Santa Lucia,1,0,,1,POINT (4697157 -74140516)
2014,Diciembre,Senegal,1,2,,3,POINT (6170465 -7542726)
2014,Diciembre,Singapur,0,4,,4,POINT (4697157 -74140516)
2014,Diciembre,Sri Lanka,0,2,,2,POINT (4697157 -74140516)
2014,Diciembre,Sudáfrica,3,5,,8,POINT (4697157 -74140516)
2014,Diciembre,Sudáfrica,0,1,,1,POINT (6170465 -7542726)
2014,Diciembre,Suecia,2,1,,3,POINT (10886686 -74776479)
2014,Diciembre,Suecia,8,16,,24,POINT (3451668 -76532004)
2014,Diciembre,Suecia,57,78,,135,POINT (4697157 -74140516)
2014,Diciembre,Suecia,1,0,,1,POINT (4815189 -75736374)
2014,Diciembre,Suecia,5,8,,13,POINT (6170465 -7542726)
2014,Diciembre,Suecia,4,1,,5,POINT (7128047 -73181317)
2014,Diciembre,Suiza,1,1,,2,POINT (10446304 -75516486)
2014,Diciembre,Suiza,2,0,,2,POINT (10886686 -74776479)
2014,Diciembre,Suiza,0,1,,1,POINT (125862 -81702165)
2014,Diciembre,Suiza,11,18,,29,POINT (3451668 -76532004)
2014,Diciembre,Suiza,113,180,,293,POINT (4697157 -74140516)
2014,Diciembre,Suiza,0,1,,1,POINT (4815189 -75736374)
2014,Diciembre,Suiza,12,20,,32,POINT (6170465 -7542726)
2014,Diciembre,Suiza,0,1,,1,POINT (7128047 -73181317)
2014,Diciembre,Suiza,0,2,,2,POINT (7927233 -72508188)
2014,Diciembre,Surinam,0,36,,36,POINT (10406342 -75527794)
2014,Diciembre,Surinam,0,2,,2,POINT (4697157 -74140516)
2014,Diciembre,Taiwán,0,2,,2,POINT (10406342 -75527794)
2014,Diciembre,Taiwán,0,1,,1,POINT (4697157 -74140516)
2014,Diciembre,Taiwán,0,1,,1,POINT (4815189 -75736374)
2014,Diciembre,Tailandia,1,2,,3,POINT (4697157 -74140516)
2014,Diciembre,Trinidad y Tobago,1,3,,4,POINT (10446304 -75516486)
2014,Diciembre,Trinidad y Tobago,2,1,,3,POINT (10886686 -74776479)
2014,Diciembre,Trinidad y Tobago,0,17,,17,POINT (11247723 -74213989)
2014,Diciembre,Trinidad y Tobago,2,2,,4,POINT (3451668 -76532004)
2014,Diciembre,Trinidad y Tobago,8,9,,17,POINT (4697157 -74140516)
2014,Diciembre,Trinidad y Tobago,0,1,,1,POINT (4815189 -75736374)
2014,Diciembre,Trinidad y Tobago,2,6,,8,POINT (6170465 -7542726)
2014,Diciembre,Trinidad y Tobago,1,3,,4,POINT (7128047 -73181317)
2014,Diciembre,Trinidad y Tobago,0,3,,3,POINT (7927233 -72508188)
2014,Diciembre,Túnez,1,0,,1,POINT (4697157 -74140516)
2014,Diciembre,Turquía,1,2,,3,POINT (10446304 -75516486)
2014,Diciembre,Turquía,2,8,,10,POINT (4697157 -74140516)
2014,Diciembre,Ucrania,2,0,,2,POINT (4697157 -74140516)
2014,Diciembre,Uruguay,5,3,,8,POINT (10446304 -75516486)
2014,Diciembre,Uruguay,1,2,,3,POINT (10886686 -74776479)
2014,Diciembre,Uruguay,6,7,,13,POINT (125862 -81702165)
2014,Diciembre,Uruguay,6,27,,33,POINT (3451668 -76532004)
2014,Diciembre,Uruguay,34,56,,90,POINT (4697157 -74140516)
2014,Diciembre,Uruguay,35,28,,63,POINT (6170465 -7542726)
2014,Diciembre,Uruguay,0,1,,1,POINT (7128047 -73181317)
2014,Diciembre,Uruguay,0,2,,2,POINT (7927233 -72508188)
2014,Diciembre,Venezuela,8,22,,30,POINT (10446304 -75516486)
2014,Diciembre,Venezuela,15,56,,71,POINT (10886686 -74776479)
2014,Diciembre,Venezuela,0,3,,3,POINT (10970933 -74765343)
2014,Diciembre,Venezuela,0,6,,6,POINT (11117206 -74232675)
2014,Diciembre,Venezuela,3505,4402,,7907,POINT (11360029 -72129595)
2014,Diciembre,Venezuela,4,1,,5,POINT (125862 -81702165)
2014,Diciembre,Venezuela,10,16,,26,POINT (3451668 -76532004)
2014,Diciembre,Venezuela,7,7,,14,POINT (3866713 -67927521)
2014,Diciembre,Venezuela,4523,4553,,9076,POINT (4697157 -74140516)
2014,Diciembre,Venezuela,0,1,,1,POINT (4815189 -75736374)
2014,Diciembre,Venezuela,64,74,,138,POINT (6170465 -7542726)
2014,Diciembre,Venezuela,404,650,,1054,POINT (6185536 -67484028)
2014,Diciembre,Venezuela,206,311,,517,POINT (7088729 -70740253)
2014,Diciembre,Venezuela,3,13,,16,POINT (7128047 -73181317)
2014,Diciembre,Venezuela,6268,7293,,13561,POINT (7819 -72453013)
2014,Diciembre,Venezuela,669,627,,1296,POINT (7927233 -72508188)
2014,Diciembre,Vietnam,0,5,,5,POINT (10406342 -75527794)
2014,Diciembre,Vietnam,1,0,,1,POINT (6170465 -7542726)
2014,Diciembre,Vietnam,0,1,,1,POINT (7927233 -72508188)
2014,Diciembre,Islas Vírgenes Británicas/Territorio Británico de Ultramar,0,1,,1,POINT (11247723 -74213989)
2014,Diciembre,República Árabe de Yemen,1,0,,1,POINT (4697157 -74140516)
2014,Diciembre,Zambia,0,1,,1,POINT (10886686 -74776479)
2014,Diciembre,Desconocido,14,2,,16,POINT (3451668 -76532004)
2014,Diciembre,Desconocido,2,95,,97,POINT (4697157 -74140516)
2014,Diciembre,Desconocido,1,24,,25,POINT (4697157 -74140516)
2015,Enero,Alemania,2,1,,3,POINT (10886686 -74776479)
2015,Enero,Alemania,19,12,,31,POINT (3451668 -76532004)
2015,Enero,Alemania,1480,2497,,3977,POINT (4697157 -74140516)
2015,Enero,Alemania,0,1,,1,POINT (4815189 -75736374)
2015,Enero,Alemania,15,19,,34,POINT (6170465 -7542726)
2015,Enero,Andorra,2,2,,4,POINT (4697157 -74140516)
2015,Enero,Países Bajos,39,29,,68,POINT (10406342 -75527794)
2015,Enero,Países Bajos,2,0,,2,POINT (10886686 -74776479)
2015,Enero,Países Bajos,0,1,,1,POINT (10970933 -74765343)
2015,Enero,Países Bajos,14,22,,36,POINT (11247723 -74213989)
2015,Enero,Países Bajos,6,16,,22,POINT (3451668 -76532004)
2015,Enero,Países Bajos,66,108,,174,POINT (4697157 -74140516)
2015,Enero,Países Bajos,0,1,,1,POINT (4815189 -75736374)
2015,Enero,Países Bajos,24,43,,67,POINT (6170465 -7542726)
2015,Enero,Países Bajos,2,0,,2,POINT (7128047 -73181317)
2015,Enero,Arabia Saudita,0,1,,1,POINT (4697157 -74140516)
2015,Enero,Argelia,4,2,,6,POINT (4697157 -74140516)
2015,Enero,Argentina,3,6,,9,POINT (0.81488 -77356)
2015,Enero,Argentina,68,44,,112,POINT (10446304 -75516486)
2015,Enero,Argentina,14,21,,35,POINT (10886686 -74776479)
2015,Enero,Argentina,94,75,,169,POINT (125862 -81702165)
2015,Enero,Argentina,98,110,,208,POINT (3451668 -76532004)
2015,Enero,Argentina,3421,3654,,7075,POINT (4697157 -74140516)
2015,Enero,Argentina,0,1,,1,POINT (4815189 -75736374)
2015,Enero,Argentina,155,167,,322,POINT (6170465 -7542726)
2015,Enero,Argentina,1,0,,1,POINT (7128047 -73181317)
2015,Enero,Argentina,0,1,,1,POINT (7927233 -72508188)
2015,Enero,República de Armenia,1,0,,1,POINT (4697157 -74140516)
2015,Enero,Aruba,72,80,,152,POINT (10406342 -75527794)
2015,Enero,Aruba,0,1,,1,POINT (10446304 -75516486)
2015,Enero,Aruba,1,3,,4,POINT (10886686 -74776479)
2015,Enero,Aruba,0,2,,2,POINT (10970933 -74765343)
2015,Enero,Aruba,24,22,,46,POINT (11247723 -74213989)
2015,Enero,Aruba,1,1,,2,POINT (3451668 -76532004)
2015,Enero,Aruba,386,440,,826,POINT (4697157 -74140516)
2015,Enero,Aruba,1,3,,4,POINT (4815189 -75736374)
2015,Enero,Aruba,3,7,,10,POINT (6170465 -7542726)
2015,Enero,Aruba,8,7,,15,POINT (7128047 -73181317)
2015,Enero,Aruba,0,2,,2,POINT (7927233 -72508188)
2015,Enero,Aruba,0,5,,5,POINT (9402597 -75681642)
2015,Enero,Australia,2,2,,4,POINT (10446304 -75516486)
2015,Enero,Australia,0,4,,4,POINT (10886686 -74776479)
2015,Enero,Australia,8,9,,17,POINT (3451668 -76532004)
2015,Enero,Australia,21,46,,67,POINT (4697157 -74140516)
2015,Enero,Australia,1,1,,2,POINT (4815189 -75736374)
2015,Enero,Australia,14,15,,29,POINT (6170465 -7542726)
2015,Enero,Austria,22,40,,62,POINT (4697157 -74140516)
2015,Enero,Austria,1,1,,2,POINT (6170465 -7542726)
2015,Enero,Austria,0,1,,1,POINT (7128047 -73181317)
2015,Enero,Azerbaiyán,1,1,,2,POINT (3451668 -76532004)
2015,Enero,Azerbaiyán,1,0,,1,POINT (4697157 -74140516)
2015,Enero,Bahamas,0,4,,4,POINT (10446304 -75516486)
2015,Enero,Bahamas,0,5,,5,POINT (3884426 -77061029)
2015,Enero,Bahamas,1,2,,3,POINT (4697157 -74140516)
2015,Enero,Bahamas,1,0,,1,POINT (4815189 -75736374)
2015,Enero,Bahréin,0,1,,1,POINT (11360029 -72129595)
2015,Enero,Bangladesh,0,1,,1,POINT (4697157 -74140516)
2015,Enero,Barbados,0,1,,1,POINT (3451668 -76532004)
2015,Enero,Barbados,0,3,,3,POINT (4697157 -74140516)
2015,Enero,Barbados,0,1,,1,POINT (4815189 -75736374)
2015,Enero,Barbados,0,1,,1,POINT (7927233 -72508188)
2015,Enero,República de Belarús,0,1,,1,POINT (11360029 -72129595)
2015,Enero,Bélgica,0,1,,1,POINT (10446304 -75516486)
2015,Enero,Bélgica,0,1,,1,POINT (10886686 -74776479)
2015,Enero,Bélgica,1,7,,8,POINT (3451668 -76532004)
2015,Enero,Bélgica,21,46,,67,POINT (4697157 -74140516)
2015,Enero,Bélgica,0,6,,6,POINT (6170465 -7542726)
2015,Enero,Belice,0,1,,1,POINT (10446304 -75516486)
2015,Enero,Belice,2,0,,2,POINT (4697157 -74140516)
2015,Enero,Belice,0,2,,2,POINT (6170465 -7542726)
2015,Enero,Benín,1,1,,2,POINT (4697157 -74140516)
2015,Enero,Bermudas/Territorio Británico de Ultramar,0,2,,2,POINT (3451668 -76532004)
2015,Enero,Bermudas/Territorio Británico de Ultramar,0,1,,1,POINT (6170465 -7542726)
2015,Enero,Bolivia,1,0,,1,POINT (0.81488 -77356)
2015,Enero,Bolivia,1,6,,7,POINT (10446304 -75516486)
2015,Enero,Bolivia,2,2,,4,POINT (125862 -81702165)
2015,Enero,Bolivia,19,14,,33,POINT (3451668 -76532004)
2015,Enero,Bolivia,605,669,,1274,POINT (4697157 -74140516)
2015,Enero,Bolivia,0,1,,1,POINT (4815189 -75736374)
2015,Enero,Bolivia,28,32,,60,POINT (6170465 -7542726)
2015,Enero,Bosnia y Herzegovina,0,1,,1,POINT (6170465 -7542726)
2015,Enero,Brasil,184,215,,399,POINT (-4191162 -69941498)
2015,Enero,Brasil,13,31,,44,POINT (-4214082 -69941431)
2015,Enero,Brasil,1,2,,3,POINT (0.81488 -77356)
2015,Enero,Brasil,3,14,,17,POINT (10406342 -75527794)
2015,Enero,Brasil,105,78,,183,POINT (10446304 -75516486)
2015,Enero,Brasil,10,9,,19,POINT (10886686 -74776479)
2015,Enero,Brasil,96,67,,163,POINT (125862 -81702165)
2015,Enero,Brasil,55,72,,127,POINT (3451668 -76532004)
2015,Enero,Brasil,4007,5060,,9067,POINT (4697157 -74140516)
2015,Enero,Brasil,1,4,,5,POINT (4815189 -75736374)
2015,Enero,Brasil,105,172,,277,POINT (6170465 -7542726)
2015,Enero,Brasil,2,6,,8,POINT (7128047 -73181317)
2015,Enero,Brasil,0,3,,3,POINT (7927233 -72508188)
2015,Enero,Bulgaria,0,4,,4,POINT (4697157 -74140516)
2015,Enero,Bután,0,1,,1,POINT (4697157 -74140516)
2015,Enero,Islas Caimán/Territorio Británico de Ultramar,1,3,,4,POINT (125744111 -81703935)
2015,Enero,Islas Caimán/Territorio Británico de Ultramar,2,3,,5,POINT (125862 -81702165)
2015,Enero,Islas Caimán/Territorio Británico de Ultramar,0,3,,3,POINT (4697157 -74140516)
2015,Enero,Canadá,726,702,,1428,POINT (10446304 -75516486)
2015,Enero,Canadá,21,24,,45,POINT (10886686 -74776479)
2015,Enero,Canadá,324,316,,640,POINT (125862 -81702165)
2015,Enero,Canadá,26,33,,59,POINT (3451668 -76532004)
2015,Enero,Canadá,1,0,,1,POINT (445285 -75766353)
2015,Enero,Canadá,655,985,,1640,POINT (4697157 -74140516)
2015,Enero,Canadá,1,4,,5,POINT (4815189 -75736374)
2015,Enero,Canadá,72,128,,200,POINT (6170465 -7542726)
2015,Enero,Canadá,1,4,,5,POINT (7128047 -73181317)
2015,Enero,Canadá,4,5,,9,POINT (7927233 -72508188)
2015,Enero,España,0,8,,8,POINT (10406342 -75527794)
2015,Enero,España,0,1,,1,POINT (10446304 -75516486)
2015,Enero,España,0,2,,2,POINT (10886686 -74776479)
2015,Enero,España,0,1,,1,POINT (11247723 -74213989)
2015,Enero,España,1,0,,1,POINT (125862 -81702165)
2015,Enero,España,243,422,,665,POINT (3451668 -76532004)
2015,Enero,España,3162,5964,,9126,POINT (4697157 -74140516)
2015,Enero,España,1,3,,4,POINT (4815189 -75736374)
2015,Enero,España,151,353,,504,POINT (6170465 -7542726)
2015,Enero,República de Corea,0,1,,1,POINT (3451668 -76532004)
2015,Enero,República de Corea,0,2,,2,POINT (3884426 -77061029)
2015,Enero,República de Corea,18,25,,43,POINT (4697157 -74140516)
2015,Enero,República de Corea,0,1,,1,POINT (4815189 -75736374)
2015,Enero,República de Corea,2,1,,3,POINT (6170465 -7542726)
2015,Enero,República de Corea,0,1,,1,POINT (7927233 -72508188)
2015,Enero,Costa de Marfil,0,1,,1,POINT (10970933 -74765343)
2015,Enero,Costa de Marfil,3,0,,3,POINT (4697157 -74140516)
2015,Enero,Costa de Marfil,0,1,,1,POINT (6170465 -7542726)
2015,Enero,Costa Rica,3,5,,8,POINT (10406342 -75527794)
2015,Enero,Costa Rica,16,14,,30,POINT (10446304 -75516486)
2015,Enero,Costa Rica,5,8,,13,POINT (10886686 -74776479)
2015,Enero,Costa Rica,412,320,,732,POINT (125862 -81702165)
2015,Enero,Costa Rica,12,31,,43,POINT (3451668 -76532004)
2015,Enero,Costa Rica,0,2,,2,POINT (3884426 -77061029)
2015,Enero,Costa Rica,579,899,,1478,POINT (4697157 -74140516)
2015,Enero,Costa Rica,6,9,,15,POINT (4815189 -75736374)
2015,Enero,Costa Rica,63,99,,162,POINT (6170465 -7542726)
2015,Enero,Costa Rica,2,6,,8,POINT (7128047 -73181317)
2015,Enero,Costa Rica,4,11,,15,POINT (7927233 -72508188)
2015,Enero,Croacia,0,2,,2,POINT (3451668 -76532004)
2015,Enero,Croacia,0,2,,2,POINT (4697157 -74140516)
2015,Enero,Cuba,3,3,,6,POINT (10446304 -75516486)
2015,Enero,Cuba,9,10,,19,POINT (10886686 -74776479)
2015,Enero,Cuba,1,0,,1,POINT (125862 -81702165)
2015,Enero,Cuba,1,1,,2,POINT (133387613 -81372937)
2015,Enero,Cuba,15,24,,39,POINT (3451668 -76532004)
2015,Enero,Cuba,248,353,,601,POINT (4697157 -74140516)
2015,Enero,Cuba,4,5,,9,POINT (4815189 -75736374)
2015,Enero,Cuba,13,18,,31,POINT (6170465 -7542726)
2015,Enero,Cuba,2,2,,4,POINT (7128047 -73181317)
2015,Enero,Cuba,2,12,,14,POINT (7927233 -72508188)
2015,Enero,Curazao,4,6,,10,POINT (10406342 -75527794)
2015,Enero,Curazao,52,85,,137,POINT (10886686 -74776479)
2015,Enero,Curazao,2,6,,8,POINT (11247723 -74213989)
2015,Enero,Curazao,1,2,,3,POINT (3451668 -76532004)
2015,Enero,Curazao,326,418,,744,POINT (4697157 -74140516)
2015,Enero,Curazao,122,176,,298,POINT (6170465 -7542726)
2015,Enero,República Checa,13,17,,30,POINT (4697157 -74140516)
2015,Enero,Chile,1,0,,1,POINT (0.81488 -77356)
2015,Enero,Chile,11,12,,23,POINT (10446304 -75516486)
2015,Enero,Chile,5,9,,14,POINT (10886686 -74776479)
2015,Enero,Chile,26,23,,49,POINT (125862 -81702165)
2015,Enero,Chile,45,58,,103,POINT (3451668 -76532004)
2015,Enero,Chile,4156,4842,,8998,POINT (4697157 -74140516)
2015,Enero,Chile,0,2,,2,POINT (4815189 -75736374)
2015,Enero,Chile,36,91,,127,POINT (6170465 -7542726)
2015,Enero,Chile,2,3,,5,POINT (7128047 -73181317)
2015,Enero,Chile,0,1,,1,POINT (7927233 -72508188)
2015,Enero,China,1,3,,4,POINT (3451668 -76532004)
2015,Enero,China,41,111,,152,POINT (4697157 -74140516)
2015,Enero,China,1,0,,1,POINT (7128047 -73181317)
2015,Enero,Dinamarca,1,2,,3,POINT (3451668 -76532004)
2015,Enero,Dinamarca,19,18,,37,POINT (4697157 -74140516)
2015,Enero,Dinamarca,1,3,,4,POINT (6170465 -7542726)
2015,Enero,Ecuador,53,183,,236,POINT (0.33002 -76876446)
2015,Enero,Ecuador,2996,4608,,7604,POINT (0.81488 -77356)
2015,Enero,Ecuador,8,20,,28,POINT (1800143 -78802679)
2015,Enero,Ecuador,0,1,,1,POINT (10406342 -75527794)
2015,Enero,Ecuador,0,3,,3,POINT (10446304 -75516486)
2015,Enero,Ecuador,1,5,,6,POINT (10886686 -74776479)
2015,Enero,Ecuador,1,0,,1,POINT (125862 -81702165)
2015,Enero,Ecuador,340,506,,846,POINT (3451668 -76532004)
2015,Enero,Ecuador,0,2,,2,POINT (3884426 -77061029)
2015,Enero,Ecuador,2686,4158,,6844,POINT (4697157 -74140516)
2015,Enero,Ecuador,2,6,,8,POINT (4815189 -75736374)
2015,Enero,Ecuador,357,483,,840,POINT (6170465 -7542726)
2015,Enero,Ecuador,2,3,,5,POINT (7128047 -73181317)
2015,Enero,Ecuador,7,2,,9,POINT (7927233 -72508188)
2015,Enero,Egipto,0,1,,1,POINT (3451668 -76532004)
2015,Enero,Egipto,2,8,,10,POINT (4697157 -74140516)
2015,Enero,El Salvador,1,0,,1,POINT (10886686 -74776479)
2015,Enero,El Salvador,116,178,,294,POINT (3451668 -76532004)
2015,Enero,El Salvador,622,990,,1612,POINT (4697157 -74140516)
2015,Enero,El Salvador,1,0,,1,POINT (4815189 -75736374)
2015,Enero,El Salvador,110,214,,324,POINT (6170465 -7542726)
2015,Enero,El Salvador,5,2,,7,POINT (7927233 -72508188)
2015,Enero,Emiratos Árabes,3,4,,7,POINT (4697157 -74140516)
2015,Enero,Eslovaquia,0,1,,1,POINT (3451668 -76532004)
2015,Enero,Eslovaquia,3,3,,6,POINT (4697157 -74140516)
2015,Enero,Eslovaquia,1,0,,1,POINT (6170465 -7542726)
2015,Enero,Eslovenia,0,2,,2,POINT (3451668 -76532004)
2015,Enero,Eslovenia,2,5,,7,POINT (4697157 -74140516)
2015,Enero,Estados Unidos de América,1,24,,25,POINT (10406342 -75527794)
2015,Enero,Estados Unidos de América,2085,3106,,5191,POINT (10446304 -75516486)
2015,Enero,Estados Unidos de América,191,366,,557,POINT (10886686 -74776479)
2015,Enero,Estados Unidos de América,0,2,,2,POINT (10970933 -74765343)
2015,Enero,Estados Unidos de América,0,1,,1,POINT (11117206 -74232675)
2015,Enero,Estados Unidos de América,3,9,,12,POINT (11247723 -74213989)
2015,Enero,Estados Unidos de América,4,6,,10,POINT (125862 -81702165)
2015,Enero,Estados Unidos de América,586,1055,,1641,POINT (3451668 -76532004)
2015,Enero,Estados Unidos de América,0,4,,4,POINT (3884426 -77061029)
2015,Enero,Estados Unidos de América,71,109,,180,POINT (445285 -75766353)
2015,Enero,Estados Unidos de América,7525,13075,,20600,POINT (4697157 -74140516)
2015,Enero,Estados Unidos de América,97,165,,262,POINT (4815189 -75736374)
2015,Enero,Estados Unidos de América,1267,3075,,4342,POINT (6170465 -7542726)
2015,Enero,Estados Unidos de América,28,29,,57,POINT (7128047 -73181317)
2015,Enero,Estados Unidos de América,97,86,,183,POINT (7927233 -72508188)
2015,Enero,Estados Unidos de América,0,2,,2,POINT (806667 -767333)
2015,Enero,Estados Unidos de América,0,4,,4,POINT (9402597 -75681642)
2015,Enero,Estonia,1,0,,1,POINT (4697157 -74140516)
2015,Enero,Etiopia,0,1,,1,POINT (4697157 -74140516)
2015,Enero,Filipinas,0,7,,7,POINT (10446304 -75516486)
2015,Enero,Filipinas,0,1,,1,POINT (10886686 -74776479)
2015,Enero,Filipinas,2,5,,7,POINT (3451668 -76532004)
2015,Enero,Filipinas,0,8,,8,POINT (4697157 -74140516)
2015,Enero,Finlandia,0,1,,1,POINT (3451668 -76532004)
2015,Enero,Finlandia,5,7,,12,POINT (4697157 -74140516)
2015,Enero,Finlandia,3,1,,4,POINT (6170465 -7542726)
2015,Enero,Francia,1,2,,3,POINT (10446304 -75516486)
2015,Enero,Francia,0,5,,5,POINT (10886686 -74776479)
2015,Enero,Francia,13,21,,34,POINT (3451668 -76532004)
2015,Enero,Francia,1295,2235,,3530,POINT (4697157 -74140516)
2015,Enero,Francia,1,4,,5,POINT (4815189 -75736374)
2015,Enero,Francia,5,19,,24,POINT (6170465 -7542726)
2015,Enero,Francia,0,1,,1,POINT (7128047 -73181317)
2015,Enero,Georgia,1,0,,1,POINT (4697157 -74140516)
2015,Enero,Ghana,0,2,,2,POINT (4697157 -74140516)
2015,Enero,Granada,0,1,,1,POINT (10406342 -75527794)
2015,Enero,Granada,1,1,,2,POINT (10886686 -74776479)
2015,Enero,Grecia,0,9,,9,POINT (4697157 -74140516)
2015,Enero,Guatemala,5,23,,28,POINT (10446304 -75516486)
2015,Enero,Guatemala,2,9,,11,POINT (10886686 -74776479)
2015,Enero,Guatemala,3,2,,5,POINT (125862 -81702165)
2015,Enero,Guatemala,9,11,,20,POINT (3451668 -76532004)
2015,Enero,Guatemala,181,375,,556,POINT (4697157 -74140516)
2015,Enero,Guatemala,3,5,,8,POINT (4815189 -75736374)
2015,Enero,Guatemala,30,79,,109,POINT (6170465 -7542726)
2015,Enero,Guatemala,0,1,,1,POINT (7128047 -73181317)
2015,Enero,Guatemala,5,9,,14,POINT (7927233 -72508188)
2015,Enero,Guyana,4,1,,5,POINT (4697157 -74140516)
2015,Enero,Guinea Ecuatorial,0,6,,6,POINT (10886686 -74776479)
2015,Enero,Guadalupe/Territorio Francés,1,2,,3,POINT (4697157 -74140516)
2015,Enero,Guadalupe/Territorio Francés,2,2,,4,POINT (6170465 -7542726)
2015,Enero,Guayana Francesa/Departamento de Ultramar Francés,2,1,,3,POINT (4697157 -74140516)
2015,Enero,Guayana Francesa/Departamento de Ultramar Francés,0,1,,1,POINT (6170465 -7542726)
2015,Enero,Haití,0,12,,12,POINT (10406342 -75527794)
2015,Enero,Haití,0,26,,26,POINT (10446304 -75516486)
2015,Enero,Haití,1,5,,6,POINT (4697157 -74140516)
2015,Enero,Haití,1,0,,1,POINT (4815189 -75736374)
2015,Enero,Haití,0,2,,2,POINT (6170465 -7542726)
2015,Enero,Honduras,0,1,,1,POINT (10406342 -75527794)
2015,Enero,Honduras,4,5,,9,POINT (10446304 -75516486)
2015,Enero,Honduras,3,10,,13,POINT (133387613 -81372937)
2015,Enero,Honduras,6,16,,22,POINT (3451668 -76532004)
2015,Enero,Honduras,24,51,,75,POINT (4697157 -74140516)
2015,Enero,Honduras,1,2,,3,POINT (4815189 -75736374)
2015,Enero,Honduras,23,35,,58,POINT (6170465 -7542726)
2015,Enero,Honduras,2,0,,2,POINT (7128047 -73181317)
2015,Enero,Honduras,7,3,,10,POINT (7927233 -72508188)
2015,Enero,Hong Kong,3,4,,7,POINT (4697157 -74140516)
2015,Enero,Hungría,0,1,,1,POINT (3451668 -76532004)
2015,Enero,Hungría,2,3,,5,POINT (4697157 -74140516)
2015,Enero,India,0,1,,1,POINT (10446304 -75516486)
2015,Enero,India,0,8,,8,POINT (3451668 -76532004)
2015,Enero,India,4,25,,29,POINT (4697157 -74140516)
2015,Enero,India,0,6,,6,POINT (6170465 -7542726)
2015,Enero,Indonesia,0,1,,1,POINT (10446304 -75516486)
2015,Enero,Indonesia,1,2,,3,POINT (4697157 -74140516)
2015,Enero,Indonesia,0,1,,1,POINT (6170465 -7542726)
2015,Enero,Iraq,0,9,,9,POINT (4697157 -74140516)
2015,Enero,Irán,0,2,,2,POINT (4697157 -74140516)
2015,Enero,República de Irlanda,1,4,,5,POINT (3451668 -76532004)
2015,Enero,República de Irlanda,5,15,,20,POINT (4697157 -74140516)
2015,Enero,República de Irlanda,1,2,,3,POINT (6170465 -7542726)
2015,Enero,República de Irlanda,2,1,,3,POINT (4697157 -74140516)
2015,Enero,Israel,0,2,,2,POINT (10886686 -74776479)
2015,Enero,Israel,1,7,,8,POINT (3451668 -76532004)
2015,Enero,Israel,17,66,,83,POINT (4697157 -74140516)
2015,Enero,Israel,0,7,,7,POINT (6170465 -7542726)
2015,Enero,Italia,1,7,,8,POINT (10446304 -75516486)
2015,Enero,Italia,1,1,,2,POINT (10886686 -74776479)
2015,Enero,Italia,158,154,,312,POINT (125862 -81702165)
2015,Enero,Italia,11,31,,42,POINT (3451668 -76532004)
2015,Enero,Italia,111,341,,452,POINT (4697157 -74140516)
2015,Enero,Italia,3,2,,5,POINT (4815189 -75736374)
2015,Enero,Italia,12,35,,47,POINT (6170465 -7542726)
2015,Enero,Italia,0,1,,1,POINT (7128047 -73181317)
2015,Enero,Jamaica,2,3,,5,POINT (10406342 -75527794)
2015,Enero,Jamaica,0,3,,3,POINT (10446304 -75516486)
2015,Enero,Jamaica,0,1,,1,POINT (10886686 -74776479)
2015,Enero,Jamaica,0,1,,1,POINT (11247723 -74213989)
2015,Enero,Jamaica,2,1,,3,POINT (3451668 -76532004)
2015,Enero,Jamaica,1,5,,6,POINT (4697157 -74140516)
2015,Enero,Jamaica,0,2,,2,POINT (6170465 -7542726)
2015,Enero,Jamaica,2,0,,2,POINT (7128047 -73181317)
2015,Enero,Islas Salomón,1,0,,1,POINT (4697157 -74140516)
2015,Enero,Japón,1,10,,11,POINT (3451668 -76532004)
2015,Enero,Japón,12,33,,45,POINT (4697157 -74140516)
2015,Enero,Japón,1,1,,2,POINT (4815189 -75736374)
2015,Enero,Japón,0,5,,5,POINT (6170465 -7542726)
2015,Enero,Kazajistán,0,2,,2,POINT (4697157 -74140516)
2015,Enero,Kenia,2,1,,3,POINT (4697157 -74140516)
2015,Enero,Lituania,1,1,,2,POINT (4697157 -74140516)
2015,Enero,Líbano,5,5,,10,POINT (4697157 -74140516)
2015,Enero,Liberia,0,1,,1,POINT (4697157 -74140516)
2015,Enero,Luxemburgo,3,2,,5,POINT (4697157 -74140516)
2015,Enero,Malasia,1,1,,2,POINT (3451668 -76532004)
2015,Enero,Malasia,2,1,,3,POINT (4697157 -74140516)
2015,Enero,Malta,0,1,,1,POINT (4697157 -74140516)
2015,Enero,Marruecos,1,4,,5,POINT (4697157 -74140516)
2015,Enero,México,0,1,,1,POINT (10406342 -75527794)
2015,Enero,México,7,9,,16,POINT (10446304 -75516486)
2015,Enero,México,10,32,,42,POINT (10886686 -74776479)
2015,Enero,México,1,3,,4,POINT (125862 -81702165)
2015,Enero,México,42,90,,132,POINT (3451668 -76532004)
2015,Enero,México,3412,5932,,9344,POINT (4697157 -74140516)
2015,Enero,México,6,6,,12,POINT (4815189 -75736374)
2015,Enero,México,97,280,,377,POINT (6170465 -7542726)
2015,Enero,México,8,18,,26,POINT (7128047 -73181317)
2015,Enero,México,28,26,,54,POINT (7927233 -72508188)
2015,Enero,Mónaco,1,0,,1,POINT (4697157 -74140516)
2015,Enero,Nauru,0,2,,2,POINT (4697157 -74140516)
2015,Enero,Nepal,0,1,,1,POINT (3451668 -76532004)
2015,Enero,Nicaragua,2,1,,3,POINT (10446304 -75516486)
2015,Enero,Nicaragua,1,1,,2,POINT (10886686 -74776479)
2015,Enero,Nicaragua,4,6,,10,POINT (3451668 -76532004)
2015,Enero,Nicaragua,15,24,,39,POINT (4697157 -74140516)
2015,Enero,Nicaragua,0,1,,1,POINT (4815189 -75736374)
2015,Enero,Nicaragua,3,9,,12,POINT (6170465 -7542726)
2015,Enero,Nicaragua,1,0,,1,POINT (7128047 -73181317)
2015,Enero,Nicaragua,2,0,,2,POINT (7927233 -72508188)
2015,Enero,Noruega,0,1,,1,POINT (3451668 -76532004)
2015,Enero,Noruega,12,25,,37,POINT (4697157 -74140516)
2015,Enero,Noruega,0,1,,1,POINT (4815189 -75736374)
2015,Enero,Noruega,0,4,,4,POINT (6170465 -7542726)
2015,Enero,Noruega,1,0,,1,POINT (7927233 -72508188)
2015,Enero,Nueva Zelanda,2,7,,9,POINT (3451668 -76532004)
2015,Enero,Nueva Zelanda,3,4,,7,POINT (4697157 -74140516)
2015,Enero,Nueva Zelanda,0,1,,1,POINT (4815189 -75736374)
2015,Enero,Papúa Nueva Guinea,1,0,,1,POINT (10446304 -75516486)
2015,Enero,Pakistán,0,2,,2,POINT (6170465 -7542726)
2015,Enero,Panamá,0,3,,3,POINT (-4191162 -69941498)
2015,Enero,Panamá,1178,1496,,2674,POINT (10406342 -75527794)
2015,Enero,Panamá,1980,2423,,4403,POINT (10446304 -75516486)
2015,Enero,Panamá,194,412,,606,POINT (10886686 -74776479)
2015,Enero,Panamá,0,5,,5,POINT (10970933 -74765343)
2015,Enero,Panamá,1,2,,3,POINT (11117206 -74232675)
2015,Enero,Panamá,15,13,,28,POINT (11247723 -74213989)
2015,Enero,Panamá,4,10,,14,POINT (125744111 -81703935)
2015,Enero,Panamá,1359,1074,,2433,POINT (125862 -81702165)
2015,Enero,Panamá,1,1,,2,POINT (133387613 -81372937)
2015,Enero,Panamá,342,608,,950,POINT (3451668 -76532004)
2015,Enero,Panamá,0,32,,32,POINT (3884426 -77061029)
2015,Enero,Panamá,2784,4394,,7178,POINT (4697157 -74140516)
2015,Enero,Panamá,57,116,,173,POINT (4815189 -75736374)
2015,Enero,Panamá,737,1417,,2154,POINT (6170465 -7542726)
2015,Enero,Panamá,2,0,,2,POINT (6222552 -77401154)
2015,Enero,Panamá,0,2,,2,POINT (7102626 -77762647)
2015,Enero,Panamá,42,70,,112,POINT (7128047 -73181317)
2015,Enero,Panamá,196,216,,412,POINT (7927233 -72508188)
2015,Enero,Panamá,76,121,,197,POINT (863337 -7735002)
2015,Enero,Panamá,0,1,,1,POINT (9402597 -75681642)
2015,Enero,Paraguay,1,0,,1,POINT (10446304 -75516486)
2015,Enero,Paraguay,1,0,,1,POINT (10886686 -74776479)
2015,Enero,Paraguay,33,20,,53,POINT (125862 -81702165)
2015,Enero,Paraguay,6,7,,13,POINT (3451668 -76532004)
2015,Enero,Paraguay,37,41,,78,POINT (4697157 -74140516)
2015,Enero,Paraguay,9,17,,26,POINT (6170465 -7542726)
2015,Enero,Perú,88,111,,199,POINT (-4191162 -69941498)
2015,Enero,Perú,13,18,,31,POINT (-4214082 -69941431)
2015,Enero,Perú,14,15,,29,POINT (0.81488 -77356)
2015,Enero,Perú,5,2,,7,POINT (10446304 -75516486)
2015,Enero,Perú,2,8,,10,POINT (10886686 -74776479)
2015,Enero,Perú,54,35,,89,POINT (125862 -81702165)
2015,Enero,Perú,360,426,,786,POINT (3451668 -76532004)
2015,Enero,Perú,0,2,,2,POINT (3884426 -77061029)
2015,Enero,Perú,5668,7001,,12669,POINT (4697157 -74140516)
2015,Enero,Perú,348,518,,866,POINT (6170465 -7542726)
2015,Enero,Perú,3,3,,6,POINT (7128047 -73181317)
2015,Enero,Perú,8,2,,10,POINT (7927233 -72508188)
2015,Enero,Palestina,1,0,,1,POINT (4697157 -74140516)
2015,Enero,Polonia,1,1,,2,POINT (3451668 -76532004)
2015,Enero,Polonia,17,30,,47,POINT (4697157 -74140516)
2015,Enero,Polonia,1,1,,2,POINT (6170465 -7542726)
2015,Enero,Portugal,0,2,,2,POINT (3451668 -76532004)
2015,Enero,Portugal,372,738,,1110,POINT (4697157 -74140516)
2015,Enero,Portugal,2,0,,2,POINT (6170465 -7542726)
2015,Enero,Polinesia Francesa/Colectividad de Ultramar Francesa,1,0,,1,POINT (4697157 -74140516)
2015,Enero,Puerto Rico/Territorio de Estados Unidos,1,4,,5,POINT (10446304 -75516486)
2015,Enero,Puerto Rico/Territorio de Estados Unidos,6,56,,62,POINT (10886686 -74776479)
2015,Enero,Puerto Rico/Territorio de Estados Unidos,12,27,,39,POINT (3451668 -76532004)
2015,Enero,Puerto Rico/Territorio de Estados Unidos,129,265,,394,POINT (4697157 -74140516)
2015,Enero,Puerto Rico/Territorio de Estados Unidos,7,13,,20,POINT (4815189 -75736374)
2015,Enero,Puerto Rico/Territorio de Estados Unidos,33,69,,102,POINT (6170465 -7542726)
2015,Enero,Puerto Rico/Territorio de Estados Unidos,2,2,,4,POINT (7128047 -73181317)
2015,Enero,Puerto Rico/Territorio de Estados Unidos,2,4,,6,POINT (7927233 -72508188)
2015,Enero,Qatar,0,1,,1,POINT (4697157 -74140516)
2015,Enero,Reino Unido de Gran Bretaña e Irlanda del Norte,1,0,,1,POINT (10886686 -74776479)
2015,Enero,Reino Unido de Gran Bretaña e Irlanda del Norte,3,9,,12,POINT (3451668 -76532004)
2015,Enero,Reino Unido de Gran Bretaña e Irlanda del Norte,440,743,,1183,POINT (4697157 -74140516)
2015,Enero,Reino Unido de Gran Bretaña e Irlanda del Norte,0,1,,1,POINT (4815189 -75736374)
2015,Enero,Reino Unido de Gran Bretaña e Irlanda del Norte,7,15,,22,POINT (6170465 -7542726)
2015,Enero,República CentroÁfricana,0,1,,1,POINT (4697157 -74140516)
2015,Enero,Federación de Rusia,3,5,,8,POINT (3451668 -76532004)
2015,Enero,Federación de Rusia,61,81,,142,POINT (4697157 -74140516)
2015,Enero,Federación de Rusia,2,5,,7,POINT (6170465 -7542726)
2015,Enero,República Dominicana,0,3,,3,POINT (10406342 -75527794)
2015,Enero,República Dominicana,11,19,,30,POINT (10446304 -75516486)
2015,Enero,República Dominicana,1,9,,10,POINT (10886686 -74776479)
2015,Enero,República Dominicana,0,1,,1,POINT (10970933 -74765343)
2015,Enero,República Dominicana,1,3,,4,POINT (11117206 -74232675)
2015,Enero,República Dominicana,20,29,,49,POINT (3451668 -76532004)
2015,Enero,República Dominicana,336,541,,877,POINT (4697157 -74140516)
2015,Enero,República Dominicana,3,3,,6,POINT (4815189 -75736374)
2015,Enero,República Dominicana,34,56,,90,POINT (6170465 -7542726)
2015,Enero,República Dominicana,0,4,,4,POINT (7128047 -73181317)
2015,Enero,República Dominicana,2,4,,6,POINT (7927233 -72508188)
2015,Enero,República Democrática Popular de Corea,0,1,,1,POINT (3451668 -76532004)
2015,Enero,Rumania,5,6,,11,POINT (4697157 -74140516)
2015,Enero,San Marino,1,0,,1,POINT (7927233 -72508188)
2015,Enero,Singapur,3,5,,8,POINT (4697157 -74140516)
2015,Enero,Sri Lanka,1,1,,2,POINT (4697157 -74140516)
2015,Enero,Sudáfrica,0,1,,1,POINT (3884426 -77061029)
2015,Enero,Sudáfrica,7,7,,14,POINT (4697157 -74140516)
2015,Enero,Suecia,1,5,,6,POINT (3451668 -76532004)
2015,Enero,Suecia,33,48,,81,POINT (4697157 -74140516)
2015,Enero,Suecia,3,11,,14,POINT (6170465 -7542726)
2015,Enero,Suiza,1,3,,4,POINT (10446304 -75516486)
2015,Enero,Suiza,5,23,,28,POINT (3451668 -76532004)
2015,Enero,Suiza,78,110,,188,POINT (4697157 -74140516)
2015,Enero,Suiza,10,14,,24,POINT (6170465 -7542726)
2015,Enero,Surinam,0,2,,2,POINT (4697157 -74140516)
2015,Enero,Surinam,4,9,,13,POINT (6170465 -7542726)
2015,Enero,Taiwán,1,0,,1,POINT (3451668 -76532004)
2015,Enero,Taiwán,1,1,,2,POINT (4697157 -74140516)
2015,Enero,Taiwán,0,2,,2,POINT (6170465 -7542726)
2015,Enero,Togo,0,1,,1,POINT (4697157 -74140516)
2015,Enero,Trinidad y Tobago,0,94,,94,POINT (10406342 -75527794)
2015,Enero,Trinidad y Tobago,0,2,,2,POINT (10446304 -75516486)
2015,Enero,Trinidad y Tobago,0,5,,5,POINT (10970933 -74765343)
2015,Enero,Trinidad y Tobago,3,12,,15,POINT (3451668 -76532004)
2015,Enero,Trinidad y Tobago,3,10,,13,POINT (4697157 -74140516)
2015,Enero,Trinidad y Tobago,0,1,,1,POINT (4815189 -75736374)
2015,Enero,Trinidad y Tobago,0,4,,4,POINT (6170465 -7542726)
2015,Enero,Trinidad y Tobago,1,1,,2,POINT (7128047 -73181317)
2015,Enero,Trinidad y Tobago,0,2,,2,POINT (7927233 -72508188)
2015,Enero,Turquía,0,2,,2,POINT (3451668 -76532004)
2015,Enero,Turquía,8,17,,25,POINT (4697157 -74140516)
2015,Enero,Turquía,3,10,,13,POINT (6170465 -7542726)
2015,Enero,Ucrania,3,3,,6,POINT (3451668 -76532004)
2015,Enero,Ucrania,1,10,,11,POINT (4697157 -74140516)
2015,Enero,Uruguay,16,14,,30,POINT (10446304 -75516486)
2015,Enero,Uruguay,3,3,,6,POINT (10886686 -74776479)
2015,Enero,Uruguay,25,18,,43,POINT (125862 -81702165)
2015,Enero,Uruguay,13,16,,29,POINT (3451668 -76532004)
2015,Enero,Uruguay,55,62,,117,POINT (4697157 -74140516)
2015,Enero,Uruguay,1,2,,3,POINT (4815189 -75736374)
2015,Enero,Uruguay,22,26,,48,POINT (6170465 -7542726)
2015,Enero,Venezuela,0,19,,19,POINT (10406342 -75527794)
2015,Enero,Venezuela,5,19,,24,POINT (10446304 -75516486)
2015,Enero,Venezuela,9,45,,54,POINT (10886686 -74776479)
2015,Enero,Venezuela,0,4,,4,POINT (10970933 -74765343)
2015,Enero,Venezuela,1843,2794,,4637,POINT (11360029 -72129595)
2015,Enero,Venezuela,9,34,,43,POINT (3451668 -76532004)
2015,Enero,Venezuela,8,8,,16,POINT (3866713 -67927521)
2015,Enero,Venezuela,3405,3945,,7350,POINT (4697157 -74140516)
2015,Enero,Venezuela,8,4,,12,POINT (4815189 -75736374)
2015,Enero,Venezuela,45,87,,132,POINT (6170465 -7542726)
2015,Enero,Venezuela,384,571,,955,POINT (6185536 -67484028)
2015,Enero,Venezuela,93,189,,282,POINT (7088729 -70740253)
2015,Enero,Venezuela,2,3,,5,POINT (7128047 -73181317)
2015,Enero,Venezuela,3709,4861,,8570,POINT (7819 -72453013)
2015,Enero,Venezuela,296,286,,582,POINT (7927233 -72508188)
2015,Enero,Vietnam,0,1,,1,POINT (4697157 -74140516)
2015,Enero,Islas Vírgenes Británicas/Territorio Británico de Ultramar,0,2,,2,POINT (4697157 -74140516)
2015,Enero,Islas Vírgenes Estadounidenses/Territorio de Estados Unidos,1,6,,7,POINT (10446304 -75516486)
2015,Enero,Desconocido,10,12,,22,POINT (133387613 -81372937)
2015,Enero,Desconocido,0,2,,2,POINT (3451668 -76532004)
2015,Enero,Desconocido,1,27,,28,POINT (4697157 -74140516)
2015,Febrero,Albania,0,1,,1,POINT (4697157 -74140516)
2015,Febrero,Alemania,0,1,,1,POINT (10446304 -75516486)
2015,Febrero,Alemania,0,1,,1,POINT (10886686 -74776479)
2015,Febrero,Alemania,1,2,,3,POINT (125862 -81702165)
2015,Febrero,Alemania,8,16,,24,POINT (3451668 -76532004)
2015,Febrero,Alemania,1434,2242,,3676,POINT (4697157 -74140516)
2015,Febrero,Alemania,0,1,,1,POINT (4815189 -75736374)
2015,Febrero,Alemania,10,17,,27,POINT (6170465 -7542726)
2015,Febrero,Países Bajos,1,2,,3,POINT (10446304 -75516486)
2015,Febrero,Países Bajos,9,16,,25,POINT (10886686 -74776479)
2015,Febrero,Países Bajos,5,12,,17,POINT (11247723 -74213989)
2015,Febrero,Países Bajos,3,10,,13,POINT (3451668 -76532004)
2015,Febrero,Países Bajos,83,141,,224,POINT (4697157 -74140516)
2015,Febrero,Países Bajos,1,2,,3,POINT (4815189 -75736374)
2015,Febrero,Países Bajos,68,78,,146,POINT (6170465 -7542726)
2015,Febrero,Países Bajos,3,1,,4,POINT (7128047 -73181317)
2015,Febrero,Argelia,2,2,,4,POINT (4697157 -74140516)
2015,Febrero,Argelia,0,8,,8,POINT (806667 -767333)
2015,Febrero,Argentina,81,60,,141,POINT (10446304 -75516486)
2015,Febrero,Argentina,5,4,,9,POINT (10886686 -74776479)
2015,Febrero,Argentina,129,102,,231,POINT (125862 -81702165)
2015,Febrero,Argentina,80,84,,164,POINT (3451668 -76532004)
2015,Febrero,Argentina,2631,3057,,5688,POINT (4697157 -74140516)
2015,Febrero,Argentina,1,1,,2,POINT (4815189 -75736374)
2015,Febrero,Argentina,100,145,,245,POINT (6170465 -7542726)
2015,Febrero,Aruba,75,58,,133,POINT (10406342 -75527794)
2015,Febrero,Aruba,2,6,,8,POINT (10886686 -74776479)
2015,Febrero,Aruba,0,2,,2,POINT (10970933 -74765343)
2015,Febrero,Aruba,0,1,,1,POINT (11117206 -74232675)
2015,Febrero,Aruba,12,18,,30,POINT (11247723 -74213989)
2015,Febrero,Aruba,3,7,,10,POINT (3451668 -76532004)
2015,Febrero,Aruba,433,494,,927,POINT (4697157 -74140516)
2015,Febrero,Aruba,6,18,,24,POINT (6170465 -7542726)
2015,Febrero,Aruba,9,4,,13,POINT (7128047 -73181317)
2015,Febrero,Aruba,1,0,,1,POINT (7927233 -72508188)
2015,Febrero,Australia,3,3,,6,POINT (10446304 -75516486)
2015,Febrero,Australia,2,2,,4,POINT (10886686 -74776479)
2015,Febrero,Australia,1,2,,3,POINT (3451668 -76532004)
2015,Febrero,Australia,11,36,,47,POINT (4697157 -74140516)
2015,Febrero,Australia,14,14,,28,POINT (6170465 -7542726)
2015,Febrero,Austria,0,1,,1,POINT (3451668 -76532004)
2015,Febrero,Austria,34,33,,67,POINT (4697157 -74140516)
2015,Febrero,Austria,1,2,,3,POINT (6170465 -7542726)
2015,Febrero,Bahamas,0,1,,1,POINT (10406342 -75527794)
2015,Febrero,Bahamas,1,3,,4,POINT (10446304 -75516486)
2015,Febrero,Bahamas,2,3,,5,POINT (4697157 -74140516)
2015,Febrero,Bahamas,0,2,,2,POINT (6170465 -7542726)
2015,Febrero,Bahréin,1,1,,2,POINT (10406342 -75527794)
2015,Febrero,Bahréin,1,1,,2,POINT (4697157 -74140516)
2015,Febrero,Barbados,0,1,,1,POINT (3451668 -76532004)
2015,Febrero,Barbados,0,2,,2,POINT (4697157 -74140516)
2015,Febrero,República de Belarús,3,1,,4,POINT (4697157 -74140516)
2015,Febrero,República de Belarús,0,1,,1,POINT (7819 -72453013)
2015,Febrero,Bélgica,0,3,,3,POINT (10406342 -75527794)
2015,Febrero,Bélgica,1,4,,5,POINT (3451668 -76532004)
2015,Febrero,Bélgica,23,35,,58,POINT (4697157 -74140516)
2015,Febrero,Bélgica,3,3,,6,POINT (6170465 -7542726)
2015,Febrero,Belice,1,1,,2,POINT (10446304 -75516486)
2015,Febrero,Belice,0,5,,5,POINT (4697157 -74140516)
2015,Febrero,Bermudas/Territorio Británico de Ultramar,0,2,,2,POINT (3451668 -76532004)
2015,Febrero,Bermudas/Territorio Británico de Ultramar,1,4,,5,POINT (4697157 -74140516)
2015,Febrero,Bolivia,0,1,,1,POINT (10446304 -75516486)
2015,Febrero,Bolivia,0,1,,1,POINT (10886686 -74776479)
2015,Febrero,Bolivia,4,3,,7,POINT (125862 -81702165)
2015,Febrero,Bolivia,8,13,,21,POINT (3451668 -76532004)
2015,Febrero,Bolivia,299,466,,765,POINT (4697157 -74140516)
2015,Febrero,Bolivia,5,11,,16,POINT (6170465 -7542726)
2015,Febrero,Bolivia,1,3,,4,POINT (7128047 -73181317)
2015,Febrero,Brasil,99,129,,228,POINT (-4191162 -69941498)
2015,Febrero,Brasil,9,22,,31,POINT (-4214082 -69941431)
2015,Febrero,Brasil,0,3,,3,POINT (10406342 -75527794)
2015,Febrero,Brasil,81,49,,130,POINT (10446304 -75516486)
2015,Febrero,Brasil,6,5,,11,POINT (10886686 -74776479)
2015,Febrero,Brasil,155,123,,278,POINT (125862 -81702165)
2015,Febrero,Brasil,26,56,,82,POINT (3451668 -76532004)
2015,Febrero,Brasil,3712,5185,,8897,POINT (4697157 -74140516)
2015,Febrero,Brasil,4,7,,11,POINT (4815189 -75736374)
2015,Febrero,Brasil,199,217,,416,POINT (6170465 -7542726)
2015,Febrero,Brasil,0,1,,1,POINT (7128047 -73181317)
2015,Febrero,Brasil,1,3,,4,POINT (7927233 -72508188)
2015,Febrero,Brunei Darussalam,1,0,,1,POINT (4697157 -74140516)
2015,Febrero,Bulgaria,2,5,,7,POINT (4697157 -74140516)
2015,Febrero,Islas Caimán/Territorio Británico de Ultramar,2,11,,13,POINT (10406342 -75527794)
2015,Febrero,Islas Caimán/Territorio Británico de Ultramar,1,3,,4,POINT (10446304 -75516486)
2015,Febrero,Islas Caimán/Territorio Británico de Ultramar,1,2,,3,POINT (125744111 -81703935)
2015,Febrero,Islas Caimán/Territorio Británico de Ultramar,0,12,,12,POINT (4697157 -74140516)
2015,Febrero,Camerún,1,1,,2,POINT (4697157 -74140516)
2015,Febrero,Canadá,0,1,,1,POINT (10406342 -75527794)
2015,Febrero,Canadá,694,643,,1337,POINT (10446304 -75516486)
2015,Febrero,Canadá,12,17,,29,POINT (10886686 -74776479)
2015,Febrero,Canadá,360,323,,683,POINT (125862 -81702165)
2015,Febrero,Canadá,23,35,,58,POINT (3451668 -76532004)
2015,Febrero,Canadá,0,1,,1,POINT (445285 -75766353)
2015,Febrero,Canadá,614,924,,1538,POINT (4697157 -74140516)
2015,Febrero,Canadá,3,5,,8,POINT (4815189 -75736374)
2015,Febrero,Canadá,48,96,,144,POINT (6170465 -7542726)
2015,Febrero,Canadá,4,7,,11,POINT (7128047 -73181317)
2015,Febrero,Canadá,3,3,,6,POINT (7927233 -72508188)
2015,Febrero,Chad,0,1,,1,POINT (4697157 -74140516)
2015,Febrero,España,0,1,,1,POINT (10406342 -75527794)
2015,Febrero,España,1,2,,3,POINT (10446304 -75516486)
2015,Febrero,España,1,2,,3,POINT (10886686 -74776479)
2015,Febrero,España,0,1,,1,POINT (11247723 -74213989)
2015,Febrero,España,0,3,,3,POINT (125862 -81702165)
2015,Febrero,España,142,242,,384,POINT (3451668 -76532004)
2015,Febrero,España,2395,5274,,7669,POINT (4697157 -74140516)
2015,Febrero,España,1,1,,2,POINT (4815189 -75736374)
2015,Febrero,España,109,265,,374,POINT (6170465 -7542726)
2015,Febrero,República de Corea,14,11,,25,POINT (4697157 -74140516)
2015,Febrero,República de Corea,0,1,,1,POINT (4815189 -75736374)
2015,Febrero,República de Corea,5,4,,9,POINT (6170465 -7542726)
2015,Febrero,Costa de Marfil,1,2,,3,POINT (4697157 -74140516)
2015,Febrero,Costa Rica,1,3,,4,POINT (10406342 -75527794)
2015,Febrero,Costa Rica,2,2,,4,POINT (10446304 -75516486)
2015,Febrero,Costa Rica,4,4,,8,POINT (10886686 -74776479)
2015,Febrero,Costa Rica,0,10,,10,POINT (125744111 -81703935)
2015,Febrero,Costa Rica,42,45,,87,POINT (125862 -81702165)
2015,Febrero,Costa Rica,17,32,,49,POINT (3451668 -76532004)
2015,Febrero,Costa Rica,624,1076,,1700,POINT (4697157 -74140516)
2015,Febrero,Costa Rica,3,9,,12,POINT (4815189 -75736374)
2015,Febrero,Costa Rica,32,61,,93,POINT (6170465 -7542726)
2015,Febrero,Costa Rica,3,1,,4,POINT (7128047 -73181317)
2015,Febrero,Costa Rica,0,3,,3,POINT (7927233 -72508188)
2015,Febrero,Croacia,0,2,,2,POINT (4697157 -74140516)
2015,Febrero,Cuba,3,10,,13,POINT (10446304 -75516486)
2015,Febrero,Cuba,3,9,,12,POINT (10886686 -74776479)
2015,Febrero,Cuba,4,3,,7,POINT (3451668 -76532004)
2015,Febrero,Cuba,269,392,,661,POINT (4697157 -74140516)
2015,Febrero,Cuba,10,16,,26,POINT (6170465 -7542726)
2015,Febrero,Cuba,0,2,,2,POINT (7128047 -73181317)
2015,Febrero,Cuba,1,3,,4,POINT (7927233 -72508188)
2015,Febrero,Curazao,23,66,,89,POINT (10886686 -74776479)
2015,Febrero,Curazao,3,13,,16,POINT (11247723 -74213989)
2015,Febrero,Curazao,259,337,,596,POINT (4697157 -74140516)
2015,Febrero,Curazao,98,150,,248,POINT (6170465 -7542726)
2015,Febrero,Curazao,0,1,,1,POINT (7927233 -72508188)
2015,Febrero,República Checa,0,1,,1,POINT (3451668 -76532004)
2015,Febrero,República Checa,7,8,,15,POINT (4697157 -74140516)
2015,Febrero,Chile,24,23,,47,POINT (10446304 -75516486)
2015,Febrero,Chile,3,4,,7,POINT (10886686 -74776479)
2015,Febrero,Chile,69,73,,142,POINT (125862 -81702165)
2015,Febrero,Chile,64,88,,152,POINT (3451668 -76532004)
2015,Febrero,Chile,4834,5411,,10245,POINT (4697157 -74140516)
2015,Febrero,Chile,0,2,,2,POINT (4815189 -75736374)
2015,Febrero,Chile,81,84,,165,POINT (6170465 -7542726)
2015,Febrero,Chile,1,3,,4,POINT (7128047 -73181317)
2015,Febrero,China,26,52,,78,POINT (4697157 -74140516)
2015,Febrero,China,0,2,,2,POINT (6170465 -7542726)
2015,Febrero,Chipre,1,0,,1,POINT (4697157 -74140516)
2015,Febrero,Dinamarca,0,1,,1,POINT (10886686 -74776479)
2015,Febrero,Dinamarca,2,0,,2,POINT (3451668 -76532004)
2015,Febrero,Dinamarca,17,15,,32,POINT (4697157 -74140516)
2015,Febrero,Dinamarca,0,1,,1,POINT (4815189 -75736374)
2015,Febrero,Dinamarca,1,1,,2,POINT (6170465 -7542726)
2015,Febrero,Ecuador,40,140,,180,POINT (0.33002 -76876446)
2015,Febrero,Ecuador,2835,3846,,6681,POINT (0.81488 -77356)
2015,Febrero,Ecuador,20,31,,51,POINT (1800143 -78802679)
2015,Febrero,Ecuador,0,1,,1,POINT (10446304 -75516486)
2015,Febrero,Ecuador,1,3,,4,POINT (125862 -81702165)
2015,Febrero,Ecuador,567,668,,1235,POINT (3451668 -76532004)
2015,Febrero,Ecuador,2479,4135,,6614,POINT (4697157 -74140516)
2015,Febrero,Ecuador,0,1,,1,POINT (4815189 -75736374)
2015,Febrero,Ecuador,510,678,,1188,POINT (6170465 -7542726)
2015,Febrero,Ecuador,0,5,,5,POINT (7128047 -73181317)
2015,Febrero,Ecuador,1,0,,1,POINT (7927233 -72508188)
2015,Febrero,Egipto,2,5,,7,POINT (4697157 -74140516)
2015,Febrero,El Salvador,2,3,,5,POINT (10446304 -75516486)
2015,Febrero,El Salvador,0,1,,1,POINT (10886686 -74776479)
2015,Febrero,El Salvador,76,140,,216,POINT (3451668 -76532004)
2015,Febrero,El Salvador,606,1028,,1634,POINT (4697157 -74140516)
2015,Febrero,El Salvador,1,0,,1,POINT (4815189 -75736374)
2015,Febrero,El Salvador,101,148,,249,POINT (6170465 -7542726)
2015,Febrero,El Salvador,2,0,,2,POINT (7927233 -72508188)
2015,Febrero,Emiratos Árabes,1,3,,4,POINT (4697157 -74140516)
2015,Febrero,Emiratos Árabes,0,1,,1,POINT (6170465 -7542726)
2015,Febrero,Eslovaquia,7,4,,11,POINT (4697157 -74140516)
2015,Febrero,Eslovaquia,1,0,,1,POINT (6170465 -7542726)
2015,Febrero,Eslovenia,1,4,,5,POINT (4697157 -74140516)
2015,Febrero,Estados Unidos de América,1,11,,12,POINT (10406342 -75527794)
2015,Febrero,Estados Unidos de América,2412,3379,,5791,POINT (10446304 -75516486)
2015,Febrero,Estados Unidos de América,314,504,,818,POINT (10886686 -74776479)
2015,Febrero,Estados Unidos de América,0,3,,3,POINT (10970933 -74765343)
2015,Febrero,Estados Unidos de América,0,17,,17,POINT (11247723 -74213989)
2015,Febrero,Estados Unidos de América,13,20,,33,POINT (125862 -81702165)
2015,Febrero,Estados Unidos de América,673,1119,,1792,POINT (3451668 -76532004)
2015,Febrero,Estados Unidos de América,95,115,,210,POINT (445285 -75766353)
2015,Febrero,Estados Unidos de América,7756,14094,,21850,POINT (4697157 -74140516)
2015,Febrero,Estados Unidos de América,104,152,,256,POINT (4815189 -75736374)
2015,Febrero,Estados Unidos de América,1489,3496,,4985,POINT (6170465 -7542726)
2015,Febrero,Estados Unidos de América,11,17,,28,POINT (7128047 -73181317)
2015,Febrero,Estados Unidos de América,31,32,,63,POINT (7927233 -72508188)
2015,Febrero,Estados Unidos de América,0,1,,1,POINT (9402597 -75681642)
2015,Febrero,Estonia,6,6,,12,POINT (4697157 -74140516)
2015,Febrero,Filipinas,0,4,,4,POINT (10886686 -74776479)
2015,Febrero,Filipinas,1,12,,13,POINT (3451668 -76532004)
2015,Febrero,Filipinas,2,6,,8,POINT (4697157 -74140516)
2015,Febrero,Finlandia,0,1,,1,POINT (3451668 -76532004)
2015,Febrero,Finlandia,9,13,,22,POINT (4697157 -74140516)
2015,Febrero,Finlandia,0,1,,1,POINT (6170465 -7542726)
2015,Febrero,Francia,0,1,,1,POINT (10446304 -75516486)
2015,Febrero,Francia,1,2,,3,POINT (10886686 -74776479)
2015,Febrero,Francia,7,17,,24,POINT (3451668 -76532004)
2015,Febrero,Francia,1251,2031,,3282,POINT (4697157 -74140516)
2015,Febrero,Francia,2,3,,5,POINT (4815189 -75736374)
2015,Febrero,Francia,6,20,,26,POINT (6170465 -7542726)
2015,Febrero,Francia,1,0,,1,POINT (7128047 -73181317)
2015,Febrero,Ghana,0,4,,4,POINT (4697157 -74140516)
2015,Febrero,Granada,1,1,,2,POINT (11247723 -74213989)
2015,Febrero,Grecia,0,1,,1,POINT (10446304 -75516486)
2015,Febrero,Grecia,6,5,,11,POINT (4697157 -74140516)
2015,Febrero,Grecia,0,1,,1,POINT (6170465 -7542726)
2015,Febrero,Guatemala,60,72,,132,POINT (10446304 -75516486)
2015,Febrero,Guatemala,0,6,,6,POINT (10886686 -74776479)
2015,Febrero,Guatemala,0,2,,2,POINT (125744111 -81703935)
2015,Febrero,Guatemala,3,2,,5,POINT (125862 -81702165)
2015,Febrero,Guatemala,10,22,,32,POINT (3451668 -76532004)
2015,Febrero,Guatemala,242,537,,779,POINT (4697157 -74140516)
2015,Febrero,Guatemala,2,2,,4,POINT (4815189 -75736374)
2015,Febrero,Guatemala,25,49,,74,POINT (6170465 -7542726)
2015,Febrero,Guatemala,0,4,,4,POINT (7128047 -73181317)
2015,Febrero,Guatemala,1,4,,5,POINT (7927233 -72508188)
2015,Febrero,Guyana,0,1,,1,POINT (10886686 -74776479)
2015,Febrero,Guyana,0,1,,1,POINT (3884426 -77061029)
2015,Febrero,Guyana,1,0,,1,POINT (4697157 -74140516)
2015,Febrero,Guyana,2,0,,2,POINT (6170465 -7542726)
2015,Febrero,Guinea,0,2,,2,POINT (4697157 -74140516)
2015,Febrero,Guinea Ecuatorial,0,4,,4,POINT (4697157 -74140516)
2015,Febrero,Guadalupe/Territorio Francés,1,1,,2,POINT (6170465 -7542726)
2015,Febrero,Haití,3,12,,15,POINT (4697157 -74140516)
2015,Febrero,Honduras,3,6,,9,POINT (10406342 -75527794)
2015,Febrero,Honduras,1,2,,3,POINT (10446304 -75516486)
2015,Febrero,Honduras,1,4,,5,POINT (10886686 -74776479)
2015,Febrero,Honduras,2,7,,9,POINT (3451668 -76532004)
2015,Febrero,Honduras,51,72,,123,POINT (4697157 -74140516)
2015,Febrero,Honduras,17,42,,59,POINT (6170465 -7542726)
2015,Febrero,Honduras,1,1,,2,POINT (7927233 -72508188)
2015,Febrero,Hong Kong,1,0,,1,POINT (4697157 -74140516)
2015,Febrero,Hong Kong,1,1,,2,POINT (6170465 -7542726)
2015,Febrero,Hungría,2,5,,7,POINT (4697157 -74140516)
2015,Febrero,India,0,2,,2,POINT (3451668 -76532004)
2015,Febrero,India,6,30,,36,POINT (4697157 -74140516)
2015,Febrero,India,0,1,,1,POINT (4815189 -75736374)
2015,Febrero,India,0,2,,2,POINT (6170465 -7542726)
2015,Febrero,Indonesia,6,10,,16,POINT (4697157 -74140516)
2015,Febrero,Iraq,0,1,,1,POINT (4697157 -74140516)
2015,Febrero,Irán,1,1,,2,POINT (4697157 -74140516)
2015,Febrero,República de Irlanda,0,1,,1,POINT (10886686 -74776479)
2015,Febrero,República de Irlanda,0,2,,2,POINT (3451668 -76532004)
2015,Febrero,República de Irlanda,5,17,,22,POINT (4697157 -74140516)
2015,Febrero,Israel,0,1,,1,POINT (10446304 -75516486)
2015,Febrero,Israel,0,1,,1,POINT (3451668 -76532004)
2015,Febrero,Israel,15,58,,73,POINT (4697157 -74140516)
2015,Febrero,Israel,1,3,,4,POINT (6170465 -7542726)
2015,Febrero,Italia,1,3,,4,POINT (10886686 -74776479)
2015,Febrero,Italia,187,177,,364,POINT (125862 -81702165)
2015,Febrero,Italia,8,24,,32,POINT (3451668 -76532004)
2015,Febrero,Italia,123,315,,438,POINT (4697157 -74140516)
2015,Febrero,Italia,2,12,,14,POINT (6170465 -7542726)
2015,Febrero,Italia,0,2,,2,POINT (7128047 -73181317)
2015,Febrero,Jamaica,0,6,,6,POINT (10406342 -75527794)
2015,Febrero,Jamaica,2,3,,5,POINT (10446304 -75516486)
2015,Febrero,Jamaica,4,9,,13,POINT (10886686 -74776479)
2015,Febrero,Jamaica,0,1,,1,POINT (11117206 -74232675)
2015,Febrero,Jamaica,1,0,,1,POINT (133387613 -81372937)
2015,Febrero,Jamaica,0,2,,2,POINT (3451668 -76532004)
2015,Febrero,Jamaica,3,10,,13,POINT (4697157 -74140516)
2015,Febrero,Jamaica,0,6,,6,POINT (6170465 -7542726)
2015,Febrero,Japón,0,2,,2,POINT (10886686 -74776479)
2015,Febrero,Japón,0,3,,3,POINT (3451668 -76532004)
2015,Febrero,Japón,8,20,,28,POINT (4697157 -74140516)
2015,Febrero,Japón,2,6,,8,POINT (6170465 -7542726)
2015,Febrero,Kazajistán,1,0,,1,POINT (4697157 -74140516)
2015,Febrero,Kazajistán,0,2,,2,POINT (6170465 -7542726)
2015,Febrero,Kenia,0,1,,1,POINT (4697157 -74140516)
2015,Febrero,Kenia,1,0,,1,POINT (6170465 -7542726)
2015,Febrero,Letonia,1,0,,1,POINT (4697157 -74140516)
2015,Febrero,Lituania,1,3,,4,POINT (4697157 -74140516)
2015,Febrero,Líbano,1,0,,1,POINT (10886686 -74776479)
2015,Febrero,Líbano,4,6,,10,POINT (4697157 -74140516)
2015,Febrero,Liberia,1,0,,1,POINT (4697157 -74140516)
2015,Febrero,Luxemburgo,0,1,,1,POINT (3451668 -76532004)
2015,Febrero,Luxemburgo,2,1,,3,POINT (4697157 -74140516)
2015,Febrero,Macedonia,0,1,,1,POINT (4697157 -74140516)
2015,Febrero,Malasia,1,0,,1,POINT (4697157 -74140516)
2015,Febrero,Malta,1,0,,1,POINT (4697157 -74140516)
2015,Febrero,Martinica/Departamento de Ultramar Francés,1,1,,2,POINT (11247723 -74213989)
2015,Febrero,Martinica/Departamento de Ultramar Francés,2,1,,3,POINT (3451668 -76532004)
2015,Febrero,México,0,1,,1,POINT (10406342 -75527794)
2015,Febrero,México,13,11,,24,POINT (10446304 -75516486)
2015,Febrero,México,9,50,,59,POINT (10886686 -74776479)
2015,Febrero,México,0,1,,1,POINT (10970933 -74765343)
2015,Febrero,México,0,1,,1,POINT (11247723 -74213989)
2015,Febrero,México,0,4,,4,POINT (125744111 -81703935)
2015,Febrero,México,2,2,,4,POINT (125862 -81702165)
2015,Febrero,México,3,3,,6,POINT (133387613 -81372937)
2015,Febrero,México,27,68,,95,POINT (3451668 -76532004)
2015,Febrero,México,3251,6379,,9630,POINT (4697157 -74140516)
2015,Febrero,México,4,9,,13,POINT (4815189 -75736374)
2015,Febrero,México,195,365,,560,POINT (6170465 -7542726)
2015,Febrero,México,0,5,,5,POINT (7128047 -73181317)
2015,Febrero,México,9,5,,14,POINT (7927233 -72508188)
2015,Febrero,Mónaco,0,1,,1,POINT (4697157 -74140516)
2015,Febrero,Nicaragua,1,3,,4,POINT (10446304 -75516486)
2015,Febrero,Nicaragua,1,7,,8,POINT (125744111 -81703935)
2015,Febrero,Nicaragua,4,6,,10,POINT (3451668 -76532004)
2015,Febrero,Nicaragua,33,37,,70,POINT (4697157 -74140516)
2015,Febrero,Nicaragua,1,3,,4,POINT (4815189 -75736374)
2015,Febrero,Nicaragua,5,14,,19,POINT (6170465 -7542726)
2015,Febrero,Nigeria,0,10,,10,POINT (4697157 -74140516)
2015,Febrero,Noruega,1,2,,3,POINT (10886686 -74776479)
2015,Febrero,Noruega,0,5,,5,POINT (10970933 -74765343)
2015,Febrero,Noruega,1,1,,2,POINT (3451668 -76532004)
2015,Febrero,Noruega,15,29,,44,POINT (4697157 -74140516)
2015,Febrero,Noruega,1,5,,6,POINT (6170465 -7542726)
2015,Febrero,Nueva Zelanda,1,1,,2,POINT (10446304 -75516486)
2015,Febrero,Nueva Zelanda,0,4,,4,POINT (4697157 -74140516)
2015,Febrero,Nueva Zelanda,0,1,,1,POINT (6170465 -7542726)
2015,Febrero,Panamá,1549,1558,,3107,POINT (10406342 -75527794)
2015,Febrero,Panamá,2175,2411,,4586,POINT (10446304 -75516486)
2015,Febrero,Panamá,234,534,,768,POINT (10886686 -74776479)
2015,Febrero,Panamá,0,2,,2,POINT (11247723 -74213989)
2015,Febrero,Panamá,5,12,,17,POINT (125744111 -81703935)
2015,Febrero,Panamá,1180,984,,2164,POINT (125862 -81702165)
2015,Febrero,Panamá,26,23,,49,POINT (133387613 -81372937)
2015,Febrero,Panamá,295,503,,798,POINT (3451668 -76532004)
2015,Febrero,Panamá,0,27,,27,POINT (3884426 -77061029)
2015,Febrero,Panamá,3229,5243,,8472,POINT (4697157 -74140516)
2015,Febrero,Panamá,75,150,,225,POINT (4815189 -75736374)
2015,Febrero,Panamá,1137,1778,,2915,POINT (6170465 -7542726)
2015,Febrero,Panamá,0,3,,3,POINT (6222552 -77401154)
2015,Febrero,Panamá,4,0,,4,POINT (7102626 -77762647)
2015,Febrero,Panamá,32,54,,86,POINT (7128047 -73181317)
2015,Febrero,Panamá,89,117,,206,POINT (7927233 -72508188)
2015,Febrero,Panamá,0,1,,1,POINT (806667 -767333)
2015,Febrero,Panamá,88,83,,171,POINT (863337 -7735002)
2015,Febrero,Paraguay,3,1,,4,POINT (10446304 -75516486)
2015,Febrero,Paraguay,0,1,,1,POINT (10886686 -74776479)
2015,Febrero,Paraguay,59,44,,103,POINT (125862 -81702165)
2015,Febrero,Paraguay,3,3,,6,POINT (3451668 -76532004)
2015,Febrero,Paraguay,43,74,,117,POINT (4697157 -74140516)
2015,Febrero,Paraguay,1,0,,1,POINT (4815189 -75736374)
2015,Febrero,Paraguay,55,46,,101,POINT (6170465 -7542726)
2015,Febrero,Perú,82,109,,191,POINT (-4191162 -69941498)
2015,Febrero,Perú,6,8,,14,POINT (-4214082 -69941431)
2015,Febrero,Perú,0,1,,1,POINT (0.81488 -77356)
2015,Febrero,Perú,24,81,,105,POINT (10446304 -75516486)
2015,Febrero,Perú,2,5,,7,POINT (10886686 -74776479)
2015,Febrero,Perú,197,131,,328,POINT (125862 -81702165)
2015,Febrero,Perú,314,416,,730,POINT (3451668 -76532004)
2015,Febrero,Perú,6467,7791,,14258,POINT (4697157 -74140516)
2015,Febrero,Perú,1,2,,3,POINT (4815189 -75736374)
2015,Febrero,Perú,512,636,,1148,POINT (6170465 -7542726)
2015,Febrero,Perú,2,2,,4,POINT (7128047 -73181317)
2015,Febrero,Perú,10,9,,19,POINT (7927233 -72508188)
2015,Febrero,Polonia,0,1,,1,POINT (3451668 -76532004)
2015,Febrero,Polonia,24,35,,59,POINT (4697157 -74140516)
2015,Febrero,Polonia,0,1,,1,POINT (6170465 -7542726)
2015,Febrero,Portugal,1,0,,1,POINT (125862 -81702165)
2015,Febrero,Portugal,265,410,,675,POINT (4697157 -74140516)
2015,Febrero,Portugal,0,3,,3,POINT (6170465 -7542726)
2015,Febrero,Puerto Rico/Territorio de Estados Unidos,0,2,,2,POINT (10406342 -75527794)
2015,Febrero,Puerto Rico/Territorio de Estados Unidos,2,2,,4,POINT (10446304 -75516486)
2015,Febrero,Puerto Rico/Territorio de Estados Unidos,16,79,,95,POINT (10886686 -74776479)
2015,Febrero,Puerto Rico/Territorio de Estados Unidos,12,21,,33,POINT (3451668 -76532004)
2015,Febrero,Puerto Rico/Territorio de Estados Unidos,194,359,,553,POINT (4697157 -74140516)
2015,Febrero,Puerto Rico/Territorio de Estados Unidos,1,3,,4,POINT (4815189 -75736374)
2015,Febrero,Puerto Rico/Territorio de Estados Unidos,17,51,,68,POINT (6170465 -7542726)
2015,Febrero,Puerto Rico/Territorio de Estados Unidos,0,2,,2,POINT (7128047 -73181317)
2015,Febrero,Puerto Rico/Territorio de Estados Unidos,0,2,,2,POINT (7927233 -72508188)
2015,Febrero,Qatar,0,1,,1,POINT (4697157 -74140516)
2015,Febrero,Reino Unido de Gran Bretaña e Irlanda del Norte,1,2,,3,POINT (10446304 -75516486)
2015,Febrero,Reino Unido de Gran Bretaña e Irlanda del Norte,1,1,,2,POINT (10886686 -74776479)
2015,Febrero,Reino Unido de Gran Bretaña e Irlanda del Norte,0,4,,4,POINT (11247723 -74213989)
2015,Febrero,Reino Unido de Gran Bretaña e Irlanda del Norte,26,80,,106,POINT (3451668 -76532004)
2015,Febrero,Reino Unido de Gran Bretaña e Irlanda del Norte,444,762,,1206,POINT (4697157 -74140516)
2015,Febrero,Reino Unido de Gran Bretaña e Irlanda del Norte,7,12,,19,POINT (6170465 -7542726)
2015,Febrero,Federación de Rusia,0,1,,1,POINT (10886686 -74776479)
2015,Febrero,Federación de Rusia,22,19,,41,POINT (4697157 -74140516)
2015,Febrero,Federación de Rusia,1,0,,1,POINT (6170465 -7542726)
2015,Febrero,República Dominicana,0,1,,1,POINT (10406342 -75527794)
2015,Febrero,República Dominicana,3,8,,11,POINT (10446304 -75516486)
2015,Febrero,República Dominicana,5,21,,26,POINT (10886686 -74776479)
2015,Febrero,República Dominicana,0,2,,2,POINT (10970933 -74765343)
2015,Febrero,República Dominicana,0,1,,1,POINT (11117206 -74232675)
2015,Febrero,República Dominicana,12,33,,45,POINT (3451668 -76532004)
2015,Febrero,República Dominicana,413,664,,1077,POINT (4697157 -74140516)
2015,Febrero,República Dominicana,3,4,,7,POINT (4815189 -75736374)
2015,Febrero,República Dominicana,31,53,,84,POINT (6170465 -7542726)
2015,Febrero,República Dominicana,1,0,,1,POINT (7128047 -73181317)
2015,Febrero,República Dominicana,1,5,,6,POINT (7927233 -72508188)
2015,Febrero,República Democrática Popular de Corea,0,3,,3,POINT (6170465 -7542726)
2015,Febrero,Rumania,0,1,,1,POINT (10446304 -75516486)
2015,Febrero,Rumania,5,12,,17,POINT (4697157 -74140516)
2015,Febrero,Rwanda,0,1,,1,POINT (4697157 -74140516)
2015,Febrero,San  Vicente y las Granadinas,1,0,,1,POINT (4697157 -74140516)
2015,Febrero,Santa Lucia,1,1,,2,POINT (4697157 -74140516)
2015,Febrero,Senegal,1,0,,1,POINT (4697157 -74140516)
2015,Febrero,Singapur,2,0,,2,POINT (4697157 -74140516)
2015,Febrero,Singapur,1,1,,2,POINT (6170465 -7542726)
2015,Febrero,Sri Lanka,0,1,,1,POINT (4697157 -74140516)
2015,Febrero,Sudáfrica,4,5,,9,POINT (4697157 -74140516)
2015,Febrero,Suecia,0,1,,1,POINT (10446304 -75516486)
2015,Febrero,Suecia,0,1,,1,POINT (10886686 -74776479)
2015,Febrero,Suecia,3,3,,6,POINT (3451668 -76532004)
2015,Febrero,Suecia,36,37,,73,POINT (4697157 -74140516)
2015,Febrero,Suecia,1,4,,5,POINT (6170465 -7542726)
2015,Febrero,Suecia,0,1,,1,POINT (7927233 -72508188)
2015,Febrero,Suiza,1,0,,1,POINT (10446304 -75516486)
2015,Febrero,Suiza,2,0,,2,POINT (10886686 -74776479)
2015,Febrero,Suiza,7,16,,23,POINT (3451668 -76532004)
2015,Febrero,Suiza,71,112,,183,POINT (4697157 -74140516)
2015,Febrero,Suiza,7,12,,19,POINT (6170465 -7542726)
2015,Febrero,Suiza,1,5,,6,POINT (7128047 -73181317)
2015,Febrero,Surinam,2,1,,3,POINT (4697157 -74140516)
2015,Febrero,Surinam,3,2,,5,POINT (6170465 -7542726)
2015,Febrero,Taiwán,0,2,,2,POINT (10406342 -75527794)
2015,Febrero,Taiwán,4,4,,8,POINT (4697157 -74140516)
2015,Febrero,Taiwán,2,0,,2,POINT (6170465 -7542726)
2015,Febrero,Tailandia,1,1,,2,POINT (4697157 -74140516)
2015,Febrero,Tailandia,0,1,,1,POINT (6170465 -7542726)
2015,Febrero,Trinidad y Tobago,1,4,,5,POINT (10406342 -75527794)
2015,Febrero,Trinidad y Tobago,0,1,,1,POINT (10446304 -75516486)
2015,Febrero,Trinidad y Tobago,1,0,,1,POINT (10886686 -74776479)
2015,Febrero,Trinidad y Tobago,0,6,,6,POINT (3451668 -76532004)
2015,Febrero,Trinidad y Tobago,6,12,,18,POINT (4697157 -74140516)
2015,Febrero,Trinidad y Tobago,0,1,,1,POINT (4815189 -75736374)
2015,Febrero,Trinidad y Tobago,2,4,,6,POINT (6170465 -7542726)
2015,Febrero,Túnez,0,1,,1,POINT (4697157 -74140516)
2015,Febrero,Turquía,0,2,,2,POINT (10446304 -75516486)
2015,Febrero,Turquía,0,2,,2,POINT (3451668 -76532004)
2015,Febrero,Turquía,26,112,,138,POINT (4697157 -74140516)
2015,Febrero,Turquía,0,1,,1,POINT (6170465 -7542726)
2015,Febrero,Ucrania,0,1,,1,POINT (4697157 -74140516)
2015,Febrero,Uruguay,24,12,,36,POINT (10446304 -75516486)
2015,Febrero,Uruguay,39,33,,72,POINT (125862 -81702165)
2015,Febrero,Uruguay,10,17,,27,POINT (3451668 -76532004)
2015,Febrero,Uruguay,30,60,,90,POINT (4697157 -74140516)
2015,Febrero,Uruguay,16,26,,42,POINT (6170465 -7542726)
2015,Febrero,Uruguay,0,4,,4,POINT (7128047 -73181317)
2015,Febrero,Venezuela,0,22,,22,POINT (10406342 -75527794)
2015,Febrero,Venezuela,20,32,,52,POINT (10446304 -75516486)
2015,Febrero,Venezuela,13,71,,84,POINT (10886686 -74776479)
2015,Febrero,Venezuela,0,4,,4,POINT (10970933 -74765343)
2015,Febrero,Venezuela,2256,3048,,5304,POINT (11360029 -72129595)
2015,Febrero,Venezuela,9,22,,31,POINT (3451668 -76532004)
2015,Febrero,Venezuela,5,22,,27,POINT (3866713 -67927521)
2015,Febrero,Venezuela,2942,3699,,6641,POINT (4697157 -74140516)
2015,Febrero,Venezuela,0,1,,1,POINT (4815189 -75736374)
2015,Febrero,Venezuela,26,67,,93,POINT (6170465 -7542726)
2015,Febrero,Venezuela,305,511,,816,POINT (6185536 -67484028)
2015,Febrero,Venezuela,70,118,,188,POINT (7088729 -70740253)
2015,Febrero,Venezuela,1,5,,6,POINT (7128047 -73181317)
2015,Febrero,Venezuela,2825,3574,,6399,POINT (7819 -72453013)
2015,Febrero,Venezuela,252,282,,534,POINT (7927233 -72508188)
2015,Febrero,Vietnam,0,1,,1,POINT (4697157 -74140516)
2015,Febrero,Desconocido,0,6,,6,POINT (0.812436 -77847006)
2015,Febrero,Desconocido,1,0,,1,POINT (125862 -81702165)
2015,Febrero,Desconocido,10,19,,29,POINT (133387613 -81372937)
2015,Febrero,Desconocido,1,36,,37,POINT (4697157 -74140516)
2015,Febrero,Desconocido,0,1,,1,POINT (6170465 -7542726)
2015,Febrero,Desconocido,3,2,,5,POINT (6185536 -67484028)
2015,Febrero,Desconocido,0,1,,1,POINT (806667 -767333)
2015,Febrero,Desconocido,0,5,,5,POINT (9402597 -75681642)
2015,Marzo,Afganistán,1,0,,1,POINT (4697157 -74140516)
2015,Marzo,Afganistán,0,1,,1,POINT (6170465 -7542726)
2015,Marzo,Alemania,5,2,,7,POINT (10886686 -74776479)
2015,Marzo,Alemania,0,1,,1,POINT (125862 -81702165)
2015,Marzo,Alemania,17,27,,44,POINT (3451668 -76532004)
2015,Marzo,Alemania,1444,2506,,3950,POINT (4697157 -74140516)
2015,Marzo,Alemania,1,1,,2,POINT (4815189 -75736374)
2015,Marzo,Alemania,15,20,,35,POINT (6170465 -7542726)
2015,Marzo,Andorra,1,0,,1,POINT (4697157 -74140516)
2015,Marzo,Antigua y Barbuda,0,3,,3,POINT (10406342 -75527794)
2015,Marzo,Antigua y Barbuda,1,0,,1,POINT (10886686 -74776479)
2015,Marzo,Antigua y Barbuda,0,3,,3,POINT (4697157 -74140516)
2015,Marzo,Países Bajos,1,3,,4,POINT (10406342 -75527794)
2015,Marzo,Países Bajos,38,38,,76,POINT (10886686 -74776479)
2015,Marzo,Países Bajos,1,18,,19,POINT (11247723 -74213989)
2015,Marzo,Países Bajos,26,56,,82,POINT (3451668 -76532004)
2015,Marzo,Países Bajos,298,428,,726,POINT (4697157 -74140516)
2015,Marzo,Países Bajos,165,235,,400,POINT (6170465 -7542726)
2015,Marzo,Países Bajos,3,3,,6,POINT (7128047 -73181317)
2015,Marzo,Arabia Saudita,0,3,,3,POINT (4697157 -74140516)
2015,Marzo,Arabia Saudita,0,1,,1,POINT (4815189 -75736374)
2015,Marzo,Argelia,3,2,,5,POINT (4697157 -74140516)
2015,Marzo,Argentina,13,12,,25,POINT (0.81488 -77356)
2015,Marzo,Argentina,107,73,,180,POINT (10446304 -75516486)
2015,Marzo,Argentina,1,13,,14,POINT (10886686 -74776479)
2015,Marzo,Argentina,0,3,,3,POINT (10970933 -74765343)
2015,Marzo,Argentina,157,122,,279,POINT (125862 -81702165)
2015,Marzo,Argentina,85,111,,196,POINT (3451668 -76532004)
2015,Marzo,Argentina,2813,3577,,6390,POINT (4697157 -74140516)
2015,Marzo,Argentina,88,193,,281,POINT (6170465 -7542726)
2015,Marzo,Aruba,75,75,,150,POINT (10406342 -75527794)
2015,Marzo,Aruba,24,33,,57,POINT (10886686 -74776479)
2015,Marzo,Aruba,0,1,,1,POINT (10970933 -74765343)
2015,Marzo,Aruba,9,9,,18,POINT (11247723 -74213989)
2015,Marzo,Aruba,2,6,,8,POINT (3451668 -76532004)
2015,Marzo,Aruba,473,589,,1062,POINT (4697157 -74140516)
2015,Marzo,Aruba,9,6,,15,POINT (6170465 -7542726)
2015,Marzo,Aruba,8,3,,11,POINT (7128047 -73181317)
2015,Marzo,Australia,0,1,,1,POINT (10446304 -75516486)
2015,Marzo,Australia,0,3,,3,POINT (10886686 -74776479)
2015,Marzo,Australia,2,0,,2,POINT (125862 -81702165)
2015,Marzo,Australia,5,5,,10,POINT (3451668 -76532004)
2015,Marzo,Australia,27,39,,66,POINT (4697157 -74140516)
2015,Marzo,Australia,0,12,,12,POINT (6170465 -7542726)
2015,Marzo,Australia,0,1,,1,POINT (7128047 -73181317)
2015,Marzo,Austria,0,1,,1,POINT (10886686 -74776479)
2015,Marzo,Austria,0,2,,2,POINT (3451668 -76532004)
2015,Marzo,Austria,8,24,,32,POINT (4697157 -74140516)
2015,Marzo,Austria,0,1,,1,POINT (6170465 -7542726)
2015,Marzo,Bahamas,1,2,,3,POINT (10406342 -75527794)
2015,Marzo,Bahamas,0,3,,3,POINT (10970933 -74765343)
2015,Marzo,Bahamas,0,1,,1,POINT (4697157 -74140516)
2015,Marzo,Bahamas,0,2,,2,POINT (6170465 -7542726)
2015,Marzo,Bahréin,0,1,,1,POINT (10446304 -75516486)
2015,Marzo,Barbados,0,2,,2,POINT (10406342 -75527794)
2015,Marzo,Barbados,0,2,,2,POINT (3451668 -76532004)
2015,Marzo,Barbados,0,2,,2,POINT (4697157 -74140516)
2015,Marzo,República de Belarús,0,1,,1,POINT (4697157 -74140516)
2015,Marzo,República de Belarús,0,1,,1,POINT (7819 -72453013)
2015,Marzo,Bélgica,1,1,,2,POINT (10886686 -74776479)
2015,Marzo,Bélgica,2,2,,4,POINT (3451668 -76532004)
2015,Marzo,Bélgica,22,34,,56,POINT (4697157 -74140516)
2015,Marzo,Bélgica,4,6,,10,POINT (6170465 -7542726)
2015,Marzo,Belice,1,3,,4,POINT (4697157 -74140516)
2015,Marzo,Benín,2,0,,2,POINT (4697157 -74140516)
2015,Marzo,Bermudas/Territorio Británico de Ultramar,0,1,,1,POINT (4697157 -74140516)
2015,Marzo,Bolivia,1,0,,1,POINT (0.81488 -77356)
2015,Marzo,Bolivia,0,3,,3,POINT (11117206 -74232675)
2015,Marzo,Bolivia,1,1,,2,POINT (125862 -81702165)
2015,Marzo,Bolivia,9,7,,16,POINT (3451668 -76532004)
2015,Marzo,Bolivia,340,442,,782,POINT (4697157 -74140516)
2015,Marzo,Bolivia,13,34,,47,POINT (6170465 -7542726)
2015,Marzo,Botsuana,0,2,,2,POINT (4697157 -74140516)
2015,Marzo,Brasil,104,138,,242,POINT (-4191162 -69941498)
2015,Marzo,Brasil,15,19,,34,POINT (-4214082 -69941431)
2015,Marzo,Brasil,0,2,,2,POINT (0.81488 -77356)
2015,Marzo,Brasil,0,7,,7,POINT (10406342 -75527794)
2015,Marzo,Brasil,54,47,,101,POINT (10446304 -75516486)
2015,Marzo,Brasil,1,4,,5,POINT (10886686 -74776479)
2015,Marzo,Brasil,143,100,,243,POINT (125862 -81702165)
2015,Marzo,Brasil,39,73,,112,POINT (3451668 -76532004)
2015,Marzo,Brasil,0,4,,4,POINT (3866713 -67927521)
2015,Marzo,Brasil,3250,5314,,8564,POINT (4697157 -74140516)
2015,Marzo,Brasil,3,2,,5,POINT (4815189 -75736374)
2015,Marzo,Brasil,92,180,,272,POINT (6170465 -7542726)
2015,Marzo,Brasil,3,1,,4,POINT (7128047 -73181317)
2015,Marzo,Brasil,4,3,,7,POINT (7927233 -72508188)
2015,Marzo,Bulgaria,0,1,,1,POINT (10970933 -74765343)
2015,Marzo,Bulgaria,3,4,,7,POINT (4697157 -74140516)
2015,Marzo,Burundi,0,2,,2,POINT (4697157 -74140516)
2015,Marzo,Cabo Verde,1,0,,1,POINT (4697157 -74140516)
2015,Marzo,Islas Caimán/Territorio Británico de Ultramar,4,3,,7,POINT (10406342 -75527794)
2015,Marzo,Islas Caimán/Territorio Británico de Ultramar,1,0,,1,POINT (10886686 -74776479)
2015,Marzo,Islas Caimán/Territorio Británico de Ultramar,0,5,,5,POINT (4697157 -74140516)
2015,Marzo,Camerún,0,1,,1,POINT (4697157 -74140516)
2015,Marzo,Camerún,0,1,,1,POINT (6170465 -7542726)
2015,Marzo,Canadá,298,321,,619,POINT (10446304 -75516486)
2015,Marzo,Canadá,10,10,,20,POINT (10886686 -74776479)
2015,Marzo,Canadá,424,380,,804,POINT (125862 -81702165)
2015,Marzo,Canadá,25,45,,70,POINT (3451668 -76532004)
2015,Marzo,Canadá,589,907,,1496,POINT (4697157 -74140516)
2015,Marzo,Canadá,5,10,,15,POINT (4815189 -75736374)
2015,Marzo,Canadá,54,93,,147,POINT (6170465 -7542726)
2015,Marzo,Canadá,1,3,,4,POINT (7128047 -73181317)
2015,Marzo,Canadá,4,2,,6,POINT (7927233 -72508188)
2015,Marzo,España,0,1,,1,POINT (10446304 -75516486)
2015,Marzo,España,2,4,,6,POINT (10886686 -74776479)
2015,Marzo,España,0,4,,4,POINT (10970933 -74765343)
2015,Marzo,España,0,6,,6,POINT (11247723 -74213989)
2015,Marzo,España,1,1,,2,POINT (125862 -81702165)
2015,Marzo,España,156,277,,433,POINT (3451668 -76532004)
2015,Marzo,España,2599,5310,,7909,POINT (4697157 -74140516)
2015,Marzo,España,4,3,,7,POINT (4815189 -75736374)
2015,Marzo,España,105,264,,369,POINT (6170465 -7542726)
2015,Marzo,España,1,1,,2,POINT (7927233 -72508188)
2015,Marzo,República de Corea,1,0,,1,POINT (3451668 -76532004)
2015,Marzo,República de Corea,8,28,,36,POINT (4697157 -74140516)
2015,Marzo,República de Corea,1,2,,3,POINT (6170465 -7542726)
2015,Marzo,República de Corea,0,1,,1,POINT (7927233 -72508188)
2015,Marzo,Costa de Marfil,2,3,,5,POINT (4697157 -74140516)
2015,Marzo,Costa Rica,1,2,,3,POINT (10406342 -75527794)
2015,Marzo,Costa Rica,5,11,,16,POINT (10446304 -75516486)
2015,Marzo,Costa Rica,11,7,,18,POINT (10886686 -74776479)
2015,Marzo,Costa Rica,4,3,,7,POINT (125862 -81702165)
2015,Marzo,Costa Rica,22,41,,63,POINT (3451668 -76532004)
2015,Marzo,Costa Rica,0,2,,2,POINT (3884426 -77061029)
2015,Marzo,Costa Rica,857,1290,,2147,POINT (4697157 -74140516)
2015,Marzo,Costa Rica,7,4,,11,POINT (4815189 -75736374)
2015,Marzo,Costa Rica,45,79,,124,POINT (6170465 -7542726)
2015,Marzo,Costa Rica,5,3,,8,POINT (7128047 -73181317)
2015,Marzo,Costa Rica,0,2,,2,POINT (7927233 -72508188)
2015,Marzo,Croacia,2,4,,6,POINT (4697157 -74140516)
2015,Marzo,Cuba,1,4,,5,POINT (10446304 -75516486)
2015,Marzo,Cuba,7,9,,16,POINT (10886686 -74776479)
2015,Marzo,Cuba,1,1,,2,POINT (125862 -81702165)
2015,Marzo,Cuba,6,9,,15,POINT (3451668 -76532004)
2015,Marzo,Cuba,257,400,,657,POINT (4697157 -74140516)
2015,Marzo,Cuba,2,3,,5,POINT (4815189 -75736374)
2015,Marzo,Cuba,15,14,,29,POINT (6170465 -7542726)
2015,Marzo,Cuba,1,1,,2,POINT (7128047 -73181317)
2015,Marzo,Cuba,0,1,,1,POINT (7927233 -72508188)
2015,Marzo,República Checa,1,5,,6,POINT (4697157 -74140516)
2015,Marzo,República Checa,0,1,,1,POINT (6170465 -7542726)
2015,Marzo,Chile,2,10,,12,POINT (0.81488 -77356)
2015,Marzo,Chile,10,10,,20,POINT (10446304 -75516486)
2015,Marzo,Chile,0,3,,3,POINT (10886686 -74776479)
2015,Marzo,Chile,51,42,,93,POINT (125862 -81702165)
2015,Marzo,Chile,13,51,,64,POINT (3451668 -76532004)
2015,Marzo,Chile,4122,5642,,9764,POINT (4697157 -74140516)
2015,Marzo,Chile,0,1,,1,POINT (4815189 -75736374)
2015,Marzo,Chile,15,61,,76,POINT (6170465 -7542726)
2015,Marzo,Chile,0,1,,1,POINT (7128047 -73181317)
2015,Marzo,Chile,1,2,,3,POINT (7927233 -72508188)
2015,Marzo,China,39,132,,171,POINT (4697157 -74140516)
2015,Marzo,China,4,2,,6,POINT (6170465 -7542726)
2015,Marzo,China,0,1,,1,POINT (7927233 -72508188)
2015,Marzo,Dinamarca,18,24,,42,POINT (4697157 -74140516)
2015,Marzo,Dinamarca,1,0,,1,POINT (6170465 -7542726)
2015,Marzo,Ecuador,40,201,,241,POINT (0.33002 -76876446)
2015,Marzo,Ecuador,2905,4727,,7632,POINT (0.81488 -77356)
2015,Marzo,Ecuador,18,24,,42,POINT (1800143 -78802679)
2015,Marzo,Ecuador,0,4,,4,POINT (10886686 -74776479)
2015,Marzo,Ecuador,516,630,,1146,POINT (3451668 -76532004)
2015,Marzo,Ecuador,2708,4593,,7301,POINT (4697157 -74140516)
2015,Marzo,Ecuador,0,1,,1,POINT (4815189 -75736374)
2015,Marzo,Ecuador,492,708,,1200,POINT (6170465 -7542726)
2015,Marzo,Ecuador,1,2,,3,POINT (7128047 -73181317)
2015,Marzo,Ecuador,3,4,,7,POINT (7927233 -72508188)
2015,Marzo,Egipto,1,6,,7,POINT (4697157 -74140516)
2015,Marzo,El Salvador,4,4,,8,POINT (10446304 -75516486)
2015,Marzo,El Salvador,1,1,,2,POINT (10886686 -74776479)
2015,Marzo,El Salvador,1,4,,5,POINT (125862 -81702165)
2015,Marzo,El Salvador,83,152,,235,POINT (3451668 -76532004)
2015,Marzo,El Salvador,693,1086,,1779,POINT (4697157 -74140516)
2015,Marzo,El Salvador,114,239,,353,POINT (6170465 -7542726)
2015,Marzo,Emiratos Árabes,2,4,,6,POINT (4697157 -74140516)
2015,Marzo,Emiratos Árabes,0,1,,1,POINT (6170465 -7542726)
2015,Marzo,Eslovaquia,3,3,,6,POINT (4697157 -74140516)
2015,Marzo,Eslovenia,2,2,,4,POINT (4697157 -74140516)
2015,Marzo,Estados Unidos de América,0,1,,1,POINT (1800143 -78802679)
2015,Marzo,Estados Unidos de América,0,30,,30,POINT (10406342 -75527794)
2015,Marzo,Estados Unidos de América,2790,3959,,6749,POINT (10446304 -75516486)
2015,Marzo,Estados Unidos de América,237,458,,695,POINT (10886686 -74776479)
2015,Marzo,Estados Unidos de América,0,17,,17,POINT (10970933 -74765343)
2015,Marzo,Estados Unidos de América,0,2,,2,POINT (11117206 -74232675)
2015,Marzo,Estados Unidos de América,2,37,,39,POINT (11247723 -74213989)
2015,Marzo,Estados Unidos de América,9,10,,19,POINT (125862 -81702165)
2015,Marzo,Estados Unidos de América,888,1294,,2182,POINT (3451668 -76532004)
2015,Marzo,Estados Unidos de América,0,6,,6,POINT (3884426 -77061029)
2015,Marzo,Estados Unidos de América,114,164,,278,POINT (445285 -75766353)
2015,Marzo,Estados Unidos de América,8330,15316,,23646,POINT (4697157 -74140516)
2015,Marzo,Estados Unidos de América,103,118,,221,POINT (4815189 -75736374)
2015,Marzo,Estados Unidos de América,1670,3702,,5372,POINT (6170465 -7542726)
2015,Marzo,Estados Unidos de América,10,27,,37,POINT (7128047 -73181317)
2015,Marzo,Estados Unidos de América,47,38,,85,POINT (7927233 -72508188)
2015,Marzo,Estados Unidos de América,0,3,,3,POINT (806667 -767333)
2015,Marzo,Estonia,1,1,,2,POINT (4697157 -74140516)
2015,Marzo,Filipinas,0,2,,2,POINT (10446304 -75516486)
2015,Marzo,Filipinas,1,0,,1,POINT (10886686 -74776479)
2015,Marzo,Filipinas,0,5,,5,POINT (3451668 -76532004)
2015,Marzo,Filipinas,0,1,,1,POINT (3884426 -77061029)
2015,Marzo,Filipinas,1,21,,22,POINT (4697157 -74140516)
2015,Marzo,Filipinas,1,0,,1,POINT (6170465 -7542726)
2015,Marzo,Finlandia,2,1,,3,POINT (3451668 -76532004)
2015,Marzo,Finlandia,3,13,,16,POINT (4697157 -74140516)
2015,Marzo,Francia,0,2,,2,POINT (10446304 -75516486)
2015,Marzo,Francia,0,1,,1,POINT (10886686 -74776479)
2015,Marzo,Francia,5,24,,29,POINT (3451668 -76532004)
2015,Marzo,Francia,1087,2104,,3191,POINT (4697157 -74140516)
2015,Marzo,Francia,0,1,,1,POINT (4815189 -75736374)
2015,Marzo,Francia,11,21,,32,POINT (6170465 -7542726)
2015,Marzo,Georgia,0,4,,4,POINT (4697157 -74140516)
2015,Marzo,Gibraltar/Territorio Británico de Ultramar,1,1,,2,POINT (0.81488 -77356)
2015,Marzo,Grecia,3,5,,8,POINT (4697157 -74140516)
2015,Marzo,Guatemala,10,16,,26,POINT (10446304 -75516486)
2015,Marzo,Guatemala,0,3,,3,POINT (10886686 -74776479)
2015,Marzo,Guatemala,2,1,,3,POINT (125862 -81702165)
2015,Marzo,Guatemala,3,4,,7,POINT (133387613 -81372937)
2015,Marzo,Guatemala,19,48,,67,POINT (3451668 -76532004)
2015,Marzo,Guatemala,301,564,,865,POINT (4697157 -74140516)
2015,Marzo,Guatemala,4,6,,10,POINT (4815189 -75736374)
2015,Marzo,Guatemala,31,71,,102,POINT (6170465 -7542726)
2015,Marzo,Guatemala,0,1,,1,POINT (7128047 -73181317)
2015,Marzo,Guatemala,3,7,,10,POINT (7927233 -72508188)
2015,Marzo,Guyana,1,0,,1,POINT (4697157 -74140516)
2015,Marzo,Guinea Ecuatorial,0,3,,3,POINT (4697157 -74140516)
2015,Marzo,Guadalupe/Territorio Francés,3,6,,9,POINT (4697157 -74140516)
2015,Marzo,Guayana Francesa/Departamento de Ultramar Francés,0,1,,1,POINT (4697157 -74140516)
2015,Marzo,Haití,0,2,,2,POINT (10446304 -75516486)
2015,Marzo,Haití,2,7,,9,POINT (4697157 -74140516)
2015,Marzo,Haití,0,1,,1,POINT (6170465 -7542726)
2015,Marzo,Honduras,1,3,,4,POINT (10406342 -75527794)
2015,Marzo,Honduras,2,8,,10,POINT (10446304 -75516486)
2015,Marzo,Honduras,4,2,,6,POINT (10886686 -74776479)
2015,Marzo,Honduras,2,0,,2,POINT (125862 -81702165)
2015,Marzo,Honduras,8,9,,17,POINT (133387613 -81372937)
2015,Marzo,Honduras,1,9,,10,POINT (3451668 -76532004)
2015,Marzo,Honduras,57,73,,130,POINT (4697157 -74140516)
2015,Marzo,Honduras,4,3,,7,POINT (4815189 -75736374)
2015,Marzo,Honduras,35,41,,76,POINT (6170465 -7542726)
2015,Marzo,Honduras,2,3,,5,POINT (7927233 -72508188)
2015,Marzo,Hong Kong,3,3,,6,POINT (4697157 -74140516)
2015,Marzo,Hungría,1,2,,3,POINT (4697157 -74140516)
2015,Marzo,India,0,1,,1,POINT (10446304 -75516486)
2015,Marzo,India,0,3,,3,POINT (10886686 -74776479)
2015,Marzo,India,6,40,,46,POINT (4697157 -74140516)
2015,Marzo,India,0,2,,2,POINT (6170465 -7542726)
2015,Marzo,Indonesia,0,1,,1,POINT (3451668 -76532004)
2015,Marzo,Indonesia,2,0,,2,POINT (4697157 -74140516)
2015,Marzo,Iraq,0,1,,1,POINT (4697157 -74140516)
2015,Marzo,Irán,0,2,,2,POINT (4697157 -74140516)
2015,Marzo,República de Irlanda,0,2,,2,POINT (10446304 -75516486)
2015,Marzo,República de Irlanda,1,1,,2,POINT (125862 -81702165)
2015,Marzo,República de Irlanda,0,1,,1,POINT (3451668 -76532004)
2015,Marzo,República de Irlanda,8,11,,19,POINT (4697157 -74140516)
2015,Marzo,República de Irlanda,0,2,,2,POINT (6170465 -7542726)
2015,Marzo,Isla de Man,1,4,,5,POINT (4697157 -74140516)
2015,Marzo,Israel,2,2,,4,POINT (3451668 -76532004)
2015,Marzo,Israel,23,67,,90,POINT (4697157 -74140516)
2015,Marzo,Israel,1,1,,2,POINT (6170465 -7542726)
2015,Marzo,Israel,0,1,,1,POINT (7927233 -72508188)
2015,Marzo,Italia,49,104,,153,POINT (10446304 -75516486)
2015,Marzo,Italia,213,191,,404,POINT (125862 -81702165)
2015,Marzo,Italia,4,23,,27,POINT (3451668 -76532004)
2015,Marzo,Italia,86,237,,323,POINT (4697157 -74140516)
2015,Marzo,Italia,5,19,,24,POINT (6170465 -7542726)
2015,Marzo,Jamaica,1,1,,2,POINT (10406342 -75527794)
2015,Marzo,Jamaica,0,2,,2,POINT (10446304 -75516486)
2015,Marzo,Jamaica,0,3,,3,POINT (10886686 -74776479)
2015,Marzo,Jamaica,0,4,,4,POINT (125744111 -81703935)
2015,Marzo,Jamaica,1,1,,2,POINT (3451668 -76532004)
2015,Marzo,Jamaica,2,4,,6,POINT (4697157 -74140516)
2015,Marzo,Jamaica,0,10,,10,POINT (6170465 -7542726)
2015,Marzo,Japón,0,2,,2,POINT (3451668 -76532004)
2015,Marzo,Japón,12,36,,48,POINT (4697157 -74140516)
2015,Marzo,Japón,1,2,,3,POINT (6170465 -7542726)
2015,Marzo,Jordania,0,2,,2,POINT (4697157 -74140516)
2015,Marzo,Kenia,0,4,,4,POINT (4697157 -74140516)
2015,Marzo,Kirguistán,0,3,,3,POINT (4697157 -74140516)
2015,Marzo,Lesoto,0,1,,1,POINT (4697157 -74140516)
2015,Marzo,Letonia,0,1,,1,POINT (4697157 -74140516)
2015,Marzo,Lituania,1,0,,1,POINT (4697157 -74140516)
2015,Marzo,Líbano,1,0,,1,POINT (3451668 -76532004)
2015,Marzo,Líbano,1,7,,8,POINT (4697157 -74140516)
2015,Marzo,Liechtenstein,0,1,,1,POINT (4697157 -74140516)
2015,Marzo,Luxemburgo,2,0,,2,POINT (4697157 -74140516)
2015,Marzo,Macedonia,0,1,,1,POINT (4697157 -74140516)
2015,Marzo,Malasia,0,1,,1,POINT (10446304 -75516486)
2015,Marzo,Malasia,0,3,,3,POINT (4697157 -74140516)
2015,Marzo,Malí,0,1,,1,POINT (4697157 -74140516)
2015,Marzo,Malta,0,1,,1,POINT (4697157 -74140516)
2015,Marzo,Marruecos,1,0,,1,POINT (4697157 -74140516)
2015,Marzo,Marruecos,0,1,,1,POINT (6170465 -7542726)
2015,Marzo,Martinica/Departamento de Ultramar Francés,1,2,,3,POINT (11247723 -74213989)
2015,Marzo,Martinica/Departamento de Ultramar Francés,1,0,,1,POINT (4697157 -74140516)
2015,Marzo,México,0,4,,4,POINT (10406342 -75527794)
2015,Marzo,México,16,38,,54,POINT (10446304 -75516486)
2015,Marzo,México,8,16,,24,POINT (10886686 -74776479)
2015,Marzo,México,1,4,,5,POINT (125744111 -81703935)
2015,Marzo,México,2,3,,5,POINT (125862 -81702165)
2015,Marzo,México,39,104,,143,POINT (3451668 -76532004)
2015,Marzo,México,4404,7802,,12206,POINT (4697157 -74140516)
2015,Marzo,México,11,9,,20,POINT (4815189 -75736374)
2015,Marzo,México,357,877,,1234,POINT (6170465 -7542726)
2015,Marzo,México,3,11,,14,POINT (7128047 -73181317)
2015,Marzo,México,16,17,,33,POINT (7927233 -72508188)
2015,Marzo,Mónaco,0,1,,1,POINT (4697157 -74140516)
2015,Marzo,Mongolia,0,1,,1,POINT (4697157 -74140516)
2015,Marzo,Nicaragua,2,2,,4,POINT (10446304 -75516486)
2015,Marzo,Nicaragua,1,1,,2,POINT (10886686 -74776479)
2015,Marzo,Nicaragua,6,15,,21,POINT (125744111 -81703935)
2015,Marzo,Nicaragua,0,1,,1,POINT (125862 -81702165)
2015,Marzo,Nicaragua,1,7,,8,POINT (133387613 -81372937)
2015,Marzo,Nicaragua,5,4,,9,POINT (3451668 -76532004)
2015,Marzo,Nicaragua,21,22,,43,POINT (4697157 -74140516)
2015,Marzo,Nicaragua,0,4,,4,POINT (4815189 -75736374)
2015,Marzo,Nicaragua,4,16,,20,POINT (6170465 -7542726)
2015,Marzo,Nigeria,0,1,,1,POINT (4697157 -74140516)
2015,Marzo,Noruega,1,0,,1,POINT (10446304 -75516486)
2015,Marzo,Noruega,0,1,,1,POINT (10886686 -74776479)
2015,Marzo,Noruega,2,5,,7,POINT (3451668 -76532004)
2015,Marzo,Noruega,27,24,,51,POINT (4697157 -74140516)
2015,Marzo,Noruega,1,2,,3,POINT (7927233 -72508188)
2015,Marzo,Nueva Zelanda,0,1,,1,POINT (3451668 -76532004)
2015,Marzo,Nueva Zelanda,0,3,,3,POINT (4697157 -74140516)
2015,Marzo,Nueva Zelanda,1,2,,3,POINT (6170465 -7542726)
2015,Marzo,Pakistán,0,2,,2,POINT (4697157 -74140516)
2015,Marzo,Panamá,1093,1170,,2263,POINT (10406342 -75527794)
2015,Marzo,Panamá,2159,2644,,4803,POINT (10446304 -75516486)
2015,Marzo,Panamá,143,367,,510,POINT (10886686 -74776479)
2015,Marzo,Panamá,0,6,,6,POINT (10970933 -74765343)
2015,Marzo,Panamá,0,1,,1,POINT (11247723 -74213989)
2015,Marzo,Panamá,8,24,,32,POINT (125744111 -81703935)
2015,Marzo,Panamá,1033,866,,1899,POINT (125862 -81702165)
2015,Marzo,Panamá,5,7,,12,POINT (133387613 -81372937)
2015,Marzo,Panamá,279,533,,812,POINT (3451668 -76532004)
2015,Marzo,Panamá,1,10,,11,POINT (3884426 -77061029)
2015,Marzo,Panamá,2678,4937,,7615,POINT (4697157 -74140516)
2015,Marzo,Panamá,66,112,,178,POINT (4815189 -75736374)
2015,Marzo,Panamá,660,1453,,2113,POINT (6170465 -7542726)
2015,Marzo,Panamá,1,7,,8,POINT (6222552 -77401154)
2015,Marzo,Panamá,2,1,,3,POINT (7102626 -77762647)
2015,Marzo,Panamá,30,31,,61,POINT (7128047 -73181317)
2015,Marzo,Panamá,115,120,,235,POINT (7927233 -72508188)
2015,Marzo,Panamá,0,4,,4,POINT (806667 -767333)
2015,Marzo,Panamá,90,100,,190,POINT (863337 -7735002)
2015,Marzo,Paraguay,10,9,,19,POINT (10446304 -75516486)
2015,Marzo,Paraguay,2,1,,3,POINT (10886686 -74776479)
2015,Marzo,Paraguay,39,25,,64,POINT (125862 -81702165)
2015,Marzo,Paraguay,3,5,,8,POINT (3451668 -76532004)
2015,Marzo,Paraguay,41,53,,94,POINT (4697157 -74140516)
2015,Marzo,Paraguay,10,9,,19,POINT (6170465 -7542726)
2015,Marzo,Perú,108,186,,294,POINT (-4191162 -69941498)
2015,Marzo,Perú,14,19,,33,POINT (-4214082 -69941431)
2015,Marzo,Perú,17,26,,43,POINT (0.81488 -77356)
2015,Marzo,Perú,0,30,,30,POINT (10406342 -75527794)
2015,Marzo,Perú,16,10,,26,POINT (10446304 -75516486)
2015,Marzo,Perú,1,5,,6,POINT (10886686 -74776479)
2015,Marzo,Perú,108,77,,185,POINT (125862 -81702165)
2015,Marzo,Perú,225,392,,617,POINT (3451668 -76532004)
2015,Marzo,Perú,0,4,,4,POINT (3884426 -77061029)
2015,Marzo,Perú,5565,7724,,13289,POINT (4697157 -74140516)
2015,Marzo,Perú,0,1,,1,POINT (4815189 -75736374)
2015,Marzo,Perú,297,646,,943,POINT (6170465 -7542726)
2015,Marzo,Perú,1,4,,5,POINT (7927233 -72508188)
2015,Marzo,Polonia,0,1,,1,POINT (10446304 -75516486)
2015,Marzo,Polonia,2,0,,2,POINT (3451668 -76532004)
2015,Marzo,Polonia,16,13,,29,POINT (4697157 -74140516)
2015,Marzo,Polonia,0,1,,1,POINT (6170465 -7542726)
2015,Marzo,Portugal,1,2,,3,POINT (3451668 -76532004)
2015,Marzo,Portugal,250,441,,691,POINT (4697157 -74140516)
2015,Marzo,Portugal,0,1,,1,POINT (6170465 -7542726)
2015,Marzo,Puerto Rico/Territorio de Estados Unidos,1,1,,2,POINT (10446304 -75516486)
2015,Marzo,Puerto Rico/Territorio de Estados Unidos,13,54,,67,POINT (10886686 -74776479)
2015,Marzo,Puerto Rico/Territorio de Estados Unidos,0,1,,1,POINT (10970933 -74765343)
2015,Marzo,Puerto Rico/Territorio de Estados Unidos,27,36,,63,POINT (3451668 -76532004)
2015,Marzo,Puerto Rico/Territorio de Estados Unidos,231,392,,623,POINT (4697157 -74140516)
2015,Marzo,Puerto Rico/Territorio de Estados Unidos,1,5,,6,POINT (4815189 -75736374)
2015,Marzo,Puerto Rico/Territorio de Estados Unidos,24,77,,101,POINT (6170465 -7542726)
2015,Marzo,Puerto Rico/Territorio de Estados Unidos,1,3,,4,POINT (7128047 -73181317)
2015,Marzo,Puerto Rico/Territorio de Estados Unidos,2,1,,3,POINT (7927233 -72508188)
2015,Marzo,Reino Unido de Gran Bretaña e Irlanda del Norte,0,3,,3,POINT (10446304 -75516486)
2015,Marzo,Reino Unido de Gran Bretaña e Irlanda del Norte,0,1,,1,POINT (10886686 -74776479)
2015,Marzo,Reino Unido de Gran Bretaña e Irlanda del Norte,2,8,,10,POINT (3451668 -76532004)
2015,Marzo,Reino Unido de Gran Bretaña e Irlanda del Norte,465,828,,1293,POINT (4697157 -74140516)
2015,Marzo,Reino Unido de Gran Bretaña e Irlanda del Norte,1,1,,2,POINT (4815189 -75736374)
2015,Marzo,Reino Unido de Gran Bretaña e Irlanda del Norte,5,9,,14,POINT (6170465 -7542726)
2015,Marzo,Federación de Rusia,0,1,,1,POINT (10446304 -75516486)
2015,Marzo,Federación de Rusia,0,1,,1,POINT (3451668 -76532004)
2015,Marzo,Federación de Rusia,30,55,,85,POINT (4697157 -74140516)
2015,Marzo,República Dominicana,0,4,,4,POINT (10406342 -75527794)
2015,Marzo,República Dominicana,1,7,,8,POINT (10446304 -75516486)
2015,Marzo,República Dominicana,6,20,,26,POINT (10886686 -74776479)
2015,Marzo,República Dominicana,0,1,,1,POINT (10970933 -74765343)
2015,Marzo,República Dominicana,2,2,,4,POINT (125862 -81702165)
2015,Marzo,República Dominicana,18,33,,51,POINT (3451668 -76532004)
2015,Marzo,República Dominicana,367,607,,974,POINT (4697157 -74140516)
2015,Marzo,República Dominicana,3,7,,10,POINT (4815189 -75736374)
2015,Marzo,República Dominicana,22,55,,77,POINT (6170465 -7542726)
2015,Marzo,República Dominicana,1,0,,1,POINT (7128047 -73181317)
2015,Marzo,República Dominicana,1,3,,4,POINT (7927233 -72508188)
2015,Marzo,Reunión,1,1,,2,POINT (4697157 -74140516)
2015,Marzo,Rumania,4,7,,11,POINT (4697157 -74140516)
2015,Marzo,San Pedro y Miquelón/territorio de Ultramar de La Unión Europea,0,1,,1,POINT (4697157 -74140516)
2015,Marzo,San  Vicente y las Granadinas,7,8,,15,POINT (10406342 -75527794)
2015,Marzo,Santa Lucia,0,1,,1,POINT (4697157 -74140516)
2015,Marzo,Serbia,0,1,,1,POINT (4697157 -74140516)
2015,Marzo,Singapur,1,4,,5,POINT (4697157 -74140516)
2015,Marzo,Singapur,0,1,,1,POINT (6170465 -7542726)
2015,Marzo,Sri Lanka,0,1,,1,POINT (4697157 -74140516)
2015,Marzo,Sudáfrica,4,5,,9,POINT (4697157 -74140516)
2015,Marzo,Suecia,1,0,,1,POINT (10446304 -75516486)
2015,Marzo,Suecia,0,2,,2,POINT (10886686 -74776479)
2015,Marzo,Suecia,2,0,,2,POINT (3451668 -76532004)
2015,Marzo,Suecia,21,40,,61,POINT (4697157 -74140516)
2015,Marzo,Suecia,3,5,,8,POINT (6170465 -7542726)
2015,Marzo,Suiza,0,1,,1,POINT (10446304 -75516486)
2015,Marzo,Suiza,1,8,,9,POINT (10886686 -74776479)
2015,Marzo,Suiza,0,1,,1,POINT (125862 -81702165)
2015,Marzo,Suiza,2,10,,12,POINT (3451668 -76532004)
2015,Marzo,Suiza,53,115,,168,POINT (4697157 -74140516)
2015,Marzo,Suiza,3,15,,18,POINT (6170465 -7542726)
2015,Marzo,Surinam,2,3,,5,POINT (4697157 -74140516)
2015,Marzo,Surinam,1,2,,3,POINT (6170465 -7542726)
2015,Marzo,Taiwán,2,4,,6,POINT (4697157 -74140516)
2015,Marzo,Taiwán,0,1,,1,POINT (6170465 -7542726)
2015,Marzo,Tailandia,2,3,,5,POINT (4697157 -74140516)
2015,Marzo,Tanzania,0,1,,1,POINT (3451668 -76532004)
2015,Marzo,Tanzania,0,2,,2,POINT (4697157 -74140516)
2015,Marzo,Trinidad y Tobago,1,0,,1,POINT (10406342 -75527794)
2015,Marzo,Trinidad y Tobago,0,1,,1,POINT (10446304 -75516486)
2015,Marzo,Trinidad y Tobago,0,1,,1,POINT (10970933 -74765343)
2015,Marzo,Trinidad y Tobago,4,7,,11,POINT (3451668 -76532004)
2015,Marzo,Trinidad y Tobago,7,17,,24,POINT (4697157 -74140516)
2015,Marzo,Trinidad y Tobago,0,1,,1,POINT (6170465 -7542726)
2015,Marzo,Trinidad y Tobago,1,2,,3,POINT (7128047 -73181317)
2015,Marzo,Túnez,0,2,,2,POINT (4697157 -74140516)
2015,Marzo,Turkmenistán,0,1,,1,POINT (6170465 -7542726)
2015,Marzo,Turquía,2,1,,3,POINT (3451668 -76532004)
2015,Marzo,Turquía,12,7,,19,POINT (4697157 -74140516)
2015,Marzo,Turquía,2,3,,5,POINT (6170465 -7542726)
2015,Marzo,Ucrania,5,8,,13,POINT (4697157 -74140516)
2015,Marzo,Uganda,1,0,,1,POINT (4697157 -74140516)
2015,Marzo,Uruguay,10,11,,21,POINT (10446304 -75516486)
2015,Marzo,Uruguay,0,1,,1,POINT (10886686 -74776479)
2015,Marzo,Uruguay,41,31,,72,POINT (125862 -81702165)
2015,Marzo,Uruguay,4,16,,20,POINT (3451668 -76532004)
2015,Marzo,Uruguay,50,60,,110,POINT (4697157 -74140516)
2015,Marzo,Uruguay,16,26,,42,POINT (6170465 -7542726)
2015,Marzo,Uruguay,0,1,,1,POINT (7128047 -73181317)
2015,Marzo,Uruguay,2,1,,3,POINT (7927233 -72508188)
2015,Marzo,Venezuela,1,28,,29,POINT (10406342 -75527794)
2015,Marzo,Venezuela,57,104,,161,POINT (10446304 -75516486)
2015,Marzo,Venezuela,7,68,,75,POINT (10886686 -74776479)
2015,Marzo,Venezuela,0,7,,7,POINT (10970933 -74765343)
2015,Marzo,Venezuela,2142,2691,,4833,POINT (11360029 -72129595)
2015,Marzo,Venezuela,7,14,,21,POINT (3451668 -76532004)
2015,Marzo,Venezuela,11,12,,23,POINT (3866713 -67927521)
2015,Marzo,Venezuela,0,1,,1,POINT (3884426 -77061029)
2015,Marzo,Venezuela,3645,4259,,7904,POINT (4697157 -74140516)
2015,Marzo,Venezuela,5,6,,11,POINT (4815189 -75736374)
2015,Marzo,Venezuela,31,83,,114,POINT (6170465 -7542726)
2015,Marzo,Venezuela,124,228,,352,POINT (6185536 -67484028)
2015,Marzo,Venezuela,142,227,,369,POINT (7088729 -70740253)
2015,Marzo,Venezuela,4,7,,11,POINT (7128047 -73181317)
2015,Marzo,Venezuela,3270,4232,,7502,POINT (7819 -72453013)
2015,Marzo,Venezuela,265,326,,591,POINT (7927233 -72508188)
2015,Marzo,Vietnam,0,1,,1,POINT (4697157 -74140516)
2015,Marzo,Islas Vírgenes Británicas/Territorio Británico de Ultramar,0,1,,1,POINT (10406342 -75527794)
2015,Marzo,Islas Vírgenes Británicas/Territorio Británico de Ultramar,0,1,,1,POINT (10446304 -75516486)
2015,Marzo,Islas Vírgenes Británicas/Territorio Británico de Ultramar,0,3,,3,POINT (4697157 -74140516)
2015,Marzo,Islas Vírgenes Estadounidenses/Territorio de Estados Unidos,0,2,,2,POINT (4697157 -74140516)
2015,Marzo,Desconocido,0,2,,2,POINT (0.812436 -77847006)
2015,Marzo,Desconocido,2,5,,7,POINT (133387613 -81372937)
2015,Marzo,Desconocido,0,1,,1,POINT (3451668 -76532004)
2015,Marzo,Desconocido,2,40,,42,POINT (4697157 -74140516)
2015,Marzo,Desconocido,0,2,,2,POINT (6170465 -7542726)
2015,Marzo,Desconocido,14,39,,53,POINT (6185536 -67484028)
2015,Marzo,Desconocido,0,5,,5,POINT (9402597 -75681642)
2015,Abril,Albania,1,0,,1,POINT (4697157 -74140516)
2015,Abril,Alemania,1,1,,2,POINT (10886686 -74776479)
2015,Abril,Alemania,0,1,,1,POINT (125862 -81702165)
2015,Abril,Alemania,34,47,,81,POINT (3451668 -76532004)
2015,Abril,Alemania,1044,1978,,3022,POINT (4697157 -74140516)
2015,Abril,Alemania,2,4,,6,POINT (4815189 -75736374)
2015,Abril,Alemania,11,10,,21,POINT (6170465 -7542726)
2015,Abril,Andorra,1,0,,1,POINT (4697157 -74140516)
2015,Abril,Antigua y Barbuda,5,6,,11,POINT (10406342 -75527794)
2015,Abril,Antigua y Barbuda,1,2,,3,POINT (10446304 -75516486)
2015,Abril,Antigua y Barbuda,3,2,,5,POINT (11247723 -74213989)
2015,Abril,Antigua y Barbuda,1,3,,4,POINT (4697157 -74140516)
2015,Abril,Antigua y Barbuda,0,1,,1,POINT (6170465 -7542726)
2015,Abril,Países Bajos,38,55,,93,POINT (10886686 -74776479)
2015,Abril,Países Bajos,0,3,,3,POINT (11117206 -74232675)
2015,Abril,Países Bajos,2,2,,4,POINT (11247723 -74213989)
2015,Abril,Países Bajos,0,9,,9,POINT (125862 -81702165)
2015,Abril,Países Bajos,109,181,,290,POINT (3451668 -76532004)
2015,Abril,Países Bajos,749,1192,,1941,POINT (4697157 -74140516)
2015,Abril,Países Bajos,0,1,,1,POINT (4815189 -75736374)
2015,Abril,Países Bajos,247,282,,529,POINT (6170465 -7542726)
2015,Abril,Países Bajos,3,1,,4,POINT (7128047 -73181317)
2015,Abril,Arabia Saudita,0,3,,3,POINT (4697157 -74140516)
2015,Abril,Arabia Saudita,0,2,,2,POINT (6170465 -7542726)
2015,Abril,Argelia,0,2,,2,POINT (4697157 -74140516)
2015,Abril,Argentina,5,8,,13,POINT (0.81488 -77356)
2015,Abril,Argentina,147,93,,240,POINT (10446304 -75516486)
2015,Abril,Argentina,3,3,,6,POINT (10886686 -74776479)
2015,Abril,Argentina,96,63,,159,POINT (125862 -81702165)
2015,Abril,Argentina,64,84,,148,POINT (3451668 -76532004)
2015,Abril,Argentina,2026,2739,,4765,POINT (4697157 -74140516)
2015,Abril,Argentina,0,1,,1,POINT (4815189 -75736374)
2015,Abril,Argentina,60,113,,173,POINT (6170465 -7542726)
2015,Abril,Argentina,1,0,,1,POINT (7128047 -73181317)
2015,Abril,Aruba,35,25,,60,POINT (10406342 -75527794)
2015,Abril,Aruba,12,29,,41,POINT (10886686 -74776479)
2015,Abril,Aruba,0,2,,2,POINT (10970933 -74765343)
2015,Abril,Aruba,6,8,,14,POINT (11247723 -74213989)
2015,Abril,Aruba,8,2,,10,POINT (3451668 -76532004)
2015,Abril,Aruba,575,737,,1312,POINT (4697157 -74140516)
2015,Abril,Aruba,1,1,,2,POINT (4815189 -75736374)
2015,Abril,Aruba,121,93,,214,POINT (6170465 -7542726)
2015,Abril,Aruba,13,14,,27,POINT (7128047 -73181317)
2015,Abril,Aruba,1,0,,1,POINT (7927233 -72508188)
2015,Abril,Australia,0,1,,1,POINT (10446304 -75516486)
2015,Abril,Australia,0,3,,3,POINT (3451668 -76532004)
2015,Abril,Australia,11,21,,32,POINT (4697157 -74140516)
2015,Abril,Australia,2,0,,2,POINT (4815189 -75736374)
2015,Abril,Australia,2,10,,12,POINT (6170465 -7542726)
2015,Abril,Australia,1,0,,1,POINT (7927233 -72508188)
2015,Abril,Austria,0,1,,1,POINT (10446304 -75516486)
2015,Abril,Austria,0,1,,1,POINT (3451668 -76532004)
2015,Abril,Austria,10,28,,38,POINT (4697157 -74140516)
2015,Abril,Austria,0,1,,1,POINT (6170465 -7542726)
2015,Abril,Bahamas,2,5,,7,POINT (10406342 -75527794)
2015,Abril,Bahamas,1,0,,1,POINT (10446304 -75516486)
2015,Abril,Bahamas,1,3,,4,POINT (6170465 -7542726)
2015,Abril,Bahréin,0,1,,1,POINT (7819 -72453013)
2015,Abril,Barbados,0,1,,1,POINT (3451668 -76532004)
2015,Abril,Barbados,0,7,,7,POINT (4697157 -74140516)
2015,Abril,Barbados,1,0,,1,POINT (7128047 -73181317)
2015,Abril,República de Belarús,1,1,,2,POINT (4697157 -74140516)
2015,Abril,República de Belarús,0,1,,1,POINT (7819 -72453013)
2015,Abril,Bélgica,1,3,,4,POINT (3451668 -76532004)
2015,Abril,Bélgica,19,24,,43,POINT (4697157 -74140516)
2015,Abril,Bélgica,1,6,,7,POINT (6170465 -7542726)
2015,Abril,Belice,2,3,,5,POINT (4697157 -74140516)
2015,Abril,Belice,0,1,,1,POINT (6170465 -7542726)
2015,Abril,Bermudas/Territorio Británico de Ultramar,0,2,,2,POINT (10446304 -75516486)
2015,Abril,Bolivia,12,20,,32,POINT (3451668 -76532004)
2015,Abril,Bolivia,341,508,,849,POINT (4697157 -74140516)
2015,Abril,Bolivia,0,1,,1,POINT (4815189 -75736374)
2015,Abril,Bolivia,21,30,,51,POINT (6170465 -7542726)
2015,Abril,Brasil,105,126,,231,POINT (-4191162 -69941498)
2015,Abril,Brasil,10,20,,30,POINT (-4214082 -69941431)
2015,Abril,Brasil,1,1,,2,POINT (0.81488 -77356)
2015,Abril,Brasil,0,3,,3,POINT (10406342 -75527794)
2015,Abril,Brasil,76,61,,137,POINT (10446304 -75516486)
2015,Abril,Brasil,5,3,,8,POINT (10886686 -74776479)
2015,Abril,Brasil,94,71,,165,POINT (125862 -81702165)
2015,Abril,Brasil,39,72,,111,POINT (3451668 -76532004)
2015,Abril,Brasil,3561,5119,,8680,POINT (4697157 -74140516)
2015,Abril,Brasil,1,5,,6,POINT (4815189 -75736374)
2015,Abril,Brasil,139,160,,299,POINT (6170465 -7542726)
2015,Abril,Brasil,0,1,,1,POINT (7128047 -73181317)
2015,Abril,Brasil,7,2,,9,POINT (7927233 -72508188)
2015,Abril,Bulgaria,0,1,,1,POINT (3451668 -76532004)
2015,Abril,Bulgaria,3,7,,10,POINT (4697157 -74140516)
2015,Abril,Islas Caimán/Territorio Británico de Ultramar,0,1,,1,POINT (133387613 -81372937)
2015,Abril,Islas Caimán/Territorio Británico de Ultramar,0,1,,1,POINT (6170465 -7542726)
2015,Abril,Camerún,1,0,,1,POINT (4697157 -74140516)
2015,Abril,Canadá,6,8,,14,POINT (10446304 -75516486)
2015,Abril,Canadá,1,4,,5,POINT (10886686 -74776479)
2015,Abril,Canadá,3,2,,5,POINT (125862 -81702165)
2015,Abril,Canadá,19,54,,73,POINT (3451668 -76532004)
2015,Abril,Canadá,472,750,,1222,POINT (4697157 -74140516)
2015,Abril,Canadá,5,8,,13,POINT (4815189 -75736374)
2015,Abril,Canadá,33,96,,129,POINT (6170465 -7542726)
2015,Abril,Canadá,1,4,,5,POINT (7128047 -73181317)
2015,Abril,Canadá,6,6,,12,POINT (7927233 -72508188)
2015,Abril,España,2,1,,3,POINT (10446304 -75516486)
2015,Abril,España,1,1,,2,POINT (10886686 -74776479)
2015,Abril,España,151,278,,429,POINT (3451668 -76532004)
2015,Abril,España,2328,4804,,7132,POINT (4697157 -74140516)
2015,Abril,España,1,2,,3,POINT (4815189 -75736374)
2015,Abril,España,93,230,,323,POINT (6170465 -7542726)
2015,Abril,España,2,0,,2,POINT (7128047 -73181317)
2015,Abril,España,1,14,,15,POINT (7927233 -72508188)
2015,Abril,República de Corea,0,1,,1,POINT (3451668 -76532004)
2015,Abril,República de Corea,54,176,,230,POINT (4697157 -74140516)
2015,Abril,República de Corea,0,2,,2,POINT (6170465 -7542726)
2015,Abril,Costa de Marfil,0,1,,1,POINT (10446304 -75516486)
2015,Abril,Costa de Marfil,1,6,,7,POINT (4697157 -74140516)
2015,Abril,Costa Rica,14,16,,30,POINT (10406342 -75527794)
2015,Abril,Costa Rica,6,12,,18,POINT (10446304 -75516486)
2015,Abril,Costa Rica,1,12,,13,POINT (10886686 -74776479)
2015,Abril,Costa Rica,0,1,,1,POINT (11247723 -74213989)
2015,Abril,Costa Rica,2,3,,5,POINT (125744111 -81703935)
2015,Abril,Costa Rica,1,1,,2,POINT (125862 -81702165)
2015,Abril,Costa Rica,31,53,,84,POINT (3451668 -76532004)
2015,Abril,Costa Rica,714,1259,,1973,POINT (4697157 -74140516)
2015,Abril,Costa Rica,2,5,,7,POINT (4815189 -75736374)
2015,Abril,Costa Rica,59,110,,169,POINT (6170465 -7542726)
2015,Abril,Costa Rica,1,0,,1,POINT (7128047 -73181317)
2015,Abril,Costa Rica,4,1,,5,POINT (7927233 -72508188)
2015,Abril,Croacia,0,1,,1,POINT (4697157 -74140516)
2015,Abril,Cuba,3,1,,4,POINT (10446304 -75516486)
2015,Abril,Cuba,1,5,,6,POINT (10886686 -74776479)
2015,Abril,Cuba,9,13,,22,POINT (3451668 -76532004)
2015,Abril,Cuba,415,538,,953,POINT (4697157 -74140516)
2015,Abril,Cuba,1,0,,1,POINT (4815189 -75736374)
2015,Abril,Cuba,18,13,,31,POINT (6170465 -7542726)
2015,Abril,Cuba,6,5,,11,POINT (7927233 -72508188)
2015,Abril,República Checa,1,0,,1,POINT (3451668 -76532004)
2015,Abril,República Checa,5,7,,12,POINT (4697157 -74140516)
2015,Abril,Chile,1,6,,7,POINT (0.81488 -77356)
2015,Abril,Chile,9,8,,17,POINT (10446304 -75516486)
2015,Abril,Chile,5,4,,9,POINT (125862 -81702165)
2015,Abril,Chile,20,29,,49,POINT (3451668 -76532004)
2015,Abril,Chile,3881,5180,,9061,POINT (4697157 -74140516)
2015,Abril,Chile,12,36,,48,POINT (6170465 -7542726)
2015,Abril,Chile,0,3,,3,POINT (7128047 -73181317)
2015,Abril,China,1,3,,4,POINT (3451668 -76532004)
2015,Abril,China,28,102,,130,POINT (4697157 -74140516)
2015,Abril,China,1,2,,3,POINT (6170465 -7542726)
2015,Abril,Dinamarca,0,2,,2,POINT (3451668 -76532004)
2015,Abril,Dinamarca,10,5,,15,POINT (4697157 -74140516)
2015,Abril,Dinamarca,1,2,,3,POINT (6170465 -7542726)
2015,Abril,Dinamarca,0,1,,1,POINT (7927233 -72508188)
2015,Abril,Ecuador,52,164,,216,POINT (0.33002 -76876446)
2015,Abril,Ecuador,1,13,,14,POINT (0.812436 -77847006)
2015,Abril,Ecuador,2835,4273,,7108,POINT (0.81488 -77356)
2015,Abril,Ecuador,35,38,,73,POINT (1800143 -78802679)
2015,Abril,Ecuador,2,4,,6,POINT (10446304 -75516486)
2015,Abril,Ecuador,2,3,,5,POINT (10886686 -74776479)
2015,Abril,Ecuador,3,3,,6,POINT (125862 -81702165)
2015,Abril,Ecuador,432,461,,893,POINT (3451668 -76532004)
2015,Abril,Ecuador,0,1,,1,POINT (3884426 -77061029)
2015,Abril,Ecuador,3504,5049,,8553,POINT (4697157 -74140516)
2015,Abril,Ecuador,1,3,,4,POINT (4815189 -75736374)
2015,Abril,Ecuador,3,17,,20,POINT (6170465 -7542726)
2015,Abril,Ecuador,5,5,,10,POINT (7128047 -73181317)
2015,Abril,Ecuador,4,15,,19,POINT (7927233 -72508188)
2015,Abril,Egipto,0,5,,5,POINT (4697157 -74140516)
2015,Abril,El Salvador,1,2,,3,POINT (10446304 -75516486)
2015,Abril,El Salvador,3,7,,10,POINT (10886686 -74776479)
2015,Abril,El Salvador,6,4,,10,POINT (125862 -81702165)
2015,Abril,El Salvador,77,120,,197,POINT (3451668 -76532004)
2015,Abril,El Salvador,751,1160,,1911,POINT (4697157 -74140516)
2015,Abril,El Salvador,0,1,,1,POINT (4815189 -75736374)
2015,Abril,El Salvador,118,181,,299,POINT (6170465 -7542726)
2015,Abril,Emiratos Árabes,3,4,,7,POINT (4697157 -74140516)
2015,Abril,Eritrea,1,0,,1,POINT (3451668 -76532004)
2015,Abril,Eritrea,0,1,,1,POINT (4697157 -74140516)
2015,Abril,Eslovaquia,1,1,,2,POINT (4697157 -74140516)
2015,Abril,Eslovenia,0,3,,3,POINT (4697157 -74140516)
2015,Abril,Eslovenia,0,1,,1,POINT (6170465 -7542726)
2015,Abril,Estados Unidos de América,9,55,,64,POINT (10406342 -75527794)
2015,Abril,Estados Unidos de América,2012,3039,,5051,POINT (10446304 -75516486)
2015,Abril,Estados Unidos de América,238,437,,675,POINT (10886686 -74776479)
2015,Abril,Estados Unidos de América,0,3,,3,POINT (10970933 -74765343)
2015,Abril,Estados Unidos de América,1,3,,4,POINT (11117206 -74232675)
2015,Abril,Estados Unidos de América,1,24,,25,POINT (11247723 -74213989)
2015,Abril,Estados Unidos de América,0,3,,3,POINT (125744111 -81703935)
2015,Abril,Estados Unidos de América,11,16,,27,POINT (125862 -81702165)
2015,Abril,Estados Unidos de América,785,1121,,1906,POINT (3451668 -76532004)
2015,Abril,Estados Unidos de América,0,1,,1,POINT (3884426 -77061029)
2015,Abril,Estados Unidos de América,88,121,,209,POINT (445285 -75766353)
2015,Abril,Estados Unidos de América,6504,12593,,19097,POINT (4697157 -74140516)
2015,Abril,Estados Unidos de América,99,134,,233,POINT (4815189 -75736374)
2015,Abril,Estados Unidos de América,1434,3459,,4893,POINT (6170465 -7542726)
2015,Abril,Estados Unidos de América,12,32,,44,POINT (7128047 -73181317)
2015,Abril,Estados Unidos de América,53,56,,109,POINT (7927233 -72508188)
2015,Abril,Estados Unidos de América,0,1,,1,POINT (806667 -767333)
2015,Abril,Estados Unidos de América,0,2,,2,POINT (9402597 -75681642)
2015,Abril,Estonia,0,4,,4,POINT (4697157 -74140516)
2015,Abril,Etiopia,1,1,,2,POINT (4697157 -74140516)
2015,Abril,Filipinas,0,3,,3,POINT (10886686 -74776479)
2015,Abril,Filipinas,0,1,,1,POINT (3451668 -76532004)
2015,Abril,Filipinas,2,9,,11,POINT (4697157 -74140516)
2015,Abril,Filipinas,0,1,,1,POINT (6170465 -7542726)
2015,Abril,Finlandia,0,1,,1,POINT (3451668 -76532004)
2015,Abril,Finlandia,2,4,,6,POINT (4697157 -74140516)
2015,Abril,Finlandia,0,1,,1,POINT (6170465 -7542726)
2015,Abril,Francia,1,2,,3,POINT (10886686 -74776479)
2015,Abril,Francia,8,19,,27,POINT (3451668 -76532004)
2015,Abril,Francia,952,1845,,2797,POINT (4697157 -74140516)
2015,Abril,Francia,1,1,,2,POINT (4815189 -75736374)
2015,Abril,Francia,10,16,,26,POINT (6170465 -7542726)
2015,Abril,Gibraltar/Territorio Británico de Ultramar,1,0,,1,POINT (0.81488 -77356)
2015,Abril,Granada,0,5,,5,POINT (10406342 -75527794)
2015,Abril,Granada,1,0,,1,POINT (4697157 -74140516)
2015,Abril,Grecia,3,10,,13,POINT (4697157 -74140516)
2015,Abril,Guatemala,8,10,,18,POINT (10446304 -75516486)
2015,Abril,Guatemala,3,11,,14,POINT (10886686 -74776479)
2015,Abril,Guatemala,3,0,,3,POINT (125862 -81702165)
2015,Abril,Guatemala,26,55,,81,POINT (3451668 -76532004)
2015,Abril,Guatemala,225,512,,737,POINT (4697157 -74140516)
2015,Abril,Guatemala,1,3,,4,POINT (4815189 -75736374)
2015,Abril,Guatemala,29,91,,120,POINT (6170465 -7542726)
2015,Abril,Guatemala,0,2,,2,POINT (7128047 -73181317)
2015,Abril,Guatemala,1,0,,1,POINT (7927233 -72508188)
2015,Abril,Guyana,0,2,,2,POINT (3451668 -76532004)
2015,Abril,Guyana,1,1,,2,POINT (4697157 -74140516)
2015,Abril,Guyana,1,0,,1,POINT (6170465 -7542726)
2015,Abril,Guyana,1,0,,1,POINT (7927233 -72508188)
2015,Abril,Guadalupe/Territorio Francés,1,3,,4,POINT (4697157 -74140516)
2015,Abril,Guadalupe/Territorio Francés,0,1,,1,POINT (6170465 -7542726)
2015,Abril,Guayana Francesa/Departamento de Ultramar Francés,3,1,,4,POINT (3451668 -76532004)
2015,Abril,Guayana Francesa/Departamento de Ultramar Francés,0,1,,1,POINT (4697157 -74140516)
2015,Abril,Haití,0,2,,2,POINT (3451668 -76532004)
2015,Abril,Haití,0,24,,24,POINT (4697157 -74140516)
2015,Abril,Haití,0,2,,2,POINT (6170465 -7542726)
2015,Abril,Honduras,0,1,,1,POINT (10446304 -75516486)
2015,Abril,Honduras,0,1,,1,POINT (10886686 -74776479)
2015,Abril,Honduras,0,2,,2,POINT (125744111 -81703935)
2015,Abril,Honduras,0,1,,1,POINT (125862 -81702165)
2015,Abril,Honduras,1,1,,2,POINT (133387613 -81372937)
2015,Abril,Honduras,7,20,,27,POINT (3451668 -76532004)
2015,Abril,Honduras,39,63,,102,POINT (4697157 -74140516)
2015,Abril,Honduras,1,2,,3,POINT (4815189 -75736374)
2015,Abril,Honduras,41,47,,88,POINT (6170465 -7542726)
2015,Abril,Honduras,1,0,,1,POINT (7128047 -73181317)
2015,Abril,Honduras,0,1,,1,POINT (7927233 -72508188)
2015,Abril,Hong Kong,1,4,,5,POINT (4697157 -74140516)
2015,Abril,Hong Kong,0,1,,1,POINT (6170465 -7542726)
2015,Abril,Hungría,1,3,,4,POINT (4697157 -74140516)
2015,Abril,India,0,1,,1,POINT (10886686 -74776479)
2015,Abril,India,1,9,,10,POINT (3451668 -76532004)
2015,Abril,India,5,28,,33,POINT (4697157 -74140516)
2015,Abril,India,0,1,,1,POINT (6170465 -7542726)
2015,Abril,Indonesia,0,1,,1,POINT (4697157 -74140516)
2015,Abril,Iraq,0,1,,1,POINT (3451668 -76532004)
2015,Abril,Irán,0,1,,1,POINT (4697157 -74140516)
2015,Abril,República de Irlanda,1,2,,3,POINT (3451668 -76532004)
2015,Abril,República de Irlanda,3,5,,8,POINT (4697157 -74140516)
2015,Abril,República de Irlanda,0,1,,1,POINT (6170465 -7542726)
2015,Abril,Islandia,1,1,,2,POINT (4697157 -74140516)
2015,Abril,Israel,2,7,,9,POINT (3451668 -76532004)
2015,Abril,Israel,15,83,,98,POINT (4697157 -74140516)
2015,Abril,Israel,0,3,,3,POINT (6170465 -7542726)
2015,Abril,Italia,0,2,,2,POINT (10886686 -74776479)
2015,Abril,Italia,40,36,,76,POINT (125862 -81702165)
2015,Abril,Italia,12,22,,34,POINT (3451668 -76532004)
2015,Abril,Italia,49,187,,236,POINT (4697157 -74140516)
2015,Abril,Italia,0,1,,1,POINT (4815189 -75736374)
2015,Abril,Italia,7,23,,30,POINT (6170465 -7542726)
2015,Abril,Jamaica,1,5,,6,POINT (10406342 -75527794)
2015,Abril,Jamaica,1,0,,1,POINT (10886686 -74776479)
2015,Abril,Jamaica,0,1,,1,POINT (10970933 -74765343)
2015,Abril,Jamaica,0,3,,3,POINT (11117206 -74232675)
2015,Abril,Jamaica,7,6,,13,POINT (133387613 -81372937)
2015,Abril,Jamaica,0,4,,4,POINT (4697157 -74140516)
2015,Abril,Jamaica,1,4,,5,POINT (6170465 -7542726)
2015,Abril,Japón,0,3,,3,POINT (3451668 -76532004)
2015,Abril,Japón,6,20,,26,POINT (4697157 -74140516)
2015,Abril,Japón,0,1,,1,POINT (4815189 -75736374)
2015,Abril,Japón,0,1,,1,POINT (6170465 -7542726)
2015,Abril,Kazajistán,0,1,,1,POINT (4697157 -74140516)
2015,Abril,Kenia,2,0,,2,POINT (3451668 -76532004)
2015,Abril,Kenia,0,11,,11,POINT (4697157 -74140516)
2015,Abril,Letonia,1,0,,1,POINT (4697157 -74140516)
2015,Abril,Lituania,1,0,,1,POINT (4697157 -74140516)
2015,Abril,Líbano,2,4,,6,POINT (4697157 -74140516)
2015,Abril,Liechtenstein,2,2,,4,POINT (4697157 -74140516)
2015,Abril,Luxemburgo,2,6,,8,POINT (4697157 -74140516)
2015,Abril,Luxemburgo,2,2,,4,POINT (6170465 -7542726)
2015,Abril,Macedonia,0,1,,1,POINT (4697157 -74140516)
2015,Abril,Malasia,2,11,,13,POINT (4697157 -74140516)
2015,Abril,Malta,0,1,,1,POINT (6170465 -7542726)
2015,Abril,Marruecos,0,2,,2,POINT (10970933 -74765343)
2015,Abril,Marruecos,1,2,,3,POINT (4697157 -74140516)
2015,Abril,Marruecos,1,0,,1,POINT (6170465 -7542726)
2015,Abril,Martinica/Departamento de Ultramar Francés,0,2,,2,POINT (10406342 -75527794)
2015,Abril,México,0,6,,6,POINT (10406342 -75527794)
2015,Abril,México,113,52,,165,POINT (10446304 -75516486)
2015,Abril,México,7,16,,23,POINT (10886686 -74776479)
2015,Abril,México,0,1,,1,POINT (125744111 -81703935)
2015,Abril,México,1,4,,5,POINT (125862 -81702165)
2015,Abril,México,42,131,,173,POINT (3451668 -76532004)
2015,Abril,México,4322,7855,,12177,POINT (4697157 -74140516)
2015,Abril,México,13,16,,29,POINT (4815189 -75736374)
2015,Abril,México,278,712,,990,POINT (6170465 -7542726)
2015,Abril,México,1,6,,7,POINT (7128047 -73181317)
2015,Abril,México,13,21,,34,POINT (7927233 -72508188)
2015,Abril,Mónaco,1,0,,1,POINT (4697157 -74140516)
2015,Abril,Montenegro,0,2,,2,POINT (4697157 -74140516)
2015,Abril,Namibia,0,1,,1,POINT (4697157 -74140516)
2015,Abril,Nicaragua,1,2,,3,POINT (10446304 -75516486)
2015,Abril,Nicaragua,0,1,,1,POINT (10886686 -74776479)
2015,Abril,Nicaragua,1,1,,2,POINT (125862 -81702165)
2015,Abril,Nicaragua,1,1,,2,POINT (133387613 -81372937)
2015,Abril,Nicaragua,5,10,,15,POINT (3451668 -76532004)
2015,Abril,Nicaragua,22,37,,59,POINT (4697157 -74140516)
2015,Abril,Nicaragua,1,2,,3,POINT (4815189 -75736374)
2015,Abril,Nicaragua,3,16,,19,POINT (6170465 -7542726)
2015,Abril,Nicaragua,1,0,,1,POINT (7128047 -73181317)
2015,Abril,Noruega,5,11,,16,POINT (4697157 -74140516)
2015,Abril,Noruega,2,0,,2,POINT (6170465 -7542726)
2015,Abril,Nueva Caledonia/Territorio francés,0,2,,2,POINT (4697157 -74140516)
2015,Abril,Nueva Zelanda,0,1,,1,POINT (125862 -81702165)
2015,Abril,Nueva Zelanda,5,7,,12,POINT (4697157 -74140516)
2015,Abril,Panamá,947,902,,1849,POINT (10406342 -75527794)
2015,Abril,Panamá,0,3,,3,POINT (10433609 -73247863)
2015,Abril,Panamá,1830,1881,,3711,POINT (10446304 -75516486)
2015,Abril,Panamá,139,321,,460,POINT (10886686 -74776479)
2015,Abril,Panamá,0,2,,2,POINT (10970933 -74765343)
2015,Abril,Panamá,2,6,,8,POINT (11247723 -74213989)
2015,Abril,Panamá,3,6,,9,POINT (125744111 -81703935)
2015,Abril,Panamá,1164,921,,2085,POINT (125862 -81702165)
2015,Abril,Panamá,16,16,,32,POINT (133387613 -81372937)
2015,Abril,Panamá,233,413,,646,POINT (3451668 -76532004)
2015,Abril,Panamá,0,10,,10,POINT (3884426 -77061029)
2015,Abril,Panamá,2993,4885,,7878,POINT (4697157 -74140516)
2015,Abril,Panamá,40,111,,151,POINT (4815189 -75736374)
2015,Abril,Panamá,819,1487,,2306,POINT (6170465 -7542726)
2015,Abril,Panamá,0,1,,1,POINT (6222552 -77401154)
2015,Abril,Panamá,1,4,,5,POINT (7102626 -77762647)
2015,Abril,Panamá,13,39,,52,POINT (7128047 -73181317)
2015,Abril,Panamá,150,174,,324,POINT (7927233 -72508188)
2015,Abril,Panamá,67,73,,140,POINT (863337 -7735002)
2015,Abril,Paraguay,1,0,,1,POINT (0.81488 -77356)
2015,Abril,Paraguay,12,8,,20,POINT (10446304 -75516486)
2015,Abril,Paraguay,19,13,,32,POINT (125862 -81702165)
2015,Abril,Paraguay,8,6,,14,POINT (3451668 -76532004)
2015,Abril,Paraguay,51,59,,110,POINT (4697157 -74140516)
2015,Abril,Paraguay,6,22,,28,POINT (6170465 -7542726)
2015,Abril,Perú,151,238,,389,POINT (-4191162 -69941498)
2015,Abril,Perú,4,10,,14,POINT (-4214082 -69941431)
2015,Abril,Perú,12,22,,34,POINT (0.81488 -77356)
2015,Abril,Perú,18,12,,30,POINT (10446304 -75516486)
2015,Abril,Perú,1,1,,2,POINT (10886686 -74776479)
2015,Abril,Perú,0,1,,1,POINT (11247723 -74213989)
2015,Abril,Perú,53,41,,94,POINT (125862 -81702165)
2015,Abril,Perú,322,424,,746,POINT (3451668 -76532004)
2015,Abril,Perú,5229,7485,,12714,POINT (4697157 -74140516)
2015,Abril,Perú,329,537,,866,POINT (6170465 -7542726)
2015,Abril,Perú,2,4,,6,POINT (7927233 -72508188)
2015,Abril,Polonia,2,2,,4,POINT (3451668 -76532004)
2015,Abril,Polonia,10,12,,22,POINT (4697157 -74140516)
2015,Abril,Portugal,0,1,,1,POINT (3451668 -76532004)
2015,Abril,Portugal,221,356,,577,POINT (4697157 -74140516)
2015,Abril,Portugal,0,1,,1,POINT (6170465 -7542726)
2015,Abril,Puerto Rico/Territorio de Estados Unidos,1,7,,8,POINT (10446304 -75516486)
2015,Abril,Puerto Rico/Territorio de Estados Unidos,0,25,,25,POINT (10886686 -74776479)
2015,Abril,Puerto Rico/Territorio de Estados Unidos,18,33,,51,POINT (3451668 -76532004)
2015,Abril,Puerto Rico/Territorio de Estados Unidos,254,329,,583,POINT (4697157 -74140516)
2015,Abril,Puerto Rico/Territorio de Estados Unidos,0,2,,2,POINT (4815189 -75736374)
2015,Abril,Puerto Rico/Territorio de Estados Unidos,35,75,,110,POINT (6170465 -7542726)
2015,Abril,Puerto Rico/Territorio de Estados Unidos,2,2,,4,POINT (7128047 -73181317)
2015,Abril,Qatar,0,1,,1,POINT (4697157 -74140516)
2015,Abril,Reino Unido de Gran Bretaña e Irlanda del Norte,0,1,,1,POINT (10446304 -75516486)
2015,Abril,Reino Unido de Gran Bretaña e Irlanda del Norte,8,14,,22,POINT (3451668 -76532004)
2015,Abril,Reino Unido de Gran Bretaña e Irlanda del Norte,295,557,,852,POINT (4697157 -74140516)
2015,Abril,Reino Unido de Gran Bretaña e Irlanda del Norte,3,15,,18,POINT (6170465 -7542726)
2015,Abril,Reino Unido de Gran Bretaña e Irlanda del Norte,0,1,,1,POINT (7128047 -73181317)
2015,Abril,República CentroÁfricana,0,3,,3,POINT (10406342 -75527794)
2015,Abril,República CentroÁfricana,1,1,,2,POINT (4697157 -74140516)
2015,Abril,Federación de Rusia,0,2,,2,POINT (3451668 -76532004)
2015,Abril,Federación de Rusia,13,24,,37,POINT (4697157 -74140516)
2015,Abril,Federación de Rusia,3,1,,4,POINT (6170465 -7542726)
2015,Abril,República Dominicana,0,1,,1,POINT (10406342 -75527794)
2015,Abril,República Dominicana,3,5,,8,POINT (10446304 -75516486)
2015,Abril,República Dominicana,6,15,,21,POINT (10886686 -74776479)
2015,Abril,República Dominicana,0,1,,1,POINT (10970933 -74765343)
2015,Abril,República Dominicana,0,1,,1,POINT (11117206 -74232675)
2015,Abril,República Dominicana,0,3,,3,POINT (125862 -81702165)
2015,Abril,República Dominicana,24,20,,44,POINT (3451668 -76532004)
2015,Abril,República Dominicana,353,551,,904,POINT (4697157 -74140516)
2015,Abril,República Dominicana,2,2,,4,POINT (4815189 -75736374)
2015,Abril,República Dominicana,32,34,,66,POINT (6170465 -7542726)
2015,Abril,República Dominicana,0,2,,2,POINT (7128047 -73181317)
2015,Abril,República Dominicana,1,3,,4,POINT (7927233 -72508188)
2015,Abril,República Democrática Popular de Corea,0,1,,1,POINT (3451668 -76532004)
2015,Abril,Rumania,0,1,,1,POINT (3451668 -76532004)
2015,Abril,Rumania,2,8,,10,POINT (4697157 -74140516)
2015,Abril,Rumania,0,1,,1,POINT (6170465 -7542726)
2015,Abril,San Marino,1,3,,4,POINT (11247723 -74213989)
2015,Abril,San Marino,0,1,,1,POINT (4697157 -74140516)
2015,Abril,Santa Lucia,0,1,,1,POINT (125862 -81702165)
2015,Abril,Santa Lucia,1,1,,2,POINT (4697157 -74140516)
2015,Abril,Santa Sede/Ciudad del Vaticano,0,1,,1,POINT (4697157 -74140516)
2015,Abril,Singapur,0,1,,1,POINT (3451668 -76532004)
2015,Abril,Singapur,0,2,,2,POINT (4697157 -74140516)
2015,Abril,República Árabe Siria,1,0,,1,POINT (4697157 -74140516)
2015,Abril,Sri Lanka,1,0,,1,POINT (4697157 -74140516)
2015,Abril,Sudáfrica,5,8,,13,POINT (4697157 -74140516)
2015,Abril,Sudáfrica,0,1,,1,POINT (6170465 -7542726)
2015,Abril,Suecia,2,5,,7,POINT (3451668 -76532004)
2015,Abril,Suecia,17,17,,34,POINT (4697157 -74140516)
2015,Abril,Suecia,1,4,,5,POINT (6170465 -7542726)
2015,Abril,Suiza,1,1,,2,POINT (10446304 -75516486)
2015,Abril,Suiza,0,1,,1,POINT (125862 -81702165)
2015,Abril,Suiza,10,13,,23,POINT (3451668 -76532004)
2015,Abril,Suiza,51,66,,117,POINT (4697157 -74140516)
2015,Abril,Suiza,3,6,,9,POINT (6170465 -7542726)
2015,Abril,Surinam,1,0,,1,POINT (3451668 -76532004)
2015,Abril,Surinam,1,1,,2,POINT (4697157 -74140516)
2015,Abril,Surinam,2,2,,4,POINT (6170465 -7542726)
2015,Abril,Taiwán,1,1,,2,POINT (4697157 -74140516)
2015,Abril,Taiwán,2,6,,8,POINT (6170465 -7542726)
2015,Abril,Trinidad y Tobago,0,1,,1,POINT (10886686 -74776479)
2015,Abril,Trinidad y Tobago,2,24,,26,POINT (11247723 -74213989)
2015,Abril,Trinidad y Tobago,5,5,,10,POINT (3451668 -76532004)
2015,Abril,Trinidad y Tobago,5,14,,19,POINT (4697157 -74140516)
2015,Abril,Trinidad y Tobago,0,4,,4,POINT (6170465 -7542726)
2015,Abril,Trinidad y Tobago,0,1,,1,POINT (7128047 -73181317)
2015,Abril,Trinidad y Tobago,0,1,,1,POINT (7927233 -72508188)
2015,Abril,Túnez,0,1,,1,POINT (4697157 -74140516)
2015,Abril,Turquía,0,1,,1,POINT (3451668 -76532004)
2015,Abril,Turquía,2,15,,17,POINT (4697157 -74140516)
2015,Abril,Turquía,0,2,,2,POINT (6170465 -7542726)
2015,Abril,Ucrania,2,1,,3,POINT (4697157 -74140516)
2015,Abril,Uruguay,1,1,,2,POINT (0.81488 -77356)
2015,Abril,Uruguay,20,15,,35,POINT (10446304 -75516486)
2015,Abril,Uruguay,2,4,,6,POINT (10886686 -74776479)
2015,Abril,Uruguay,12,9,,21,POINT (125862 -81702165)
2015,Abril,Uruguay,13,15,,28,POINT (3451668 -76532004)
2015,Abril,Uruguay,44,70,,114,POINT (4697157 -74140516)
2015,Abril,Uruguay,1,0,,1,POINT (4815189 -75736374)
2015,Abril,Uruguay,15,25,,40,POINT (6170465 -7542726)
2015,Abril,Uruguay,0,1,,1,POINT (7128047 -73181317)
2015,Abril,Uruguay,1,1,,2,POINT (7927233 -72508188)
2015,Abril,Venezuela,0,9,,9,POINT (10406342 -75527794)
2015,Abril,Venezuela,4,13,,17,POINT (10433609 -73247863)
2015,Abril,Venezuela,8,28,,36,POINT (10446304 -75516486)
2015,Abril,Venezuela,5,65,,70,POINT (10886686 -74776479)
2015,Abril,Venezuela,0,5,,5,POINT (11247723 -74213989)
2015,Abril,Venezuela,1775,2840,,4615,POINT (11360029 -72129595)
2015,Abril,Venezuela,9,18,,27,POINT (3451668 -76532004)
2015,Abril,Venezuela,9,10,,19,POINT (3866713 -67927521)
2015,Abril,Venezuela,3686,4295,,7981,POINT (4697157 -74140516)
2015,Abril,Venezuela,0,1,,1,POINT (4815189 -75736374)
2015,Abril,Venezuela,52,100,,152,POINT (6170465 -7542726)
2015,Abril,Venezuela,149,264,,413,POINT (6185536 -67484028)
2015,Abril,Venezuela,65,122,,187,POINT (7088729 -70740253)
2015,Abril,Venezuela,2,3,,5,POINT (7128047 -73181317)
2015,Abril,Venezuela,2712,3840,,6552,POINT (7819 -72453013)
2015,Abril,Venezuela,193,234,,427,POINT (7927233 -72508188)
2015,Abril,Islas Vírgenes Estadounidenses/Territorio de Estados Unidos,0,1,,1,POINT (10886686 -74776479)
2015,Abril,República Árabe de Yemen,1,1,,2,POINT (4697157 -74140516)
2015,Abril,Islas Turcas y Caicos/Territorio Británico de Ultramar,0,2,,2,POINT (4697157 -74140516)
2015,Abril,Desconocido,0,1,,1,POINT (0.812436 -77847006)
2015,Abril,Desconocido,2,45,,47,POINT (4697157 -74140516)
2015,Abril,Desconocido,13,36,,49,POINT (6185536 -67484028)
2015,Abril,Desconocido,1,8,,9,POINT (9402597 -75681642)
2015,Mayo,Afganistán,0,2,,2,POINT (4697157 -74140516)
2015,Mayo,Alemania,1,1,,2,POINT (10886686 -74776479)
2015,Mayo,Alemania,31,36,,67,POINT (3451668 -76532004)
2015,Mayo,Alemania,1032,1931,,2963,POINT (4697157 -74140516)
2015,Mayo,Alemania,2,1,,3,POINT (4815189 -75736374)
2015,Mayo,Alemania,4,8,,12,POINT (6170465 -7542726)
2015,Mayo,Alemania,1,0,,1,POINT (7927233 -72508188)
2015,Mayo,Antigua y Barbuda,2,2,,4,POINT (10446304 -75516486)
2015,Mayo,Antigua y Barbuda,0,2,,2,POINT (4697157 -74140516)
2015,Mayo,Países Bajos,0,1,,1,POINT (10406342 -75527794)
2015,Mayo,Países Bajos,0,1,,1,POINT (10446304 -75516486)
2015,Mayo,Países Bajos,49,49,,98,POINT (10886686 -74776479)
2015,Mayo,Países Bajos,2,4,,6,POINT (11247723 -74213989)
2015,Mayo,Países Bajos,70,155,,225,POINT (3451668 -76532004)
2015,Mayo,Países Bajos,621,955,,1576,POINT (4697157 -74140516)
2015,Mayo,Países Bajos,0,1,,1,POINT (4815189 -75736374)
2015,Mayo,Países Bajos,238,270,,508,POINT (6170465 -7542726)
2015,Mayo,Países Bajos,8,1,,9,POINT (7128047 -73181317)
2015,Mayo,Países Bajos,3,1,,4,POINT (7927233 -72508188)
2015,Mayo,Arabia Saudita,1,1,,2,POINT (4697157 -74140516)
2015,Mayo,Argelia,1,0,,1,POINT (3451668 -76532004)
2015,Mayo,Argelia,0,5,,5,POINT (4697157 -74140516)
2015,Mayo,Argentina,1,7,,8,POINT (0.81488 -77356)
2015,Mayo,Argentina,109,57,,166,POINT (10446304 -75516486)
2015,Mayo,Argentina,6,5,,11,POINT (10886686 -74776479)
2015,Mayo,Argentina,39,31,,70,POINT (125862 -81702165)
2015,Mayo,Argentina,48,87,,135,POINT (3451668 -76532004)
2015,Mayo,Argentina,2159,3090,,5249,POINT (4697157 -74140516)
2015,Mayo,Argentina,1,1,,2,POINT (4815189 -75736374)
2015,Mayo,Argentina,71,123,,194,POINT (6170465 -7542726)
2015,Mayo,Argentina,0,1,,1,POINT (7128047 -73181317)
2015,Mayo,Argentina,2,5,,7,POINT (7927233 -72508188)
2015,Mayo,Aruba,12,14,,26,POINT (10406342 -75527794)
2015,Mayo,Aruba,11,7,,18,POINT (10886686 -74776479)
2015,Mayo,Aruba,9,22,,31,POINT (11247723 -74213989)
2015,Mayo,Aruba,10,3,,13,POINT (3451668 -76532004)
2015,Mayo,Aruba,599,750,,1349,POINT (4697157 -74140516)
2015,Mayo,Aruba,6,7,,13,POINT (6170465 -7542726)
2015,Mayo,Aruba,5,7,,12,POINT (7128047 -73181317)
2015,Mayo,Aruba,1,1,,2,POINT (7927233 -72508188)
2015,Mayo,Australia,0,1,,1,POINT (10446304 -75516486)
2015,Mayo,Australia,2,2,,4,POINT (10886686 -74776479)
2015,Mayo,Australia,0,1,,1,POINT (125862 -81702165)
2015,Mayo,Australia,5,7,,12,POINT (3451668 -76532004)
2015,Mayo,Australia,17,28,,45,POINT (4697157 -74140516)
2015,Mayo,Australia,0,2,,2,POINT (4815189 -75736374)
2015,Mayo,Australia,5,17,,22,POINT (6170465 -7542726)
2015,Mayo,Austria,0,2,,2,POINT (10446304 -75516486)
2015,Mayo,Austria,1,1,,2,POINT (10886686 -74776479)
2015,Mayo,Austria,1,2,,3,POINT (3451668 -76532004)
2015,Mayo,Austria,16,24,,40,POINT (4697157 -74140516)
2015,Mayo,Austria,2,0,,2,POINT (6170465 -7542726)
2015,Mayo,Bahamas,0,3,,3,POINT (10446304 -75516486)
2015,Mayo,Bahamas,0,1,,1,POINT (11247723 -74213989)
2015,Mayo,Bahamas,0,1,,1,POINT (4697157 -74140516)
2015,Mayo,Bahréin,1,3,,4,POINT (4697157 -74140516)
2015,Mayo,Bahréin,0,1,,1,POINT (7819 -72453013)
2015,Mayo,Barbados,0,2,,2,POINT (10970933 -74765343)
2015,Mayo,Barbados,1,0,,1,POINT (6170465 -7542726)
2015,Mayo,República de Belarús,0,1,,1,POINT (11360029 -72129595)
2015,Mayo,República de Belarús,0,3,,3,POINT (4697157 -74140516)
2015,Mayo,República de Belarús,1,0,,1,POINT (7819 -72453013)
2015,Mayo,Bélgica,3,4,,7,POINT (3451668 -76532004)
2015,Mayo,Bélgica,12,33,,45,POINT (4697157 -74140516)
2015,Mayo,Bélgica,1,4,,5,POINT (6170465 -7542726)
2015,Mayo,Belice,0,1,,1,POINT (10446304 -75516486)
2015,Mayo,Belice,1,4,,5,POINT (4697157 -74140516)
2015,Mayo,Bermudas/Territorio Británico de Ultramar,0,1,,1,POINT (4697157 -74140516)
2015,Mayo,Bermudas/Territorio Británico de Ultramar,0,1,,1,POINT (6170465 -7542726)
2015,Mayo,Bolivia,2,2,,4,POINT (0.81488 -77356)
2015,Mayo,Bolivia,5,3,,8,POINT (10446304 -75516486)
2015,Mayo,Bolivia,14,18,,32,POINT (3451668 -76532004)
2015,Mayo,Bolivia,329,538,,867,POINT (4697157 -74140516)
2015,Mayo,Bolivia,25,18,,43,POINT (6170465 -7542726)
2015,Mayo,Brasil,94,227,,321,POINT (-4191162 -69941498)
2015,Mayo,Brasil,8,10,,18,POINT (-4214082 -69941431)
2015,Mayo,Brasil,0,1,,1,POINT (0.81488 -77356)
2015,Mayo,Brasil,27,28,,55,POINT (10446304 -75516486)
2015,Mayo,Brasil,5,7,,12,POINT (10886686 -74776479)
2015,Mayo,Brasil,17,12,,29,POINT (125862 -81702165)
2015,Mayo,Brasil,36,67,,103,POINT (3451668 -76532004)
2015,Mayo,Brasil,3432,5697,,9129,POINT (4697157 -74140516)
2015,Mayo,Brasil,1,5,,6,POINT (4815189 -75736374)
2015,Mayo,Brasil,90,166,,256,POINT (6170465 -7542726)
2015,Mayo,Brasil,0,3,,3,POINT (7128047 -73181317)
2015,Mayo,Brasil,3,2,,5,POINT (7927233 -72508188)
2015,Mayo,Bulgaria,3,5,,8,POINT (4697157 -74140516)
2015,Mayo,Bulgaria,1,2,,3,POINT (6170465 -7542726)
2015,Mayo,Islas Caimán/Territorio Británico de Ultramar,0,1,,1,POINT (10970933 -74765343)
2015,Mayo,Islas Caimán/Territorio Británico de Ultramar,4,5,,9,POINT (133387613 -81372937)
2015,Mayo,Islas Caimán/Territorio Británico de Ultramar,1,0,,1,POINT (3451668 -76532004)
2015,Mayo,Islas Caimán/Territorio Británico de Ultramar,0,3,,3,POINT (4697157 -74140516)
2015,Mayo,Antártida,0,1,,1,POINT (11247723 -74213989)
2015,Mayo,Canadá,5,11,,16,POINT (10446304 -75516486)
2015,Mayo,Canadá,2,8,,10,POINT (10886686 -74776479)
2015,Mayo,Canadá,0,1,,1,POINT (10970933 -74765343)
2015,Mayo,Canadá,36,45,,81,POINT (3451668 -76532004)
2015,Mayo,Canadá,452,749,,1201,POINT (4697157 -74140516)
2015,Mayo,Canadá,7,5,,12,POINT (4815189 -75736374)
2015,Mayo,Canadá,41,86,,127,POINT (6170465 -7542726)
2015,Mayo,Canadá,0,2,,2,POINT (7128047 -73181317)
2015,Mayo,Canadá,0,1,,1,POINT (7927233 -72508188)
2015,Mayo,España,0,1,,1,POINT (10446304 -75516486)
2015,Mayo,España,0,1,,1,POINT (10886686 -74776479)
2015,Mayo,España,147,258,,405,POINT (3451668 -76532004)
2015,Mayo,España,2394,4966,,7360,POINT (4697157 -74140516)
2015,Mayo,España,3,3,,6,POINT (4815189 -75736374)
2015,Mayo,España,93,227,,320,POINT (6170465 -7542726)
2015,Mayo,España,1,1,,2,POINT (7927233 -72508188)
2015,Mayo,República de Corea,1,2,,3,POINT (3451668 -76532004)
2015,Mayo,República de Corea,4,14,,18,POINT (4697157 -74140516)
2015,Mayo,República de Corea,2,3,,5,POINT (6170465 -7542726)
2015,Mayo,República de Corea,0,1,,1,POINT (7927233 -72508188)
2015,Mayo,Costa de Marfil,2,1,,3,POINT (4697157 -74140516)
2015,Mayo,Costa Rica,0,3,,3,POINT (10406342 -75527794)
2015,Mayo,Costa Rica,3,7,,10,POINT (10446304 -75516486)
2015,Mayo,Costa Rica,1,3,,4,POINT (10886686 -74776479)
2015,Mayo,Costa Rica,0,1,,1,POINT (10970933 -74765343)
2015,Mayo,Costa Rica,3,1,,4,POINT (125862 -81702165)
2015,Mayo,Costa Rica,25,41,,66,POINT (3451668 -76532004)
2015,Mayo,Costa Rica,777,1323,,2100,POINT (4697157 -74140516)
2015,Mayo,Costa Rica,4,4,,8,POINT (4815189 -75736374)
2015,Mayo,Costa Rica,83,135,,218,POINT (6170465 -7542726)
2015,Mayo,Costa Rica,1,0,,1,POINT (7128047 -73181317)
2015,Mayo,Costa Rica,5,5,,10,POINT (7927233 -72508188)
2015,Mayo,Croacia,0,1,,1,POINT (10446304 -75516486)
2015,Mayo,Croacia,0,4,,4,POINT (4697157 -74140516)
2015,Mayo,Cuba,1,1,,2,POINT (10406342 -75527794)
2015,Mayo,Cuba,6,8,,14,POINT (10886686 -74776479)
2015,Mayo,Cuba,11,10,,21,POINT (3451668 -76532004)
2015,Mayo,Cuba,420,546,,966,POINT (4697157 -74140516)
2015,Mayo,Cuba,9,18,,27,POINT (6170465 -7542726)
2015,Mayo,Cuba,3,1,,4,POINT (7128047 -73181317)
2015,Mayo,Cuba,4,17,,21,POINT (7927233 -72508188)
2015,Mayo,República Checa,3,9,,12,POINT (4697157 -74140516)
2015,Mayo,Chile,1,0,,1,POINT (0.81488 -77356)
2015,Mayo,Chile,5,4,,9,POINT (10446304 -75516486)
2015,Mayo,Chile,1,0,,1,POINT (10886686 -74776479)
2015,Mayo,Chile,0,1,,1,POINT (10970933 -74765343)
2015,Mayo,Chile,18,34,,52,POINT (3451668 -76532004)
2015,Mayo,Chile,4622,5795,,10417,POINT (4697157 -74140516)
2015,Mayo,Chile,2,1,,3,POINT (4815189 -75736374)
2015,Mayo,Chile,13,62,,75,POINT (6170465 -7542726)
2015,Mayo,Chile,0,1,,1,POINT (7128047 -73181317)
2015,Mayo,China,0,1,,1,POINT (10886686 -74776479)
2015,Mayo,China,2,0,,2,POINT (3451668 -76532004)
2015,Mayo,China,44,142,,186,POINT (4697157 -74140516)
2015,Mayo,China,3,3,,6,POINT (6170465 -7542726)
2015,Mayo,Dinamarca,0,1,,1,POINT (10446304 -75516486)
2015,Mayo,Dinamarca,3,0,,3,POINT (10886686 -74776479)
2015,Mayo,Dinamarca,2,1,,3,POINT (3451668 -76532004)
2015,Mayo,Dinamarca,9,16,,25,POINT (4697157 -74140516)
2015,Mayo,Dinamarca,3,0,,3,POINT (6170465 -7542726)
2015,Mayo,Dominica,0,1,,1,POINT (4697157 -74140516)
2015,Mayo,Ecuador,46,152,,198,POINT (0.33002 -76876446)
2015,Mayo,Ecuador,2,11,,13,POINT (0.812436 -77847006)
2015,Mayo,Ecuador,2334,4071,,6405,POINT (0.81488 -77356)
2015,Mayo,Ecuador,11,97,,108,POINT (1800143 -78802679)
2015,Mayo,Ecuador,0,1,,1,POINT (10446304 -75516486)
2015,Mayo,Ecuador,2,6,,8,POINT (10886686 -74776479)
2015,Mayo,Ecuador,295,405,,700,POINT (3451668 -76532004)
2015,Mayo,Ecuador,0,6,,6,POINT (3884426 -77061029)
2015,Mayo,Ecuador,3027,5018,,8045,POINT (4697157 -74140516)
2015,Mayo,Ecuador,0,1,,1,POINT (4815189 -75736374)
2015,Mayo,Ecuador,17,25,,42,POINT (6170465 -7542726)
2015,Mayo,Ecuador,3,2,,5,POINT (7128047 -73181317)
2015,Mayo,Ecuador,10,10,,20,POINT (7927233 -72508188)
2015,Mayo,Egipto,1,0,,1,POINT (10446304 -75516486)
2015,Mayo,Egipto,1,8,,9,POINT (4697157 -74140516)
2015,Mayo,Egipto,0,1,,1,POINT (7927233 -72508188)
2015,Mayo,El Salvador,0,3,,3,POINT (10886686 -74776479)
2015,Mayo,El Salvador,0,2,,2,POINT (125862 -81702165)
2015,Mayo,El Salvador,91,150,,241,POINT (3451668 -76532004)
2015,Mayo,El Salvador,787,1212,,1999,POINT (4697157 -74140516)
2015,Mayo,El Salvador,1,1,,2,POINT (4815189 -75736374)
2015,Mayo,El Salvador,100,180,,280,POINT (6170465 -7542726)
2015,Mayo,El Salvador,3,1,,4,POINT (7128047 -73181317)
2015,Mayo,El Salvador,1,0,,1,POINT (7927233 -72508188)
2015,Mayo,Emiratos Árabes,0,4,,4,POINT (4697157 -74140516)
2015,Mayo,Eslovaquia,1,1,,2,POINT (4697157 -74140516)
2015,Mayo,Eslovenia,0,2,,2,POINT (3451668 -76532004)
2015,Mayo,Eslovenia,0,1,,1,POINT (4697157 -74140516)
2015,Mayo,Estados Unidos de América,1,29,,30,POINT (10406342 -75527794)
2015,Mayo,Estados Unidos de América,2,3,,5,POINT (10433609 -73247863)
2015,Mayo,Estados Unidos de América,2041,3319,,5360,POINT (10446304 -75516486)
2015,Mayo,Estados Unidos de América,316,549,,865,POINT (10886686 -74776479)
2015,Mayo,Estados Unidos de América,0,6,,6,POINT (10970933 -74765343)
2015,Mayo,Estados Unidos de América,1,2,,3,POINT (11117206 -74232675)
2015,Mayo,Estados Unidos de América,0,11,,11,POINT (11247723 -74213989)
2015,Mayo,Estados Unidos de América,2,7,,9,POINT (125862 -81702165)
2015,Mayo,Estados Unidos de América,957,1333,,2290,POINT (3451668 -76532004)
2015,Mayo,Estados Unidos de América,90,163,,253,POINT (445285 -75766353)
2015,Mayo,Estados Unidos de América,7381,13949,,21330,POINT (4697157 -74140516)
2015,Mayo,Estados Unidos de América,150,166,,316,POINT (4815189 -75736374)
2015,Mayo,Estados Unidos de América,1670,3846,,5516,POINT (6170465 -7542726)
2015,Mayo,Estados Unidos de América,24,35,,59,POINT (7128047 -73181317)
2015,Mayo,Estados Unidos de América,57,64,,121,POINT (7927233 -72508188)
2015,Mayo,Estados Unidos de América,0,1,,1,POINT (806667 -767333)
2015,Mayo,Estonia,0,3,,3,POINT (4697157 -74140516)
2015,Mayo,Filipinas,0,5,,5,POINT (10406342 -75527794)
2015,Mayo,Filipinas,0,5,,5,POINT (10446304 -75516486)
2015,Mayo,Filipinas,0,4,,4,POINT (10886686 -74776479)
2015,Mayo,Filipinas,0,3,,3,POINT (3451668 -76532004)
2015,Mayo,Filipinas,1,14,,15,POINT (4697157 -74140516)
2015,Mayo,Filipinas,1,0,,1,POINT (6170465 -7542726)
2015,Mayo,Finlandia,3,5,,8,POINT (4697157 -74140516)
2015,Mayo,Finlandia,1,2,,3,POINT (6170465 -7542726)
2015,Mayo,Francia,0,1,,1,POINT (10406342 -75527794)
2015,Mayo,Francia,0,1,,1,POINT (10886686 -74776479)
2015,Mayo,Francia,24,31,,55,POINT (3451668 -76532004)
2015,Mayo,Francia,913,1861,,2774,POINT (4697157 -74140516)
2015,Mayo,Francia,8,7,,15,POINT (6170465 -7542726)
2015,Mayo,Grecia,3,6,,9,POINT (4697157 -74140516)
2015,Mayo,Groenlandia,0,1,,1,POINT (3451668 -76532004)
2015,Mayo,Guatemala,7,5,,12,POINT (10446304 -75516486)
2015,Mayo,Guatemala,1,4,,5,POINT (10886686 -74776479)
2015,Mayo,Guatemala,0,1,,1,POINT (10970933 -74765343)
2015,Mayo,Guatemala,2,3,,5,POINT (125862 -81702165)
2015,Mayo,Guatemala,29,71,,100,POINT (3451668 -76532004)
2015,Mayo,Guatemala,258,547,,805,POINT (4697157 -74140516)
2015,Mayo,Guatemala,0,6,,6,POINT (4815189 -75736374)
2015,Mayo,Guatemala,33,75,,108,POINT (6170465 -7542726)
2015,Mayo,Guatemala,1,6,,7,POINT (7128047 -73181317)
2015,Mayo,Guatemala,5,4,,9,POINT (7927233 -72508188)
2015,Mayo,Guyana,2,1,,3,POINT (3451668 -76532004)
2015,Mayo,Guyana,0,1,,1,POINT (4697157 -74140516)
2015,Mayo,Guyana,1,1,,2,POINT (6170465 -7542726)
2015,Mayo,Guadalupe/Territorio Francés,1,0,,1,POINT (3451668 -76532004)
2015,Mayo,Guadalupe/Territorio Francés,1,2,,3,POINT (4697157 -74140516)
2015,Mayo,Guayana Francesa/Departamento de Ultramar Francés,0,1,,1,POINT (10970933 -74765343)
2015,Mayo,Guayana Francesa/Departamento de Ultramar Francés,0,1,,1,POINT (4697157 -74140516)
2015,Mayo,Guayana Francesa/Departamento de Ultramar Francés,1,0,,1,POINT (6170465 -7542726)
2015,Mayo,Haití,0,9,,9,POINT (10886686 -74776479)
2015,Mayo,Haití,1,0,,1,POINT (4697157 -74140516)
2015,Mayo,Haití,3,1,,4,POINT (6170465 -7542726)
2015,Mayo,Honduras,0,3,,3,POINT (10406342 -75527794)
2015,Mayo,Honduras,4,3,,7,POINT (10446304 -75516486)
2015,Mayo,Honduras,4,4,,8,POINT (133387613 -81372937)
2015,Mayo,Honduras,8,17,,25,POINT (3451668 -76532004)
2015,Mayo,Honduras,42,52,,94,POINT (4697157 -74140516)
2015,Mayo,Honduras,1,3,,4,POINT (4815189 -75736374)
2015,Mayo,Honduras,31,32,,63,POINT (6170465 -7542726)
2015,Mayo,Honduras,1,0,,1,POINT (7128047 -73181317)
2015,Mayo,Honduras,1,3,,4,POINT (7927233 -72508188)
2015,Mayo,Hong Kong,2,3,,5,POINT (4697157 -74140516)
2015,Mayo,Hong Kong,1,2,,3,POINT (6170465 -7542726)
2015,Mayo,Hungría,1,2,,3,POINT (4697157 -74140516)
2015,Mayo,Hungría,1,0,,1,POINT (6170465 -7542726)
2015,Mayo,India,0,1,,1,POINT (10406342 -75527794)
2015,Mayo,India,0,1,,1,POINT (10886686 -74776479)
2015,Mayo,India,0,4,,4,POINT (3451668 -76532004)
2015,Mayo,India,6,31,,37,POINT (4697157 -74140516)
2015,Mayo,India,3,3,,6,POINT (6170465 -7542726)
2015,Mayo,Indonesia,3,3,,6,POINT (4697157 -74140516)
2015,Mayo,República de Irlanda,1,0,,1,POINT (10446304 -75516486)
2015,Mayo,República de Irlanda,0,1,,1,POINT (10886686 -74776479)
2015,Mayo,República de Irlanda,0,1,,1,POINT (3451668 -76532004)
2015,Mayo,República de Irlanda,1,7,,8,POINT (4697157 -74140516)
2015,Mayo,Islandia,1,0,,1,POINT (4697157 -74140516)
2015,Mayo,Israel,1,0,,1,POINT (10886686 -74776479)
2015,Mayo,Israel,6,10,,16,POINT (3451668 -76532004)
2015,Mayo,Israel,8,74,,82,POINT (4697157 -74140516)
2015,Mayo,Israel,6,4,,10,POINT (6170465 -7542726)
2015,Mayo,Israel,3,1,,4,POINT (7128047 -73181317)
2015,Mayo,Italia,1,2,,3,POINT (10446304 -75516486)
2015,Mayo,Italia,0,2,,2,POINT (10886686 -74776479)
2015,Mayo,Italia,4,21,,25,POINT (3451668 -76532004)
2015,Mayo,Italia,59,201,,260,POINT (4697157 -74140516)
2015,Mayo,Italia,9,16,,25,POINT (6170465 -7542726)
2015,Mayo,Italia,0,1,,1,POINT (7927233 -72508188)
2015,Mayo,Jamaica,0,10,,10,POINT (10406342 -75527794)
2015,Mayo,Jamaica,0,2,,2,POINT (10446304 -75516486)
2015,Mayo,Jamaica,0,2,,2,POINT (10886686 -74776479)
2015,Mayo,Jamaica,0,1,,1,POINT (10970933 -74765343)
2015,Mayo,Jamaica,1,1,,2,POINT (3451668 -76532004)
2015,Mayo,Jamaica,3,8,,11,POINT (4697157 -74140516)
2015,Mayo,Jamaica,1,1,,2,POINT (6170465 -7542726)
2015,Mayo,Jamaica,0,1,,1,POINT (7128047 -73181317)
2015,Mayo,Japón,0,1,,1,POINT (3451668 -76532004)
2015,Mayo,Japón,6,8,,14,POINT (4697157 -74140516)
2015,Mayo,Japón,0,2,,2,POINT (6170465 -7542726)
2015,Mayo,Japón,0,1,,1,POINT (7128047 -73181317)
2015,Mayo,Jordania,2,0,,2,POINT (4697157 -74140516)
2015,Mayo,Kazajistán,3,0,,3,POINT (4697157 -74140516)
2015,Mayo,Kuwait,0,1,,1,POINT (4697157 -74140516)
2015,Mayo,Letonia,0,2,,2,POINT (4697157 -74140516)
2015,Mayo,Lituania,1,1,,2,POINT (4697157 -74140516)
2015,Mayo,Líbano,5,2,,7,POINT (4697157 -74140516)
2015,Mayo,Luxemburgo,1,1,,2,POINT (4697157 -74140516)
2015,Mayo,Malasia,0,3,,3,POINT (4697157 -74140516)
2015,Mayo,Malasia,0,1,,1,POINT (6170465 -7542726)
2015,Mayo,Marruecos,0,1,,1,POINT (4697157 -74140516)
2015,Mayo,Martinica/Departamento de Ultramar Francés,1,0,,1,POINT (10886686 -74776479)
2015,Mayo,México,2,11,,13,POINT (10406342 -75527794)
2015,Mayo,México,9,18,,27,POINT (10446304 -75516486)
2015,Mayo,México,11,26,,37,POINT (10886686 -74776479)
2015,Mayo,México,0,9,,9,POINT (125862 -81702165)
2015,Mayo,México,84,142,,226,POINT (3451668 -76532004)
2015,Mayo,México,4608,7973,,12581,POINT (4697157 -74140516)
2015,Mayo,México,4,21,,25,POINT (4815189 -75736374)
2015,Mayo,México,367,828,,1195,POINT (6170465 -7542726)
2015,Mayo,México,3,12,,15,POINT (7128047 -73181317)
2015,Mayo,México,22,33,,55,POINT (7927233 -72508188)
2015,Mayo,Mongolia,0,1,,1,POINT (4697157 -74140516)
2015,Mayo,Montenegro,0,1,,1,POINT (10446304 -75516486)
2015,Mayo,Montenegro,1,0,,1,POINT (4697157 -74140516)
2015,Mayo,Nicaragua,1,1,,2,POINT (10446304 -75516486)
2015,Mayo,Nicaragua,0,1,,1,POINT (10886686 -74776479)
2015,Mayo,Nicaragua,1,3,,4,POINT (125862 -81702165)
2015,Mayo,Nicaragua,22,36,,58,POINT (3451668 -76532004)
2015,Mayo,Nicaragua,24,35,,59,POINT (4697157 -74140516)
2015,Mayo,Nicaragua,0,4,,4,POINT (4815189 -75736374)
2015,Mayo,Nicaragua,6,21,,27,POINT (6170465 -7542726)
2015,Mayo,Nicaragua,0,1,,1,POINT (7927233 -72508188)
2015,Mayo,Nigeria,0,1,,1,POINT (4815189 -75736374)
2015,Mayo,Noruega,1,1,,2,POINT (3451668 -76532004)
2015,Mayo,Noruega,5,12,,17,POINT (4697157 -74140516)
2015,Mayo,Noruega,0,1,,1,POINT (6170465 -7542726)
2015,Mayo,Nueva Zelanda,0,1,,1,POINT (3451668 -76532004)
2015,Mayo,Nueva Zelanda,2,4,,6,POINT (4697157 -74140516)
2015,Mayo,Nueva Zelanda,0,1,,1,POINT (4815189 -75736374)
2015,Mayo,Nueva Zelanda,0,3,,3,POINT (6170465 -7542726)
2015,Mayo,Omán,1,0,,1,POINT (4697157 -74140516)
2015,Mayo,Papúa Nueva Guinea,1,0,,1,POINT (10446304 -75516486)
2015,Mayo,Panamá,816,753,,1569,POINT (10406342 -75527794)
2015,Mayo,Panamá,1605,1951,,3556,POINT (10446304 -75516486)
2015,Mayo,Panamá,140,309,,449,POINT (10886686 -74776479)
2015,Mayo,Panamá,0,16,,16,POINT (10970933 -74765343)
2015,Mayo,Panamá,0,15,,15,POINT (11247723 -74213989)
2015,Mayo,Panamá,1,10,,11,POINT (125744111 -81703935)
2015,Mayo,Panamá,1133,784,,1917,POINT (125862 -81702165)
2015,Mayo,Panamá,6,6,,12,POINT (133387613 -81372937)
2015,Mayo,Panamá,305,596,,901,POINT (3451668 -76532004)
2015,Mayo,Panamá,0,26,,26,POINT (3884426 -77061029)
2015,Mayo,Panamá,3247,5411,,8658,POINT (4697157 -74140516)
2015,Mayo,Panamá,27,109,,136,POINT (4815189 -75736374)
2015,Mayo,Panamá,979,1659,,2638,POINT (6170465 -7542726)
2015,Mayo,Panamá,2,2,,4,POINT (6222552 -77401154)
2015,Mayo,Panamá,1,2,,3,POINT (7102626 -77762647)
2015,Mayo,Panamá,31,43,,74,POINT (7128047 -73181317)
2015,Mayo,Panamá,104,172,,276,POINT (7927233 -72508188)
2015,Mayo,Panamá,106,105,,211,POINT (863337 -7735002)
2015,Mayo,Paraguay,4,7,,11,POINT (10446304 -75516486)
2015,Mayo,Paraguay,1,0,,1,POINT (10886686 -74776479)
2015,Mayo,Paraguay,12,1,,13,POINT (125862 -81702165)
2015,Mayo,Paraguay,10,11,,21,POINT (3451668 -76532004)
2015,Mayo,Paraguay,56,57,,113,POINT (4697157 -74140516)
2015,Mayo,Paraguay,21,27,,48,POINT (6170465 -7542726)
2015,Mayo,Perú,136,210,,346,POINT (-4191162 -69941498)
2015,Mayo,Perú,13,16,,29,POINT (-4214082 -69941431)
2015,Mayo,Perú,16,24,,40,POINT (0.81488 -77356)
2015,Mayo,Perú,6,5,,11,POINT (10446304 -75516486)
2015,Mayo,Perú,0,3,,3,POINT (10886686 -74776479)
2015,Mayo,Perú,0,1,,1,POINT (11247723 -74213989)
2015,Mayo,Perú,25,18,,43,POINT (125862 -81702165)
2015,Mayo,Perú,307,422,,729,POINT (3451668 -76532004)
2015,Mayo,Perú,5442,7388,,12830,POINT (4697157 -74140516)
2015,Mayo,Perú,1,2,,3,POINT (4815189 -75736374)
2015,Mayo,Perú,402,631,,1033,POINT (6170465 -7542726)
2015,Mayo,Perú,3,0,,3,POINT (7128047 -73181317)
2015,Mayo,Perú,5,5,,10,POINT (7927233 -72508188)
2015,Mayo,Polonia,0,1,,1,POINT (10446304 -75516486)
2015,Mayo,Polonia,5,5,,10,POINT (3451668 -76532004)
2015,Mayo,Polonia,13,19,,32,POINT (4697157 -74140516)
2015,Mayo,Polonia,1,1,,2,POINT (6170465 -7542726)
2015,Mayo,Portugal,1,3,,4,POINT (3451668 -76532004)
2015,Mayo,Portugal,164,323,,487,POINT (4697157 -74140516)
2015,Mayo,Portugal,0,1,,1,POINT (7927233 -72508188)
2015,Mayo,Puerto Rico/Territorio de Estados Unidos,1,2,,3,POINT (10446304 -75516486)
2015,Mayo,Puerto Rico/Territorio de Estados Unidos,4,40,,44,POINT (10886686 -74776479)
2015,Mayo,Puerto Rico/Territorio de Estados Unidos,17,31,,48,POINT (3451668 -76532004)
2015,Mayo,Puerto Rico/Territorio de Estados Unidos,271,354,,625,POINT (4697157 -74140516)
2015,Mayo,Puerto Rico/Territorio de Estados Unidos,2,4,,6,POINT (4815189 -75736374)
2015,Mayo,Puerto Rico/Territorio de Estados Unidos,51,97,,148,POINT (6170465 -7542726)
2015,Mayo,Puerto Rico/Territorio de Estados Unidos,0,1,,1,POINT (7128047 -73181317)
2015,Mayo,Puerto Rico/Territorio de Estados Unidos,0,3,,3,POINT (7927233 -72508188)
2015,Mayo,Reino Unido de Gran Bretaña e Irlanda del Norte,0,1,,1,POINT (10446304 -75516486)
2015,Mayo,Reino Unido de Gran Bretaña e Irlanda del Norte,0,1,,1,POINT (10970933 -74765343)
2015,Mayo,Reino Unido de Gran Bretaña e Irlanda del Norte,8,88,,96,POINT (3451668 -76532004)
2015,Mayo,Reino Unido de Gran Bretaña e Irlanda del Norte,291,617,,908,POINT (4697157 -74140516)
2015,Mayo,Reino Unido de Gran Bretaña e Irlanda del Norte,0,1,,1,POINT (4815189 -75736374)
2015,Mayo,Reino Unido de Gran Bretaña e Irlanda del Norte,8,8,,16,POINT (6170465 -7542726)
2015,Mayo,República CentroÁfricana,0,1,,1,POINT (4697157 -74140516)
2015,Mayo,Federación de Rusia,0,1,,1,POINT (10886686 -74776479)
2015,Mayo,Federación de Rusia,2,1,,3,POINT (3451668 -76532004)
2015,Mayo,Federación de Rusia,16,28,,44,POINT (4697157 -74140516)
2015,Mayo,Federación de Rusia,1,1,,2,POINT (6170465 -7542726)
2015,Mayo,República Dominicana,4,9,,13,POINT (10406342 -75527794)
2015,Mayo,República Dominicana,3,5,,8,POINT (10433609 -73247863)
2015,Mayo,República Dominicana,1,3,,4,POINT (10446304 -75516486)
2015,Mayo,República Dominicana,14,10,,24,POINT (10886686 -74776479)
2015,Mayo,República Dominicana,0,3,,3,POINT (10970933 -74765343)
2015,Mayo,República Dominicana,15,15,,30,POINT (3451668 -76532004)
2015,Mayo,República Dominicana,476,737,,1213,POINT (4697157 -74140516)
2015,Mayo,República Dominicana,3,6,,9,POINT (4815189 -75736374)
2015,Mayo,República Dominicana,39,71,,110,POINT (6170465 -7542726)
2015,Mayo,República Dominicana,1,0,,1,POINT (7128047 -73181317)
2015,Mayo,República Dominicana,2,7,,9,POINT (7927233 -72508188)
2015,Mayo,República Democrática Popular de Corea,1,0,,1,POINT (4697157 -74140516)
2015,Mayo,Rumania,0,1,,1,POINT (3451668 -76532004)
2015,Mayo,Rumania,3,7,,10,POINT (4697157 -74140516)
2015,Mayo,Rumania,1,0,,1,POINT (6170465 -7542726)
2015,Mayo,San Cristóbal y Nevis,0,1,,1,POINT (3451668 -76532004)
2015,Mayo,San  Vicente y las Granadinas,0,1,,1,POINT (4697157 -74140516)
2015,Mayo,San  Vicente y las Granadinas,1,5,,6,POINT (7927233 -72508188)
2015,Mayo,Santa Lucia,3,8,,11,POINT (4697157 -74140516)
2015,Mayo,Serbia,0,2,,2,POINT (4697157 -74140516)
2015,Mayo,Singapur,1,3,,4,POINT (4697157 -74140516)
2015,Mayo,República Árabe Siria,1,0,,1,POINT (4697157 -74140516)
2015,Mayo,Sudáfrica,2,5,,7,POINT (4697157 -74140516)
2015,Mayo,Suecia,1,7,,8,POINT (3451668 -76532004)
2015,Mayo,Suecia,6,19,,25,POINT (4697157 -74140516)
2015,Mayo,Suecia,1,1,,2,POINT (6170465 -7542726)
2015,Mayo,Suiza,3,0,,3,POINT (10446304 -75516486)
2015,Mayo,Suiza,12,13,,25,POINT (3451668 -76532004)
2015,Mayo,Suiza,31,66,,97,POINT (4697157 -74140516)
2015,Mayo,Suiza,2,2,,4,POINT (6170465 -7542726)
2015,Mayo,Surinam,1,1,,2,POINT (10886686 -74776479)
2015,Mayo,Surinam,0,1,,1,POINT (3451668 -76532004)
2015,Mayo,Surinam,0,1,,1,POINT (4697157 -74140516)
2015,Mayo,Surinam,5,11,,16,POINT (6170465 -7542726)
2015,Mayo,Taiwán,0,1,,1,POINT (3451668 -76532004)
2015,Mayo,Taiwán,5,5,,10,POINT (4697157 -74140516)
2015,Mayo,Taiwán,0,1,,1,POINT (4815189 -75736374)
2015,Mayo,Taiwán,2,3,,5,POINT (6170465 -7542726)
2015,Mayo,Tailandia,0,1,,1,POINT (3451668 -76532004)
2015,Mayo,Tailandia,1,3,,4,POINT (4697157 -74140516)
2015,Mayo,Trinidad y Tobago,0,6,,6,POINT (10406342 -75527794)
2015,Mayo,Trinidad y Tobago,0,7,,7,POINT (10970933 -74765343)
2015,Mayo,Trinidad y Tobago,1,4,,5,POINT (3451668 -76532004)
2015,Mayo,Trinidad y Tobago,1,14,,15,POINT (4697157 -74140516)
2015,Mayo,Trinidad y Tobago,0,2,,2,POINT (4815189 -75736374)
2015,Mayo,Trinidad y Tobago,19,9,,28,POINT (6170465 -7542726)
2015,Mayo,Trinidad y Tobago,1,0,,1,POINT (7128047 -73181317)
2015,Mayo,Trinidad y Tobago,0,2,,2,POINT (7927233 -72508188)
2015,Mayo,Túnez,0,1,,1,POINT (4697157 -74140516)
2015,Mayo,Turquía,0,1,,1,POINT (3451668 -76532004)
2015,Mayo,Turquía,1,9,,10,POINT (4697157 -74140516)
2015,Mayo,Turquía,2,1,,3,POINT (6170465 -7542726)
2015,Mayo,Ucrania,2,1,,3,POINT (4697157 -74140516)
2015,Mayo,Ucrania,1,0,,1,POINT (6170465 -7542726)
2015,Mayo,Uruguay,12,9,,21,POINT (10446304 -75516486)
2015,Mayo,Uruguay,1,1,,2,POINT (10886686 -74776479)
2015,Mayo,Uruguay,2,1,,3,POINT (125862 -81702165)
2015,Mayo,Uruguay,7,31,,38,POINT (3451668 -76532004)
2015,Mayo,Uruguay,48,75,,123,POINT (4697157 -74140516)
2015,Mayo,Uruguay,18,37,,55,POINT (6170465 -7542726)
2015,Mayo,Venezuela,0,12,,12,POINT (10406342 -75527794)
2015,Mayo,Venezuela,0,7,,7,POINT (10433609 -73247863)
2015,Mayo,Venezuela,7,41,,48,POINT (10446304 -75516486)
2015,Mayo,Venezuela,19,79,,98,POINT (10886686 -74776479)
2015,Mayo,Venezuela,0,1,,1,POINT (10970933 -74765343)
2015,Mayo,Venezuela,1770,2658,,4428,POINT (11360029 -72129595)
2015,Mayo,Venezuela,28,58,,86,POINT (3451668 -76532004)
2015,Mayo,Venezuela,11,14,,25,POINT (3866713 -67927521)
2015,Mayo,Venezuela,3172,3929,,7101,POINT (4697157 -74140516)
2015,Mayo,Venezuela,0,4,,4,POINT (4815189 -75736374)
2015,Mayo,Venezuela,59,81,,140,POINT (6170465 -7542726)
2015,Mayo,Venezuela,199,462,,661,POINT (6185536 -67484028)
2015,Mayo,Venezuela,53,106,,159,POINT (7088729 -70740253)
2015,Mayo,Venezuela,2,6,,8,POINT (7128047 -73181317)
2015,Mayo,Venezuela,3047,3986,,7033,POINT (7819 -72453013)
2015,Mayo,Venezuela,229,282,,511,POINT (7927233 -72508188)
2015,Mayo,Vietnam,0,1,,1,POINT (4697157 -74140516)
2015,Mayo,Islas Vírgenes Británicas/Territorio Británico de Ultramar,1,3,,4,POINT (10886686 -74776479)
2015,Mayo,Islas Vírgenes Estadounidenses/Territorio de Estados Unidos,5,6,,11,POINT (10886686 -74776479)
2015,Mayo,Islas Vírgenes Estadounidenses/Territorio de Estados Unidos,2,1,,3,POINT (3451668 -76532004)
2015,Mayo,Zambia,1,0,,1,POINT (3451668 -76532004)
2015,Mayo,Zambia,3,1,,4,POINT (4697157 -74140516)
2015,Mayo,Desconocido,0,7,,7,POINT (125744111 -81703935)
2015,Mayo,Desconocido,5,0,,5,POINT (3451668 -76532004)
2015,Mayo,Desconocido,0,40,,40,POINT (4697157 -74140516)
2015,Mayo,Desconocido,0,29,,29,POINT (9402597 -75681642)
2015,Junio,Albania,0,2,,2,POINT (3451668 -76532004)
2015,Junio,Albania,0,1,,1,POINT (4697157 -74140516)
2015,Junio,Alemania,1,0,,1,POINT (10446304 -75516486)
2015,Junio,Alemania,4,3,,7,POINT (10886686 -74776479)
2015,Junio,Alemania,23,31,,54,POINT (3451668 -76532004)
2015,Junio,Alemania,0,1,,1,POINT (3884426 -77061029)
2015,Junio,Alemania,1176,2069,,3245,POINT (4697157 -74140516)
2015,Junio,Alemania,1,0,,1,POINT (4815189 -75736374)
2015,Junio,Alemania,8,21,,29,POINT (6170465 -7542726)
2015,Junio,Alemania,0,1,,1,POINT (7128047 -73181317)
2015,Junio,Antigua y Barbuda,0,1,,1,POINT (10406342 -75527794)
2015,Junio,Antigua y Barbuda,1,4,,5,POINT (4697157 -74140516)
2015,Junio,Países Bajos,1,1,,2,POINT (10406342 -75527794)
2015,Junio,Países Bajos,1,0,,1,POINT (10446304 -75516486)
2015,Junio,Países Bajos,35,50,,85,POINT (10886686 -74776479)
2015,Junio,Países Bajos,51,123,,174,POINT (3451668 -76532004)
2015,Junio,Países Bajos,0,1,,1,POINT (3884426 -77061029)
2015,Junio,Países Bajos,616,886,,1502,POINT (4697157 -74140516)
2015,Junio,Países Bajos,189,213,,402,POINT (6170465 -7542726)
2015,Junio,Países Bajos,2,3,,5,POINT (7128047 -73181317)
2015,Junio,Arabia Saudita,0,4,,4,POINT (4697157 -74140516)
2015,Junio,Arabia Saudita,0,2,,2,POINT (6170465 -7542726)
2015,Junio,Argelia,0,1,,1,POINT (3451668 -76532004)
2015,Junio,Argelia,2,1,,3,POINT (4697157 -74140516)
2015,Junio,Argentina,6,14,,20,POINT (0.81488 -77356)
2015,Junio,Argentina,47,19,,66,POINT (10446304 -75516486)
2015,Junio,Argentina,3,7,,10,POINT (10886686 -74776479)
2015,Junio,Argentina,201,130,,331,POINT (125862 -81702165)
2015,Junio,Argentina,48,88,,136,POINT (3451668 -76532004)
2015,Junio,Argentina,1580,2543,,4123,POINT (4697157 -74140516)
2015,Junio,Argentina,78,170,,248,POINT (6170465 -7542726)
2015,Junio,República de Armenia,1,1,,2,POINT (4697157 -74140516)
2015,Junio,Aruba,21,17,,38,POINT (10406342 -75527794)
2015,Junio,Aruba,13,18,,31,POINT (10886686 -74776479)
2015,Junio,Aruba,1,10,,11,POINT (11247723 -74213989)
2015,Junio,Aruba,3,4,,7,POINT (3451668 -76532004)
2015,Junio,Aruba,484,680,,1164,POINT (4697157 -74140516)
2015,Junio,Aruba,0,2,,2,POINT (4815189 -75736374)
2015,Junio,Aruba,25,23,,48,POINT (6170465 -7542726)
2015,Junio,Aruba,5,6,,11,POINT (7128047 -73181317)
2015,Junio,Aruba,0,3,,3,POINT (7927233 -72508188)
2015,Junio,Australia,0,2,,2,POINT (10446304 -75516486)
2015,Junio,Australia,0,2,,2,POINT (10886686 -74776479)
2015,Junio,Australia,4,7,,11,POINT (3451668 -76532004)
2015,Junio,Australia,27,37,,64,POINT (4697157 -74140516)
2015,Junio,Australia,7,18,,25,POINT (6170465 -7542726)
2015,Junio,Australia,1,1,,2,POINT (7128047 -73181317)
2015,Junio,Austria,4,2,,6,POINT (3451668 -76532004)
2015,Junio,Austria,9,9,,18,POINT (4697157 -74140516)
2015,Junio,Austria,0,1,,1,POINT (6170465 -7542726)
2015,Junio,Azerbaiyán,0,1,,1,POINT (4697157 -74140516)
2015,Junio,Bahamas,0,2,,2,POINT (10446304 -75516486)
2015,Junio,Bahamas,1,1,,2,POINT (3451668 -76532004)
2015,Junio,Bahamas,1,2,,3,POINT (4697157 -74140516)
2015,Junio,Bahamas,4,3,,7,POINT (6170465 -7542726)
2015,Junio,Barbados,0,2,,2,POINT (3451668 -76532004)
2015,Junio,República de Belarús,0,3,,3,POINT (4697157 -74140516)
2015,Junio,República de Belarús,1,0,,1,POINT (7927233 -72508188)
2015,Junio,Bélgica,0,2,,2,POINT (10446304 -75516486)
2015,Junio,Bélgica,7,7,,14,POINT (3451668 -76532004)
2015,Junio,Bélgica,39,51,,90,POINT (4697157 -74140516)
2015,Junio,Bélgica,2,10,,12,POINT (6170465 -7542726)
2015,Junio,Belice,0,1,,1,POINT (3451668 -76532004)
2015,Junio,Belice,2,7,,9,POINT (4697157 -74140516)
2015,Junio,Benín,0,1,,1,POINT (4697157 -74140516)
2015,Junio,Bolivia,8,2,,10,POINT (10446304 -75516486)
2015,Junio,Bolivia,10,0,,10,POINT (10886686 -74776479)
2015,Junio,Bolivia,10,5,,15,POINT (125862 -81702165)
2015,Junio,Bolivia,25,25,,50,POINT (3451668 -76532004)
2015,Junio,Bolivia,456,518,,974,POINT (4697157 -74140516)
2015,Junio,Bolivia,21,26,,47,POINT (6170465 -7542726)
2015,Junio,Botsuana,1,1,,2,POINT (6170465 -7542726)
2015,Junio,Brasil,117,154,,271,POINT (-4191162 -69941498)
2015,Junio,Brasil,5,2,,7,POINT (-4214082 -69941431)
2015,Junio,Brasil,1,2,,3,POINT (0.81488 -77356)
2015,Junio,Brasil,0,4,,4,POINT (10406342 -75527794)
2015,Junio,Brasil,25,26,,51,POINT (10446304 -75516486)
2015,Junio,Brasil,3,2,,5,POINT (10886686 -74776479)
2015,Junio,Brasil,97,79,,176,POINT (125862 -81702165)
2015,Junio,Brasil,34,49,,83,POINT (3451668 -76532004)
2015,Junio,Brasil,0,1,,1,POINT (3866713 -67927521)
2015,Junio,Brasil,3070,4890,,7960,POINT (4697157 -74140516)
2015,Junio,Brasil,107,162,,269,POINT (6170465 -7542726)
2015,Junio,Brasil,0,5,,5,POINT (7128047 -73181317)
2015,Junio,Brasil,3,2,,5,POINT (7927233 -72508188)
2015,Junio,Bulgaria,4,5,,9,POINT (4697157 -74140516)
2015,Junio,Bulgaria,3,2,,5,POINT (7927233 -72508188)
2015,Junio,Islas Caimán/Territorio Británico de Ultramar,0,3,,3,POINT (10886686 -74776479)
2015,Junio,Islas Caimán/Territorio Británico de Ultramar,0,1,,1,POINT (125862 -81702165)
2015,Junio,Islas Caimán/Territorio Británico de Ultramar,2,2,,4,POINT (133387613 -81372937)
2015,Junio,Islas Caimán/Territorio Británico de Ultramar,0,10,,10,POINT (4697157 -74140516)
2015,Junio,Islas Caimán/Territorio Británico de Ultramar,0,2,,2,POINT (6170465 -7542726)
2015,Junio,Camerún,0,2,,2,POINT (4697157 -74140516)
2015,Junio,Canadá,5,23,,28,POINT (10446304 -75516486)
2015,Junio,Canadá,13,10,,23,POINT (10886686 -74776479)
2015,Junio,Canadá,0,1,,1,POINT (10970933 -74765343)
2015,Junio,Canadá,0,1,,1,POINT (125862 -81702165)
2015,Junio,Canadá,27,49,,76,POINT (3451668 -76532004)
2015,Junio,Canadá,569,873,,1442,POINT (4697157 -74140516)
2015,Junio,Canadá,1,7,,8,POINT (4815189 -75736374)
2015,Junio,Canadá,75,124,,199,POINT (6170465 -7542726)
2015,Junio,Canadá,8,13,,21,POINT (7128047 -73181317)
2015,Junio,Canadá,2,5,,7,POINT (7927233 -72508188)
2015,Junio,España,0,2,,2,POINT (10406342 -75527794)
2015,Junio,España,25,151,,176,POINT (10886686 -74776479)
2015,Junio,España,0,2,,2,POINT (11247723 -74213989)
2015,Junio,España,250,322,,572,POINT (3451668 -76532004)
2015,Junio,España,2743,5155,,7898,POINT (4697157 -74140516)
2015,Junio,España,15,19,,34,POINT (4815189 -75736374)
2015,Junio,España,132,279,,411,POINT (6170465 -7542726)
2015,Junio,España,8,2,,10,POINT (7128047 -73181317)
2015,Junio,España,4,10,,14,POINT (7927233 -72508188)
2015,Junio,República de Corea,1,1,,2,POINT (3451668 -76532004)
2015,Junio,República de Corea,4,20,,24,POINT (4697157 -74140516)
2015,Junio,República de Corea,0,4,,4,POINT (6170465 -7542726)
2015,Junio,República de Corea,0,3,,3,POINT (7927233 -72508188)
2015,Junio,Islas Malvinas,0,1,,1,POINT (4697157 -74140516)
2015,Junio,Costa de Marfil,2,2,,4,POINT (4697157 -74140516)
2015,Junio,Costa Rica,0,4,,4,POINT (10406342 -75527794)
2015,Junio,Costa Rica,7,11,,18,POINT (10446304 -75516486)
2015,Junio,Costa Rica,8,8,,16,POINT (10886686 -74776479)
2015,Junio,Costa Rica,0,1,,1,POINT (11247723 -74213989)
2015,Junio,Costa Rica,8,5,,13,POINT (125862 -81702165)
2015,Junio,Costa Rica,44,52,,96,POINT (3451668 -76532004)
2015,Junio,Costa Rica,789,1389,,2178,POINT (4697157 -74140516)
2015,Junio,Costa Rica,1,4,,5,POINT (4815189 -75736374)
2015,Junio,Costa Rica,52,83,,135,POINT (6170465 -7542726)
2015,Junio,Costa Rica,0,1,,1,POINT (7128047 -73181317)
2015,Junio,Costa Rica,4,2,,6,POINT (7927233 -72508188)
2015,Junio,Croacia,1,6,,7,POINT (4697157 -74140516)
2015,Junio,Cuba,1,1,,2,POINT (10446304 -75516486)
2015,Junio,Cuba,5,4,,9,POINT (10886686 -74776479)
2015,Junio,Cuba,27,35,,62,POINT (3451668 -76532004)
2015,Junio,Cuba,499,658,,1157,POINT (4697157 -74140516)
2015,Junio,Cuba,1,0,,1,POINT (4815189 -75736374)
2015,Junio,Cuba,10,15,,25,POINT (6170465 -7542726)
2015,Junio,Cuba,2,2,,4,POINT (7128047 -73181317)
2015,Junio,Cuba,5,1,,6,POINT (7927233 -72508188)
2015,Junio,República Checa,1,0,,1,POINT (10446304 -75516486)
2015,Junio,República Checa,0,1,,1,POINT (3451668 -76532004)
2015,Junio,República Checa,9,5,,14,POINT (4697157 -74140516)
2015,Junio,República Checa,2,2,,4,POINT (6170465 -7542726)
2015,Junio,Chile,6,6,,12,POINT (0.81488 -77356)
2015,Junio,Chile,4,5,,9,POINT (10446304 -75516486)
2015,Junio,Chile,3,1,,4,POINT (10886686 -74776479)
2015,Junio,Chile,0,6,,6,POINT (10970933 -74765343)
2015,Junio,Chile,52,46,,98,POINT (125862 -81702165)
2015,Junio,Chile,21,35,,56,POINT (3451668 -76532004)
2015,Junio,Chile,2718,4232,,6950,POINT (4697157 -74140516)
2015,Junio,Chile,0,3,,3,POINT (4815189 -75736374)
2015,Junio,Chile,17,57,,74,POINT (6170465 -7542726)
2015,Junio,Chile,0,1,,1,POINT (7128047 -73181317)
2015,Junio,Chile,4,3,,7,POINT (7927233 -72508188)
2015,Junio,China,3,1,,4,POINT (3451668 -76532004)
2015,Junio,China,38,99,,137,POINT (4697157 -74140516)
2015,Junio,Chipre,0,3,,3,POINT (4697157 -74140516)
2015,Junio,Dinamarca,2,1,,3,POINT (3451668 -76532004)
2015,Junio,Dinamarca,7,13,,20,POINT (4697157 -74140516)
2015,Junio,Dinamarca,0,1,,1,POINT (6170465 -7542726)
2015,Junio,Dominica,0,1,,1,POINT (4697157 -74140516)
2015,Junio,Dominica,0,2,,2,POINT (7927233 -72508188)
2015,Junio,Ecuador,67,160,,227,POINT (0.33002 -76876446)
2015,Junio,Ecuador,1,5,,6,POINT (0.812436 -77847006)
2015,Junio,Ecuador,2237,3691,,5928,POINT (0.81488 -77356)
2015,Junio,Ecuador,27,125,,152,POINT (1800143 -78802679)
2015,Junio,Ecuador,73,65,,138,POINT (10446304 -75516486)
2015,Junio,Ecuador,4,6,,10,POINT (10886686 -74776479)
2015,Junio,Ecuador,237,347,,584,POINT (3451668 -76532004)
2015,Junio,Ecuador,0,1,,1,POINT (3884426 -77061029)
2015,Junio,Ecuador,2610,4312,,6922,POINT (4697157 -74140516)
2015,Junio,Ecuador,0,5,,5,POINT (4815189 -75736374)
2015,Junio,Ecuador,3,13,,16,POINT (6170465 -7542726)
2015,Junio,Ecuador,1,2,,3,POINT (7128047 -73181317)
2015,Junio,Ecuador,2,5,,7,POINT (7927233 -72508188)
2015,Junio,Egipto,1,0,,1,POINT (4697157 -74140516)
2015,Junio,El Salvador,0,2,,2,POINT (10886686 -74776479)
2015,Junio,El Salvador,8,6,,14,POINT (125862 -81702165)
2015,Junio,El Salvador,118,175,,293,POINT (3451668 -76532004)
2015,Junio,El Salvador,802,1306,,2108,POINT (4697157 -74140516)
2015,Junio,El Salvador,115,199,,314,POINT (6170465 -7542726)
2015,Junio,El Salvador,1,2,,3,POINT (7927233 -72508188)
2015,Junio,Emiratos Árabes,3,9,,12,POINT (4697157 -74140516)
2015,Junio,Emiratos Árabes,1,0,,1,POINT (6170465 -7542726)
2015,Junio,Eslovaquia,1,1,,2,POINT (4697157 -74140516)
2015,Junio,Eslovenia,0,1,,1,POINT (3451668 -76532004)
2015,Junio,Eslovenia,4,3,,7,POINT (4697157 -74140516)
2015,Junio,Estados Unidos de América,0,29,,29,POINT (10406342 -75527794)
2015,Junio,Estados Unidos de América,2515,3521,,6036,POINT (10446304 -75516486)
2015,Junio,Estados Unidos de América,795,1192,,1987,POINT (10886686 -74776479)
2015,Junio,Estados Unidos de América,2,126,,128,POINT (10970933 -74765343)
2015,Junio,Estados Unidos de América,1,3,,4,POINT (11117206 -74232675)
2015,Junio,Estados Unidos de América,1,8,,9,POINT (11247723 -74213989)
2015,Junio,Estados Unidos de América,26,29,,55,POINT (125862 -81702165)
2015,Junio,Estados Unidos de América,1932,2277,,4209,POINT (3451668 -76532004)
2015,Junio,Estados Unidos de América,200,236,,436,POINT (445285 -75766353)
2015,Junio,Estados Unidos de América,9925,15882,,25807,POINT (4697157 -74140516)
2015,Junio,Estados Unidos de América,299,316,,615,POINT (4815189 -75736374)
2015,Junio,Estados Unidos de América,3062,4809,,7871,POINT (6170465 -7542726)
2015,Junio,Estados Unidos de América,81,99,,180,POINT (7128047 -73181317)
2015,Junio,Estados Unidos de América,87,69,,156,POINT (7927233 -72508188)
2015,Junio,Estados Unidos de América,0,1,,1,POINT (806667 -767333)
2015,Junio,Estados Unidos de América,0,1,,1,POINT (9402597 -75681642)
2015,Junio,Estonia,2,2,,4,POINT (4697157 -74140516)
2015,Junio,Etiopia,1,0,,1,POINT (3451668 -76532004)
2015,Junio,Etiopia,1,1,,2,POINT (6170465 -7542726)
2015,Junio,Filipinas,0,3,,3,POINT (10446304 -75516486)
2015,Junio,Filipinas,0,4,,4,POINT (10886686 -74776479)
2015,Junio,Filipinas,0,5,,5,POINT (3451668 -76532004)
2015,Junio,Filipinas,3,17,,20,POINT (4697157 -74140516)
2015,Junio,Filipinas,0,1,,1,POINT (6170465 -7542726)
2015,Junio,Finlandia,1,1,,2,POINT (10446304 -75516486)
2015,Junio,Finlandia,3,5,,8,POINT (4697157 -74140516)
2015,Junio,Finlandia,1,2,,3,POINT (6170465 -7542726)
2015,Junio,Francia,0,1,,1,POINT (10406342 -75527794)
2015,Junio,Francia,0,1,,1,POINT (10446304 -75516486)
2015,Junio,Francia,12,19,,31,POINT (3451668 -76532004)
2015,Junio,Francia,1165,2041,,3206,POINT (4697157 -74140516)
2015,Junio,Francia,2,2,,4,POINT (4815189 -75736374)
2015,Junio,Francia,6,14,,20,POINT (6170465 -7542726)
2015,Junio,Francia,0,1,,1,POINT (7128047 -73181317)
2015,Junio,Francia,0,1,,1,POINT (7927233 -72508188)
2015,Junio,Gabón,0,1,,1,POINT (4697157 -74140516)
2015,Junio,Georgia,0,2,,2,POINT (4697157 -74140516)
2015,Junio,Ghana,0,1,,1,POINT (4697157 -74140516)
2015,Junio,Ghana,1,0,,1,POINT (4815189 -75736374)
2015,Junio,Gibraltar/Territorio Británico de Ultramar,0,8,,8,POINT (11247723 -74213989)
2015,Junio,Granada,0,1,,1,POINT (4697157 -74140516)
2015,Junio,Grecia,0,1,,1,POINT (3451668 -76532004)
2015,Junio,Grecia,0,1,,1,POINT (3884426 -77061029)
2015,Junio,Grecia,0,5,,5,POINT (4697157 -74140516)
2015,Junio,Guatemala,6,8,,14,POINT (10446304 -75516486)
2015,Junio,Guatemala,2,6,,8,POINT (10886686 -74776479)
2015,Junio,Guatemala,7,13,,20,POINT (125862 -81702165)
2015,Junio,Guatemala,1,2,,3,POINT (133387613 -81372937)
2015,Junio,Guatemala,19,41,,60,POINT (3451668 -76532004)
2015,Junio,Guatemala,294,520,,814,POINT (4697157 -74140516)
2015,Junio,Guatemala,2,9,,11,POINT (4815189 -75736374)
2015,Junio,Guatemala,25,63,,88,POINT (6170465 -7542726)
2015,Junio,Guatemala,1,3,,4,POINT (7128047 -73181317)
2015,Junio,Guatemala,8,11,,19,POINT (7927233 -72508188)
2015,Junio,Guyana,0,1,,1,POINT (10406342 -75527794)
2015,Junio,Guadalupe/Territorio Francés,0,1,,1,POINT (10446304 -75516486)
2015,Junio,Guadalupe/Territorio Francés,0,4,,4,POINT (4697157 -74140516)
2015,Junio,Guayana Francesa/Departamento de Ultramar Francés,0,1,,1,POINT (10406342 -75527794)
2015,Junio,Haití,0,7,,7,POINT (10886686 -74776479)
2015,Junio,Haití,0,15,,15,POINT (4697157 -74140516)
2015,Junio,Haití,1,1,,2,POINT (6170465 -7542726)
2015,Junio,Haití,0,1,,1,POINT (7927233 -72508188)
2015,Junio,Honduras,5,4,,9,POINT (10446304 -75516486)
2015,Junio,Honduras,0,3,,3,POINT (10886686 -74776479)
2015,Junio,Honduras,0,3,,3,POINT (125744111 -81703935)
2015,Junio,Honduras,1,1,,2,POINT (125862 -81702165)
2015,Junio,Honduras,1,1,,2,POINT (133387613 -81372937)
2015,Junio,Honduras,14,13,,27,POINT (3451668 -76532004)
2015,Junio,Honduras,41,82,,123,POINT (4697157 -74140516)
2015,Junio,Honduras,1,1,,2,POINT (4815189 -75736374)
2015,Junio,Honduras,14,21,,35,POINT (6170465 -7542726)
2015,Junio,Honduras,1,1,,2,POINT (7128047 -73181317)
2015,Junio,Honduras,3,3,,6,POINT (7927233 -72508188)
2015,Junio,Hong Kong,4,4,,8,POINT (4697157 -74140516)
2015,Junio,Hong Kong,0,2,,2,POINT (6170465 -7542726)
2015,Junio,Hungría,6,8,,14,POINT (4697157 -74140516)
2015,Junio,India,0,1,,1,POINT (10886686 -74776479)
2015,Junio,India,0,6,,6,POINT (3451668 -76532004)
2015,Junio,India,6,28,,34,POINT (4697157 -74140516)
2015,Junio,India,4,3,,7,POINT (6170465 -7542726)
2015,Junio,India,0,1,,1,POINT (7927233 -72508188)
2015,Junio,Indonesia,0,5,,5,POINT (4697157 -74140516)
2015,Junio,Indonesia,1,3,,4,POINT (6170465 -7542726)
2015,Junio,República de Irlanda,5,13,,18,POINT (4697157 -74140516)
2015,Junio,República de Irlanda,3,0,,3,POINT (6170465 -7542726)
2015,Junio,Islandia,1,1,,2,POINT (4697157 -74140516)
2015,Junio,Israel,0,1,,1,POINT (10446304 -75516486)
2015,Junio,Israel,0,1,,1,POINT (10886686 -74776479)
2015,Junio,Israel,0,1,,1,POINT (3451668 -76532004)
2015,Junio,Israel,10,50,,60,POINT (4697157 -74140516)
2015,Junio,Italia,1,0,,1,POINT (10446304 -75516486)
2015,Junio,Italia,1,3,,4,POINT (10886686 -74776479)
2015,Junio,Italia,22,41,,63,POINT (3451668 -76532004)
2015,Junio,Italia,108,290,,398,POINT (4697157 -74140516)
2015,Junio,Italia,0,1,,1,POINT (4815189 -75736374)
2015,Junio,Italia,7,18,,25,POINT (6170465 -7542726)
2015,Junio,Italia,0,3,,3,POINT (7927233 -72508188)
2015,Junio,Jamaica,5,11,,16,POINT (10406342 -75527794)
2015,Junio,Jamaica,3,10,,13,POINT (125862 -81702165)
2015,Junio,Jamaica,1,3,,4,POINT (3451668 -76532004)
2015,Junio,Jamaica,9,14,,23,POINT (4697157 -74140516)
2015,Junio,Jamaica,0,2,,2,POINT (6170465 -7542726)
2015,Junio,Jamaica,1,0,,1,POINT (7128047 -73181317)
2015,Junio,Japón,0,7,,7,POINT (10406342 -75527794)
2015,Junio,Japón,0,3,,3,POINT (10446304 -75516486)
2015,Junio,Japón,0,2,,2,POINT (10970933 -74765343)
2015,Junio,Japón,2,3,,5,POINT (3451668 -76532004)
2015,Junio,Japón,2,18,,20,POINT (4697157 -74140516)
2015,Junio,Japón,2,7,,9,POINT (6170465 -7542726)
2015,Junio,Jordania,1,0,,1,POINT (4697157 -74140516)
2015,Junio,Kazajistán,0,1,,1,POINT (4697157 -74140516)
2015,Junio,Kenia,1,6,,7,POINT (3451668 -76532004)
2015,Junio,Kenia,1,4,,5,POINT (4697157 -74140516)
2015,Junio,Kenia,1,1,,2,POINT (6170465 -7542726)
2015,Junio,Kuwait,0,1,,1,POINT (4697157 -74140516)
2015,Junio,Letonia,3,5,,8,POINT (4697157 -74140516)
2015,Junio,Lituania,4,4,,8,POINT (4697157 -74140516)
2015,Junio,Líbano,5,7,,12,POINT (4697157 -74140516)
2015,Junio,Luxemburgo,0,1,,1,POINT (3451668 -76532004)
2015,Junio,Malasia,3,6,,9,POINT (4697157 -74140516)
2015,Junio,Malawi,0,1,,1,POINT (3451668 -76532004)
2015,Junio,Malí,0,1,,1,POINT (4697157 -74140516)
2015,Junio,Marruecos,2,1,,3,POINT (4697157 -74140516)
2015,Junio,Martinica/Departamento de Ultramar Francés,0,1,,1,POINT (4697157 -74140516)
2015,Junio,México,0,6,,6,POINT (10406342 -75527794)
2015,Junio,México,7,17,,24,POINT (10446304 -75516486)
2015,Junio,México,16,30,,46,POINT (10886686 -74776479)
2015,Junio,México,0,1,,1,POINT (10970933 -74765343)
2015,Junio,México,6,7,,13,POINT (125862 -81702165)
2015,Junio,México,56,107,,163,POINT (3451668 -76532004)
2015,Junio,México,4794,8162,,12956,POINT (4697157 -74140516)
2015,Junio,México,7,12,,19,POINT (4815189 -75736374)
2015,Junio,México,507,1115,,1622,POINT (6170465 -7542726)
2015,Junio,México,10,7,,17,POINT (7128047 -73181317)
2015,Junio,México,22,16,,38,POINT (7927233 -72508188)
2015,Junio,Mónaco,0,1,,1,POINT (4697157 -74140516)
2015,Junio,Mongolia,0,2,,2,POINT (4697157 -74140516)
2015,Junio,Montenegro,0,1,,1,POINT (6170465 -7542726)
2015,Junio,Mozambique,0,2,,2,POINT (3451668 -76532004)
2015,Junio,Mozambique,0,1,,1,POINT (4697157 -74140516)
2015,Junio,Nauru,2,0,,2,POINT (6170465 -7542726)
2015,Junio,Nepal,0,5,,5,POINT (4697157 -74140516)
2015,Junio,Nicaragua,2,8,,10,POINT (10406342 -75527794)
2015,Junio,Nicaragua,2,4,,6,POINT (10446304 -75516486)
2015,Junio,Nicaragua,1,1,,2,POINT (10886686 -74776479)
2015,Junio,Nicaragua,2,6,,8,POINT (125744111 -81703935)
2015,Junio,Nicaragua,8,4,,12,POINT (125862 -81702165)
2015,Junio,Nicaragua,10,12,,22,POINT (3451668 -76532004)
2015,Junio,Nicaragua,31,24,,55,POINT (4697157 -74140516)
2015,Junio,Nicaragua,1,5,,6,POINT (4815189 -75736374)
2015,Junio,Nicaragua,1,4,,5,POINT (6170465 -7542726)
2015,Junio,Nicaragua,1,0,,1,POINT (7128047 -73181317)
2015,Junio,Nicaragua,2,3,,5,POINT (7927233 -72508188)
2015,Junio,Nigeria,1,3,,4,POINT (4697157 -74140516)
2015,Junio,Noruega,0,5,,5,POINT (10886686 -74776479)
2015,Junio,Noruega,7,9,,16,POINT (3451668 -76532004)
2015,Junio,Noruega,24,36,,60,POINT (4697157 -74140516)
2015,Junio,Noruega,0,1,,1,POINT (6170465 -7542726)
2015,Junio,Noruega,2,1,,3,POINT (7128047 -73181317)
2015,Junio,Nueva Caledonia/Territorio francés,1,0,,1,POINT (4697157 -74140516)
2015,Junio,Nueva Zelanda,1,1,,2,POINT (10446304 -75516486)
2015,Junio,Nueva Zelanda,0,1,,1,POINT (3451668 -76532004)
2015,Junio,Nueva Zelanda,2,2,,4,POINT (4697157 -74140516)
2015,Junio,Nueva Zelanda,1,0,,1,POINT (7927233 -72508188)
2015,Junio,Omán,1,0,,1,POINT (4697157 -74140516)
2015,Junio,Omán,0,1,,1,POINT (6170465 -7542726)
2015,Junio,Pakistán,0,1,,1,POINT (3451668 -76532004)
2015,Junio,Pakistán,0,1,,1,POINT (4697157 -74140516)
2015,Junio,Panamá,181,263,,444,POINT (10406342 -75527794)
2015,Junio,Panamá,1608,1911,,3519,POINT (10446304 -75516486)
2015,Junio,Panamá,233,457,,690,POINT (10886686 -74776479)
2015,Junio,Panamá,0,21,,21,POINT (10970933 -74765343)
2015,Junio,Panamá,0,6,,6,POINT (11247723 -74213989)
2015,Junio,Panamá,0,1,,1,POINT (125744111 -81703935)
2015,Junio,Panamá,385,289,,674,POINT (125862 -81702165)
2015,Junio,Panamá,2,7,,9,POINT (133387613 -81372937)
2015,Junio,Panamá,335,462,,797,POINT (3451668 -76532004)
2015,Junio,Panamá,0,38,,38,POINT (3884426 -77061029)
2015,Junio,Panamá,3047,4975,,8022,POINT (4697157 -74140516)
2015,Junio,Panamá,32,80,,112,POINT (4815189 -75736374)
2015,Junio,Panamá,872,1535,,2407,POINT (6170465 -7542726)
2015,Junio,Panamá,1,1,,2,POINT (7102626 -77762647)
2015,Junio,Panamá,14,33,,47,POINT (7128047 -73181317)
2015,Junio,Panamá,114,133,,247,POINT (7927233 -72508188)
2015,Junio,Panamá,1,0,,1,POINT (806667 -767333)
2015,Junio,Panamá,75,88,,163,POINT (863337 -7735002)
2015,Junio,Paraguay,10,6,,16,POINT (10446304 -75516486)
2015,Junio,Paraguay,2,0,,2,POINT (10886686 -74776479)
2015,Junio,Paraguay,100,58,,158,POINT (125862 -81702165)
2015,Junio,Paraguay,12,17,,29,POINT (3451668 -76532004)
2015,Junio,Paraguay,71,63,,134,POINT (4697157 -74140516)
2015,Junio,Paraguay,1,1,,2,POINT (4815189 -75736374)
2015,Junio,Paraguay,12,53,,65,POINT (6170465 -7542726)
2015,Junio,Perú,141,222,,363,POINT (-4191162 -69941498)
2015,Junio,Perú,1,2,,3,POINT (-4214082 -69941431)
2015,Junio,Perú,8,34,,42,POINT (0.81488 -77356)
2015,Junio,Perú,0,4,,4,POINT (10406342 -75527794)
2015,Junio,Perú,15,8,,23,POINT (10446304 -75516486)
2015,Junio,Perú,1,8,,9,POINT (10886686 -74776479)
2015,Junio,Perú,120,85,,205,POINT (125862 -81702165)
2015,Junio,Perú,206,308,,514,POINT (3451668 -76532004)
2015,Junio,Perú,0,1,,1,POINT (3884426 -77061029)
2015,Junio,Perú,4683,6810,,11493,POINT (4697157 -74140516)
2015,Junio,Perú,1,2,,3,POINT (4815189 -75736374)
2015,Junio,Perú,244,401,,645,POINT (6170465 -7542726)
2015,Junio,Perú,2,1,,3,POINT (7128047 -73181317)
2015,Junio,Perú,2,5,,7,POINT (7927233 -72508188)
2015,Junio,Polonia,0,3,,3,POINT (10886686 -74776479)
2015,Junio,Polonia,8,10,,18,POINT (4697157 -74140516)
2015,Junio,Polonia,0,1,,1,POINT (6170465 -7542726)
2015,Junio,Portugal,1,1,,2,POINT (3451668 -76532004)
2015,Junio,Portugal,321,558,,879,POINT (4697157 -74140516)
2015,Junio,Portugal,1,1,,2,POINT (6170465 -7542726)
2015,Junio,Portugal,1,0,,1,POINT (7927233 -72508188)
2015,Junio,Puerto Rico/Territorio de Estados Unidos,0,2,,2,POINT (10446304 -75516486)
2015,Junio,Puerto Rico/Territorio de Estados Unidos,3,35,,38,POINT (10886686 -74776479)
2015,Junio,Puerto Rico/Territorio de Estados Unidos,1,2,,3,POINT (125862 -81702165)
2015,Junio,Puerto Rico/Territorio de Estados Unidos,32,37,,69,POINT (3451668 -76532004)
2015,Junio,Puerto Rico/Territorio de Estados Unidos,354,419,,773,POINT (4697157 -74140516)
2015,Junio,Puerto Rico/Territorio de Estados Unidos,4,7,,11,POINT (4815189 -75736374)
2015,Junio,Puerto Rico/Territorio de Estados Unidos,36,79,,115,POINT (6170465 -7542726)
2015,Junio,Puerto Rico/Territorio de Estados Unidos,3,4,,7,POINT (7128047 -73181317)
2015,Junio,Puerto Rico/Territorio de Estados Unidos,0,2,,2,POINT (7927233 -72508188)
2015,Junio,Qatar,1,2,,3,POINT (4697157 -74140516)
2015,Junio,Qatar,2,2,,4,POINT (6170465 -7542726)
2015,Junio,Reino Unido de Gran Bretaña e Irlanda del Norte,1,4,,5,POINT (10446304 -75516486)
2015,Junio,Reino Unido de Gran Bretaña e Irlanda del Norte,0,1,,1,POINT (10886686 -74776479)
2015,Junio,Reino Unido de Gran Bretaña e Irlanda del Norte,3,0,,3,POINT (125862 -81702165)
2015,Junio,Reino Unido de Gran Bretaña e Irlanda del Norte,14,16,,30,POINT (3451668 -76532004)
2015,Junio,Reino Unido de Gran Bretaña e Irlanda del Norte,0,1,,1,POINT (3884426 -77061029)
2015,Junio,Reino Unido de Gran Bretaña e Irlanda del Norte,371,647,,1018,POINT (4697157 -74140516)
2015,Junio,Reino Unido de Gran Bretaña e Irlanda del Norte,2,0,,2,POINT (4815189 -75736374)
2015,Junio,Reino Unido de Gran Bretaña e Irlanda del Norte,4,14,,18,POINT (6170465 -7542726)
2015,Junio,República CentroÁfricana,1,1,,2,POINT (4697157 -74140516)
2015,Junio,Federación de Rusia,0,6,,6,POINT (11247723 -74213989)
2015,Junio,Federación de Rusia,1,3,,4,POINT (3451668 -76532004)
2015,Junio,Federación de Rusia,12,21,,33,POINT (4697157 -74140516)
2015,Junio,República Dominicana,2,6,,8,POINT (10446304 -75516486)
2015,Junio,República Dominicana,6,13,,19,POINT (10886686 -74776479)
2015,Junio,República Dominicana,22,32,,54,POINT (3451668 -76532004)
2015,Junio,República Dominicana,520,739,,1259,POINT (4697157 -74140516)
2015,Junio,República Dominicana,0,3,,3,POINT (4815189 -75736374)
2015,Junio,República Dominicana,33,49,,82,POINT (6170465 -7542726)
2015,Junio,República Dominicana,0,3,,3,POINT (7128047 -73181317)
2015,Junio,República Dominicana,5,6,,11,POINT (7927233 -72508188)
2015,Junio,Rumania,0,3,,3,POINT (4697157 -74140516)
2015,Junio,Rwanda,0,1,,1,POINT (3451668 -76532004)
2015,Junio,San Cristóbal y Nevis,1,15,,16,POINT (10446304 -75516486)
2015,Junio,San Cristóbal y Nevis,0,1,,1,POINT (6170465 -7542726)
2015,Junio,Santa Lucia,1,1,,2,POINT (7128047 -73181317)
2015,Junio,Santo Tomé y Príncipe,1,0,,1,POINT (4697157 -74140516)
2015,Junio,Senegal,0,2,,2,POINT (4697157 -74140516)
2015,Junio,Serbia,1,1,,2,POINT (4697157 -74140516)
2015,Junio,Seychelles,0,2,,2,POINT (4697157 -74140516)
2015,Junio,Singapur,0,1,,1,POINT (3451668 -76532004)
2015,Junio,Singapur,4,6,,10,POINT (4697157 -74140516)
2015,Junio,Sudáfrica,4,9,,13,POINT (4697157 -74140516)
2015,Junio,Sudáfrica,0,1,,1,POINT (6170465 -7542726)
2015,Junio,Suecia,2,0,,2,POINT (10446304 -75516486)
2015,Junio,Suecia,1,0,,1,POINT (10886686 -74776479)
2015,Junio,Suecia,18,9,,27,POINT (3451668 -76532004)
2015,Junio,Suecia,34,45,,79,POINT (4697157 -74140516)
2015,Junio,Suecia,2,8,,10,POINT (6170465 -7542726)
2015,Junio,Suecia,0,1,,1,POINT (7128047 -73181317)
2015,Junio,Suiza,1,0,,1,POINT (10886686 -74776479)
2015,Junio,Suiza,17,30,,47,POINT (3451668 -76532004)
2015,Junio,Suiza,60,90,,150,POINT (4697157 -74140516)
2015,Junio,Suiza,0,1,,1,POINT (4815189 -75736374)
2015,Junio,Suiza,5,16,,21,POINT (6170465 -7542726)
2015,Junio,Surinam,3,1,,4,POINT (4697157 -74140516)
2015,Junio,Taiwán,0,3,,3,POINT (3451668 -76532004)
2015,Junio,Taiwán,1,1,,2,POINT (4697157 -74140516)
2015,Junio,Tailandia,2,3,,5,POINT (4697157 -74140516)
2015,Junio,Tanzania,0,2,,2,POINT (4697157 -74140516)
2015,Junio,Togo,0,1,,1,POINT (6170465 -7542726)
2015,Junio,Trinidad y Tobago,0,1,,1,POINT (10406342 -75527794)
2015,Junio,Trinidad y Tobago,0,1,,1,POINT (10446304 -75516486)
2015,Junio,Trinidad y Tobago,0,7,,7,POINT (10970933 -74765343)
2015,Junio,Trinidad y Tobago,4,6,,10,POINT (3451668 -76532004)
2015,Junio,Trinidad y Tobago,6,15,,21,POINT (4697157 -74140516)
2015,Junio,Trinidad y Tobago,0,1,,1,POINT (4815189 -75736374)
2015,Junio,Trinidad y Tobago,3,12,,15,POINT (6170465 -7542726)
2015,Junio,Trinidad y Tobago,1,1,,2,POINT (7128047 -73181317)
2015,Junio,Trinidad y Tobago,0,5,,5,POINT (7927233 -72508188)
2015,Junio,Túnez,1,1,,2,POINT (4697157 -74140516)
2015,Junio,Turquía,0,1,,1,POINT (3451668 -76532004)
2015,Junio,Turquía,4,6,,10,POINT (4697157 -74140516)
2015,Junio,Turquía,2,2,,4,POINT (6170465 -7542726)
2015,Junio,Turquía,0,1,,1,POINT (7128047 -73181317)
2015,Junio,Ucrania,3,1,,4,POINT (4697157 -74140516)
2015,Junio,Uganda,1,0,,1,POINT (3451668 -76532004)
2015,Junio,Uganda,0,1,,1,POINT (4697157 -74140516)
2015,Junio,Uruguay,18,4,,22,POINT (10446304 -75516486)
2015,Junio,Uruguay,3,2,,5,POINT (10886686 -74776479)
2015,Junio,Uruguay,28,22,,50,POINT (125862 -81702165)
2015,Junio,Uruguay,13,22,,35,POINT (3451668 -76532004)
2015,Junio,Uruguay,69,89,,158,POINT (4697157 -74140516)
2015,Junio,Uruguay,0,1,,1,POINT (4815189 -75736374)
2015,Junio,Uruguay,42,68,,110,POINT (6170465 -7542726)
2015,Junio,Uzbekistán,1,0,,1,POINT (4697157 -74140516)
2015,Junio,Venezuela,0,26,,26,POINT (10406342 -75527794)
2015,Junio,Venezuela,9,30,,39,POINT (10446304 -75516486)
2015,Junio,Venezuela,15,75,,90,POINT (10886686 -74776479)
2015,Junio,Venezuela,0,1,,1,POINT (10970933 -74765343)
2015,Junio,Venezuela,0,4,,4,POINT (11117206 -74232675)
2015,Junio,Venezuela,0,1,,1,POINT (11247723 -74213989)
2015,Junio,Venezuela,1820,2608,,4428,POINT (11360029 -72129595)
2015,Junio,Venezuela,0,2,,2,POINT (125862 -81702165)
2015,Junio,Venezuela,14,29,,43,POINT (3451668 -76532004)
2015,Junio,Venezuela,13,9,,22,POINT (3866713 -67927521)
2015,Junio,Venezuela,3018,3716,,6734,POINT (4697157 -74140516)
2015,Junio,Venezuela,1,4,,5,POINT (4815189 -75736374)
2015,Junio,Venezuela,42,79,,121,POINT (6170465 -7542726)
2015,Junio,Venezuela,214,397,,611,POINT (6185536 -67484028)
2015,Junio,Venezuela,130,200,,330,POINT (7088729 -70740253)
2015,Junio,Venezuela,1,2,,3,POINT (7128047 -73181317)
2015,Junio,Venezuela,3055,3996,,7051,POINT (7819 -72453013)
2015,Junio,Venezuela,201,217,,418,POINT (7927233 -72508188)
2015,Junio,Vietnam,1,2,,3,POINT (4697157 -74140516)
2015,Junio,Vietnam,1,0,,1,POINT (6170465 -7542726)
2015,Junio,Islas Vírgenes Británicas/Territorio Británico de Ultramar,0,4,,4,POINT (11247723 -74213989)
2015,Junio,Islas Vírgenes Británicas/Territorio Británico de Ultramar,1,7,,8,POINT (4697157 -74140516)
2015,Junio,República Árabe de Yemen,1,1,,2,POINT (4697157 -74140516)
2015,Junio,Desconocido,2,1,,3,POINT (125744111 -81703935)
2015,Junio,Desconocido,3,37,,40,POINT (4697157 -74140516)
2015,Junio,Desconocido,1,2,,3,POINT (7088729 -70740253)
2015,Junio,Desconocido,0,4,,4,POINT (9402597 -75681642)
2015,Julio,Alemania,5,5,,10,POINT (10886686 -74776479)
2015,Julio,Alemania,3,1,,4,POINT (125862 -81702165)
2015,Julio,Alemania,99,73,,172,POINT (3451668 -76532004)
2015,Julio,Alemania,1801,2485,,4286,POINT (4697157 -74140516)
2015,Julio,Alemania,0,1,,1,POINT (4815189 -75736374)
2015,Julio,Alemania,37,41,,78,POINT (6170465 -7542726)
2015,Julio,Alemania,0,1,,1,POINT (7128047 -73181317)
2015,Julio,Angola,0,1,,1,POINT (4697157 -74140516)
2015,Julio,Antigua y Barbuda,1,2,,3,POINT (3451668 -76532004)
2015,Julio,Antigua y Barbuda,3,2,,5,POINT (4697157 -74140516)
2015,Julio,Antigua y Barbuda,1,1,,2,POINT (6170465 -7542726)
2015,Julio,Países Bajos,0,2,,2,POINT (10406342 -75527794)
2015,Julio,Países Bajos,1,3,,4,POINT (10446304 -75516486)
2015,Julio,Países Bajos,80,96,,176,POINT (10886686 -74776479)
2015,Julio,Países Bajos,150,260,,410,POINT (3451668 -76532004)
2015,Julio,Países Bajos,893,1146,,2039,POINT (4697157 -74140516)
2015,Julio,Países Bajos,2,6,,8,POINT (4815189 -75736374)
2015,Julio,Países Bajos,397,436,,833,POINT (6170465 -7542726)
2015,Julio,Países Bajos,3,5,,8,POINT (7128047 -73181317)
2015,Julio,Países Bajos,2,1,,3,POINT (7927233 -72508188)
2015,Julio,Arabia Saudita,0,1,,1,POINT (3451668 -76532004)
2015,Julio,Arabia Saudita,1,6,,7,POINT (4697157 -74140516)
2015,Julio,Arabia Saudita,0,1,,1,POINT (6170465 -7542726)
2015,Julio,Argelia,1,4,,5,POINT (4697157 -74140516)
2015,Julio,Argentina,5,11,,16,POINT (0.81488 -77356)
2015,Julio,Argentina,49,34,,83,POINT (10446304 -75516486)
2015,Julio,Argentina,6,23,,29,POINT (10886686 -74776479)
2015,Julio,Argentina,168,124,,292,POINT (125862 -81702165)
2015,Julio,Argentina,82,81,,163,POINT (3451668 -76532004)
2015,Julio,Argentina,2437,3107,,5544,POINT (4697157 -74140516)
2015,Julio,Argentina,4,0,,4,POINT (4815189 -75736374)
2015,Julio,Argentina,104,138,,242,POINT (6170465 -7542726)
2015,Julio,Argentina,0,2,,2,POINT (7128047 -73181317)
2015,Julio,República de Armenia,0,1,,1,POINT (3451668 -76532004)
2015,Julio,Aruba,0,4,,4,POINT (10406342 -75527794)
2015,Julio,Aruba,17,15,,32,POINT (10886686 -74776479)
2015,Julio,Aruba,1,1,,2,POINT (10970933 -74765343)
2015,Julio,Aruba,1,5,,6,POINT (11247723 -74213989)
2015,Julio,Aruba,8,9,,17,POINT (3451668 -76532004)
2015,Julio,Aruba,886,929,,1815,POINT (4697157 -74140516)
2015,Julio,Aruba,5,7,,12,POINT (4815189 -75736374)
2015,Julio,Aruba,99,126,,225,POINT (6170465 -7542726)
2015,Julio,Aruba,2,6,,8,POINT (7128047 -73181317)
2015,Julio,Aruba,0,1,,1,POINT (7927233 -72508188)
2015,Julio,Australia,1,2,,3,POINT (10446304 -75516486)
2015,Julio,Australia,0,1,,1,POINT (10886686 -74776479)
2015,Julio,Australia,22,30,,52,POINT (3451668 -76532004)
2015,Julio,Australia,17,39,,56,POINT (4697157 -74140516)
2015,Julio,Australia,9,14,,23,POINT (6170465 -7542726)
2015,Julio,Australia,0,1,,1,POINT (7128047 -73181317)
2015,Julio,Austria,9,17,,26,POINT (3451668 -76532004)
2015,Julio,Austria,26,24,,50,POINT (4697157 -74140516)
2015,Julio,Austria,2,2,,4,POINT (4815189 -75736374)
2015,Julio,Austria,3,5,,8,POINT (6170465 -7542726)
2015,Julio,Azerbaiyán,1,2,,3,POINT (4697157 -74140516)
2015,Julio,Bahamas,1,5,,6,POINT (10886686 -74776479)
2015,Julio,Bahamas,2,6,,8,POINT (3451668 -76532004)
2015,Julio,Bahamas,1,0,,1,POINT (4697157 -74140516)
2015,Julio,Bahamas,1,5,,6,POINT (6170465 -7542726)
2015,Julio,Bahréin,0,1,,1,POINT (10406342 -75527794)
2015,Julio,Bahréin,1,0,,1,POINT (10446304 -75516486)
2015,Julio,Bahréin,1,0,,1,POINT (3451668 -76532004)
2015,Julio,Bahréin,0,1,,1,POINT (4697157 -74140516)
2015,Julio,Bahréin,1,2,,3,POINT (6170465 -7542726)
2015,Julio,Barbados,3,0,,3,POINT (3451668 -76532004)
2015,Julio,Barbados,0,6,,6,POINT (4697157 -74140516)
2015,Julio,Barbados,1,0,,1,POINT (6170465 -7542726)
2015,Julio,República de Belarús,1,1,,2,POINT (11360029 -72129595)
2015,Julio,República de Belarús,1,3,,4,POINT (4697157 -74140516)
2015,Julio,República de Belarús,0,1,,1,POINT (6170465 -7542726)
2015,Julio,República de Belarús,1,2,,3,POINT (7927233 -72508188)
2015,Julio,Bélgica,0,1,,1,POINT (10886686 -74776479)
2015,Julio,Bélgica,10,13,,23,POINT (3451668 -76532004)
2015,Julio,Bélgica,59,70,,129,POINT (4697157 -74140516)
2015,Julio,Bélgica,0,1,,1,POINT (4815189 -75736374)
2015,Julio,Bélgica,12,20,,32,POINT (6170465 -7542726)
2015,Julio,Belice,7,9,,16,POINT (4697157 -74140516)
2015,Julio,Belice,0,4,,4,POINT (7128047 -73181317)
2015,Julio,Belice,0,1,,1,POINT (7927233 -72508188)
2015,Julio,Benín,0,1,,1,POINT (4697157 -74140516)
2015,Julio,Bolivia,0,1,,1,POINT (0.81488 -77356)
2015,Julio,Bolivia,2,0,,2,POINT (10446304 -75516486)
2015,Julio,Bolivia,0,1,,1,POINT (10886686 -74776479)
2015,Julio,Bolivia,10,10,,20,POINT (125862 -81702165)
2015,Julio,Bolivia,34,27,,61,POINT (3451668 -76532004)
2015,Julio,Bolivia,450,551,,1001,POINT (4697157 -74140516)
2015,Julio,Bolivia,2,2,,4,POINT (4815189 -75736374)
2015,Julio,Bolivia,22,21,,43,POINT (6170465 -7542726)
2015,Julio,Bolivia,0,1,,1,POINT (7128047 -73181317)
2015,Julio,Bolivia,0,1,,1,POINT (7927233 -72508188)
2015,Julio,Brasil,151,172,,323,POINT (-4191162 -69941498)
2015,Julio,Brasil,0,6,,6,POINT (-4214082 -69941431)
2015,Julio,Brasil,1,0,,1,POINT (0.81488 -77356)
2015,Julio,Brasil,0,8,,8,POINT (10406342 -75527794)
2015,Julio,Brasil,37,24,,61,POINT (10446304 -75516486)
2015,Julio,Brasil,7,9,,16,POINT (10886686 -74776479)
2015,Julio,Brasil,204,135,,339,POINT (125862 -81702165)
2015,Julio,Brasil,57,103,,160,POINT (3451668 -76532004)
2015,Julio,Brasil,4034,5379,,9413,POINT (4697157 -74140516)
2015,Julio,Brasil,1,2,,3,POINT (4815189 -75736374)
2015,Julio,Brasil,82,129,,211,POINT (6170465 -7542726)
2015,Julio,Brasil,1,4,,5,POINT (7128047 -73181317)
2015,Julio,Brasil,5,0,,5,POINT (7927233 -72508188)
2015,Julio,Bulgaria,1,1,,2,POINT (4697157 -74140516)
2015,Julio,Burundi,0,1,,1,POINT (4697157 -74140516)
2015,Julio,Cabo Verde,1,1,,2,POINT (4697157 -74140516)
2015,Julio,Islas Caimán/Territorio Británico de Ultramar,4,5,,9,POINT (125862 -81702165)
2015,Julio,Islas Caimán/Territorio Británico de Ultramar,4,4,,8,POINT (133387613 -81372937)
2015,Julio,Islas Caimán/Territorio Británico de Ultramar,1,2,,3,POINT (3451668 -76532004)
2015,Julio,Islas Caimán/Territorio Británico de Ultramar,0,6,,6,POINT (4697157 -74140516)
2015,Julio,Islas Caimán/Territorio Británico de Ultramar,0,1,,1,POINT (6170465 -7542726)
2015,Julio,Camboya,1,0,,1,POINT (4697157 -74140516)
2015,Julio,Canadá,0,3,,3,POINT (10406342 -75527794)
2015,Julio,Canadá,5,10,,15,POINT (10446304 -75516486)
2015,Julio,Canadá,11,16,,27,POINT (10886686 -74776479)
2015,Julio,Canadá,1,1,,2,POINT (125862 -81702165)
2015,Julio,Canadá,70,78,,148,POINT (3451668 -76532004)
2015,Julio,Canadá,668,885,,1553,POINT (4697157 -74140516)
2015,Julio,Canadá,9,5,,14,POINT (4815189 -75736374)
2015,Julio,Canadá,82,131,,213,POINT (6170465 -7542726)
2015,Julio,Canadá,6,10,,16,POINT (7128047 -73181317)
2015,Julio,Canadá,8,7,,15,POINT (7927233 -72508188)
2015,Julio,España,3,4,,7,POINT (10446304 -75516486)
2015,Julio,España,4,13,,17,POINT (10886686 -74776479)
2015,Julio,España,0,1,,1,POINT (10970933 -74765343)
2015,Julio,España,2,1,,3,POINT (125862 -81702165)
2015,Julio,España,590,970,,1560,POINT (3451668 -76532004)
2015,Julio,España,3079,5045,,8124,POINT (4697157 -74140516)
2015,Julio,España,5,9,,14,POINT (4815189 -75736374)
2015,Julio,España,382,670,,1052,POINT (6170465 -7542726)
2015,Julio,España,3,7,,10,POINT (7128047 -73181317)
2015,Julio,España,2,2,,4,POINT (7927233 -72508188)
2015,Julio,República Del Congo,0,1,,1,POINT (4697157 -74140516)
2015,Julio,República de Corea,2,13,,15,POINT (3451668 -76532004)
2015,Julio,República de Corea,8,16,,24,POINT (4697157 -74140516)
2015,Julio,República de Corea,3,6,,9,POINT (6170465 -7542726)
2015,Julio,República de Corea,0,2,,2,POINT (7927233 -72508188)
2015,Julio,Costa de Marfil,0,2,,2,POINT (3451668 -76532004)
2015,Julio,Costa de Marfil,0,5,,5,POINT (4697157 -74140516)
2015,Julio,Costa Rica,3,7,,10,POINT (10406342 -75527794)
2015,Julio,Costa Rica,4,7,,11,POINT (10446304 -75516486)
2015,Julio,Costa Rica,8,9,,17,POINT (10886686 -74776479)
2015,Julio,Costa Rica,0,6,,6,POINT (10970933 -74765343)
2015,Julio,Costa Rica,0,10,,10,POINT (125744111 -81703935)
2015,Julio,Costa Rica,130,121,,251,POINT (125862 -81702165)
2015,Julio,Costa Rica,15,27,,42,POINT (3451668 -76532004)
2015,Julio,Costa Rica,942,1497,,2439,POINT (4697157 -74140516)
2015,Julio,Costa Rica,2,3,,5,POINT (4815189 -75736374)
2015,Julio,Costa Rica,99,98,,197,POINT (6170465 -7542726)
2015,Julio,Costa Rica,1,1,,2,POINT (7128047 -73181317)
2015,Julio,Costa Rica,1,3,,4,POINT (7927233 -72508188)
2015,Julio,Costa Rica,0,1,,1,POINT (806667 -767333)
2015,Julio,Croacia,0,1,,1,POINT (3451668 -76532004)
2015,Julio,Croacia,2,5,,7,POINT (4697157 -74140516)
2015,Julio,Cuba,0,2,,2,POINT (10406342 -75527794)
2015,Julio,Cuba,1,1,,2,POINT (10446304 -75516486)
2015,Julio,Cuba,5,7,,12,POINT (10886686 -74776479)
2015,Julio,Cuba,7,9,,16,POINT (125862 -81702165)
2015,Julio,Cuba,15,28,,43,POINT (3451668 -76532004)
2015,Julio,Cuba,265,378,,643,POINT (4697157 -74140516)
2015,Julio,Cuba,0,7,,7,POINT (4815189 -75736374)
2015,Julio,Cuba,22,32,,54,POINT (6170465 -7542726)
2015,Julio,Cuba,5,1,,6,POINT (7128047 -73181317)
2015,Julio,Cuba,1,2,,3,POINT (7927233 -72508188)
2015,Julio,República Checa,0,1,,1,POINT (3451668 -76532004)
2015,Julio,República Checa,8,9,,17,POINT (4697157 -74140516)
2015,Julio,República Checa,2,1,,3,POINT (6170465 -7542726)
2015,Julio,República Checa,0,1,,1,POINT (7927233 -72508188)
2015,Julio,Chile,2,2,,4,POINT (0.81488 -77356)
2015,Julio,Chile,15,13,,28,POINT (10446304 -75516486)
2015,Julio,Chile,2,5,,7,POINT (10886686 -74776479)
2015,Julio,Chile,82,71,,153,POINT (125862 -81702165)
2015,Julio,Chile,30,58,,88,POINT (3451668 -76532004)
2015,Julio,Chile,3956,4864,,8820,POINT (4697157 -74140516)
2015,Julio,Chile,5,3,,8,POINT (4815189 -75736374)
2015,Julio,Chile,26,115,,141,POINT (6170465 -7542726)
2015,Julio,Chile,4,2,,6,POINT (7128047 -73181317)
2015,Julio,Chile,1,1,,2,POINT (7927233 -72508188)
2015,Julio,China,1,13,,14,POINT (3451668 -76532004)
2015,Julio,China,43,122,,165,POINT (4697157 -74140516)
2015,Julio,China,1,0,,1,POINT (4815189 -75736374)
2015,Julio,China,2,2,,4,POINT (6170465 -7542726)
2015,Julio,Chipre,0,2,,2,POINT (3451668 -76532004)
2015,Julio,Chipre,1,0,,1,POINT (4697157 -74140516)
2015,Julio,Chipre,1,0,,1,POINT (6170465 -7542726)
2015,Julio,Dinamarca,1,0,,1,POINT (10446304 -75516486)
2015,Julio,Dinamarca,11,16,,27,POINT (3451668 -76532004)
2015,Julio,Dinamarca,22,20,,42,POINT (4697157 -74140516)
2015,Julio,Dinamarca,2,1,,3,POINT (4815189 -75736374)
2015,Julio,Dinamarca,1,1,,2,POINT (7128047 -73181317)
2015,Julio,Dominica,2,2,,4,POINT (4697157 -74140516)
2015,Julio,Ecuador,62,194,,256,POINT (0.33002 -76876446)
2015,Julio,Ecuador,2,2,,4,POINT (0.812436 -77847006)
2015,Julio,Ecuador,3392,4637,,8029,POINT (0.81488 -77356)
2015,Julio,Ecuador,18,264,,282,POINT (1800143 -78802679)
2015,Julio,Ecuador,0,14,,14,POINT (10406342 -75527794)
2015,Julio,Ecuador,242,148,,390,POINT (10446304 -75516486)
2015,Julio,Ecuador,6,7,,13,POINT (10886686 -74776479)
2015,Julio,Ecuador,0,1,,1,POINT (11247723 -74213989)
2015,Julio,Ecuador,5,4,,9,POINT (125862 -81702165)
2015,Julio,Ecuador,400,474,,874,POINT (3451668 -76532004)
2015,Julio,Ecuador,3489,5024,,8513,POINT (4697157 -74140516)
2015,Julio,Ecuador,4,7,,11,POINT (4815189 -75736374)
2015,Julio,Ecuador,35,35,,70,POINT (6170465 -7542726)
2015,Julio,Ecuador,4,8,,12,POINT (7927233 -72508188)
2015,Julio,Egipto,7,4,,11,POINT (4697157 -74140516)
2015,Julio,Egipto,1,0,,1,POINT (6170465 -7542726)
2015,Julio,El Salvador,1,0,,1,POINT (10886686 -74776479)
2015,Julio,El Salvador,45,48,,93,POINT (125862 -81702165)
2015,Julio,El Salvador,121,156,,277,POINT (3451668 -76532004)
2015,Julio,El Salvador,921,1376,,2297,POINT (4697157 -74140516)
2015,Julio,El Salvador,0,1,,1,POINT (4815189 -75736374)
2015,Julio,El Salvador,141,256,,397,POINT (6170465 -7542726)
2015,Julio,El Salvador,0,2,,2,POINT (7927233 -72508188)
2015,Julio,Emiratos Árabes,1,1,,2,POINT (3451668 -76532004)
2015,Julio,Emiratos Árabes,8,19,,27,POINT (4697157 -74140516)
2015,Julio,Emiratos Árabes,0,1,,1,POINT (6170465 -7542726)
2015,Julio,Eslovaquia,0,2,,2,POINT (4697157 -74140516)
2015,Julio,Eslovaquia,1,1,,2,POINT (6170465 -7542726)
2015,Julio,Eslovenia,1,1,,2,POINT (3451668 -76532004)
2015,Julio,Eslovenia,2,5,,7,POINT (4697157 -74140516)
2015,Julio,Estados Unidos de América,1,34,,35,POINT (10406342 -75527794)
2015,Julio,Estados Unidos de América,2957,4029,,6986,POINT (10446304 -75516486)
2015,Julio,Estados Unidos de América,810,1140,,1950,POINT (10886686 -74776479)
2015,Julio,Estados Unidos de América,0,3,,3,POINT (10970933 -74765343)
2015,Julio,Estados Unidos de América,0,28,,28,POINT (11247723 -74213989)
2015,Julio,Estados Unidos de América,32,52,,84,POINT (125862 -81702165)
2015,Julio,Estados Unidos de América,1708,2178,,3886,POINT (3451668 -76532004)
2015,Julio,Estados Unidos de América,0,1,,1,POINT (3884426 -77061029)
2015,Julio,Estados Unidos de América,146,217,,363,POINT (445285 -75766353)
2015,Julio,Estados Unidos de América,11496,17508,,29004,POINT (4697157 -74140516)
2015,Julio,Estados Unidos de América,300,392,,692,POINT (4815189 -75736374)
2015,Julio,Estados Unidos de América,3266,5544,,8810,POINT (6170465 -7542726)
2015,Julio,Estados Unidos de América,90,110,,200,POINT (7128047 -73181317)
2015,Julio,Estados Unidos de América,83,64,,147,POINT (7927233 -72508188)
2015,Julio,Estados Unidos de América,0,2,,2,POINT (9402597 -75681642)
2015,Julio,Estonia,1,1,,2,POINT (4697157 -74140516)
2015,Julio,Etiopia,5,8,,13,POINT (4697157 -74140516)
2015,Julio,Filipinas,0,4,,4,POINT (10446304 -75516486)
2015,Julio,Filipinas,0,3,,3,POINT (10886686 -74776479)
2015,Julio,Filipinas,2,3,,5,POINT (4697157 -74140516)
2015,Julio,Filipinas,0,1,,1,POINT (6170465 -7542726)
2015,Julio,Finlandia,14,3,,17,POINT (3451668 -76532004)
2015,Julio,Finlandia,2,8,,10,POINT (4697157 -74140516)
2015,Julio,Finlandia,2,1,,3,POINT (6170465 -7542726)
2015,Julio,Francia,3,5,,8,POINT (10886686 -74776479)
2015,Julio,Francia,92,136,,228,POINT (3451668 -76532004)
2015,Julio,Francia,1612,2526,,4138,POINT (4697157 -74140516)
2015,Julio,Francia,2,6,,8,POINT (4815189 -75736374)
2015,Julio,Francia,46,69,,115,POINT (6170465 -7542726)
2015,Julio,Francia,5,8,,13,POINT (7128047 -73181317)
2015,Julio,Georgia,1,0,,1,POINT (3451668 -76532004)
2015,Julio,Georgia,0,1,,1,POINT (4697157 -74140516)
2015,Julio,Ghana,0,3,,3,POINT (4697157 -74140516)
2015,Julio,Gibraltar/Territorio Británico de Ultramar,2,1,,3,POINT (0.81488 -77356)
2015,Julio,Granada,1,0,,1,POINT (3451668 -76532004)
2015,Julio,Granada,0,1,,1,POINT (4697157 -74140516)
2015,Julio,Grecia,9,6,,15,POINT (4697157 -74140516)
2015,Julio,Grecia,3,2,,5,POINT (7927233 -72508188)
2015,Julio,Guatemala,8,11,,19,POINT (10446304 -75516486)
2015,Julio,Guatemala,6,11,,17,POINT (10886686 -74776479)
2015,Julio,Guatemala,42,49,,91,POINT (125862 -81702165)
2015,Julio,Guatemala,27,56,,83,POINT (3451668 -76532004)
2015,Julio,Guatemala,281,589,,870,POINT (4697157 -74140516)
2015,Julio,Guatemala,1,5,,6,POINT (4815189 -75736374)
2015,Julio,Guatemala,47,65,,112,POINT (6170465 -7542726)
2015,Julio,Guatemala,1,4,,5,POINT (7128047 -73181317)
2015,Julio,Guatemala,2,1,,3,POINT (7927233 -72508188)
2015,Julio,Guyana,0,1,,1,POINT (4697157 -74140516)
2015,Julio,Guinea Bissau,0,2,,2,POINT (3451668 -76532004)
2015,Julio,Guadalupe/Territorio Francés,1,5,,6,POINT (4697157 -74140516)
2015,Julio,Guadalupe/Territorio Francés,1,1,,2,POINT (6170465 -7542726)
2015,Julio,Guayana Francesa/Departamento de Ultramar Francés,2,2,,4,POINT (6170465 -7542726)
2015,Julio,Haití,1,1,,2,POINT (10406342 -75527794)
2015,Julio,Haití,0,5,,5,POINT (10446304 -75516486)
2015,Julio,Haití,0,1,,1,POINT (10886686 -74776479)
2015,Julio,Haití,2,4,,6,POINT (4697157 -74140516)
2015,Julio,Haití,0,1,,1,POINT (4815189 -75736374)
2015,Julio,Haití,0,1,,1,POINT (6170465 -7542726)
2015,Julio,Haití,0,1,,1,POINT (7927233 -72508188)
2015,Julio,Honduras,0,1,,1,POINT (10446304 -75516486)
2015,Julio,Honduras,6,5,,11,POINT (10886686 -74776479)
2015,Julio,Honduras,0,59,,59,POINT (125744111 -81703935)
2015,Julio,Honduras,0,3,,3,POINT (125862 -81702165)
2015,Julio,Honduras,12,14,,26,POINT (3451668 -76532004)
2015,Julio,Honduras,61,69,,130,POINT (4697157 -74140516)
2015,Julio,Honduras,22,31,,53,POINT (6170465 -7542726)
2015,Julio,Honduras,0,2,,2,POINT (7927233 -72508188)
2015,Julio,Hong Kong,7,6,,13,POINT (4697157 -74140516)
2015,Julio,Hong Kong,0,1,,1,POINT (6170465 -7542726)
2015,Julio,Hungría,0,1,,1,POINT (3451668 -76532004)
2015,Julio,Hungría,11,4,,15,POINT (4697157 -74140516)
2015,Julio,Hungría,0,2,,2,POINT (6170465 -7542726)
2015,Julio,India,0,2,,2,POINT (10886686 -74776479)
2015,Julio,India,0,9,,9,POINT (3451668 -76532004)
2015,Julio,India,1,31,,32,POINT (4697157 -74140516)
2015,Julio,India,0,1,,1,POINT (4815189 -75736374)
2015,Julio,India,1,1,,2,POINT (6170465 -7542726)
2015,Julio,Indonesia,4,11,,15,POINT (4697157 -74140516)
2015,Julio,Iraq,0,1,,1,POINT (4697157 -74140516)
2015,Julio,Irán,2,0,,2,POINT (4697157 -74140516)
2015,Julio,República de Irlanda,0,1,,1,POINT (10446304 -75516486)
2015,Julio,República de Irlanda,3,2,,5,POINT (3451668 -76532004)
2015,Julio,República de Irlanda,12,8,,20,POINT (4697157 -74140516)
2015,Julio,República de Irlanda,0,3,,3,POINT (6170465 -7542726)
2015,Julio,Islandia,0,2,,2,POINT (6170465 -7542726)
2015,Julio,Israel,0,1,,1,POINT (10446304 -75516486)
2015,Julio,Israel,3,2,,5,POINT (10886686 -74776479)
2015,Julio,Israel,0,3,,3,POINT (3451668 -76532004)
2015,Julio,Israel,21,68,,89,POINT (4697157 -74140516)
2015,Julio,Israel,0,3,,3,POINT (6170465 -7542726)
2015,Julio,Italia,3,6,,9,POINT (10886686 -74776479)
2015,Julio,Italia,40,93,,133,POINT (3451668 -76532004)
2015,Julio,Italia,126,242,,368,POINT (4697157 -74140516)
2015,Julio,Italia,1,1,,2,POINT (4815189 -75736374)
2015,Julio,Italia,16,34,,50,POINT (6170465 -7542726)
2015,Julio,Italia,1,1,,2,POINT (7128047 -73181317)
2015,Julio,Jamaica,2,6,,8,POINT (10406342 -75527794)
2015,Julio,Jamaica,1,3,,4,POINT (10446304 -75516486)
2015,Julio,Jamaica,0,6,,6,POINT (10886686 -74776479)
2015,Julio,Jamaica,0,1,,1,POINT (10970933 -74765343)
2015,Julio,Jamaica,0,4,,4,POINT (125744111 -81703935)
2015,Julio,Jamaica,16,18,,34,POINT (3451668 -76532004)
2015,Julio,Jamaica,8,9,,17,POINT (4697157 -74140516)
2015,Julio,Jamaica,0,3,,3,POINT (6170465 -7542726)
2015,Julio,Japón,0,1,,1,POINT (10886686 -74776479)
2015,Julio,Japón,8,14,,22,POINT (3451668 -76532004)
2015,Julio,Japón,13,26,,39,POINT (4697157 -74140516)
2015,Julio,Japón,0,4,,4,POINT (6170465 -7542726)
2015,Julio,Japón,0,1,,1,POINT (7927233 -72508188)
2015,Julio,Jordania,2,1,,3,POINT (4697157 -74140516)
2015,Julio,Kazajistán,3,0,,3,POINT (3451668 -76532004)
2015,Julio,Kenia,1,0,,1,POINT (10886686 -74776479)
2015,Julio,Kenia,12,21,,33,POINT (3451668 -76532004)
2015,Julio,Kenia,0,5,,5,POINT (4697157 -74140516)
2015,Julio,Kiribati,0,1,,1,POINT (4697157 -74140516)
2015,Julio,Kuwait,0,2,,2,POINT (3451668 -76532004)
2015,Julio,Lesoto,1,1,,2,POINT (4697157 -74140516)
2015,Julio,Letonia,5,2,,7,POINT (3451668 -76532004)
2015,Julio,Letonia,3,2,,5,POINT (4697157 -74140516)
2015,Julio,Lituania,0,2,,2,POINT (4697157 -74140516)
2015,Julio,Líbano,5,4,,9,POINT (4697157 -74140516)
2015,Julio,Luxemburgo,1,0,,1,POINT (3451668 -76532004)
2015,Julio,Luxemburgo,2,3,,5,POINT (4697157 -74140516)
2015,Julio,Macedonia,0,1,,1,POINT (4697157 -74140516)
2015,Julio,Malasia,1,2,,3,POINT (4697157 -74140516)
2015,Julio,Malta,1,0,,1,POINT (4697157 -74140516)
2015,Julio,Marruecos,0,1,,1,POINT (3451668 -76532004)
2015,Julio,Marruecos,0,1,,1,POINT (4697157 -74140516)
2015,Julio,Marruecos,0,2,,2,POINT (6170465 -7542726)
2015,Julio,Martinica/Departamento de Ultramar Francés,0,1,,1,POINT (7128047 -73181317)
2015,Julio,México,0,4,,4,POINT (10406342 -75527794)
2015,Julio,México,24,28,,52,POINT (10446304 -75516486)
2015,Julio,México,36,45,,81,POINT (10886686 -74776479)
2015,Julio,México,0,6,,6,POINT (10970933 -74765343)
2015,Julio,México,0,1,,1,POINT (11247723 -74213989)
2015,Julio,México,0,3,,3,POINT (125744111 -81703935)
2015,Julio,México,13,9,,22,POINT (125862 -81702165)
2015,Julio,México,66,101,,167,POINT (3451668 -76532004)
2015,Julio,México,5683,8700,,14383,POINT (4697157 -74140516)
2015,Julio,México,8,13,,21,POINT (4815189 -75736374)
2015,Julio,México,848,1673,,2521,POINT (6170465 -7542726)
2015,Julio,México,18,15,,33,POINT (7128047 -73181317)
2015,Julio,México,22,18,,40,POINT (7927233 -72508188)
2015,Julio,República de Moldavia,0,1,,1,POINT (3451668 -76532004)
2015,Julio,Nauru,0,1,,1,POINT (4697157 -74140516)
2015,Julio,Namibia,1,1,,2,POINT (4697157 -74140516)
2015,Julio,Nepal,1,0,,1,POINT (4697157 -74140516)
2015,Julio,Nicaragua,0,3,,3,POINT (10886686 -74776479)
2015,Julio,Nicaragua,3,7,,10,POINT (125862 -81702165)
2015,Julio,Nicaragua,10,27,,37,POINT (3451668 -76532004)
2015,Julio,Nicaragua,21,37,,58,POINT (4697157 -74140516)
2015,Julio,Nicaragua,4,6,,10,POINT (4815189 -75736374)
2015,Julio,Nicaragua,4,7,,11,POINT (6170465 -7542726)
2015,Julio,Nicaragua,3,3,,6,POINT (7927233 -72508188)
2015,Julio,Nigeria,0,1,,1,POINT (3451668 -76532004)
2015,Julio,Nigeria,0,3,,3,POINT (4697157 -74140516)
2015,Julio,Nigeria,0,1,,1,POINT (6170465 -7542726)
2015,Julio,Noruega,19,14,,33,POINT (3451668 -76532004)
2015,Julio,Noruega,38,23,,61,POINT (4697157 -74140516)
2015,Julio,Noruega,3,5,,8,POINT (6170465 -7542726)
2015,Julio,Nueva Zelanda,3,2,,5,POINT (3451668 -76532004)
2015,Julio,Nueva Zelanda,2,4,,6,POINT (4697157 -74140516)
2015,Julio,Nueva Zelanda,2,1,,3,POINT (6170465 -7542726)
2015,Julio,Omán,0,1,,1,POINT (3451668 -76532004)
2015,Julio,Omán,0,1,,1,POINT (4697157 -74140516)
2015,Julio,Panamá,144,256,,400,POINT (10406342 -75527794)
2015,Julio,Panamá,1721,1994,,3715,POINT (10446304 -75516486)
2015,Julio,Panamá,252,489,,741,POINT (10886686 -74776479)
2015,Julio,Panamá,0,20,,20,POINT (10970933 -74765343)
2015,Julio,Panamá,0,1,,1,POINT (125744111 -81703935)
2015,Julio,Panamá,70,110,,180,POINT (125862 -81702165)
2015,Julio,Panamá,233,418,,651,POINT (3451668 -76532004)
2015,Julio,Panamá,2,24,,26,POINT (3884426 -77061029)
2015,Julio,Panamá,3639,5502,,9141,POINT (4697157 -74140516)
2015,Julio,Panamá,50,92,,142,POINT (4815189 -75736374)
2015,Julio,Panamá,1293,2028,,3321,POINT (6170465 -7542726)
2015,Julio,Panamá,1,1,,2,POINT (6222552 -77401154)
2015,Julio,Panamá,0,3,,3,POINT (7102626 -77762647)
2015,Julio,Panamá,18,49,,67,POINT (7128047 -73181317)
2015,Julio,Panamá,120,149,,269,POINT (7927233 -72508188)
2015,Julio,Panamá,119,133,,252,POINT (863337 -7735002)
2015,Julio,Paraguay,4,3,,7,POINT (10446304 -75516486)
2015,Julio,Paraguay,39,28,,67,POINT (125862 -81702165)
2015,Julio,Paraguay,4,8,,12,POINT (3451668 -76532004)
2015,Julio,Paraguay,28,31,,59,POINT (4697157 -74140516)
2015,Julio,Paraguay,11,7,,18,POINT (6170465 -7542726)
2015,Julio,Perú,197,323,,520,POINT (-4191162 -69941498)
2015,Julio,Perú,1,1,,2,POINT (-4214082 -69941431)
2015,Julio,Perú,7,23,,30,POINT (0.81488 -77356)
2015,Julio,Perú,0,13,,13,POINT (1800143 -78802679)
2015,Julio,Perú,24,14,,38,POINT (10446304 -75516486)
2015,Julio,Perú,0,1,,1,POINT (10886686 -74776479)
2015,Julio,Perú,177,165,,342,POINT (125862 -81702165)
2015,Julio,Perú,307,400,,707,POINT (3451668 -76532004)
2015,Julio,Perú,6744,8406,,15150,POINT (4697157 -74140516)
2015,Julio,Perú,4,1,,5,POINT (4815189 -75736374)
2015,Julio,Perú,396,573,,969,POINT (6170465 -7542726)
2015,Julio,Perú,3,2,,5,POINT (7927233 -72508188)
2015,Julio,Polonia,7,6,,13,POINT (3451668 -76532004)
2015,Julio,Polonia,10,16,,26,POINT (4697157 -74140516)
2015,Julio,Polonia,0,1,,1,POINT (4815189 -75736374)
2015,Julio,Polonia,1,0,,1,POINT (6170465 -7542726)
2015,Julio,Portugal,3,7,,10,POINT (3451668 -76532004)
2015,Julio,Portugal,474,683,,1157,POINT (4697157 -74140516)
2015,Julio,Portugal,1,5,,6,POINT (6170465 -7542726)
2015,Julio,Portugal,1,0,,1,POINT (7128047 -73181317)
2015,Julio,Puerto Rico/Territorio de Estados Unidos,0,1,,1,POINT (10406342 -75527794)
2015,Julio,Puerto Rico/Territorio de Estados Unidos,3,5,,8,POINT (10446304 -75516486)
2015,Julio,Puerto Rico/Territorio de Estados Unidos,2,22,,24,POINT (10886686 -74776479)
2015,Julio,Puerto Rico/Territorio de Estados Unidos,7,2,,9,POINT (125862 -81702165)
2015,Julio,Puerto Rico/Territorio de Estados Unidos,24,62,,86,POINT (3451668 -76532004)
2015,Julio,Puerto Rico/Territorio de Estados Unidos,416,508,,924,POINT (4697157 -74140516)
2015,Julio,Puerto Rico/Territorio de Estados Unidos,15,18,,33,POINT (4815189 -75736374)
2015,Julio,Puerto Rico/Territorio de Estados Unidos,43,105,,148,POINT (6170465 -7542726)
2015,Julio,Puerto Rico/Territorio de Estados Unidos,4,7,,11,POINT (7128047 -73181317)
2015,Julio,Puerto Rico/Territorio de Estados Unidos,9,12,,21,POINT (7927233 -72508188)
2015,Julio,Qatar,0,2,,2,POINT (3451668 -76532004)
2015,Julio,Qatar,0,2,,2,POINT (4697157 -74140516)
2015,Julio,Qatar,1,1,,2,POINT (6170465 -7542726)
2015,Julio,Reino Unido de Gran Bretaña e Irlanda del Norte,3,2,,5,POINT (10446304 -75516486)
2015,Julio,Reino Unido de Gran Bretaña e Irlanda del Norte,1,0,,1,POINT (10886686 -74776479)
2015,Julio,Reino Unido de Gran Bretaña e Irlanda del Norte,29,33,,62,POINT (3451668 -76532004)
2015,Julio,Reino Unido de Gran Bretaña e Irlanda del Norte,844,1197,,2041,POINT (4697157 -74140516)
2015,Julio,Reino Unido de Gran Bretaña e Irlanda del Norte,0,1,,1,POINT (4815189 -75736374)
2015,Julio,Reino Unido de Gran Bretaña e Irlanda del Norte,10,20,,30,POINT (6170465 -7542726)
2015,Julio,Reino Unido de Gran Bretaña e Irlanda del Norte,4,5,,9,POINT (7128047 -73181317)
2015,Julio,Reino Unido de Gran Bretaña e Irlanda del Norte,1,1,,2,POINT (7927233 -72508188)
2015,Julio,República CentroÁfricana,1,0,,1,POINT (4697157 -74140516)
2015,Julio,Federación de Rusia,2,1,,3,POINT (3451668 -76532004)
2015,Julio,Federación de Rusia,26,42,,68,POINT (4697157 -74140516)
2015,Julio,Federación de Rusia,0,2,,2,POINT (4815189 -75736374)
2015,Julio,Federación de Rusia,1,0,,1,POINT (6170465 -7542726)
2015,Julio,República Dominicana,0,6,,6,POINT (10406342 -75527794)
2015,Julio,República Dominicana,4,3,,7,POINT (10446304 -75516486)
2015,Julio,República Dominicana,5,11,,16,POINT (10886686 -74776479)
2015,Julio,República Dominicana,0,5,,5,POINT (10970933 -74765343)
2015,Julio,República Dominicana,0,1,,1,POINT (11117206 -74232675)
2015,Julio,República Dominicana,0,1,,1,POINT (11247723 -74213989)
2015,Julio,República Dominicana,2,1,,3,POINT (125862 -81702165)
2015,Julio,República Dominicana,18,39,,57,POINT (3451668 -76532004)
2015,Julio,República Dominicana,480,734,,1214,POINT (4697157 -74140516)
2015,Julio,República Dominicana,3,6,,9,POINT (4815189 -75736374)
2015,Julio,República Dominicana,45,55,,100,POINT (6170465 -7542726)
2015,Julio,República Dominicana,5,17,,22,POINT (7128047 -73181317)
2015,Julio,República Dominicana,1,3,,4,POINT (7927233 -72508188)
2015,Julio,Reunión,2,1,,3,POINT (4697157 -74140516)
2015,Julio,Rumania,2,5,,7,POINT (3451668 -76532004)
2015,Julio,Rumania,4,6,,10,POINT (4697157 -74140516)
2015,Julio,Rumania,0,1,,1,POINT (6170465 -7542726)
2015,Julio,San Cristóbal y Nevis,3,2,,5,POINT (3451668 -76532004)
2015,Julio,San Cristóbal y Nevis,0,1,,1,POINT (4697157 -74140516)
2015,Julio,San Marino,1,1,,2,POINT (4697157 -74140516)
2015,Julio,San  Vicente y las Granadinas,2,0,,2,POINT (3451668 -76532004)
2015,Julio,San  Vicente y las Granadinas,2,0,,2,POINT (6170465 -7542726)
2015,Julio,Santa Lucia,1,1,,2,POINT (3451668 -76532004)
2015,Julio,Santa Lucia,1,3,,4,POINT (4697157 -74140516)
2015,Julio,Santo Tomé y Príncipe,0,1,,1,POINT (4697157 -74140516)
2015,Julio,Santo Tomé y Príncipe,2,0,,2,POINT (4815189 -75736374)
2015,Julio,Senegal,1,1,,2,POINT (3451668 -76532004)
2015,Julio,Senegal,2,0,,2,POINT (4697157 -74140516)
2015,Julio,Serbia,3,6,,9,POINT (4697157 -74140516)
2015,Julio,Singapur,1,3,,4,POINT (3451668 -76532004)
2015,Julio,Singapur,1,6,,7,POINT (4697157 -74140516)
2015,Julio,Sri Lanka,1,1,,2,POINT (3451668 -76532004)
2015,Julio,Sudáfrica,3,2,,5,POINT (3451668 -76532004)
2015,Julio,Sudáfrica,8,11,,19,POINT (4697157 -74140516)
2015,Julio,Sudán,1,0,,1,POINT (4697157 -74140516)
2015,Julio,Suecia,1,2,,3,POINT (10886686 -74776479)
2015,Julio,Suecia,15,28,,43,POINT (3451668 -76532004)
2015,Julio,Suecia,23,28,,51,POINT (4697157 -74140516)
2015,Julio,Suecia,3,6,,9,POINT (6170465 -7542726)
2015,Julio,Suiza,0,1,,1,POINT (10886686 -74776479)
2015,Julio,Suiza,33,69,,102,POINT (3451668 -76532004)
2015,Julio,Suiza,179,180,,359,POINT (4697157 -74140516)
2015,Julio,Suiza,3,2,,5,POINT (4815189 -75736374)
2015,Julio,Suiza,15,25,,40,POINT (6170465 -7542726)
2015,Julio,Suiza,1,0,,1,POINT (7128047 -73181317)
2015,Julio,Surinam,1,1,,2,POINT (4697157 -74140516)
2015,Julio,Taiwán,2,5,,7,POINT (4697157 -74140516)
2015,Julio,Taiwán,0,2,,2,POINT (6170465 -7542726)
2015,Julio,Taiwán,2,0,,2,POINT (7927233 -72508188)
2015,Julio,Tailandia,1,0,,1,POINT (3451668 -76532004)
2015,Julio,Tailandia,0,1,,1,POINT (4697157 -74140516)
2015,Julio,Togo,0,1,,1,POINT (4697157 -74140516)
2015,Julio,Trinidad y Tobago,1,9,,10,POINT (10406342 -75527794)
2015,Julio,Trinidad y Tobago,0,1,,1,POINT (10446304 -75516486)
2015,Julio,Trinidad y Tobago,0,1,,1,POINT (10970933 -74765343)
2015,Julio,Trinidad y Tobago,13,12,,25,POINT (3451668 -76532004)
2015,Julio,Trinidad y Tobago,11,13,,24,POINT (4697157 -74140516)
2015,Julio,Trinidad y Tobago,2,1,,3,POINT (4815189 -75736374)
2015,Julio,Trinidad y Tobago,9,8,,17,POINT (6170465 -7542726)
2015,Julio,Trinidad y Tobago,1,3,,4,POINT (7128047 -73181317)
2015,Julio,Trinidad y Tobago,0,1,,1,POINT (7927233 -72508188)
2015,Julio,Túnez,0,3,,3,POINT (4697157 -74140516)
2015,Julio,Turquía,6,14,,20,POINT (3451668 -76532004)
2015,Julio,Turquía,7,15,,22,POINT (4697157 -74140516)
2015,Julio,Turquía,0,2,,2,POINT (6170465 -7542726)
2015,Julio,Ucrania,0,1,,1,POINT (10886686 -74776479)
2015,Julio,Ucrania,1,1,,2,POINT (3451668 -76532004)
2015,Julio,Ucrania,7,6,,13,POINT (4697157 -74140516)
2015,Julio,Ucrania,1,0,,1,POINT (7128047 -73181317)
2015,Julio,Uganda,2,2,,4,POINT (3451668 -76532004)
2015,Julio,Uganda,0,1,,1,POINT (6170465 -7542726)
2015,Julio,Uruguay,2,0,,2,POINT (0.81488 -77356)
2015,Julio,Uruguay,16,13,,29,POINT (10446304 -75516486)
2015,Julio,Uruguay,0,3,,3,POINT (10886686 -74776479)
2015,Julio,Uruguay,41,36,,77,POINT (125862 -81702165)
2015,Julio,Uruguay,5,21,,26,POINT (3451668 -76532004)
2015,Julio,Uruguay,68,80,,148,POINT (4697157 -74140516)
2015,Julio,Uruguay,15,20,,35,POINT (6170465 -7542726)
2015,Julio,Uruguay,1,1,,2,POINT (7128047 -73181317)
2015,Julio,Uzbekistán,1,2,,3,POINT (3451668 -76532004)
2015,Julio,Venezuela,0,7,,7,POINT (10406342 -75527794)
2015,Julio,Venezuela,431,374,,805,POINT (10446304 -75516486)
2015,Julio,Venezuela,22,95,,117,POINT (10886686 -74776479)
2015,Julio,Venezuela,0,6,,6,POINT (10970933 -74765343)
2015,Julio,Venezuela,0,5,,5,POINT (11117206 -74232675)
2015,Julio,Venezuela,2696,3355,,6051,POINT (11360029 -72129595)
2015,Julio,Venezuela,2,0,,2,POINT (125862 -81702165)
2015,Julio,Venezuela,14,20,,34,POINT (3451668 -76532004)
2015,Julio,Venezuela,37,65,,102,POINT (3866713 -67927521)
2015,Julio,Venezuela,3920,4566,,8486,POINT (4697157 -74140516)
2015,Julio,Venezuela,7,8,,15,POINT (4815189 -75736374)
2015,Julio,Venezuela,856,898,,1754,POINT (6170465 -7542726)
2015,Julio,Venezuela,389,646,,1035,POINT (6185536 -67484028)
2015,Julio,Venezuela,70,115,,185,POINT (7088729 -70740253)
2015,Julio,Venezuela,1,1,,2,POINT (7128047 -73181317)
2015,Julio,Venezuela,4365,4980,,9345,POINT (7819 -72453013)
2015,Julio,Venezuela,342,315,,657,POINT (7927233 -72508188)
2015,Julio,Vietnam,1,1,,2,POINT (4697157 -74140516)
2015,Julio,Islas Vírgenes Británicas/Territorio Británico de Ultramar,0,1,,1,POINT (4697157 -74140516)
2015,Julio,Zambia,0,2,,2,POINT (3451668 -76532004)
2015,Julio,Zimbabue,1,1,,2,POINT (4697157 -74140516)
2015,Julio,Anguila/Territorio Británico de Ultramar,0,3,,3,POINT (10446304 -75516486)
2015,Julio,Anguila/Territorio Británico de Ultramar,1,0,,1,POINT (3451668 -76532004)
2015,Julio,Desconocido,8,11,,19,POINT (10406342 -75527794)
2015,Julio,Desconocido,0,1,,1,POINT (3451668 -76532004)
2015,Julio,Desconocido,5,46,,51,POINT (4697157 -74140516)
2015,Julio,Desconocido,0,1,,1,POINT (6170465 -7542726)
2015,Julio,Desconocido,0,12,,12,POINT (9402597 -75681642)
2015,Agosto,Afganistán,0,4,,4,POINT (4697157 -74140516)
2015,Agosto,Alemania,1,0,,1,POINT (0.81488 -77356)
2015,Agosto,Alemania,0,1,,1,POINT (10446304 -75516486)
2015,Agosto,Alemania,4,3,,7,POINT (10886686 -74776479)
2015,Agosto,Alemania,60,76,,136,POINT (3451668 -76532004)
2015,Agosto,Alemania,1857,2506,,4363,POINT (4697157 -74140516)
2015,Agosto,Alemania,0,1,,1,POINT (4815189 -75736374)
2015,Agosto,Alemania,35,31,,66,POINT (6170465 -7542726)
2015,Agosto,Alemania,0,1,,1,POINT (7128047 -73181317)
2015,Agosto,Andorra,1,0,,1,POINT (10886686 -74776479)
2015,Agosto,Angola,0,1,,1,POINT (4697157 -74140516)
2015,Agosto,Antigua y Barbuda,0,1,,1,POINT (10406342 -75527794)
2015,Agosto,Antigua y Barbuda,0,9,,9,POINT (10446304 -75516486)
2015,Agosto,Antigua y Barbuda,0,3,,3,POINT (4697157 -74140516)
2015,Agosto,Países Bajos,2,3,,5,POINT (10406342 -75527794)
2015,Agosto,Países Bajos,0,1,,1,POINT (10446304 -75516486)
2015,Agosto,Países Bajos,50,65,,115,POINT (10886686 -74776479)
2015,Agosto,Países Bajos,0,29,,29,POINT (10970933 -74765343)
2015,Agosto,Países Bajos,8,8,,16,POINT (11247723 -74213989)
2015,Agosto,Países Bajos,68,112,,180,POINT (3451668 -76532004)
2015,Agosto,Países Bajos,740,1077,,1817,POINT (4697157 -74140516)
2015,Agosto,Países Bajos,147,213,,360,POINT (6170465 -7542726)
2015,Agosto,Países Bajos,3,2,,5,POINT (7128047 -73181317)
2015,Agosto,Arabia Saudita,0,1,,1,POINT (4697157 -74140516)
2015,Agosto,Arabia Saudita,0,1,,1,POINT (6170465 -7542726)
2015,Agosto,Argelia,0,1,,1,POINT (4697157 -74140516)
2015,Agosto,Argelia,0,1,,1,POINT (6170465 -7542726)
2015,Agosto,Argentina,8,9,,17,POINT (0.81488 -77356)
2015,Agosto,Argentina,49,35,,84,POINT (10446304 -75516486)
2015,Agosto,Argentina,2,13,,15,POINT (10886686 -74776479)
2015,Agosto,Argentina,267,178,,445,POINT (125862 -81702165)
2015,Agosto,Argentina,57,94,,151,POINT (3451668 -76532004)
2015,Agosto,Argentina,0,8,,8,POINT (3884426 -77061029)
2015,Agosto,Argentina,2039,2946,,4985,POINT (4697157 -74140516)
2015,Agosto,Argentina,5,3,,8,POINT (4815189 -75736374)
2015,Agosto,Argentina,101,176,,277,POINT (6170465 -7542726)
2015,Agosto,Argentina,2,2,,4,POINT (7128047 -73181317)
2015,Agosto,Argentina,0,1,,1,POINT (7927233 -72508188)
2015,Agosto,República de Armenia,1,0,,1,POINT (4697157 -74140516)
2015,Agosto,Aruba,0,14,,14,POINT (10406342 -75527794)
2015,Agosto,Aruba,0,1,,1,POINT (10446304 -75516486)
2015,Agosto,Aruba,1,3,,4,POINT (10886686 -74776479)
2015,Agosto,Aruba,0,6,,6,POINT (10970933 -74765343)
2015,Agosto,Aruba,10,13,,23,POINT (11247723 -74213989)
2015,Agosto,Aruba,5,2,,7,POINT (3451668 -76532004)
2015,Agosto,Aruba,633,760,,1393,POINT (4697157 -74140516)
2015,Agosto,Aruba,0,1,,1,POINT (4815189 -75736374)
2015,Agosto,Aruba,72,100,,172,POINT (6170465 -7542726)
2015,Agosto,Aruba,7,7,,14,POINT (7128047 -73181317)
2015,Agosto,Australia,2,0,,2,POINT (10886686 -74776479)
2015,Agosto,Australia,2,3,,5,POINT (3451668 -76532004)
2015,Agosto,Australia,15,40,,55,POINT (4697157 -74140516)
2015,Agosto,Australia,1,0,,1,POINT (4815189 -75736374)
2015,Agosto,Australia,5,12,,17,POINT (6170465 -7542726)
2015,Agosto,Australia,0,1,,1,POINT (7128047 -73181317)
2015,Agosto,Austria,1,0,,1,POINT (10446304 -75516486)
2015,Agosto,Austria,1,0,,1,POINT (10886686 -74776479)
2015,Agosto,Austria,4,0,,4,POINT (3451668 -76532004)
2015,Agosto,Austria,24,27,,51,POINT (4697157 -74140516)
2015,Agosto,Austria,3,1,,4,POINT (6170465 -7542726)
2015,Agosto,Bahamas,0,1,,1,POINT (10406342 -75527794)
2015,Agosto,Bahamas,1,1,,2,POINT (10886686 -74776479)
2015,Agosto,Bahamas,0,1,,1,POINT (6170465 -7542726)
2015,Agosto,Bahréin,2,1,,3,POINT (4697157 -74140516)
2015,Agosto,Bahréin,0,1,,1,POINT (6170465 -7542726)
2015,Agosto,Barbados,0,1,,1,POINT (10446304 -75516486)
2015,Agosto,Barbados,1,0,,1,POINT (4697157 -74140516)
2015,Agosto,Barbados,1,0,,1,POINT (6170465 -7542726)
2015,Agosto,República de Belarús,1,0,,1,POINT (4697157 -74140516)
2015,Agosto,Bélgica,6,5,,11,POINT (3451668 -76532004)
2015,Agosto,Bélgica,36,42,,78,POINT (4697157 -74140516)
2015,Agosto,Bélgica,0,1,,1,POINT (4815189 -75736374)
2015,Agosto,Bélgica,2,3,,5,POINT (6170465 -7542726)
2015,Agosto,Belice,0,2,,2,POINT (10886686 -74776479)
2015,Agosto,Belice,2,9,,11,POINT (4697157 -74140516)
2015,Agosto,Benín,0,4,,4,POINT (4697157 -74140516)
2015,Agosto,Bermudas/Territorio Británico de Ultramar,3,0,,3,POINT (6170465 -7542726)
2015,Agosto,Bolivia,3,1,,4,POINT (10446304 -75516486)
2015,Agosto,Bolivia,1,1,,2,POINT (10886686 -74776479)
2015,Agosto,Bolivia,6,3,,9,POINT (125862 -81702165)
2015,Agosto,Bolivia,12,22,,34,POINT (3451668 -76532004)
2015,Agosto,Bolivia,382,523,,905,POINT (4697157 -74140516)
2015,Agosto,Bolivia,39,30,,69,POINT (6170465 -7542726)
2015,Agosto,Bolivia,1,3,,4,POINT (7128047 -73181317)
2015,Agosto,Botsuana,1,0,,1,POINT (4697157 -74140516)
2015,Agosto,Brasil,120,146,,266,POINT (-4191162 -69941498)
2015,Agosto,Brasil,3,8,,11,POINT (-4214082 -69941431)
2015,Agosto,Brasil,1,1,,2,POINT (0.81488 -77356)
2015,Agosto,Brasil,1,1,,2,POINT (10406342 -75527794)
2015,Agosto,Brasil,38,33,,71,POINT (10446304 -75516486)
2015,Agosto,Brasil,2,5,,7,POINT (10886686 -74776479)
2015,Agosto,Brasil,109,77,,186,POINT (125862 -81702165)
2015,Agosto,Brasil,30,79,,109,POINT (3451668 -76532004)
2015,Agosto,Brasil,3177,5331,,8508,POINT (4697157 -74140516)
2015,Agosto,Brasil,3,5,,8,POINT (4815189 -75736374)
2015,Agosto,Brasil,51,134,,185,POINT (6170465 -7542726)
2015,Agosto,Brasil,2,9,,11,POINT (7128047 -73181317)
2015,Agosto,Brasil,0,2,,2,POINT (7927233 -72508188)
2015,Agosto,Brunei Darussalam,0,1,,1,POINT (4697157 -74140516)
2015,Agosto,Bulgaria,2,1,,3,POINT (4697157 -74140516)
2015,Agosto,Islas Caimán/Territorio Británico de Ultramar,0,1,,1,POINT (10406342 -75527794)
2015,Agosto,Islas Caimán/Territorio Británico de Ultramar,0,2,,2,POINT (10886686 -74776479)
2015,Agosto,Islas Caimán/Territorio Británico de Ultramar,1,1,,2,POINT (125862 -81702165)
2015,Agosto,Islas Caimán/Territorio Británico de Ultramar,0,10,,10,POINT (4697157 -74140516)
2015,Agosto,Camboya,1,2,,3,POINT (4697157 -74140516)
2015,Agosto,Canadá,0,1,,1,POINT (10406342 -75527794)
2015,Agosto,Canadá,0,1,,1,POINT (10446304 -75516486)
2015,Agosto,Canadá,5,8,,13,POINT (10886686 -74776479)
2015,Agosto,Canadá,0,2,,2,POINT (11247723 -74213989)
2015,Agosto,Canadá,0,2,,2,POINT (125862 -81702165)
2015,Agosto,Canadá,47,43,,90,POINT (3451668 -76532004)
2015,Agosto,Canadá,641,901,,1542,POINT (4697157 -74140516)
2015,Agosto,Canadá,11,8,,19,POINT (4815189 -75736374)
2015,Agosto,Canadá,63,130,,193,POINT (6170465 -7542726)
2015,Agosto,Canadá,1,2,,3,POINT (7128047 -73181317)
2015,Agosto,Canadá,4,5,,9,POINT (7927233 -72508188)
2015,Agosto,España,2,2,,4,POINT (10406342 -75527794)
2015,Agosto,España,0,1,,1,POINT (10446304 -75516486)
2015,Agosto,España,0,3,,3,POINT (10886686 -74776479)
2015,Agosto,España,549,825,,1374,POINT (3451668 -76532004)
2015,Agosto,España,3757,5652,,9409,POINT (4697157 -74140516)
2015,Agosto,España,4,11,,15,POINT (4815189 -75736374)
2015,Agosto,España,422,622,,1044,POINT (6170465 -7542726)
2015,Agosto,España,7,8,,15,POINT (7128047 -73181317)
2015,Agosto,España,1,4,,5,POINT (7927233 -72508188)
2015,Agosto,República Democrática del Congo,0,1,,1,POINT (4697157 -74140516)
2015,Agosto,República de Corea,0,1,,1,POINT (10406342 -75527794)
2015,Agosto,República de Corea,1,1,,2,POINT (3451668 -76532004)
2015,Agosto,República de Corea,12,22,,34,POINT (4697157 -74140516)
2015,Agosto,República de Corea,0,1,,1,POINT (4815189 -75736374)
2015,Agosto,República de Corea,2,4,,6,POINT (6170465 -7542726)
2015,Agosto,República de Corea,0,5,,5,POINT (7927233 -72508188)
2015,Agosto,Costa de Marfil,3,3,,6,POINT (4697157 -74140516)
2015,Agosto,Costa de Marfil,1,0,,1,POINT (6170465 -7542726)
2015,Agosto,Costa Rica,2,7,,9,POINT (10446304 -75516486)
2015,Agosto,Costa Rica,8,4,,12,POINT (10886686 -74776479)
2015,Agosto,Costa Rica,0,3,,3,POINT (11117206 -74232675)
2015,Agosto,Costa Rica,0,8,,8,POINT (125744111 -81703935)
2015,Agosto,Costa Rica,94,104,,198,POINT (125862 -81702165)
2015,Agosto,Costa Rica,25,48,,73,POINT (3451668 -76532004)
2015,Agosto,Costa Rica,846,1352,,2198,POINT (4697157 -74140516)
2015,Agosto,Costa Rica,3,7,,10,POINT (4815189 -75736374)
2015,Agosto,Costa Rica,71,121,,192,POINT (6170465 -7542726)
2015,Agosto,Costa Rica,0,2,,2,POINT (7128047 -73181317)
2015,Agosto,Costa Rica,5,4,,9,POINT (7927233 -72508188)
2015,Agosto,Croacia,2,6,,8,POINT (4697157 -74140516)
2015,Agosto,Cuba,0,2,,2,POINT (10446304 -75516486)
2015,Agosto,Cuba,1,3,,4,POINT (10886686 -74776479)
2015,Agosto,Cuba,1,3,,4,POINT (125862 -81702165)
2015,Agosto,Cuba,17,21,,38,POINT (3451668 -76532004)
2015,Agosto,Cuba,295,486,,781,POINT (4697157 -74140516)
2015,Agosto,Cuba,2,3,,5,POINT (4815189 -75736374)
2015,Agosto,Cuba,34,48,,82,POINT (6170465 -7542726)
2015,Agosto,Cuba,1,2,,3,POINT (7128047 -73181317)
2015,Agosto,Cuba,2,2,,4,POINT (7927233 -72508188)
2015,Agosto,Curazao,0,4,,4,POINT (4697157 -74140516)
2015,Agosto,Curazao,0,1,,1,POINT (6170465 -7542726)
2015,Agosto,República Checa,2,5,,7,POINT (4697157 -74140516)
2015,Agosto,República Checa,0,1,,1,POINT (6170465 -7542726)
2015,Agosto,Chile,6,3,,9,POINT (0.81488 -77356)
2015,Agosto,Chile,6,4,,10,POINT (10446304 -75516486)
2015,Agosto,Chile,0,6,,6,POINT (10886686 -74776479)
2015,Agosto,Chile,28,19,,47,POINT (125862 -81702165)
2015,Agosto,Chile,36,70,,106,POINT (3451668 -76532004)
2015,Agosto,Chile,4278,5499,,9777,POINT (4697157 -74140516)
2015,Agosto,Chile,3,2,,5,POINT (4815189 -75736374)
2015,Agosto,Chile,27,74,,101,POINT (6170465 -7542726)
2015,Agosto,Chile,1,3,,4,POINT (7128047 -73181317)
2015,Agosto,China,0,1,,1,POINT (10446304 -75516486)
2015,Agosto,China,0,1,,1,POINT (3451668 -76532004)
2015,Agosto,China,39,85,,124,POINT (4697157 -74140516)
2015,Agosto,China,0,2,,2,POINT (6170465 -7542726)
2015,Agosto,Chipre,0,1,,1,POINT (4697157 -74140516)
2015,Agosto,Dinamarca,0,1,,1,POINT (10886686 -74776479)
2015,Agosto,Dinamarca,4,2,,6,POINT (3451668 -76532004)
2015,Agosto,Dinamarca,5,8,,13,POINT (4697157 -74140516)
2015,Agosto,Dinamarca,3,2,,5,POINT (6170465 -7542726)
2015,Agosto,Dominica,0,1,,1,POINT (10406342 -75527794)
2015,Agosto,Dominica,0,1,,1,POINT (10446304 -75516486)
2015,Agosto,Dominica,0,3,,3,POINT (4697157 -74140516)
2015,Agosto,Ecuador,93,230,,323,POINT (0.33002 -76876446)
2015,Agosto,Ecuador,5,14,,19,POINT (0.812436 -77847006)
2015,Agosto,Ecuador,4081,5460,,9541,POINT (0.81488 -77356)
2015,Agosto,Ecuador,25,240,,265,POINT (1800143 -78802679)
2015,Agosto,Ecuador,385,322,,707,POINT (10446304 -75516486)
2015,Agosto,Ecuador,3,5,,8,POINT (10886686 -74776479)
2015,Agosto,Ecuador,0,4,,4,POINT (11117206 -74232675)
2015,Agosto,Ecuador,8,10,,18,POINT (125862 -81702165)
2015,Agosto,Ecuador,479,599,,1078,POINT (3451668 -76532004)
2015,Agosto,Ecuador,0,5,,5,POINT (3884426 -77061029)
2015,Agosto,Ecuador,3756,4887,,8643,POINT (4697157 -74140516)
2015,Agosto,Ecuador,1,2,,3,POINT (4815189 -75736374)
2015,Agosto,Ecuador,13,38,,51,POINT (6170465 -7542726)
2015,Agosto,Ecuador,1,0,,1,POINT (7927233 -72508188)
2015,Agosto,Egipto,0,5,,5,POINT (4697157 -74140516)
2015,Agosto,El Salvador,1,0,,1,POINT (10886686 -74776479)
2015,Agosto,El Salvador,113,77,,190,POINT (125862 -81702165)
2015,Agosto,El Salvador,102,163,,265,POINT (3451668 -76532004)
2015,Agosto,El Salvador,997,1400,,2397,POINT (4697157 -74140516)
2015,Agosto,El Salvador,168,268,,436,POINT (6170465 -7542726)
2015,Agosto,Emiratos Árabes,5,2,,7,POINT (4697157 -74140516)
2015,Agosto,Eritrea,0,1,,1,POINT (4697157 -74140516)
2015,Agosto,Eslovaquia,1,1,,2,POINT (4697157 -74140516)
2015,Agosto,Estados Unidos de América,0,34,,34,POINT (10406342 -75527794)
2015,Agosto,Estados Unidos de América,2920,4061,,6981,POINT (10446304 -75516486)
2015,Agosto,Estados Unidos de América,632,1107,,1739,POINT (10886686 -74776479)
2015,Agosto,Estados Unidos de América,0,3,,3,POINT (10970933 -74765343)
2015,Agosto,Estados Unidos de América,0,6,,6,POINT (11247723 -74213989)
2015,Agosto,Estados Unidos de América,10,20,,30,POINT (125862 -81702165)
2015,Agosto,Estados Unidos de América,1195,1532,,2727,POINT (3451668 -76532004)
2015,Agosto,Estados Unidos de América,97,154,,251,POINT (445285 -75766353)
2015,Agosto,Estados Unidos de América,9719,16443,,26162,POINT (4697157 -74140516)
2015,Agosto,Estados Unidos de América,185,225,,410,POINT (4815189 -75736374)
2015,Agosto,Estados Unidos de América,2704,5103,,7807,POINT (6170465 -7542726)
2015,Agosto,Estados Unidos de América,31,54,,85,POINT (7128047 -73181317)
2015,Agosto,Estados Unidos de América,58,71,,129,POINT (7927233 -72508188)
2015,Agosto,Estados Unidos de América,0,1,,1,POINT (806667 -767333)
2015,Agosto,Estonia,1,0,,1,POINT (6170465 -7542726)
2015,Agosto,Etiopia,1,0,,1,POINT (4697157 -74140516)
2015,Agosto,Islas Fiji,0,1,,1,POINT (6170465 -7542726)
2015,Agosto,Filipinas,0,5,,5,POINT (10446304 -75516486)
2015,Agosto,Filipinas,0,1,,1,POINT (10886686 -74776479)
2015,Agosto,Filipinas,0,3,,3,POINT (3451668 -76532004)
2015,Agosto,Filipinas,2,15,,17,POINT (4697157 -74140516)
2015,Agosto,Finlandia,1,0,,1,POINT (3451668 -76532004)
2015,Agosto,Finlandia,1,2,,3,POINT (4697157 -74140516)
2015,Agosto,Francia,1,6,,7,POINT (10406342 -75527794)
2015,Agosto,Francia,1,0,,1,POINT (10886686 -74776479)
2015,Agosto,Francia,0,3,,3,POINT (125862 -81702165)
2015,Agosto,Francia,43,53,,96,POINT (3451668 -76532004)
2015,Agosto,Francia,1583,2601,,4184,POINT (4697157 -74140516)
2015,Agosto,Francia,0,1,,1,POINT (4815189 -75736374)
2015,Agosto,Francia,18,31,,49,POINT (6170465 -7542726)
2015,Agosto,Francia,1,2,,3,POINT (7128047 -73181317)
2015,Agosto,Francia,0,1,,1,POINT (806667 -767333)
2015,Agosto,Ghana,0,4,,4,POINT (4697157 -74140516)
2015,Agosto,Grecia,0,1,,1,POINT (3451668 -76532004)
2015,Agosto,Grecia,5,7,,12,POINT (4697157 -74140516)
2015,Agosto,Grecia,2,2,,4,POINT (6170465 -7542726)
2015,Agosto,Grecia,0,4,,4,POINT (806667 -767333)
2015,Agosto,Guatemala,2,4,,6,POINT (10446304 -75516486)
2015,Agosto,Guatemala,1,3,,4,POINT (10886686 -74776479)
2015,Agosto,Guatemala,21,28,,49,POINT (125862 -81702165)
2015,Agosto,Guatemala,23,70,,93,POINT (3451668 -76532004)
2015,Agosto,Guatemala,285,572,,857,POINT (4697157 -74140516)
2015,Agosto,Guatemala,7,5,,12,POINT (4815189 -75736374)
2015,Agosto,Guatemala,37,73,,110,POINT (6170465 -7542726)
2015,Agosto,Guatemala,6,2,,8,POINT (7128047 -73181317)
2015,Agosto,Guatemala,6,4,,10,POINT (7927233 -72508188)
2015,Agosto,Guyana,0,1,,1,POINT (10446304 -75516486)
2015,Agosto,Guyana,0,1,,1,POINT (4697157 -74140516)
2015,Agosto,Guadalupe/Territorio Francés,1,0,,1,POINT (10886686 -74776479)
2015,Agosto,Guadalupe/Territorio Francés,2,4,,6,POINT (4697157 -74140516)
2015,Agosto,Guadalupe/Territorio Francés,1,0,,1,POINT (7927233 -72508188)
2015,Agosto,Guayana Francesa/Departamento de Ultramar Francés,1,1,,2,POINT (4697157 -74140516)
2015,Agosto,Haití,0,1,,1,POINT (3451668 -76532004)
2015,Agosto,Haití,2,14,,16,POINT (4697157 -74140516)
2015,Agosto,Haití,1,0,,1,POINT (6170465 -7542726)
2015,Agosto,Honduras,0,1,,1,POINT (10406342 -75527794)
2015,Agosto,Honduras,1,1,,2,POINT (10446304 -75516486)
2015,Agosto,Honduras,0,2,,2,POINT (10886686 -74776479)
2015,Agosto,Honduras,0,14,,14,POINT (125744111 -81703935)
2015,Agosto,Honduras,1,0,,1,POINT (125862 -81702165)
2015,Agosto,Honduras,1,2,,3,POINT (133387613 -81372937)
2015,Agosto,Honduras,13,20,,33,POINT (3451668 -76532004)
2015,Agosto,Honduras,56,80,,136,POINT (4697157 -74140516)
2015,Agosto,Honduras,2,0,,2,POINT (4815189 -75736374)
2015,Agosto,Honduras,15,48,,63,POINT (6170465 -7542726)
2015,Agosto,Honduras,3,0,,3,POINT (7128047 -73181317)
2015,Agosto,Honduras,0,3,,3,POINT (7927233 -72508188)
2015,Agosto,Hong Kong,0,1,,1,POINT (10886686 -74776479)
2015,Agosto,Hong Kong,1,0,,1,POINT (3451668 -76532004)
2015,Agosto,Hong Kong,2,4,,6,POINT (4697157 -74140516)
2015,Agosto,Hong Kong,1,1,,2,POINT (6170465 -7542726)
2015,Agosto,Hungría,1,6,,7,POINT (4697157 -74140516)
2015,Agosto,Hungría,1,0,,1,POINT (6170465 -7542726)
2015,Agosto,India,0,1,,1,POINT (10886686 -74776479)
2015,Agosto,India,0,14,,14,POINT (3451668 -76532004)
2015,Agosto,India,9,39,,48,POINT (4697157 -74140516)
2015,Agosto,India,2,22,,24,POINT (6170465 -7542726)
2015,Agosto,Indonesia,3,5,,8,POINT (4697157 -74140516)
2015,Agosto,Iraq,1,0,,1,POINT (4697157 -74140516)
2015,Agosto,Irán,1,2,,3,POINT (4697157 -74140516)
2015,Agosto,República de Irlanda,0,3,,3,POINT (3451668 -76532004)
2015,Agosto,República de Irlanda,8,19,,27,POINT (4697157 -74140516)
2015,Agosto,República de Irlanda,2,7,,9,POINT (6170465 -7542726)
2015,Agosto,Israel,2,0,,2,POINT (10446304 -75516486)
2015,Agosto,Israel,2,2,,4,POINT (3451668 -76532004)
2015,Agosto,Israel,20,71,,91,POINT (4697157 -74140516)
2015,Agosto,Israel,2,5,,7,POINT (6170465 -7542726)
2015,Agosto,Israel,2,2,,4,POINT (7128047 -73181317)
2015,Agosto,Italia,1,2,,3,POINT (10446304 -75516486)
2015,Agosto,Italia,0,3,,3,POINT (10886686 -74776479)
2015,Agosto,Italia,2,6,,8,POINT (125862 -81702165)
2015,Agosto,Italia,25,78,,103,POINT (3451668 -76532004)
2015,Agosto,Italia,158,333,,491,POINT (4697157 -74140516)
2015,Agosto,Italia,1,1,,2,POINT (4815189 -75736374)
2015,Agosto,Italia,23,51,,74,POINT (6170465 -7542726)
2015,Agosto,Italia,0,1,,1,POINT (7128047 -73181317)
2015,Agosto,Italia,1,0,,1,POINT (7927233 -72508188)
2015,Agosto,Jamaica,1,7,,8,POINT (10406342 -75527794)
2015,Agosto,Jamaica,0,1,,1,POINT (10446304 -75516486)
2015,Agosto,Jamaica,0,7,,7,POINT (10886686 -74776479)
2015,Agosto,Jamaica,2,7,,9,POINT (125862 -81702165)
2015,Agosto,Jamaica,0,5,,5,POINT (3451668 -76532004)
2015,Agosto,Jamaica,1,7,,8,POINT (4697157 -74140516)
2015,Agosto,Jamaica,2,1,,3,POINT (6170465 -7542726)
2015,Agosto,Japón,0,1,,1,POINT (10886686 -74776479)
2015,Agosto,Japón,2,1,,3,POINT (3451668 -76532004)
2015,Agosto,Japón,16,25,,41,POINT (4697157 -74140516)
2015,Agosto,Japón,1,3,,4,POINT (6170465 -7542726)
2015,Agosto,Kazajistán,1,1,,2,POINT (3451668 -76532004)
2015,Agosto,Kazajistán,1,1,,2,POINT (4697157 -74140516)
2015,Agosto,Kenia,0,3,,3,POINT (4697157 -74140516)
2015,Agosto,Letonia,1,2,,3,POINT (4697157 -74140516)
2015,Agosto,Lituania,0,1,,1,POINT (3451668 -76532004)
2015,Agosto,Lituania,2,3,,5,POINT (6170465 -7542726)
2015,Agosto,Líbano,0,1,,1,POINT (3451668 -76532004)
2015,Agosto,Líbano,7,12,,19,POINT (4697157 -74140516)
2015,Agosto,Luxemburgo,1,2,,3,POINT (4697157 -74140516)
2015,Agosto,Malasia,2,6,,8,POINT (4697157 -74140516)
2015,Agosto,Malawi,2,2,,4,POINT (3451668 -76532004)
2015,Agosto,Malta,2,2,,4,POINT (4697157 -74140516)
2015,Agosto,Marruecos,0,2,,2,POINT (4697157 -74140516)
2015,Agosto,Marruecos,0,1,,1,POINT (6170465 -7542726)
2015,Agosto,Martinica/Departamento de Ultramar Francés,0,2,,2,POINT (10406342 -75527794)
2015,Agosto,Martinica/Departamento de Ultramar Francés,1,0,,1,POINT (3451668 -76532004)
2015,Agosto,México,0,6,,6,POINT (10406342 -75527794)
2015,Agosto,México,14,20,,34,POINT (10446304 -75516486)
2015,Agosto,México,12,39,,51,POINT (10886686 -74776479)
2015,Agosto,México,0,6,,6,POINT (10970933 -74765343)
2015,Agosto,México,0,1,,1,POINT (11247723 -74213989)
2015,Agosto,México,4,7,,11,POINT (125862 -81702165)
2015,Agosto,México,57,110,,167,POINT (3451668 -76532004)
2015,Agosto,México,4631,8241,,12872,POINT (4697157 -74140516)
2015,Agosto,México,13,19,,32,POINT (4815189 -75736374)
2015,Agosto,México,750,1599,,2349,POINT (6170465 -7542726)
2015,Agosto,México,10,30,,40,POINT (7128047 -73181317)
2015,Agosto,México,23,37,,60,POINT (7927233 -72508188)
2015,Agosto,Mónaco,0,1,,1,POINT (4697157 -74140516)
2015,Agosto,Myanmar,0,1,,1,POINT (4697157 -74140516)
2015,Agosto,Nepal,0,1,,1,POINT (4697157 -74140516)
2015,Agosto,Nicaragua,1,0,,1,POINT (10886686 -74776479)
2015,Agosto,Nicaragua,1,2,,3,POINT (125862 -81702165)
2015,Agosto,Nicaragua,8,42,,50,POINT (3451668 -76532004)
2015,Agosto,Nicaragua,19,25,,44,POINT (4697157 -74140516)
2015,Agosto,Nicaragua,2,7,,9,POINT (4815189 -75736374)
2015,Agosto,Nicaragua,9,11,,20,POINT (6170465 -7542726)
2015,Agosto,Nigeria,0,1,,1,POINT (3451668 -76532004)
2015,Agosto,Nigeria,0,1,,1,POINT (4697157 -74140516)
2015,Agosto,Noruega,0,1,,1,POINT (10886686 -74776479)
2015,Agosto,Noruega,2,1,,3,POINT (3451668 -76532004)
2015,Agosto,Noruega,5,19,,24,POINT (4697157 -74140516)
2015,Agosto,Noruega,1,0,,1,POINT (4815189 -75736374)
2015,Agosto,Noruega,1,4,,5,POINT (6170465 -7542726)
2015,Agosto,Nueva Zelanda,0,1,,1,POINT (10446304 -75516486)
2015,Agosto,Nueva Zelanda,3,6,,9,POINT (4697157 -74140516)
2015,Agosto,Nueva Zelanda,1,2,,3,POINT (6170465 -7542726)
2015,Agosto,Omán,0,1,,1,POINT (4697157 -74140516)
2015,Agosto,Papúa Nueva Guinea,0,1,,1,POINT (3451668 -76532004)
2015,Agosto,Panamá,143,256,,399,POINT (10406342 -75527794)
2015,Agosto,Panamá,1526,1975,,3501,POINT (10446304 -75516486)
2015,Agosto,Panamá,196,436,,632,POINT (10886686 -74776479)
2015,Agosto,Panamá,0,4,,4,POINT (10970933 -74765343)
2015,Agosto,Panamá,1,9,,10,POINT (125744111 -81703935)
2015,Agosto,Panamá,150,108,,258,POINT (125862 -81702165)
2015,Agosto,Panamá,239,472,,711,POINT (3451668 -76532004)
2015,Agosto,Panamá,0,10,,10,POINT (3884426 -77061029)
2015,Agosto,Panamá,3601,5644,,9245,POINT (4697157 -74140516)
2015,Agosto,Panamá,48,89,,137,POINT (4815189 -75736374)
2015,Agosto,Panamá,1462,2252,,3714,POINT (6170465 -7542726)
2015,Agosto,Panamá,1,1,,2,POINT (6222552 -77401154)
2015,Agosto,Panamá,6,6,,12,POINT (7102626 -77762647)
2015,Agosto,Panamá,21,29,,50,POINT (7128047 -73181317)
2015,Agosto,Panamá,77,102,,179,POINT (7927233 -72508188)
2015,Agosto,Panamá,91,137,,228,POINT (863337 -7735002)
2015,Agosto,Paraguay,0,1,,1,POINT (0.81488 -77356)
2015,Agosto,Paraguay,4,0,,4,POINT (10446304 -75516486)
2015,Agosto,Paraguay,0,1,,1,POINT (10886686 -74776479)
2015,Agosto,Paraguay,28,11,,39,POINT (125862 -81702165)
2015,Agosto,Paraguay,9,6,,15,POINT (3451668 -76532004)
2015,Agosto,Paraguay,49,67,,116,POINT (4697157 -74140516)
2015,Agosto,Paraguay,23,18,,41,POINT (6170465 -7542726)
2015,Agosto,Perú,181,245,,426,POINT (-4191162 -69941498)
2015,Agosto,Perú,1,2,,3,POINT (-4214082 -69941431)
2015,Agosto,Perú,7,37,,44,POINT (0.81488 -77356)
2015,Agosto,Perú,11,7,,18,POINT (10446304 -75516486)
2015,Agosto,Perú,5,1,,6,POINT (10886686 -74776479)
2015,Agosto,Perú,86,63,,149,POINT (125862 -81702165)
2015,Agosto,Perú,346,491,,837,POINT (3451668 -76532004)
2015,Agosto,Perú,6189,8364,,14553,POINT (4697157 -74140516)
2015,Agosto,Perú,481,746,,1227,POINT (6170465 -7542726)
2015,Agosto,Perú,2,3,,5,POINT (7927233 -72508188)
2015,Agosto,Polonia,10,10,,20,POINT (4697157 -74140516)
2015,Agosto,Polonia,3,2,,5,POINT (6170465 -7542726)
2015,Agosto,Polonia,0,1,,1,POINT (7128047 -73181317)
2015,Agosto,Portugal,4,4,,8,POINT (3451668 -76532004)
2015,Agosto,Portugal,440,621,,1061,POINT (4697157 -74140516)
2015,Agosto,Portugal,0,1,,1,POINT (6170465 -7542726)
2015,Agosto,Polinesia Francesa/Colectividad de Ultramar Francesa,0,1,,1,POINT (4697157 -74140516)
2015,Agosto,Puerto Rico/Territorio de Estados Unidos,0,1,,1,POINT (10406342 -75527794)
2015,Agosto,Puerto Rico/Territorio de Estados Unidos,8,8,,16,POINT (10446304 -75516486)
2015,Agosto,Puerto Rico/Territorio de Estados Unidos,5,17,,22,POINT (10886686 -74776479)
2015,Agosto,Puerto Rico/Territorio de Estados Unidos,34,42,,76,POINT (3451668 -76532004)
2015,Agosto,Puerto Rico/Territorio de Estados Unidos,216,380,,596,POINT (4697157 -74140516)
2015,Agosto,Puerto Rico/Territorio de Estados Unidos,5,7,,12,POINT (4815189 -75736374)
2015,Agosto,Puerto Rico/Territorio de Estados Unidos,47,165,,212,POINT (6170465 -7542726)
2015,Agosto,Puerto Rico/Territorio de Estados Unidos,2,1,,3,POINT (7128047 -73181317)
2015,Agosto,Puerto Rico/Territorio de Estados Unidos,2,1,,3,POINT (7927233 -72508188)
2015,Agosto,Reino Unido de Gran Bretaña e Irlanda del Norte,0,5,,5,POINT (10406342 -75527794)
2015,Agosto,Reino Unido de Gran Bretaña e Irlanda del Norte,1,2,,3,POINT (10446304 -75516486)
2015,Agosto,Reino Unido de Gran Bretaña e Irlanda del Norte,0,2,,2,POINT (11247723 -74213989)
2015,Agosto,Reino Unido de Gran Bretaña e Irlanda del Norte,9,20,,29,POINT (3451668 -76532004)
2015,Agosto,Reino Unido de Gran Bretaña e Irlanda del Norte,666,1091,,1757,POINT (4697157 -74140516)
2015,Agosto,Reino Unido de Gran Bretaña e Irlanda del Norte,0,1,,1,POINT (4815189 -75736374)
2015,Agosto,Reino Unido de Gran Bretaña e Irlanda del Norte,14,17,,31,POINT (6170465 -7542726)
2015,Agosto,Reino Unido de Gran Bretaña e Irlanda del Norte,0,1,,1,POINT (7927233 -72508188)
2015,Agosto,Federación de Rusia,0,1,,1,POINT (10886686 -74776479)
2015,Agosto,Federación de Rusia,2,1,,3,POINT (3451668 -76532004)
2015,Agosto,Federación de Rusia,24,28,,52,POINT (4697157 -74140516)
2015,Agosto,Federación de Rusia,1,3,,4,POINT (6170465 -7542726)
2015,Agosto,Federación de Rusia,1,1,,2,POINT (7128047 -73181317)
2015,Agosto,República Dominicana,2,5,,7,POINT (10406342 -75527794)
2015,Agosto,República Dominicana,5,7,,12,POINT (10446304 -75516486)
2015,Agosto,República Dominicana,6,9,,15,POINT (10886686 -74776479)
2015,Agosto,República Dominicana,3,2,,5,POINT (125862 -81702165)
2015,Agosto,República Dominicana,36,40,,76,POINT (3451668 -76532004)
2015,Agosto,República Dominicana,582,776,,1358,POINT (4697157 -74140516)
2015,Agosto,República Dominicana,3,6,,9,POINT (4815189 -75736374)
2015,Agosto,República Dominicana,43,113,,156,POINT (6170465 -7542726)
2015,Agosto,República Dominicana,3,10,,13,POINT (7128047 -73181317)
2015,Agosto,República Dominicana,4,7,,11,POINT (7927233 -72508188)
2015,Agosto,República Democrática Popular de Corea,0,2,,2,POINT (4697157 -74140516)
2015,Agosto,Rumania,1,0,,1,POINT (3451668 -76532004)
2015,Agosto,Rumania,4,7,,11,POINT (4697157 -74140516)
2015,Agosto,Rumania,0,1,,1,POINT (6170465 -7542726)
2015,Agosto,San Marino,0,1,,1,POINT (4697157 -74140516)
2015,Agosto,San  Vicente y las Granadinas,0,1,,1,POINT (10446304 -75516486)
2015,Agosto,San  Vicente y las Granadinas,0,1,,1,POINT (4697157 -74140516)
2015,Agosto,Santa Lucia,0,4,,4,POINT (10446304 -75516486)
2015,Agosto,Santa Lucia,1,0,,1,POINT (3451668 -76532004)
2015,Agosto,Senegal,0,1,,1,POINT (4697157 -74140516)
2015,Agosto,Serbia,0,3,,3,POINT (4697157 -74140516)
2015,Agosto,Serbia,1,0,,1,POINT (6170465 -7542726)
2015,Agosto,Singapur,0,1,,1,POINT (3451668 -76532004)
2015,Agosto,Singapur,0,2,,2,POINT (4697157 -74140516)
2015,Agosto,Singapur,0,1,,1,POINT (6170465 -7542726)
2015,Agosto,Sudáfrica,11,8,,19,POINT (4697157 -74140516)
2015,Agosto,Sudáfrica,0,1,,1,POINT (7128047 -73181317)
2015,Agosto,Suecia,9,2,,11,POINT (3451668 -76532004)
2015,Agosto,Suecia,8,10,,18,POINT (4697157 -74140516)
2015,Agosto,Suecia,4,5,,9,POINT (6170465 -7542726)
2015,Agosto,Suiza,12,14,,26,POINT (3451668 -76532004)
2015,Agosto,Suiza,57,74,,131,POINT (4697157 -74140516)
2015,Agosto,Suiza,1,0,,1,POINT (4815189 -75736374)
2015,Agosto,Suiza,8,17,,25,POINT (6170465 -7542726)
2015,Agosto,Surinam,0,2,,2,POINT (10886686 -74776479)
2015,Agosto,Surinam,3,4,,7,POINT (4697157 -74140516)
2015,Agosto,Surinam,1,3,,4,POINT (6170465 -7542726)
2015,Agosto,Taiwán,3,2,,5,POINT (4697157 -74140516)
2015,Agosto,Tailandia,1,0,,1,POINT (3451668 -76532004)
2015,Agosto,Tailandia,6,2,,8,POINT (4697157 -74140516)
2015,Agosto,Tailandia,0,1,,1,POINT (6170465 -7542726)
2015,Agosto,Tanzania,0,1,,1,POINT (4697157 -74140516)
2015,Agosto,Trinidad y Tobago,1,0,,1,POINT (10886686 -74776479)
2015,Agosto,Trinidad y Tobago,0,16,,16,POINT (11247723 -74213989)
2015,Agosto,Trinidad y Tobago,7,8,,15,POINT (3451668 -76532004)
2015,Agosto,Trinidad y Tobago,6,19,,25,POINT (4697157 -74140516)
2015,Agosto,Trinidad y Tobago,9,15,,24,POINT (6170465 -7542726)
2015,Agosto,Trinidad y Tobago,1,0,,1,POINT (7128047 -73181317)
2015,Agosto,Trinidad y Tobago,3,2,,5,POINT (7927233 -72508188)
2015,Agosto,Túnez,1,1,,2,POINT (6170465 -7542726)
2015,Agosto,Turkmenistán,0,1,,1,POINT (4697157 -74140516)
2015,Agosto,Turquía,7,15,,22,POINT (4697157 -74140516)
2015,Agosto,Ucrania,1,0,,1,POINT (3451668 -76532004)
2015,Agosto,Ucrania,0,1,,1,POINT (4697157 -74140516)
2015,Agosto,Uganda,0,3,,3,POINT (3451668 -76532004)
2015,Agosto,Uganda,4,3,,7,POINT (4697157 -74140516)
2015,Agosto,Uruguay,0,1,,1,POINT (0.81488 -77356)
2015,Agosto,Uruguay,18,17,,35,POINT (10446304 -75516486)
2015,Agosto,Uruguay,2,1,,3,POINT (10886686 -74776479)
2015,Agosto,Uruguay,29,29,,58,POINT (125862 -81702165)
2015,Agosto,Uruguay,11,16,,27,POINT (3451668 -76532004)
2015,Agosto,Uruguay,47,89,,136,POINT (4697157 -74140516)
2015,Agosto,Uruguay,27,31,,58,POINT (6170465 -7542726)
2015,Agosto,Venezuela,0,9,,9,POINT (10406342 -75527794)
2015,Agosto,Venezuela,521,433,,954,POINT (10446304 -75516486)
2015,Agosto,Venezuela,5,37,,42,POINT (10886686 -74776479)
2015,Agosto,Venezuela,0,6,,6,POINT (10970933 -74765343)
2015,Agosto,Venezuela,4183,4807,,8990,POINT (11360029 -72129595)
2015,Agosto,Venezuela,18,40,,58,POINT (3451668 -76532004)
2015,Agosto,Venezuela,52,78,,130,POINT (3866713 -67927521)
2015,Agosto,Venezuela,4536,4731,,9267,POINT (4697157 -74140516)
2015,Agosto,Venezuela,1,1,,2,POINT (4815189 -75736374)
2015,Agosto,Venezuela,2585,2404,,4989,POINT (6170465 -7542726)
2015,Agosto,Venezuela,359,641,,1000,POINT (6185536 -67484028)
2015,Agosto,Venezuela,323,401,,724,POINT (7088729 -70740253)
2015,Agosto,Venezuela,12,10,,22,POINT (7128047 -73181317)
2015,Agosto,Venezuela,4242,4548,,8790,POINT (7819 -72453013)
2015,Agosto,Venezuela,368,327,,695,POINT (7927233 -72508188)
2015,Agosto,Venezuela,0,1,,1,
2015,Agosto,Vietnam,0,1,,1,POINT (4697157 -74140516)
2015,Agosto,Islas Vírgenes Estadounidenses/Territorio de Estados Unidos,0,1,,1,POINT (4697157 -74140516)
2015,Agosto,Zimbabue,0,1,,1,POINT (4697157 -74140516)
2015,Agosto,Desconocido,0,6,,6,POINT (4697157 -74140516)
2015,Agosto,Desconocido,0,12,,12,POINT (9402597 -75681642)
2015,Septiembre,Afganistán,1,1,,2,POINT (4697157 -74140516)
2015,Septiembre,Afganistán,0,2,,2,POINT (6170465 -7542726)
2015,Septiembre,Alemania,1,0,,1,POINT (125862 -81702165)
2015,Septiembre,Alemania,73,60,,133,POINT (3451668 -76532004)
2015,Septiembre,Alemania,0,1,,1,POINT (3884426 -77061029)
2015,Septiembre,Alemania,1188,2054,,3242,POINT (4697157 -74140516)
2015,Septiembre,Alemania,1,1,,2,POINT (4815189 -75736374)
2015,Septiembre,Alemania,11,27,,38,POINT (6170465 -7542726)
2015,Septiembre,Antigua y Barbuda,1,2,,3,POINT (10886686 -74776479)
2015,Septiembre,Antigua y Barbuda,0,3,,3,POINT (4697157 -74140516)
2015,Septiembre,Antigua y Barbuda,0,1,,1,POINT (6170465 -7542726)
2015,Septiembre,Países Bajos,1,3,,4,POINT (10406342 -75527794)
2015,Septiembre,Países Bajos,68,69,,137,POINT (10886686 -74776479)
2015,Septiembre,Países Bajos,3,6,,9,POINT (11247723 -74213989)
2015,Septiembre,Países Bajos,103,148,,251,POINT (3451668 -76532004)
2015,Septiembre,Países Bajos,710,1104,,1814,POINT (4697157 -74140516)
2015,Septiembre,Países Bajos,0,2,,2,POINT (4815189 -75736374)
2015,Septiembre,Países Bajos,199,280,,479,POINT (6170465 -7542726)
2015,Septiembre,Arabia Saudita,1,1,,2,POINT (4697157 -74140516)
2015,Septiembre,Arabia Saudita,0,2,,2,POINT (6170465 -7542726)
2015,Septiembre,Argelia,1,4,,5,POINT (4697157 -74140516)
2015,Septiembre,Argentina,3,15,,18,POINT (0.81488 -77356)
2015,Septiembre,Argentina,67,42,,109,POINT (10446304 -75516486)
2015,Septiembre,Argentina,5,2,,7,POINT (10886686 -74776479)
2015,Septiembre,Argentina,233,150,,383,POINT (125862 -81702165)
2015,Septiembre,Argentina,86,108,,194,POINT (3451668 -76532004)
2015,Septiembre,Argentina,1890,2562,,4452,POINT (4697157 -74140516)
2015,Septiembre,Argentina,0,3,,3,POINT (4815189 -75736374)
2015,Septiembre,Argentina,89,173,,262,POINT (6170465 -7542726)
2015,Septiembre,Argentina,1,0,,1,POINT (7128047 -73181317)
2015,Septiembre,Argentina,0,1,,1,POINT (7927233 -72508188)
2015,Septiembre,República de Armenia,1,0,,1,POINT (4697157 -74140516)
2015,Septiembre,Aruba,148,149,,297,POINT (10406342 -75527794)
2015,Septiembre,Aruba,0,2,,2,POINT (10446304 -75516486)
2015,Septiembre,Aruba,2,6,,8,POINT (10886686 -74776479)
2015,Septiembre,Aruba,6,8,,14,POINT (11247723 -74213989)
2015,Septiembre,Aruba,5,3,,8,POINT (3451668 -76532004)
2015,Septiembre,Aruba,549,694,,1243,POINT (4697157 -74140516)
2015,Septiembre,Aruba,40,70,,110,POINT (6170465 -7542726)
2015,Septiembre,Aruba,51,58,,109,POINT (7128047 -73181317)
2015,Septiembre,Australia,2,3,,5,POINT (10446304 -75516486)
2015,Septiembre,Australia,1,2,,3,POINT (10886686 -74776479)
2015,Septiembre,Australia,6,6,,12,POINT (3451668 -76532004)
2015,Septiembre,Australia,19,18,,37,POINT (4697157 -74140516)
2015,Septiembre,Australia,2,0,,2,POINT (4815189 -75736374)
2015,Septiembre,Australia,10,13,,23,POINT (6170465 -7542726)
2015,Septiembre,Austria,1,1,,2,POINT (3451668 -76532004)
2015,Septiembre,Austria,8,24,,32,POINT (4697157 -74140516)
2015,Septiembre,Austria,3,2,,5,POINT (6170465 -7542726)
2015,Septiembre,Azerbaiyán,2,1,,3,POINT (4697157 -74140516)
2015,Septiembre,Azerbaiyán,0,1,,1,POINT (6170465 -7542726)
2015,Septiembre,Bahamas,0,2,,2,POINT (10406342 -75527794)
2015,Septiembre,Bahamas,0,1,,1,POINT (3451668 -76532004)
2015,Septiembre,Bahamas,2,12,,14,POINT (4697157 -74140516)
2015,Septiembre,Bahamas,0,1,,1,POINT (6170465 -7542726)
2015,Septiembre,Bahréin,1,1,,2,POINT (4697157 -74140516)
2015,Septiembre,Bahréin,1,1,,2,POINT (6170465 -7542726)
2015,Septiembre,Barbados,0,2,,2,POINT (4697157 -74140516)
2015,Septiembre,República de Belarús,1,0,,1,POINT (4697157 -74140516)
2015,Septiembre,Bélgica,1,2,,3,POINT (10886686 -74776479)
2015,Septiembre,Bélgica,1,8,,9,POINT (3451668 -76532004)
2015,Septiembre,Bélgica,17,25,,42,POINT (4697157 -74140516)
2015,Septiembre,Bélgica,2,8,,10,POINT (6170465 -7542726)
2015,Septiembre,Bélgica,0,1,,1,POINT (7128047 -73181317)
2015,Septiembre,Belice,0,3,,3,POINT (3451668 -76532004)
2015,Septiembre,Belice,1,2,,3,POINT (4697157 -74140516)
2015,Septiembre,Benín,1,3,,4,POINT (4697157 -74140516)
2015,Septiembre,Bermudas/Territorio Británico de Ultramar,0,1,,1,POINT (6170465 -7542726)
2015,Septiembre,Bolivia,0,2,,2,POINT (0.81488 -77356)
2015,Septiembre,Bolivia,1,3,,4,POINT (10446304 -75516486)
2015,Septiembre,Bolivia,1,0,,1,POINT (10886686 -74776479)
2015,Septiembre,Bolivia,6,4,,10,POINT (125862 -81702165)
2015,Septiembre,Bolivia,20,34,,54,POINT (3451668 -76532004)
2015,Septiembre,Bolivia,359,522,,881,POINT (4697157 -74140516)
2015,Septiembre,Bolivia,44,30,,74,POINT (6170465 -7542726)
2015,Septiembre,Brasil,111,162,,273,POINT (-4191162 -69941498)
2015,Septiembre,Brasil,4,5,,9,POINT (-4214082 -69941431)
2015,Septiembre,Brasil,0,10,,10,POINT (10406342 -75527794)
2015,Septiembre,Brasil,30,32,,62,POINT (10446304 -75516486)
2015,Septiembre,Brasil,0,7,,7,POINT (10886686 -74776479)
2015,Septiembre,Brasil,0,1,,1,POINT (11247723 -74213989)
2015,Septiembre,Brasil,134,75,,209,POINT (125862 -81702165)
2015,Septiembre,Brasil,64,74,,138,POINT (3451668 -76532004)
2015,Septiembre,Brasil,4118,5834,,9952,POINT (4697157 -74140516)
2015,Septiembre,Brasil,3,6,,9,POINT (4815189 -75736374)
2015,Septiembre,Brasil,99,149,,248,POINT (6170465 -7542726)
2015,Septiembre,Brasil,0,2,,2,POINT (7128047 -73181317)
2015,Septiembre,Brasil,2,0,,2,POINT (7927233 -72508188)
2015,Septiembre,Brunei Darussalam,0,1,,1,POINT (4697157 -74140516)
2015,Septiembre,Bulgaria,1,1,,2,POINT (4697157 -74140516)
2015,Septiembre,Burkina Faso,0,1,,1,POINT (6170465 -7542726)
2015,Septiembre,Bután,1,0,,1,POINT (4697157 -74140516)
2015,Septiembre,Islas Caimán/Territorio Británico de Ultramar,1,2,,3,POINT (10406342 -75527794)
2015,Septiembre,Islas Caimán/Territorio Británico de Ultramar,0,7,,7,POINT (125744111 -81703935)
2015,Septiembre,Islas Caimán/Territorio Británico de Ultramar,0,1,,1,POINT (125862 -81702165)
2015,Septiembre,Islas Caimán/Territorio Británico de Ultramar,0,7,,7,POINT (4697157 -74140516)
2015,Septiembre,Canadá,7,11,,18,POINT (10446304 -75516486)
2015,Septiembre,Canadá,1,9,,10,POINT (10886686 -74776479)
2015,Septiembre,Canadá,0,3,,3,POINT (125862 -81702165)
2015,Septiembre,Canadá,22,44,,66,POINT (3451668 -76532004)
2015,Septiembre,Canadá,388,639,,1027,POINT (4697157 -74140516)
2015,Septiembre,Canadá,3,5,,8,POINT (4815189 -75736374)
2015,Septiembre,Canadá,54,111,,165,POINT (6170465 -7542726)
2015,Septiembre,Canadá,1,7,,8,POINT (7128047 -73181317)
2015,Septiembre,Canadá,2,1,,3,POINT (7927233 -72508188)
2015,Septiembre,Chad,0,1,,1,POINT (4697157 -74140516)
2015,Septiembre,España,3,6,,9,POINT (10446304 -75516486)
2015,Septiembre,España,2,9,,11,POINT (10886686 -74776479)
2015,Septiembre,España,425,640,,1065,POINT (3451668 -76532004)
2015,Septiembre,España,3022,5494,,8516,POINT (4697157 -74140516)
2015,Septiembre,España,1,3,,4,POINT (4815189 -75736374)
2015,Septiembre,España,326,515,,841,POINT (6170465 -7542726)
2015,Septiembre,España,2,1,,3,POINT (7128047 -73181317)
2015,Septiembre,España,2,5,,7,POINT (7927233 -72508188)
2015,Septiembre,España,0,3,,3,POINT (806667 -767333)
2015,Septiembre,República Del Congo,0,2,,2,POINT (4697157 -74140516)
2015,Septiembre,República de Corea,0,1,,1,POINT (10406342 -75527794)
2015,Septiembre,República de Corea,0,1,,1,POINT (3451668 -76532004)
2015,Septiembre,República de Corea,5,14,,19,POINT (4697157 -74140516)
2015,Septiembre,República de Corea,2,4,,6,POINT (6170465 -7542726)
2015,Septiembre,Costa de Marfil,0,3,,3,POINT (3451668 -76532004)
2015,Septiembre,Costa de Marfil,0,6,,6,POINT (4697157 -74140516)
2015,Septiembre,Costa de Marfil,1,0,,1,POINT (6170465 -7542726)
2015,Septiembre,Costa Rica,2,4,,6,POINT (10406342 -75527794)
2015,Septiembre,Costa Rica,5,7,,12,POINT (10446304 -75516486)
2015,Septiembre,Costa Rica,1,7,,8,POINT (10886686 -74776479)
2015,Septiembre,Costa Rica,0,2,,2,POINT (10970933 -74765343)
2015,Septiembre,Costa Rica,0,24,,24,POINT (125744111 -81703935)
2015,Septiembre,Costa Rica,79,69,,148,POINT (125862 -81702165)
2015,Septiembre,Costa Rica,32,66,,98,POINT (3451668 -76532004)
2015,Septiembre,Costa Rica,773,1363,,2136,POINT (4697157 -74140516)
2015,Septiembre,Costa Rica,2,7,,9,POINT (4815189 -75736374)
2015,Septiembre,Costa Rica,78,116,,194,POINT (6170465 -7542726)
2015,Septiembre,Costa Rica,0,9,,9,POINT (7128047 -73181317)
2015,Septiembre,Costa Rica,1,3,,4,POINT (7927233 -72508188)
2015,Septiembre,Croacia,0,1,,1,POINT (10886686 -74776479)
2015,Septiembre,Croacia,0,1,,1,POINT (3451668 -76532004)
2015,Septiembre,Croacia,1,1,,2,POINT (4697157 -74140516)
2015,Septiembre,Cuba,0,7,,7,POINT (10406342 -75527794)
2015,Septiembre,Cuba,0,2,,2,POINT (10446304 -75516486)
2015,Septiembre,Cuba,2,5,,7,POINT (10886686 -74776479)
2015,Septiembre,Cuba,0,2,,2,POINT (125862 -81702165)
2015,Septiembre,Cuba,10,32,,42,POINT (3451668 -76532004)
2015,Septiembre,Cuba,362,541,,903,POINT (4697157 -74140516)
2015,Septiembre,Cuba,1,2,,3,POINT (4815189 -75736374)
2015,Septiembre,Cuba,29,32,,61,POINT (6170465 -7542726)
2015,Septiembre,Cuba,1,4,,5,POINT (7128047 -73181317)
2015,Septiembre,Curazao,0,1,,1,POINT (6170465 -7542726)
2015,Septiembre,República Checa,3,2,,5,POINT (4697157 -74140516)
2015,Septiembre,República Checa,0,1,,1,POINT (6170465 -7542726)
2015,Septiembre,Chile,4,4,,8,POINT (0.81488 -77356)
2015,Septiembre,Chile,1,2,,3,POINT (10446304 -75516486)
2015,Septiembre,Chile,7,0,,7,POINT (10886686 -74776479)
2015,Septiembre,Chile,34,17,,51,POINT (125862 -81702165)
2015,Septiembre,Chile,31,59,,90,POINT (3451668 -76532004)
2015,Septiembre,Chile,3676,4846,,8522,POINT (4697157 -74140516)
2015,Septiembre,Chile,0,4,,4,POINT (4815189 -75736374)
2015,Septiembre,Chile,26,74,,100,POINT (6170465 -7542726)
2015,Septiembre,Chile,0,1,,1,POINT (7128047 -73181317)
2015,Septiembre,Chile,0,1,,1,POINT (7927233 -72508188)
2015,Septiembre,China,0,1,,1,POINT (10446304 -75516486)
2015,Septiembre,China,0,2,,2,POINT (3451668 -76532004)
2015,Septiembre,China,20,78,,98,POINT (4697157 -74140516)
2015,Septiembre,China,2,1,,3,POINT (6170465 -7542726)
2015,Septiembre,Dinamarca,0,1,,1,POINT (3451668 -76532004)
2015,Septiembre,Dinamarca,9,17,,26,POINT (4697157 -74140516)
2015,Septiembre,Dinamarca,0,1,,1,POINT (4815189 -75736374)
2015,Septiembre,Dinamarca,1,2,,3,POINT (6170465 -7542726)
2015,Septiembre,Ecuador,81,178,,259,POINT (0.33002 -76876446)
2015,Septiembre,Ecuador,3,8,,11,POINT (0.812436 -77847006)
2015,Septiembre,Ecuador,2484,4048,,6532,POINT (0.81488 -77356)
2015,Septiembre,Ecuador,32,156,,188,POINT (1800143 -78802679)
2015,Septiembre,Ecuador,147,135,,282,POINT (10446304 -75516486)
2015,Septiembre,Ecuador,1,1,,2,POINT (10886686 -74776479)
2015,Septiembre,Ecuador,7,7,,14,POINT (125862 -81702165)
2015,Septiembre,Ecuador,453,573,,1026,POINT (3451668 -76532004)
2015,Septiembre,Ecuador,3400,5306,,8706,POINT (4697157 -74140516)
2015,Septiembre,Ecuador,1,1,,2,POINT (4815189 -75736374)
2015,Septiembre,Ecuador,48,71,,119,POINT (6170465 -7542726)
2015,Septiembre,Ecuador,1,2,,3,POINT (7128047 -73181317)
2015,Septiembre,Ecuador,15,13,,28,POINT (7927233 -72508188)
2015,Septiembre,Egipto,0,1,,1,POINT (3451668 -76532004)
2015,Septiembre,Egipto,2,7,,9,POINT (4697157 -74140516)
2015,Septiembre,Egipto,0,1,,1,POINT (6170465 -7542726)
2015,Septiembre,El Salvador,29,25,,54,POINT (125862 -81702165)
2015,Septiembre,El Salvador,97,138,,235,POINT (3451668 -76532004)
2015,Septiembre,El Salvador,895,1439,,2334,POINT (4697157 -74140516)
2015,Septiembre,El Salvador,0,1,,1,POINT (4815189 -75736374)
2015,Septiembre,El Salvador,102,172,,274,POINT (6170465 -7542726)
2015,Septiembre,El Salvador,2,0,,2,POINT (7927233 -72508188)
2015,Septiembre,Emiratos Árabes,1,3,,4,POINT (4697157 -74140516)
2015,Septiembre,Emiratos Árabes,0,3,,3,POINT (6170465 -7542726)
2015,Septiembre,Eslovaquia,4,0,,4,POINT (4697157 -74140516)
2015,Septiembre,Eslovaquia,1,0,,1,POINT (6170465 -7542726)
2015,Septiembre,Eslovenia,3,1,,4,POINT (3451668 -76532004)
2015,Septiembre,Eslovenia,2,1,,3,POINT (4697157 -74140516)
2015,Septiembre,Eslovenia,0,1,,1,POINT (6170465 -7542726)
2015,Septiembre,Estados Unidos de América,0,41,,41,POINT (10406342 -75527794)
2015,Septiembre,Estados Unidos de América,1938,3141,,5079,POINT (10446304 -75516486)
2015,Septiembre,Estados Unidos de América,509,997,,1506,POINT (10886686 -74776479)
2015,Septiembre,Estados Unidos de América,0,8,,8,POINT (10970933 -74765343)
2015,Septiembre,Estados Unidos de América,0,6,,6,POINT (11247723 -74213989)
2015,Septiembre,Estados Unidos de América,8,29,,37,POINT (125862 -81702165)
2015,Septiembre,Estados Unidos de América,759,1178,,1937,POINT (3451668 -76532004)
2015,Septiembre,Estados Unidos de América,66,121,,187,POINT (445285 -75766353)
2015,Septiembre,Estados Unidos de América,6936,13508,,20444,POINT (4697157 -74140516)
2015,Septiembre,Estados Unidos de América,78,126,,204,POINT (4815189 -75736374)
2015,Septiembre,Estados Unidos de América,1716,4313,,6029,POINT (6170465 -7542726)
2015,Septiembre,Estados Unidos de América,20,52,,72,POINT (7128047 -73181317)
2015,Septiembre,Estados Unidos de América,85,63,,148,POINT (7927233 -72508188)
2015,Septiembre,Estados Unidos de América,0,1,,1,POINT (806667 -767333)
2015,Septiembre,Etiopia,0,1,,1,POINT (4697157 -74140516)
2015,Septiembre,Filipinas,0,3,,3,POINT (10446304 -75516486)
2015,Septiembre,Filipinas,0,1,,1,POINT (10886686 -74776479)
2015,Septiembre,Filipinas,1,2,,3,POINT (4697157 -74140516)
2015,Septiembre,Finlandia,1,0,,1,POINT (3451668 -76532004)
2015,Septiembre,Finlandia,2,10,,12,POINT (4697157 -74140516)
2015,Septiembre,Finlandia,1,2,,3,POINT (6170465 -7542726)
2015,Septiembre,Francia,2,2,,4,POINT (10886686 -74776479)
2015,Septiembre,Francia,0,1,,1,POINT (125862 -81702165)
2015,Septiembre,Francia,23,35,,58,POINT (3451668 -76532004)
2015,Septiembre,Francia,985,2072,,3057,POINT (4697157 -74140516)
2015,Septiembre,Francia,0,2,,2,POINT (4815189 -75736374)
2015,Septiembre,Francia,10,28,,38,POINT (6170465 -7542726)
2015,Septiembre,Francia,1,0,,1,POINT (7927233 -72508188)
2015,Septiembre,Gambia,0,1,,1,POINT (6170465 -7542726)
2015,Septiembre,Ghana,0,2,,2,POINT (4697157 -74140516)
2015,Septiembre,Ghana,1,3,,4,POINT (6170465 -7542726)
2015,Septiembre,Grecia,0,1,,1,POINT (3451668 -76532004)
2015,Septiembre,Grecia,2,3,,5,POINT (4697157 -74140516)
2015,Septiembre,Guatemala,1,5,,6,POINT (10406342 -75527794)
2015,Septiembre,Guatemala,7,7,,14,POINT (10446304 -75516486)
2015,Septiembre,Guatemala,1,2,,3,POINT (10886686 -74776479)
2015,Septiembre,Guatemala,0,4,,4,POINT (125744111 -81703935)
2015,Septiembre,Guatemala,25,32,,57,POINT (125862 -81702165)
2015,Septiembre,Guatemala,23,46,,69,POINT (3451668 -76532004)
2015,Septiembre,Guatemala,275,576,,851,POINT (4697157 -74140516)
2015,Septiembre,Guatemala,1,6,,7,POINT (4815189 -75736374)
2015,Septiembre,Guatemala,26,124,,150,POINT (6170465 -7542726)
2015,Septiembre,Guatemala,2,1,,3,POINT (7128047 -73181317)
2015,Septiembre,Guatemala,7,1,,8,POINT (7927233 -72508188)
2015,Septiembre,Guyana,1,0,,1,POINT (3451668 -76532004)
2015,Septiembre,Guyana,0,3,,3,POINT (4697157 -74140516)
2015,Septiembre,Guyana,0,1,,1,POINT (6170465 -7542726)
2015,Septiembre,Guyana,0,3,,3,POINT (7927233 -72508188)
2015,Septiembre,Guadalupe/Territorio Francés,0,1,,1,POINT (4697157 -74140516)
2015,Septiembre,Guayana Francesa/Departamento de Ultramar Francés,0,1,,1,POINT (10406342 -75527794)
2015,Septiembre,Guayana Francesa/Departamento de Ultramar Francés,0,1,,1,POINT (10886686 -74776479)
2015,Septiembre,Guayana Francesa/Departamento de Ultramar Francés,0,1,,1,POINT (3451668 -76532004)
2015,Septiembre,Haití,0,1,,1,POINT (3451668 -76532004)
2015,Septiembre,Haití,4,12,,16,POINT (4697157 -74140516)
2015,Septiembre,Haití,1,2,,3,POINT (6170465 -7542726)
2015,Septiembre,Honduras,1,7,,8,POINT (10446304 -75516486)
2015,Septiembre,Honduras,3,7,,10,POINT (10886686 -74776479)
2015,Septiembre,Honduras,0,6,,6,POINT (125744111 -81703935)
2015,Septiembre,Honduras,2,9,,11,POINT (125862 -81702165)
2015,Septiembre,Honduras,17,32,,49,POINT (3451668 -76532004)
2015,Septiembre,Honduras,52,90,,142,POINT (4697157 -74140516)
2015,Septiembre,Honduras,59,59,,118,POINT (6170465 -7542726)
2015,Septiembre,Honduras,0,1,,1,POINT (7927233 -72508188)
2015,Septiembre,Hong Kong,2,1,,3,POINT (3451668 -76532004)
2015,Septiembre,Hong Kong,2,4,,6,POINT (4697157 -74140516)
2015,Septiembre,Hong Kong,0,1,,1,POINT (6170465 -7542726)
2015,Septiembre,Hungría,2,7,,9,POINT (4697157 -74140516)
2015,Septiembre,India,0,4,,4,POINT (10886686 -74776479)
2015,Septiembre,India,0,2,,2,POINT (10970933 -74765343)
2015,Septiembre,India,4,10,,14,POINT (3451668 -76532004)
2015,Septiembre,India,3,37,,40,POINT (4697157 -74140516)
2015,Septiembre,India,3,8,,11,POINT (6170465 -7542726)
2015,Septiembre,Indonesia,0,1,,1,POINT (3451668 -76532004)
2015,Septiembre,Indonesia,1,1,,2,POINT (4697157 -74140516)
2015,Septiembre,Indonesia,0,2,,2,POINT (6170465 -7542726)
2015,Septiembre,Irán,0,1,,1,POINT (4697157 -74140516)
2015,Septiembre,República de Irlanda,0,1,,1,POINT (10446304 -75516486)
2015,Septiembre,República de Irlanda,0,4,,4,POINT (3451668 -76532004)
2015,Septiembre,República de Irlanda,2,13,,15,POINT (4697157 -74140516)
2015,Septiembre,República de Irlanda,1,3,,4,POINT (6170465 -7542726)
2015,Septiembre,Israel,1,1,,2,POINT (3451668 -76532004)
2015,Septiembre,Israel,17,59,,76,POINT (4697157 -74140516)
2015,Septiembre,Israel,1,0,,1,POINT (4815189 -75736374)
2015,Septiembre,Israel,2,3,,5,POINT (6170465 -7542726)
2015,Septiembre,Italia,176,95,,271,POINT (3451668 -76532004)
2015,Septiembre,Italia,74,227,,301,POINT (4697157 -74140516)
2015,Septiembre,Italia,10,32,,42,POINT (6170465 -7542726)
2015,Septiembre,Italia,0,1,,1,POINT (7128047 -73181317)
2015,Septiembre,Jamaica,0,2,,2,POINT (10406342 -75527794)
2015,Septiembre,Jamaica,0,1,,1,POINT (10446304 -75516486)
2015,Septiembre,Jamaica,0,5,,5,POINT (10886686 -74776479)
2015,Septiembre,Jamaica,2,6,,8,POINT (125862 -81702165)
2015,Septiembre,Jamaica,1,1,,2,POINT (3451668 -76532004)
2015,Septiembre,Jamaica,3,8,,11,POINT (4697157 -74140516)
2015,Septiembre,Jamaica,7,5,,12,POINT (6170465 -7542726)
2015,Septiembre,Jamaica,0,3,,3,POINT (7927233 -72508188)
2015,Septiembre,Japón,3,1,,4,POINT (10446304 -75516486)
2015,Septiembre,Japón,0,1,,1,POINT (10886686 -74776479)
2015,Septiembre,Japón,12,5,,17,POINT (3451668 -76532004)
2015,Septiembre,Japón,13,18,,31,POINT (4697157 -74140516)
2015,Septiembre,Japón,0,1,,1,POINT (4815189 -75736374)
2015,Septiembre,Japón,1,9,,10,POINT (6170465 -7542726)
2015,Septiembre,Jordania,4,4,,8,POINT (4697157 -74140516)
2015,Septiembre,Kazajistán,1,0,,1,POINT (10446304 -75516486)
2015,Septiembre,Kenia,1,3,,4,POINT (4697157 -74140516)
2015,Septiembre,Kenia,3,3,,6,POINT (6170465 -7542726)
2015,Septiembre,Letonia,1,0,,1,POINT (4697157 -74140516)
2015,Septiembre,Lituania,1,0,,1,POINT (4697157 -74140516)
2015,Septiembre,Lituania,3,1,,4,POINT (6170465 -7542726)
2015,Septiembre,Líbano,11,12,,23,POINT (4697157 -74140516)
2015,Septiembre,Luxemburgo,1,0,,1,POINT (4697157 -74140516)
2015,Septiembre,Madagascar,0,1,,1,POINT (10886686 -74776479)
2015,Septiembre,Madagascar,0,1,,1,POINT (4697157 -74140516)
2015,Septiembre,Malasia,1,10,,11,POINT (4697157 -74140516)
2015,Septiembre,Malasia,0,3,,3,POINT (6170465 -7542726)
2015,Septiembre,Malta,2,3,,5,POINT (4697157 -74140516)
2015,Septiembre,Marruecos,3,6,,9,POINT (4697157 -74140516)
2015,Septiembre,Marruecos,1,3,,4,POINT (6170465 -7542726)
2015,Septiembre,México,0,12,,12,POINT (10406342 -75527794)
2015,Septiembre,México,6,19,,25,POINT (10446304 -75516486)
2015,Septiembre,México,8,18,,26,POINT (10886686 -74776479)
2015,Septiembre,México,9,8,,17,POINT (125862 -81702165)
2015,Septiembre,México,66,134,,200,POINT (3451668 -76532004)
2015,Septiembre,México,4303,7669,,11972,POINT (4697157 -74140516)
2015,Septiembre,México,10,19,,29,POINT (4815189 -75736374)
2015,Septiembre,México,576,1411,,1987,POINT (6170465 -7542726)
2015,Septiembre,México,4,15,,19,POINT (7128047 -73181317)
2015,Septiembre,México,16,13,,29,POINT (7927233 -72508188)
2015,Septiembre,Mónaco,1,0,,1,POINT (4697157 -74140516)
2015,Septiembre,Mónaco,1,0,,1,POINT (6170465 -7542726)
2015,Septiembre,Mongolia,1,0,,1,POINT (4697157 -74140516)
2015,Septiembre,Mozambique,0,3,,3,POINT (4697157 -74140516)
2015,Septiembre,Nicaragua,0,1,,1,POINT (10406342 -75527794)
2015,Septiembre,Nicaragua,2,2,,4,POINT (10446304 -75516486)
2015,Septiembre,Nicaragua,1,2,,3,POINT (10886686 -74776479)
2015,Septiembre,Nicaragua,1,1,,2,POINT (125744111 -81703935)
2015,Septiembre,Nicaragua,2,1,,3,POINT (125862 -81702165)
2015,Septiembre,Nicaragua,14,25,,39,POINT (3451668 -76532004)
2015,Septiembre,Nicaragua,23,47,,70,POINT (4697157 -74140516)
2015,Septiembre,Nicaragua,0,6,,6,POINT (4815189 -75736374)
2015,Septiembre,Nicaragua,10,16,,26,POINT (6170465 -7542726)
2015,Septiembre,Nicaragua,0,1,,1,POINT (7128047 -73181317)
2015,Septiembre,Nicaragua,2,1,,3,POINT (7927233 -72508188)
2015,Septiembre,Nigeria,0,2,,2,POINT (6170465 -7542726)
2015,Septiembre,Noruega,2,4,,6,POINT (3451668 -76532004)
2015,Septiembre,Noruega,11,11,,22,POINT (4697157 -74140516)
2015,Septiembre,Noruega,1,0,,1,POINT (4815189 -75736374)
2015,Septiembre,Noruega,2,1,,3,POINT (6170465 -7542726)
2015,Septiembre,Nueva Caledonia/Territorio francés,1,0,,1,POINT (3451668 -76532004)
2015,Septiembre,Nueva Zelanda,0,1,,1,POINT (3451668 -76532004)
2015,Septiembre,Nueva Zelanda,2,3,,5,POINT (4697157 -74140516)
2015,Septiembre,Nueva Zelanda,0,1,,1,POINT (6170465 -7542726)
2015,Septiembre,Omán,0,1,,1,POINT (4697157 -74140516)
2015,Septiembre,Panamá,516,475,,991,POINT (10406342 -75527794)
2015,Septiembre,Panamá,1772,2143,,3915,POINT (10446304 -75516486)
2015,Septiembre,Panamá,165,433,,598,POINT (10886686 -74776479)
2015,Septiembre,Panamá,1,12,,13,POINT (10970933 -74765343)
2015,Septiembre,Panamá,1,3,,4,POINT (11247723 -74213989)
2015,Septiembre,Panamá,311,222,,533,POINT (125862 -81702165)
2015,Septiembre,Panamá,281,483,,764,POINT (3451668 -76532004)
2015,Septiembre,Panamá,0,12,,12,POINT (3884426 -77061029)
2015,Septiembre,Panamá,3488,5315,,8803,POINT (4697157 -74140516)
2015,Septiembre,Panamá,39,108,,147,POINT (4815189 -75736374)
2015,Septiembre,Panamá,1328,1990,,3318,POINT (6170465 -7542726)
2015,Septiembre,Panamá,2,1,,3,POINT (6222552 -77401154)
2015,Septiembre,Panamá,1,0,,1,POINT (7102626 -77762647)
2015,Septiembre,Panamá,20,53,,73,POINT (7128047 -73181317)
2015,Septiembre,Panamá,107,90,,197,POINT (7927233 -72508188)
2015,Septiembre,Panamá,0,10,,10,POINT (806667 -767333)
2015,Septiembre,Panamá,77,88,,165,POINT (863337 -7735002)
2015,Septiembre,Paraguay,2,2,,4,POINT (10446304 -75516486)
2015,Septiembre,Paraguay,1,0,,1,POINT (10886686 -74776479)
2015,Septiembre,Paraguay,38,23,,61,POINT (125862 -81702165)
2015,Septiembre,Paraguay,26,55,,81,POINT (3451668 -76532004)
2015,Septiembre,Paraguay,51,66,,117,POINT (4697157 -74140516)
2015,Septiembre,Paraguay,29,63,,92,POINT (6170465 -7542726)
2015,Septiembre,Paraguay,3,5,,8,POINT (7128047 -73181317)
2015,Septiembre,Paraguay,1,2,,3,POINT (7927233 -72508188)
2015,Septiembre,Perú,87,174,,261,POINT (-4191162 -69941498)
2015,Septiembre,Perú,1,0,,1,POINT (-4214082 -69941431)
2015,Septiembre,Perú,7,25,,32,POINT (0.81488 -77356)
2015,Septiembre,Perú,0,1,,1,POINT (1800143 -78802679)
2015,Septiembre,Perú,0,1,,1,POINT (10406342 -75527794)
2015,Septiembre,Perú,7,0,,7,POINT (10446304 -75516486)
2015,Septiembre,Perú,0,11,,11,POINT (10886686 -74776479)
2015,Septiembre,Perú,134,82,,216,POINT (125862 -81702165)
2015,Septiembre,Perú,314,471,,785,POINT (3451668 -76532004)
2015,Septiembre,Perú,5683,7804,,13487,POINT (4697157 -74140516)
2015,Septiembre,Perú,1,1,,2,POINT (4815189 -75736374)
2015,Septiembre,Perú,386,699,,1085,POINT (6170465 -7542726)
2015,Septiembre,Perú,1,2,,3,POINT (7128047 -73181317)
2015,Septiembre,Perú,2,4,,6,POINT (7927233 -72508188)
2015,Septiembre,Palestina,0,1,,1,POINT (4697157 -74140516)
2015,Septiembre,Polonia,0,3,,3,POINT (3451668 -76532004)
2015,Septiembre,Polonia,10,17,,27,POINT (4697157 -74140516)
2015,Septiembre,Polonia,0,2,,2,POINT (4815189 -75736374)
2015,Septiembre,Polonia,0,1,,1,POINT (6170465 -7542726)
2015,Septiembre,Portugal,1,8,,9,POINT (10446304 -75516486)
2015,Septiembre,Portugal,4,5,,9,POINT (3451668 -76532004)
2015,Septiembre,Portugal,267,436,,703,POINT (4697157 -74140516)
2015,Septiembre,Portugal,2,4,,6,POINT (6170465 -7542726)
2015,Septiembre,Puerto Rico/Territorio de Estados Unidos,3,3,,6,POINT (10446304 -75516486)
2015,Septiembre,Puerto Rico/Territorio de Estados Unidos,8,29,,37,POINT (10886686 -74776479)
2015,Septiembre,Puerto Rico/Territorio de Estados Unidos,1,1,,2,POINT (125862 -81702165)
2015,Septiembre,Puerto Rico/Territorio de Estados Unidos,14,37,,51,POINT (3451668 -76532004)
2015,Septiembre,Puerto Rico/Territorio de Estados Unidos,208,373,,581,POINT (4697157 -74140516)
2015,Septiembre,Puerto Rico/Territorio de Estados Unidos,2,4,,6,POINT (4815189 -75736374)
2015,Septiembre,Puerto Rico/Territorio de Estados Unidos,61,93,,154,POINT (6170465 -7542726)
2015,Septiembre,Puerto Rico/Territorio de Estados Unidos,3,17,,20,POINT (7128047 -73181317)
2015,Septiembre,Puerto Rico/Territorio de Estados Unidos,1,1,,2,POINT (7927233 -72508188)
2015,Septiembre,Qatar,1,5,,6,POINT (4697157 -74140516)
2015,Septiembre,Reino Unido de Gran Bretaña e Irlanda del Norte,1,1,,2,POINT (10446304 -75516486)
2015,Septiembre,Reino Unido de Gran Bretaña e Irlanda del Norte,1,1,,2,POINT (10886686 -74776479)
2015,Septiembre,Reino Unido de Gran Bretaña e Irlanda del Norte,0,1,,1,POINT (11247723 -74213989)
2015,Septiembre,Reino Unido de Gran Bretaña e Irlanda del Norte,12,18,,30,POINT (3451668 -76532004)
2015,Septiembre,Reino Unido de Gran Bretaña e Irlanda del Norte,449,935,,1384,POINT (4697157 -74140516)
2015,Septiembre,Reino Unido de Gran Bretaña e Irlanda del Norte,9,16,,25,POINT (6170465 -7542726)
2015,Septiembre,Reino Unido de Gran Bretaña e Irlanda del Norte,0,1,,1,POINT (7128047 -73181317)
2015,Septiembre,Reino Unido de Gran Bretaña e Irlanda del Norte,0,1,,1,POINT (7927233 -72508188)
2015,Septiembre,Federación de Rusia,0,2,,2,POINT (3451668 -76532004)
2015,Septiembre,Federación de Rusia,25,37,,62,POINT (4697157 -74140516)
2015,Septiembre,República Dominicana,0,22,,22,POINT (10406342 -75527794)
2015,Septiembre,República Dominicana,6,7,,13,POINT (10446304 -75516486)
2015,Septiembre,República Dominicana,1,10,,11,POINT (10886686 -74776479)
2015,Septiembre,República Dominicana,0,1,,1,POINT (11247723 -74213989)
2015,Septiembre,República Dominicana,28,45,,73,POINT (3451668 -76532004)
2015,Septiembre,República Dominicana,587,938,,1525,POINT (4697157 -74140516)
2015,Septiembre,República Dominicana,3,0,,3,POINT (4815189 -75736374)
2015,Septiembre,República Dominicana,46,95,,141,POINT (6170465 -7542726)
2015,Septiembre,República Dominicana,5,8,,13,POINT (7128047 -73181317)
2015,Septiembre,República Dominicana,1,2,,3,POINT (7927233 -72508188)
2015,Septiembre,República Democrática Popular de Corea,0,1,,1,POINT (10970933 -74765343)
2015,Septiembre,República Democrática Popular de Corea,0,1,,1,POINT (4697157 -74140516)
2015,Septiembre,Rumania,0,1,,1,POINT (10970933 -74765343)
2015,Septiembre,Rumania,0,1,,1,POINT (3451668 -76532004)
2015,Septiembre,Rumania,2,5,,7,POINT (4697157 -74140516)
2015,Septiembre,Rumania,3,1,,4,POINT (6170465 -7542726)
2015,Septiembre,San Marino,0,1,,1,POINT (4697157 -74140516)
2015,Septiembre,San  Vicente y las Granadinas,0,1,,1,POINT (10446304 -75516486)
2015,Septiembre,San  Vicente y las Granadinas,0,1,,1,POINT (4697157 -74140516)
2015,Septiembre,San  Vicente y las Granadinas,0,1,,1,POINT (6170465 -7542726)
2015,Septiembre,Santa Lucia,0,1,,1,POINT (4697157 -74140516)
2015,Septiembre,Santa Lucia,0,1,,1,POINT (6170465 -7542726)
2015,Septiembre,Santo Tomé y Príncipe,0,1,,1,POINT (4697157 -74140516)
2015,Septiembre,Senegal,1,0,,1,POINT (4697157 -74140516)
2015,Septiembre,Senegal,0,2,,2,POINT (6170465 -7542726)
2015,Septiembre,Seychelles,1,0,,1,POINT (4697157 -74140516)
2015,Septiembre,Singapur,2,2,,4,POINT (4697157 -74140516)
2015,Septiembre,Sudáfrica,3,9,,12,POINT (4697157 -74140516)
2015,Septiembre,Sudáfrica,0,2,,2,POINT (6170465 -7542726)
2015,Septiembre,Sudán,0,2,,2,POINT (3451668 -76532004)
2015,Septiembre,Sudán,0,1,,1,POINT (4697157 -74140516)
2015,Septiembre,Suecia,1,6,,7,POINT (3451668 -76532004)
2015,Septiembre,Suecia,17,25,,42,POINT (4697157 -74140516)
2015,Septiembre,Suecia,3,4,,7,POINT (6170465 -7542726)
2015,Septiembre,Suiza,12,25,,37,POINT (3451668 -76532004)
2015,Septiembre,Suiza,39,78,,117,POINT (4697157 -74140516)
2015,Septiembre,Suiza,14,23,,37,POINT (6170465 -7542726)
2015,Septiembre,Surinam,0,5,,5,POINT (4697157 -74140516)
2015,Septiembre,Surinam,2,4,,6,POINT (6170465 -7542726)
2015,Septiembre,Taiwán,1,0,,1,POINT (10446304 -75516486)
2015,Septiembre,Taiwán,7,7,,14,POINT (3451668 -76532004)
2015,Septiembre,Taiwán,3,5,,8,POINT (4697157 -74140516)
2015,Septiembre,Tailandia,0,3,,3,POINT (4697157 -74140516)
2015,Septiembre,Tanzania,0,1,,1,POINT (6170465 -7542726)
2015,Septiembre,República Democrática de Timor Oriental,0,1,,1,POINT (6170465 -7542726)
2015,Septiembre,Trinidad y Tobago,0,6,,6,POINT (10406342 -75527794)
2015,Septiembre,Trinidad y Tobago,0,1,,1,POINT (10446304 -75516486)
2015,Septiembre,Trinidad y Tobago,0,1,,1,POINT (10970933 -74765343)
2015,Septiembre,Trinidad y Tobago,1,4,,5,POINT (3451668 -76532004)
2015,Septiembre,Trinidad y Tobago,2,7,,9,POINT (4697157 -74140516)
2015,Septiembre,Trinidad y Tobago,0,3,,3,POINT (4815189 -75736374)
2015,Septiembre,Trinidad y Tobago,1,6,,7,POINT (6170465 -7542726)
2015,Septiembre,Túnez,1,2,,3,POINT (4697157 -74140516)
2015,Septiembre,Turquía,0,1,,1,POINT (3451668 -76532004)
2015,Septiembre,Turquía,1,14,,15,POINT (4697157 -74140516)
2015,Septiembre,Turquía,0,2,,2,POINT (6170465 -7542726)
2015,Septiembre,Ucrania,0,1,,1,POINT (3451668 -76532004)
2015,Septiembre,Ucrania,2,3,,5,POINT (4697157 -74140516)
2015,Septiembre,Ucrania,0,1,,1,POINT (6170465 -7542726)
2015,Septiembre,Uganda,0,2,,2,POINT (6170465 -7542726)
2015,Septiembre,Uruguay,0,1,,1,POINT (0.81488 -77356)
2015,Septiembre,Uruguay,8,6,,14,POINT (10446304 -75516486)
2015,Septiembre,Uruguay,2,1,,3,POINT (10886686 -74776479)
2015,Septiembre,Uruguay,23,13,,36,POINT (125862 -81702165)
2015,Septiembre,Uruguay,21,29,,50,POINT (3451668 -76532004)
2015,Septiembre,Uruguay,68,101,,169,POINT (4697157 -74140516)
2015,Septiembre,Uruguay,22,42,,64,POINT (6170465 -7542726)
2015,Septiembre,Uzbekistán,1,1,,2,POINT (4697157 -74140516)
2015,Septiembre,Venezuela,0,9,,9,POINT (10406342 -75527794)
2015,Septiembre,Venezuela,436,397,,833,POINT (10446304 -75516486)
2015,Septiembre,Venezuela,15,53,,68,POINT (10886686 -74776479)
2015,Septiembre,Venezuela,0,2,,2,POINT (10970933 -74765343)
2015,Septiembre,Venezuela,970,1250,,2220,POINT (11360029 -72129595)
2015,Septiembre,Venezuela,1,0,,1,POINT (125862 -81702165)
2015,Septiembre,Venezuela,12,10,,22,POINT (3451668 -76532004)
2015,Septiembre,Venezuela,34,44,,78,POINT (3866713 -67927521)
2015,Septiembre,Venezuela,4122,4564,,8686,POINT (4697157 -74140516)
2015,Septiembre,Venezuela,0,2,,2,POINT (4815189 -75736374)
2015,Septiembre,Venezuela,2561,2271,,4832,POINT (6170465 -7542726)
2015,Septiembre,Venezuela,205,424,,629,POINT (6185536 -67484028)
2015,Septiembre,Venezuela,191,278,,469,POINT (7088729 -70740253)
2015,Septiembre,Venezuela,3,2,,5,POINT (7128047 -73181317)
2015,Septiembre,Venezuela,1457,1804,,3261,POINT (7819 -72453013)
2015,Septiembre,Venezuela,61,89,,150,POINT (7927233 -72508188)
2015,Septiembre,Islas Vírgenes Británicas/Territorio Británico de Ultramar,1,0,,1,POINT (6170465 -7542726)
2015,Septiembre,Islas Vírgenes Estadounidenses/Territorio de Estados Unidos,0,1,,1,POINT (6170465 -7542726)
2015,Septiembre,Zambia,4,0,,4,POINT (4697157 -74140516)
2015,Septiembre,Zambia,1,0,,1,POINT (6170465 -7542726)
2015,Septiembre,Zimbabue,0,1,,1,POINT (4697157 -74140516)
2015,Septiembre,Zimbabue,0,1,,1,POINT (6170465 -7542726)
2015,Septiembre,Desconocido,0,24,,24,POINT (9402597 -75681642)
2015,Octubre,Afganistán,0,4,,4,POINT (4697157 -74140516)
2015,Octubre,Albania,0,1,,1,POINT (3451668 -76532004)
2015,Octubre,Albania,0,2,,2,POINT (4697157 -74140516)
2015,Octubre,Alemania,1,1,,2,POINT (10446304 -75516486)
2015,Octubre,Alemania,3,4,,7,POINT (10886686 -74776479)
2015,Octubre,Alemania,1,0,,1,POINT (125862 -81702165)
2015,Octubre,Alemania,38,35,,73,POINT (3451668 -76532004)
2015,Octubre,Alemania,1346,2323,,3669,POINT (4697157 -74140516)
2015,Octubre,Alemania,0,1,,1,POINT (4815189 -75736374)
2015,Octubre,Alemania,39,44,,83,POINT (6170465 -7542726)
2015,Octubre,Alemania,0,2,,2,POINT (7128047 -73181317)
2015,Octubre,Andorra,0,1,,1,POINT (3451668 -76532004)
2015,Octubre,Andorra,0,1,,1,POINT (4697157 -74140516)
2015,Octubre,Antigua y Barbuda,0,2,,2,POINT (10406342 -75527794)
2015,Octubre,Antigua y Barbuda,0,4,,4,POINT (4697157 -74140516)
2015,Octubre,Países Bajos,0,1,,1,POINT (1800143 -78802679)
2015,Octubre,Países Bajos,1,5,,6,POINT (10406342 -75527794)
2015,Octubre,Países Bajos,0,1,,1,POINT (10446304 -75516486)
2015,Octubre,Países Bajos,91,106,,197,POINT (10886686 -74776479)
2015,Octubre,Países Bajos,1,1,,2,POINT (10970933 -74765343)
2015,Octubre,Países Bajos,3,1,,4,POINT (11247723 -74213989)
2015,Octubre,Países Bajos,116,225,,341,POINT (3451668 -76532004)
2015,Octubre,Países Bajos,872,1315,,2187,POINT (4697157 -74140516)
2015,Octubre,Países Bajos,1,2,,3,POINT (4815189 -75736374)
2015,Octubre,Países Bajos,239,321,,560,POINT (6170465 -7542726)
2015,Octubre,Países Bajos,1,0,,1,POINT (7927233 -72508188)
2015,Octubre,Arabia Saudita,2,0,,2,POINT (4697157 -74140516)
2015,Octubre,Arabia Saudita,0,1,,1,POINT (7927233 -72508188)
2015,Octubre,Argelia,1,0,,1,POINT (125862 -81702165)
2015,Octubre,Argelia,1,0,,1,POINT (3451668 -76532004)
2015,Octubre,Argelia,3,5,,8,POINT (4697157 -74140516)
2015,Octubre,Argelia,0,1,,1,POINT (6170465 -7542726)
2015,Octubre,Argelia,0,4,,4,POINT (806667 -767333)
2015,Octubre,Argentina,9,15,,24,POINT (0.81488 -77356)
2015,Octubre,Argentina,52,32,,84,POINT (10446304 -75516486)
2015,Octubre,Argentina,0,3,,3,POINT (10886686 -74776479)
2015,Octubre,Argentina,250,191,,441,POINT (125862 -81702165)
2015,Octubre,Argentina,46,151,,197,POINT (3451668 -76532004)
2015,Octubre,Argentina,1647,2644,,4291,POINT (4697157 -74140516)
2015,Octubre,Argentina,1,4,,5,POINT (4815189 -75736374)
2015,Octubre,Argentina,71,128,,199,POINT (6170465 -7542726)
2015,Octubre,Argentina,1,2,,3,POINT (7128047 -73181317)
2015,Octubre,Aruba,4,11,,15,POINT (10406342 -75527794)
2015,Octubre,Aruba,2,2,,4,POINT (10446304 -75516486)
2015,Octubre,Aruba,4,6,,10,POINT (10886686 -74776479)
2015,Octubre,Aruba,1,31,,32,POINT (10970933 -74765343)
2015,Octubre,Aruba,17,25,,42,POINT (11247723 -74213989)
2015,Octubre,Aruba,9,18,,27,POINT (3451668 -76532004)
2015,Octubre,Aruba,585,663,,1248,POINT (4697157 -74140516)
2015,Octubre,Aruba,4,5,,9,POINT (4815189 -75736374)
2015,Octubre,Aruba,91,102,,193,POINT (6170465 -7542726)
2015,Octubre,Aruba,8,3,,11,POINT (7128047 -73181317)
2015,Octubre,Aruba,0,1,,1,POINT (7927233 -72508188)
2015,Octubre,Australia,0,1,,1,POINT (10886686 -74776479)
2015,Octubre,Australia,0,1,,1,POINT (125862 -81702165)
2015,Octubre,Australia,8,4,,12,POINT (3451668 -76532004)
2015,Octubre,Australia,17,37,,54,POINT (4697157 -74140516)
2015,Octubre,Australia,1,0,,1,POINT (4815189 -75736374)
2015,Octubre,Australia,4,22,,26,POINT (6170465 -7542726)
2015,Octubre,Australia,2,1,,3,POINT (7128047 -73181317)
2015,Octubre,Austria,2,1,,3,POINT (3451668 -76532004)
2015,Octubre,Austria,7,16,,23,POINT (4697157 -74140516)
2015,Octubre,Austria,1,3,,4,POINT (6170465 -7542726)
2015,Octubre,Azerbaiyán,0,2,,2,POINT (3451668 -76532004)
2015,Octubre,Azerbaiyán,1,2,,3,POINT (4697157 -74140516)
2015,Octubre,Bahamas,0,1,,1,POINT (3451668 -76532004)
2015,Octubre,Bahamas,0,1,,1,POINT (4697157 -74140516)
2015,Octubre,Bahamas,0,2,,2,POINT (6170465 -7542726)
2015,Octubre,Bahréin,1,1,,2,POINT (4697157 -74140516)
2015,Octubre,Barbados,0,9,,9,POINT (10446304 -75516486)
2015,Octubre,Barbados,2,1,,3,POINT (4697157 -74140516)
2015,Octubre,Barbados,0,1,,1,POINT (6170465 -7542726)
2015,Octubre,República de Belarús,4,0,,4,POINT (4697157 -74140516)
2015,Octubre,Bélgica,0,4,,4,POINT (10406342 -75527794)
2015,Octubre,Bélgica,4,11,,15,POINT (3451668 -76532004)
2015,Octubre,Bélgica,25,48,,73,POINT (4697157 -74140516)
2015,Octubre,Bélgica,3,9,,12,POINT (6170465 -7542726)
2015,Octubre,Belice,0,1,,1,POINT (4697157 -74140516)
2015,Octubre,Belice,0,2,,2,POINT (6170465 -7542726)
2015,Octubre,Benín,0,1,,1,POINT (3451668 -76532004)
2015,Octubre,Benín,1,0,,1,POINT (4697157 -74140516)
2015,Octubre,Bermudas/Territorio Británico de Ultramar,3,6,,9,POINT (3451668 -76532004)
2015,Octubre,Bolivia,1,0,,1,POINT (0.81488 -77356)
2015,Octubre,Bolivia,1,1,,2,POINT (10446304 -75516486)
2015,Octubre,Bolivia,1,2,,3,POINT (10886686 -74776479)
2015,Octubre,Bolivia,18,13,,31,POINT (125862 -81702165)
2015,Octubre,Bolivia,20,26,,46,POINT (3451668 -76532004)
2015,Octubre,Bolivia,407,597,,1004,POINT (4697157 -74140516)
2015,Octubre,Bolivia,1,3,,4,POINT (4815189 -75736374)
2015,Octubre,Bolivia,43,36,,79,POINT (6170465 -7542726)
2015,Octubre,Bolivia,1,1,,2,POINT (7128047 -73181317)
2015,Octubre,Brasil,126,161,,287,POINT (-4191162 -69941498)
2015,Octubre,Brasil,2,12,,14,POINT (-4214082 -69941431)
2015,Octubre,Brasil,1,1,,2,POINT (0.81488 -77356)
2015,Octubre,Brasil,0,4,,4,POINT (10406342 -75527794)
2015,Octubre,Brasil,43,30,,73,POINT (10446304 -75516486)
2015,Octubre,Brasil,1,4,,5,POINT (10886686 -74776479)
2015,Octubre,Brasil,192,156,,348,POINT (125862 -81702165)
2015,Octubre,Brasil,40,71,,111,POINT (3451668 -76532004)
2015,Octubre,Brasil,0,3,,3,POINT (3866713 -67927521)
2015,Octubre,Brasil,3890,5470,,9360,POINT (4697157 -74140516)
2015,Octubre,Brasil,1,31,,32,POINT (4815189 -75736374)
2015,Octubre,Brasil,92,143,,235,POINT (6170465 -7542726)
2015,Octubre,Brasil,0,4,,4,POINT (7128047 -73181317)
2015,Octubre,Brasil,1,0,,1,POINT (7927233 -72508188)
2015,Octubre,Bulgaria,0,1,,1,POINT (10446304 -75516486)
2015,Octubre,Bulgaria,2,2,,4,POINT (4697157 -74140516)
2015,Octubre,Bulgaria,0,1,,1,POINT (6170465 -7542726)
2015,Octubre,Cabo Verde,1,0,,1,POINT (4697157 -74140516)
2015,Octubre,Islas Caimán/Territorio Británico de Ultramar,1,1,,2,POINT (11247723 -74213989)
2015,Octubre,Islas Caimán/Territorio Británico de Ultramar,1,1,,2,POINT (133387613 -81372937)
2015,Octubre,Islas Caimán/Territorio Británico de Ultramar,2,6,,8,POINT (4697157 -74140516)
2015,Octubre,Camerún,0,1,,1,POINT (10886686 -74776479)
2015,Octubre,Canadá,0,8,,8,POINT (10406342 -75527794)
2015,Octubre,Canadá,17,19,,36,POINT (10446304 -75516486)
2015,Octubre,Canadá,6,8,,14,POINT (10886686 -74776479)
2015,Octubre,Canadá,0,2,,2,POINT (10970933 -74765343)
2015,Octubre,Canadá,0,1,,1,POINT (125862 -81702165)
2015,Octubre,Canadá,29,46,,75,POINT (3451668 -76532004)
2015,Octubre,Canadá,499,787,,1286,POINT (4697157 -74140516)
2015,Octubre,Canadá,3,6,,9,POINT (4815189 -75736374)
2015,Octubre,Canadá,52,100,,152,POINT (6170465 -7542726)
2015,Octubre,Canadá,4,4,,8,POINT (7128047 -73181317)
2015,Octubre,Canadá,1,1,,2,POINT (7927233 -72508188)
2015,Octubre,Chad,0,1,,1,POINT (4697157 -74140516)
2015,Octubre,España,1,6,,7,POINT (10406342 -75527794)
2015,Octubre,España,2,5,,7,POINT (10886686 -74776479)
2015,Octubre,España,0,1,,1,POINT (11247723 -74213989)
2015,Octubre,España,457,718,,1175,POINT (3451668 -76532004)
2015,Octubre,España,2647,5017,,7664,POINT (4697157 -74140516)
2015,Octubre,España,5,2,,7,POINT (4815189 -75736374)
2015,Octubre,España,266,526,,792,POINT (6170465 -7542726)
2015,Octubre,España,1,0,,1,POINT (7128047 -73181317)
2015,Octubre,España,0,1,,1,POINT (7927233 -72508188)
2015,Octubre,República de Corea,0,2,,2,POINT (10406342 -75527794)
2015,Octubre,República de Corea,0,1,,1,POINT (10446304 -75516486)
2015,Octubre,República de Corea,4,6,,10,POINT (3451668 -76532004)
2015,Octubre,República de Corea,12,32,,44,POINT (4697157 -74140516)
2015,Octubre,República de Corea,2,2,,4,POINT (6170465 -7542726)
2015,Octubre,República de Corea,0,2,,2,POINT (7927233 -72508188)
2015,Octubre,Costa de Marfil,3,2,,5,POINT (4697157 -74140516)
2015,Octubre,Costa Rica,13,17,,30,POINT (10406342 -75527794)
2015,Octubre,Costa Rica,5,12,,17,POINT (10446304 -75516486)
2015,Octubre,Costa Rica,4,7,,11,POINT (10886686 -74776479)
2015,Octubre,Costa Rica,0,1,,1,POINT (11247723 -74213989)
2015,Octubre,Costa Rica,59,57,,116,POINT (125862 -81702165)
2015,Octubre,Costa Rica,35,49,,84,POINT (3451668 -76532004)
2015,Octubre,Costa Rica,1006,1487,,2493,POINT (4697157 -74140516)
2015,Octubre,Costa Rica,2,2,,4,POINT (4815189 -75736374)
2015,Octubre,Costa Rica,63,89,,152,POINT (6170465 -7542726)
2015,Octubre,Costa Rica,4,0,,4,POINT (7128047 -73181317)
2015,Octubre,Costa Rica,0,1,,1,POINT (7927233 -72508188)
2015,Octubre,Costa Rica,0,4,,4,POINT (806667 -767333)
2015,Octubre,Croacia,0,1,,1,POINT (3451668 -76532004)
2015,Octubre,Croacia,0,1,,1,POINT (4697157 -74140516)
2015,Octubre,Cuba,0,4,,4,POINT (10406342 -75527794)
2015,Octubre,Cuba,1,4,,5,POINT (10446304 -75516486)
2015,Octubre,Cuba,7,20,,27,POINT (10886686 -74776479)
2015,Octubre,Cuba,1,0,,1,POINT (125862 -81702165)
2015,Octubre,Cuba,14,21,,35,POINT (3451668 -76532004)
2015,Octubre,Cuba,341,491,,832,POINT (4697157 -74140516)
2015,Octubre,Cuba,1,3,,4,POINT (4815189 -75736374)
2015,Octubre,Cuba,11,30,,41,POINT (6170465 -7542726)
2015,Octubre,Cuba,2,2,,4,POINT (7128047 -73181317)
2015,Octubre,Cuba,0,2,,2,POINT (7927233 -72508188)
2015,Octubre,Curazao,1,0,,1,POINT (4697157 -74140516)
2015,Octubre,República Checa,0,2,,2,POINT (3451668 -76532004)
2015,Octubre,República Checa,7,15,,22,POINT (4697157 -74140516)
2015,Octubre,República Checa,0,1,,1,POINT (7927233 -72508188)
2015,Octubre,Chile,1,1,,2,POINT (0.81488 -77356)
2015,Octubre,Chile,0,1,,1,POINT (10446304 -75516486)
2015,Octubre,Chile,0,3,,3,POINT (10886686 -74776479)
2015,Octubre,Chile,21,11,,32,POINT (125862 -81702165)
2015,Octubre,Chile,50,165,,215,POINT (3451668 -76532004)
2015,Octubre,Chile,4043,5126,,9169,POINT (4697157 -74140516)
2015,Octubre,Chile,1,1,,2,POINT (4815189 -75736374)
2015,Octubre,Chile,28,62,,90,POINT (6170465 -7542726)
2015,Octubre,Chile,1,2,,3,POINT (7128047 -73181317)
2015,Octubre,Chile,0,2,,2,POINT (7927233 -72508188)
2015,Octubre,China,1,2,,3,POINT (3451668 -76532004)
2015,Octubre,China,30,74,,104,POINT (4697157 -74140516)
2015,Octubre,China,0,1,,1,POINT (4815189 -75736374)
2015,Octubre,China,3,4,,7,POINT (6170465 -7542726)
2015,Octubre,Chipre,1,1,,2,POINT (4697157 -74140516)
2015,Octubre,Dinamarca,2,7,,9,POINT (3451668 -76532004)
2015,Octubre,Dinamarca,14,20,,34,POINT (4697157 -74140516)
2015,Octubre,Dinamarca,0,1,,1,POINT (6170465 -7542726)
2015,Octubre,Ecuador,65,185,,250,POINT (0.33002 -76876446)
2015,Octubre,Ecuador,3,9,,12,POINT (0.812436 -77847006)
2015,Octubre,Ecuador,3327,4583,,7910,POINT (0.81488 -77356)
2015,Octubre,Ecuador,34,290,,324,POINT (1800143 -78802679)
2015,Octubre,Ecuador,0,1,,1,POINT (10406342 -75527794)
2015,Octubre,Ecuador,1,5,,6,POINT (10886686 -74776479)
2015,Octubre,Ecuador,12,11,,23,POINT (125862 -81702165)
2015,Octubre,Ecuador,510,596,,1106,POINT (3451668 -76532004)
2015,Octubre,Ecuador,3872,5345,,9217,POINT (4697157 -74140516)
2015,Octubre,Ecuador,1,3,,4,POINT (4815189 -75736374)
2015,Octubre,Ecuador,39,48,,87,POINT (6170465 -7542726)
2015,Octubre,Ecuador,4,1,,5,POINT (7128047 -73181317)
2015,Octubre,Ecuador,0,3,,3,POINT (7927233 -72508188)
2015,Octubre,Egipto,0,1,,1,POINT (4697157 -74140516)
2015,Octubre,El Salvador,1,1,,2,POINT (10446304 -75516486)
2015,Octubre,El Salvador,1,3,,4,POINT (10886686 -74776479)
2015,Octubre,El Salvador,19,12,,31,POINT (125862 -81702165)
2015,Octubre,El Salvador,83,154,,237,POINT (3451668 -76532004)
2015,Octubre,El Salvador,1018,1435,,2453,POINT (4697157 -74140516)
2015,Octubre,El Salvador,0,2,,2,POINT (4815189 -75736374)
2015,Octubre,El Salvador,157,236,,393,POINT (6170465 -7542726)
2015,Octubre,Emiratos Árabes,3,3,,6,POINT (4697157 -74140516)
2015,Octubre,Eslovaquia,0,3,,3,POINT (3451668 -76532004)
2015,Octubre,Eslovaquia,2,3,,5,POINT (4697157 -74140516)
2015,Octubre,Eslovenia,3,5,,8,POINT (4697157 -74140516)
2015,Octubre,Estados Unidos de América,8,34,,42,POINT (10406342 -75527794)
2015,Octubre,Estados Unidos de América,1830,2937,,4767,POINT (10446304 -75516486)
2015,Octubre,Estados Unidos de América,449,911,,1360,POINT (10886686 -74776479)
2015,Octubre,Estados Unidos de América,0,12,,12,POINT (10970933 -74765343)
2015,Octubre,Estados Unidos de América,0,3,,3,POINT (11117206 -74232675)
2015,Octubre,Estados Unidos de América,0,25,,25,POINT (11247723 -74213989)
2015,Octubre,Estados Unidos de América,7,15,,22,POINT (125862 -81702165)
2015,Octubre,Estados Unidos de América,802,1231,,2033,POINT (3451668 -76532004)
2015,Octubre,Estados Unidos de América,84,129,,213,POINT (445285 -75766353)
2015,Octubre,Estados Unidos de América,7241,14181,,21422,POINT (4697157 -74140516)
2015,Octubre,Estados Unidos de América,79,150,,229,POINT (4815189 -75736374)
2015,Octubre,Estados Unidos de América,1638,4067,,5705,POINT (6170465 -7542726)
2015,Octubre,Estados Unidos de América,13,43,,56,POINT (7128047 -73181317)
2015,Octubre,Estados Unidos de América,44,27,,71,POINT (7927233 -72508188)
2015,Octubre,Estados Unidos de América,0,1,,1,POINT (9402597 -75681642)
2015,Octubre,Estonia,1,3,,4,POINT (4697157 -74140516)
2015,Octubre,Filipinas,0,1,,1,POINT (10446304 -75516486)
2015,Octubre,Filipinas,0,2,,2,POINT (10886686 -74776479)
2015,Octubre,Filipinas,3,12,,15,POINT (4697157 -74140516)
2015,Octubre,Finlandia,2,4,,6,POINT (3451668 -76532004)
2015,Octubre,Finlandia,4,5,,9,POINT (4697157 -74140516)
2015,Octubre,Finlandia,1,3,,4,POINT (6170465 -7542726)
2015,Octubre,Francia,0,1,,1,POINT (10446304 -75516486)
2015,Octubre,Francia,2,2,,4,POINT (10886686 -74776479)
2015,Octubre,Francia,18,51,,69,POINT (3451668 -76532004)
2015,Octubre,Francia,1257,2217,,3474,POINT (4697157 -74140516)
2015,Octubre,Francia,1,3,,4,POINT (4815189 -75736374)
2015,Octubre,Francia,15,33,,48,POINT (6170465 -7542726)
2015,Octubre,Francia,3,6,,9,POINT (7128047 -73181317)
2015,Octubre,Georgia,0,1,,1,POINT (4697157 -74140516)
2015,Octubre,Ghana,0,1,,1,POINT (4697157 -74140516)
2015,Octubre,Gibraltar/Territorio Británico de Ultramar,0,1,,1,POINT (0.81488 -77356)
2015,Octubre,Gibraltar/Territorio Británico de Ultramar,0,1,,1,POINT (806667 -767333)
2015,Octubre,Grecia,1,0,,1,POINT (3451668 -76532004)
2015,Octubre,Grecia,2,14,,16,POINT (4697157 -74140516)
2015,Octubre,Guatemala,1,5,,6,POINT (10446304 -75516486)
2015,Octubre,Guatemala,0,3,,3,POINT (10886686 -74776479)
2015,Octubre,Guatemala,0,1,,1,POINT (10970933 -74765343)
2015,Octubre,Guatemala,30,43,,73,POINT (125862 -81702165)
2015,Octubre,Guatemala,36,61,,97,POINT (3451668 -76532004)
2015,Octubre,Guatemala,335,633,,968,POINT (4697157 -74140516)
2015,Octubre,Guatemala,3,7,,10,POINT (4815189 -75736374)
2015,Octubre,Guatemala,40,86,,126,POINT (6170465 -7542726)
2015,Octubre,Guatemala,0,7,,7,POINT (7128047 -73181317)
2015,Octubre,Guatemala,2,1,,3,POINT (7927233 -72508188)
2015,Octubre,Guyana,1,1,,2,POINT (3451668 -76532004)
2015,Octubre,Guyana,1,1,,2,POINT (4697157 -74140516)
2015,Octubre,Guyana,1,0,,1,POINT (6170465 -7542726)
2015,Octubre,Guinea Ecuatorial,1,0,,1,POINT (4697157 -74140516)
2015,Octubre,Guadalupe/Territorio Francés,1,1,,2,POINT (10406342 -75527794)
2015,Octubre,Guadalupe/Territorio Francés,0,1,,1,POINT (3451668 -76532004)
2015,Octubre,Guadalupe/Territorio Francés,1,2,,3,POINT (4697157 -74140516)
2015,Octubre,Haití,4,2,,6,POINT (10446304 -75516486)
2015,Octubre,Haití,0,1,,1,POINT (10886686 -74776479)
2015,Octubre,Haití,0,7,,7,POINT (10970933 -74765343)
2015,Octubre,Haití,1,17,,18,POINT (4697157 -74140516)
2015,Octubre,Haití,1,0,,1,POINT (4815189 -75736374)
2015,Octubre,Haití,0,2,,2,POINT (7927233 -72508188)
2015,Octubre,Honduras,1,19,,20,POINT (10406342 -75527794)
2015,Octubre,Honduras,7,0,,7,POINT (10446304 -75516486)
2015,Octubre,Honduras,3,3,,6,POINT (10886686 -74776479)
2015,Octubre,Honduras,2,3,,5,POINT (125744111 -81703935)
2015,Octubre,Honduras,0,3,,3,POINT (125862 -81702165)
2015,Octubre,Honduras,34,60,,94,POINT (3451668 -76532004)
2015,Octubre,Honduras,85,68,,153,POINT (4697157 -74140516)
2015,Octubre,Honduras,16,47,,63,POINT (6170465 -7542726)
2015,Octubre,Honduras,0,1,,1,POINT (7128047 -73181317)
2015,Octubre,Hong Kong,7,3,,10,POINT (3451668 -76532004)
2015,Octubre,Hong Kong,3,0,,3,POINT (4697157 -74140516)
2015,Octubre,Hungría,0,1,,1,POINT (3451668 -76532004)
2015,Octubre,Hungría,4,5,,9,POINT (4697157 -74140516)
2015,Octubre,India,1,1,,2,POINT (10886686 -74776479)
2015,Octubre,India,0,1,,1,POINT (3451668 -76532004)
2015,Octubre,India,3,31,,34,POINT (4697157 -74140516)
2015,Octubre,India,0,1,,1,POINT (4815189 -75736374)
2015,Octubre,India,2,2,,4,POINT (6170465 -7542726)
2015,Octubre,India,0,1,,1,POINT (7128047 -73181317)
2015,Octubre,Indonesia,1,0,,1,POINT (4697157 -74140516)
2015,Octubre,Iraq,0,1,,1,POINT (4697157 -74140516)
2015,Octubre,Irán,0,1,,1,POINT (3451668 -76532004)
2015,Octubre,Irán,0,1,,1,POINT (4697157 -74140516)
2015,Octubre,República de Irlanda,2,4,,6,POINT (3451668 -76532004)
2015,Octubre,República de Irlanda,8,6,,14,POINT (4697157 -74140516)
2015,Octubre,República de Irlanda,1,3,,4,POINT (6170465 -7542726)
2015,Octubre,República de Irlanda,2,0,,2,POINT (7927233 -72508188)
2015,Octubre,Islandia,1,0,,1,POINT (4697157 -74140516)
2015,Octubre,Israel,0,1,,1,POINT (10446304 -75516486)
2015,Octubre,Israel,0,1,,1,POINT (125862 -81702165)
2015,Octubre,Israel,2,7,,9,POINT (3451668 -76532004)
2015,Octubre,Israel,15,63,,78,POINT (4697157 -74140516)
2015,Octubre,Israel,0,6,,6,POINT (6170465 -7542726)
2015,Octubre,Italia,21,61,,82,POINT (3451668 -76532004)
2015,Octubre,Italia,96,193,,289,POINT (4697157 -74140516)
2015,Octubre,Italia,11,37,,48,POINT (6170465 -7542726)
2015,Octubre,Jamaica,0,2,,2,POINT (10446304 -75516486)
2015,Octubre,Jamaica,0,2,,2,POINT (11117206 -74232675)
2015,Octubre,Jamaica,2,2,,4,POINT (125862 -81702165)
2015,Octubre,Jamaica,2,1,,3,POINT (3451668 -76532004)
2015,Octubre,Jamaica,3,6,,9,POINT (4697157 -74140516)
2015,Octubre,Jamaica,0,2,,2,POINT (6170465 -7542726)
2015,Octubre,Japón,0,1,,1,POINT (10886686 -74776479)
2015,Octubre,Japón,8,10,,18,POINT (3451668 -76532004)
2015,Octubre,Japón,4,16,,20,POINT (4697157 -74140516)
2015,Octubre,Japón,1,2,,3,POINT (6170465 -7542726)
2015,Octubre,Kazajistán,0,3,,3,POINT (3451668 -76532004)
2015,Octubre,Kazajistán,1,0,,1,POINT (6170465 -7542726)
2015,Octubre,Kenia,1,1,,2,POINT (4697157 -74140516)
2015,Octubre,Kirguistán,0,1,,1,POINT (4697157 -74140516)
2015,Octubre,Kuwait,0,1,,1,POINT (4815189 -75736374)
2015,Octubre,Letonia,2,1,,3,POINT (4697157 -74140516)
2015,Octubre,Lituania,2,1,,3,POINT (4697157 -74140516)
2015,Octubre,Líbano,5,9,,14,POINT (4697157 -74140516)
2015,Octubre,Libia,0,1,,1,POINT (4697157 -74140516)
2015,Octubre,Luxemburgo,1,1,,2,POINT (4697157 -74140516)
2015,Octubre,Madagascar,0,1,,1,POINT (10886686 -74776479)
2015,Octubre,Malasia,2,0,,2,POINT (3451668 -76532004)
2015,Octubre,Malasia,1,4,,5,POINT (4697157 -74140516)
2015,Octubre,Malasia,0,1,,1,POINT (6170465 -7542726)
2015,Octubre,Malta,0,1,,1,POINT (4697157 -74140516)
2015,Octubre,Malta,0,1,,1,POINT (6170465 -7542726)
2015,Octubre,Marruecos,4,1,,5,POINT (4697157 -74140516)
2015,Octubre,México,0,8,,8,POINT (10406342 -75527794)
2015,Octubre,México,8,9,,17,POINT (10446304 -75516486)
2015,Octubre,México,8,31,,39,POINT (10886686 -74776479)
2015,Octubre,México,0,6,,6,POINT (10970933 -74765343)
2015,Octubre,México,9,5,,14,POINT (125862 -81702165)
2015,Octubre,México,51,108,,159,POINT (3451668 -76532004)
2015,Octubre,México,4227,7321,,11548,POINT (4697157 -74140516)
2015,Octubre,México,6,12,,18,POINT (4815189 -75736374)
2015,Octubre,México,526,1180,,1706,POINT (6170465 -7542726)
2015,Octubre,México,9,22,,31,POINT (7128047 -73181317)
2015,Octubre,México,4,8,,12,POINT (7927233 -72508188)
2015,Octubre,Mónaco,0,3,,3,POINT (4697157 -74140516)
2015,Octubre,Nepal,0,2,,2,POINT (4697157 -74140516)
2015,Octubre,Nicaragua,0,3,,3,POINT (10446304 -75516486)
2015,Octubre,Nicaragua,1,3,,4,POINT (10886686 -74776479)
2015,Octubre,Nicaragua,2,0,,2,POINT (125862 -81702165)
2015,Octubre,Nicaragua,14,7,,21,POINT (3451668 -76532004)
2015,Octubre,Nicaragua,16,29,,45,POINT (4697157 -74140516)
2015,Octubre,Nicaragua,3,6,,9,POINT (4815189 -75736374)
2015,Octubre,Nicaragua,4,11,,15,POINT (6170465 -7542726)
2015,Octubre,Nicaragua,1,0,,1,POINT (7128047 -73181317)
2015,Octubre,Nicaragua,1,0,,1,POINT (7927233 -72508188)
2015,Octubre,Noruega,3,3,,6,POINT (3451668 -76532004)
2015,Octubre,Noruega,14,18,,32,POINT (4697157 -74140516)
2015,Octubre,Noruega,1,1,,2,POINT (6170465 -7542726)
2015,Octubre,Nueva Zelanda,2,1,,3,POINT (3451668 -76532004)
2015,Octubre,Nueva Zelanda,5,1,,6,POINT (4697157 -74140516)
2015,Octubre,Nueva Zelanda,0,1,,1,POINT (6170465 -7542726)
2015,Octubre,Pakistán,0,1,,1,POINT (3451668 -76532004)
2015,Octubre,Panamá,0,13,,13,POINT (1800143 -78802679)
2015,Octubre,Panamá,1253,918,,2171,POINT (10406342 -75527794)
2015,Octubre,Panamá,2252,2532,,4784,POINT (10446304 -75516486)
2015,Octubre,Panamá,243,575,,818,POINT (10886686 -74776479)
2015,Octubre,Panamá,1,29,,30,POINT (10970933 -74765343)
2015,Octubre,Panamá,3,3,,6,POINT (11247723 -74213989)
2015,Octubre,Panamá,6,12,,18,POINT (125744111 -81703935)
2015,Octubre,Panamá,411,356,,767,POINT (125862 -81702165)
2015,Octubre,Panamá,4,5,,9,POINT (133387613 -81372937)
2015,Octubre,Panamá,290,506,,796,POINT (3451668 -76532004)
2015,Octubre,Panamá,0,13,,13,POINT (3884426 -77061029)
2015,Octubre,Panamá,4032,5986,,10018,POINT (4697157 -74140516)
2015,Octubre,Panamá,51,113,,164,POINT (4815189 -75736374)
2015,Octubre,Panamá,1621,2471,,4092,POINT (6170465 -7542726)
2015,Octubre,Panamá,0,3,,3,POINT (6222552 -77401154)
2015,Octubre,Panamá,3,8,,11,POINT (7102626 -77762647)
2015,Octubre,Panamá,48,83,,131,POINT (7128047 -73181317)
2015,Octubre,Panamá,38,47,,85,POINT (7927233 -72508188)
2015,Octubre,Panamá,1,3,,4,POINT (806667 -767333)
2015,Octubre,Panamá,84,103,,187,POINT (863337 -7735002)
2015,Octubre,Panamá,10,15,,25,POINT (9402597 -75681642)
2015,Octubre,Paraguay,4,3,,7,POINT (10446304 -75516486)
2015,Octubre,Paraguay,0,1,,1,POINT (10886686 -74776479)
2015,Octubre,Paraguay,59,25,,84,POINT (125862 -81702165)
2015,Octubre,Paraguay,11,13,,24,POINT (3451668 -76532004)
2015,Octubre,Paraguay,80,71,,151,POINT (4697157 -74140516)
2015,Octubre,Paraguay,7,15,,22,POINT (6170465 -7542726)
2015,Octubre,Paraguay,1,0,,1,POINT (7128047 -73181317)
2015,Octubre,Paraguay,1,1,,2,POINT (7927233 -72508188)
2015,Octubre,Perú,55,95,,150,POINT (-4191162 -69941498)
2015,Octubre,Perú,2,5,,7,POINT (-4214082 -69941431)
2015,Octubre,Perú,7,26,,33,POINT (0.81488 -77356)
2015,Octubre,Perú,0,1,,1,POINT (10406342 -75527794)
2015,Octubre,Perú,9,11,,20,POINT (10446304 -75516486)
2015,Octubre,Perú,13,142,,155,POINT (10886686 -74776479)
2015,Octubre,Perú,195,127,,322,POINT (125862 -81702165)
2015,Octubre,Perú,325,451,,776,POINT (3451668 -76532004)
2015,Octubre,Perú,6813,8930,,15743,POINT (4697157 -74140516)
2015,Octubre,Perú,1,0,,1,POINT (4815189 -75736374)
2015,Octubre,Perú,425,779,,1204,POINT (6170465 -7542726)
2015,Octubre,Perú,1,2,,3,POINT (7128047 -73181317)
2015,Octubre,Perú,1,1,,2,POINT (7927233 -72508188)
2015,Octubre,Polonia,2,4,,6,POINT (3451668 -76532004)
2015,Octubre,Polonia,10,26,,36,POINT (4697157 -74140516)
2015,Octubre,Polonia,1,16,,17,POINT (6170465 -7542726)
2015,Octubre,Portugal,1,0,,1,POINT (10886686 -74776479)
2015,Octubre,Portugal,0,2,,2,POINT (10970933 -74765343)
2015,Octubre,Portugal,2,9,,11,POINT (3451668 -76532004)
2015,Octubre,Portugal,363,591,,954,POINT (4697157 -74140516)
2015,Octubre,Portugal,5,7,,12,POINT (6170465 -7542726)
2015,Octubre,Polinesia Francesa/Colectividad de Ultramar Francesa,0,1,,1,POINT (4697157 -74140516)
2015,Octubre,Puerto Rico/Territorio de Estados Unidos,6,20,,26,POINT (10886686 -74776479)
2015,Octubre,Puerto Rico/Territorio de Estados Unidos,3,2,,5,POINT (125862 -81702165)
2015,Octubre,Puerto Rico/Territorio de Estados Unidos,18,57,,75,POINT (3451668 -76532004)
2015,Octubre,Puerto Rico/Territorio de Estados Unidos,211,342,,553,POINT (4697157 -74140516)
2015,Octubre,Puerto Rico/Territorio de Estados Unidos,3,12,,15,POINT (4815189 -75736374)
2015,Octubre,Puerto Rico/Territorio de Estados Unidos,35,63,,98,POINT (6170465 -7542726)
2015,Octubre,Puerto Rico/Territorio de Estados Unidos,1,4,,5,POINT (7128047 -73181317)
2015,Octubre,Puerto Rico/Territorio de Estados Unidos,1,0,,1,POINT (7927233 -72508188)
2015,Octubre,Qatar,0,1,,1,POINT (4697157 -74140516)
2015,Octubre,Reino Unido de Gran Bretaña e Irlanda del Norte,0,1,,1,POINT (10886686 -74776479)
2015,Octubre,Reino Unido de Gran Bretaña e Irlanda del Norte,10,26,,36,POINT (3451668 -76532004)
2015,Octubre,Reino Unido de Gran Bretaña e Irlanda del Norte,587,980,,1567,POINT (4697157 -74140516)
2015,Octubre,Reino Unido de Gran Bretaña e Irlanda del Norte,9,24,,33,POINT (6170465 -7542726)
2015,Octubre,República CentroÁfricana,1,0,,1,POINT (4697157 -74140516)
2015,Octubre,Federación de Rusia,10,19,,29,POINT (3451668 -76532004)
2015,Octubre,Federación de Rusia,17,27,,44,POINT (4697157 -74140516)
2015,Octubre,Federación de Rusia,1,1,,2,POINT (6170465 -7542726)
2015,Octubre,República Dominicana,27,36,,63,POINT (10406342 -75527794)
2015,Octubre,República Dominicana,2,7,,9,POINT (10446304 -75516486)
2015,Octubre,República Dominicana,6,30,,36,POINT (10886686 -74776479)
2015,Octubre,República Dominicana,0,2,,2,POINT (10970933 -74765343)
2015,Octubre,República Dominicana,0,1,,1,POINT (125862 -81702165)
2015,Octubre,República Dominicana,19,24,,43,POINT (3451668 -76532004)
2015,Octubre,República Dominicana,605,788,,1393,POINT (4697157 -74140516)
2015,Octubre,República Dominicana,3,4,,7,POINT (4815189 -75736374)
2015,Octubre,República Dominicana,14,34,,48,POINT (6170465 -7542726)
2015,Octubre,República Dominicana,2,1,,3,POINT (7128047 -73181317)
2015,Octubre,República Dominicana,0,1,,1,POINT (7927233 -72508188)
2015,Octubre,Rumania,0,1,,1,POINT (10446304 -75516486)
2015,Octubre,Rumania,0,1,,1,POINT (10886686 -74776479)
2015,Octubre,Rumania,1,1,,2,POINT (3451668 -76532004)
2015,Octubre,Rumania,3,8,,11,POINT (4697157 -74140516)
2015,Octubre,San  Vicente y las Granadinas,0,1,,1,POINT (10446304 -75516486)
2015,Octubre,San  Vicente y las Granadinas,0,1,,1,POINT (10970933 -74765343)
2015,Octubre,San  Vicente y las Granadinas,1,1,,2,POINT (6170465 -7542726)
2015,Octubre,Santa Lucia,1,1,,2,POINT (4697157 -74140516)
2015,Octubre,Senegal,0,1,,1,POINT (4697157 -74140516)
2015,Octubre,Singapur,3,0,,3,POINT (3451668 -76532004)
2015,Octubre,Singapur,2,2,,4,POINT (4697157 -74140516)
2015,Octubre,Sri Lanka,0,1,,1,POINT (6170465 -7542726)
2015,Octubre,Sudáfrica,6,7,,13,POINT (4697157 -74140516)
2015,Octubre,Suecia,1,0,,1,POINT (10886686 -74776479)
2015,Octubre,Suecia,9,6,,15,POINT (3451668 -76532004)
2015,Octubre,Suecia,19,30,,49,POINT (4697157 -74140516)
2015,Octubre,Suecia,2,2,,4,POINT (6170465 -7542726)
2015,Octubre,Suiza,3,0,,3,POINT (10886686 -74776479)
2015,Octubre,Suiza,14,28,,42,POINT (3451668 -76532004)
2015,Octubre,Suiza,63,92,,155,POINT (4697157 -74140516)
2015,Octubre,Suiza,5,15,,20,POINT (6170465 -7542726)
2015,Octubre,Suiza,1,3,,4,POINT (7128047 -73181317)
2015,Octubre,Suiza,3,0,,3,POINT (7927233 -72508188)
2015,Octubre,Surinam,3,4,,7,POINT (6170465 -7542726)
2015,Octubre,Taiwán,2,5,,7,POINT (3451668 -76532004)
2015,Octubre,Taiwán,1,5,,6,POINT (4697157 -74140516)
2015,Octubre,Taiwán,0,2,,2,POINT (6170465 -7542726)
2015,Octubre,República de Tayikistán,1,0,,1,POINT (4697157 -74140516)
2015,Octubre,Tailandia,1,0,,1,POINT (3451668 -76532004)
2015,Octubre,Tailandia,2,3,,5,POINT (4697157 -74140516)
2015,Octubre,Tanzania,1,1,,2,POINT (4697157 -74140516)
2015,Octubre,Trinidad y Tobago,0,4,,4,POINT (10406342 -75527794)
2015,Octubre,Trinidad y Tobago,1,5,,6,POINT (10446304 -75516486)
2015,Octubre,Trinidad y Tobago,0,1,,1,POINT (10886686 -74776479)
2015,Octubre,Trinidad y Tobago,4,11,,15,POINT (3451668 -76532004)
2015,Octubre,Trinidad y Tobago,4,4,,8,POINT (4697157 -74140516)
2015,Octubre,Trinidad y Tobago,0,5,,5,POINT (6170465 -7542726)
2015,Octubre,Trinidad y Tobago,0,1,,1,POINT (7128047 -73181317)
2015,Octubre,Turquía,2,5,,7,POINT (3451668 -76532004)
2015,Octubre,Turquía,3,12,,15,POINT (4697157 -74140516)
2015,Octubre,Ucrania,4,5,,9,POINT (3451668 -76532004)
2015,Octubre,Ucrania,4,2,,6,POINT (4697157 -74140516)
2015,Octubre,Ucrania,1,0,,1,POINT (6170465 -7542726)
2015,Octubre,Uruguay,6,4,,10,POINT (10446304 -75516486)
2015,Octubre,Uruguay,0,1,,1,POINT (10886686 -74776479)
2015,Octubre,Uruguay,14,9,,23,POINT (125862 -81702165)
2015,Octubre,Uruguay,14,16,,30,POINT (3451668 -76532004)
2015,Octubre,Uruguay,57,87,,144,POINT (4697157 -74140516)
2015,Octubre,Uruguay,0,1,,1,POINT (4815189 -75736374)
2015,Octubre,Uruguay,40,33,,73,POINT (6170465 -7542726)
2015,Octubre,Venezuela,0,21,,21,POINT (10406342 -75527794)
2015,Octubre,Venezuela,443,376,,819,POINT (10446304 -75516486)
2015,Octubre,Venezuela,20,63,,83,POINT (10886686 -74776479)
2015,Octubre,Venezuela,2,20,,22,POINT (11117206 -74232675)
2015,Octubre,Venezuela,206,288,,494,POINT (11360029 -72129595)
2015,Octubre,Venezuela,18,33,,51,POINT (3451668 -76532004)
2015,Octubre,Venezuela,34,55,,89,POINT (3866713 -67927521)
2015,Octubre,Venezuela,4433,4837,,9270,POINT (4697157 -74140516)
2015,Octubre,Venezuela,0,2,,2,POINT (4815189 -75736374)
2015,Octubre,Venezuela,2400,2107,,4507,POINT (6170465 -7542726)
2015,Octubre,Venezuela,27,50,,77,POINT (6185536 -67484028)
2015,Octubre,Venezuela,46,96,,142,POINT (7088729 -70740253)
2015,Octubre,Venezuela,6,10,,16,POINT (7128047 -73181317)
2015,Octubre,Venezuela,1793,2282,,4075,POINT (7819 -72453013)
2015,Octubre,Venezuela,78,95,,173,POINT (7927233 -72508188)
2015,Octubre,Islas Vírgenes Británicas/Territorio Británico de Ultramar,0,1,,1,POINT (10406342 -75527794)
2015,Octubre,Islas Vírgenes Estadounidenses/Territorio de Estados Unidos,0,1,,1,POINT (10406342 -75527794)
2015,Octubre,Desconocido,0,10,,10,POINT (3884426 -77061029)
2015,Octubre,Desconocido,0,8,,8,POINT (9402597 -75681642)
2015,Noviembre,Afganistán,0,2,,2,POINT (4697157 -74140516)
2015,Noviembre,Alemania,5,3,,8,POINT (10446304 -75516486)
2015,Noviembre,Alemania,1,1,,2,POINT (10886686 -74776479)
2015,Noviembre,Alemania,1,0,,1,POINT (125862 -81702165)
2015,Noviembre,Alemania,22,38,,60,POINT (3451668 -76532004)
2015,Noviembre,Alemania,1157,2187,,3344,POINT (4697157 -74140516)
2015,Noviembre,Alemania,0,1,,1,POINT (4815189 -75736374)
2015,Noviembre,Alemania,12,36,,48,POINT (6170465 -7542726)
2015,Noviembre,Alemania,1,0,,1,POINT (7128047 -73181317)
2015,Noviembre,Andorra,0,1,,1,POINT (6170465 -7542726)
2015,Noviembre,Angola,1,0,,1,POINT (3451668 -76532004)
2015,Noviembre,Antigua y Barbuda,0,1,,1,POINT (10406342 -75527794)
2015,Noviembre,Antigua y Barbuda,1,3,,4,POINT (4697157 -74140516)
2015,Noviembre,Países Bajos,21,32,,53,POINT (10406342 -75527794)
2015,Noviembre,Países Bajos,0,3,,3,POINT (10446304 -75516486)
2015,Noviembre,Países Bajos,57,80,,137,POINT (10886686 -74776479)
2015,Noviembre,Países Bajos,4,6,,10,POINT (11247723 -74213989)
2015,Noviembre,Países Bajos,70,162,,232,POINT (3451668 -76532004)
2015,Noviembre,Países Bajos,771,1215,,1986,POINT (4697157 -74140516)
2015,Noviembre,Países Bajos,1,2,,3,POINT (4815189 -75736374)
2015,Noviembre,Países Bajos,200,288,,488,POINT (6170465 -7542726)
2015,Noviembre,Países Bajos,1,1,,2,POINT (7128047 -73181317)
2015,Noviembre,Arabia Saudita,1,0,,1,POINT (4697157 -74140516)
2015,Noviembre,Argelia,3,5,,8,POINT (4697157 -74140516)
2015,Noviembre,Argelia,1,2,,3,POINT (6170465 -7542726)
2015,Noviembre,Argentina,2,4,,6,POINT (0.81488 -77356)
2015,Noviembre,Argentina,0,1,,1,POINT (1800143 -78802679)
2015,Noviembre,Argentina,0,2,,2,POINT (10406342 -75527794)
2015,Noviembre,Argentina,69,37,,106,POINT (10446304 -75516486)
2015,Noviembre,Argentina,6,78,,84,POINT (10886686 -74776479)
2015,Noviembre,Argentina,330,213,,543,POINT (125862 -81702165)
2015,Noviembre,Argentina,48,70,,118,POINT (3451668 -76532004)
2015,Noviembre,Argentina,0,1,,1,POINT (3884426 -77061029)
2015,Noviembre,Argentina,1745,2796,,4541,POINT (4697157 -74140516)
2015,Noviembre,Argentina,0,2,,2,POINT (4815189 -75736374)
2015,Noviembre,Argentina,139,208,,347,POINT (6170465 -7542726)
2015,Noviembre,Argentina,1,3,,4,POINT (7128047 -73181317)
2015,Noviembre,Argentina,0,2,,2,POINT (7927233 -72508188)
2015,Noviembre,Aruba,11,24,,35,POINT (10406342 -75527794)
2015,Noviembre,Aruba,0,3,,3,POINT (10446304 -75516486)
2015,Noviembre,Aruba,2,4,,6,POINT (10886686 -74776479)
2015,Noviembre,Aruba,13,22,,35,POINT (11247723 -74213989)
2015,Noviembre,Aruba,9,8,,17,POINT (3451668 -76532004)
2015,Noviembre,Aruba,541,644,,1185,POINT (4697157 -74140516)
2015,Noviembre,Aruba,63,93,,156,POINT (6170465 -7542726)
2015,Noviembre,Aruba,11,14,,25,POINT (7128047 -73181317)
2015,Noviembre,Aruba,1,3,,4,POINT (7927233 -72508188)
2015,Noviembre,Australia,2,3,,5,POINT (10446304 -75516486)
2015,Noviembre,Australia,2,0,,2,POINT (10886686 -74776479)
2015,Noviembre,Australia,7,10,,17,POINT (3451668 -76532004)
2015,Noviembre,Australia,43,62,,105,POINT (4697157 -74140516)
2015,Noviembre,Australia,2,5,,7,POINT (4815189 -75736374)
2015,Noviembre,Australia,7,22,,29,POINT (6170465 -7542726)
2015,Noviembre,Australia,0,1,,1,POINT (7128047 -73181317)
2015,Noviembre,Austria,1,3,,4,POINT (3451668 -76532004)
2015,Noviembre,Austria,19,41,,60,POINT (4697157 -74140516)
2015,Noviembre,Austria,0,2,,2,POINT (6170465 -7542726)
2015,Noviembre,Bahamas,2,3,,5,POINT (10446304 -75516486)
2015,Noviembre,Bahamas,1,0,,1,POINT (125862 -81702165)
2015,Noviembre,Bahamas,1,0,,1,POINT (3451668 -76532004)
2015,Noviembre,Bahamas,1,3,,4,POINT (4697157 -74140516)
2015,Noviembre,Bahamas,0,1,,1,POINT (6170465 -7542726)
2015,Noviembre,Bahréin,0,1,,1,POINT (10446304 -75516486)
2015,Noviembre,Bahréin,0,1,,1,POINT (3451668 -76532004)
2015,Noviembre,Bahréin,0,2,,2,POINT (6170465 -7542726)
2015,Noviembre,Barbados,4,4,,8,POINT (4697157 -74140516)
2015,Noviembre,Barbados,0,1,,1,POINT (6170465 -7542726)
2015,Noviembre,República de Belarús,1,0,,1,POINT (4697157 -74140516)
2015,Noviembre,Bélgica,1,0,,1,POINT (10446304 -75516486)
2015,Noviembre,Bélgica,0,2,,2,POINT (10886686 -74776479)
2015,Noviembre,Bélgica,3,8,,11,POINT (3451668 -76532004)
2015,Noviembre,Bélgica,35,60,,95,POINT (4697157 -74140516)
2015,Noviembre,Bélgica,1,7,,8,POINT (6170465 -7542726)
2015,Noviembre,Belice,0,1,,1,POINT (3451668 -76532004)
2015,Noviembre,Belice,7,4,,11,POINT (4697157 -74140516)
2015,Noviembre,Belice,0,1,,1,POINT (6170465 -7542726)
2015,Noviembre,Benín,0,1,,1,POINT (3451668 -76532004)
2015,Noviembre,Benín,2,2,,4,POINT (4697157 -74140516)
2015,Noviembre,Bermudas/Territorio Británico de Ultramar,0,1,,1,POINT (4697157 -74140516)
2015,Noviembre,Bolivia,2,1,,3,POINT (0.81488 -77356)
2015,Noviembre,Bolivia,6,2,,8,POINT (10446304 -75516486)
2015,Noviembre,Bolivia,0,2,,2,POINT (10886686 -74776479)
2015,Noviembre,Bolivia,29,12,,41,POINT (125862 -81702165)
2015,Noviembre,Bolivia,34,41,,75,POINT (3451668 -76532004)
2015,Noviembre,Bolivia,378,557,,935,POINT (4697157 -74140516)
2015,Noviembre,Bolivia,1,1,,2,POINT (4815189 -75736374)
2015,Noviembre,Bolivia,37,30,,67,POINT (6170465 -7542726)
2015,Noviembre,Bolivia,1,0,,1,POINT (7128047 -73181317)
2015,Noviembre,Brasil,122,137,,259,POINT (-4191162 -69941498)
2015,Noviembre,Brasil,8,17,,25,POINT (-4214082 -69941431)
2015,Noviembre,Brasil,1,1,,2,POINT (0.81488 -77356)
2015,Noviembre,Brasil,24,27,,51,POINT (10446304 -75516486)
2015,Noviembre,Brasil,1,4,,5,POINT (10886686 -74776479)
2015,Noviembre,Brasil,254,207,,461,POINT (125862 -81702165)
2015,Noviembre,Brasil,41,95,,136,POINT (3451668 -76532004)
2015,Noviembre,Brasil,0,4,,4,POINT (3866713 -67927521)
2015,Noviembre,Brasil,3378,5521,,8899,POINT (4697157 -74140516)
2015,Noviembre,Brasil,2,27,,29,POINT (4815189 -75736374)
2015,Noviembre,Brasil,106,239,,345,POINT (6170465 -7542726)
2015,Noviembre,Brasil,3,4,,7,POINT (7128047 -73181317)
2015,Noviembre,Brunei Darussalam,0,1,,1,POINT (4697157 -74140516)
2015,Noviembre,Bulgaria,2,0,,2,POINT (4697157 -74140516)
2015,Noviembre,Cabo Verde,0,3,,3,POINT (10970933 -74765343)
2015,Noviembre,Islas Caimán/Territorio Británico de Ultramar,4,5,,9,POINT (10406342 -75527794)
2015,Noviembre,Islas Caimán/Territorio Británico de Ultramar,1,5,,6,POINT (125862 -81702165)
2015,Noviembre,Islas Caimán/Territorio Británico de Ultramar,0,3,,3,POINT (4697157 -74140516)
2015,Noviembre,Camboya,0,1,,1,POINT (4697157 -74140516)
2015,Noviembre,Camerún,0,1,,1,POINT (3451668 -76532004)
2015,Noviembre,Canadá,0,1,,1,POINT (10406342 -75527794)
2015,Noviembre,Canadá,10,19,,29,POINT (10446304 -75516486)
2015,Noviembre,Canadá,5,6,,11,POINT (10886686 -74776479)
2015,Noviembre,Canadá,1,1,,2,POINT (125862 -81702165)
2015,Noviembre,Canadá,24,55,,79,POINT (3451668 -76532004)
2015,Noviembre,Canadá,602,986,,1588,POINT (4697157 -74140516)
2015,Noviembre,Canadá,4,7,,11,POINT (4815189 -75736374)
2015,Noviembre,Canadá,68,146,,214,POINT (6170465 -7542726)
2015,Noviembre,Canadá,4,6,,10,POINT (7128047 -73181317)
2015,Noviembre,Canadá,0,4,,4,POINT (7927233 -72508188)
2015,Noviembre,España,2,27,,29,POINT (10406342 -75527794)
2015,Noviembre,España,1,1,,2,POINT (10446304 -75516486)
2015,Noviembre,España,3,7,,10,POINT (10886686 -74776479)
2015,Noviembre,España,0,2,,2,POINT (10970933 -74765343)
2015,Noviembre,España,0,1,,1,POINT (11247723 -74213989)
2015,Noviembre,España,0,1,,1,POINT (125862 -81702165)
2015,Noviembre,España,503,706,,1209,POINT (3451668 -76532004)
2015,Noviembre,España,2879,5980,,8859,POINT (4697157 -74140516)
2015,Noviembre,España,10,28,,38,POINT (4815189 -75736374)
2015,Noviembre,España,256,509,,765,POINT (6170465 -7542726)
2015,Noviembre,España,3,7,,10,POINT (7128047 -73181317)
2015,Noviembre,España,1,2,,3,POINT (7927233 -72508188)
2015,Noviembre,República Del Congo,0,1,,1,POINT (4697157 -74140516)
2015,Noviembre,República Democrática del Congo,0,1,,1,POINT (4697157 -74140516)
2015,Noviembre,República de Corea,0,2,,2,POINT (10406342 -75527794)
2015,Noviembre,República de Corea,16,31,,47,POINT (4697157 -74140516)
2015,Noviembre,República de Corea,0,4,,4,POINT (6170465 -7542726)
2015,Noviembre,Costa de Marfil,5,6,,11,POINT (4697157 -74140516)
2015,Noviembre,Costa de Marfil,0,1,,1,POINT (6170465 -7542726)
2015,Noviembre,Costa Rica,0,4,,4,POINT (10406342 -75527794)
2015,Noviembre,Costa Rica,3,2,,5,POINT (10446304 -75516486)
2015,Noviembre,Costa Rica,9,8,,17,POINT (10886686 -74776479)
2015,Noviembre,Costa Rica,69,67,,136,POINT (125862 -81702165)
2015,Noviembre,Costa Rica,24,56,,80,POINT (3451668 -76532004)
2015,Noviembre,Costa Rica,970,1624,,2594,POINT (4697157 -74140516)
2015,Noviembre,Costa Rica,2,2,,4,POINT (4815189 -75736374)
2015,Noviembre,Costa Rica,91,126,,217,POINT (6170465 -7542726)
2015,Noviembre,Costa Rica,3,0,,3,POINT (7128047 -73181317)
2015,Noviembre,Costa Rica,1,1,,2,POINT (7927233 -72508188)
2015,Noviembre,Croacia,0,4,,4,POINT (3451668 -76532004)
2015,Noviembre,Croacia,0,7,,7,POINT (4697157 -74140516)
2015,Noviembre,Cuba,131,130,,261,POINT (10446304 -75516486)
2015,Noviembre,Cuba,5,9,,14,POINT (10886686 -74776479)
2015,Noviembre,Cuba,2,1,,3,POINT (125862 -81702165)
2015,Noviembre,Cuba,15,12,,27,POINT (3451668 -76532004)
2015,Noviembre,Cuba,378,668,,1046,POINT (4697157 -74140516)
2015,Noviembre,Cuba,2,2,,4,POINT (4815189 -75736374)
2015,Noviembre,Cuba,39,41,,80,POINT (6170465 -7542726)
2015,Noviembre,Cuba,4,2,,6,POINT (7128047 -73181317)
2015,Noviembre,Cuba,0,1,,1,POINT (7927233 -72508188)
2015,Noviembre,Curazao,0,1,,1,POINT (6170465 -7542726)
2015,Noviembre,República Checa,0,1,,1,POINT (125862 -81702165)
2015,Noviembre,República Checa,2,4,,6,POINT (3451668 -76532004)
2015,Noviembre,República Checa,14,23,,37,POINT (4697157 -74140516)
2015,Noviembre,República Checa,0,2,,2,POINT (7927233 -72508188)
2015,Noviembre,Chile,2,5,,7,POINT (0.81488 -77356)
2015,Noviembre,Chile,6,9,,15,POINT (10446304 -75516486)
2015,Noviembre,Chile,6,13,,19,POINT (10886686 -74776479)
2015,Noviembre,Chile,11,10,,21,POINT (125862 -81702165)
2015,Noviembre,Chile,17,45,,62,POINT (3451668 -76532004)
2015,Noviembre,Chile,3789,5641,,9430,POINT (4697157 -74140516)
2015,Noviembre,Chile,1,1,,2,POINT (4815189 -75736374)
2015,Noviembre,Chile,25,80,,105,POINT (6170465 -7542726)
2015,Noviembre,Chile,0,1,,1,POINT (7927233 -72508188)
2015,Noviembre,China,0,3,,3,POINT (3451668 -76532004)
2015,Noviembre,China,17,52,,69,POINT (4697157 -74140516)
2015,Noviembre,China,3,6,,9,POINT (6170465 -7542726)
2015,Noviembre,Chipre,0,2,,2,POINT (4697157 -74140516)
2015,Noviembre,Dinamarca,1,0,,1,POINT (10886686 -74776479)
2015,Noviembre,Dinamarca,4,5,,9,POINT (3451668 -76532004)
2015,Noviembre,Dinamarca,14,25,,39,POINT (4697157 -74140516)
2015,Noviembre,Dinamarca,1,3,,4,POINT (6170465 -7542726)
2015,Noviembre,Dominica,2,0,,2,POINT (4697157 -74140516)
2015,Noviembre,Dominica,0,1,,1,POINT (6170465 -7542726)
2015,Noviembre,Ecuador,85,203,,288,POINT (0.33002 -76876446)
2015,Noviembre,Ecuador,0,3,,3,POINT (0.812436 -77847006)
2015,Noviembre,Ecuador,2480,3984,,6464,POINT (0.81488 -77356)
2015,Noviembre,Ecuador,24,106,,130,POINT (1800143 -78802679)
2015,Noviembre,Ecuador,1,1,,2,POINT (10446304 -75516486)
2015,Noviembre,Ecuador,5,12,,17,POINT (10886686 -74776479)
2015,Noviembre,Ecuador,13,8,,21,POINT (125862 -81702165)
2015,Noviembre,Ecuador,455,476,,931,POINT (3451668 -76532004)
2015,Noviembre,Ecuador,3245,5082,,8327,POINT (4697157 -74140516)
2015,Noviembre,Ecuador,0,2,,2,POINT (4815189 -75736374)
2015,Noviembre,Ecuador,14,31,,45,POINT (6170465 -7542726)
2015,Noviembre,Ecuador,1,1,,2,POINT (7128047 -73181317)
2015,Noviembre,Ecuador,0,1,,1,POINT (7927233 -72508188)
2015,Noviembre,Egipto,0,3,,3,POINT (4697157 -74140516)
2015,Noviembre,Egipto,0,1,,1,POINT (6170465 -7542726)
2015,Noviembre,El Salvador,5,1,,6,POINT (10446304 -75516486)
2015,Noviembre,El Salvador,31,33,,64,POINT (125862 -81702165)
2015,Noviembre,El Salvador,121,196,,317,POINT (3451668 -76532004)
2015,Noviembre,El Salvador,1008,1585,,2593,POINT (4697157 -74140516)
2015,Noviembre,El Salvador,181,294,,475,POINT (6170465 -7542726)
2015,Noviembre,Emiratos Árabes,0,1,,1,POINT (3451668 -76532004)
2015,Noviembre,Emiratos Árabes,1,4,,5,POINT (4697157 -74140516)
2015,Noviembre,Emiratos Árabes,1,2,,3,POINT (6170465 -7542726)
2015,Noviembre,Eritrea,0,1,,1,POINT (4697157 -74140516)
2015,Noviembre,Eslovaquia,4,3,,7,POINT (4697157 -74140516)
2015,Noviembre,Eslovenia,1,1,,2,POINT (4697157 -74140516)
2015,Noviembre,Eslovenia,0,1,,1,POINT (4815189 -75736374)
2015,Noviembre,Eslovenia,3,0,,3,POINT (6170465 -7542726)
2015,Noviembre,Estados Unidos de América,3,51,,54,POINT (10406342 -75527794)
2015,Noviembre,Estados Unidos de América,2305,3641,,5946,POINT (10446304 -75516486)
2015,Noviembre,Estados Unidos de América,572,1004,,1576,POINT (10886686 -74776479)
2015,Noviembre,Estados Unidos de América,0,2,,2,POINT (10970933 -74765343)
2015,Noviembre,Estados Unidos de América,0,1,,1,POINT (11117206 -74232675)
2015,Noviembre,Estados Unidos de América,0,28,,28,POINT (11247723 -74213989)
2015,Noviembre,Estados Unidos de América,19,41,,60,POINT (125862 -81702165)
2015,Noviembre,Estados Unidos de América,848,1355,,2203,POINT (3451668 -76532004)
2015,Noviembre,Estados Unidos de América,80,129,,209,POINT (445285 -75766353)
2015,Noviembre,Estados Unidos de América,8180,16037,,24217,POINT (4697157 -74140516)
2015,Noviembre,Estados Unidos de América,89,124,,213,POINT (4815189 -75736374)
2015,Noviembre,Estados Unidos de América,1956,4866,,6822,POINT (6170465 -7542726)
2015,Noviembre,Estados Unidos de América,19,42,,61,POINT (7128047 -73181317)
2015,Noviembre,Estados Unidos de América,32,30,,62,POINT (7927233 -72508188)
2015,Noviembre,Estonia,0,14,,14,POINT (10406342 -75527794)
2015,Noviembre,Estonia,1,4,,5,POINT (4697157 -74140516)
2015,Noviembre,Etiopia,0,2,,2,POINT (4697157 -74140516)
2015,Noviembre,Filipinas,0,2,,2,POINT (10446304 -75516486)
2015,Noviembre,Filipinas,0,2,,2,POINT (10886686 -74776479)
2015,Noviembre,Filipinas,1,8,,9,POINT (3451668 -76532004)
2015,Noviembre,Filipinas,4,20,,24,POINT (4697157 -74140516)
2015,Noviembre,Filipinas,0,1,,1,POINT (6170465 -7542726)
2015,Noviembre,Finlandia,1,1,,2,POINT (3451668 -76532004)
2015,Noviembre,Finlandia,7,10,,17,POINT (4697157 -74140516)
2015,Noviembre,Finlandia,0,1,,1,POINT (4815189 -75736374)
2015,Noviembre,Francia,1,0,,1,POINT (10446304 -75516486)
2015,Noviembre,Francia,0,3,,3,POINT (10886686 -74776479)
2015,Noviembre,Francia,0,3,,3,POINT (11247723 -74213989)
2015,Noviembre,Francia,20,36,,56,POINT (3451668 -76532004)
2015,Noviembre,Francia,1232,2508,,3740,POINT (4697157 -74140516)
2015,Noviembre,Francia,10,17,,27,POINT (6170465 -7542726)
2015,Noviembre,Georgia,0,1,,1,POINT (4697157 -74140516)
2015,Noviembre,Granada,0,1,,1,POINT (4697157 -74140516)
2015,Noviembre,Grecia,0,1,,1,POINT (3451668 -76532004)
2015,Noviembre,Grecia,0,8,,8,POINT (4697157 -74140516)
2015,Noviembre,Grecia,0,1,,1,POINT (6170465 -7542726)
2015,Noviembre,Guatemala,4,6,,10,POINT (10446304 -75516486)
2015,Noviembre,Guatemala,4,11,,15,POINT (10886686 -74776479)
2015,Noviembre,Guatemala,31,36,,67,POINT (125862 -81702165)
2015,Noviembre,Guatemala,2,2,,4,POINT (133387613 -81372937)
2015,Noviembre,Guatemala,16,53,,69,POINT (3451668 -76532004)
2015,Noviembre,Guatemala,428,771,,1199,POINT (4697157 -74140516)
2015,Noviembre,Guatemala,2,13,,15,POINT (4815189 -75736374)
2015,Noviembre,Guatemala,60,100,,160,POINT (6170465 -7542726)
2015,Noviembre,Guatemala,1,2,,3,POINT (7128047 -73181317)
2015,Noviembre,Guatemala,3,1,,4,POINT (7927233 -72508188)
2015,Noviembre,Guyana,0,1,,1,POINT (10406342 -75527794)
2015,Noviembre,Guyana,0,3,,3,POINT (10886686 -74776479)
2015,Noviembre,Guyana,0,2,,2,POINT (4697157 -74140516)
2015,Noviembre,Guadalupe/Territorio Francés,0,5,,5,POINT (10406342 -75527794)
2015,Noviembre,Guadalupe/Territorio Francés,1,1,,2,POINT (3451668 -76532004)
2015,Noviembre,Guadalupe/Territorio Francés,1,6,,7,POINT (4697157 -74140516)
2015,Noviembre,Guadalupe/Territorio Francés,0,2,,2,POINT (6170465 -7542726)
2015,Noviembre,Haití,0,4,,4,POINT (10406342 -75527794)
2015,Noviembre,Haití,0,1,,1,POINT (10970933 -74765343)
2015,Noviembre,Haití,2,2,,4,POINT (4697157 -74140516)
2015,Noviembre,Haití,0,1,,1,POINT (4815189 -75736374)
2015,Noviembre,Haití,1,3,,4,POINT (6170465 -7542726)
2015,Noviembre,Haití,0,1,,1,POINT (7927233 -72508188)
2015,Noviembre,Honduras,1,1,,2,POINT (10446304 -75516486)
2015,Noviembre,Honduras,0,6,,6,POINT (10886686 -74776479)
2015,Noviembre,Honduras,0,9,,9,POINT (125744111 -81703935)
2015,Noviembre,Honduras,3,2,,5,POINT (125862 -81702165)
2015,Noviembre,Honduras,2,2,,4,POINT (133387613 -81372937)
2015,Noviembre,Honduras,12,22,,34,POINT (3451668 -76532004)
2015,Noviembre,Honduras,76,102,,178,POINT (4697157 -74140516)
2015,Noviembre,Honduras,1,2,,3,POINT (4815189 -75736374)
2015,Noviembre,Honduras,30,33,,63,POINT (6170465 -7542726)
2015,Noviembre,Honduras,0,5,,5,POINT (7128047 -73181317)
2015,Noviembre,Hong Kong,1,2,,3,POINT (4697157 -74140516)
2015,Noviembre,Hong Kong,0,1,,1,POINT (6170465 -7542726)
2015,Noviembre,Hungría,5,6,,11,POINT (4697157 -74140516)
2015,Noviembre,India,0,1,,1,POINT (11247723 -74213989)
2015,Noviembre,India,0,1,,1,POINT (3451668 -76532004)
2015,Noviembre,India,4,34,,38,POINT (4697157 -74140516)
2015,Noviembre,India,0,1,,1,POINT (4815189 -75736374)
2015,Noviembre,India,1,6,,7,POINT (6170465 -7542726)
2015,Noviembre,India,0,2,,2,POINT (7927233 -72508188)
2015,Noviembre,Indonesia,1,3,,4,POINT (4697157 -74140516)
2015,Noviembre,Iraq,0,1,,1,POINT (4697157 -74140516)
2015,Noviembre,Irán,0,3,,3,POINT (4697157 -74140516)
2015,Noviembre,Irán,1,0,,1,POINT (6170465 -7542726)
2015,Noviembre,República de Irlanda,0,1,,1,POINT (10886686 -74776479)
2015,Noviembre,República de Irlanda,6,16,,22,POINT (4697157 -74140516)
2015,Noviembre,República de Irlanda,1,4,,5,POINT (6170465 -7542726)
2015,Noviembre,Islandia,1,0,,1,POINT (3451668 -76532004)
2015,Noviembre,Israel,0,2,,2,POINT (10446304 -75516486)
2015,Noviembre,Israel,1,1,,2,POINT (10886686 -74776479)
2015,Noviembre,Israel,0,1,,1,POINT (125862 -81702165)
2015,Noviembre,Israel,6,5,,11,POINT (3451668 -76532004)
2015,Noviembre,Israel,7,67,,74,POINT (4697157 -74140516)
2015,Noviembre,Israel,0,1,,1,POINT (6170465 -7542726)
2015,Noviembre,Italia,0,3,,3,POINT (10446304 -75516486)
2015,Noviembre,Italia,0,2,,2,POINT (10886686 -74776479)
2015,Noviembre,Italia,0,1,,1,POINT (125862 -81702165)
2015,Noviembre,Italia,19,59,,78,POINT (3451668 -76532004)
2015,Noviembre,Italia,97,345,,442,POINT (4697157 -74140516)
2015,Noviembre,Italia,1,2,,3,POINT (4815189 -75736374)
2015,Noviembre,Italia,17,42,,59,POINT (6170465 -7542726)
2015,Noviembre,Italia,1,0,,1,POINT (7128047 -73181317)
2015,Noviembre,Jamaica,0,11,,11,POINT (10406342 -75527794)
2015,Noviembre,Jamaica,0,1,,1,POINT (10886686 -74776479)
2015,Noviembre,Jamaica,1,7,,8,POINT (125862 -81702165)
2015,Noviembre,Jamaica,0,4,,4,POINT (133387613 -81372937)
2015,Noviembre,Jamaica,2,2,,4,POINT (3451668 -76532004)
2015,Noviembre,Jamaica,2,6,,8,POINT (4697157 -74140516)
2015,Noviembre,Jamaica,2,7,,9,POINT (6170465 -7542726)
2015,Noviembre,Jamaica,1,0,,1,POINT (7128047 -73181317)
2015,Noviembre,Japón,0,6,,6,POINT (3451668 -76532004)
2015,Noviembre,Japón,13,38,,51,POINT (4697157 -74140516)
2015,Noviembre,Japón,1,4,,5,POINT (6170465 -7542726)
2015,Noviembre,Japón,1,0,,1,POINT (7927233 -72508188)
2015,Noviembre,Kazajistán,0,1,,1,POINT (4697157 -74140516)
2015,Noviembre,Kenia,2,3,,5,POINT (4697157 -74140516)
2015,Noviembre,Kirguistán,0,1,,1,POINT (4697157 -74140516)
2015,Noviembre,República Democrática Popular  Lao,0,1,,1,POINT (3451668 -76532004)
2015,Noviembre,República Democrática Popular  Lao,0,1,,1,POINT (4697157 -74140516)
2015,Noviembre,Lituania,6,5,,11,POINT (4697157 -74140516)
2015,Noviembre,Líbano,2,2,,4,POINT (4697157 -74140516)
2015,Noviembre,Líbano,0,2,,2,POINT (4815189 -75736374)
2015,Noviembre,Luxemburgo,1,1,,2,POINT (4697157 -74140516)
2015,Noviembre,Luxemburgo,0,1,,1,POINT (6170465 -7542726)
2015,Noviembre,Madagascar,1,1,,2,POINT (4697157 -74140516)
2015,Noviembre,Malasia,0,2,,2,POINT (4697157 -74140516)
2015,Noviembre,Malasia,1,0,,1,POINT (6170465 -7542726)
2015,Noviembre,Malta,0,1,,1,POINT (6170465 -7542726)
2015,Noviembre,Marruecos,0,1,,1,POINT (10970933 -74765343)
2015,Noviembre,Marruecos,0,2,,2,POINT (4697157 -74140516)
2015,Noviembre,Marruecos,1,4,,5,POINT (6170465 -7542726)
2015,Noviembre,Martinica/Departamento de Ultramar Francés,1,1,,2,POINT (11247723 -74213989)
2015,Noviembre,México,7,21,,28,POINT (10406342 -75527794)
2015,Noviembre,México,8,27,,35,POINT (10446304 -75516486)
2015,Noviembre,México,11,26,,37,POINT (10886686 -74776479)
2015,Noviembre,México,7,9,,16,POINT (125862 -81702165)
2015,Noviembre,México,74,186,,260,POINT (3451668 -76532004)
2015,Noviembre,México,4204,8085,,12289,POINT (4697157 -74140516)
2015,Noviembre,México,5,15,,20,POINT (4815189 -75736374)
2015,Noviembre,México,547,1334,,1881,POINT (6170465 -7542726)
2015,Noviembre,México,7,5,,12,POINT (7128047 -73181317)
2015,Noviembre,México,2,4,,6,POINT (7927233 -72508188)
2015,Noviembre,Mónaco,0,1,,1,POINT (4697157 -74140516)
2015,Noviembre,Nicaragua,1,0,,1,POINT (10446304 -75516486)
2015,Noviembre,Nicaragua,0,2,,2,POINT (10886686 -74776479)
2015,Noviembre,Nicaragua,3,0,,3,POINT (125862 -81702165)
2015,Noviembre,Nicaragua,5,9,,14,POINT (3451668 -76532004)
2015,Noviembre,Nicaragua,29,32,,61,POINT (4697157 -74140516)
2015,Noviembre,Nicaragua,1,2,,3,POINT (4815189 -75736374)
2015,Noviembre,Nicaragua,12,29,,41,POINT (6170465 -7542726)
2015,Noviembre,Nicaragua,2,0,,2,POINT (7128047 -73181317)
2015,Noviembre,Nigeria,0,1,,1,POINT (4815189 -75736374)
2015,Noviembre,Noruega,0,1,,1,POINT (10446304 -75516486)
2015,Noviembre,Noruega,4,3,,7,POINT (10886686 -74776479)
2015,Noviembre,Noruega,0,1,,1,POINT (125862 -81702165)
2015,Noviembre,Noruega,3,3,,6,POINT (3451668 -76532004)
2015,Noviembre,Noruega,22,29,,51,POINT (4697157 -74140516)
2015,Noviembre,Nueva Zelanda,1,0,,1,POINT (3451668 -76532004)
2015,Noviembre,Nueva Zelanda,4,3,,7,POINT (4697157 -74140516)
2015,Noviembre,Nueva Zelanda,1,3,,4,POINT (6170465 -7542726)
2015,Noviembre,Omán,0,1,,1,POINT (6170465 -7542726)
2015,Noviembre,Pakistán,0,1,,1,POINT (4697157 -74140516)
2015,Noviembre,Panamá,0,1,,1,POINT (1800143 -78802679)
2015,Noviembre,Panamá,1037,862,,1899,POINT (10406342 -75527794)
2015,Noviembre,Panamá,2475,2632,,5107,POINT (10446304 -75516486)
2015,Noviembre,Panamá,239,542,,781,POINT (10886686 -74776479)
2015,Noviembre,Panamá,0,28,,28,POINT (10970933 -74765343)
2015,Noviembre,Panamá,1,3,,4,POINT (11247723 -74213989)
2015,Noviembre,Panamá,11,22,,33,POINT (125744111 -81703935)
2015,Noviembre,Panamá,281,243,,524,POINT (125862 -81702165)
2015,Noviembre,Panamá,10,8,,18,POINT (133387613 -81372937)
2015,Noviembre,Panamá,234,460,,694,POINT (3451668 -76532004)
2015,Noviembre,Panamá,0,102,,102,POINT (3884426 -77061029)
2015,Noviembre,Panamá,4291,6513,,10804,POINT (4697157 -74140516)
2015,Noviembre,Panamá,46,98,,144,POINT (4815189 -75736374)
2015,Noviembre,Panamá,1867,2628,,4495,POINT (6170465 -7542726)
2015,Noviembre,Panamá,1,0,,1,POINT (6222552 -77401154)
2015,Noviembre,Panamá,0,1,,1,POINT (7102626 -77762647)
2015,Noviembre,Panamá,23,48,,71,POINT (7128047 -73181317)
2015,Noviembre,Panamá,44,71,,115,POINT (7927233 -72508188)
2015,Noviembre,Panamá,92,115,,207,POINT (863337 -7735002)
2015,Noviembre,Paraguay,3,1,,4,POINT (10446304 -75516486)
2015,Noviembre,Paraguay,2,2,,4,POINT (10886686 -74776479)
2015,Noviembre,Paraguay,60,37,,97,POINT (125862 -81702165)
2015,Noviembre,Paraguay,15,45,,60,POINT (3451668 -76532004)
2015,Noviembre,Paraguay,71,95,,166,POINT (4697157 -74140516)
2015,Noviembre,Paraguay,21,39,,60,POINT (6170465 -7542726)
2015,Noviembre,Paraguay,0,1,,1,POINT (7128047 -73181317)
2015,Noviembre,Perú,67,114,,181,POINT (-4191162 -69941498)
2015,Noviembre,Perú,4,10,,14,POINT (-4214082 -69941431)
2015,Noviembre,Perú,7,14,,21,POINT (0.81488 -77356)
2015,Noviembre,Perú,0,1,,1,POINT (1800143 -78802679)
2015,Noviembre,Perú,0,3,,3,POINT (10406342 -75527794)
2015,Noviembre,Perú,8,9,,17,POINT (10446304 -75516486)
2015,Noviembre,Perú,1,5,,6,POINT (10886686 -74776479)
2015,Noviembre,Perú,0,1,,1,POINT (11247723 -74213989)
2015,Noviembre,Perú,99,68,,167,POINT (125862 -81702165)
2015,Noviembre,Perú,221,414,,635,POINT (3451668 -76532004)
2015,Noviembre,Perú,5467,8512,,13979,POINT (4697157 -74140516)
2015,Noviembre,Perú,6,6,,12,POINT (4815189 -75736374)
2015,Noviembre,Perú,329,594,,923,POINT (6170465 -7542726)
2015,Noviembre,Perú,0,1,,1,POINT (7128047 -73181317)
2015,Noviembre,Perú,0,2,,2,POINT (7927233 -72508188)
2015,Noviembre,Polonia,0,4,,4,POINT (3451668 -76532004)
2015,Noviembre,Polonia,27,30,,57,POINT (4697157 -74140516)
2015,Noviembre,Portugal,20,27,,47,POINT (10446304 -75516486)
2015,Noviembre,Portugal,0,1,,1,POINT (10886686 -74776479)
2015,Noviembre,Portugal,0,6,,6,POINT (3451668 -76532004)
2015,Noviembre,Portugal,422,648,,1070,POINT (4697157 -74140516)
2015,Noviembre,Portugal,1,5,,6,POINT (6170465 -7542726)
2015,Noviembre,Portugal,1,0,,1,POINT (7927233 -72508188)
2015,Noviembre,Puerto Rico/Territorio de Estados Unidos,3,1,,4,POINT (10446304 -75516486)
2015,Noviembre,Puerto Rico/Territorio de Estados Unidos,6,50,,56,POINT (10886686 -74776479)
2015,Noviembre,Puerto Rico/Territorio de Estados Unidos,20,33,,53,POINT (3451668 -76532004)
2015,Noviembre,Puerto Rico/Territorio de Estados Unidos,308,405,,713,POINT (4697157 -74140516)
2015,Noviembre,Puerto Rico/Territorio de Estados Unidos,35,90,,125,POINT (6170465 -7542726)
2015,Noviembre,Puerto Rico/Territorio de Estados Unidos,2,4,,6,POINT (7128047 -73181317)
2015,Noviembre,Puerto Rico/Territorio de Estados Unidos,1,2,,3,POINT (7927233 -72508188)
2015,Noviembre,Qatar,1,0,,1,POINT (4697157 -74140516)
2015,Noviembre,Reino Unido de Gran Bretaña e Irlanda del Norte,0,8,,8,POINT (10406342 -75527794)
2015,Noviembre,Reino Unido de Gran Bretaña e Irlanda del Norte,7,20,,27,POINT (3451668 -76532004)
2015,Noviembre,Reino Unido de Gran Bretaña e Irlanda del Norte,572,1115,,1687,POINT (4697157 -74140516)
2015,Noviembre,Reino Unido de Gran Bretaña e Irlanda del Norte,8,27,,35,POINT (6170465 -7542726)
2015,Noviembre,Federación de Rusia,1,2,,3,POINT (10446304 -75516486)
2015,Noviembre,Federación de Rusia,0,1,,1,POINT (10886686 -74776479)
2015,Noviembre,Federación de Rusia,2,1,,3,POINT (125862 -81702165)
2015,Noviembre,Federación de Rusia,0,1,,1,POINT (3451668 -76532004)
2015,Noviembre,Federación de Rusia,24,49,,73,POINT (4697157 -74140516)
2015,Noviembre,Federación de Rusia,0,2,,2,POINT (6170465 -7542726)
2015,Noviembre,República Dominicana,3,9,,12,POINT (10406342 -75527794)
2015,Noviembre,República Dominicana,3,2,,5,POINT (10446304 -75516486)
2015,Noviembre,República Dominicana,2,14,,16,POINT (10886686 -74776479)
2015,Noviembre,República Dominicana,1,3,,4,POINT (125862 -81702165)
2015,Noviembre,República Dominicana,22,33,,55,POINT (3451668 -76532004)
2015,Noviembre,República Dominicana,745,1169,,1914,POINT (4697157 -74140516)
2015,Noviembre,República Dominicana,1,0,,1,POINT (4815189 -75736374)
2015,Noviembre,República Dominicana,38,59,,97,POINT (6170465 -7542726)
2015,Noviembre,República Dominicana,2,3,,5,POINT (7128047 -73181317)
2015,Noviembre,República Dominicana,0,1,,1,POINT (7927233 -72508188)
2015,Noviembre,Reunión,0,1,,1,POINT (4697157 -74140516)
2015,Noviembre,Rumania,0,1,,1,POINT (3451668 -76532004)
2015,Noviembre,Rumania,3,8,,11,POINT (4697157 -74140516)
2015,Noviembre,San  Vicente y las Granadinas,1,0,,1,POINT (3451668 -76532004)
2015,Noviembre,Santa Lucia,1,0,,1,POINT (3451668 -76532004)
2015,Noviembre,Santo Tomé y Príncipe,0,1,,1,POINT (10406342 -75527794)
2015,Noviembre,Senegal,0,2,,2,POINT (4697157 -74140516)
2015,Noviembre,Serbia,0,1,,1,POINT (10446304 -75516486)
2015,Noviembre,Serbia,1,0,,1,POINT (4697157 -74140516)
2015,Noviembre,Singapur,1,3,,4,POINT (4697157 -74140516)
2015,Noviembre,Singapur,1,1,,2,POINT (6170465 -7542726)
2015,Noviembre,Sri Lanka,1,0,,1,POINT (3451668 -76532004)
2015,Noviembre,Sri Lanka,0,1,,1,POINT (4697157 -74140516)
2015,Noviembre,Sudáfrica,4,11,,15,POINT (4697157 -74140516)
2015,Noviembre,Sudáfrica,0,1,,1,POINT (6170465 -7542726)
2015,Noviembre,Suecia,0,1,,1,POINT (10886686 -74776479)
2015,Noviembre,Suecia,8,13,,21,POINT (3451668 -76532004)
2015,Noviembre,Suecia,26,50,,76,POINT (4697157 -74140516)
2015,Noviembre,Suecia,1,1,,2,POINT (4815189 -75736374)
2015,Noviembre,Suecia,3,6,,9,POINT (6170465 -7542726)
2015,Noviembre,Suiza,0,1,,1,POINT (10446304 -75516486)
2015,Noviembre,Suiza,2,1,,3,POINT (10886686 -74776479)
2015,Noviembre,Suiza,9,21,,30,POINT (3451668 -76532004)
2015,Noviembre,Suiza,77,110,,187,POINT (4697157 -74140516)
2015,Noviembre,Suiza,10,19,,29,POINT (6170465 -7542726)
2015,Noviembre,Surinam,0,2,,2,POINT (4697157 -74140516)
2015,Noviembre,Surinam,8,5,,13,POINT (6170465 -7542726)
2015,Noviembre,Taiwán,0,1,,1,POINT (3451668 -76532004)
2015,Noviembre,Taiwán,1,6,,7,POINT (4697157 -74140516)
2015,Noviembre,Tailandia,3,1,,4,POINT (4697157 -74140516)
2015,Noviembre,Trinidad y Tobago,1,5,,6,POINT (10406342 -75527794)
2015,Noviembre,Trinidad y Tobago,1,0,,1,POINT (10886686 -74776479)
2015,Noviembre,Trinidad y Tobago,1,1,,2,POINT (125862 -81702165)
2015,Noviembre,Trinidad y Tobago,4,9,,13,POINT (3451668 -76532004)
2015,Noviembre,Trinidad y Tobago,7,19,,26,POINT (4697157 -74140516)
2015,Noviembre,Trinidad y Tobago,1,8,,9,POINT (6170465 -7542726)
2015,Noviembre,Turquía,3,15,,18,POINT (4697157 -74140516)
2015,Noviembre,Turquía,0,4,,4,POINT (6170465 -7542726)
2015,Noviembre,Ucrania,2,3,,5,POINT (4697157 -74140516)
2015,Noviembre,Uganda,0,1,,1,POINT (4697157 -74140516)
2015,Noviembre,Uruguay,6,3,,9,POINT (10446304 -75516486)
2015,Noviembre,Uruguay,1,3,,4,POINT (10886686 -74776479)
2015,Noviembre,Uruguay,24,16,,40,POINT (125862 -81702165)
2015,Noviembre,Uruguay,16,34,,50,POINT (3451668 -76532004)
2015,Noviembre,Uruguay,49,90,,139,POINT (4697157 -74140516)
2015,Noviembre,Uruguay,0,1,,1,POINT (4815189 -75736374)
2015,Noviembre,Uruguay,26,40,,66,POINT (6170465 -7542726)
2015,Noviembre,Uruguay,0,1,,1,POINT (7128047 -73181317)
2015,Noviembre,Uruguay,1,0,,1,POINT (7927233 -72508188)
2015,Noviembre,Venezuela,0,22,,22,POINT (10406342 -75527794)
2015,Noviembre,Venezuela,545,431,,976,POINT (10446304 -75516486)
2015,Noviembre,Venezuela,14,45,,59,POINT (10886686 -74776479)
2015,Noviembre,Venezuela,0,4,,4,POINT (10970933 -74765343)
2015,Noviembre,Venezuela,6,7,,13,POINT (11117206 -74232675)
2015,Noviembre,Venezuela,188,291,,479,POINT (11360029 -72129595)
2015,Noviembre,Venezuela,2,0,,2,POINT (125862 -81702165)
2015,Noviembre,Venezuela,12,16,,28,POINT (3451668 -76532004)
2015,Noviembre,Venezuela,36,59,,95,POINT (3866713 -67927521)
2015,Noviembre,Venezuela,4208,4760,,8968,POINT (4697157 -74140516)
2015,Noviembre,Venezuela,4,4,,8,POINT (4815189 -75736374)
2015,Noviembre,Venezuela,1892,1810,,3702,POINT (6170465 -7542726)
2015,Noviembre,Venezuela,59,101,,160,POINT (6185536 -67484028)
2015,Noviembre,Venezuela,40,63,,103,POINT (7088729 -70740253)
2015,Noviembre,Venezuela,7,6,,13,POINT (7128047 -73181317)
2015,Noviembre,Venezuela,2521,3080,,5601,POINT (7819 -72453013)
2015,Noviembre,Venezuela,115,132,,247,POINT (7927233 -72508188)
2015,Noviembre,Vietnam,0,1,,1,POINT (4697157 -74140516)
2015,Noviembre,Islas Vírgenes Británicas/Territorio Británico de Ultramar,2,8,,10,POINT (4697157 -74140516)
2015,Noviembre,Islas Vírgenes Estadounidenses/Territorio de Estados Unidos,0,10,,10,POINT (4697157 -74140516)
2015,Noviembre,República Árabe de Yemen,0,1,,1,POINT (4697157 -74140516)
2015,Noviembre,Anguila/Territorio Británico de Ultramar,1,0,,1,POINT (3451668 -76532004)
2015,Noviembre,Islas Turcas y Caicos/Territorio Británico de Ultramar,0,2,,2,POINT (10446304 -75516486)
2015,Noviembre,Desconocido,4,7,,11,POINT (7128047 -73181317)
2015,Noviembre,Desconocido,1,28,,29,POINT (9402597 -75681642)
2015,Diciembre,Afganistán,0,1,,1,POINT (3451668 -76532004)
2015,Diciembre,Afganistán,0,1,,1,POINT (4697157 -74140516)
2015,Diciembre,Albania,1,2,,3,POINT (4697157 -74140516)
2015,Diciembre,Alemania,1,1,,2,POINT (0.81488 -77356)
2015,Diciembre,Alemania,0,1,,1,POINT (10446304 -75516486)
2015,Diciembre,Alemania,2,10,,12,POINT (10886686 -74776479)
2015,Diciembre,Alemania,4,2,,6,POINT (125862 -81702165)
2015,Diciembre,Alemania,80,111,,191,POINT (3451668 -76532004)
2015,Diciembre,Alemania,1457,2388,,3845,POINT (4697157 -74140516)
2015,Diciembre,Alemania,1,1,,2,POINT (4815189 -75736374)
2015,Diciembre,Alemania,23,41,,64,POINT (6170465 -7542726)
2015,Diciembre,Alemania,5,4,,9,POINT (7128047 -73181317)
2015,Diciembre,Angola,0,2,,2,POINT (4697157 -74140516)
2015,Diciembre,Angola,0,1,,1,POINT (6170465 -7542726)
2015,Diciembre,Antigua y Barbuda,0,4,,4,POINT (10406342 -75527794)
2015,Diciembre,Antigua y Barbuda,1,1,,2,POINT (10886686 -74776479)
2015,Diciembre,Antigua y Barbuda,0,3,,3,POINT (4697157 -74140516)
2015,Diciembre,Países Bajos,2,12,,14,POINT (10406342 -75527794)
2015,Diciembre,Países Bajos,39,78,,117,POINT (10886686 -74776479)
2015,Diciembre,Países Bajos,0,2,,2,POINT (11117206 -74232675)
2015,Diciembre,Países Bajos,3,6,,9,POINT (11247723 -74213989)
2015,Diciembre,Países Bajos,119,249,,368,POINT (3451668 -76532004)
2015,Diciembre,Países Bajos,813,1198,,2011,POINT (4697157 -74140516)
2015,Diciembre,Países Bajos,2,5,,7,POINT (4815189 -75736374)
2015,Diciembre,Países Bajos,276,367,,643,POINT (6170465 -7542726)
2015,Diciembre,Países Bajos,1,7,,8,POINT (7128047 -73181317)
2015,Diciembre,Países Bajos,1,2,,3,POINT (7927233 -72508188)
2015,Diciembre,Arabia Saudita,1,1,,2,POINT (4697157 -74140516)
2015,Diciembre,Argelia,0,1,,1,POINT (3451668 -76532004)
2015,Diciembre,Argelia,3,4,,7,POINT (4697157 -74140516)
2015,Diciembre,Argelia,1,0,,1,POINT (6170465 -7542726)
2015,Diciembre,Argentina,10,8,,18,POINT (0.81488 -77356)
2015,Diciembre,Argentina,36,30,,66,POINT (10446304 -75516486)
2015,Diciembre,Argentina,4,6,,10,POINT (10886686 -74776479)
2015,Diciembre,Argentina,243,207,,450,POINT (125862 -81702165)
2015,Diciembre,Argentina,96,194,,290,POINT (3451668 -76532004)
2015,Diciembre,Argentina,2195,2925,,5120,POINT (4697157 -74140516)
2015,Diciembre,Argentina,2,4,,6,POINT (4815189 -75736374)
2015,Diciembre,Argentina,98,155,,253,POINT (6170465 -7542726)
2015,Diciembre,Argentina,2,3,,5,POINT (7128047 -73181317)
2015,Diciembre,Argentina,1,0,,1,POINT (7927233 -72508188)
2015,Diciembre,Aruba,10,20,,30,POINT (10406342 -75527794)
2015,Diciembre,Aruba,1,2,,3,POINT (10446304 -75516486)
2015,Diciembre,Aruba,13,6,,19,POINT (10886686 -74776479)
2015,Diciembre,Aruba,12,16,,28,POINT (11247723 -74213989)
2015,Diciembre,Aruba,4,5,,9,POINT (3451668 -76532004)
2015,Diciembre,Aruba,677,877,,1554,POINT (4697157 -74140516)
2015,Diciembre,Aruba,0,2,,2,POINT (4815189 -75736374)
2015,Diciembre,Aruba,71,103,,174,POINT (6170465 -7542726)
2015,Diciembre,Aruba,7,2,,9,POINT (7128047 -73181317)
2015,Diciembre,Aruba,0,3,,3,POINT (7927233 -72508188)
2015,Diciembre,Australia,3,1,,4,POINT (10446304 -75516486)
2015,Diciembre,Australia,1,4,,5,POINT (10886686 -74776479)
2015,Diciembre,Australia,1,0,,1,POINT (125862 -81702165)
2015,Diciembre,Australia,11,14,,25,POINT (3451668 -76532004)
2015,Diciembre,Australia,0,1,,1,POINT (445285 -75766353)
2015,Diciembre,Australia,77,125,,202,POINT (4697157 -74140516)
2015,Diciembre,Australia,1,4,,5,POINT (4815189 -75736374)
2015,Diciembre,Australia,27,39,,66,POINT (6170465 -7542726)
2015,Diciembre,Australia,1,1,,2,POINT (7128047 -73181317)
2015,Diciembre,Australia,1,1,,2,POINT (7927233 -72508188)
2015,Diciembre,Austria,1,1,,2,POINT (10446304 -75516486)
2015,Diciembre,Austria,1,2,,3,POINT (10886686 -74776479)
2015,Diciembre,Austria,0,1,,1,POINT (125862 -81702165)
2015,Diciembre,Austria,8,9,,17,POINT (3451668 -76532004)
2015,Diciembre,Austria,25,44,,69,POINT (4697157 -74140516)
2015,Diciembre,Austria,1,2,,3,POINT (6170465 -7542726)
2015,Diciembre,Azerbaiyán,1,1,,2,POINT (4697157 -74140516)
2015,Diciembre,Bahamas,1,7,,8,POINT (10406342 -75527794)
2015,Diciembre,Bahamas,0,2,,2,POINT (10446304 -75516486)
2015,Diciembre,Bahamas,1,1,,2,POINT (11247723 -74213989)
2015,Diciembre,Bahamas,1,5,,6,POINT (3451668 -76532004)
2015,Diciembre,Bahamas,0,2,,2,POINT (4697157 -74140516)
2015,Diciembre,Bahréin,0,1,,1,POINT (3451668 -76532004)
2015,Diciembre,Bahréin,1,0,,1,POINT (4697157 -74140516)
2015,Diciembre,Barbados,16,26,,42,POINT (4697157 -74140516)
2015,Diciembre,República de Belarús,1,0,,1,POINT (6170465 -7542726)
2015,Diciembre,Bélgica,0,2,,2,POINT (10406342 -75527794)
2015,Diciembre,Bélgica,1,2,,3,POINT (10886686 -74776479)
2015,Diciembre,Bélgica,0,1,,1,POINT (125862 -81702165)
2015,Diciembre,Bélgica,6,16,,22,POINT (3451668 -76532004)
2015,Diciembre,Bélgica,51,79,,130,POINT (4697157 -74140516)
2015,Diciembre,Bélgica,0,1,,1,POINT (4815189 -75736374)
2015,Diciembre,Bélgica,3,9,,12,POINT (6170465 -7542726)
2015,Diciembre,Belice,1,0,,1,POINT (3451668 -76532004)
2015,Diciembre,Belice,1,3,,4,POINT (4697157 -74140516)
2015,Diciembre,Belice,0,2,,2,POINT (6170465 -7542726)
2015,Diciembre,Benín,0,2,,2,POINT (4697157 -74140516)
2015,Diciembre,Bolivia,8,3,,11,POINT (0.81488 -77356)
2015,Diciembre,Bolivia,11,10,,21,POINT (10446304 -75516486)
2015,Diciembre,Bolivia,2,0,,2,POINT (10886686 -74776479)
2015,Diciembre,Bolivia,16,17,,33,POINT (125862 -81702165)
2015,Diciembre,Bolivia,44,38,,82,POINT (3451668 -76532004)
2015,Diciembre,Bolivia,576,592,,1168,POINT (4697157 -74140516)
2015,Diciembre,Bolivia,38,37,,75,POINT (6170465 -7542726)
2015,Diciembre,Bolivia,0,2,,2,POINT (7128047 -73181317)
2015,Diciembre,Bolivia,0,1,,1,POINT (7927233 -72508188)
2015,Diciembre,Bosnia y Herzegovina,0,1,,1,POINT (4697157 -74140516)
2015,Diciembre,Botsuana,0,1,,1,POINT (4697157 -74140516)
2015,Diciembre,Brasil,130,154,,284,POINT (-4191162 -69941498)
2015,Diciembre,Brasil,5,5,,10,POINT (-4214082 -69941431)
2015,Diciembre,Brasil,2,3,,5,POINT (0.81488 -77356)
2015,Diciembre,Brasil,85,77,,162,POINT (10446304 -75516486)
2015,Diciembre,Brasil,18,7,,25,POINT (10886686 -74776479)
2015,Diciembre,Brasil,521,430,,951,POINT (125862 -81702165)
2015,Diciembre,Brasil,49,71,,120,POINT (3451668 -76532004)
2015,Diciembre,Brasil,1,3,,4,POINT (3866713 -67927521)
2015,Diciembre,Brasil,4090,4904,,8994,POINT (4697157 -74140516)
2015,Diciembre,Brasil,11,8,,19,POINT (4815189 -75736374)
2015,Diciembre,Brasil,147,182,,329,POINT (6170465 -7542726)
2015,Diciembre,Brasil,4,4,,8,POINT (7128047 -73181317)
2015,Diciembre,Brasil,3,1,,4,POINT (7927233 -72508188)
2015,Diciembre,Bulgaria,1,1,,2,POINT (3451668 -76532004)
2015,Diciembre,Bulgaria,3,3,,6,POINT (4697157 -74140516)
2015,Diciembre,Bulgaria,0,1,,1,POINT (6170465 -7542726)
2015,Diciembre,Cabo Verde,0,1,,1,POINT (10406342 -75527794)
2015,Diciembre,Cabo Verde,1,0,,1,POINT (4697157 -74140516)
2015,Diciembre,Islas Caimán/Territorio Británico de Ultramar,1,5,,6,POINT (10406342 -75527794)
2015,Diciembre,Islas Caimán/Territorio Británico de Ultramar,0,3,,3,POINT (125744111 -81703935)
2015,Diciembre,Islas Caimán/Territorio Británico de Ultramar,0,2,,2,POINT (125862 -81702165)
2015,Diciembre,Islas Caimán/Territorio Británico de Ultramar,1,1,,2,POINT (3451668 -76532004)
2015,Diciembre,Islas Caimán/Territorio Británico de Ultramar,0,2,,2,POINT (4697157 -74140516)
2015,Diciembre,Canadá,1,1,,2,POINT (10406342 -75527794)
2015,Diciembre,Canadá,139,149,,288,POINT (10446304 -75516486)
2015,Diciembre,Canadá,19,19,,38,POINT (10886686 -74776479)
2015,Diciembre,Canadá,162,166,,328,POINT (125862 -81702165)
2015,Diciembre,Canadá,106,131,,237,POINT (3451668 -76532004)
2015,Diciembre,Canadá,1,2,,3,POINT (445285 -75766353)
2015,Diciembre,Canadá,732,1011,,1743,POINT (4697157 -74140516)
2015,Diciembre,Canadá,18,17,,35,POINT (4815189 -75736374)
2015,Diciembre,Canadá,156,285,,441,POINT (6170465 -7542726)
2015,Diciembre,Canadá,20,28,,48,POINT (7128047 -73181317)
2015,Diciembre,Canadá,9,8,,17,POINT (7927233 -72508188)
2015,Diciembre,España,0,5,,5,POINT (10406342 -75527794)
2015,Diciembre,España,9,29,,38,POINT (10446304 -75516486)
2015,Diciembre,España,1,2,,3,POINT (10886686 -74776479)
2015,Diciembre,España,0,6,,6,POINT (10970933 -74765343)
2015,Diciembre,España,0,11,,11,POINT (11247723 -74213989)
2015,Diciembre,España,535,953,,1488,POINT (3451668 -76532004)
2015,Diciembre,España,3114,5416,,8530,POINT (4697157 -74140516)
2015,Diciembre,España,8,15,,23,POINT (4815189 -75736374)
2015,Diciembre,España,338,587,,925,POINT (6170465 -7542726)
2015,Diciembre,España,5,9,,14,POINT (7128047 -73181317)
2015,Diciembre,España,7,11,,18,POINT (7927233 -72508188)
2015,Diciembre,República de Corea,1,0,,1,POINT (10446304 -75516486)
2015,Diciembre,República de Corea,0,1,,1,POINT (125862 -81702165)
2015,Diciembre,República de Corea,1,0,,1,POINT (3451668 -76532004)
2015,Diciembre,República de Corea,14,19,,33,POINT (4697157 -74140516)
2015,Diciembre,República de Corea,1,4,,5,POINT (6170465 -7542726)
2015,Diciembre,República de Corea,0,2,,2,POINT (7927233 -72508188)
2015,Diciembre,Costa de Marfil,6,2,,8,POINT (4697157 -74140516)
2015,Diciembre,Costa de Marfil,2,2,,4,POINT (6170465 -7542726)
2015,Diciembre,Costa Rica,2,7,,9,POINT (10406342 -75527794)
2015,Diciembre,Costa Rica,18,19,,37,POINT (10446304 -75516486)
2015,Diciembre,Costa Rica,15,14,,29,POINT (10886686 -74776479)
2015,Diciembre,Costa Rica,0,1,,1,POINT (11247723 -74213989)
2015,Diciembre,Costa Rica,0,12,,12,POINT (125744111 -81703935)
2015,Diciembre,Costa Rica,154,124,,278,POINT (125862 -81702165)
2015,Diciembre,Costa Rica,82,91,,173,POINT (3451668 -76532004)
2015,Diciembre,Costa Rica,1244,1575,,2819,POINT (4697157 -74140516)
2015,Diciembre,Costa Rica,24,16,,40,POINT (4815189 -75736374)
2015,Diciembre,Costa Rica,215,242,,457,POINT (6170465 -7542726)
2015,Diciembre,Costa Rica,15,9,,24,POINT (7128047 -73181317)
2015,Diciembre,Costa Rica,3,2,,5,POINT (7927233 -72508188)
2015,Diciembre,Croacia,0,5,,5,POINT (3451668 -76532004)
2015,Diciembre,Croacia,0,1,,1,POINT (4697157 -74140516)
2015,Diciembre,Croacia,0,1,,1,POINT (6170465 -7542726)
2015,Diciembre,Cuba,0,6,,6,POINT (10406342 -75527794)
2015,Diciembre,Cuba,3,2,,5,POINT (10446304 -75516486)
2015,Diciembre,Cuba,5,2,,7,POINT (10886686 -74776479)
2015,Diciembre,Cuba,0,2,,2,POINT (125862 -81702165)
2015,Diciembre,Cuba,11,9,,20,POINT (3451668 -76532004)
2015,Diciembre,Cuba,461,670,,1131,POINT (4697157 -74140516)
2015,Diciembre,Cuba,2,0,,2,POINT (4815189 -75736374)
2015,Diciembre,Cuba,15,15,,30,POINT (6170465 -7542726)
2015,Diciembre,Cuba,4,2,,6,POINT (7128047 -73181317)
2015,Diciembre,Cuba,2,2,,4,POINT (7927233 -72508188)
2015,Diciembre,Curazao,1,2,,3,POINT (4697157 -74140516)
2015,Diciembre,Curazao,0,1,,1,POINT (6170465 -7542726)
2015,Diciembre,República Checa,2,10,,12,POINT (4697157 -74140516)
2015,Diciembre,República Checa,2,0,,2,POINT (6170465 -7542726)
2015,Diciembre,República Checa,0,1,,1,POINT (7927233 -72508188)
2015,Diciembre,Chile,2,3,,5,POINT (0.81488 -77356)
2015,Diciembre,Chile,5,7,,12,POINT (10446304 -75516486)
2015,Diciembre,Chile,26,21,,47,POINT (125862 -81702165)
2015,Diciembre,Chile,44,60,,104,POINT (3451668 -76532004)
2015,Diciembre,Chile,3636,4902,,8538,POINT (4697157 -74140516)
2015,Diciembre,Chile,2,7,,9,POINT (4815189 -75736374)
2015,Diciembre,Chile,44,76,,120,POINT (6170465 -7542726)
2015,Diciembre,Chile,1,3,,4,POINT (7128047 -73181317)
2015,Diciembre,Chile,1,4,,5,POINT (7927233 -72508188)
2015,Diciembre,China,2,3,,5,POINT (3451668 -76532004)
2015,Diciembre,China,30,59,,89,POINT (4697157 -74140516)
2015,Diciembre,China,1,7,,8,POINT (6170465 -7542726)
2015,Diciembre,Dinamarca,0,1,,1,POINT (0.81488 -77356)
2015,Diciembre,Dinamarca,1,0,,1,POINT (125862 -81702165)
2015,Diciembre,Dinamarca,2,6,,8,POINT (3451668 -76532004)
2015,Diciembre,Dinamarca,15,30,,45,POINT (4697157 -74140516)
2015,Diciembre,Dinamarca,3,3,,6,POINT (6170465 -7542726)
2015,Diciembre,Dinamarca,3,3,,6,POINT (7927233 -72508188)
2015,Diciembre,Dominica,11,19,,30,POINT (4697157 -74140516)
2015,Diciembre,Ecuador,171,320,,491,POINT (0.33002 -76876446)
2015,Diciembre,Ecuador,0,1,,1,POINT (0.812436 -77847006)
2015,Diciembre,Ecuador,4308,6411,,10719,POINT (0.81488 -77356)
2015,Diciembre,Ecuador,35,66,,101,POINT (1800143 -78802679)
2015,Diciembre,Ecuador,0,13,,13,POINT (10406342 -75527794)
2015,Diciembre,Ecuador,6,9,,15,POINT (10446304 -75516486)
2015,Diciembre,Ecuador,3,2,,5,POINT (10886686 -74776479)
2015,Diciembre,Ecuador,4,3,,7,POINT (125862 -81702165)
2015,Diciembre,Ecuador,486,553,,1039,POINT (3451668 -76532004)
2015,Diciembre,Ecuador,3551,4624,,8175,POINT (4697157 -74140516)
2015,Diciembre,Ecuador,41,36,,77,POINT (6170465 -7542726)
2015,Diciembre,Ecuador,6,0,,6,POINT (7128047 -73181317)
2015,Diciembre,Ecuador,2,7,,9,POINT (7927233 -72508188)
2015,Diciembre,Egipto,0,3,,3,POINT (4697157 -74140516)
2015,Diciembre,Egipto,0,1,,1,POINT (6170465 -7542726)
2015,Diciembre,El Salvador,3,10,,13,POINT (10446304 -75516486)
2015,Diciembre,El Salvador,14,11,,25,POINT (125862 -81702165)
2015,Diciembre,El Salvador,134,205,,339,POINT (3451668 -76532004)
2015,Diciembre,El Salvador,1098,1407,,2505,POINT (4697157 -74140516)
2015,Diciembre,El Salvador,1,1,,2,POINT (4815189 -75736374)
2015,Diciembre,El Salvador,182,257,,439,POINT (6170465 -7542726)
2015,Diciembre,El Salvador,0,1,,1,POINT (7927233 -72508188)
2015,Diciembre,Emiratos Árabes,2,5,,7,POINT (4697157 -74140516)
2015,Diciembre,Emiratos Árabes,0,1,,1,POINT (6170465 -7542726)
2015,Diciembre,Eritrea,0,1,,1,POINT (4697157 -74140516)
2015,Diciembre,Eslovaquia,7,6,,13,POINT (4697157 -74140516)
2015,Diciembre,Eslovenia,6,5,,11,POINT (4697157 -74140516)
2015,Diciembre,Estados Unidos de América,17,67,,84,POINT (10406342 -75527794)
2015,Diciembre,Estados Unidos de América,3740,5162,,8902,POINT (10446304 -75516486)
2015,Diciembre,Estados Unidos de América,865,1432,,2297,POINT (10886686 -74776479)
2015,Diciembre,Estados Unidos de América,0,11,,11,POINT (10970933 -74765343)
2015,Diciembre,Estados Unidos de América,0,20,,20,POINT (11247723 -74213989)
2015,Diciembre,Estados Unidos de América,54,54,,108,POINT (125862 -81702165)
2015,Diciembre,Estados Unidos de América,1886,2847,,4733,POINT (3451668 -76532004)
2015,Diciembre,Estados Unidos de América,127,223,,350,POINT (445285 -75766353)
2015,Diciembre,Estados Unidos de América,13028,20467,,33495,POINT (4697157 -74140516)
2015,Diciembre,Estados Unidos de América,273,425,,698,POINT (4815189 -75736374)
2015,Diciembre,Estados Unidos de América,3943,7065,,11008,POINT (6170465 -7542726)
2015,Diciembre,Estados Unidos de América,73,119,,192,POINT (7128047 -73181317)
2015,Diciembre,Estados Unidos de América,44,70,,114,POINT (7927233 -72508188)
2015,Diciembre,Estados Unidos de América,0,12,,12,POINT (9402597 -75681642)
2015,Diciembre,Estonia,0,2,,2,POINT (4697157 -74140516)
2015,Diciembre,Etiopia,0,2,,2,POINT (4697157 -74140516)
2015,Diciembre,Filipinas,0,1,,1,POINT (10446304 -75516486)
2015,Diciembre,Filipinas,1,4,,5,POINT (3451668 -76532004)
2015,Diciembre,Filipinas,1,16,,17,POINT (4697157 -74140516)
2015,Diciembre,Finlandia,2,6,,8,POINT (3451668 -76532004)
2015,Diciembre,Finlandia,13,13,,26,POINT (4697157 -74140516)
2015,Diciembre,Finlandia,2,1,,3,POINT (6170465 -7542726)
2015,Diciembre,Finlandia,0,1,,1,POINT (7128047 -73181317)
2015,Diciembre,Francia,0,4,,4,POINT (10406342 -75527794)
2015,Diciembre,Francia,1,2,,3,POINT (10446304 -75516486)
2015,Diciembre,Francia,6,3,,9,POINT (10886686 -74776479)
2015,Diciembre,Francia,2,2,,4,POINT (125862 -81702165)
2015,Diciembre,Francia,43,82,,125,POINT (3451668 -76532004)
2015,Diciembre,Francia,1447,2377,,3824,POINT (4697157 -74140516)
2015,Diciembre,Francia,4,4,,8,POINT (4815189 -75736374)
2015,Diciembre,Francia,40,63,,103,POINT (6170465 -7542726)
2015,Diciembre,Francia,4,3,,7,POINT (7128047 -73181317)
2015,Diciembre,Francia,0,1,,1,POINT (7927233 -72508188)
2015,Diciembre,Georgia,2,0,,2,POINT (4697157 -74140516)
2015,Diciembre,Ghana,0,1,,1,POINT (4697157 -74140516)
2015,Diciembre,Gibraltar/Territorio Británico de Ultramar,0,2,,2,POINT (0.81488 -77356)
2015,Diciembre,Granada,2,2,,4,POINT (6170465 -7542726)
2015,Diciembre,Granada,1,1,,2,POINT (7927233 -72508188)
2015,Diciembre,Grecia,2,0,,2,POINT (3451668 -76532004)
2015,Diciembre,Grecia,2,11,,13,POINT (4697157 -74140516)
2015,Diciembre,Grecia,0,2,,2,POINT (6170465 -7542726)
2015,Diciembre,Guatemala,11,6,,17,POINT (10446304 -75516486)
2015,Diciembre,Guatemala,3,8,,11,POINT (10886686 -74776479)
2015,Diciembre,Guatemala,74,49,,123,POINT (125862 -81702165)
2015,Diciembre,Guatemala,42,46,,88,POINT (3451668 -76532004)
2015,Diciembre,Guatemala,431,591,,1022,POINT (4697157 -74140516)
2015,Diciembre,Guatemala,3,8,,11,POINT (4815189 -75736374)
2015,Diciembre,Guatemala,72,106,,178,POINT (6170465 -7542726)
2015,Diciembre,Guatemala,7,7,,14,POINT (7128047 -73181317)
2015,Diciembre,Guatemala,13,7,,20,POINT (7927233 -72508188)
2015,Diciembre,Guyana,0,1,,1,POINT (3451668 -76532004)
2015,Diciembre,Guyana,1,3,,4,POINT (4697157 -74140516)
2015,Diciembre,Guyana,0,2,,2,POINT (6170465 -7542726)
2015,Diciembre,Guadalupe/Territorio Francés,1,0,,1,POINT (3451668 -76532004)
2015,Diciembre,Guadalupe/Territorio Francés,2,2,,4,POINT (4697157 -74140516)
2015,Diciembre,Guayana Francesa/Departamento de Ultramar Francés,0,1,,1,POINT (4697157 -74140516)
2015,Diciembre,Haití,1,0,,1,POINT (10886686 -74776479)
2015,Diciembre,Haití,0,2,,2,POINT (4697157 -74140516)
2015,Diciembre,Haití,1,2,,3,POINT (6170465 -7542726)
2015,Diciembre,Honduras,0,2,,2,POINT (10406342 -75527794)
2015,Diciembre,Honduras,73,54,,127,POINT (10446304 -75516486)
2015,Diciembre,Honduras,0,2,,2,POINT (10886686 -74776479)
2015,Diciembre,Honduras,0,4,,4,POINT (125744111 -81703935)
2015,Diciembre,Honduras,6,9,,15,POINT (133387613 -81372937)
2015,Diciembre,Honduras,20,24,,44,POINT (3451668 -76532004)
2015,Diciembre,Honduras,49,48,,97,POINT (4697157 -74140516)
2015,Diciembre,Honduras,0,1,,1,POINT (4815189 -75736374)
2015,Diciembre,Honduras,40,32,,72,POINT (6170465 -7542726)
2015,Diciembre,Honduras,0,1,,1,POINT (7128047 -73181317)
2015,Diciembre,Honduras,1,1,,2,POINT (7927233 -72508188)
2015,Diciembre,Hong Kong,1,0,,1,POINT (3451668 -76532004)
2015,Diciembre,Hong Kong,3,6,,9,POINT (4697157 -74140516)
2015,Diciembre,Hong Kong,1,1,,2,POINT (6170465 -7542726)
2015,Diciembre,Hungría,5,5,,10,POINT (4697157 -74140516)
2015,Diciembre,India,0,2,,2,POINT (10446304 -75516486)
2015,Diciembre,India,0,1,,1,POINT (10886686 -74776479)
2015,Diciembre,India,0,1,,1,POINT (3451668 -76532004)
2015,Diciembre,India,4,21,,25,POINT (4697157 -74140516)
2015,Diciembre,India,1,0,,1,POINT (4815189 -75736374)
2015,Diciembre,India,2,7,,9,POINT (6170465 -7542726)
2015,Diciembre,Indonesia,0,2,,2,POINT (3451668 -76532004)
2015,Diciembre,Indonesia,4,4,,8,POINT (4697157 -74140516)
2015,Diciembre,Indonesia,1,0,,1,POINT (6170465 -7542726)
2015,Diciembre,República de Irlanda,0,1,,1,POINT (3451668 -76532004)
2015,Diciembre,República de Irlanda,9,19,,28,POINT (4697157 -74140516)
2015,Diciembre,Islandia,0,1,,1,POINT (4697157 -74140516)
2015,Diciembre,Israel,1,2,,3,POINT (125862 -81702165)
2015,Diciembre,Israel,6,10,,16,POINT (3451668 -76532004)
2015,Diciembre,Israel,33,51,,84,POINT (4697157 -74140516)
2015,Diciembre,Israel,0,4,,4,POINT (6170465 -7542726)
2015,Diciembre,Italia,1,10,,11,POINT (10446304 -75516486)
2015,Diciembre,Italia,1,2,,3,POINT (10886686 -74776479)
2015,Diciembre,Italia,60,50,,110,POINT (125862 -81702165)
2015,Diciembre,Italia,46,109,,155,POINT (3451668 -76532004)
2015,Diciembre,Italia,169,319,,488,POINT (4697157 -74140516)
2015,Diciembre,Italia,1,4,,5,POINT (4815189 -75736374)
2015,Diciembre,Italia,27,45,,72,POINT (6170465 -7542726)
2015,Diciembre,Italia,2,4,,6,POINT (7128047 -73181317)
2015,Diciembre,Jamaica,3,12,,15,POINT (10406342 -75527794)
2015,Diciembre,Jamaica,1,4,,5,POINT (10446304 -75516486)
2015,Diciembre,Jamaica,0,2,,2,POINT (10886686 -74776479)
2015,Diciembre,Jamaica,0,2,,2,POINT (125862 -81702165)
2015,Diciembre,Jamaica,1,7,,8,POINT (3451668 -76532004)
2015,Diciembre,Jamaica,3,3,,6,POINT (4697157 -74140516)
2015,Diciembre,Jamaica,1,0,,1,POINT (6170465 -7542726)
2015,Diciembre,Japón,1,1,,2,POINT (10886686 -74776479)
2015,Diciembre,Japón,6,3,,9,POINT (3451668 -76532004)
2015,Diciembre,Japón,12,26,,38,POINT (4697157 -74140516)
2015,Diciembre,Japón,0,1,,1,POINT (4815189 -75736374)
2015,Diciembre,Japón,1,9,,10,POINT (6170465 -7542726)
2015,Diciembre,Japón,0,1,,1,POINT (7927233 -72508188)
2015,Diciembre,Jordania,0,3,,3,POINT (4697157 -74140516)
2015,Diciembre,Kenia,1,4,,5,POINT (4697157 -74140516)
2015,Diciembre,Lesoto,1,0,,1,POINT (4697157 -74140516)
2015,Diciembre,Letonia,1,6,,7,POINT (4697157 -74140516)
2015,Diciembre,Lituania,3,6,,9,POINT (4697157 -74140516)
2015,Diciembre,Líbano,4,3,,7,POINT (4697157 -74140516)
2015,Diciembre,Liechtenstein,0,3,,3,POINT (4697157 -74140516)
2015,Diciembre,Luxemburgo,2,5,,7,POINT (4697157 -74140516)
2015,Diciembre,Luxemburgo,2,0,,2,POINT (4815189 -75736374)
2015,Diciembre,Malasia,0,2,,2,POINT (4697157 -74140516)
2015,Diciembre,Malasia,0,1,,1,POINT (6170465 -7542726)
2015,Diciembre,Malí,0,1,,1,POINT (4697157 -74140516)
2015,Diciembre,Malta,0,1,,1,POINT (4697157 -74140516)
2015,Diciembre,Marruecos,0,1,,1,POINT (4697157 -74140516)
2015,Diciembre,Marruecos,1,0,,1,POINT (6170465 -7542726)
2015,Diciembre,Martinica/Departamento de Ultramar Francés,0,2,,2,POINT (10406342 -75527794)
2015,Diciembre,México,0,11,,11,POINT (10406342 -75527794)
2015,Diciembre,México,31,34,,65,POINT (10446304 -75516486)
2015,Diciembre,México,23,40,,63,POINT (10886686 -74776479)
2015,Diciembre,México,0,1,,1,POINT (10970933 -74765343)
2015,Diciembre,México,0,3,,3,POINT (125744111 -81703935)
2015,Diciembre,México,13,22,,35,POINT (125862 -81702165)
2015,Diciembre,México,49,121,,170,POINT (3451668 -76532004)
2015,Diciembre,México,5128,7606,,12734,POINT (4697157 -74140516)
2015,Diciembre,México,14,19,,33,POINT (4815189 -75736374)
2015,Diciembre,México,650,1151,,1801,POINT (6170465 -7542726)
2015,Diciembre,México,17,28,,45,POINT (7128047 -73181317)
2015,Diciembre,México,18,17,,35,POINT (7927233 -72508188)
2015,Diciembre,Myanmar,1,3,,4,POINT (4697157 -74140516)
2015,Diciembre,Nicaragua,3,12,,15,POINT (10446304 -75516486)
2015,Diciembre,Nicaragua,4,6,,10,POINT (10886686 -74776479)
2015,Diciembre,Nicaragua,2,2,,4,POINT (125862 -81702165)
2015,Diciembre,Nicaragua,4,7,,11,POINT (3451668 -76532004)
2015,Diciembre,Nicaragua,34,22,,56,POINT (4697157 -74140516)
2015,Diciembre,Nicaragua,2,5,,7,POINT (4815189 -75736374)
2015,Diciembre,Nicaragua,3,9,,12,POINT (6170465 -7542726)
2015,Diciembre,Nicaragua,2,1,,3,POINT (7927233 -72508188)
2015,Diciembre,Nicaragua,0,1,,1,POINT (863337 -7735002)
2015,Diciembre,Noruega,0,1,,1,POINT (10446304 -75516486)
2015,Diciembre,Noruega,0,1,,1,POINT (10886686 -74776479)
2015,Diciembre,Noruega,0,2,,2,POINT (125862 -81702165)
2015,Diciembre,Noruega,10,5,,15,POINT (3451668 -76532004)
2015,Diciembre,Noruega,42,38,,80,POINT (4697157 -74140516)
2015,Diciembre,Noruega,2,3,,5,POINT (6170465 -7542726)
2015,Diciembre,Nueva Zelanda,1,3,,4,POINT (3451668 -76532004)
2015,Diciembre,Nueva Zelanda,4,7,,11,POINT (4697157 -74140516)
2015,Diciembre,Nueva Zelanda,0,3,,3,POINT (6170465 -7542726)
2015,Diciembre,Papúa Nueva Guinea,1,0,,1,POINT (3451668 -76532004)
2015,Diciembre,Pakistán,0,2,,2,POINT (4697157 -74140516)
2015,Diciembre,Panamá,0,2,,2,POINT (1800143 -78802679)
2015,Diciembre,Panamá,811,789,,1600,POINT (10406342 -75527794)
2015,Diciembre,Panamá,2933,3061,,5994,POINT (10446304 -75516486)
2015,Diciembre,Panamá,400,699,,1099,POINT (10886686 -74776479)
2015,Diciembre,Panamá,0,24,,24,POINT (10970933 -74765343)
2015,Diciembre,Panamá,5,16,,21,POINT (125744111 -81703935)
2015,Diciembre,Panamá,241,234,,475,POINT (125862 -81702165)
2015,Diciembre,Panamá,11,9,,20,POINT (133387613 -81372937)
2015,Diciembre,Panamá,323,619,,942,POINT (3451668 -76532004)
2015,Diciembre,Panamá,0,44,,44,POINT (3884426 -77061029)
2015,Diciembre,Panamá,100,160,,260,POINT (445285 -75766353)
2015,Diciembre,Panamá,4087,5833,,9920,POINT (4697157 -74140516)
2015,Diciembre,Panamá,86,128,,214,POINT (4815189 -75736374)
2015,Diciembre,Panamá,1686,2620,,4306,POINT (6170465 -7542726)
2015,Diciembre,Panamá,1,1,,2,POINT (6222552 -77401154)
2015,Diciembre,Panamá,4,10,,14,POINT (7102626 -77762647)
2015,Diciembre,Panamá,32,56,,88,POINT (7128047 -73181317)
2015,Diciembre,Panamá,114,140,,254,POINT (7927233 -72508188)
2015,Diciembre,Panamá,106,162,,268,POINT (863337 -7735002)
2015,Diciembre,Paraguay,1,5,,6,POINT (10886686 -74776479)
2015,Diciembre,Paraguay,34,27,,61,POINT (125862 -81702165)
2015,Diciembre,Paraguay,9,11,,20,POINT (3451668 -76532004)
2015,Diciembre,Paraguay,63,66,,129,POINT (4697157 -74140516)
2015,Diciembre,Paraguay,11,11,,22,POINT (6170465 -7542726)
2015,Diciembre,Perú,119,138,,257,POINT (-4191162 -69941498)
2015,Diciembre,Perú,8,6,,14,POINT (-4214082 -69941431)
2015,Diciembre,Perú,8,20,,28,POINT (0.81488 -77356)
2015,Diciembre,Perú,0,4,,4,POINT (10406342 -75527794)
2015,Diciembre,Perú,7,4,,11,POINT (10446304 -75516486)
2015,Diciembre,Perú,3,5,,8,POINT (10886686 -74776479)
2015,Diciembre,Perú,83,58,,141,POINT (125862 -81702165)
2015,Diciembre,Perú,269,347,,616,POINT (3451668 -76532004)
2015,Diciembre,Perú,5663,7317,,12980,POINT (4697157 -74140516)
2015,Diciembre,Perú,5,1,,6,POINT (4815189 -75736374)
2015,Diciembre,Perú,280,561,,841,POINT (6170465 -7542726)
2015,Diciembre,Perú,4,6,,10,POINT (7128047 -73181317)
2015,Diciembre,Perú,9,5,,14,POINT (7927233 -72508188)
2015,Diciembre,Polonia,0,1,,1,POINT (10886686 -74776479)
2015,Diciembre,Polonia,0,2,,2,POINT (125862 -81702165)
2015,Diciembre,Polonia,0,1,,1,POINT (3451668 -76532004)
2015,Diciembre,Polonia,20,13,,33,POINT (4697157 -74140516)
2015,Diciembre,Polonia,0,1,,1,POINT (6170465 -7542726)
2015,Diciembre,Portugal,0,1,,1,POINT (11247723 -74213989)
2015,Diciembre,Portugal,2,2,,4,POINT (3451668 -76532004)
2015,Diciembre,Portugal,386,560,,946,POINT (4697157 -74140516)
2015,Diciembre,Portugal,0,3,,3,POINT (6170465 -7542726)
2015,Diciembre,Polinesia Francesa/Colectividad de Ultramar Francesa,0,1,,1,POINT (4697157 -74140516)
2015,Diciembre,Puerto Rico/Territorio de Estados Unidos,1,3,,4,POINT (10446304 -75516486)
2015,Diciembre,Puerto Rico/Territorio de Estados Unidos,17,48,,65,POINT (10886686 -74776479)
2015,Diciembre,Puerto Rico/Territorio de Estados Unidos,1,1,,2,POINT (10970933 -74765343)
2015,Diciembre,Puerto Rico/Territorio de Estados Unidos,2,10,,12,POINT (125862 -81702165)
2015,Diciembre,Puerto Rico/Territorio de Estados Unidos,41,120,,161,POINT (3451668 -76532004)
2015,Diciembre,Puerto Rico/Territorio de Estados Unidos,405,483,,888,POINT (4697157 -74140516)
2015,Diciembre,Puerto Rico/Territorio de Estados Unidos,19,13,,32,POINT (4815189 -75736374)
2015,Diciembre,Puerto Rico/Territorio de Estados Unidos,55,108,,163,POINT (6170465 -7542726)
2015,Diciembre,Puerto Rico/Territorio de Estados Unidos,3,10,,13,POINT (7128047 -73181317)
2015,Diciembre,Puerto Rico/Territorio de Estados Unidos,4,3,,7,POINT (7927233 -72508188)
2015,Diciembre,Qatar,0,1,,1,POINT (4697157 -74140516)
2015,Diciembre,Reino Unido de Gran Bretaña e Irlanda del Norte,2,0,,2,POINT (10446304 -75516486)
2015,Diciembre,Reino Unido de Gran Bretaña e Irlanda del Norte,2,7,,9,POINT (10886686 -74776479)
2015,Diciembre,Reino Unido de Gran Bretaña e Irlanda del Norte,0,1,,1,POINT (125862 -81702165)
2015,Diciembre,Reino Unido de Gran Bretaña e Irlanda del Norte,31,59,,90,POINT (3451668 -76532004)
2015,Diciembre,Reino Unido de Gran Bretaña e Irlanda del Norte,1128,1782,,2910,POINT (4697157 -74140516)
2015,Diciembre,Reino Unido de Gran Bretaña e Irlanda del Norte,2,2,,4,POINT (4815189 -75736374)
2015,Diciembre,Reino Unido de Gran Bretaña e Irlanda del Norte,25,43,,68,POINT (6170465 -7542726)
2015,Diciembre,Reino Unido de Gran Bretaña e Irlanda del Norte,0,1,,1,POINT (7927233 -72508188)
2015,Diciembre,República CentroÁfricana,0,2,,2,POINT (3451668 -76532004)
2015,Diciembre,República CentroÁfricana,0,1,,1,POINT (4697157 -74140516)
2015,Diciembre,Federación de Rusia,0,1,,1,POINT (10886686 -74776479)
2015,Diciembre,Federación de Rusia,1,0,,1,POINT (3451668 -76532004)
2015,Diciembre,Federación de Rusia,18,24,,42,POINT (4697157 -74140516)
2015,Diciembre,Federación de Rusia,0,1,,1,POINT (6170465 -7542726)
2015,Diciembre,República Dominicana,2,16,,18,POINT (10406342 -75527794)
2015,Diciembre,República Dominicana,2,1,,3,POINT (10446304 -75516486)
2015,Diciembre,República Dominicana,4,15,,19,POINT (10886686 -74776479)
2015,Diciembre,República Dominicana,0,1,,1,POINT (10970933 -74765343)
2015,Diciembre,República Dominicana,1,3,,4,POINT (125862 -81702165)
2015,Diciembre,República Dominicana,12,72,,84,POINT (3451668 -76532004)
2015,Diciembre,República Dominicana,579,940,,1519,POINT (4697157 -74140516)
2015,Diciembre,República Dominicana,4,13,,17,POINT (4815189 -75736374)
2015,Diciembre,República Dominicana,35,41,,76,POINT (6170465 -7542726)
2015,Diciembre,República Dominicana,2,3,,5,POINT (7128047 -73181317)
2015,Diciembre,República Dominicana,2,2,,4,POINT (7927233 -72508188)
2015,Diciembre,Reunión,1,2,,3,POINT (4697157 -74140516)
2015,Diciembre,República Democrática Popular de Corea,0,1,,1,POINT (4697157 -74140516)
2015,Diciembre,Rumania,1,0,,1,POINT (3451668 -76532004)
2015,Diciembre,Rumania,4,8,,12,POINT (4697157 -74140516)
2015,Diciembre,San Cristóbal y Nevis,0,1,,1,POINT (10406342 -75527794)
2015,Diciembre,San Cristóbal y Nevis,1,2,,3,POINT (4697157 -74140516)
2015,Diciembre,San  Vicente y las Granadinas,0,4,,4,POINT (10406342 -75527794)
2015,Diciembre,San  Vicente y las Granadinas,1,3,,4,POINT (11247723 -74213989)
2015,Diciembre,Santa Elena/Territorio Británico de Ultramar,0,1,,1,POINT (4697157 -74140516)
2015,Diciembre,Santa Lucia,0,1,,1,POINT (11247723 -74213989)
2015,Diciembre,Santa Lucia,0,1,,1,POINT (3451668 -76532004)
2015,Diciembre,Serbia,2,0,,2,POINT (4697157 -74140516)
2015,Diciembre,Singapur,0,1,,1,POINT (3451668 -76532004)
2015,Diciembre,Singapur,7,5,,12,POINT (4697157 -74140516)
2015,Diciembre,Singapur,0,1,,1,POINT (4815189 -75736374)
2015,Diciembre,Singapur,0,1,,1,POINT (6170465 -7542726)
2015,Diciembre,Sri Lanka,1,0,,1,POINT (4697157 -74140516)
2015,Diciembre,Sudáfrica,1,2,,3,POINT (3451668 -76532004)
2015,Diciembre,Sudáfrica,3,5,,8,POINT (4697157 -74140516)
2015,Diciembre,Suecia,0,2,,2,POINT (10446304 -75516486)
2015,Diciembre,Suecia,5,2,,7,POINT (10886686 -74776479)
2015,Diciembre,Suecia,27,34,,61,POINT (3451668 -76532004)
2015,Diciembre,Suecia,87,111,,198,POINT (4697157 -74140516)
2015,Diciembre,Suecia,1,2,,3,POINT (4815189 -75736374)
2015,Diciembre,Suecia,5,15,,20,POINT (6170465 -7542726)
2015,Diciembre,Suiza,2,1,,3,POINT (10446304 -75516486)
2015,Diciembre,Suiza,1,0,,1,POINT (125862 -81702165)
2015,Diciembre,Suiza,45,61,,106,POINT (3451668 -76532004)
2015,Diciembre,Suiza,123,202,,325,POINT (4697157 -74140516)
2015,Diciembre,Suiza,2,2,,4,POINT (4815189 -75736374)
2015,Diciembre,Suiza,10,34,,44,POINT (6170465 -7542726)
2015,Diciembre,Suiza,1,4,,5,POINT (7128047 -73181317)
2015,Diciembre,Suiza,1,0,,1,POINT (7927233 -72508188)
2015,Diciembre,Surinam,1,0,,1,POINT (4697157 -74140516)
2015,Diciembre,Surinam,1,4,,5,POINT (6170465 -7542726)
2015,Diciembre,Taiwán,1,5,,6,POINT (4697157 -74140516)
2015,Diciembre,Taiwán,2,0,,2,POINT (6170465 -7542726)
2015,Diciembre,Tailandia,2,2,,4,POINT (4697157 -74140516)
2015,Diciembre,Togo,0,1,,1,POINT (4697157 -74140516)
2015,Diciembre,Trinidad y Tobago,0,1,,1,POINT (10446304 -75516486)
2015,Diciembre,Trinidad y Tobago,8,8,,16,POINT (3451668 -76532004)
2015,Diciembre,Trinidad y Tobago,2,13,,15,POINT (4697157 -74140516)
2015,Diciembre,Trinidad y Tobago,1,4,,5,POINT (4815189 -75736374)
2015,Diciembre,Trinidad y Tobago,1,5,,6,POINT (6170465 -7542726)
2015,Diciembre,Trinidad y Tobago,1,4,,5,POINT (7128047 -73181317)
2015,Diciembre,Trinidad y Tobago,4,3,,7,POINT (7927233 -72508188)
2015,Diciembre,Túnez,0,1,,1,POINT (4697157 -74140516)
2015,Diciembre,Turquía,0,1,,1,POINT (3451668 -76532004)
2015,Diciembre,Turquía,4,14,,18,POINT (4697157 -74140516)
2015,Diciembre,Turquía,0,4,,4,POINT (6170465 -7542726)
2015,Diciembre,Ucrania,1,1,,2,POINT (10886686 -74776479)
2015,Diciembre,Ucrania,0,2,,2,POINT (3451668 -76532004)
2015,Diciembre,Ucrania,4,1,,5,POINT (4697157 -74140516)
2015,Diciembre,Uruguay,3,0,,3,POINT (10446304 -75516486)
2015,Diciembre,Uruguay,1,2,,3,POINT (10886686 -74776479)
2015,Diciembre,Uruguay,15,18,,33,POINT (125862 -81702165)
2015,Diciembre,Uruguay,14,22,,36,POINT (3451668 -76532004)
2015,Diciembre,Uruguay,41,63,,104,POINT (4697157 -74140516)
2015,Diciembre,Uruguay,21,33,,54,POINT (6170465 -7542726)
2015,Diciembre,Uruguay,0,1,,1,POINT (7128047 -73181317)
2015,Diciembre,Venezuela,0,20,,20,POINT (10406342 -75527794)
2015,Diciembre,Venezuela,529,406,,935,POINT (10446304 -75516486)
2015,Diciembre,Venezuela,27,48,,75,POINT (10886686 -74776479)
2015,Diciembre,Venezuela,0,6,,6,POINT (11117206 -74232675)
2015,Diciembre,Venezuela,225,330,,555,POINT (11360029 -72129595)
2015,Diciembre,Venezuela,3,5,,8,POINT (125862 -81702165)
2015,Diciembre,Venezuela,24,43,,67,POINT (3451668 -76532004)
2015,Diciembre,Venezuela,47,48,,95,POINT (3866713 -67927521)
2015,Diciembre,Venezuela,4543,4387,,8930,POINT (4697157 -74140516)
2015,Diciembre,Venezuela,1,4,,5,POINT (4815189 -75736374)
2015,Diciembre,Venezuela,1985,1641,,3626,POINT (6170465 -7542726)
2015,Diciembre,Venezuela,49,76,,125,POINT (6185536 -67484028)
2015,Diciembre,Venezuela,61,145,,206,POINT (7088729 -70740253)
2015,Diciembre,Venezuela,20,18,,38,POINT (7128047 -73181317)
2015,Diciembre,Venezuela,3048,3439,,6487,POINT (7819 -72453013)
2015,Diciembre,Venezuela,178,221,,399,POINT (7927233 -72508188)
2015,Diciembre,Islas Vírgenes Británicas/Territorio Británico de Ultramar,5,3,,8,POINT (133387613 -81372937)
2015,Diciembre,Islas Vírgenes Británicas/Territorio Británico de Ultramar,4,9,,13,POINT (4697157 -74140516)
2015,Diciembre,República Árabe de Yemen,0,1,,1,POINT (4697157 -74140516)
2015,Diciembre,Desconocido,0,8,,8,POINT (9402597 -75681642)
2015,Diciembre,Desconocido,199,1220,,1419,POINT (4697157 -74140516)
2016,Enero,Afganistán,2,0,,2,POINT (4697157 -74140516)
2016,Enero,Alemania,3,2,,5,POINT (10886686 -74776479)
2016,Enero,Alemania,1,0,,1,POINT (125862 -81702165)
2016,Enero,Alemania,31,52,,83,POINT (3451668 -76532004)
2016,Enero,Alemania,1360,2188,,3548,POINT (4697157 -74140516)
2016,Enero,Alemania,0,2,,2,POINT (4815189 -75736374)
2016,Enero,Alemania,42,52,,94,POINT (6170465 -7542726)
2016,Enero,Angola,0,1,,1,POINT (4697157 -74140516)
2016,Enero,Antigua y Barbuda,0,1,,1,POINT (10406342 -75527794)
2016,Enero,Antigua y Barbuda,0,4,,4,POINT (4697157 -74140516)
2016,Enero,Países Bajos,30,30,,60,POINT (10406342 -75527794)
2016,Enero,Países Bajos,3,10,,13,POINT (10446304 -75516486)
2016,Enero,Países Bajos,49,54,,103,POINT (10886686 -74776479)
2016,Enero,Países Bajos,10,15,,25,POINT (11247723 -74213989)
2016,Enero,Países Bajos,87,185,,272,POINT (3451668 -76532004)
2016,Enero,Países Bajos,926,1356,,2282,POINT (4697157 -74140516)
2016,Enero,Países Bajos,1,0,,1,POINT (4815189 -75736374)
2016,Enero,Países Bajos,163,234,,397,POINT (6170465 -7542726)
2016,Enero,Países Bajos,9,4,,13,POINT (7128047 -73181317)
2016,Enero,Arabia Saudita,0,1,,1,POINT (4697157 -74140516)
2016,Enero,Argelia,0,2,,2,POINT (3451668 -76532004)
2016,Enero,Argelia,3,3,,6,POINT (4697157 -74140516)
2016,Enero,Argentina,1,6,,7,POINT (0.81488 -77356)
2016,Enero,Argentina,32,21,,53,POINT (10446304 -75516486)
2016,Enero,Argentina,10,11,,21,POINT (10886686 -74776479)
2016,Enero,Argentina,281,193,,474,POINT (125862 -81702165)
2016,Enero,Argentina,61,69,,130,POINT (3451668 -76532004)
2016,Enero,Argentina,3959,4056,,8015,POINT (4697157 -74140516)
2016,Enero,Argentina,5,3,,8,POINT (4815189 -75736374)
2016,Enero,Argentina,133,121,,254,POINT (6170465 -7542726)
2016,Enero,Argentina,0,3,,3,POINT (7128047 -73181317)
2016,Enero,Aruba,157,145,,302,POINT (10406342 -75527794)
2016,Enero,Aruba,4,7,,11,POINT (10446304 -75516486)
2016,Enero,Aruba,9,4,,13,POINT (10886686 -74776479)
2016,Enero,Aruba,40,65,,105,POINT (11247723 -74213989)
2016,Enero,Aruba,13,13,,26,POINT (3451668 -76532004)
2016,Enero,Aruba,564,726,,1290,POINT (4697157 -74140516)
2016,Enero,Aruba,30,44,,74,POINT (6170465 -7542726)
2016,Enero,Aruba,10,6,,16,POINT (7128047 -73181317)
2016,Enero,Australia,1,1,,2,POINT (10886686 -74776479)
2016,Enero,Australia,1,1,,2,POINT (125862 -81702165)
2016,Enero,Australia,5,11,,16,POINT (3451668 -76532004)
2016,Enero,Australia,38,34,,72,POINT (4697157 -74140516)
2016,Enero,Australia,0,1,,1,POINT (4815189 -75736374)
2016,Enero,Australia,18,26,,44,POINT (6170465 -7542726)
2016,Enero,Australia,0,1,,1,POINT (7128047 -73181317)
2016,Enero,Austria,3,5,,8,POINT (3451668 -76532004)
2016,Enero,Austria,27,39,,66,POINT (4697157 -74140516)
2016,Enero,Austria,4,3,,7,POINT (6170465 -7542726)
2016,Enero,Austria,0,2,,2,POINT (7128047 -73181317)
2016,Enero,Austria,1,1,,2,POINT (7927233 -72508188)
2016,Enero,Bahamas,1,1,,2,POINT (11247723 -74213989)
2016,Enero,Bahamas,2,1,,3,POINT (4697157 -74140516)
2016,Enero,Bahamas,4,1,,5,POINT (6170465 -7542726)
2016,Enero,Bahréin,0,1,,1,POINT (10446304 -75516486)
2016,Enero,Bahréin,1,0,,1,POINT (4697157 -74140516)
2016,Enero,Bahréin,1,0,,1,POINT (7819 -72453013)
2016,Enero,Barbados,36,52,,88,POINT (4697157 -74140516)
2016,Enero,República de Belarús,2,2,,4,POINT (4697157 -74140516)
2016,Enero,República de Belarús,1,1,,2,POINT (7819 -72453013)
2016,Enero,Bélgica,0,1,,1,POINT (10886686 -74776479)
2016,Enero,Bélgica,3,10,,13,POINT (3451668 -76532004)
2016,Enero,Bélgica,33,45,,78,POINT (4697157 -74140516)
2016,Enero,Bélgica,1,2,,3,POINT (4815189 -75736374)
2016,Enero,Bélgica,6,14,,20,POINT (6170465 -7542726)
2016,Enero,Belice,3,3,,6,POINT (4697157 -74140516)
2016,Enero,Belice,0,2,,2,POINT (6170465 -7542726)
2016,Enero,Benín,0,2,,2,POINT (6170465 -7542726)
2016,Enero,Bolivia,3,2,,5,POINT (10446304 -75516486)
2016,Enero,Bolivia,5,2,,7,POINT (10886686 -74776479)
2016,Enero,Bolivia,21,20,,41,POINT (125862 -81702165)
2016,Enero,Bolivia,30,30,,60,POINT (3451668 -76532004)
2016,Enero,Bolivia,565,600,,1165,POINT (4697157 -74140516)
2016,Enero,Bolivia,4,0,,4,POINT (4815189 -75736374)
2016,Enero,Bolivia,41,53,,94,POINT (6170465 -7542726)
2016,Enero,Bolivia,1,1,,2,POINT (7927233 -72508188)
2016,Enero,Bosnia y Herzegovina,1,0,,1,POINT (4697157 -74140516)
2016,Enero,Brasil,111,165,,276,POINT (-4191162 -69941498)
2016,Enero,Brasil,0,19,,19,POINT (-4214082 -69941431)
2016,Enero,Brasil,0,6,,6,POINT (10406342 -75527794)
2016,Enero,Brasil,35,28,,63,POINT (10446304 -75516486)
2016,Enero,Brasil,13,11,,24,POINT (10886686 -74776479)
2016,Enero,Brasil,516,395,,911,POINT (125862 -81702165)
2016,Enero,Brasil,115,140,,255,POINT (3451668 -76532004)
2016,Enero,Brasil,0,4,,4,POINT (3884426 -77061029)
2016,Enero,Brasil,5306,6111,,11417,POINT (4697157 -74140516)
2016,Enero,Brasil,4,6,,10,POINT (4815189 -75736374)
2016,Enero,Brasil,212,246,,458,POINT (6170465 -7542726)
2016,Enero,Brasil,5,6,,11,POINT (7128047 -73181317)
2016,Enero,Brasil,5,4,,9,POINT (7927233 -72508188)
2016,Enero,Bulgaria,5,3,,8,POINT (4697157 -74140516)
2016,Enero,Bulgaria,0,1,,1,POINT (6170465 -7542726)
2016,Enero,Bulgaria,1,1,,2,POINT (7128047 -73181317)
2016,Enero,Burkina Faso,0,1,,1,POINT (4697157 -74140516)
2016,Enero,Cabo Verde,1,0,,1,POINT (4697157 -74140516)
2016,Enero,Islas Caimán/Territorio Británico de Ultramar,2,6,,8,POINT (10406342 -75527794)
2016,Enero,Islas Caimán/Territorio Británico de Ultramar,1,1,,2,POINT (133387613 -81372937)
2016,Enero,Islas Caimán/Territorio Británico de Ultramar,0,3,,3,POINT (4697157 -74140516)
2016,Enero,Canadá,0,1,,1,POINT (10406342 -75527794)
2016,Enero,Canadá,386,358,,744,POINT (10446304 -75516486)
2016,Enero,Canadá,9,19,,28,POINT (10886686 -74776479)
2016,Enero,Canadá,348,329,,677,POINT (125862 -81702165)
2016,Enero,Canadá,44,52,,96,POINT (3451668 -76532004)
2016,Enero,Canadá,0,2,,2,POINT (445285 -75766353)
2016,Enero,Canadá,617,901,,1518,POINT (4697157 -74140516)
2016,Enero,Canadá,8,22,,30,POINT (4815189 -75736374)
2016,Enero,Canadá,111,184,,295,POINT (6170465 -7542726)
2016,Enero,Canadá,5,9,,14,POINT (7128047 -73181317)
2016,Enero,Canadá,1,2,,3,POINT (7927233 -72508188)
2016,Enero,Chad,1,0,,1,POINT (4697157 -74140516)
2016,Enero,España,2,5,,7,POINT (10886686 -74776479)
2016,Enero,España,2,2,,4,POINT (125862 -81702165)
2016,Enero,España,531,815,,1346,POINT (3451668 -76532004)
2016,Enero,España,3473,5948,,9421,POINT (4697157 -74140516)
2016,Enero,España,2,2,,4,POINT (4815189 -75736374)
2016,Enero,España,357,674,,1031,POINT (6170465 -7542726)
2016,Enero,España,3,3,,6,POINT (7128047 -73181317)
2016,Enero,España,1,0,,1,POINT (7927233 -72508188)
2016,Enero,República de Corea,0,1,,1,POINT (10406342 -75527794)
2016,Enero,República de Corea,0,1,,1,POINT (10886686 -74776479)
2016,Enero,República de Corea,0,4,,4,POINT (3884426 -77061029)
2016,Enero,República de Corea,25,46,,71,POINT (4697157 -74140516)
2016,Enero,República de Corea,4,6,,10,POINT (6170465 -7542726)
2016,Enero,Costa de Marfil,0,1,,1,POINT (10406342 -75527794)
2016,Enero,Costa de Marfil,0,1,,1,POINT (3451668 -76532004)
2016,Enero,Costa de Marfil,4,4,,8,POINT (4697157 -74140516)
2016,Enero,Costa de Marfil,0,1,,1,POINT (6170465 -7542726)
2016,Enero,Costa Rica,129,107,,236,POINT (10406342 -75527794)
2016,Enero,Costa Rica,2,7,,9,POINT (10446304 -75516486)
2016,Enero,Costa Rica,9,15,,24,POINT (10886686 -74776479)
2016,Enero,Costa Rica,5,20,,25,POINT (125744111 -81703935)
2016,Enero,Costa Rica,237,168,,405,POINT (125862 -81702165)
2016,Enero,Costa Rica,41,45,,86,POINT (3451668 -76532004)
2016,Enero,Costa Rica,932,1234,,2166,POINT (4697157 -74140516)
2016,Enero,Costa Rica,14,12,,26,POINT (4815189 -75736374)
2016,Enero,Costa Rica,111,153,,264,POINT (6170465 -7542726)
2016,Enero,Costa Rica,5,5,,10,POINT (7128047 -73181317)
2016,Enero,Costa Rica,2,7,,9,POINT (7927233 -72508188)
2016,Enero,Croacia,0,2,,2,POINT (3451668 -76532004)
2016,Enero,Croacia,2,2,,4,POINT (4697157 -74140516)
2016,Enero,Cuba,0,3,,3,POINT (10446304 -75516486)
2016,Enero,Cuba,6,6,,12,POINT (10886686 -74776479)
2016,Enero,Cuba,3,0,,3,POINT (125862 -81702165)
2016,Enero,Cuba,7,18,,25,POINT (3451668 -76532004)
2016,Enero,Cuba,429,600,,1029,POINT (4697157 -74140516)
2016,Enero,Cuba,1,4,,5,POINT (4815189 -75736374)
2016,Enero,Cuba,20,41,,61,POINT (6170465 -7542726)
2016,Enero,Cuba,1,3,,4,POINT (7128047 -73181317)
2016,Enero,Cuba,1,3,,4,POINT (7927233 -72508188)
2016,Enero,Curazao,1,0,,1,POINT (4697157 -74140516)
2016,Enero,República Checa,1,2,,3,POINT (3451668 -76532004)
2016,Enero,República Checa,10,10,,20,POINT (4697157 -74140516)
2016,Enero,Chile,7,10,,17,POINT (10446304 -75516486)
2016,Enero,Chile,2,5,,7,POINT (10886686 -74776479)
2016,Enero,Chile,253,179,,432,POINT (125862 -81702165)
2016,Enero,Chile,73,101,,174,POINT (3451668 -76532004)
2016,Enero,Chile,4501,5258,,9759,POINT (4697157 -74140516)
2016,Enero,Chile,0,6,,6,POINT (4815189 -75736374)
2016,Enero,Chile,50,71,,121,POINT (6170465 -7542726)
2016,Enero,Chile,1,3,,4,POINT (7128047 -73181317)
2016,Enero,Chile,2,2,,4,POINT (7927233 -72508188)
2016,Enero,China,2,1,,3,POINT (3451668 -76532004)
2016,Enero,China,33,71,,104,POINT (4697157 -74140516)
2016,Enero,China,1,7,,8,POINT (6170465 -7542726)
2016,Enero,China,0,1,,1,POINT (7128047 -73181317)
2016,Enero,Dinamarca,7,6,,13,POINT (3451668 -76532004)
2016,Enero,Dinamarca,27,37,,64,POINT (4697157 -74140516)
2016,Enero,Dinamarca,3,3,,6,POINT (6170465 -7542726)
2016,Enero,Dinamarca,0,3,,3,POINT (7128047 -73181317)
2016,Enero,Dominica,10,8,,18,POINT (4697157 -74140516)
2016,Enero,Ecuador,90,228,,318,POINT (0.33002 -76876446)
2016,Enero,Ecuador,2,1,,3,POINT (0.812436 -77847006)
2016,Enero,Ecuador,3244,5088,,8332,POINT (0.81488 -77356)
2016,Enero,Ecuador,39,54,,93,POINT (1800143 -78802679)
2016,Enero,Ecuador,1,2,,3,POINT (10406342 -75527794)
2016,Enero,Ecuador,4,9,,13,POINT (10446304 -75516486)
2016,Enero,Ecuador,5,4,,9,POINT (10886686 -74776479)
2016,Enero,Ecuador,2,3,,5,POINT (125862 -81702165)
2016,Enero,Ecuador,322,411,,733,POINT (3451668 -76532004)
2016,Enero,Ecuador,3085,4513,,7598,POINT (4697157 -74140516)
2016,Enero,Ecuador,55,80,,135,POINT (6170465 -7542726)
2016,Enero,Ecuador,1,3,,4,POINT (7128047 -73181317)
2016,Enero,Ecuador,6,9,,15,POINT (7927233 -72508188)
2016,Enero,Egipto,2,6,,8,POINT (4697157 -74140516)
2016,Enero,Egipto,0,1,,1,POINT (7128047 -73181317)
2016,Enero,El Salvador,1,1,,2,POINT (10886686 -74776479)
2016,Enero,El Salvador,3,4,,7,POINT (125862 -81702165)
2016,Enero,El Salvador,131,186,,317,POINT (3451668 -76532004)
2016,Enero,El Salvador,790,1136,,1926,POINT (4697157 -74140516)
2016,Enero,El Salvador,160,242,,402,POINT (6170465 -7542726)
2016,Enero,El Salvador,1,1,,2,POINT (7128047 -73181317)
2016,Enero,El Salvador,2,2,,4,POINT (7927233 -72508188)
2016,Enero,Emiratos Árabes,1,0,,1,POINT (3451668 -76532004)
2016,Enero,Emiratos Árabes,2,7,,9,POINT (4697157 -74140516)
2016,Enero,Eslovaquia,0,1,,1,POINT (3451668 -76532004)
2016,Enero,Eslovaquia,3,3,,6,POINT (4697157 -74140516)
2016,Enero,Eslovenia,4,4,,8,POINT (4697157 -74140516)
2016,Enero,Eslovenia,1,0,,1,POINT (6170465 -7542726)
2016,Enero,Estados Unidos de América,1,36,,37,POINT (10406342 -75527794)
2016,Enero,Estados Unidos de América,3401,4777,,8178,POINT (10446304 -75516486)
2016,Enero,Estados Unidos de América,577,989,,1566,POINT (10886686 -74776479)
2016,Enero,Estados Unidos de América,0,2,,2,POINT (10970933 -74765343)
2016,Enero,Estados Unidos de América,0,7,,7,POINT (11247723 -74213989)
2016,Enero,Estados Unidos de América,14,16,,30,POINT (125862 -81702165)
2016,Enero,Estados Unidos de América,854,1279,,2133,POINT (3451668 -76532004)
2016,Enero,Estados Unidos de América,98,148,,246,POINT (445285 -75766353)
2016,Enero,Estados Unidos de América,8431,14652,,23083,POINT (4697157 -74140516)
2016,Enero,Estados Unidos de América,130,188,,318,POINT (4815189 -75736374)
2016,Enero,Estados Unidos de América,2349,5384,,7733,POINT (6170465 -7542726)
2016,Enero,Estados Unidos de América,39,70,,109,POINT (7128047 -73181317)
2016,Enero,Estados Unidos de América,46,52,,98,POINT (7927233 -72508188)
2016,Enero,Estados Unidos de América,0,18,,18,POINT (9402597 -75681642)
2016,Enero,Estonia,2,5,,7,POINT (4697157 -74140516)
2016,Enero,Filipinas,0,1,,1,POINT (10886686 -74776479)
2016,Enero,Filipinas,2,10,,12,POINT (3451668 -76532004)
2016,Enero,Filipinas,4,6,,10,POINT (4697157 -74140516)
2016,Enero,Filipinas,2,3,,5,POINT (4815189 -75736374)
2016,Enero,Filipinas,0,1,,1,POINT (6170465 -7542726)
2016,Enero,Finlandia,0,3,,3,POINT (10886686 -74776479)
2016,Enero,Finlandia,1,1,,2,POINT (3451668 -76532004)
2016,Enero,Finlandia,5,16,,21,POINT (4697157 -74140516)
2016,Enero,Finlandia,1,1,,2,POINT (6170465 -7542726)
2016,Enero,Francia,0,6,,6,POINT (10406342 -75527794)
2016,Enero,Francia,0,1,,1,POINT (10446304 -75516486)
2016,Enero,Francia,4,1,,5,POINT (10886686 -74776479)
2016,Enero,Francia,40,48,,88,POINT (3451668 -76532004)
2016,Enero,Francia,1579,2277,,3856,POINT (4697157 -74140516)
2016,Enero,Francia,1,6,,7,POINT (4815189 -75736374)
2016,Enero,Francia,39,54,,93,POINT (6170465 -7542726)
2016,Enero,Francia,1,0,,1,POINT (7128047 -73181317)
2016,Enero,Gibraltar/Territorio Británico de Ultramar,1,0,,1,POINT (0.81488 -77356)
2016,Enero,Grecia,2,3,,5,POINT (3451668 -76532004)
2016,Enero,Grecia,2,7,,9,POINT (4697157 -74140516)
2016,Enero,Grecia,0,1,,1,POINT (7927233 -72508188)
2016,Enero,Guatemala,0,2,,2,POINT (10406342 -75527794)
2016,Enero,Guatemala,3,5,,8,POINT (10446304 -75516486)
2016,Enero,Guatemala,2,7,,9,POINT (10886686 -74776479)
2016,Enero,Guatemala,6,3,,9,POINT (125862 -81702165)
2016,Enero,Guatemala,1,1,,2,POINT (133387613 -81372937)
2016,Enero,Guatemala,19,46,,65,POINT (3451668 -76532004)
2016,Enero,Guatemala,264,423,,687,POINT (4697157 -74140516)
2016,Enero,Guatemala,3,4,,7,POINT (4815189 -75736374)
2016,Enero,Guatemala,57,129,,186,POINT (6170465 -7542726)
2016,Enero,Guatemala,5,6,,11,POINT (7128047 -73181317)
2016,Enero,Guatemala,2,1,,3,POINT (7927233 -72508188)
2016,Enero,Guyana,0,6,,6,POINT (10406342 -75527794)
2016,Enero,Guyana,1,0,,1,POINT (10886686 -74776479)
2016,Enero,Guyana,2,1,,3,POINT (3451668 -76532004)
2016,Enero,Guyana,1,3,,4,POINT (4697157 -74140516)
2016,Enero,Guinea,1,0,,1,POINT (0.81488 -77356)
2016,Enero,Guinea Ecuatorial,0,1,,1,POINT (4697157 -74140516)
2016,Enero,Guadalupe/Territorio Francés,3,4,,7,POINT (4697157 -74140516)
2016,Enero,Guadalupe/Territorio Francés,0,1,,1,POINT (6170465 -7542726)
2016,Enero,Guayana Francesa/Departamento de Ultramar Francés,0,1,,1,POINT (4697157 -74140516)
2016,Enero,Guayana Francesa/Departamento de Ultramar Francés,0,1,,1,POINT (6170465 -7542726)
2016,Enero,Haití,0,3,,3,POINT (10406342 -75527794)
2016,Enero,Haití,3,7,,10,POINT (4697157 -74140516)
2016,Enero,Haití,1,1,,2,POINT (6170465 -7542726)
2016,Enero,Honduras,3,6,,9,POINT (10446304 -75516486)
2016,Enero,Honduras,1,1,,2,POINT (10886686 -74776479)
2016,Enero,Honduras,0,2,,2,POINT (11247723 -74213989)
2016,Enero,Honduras,6,3,,9,POINT (125744111 -81703935)
2016,Enero,Honduras,7,10,,17,POINT (133387613 -81372937)
2016,Enero,Honduras,13,18,,31,POINT (3451668 -76532004)
2016,Enero,Honduras,39,51,,90,POINT (4697157 -74140516)
2016,Enero,Honduras,2,1,,3,POINT (4815189 -75736374)
2016,Enero,Honduras,41,61,,102,POINT (6170465 -7542726)
2016,Enero,Honduras,1,0,,1,POINT (7128047 -73181317)
2016,Enero,Honduras,1,0,,1,POINT (7927233 -72508188)
2016,Enero,Hong Kong,3,7,,10,POINT (4697157 -74140516)
2016,Enero,Hong Kong,0,1,,1,POINT (6170465 -7542726)
2016,Enero,Hungría,1,0,,1,POINT (3451668 -76532004)
2016,Enero,Hungría,3,3,,6,POINT (4697157 -74140516)
2016,Enero,India,2,6,,8,POINT (3451668 -76532004)
2016,Enero,India,4,32,,36,POINT (4697157 -74140516)
2016,Enero,India,2,22,,24,POINT (6170465 -7542726)
2016,Enero,India,0,2,,2,POINT (7927233 -72508188)
2016,Enero,Indonesia,1,1,,2,POINT (4697157 -74140516)
2016,Enero,Irán,0,1,,1,POINT (3451668 -76532004)
2016,Enero,Irán,2,1,,3,POINT (4697157 -74140516)
2016,Enero,República de Irlanda,0,1,,1,POINT (10446304 -75516486)
2016,Enero,República de Irlanda,2,1,,3,POINT (10886686 -74776479)
2016,Enero,República de Irlanda,1,2,,3,POINT (3451668 -76532004)
2016,Enero,República de Irlanda,12,10,,22,POINT (4697157 -74140516)
2016,Enero,República de Irlanda,0,1,,1,POINT (6170465 -7542726)
2016,Enero,Islandia,1,0,,1,POINT (4697157 -74140516)
2016,Enero,Israel,2,9,,11,POINT (3451668 -76532004)
2016,Enero,Israel,8,74,,82,POINT (4697157 -74140516)
2016,Enero,Israel,0,7,,7,POINT (6170465 -7542726)
2016,Enero,Italia,2,1,,3,POINT (10886686 -74776479)
2016,Enero,Italia,161,154,,315,POINT (125862 -81702165)
2016,Enero,Italia,36,81,,117,POINT (3451668 -76532004)
2016,Enero,Italia,134,333,,467,POINT (4697157 -74140516)
2016,Enero,Italia,1,1,,2,POINT (4815189 -75736374)
2016,Enero,Italia,19,67,,86,POINT (6170465 -7542726)
2016,Enero,Italia,0,1,,1,POINT (7128047 -73181317)
2016,Enero,Italia,1,0,,1,POINT (7927233 -72508188)
2016,Enero,Jamaica,1,5,,6,POINT (10406342 -75527794)
2016,Enero,Jamaica,0,1,,1,POINT (10886686 -74776479)
2016,Enero,Jamaica,1,2,,3,POINT (3451668 -76532004)
2016,Enero,Jamaica,7,7,,14,POINT (4697157 -74140516)
2016,Enero,Jamaica,1,0,,1,POINT (4815189 -75736374)
2016,Enero,Jamaica,0,2,,2,POINT (6170465 -7542726)
2016,Enero,Jamaica,0,1,,1,POINT (806667 -767333)
2016,Enero,Japón,0,3,,3,POINT (3451668 -76532004)
2016,Enero,Japón,8,28,,36,POINT (4697157 -74140516)
2016,Enero,Japón,2,11,,13,POINT (6170465 -7542726)
2016,Enero,Jordania,2,1,,3,POINT (4697157 -74140516)
2016,Enero,Jordania,0,1,,1,POINT (7128047 -73181317)
2016,Enero,Kazajistán,1,2,,3,POINT (3451668 -76532004)
2016,Enero,Kazajistán,1,1,,2,POINT (4697157 -74140516)
2016,Enero,Kenia,0,1,,1,POINT (3451668 -76532004)
2016,Enero,Kenia,0,2,,2,POINT (4697157 -74140516)
2016,Enero,Letonia,0,3,,3,POINT (4697157 -74140516)
2016,Enero,Lituania,0,1,,1,POINT (3451668 -76532004)
2016,Enero,Lituania,5,2,,7,POINT (4697157 -74140516)
2016,Enero,Líbano,2,4,,6,POINT (4697157 -74140516)
2016,Enero,Luxemburgo,3,3,,6,POINT (4697157 -74140516)
2016,Enero,Macedonia,1,0,,1,POINT (3451668 -76532004)
2016,Enero,Madagascar,0,1,,1,POINT (4697157 -74140516)
2016,Enero,Malasia,1,2,,3,POINT (4697157 -74140516)
2016,Enero,Malasia,1,0,,1,POINT (6170465 -7542726)
2016,Enero,Malasia,0,1,,1,POINT (7927233 -72508188)
2016,Enero,Malí,0,2,,2,POINT (4697157 -74140516)
2016,Enero,Malta,1,2,,3,POINT (4697157 -74140516)
2016,Enero,Marruecos,0,4,,4,POINT (4697157 -74140516)
2016,Enero,Marruecos,0,1,,1,POINT (6170465 -7542726)
2016,Enero,México,13,37,,50,POINT (10446304 -75516486)
2016,Enero,México,21,14,,35,POINT (10886686 -74776479)
2016,Enero,México,0,6,,6,POINT (125744111 -81703935)
2016,Enero,México,7,7,,14,POINT (125862 -81702165)
2016,Enero,México,49,103,,152,POINT (3451668 -76532004)
2016,Enero,México,4462,7069,,11531,POINT (4697157 -74140516)
2016,Enero,México,7,24,,31,POINT (4815189 -75736374)
2016,Enero,México,453,1065,,1518,POINT (6170465 -7542726)
2016,Enero,México,19,23,,42,POINT (7128047 -73181317)
2016,Enero,México,20,16,,36,POINT (7927233 -72508188)
2016,Enero,Nicaragua,0,8,,8,POINT (10446304 -75516486)
2016,Enero,Nicaragua,1,3,,4,POINT (10886686 -74776479)
2016,Enero,Nicaragua,0,2,,2,POINT (125862 -81702165)
2016,Enero,Nicaragua,9,4,,13,POINT (3451668 -76532004)
2016,Enero,Nicaragua,29,57,,86,POINT (4697157 -74140516)
2016,Enero,Nicaragua,3,5,,8,POINT (4815189 -75736374)
2016,Enero,Nicaragua,5,7,,12,POINT (6170465 -7542726)
2016,Enero,Nicaragua,3,0,,3,POINT (7128047 -73181317)
2016,Enero,Nicaragua,2,1,,3,POINT (7927233 -72508188)
2016,Enero,Nigeria,0,7,,7,POINT (4697157 -74140516)
2016,Enero,Níger,0,1,,1,POINT (4697157 -74140516)
2016,Enero,Noruega,0,1,,1,POINT (10886686 -74776479)
2016,Enero,Noruega,2,4,,6,POINT (3451668 -76532004)
2016,Enero,Noruega,12,24,,36,POINT (4697157 -74140516)
2016,Enero,Noruega,6,6,,12,POINT (6170465 -7542726)
2016,Enero,Noruega,0,1,,1,POINT (7927233 -72508188)
2016,Enero,Nueva Zelanda,0,1,,1,POINT (10886686 -74776479)
2016,Enero,Nueva Zelanda,1,2,,3,POINT (3451668 -76532004)
2016,Enero,Nueva Zelanda,5,4,,9,POINT (4697157 -74140516)
2016,Enero,Nueva Zelanda,1,3,,4,POINT (6170465 -7542726)
2016,Enero,Pakistán,0,1,,1,POINT (6170465 -7542726)
2016,Enero,Panamá,1549,1297,,2846,POINT (10406342 -75527794)
2016,Enero,Panamá,2880,3177,,6057,POINT (10446304 -75516486)
2016,Enero,Panamá,298,553,,851,POINT (10886686 -74776479)
2016,Enero,Panamá,1,43,,44,POINT (10970933 -74765343)
2016,Enero,Panamá,1,4,,5,POINT (11247723 -74213989)
2016,Enero,Panamá,4,11,,15,POINT (125744111 -81703935)
2016,Enero,Panamá,306,297,,603,POINT (125862 -81702165)
2016,Enero,Panamá,30,27,,57,POINT (133387613 -81372937)
2016,Enero,Panamá,305,502,,807,POINT (3451668 -76532004)
2016,Enero,Panamá,0,22,,22,POINT (3884426 -77061029)
2016,Enero,Panamá,115,170,,285,POINT (445285 -75766353)
2016,Enero,Panamá,3920,5518,,9438,POINT (4697157 -74140516)
2016,Enero,Panamá,63,107,,170,POINT (4815189 -75736374)
2016,Enero,Panamá,1670,2493,,4163,POINT (6170465 -7542726)
2016,Enero,Panamá,3,3,,6,POINT (7102626 -77762647)
2016,Enero,Panamá,23,36,,59,POINT (7128047 -73181317)
2016,Enero,Panamá,64,80,,144,POINT (7927233 -72508188)
2016,Enero,Panamá,0,4,,4,POINT (806667 -767333)
2016,Enero,Panamá,160,245,,405,POINT (863337 -7735002)
2016,Enero,Paraguay,1,0,,1,POINT (0.81488 -77356)
2016,Enero,Paraguay,2,1,,3,POINT (10446304 -75516486)
2016,Enero,Paraguay,1,6,,7,POINT (10886686 -74776479)
2016,Enero,Paraguay,106,70,,176,POINT (125862 -81702165)
2016,Enero,Paraguay,6,5,,11,POINT (3451668 -76532004)
2016,Enero,Paraguay,71,70,,141,POINT (4697157 -74140516)
2016,Enero,Paraguay,2,1,,3,POINT (4815189 -75736374)
2016,Enero,Paraguay,12,13,,25,POINT (6170465 -7542726)
2016,Enero,Paraguay,0,1,,1,POINT (7927233 -72508188)
2016,Enero,Perú,97,126,,223,POINT (-4191162 -69941498)
2016,Enero,Perú,1,1,,2,POINT (-4214082 -69941431)
2016,Enero,Perú,0,10,,10,POINT (0.81488 -77356)
2016,Enero,Perú,0,3,,3,POINT (1800143 -78802679)
2016,Enero,Perú,0,3,,3,POINT (10406342 -75527794)
2016,Enero,Perú,10,10,,20,POINT (10446304 -75516486)
2016,Enero,Perú,9,15,,24,POINT (10886686 -74776479)
2016,Enero,Perú,0,1,,1,POINT (11247723 -74213989)
2016,Enero,Perú,169,117,,286,POINT (125862 -81702165)
2016,Enero,Perú,299,400,,699,POINT (3451668 -76532004)
2016,Enero,Perú,0,1,,1,POINT (3884426 -77061029)
2016,Enero,Perú,6499,7883,,14382,POINT (4697157 -74140516)
2016,Enero,Perú,4,3,,7,POINT (4815189 -75736374)
2016,Enero,Perú,377,643,,1020,POINT (6170465 -7542726)
2016,Enero,Perú,2,5,,7,POINT (7128047 -73181317)
2016,Enero,Perú,6,0,,6,POINT (7927233 -72508188)
2016,Enero,Polonia,6,13,,19,POINT (3451668 -76532004)
2016,Enero,Polonia,11,23,,34,POINT (4697157 -74140516)
2016,Enero,Polonia,2,1,,3,POINT (6170465 -7542726)
2016,Enero,Portugal,2,1,,3,POINT (3451668 -76532004)
2016,Enero,Portugal,475,740,,1215,POINT (4697157 -74140516)
2016,Enero,Portugal,3,7,,10,POINT (6170465 -7542726)
2016,Enero,Polinesia Francesa/Colectividad de Ultramar Francesa,0,1,,1,POINT (4697157 -74140516)
2016,Enero,Polinesia Francesa/Colectividad de Ultramar Francesa,2,0,,2,POINT (6170465 -7542726)
2016,Enero,Puerto Rico/Territorio de Estados Unidos,0,8,,8,POINT (10446304 -75516486)
2016,Enero,Puerto Rico/Territorio de Estados Unidos,11,41,,52,POINT (10886686 -74776479)
2016,Enero,Puerto Rico/Territorio de Estados Unidos,0,3,,3,POINT (11247723 -74213989)
2016,Enero,Puerto Rico/Territorio de Estados Unidos,1,1,,2,POINT (133387613 -81372937)
2016,Enero,Puerto Rico/Territorio de Estados Unidos,15,33,,48,POINT (3451668 -76532004)
2016,Enero,Puerto Rico/Territorio de Estados Unidos,150,251,,401,POINT (4697157 -74140516)
2016,Enero,Puerto Rico/Territorio de Estados Unidos,5,38,,43,POINT (4815189 -75736374)
2016,Enero,Puerto Rico/Territorio de Estados Unidos,19,59,,78,POINT (6170465 -7542726)
2016,Enero,Puerto Rico/Territorio de Estados Unidos,2,5,,7,POINT (7128047 -73181317)
2016,Enero,Puerto Rico/Territorio de Estados Unidos,1,2,,3,POINT (7927233 -72508188)
2016,Enero,Reino Unido de Gran Bretaña e Irlanda del Norte,283,249,,532,POINT (10446304 -75516486)
2016,Enero,Reino Unido de Gran Bretaña e Irlanda del Norte,33,60,,93,POINT (10886686 -74776479)
2016,Enero,Reino Unido de Gran Bretaña e Irlanda del Norte,19,30,,49,POINT (3451668 -76532004)
2016,Enero,Reino Unido de Gran Bretaña e Irlanda del Norte,982,1579,,2561,POINT (4697157 -74140516)
2016,Enero,Reino Unido de Gran Bretaña e Irlanda del Norte,9,28,,37,POINT (6170465 -7542726)
2016,Enero,República CentroÁfricana,1,0,,1,POINT (4697157 -74140516)
2016,Enero,Federación de Rusia,2,1,,3,POINT (3451668 -76532004)
2016,Enero,Federación de Rusia,56,70,,126,POINT (4697157 -74140516)
2016,Enero,Federación de Rusia,2,1,,3,POINT (6170465 -7542726)
2016,Enero,República Dominicana,2,4,,6,POINT (10406342 -75527794)
2016,Enero,República Dominicana,1,6,,7,POINT (10446304 -75516486)
2016,Enero,República Dominicana,4,6,,10,POINT (10886686 -74776479)
2016,Enero,República Dominicana,0,2,,2,POINT (11117206 -74232675)
2016,Enero,República Dominicana,2,3,,5,POINT (125862 -81702165)
2016,Enero,República Dominicana,22,30,,52,POINT (3451668 -76532004)
2016,Enero,República Dominicana,626,898,,1524,POINT (4697157 -74140516)
2016,Enero,República Dominicana,5,7,,12,POINT (4815189 -75736374)
2016,Enero,República Dominicana,38,62,,100,POINT (6170465 -7542726)
2016,Enero,República Dominicana,6,31,,37,POINT (7128047 -73181317)
2016,Enero,República Dominicana,1,1,,2,POINT (7927233 -72508188)
2016,Enero,Reunión,2,1,,3,POINT (4697157 -74140516)
2016,Enero,Rumania,9,19,,28,POINT (4697157 -74140516)
2016,Enero,San Marino,1,2,,3,POINT (4697157 -74140516)
2016,Enero,San  Vicente y las Granadinas,0,1,,1,POINT (10446304 -75516486)
2016,Enero,Santa Lucia,1,2,,3,POINT (10970933 -74765343)
2016,Enero,Santa Lucia,30,45,,75,POINT (11247723 -74213989)
2016,Enero,Santa Lucia,0,1,,1,POINT (4697157 -74140516)
2016,Enero,Santa Lucia,1,0,,1,POINT (7927233 -72508188)
2016,Enero,Santa Sede/Ciudad del Vaticano,0,1,,1,POINT (3451668 -76532004)
2016,Enero,Santo Tomé y Príncipe,1,0,,1,POINT (4697157 -74140516)
2016,Enero,Serbia,1,1,,2,POINT (4697157 -74140516)
2016,Enero,Seychelles,0,3,,3,POINT (11247723 -74213989)
2016,Enero,Singapur,1,2,,3,POINT (4697157 -74140516)
2016,Enero,Singapur,0,1,,1,POINT (6170465 -7542726)
2016,Enero,Sudáfrica,0,2,,2,POINT (10970933 -74765343)
2016,Enero,Sudáfrica,4,10,,14,POINT (4697157 -74140516)
2016,Enero,Sudáfrica,0,1,,1,POINT (6170465 -7542726)
2016,Enero,Suecia,0,1,,1,POINT (10886686 -74776479)
2016,Enero,Suecia,8,14,,22,POINT (3451668 -76532004)
2016,Enero,Suecia,25,45,,70,POINT (4697157 -74140516)
2016,Enero,Suecia,7,7,,14,POINT (6170465 -7542726)
2016,Enero,Suecia,0,1,,1,POINT (7128047 -73181317)
2016,Enero,Suiza,0,1,,1,POINT (10446304 -75516486)
2016,Enero,Suiza,2,0,,2,POINT (10886686 -74776479)
2016,Enero,Suiza,1,1,,2,POINT (125862 -81702165)
2016,Enero,Suiza,18,36,,54,POINT (3451668 -76532004)
2016,Enero,Suiza,83,126,,209,POINT (4697157 -74140516)
2016,Enero,Suiza,1,2,,3,POINT (4815189 -75736374)
2016,Enero,Suiza,12,23,,35,POINT (6170465 -7542726)
2016,Enero,Surinam,0,1,,1,POINT (10886686 -74776479)
2016,Enero,Surinam,3,5,,8,POINT (4697157 -74140516)
2016,Enero,Surinam,2,1,,3,POINT (6170465 -7542726)
2016,Enero,Taiwán,1,0,,1,POINT (3451668 -76532004)
2016,Enero,Taiwán,4,7,,11,POINT (4697157 -74140516)
2016,Enero,Taiwán,1,5,,6,POINT (6170465 -7542726)
2016,Enero,Tailandia,2,2,,4,POINT (4697157 -74140516)
2016,Enero,Trinidad y Tobago,0,8,,8,POINT (10406342 -75527794)
2016,Enero,Trinidad y Tobago,1,1,,2,POINT (10886686 -74776479)
2016,Enero,Trinidad y Tobago,2,11,,13,POINT (3451668 -76532004)
2016,Enero,Trinidad y Tobago,3,14,,17,POINT (4697157 -74140516)
2016,Enero,Trinidad y Tobago,0,2,,2,POINT (4815189 -75736374)
2016,Enero,Trinidad y Tobago,0,9,,9,POINT (6170465 -7542726)
2016,Enero,Trinidad y Tobago,0,1,,1,POINT (7927233 -72508188)
2016,Enero,Turkmenistán,0,1,,1,POINT (3451668 -76532004)
2016,Enero,Turquía,0,3,,3,POINT (3451668 -76532004)
2016,Enero,Turquía,5,14,,19,POINT (4697157 -74140516)
2016,Enero,Turquía,0,5,,5,POINT (6170465 -7542726)
2016,Enero,Ucrania,1,6,,7,POINT (4697157 -74140516)
2016,Enero,Ucrania,1,0,,1,POINT (6170465 -7542726)
2016,Enero,Uruguay,1,0,,1,POINT (0.81488 -77356)
2016,Enero,Uruguay,2,0,,2,POINT (10446304 -75516486)
2016,Enero,Uruguay,2,4,,6,POINT (10886686 -74776479)
2016,Enero,Uruguay,37,14,,51,POINT (125862 -81702165)
2016,Enero,Uruguay,23,24,,47,POINT (3451668 -76532004)
2016,Enero,Uruguay,69,119,,188,POINT (4697157 -74140516)
2016,Enero,Uruguay,0,1,,1,POINT (4815189 -75736374)
2016,Enero,Uruguay,35,43,,78,POINT (6170465 -7542726)
2016,Enero,Uruguay,5,0,,5,POINT (7927233 -72508188)
2016,Enero,Venezuela,0,42,,42,POINT (10406342 -75527794)
2016,Enero,Venezuela,61,88,,149,POINT (10446304 -75516486)
2016,Enero,Venezuela,14,47,,61,POINT (10886686 -74776479)
2016,Enero,Venezuela,1,5,,6,POINT (11117206 -74232675)
2016,Enero,Venezuela,244,414,,658,POINT (11360029 -72129595)
2016,Enero,Venezuela,1,2,,3,POINT (125862 -81702165)
2016,Enero,Venezuela,22,46,,68,POINT (3451668 -76532004)
2016,Enero,Venezuela,36,47,,83,POINT (3866713 -67927521)
2016,Enero,Venezuela,3445,3845,,7290,POINT (4697157 -74140516)
2016,Enero,Venezuela,5,9,,14,POINT (4815189 -75736374)
2016,Enero,Venezuela,719,716,,1435,POINT (6170465 -7542726)
2016,Enero,Venezuela,32,81,,113,POINT (6185536 -67484028)
2016,Enero,Venezuela,43,80,,123,POINT (7088729 -70740253)
2016,Enero,Venezuela,12,15,,27,POINT (7128047 -73181317)
2016,Enero,Venezuela,2721,3401,,6122,POINT (7819 -72453013)
2016,Enero,Venezuela,159,225,,384,POINT (7927233 -72508188)
2016,Enero,Vietnam,0,1,,1,POINT (4697157 -74140516)
2016,Enero,Islas Vírgenes Estadounidenses/Territorio de Estados Unidos,0,5,,5,POINT (10406342 -75527794)
2016,Enero,Islas Turcas y Caicos/Territorio Británico de Ultramar,3,1,,4,POINT (11247723 -74213989)
2016,Enero,Desconocido,0,1,,1,POINT (4697157 -74140516)
2016,Febrero,Afganistán,1,2,,3,POINT (4697157 -74140516)
2016,Febrero,Alemania,0,2,,2,POINT (10446304 -75516486)
2016,Febrero,Alemania,2,3,,5,POINT (10886686 -74776479)
2016,Febrero,Alemania,55,69,,124,POINT (3451668 -76532004)
2016,Febrero,Alemania,1463,2295,,3758,POINT (4697157 -74140516)
2016,Febrero,Alemania,0,1,,1,POINT (4815189 -75736374)
2016,Febrero,Alemania,23,40,,63,POINT (6170465 -7542726)
2016,Febrero,Alemania,0,1,,1,POINT (7128047 -73181317)
2016,Febrero,Andorra,0,1,,1,POINT (3451668 -76532004)
2016,Febrero,Andorra,0,1,,1,POINT (4697157 -74140516)
2016,Febrero,Antigua y Barbuda,0,6,,6,POINT (10406342 -75527794)
2016,Febrero,Antigua y Barbuda,1,5,,6,POINT (10446304 -75516486)
2016,Febrero,Antigua y Barbuda,1,1,,2,POINT (4697157 -74140516)
2016,Febrero,Países Bajos,57,117,,174,POINT (10406342 -75527794)
2016,Febrero,Países Bajos,3,6,,9,POINT (10446304 -75516486)
2016,Febrero,Países Bajos,55,91,,146,POINT (10886686 -74776479)
2016,Febrero,Países Bajos,3,10,,13,POINT (11247723 -74213989)
2016,Febrero,Países Bajos,57,136,,193,POINT (3451668 -76532004)
2016,Febrero,Países Bajos,914,1252,,2166,POINT (4697157 -74140516)
2016,Febrero,Países Bajos,1,6,,7,POINT (4815189 -75736374)
2016,Febrero,Países Bajos,176,226,,402,POINT (6170465 -7542726)
2016,Febrero,Países Bajos,0,2,,2,POINT (7128047 -73181317)
2016,Febrero,Arabia Saudita,0,1,,1,POINT (4697157 -74140516)
2016,Febrero,Argelia,0,1,,1,POINT (3451668 -76532004)
2016,Febrero,Argelia,0,1,,1,POINT (4697157 -74140516)
2016,Febrero,Argentina,11,20,,31,POINT (0.81488 -77356)
2016,Febrero,Argentina,31,21,,52,POINT (10446304 -75516486)
2016,Febrero,Argentina,13,11,,24,POINT (10886686 -74776479)
2016,Febrero,Argentina,312,238,,550,POINT (125862 -81702165)
2016,Febrero,Argentina,86,137,,223,POINT (3451668 -76532004)
2016,Febrero,Argentina,2779,3361,,6140,POINT (4697157 -74140516)
2016,Febrero,Argentina,1,3,,4,POINT (4815189 -75736374)
2016,Febrero,Argentina,86,121,,207,POINT (6170465 -7542726)
2016,Febrero,Argentina,1,1,,2,POINT (7128047 -73181317)
2016,Febrero,Argentina,2,1,,3,POINT (7927233 -72508188)
2016,Febrero,República de Armenia,0,1,,1,POINT (4697157 -74140516)
2016,Febrero,Aruba,5,6,,11,POINT (10406342 -75527794)
2016,Febrero,Aruba,0,2,,2,POINT (10446304 -75516486)
2016,Febrero,Aruba,1,5,,6,POINT (10886686 -74776479)
2016,Febrero,Aruba,10,12,,22,POINT (11247723 -74213989)
2016,Febrero,Aruba,6,12,,18,POINT (3451668 -76532004)
2016,Febrero,Aruba,563,740,,1303,POINT (4697157 -74140516)
2016,Febrero,Aruba,5,2,,7,POINT (4815189 -75736374)
2016,Febrero,Aruba,18,14,,32,POINT (6170465 -7542726)
2016,Febrero,Aruba,7,7,,14,POINT (7128047 -73181317)
2016,Febrero,Australia,1,1,,2,POINT (10446304 -75516486)
2016,Febrero,Australia,0,1,,1,POINT (10886686 -74776479)
2016,Febrero,Australia,0,1,,1,POINT (125862 -81702165)
2016,Febrero,Australia,4,11,,15,POINT (3451668 -76532004)
2016,Febrero,Australia,22,36,,58,POINT (4697157 -74140516)
2016,Febrero,Australia,1,0,,1,POINT (4815189 -75736374)
2016,Febrero,Australia,14,23,,37,POINT (6170465 -7542726)
2016,Febrero,Austria,2,0,,2,POINT (10886686 -74776479)
2016,Febrero,Austria,3,4,,7,POINT (3451668 -76532004)
2016,Febrero,Austria,34,56,,90,POINT (4697157 -74140516)
2016,Febrero,Austria,1,5,,6,POINT (6170465 -7542726)
2016,Febrero,Bahamas,0,2,,2,POINT (3451668 -76532004)
2016,Febrero,Bahamas,2,11,,13,POINT (4697157 -74140516)
2016,Febrero,Bahamas,1,1,,2,POINT (6170465 -7542726)
2016,Febrero,Bahréin,2,1,,3,POINT (4697157 -74140516)
2016,Febrero,Bahréin,0,1,,1,POINT (6170465 -7542726)
2016,Febrero,Barbados,0,2,,2,POINT (10446304 -75516486)
2016,Febrero,Barbados,1,4,,5,POINT (10886686 -74776479)
2016,Febrero,Barbados,0,1,,1,POINT (3451668 -76532004)
2016,Febrero,Barbados,33,38,,71,POINT (4697157 -74140516)
2016,Febrero,República de Belarús,5,16,,21,POINT (4697157 -74140516)
2016,Febrero,Bélgica,0,1,,1,POINT (11247723 -74213989)
2016,Febrero,Bélgica,1,0,,1,POINT (125862 -81702165)
2016,Febrero,Bélgica,5,12,,17,POINT (3451668 -76532004)
2016,Febrero,Bélgica,31,60,,91,POINT (4697157 -74140516)
2016,Febrero,Bélgica,9,6,,15,POINT (6170465 -7542726)
2016,Febrero,Belice,0,1,,1,POINT (10886686 -74776479)
2016,Febrero,Belice,1,1,,2,POINT (125862 -81702165)
2016,Febrero,Belice,1,3,,4,POINT (4697157 -74140516)
2016,Febrero,Belice,0,1,,1,POINT (6170465 -7542726)
2016,Febrero,Benín,1,0,,1,POINT (4697157 -74140516)
2016,Febrero,Benín,0,1,,1,POINT (6170465 -7542726)
2016,Febrero,Bolivia,1,0,,1,POINT (0.81488 -77356)
2016,Febrero,Bolivia,2,2,,4,POINT (10446304 -75516486)
2016,Febrero,Bolivia,1,0,,1,POINT (10886686 -74776479)
2016,Febrero,Bolivia,24,26,,50,POINT (125862 -81702165)
2016,Febrero,Bolivia,35,28,,63,POINT (3451668 -76532004)
2016,Febrero,Bolivia,419,505,,924,POINT (4697157 -74140516)
2016,Febrero,Bolivia,2,5,,7,POINT (4815189 -75736374)
2016,Febrero,Bolivia,39,45,,84,POINT (6170465 -7542726)
2016,Febrero,Bosnia y Herzegovina,1,0,,1,POINT (4697157 -74140516)
2016,Febrero,Botsuana,0,1,,1,POINT (4697157 -74140516)
2016,Febrero,Brasil,123,158,,281,POINT (-4191162 -69941498)
2016,Febrero,Brasil,2,10,,12,POINT (-4214082 -69941431)
2016,Febrero,Brasil,1,1,,2,POINT (0.81488 -77356)
2016,Febrero,Brasil,0,2,,2,POINT (10406342 -75527794)
2016,Febrero,Brasil,43,29,,72,POINT (10446304 -75516486)
2016,Febrero,Brasil,12,15,,27,POINT (10886686 -74776479)
2016,Febrero,Brasil,0,6,,6,POINT (10970933 -74765343)
2016,Febrero,Brasil,418,342,,760,POINT (125862 -81702165)
2016,Febrero,Brasil,126,151,,277,POINT (3451668 -76532004)
2016,Febrero,Brasil,0,1,,1,POINT (3866713 -67927521)
2016,Febrero,Brasil,5429,6632,,12061,POINT (4697157 -74140516)
2016,Febrero,Brasil,1,4,,5,POINT (4815189 -75736374)
2016,Febrero,Brasil,189,246,,435,POINT (6170465 -7542726)
2016,Febrero,Brasil,0,2,,2,POINT (7128047 -73181317)
2016,Febrero,Brasil,0,1,,1,POINT (7927233 -72508188)
2016,Febrero,Bulgaria,2,3,,5,POINT (4697157 -74140516)
2016,Febrero,Islas Caimán/Territorio Británico de Ultramar,2,1,,3,POINT (10406342 -75527794)
2016,Febrero,Islas Caimán/Territorio Británico de Ultramar,1,0,,1,POINT (3451668 -76532004)
2016,Febrero,Islas Caimán/Territorio Británico de Ultramar,0,12,,12,POINT (4697157 -74140516)
2016,Febrero,Islas Caimán/Territorio Británico de Ultramar,0,1,,1,POINT (6170465 -7542726)
2016,Febrero,Canadá,321,323,,644,POINT (10446304 -75516486)
2016,Febrero,Canadá,4,10,,14,POINT (10886686 -74776479)
2016,Febrero,Canadá,327,304,,631,POINT (125862 -81702165)
2016,Febrero,Canadá,36,44,,80,POINT (3451668 -76532004)
2016,Febrero,Canadá,674,1066,,1740,POINT (4697157 -74140516)
2016,Febrero,Canadá,0,2,,2,POINT (4815189 -75736374)
2016,Febrero,Canadá,91,138,,229,POINT (6170465 -7542726)
2016,Febrero,Canadá,3,2,,5,POINT (7927233 -72508188)
2016,Febrero,España,1,1,,2,POINT (10406342 -75527794)
2016,Febrero,España,4,5,,9,POINT (10446304 -75516486)
2016,Febrero,España,1,2,,3,POINT (10886686 -74776479)
2016,Febrero,España,348,586,,934,POINT (3451668 -76532004)
2016,Febrero,España,2800,5126,,7926,POINT (4697157 -74140516)
2016,Febrero,España,4,5,,9,POINT (4815189 -75736374)
2016,Febrero,España,201,354,,555,POINT (6170465 -7542726)
2016,Febrero,España,0,1,,1,POINT (7128047 -73181317)
2016,Febrero,España,0,1,,1,POINT (806667 -767333)
2016,Febrero,España,0,1,,1,POINT (9402597 -75681642)
2016,Febrero,República de Corea,1,0,,1,POINT (3451668 -76532004)
2016,Febrero,República de Corea,11,13,,24,POINT (4697157 -74140516)
2016,Febrero,República de Corea,3,3,,6,POINT (6170465 -7542726)
2016,Febrero,República de Corea,0,1,,1,POINT (7128047 -73181317)
2016,Febrero,República de Corea,0,1,,1,POINT (7927233 -72508188)
2016,Febrero,Costa de Marfil,1,0,,1,POINT (10406342 -75527794)
2016,Febrero,Costa de Marfil,4,4,,8,POINT (4697157 -74140516)
2016,Febrero,Costa Rica,2,10,,12,POINT (10406342 -75527794)
2016,Febrero,Costa Rica,0,1,,1,POINT (10446304 -75516486)
2016,Febrero,Costa Rica,6,14,,20,POINT (10886686 -74776479)
2016,Febrero,Costa Rica,0,5,,5,POINT (125744111 -81703935)
2016,Febrero,Costa Rica,112,99,,211,POINT (125862 -81702165)
2016,Febrero,Costa Rica,19,40,,59,POINT (3451668 -76532004)
2016,Febrero,Costa Rica,778,1326,,2104,POINT (4697157 -74140516)
2016,Febrero,Costa Rica,2,11,,13,POINT (4815189 -75736374)
2016,Febrero,Costa Rica,57,92,,149,POINT (6170465 -7542726)
2016,Febrero,Costa Rica,0,1,,1,POINT (7128047 -73181317)
2016,Febrero,Costa Rica,0,2,,2,POINT (7927233 -72508188)
2016,Febrero,Croacia,0,8,,8,POINT (11247723 -74213989)
2016,Febrero,Croacia,4,2,,6,POINT (4697157 -74140516)
2016,Febrero,Croacia,2,1,,3,POINT (6170465 -7542726)
2016,Febrero,Cuba,0,7,,7,POINT (10406342 -75527794)
2016,Febrero,Cuba,92,70,,162,POINT (10446304 -75516486)
2016,Febrero,Cuba,2,5,,7,POINT (10886686 -74776479)
2016,Febrero,Cuba,1,0,,1,POINT (125862 -81702165)
2016,Febrero,Cuba,5,8,,13,POINT (3451668 -76532004)
2016,Febrero,Cuba,288,375,,663,POINT (4697157 -74140516)
2016,Febrero,Cuba,0,1,,1,POINT (4815189 -75736374)
2016,Febrero,Cuba,14,23,,37,POINT (6170465 -7542726)
2016,Febrero,Cuba,0,2,,2,POINT (7128047 -73181317)
2016,Febrero,Cuba,1,1,,2,POINT (7927233 -72508188)
2016,Febrero,Curazao,1,2,,3,POINT (4697157 -74140516)
2016,Febrero,República Checa,5,17,,22,POINT (4697157 -74140516)
2016,Febrero,República Checa,1,0,,1,POINT (6170465 -7542726)
2016,Febrero,Chile,24,23,,47,POINT (0.81488 -77356)
2016,Febrero,Chile,29,19,,48,POINT (10446304 -75516486)
2016,Febrero,Chile,141,93,,234,POINT (125862 -81702165)
2016,Febrero,Chile,85,91,,176,POINT (3451668 -76532004)
2016,Febrero,Chile,4785,5246,,10031,POINT (4697157 -74140516)
2016,Febrero,Chile,4,5,,9,POINT (4815189 -75736374)
2016,Febrero,Chile,63,67,,130,POINT (6170465 -7542726)
2016,Febrero,Chile,1,2,,3,POINT (7128047 -73181317)
2016,Febrero,Chile,1,1,,2,POINT (7927233 -72508188)
2016,Febrero,China,7,5,,12,POINT (10886686 -74776479)
2016,Febrero,China,1,3,,4,POINT (3451668 -76532004)
2016,Febrero,China,26,56,,82,POINT (4697157 -74140516)
2016,Febrero,China,0,1,,1,POINT (6170465 -7542726)
2016,Febrero,Chipre,0,1,,1,POINT (4697157 -74140516)
2016,Febrero,Dinamarca,1,2,,3,POINT (3451668 -76532004)
2016,Febrero,Dinamarca,25,38,,63,POINT (4697157 -74140516)
2016,Febrero,Dinamarca,0,1,,1,POINT (4815189 -75736374)
2016,Febrero,Dinamarca,1,2,,3,POINT (6170465 -7542726)
2016,Febrero,Dominica,0,1,,1,POINT (10446304 -75516486)
2016,Febrero,Dominica,0,2,,2,POINT (4697157 -74140516)
2016,Febrero,Ecuador,0,2,,2,POINT (0.185957 -7478366)
2016,Febrero,Ecuador,92,209,,301,POINT (0.33002 -76876446)
2016,Febrero,Ecuador,0,1,,1,POINT (0.812436 -77847006)
2016,Febrero,Ecuador,3409,4965,,8374,POINT (0.81488 -77356)
2016,Febrero,Ecuador,22,32,,54,POINT (1800143 -78802679)
2016,Febrero,Ecuador,0,1,,1,POINT (10406342 -75527794)
2016,Febrero,Ecuador,4,3,,7,POINT (10446304 -75516486)
2016,Febrero,Ecuador,1,3,,4,POINT (10886686 -74776479)
2016,Febrero,Ecuador,12,9,,21,POINT (125862 -81702165)
2016,Febrero,Ecuador,412,438,,850,POINT (3451668 -76532004)
2016,Febrero,Ecuador,3351,4933,,8284,POINT (4697157 -74140516)
2016,Febrero,Ecuador,2,2,,4,POINT (4815189 -75736374)
2016,Febrero,Ecuador,62,88,,150,POINT (6170465 -7542726)
2016,Febrero,Egipto,0,3,,3,POINT (4697157 -74140516)
2016,Febrero,El Salvador,1,1,,2,POINT (10886686 -74776479)
2016,Febrero,El Salvador,11,9,,20,POINT (125862 -81702165)
2016,Febrero,El Salvador,89,132,,221,POINT (3451668 -76532004)
2016,Febrero,El Salvador,811,1209,,2020,POINT (4697157 -74140516)
2016,Febrero,El Salvador,0,1,,1,POINT (4815189 -75736374)
2016,Febrero,El Salvador,141,242,,383,POINT (6170465 -7542726)
2016,Febrero,Emiratos Árabes,1,5,,6,POINT (4697157 -74140516)
2016,Febrero,Eritrea,1,1,,2,POINT (4697157 -74140516)
2016,Febrero,Eslovaquia,0,2,,2,POINT (3451668 -76532004)
2016,Febrero,Eslovaquia,1,3,,4,POINT (4697157 -74140516)
2016,Febrero,Eslovenia,0,2,,2,POINT (3451668 -76532004)
2016,Febrero,Eslovenia,5,4,,9,POINT (4697157 -74140516)
2016,Febrero,Eslovenia,1,0,,1,POINT (6170465 -7542726)
2016,Febrero,Estados Unidos de América,2,29,,31,POINT (10406342 -75527794)
2016,Febrero,Estados Unidos de América,3786,4969,,8755,POINT (10446304 -75516486)
2016,Febrero,Estados Unidos de América,702,1173,,1875,POINT (10886686 -74776479)
2016,Febrero,Estados Unidos de América,0,11,,11,POINT (10970933 -74765343)
2016,Febrero,Estados Unidos de América,2,2,,4,POINT (11117206 -74232675)
2016,Febrero,Estados Unidos de América,0,22,,22,POINT (11247723 -74213989)
2016,Febrero,Estados Unidos de América,6,20,,26,POINT (125862 -81702165)
2016,Febrero,Estados Unidos de América,817,1323,,2140,POINT (3451668 -76532004)
2016,Febrero,Estados Unidos de América,0,1,,1,POINT (3884426 -77061029)
2016,Febrero,Estados Unidos de América,98,137,,235,POINT (445285 -75766353)
2016,Febrero,Estados Unidos de América,8604,15542,,24146,POINT (4697157 -74140516)
2016,Febrero,Estados Unidos de América,132,170,,302,POINT (4815189 -75736374)
2016,Febrero,Estados Unidos de América,2431,5998,,8429,POINT (6170465 -7542726)
2016,Febrero,Estados Unidos de América,12,17,,29,POINT (7128047 -73181317)
2016,Febrero,Estados Unidos de América,15,17,,32,POINT (7927233 -72508188)
2016,Febrero,Estados Unidos de América,0,29,,29,POINT (9402597 -75681642)
2016,Febrero,Estonia,0,1,,1,POINT (4697157 -74140516)
2016,Febrero,Filipinas,2,3,,5,POINT (10446304 -75516486)
2016,Febrero,Filipinas,0,3,,3,POINT (10886686 -74776479)
2016,Febrero,Filipinas,0,4,,4,POINT (3451668 -76532004)
2016,Febrero,Filipinas,4,10,,14,POINT (4697157 -74140516)
2016,Febrero,Filipinas,0,1,,1,POINT (4815189 -75736374)
2016,Febrero,Finlandia,8,6,,14,POINT (4697157 -74140516)
2016,Febrero,Finlandia,1,0,,1,POINT (6170465 -7542726)
2016,Febrero,Francia,1,2,,3,POINT (10446304 -75516486)
2016,Febrero,Francia,4,5,,9,POINT (10886686 -74776479)
2016,Febrero,Francia,9,9,,18,POINT (125862 -81702165)
2016,Febrero,Francia,35,61,,96,POINT (3451668 -76532004)
2016,Febrero,Francia,1544,2438,,3982,POINT (4697157 -74140516)
2016,Febrero,Francia,4,4,,8,POINT (4815189 -75736374)
2016,Febrero,Francia,25,37,,62,POINT (6170465 -7542726)
2016,Febrero,Georgia,0,2,,2,POINT (4697157 -74140516)
2016,Febrero,Ghana,1,1,,2,POINT (4697157 -74140516)
2016,Febrero,Grecia,2,3,,5,POINT (3451668 -76532004)
2016,Febrero,Grecia,4,16,,20,POINT (4697157 -74140516)
2016,Febrero,Guatemala,3,6,,9,POINT (10446304 -75516486)
2016,Febrero,Guatemala,1,4,,5,POINT (10886686 -74776479)
2016,Febrero,Guatemala,3,5,,8,POINT (125862 -81702165)
2016,Febrero,Guatemala,12,31,,43,POINT (3451668 -76532004)
2016,Febrero,Guatemala,285,569,,854,POINT (4697157 -74140516)
2016,Febrero,Guatemala,15,19,,34,POINT (4815189 -75736374)
2016,Febrero,Guatemala,41,73,,114,POINT (6170465 -7542726)
2016,Febrero,Guatemala,2,6,,8,POINT (7128047 -73181317)
2016,Febrero,Guatemala,4,1,,5,POINT (7927233 -72508188)
2016,Febrero,Guyana,0,1,,1,POINT (6170465 -7542726)
2016,Febrero,Guadalupe/Territorio Francés,1,0,,1,POINT (10446304 -75516486)
2016,Febrero,Guadalupe/Territorio Francés,1,1,,2,POINT (11247723 -74213989)
2016,Febrero,Guadalupe/Territorio Francés,2,5,,7,POINT (4697157 -74140516)
2016,Febrero,Guadalupe/Territorio Francés,1,0,,1,POINT (4815189 -75736374)
2016,Febrero,Guayana Francesa/Departamento de Ultramar Francés,1,0,,1,POINT (7128047 -73181317)
2016,Febrero,Haití,0,14,,14,POINT (10406342 -75527794)
2016,Febrero,Haití,0,1,,1,POINT (3451668 -76532004)
2016,Febrero,Haití,3,2,,5,POINT (4697157 -74140516)
2016,Febrero,Haití,0,1,,1,POINT (6170465 -7542726)
2016,Febrero,Honduras,0,1,,1,POINT (10446304 -75516486)
2016,Febrero,Honduras,1,1,,2,POINT (10886686 -74776479)
2016,Febrero,Honduras,0,9,,9,POINT (125744111 -81703935)
2016,Febrero,Honduras,0,1,,1,POINT (125862 -81702165)
2016,Febrero,Honduras,4,7,,11,POINT (133387613 -81372937)
2016,Febrero,Honduras,8,10,,18,POINT (3451668 -76532004)
2016,Febrero,Honduras,45,56,,101,POINT (4697157 -74140516)
2016,Febrero,Honduras,1,3,,4,POINT (4815189 -75736374)
2016,Febrero,Honduras,15,34,,49,POINT (6170465 -7542726)
2016,Febrero,Hong Kong,3,14,,17,POINT (4697157 -74140516)
2016,Febrero,Hong Kong,1,1,,2,POINT (6170465 -7542726)
2016,Febrero,Hungría,0,1,,1,POINT (3451668 -76532004)
2016,Febrero,Hungría,9,5,,14,POINT (4697157 -74140516)
2016,Febrero,India,0,1,,1,POINT (10446304 -75516486)
2016,Febrero,India,0,1,,1,POINT (10886686 -74776479)
2016,Febrero,India,0,5,,5,POINT (3451668 -76532004)
2016,Febrero,India,6,23,,29,POINT (4697157 -74140516)
2016,Febrero,India,0,1,,1,POINT (4815189 -75736374)
2016,Febrero,India,1,4,,5,POINT (6170465 -7542726)
2016,Febrero,Indonesia,1,6,,7,POINT (4697157 -74140516)
2016,Febrero,República de Irlanda,1,1,,2,POINT (125862 -81702165)
2016,Febrero,República de Irlanda,1,2,,3,POINT (3451668 -76532004)
2016,Febrero,República de Irlanda,10,14,,24,POINT (4697157 -74140516)
2016,Febrero,República de Irlanda,0,1,,1,POINT (6170465 -7542726)
2016,Febrero,Isla de Man,0,1,,1,POINT (6170465 -7542726)
2016,Febrero,Israel,0,1,,1,POINT (10886686 -74776479)
2016,Febrero,Israel,2,1,,3,POINT (3451668 -76532004)
2016,Febrero,Israel,7,47,,54,POINT (4697157 -74140516)
2016,Febrero,Israel,0,6,,6,POINT (6170465 -7542726)
2016,Febrero,Italia,1,2,,3,POINT (10446304 -75516486)
2016,Febrero,Italia,148,137,,285,POINT (125862 -81702165)
2016,Febrero,Italia,21,55,,76,POINT (3451668 -76532004)
2016,Febrero,Italia,122,259,,381,POINT (4697157 -74140516)
2016,Febrero,Italia,12,38,,50,POINT (6170465 -7542726)
2016,Febrero,Jamaica,3,10,,13,POINT (10406342 -75527794)
2016,Febrero,Jamaica,8,6,,14,POINT (10446304 -75516486)
2016,Febrero,Jamaica,3,8,,11,POINT (3451668 -76532004)
2016,Febrero,Jamaica,2,7,,9,POINT (4697157 -74140516)
2016,Febrero,Jamaica,1,0,,1,POINT (4815189 -75736374)
2016,Febrero,Jamaica,3,3,,6,POINT (6170465 -7542726)
2016,Febrero,Japón,1,5,,6,POINT (3451668 -76532004)
2016,Febrero,Japón,8,28,,36,POINT (4697157 -74140516)
2016,Febrero,Japón,1,4,,5,POINT (6170465 -7542726)
2016,Febrero,Japón,0,1,,1,POINT (7128047 -73181317)
2016,Febrero,Jordania,0,1,,1,POINT (4697157 -74140516)
2016,Febrero,Kenia,0,2,,2,POINT (4697157 -74140516)
2016,Febrero,Letonia,2,3,,5,POINT (4697157 -74140516)
2016,Febrero,Lituania,2,3,,5,POINT (4697157 -74140516)
2016,Febrero,Líbano,2,0,,2,POINT (10886686 -74776479)
2016,Febrero,Líbano,4,0,,4,POINT (4697157 -74140516)
2016,Febrero,Luxemburgo,5,1,,6,POINT (4697157 -74140516)
2016,Febrero,Luxemburgo,0,2,,2,POINT (6170465 -7542726)
2016,Febrero,Malasia,6,2,,8,POINT (4697157 -74140516)
2016,Febrero,Malí,0,1,,1,POINT (4697157 -74140516)
2016,Febrero,Malta,1,2,,3,POINT (4697157 -74140516)
2016,Febrero,Marruecos,0,4,,4,POINT (10970933 -74765343)
2016,Febrero,Marruecos,3,0,,3,POINT (3451668 -76532004)
2016,Febrero,Martinica/Departamento de Ultramar Francés,1,1,,2,POINT (10406342 -75527794)
2016,Febrero,Martinica/Departamento de Ultramar Francés,1,1,,2,POINT (133387613 -81372937)
2016,Febrero,México,2,5,,7,POINT (10406342 -75527794)
2016,Febrero,México,5,5,,10,POINT (10446304 -75516486)
2016,Febrero,México,8,27,,35,POINT (10886686 -74776479)
2016,Febrero,México,0,2,,2,POINT (10970933 -74765343)
2016,Febrero,México,1,6,,7,POINT (125862 -81702165)
2016,Febrero,México,39,131,,170,POINT (3451668 -76532004)
2016,Febrero,México,3885,7170,,11055,POINT (4697157 -74140516)
2016,Febrero,México,2,11,,13,POINT (4815189 -75736374)
2016,Febrero,México,278,844,,1122,POINT (6170465 -7542726)
2016,Febrero,México,3,6,,9,POINT (7128047 -73181317)
2016,Febrero,México,9,9,,18,POINT (7927233 -72508188)
2016,Febrero,Mónaco,0,1,,1,POINT (4697157 -74140516)
2016,Febrero,Mozambique,0,1,,1,POINT (4697157 -74140516)
2016,Febrero,Nicaragua,0,1,,1,POINT (10446304 -75516486)
2016,Febrero,Nicaragua,3,8,,11,POINT (10886686 -74776479)
2016,Febrero,Nicaragua,0,1,,1,POINT (125862 -81702165)
2016,Febrero,Nicaragua,8,3,,11,POINT (3451668 -76532004)
2016,Febrero,Nicaragua,35,33,,68,POINT (4697157 -74140516)
2016,Febrero,Nicaragua,2,8,,10,POINT (4815189 -75736374)
2016,Febrero,Nicaragua,11,14,,25,POINT (6170465 -7542726)
2016,Febrero,Nicaragua,0,2,,2,POINT (7128047 -73181317)
2016,Febrero,Nicaragua,3,0,,3,POINT (7927233 -72508188)
2016,Febrero,Nigeria,0,1,,1,POINT (4697157 -74140516)
2016,Febrero,Níger,1,0,,1,POINT (4697157 -74140516)
2016,Febrero,Noruega,0,1,,1,POINT (10446304 -75516486)
2016,Febrero,Noruega,1,1,,2,POINT (125862 -81702165)
2016,Febrero,Noruega,3,4,,7,POINT (3451668 -76532004)
2016,Febrero,Noruega,17,25,,42,POINT (4697157 -74140516)
2016,Febrero,Noruega,1,0,,1,POINT (4815189 -75736374)
2016,Febrero,Nueva Zelanda,1,2,,3,POINT (4697157 -74140516)
2016,Febrero,Nueva Zelanda,0,1,,1,POINT (6170465 -7542726)
2016,Febrero,Papúa Nueva Guinea,0,1,,1,POINT (4697157 -74140516)
2016,Febrero,Pakistán,0,1,,1,POINT (4697157 -74140516)
2016,Febrero,Panamá,2084,1640,,3724,POINT (10406342 -75527794)
2016,Febrero,Panamá,3511,3365,,6876,POINT (10446304 -75516486)
2016,Febrero,Panamá,302,570,,872,POINT (10886686 -74776479)
2016,Febrero,Panamá,2,10,,12,POINT (10970933 -74765343)
2016,Febrero,Panamá,1,1,,2,POINT (11247723 -74213989)
2016,Febrero,Panamá,13,26,,39,POINT (125744111 -81703935)
2016,Febrero,Panamá,428,370,,798,POINT (125862 -81702165)
2016,Febrero,Panamá,3,3,,6,POINT (133387613 -81372937)
2016,Febrero,Panamá,318,468,,786,POINT (3451668 -76532004)
2016,Febrero,Panamá,0,12,,12,POINT (3884426 -77061029)
2016,Febrero,Panamá,102,143,,245,POINT (445285 -75766353)
2016,Febrero,Panamá,4807,6344,,11151,POINT (4697157 -74140516)
2016,Febrero,Panamá,48,76,,124,POINT (4815189 -75736374)
2016,Febrero,Panamá,2534,2968,,5502,POINT (6170465 -7542726)
2016,Febrero,Panamá,1,1,,2,POINT (6222552 -77401154)
2016,Febrero,Panamá,0,2,,2,POINT (7102626 -77762647)
2016,Febrero,Panamá,12,19,,31,POINT (7128047 -73181317)
2016,Febrero,Panamá,46,47,,93,POINT (7927233 -72508188)
2016,Febrero,Panamá,122,163,,285,POINT (863337 -7735002)
2016,Febrero,Paraguay,1,0,,1,POINT (0.81488 -77356)
2016,Febrero,Paraguay,2,4,,6,POINT (10446304 -75516486)
2016,Febrero,Paraguay,0,5,,5,POINT (10886686 -74776479)
2016,Febrero,Paraguay,84,53,,137,POINT (125862 -81702165)
2016,Febrero,Paraguay,10,6,,16,POINT (3451668 -76532004)
2016,Febrero,Paraguay,57,71,,128,POINT (4697157 -74140516)
2016,Febrero,Paraguay,2,0,,2,POINT (4815189 -75736374)
2016,Febrero,Paraguay,22,24,,46,POINT (6170465 -7542726)
2016,Febrero,Paraguay,0,1,,1,POINT (7927233 -72508188)
2016,Febrero,Perú,119,197,,316,POINT (-4191162 -69941498)
2016,Febrero,Perú,2,7,,9,POINT (-4214082 -69941431)
2016,Febrero,Perú,1,0,,1,POINT (0.185957 -7478366)
2016,Febrero,Perú,11,38,,49,POINT (0.81488 -77356)
2016,Febrero,Perú,0,2,,2,POINT (10406342 -75527794)
2016,Febrero,Perú,19,11,,30,POINT (10446304 -75516486)
2016,Febrero,Perú,3,8,,11,POINT (10886686 -74776479)
2016,Febrero,Perú,262,223,,485,POINT (125862 -81702165)
2016,Febrero,Perú,309,411,,720,POINT (3451668 -76532004)
2016,Febrero,Perú,0,1,,1,POINT (3884426 -77061029)
2016,Febrero,Perú,6380,8194,,14574,POINT (4697157 -74140516)
2016,Febrero,Perú,1,2,,3,POINT (4815189 -75736374)
2016,Febrero,Perú,471,740,,1211,POINT (6170465 -7542726)
2016,Febrero,Perú,2,1,,3,POINT (7128047 -73181317)
2016,Febrero,Polonia,1,1,,2,POINT (10446304 -75516486)
2016,Febrero,Polonia,3,0,,3,POINT (3451668 -76532004)
2016,Febrero,Polonia,35,52,,87,POINT (4697157 -74140516)
2016,Febrero,Polonia,1,2,,3,POINT (6170465 -7542726)
2016,Febrero,Portugal,1,9,,10,POINT (3451668 -76532004)
2016,Febrero,Portugal,372,586,,958,POINT (4697157 -74140516)
2016,Febrero,Portugal,0,1,,1,POINT (4815189 -75736374)
2016,Febrero,Portugal,0,1,,1,POINT (6170465 -7542726)
2016,Febrero,Polinesia Francesa/Colectividad de Ultramar Francesa,0,1,,1,POINT (4697157 -74140516)
2016,Febrero,Puerto Rico/Territorio de Estados Unidos,0,2,,2,POINT (10406342 -75527794)
2016,Febrero,Puerto Rico/Territorio de Estados Unidos,1,1,,2,POINT (10446304 -75516486)
2016,Febrero,Puerto Rico/Territorio de Estados Unidos,11,43,,54,POINT (10886686 -74776479)
2016,Febrero,Puerto Rico/Territorio de Estados Unidos,2,0,,2,POINT (125862 -81702165)
2016,Febrero,Puerto Rico/Territorio de Estados Unidos,22,26,,48,POINT (3451668 -76532004)
2016,Febrero,Puerto Rico/Territorio de Estados Unidos,200,304,,504,POINT (4697157 -74140516)
2016,Febrero,Puerto Rico/Territorio de Estados Unidos,1,2,,3,POINT (4815189 -75736374)
2016,Febrero,Puerto Rico/Territorio de Estados Unidos,22,74,,96,POINT (6170465 -7542726)
2016,Febrero,Puerto Rico/Territorio de Estados Unidos,1,2,,3,POINT (7128047 -73181317)
2016,Febrero,Puerto Rico/Territorio de Estados Unidos,0,2,,2,POINT (7927233 -72508188)
2016,Febrero,Qatar,2,2,,4,POINT (3451668 -76532004)
2016,Febrero,Qatar,1,0,,1,POINT (4697157 -74140516)
2016,Febrero,Reino Unido de Gran Bretaña e Irlanda del Norte,0,3,,3,POINT (10446304 -75516486)
2016,Febrero,Reino Unido de Gran Bretaña e Irlanda del Norte,0,3,,3,POINT (10886686 -74776479)
2016,Febrero,Reino Unido de Gran Bretaña e Irlanda del Norte,23,44,,67,POINT (3451668 -76532004)
2016,Febrero,Reino Unido de Gran Bretaña e Irlanda del Norte,790,1263,,2053,POINT (4697157 -74140516)
2016,Febrero,Reino Unido de Gran Bretaña e Irlanda del Norte,6,25,,31,POINT (6170465 -7542726)
2016,Febrero,Reino Unido de Gran Bretaña e Irlanda del Norte,0,1,,1,POINT (7128047 -73181317)
2016,Febrero,Federación de Rusia,1,1,,2,POINT (10446304 -75516486)
2016,Febrero,Federación de Rusia,1,0,,1,POINT (125862 -81702165)
2016,Febrero,Federación de Rusia,2,4,,6,POINT (3451668 -76532004)
2016,Febrero,Federación de Rusia,18,27,,45,POINT (4697157 -74140516)
2016,Febrero,Federación de Rusia,1,0,,1,POINT (6170465 -7542726)
2016,Febrero,Federación de Rusia,0,1,,1,POINT (7927233 -72508188)
2016,Febrero,República Dominicana,2,59,,61,POINT (10406342 -75527794)
2016,Febrero,República Dominicana,3,7,,10,POINT (10446304 -75516486)
2016,Febrero,República Dominicana,7,28,,35,POINT (10886686 -74776479)
2016,Febrero,República Dominicana,24,48,,72,POINT (3451668 -76532004)
2016,Febrero,República Dominicana,585,852,,1437,POINT (4697157 -74140516)
2016,Febrero,República Dominicana,8,10,,18,POINT (4815189 -75736374)
2016,Febrero,República Dominicana,28,51,,79,POINT (6170465 -7542726)
2016,Febrero,República Dominicana,1,0,,1,POINT (7128047 -73181317)
2016,Febrero,República Dominicana,2,2,,4,POINT (7927233 -72508188)
2016,Febrero,Rumania,0,12,,12,POINT (4697157 -74140516)
2016,Febrero,Rumania,0,1,,1,POINT (6170465 -7542726)
2016,Febrero,San Marino,1,1,,2,POINT (125862 -81702165)
2016,Febrero,San  Vicente y las Granadinas,1,0,,1,POINT (4697157 -74140516)
2016,Febrero,Santa Lucia,0,2,,2,POINT (4697157 -74140516)
2016,Febrero,Serbia,0,1,,1,POINT (3451668 -76532004)
2016,Febrero,Serbia,0,2,,2,POINT (4697157 -74140516)
2016,Febrero,Singapur,2,5,,7,POINT (4697157 -74140516)
2016,Febrero,República Árabe Siria,0,1,,1,POINT (4697157 -74140516)
2016,Febrero,Sudáfrica,5,16,,21,POINT (4697157 -74140516)
2016,Febrero,Suecia,4,4,,8,POINT (3451668 -76532004)
2016,Febrero,Suecia,31,45,,76,POINT (4697157 -74140516)
2016,Febrero,Suecia,2,4,,6,POINT (6170465 -7542726)
2016,Febrero,Suiza,19,32,,51,POINT (3451668 -76532004)
2016,Febrero,Suiza,74,107,,181,POINT (4697157 -74140516)
2016,Febrero,Suiza,15,25,,40,POINT (6170465 -7542726)
2016,Febrero,Surinam,2,3,,5,POINT (4697157 -74140516)
2016,Febrero,Surinam,0,10,,10,POINT (6170465 -7542726)
2016,Febrero,Taiwán,3,3,,6,POINT (4697157 -74140516)
2016,Febrero,Taiwán,1,0,,1,POINT (6170465 -7542726)
2016,Febrero,Tailandia,5,1,,6,POINT (4697157 -74140516)
2016,Febrero,Togo,1,1,,2,POINT (4697157 -74140516)
2016,Febrero,Trinidad y Tobago,1,35,,36,POINT (10406342 -75527794)
2016,Febrero,Trinidad y Tobago,0,1,,1,POINT (10886686 -74776479)
2016,Febrero,Trinidad y Tobago,0,1,,1,POINT (10970933 -74765343)
2016,Febrero,Trinidad y Tobago,4,9,,13,POINT (3451668 -76532004)
2016,Febrero,Trinidad y Tobago,1,13,,14,POINT (4697157 -74140516)
2016,Febrero,Trinidad y Tobago,1,3,,4,POINT (4815189 -75736374)
2016,Febrero,Trinidad y Tobago,0,3,,3,POINT (6170465 -7542726)
2016,Febrero,Trinidad y Tobago,2,0,,2,POINT (7128047 -73181317)
2016,Febrero,Túnez,0,1,,1,POINT (4697157 -74140516)
2016,Febrero,Turquía,1,0,,1,POINT (3451668 -76532004)
2016,Febrero,Turquía,6,13,,19,POINT (4697157 -74140516)
2016,Febrero,Turquía,1,1,,2,POINT (6170465 -7542726)
2016,Febrero,Ucrania,0,1,,1,POINT (3451668 -76532004)
2016,Febrero,Ucrania,1,3,,4,POINT (4697157 -74140516)
2016,Febrero,Uganda,3,0,,3,POINT (4697157 -74140516)
2016,Febrero,Uruguay,0,2,,2,POINT (0.81488 -77356)
2016,Febrero,Uruguay,5,7,,12,POINT (10446304 -75516486)
2016,Febrero,Uruguay,28,16,,44,POINT (125862 -81702165)
2016,Febrero,Uruguay,7,26,,33,POINT (3451668 -76532004)
2016,Febrero,Uruguay,61,81,,142,POINT (4697157 -74140516)
2016,Febrero,Uruguay,19,41,,60,POINT (6170465 -7542726)
2016,Febrero,Uzbekistán,0,1,,1,POINT (4697157 -74140516)
2016,Febrero,Venezuela,0,7,,7,POINT (10406342 -75527794)
2016,Febrero,Venezuela,4,17,,21,POINT (10446304 -75516486)
2016,Febrero,Venezuela,16,65,,81,POINT (10886686 -74776479)
2016,Febrero,Venezuela,0,1,,1,POINT (10970933 -74765343)
2016,Febrero,Venezuela,3,4,,7,POINT (11247723 -74213989)
2016,Febrero,Venezuela,279,456,,735,POINT (11360029 -72129595)
2016,Febrero,Venezuela,1,3,,4,POINT (125862 -81702165)
2016,Febrero,Venezuela,14,28,,42,POINT (3451668 -76532004)
2016,Febrero,Venezuela,48,53,,101,POINT (3866713 -67927521)
2016,Febrero,Venezuela,2975,3669,,6644,POINT (4697157 -74140516)
2016,Febrero,Venezuela,0,1,,1,POINT (4815189 -75736374)
2016,Febrero,Venezuela,541,599,,1140,POINT (6170465 -7542726)
2016,Febrero,Venezuela,64,101,,165,POINT (6185536 -67484028)
2016,Febrero,Venezuela,36,45,,81,POINT (7088729 -70740253)
2016,Febrero,Venezuela,1,1,,2,POINT (7128047 -73181317)
2016,Febrero,Venezuela,1865,2498,,4363,POINT (7819 -72453013)
2016,Febrero,Venezuela,148,187,,335,POINT (7927233 -72508188)
2016,Febrero,Vietnam,0,1,,1,POINT (3451668 -76532004)
2016,Febrero,Islas Vírgenes Británicas/Territorio Británico de Ultramar,7,31,,38,POINT (10406342 -75527794)
2016,Febrero,Islas Vírgenes Británicas/Territorio Británico de Ultramar,1,1,,2,POINT (4697157 -74140516)
2016,Febrero,Islas Vírgenes Estadounidenses/Territorio de Estados Unidos,0,1,,1,POINT (10406342 -75527794)
2016,Febrero,Islas Vírgenes Estadounidenses/Territorio de Estados Unidos,0,1,,1,POINT (6170465 -7542726)
2016,Marzo,Afganistán,1,3,,4,POINT (4697157 -74140516)
2016,Marzo,Albania,1,0,,1,POINT (3451668 -76532004)
2016,Marzo,Albania,0,2,,2,POINT (4697157 -74140516)
2016,Marzo,Alemania,0,2,,2,POINT (10406342 -75527794)
2016,Marzo,Alemania,1,1,,2,POINT (10446304 -75516486)
2016,Marzo,Alemania,6,3,,9,POINT (10886686 -74776479)
2016,Marzo,Alemania,4,2,,6,POINT (125862 -81702165)
2016,Marzo,Alemania,45,74,,119,POINT (3451668 -76532004)
2016,Marzo,Alemania,1479,2351,,3830,POINT (4697157 -74140516)
2016,Marzo,Alemania,2,2,,4,POINT (4815189 -75736374)
2016,Marzo,Alemania,23,33,,56,POINT (6170465 -7542726)
2016,Marzo,Alemania,0,1,,1,POINT (7128047 -73181317)
2016,Marzo,Alemania,1,0,,1,POINT (7927233 -72508188)
2016,Marzo,Antigua y Barbuda,0,1,,1,POINT (10406342 -75527794)
2016,Marzo,Antigua y Barbuda,1,3,,4,POINT (4697157 -74140516)
2016,Marzo,Países Bajos,5,12,,17,POINT (10406342 -75527794)
2016,Marzo,Países Bajos,3,3,,6,POINT (10446304 -75516486)
2016,Marzo,Países Bajos,60,71,,131,POINT (10886686 -74776479)
2016,Marzo,Países Bajos,2,1,,3,POINT (10970933 -74765343)
2016,Marzo,Países Bajos,4,1,,5,POINT (11247723 -74213989)
2016,Marzo,Países Bajos,0,1,,1,POINT (125862 -81702165)
2016,Marzo,Países Bajos,86,157,,243,POINT (3451668 -76532004)
2016,Marzo,Países Bajos,866,1253,,2119,POINT (4697157 -74140516)
2016,Marzo,Países Bajos,3,2,,5,POINT (4815189 -75736374)
2016,Marzo,Países Bajos,207,226,,433,POINT (6170465 -7542726)
2016,Marzo,Países Bajos,0,1,,1,POINT (7128047 -73181317)
2016,Marzo,Arabia Saudita,0,2,,2,POINT (4697157 -74140516)
2016,Marzo,Arabia Saudita,0,1,,1,POINT (6170465 -7542726)
2016,Marzo,Argelia,3,4,,7,POINT (4697157 -74140516)
2016,Marzo,Argentina,5,22,,27,POINT (0.81488 -77356)
2016,Marzo,Argentina,51,37,,88,POINT (10446304 -75516486)
2016,Marzo,Argentina,12,12,,24,POINT (10886686 -74776479)
2016,Marzo,Argentina,293,200,,493,POINT (125862 -81702165)
2016,Marzo,Argentina,87,217,,304,POINT (3451668 -76532004)
2016,Marzo,Argentina,2485,3123,,5608,POINT (4697157 -74140516)
2016,Marzo,Argentina,0,2,,2,POINT (4815189 -75736374)
2016,Marzo,Argentina,73,138,,211,POINT (6170465 -7542726)
2016,Marzo,Argentina,0,4,,4,POINT (7128047 -73181317)
2016,Marzo,Argentina,2,1,,3,POINT (7927233 -72508188)
2016,Marzo,Aruba,14,34,,48,POINT (10406342 -75527794)
2016,Marzo,Aruba,4,12,,16,POINT (10886686 -74776479)
2016,Marzo,Aruba,2,10,,12,POINT (11247723 -74213989)
2016,Marzo,Aruba,7,11,,18,POINT (3451668 -76532004)
2016,Marzo,Aruba,724,790,,1514,POINT (4697157 -74140516)
2016,Marzo,Aruba,74,69,,143,POINT (6170465 -7542726)
2016,Marzo,Aruba,9,5,,14,POINT (7128047 -73181317)
2016,Marzo,Australia,0,2,,2,POINT (10446304 -75516486)
2016,Marzo,Australia,0,4,,4,POINT (3451668 -76532004)
2016,Marzo,Australia,16,37,,53,POINT (4697157 -74140516)
2016,Marzo,Australia,1,1,,2,POINT (4815189 -75736374)
2016,Marzo,Australia,6,20,,26,POINT (6170465 -7542726)
2016,Marzo,Austria,1,2,,3,POINT (3451668 -76532004)
2016,Marzo,Austria,16,39,,55,POINT (4697157 -74140516)
2016,Marzo,Austria,5,9,,14,POINT (6170465 -7542726)
2016,Marzo,Azerbaiyán,1,2,,3,POINT (4697157 -74140516)
2016,Marzo,Bahamas,0,1,,1,POINT (10406342 -75527794)
2016,Marzo,Bahamas,1,1,,2,POINT (3451668 -76532004)
2016,Marzo,Bahamas,2,4,,6,POINT (4697157 -74140516)
2016,Marzo,Bahamas,1,0,,1,POINT (6170465 -7542726)
2016,Marzo,Bahréin,2,0,,2,POINT (10446304 -75516486)
2016,Marzo,Bahréin,0,1,,1,POINT (4697157 -74140516)
2016,Marzo,Bangladesh,0,1,,1,POINT (4697157 -74140516)
2016,Marzo,Barbados,0,1,,1,POINT (3451668 -76532004)
2016,Marzo,Barbados,42,57,,99,POINT (4697157 -74140516)
2016,Marzo,Barbados,1,0,,1,POINT (6170465 -7542726)
2016,Marzo,República de Belarús,0,1,,1,POINT (4697157 -74140516)
2016,Marzo,República de Belarús,1,0,,1,POINT (6170465 -7542726)
2016,Marzo,República de Belarús,0,1,,1,POINT (7819 -72453013)
2016,Marzo,Bélgica,1,0,,1,POINT (10446304 -75516486)
2016,Marzo,Bélgica,8,11,,19,POINT (3451668 -76532004)
2016,Marzo,Bélgica,24,36,,60,POINT (4697157 -74140516)
2016,Marzo,Bélgica,10,15,,25,POINT (6170465 -7542726)
2016,Marzo,Belice,9,13,,22,POINT (10446304 -75516486)
2016,Marzo,Belice,3,2,,5,POINT (4697157 -74140516)
2016,Marzo,Belice,1,1,,2,POINT (6170465 -7542726)
2016,Marzo,Benín,1,0,,1,POINT (3451668 -76532004)
2016,Marzo,Bolivia,2,0,,2,POINT (0.81488 -77356)
2016,Marzo,Bolivia,0,9,,9,POINT (10886686 -74776479)
2016,Marzo,Bolivia,12,9,,21,POINT (125862 -81702165)
2016,Marzo,Bolivia,29,33,,62,POINT (3451668 -76532004)
2016,Marzo,Bolivia,443,552,,995,POINT (4697157 -74140516)
2016,Marzo,Bolivia,0,4,,4,POINT (4815189 -75736374)
2016,Marzo,Bolivia,45,40,,85,POINT (6170465 -7542726)
2016,Marzo,Bolivia,1,1,,2,POINT (7128047 -73181317)
2016,Marzo,Bosnia y Herzegovina,1,1,,2,POINT (4697157 -74140516)
2016,Marzo,Brasil,118,159,,277,POINT (-4191162 -69941498)
2016,Marzo,Brasil,5,8,,13,POINT (-4214082 -69941431)
2016,Marzo,Brasil,4,3,,7,POINT (0.81488 -77356)
2016,Marzo,Brasil,91,45,,136,POINT (10446304 -75516486)
2016,Marzo,Brasil,0,7,,7,POINT (10886686 -74776479)
2016,Marzo,Brasil,365,305,,670,POINT (125862 -81702165)
2016,Marzo,Brasil,74,94,,168,POINT (3451668 -76532004)
2016,Marzo,Brasil,0,1,,1,POINT (3866713 -67927521)
2016,Marzo,Brasil,4582,5766,,10348,POINT (4697157 -74140516)
2016,Marzo,Brasil,1,3,,4,POINT (4815189 -75736374)
2016,Marzo,Brasil,144,176,,320,POINT (6170465 -7542726)
2016,Marzo,Bulgaria,1,0,,1,POINT (3451668 -76532004)
2016,Marzo,Bulgaria,1,1,,2,POINT (4697157 -74140516)
2016,Marzo,Bulgaria,4,2,,6,POINT (6170465 -7542726)
2016,Marzo,Cabo Verde,0,1,,1,POINT (4697157 -74140516)
2016,Marzo,Islas Caimán/Territorio Británico de Ultramar,0,8,,8,POINT (10446304 -75516486)
2016,Marzo,Islas Caimán/Territorio Británico de Ultramar,0,3,,3,POINT (10886686 -74776479)
2016,Marzo,Islas Caimán/Territorio Británico de Ultramar,1,5,,6,POINT (133387613 -81372937)
2016,Marzo,Islas Caimán/Territorio Británico de Ultramar,1,15,,16,POINT (4697157 -74140516)
2016,Marzo,Islas Caimán/Territorio Británico de Ultramar,0,5,,5,POINT (6170465 -7542726)
2016,Marzo,Camerún,1,0,,1,POINT (4697157 -74140516)
2016,Marzo,Canadá,225,207,,432,POINT (10446304 -75516486)
2016,Marzo,Canadá,5,11,,16,POINT (10886686 -74776479)
2016,Marzo,Canadá,429,359,,788,POINT (125862 -81702165)
2016,Marzo,Canadá,26,36,,62,POINT (3451668 -76532004)
2016,Marzo,Canadá,579,901,,1480,POINT (4697157 -74140516)
2016,Marzo,Canadá,4,2,,6,POINT (4815189 -75736374)
2016,Marzo,Canadá,81,135,,216,POINT (6170465 -7542726)
2016,Marzo,Canadá,0,2,,2,POINT (7128047 -73181317)
2016,Marzo,Canadá,2,2,,4,POINT (7927233 -72508188)
2016,Marzo,España,0,1,,1,POINT (10446304 -75516486)
2016,Marzo,España,4,2,,6,POINT (10886686 -74776479)
2016,Marzo,España,0,2,,2,POINT (10970933 -74765343)
2016,Marzo,España,405,639,,1044,POINT (3451668 -76532004)
2016,Marzo,España,2610,4817,,7427,POINT (4697157 -74140516)
2016,Marzo,España,2,2,,4,POINT (4815189 -75736374)
2016,Marzo,España,280,502,,782,POINT (6170465 -7542726)
2016,Marzo,España,0,5,,5,POINT (7128047 -73181317)
2016,Marzo,España,0,1,,1,POINT (7927233 -72508188)
2016,Marzo,República Del Congo,0,1,,1,POINT (4697157 -74140516)
2016,Marzo,República de Corea,1,0,,1,POINT (10446304 -75516486)
2016,Marzo,República de Corea,2,0,,2,POINT (3451668 -76532004)
2016,Marzo,República de Corea,3,14,,17,POINT (4697157 -74140516)
2016,Marzo,República de Corea,0,6,,6,POINT (6170465 -7542726)
2016,Marzo,Costa de Marfil,0,1,,1,POINT (3451668 -76532004)
2016,Marzo,Costa de Marfil,1,6,,7,POINT (4697157 -74140516)
2016,Marzo,Costa Rica,4,4,,8,POINT (10406342 -75527794)
2016,Marzo,Costa Rica,9,11,,20,POINT (10446304 -75516486)
2016,Marzo,Costa Rica,10,22,,32,POINT (10886686 -74776479)
2016,Marzo,Costa Rica,0,1,,1,POINT (11247723 -74213989)
2016,Marzo,Costa Rica,134,109,,243,POINT (125862 -81702165)
2016,Marzo,Costa Rica,1,2,,3,POINT (133387613 -81372937)
2016,Marzo,Costa Rica,25,33,,58,POINT (3451668 -76532004)
2016,Marzo,Costa Rica,971,1505,,2476,POINT (4697157 -74140516)
2016,Marzo,Costa Rica,6,9,,15,POINT (4815189 -75736374)
2016,Marzo,Costa Rica,80,109,,189,POINT (6170465 -7542726)
2016,Marzo,Costa Rica,0,5,,5,POINT (7927233 -72508188)
2016,Marzo,Croacia,2,2,,4,POINT (10446304 -75516486)
2016,Marzo,Croacia,2,1,,3,POINT (4697157 -74140516)
2016,Marzo,Croacia,0,1,,1,POINT (6170465 -7542726)
2016,Marzo,Cuba,0,1,,1,POINT (10406342 -75527794)
2016,Marzo,Cuba,1,3,,4,POINT (10446304 -75516486)
2016,Marzo,Cuba,4,6,,10,POINT (10886686 -74776479)
2016,Marzo,Cuba,0,1,,1,POINT (10970933 -74765343)
2016,Marzo,Cuba,1,0,,1,POINT (125862 -81702165)
2016,Marzo,Cuba,11,12,,23,POINT (3451668 -76532004)
2016,Marzo,Cuba,319,533,,852,POINT (4697157 -74140516)
2016,Marzo,Cuba,1,1,,2,POINT (4815189 -75736374)
2016,Marzo,Cuba,11,18,,29,POINT (6170465 -7542726)
2016,Marzo,Cuba,3,2,,5,POINT (7128047 -73181317)
2016,Marzo,Cuba,1,2,,3,POINT (7927233 -72508188)
2016,Marzo,Curazao,0,1,,1,POINT (4697157 -74140516)
2016,Marzo,República Checa,1,0,,1,POINT (3451668 -76532004)
2016,Marzo,República Checa,9,11,,20,POINT (4697157 -74140516)
2016,Marzo,República Checa,1,0,,1,POINT (6170465 -7542726)
2016,Marzo,República Checa,0,2,,2,POINT (7927233 -72508188)
2016,Marzo,Chile,4,7,,11,POINT (0.81488 -77356)
2016,Marzo,Chile,15,11,,26,POINT (10446304 -75516486)
2016,Marzo,Chile,1,5,,6,POINT (10886686 -74776479)
2016,Marzo,Chile,41,31,,72,POINT (125862 -81702165)
2016,Marzo,Chile,36,51,,87,POINT (3451668 -76532004)
2016,Marzo,Chile,4022,5352,,9374,POINT (4697157 -74140516)
2016,Marzo,Chile,6,5,,11,POINT (4815189 -75736374)
2016,Marzo,Chile,30,48,,78,POINT (6170465 -7542726)
2016,Marzo,Chile,3,2,,5,POINT (7927233 -72508188)
2016,Marzo,China,0,1,,1,POINT (3451668 -76532004)
2016,Marzo,China,24,79,,103,POINT (4697157 -74140516)
2016,Marzo,China,1,2,,3,POINT (6170465 -7542726)
2016,Marzo,Dinamarca,2,3,,5,POINT (3451668 -76532004)
2016,Marzo,Dinamarca,21,29,,50,POINT (4697157 -74140516)
2016,Marzo,Dinamarca,2,1,,3,POINT (6170465 -7542726)
2016,Marzo,Dominica,2,0,,2,POINT (4697157 -74140516)
2016,Marzo,Dominica,0,1,,1,POINT (6170465 -7542726)
2016,Marzo,Ecuador,98,241,,339,POINT (0.33002 -76876446)
2016,Marzo,Ecuador,4085,5715,,9800,POINT (0.81488 -77356)
2016,Marzo,Ecuador,49,66,,115,POINT (1800143 -78802679)
2016,Marzo,Ecuador,0,1,,1,POINT (10406342 -75527794)
2016,Marzo,Ecuador,99,231,,330,POINT (10446304 -75516486)
2016,Marzo,Ecuador,47,191,,238,POINT (10886686 -74776479)
2016,Marzo,Ecuador,1,2,,3,POINT (125862 -81702165)
2016,Marzo,Ecuador,406,456,,862,POINT (3451668 -76532004)
2016,Marzo,Ecuador,0,2,,2,POINT (3884426 -77061029)
2016,Marzo,Ecuador,3818,5762,,9580,POINT (4697157 -74140516)
2016,Marzo,Ecuador,3,2,,5,POINT (4815189 -75736374)
2016,Marzo,Ecuador,28,44,,72,POINT (6170465 -7542726)
2016,Marzo,Ecuador,5,3,,8,POINT (7128047 -73181317)
2016,Marzo,Ecuador,1,3,,4,POINT (7927233 -72508188)
2016,Marzo,Ecuador,0,1,,1,
2016,Marzo,Egipto,0,3,,3,POINT (4697157 -74140516)
2016,Marzo,Egipto,0,2,,2,POINT (6170465 -7542726)
2016,Marzo,El Salvador,33,21,,54,POINT (10446304 -75516486)
2016,Marzo,El Salvador,0,1,,1,POINT (10886686 -74776479)
2016,Marzo,El Salvador,26,29,,55,POINT (125862 -81702165)
2016,Marzo,El Salvador,132,179,,311,POINT (3451668 -76532004)
2016,Marzo,El Salvador,1111,1508,,2619,POINT (4697157 -74140516)
2016,Marzo,El Salvador,0,1,,1,POINT (4815189 -75736374)
2016,Marzo,El Salvador,183,252,,435,POINT (6170465 -7542726)
2016,Marzo,Emiratos Árabes,2,2,,4,POINT (4697157 -74140516)
2016,Marzo,Emiratos Árabes,0,1,,1,POINT (6170465 -7542726)
2016,Marzo,Eritrea,0,1,,1,POINT (4697157 -74140516)
2016,Marzo,Eslovaquia,4,6,,10,POINT (4697157 -74140516)
2016,Marzo,Eslovenia,0,3,,3,POINT (4697157 -74140516)
2016,Marzo,Eslovenia,0,1,,1,POINT (6170465 -7542726)
2016,Marzo,Estados Unidos de América,1,40,,41,POINT (10406342 -75527794)
2016,Marzo,Estados Unidos de América,3854,5200,,9054,POINT (10446304 -75516486)
2016,Marzo,Estados Unidos de América,699,1092,,1791,POINT (10886686 -74776479)
2016,Marzo,Estados Unidos de América,0,6,,6,POINT (10970933 -74765343)
2016,Marzo,Estados Unidos de América,0,4,,4,POINT (11117206 -74232675)
2016,Marzo,Estados Unidos de América,1,17,,18,POINT (11247723 -74213989)
2016,Marzo,Estados Unidos de América,21,25,,46,POINT (125862 -81702165)
2016,Marzo,Estados Unidos de América,1084,1379,,2463,POINT (3451668 -76532004)
2016,Marzo,Estados Unidos de América,0,6,,6,POINT (3884426 -77061029)
2016,Marzo,Estados Unidos de América,115,216,,331,POINT (445285 -75766353)
2016,Marzo,Estados Unidos de América,9730,16052,,25782,POINT (4697157 -74140516)
2016,Marzo,Estados Unidos de América,136,190,,326,POINT (4815189 -75736374)
2016,Marzo,Estados Unidos de América,2870,6066,,8936,POINT (6170465 -7542726)
2016,Marzo,Estados Unidos de América,21,38,,59,POINT (7128047 -73181317)
2016,Marzo,Estados Unidos de América,15,28,,43,POINT (7927233 -72508188)
2016,Marzo,Estados Unidos de América,1,21,,22,POINT (9402597 -75681642)
2016,Marzo,Estonia,0,1,,1,POINT (4697157 -74140516)
2016,Marzo,Estonia,1,0,,1,POINT (6170465 -7542726)
2016,Marzo,Etiopia,0,1,,1,POINT (4697157 -74140516)
2016,Marzo,Filipinas,0,2,,2,POINT (10886686 -74776479)
2016,Marzo,Filipinas,1,6,,7,POINT (3451668 -76532004)
2016,Marzo,Filipinas,0,1,,1,POINT (3884426 -77061029)
2016,Marzo,Filipinas,2,11,,13,POINT (4697157 -74140516)
2016,Marzo,Filipinas,1,0,,1,POINT (6170465 -7542726)
2016,Marzo,Finlandia,0,2,,2,POINT (10886686 -74776479)
2016,Marzo,Finlandia,0,1,,1,POINT (3451668 -76532004)
2016,Marzo,Finlandia,9,15,,24,POINT (4697157 -74140516)
2016,Marzo,Finlandia,0,3,,3,POINT (6170465 -7542726)
2016,Marzo,Francia,0,3,,3,POINT (10406342 -75527794)
2016,Marzo,Francia,1,1,,2,POINT (10446304 -75516486)
2016,Marzo,Francia,1,1,,2,POINT (10886686 -74776479)
2016,Marzo,Francia,14,28,,42,POINT (3451668 -76532004)
2016,Marzo,Francia,1425,2256,,3681,POINT (4697157 -74140516)
2016,Marzo,Francia,17,28,,45,POINT (6170465 -7542726)
2016,Marzo,Francia,0,1,,1,POINT (7128047 -73181317)
2016,Marzo,Ghana,0,3,,3,POINT (4697157 -74140516)
2016,Marzo,Gibraltar/Territorio Británico de Ultramar,3,5,,8,POINT (0.81488 -77356)
2016,Marzo,Gibraltar/Territorio Británico de Ultramar,0,4,,4,POINT (10406342 -75527794)
2016,Marzo,Grecia,0,1,,1,POINT (3451668 -76532004)
2016,Marzo,Grecia,3,7,,10,POINT (4697157 -74140516)
2016,Marzo,Guatemala,2,8,,10,POINT (10406342 -75527794)
2016,Marzo,Guatemala,6,6,,12,POINT (10446304 -75516486)
2016,Marzo,Guatemala,17,6,,23,POINT (10886686 -74776479)
2016,Marzo,Guatemala,30,40,,70,POINT (125862 -81702165)
2016,Marzo,Guatemala,19,37,,56,POINT (3451668 -76532004)
2016,Marzo,Guatemala,425,615,,1040,POINT (4697157 -74140516)
2016,Marzo,Guatemala,6,4,,10,POINT (4815189 -75736374)
2016,Marzo,Guatemala,56,83,,139,POINT (6170465 -7542726)
2016,Marzo,Guatemala,3,0,,3,POINT (7128047 -73181317)
2016,Marzo,Guatemala,3,0,,3,POINT (7927233 -72508188)
2016,Marzo,Guyana,1,6,,7,POINT (10406342 -75527794)
2016,Marzo,Guyana,0,3,,3,POINT (4697157 -74140516)
2016,Marzo,Guyana,0,1,,1,POINT (6170465 -7542726)
2016,Marzo,Guinea,0,1,,1,POINT (4697157 -74140516)
2016,Marzo,Guadalupe/Territorio Francés,2,3,,5,POINT (10446304 -75516486)
2016,Marzo,Guadalupe/Territorio Francés,2,3,,5,POINT (4697157 -74140516)
2016,Marzo,Guayana Francesa/Departamento de Ultramar Francés,0,8,,8,POINT (10406342 -75527794)
2016,Marzo,Haití,3,7,,10,POINT (10406342 -75527794)
2016,Marzo,Haití,3,4,,7,POINT (4697157 -74140516)
2016,Marzo,Honduras,0,1,,1,POINT (10406342 -75527794)
2016,Marzo,Honduras,28,29,,57,POINT (10446304 -75516486)
2016,Marzo,Honduras,1,0,,1,POINT (125862 -81702165)
2016,Marzo,Honduras,5,7,,12,POINT (133387613 -81372937)
2016,Marzo,Honduras,25,19,,44,POINT (3451668 -76532004)
2016,Marzo,Honduras,43,58,,101,POINT (4697157 -74140516)
2016,Marzo,Honduras,0,1,,1,POINT (4815189 -75736374)
2016,Marzo,Honduras,47,40,,87,POINT (6170465 -7542726)
2016,Marzo,Honduras,0,2,,2,POINT (7927233 -72508188)
2016,Marzo,Hong Kong,1,3,,4,POINT (4697157 -74140516)
2016,Marzo,Hungría,0,1,,1,POINT (3451668 -76532004)
2016,Marzo,Hungría,5,5,,10,POINT (4697157 -74140516)
2016,Marzo,Hungría,0,1,,1,POINT (6170465 -7542726)
2016,Marzo,India,0,1,,1,POINT (10886686 -74776479)
2016,Marzo,India,0,3,,3,POINT (3451668 -76532004)
2016,Marzo,India,9,21,,30,POINT (4697157 -74140516)
2016,Marzo,India,1,7,,8,POINT (6170465 -7542726)
2016,Marzo,Indonesia,1,1,,2,POINT (3451668 -76532004)
2016,Marzo,Indonesia,3,5,,8,POINT (4697157 -74140516)
2016,Marzo,Indonesia,0,1,,1,POINT (6170465 -7542726)
2016,Marzo,Irán,0,2,,2,POINT (4697157 -74140516)
2016,Marzo,Irán,0,1,,1,POINT (6170465 -7542726)
2016,Marzo,República de Irlanda,0,2,,2,POINT (3451668 -76532004)
2016,Marzo,República de Irlanda,15,20,,35,POINT (4697157 -74140516)
2016,Marzo,República de Irlanda,2,2,,4,POINT (6170465 -7542726)
2016,Marzo,Islandia,0,1,,1,POINT (4697157 -74140516)
2016,Marzo,Israel,0,1,,1,POINT (10886686 -74776479)
2016,Marzo,Israel,3,0,,3,POINT (125862 -81702165)
2016,Marzo,Israel,2,1,,3,POINT (3451668 -76532004)
2016,Marzo,Israel,18,56,,74,POINT (4697157 -74140516)
2016,Marzo,Israel,2,1,,3,POINT (6170465 -7542726)
2016,Marzo,Italia,1,1,,2,POINT (10446304 -75516486)
2016,Marzo,Italia,1,3,,4,POINT (10886686 -74776479)
2016,Marzo,Italia,135,95,,230,POINT (125862 -81702165)
2016,Marzo,Italia,10,39,,49,POINT (3451668 -76532004)
2016,Marzo,Italia,80,217,,297,POINT (4697157 -74140516)
2016,Marzo,Italia,0,2,,2,POINT (4815189 -75736374)
2016,Marzo,Italia,9,22,,31,POINT (6170465 -7542726)
2016,Marzo,Italia,1,1,,2,POINT (7128047 -73181317)
2016,Marzo,Italia,0,1,,1,POINT (7927233 -72508188)
2016,Marzo,Jamaica,3,8,,11,POINT (10406342 -75527794)
2016,Marzo,Jamaica,0,1,,1,POINT (10886686 -74776479)
2016,Marzo,Jamaica,0,2,,2,POINT (10970933 -74765343)
2016,Marzo,Jamaica,2,1,,3,POINT (3451668 -76532004)
2016,Marzo,Jamaica,3,3,,6,POINT (4697157 -74140516)
2016,Marzo,Jamaica,0,1,,1,POINT (4815189 -75736374)
2016,Marzo,Japón,2,3,,5,POINT (3451668 -76532004)
2016,Marzo,Japón,13,14,,27,POINT (4697157 -74140516)
2016,Marzo,Japón,0,1,,1,POINT (4815189 -75736374)
2016,Marzo,Japón,2,5,,7,POINT (6170465 -7542726)
2016,Marzo,Jordania,1,3,,4,POINT (4697157 -74140516)
2016,Marzo,Kenia,0,1,,1,POINT (4697157 -74140516)
2016,Marzo,Kenia,0,1,,1,POINT (6170465 -7542726)
2016,Marzo,Lituania,0,1,,1,POINT (3451668 -76532004)
2016,Marzo,Lituania,5,5,,10,POINT (4697157 -74140516)
2016,Marzo,Líbano,2,4,,6,POINT (4697157 -74140516)
2016,Marzo,Luxemburgo,0,6,,6,POINT (4697157 -74140516)
2016,Marzo,Luxemburgo,2,2,,4,POINT (6170465 -7542726)
2016,Marzo,Macao,0,1,,1,POINT (4697157 -74140516)
2016,Marzo,Madagascar,1,0,,1,POINT (4697157 -74140516)
2016,Marzo,Malasia,1,3,,4,POINT (4697157 -74140516)
2016,Marzo,Malta,0,2,,2,POINT (4697157 -74140516)
2016,Marzo,Marruecos,0,1,,1,POINT (3451668 -76532004)
2016,Marzo,Marruecos,0,1,,1,POINT (4697157 -74140516)
2016,Marzo,Marruecos,1,2,,3,POINT (6170465 -7542726)
2016,Marzo,Mauricio,0,1,,1,POINT (10406342 -75527794)
2016,Marzo,Mauricio,0,3,,3,POINT (4697157 -74140516)
2016,Marzo,Martinica/Departamento de Ultramar Francés,2,3,,5,POINT (10406342 -75527794)
2016,Marzo,Martinica/Departamento de Ultramar Francés,0,3,,3,POINT (10446304 -75516486)
2016,Marzo,México,0,8,,8,POINT (10406342 -75527794)
2016,Marzo,México,11,30,,41,POINT (10446304 -75516486)
2016,Marzo,México,16,25,,41,POINT (10886686 -74776479)
2016,Marzo,México,0,1,,1,POINT (10970933 -74765343)
2016,Marzo,México,4,8,,12,POINT (125862 -81702165)
2016,Marzo,México,72,127,,199,POINT (3451668 -76532004)
2016,Marzo,México,0,1,,1,POINT (3884426 -77061029)
2016,Marzo,México,5186,8424,,13610,POINT (4697157 -74140516)
2016,Marzo,México,12,14,,26,POINT (4815189 -75736374)
2016,Marzo,México,573,1088,,1661,POINT (6170465 -7542726)
2016,Marzo,México,0,9,,9,POINT (7128047 -73181317)
2016,Marzo,México,14,4,,18,POINT (7927233 -72508188)
2016,Marzo,Mongolia,0,1,,1,POINT (4697157 -74140516)
2016,Marzo,Montenegro,0,2,,2,POINT (4697157 -74140516)
2016,Marzo,Nicaragua,3,2,,5,POINT (10446304 -75516486)
2016,Marzo,Nicaragua,1,0,,1,POINT (10886686 -74776479)
2016,Marzo,Nicaragua,0,3,,3,POINT (125862 -81702165)
2016,Marzo,Nicaragua,6,10,,16,POINT (3451668 -76532004)
2016,Marzo,Nicaragua,35,31,,66,POINT (4697157 -74140516)
2016,Marzo,Nicaragua,6,3,,9,POINT (4815189 -75736374)
2016,Marzo,Nicaragua,22,12,,34,POINT (6170465 -7542726)
2016,Marzo,Nicaragua,1,0,,1,POINT (7128047 -73181317)
2016,Marzo,Nigeria,0,1,,1,POINT (4697157 -74140516)
2016,Marzo,Noruega,1,2,,3,POINT (10886686 -74776479)
2016,Marzo,Noruega,2,5,,7,POINT (3451668 -76532004)
2016,Marzo,Noruega,22,22,,44,POINT (4697157 -74140516)
2016,Marzo,Noruega,0,6,,6,POINT (6170465 -7542726)
2016,Marzo,Nueva Zelanda,2,6,,8,POINT (4697157 -74140516)
2016,Marzo,Nueva Zelanda,0,2,,2,POINT (6170465 -7542726)
2016,Marzo,Pakistán,0,1,,1,POINT (4697157 -74140516)
2016,Marzo,Pakistán,0,1,,1,POINT (6170465 -7542726)
2016,Marzo,Panamá,1593,1298,,2891,POINT (10406342 -75527794)
2016,Marzo,Panamá,3550,3376,,6926,POINT (10446304 -75516486)
2016,Marzo,Panamá,273,473,,746,POINT (10886686 -74776479)
2016,Marzo,Panamá,0,10,,10,POINT (10970933 -74765343)
2016,Marzo,Panamá,26,38,,64,POINT (125744111 -81703935)
2016,Marzo,Panamá,382,320,,702,POINT (125862 -81702165)
2016,Marzo,Panamá,3,12,,15,POINT (133387613 -81372937)
2016,Marzo,Panamá,215,327,,542,POINT (3451668 -76532004)
2016,Marzo,Panamá,0,6,,6,POINT (3884426 -77061029)
2016,Marzo,Panamá,95,163,,258,POINT (445285 -75766353)
2016,Marzo,Panamá,4614,6347,,10961,POINT (4697157 -74140516)
2016,Marzo,Panamá,31,68,,99,POINT (4815189 -75736374)
2016,Marzo,Panamá,1860,2677,,4537,POINT (6170465 -7542726)
2016,Marzo,Panamá,0,3,,3,POINT (6222552 -77401154)
2016,Marzo,Panamá,15,36,,51,POINT (7128047 -73181317)
2016,Marzo,Panamá,38,58,,96,POINT (7927233 -72508188)
2016,Marzo,Panamá,0,3,,3,POINT (806667 -767333)
2016,Marzo,Panamá,144,154,,298,POINT (863337 -7735002)
2016,Marzo,Panamá,0,3,,3,POINT (9402597 -75681642)
2016,Marzo,Paraguay,4,4,,8,POINT (10446304 -75516486)
2016,Marzo,Paraguay,0,2,,2,POINT (10886686 -74776479)
2016,Marzo,Paraguay,69,56,,125,POINT (125862 -81702165)
2016,Marzo,Paraguay,7,10,,17,POINT (3451668 -76532004)
2016,Marzo,Paraguay,77,73,,150,POINT (4697157 -74140516)
2016,Marzo,Paraguay,2,1,,3,POINT (4815189 -75736374)
2016,Marzo,Paraguay,11,15,,26,POINT (6170465 -7542726)
2016,Marzo,Paraguay,1,1,,2,POINT (7927233 -72508188)
2016,Marzo,Perú,99,174,,273,POINT (-4191162 -69941498)
2016,Marzo,Perú,0,3,,3,POINT (0.185957 -7478366)
2016,Marzo,Perú,15,32,,47,POINT (0.81488 -77356)
2016,Marzo,Perú,0,4,,4,POINT (10406342 -75527794)
2016,Marzo,Perú,21,13,,34,POINT (10446304 -75516486)
2016,Marzo,Perú,172,117,,289,POINT (125862 -81702165)
2016,Marzo,Perú,312,436,,748,POINT (3451668 -76532004)
2016,Marzo,Perú,6135,8252,,14387,POINT (4697157 -74140516)
2016,Marzo,Perú,2,1,,3,POINT (4815189 -75736374)
2016,Marzo,Perú,495,759,,1254,POINT (6170465 -7542726)
2016,Marzo,Perú,0,1,,1,POINT (7128047 -73181317)
2016,Marzo,Perú,1,1,,2,POINT (7927233 -72508188)
2016,Marzo,Polonia,0,1,,1,POINT (10886686 -74776479)
2016,Marzo,Polonia,15,24,,39,POINT (4697157 -74140516)
2016,Marzo,Polonia,3,0,,3,POINT (6170465 -7542726)
2016,Marzo,Portugal,0,2,,2,POINT (10970933 -74765343)
2016,Marzo,Portugal,5,11,,16,POINT (3451668 -76532004)
2016,Marzo,Portugal,163,272,,435,POINT (4697157 -74140516)
2016,Marzo,Portugal,7,4,,11,POINT (6170465 -7542726)
2016,Marzo,Puerto Rico/Territorio de Estados Unidos,1,9,,10,POINT (10406342 -75527794)
2016,Marzo,Puerto Rico/Territorio de Estados Unidos,2,4,,6,POINT (10446304 -75516486)
2016,Marzo,Puerto Rico/Territorio de Estados Unidos,5,53,,58,POINT (10886686 -74776479)
2016,Marzo,Puerto Rico/Territorio de Estados Unidos,0,1,,1,POINT (10970933 -74765343)
2016,Marzo,Puerto Rico/Territorio de Estados Unidos,0,5,,5,POINT (11247723 -74213989)
2016,Marzo,Puerto Rico/Territorio de Estados Unidos,2,0,,2,POINT (125862 -81702165)
2016,Marzo,Puerto Rico/Territorio de Estados Unidos,31,48,,79,POINT (3451668 -76532004)
2016,Marzo,Puerto Rico/Territorio de Estados Unidos,257,384,,641,POINT (4697157 -74140516)
2016,Marzo,Puerto Rico/Territorio de Estados Unidos,2,4,,6,POINT (4815189 -75736374)
2016,Marzo,Puerto Rico/Territorio de Estados Unidos,25,63,,88,POINT (6170465 -7542726)
2016,Marzo,Puerto Rico/Territorio de Estados Unidos,0,1,,1,POINT (7927233 -72508188)
2016,Marzo,Qatar,1,0,,1,POINT (4697157 -74140516)
2016,Marzo,Reino Unido de Gran Bretaña e Irlanda del Norte,0,3,,3,POINT (10406342 -75527794)
2016,Marzo,Reino Unido de Gran Bretaña e Irlanda del Norte,136,128,,264,POINT (10446304 -75516486)
2016,Marzo,Reino Unido de Gran Bretaña e Irlanda del Norte,1,0,,1,POINT (125862 -81702165)
2016,Marzo,Reino Unido de Gran Bretaña e Irlanda del Norte,17,20,,37,POINT (3451668 -76532004)
2016,Marzo,Reino Unido de Gran Bretaña e Irlanda del Norte,832,1283,,2115,POINT (4697157 -74140516)
2016,Marzo,Reino Unido de Gran Bretaña e Irlanda del Norte,7,23,,30,POINT (6170465 -7542726)
2016,Marzo,Reino Unido de Gran Bretaña e Irlanda del Norte,1,0,,1,POINT (7927233 -72508188)
2016,Marzo,República CentroÁfricana,0,1,,1,POINT (3451668 -76532004)
2016,Marzo,República CentroÁfricana,0,1,,1,POINT (4697157 -74140516)
2016,Marzo,República CentroÁfricana,1,0,,1,POINT (6170465 -7542726)
2016,Marzo,Federación de Rusia,1,0,,1,POINT (10446304 -75516486)
2016,Marzo,Federación de Rusia,1,2,,3,POINT (3451668 -76532004)
2016,Marzo,Federación de Rusia,15,26,,41,POINT (4697157 -74140516)
2016,Marzo,Federación de Rusia,0,1,,1,POINT (6170465 -7542726)
2016,Marzo,República Dominicana,0,1,,1,POINT (10406342 -75527794)
2016,Marzo,República Dominicana,1,1,,2,POINT (10446304 -75516486)
2016,Marzo,República Dominicana,7,15,,22,POINT (10886686 -74776479)
2016,Marzo,República Dominicana,0,1,,1,POINT (10970933 -74765343)
2016,Marzo,República Dominicana,27,45,,72,POINT (3451668 -76532004)
2016,Marzo,República Dominicana,764,962,,1726,POINT (4697157 -74140516)
2016,Marzo,República Dominicana,3,2,,5,POINT (4815189 -75736374)
2016,Marzo,República Dominicana,96,86,,182,POINT (6170465 -7542726)
2016,Marzo,República Dominicana,1,4,,5,POINT (7927233 -72508188)
2016,Marzo,Reunión,1,0,,1,POINT (4697157 -74140516)
2016,Marzo,Rumania,4,6,,10,POINT (4697157 -74140516)
2016,Marzo,Rumania,0,1,,1,POINT (6170465 -7542726)
2016,Marzo,San Cristóbal y Nevis,0,2,,2,POINT (4697157 -74140516)
2016,Marzo,San  Vicente y las Granadinas,0,1,,1,POINT (10406342 -75527794)
2016,Marzo,San  Vicente y las Granadinas,1,0,,1,POINT (125862 -81702165)
2016,Marzo,Santa Sede/Ciudad del Vaticano,0,1,,1,POINT (4697157 -74140516)
2016,Marzo,Santo Tomé y Príncipe,0,1,,1,POINT (4697157 -74140516)
2016,Marzo,Serbia,2,0,,2,POINT (4697157 -74140516)
2016,Marzo,Sierra Leona,0,1,,1,POINT (4697157 -74140516)
2016,Marzo,Singapur,3,4,,7,POINT (4697157 -74140516)
2016,Marzo,Singapur,0,1,,1,POINT (6170465 -7542726)
2016,Marzo,Sri Lanka,0,1,,1,POINT (4697157 -74140516)
2016,Marzo,Sudáfrica,2,8,,10,POINT (4697157 -74140516)
2016,Marzo,Sudáfrica,3,1,,4,POINT (6170465 -7542726)
2016,Marzo,Sudán,0,1,,1,POINT (6170465 -7542726)
2016,Marzo,Suecia,1,1,,2,POINT (10886686 -74776479)
2016,Marzo,Suecia,0,1,,1,POINT (125862 -81702165)
2016,Marzo,Suecia,6,6,,12,POINT (3451668 -76532004)
2016,Marzo,Suecia,20,34,,54,POINT (4697157 -74140516)
2016,Marzo,Suecia,2,5,,7,POINT (6170465 -7542726)
2016,Marzo,Suiza,2,1,,3,POINT (10446304 -75516486)
2016,Marzo,Suiza,1,2,,3,POINT (125862 -81702165)
2016,Marzo,Suiza,11,19,,30,POINT (3451668 -76532004)
2016,Marzo,Suiza,66,91,,157,POINT (4697157 -74140516)
2016,Marzo,Suiza,1,2,,3,POINT (4815189 -75736374)
2016,Marzo,Suiza,9,11,,20,POINT (6170465 -7542726)
2016,Marzo,Surinam,1,4,,5,POINT (4697157 -74140516)
2016,Marzo,Surinam,8,7,,15,POINT (6170465 -7542726)
2016,Marzo,Taiwán,0,2,,2,POINT (4697157 -74140516)
2016,Marzo,Taiwán,0,1,,1,POINT (6170465 -7542726)
2016,Marzo,Tailandia,2,1,,3,POINT (4697157 -74140516)
2016,Marzo,Tailandia,1,0,,1,POINT (6170465 -7542726)
2016,Marzo,Trinidad y Tobago,2,73,,75,POINT (10406342 -75527794)
2016,Marzo,Trinidad y Tobago,1,1,,2,POINT (10446304 -75516486)
2016,Marzo,Trinidad y Tobago,1,0,,1,POINT (10886686 -74776479)
2016,Marzo,Trinidad y Tobago,3,6,,9,POINT (3451668 -76532004)
2016,Marzo,Trinidad y Tobago,0,12,,12,POINT (4697157 -74140516)
2016,Marzo,Trinidad y Tobago,10,9,,19,POINT (6170465 -7542726)
2016,Marzo,Turkmenistán,1,1,,2,POINT (3451668 -76532004)
2016,Marzo,Turquía,0,3,,3,POINT (10970933 -74765343)
2016,Marzo,Turquía,0,1,,1,POINT (11247723 -74213989)
2016,Marzo,Turquía,9,18,,27,POINT (4697157 -74140516)
2016,Marzo,Turquía,2,0,,2,POINT (6170465 -7542726)
2016,Marzo,Ucrania,0,1,,1,POINT (10886686 -74776479)
2016,Marzo,Ucrania,2,2,,4,POINT (4697157 -74140516)
2016,Marzo,Uganda,0,2,,2,POINT (4697157 -74140516)
2016,Marzo,Uruguay,1,0,,1,POINT (0.81488 -77356)
2016,Marzo,Uruguay,1,5,,6,POINT (10446304 -75516486)
2016,Marzo,Uruguay,1,4,,5,POINT (10886686 -74776479)
2016,Marzo,Uruguay,0,11,,11,POINT (10970933 -74765343)
2016,Marzo,Uruguay,39,33,,72,POINT (125862 -81702165)
2016,Marzo,Uruguay,9,31,,40,POINT (3451668 -76532004)
2016,Marzo,Uruguay,72,91,,163,POINT (4697157 -74140516)
2016,Marzo,Uruguay,1,0,,1,POINT (4815189 -75736374)
2016,Marzo,Uruguay,44,123,,167,POINT (6170465 -7542726)
2016,Marzo,Vanuatu,1,0,,1,POINT (4697157 -74140516)
2016,Marzo,Venezuela,2,9,,11,POINT (10406342 -75527794)
2016,Marzo,Venezuela,3,6,,9,POINT (10446304 -75516486)
2016,Marzo,Venezuela,16,42,,58,POINT (10886686 -74776479)
2016,Marzo,Venezuela,0,10,,10,POINT (11117206 -74232675)
2016,Marzo,Venezuela,424,602,,1026,POINT (11360029 -72129595)
2016,Marzo,Venezuela,0,1,,1,POINT (125862 -81702165)
2016,Marzo,Venezuela,11,18,,29,POINT (3451668 -76532004)
2016,Marzo,Venezuela,53,72,,125,POINT (3866713 -67927521)
2016,Marzo,Venezuela,3610,4205,,7815,POINT (4697157 -74140516)
2016,Marzo,Venezuela,3,5,,8,POINT (4815189 -75736374)
2016,Marzo,Venezuela,831,812,,1643,POINT (6170465 -7542726)
2016,Marzo,Venezuela,81,134,,215,POINT (6185536 -67484028)
2016,Marzo,Venezuela,63,93,,156,POINT (7088729 -70740253)
2016,Marzo,Venezuela,2,11,,13,POINT (7128047 -73181317)
2016,Marzo,Venezuela,1656,2095,,3751,POINT (7819 -72453013)
2016,Marzo,Venezuela,107,146,,253,POINT (7927233 -72508188)
2016,Marzo,Vietnam,1,0,,1,POINT (4697157 -74140516)
2016,Abril,Afganistán,0,1,,1,POINT (4697157 -74140516)
2016,Abril,Alemania,1,0,,1,POINT (10446304 -75516486)
2016,Abril,Alemania,3,3,,6,POINT (10886686 -74776479)
2016,Abril,Alemania,25,33,,58,POINT (3451668 -76532004)
2016,Abril,Alemania,892,1625,,2517,POINT (4697157 -74140516)
2016,Abril,Alemania,2,2,,4,POINT (4815189 -75736374)
2016,Abril,Alemania,20,35,,55,POINT (6170465 -7542726)
2016,Abril,Alemania,1,0,,1,POINT (7128047 -73181317)
2016,Abril,Andorra,0,1,,1,POINT (4697157 -74140516)
2016,Abril,Antigua y Barbuda,0,3,,3,POINT (10406342 -75527794)
2016,Abril,Antigua y Barbuda,1,4,,5,POINT (4697157 -74140516)
2016,Abril,Antigua y Barbuda,1,0,,1,POINT (6170465 -7542726)
2016,Abril,Países Bajos,6,24,,30,POINT (10406342 -75527794)
2016,Abril,Países Bajos,2,4,,6,POINT (10446304 -75516486)
2016,Abril,Países Bajos,76,84,,160,POINT (10886686 -74776479)
2016,Abril,Países Bajos,1,4,,5,POINT (11247723 -74213989)
2016,Abril,Países Bajos,78,123,,201,POINT (3451668 -76532004)
2016,Abril,Países Bajos,819,1189,,2008,POINT (4697157 -74140516)
2016,Abril,Países Bajos,2,1,,3,POINT (4815189 -75736374)
2016,Abril,Países Bajos,248,281,,529,POINT (6170465 -7542726)
2016,Abril,Países Bajos,3,3,,6,POINT (7128047 -73181317)
2016,Abril,Países Bajos,0,1,,1,POINT (7927233 -72508188)
2016,Abril,Países Bajos,0,1,,1,POINT (806667 -767333)
2016,Abril,Arabia Saudita,0,2,,2,POINT (3451668 -76532004)
2016,Abril,Argelia,1,2,,3,POINT (4697157 -74140516)
2016,Abril,Argelia,0,1,,1,POINT (6170465 -7542726)
2016,Abril,Argentina,15,19,,34,POINT (0.81488 -77356)
2016,Abril,Argentina,36,16,,52,POINT (10446304 -75516486)
2016,Abril,Argentina,8,14,,22,POINT (10886686 -74776479)
2016,Abril,Argentina,168,105,,273,POINT (125862 -81702165)
2016,Abril,Argentina,39,70,,109,POINT (3451668 -76532004)
2016,Abril,Argentina,2074,2920,,4994,POINT (4697157 -74140516)
2016,Abril,Argentina,1,1,,2,POINT (4815189 -75736374)
2016,Abril,Argentina,53,136,,189,POINT (6170465 -7542726)
2016,Abril,Argentina,4,1,,5,POINT (7128047 -73181317)
2016,Abril,República de Armenia,1,0,,1,POINT (4697157 -74140516)
2016,Abril,Aruba,19,36,,55,POINT (10406342 -75527794)
2016,Abril,Aruba,1,3,,4,POINT (10446304 -75516486)
2016,Abril,Aruba,10,20,,30,POINT (10886686 -74776479)
2016,Abril,Aruba,0,2,,2,POINT (10970933 -74765343)
2016,Abril,Aruba,1,2,,3,POINT (11247723 -74213989)
2016,Abril,Aruba,4,7,,11,POINT (3451668 -76532004)
2016,Abril,Aruba,563,698,,1261,POINT (4697157 -74140516)
2016,Abril,Aruba,0,1,,1,POINT (4815189 -75736374)
2016,Abril,Aruba,89,115,,204,POINT (6170465 -7542726)
2016,Abril,Aruba,10,16,,26,POINT (7128047 -73181317)
2016,Abril,Australia,2,3,,5,POINT (10446304 -75516486)
2016,Abril,Australia,0,1,,1,POINT (10886686 -74776479)
2016,Abril,Australia,6,1,,7,POINT (3451668 -76532004)
2016,Abril,Australia,21,27,,48,POINT (4697157 -74140516)
2016,Abril,Australia,0,1,,1,POINT (4815189 -75736374)
2016,Abril,Australia,9,12,,21,POINT (6170465 -7542726)
2016,Abril,Austria,0,1,,1,POINT (10886686 -74776479)
2016,Abril,Austria,0,1,,1,POINT (125862 -81702165)
2016,Abril,Austria,5,21,,26,POINT (4697157 -74140516)
2016,Abril,Azerbaiyán,1,0,,1,POINT (4697157 -74140516)
2016,Abril,Bahamas,1,1,,2,POINT (10406342 -75527794)
2016,Abril,Bahamas,0,1,,1,POINT (10886686 -74776479)
2016,Abril,Bahamas,0,1,,1,POINT (4697157 -74140516)
2016,Abril,Bahamas,0,4,,4,POINT (6170465 -7542726)
2016,Abril,Bahréin,1,0,,1,POINT (10446304 -75516486)
2016,Abril,Bahréin,0,1,,1,POINT (4697157 -74140516)
2016,Abril,Bangladesh,0,1,,1,POINT (3451668 -76532004)
2016,Abril,Barbados,0,8,,8,POINT (10446304 -75516486)
2016,Abril,Barbados,32,38,,70,POINT (4697157 -74140516)
2016,Abril,República de Belarús,2,5,,7,POINT (4697157 -74140516)
2016,Abril,Bélgica,0,1,,1,POINT (10886686 -74776479)
2016,Abril,Bélgica,2,6,,8,POINT (3451668 -76532004)
2016,Abril,Bélgica,14,25,,39,POINT (4697157 -74140516)
2016,Abril,Bélgica,3,2,,5,POINT (6170465 -7542726)
2016,Abril,Belice,0,2,,2,POINT (3451668 -76532004)
2016,Abril,Belice,1,7,,8,POINT (4697157 -74140516)
2016,Abril,Benín,0,1,,1,POINT (3451668 -76532004)
2016,Abril,Benín,0,2,,2,POINT (4697157 -74140516)
2016,Abril,Bermudas/Territorio Británico de Ultramar,0,1,,1,POINT (6170465 -7542726)
2016,Abril,Bolivia,0,1,,1,POINT (0.81488 -77356)
2016,Abril,Bolivia,2,2,,4,POINT (10446304 -75516486)
2016,Abril,Bolivia,14,9,,23,POINT (10886686 -74776479)
2016,Abril,Bolivia,30,26,,56,POINT (125862 -81702165)
2016,Abril,Bolivia,27,45,,72,POINT (3451668 -76532004)
2016,Abril,Bolivia,375,505,,880,POINT (4697157 -74140516)
2016,Abril,Bolivia,1,0,,1,POINT (4815189 -75736374)
2016,Abril,Bolivia,43,57,,100,POINT (6170465 -7542726)
2016,Abril,Botsuana,0,1,,1,POINT (4697157 -74140516)
2016,Abril,Brasil,107,151,,258,POINT (-4191162 -69941498)
2016,Abril,Brasil,0,8,,8,POINT (-4214082 -69941431)
2016,Abril,Brasil,2,3,,5,POINT (0.81488 -77356)
2016,Abril,Brasil,0,8,,8,POINT (10406342 -75527794)
2016,Abril,Brasil,46,36,,82,POINT (10446304 -75516486)
2016,Abril,Brasil,1,12,,13,POINT (10886686 -74776479)
2016,Abril,Brasil,0,2,,2,POINT (10970933 -74765343)
2016,Abril,Brasil,337,274,,611,POINT (125862 -81702165)
2016,Abril,Brasil,100,115,,215,POINT (3451668 -76532004)
2016,Abril,Brasil,5270,6557,,11827,POINT (4697157 -74140516)
2016,Abril,Brasil,2,3,,5,POINT (4815189 -75736374)
2016,Abril,Brasil,108,207,,315,POINT (6170465 -7542726)
2016,Abril,Brasil,0,2,,2,POINT (7128047 -73181317)
2016,Abril,Bulgaria,0,1,,1,POINT (4697157 -74140516)
2016,Abril,Burundi,0,1,,1,POINT (4697157 -74140516)
2016,Abril,Cabo Verde,0,1,,1,POINT (4697157 -74140516)
2016,Abril,Islas Caimán/Territorio Británico de Ultramar,3,1,,4,POINT (10406342 -75527794)
2016,Abril,Islas Caimán/Territorio Británico de Ultramar,1,0,,1,POINT (125862 -81702165)
2016,Abril,Islas Caimán/Territorio Británico de Ultramar,3,4,,7,POINT (133387613 -81372937)
2016,Abril,Islas Caimán/Territorio Británico de Ultramar,1,2,,3,POINT (4697157 -74140516)
2016,Abril,Islas Caimán/Territorio Británico de Ultramar,0,1,,1,POINT (6170465 -7542726)
2016,Abril,Canadá,0,4,,4,POINT (10406342 -75527794)
2016,Abril,Canadá,3,2,,5,POINT (10446304 -75516486)
2016,Abril,Canadá,4,5,,9,POINT (10886686 -74776479)
2016,Abril,Canadá,1,0,,1,POINT (125862 -81702165)
2016,Abril,Canadá,30,49,,79,POINT (3451668 -76532004)
2016,Abril,Canadá,394,671,,1065,POINT (4697157 -74140516)
2016,Abril,Canadá,0,3,,3,POINT (4815189 -75736374)
2016,Abril,Canadá,65,121,,186,POINT (6170465 -7542726)
2016,Abril,Canadá,2,4,,6,POINT (7128047 -73181317)
2016,Abril,Canadá,1,1,,2,POINT (7927233 -72508188)
2016,Abril,Canadá,0,2,,2,POINT (9402597 -75681642)
2016,Abril,España,0,8,,8,POINT (10406342 -75527794)
2016,Abril,España,1,4,,5,POINT (10886686 -74776479)
2016,Abril,España,0,1,,1,POINT (125862 -81702165)
2016,Abril,España,311,507,,818,POINT (3451668 -76532004)
2016,Abril,España,2152,4416,,6568,POINT (4697157 -74140516)
2016,Abril,España,4,5,,9,POINT (4815189 -75736374)
2016,Abril,España,157,367,,524,POINT (6170465 -7542726)
2016,Abril,España,0,1,,1,POINT (7128047 -73181317)
2016,Abril,República de Corea,0,8,,8,POINT (10406342 -75527794)
2016,Abril,República de Corea,1,1,,2,POINT (3451668 -76532004)
2016,Abril,República de Corea,6,14,,20,POINT (4697157 -74140516)
2016,Abril,República de Corea,1,3,,4,POINT (6170465 -7542726)
2016,Abril,República de Corea,0,3,,3,POINT (7927233 -72508188)
2016,Abril,Costa de Marfil,2,1,,3,POINT (3451668 -76532004)
2016,Abril,Costa de Marfil,2,6,,8,POINT (4697157 -74140516)
2016,Abril,Costa Rica,0,4,,4,POINT (10406342 -75527794)
2016,Abril,Costa Rica,2,7,,9,POINT (10446304 -75516486)
2016,Abril,Costa Rica,4,14,,18,POINT (10886686 -74776479)
2016,Abril,Costa Rica,0,6,,6,POINT (10970933 -74765343)
2016,Abril,Costa Rica,0,3,,3,POINT (11117206 -74232675)
2016,Abril,Costa Rica,153,111,,264,POINT (125862 -81702165)
2016,Abril,Costa Rica,34,27,,61,POINT (3451668 -76532004)
2016,Abril,Costa Rica,786,1272,,2058,POINT (4697157 -74140516)
2016,Abril,Costa Rica,7,16,,23,POINT (4815189 -75736374)
2016,Abril,Costa Rica,79,123,,202,POINT (6170465 -7542726)
2016,Abril,Costa Rica,1,2,,3,POINT (7128047 -73181317)
2016,Abril,Costa Rica,0,4,,4,POINT (7927233 -72508188)
2016,Abril,Costa Rica,0,1,,1,POINT (863337 -7735002)
2016,Abril,Croacia,0,6,,6,POINT (4697157 -74140516)
2016,Abril,Croacia,0,2,,2,POINT (6170465 -7542726)
2016,Abril,Cuba,0,4,,4,POINT (10406342 -75527794)
2016,Abril,Cuba,9,97,,106,POINT (10446304 -75516486)
2016,Abril,Cuba,4,3,,7,POINT (10886686 -74776479)
2016,Abril,Cuba,1,2,,3,POINT (125862 -81702165)
2016,Abril,Cuba,0,3,,3,POINT (133387613 -81372937)
2016,Abril,Cuba,11,13,,24,POINT (3451668 -76532004)
2016,Abril,Cuba,244,414,,658,POINT (4697157 -74140516)
2016,Abril,Cuba,2,1,,3,POINT (4815189 -75736374)
2016,Abril,Cuba,18,18,,36,POINT (6170465 -7542726)
2016,Abril,Cuba,2,1,,3,POINT (7128047 -73181317)
2016,Abril,Cuba,0,1,,1,POINT (7927233 -72508188)
2016,Abril,Curazao,2,0,,2,POINT (4697157 -74140516)
2016,Abril,República Checa,2,4,,6,POINT (4697157 -74140516)
2016,Abril,Chile,4,9,,13,POINT (0.81488 -77356)
2016,Abril,Chile,9,2,,11,POINT (10446304 -75516486)
2016,Abril,Chile,1,4,,5,POINT (10886686 -74776479)
2016,Abril,Chile,22,17,,39,POINT (125862 -81702165)
2016,Abril,Chile,30,43,,73,POINT (3451668 -76532004)
2016,Abril,Chile,4037,5367,,9404,POINT (4697157 -74140516)
2016,Abril,Chile,2,5,,7,POINT (4815189 -75736374)
2016,Abril,Chile,31,50,,81,POINT (6170465 -7542726)
2016,Abril,Chile,1,1,,2,POINT (7927233 -72508188)
2016,Abril,China,2,0,,2,POINT (3451668 -76532004)
2016,Abril,China,28,77,,105,POINT (4697157 -74140516)
2016,Abril,China,4,5,,9,POINT (6170465 -7542726)
2016,Abril,Dinamarca,0,1,,1,POINT (10886686 -74776479)
2016,Abril,Dinamarca,3,3,,6,POINT (3451668 -76532004)
2016,Abril,Dinamarca,14,16,,30,POINT (4697157 -74140516)
2016,Abril,Dinamarca,2,1,,3,POINT (6170465 -7542726)
2016,Abril,Dominica,1,3,,4,POINT (4697157 -74140516)
2016,Abril,Ecuador,0,1,,1,POINT (0.185957 -7478366)
2016,Abril,Ecuador,105,188,,293,POINT (0.33002 -76876446)
2016,Abril,Ecuador,2,1,,3,POINT (0.812436 -77847006)
2016,Abril,Ecuador,3613,4894,,8507,POINT (0.81488 -77356)
2016,Abril,Ecuador,45,38,,83,POINT (1800143 -78802679)
2016,Abril,Ecuador,0,5,,5,POINT (10406342 -75527794)
2016,Abril,Ecuador,3,2,,5,POINT (10446304 -75516486)
2016,Abril,Ecuador,1,1,,2,POINT (10886686 -74776479)
2016,Abril,Ecuador,14,11,,25,POINT (125862 -81702165)
2016,Abril,Ecuador,416,501,,917,POINT (3451668 -76532004)
2016,Abril,Ecuador,3038,4369,,7407,POINT (4697157 -74140516)
2016,Abril,Ecuador,8,5,,13,POINT (4815189 -75736374)
2016,Abril,Ecuador,21,43,,64,POINT (6170465 -7542726)
2016,Abril,Ecuador,0,1,,1,POINT (7128047 -73181317)
2016,Abril,Ecuador,1,0,,1,POINT (7927233 -72508188)
2016,Abril,Egipto,2,7,,9,POINT (4697157 -74140516)
2016,Abril,El Salvador,3,3,,6,POINT (10446304 -75516486)
2016,Abril,El Salvador,2,0,,2,POINT (10886686 -74776479)
2016,Abril,El Salvador,11,8,,19,POINT (125862 -81702165)
2016,Abril,El Salvador,97,160,,257,POINT (3451668 -76532004)
2016,Abril,El Salvador,958,1427,,2385,POINT (4697157 -74140516)
2016,Abril,El Salvador,1,0,,1,POINT (4815189 -75736374)
2016,Abril,El Salvador,153,224,,377,POINT (6170465 -7542726)
2016,Abril,Emiratos Árabes,0,1,,1,POINT (3451668 -76532004)
2016,Abril,Emiratos Árabes,2,2,,4,POINT (4697157 -74140516)
2016,Abril,Eslovaquia,1,0,,1,POINT (10446304 -75516486)
2016,Abril,Eslovaquia,0,4,,4,POINT (4697157 -74140516)
2016,Abril,Eslovenia,0,2,,2,POINT (4697157 -74140516)
2016,Abril,Estados Unidos de América,7,65,,72,POINT (10406342 -75527794)
2016,Abril,Estados Unidos de América,3199,4563,,7762,POINT (10446304 -75516486)
2016,Abril,Estados Unidos de América,425,879,,1304,POINT (10886686 -74776479)
2016,Abril,Estados Unidos de América,0,15,,15,POINT (10970933 -74765343)
2016,Abril,Estados Unidos de América,0,6,,6,POINT (11247723 -74213989)
2016,Abril,Estados Unidos de América,10,26,,36,POINT (125862 -81702165)
2016,Abril,Estados Unidos de América,891,1244,,2135,POINT (3451668 -76532004)
2016,Abril,Estados Unidos de América,114,168,,282,POINT (445285 -75766353)
2016,Abril,Estados Unidos de América,7157,13664,,20821,POINT (4697157 -74140516)
2016,Abril,Estados Unidos de América,125,155,,280,POINT (4815189 -75736374)
2016,Abril,Estados Unidos de América,2180,5515,,7695,POINT (6170465 -7542726)
2016,Abril,Estados Unidos de América,14,25,,39,POINT (7128047 -73181317)
2016,Abril,Estados Unidos de América,15,22,,37,POINT (7927233 -72508188)
2016,Abril,Estados Unidos de América,0,7,,7,POINT (9402597 -75681642)
2016,Abril,Etiopia,1,0,,1,POINT (3451668 -76532004)
2016,Abril,Etiopia,1,1,,2,POINT (4697157 -74140516)
2016,Abril,Islas Fiji,0,1,,1,POINT (4697157 -74140516)
2016,Abril,Filipinas,0,3,,3,POINT (10446304 -75516486)
2016,Abril,Filipinas,0,10,,10,POINT (10886686 -74776479)
2016,Abril,Filipinas,1,16,,17,POINT (4697157 -74140516)
2016,Abril,Finlandia,0,3,,3,POINT (3451668 -76532004)
2016,Abril,Finlandia,4,7,,11,POINT (4697157 -74140516)
2016,Abril,Finlandia,1,1,,2,POINT (6170465 -7542726)
2016,Abril,Francia,0,1,,1,POINT (1800143 -78802679)
2016,Abril,Francia,0,1,,1,POINT (10406342 -75527794)
2016,Abril,Francia,2,1,,3,POINT (10446304 -75516486)
2016,Abril,Francia,2,3,,5,POINT (10886686 -74776479)
2016,Abril,Francia,24,46,,70,POINT (3451668 -76532004)
2016,Abril,Francia,1132,1911,,3043,POINT (4697157 -74140516)
2016,Abril,Francia,1,3,,4,POINT (4815189 -75736374)
2016,Abril,Francia,22,31,,53,POINT (6170465 -7542726)
2016,Abril,Francia,0,1,,1,POINT (7927233 -72508188)
2016,Abril,Gabón,0,1,,1,POINT (4697157 -74140516)
2016,Abril,Ghana,1,1,,2,POINT (4697157 -74140516)
2016,Abril,Gibraltar/Territorio Británico de Ultramar,1,1,,2,POINT (0.81488 -77356)
2016,Abril,Granada,0,1,,1,POINT (4815189 -75736374)
2016,Abril,Grecia,0,1,,1,POINT (3451668 -76532004)
2016,Abril,Grecia,0,4,,4,POINT (4697157 -74140516)
2016,Abril,Grecia,1,0,,1,POINT (6170465 -7542726)
2016,Abril,Guatemala,4,1,,5,POINT (10446304 -75516486)
2016,Abril,Guatemala,5,5,,10,POINT (10886686 -74776479)
2016,Abril,Guatemala,24,20,,44,POINT (125862 -81702165)
2016,Abril,Guatemala,20,37,,57,POINT (3451668 -76532004)
2016,Abril,Guatemala,294,599,,893,POINT (4697157 -74140516)
2016,Abril,Guatemala,3,7,,10,POINT (4815189 -75736374)
2016,Abril,Guatemala,43,79,,122,POINT (6170465 -7542726)
2016,Abril,Guatemala,2,4,,6,POINT (7128047 -73181317)
2016,Abril,Guatemala,1,0,,1,POINT (7927233 -72508188)
2016,Abril,Guyana,2,0,,2,POINT (4815189 -75736374)
2016,Abril,Guadalupe/Territorio Francés,0,1,,1,POINT (10446304 -75516486)
2016,Abril,Guadalupe/Territorio Francés,1,0,,1,POINT (3451668 -76532004)
2016,Abril,Guadalupe/Territorio Francés,1,3,,4,POINT (4697157 -74140516)
2016,Abril,Guadalupe/Territorio Francés,1,0,,1,POINT (6170465 -7542726)
2016,Abril,Haití,0,3,,3,POINT (10446304 -75516486)
2016,Abril,Haití,1,2,,3,POINT (4697157 -74140516)
2016,Abril,Haití,2,0,,2,POINT (7128047 -73181317)
2016,Abril,Honduras,1,12,,13,POINT (10406342 -75527794)
2016,Abril,Honduras,2,0,,2,POINT (10446304 -75516486)
2016,Abril,Honduras,0,2,,2,POINT (10886686 -74776479)
2016,Abril,Honduras,0,3,,3,POINT (11247723 -74213989)
2016,Abril,Honduras,1,2,,3,POINT (125744111 -81703935)
2016,Abril,Honduras,3,0,,3,POINT (125862 -81702165)
2016,Abril,Honduras,3,3,,6,POINT (133387613 -81372937)
2016,Abril,Honduras,22,22,,44,POINT (3451668 -76532004)
2016,Abril,Honduras,58,69,,127,POINT (4697157 -74140516)
2016,Abril,Honduras,57,71,,128,POINT (6170465 -7542726)
2016,Abril,Honduras,0,3,,3,POINT (7128047 -73181317)
2016,Abril,Hong Kong,1,2,,3,POINT (4697157 -74140516)
2016,Abril,Hungría,2,6,,8,POINT (4697157 -74140516)
2016,Abril,Hungría,0,1,,1,POINT (4815189 -75736374)
2016,Abril,India,0,3,,3,POINT (10886686 -74776479)
2016,Abril,India,0,1,,1,POINT (3451668 -76532004)
2016,Abril,India,3,20,,23,POINT (4697157 -74140516)
2016,Abril,India,4,13,,17,POINT (6170465 -7542726)
2016,Abril,Indonesia,1,1,,2,POINT (4697157 -74140516)
2016,Abril,República de Irlanda,1,0,,1,POINT (3451668 -76532004)
2016,Abril,República de Irlanda,6,14,,20,POINT (4697157 -74140516)
2016,Abril,República de Irlanda,0,1,,1,POINT (6170465 -7542726)
2016,Abril,Islandia,0,1,,1,POINT (4697157 -74140516)
2016,Abril,Israel,1,3,,4,POINT (10446304 -75516486)
2016,Abril,Israel,2,0,,2,POINT (10886686 -74776479)
2016,Abril,Israel,1,1,,2,POINT (125862 -81702165)
2016,Abril,Israel,1,4,,5,POINT (3451668 -76532004)
2016,Abril,Israel,29,96,,125,POINT (4697157 -74140516)
2016,Abril,Israel,5,10,,15,POINT (6170465 -7542726)
2016,Abril,Italia,0,3,,3,POINT (10446304 -75516486)
2016,Abril,Italia,1,0,,1,POINT (10886686 -74776479)
2016,Abril,Italia,7,5,,12,POINT (125862 -81702165)
2016,Abril,Italia,17,37,,54,POINT (3451668 -76532004)
2016,Abril,Italia,54,155,,209,POINT (4697157 -74140516)
2016,Abril,Italia,9,35,,44,POINT (6170465 -7542726)
2016,Abril,Italia,0,1,,1,POINT (7927233 -72508188)
2016,Abril,Jamaica,1,4,,5,POINT (10406342 -75527794)
2016,Abril,Jamaica,0,4,,4,POINT (10970933 -74765343)
2016,Abril,Jamaica,0,3,,3,POINT (133387613 -81372937)
2016,Abril,Jamaica,0,1,,1,POINT (3451668 -76532004)
2016,Abril,Jamaica,0,1,,1,POINT (4697157 -74140516)
2016,Abril,Jamaica,0,3,,3,POINT (6170465 -7542726)
2016,Abril,Japón,0,2,,2,POINT (3451668 -76532004)
2016,Abril,Japón,11,18,,29,POINT (4697157 -74140516)
2016,Abril,Japón,2,7,,9,POINT (6170465 -7542726)
2016,Abril,Japón,0,1,,1,POINT (7128047 -73181317)
2016,Abril,Jordania,1,0,,1,POINT (4697157 -74140516)
2016,Abril,Kenia,4,6,,10,POINT (4697157 -74140516)
2016,Abril,Letonia,0,1,,1,POINT (4697157 -74140516)
2016,Abril,Lituania,0,1,,1,POINT (4697157 -74140516)
2016,Abril,Líbano,1,4,,5,POINT (4697157 -74140516)
2016,Abril,Líbano,0,1,,1,POINT (6170465 -7542726)
2016,Abril,Luxemburgo,1,0,,1,POINT (3451668 -76532004)
2016,Abril,Luxemburgo,0,1,,1,POINT (4697157 -74140516)
2016,Abril,Malasia,0,2,,2,POINT (4697157 -74140516)
2016,Abril,Malasia,0,1,,1,POINT (6170465 -7542726)
2016,Abril,Malta,0,1,,1,POINT (4697157 -74140516)
2016,Abril,Marruecos,0,1,,1,POINT (4697157 -74140516)
2016,Abril,Mauritania,0,1,,1,POINT (4697157 -74140516)
2016,Abril,Martinica/Departamento de Ultramar Francés,1,1,,2,POINT (10446304 -75516486)
2016,Abril,México,0,5,,5,POINT (10406342 -75527794)
2016,Abril,México,158,108,,266,POINT (10446304 -75516486)
2016,Abril,México,10,31,,41,POINT (10886686 -74776479)
2016,Abril,México,4,5,,9,POINT (125862 -81702165)
2016,Abril,México,67,128,,195,POINT (3451668 -76532004)
2016,Abril,México,0,1,,1,POINT (445285 -75766353)
2016,Abril,México,3894,7398,,11292,POINT (4697157 -74140516)
2016,Abril,México,7,13,,20,POINT (4815189 -75736374)
2016,Abril,México,352,916,,1268,POINT (6170465 -7542726)
2016,Abril,México,3,10,,13,POINT (7128047 -73181317)
2016,Abril,México,8,7,,15,POINT (7927233 -72508188)
2016,Abril,Mónaco,2,0,,2,POINT (4697157 -74140516)
2016,Abril,Nauru,0,1,,1,POINT (4697157 -74140516)
2016,Abril,Nepal,0,1,,1,POINT (4697157 -74140516)
2016,Abril,Nicaragua,2,2,,4,POINT (10446304 -75516486)
2016,Abril,Nicaragua,14,16,,30,POINT (125744111 -81703935)
2016,Abril,Nicaragua,5,13,,18,POINT (3451668 -76532004)
2016,Abril,Nicaragua,18,34,,52,POINT (4697157 -74140516)
2016,Abril,Nicaragua,1,1,,2,POINT (4815189 -75736374)
2016,Abril,Nicaragua,7,22,,29,POINT (6170465 -7542726)
2016,Abril,Nicaragua,0,1,,1,POINT (7128047 -73181317)
2016,Abril,Nigeria,0,1,,1,POINT (10886686 -74776479)
2016,Abril,Nigeria,1,0,,1,POINT (4697157 -74140516)
2016,Abril,Noruega,2,11,,13,POINT (4697157 -74140516)
2016,Abril,Noruega,0,2,,2,POINT (4815189 -75736374)
2016,Abril,Noruega,0,2,,2,POINT (6170465 -7542726)
2016,Abril,Nueva Zelanda,1,2,,3,POINT (4697157 -74140516)
2016,Abril,Nueva Zelanda,0,2,,2,POINT (6170465 -7542726)
2016,Abril,Pakistán,0,1,,1,POINT (4697157 -74140516)
2016,Abril,Panamá,1847,1372,,3219,POINT (10406342 -75527794)
2016,Abril,Panamá,1,3,,4,POINT (10433609 -73247863)
2016,Abril,Panamá,3026,3443,,6469,POINT (10446304 -75516486)
2016,Abril,Panamá,180,486,,666,POINT (10886686 -74776479)
2016,Abril,Panamá,0,26,,26,POINT (10970933 -74765343)
2016,Abril,Panamá,0,1,,1,POINT (11247723 -74213989)
2016,Abril,Panamá,8,13,,21,POINT (125744111 -81703935)
2016,Abril,Panamá,383,296,,679,POINT (125862 -81702165)
2016,Abril,Panamá,8,11,,19,POINT (133387613 -81372937)
2016,Abril,Panamá,275,408,,683,POINT (3451668 -76532004)
2016,Abril,Panamá,0,5,,5,POINT (3884426 -77061029)
2016,Abril,Panamá,85,137,,222,POINT (445285 -75766353)
2016,Abril,Panamá,4747,6421,,11168,POINT (4697157 -74140516)
2016,Abril,Panamá,56,75,,131,POINT (4815189 -75736374)
2016,Abril,Panamá,1907,2546,,4453,POINT (6170465 -7542726)
2016,Abril,Panamá,0,1,,1,POINT (6222552 -77401154)
2016,Abril,Panamá,1,0,,1,POINT (7102626 -77762647)
2016,Abril,Panamá,14,33,,47,POINT (7128047 -73181317)
2016,Abril,Panamá,32,49,,81,POINT (7927233 -72508188)
2016,Abril,Panamá,0,1,,1,POINT (806667 -767333)
2016,Abril,Panamá,127,149,,276,POINT (863337 -7735002)
2016,Abril,Panamá,0,15,,15,POINT (9402597 -75681642)
2016,Abril,Paraguay,6,1,,7,POINT (10446304 -75516486)
2016,Abril,Paraguay,0,1,,1,POINT (10886686 -74776479)
2016,Abril,Paraguay,43,20,,63,POINT (125862 -81702165)
2016,Abril,Paraguay,6,15,,21,POINT (3451668 -76532004)
2016,Abril,Paraguay,48,54,,102,POINT (4697157 -74140516)
2016,Abril,Paraguay,1,0,,1,POINT (4815189 -75736374)
2016,Abril,Paraguay,26,26,,52,POINT (6170465 -7542726)
2016,Abril,Paraguay,1,2,,3,POINT (7927233 -72508188)
2016,Abril,Perú,98,157,,255,POINT (-4191162 -69941498)
2016,Abril,Perú,1,0,,1,POINT (0.185957 -7478366)
2016,Abril,Perú,7,30,,37,POINT (0.81488 -77356)
2016,Abril,Perú,0,2,,2,POINT (10406342 -75527794)
2016,Abril,Perú,18,9,,27,POINT (10446304 -75516486)
2016,Abril,Perú,3,2,,5,POINT (10886686 -74776479)
2016,Abril,Perú,104,79,,183,POINT (125862 -81702165)
2016,Abril,Perú,277,427,,704,POINT (3451668 -76532004)
2016,Abril,Perú,5237,7643,,12880,POINT (4697157 -74140516)
2016,Abril,Perú,1,4,,5,POINT (4815189 -75736374)
2016,Abril,Perú,351,757,,1108,POINT (6170465 -7542726)
2016,Abril,Palestina,0,1,,1,POINT (4697157 -74140516)
2016,Abril,Polonia,10,17,,27,POINT (4697157 -74140516)
2016,Abril,Polonia,0,1,,1,POINT (6170465 -7542726)
2016,Abril,Portugal,2,13,,15,POINT (3451668 -76532004)
2016,Abril,Portugal,17,52,,69,POINT (4697157 -74140516)
2016,Abril,Portugal,0,1,,1,POINT (4815189 -75736374)
2016,Abril,Portugal,0,5,,5,POINT (6170465 -7542726)
2016,Abril,Puerto Rico/Territorio de Estados Unidos,1,4,,5,POINT (10433609 -73247863)
2016,Abril,Puerto Rico/Territorio de Estados Unidos,0,2,,2,POINT (10446304 -75516486)
2016,Abril,Puerto Rico/Territorio de Estados Unidos,8,41,,49,POINT (10886686 -74776479)
2016,Abril,Puerto Rico/Territorio de Estados Unidos,1,3,,4,POINT (125862 -81702165)
2016,Abril,Puerto Rico/Territorio de Estados Unidos,33,34,,67,POINT (3451668 -76532004)
2016,Abril,Puerto Rico/Territorio de Estados Unidos,173,299,,472,POINT (4697157 -74140516)
2016,Abril,Puerto Rico/Territorio de Estados Unidos,3,4,,7,POINT (4815189 -75736374)
2016,Abril,Puerto Rico/Territorio de Estados Unidos,44,67,,111,POINT (6170465 -7542726)
2016,Abril,Puerto Rico/Territorio de Estados Unidos,1,3,,4,POINT (7128047 -73181317)
2016,Abril,Qatar,0,2,,2,POINT (4697157 -74140516)
2016,Abril,Reino Unido de Gran Bretaña e Irlanda del Norte,0,2,,2,POINT (10446304 -75516486)
2016,Abril,Reino Unido de Gran Bretaña e Irlanda del Norte,1,4,,5,POINT (10886686 -74776479)
2016,Abril,Reino Unido de Gran Bretaña e Irlanda del Norte,10,25,,35,POINT (3451668 -76532004)
2016,Abril,Reino Unido de Gran Bretaña e Irlanda del Norte,484,856,,1340,POINT (4697157 -74140516)
2016,Abril,Reino Unido de Gran Bretaña e Irlanda del Norte,15,26,,41,POINT (6170465 -7542726)
2016,Abril,Federación de Rusia,0,1,,1,POINT (11247723 -74213989)
2016,Abril,Federación de Rusia,1,1,,2,POINT (3451668 -76532004)
2016,Abril,Federación de Rusia,5,13,,18,POINT (4697157 -74140516)
2016,Abril,Federación de Rusia,2,2,,4,POINT (6170465 -7542726)
2016,Abril,República Dominicana,0,16,,16,POINT (10406342 -75527794)
2016,Abril,República Dominicana,5,5,,10,POINT (10446304 -75516486)
2016,Abril,República Dominicana,3,16,,19,POINT (10886686 -74776479)
2016,Abril,República Dominicana,0,2,,2,POINT (11247723 -74213989)
2016,Abril,República Dominicana,0,2,,2,POINT (125862 -81702165)
2016,Abril,República Dominicana,20,30,,50,POINT (3451668 -76532004)
2016,Abril,República Dominicana,453,659,,1112,POINT (4697157 -74140516)
2016,Abril,República Dominicana,6,5,,11,POINT (4815189 -75736374)
2016,Abril,República Dominicana,22,28,,50,POINT (6170465 -7542726)
2016,Abril,República Dominicana,1,0,,1,POINT (7128047 -73181317)
2016,Abril,República Dominicana,1,0,,1,POINT (7927233 -72508188)
2016,Abril,República Democrática Popular de Corea,0,1,,1,POINT (10406342 -75527794)
2016,Abril,Rumania,4,11,,15,POINT (4697157 -74140516)
2016,Abril,San Cristóbal y Nevis,0,1,,1,POINT (6170465 -7542726)
2016,Abril,Santa Elena/Territorio Británico de Ultramar,0,1,,1,POINT (4697157 -74140516)
2016,Abril,Santa Lucia,1,3,,4,POINT (11247723 -74213989)
2016,Abril,Serbia,0,3,,3,POINT (4697157 -74140516)
2016,Abril,Sierra Leona,1,2,,3,POINT (4697157 -74140516)
2016,Abril,Singapur,0,1,,1,POINT (10406342 -75527794)
2016,Abril,Singapur,0,3,,3,POINT (4697157 -74140516)
2016,Abril,Sudáfrica,3,5,,8,POINT (4697157 -74140516)
2016,Abril,Sudáfrica,1,0,,1,POINT (6170465 -7542726)
2016,Abril,Suecia,2,5,,7,POINT (3451668 -76532004)
2016,Abril,Suecia,16,30,,46,POINT (4697157 -74140516)
2016,Abril,Suecia,3,1,,4,POINT (6170465 -7542726)
2016,Abril,Suiza,0,2,,2,POINT (10446304 -75516486)
2016,Abril,Suiza,1,1,,2,POINT (125862 -81702165)
2016,Abril,Suiza,10,21,,31,POINT (3451668 -76532004)
2016,Abril,Suiza,56,63,,119,POINT (4697157 -74140516)
2016,Abril,Suiza,1,2,,3,POINT (4815189 -75736374)
2016,Abril,Suiza,5,17,,22,POINT (6170465 -7542726)
2016,Abril,Suiza,0,1,,1,POINT (7128047 -73181317)
2016,Abril,Surinam,3,0,,3,POINT (10886686 -74776479)
2016,Abril,Surinam,0,1,,1,POINT (4697157 -74140516)
2016,Abril,Surinam,0,2,,2,POINT (6170465 -7542726)
2016,Abril,Taiwán,0,4,,4,POINT (3451668 -76532004)
2016,Abril,Taiwán,0,3,,3,POINT (4697157 -74140516)
2016,Abril,República de Tayikistán,0,1,,1,POINT (4697157 -74140516)
2016,Abril,Tailandia,1,0,,1,POINT (3451668 -76532004)
2016,Abril,Tailandia,2,3,,5,POINT (4697157 -74140516)
2016,Abril,Territorio Británico del Océano Índico/Territorios Británicos de Ultramar,1,0,,1,POINT (4697157 -74140516)
2016,Abril,Trinidad y Tobago,0,12,,12,POINT (10406342 -75527794)
2016,Abril,Trinidad y Tobago,0,1,,1,POINT (10446304 -75516486)
2016,Abril,Trinidad y Tobago,0,1,,1,POINT (125862 -81702165)
2016,Abril,Trinidad y Tobago,2,1,,3,POINT (3451668 -76532004)
2016,Abril,Trinidad y Tobago,4,9,,13,POINT (4697157 -74140516)
2016,Abril,Trinidad y Tobago,0,2,,2,POINT (4815189 -75736374)
2016,Abril,Trinidad y Tobago,0,1,,1,POINT (6170465 -7542726)
2016,Abril,Trinidad y Tobago,1,0,,1,POINT (7128047 -73181317)
2016,Abril,Túnez,0,2,,2,POINT (4697157 -74140516)
2016,Abril,Turquía,0,1,,1,POINT (11247723 -74213989)
2016,Abril,Turquía,0,1,,1,POINT (3451668 -76532004)
2016,Abril,Turquía,4,14,,18,POINT (4697157 -74140516)
2016,Abril,Turquía,0,1,,1,POINT (6170465 -7542726)
2016,Abril,Ucrania,0,1,,1,POINT (3451668 -76532004)
2016,Abril,Ucrania,2,1,,3,POINT (4697157 -74140516)
2016,Abril,Uganda,0,1,,1,POINT (3451668 -76532004)
2016,Abril,Uganda,2,0,,2,POINT (4697157 -74140516)
2016,Abril,Uruguay,0,2,,2,POINT (0.81488 -77356)
2016,Abril,Uruguay,4,2,,6,POINT (10446304 -75516486)
2016,Abril,Uruguay,0,1,,1,POINT (10886686 -74776479)
2016,Abril,Uruguay,24,21,,45,POINT (125862 -81702165)
2016,Abril,Uruguay,6,19,,25,POINT (3451668 -76532004)
2016,Abril,Uruguay,79,81,,160,POINT (4697157 -74140516)
2016,Abril,Uruguay,23,22,,45,POINT (6170465 -7542726)
2016,Abril,Uruguay,0,1,,1,POINT (7128047 -73181317)
2016,Abril,Vanuatu,0,1,,1,POINT (4697157 -74140516)
2016,Abril,Venezuela,0,9,,9,POINT (10406342 -75527794)
2016,Abril,Venezuela,6,4,,10,POINT (10433609 -73247863)
2016,Abril,Venezuela,3,21,,24,POINT (10446304 -75516486)
2016,Abril,Venezuela,11,61,,72,POINT (10886686 -74776479)
2016,Abril,Venezuela,0,1,,1,POINT (10970933 -74765343)
2016,Abril,Venezuela,0,5,,5,POINT (11117206 -74232675)
2016,Abril,Venezuela,0,3,,3,POINT (11247723 -74213989)
2016,Abril,Venezuela,402,643,,1045,POINT (11360029 -72129595)
2016,Abril,Venezuela,1,4,,5,POINT (125862 -81702165)
2016,Abril,Venezuela,15,20,,35,POINT (3451668 -76532004)
2016,Abril,Venezuela,35,26,,61,POINT (3866713 -67927521)
2016,Abril,Venezuela,3024,3553,,6577,POINT (4697157 -74140516)
2016,Abril,Venezuela,2,5,,7,POINT (4815189 -75736374)
2016,Abril,Venezuela,507,586,,1093,POINT (6170465 -7542726)
2016,Abril,Venezuela,40,53,,93,POINT (6185536 -67484028)
2016,Abril,Venezuela,51,47,,98,POINT (7088729 -70740253)
2016,Abril,Venezuela,3,3,,6,POINT (7128047 -73181317)
2016,Abril,Venezuela,1308,1935,,3243,POINT (7819 -72453013)
2016,Abril,Venezuela,90,126,,216,POINT (7927233 -72508188)
2016,Abril,Venezuela,1,0,,1,
2016,Abril,Vietnam,1,1,,2,POINT (4697157 -74140516)
2016,Abril,Islas Vírgenes Británicas/Territorio Británico de Ultramar,1,1,,2,POINT (4697157 -74140516)
2016,Abril,Islas Vírgenes Estadounidenses/Territorio de Estados Unidos,0,16,,16,POINT (10406342 -75527794)
2016,Abril,Anguila/Territorio Británico de Ultramar,1,0,,1,POINT (3451668 -76532004)
2016,Mayo,Afganistán,0,1,,1,POINT (4697157 -74140516)
2016,Mayo,Albania,0,1,,1,POINT (4697157 -74140516)
2016,Mayo,Alemania,3,1,,4,POINT (10886686 -74776479)
2016,Mayo,Alemania,0,1,,1,POINT (125862 -81702165)
2016,Mayo,Alemania,22,39,,61,POINT (3451668 -76532004)
2016,Mayo,Alemania,847,1747,,2594,POINT (4697157 -74140516)
2016,Mayo,Alemania,1,2,,3,POINT (4815189 -75736374)
2016,Mayo,Alemania,20,29,,49,POINT (6170465 -7542726)
2016,Mayo,Alemania,1,0,,1,POINT (7128047 -73181317)
2016,Mayo,Andorra,2,2,,4,POINT (4697157 -74140516)
2016,Mayo,Angola,1,1,,2,POINT (3451668 -76532004)
2016,Mayo,Angola,0,2,,2,POINT (4697157 -74140516)
2016,Mayo,Antigua y Barbuda,0,1,,1,POINT (10406342 -75527794)
2016,Mayo,Antigua y Barbuda,0,2,,2,POINT (4697157 -74140516)
2016,Mayo,Antigua y Barbuda,0,1,,1,POINT (6170465 -7542726)
2016,Mayo,Antigua y Barbuda,0,1,,1,POINT (9402597 -75681642)
2016,Mayo,Países Bajos,2,13,,15,POINT (10406342 -75527794)
2016,Mayo,Países Bajos,0,1,,1,POINT (10446304 -75516486)
2016,Mayo,Países Bajos,44,62,,106,POINT (10886686 -74776479)
2016,Mayo,Países Bajos,0,11,,11,POINT (11247723 -74213989)
2016,Mayo,Países Bajos,61,147,,208,POINT (3451668 -76532004)
2016,Mayo,Países Bajos,630,1059,,1689,POINT (4697157 -74140516)
2016,Mayo,Países Bajos,0,1,,1,POINT (4815189 -75736374)
2016,Mayo,Países Bajos,220,289,,509,POINT (6170465 -7542726)
2016,Mayo,Países Bajos,7,1,,8,POINT (7128047 -73181317)
2016,Mayo,Países Bajos,0,2,,2,POINT (9402597 -75681642)
2016,Mayo,Arabia Saudita,2,3,,5,POINT (4697157 -74140516)
2016,Mayo,Arabia Saudita,1,0,,1,POINT (6170465 -7542726)
2016,Mayo,Argelia,0,3,,3,POINT (4697157 -74140516)
2016,Mayo,Argentina,13,20,,33,POINT (0.81488 -77356)
2016,Mayo,Argentina,1,5,,6,POINT (10406342 -75527794)
2016,Mayo,Argentina,38,18,,56,POINT (10446304 -75516486)
2016,Mayo,Argentina,4,5,,9,POINT (10886686 -74776479)
2016,Mayo,Argentina,111,90,,201,POINT (125862 -81702165)
2016,Mayo,Argentina,34,51,,85,POINT (3451668 -76532004)
2016,Mayo,Argentina,1931,2836,,4767,POINT (4697157 -74140516)
2016,Mayo,Argentina,3,2,,5,POINT (4815189 -75736374)
2016,Mayo,Argentina,76,319,,395,POINT (6170465 -7542726)
2016,Mayo,Argentina,1,1,,2,POINT (7128047 -73181317)
2016,Mayo,Argentina,1,2,,3,POINT (7927233 -72508188)
2016,Mayo,Aruba,3,5,,8,POINT (10406342 -75527794)
2016,Mayo,Aruba,0,2,,2,POINT (10446304 -75516486)
2016,Mayo,Aruba,0,1,,1,POINT (10886686 -74776479)
2016,Mayo,Aruba,0,8,,8,POINT (11247723 -74213989)
2016,Mayo,Aruba,8,5,,13,POINT (3451668 -76532004)
2016,Mayo,Aruba,600,719,,1319,POINT (4697157 -74140516)
2016,Mayo,Aruba,1,2,,3,POINT (4815189 -75736374)
2016,Mayo,Aruba,106,97,,203,POINT (6170465 -7542726)
2016,Mayo,Aruba,10,11,,21,POINT (7128047 -73181317)
2016,Mayo,Australia,2,2,,4,POINT (10446304 -75516486)
2016,Mayo,Australia,0,1,,1,POINT (10886686 -74776479)
2016,Mayo,Australia,3,2,,5,POINT (3451668 -76532004)
2016,Mayo,Australia,28,40,,68,POINT (4697157 -74140516)
2016,Mayo,Australia,0,1,,1,POINT (4815189 -75736374)
2016,Mayo,Australia,29,54,,83,POINT (6170465 -7542726)
2016,Mayo,Australia,3,2,,5,POINT (7128047 -73181317)
2016,Mayo,Austria,0,2,,2,POINT (125862 -81702165)
2016,Mayo,Austria,0,2,,2,POINT (3451668 -76532004)
2016,Mayo,Austria,12,13,,25,POINT (4697157 -74140516)
2016,Mayo,Austria,0,5,,5,POINT (6170465 -7542726)
2016,Mayo,Azerbaiyán,0,1,,1,POINT (4697157 -74140516)
2016,Mayo,Bahamas,0,3,,3,POINT (10406342 -75527794)
2016,Mayo,Bahamas,1,1,,2,POINT (4697157 -74140516)
2016,Mayo,Bahamas,1,0,,1,POINT (6170465 -7542726)
2016,Mayo,Bahréin,0,1,,1,POINT (10446304 -75516486)
2016,Mayo,Bahréin,1,0,,1,POINT (4697157 -74140516)
2016,Mayo,Bangladesh,0,1,,1,POINT (4697157 -74140516)
2016,Mayo,Barbados,34,45,,79,POINT (4697157 -74140516)
2016,Mayo,República de Belarús,1,2,,3,POINT (4697157 -74140516)
2016,Mayo,República de Belarús,1,1,,2,POINT (7819 -72453013)
2016,Mayo,Bélgica,0,1,,1,POINT (10406342 -75527794)
2016,Mayo,Bélgica,1,1,,2,POINT (10886686 -74776479)
2016,Mayo,Bélgica,4,11,,15,POINT (3451668 -76532004)
2016,Mayo,Bélgica,9,28,,37,POINT (4697157 -74140516)
2016,Mayo,Bélgica,9,11,,20,POINT (6170465 -7542726)
2016,Mayo,Belice,2,3,,5,POINT (4697157 -74140516)
2016,Mayo,Belice,3,0,,3,POINT (6170465 -7542726)
2016,Mayo,Bermudas/Territorio Británico de Ultramar,0,1,,1,POINT (6170465 -7542726)
2016,Mayo,Bolivia,1,0,,1,POINT (0.81488 -77356)
2016,Mayo,Bolivia,6,5,,11,POINT (10446304 -75516486)
2016,Mayo,Bolivia,0,2,,2,POINT (10886686 -74776479)
2016,Mayo,Bolivia,29,21,,50,POINT (125862 -81702165)
2016,Mayo,Bolivia,16,39,,55,POINT (3451668 -76532004)
2016,Mayo,Bolivia,386,499,,885,POINT (4697157 -74140516)
2016,Mayo,Bolivia,1,2,,3,POINT (4815189 -75736374)
2016,Mayo,Bolivia,64,81,,145,POINT (6170465 -7542726)
2016,Mayo,Bolivia,0,1,,1,POINT (7128047 -73181317)
2016,Mayo,Bolivia,2,2,,4,POINT (7927233 -72508188)
2016,Mayo,Bosnia y Herzegovina,0,1,,1,POINT (4697157 -74140516)
2016,Mayo,Botsuana,1,0,,1,POINT (4697157 -74140516)
2016,Mayo,Brasil,110,146,,256,POINT (-4191162 -69941498)
2016,Mayo,Brasil,1,5,,6,POINT (0.81488 -77356)
2016,Mayo,Brasil,0,3,,3,POINT (10406342 -75527794)
2016,Mayo,Brasil,66,50,,116,POINT (10446304 -75516486)
2016,Mayo,Brasil,4,9,,13,POINT (10886686 -74776479)
2016,Mayo,Brasil,0,3,,3,POINT (11247723 -74213989)
2016,Mayo,Brasil,241,182,,423,POINT (125862 -81702165)
2016,Mayo,Brasil,74,119,,193,POINT (3451668 -76532004)
2016,Mayo,Brasil,0,3,,3,POINT (3866713 -67927521)
2016,Mayo,Brasil,4539,6090,,10629,POINT (4697157 -74140516)
2016,Mayo,Brasil,2,10,,12,POINT (4815189 -75736374)
2016,Mayo,Brasil,118,229,,347,POINT (6170465 -7542726)
2016,Mayo,Brasil,0,3,,3,POINT (7128047 -73181317)
2016,Mayo,Brasil,1,4,,5,POINT (7927233 -72508188)
2016,Mayo,Brunei Darussalam,0,1,,1,POINT (4697157 -74140516)
2016,Mayo,Bulgaria,1,4,,5,POINT (4697157 -74140516)
2016,Mayo,Bulgaria,0,1,,1,POINT (6170465 -7542726)
2016,Mayo,Burundi,1,0,,1,POINT (4697157 -74140516)
2016,Mayo,Islas Caimán/Territorio Británico de Ultramar,1,2,,3,POINT (10406342 -75527794)
2016,Mayo,Islas Caimán/Territorio Británico de Ultramar,0,4,,4,POINT (10886686 -74776479)
2016,Mayo,Islas Caimán/Territorio Británico de Ultramar,0,1,,1,POINT (125862 -81702165)
2016,Mayo,Islas Caimán/Territorio Británico de Ultramar,5,5,,10,POINT (133387613 -81372937)
2016,Mayo,Islas Caimán/Territorio Británico de Ultramar,0,1,,1,POINT (3451668 -76532004)
2016,Mayo,Islas Caimán/Territorio Británico de Ultramar,0,1,,1,POINT (4697157 -74140516)
2016,Mayo,Islas Caimán/Territorio Británico de Ultramar,0,1,,1,POINT (6170465 -7542726)
2016,Mayo,Camerún,0,1,,1,POINT (3451668 -76532004)
2016,Mayo,Camerún,0,1,,1,POINT (4697157 -74140516)
2016,Mayo,Canadá,0,1,,1,POINT (10406342 -75527794)
2016,Mayo,Canadá,12,9,,21,POINT (10446304 -75516486)
2016,Mayo,Canadá,5,6,,11,POINT (10886686 -74776479)
2016,Mayo,Canadá,0,1,,1,POINT (125862 -81702165)
2016,Mayo,Canadá,32,25,,57,POINT (3451668 -76532004)
2016,Mayo,Canadá,571,844,,1415,POINT (4697157 -74140516)
2016,Mayo,Canadá,4,3,,7,POINT (4815189 -75736374)
2016,Mayo,Canadá,61,182,,243,POINT (6170465 -7542726)
2016,Mayo,Canadá,2,3,,5,POINT (7128047 -73181317)
2016,Mayo,Canadá,2,3,,5,POINT (7927233 -72508188)
2016,Mayo,Chad,0,1,,1,POINT (4697157 -74140516)
2016,Mayo,España,0,2,,2,POINT (10406342 -75527794)
2016,Mayo,España,0,9,,9,POINT (10446304 -75516486)
2016,Mayo,España,3,3,,6,POINT (10886686 -74776479)
2016,Mayo,España,295,497,,792,POINT (3451668 -76532004)
2016,Mayo,España,1863,4250,,6113,POINT (4697157 -74140516)
2016,Mayo,España,7,4,,11,POINT (4815189 -75736374)
2016,Mayo,España,147,333,,480,POINT (6170465 -7542726)
2016,Mayo,España,1,0,,1,POINT (7927233 -72508188)
2016,Mayo,República de Corea,0,2,,2,POINT (10406342 -75527794)
2016,Mayo,República de Corea,1,0,,1,POINT (10886686 -74776479)
2016,Mayo,República de Corea,0,1,,1,POINT (3451668 -76532004)
2016,Mayo,República de Corea,0,2,,2,POINT (3884426 -77061029)
2016,Mayo,República de Corea,3,17,,20,POINT (4697157 -74140516)
2016,Mayo,República de Corea,2,7,,9,POINT (6170465 -7542726)
2016,Mayo,Costa de Marfil,0,4,,4,POINT (4697157 -74140516)
2016,Mayo,Costa Rica,4,6,,10,POINT (10446304 -75516486)
2016,Mayo,Costa Rica,15,18,,33,POINT (10886686 -74776479)
2016,Mayo,Costa Rica,0,3,,3,POINT (11117206 -74232675)
2016,Mayo,Costa Rica,0,9,,9,POINT (125744111 -81703935)
2016,Mayo,Costa Rica,99,89,,188,POINT (125862 -81702165)
2016,Mayo,Costa Rica,23,31,,54,POINT (3451668 -76532004)
2016,Mayo,Costa Rica,0,1,,1,POINT (3884426 -77061029)
2016,Mayo,Costa Rica,828,1359,,2187,POINT (4697157 -74140516)
2016,Mayo,Costa Rica,5,1,,6,POINT (4815189 -75736374)
2016,Mayo,Costa Rica,63,114,,177,POINT (6170465 -7542726)
2016,Mayo,Costa Rica,1,1,,2,POINT (7128047 -73181317)
2016,Mayo,Costa Rica,0,1,,1,POINT (7927233 -72508188)
2016,Mayo,Croacia,1,4,,5,POINT (4697157 -74140516)
2016,Mayo,Croacia,0,1,,1,POINT (6170465 -7542726)
2016,Mayo,Cuba,0,1,,1,POINT (10406342 -75527794)
2016,Mayo,Cuba,1,0,,1,POINT (10446304 -75516486)
2016,Mayo,Cuba,2,6,,8,POINT (10886686 -74776479)
2016,Mayo,Cuba,0,1,,1,POINT (11247723 -74213989)
2016,Mayo,Cuba,22,12,,34,POINT (3451668 -76532004)
2016,Mayo,Cuba,286,501,,787,POINT (4697157 -74140516)
2016,Mayo,Cuba,0,3,,3,POINT (4815189 -75736374)
2016,Mayo,Cuba,20,36,,56,POINT (6170465 -7542726)
2016,Mayo,Cuba,2,3,,5,POINT (7128047 -73181317)
2016,Mayo,Cuba,0,5,,5,POINT (7927233 -72508188)
2016,Mayo,Curazao,0,2,,2,POINT (4697157 -74140516)
2016,Mayo,República Checa,8,8,,16,POINT (4697157 -74140516)
2016,Mayo,Chile,9,10,,19,POINT (0.81488 -77356)
2016,Mayo,Chile,5,0,,5,POINT (10446304 -75516486)
2016,Mayo,Chile,2,4,,6,POINT (10886686 -74776479)
2016,Mayo,Chile,20,15,,35,POINT (125862 -81702165)
2016,Mayo,Chile,33,48,,81,POINT (3451668 -76532004)
2016,Mayo,Chile,4208,5696,,9904,POINT (4697157 -74140516)
2016,Mayo,Chile,1,1,,2,POINT (4815189 -75736374)
2016,Mayo,Chile,24,47,,71,POINT (6170465 -7542726)
2016,Mayo,Chile,1,2,,3,POINT (7927233 -72508188)
2016,Mayo,China,2,2,,4,POINT (3451668 -76532004)
2016,Mayo,China,31,59,,90,POINT (4697157 -74140516)
2016,Mayo,China,3,11,,14,POINT (6170465 -7542726)
2016,Mayo,Chipre,1,0,,1,POINT (4697157 -74140516)
2016,Mayo,Dinamarca,0,3,,3,POINT (3451668 -76532004)
2016,Mayo,Dinamarca,7,7,,14,POINT (4697157 -74140516)
2016,Mayo,Dinamarca,2,3,,5,POINT (6170465 -7542726)
2016,Mayo,Dinamarca,1,2,,3,POINT (7128047 -73181317)
2016,Mayo,Dominica,0,3,,3,POINT (4697157 -74140516)
2016,Mayo,Dominica,0,1,,1,POINT (6170465 -7542726)
2016,Mayo,Ecuador,0,2,,2,POINT (0.185957 -7478366)
2016,Mayo,Ecuador,124,272,,396,POINT (0.33002 -76876446)
2016,Mayo,Ecuador,2733,4610,,7343,POINT (0.81488 -77356)
2016,Mayo,Ecuador,19,37,,56,POINT (1800143 -78802679)
2016,Mayo,Ecuador,0,1,,1,POINT (10406342 -75527794)
2016,Mayo,Ecuador,5,6,,11,POINT (10446304 -75516486)
2016,Mayo,Ecuador,2,2,,4,POINT (10886686 -74776479)
2016,Mayo,Ecuador,6,5,,11,POINT (125862 -81702165)
2016,Mayo,Ecuador,320,430,,750,POINT (3451668 -76532004)
2016,Mayo,Ecuador,2,2,,4,POINT (3884426 -77061029)
2016,Mayo,Ecuador,2541,4069,,6610,POINT (4697157 -74140516)
2016,Mayo,Ecuador,1,0,,1,POINT (4815189 -75736374)
2016,Mayo,Ecuador,35,44,,79,POINT (6170465 -7542726)
2016,Mayo,Ecuador,1,0,,1,POINT (7128047 -73181317)
2016,Mayo,Ecuador,0,1,,1,POINT (7927233 -72508188)
2016,Mayo,Egipto,0,1,,1,POINT (10446304 -75516486)
2016,Mayo,Egipto,1,2,,3,POINT (4697157 -74140516)
2016,Mayo,El Salvador,1,0,,1,POINT (10446304 -75516486)
2016,Mayo,El Salvador,1,2,,3,POINT (10886686 -74776479)
2016,Mayo,El Salvador,17,18,,35,POINT (125862 -81702165)
2016,Mayo,El Salvador,97,163,,260,POINT (3451668 -76532004)
2016,Mayo,El Salvador,800,1276,,2076,POINT (4697157 -74140516)
2016,Mayo,El Salvador,160,288,,448,POINT (6170465 -7542726)
2016,Mayo,El Salvador,0,1,,1,POINT (7128047 -73181317)
2016,Mayo,Emiratos Árabes,0,1,,1,POINT (3451668 -76532004)
2016,Mayo,Emiratos Árabes,1,7,,8,POINT (4697157 -74140516)
2016,Mayo,Emiratos Árabes,0,1,,1,POINT (6170465 -7542726)
2016,Mayo,Emiratos Árabes,0,1,,1,POINT (7128047 -73181317)
2016,Mayo,Eritrea,1,0,,1,POINT (4697157 -74140516)
2016,Mayo,Eslovaquia,0,1,,1,POINT (3451668 -76532004)
2016,Mayo,Eslovaquia,2,2,,4,POINT (4697157 -74140516)
2016,Mayo,Eslovaquia,1,0,,1,POINT (6170465 -7542726)
2016,Mayo,Eslovenia,0,4,,4,POINT (4697157 -74140516)
2016,Mayo,Estados Unidos de América,1,71,,72,POINT (10406342 -75527794)
2016,Mayo,Estados Unidos de América,2778,3993,,6771,POINT (10446304 -75516486)
2016,Mayo,Estados Unidos de América,577,1034,,1611,POINT (10886686 -74776479)
2016,Mayo,Estados Unidos de América,1,10,,11,POINT (10970933 -74765343)
2016,Mayo,Estados Unidos de América,0,3,,3,POINT (11117206 -74232675)
2016,Mayo,Estados Unidos de América,0,15,,15,POINT (11247723 -74213989)
2016,Mayo,Estados Unidos de América,11,13,,24,POINT (125862 -81702165)
2016,Mayo,Estados Unidos de América,947,1335,,2282,POINT (3451668 -76532004)
2016,Mayo,Estados Unidos de América,0,4,,4,POINT (3884426 -77061029)
2016,Mayo,Estados Unidos de América,144,209,,353,POINT (445285 -75766353)
2016,Mayo,Estados Unidos de América,8002,14405,,22407,POINT (4697157 -74140516)
2016,Mayo,Estados Unidos de América,116,178,,294,POINT (4815189 -75736374)
2016,Mayo,Estados Unidos de América,2489,5712,,8201,POINT (6170465 -7542726)
2016,Mayo,Estados Unidos de América,24,39,,63,POINT (7128047 -73181317)
2016,Mayo,Estados Unidos de América,29,27,,56,POINT (7927233 -72508188)
2016,Mayo,Estados Unidos de América,0,20,,20,POINT (9402597 -75681642)
2016,Mayo,Estonia,1,0,,1,POINT (4697157 -74140516)
2016,Mayo,Etiopia,0,1,,1,POINT (4697157 -74140516)
2016,Mayo,Filipinas,0,3,,3,POINT (10446304 -75516486)
2016,Mayo,Filipinas,0,6,,6,POINT (3451668 -76532004)
2016,Mayo,Filipinas,4,12,,16,POINT (4697157 -74140516)
2016,Mayo,Filipinas,1,0,,1,POINT (6170465 -7542726)
2016,Mayo,Finlandia,0,1,,1,POINT (3451668 -76532004)
2016,Mayo,Finlandia,10,3,,13,POINT (4697157 -74140516)
2016,Mayo,Finlandia,0,3,,3,POINT (6170465 -7542726)
2016,Mayo,Francia,0,1,,1,POINT (10446304 -75516486)
2016,Mayo,Francia,1,1,,2,POINT (10886686 -74776479)
2016,Mayo,Francia,18,33,,51,POINT (3451668 -76532004)
2016,Mayo,Francia,887,1636,,2523,POINT (4697157 -74140516)
2016,Mayo,Francia,2,3,,5,POINT (4815189 -75736374)
2016,Mayo,Francia,40,94,,134,POINT (6170465 -7542726)
2016,Mayo,Georgia,0,1,,1,POINT (4697157 -74140516)
2016,Mayo,Ghana,0,1,,1,POINT (4697157 -74140516)
2016,Mayo,Grecia,0,1,,1,POINT (10886686 -74776479)
2016,Mayo,Grecia,0,4,,4,POINT (11247723 -74213989)
2016,Mayo,Grecia,0,2,,2,POINT (3451668 -76532004)
2016,Mayo,Grecia,4,6,,10,POINT (4697157 -74140516)
2016,Mayo,Grecia,0,1,,1,POINT (6170465 -7542726)
2016,Mayo,Guatemala,5,5,,10,POINT (10446304 -75516486)
2016,Mayo,Guatemala,2,3,,5,POINT (10886686 -74776479)
2016,Mayo,Guatemala,18,28,,46,POINT (125862 -81702165)
2016,Mayo,Guatemala,14,37,,51,POINT (3451668 -76532004)
2016,Mayo,Guatemala,305,595,,900,POINT (4697157 -74140516)
2016,Mayo,Guatemala,2,9,,11,POINT (4815189 -75736374)
2016,Mayo,Guatemala,58,149,,207,POINT (6170465 -7542726)
2016,Mayo,Guatemala,2,2,,4,POINT (7128047 -73181317)
2016,Mayo,Guatemala,6,8,,14,POINT (7927233 -72508188)
2016,Mayo,Guyana,1,1,,2,POINT (10406342 -75527794)
2016,Mayo,Guyana,1,1,,2,POINT (10886686 -74776479)
2016,Mayo,Guyana,1,4,,5,POINT (3451668 -76532004)
2016,Mayo,Guyana,1,0,,1,POINT (4697157 -74140516)
2016,Mayo,Guyana,2,1,,3,POINT (6170465 -7542726)
2016,Mayo,Guadalupe/Territorio Francés,0,4,,4,POINT (4697157 -74140516)
2016,Mayo,Guadalupe/Territorio Francés,0,2,,2,POINT (6170465 -7542726)
2016,Mayo,Guayana Francesa/Departamento de Ultramar Francés,0,1,,1,POINT (10406342 -75527794)
2016,Mayo,Guayana Francesa/Departamento de Ultramar Francés,1,0,,1,POINT (3451668 -76532004)
2016,Mayo,Guayana Francesa/Departamento de Ultramar Francés,1,1,,2,POINT (4697157 -74140516)
2016,Mayo,Haití,0,2,,2,POINT (10406342 -75527794)
2016,Mayo,Haití,2,1,,3,POINT (4697157 -74140516)
2016,Mayo,Honduras,0,2,,2,POINT (10446304 -75516486)
2016,Mayo,Honduras,2,4,,6,POINT (10886686 -74776479)
2016,Mayo,Honduras,0,1,,1,POINT (10970933 -74765343)
2016,Mayo,Honduras,0,2,,2,POINT (125744111 -81703935)
2016,Mayo,Honduras,0,3,,3,POINT (125862 -81702165)
2016,Mayo,Honduras,0,4,,4,POINT (133387613 -81372937)
2016,Mayo,Honduras,20,42,,62,POINT (3451668 -76532004)
2016,Mayo,Honduras,61,62,,123,POINT (4697157 -74140516)
2016,Mayo,Honduras,2,1,,3,POINT (4815189 -75736374)
2016,Mayo,Honduras,33,49,,82,POINT (6170465 -7542726)
2016,Mayo,Honduras,0,1,,1,POINT (7927233 -72508188)
2016,Mayo,Hong Kong,2,4,,6,POINT (4697157 -74140516)
2016,Mayo,Hong Kong,1,0,,1,POINT (6170465 -7542726)
2016,Mayo,Hungría,2,5,,7,POINT (4697157 -74140516)
2016,Mayo,Hungría,0,1,,1,POINT (6170465 -7542726)
2016,Mayo,India,0,4,,4,POINT (11247723 -74213989)
2016,Mayo,India,0,1,,1,POINT (125862 -81702165)
2016,Mayo,India,0,6,,6,POINT (3451668 -76532004)
2016,Mayo,India,5,36,,41,POINT (4697157 -74140516)
2016,Mayo,India,1,1,,2,POINT (4815189 -75736374)
2016,Mayo,India,11,19,,30,POINT (6170465 -7542726)
2016,Mayo,Indonesia,1,0,,1,POINT (3451668 -76532004)
2016,Mayo,Indonesia,0,1,,1,POINT (4697157 -74140516)
2016,Mayo,Indonesia,0,1,,1,POINT (6170465 -7542726)
2016,Mayo,República de Irlanda,0,1,,1,POINT (10446304 -75516486)
2016,Mayo,República de Irlanda,0,1,,1,POINT (3451668 -76532004)
2016,Mayo,República de Irlanda,10,14,,24,POINT (4697157 -74140516)
2016,Mayo,República de Irlanda,3,9,,12,POINT (6170465 -7542726)
2016,Mayo,Islandia,0,1,,1,POINT (4697157 -74140516)
2016,Mayo,Israel,0,1,,1,POINT (10446304 -75516486)
2016,Mayo,Israel,5,1,,6,POINT (125862 -81702165)
2016,Mayo,Israel,0,7,,7,POINT (3451668 -76532004)
2016,Mayo,Israel,20,84,,104,POINT (4697157 -74140516)
2016,Mayo,Israel,2,10,,12,POINT (6170465 -7542726)
2016,Mayo,Italia,1,3,,4,POINT (10446304 -75516486)
2016,Mayo,Italia,1,0,,1,POINT (10886686 -74776479)
2016,Mayo,Italia,0,1,,1,POINT (125862 -81702165)
2016,Mayo,Italia,6,25,,31,POINT (3451668 -76532004)
2016,Mayo,Italia,0,1,,1,POINT (445285 -75766353)
2016,Mayo,Italia,60,145,,205,POINT (4697157 -74140516)
2016,Mayo,Italia,1,1,,2,POINT (4815189 -75736374)
2016,Mayo,Italia,18,61,,79,POINT (6170465 -7542726)
2016,Mayo,Italia,1,1,,2,POINT (7128047 -73181317)
2016,Mayo,Jamaica,3,12,,15,POINT (10406342 -75527794)
2016,Mayo,Jamaica,0,10,,10,POINT (10446304 -75516486)
2016,Mayo,Jamaica,0,3,,3,POINT (10886686 -74776479)
2016,Mayo,Jamaica,1,2,,3,POINT (11247723 -74213989)
2016,Mayo,Jamaica,0,1,,1,POINT (125862 -81702165)
2016,Mayo,Jamaica,5,8,,13,POINT (133387613 -81372937)
2016,Mayo,Jamaica,0,2,,2,POINT (3451668 -76532004)
2016,Mayo,Jamaica,1,5,,6,POINT (4697157 -74140516)
2016,Mayo,Jamaica,0,4,,4,POINT (6170465 -7542726)
2016,Mayo,Japón,1,1,,2,POINT (125862 -81702165)
2016,Mayo,Japón,1,1,,2,POINT (3451668 -76532004)
2016,Mayo,Japón,4,21,,25,POINT (4697157 -74140516)
2016,Mayo,Japón,16,21,,37,POINT (6170465 -7542726)
2016,Mayo,Jordania,1,1,,2,POINT (4697157 -74140516)
2016,Mayo,Kazajistán,1,1,,2,POINT (4697157 -74140516)
2016,Mayo,Kenia,2,0,,2,POINT (4697157 -74140516)
2016,Mayo,Kenia,0,1,,1,POINT (6170465 -7542726)
2016,Mayo,Letonia,1,0,,1,POINT (3451668 -76532004)
2016,Mayo,Letonia,0,4,,4,POINT (4697157 -74140516)
2016,Mayo,Letonia,2,6,,8,POINT (6170465 -7542726)
2016,Mayo,Lituania,0,1,,1,POINT (3451668 -76532004)
2016,Mayo,Lituania,1,3,,4,POINT (4697157 -74140516)
2016,Mayo,Líbano,2,8,,10,POINT (4697157 -74140516)
2016,Mayo,Liechtenstein,1,0,,1,POINT (4697157 -74140516)
2016,Mayo,Luxemburgo,1,2,,3,POINT (4697157 -74140516)
2016,Mayo,Malasia,0,1,,1,POINT (4697157 -74140516)
2016,Mayo,Malta,2,1,,3,POINT (6170465 -7542726)
2016,Mayo,Martinica/Departamento de Ultramar Francés,0,2,,2,POINT (10406342 -75527794)
2016,Mayo,México,2,8,,10,POINT (10406342 -75527794)
2016,Mayo,México,6,25,,31,POINT (10446304 -75516486)
2016,Mayo,México,11,29,,40,POINT (10886686 -74776479)
2016,Mayo,México,12,8,,20,POINT (125862 -81702165)
2016,Mayo,México,70,175,,245,POINT (3451668 -76532004)
2016,Mayo,México,4395,8094,,12489,POINT (4697157 -74140516)
2016,Mayo,México,14,29,,43,POINT (4815189 -75736374)
2016,Mayo,México,431,987,,1418,POINT (6170465 -7542726)
2016,Mayo,México,6,6,,12,POINT (7128047 -73181317)
2016,Mayo,México,13,8,,21,POINT (7927233 -72508188)
2016,Mayo,Mónaco,1,1,,2,POINT (4697157 -74140516)
2016,Mayo,Mozambique,1,0,,1,POINT (4697157 -74140516)
2016,Mayo,Nicaragua,1,2,,3,POINT (10886686 -74776479)
2016,Mayo,Nicaragua,2,1,,3,POINT (125862 -81702165)
2016,Mayo,Nicaragua,0,3,,3,POINT (3451668 -76532004)
2016,Mayo,Nicaragua,16,39,,55,POINT (4697157 -74140516)
2016,Mayo,Nicaragua,2,6,,8,POINT (4815189 -75736374)
2016,Mayo,Nicaragua,5,16,,21,POINT (6170465 -7542726)
2016,Mayo,Nicaragua,0,1,,1,POINT (7927233 -72508188)
2016,Mayo,Nigeria,1,0,,1,POINT (4697157 -74140516)
2016,Mayo,Noruega,0,12,,12,POINT (10406342 -75527794)
2016,Mayo,Noruega,2,5,,7,POINT (3451668 -76532004)
2016,Mayo,Noruega,3,13,,16,POINT (4697157 -74140516)
2016,Mayo,Noruega,2,4,,6,POINT (6170465 -7542726)
2016,Mayo,Noruega,2,2,,4,POINT (7128047 -73181317)
2016,Mayo,Nueva Zelanda,0,2,,2,POINT (3451668 -76532004)
2016,Mayo,Nueva Zelanda,5,11,,16,POINT (4697157 -74140516)
2016,Mayo,Nueva Zelanda,4,9,,13,POINT (6170465 -7542726)
2016,Mayo,Pakistán,0,1,,1,POINT (3451668 -76532004)
2016,Mayo,Pakistán,0,1,,1,POINT (4697157 -74140516)
2016,Mayo,Panamá,1550,1159,,2709,POINT (10406342 -75527794)
2016,Mayo,Panamá,2589,2939,,5528,POINT (10446304 -75516486)
2016,Mayo,Panamá,198,425,,623,POINT (10886686 -74776479)
2016,Mayo,Panamá,0,12,,12,POINT (10970933 -74765343)
2016,Mayo,Panamá,0,1,,1,POINT (11117206 -74232675)
2016,Mayo,Panamá,0,2,,2,POINT (11247723 -74213989)
2016,Mayo,Panamá,4,10,,14,POINT (125744111 -81703935)
2016,Mayo,Panamá,315,269,,584,POINT (125862 -81702165)
2016,Mayo,Panamá,5,5,,10,POINT (133387613 -81372937)
2016,Mayo,Panamá,239,411,,650,POINT (3451668 -76532004)
2016,Mayo,Panamá,0,10,,10,POINT (3884426 -77061029)
2016,Mayo,Panamá,88,136,,224,POINT (445285 -75766353)
2016,Mayo,Panamá,3510,5421,,8931,POINT (4697157 -74140516)
2016,Mayo,Panamá,30,70,,100,POINT (4815189 -75736374)
2016,Mayo,Panamá,1569,2508,,4077,POINT (6170465 -7542726)
2016,Mayo,Panamá,0,3,,3,POINT (6222552 -77401154)
2016,Mayo,Panamá,1,1,,2,POINT (7102626 -77762647)
2016,Mayo,Panamá,13,15,,28,POINT (7128047 -73181317)
2016,Mayo,Panamá,29,55,,84,POINT (7927233 -72508188)
2016,Mayo,Panamá,101,126,,227,POINT (863337 -7735002)
2016,Mayo,Panamá,0,2,,2,POINT (9402597 -75681642)
2016,Mayo,Paraguay,3,5,,8,POINT (10446304 -75516486)
2016,Mayo,Paraguay,1,4,,5,POINT (10886686 -74776479)
2016,Mayo,Paraguay,48,41,,89,POINT (125862 -81702165)
2016,Mayo,Paraguay,5,5,,10,POINT (3451668 -76532004)
2016,Mayo,Paraguay,40,40,,80,POINT (4697157 -74140516)
2016,Mayo,Paraguay,1,1,,2,POINT (4815189 -75736374)
2016,Mayo,Paraguay,7,29,,36,POINT (6170465 -7542726)
2016,Mayo,Paraguay,2,1,,3,POINT (7927233 -72508188)
2016,Mayo,Perú,146,207,,353,POINT (-4191162 -69941498)
2016,Mayo,Perú,0,3,,3,POINT (0.185957 -7478366)
2016,Mayo,Perú,17,36,,53,POINT (0.81488 -77356)
2016,Mayo,Perú,1,7,,8,POINT (10406342 -75527794)
2016,Mayo,Perú,18,12,,30,POINT (10446304 -75516486)
2016,Mayo,Perú,3,3,,6,POINT (10886686 -74776479)
2016,Mayo,Perú,185,113,,298,POINT (125862 -81702165)
2016,Mayo,Perú,292,507,,799,POINT (3451668 -76532004)
2016,Mayo,Perú,5348,7543,,12891,POINT (4697157 -74140516)
2016,Mayo,Perú,2,1,,3,POINT (4815189 -75736374)
2016,Mayo,Perú,423,838,,1261,POINT (6170465 -7542726)
2016,Mayo,Perú,0,1,,1,POINT (7927233 -72508188)
2016,Mayo,Polonia,0,2,,2,POINT (10886686 -74776479)
2016,Mayo,Polonia,1,1,,2,POINT (3451668 -76532004)
2016,Mayo,Polonia,5,14,,19,POINT (4697157 -74140516)
2016,Mayo,Polonia,2,2,,4,POINT (6170465 -7542726)
2016,Mayo,Portugal,0,1,,1,POINT (10406342 -75527794)
2016,Mayo,Portugal,2,5,,7,POINT (3451668 -76532004)
2016,Mayo,Portugal,17,31,,48,POINT (4697157 -74140516)
2016,Mayo,Portugal,3,6,,9,POINT (6170465 -7542726)
2016,Mayo,Portugal,0,1,,1,POINT (7128047 -73181317)
2016,Mayo,Puerto Rico/Territorio de Estados Unidos,0,2,,2,POINT (10406342 -75527794)
2016,Mayo,Puerto Rico/Territorio de Estados Unidos,1,4,,5,POINT (10446304 -75516486)
2016,Mayo,Puerto Rico/Territorio de Estados Unidos,8,42,,50,POINT (10886686 -74776479)
2016,Mayo,Puerto Rico/Territorio de Estados Unidos,1,1,,2,POINT (125862 -81702165)
2016,Mayo,Puerto Rico/Territorio de Estados Unidos,39,70,,109,POINT (3451668 -76532004)
2016,Mayo,Puerto Rico/Territorio de Estados Unidos,271,352,,623,POINT (4697157 -74140516)
2016,Mayo,Puerto Rico/Territorio de Estados Unidos,2,3,,5,POINT (4815189 -75736374)
2016,Mayo,Puerto Rico/Territorio de Estados Unidos,36,70,,106,POINT (6170465 -7542726)
2016,Mayo,Puerto Rico/Territorio de Estados Unidos,1,2,,3,POINT (7128047 -73181317)
2016,Mayo,Puerto Rico/Territorio de Estados Unidos,0,1,,1,POINT (7927233 -72508188)
2016,Mayo,Reino Unido de Gran Bretaña e Irlanda del Norte,2,0,,2,POINT (10446304 -75516486)
2016,Mayo,Reino Unido de Gran Bretaña e Irlanda del Norte,11,13,,24,POINT (3451668 -76532004)
2016,Mayo,Reino Unido de Gran Bretaña e Irlanda del Norte,481,930,,1411,POINT (4697157 -74140516)
2016,Mayo,Reino Unido de Gran Bretaña e Irlanda del Norte,3,0,,3,POINT (4815189 -75736374)
2016,Mayo,Reino Unido de Gran Bretaña e Irlanda del Norte,40,86,,126,POINT (6170465 -7542726)
2016,Mayo,República CentroÁfricana,0,1,,1,POINT (4697157 -74140516)
2016,Mayo,Federación de Rusia,0,1,,1,POINT (10886686 -74776479)
2016,Mayo,Federación de Rusia,0,1,,1,POINT (125862 -81702165)
2016,Mayo,Federación de Rusia,0,1,,1,POINT (3451668 -76532004)
2016,Mayo,Federación de Rusia,13,25,,38,POINT (4697157 -74140516)
2016,Mayo,Federación de Rusia,3,1,,4,POINT (6170465 -7542726)
2016,Mayo,República Dominicana,0,6,,6,POINT (10406342 -75527794)
2016,Mayo,República Dominicana,3,6,,9,POINT (10446304 -75516486)
2016,Mayo,República Dominicana,8,24,,32,POINT (10886686 -74776479)
2016,Mayo,República Dominicana,1,0,,1,POINT (11247723 -74213989)
2016,Mayo,República Dominicana,4,4,,8,POINT (125862 -81702165)
2016,Mayo,República Dominicana,8,31,,39,POINT (3451668 -76532004)
2016,Mayo,República Dominicana,521,720,,1241,POINT (4697157 -74140516)
2016,Mayo,República Dominicana,6,9,,15,POINT (4815189 -75736374)
2016,Mayo,República Dominicana,35,53,,88,POINT (6170465 -7542726)
2016,Mayo,República Dominicana,0,2,,2,POINT (7128047 -73181317)
2016,Mayo,República Dominicana,1,5,,6,POINT (7927233 -72508188)
2016,Mayo,Rumania,3,7,,10,POINT (4697157 -74140516)
2016,Mayo,San Cristóbal y Nevis,0,1,,1,POINT (4697157 -74140516)
2016,Mayo,San Cristóbal y Nevis,0,2,,2,POINT (6170465 -7542726)
2016,Mayo,San  Vicente y las Granadinas,0,1,,1,POINT (3451668 -76532004)
2016,Mayo,Serbia,0,1,,1,POINT (6170465 -7542726)
2016,Mayo,Sierra Leona,0,1,,1,POINT (3451668 -76532004)
2016,Mayo,Singapur,0,1,,1,POINT (4697157 -74140516)
2016,Mayo,Singapur,1,1,,2,POINT (6170465 -7542726)
2016,Mayo,Sudáfrica,1,7,,8,POINT (4697157 -74140516)
2016,Mayo,Sudáfrica,0,5,,5,POINT (6170465 -7542726)
2016,Mayo,Suecia,1,0,,1,POINT (10446304 -75516486)
2016,Mayo,Suecia,5,2,,7,POINT (3451668 -76532004)
2016,Mayo,Suecia,12,15,,27,POINT (4697157 -74140516)
2016,Mayo,Suecia,2,5,,7,POINT (6170465 -7542726)
2016,Mayo,Suiza,0,1,,1,POINT (10446304 -75516486)
2016,Mayo,Suiza,0,2,,2,POINT (10886686 -74776479)
2016,Mayo,Suiza,7,12,,19,POINT (3451668 -76532004)
2016,Mayo,Suiza,29,65,,94,POINT (4697157 -74140516)
2016,Mayo,Suiza,13,11,,24,POINT (6170465 -7542726)
2016,Mayo,Suiza,3,1,,4,POINT (7927233 -72508188)
2016,Mayo,Surinam,1,1,,2,POINT (4697157 -74140516)
2016,Mayo,Surinam,0,7,,7,POINT (6170465 -7542726)
2016,Mayo,Taiwán,0,4,,4,POINT (4697157 -74140516)
2016,Mayo,Taiwán,2,3,,5,POINT (6170465 -7542726)
2016,Mayo,Tailandia,0,1,,1,POINT (3451668 -76532004)
2016,Mayo,Tailandia,4,1,,5,POINT (4697157 -74140516)
2016,Mayo,Trinidad y Tobago,0,3,,3,POINT (10886686 -74776479)
2016,Mayo,Trinidad y Tobago,1,5,,6,POINT (3451668 -76532004)
2016,Mayo,Trinidad y Tobago,2,8,,10,POINT (4697157 -74140516)
2016,Mayo,Trinidad y Tobago,0,1,,1,POINT (4815189 -75736374)
2016,Mayo,Trinidad y Tobago,0,16,,16,POINT (6170465 -7542726)
2016,Mayo,Túnez,0,1,,1,POINT (4697157 -74140516)
2016,Mayo,Turkmenistán,2,5,,7,POINT (4697157 -74140516)
2016,Mayo,Turquía,298,489,,787,POINT (4697157 -74140516)
2016,Mayo,Ucrania,2,1,,3,POINT (4697157 -74140516)
2016,Mayo,Uruguay,4,5,,9,POINT (10446304 -75516486)
2016,Mayo,Uruguay,0,2,,2,POINT (10886686 -74776479)
2016,Mayo,Uruguay,20,11,,31,POINT (125862 -81702165)
2016,Mayo,Uruguay,12,14,,26,POINT (3451668 -76532004)
2016,Mayo,Uruguay,67,83,,150,POINT (4697157 -74140516)
2016,Mayo,Uruguay,27,54,,81,POINT (6170465 -7542726)
2016,Mayo,Venezuela,0,14,,14,POINT (10406342 -75527794)
2016,Mayo,Venezuela,1,3,,4,POINT (10446304 -75516486)
2016,Mayo,Venezuela,12,44,,56,POINT (10886686 -74776479)
2016,Mayo,Venezuela,0,2,,2,POINT (10970933 -74765343)
2016,Mayo,Venezuela,1,10,,11,POINT (11117206 -74232675)
2016,Mayo,Venezuela,0,7,,7,POINT (11247723 -74213989)
2016,Mayo,Venezuela,418,677,,1095,POINT (11360029 -72129595)
2016,Mayo,Venezuela,1,1,,2,POINT (125862 -81702165)
2016,Mayo,Venezuela,8,22,,30,POINT (3451668 -76532004)
2016,Mayo,Venezuela,32,39,,71,POINT (3866713 -67927521)
2016,Mayo,Venezuela,3120,4011,,7131,POINT (4697157 -74140516)
2016,Mayo,Venezuela,0,6,,6,POINT (4815189 -75736374)
2016,Mayo,Venezuela,492,588,,1080,POINT (6170465 -7542726)
2016,Mayo,Venezuela,47,54,,101,POINT (6185536 -67484028)
2016,Mayo,Venezuela,60,71,,131,POINT (7088729 -70740253)
2016,Mayo,Venezuela,3,2,,5,POINT (7128047 -73181317)
2016,Mayo,Venezuela,1513,2147,,3660,POINT (7819 -72453013)
2016,Mayo,Venezuela,136,172,,308,POINT (7927233 -72508188)
2016,Mayo,Islas Vírgenes Británicas/Territorio Británico de Ultramar,0,1,,1,POINT (10406342 -75527794)
2016,Mayo,Islas Vírgenes Británicas/Territorio Británico de Ultramar,0,1,,1,POINT (4697157 -74140516)
2016,Mayo,Zimbabue,0,1,,1,POINT (4697157 -74140516)
2016,Mayo,Zimbabue,3,2,,5,POINT (6170465 -7542726)
2016,Mayo,Islas Turcas y Caicos/Territorio Británico de Ultramar,2,4,,6,POINT (4697157 -74140516)
2016,Mayo,Desconocido,0,1,,1,POINT (-4191162 -69941498)
2016,Mayo,Desconocido,0,1,,1,POINT (3451668 -76532004)
2016,Junio,Afganistán,1,0,,1,POINT (4697157 -74140516)
2016,Junio,Afganistán,0,1,,1,POINT (6170465 -7542726)
2016,Junio,Alemania,1,1,,2,POINT (10446304 -75516486)
2016,Junio,Alemania,4,3,,7,POINT (10886686 -74776479)
2016,Junio,Alemania,37,36,,73,POINT (3451668 -76532004)
2016,Junio,Alemania,1024,1805,,2829,POINT (4697157 -74140516)
2016,Junio,Alemania,1,2,,3,POINT (4815189 -75736374)
2016,Junio,Alemania,19,27,,46,POINT (6170465 -7542726)
2016,Junio,Antigua y Barbuda,1,2,,3,POINT (4697157 -74140516)
2016,Junio,Antigua y Barbuda,0,1,,1,POINT (6170465 -7542726)
2016,Junio,Países Bajos,0,3,,3,POINT (10406342 -75527794)
2016,Junio,Países Bajos,2,6,,8,POINT (10446304 -75516486)
2016,Junio,Países Bajos,34,64,,98,POINT (10886686 -74776479)
2016,Junio,Países Bajos,1,1,,2,POINT (11247723 -74213989)
2016,Junio,Países Bajos,74,111,,185,POINT (3451668 -76532004)
2016,Junio,Países Bajos,619,963,,1582,POINT (4697157 -74140516)
2016,Junio,Países Bajos,0,3,,3,POINT (4815189 -75736374)
2016,Junio,Países Bajos,142,205,,347,POINT (6170465 -7542726)
2016,Junio,Países Bajos,0,1,,1,POINT (7128047 -73181317)
2016,Junio,Países Bajos,0,1,,1,POINT (7927233 -72508188)
2016,Junio,Arabia Saudita,0,1,,1,POINT (3451668 -76532004)
2016,Junio,Arabia Saudita,0,2,,2,POINT (4697157 -74140516)
2016,Junio,Arabia Saudita,0,1,,1,POINT (6170465 -7542726)
2016,Junio,Argelia,4,4,,8,POINT (4697157 -74140516)
2016,Junio,Argentina,4,14,,18,POINT (0.81488 -77356)
2016,Junio,Argentina,1,14,,15,POINT (10406342 -75527794)
2016,Junio,Argentina,21,15,,36,POINT (10446304 -75516486)
2016,Junio,Argentina,2,8,,10,POINT (10886686 -74776479)
2016,Junio,Argentina,94,61,,155,POINT (125862 -81702165)
2016,Junio,Argentina,35,78,,113,POINT (3451668 -76532004)
2016,Junio,Argentina,2036,2988,,5024,POINT (4697157 -74140516)
2016,Junio,Argentina,3,9,,12,POINT (4815189 -75736374)
2016,Junio,Argentina,35,116,,151,POINT (6170465 -7542726)
2016,Junio,Argentina,1,2,,3,POINT (7128047 -73181317)
2016,Junio,Argentina,1,1,,2,POINT (7927233 -72508188)
2016,Junio,República de Armenia,1,0,,1,POINT (4697157 -74140516)
2016,Junio,Aruba,1,8,,9,POINT (10406342 -75527794)
2016,Junio,Aruba,4,6,,10,POINT (10886686 -74776479)
2016,Junio,Aruba,3,16,,19,POINT (11247723 -74213989)
2016,Junio,Aruba,7,9,,16,POINT (3451668 -76532004)
2016,Junio,Aruba,564,681,,1245,POINT (4697157 -74140516)
2016,Junio,Aruba,0,2,,2,POINT (4815189 -75736374)
2016,Junio,Aruba,52,93,,145,POINT (6170465 -7542726)
2016,Junio,Aruba,21,10,,31,POINT (7128047 -73181317)
2016,Junio,Aruba,0,1,,1,POINT (9402597 -75681642)
2016,Junio,Australia,13,7,,20,POINT (3451668 -76532004)
2016,Junio,Australia,39,62,,101,POINT (4697157 -74140516)
2016,Junio,Australia,8,15,,23,POINT (6170465 -7542726)
2016,Junio,Australia,1,2,,3,POINT (7128047 -73181317)
2016,Junio,Austria,0,1,,1,POINT (3451668 -76532004)
2016,Junio,Austria,10,24,,34,POINT (4697157 -74140516)
2016,Junio,Austria,3,2,,5,POINT (6170465 -7542726)
2016,Junio,Azerbaiyán,1,2,,3,POINT (4697157 -74140516)
2016,Junio,Bahamas,0,1,,1,POINT (10886686 -74776479)
2016,Junio,Bahamas,2,1,,3,POINT (4697157 -74140516)
2016,Junio,Bahamas,1,3,,4,POINT (6170465 -7542726)
2016,Junio,Bahamas,0,5,,5,POINT (9402597 -75681642)
2016,Junio,Barbados,27,44,,71,POINT (4697157 -74140516)
2016,Junio,República de Belarús,2,1,,3,POINT (4697157 -74140516)
2016,Junio,Bélgica,16,10,,26,POINT (3451668 -76532004)
2016,Junio,Bélgica,40,50,,90,POINT (4697157 -74140516)
2016,Junio,Bélgica,1,2,,3,POINT (4815189 -75736374)
2016,Junio,Bélgica,23,35,,58,POINT (6170465 -7542726)
2016,Junio,Belice,2,0,,2,POINT (125862 -81702165)
2016,Junio,Belice,1,0,,1,POINT (3451668 -76532004)
2016,Junio,Belice,1,4,,5,POINT (4697157 -74140516)
2016,Junio,Belice,0,2,,2,POINT (6170465 -7542726)
2016,Junio,Benín,1,0,,1,POINT (6170465 -7542726)
2016,Junio,Bermudas/Territorio Británico de Ultramar,0,2,,2,POINT (10406342 -75527794)
2016,Junio,Bermudas/Territorio Británico de Ultramar,0,1,,1,POINT (4697157 -74140516)
2016,Junio,Bolivia,6,7,,13,POINT (10446304 -75516486)
2016,Junio,Bolivia,0,1,,1,POINT (10886686 -74776479)
2016,Junio,Bolivia,31,26,,57,POINT (125862 -81702165)
2016,Junio,Bolivia,20,28,,48,POINT (3451668 -76532004)
2016,Junio,Bolivia,412,581,,993,POINT (4697157 -74140516)
2016,Junio,Bolivia,3,2,,5,POINT (4815189 -75736374)
2016,Junio,Bolivia,47,51,,98,POINT (6170465 -7542726)
2016,Junio,Bolivia,0,4,,4,POINT (7128047 -73181317)
2016,Junio,Brasil,134,149,,283,POINT (-4191162 -69941498)
2016,Junio,Brasil,6,2,,8,POINT (-4214082 -69941431)
2016,Junio,Brasil,0,1,,1,POINT (0.81488 -77356)
2016,Junio,Brasil,0,29,,29,POINT (10406342 -75527794)
2016,Junio,Brasil,17,14,,31,POINT (10446304 -75516486)
2016,Junio,Brasil,4,8,,12,POINT (10886686 -74776479)
2016,Junio,Brasil,181,118,,299,POINT (125862 -81702165)
2016,Junio,Brasil,39,81,,120,POINT (3451668 -76532004)
2016,Junio,Brasil,0,2,,2,POINT (3866713 -67927521)
2016,Junio,Brasil,4067,5920,,9987,POINT (4697157 -74140516)
2016,Junio,Brasil,3,1,,4,POINT (4815189 -75736374)
2016,Junio,Brasil,54,119,,173,POINT (6170465 -7542726)
2016,Junio,Brasil,1,1,,2,POINT (7128047 -73181317)
2016,Junio,Bulgaria,2,1,,3,POINT (4697157 -74140516)
2016,Junio,Bulgaria,0,2,,2,POINT (6170465 -7542726)
2016,Junio,Cabo Verde,0,16,,16,POINT (10406342 -75527794)
2016,Junio,Islas Caimán/Territorio Británico de Ultramar,0,1,,1,POINT (10886686 -74776479)
2016,Junio,Islas Caimán/Territorio Británico de Ultramar,1,1,,2,POINT (125744111 -81703935)
2016,Junio,Islas Caimán/Territorio Británico de Ultramar,0,1,,1,POINT (125862 -81702165)
2016,Junio,Islas Caimán/Territorio Británico de Ultramar,2,3,,5,POINT (133387613 -81372937)
2016,Junio,Islas Caimán/Territorio Británico de Ultramar,0,3,,3,POINT (4697157 -74140516)
2016,Junio,Camboya,0,1,,1,POINT (4697157 -74140516)
2016,Junio,Canadá,5,6,,11,POINT (10446304 -75516486)
2016,Junio,Canadá,3,5,,8,POINT (10886686 -74776479)
2016,Junio,Canadá,39,48,,87,POINT (3451668 -76532004)
2016,Junio,Canadá,0,1,,1,POINT (445285 -75766353)
2016,Junio,Canadá,554,906,,1460,POINT (4697157 -74140516)
2016,Junio,Canadá,9,8,,17,POINT (4815189 -75736374)
2016,Junio,Canadá,53,96,,149,POINT (6170465 -7542726)
2016,Junio,Canadá,2,6,,8,POINT (7128047 -73181317)
2016,Junio,Canadá,4,2,,6,POINT (7927233 -72508188)
2016,Junio,España,0,8,,8,POINT (10406342 -75527794)
2016,Junio,España,2,1,,3,POINT (10446304 -75516486)
2016,Junio,España,11,8,,19,POINT (10886686 -74776479)
2016,Junio,España,540,741,,1281,POINT (3451668 -76532004)
2016,Junio,España,2482,4457,,6939,POINT (4697157 -74140516)
2016,Junio,España,6,9,,15,POINT (4815189 -75736374)
2016,Junio,España,273,441,,714,POINT (6170465 -7542726)
2016,Junio,España,4,3,,7,POINT (7128047 -73181317)
2016,Junio,República de Corea,0,3,,3,POINT (11247723 -74213989)
2016,Junio,República de Corea,1,2,,3,POINT (3451668 -76532004)
2016,Junio,República de Corea,13,25,,38,POINT (4697157 -74140516)
2016,Junio,República de Corea,2,4,,6,POINT (6170465 -7542726)
2016,Junio,Costa de Marfil,1,1,,2,POINT (4697157 -74140516)
2016,Junio,Costa de Marfil,0,1,,1,POINT (7927233 -72508188)
2016,Junio,Costa Rica,1,5,,6,POINT (10406342 -75527794)
2016,Junio,Costa Rica,1,1,,2,POINT (10446304 -75516486)
2016,Junio,Costa Rica,9,9,,18,POINT (10886686 -74776479)
2016,Junio,Costa Rica,0,9,,9,POINT (125744111 -81703935)
2016,Junio,Costa Rica,102,88,,190,POINT (125862 -81702165)
2016,Junio,Costa Rica,29,26,,55,POINT (3451668 -76532004)
2016,Junio,Costa Rica,953,1385,,2338,POINT (4697157 -74140516)
2016,Junio,Costa Rica,5,0,,5,POINT (4815189 -75736374)
2016,Junio,Costa Rica,72,137,,209,POINT (6170465 -7542726)
2016,Junio,Costa Rica,1,3,,4,POINT (7128047 -73181317)
2016,Junio,Costa Rica,1,1,,2,POINT (7927233 -72508188)
2016,Junio,Croacia,1,2,,3,POINT (4697157 -74140516)
2016,Junio,Croacia,0,1,,1,POINT (6170465 -7542726)
2016,Junio,Cuba,0,2,,2,POINT (10406342 -75527794)
2016,Junio,Cuba,1,4,,5,POINT (10446304 -75516486)
2016,Junio,Cuba,6,4,,10,POINT (10886686 -74776479)
2016,Junio,Cuba,0,1,,1,POINT (10970933 -74765343)
2016,Junio,Cuba,0,1,,1,POINT (125862 -81702165)
2016,Junio,Cuba,0,2,,2,POINT (133387613 -81372937)
2016,Junio,Cuba,12,16,,28,POINT (3451668 -76532004)
2016,Junio,Cuba,223,409,,632,POINT (4697157 -74140516)
2016,Junio,Cuba,4,3,,7,POINT (4815189 -75736374)
2016,Junio,Cuba,8,21,,29,POINT (6170465 -7542726)
2016,Junio,Cuba,1,1,,2,POINT (7128047 -73181317)
2016,Junio,Cuba,1,1,,2,POINT (7927233 -72508188)
2016,Junio,Curazao,0,3,,3,POINT (4697157 -74140516)
2016,Junio,República Checa,3,7,,10,POINT (4697157 -74140516)
2016,Junio,República Checa,0,1,,1,POINT (6170465 -7542726)
2016,Junio,Chile,3,9,,12,POINT (0.81488 -77356)
2016,Junio,Chile,0,3,,3,POINT (10406342 -75527794)
2016,Junio,Chile,12,4,,16,POINT (10446304 -75516486)
2016,Junio,Chile,1,3,,4,POINT (10886686 -74776479)
2016,Junio,Chile,53,30,,83,POINT (125862 -81702165)
2016,Junio,Chile,17,48,,65,POINT (3451668 -76532004)
2016,Junio,Chile,4276,5953,,10229,POINT (4697157 -74140516)
2016,Junio,Chile,2,1,,3,POINT (4815189 -75736374)
2016,Junio,Chile,27,43,,70,POINT (6170465 -7542726)
2016,Junio,Chile,2,2,,4,POINT (7128047 -73181317)
2016,Junio,Chile,0,2,,2,POINT (7927233 -72508188)
2016,Junio,China,2,2,,4,POINT (3451668 -76532004)
2016,Junio,China,40,79,,119,POINT (4697157 -74140516)
2016,Junio,China,0,1,,1,POINT (4815189 -75736374)
2016,Junio,China,3,5,,8,POINT (6170465 -7542726)
2016,Junio,Chipre,0,1,,1,POINT (4697157 -74140516)
2016,Junio,Dinamarca,0,3,,3,POINT (3451668 -76532004)
2016,Junio,Dinamarca,18,15,,33,POINT (4697157 -74140516)
2016,Junio,Dinamarca,1,0,,1,POINT (7927233 -72508188)
2016,Junio,Ecuador,2,6,,8,POINT (0.185957 -7478366)
2016,Junio,Ecuador,95,275,,370,POINT (0.33002 -76876446)
2016,Junio,Ecuador,2680,4309,,6989,POINT (0.81488 -77356)
2016,Junio,Ecuador,35,101,,136,POINT (1800143 -78802679)
2016,Junio,Ecuador,0,6,,6,POINT (10406342 -75527794)
2016,Junio,Ecuador,3,13,,16,POINT (10446304 -75516486)
2016,Junio,Ecuador,0,4,,4,POINT (10886686 -74776479)
2016,Junio,Ecuador,0,2,,2,POINT (11247723 -74213989)
2016,Junio,Ecuador,29,28,,57,POINT (125862 -81702165)
2016,Junio,Ecuador,244,389,,633,POINT (3451668 -76532004)
2016,Junio,Ecuador,0,1,,1,POINT (3884426 -77061029)
2016,Junio,Ecuador,2703,4228,,6931,POINT (4697157 -74140516)
2016,Junio,Ecuador,0,1,,1,POINT (4815189 -75736374)
2016,Junio,Ecuador,23,42,,65,POINT (6170465 -7542726)
2016,Junio,Ecuador,1,2,,3,POINT (7128047 -73181317)
2016,Junio,Ecuador,5,2,,7,POINT (7927233 -72508188)
2016,Junio,Egipto,3,3,,6,POINT (4697157 -74140516)
2016,Junio,El Salvador,2,15,,17,POINT (10446304 -75516486)
2016,Junio,El Salvador,1,5,,6,POINT (10886686 -74776479)
2016,Junio,El Salvador,37,29,,66,POINT (125862 -81702165)
2016,Junio,El Salvador,131,194,,325,POINT (3451668 -76532004)
2016,Junio,El Salvador,824,1324,,2148,POINT (4697157 -74140516)
2016,Junio,El Salvador,0,1,,1,POINT (4815189 -75736374)
2016,Junio,El Salvador,170,227,,397,POINT (6170465 -7542726)
2016,Junio,Emiratos Árabes,2,1,,3,POINT (3451668 -76532004)
2016,Junio,Emiratos Árabes,8,6,,14,POINT (4697157 -74140516)
2016,Junio,Eslovaquia,3,4,,7,POINT (4697157 -74140516)
2016,Junio,Eslovenia,1,2,,3,POINT (4697157 -74140516)
2016,Junio,Eslovenia,1,1,,2,POINT (6170465 -7542726)
2016,Junio,Estados Unidos de América,0,28,,28,POINT (10406342 -75527794)
2016,Junio,Estados Unidos de América,3511,4741,,8252,POINT (10446304 -75516486)
2016,Junio,Estados Unidos de América,848,1278,,2126,POINT (10886686 -74776479)
2016,Junio,Estados Unidos de América,0,2,,2,POINT (10970933 -74765343)
2016,Junio,Estados Unidos de América,0,18,,18,POINT (11247723 -74213989)
2016,Junio,Estados Unidos de América,0,1,,1,POINT (125744111 -81703935)
2016,Junio,Estados Unidos de América,53,42,,95,POINT (125862 -81702165)
2016,Junio,Estados Unidos de América,1818,2276,,4094,POINT (3451668 -76532004)
2016,Junio,Estados Unidos de América,0,3,,3,POINT (3884426 -77061029)
2016,Junio,Estados Unidos de América,307,347,,654,POINT (445285 -75766353)
2016,Junio,Estados Unidos de América,11116,16464,,27580,POINT (4697157 -74140516)
2016,Junio,Estados Unidos de América,255,325,,580,POINT (4815189 -75736374)
2016,Junio,Estados Unidos de América,3719,6541,,10260,POINT (6170465 -7542726)
2016,Junio,Estados Unidos de América,40,57,,97,POINT (7128047 -73181317)
2016,Junio,Estados Unidos de América,41,27,,68,POINT (7927233 -72508188)
2016,Junio,Estados Unidos de América,0,17,,17,POINT (9402597 -75681642)
2016,Junio,Estonia,0,2,,2,POINT (4697157 -74140516)
2016,Junio,Etiopia,0,1,,1,POINT (4697157 -74140516)
2016,Junio,Filipinas,0,1,,1,POINT (10446304 -75516486)
2016,Junio,Filipinas,0,2,,2,POINT (10886686 -74776479)
2016,Junio,Filipinas,0,13,,13,POINT (3884426 -77061029)
2016,Junio,Filipinas,2,19,,21,POINT (4697157 -74140516)
2016,Junio,Filipinas,0,2,,2,POINT (6170465 -7542726)
2016,Junio,Finlandia,9,13,,22,POINT (4697157 -74140516)
2016,Junio,Finlandia,0,1,,1,POINT (6170465 -7542726)
2016,Junio,Francia,1,1,,2,POINT (10446304 -75516486)
2016,Junio,Francia,1,6,,7,POINT (10886686 -74776479)
2016,Junio,Francia,29,44,,73,POINT (3451668 -76532004)
2016,Junio,Francia,988,1738,,2726,POINT (4697157 -74140516)
2016,Junio,Francia,18,50,,68,POINT (6170465 -7542726)
2016,Junio,Francia,0,1,,1,POINT (7128047 -73181317)
2016,Junio,Ghana,0,1,,1,POINT (4697157 -74140516)
2016,Junio,Gibraltar/Territorio Británico de Ultramar,2,0,,2,POINT (0.81488 -77356)
2016,Junio,Gibraltar/Territorio Británico de Ultramar,0,8,,8,POINT (11247723 -74213989)
2016,Junio,Granada,0,2,,2,POINT (10406342 -75527794)
2016,Junio,Granada,4,8,,12,POINT (11247723 -74213989)
2016,Junio,Grecia,0,2,,2,POINT (3451668 -76532004)
2016,Junio,Grecia,7,8,,15,POINT (4697157 -74140516)
2016,Junio,Grecia,0,1,,1,POINT (4815189 -75736374)
2016,Junio,Grecia,1,0,,1,POINT (6170465 -7542726)
2016,Junio,Guatemala,5,11,,16,POINT (10446304 -75516486)
2016,Junio,Guatemala,35,51,,86,POINT (10886686 -74776479)
2016,Junio,Guatemala,16,16,,32,POINT (125862 -81702165)
2016,Junio,Guatemala,33,53,,86,POINT (3451668 -76532004)
2016,Junio,Guatemala,0,1,,1,POINT (3884426 -77061029)
2016,Junio,Guatemala,356,561,,917,POINT (4697157 -74140516)
2016,Junio,Guatemala,3,4,,7,POINT (4815189 -75736374)
2016,Junio,Guatemala,57,130,,187,POINT (6170465 -7542726)
2016,Junio,Guatemala,1,2,,3,POINT (7128047 -73181317)
2016,Junio,Guatemala,1,1,,2,POINT (7927233 -72508188)
2016,Junio,Guyana,0,1,,1,POINT (3451668 -76532004)
2016,Junio,Guadalupe/Territorio Francés,1,1,,2,POINT (4697157 -74140516)
2016,Junio,Guayana Francesa/Departamento de Ultramar Francés,1,0,,1,POINT (4697157 -74140516)
2016,Junio,Haití,1,0,,1,POINT (3451668 -76532004)
2016,Junio,Haití,0,3,,3,POINT (4697157 -74140516)
2016,Junio,Haití,0,3,,3,POINT (6170465 -7542726)
2016,Junio,Haití,0,1,,1,POINT (7128047 -73181317)
2016,Junio,Honduras,3,2,,5,POINT (10446304 -75516486)
2016,Junio,Honduras,6,0,,6,POINT (10886686 -74776479)
2016,Junio,Honduras,0,15,,15,POINT (125744111 -81703935)
2016,Junio,Honduras,1,4,,5,POINT (125862 -81702165)
2016,Junio,Honduras,5,7,,12,POINT (133387613 -81372937)
2016,Junio,Honduras,21,20,,41,POINT (3451668 -76532004)
2016,Junio,Honduras,43,75,,118,POINT (4697157 -74140516)
2016,Junio,Honduras,3,2,,5,POINT (4815189 -75736374)
2016,Junio,Honduras,22,47,,69,POINT (6170465 -7542726)
2016,Junio,Honduras,0,1,,1,POINT (7128047 -73181317)
2016,Junio,Honduras,2,2,,4,POINT (7927233 -72508188)
2016,Junio,Hong Kong,2,6,,8,POINT (4697157 -74140516)
2016,Junio,Hungría,0,8,,8,POINT (4697157 -74140516)
2016,Junio,Hungría,1,0,,1,POINT (6170465 -7542726)
2016,Junio,India,0,1,,1,POINT (10446304 -75516486)
2016,Junio,India,0,2,,2,POINT (3451668 -76532004)
2016,Junio,India,9,26,,35,POINT (4697157 -74140516)
2016,Junio,India,8,8,,16,POINT (6170465 -7542726)
2016,Junio,Indonesia,0,1,,1,POINT (11247723 -74213989)
2016,Junio,Indonesia,1,3,,4,POINT (4697157 -74140516)
2016,Junio,República de Irlanda,1,4,,5,POINT (3451668 -76532004)
2016,Junio,República de Irlanda,11,18,,29,POINT (4697157 -74140516)
2016,Junio,República de Irlanda,0,3,,3,POINT (6170465 -7542726)
2016,Junio,Islandia,2,1,,3,POINT (3451668 -76532004)
2016,Junio,Islandia,3,2,,5,POINT (4697157 -74140516)
2016,Junio,Israel,0,1,,1,POINT (10886686 -74776479)
2016,Junio,Israel,4,3,,7,POINT (3451668 -76532004)
2016,Junio,Israel,14,49,,63,POINT (4697157 -74140516)
2016,Junio,Israel,0,1,,1,POINT (6170465 -7542726)
2016,Junio,Italia,3,2,,5,POINT (10446304 -75516486)
2016,Junio,Italia,0,1,,1,POINT (11247723 -74213989)
2016,Junio,Italia,2,1,,3,POINT (125862 -81702165)
2016,Junio,Italia,28,46,,74,POINT (3451668 -76532004)
2016,Junio,Italia,109,246,,355,POINT (4697157 -74140516)
2016,Junio,Italia,1,3,,4,POINT (4815189 -75736374)
2016,Junio,Italia,23,42,,65,POINT (6170465 -7542726)
2016,Junio,Italia,0,1,,1,POINT (7128047 -73181317)
2016,Junio,Italia,1,2,,3,POINT (7927233 -72508188)
2016,Junio,Jamaica,0,6,,6,POINT (10406342 -75527794)
2016,Junio,Jamaica,0,4,,4,POINT (10446304 -75516486)
2016,Junio,Jamaica,1,5,,6,POINT (125862 -81702165)
2016,Junio,Jamaica,1,1,,2,POINT (133387613 -81372937)
2016,Junio,Jamaica,0,1,,1,POINT (3451668 -76532004)
2016,Junio,Jamaica,2,9,,11,POINT (4697157 -74140516)
2016,Junio,Jamaica,1,2,,3,POINT (6170465 -7542726)
2016,Junio,Japón,0,1,,1,POINT (3451668 -76532004)
2016,Junio,Japón,5,20,,25,POINT (4697157 -74140516)
2016,Junio,Japón,1,3,,4,POINT (6170465 -7542726)
2016,Junio,Jordania,2,1,,3,POINT (4697157 -74140516)
2016,Junio,Kazajistán,4,1,,5,POINT (4697157 -74140516)
2016,Junio,Kenia,0,7,,7,POINT (4697157 -74140516)
2016,Junio,Kenia,0,1,,1,POINT (6170465 -7542726)
2016,Junio,Kuwait,1,1,,2,POINT (4697157 -74140516)
2016,Junio,Letonia,1,1,,2,POINT (4697157 -74140516)
2016,Junio,Líbano,4,2,,6,POINT (4697157 -74140516)
2016,Junio,Liechtenstein,1,0,,1,POINT (4697157 -74140516)
2016,Junio,Luxemburgo,2,2,,4,POINT (4697157 -74140516)
2016,Junio,Malasia,2,1,,3,POINT (4697157 -74140516)
2016,Junio,Malta,3,5,,8,POINT (4697157 -74140516)
2016,Junio,Marruecos,1,2,,3,POINT (4697157 -74140516)
2016,Junio,Marruecos,0,1,,1,POINT (6170465 -7542726)
2016,Junio,Martinica/Departamento de Ultramar Francés,0,2,,2,POINT (10406342 -75527794)
2016,Junio,México,0,6,,6,POINT (10406342 -75527794)
2016,Junio,México,22,29,,51,POINT (10446304 -75516486)
2016,Junio,México,23,36,,59,POINT (10886686 -74776479)
2016,Junio,México,2,5,,7,POINT (11117206 -74232675)
2016,Junio,México,0,1,,1,POINT (11247723 -74213989)
2016,Junio,México,5,10,,15,POINT (125862 -81702165)
2016,Junio,México,96,187,,283,POINT (3451668 -76532004)
2016,Junio,México,4805,8102,,12907,POINT (4697157 -74140516)
2016,Junio,México,24,23,,47,POINT (4815189 -75736374)
2016,Junio,México,545,1206,,1751,POINT (6170465 -7542726)
2016,Junio,México,6,11,,17,POINT (7128047 -73181317)
2016,Junio,México,7,20,,27,POINT (7927233 -72508188)
2016,Junio,Mónaco,0,2,,2,POINT (4697157 -74140516)
2016,Junio,Nepal,0,1,,1,POINT (4697157 -74140516)
2016,Junio,Nicaragua,1,1,,2,POINT (10446304 -75516486)
2016,Junio,Nicaragua,0,1,,1,POINT (10886686 -74776479)
2016,Junio,Nicaragua,1,2,,3,POINT (125862 -81702165)
2016,Junio,Nicaragua,4,14,,18,POINT (3451668 -76532004)
2016,Junio,Nicaragua,35,45,,80,POINT (4697157 -74140516)
2016,Junio,Nicaragua,5,3,,8,POINT (4815189 -75736374)
2016,Junio,Nicaragua,27,20,,47,POINT (6170465 -7542726)
2016,Junio,Nigeria,1,3,,4,POINT (10406342 -75527794)
2016,Junio,Nigeria,1,2,,3,POINT (3451668 -76532004)
2016,Junio,Noruega,2,0,,2,POINT (10446304 -75516486)
2016,Junio,Noruega,2,3,,5,POINT (10886686 -74776479)
2016,Junio,Noruega,11,12,,23,POINT (3451668 -76532004)
2016,Junio,Noruega,41,48,,89,POINT (4697157 -74140516)
2016,Junio,Noruega,1,1,,2,POINT (6170465 -7542726)
2016,Junio,Nueva Zelanda,1,0,,1,POINT (10446304 -75516486)
2016,Junio,Nueva Zelanda,2,6,,8,POINT (4697157 -74140516)
2016,Junio,Nueva Zelanda,3,3,,6,POINT (6170465 -7542726)
2016,Junio,Panamá,150,236,,386,POINT (10406342 -75527794)
2016,Junio,Panamá,2791,3297,,6088,POINT (10446304 -75516486)
2016,Junio,Panamá,275,554,,829,POINT (10886686 -74776479)
2016,Junio,Panamá,1,22,,23,POINT (10970933 -74765343)
2016,Junio,Panamá,0,8,,8,POINT (11247723 -74213989)
2016,Junio,Panamá,4,40,,44,POINT (125744111 -81703935)
2016,Junio,Panamá,583,419,,1002,POINT (125862 -81702165)
2016,Junio,Panamá,2,8,,10,POINT (133387613 -81372937)
2016,Junio,Panamá,375,581,,956,POINT (3451668 -76532004)
2016,Junio,Panamá,1,11,,12,POINT (3884426 -77061029)
2016,Junio,Panamá,32,42,,74,POINT (445285 -75766353)
2016,Junio,Panamá,4188,5773,,9961,POINT (4697157 -74140516)
2016,Junio,Panamá,24,51,,75,POINT (4815189 -75736374)
2016,Junio,Panamá,2033,2636,,4669,POINT (6170465 -7542726)
2016,Junio,Panamá,5,17,,22,POINT (7102626 -77762647)
2016,Junio,Panamá,17,37,,54,POINT (7128047 -73181317)
2016,Junio,Panamá,49,45,,94,POINT (7927233 -72508188)
2016,Junio,Panamá,0,10,,10,POINT (806667 -767333)
2016,Junio,Panamá,127,144,,271,POINT (863337 -7735002)
2016,Junio,Panamá,2,5,,7,POINT (9402597 -75681642)
2016,Junio,Paraguay,1,2,,3,POINT (10446304 -75516486)
2016,Junio,Paraguay,2,7,,9,POINT (10886686 -74776479)
2016,Junio,Paraguay,70,32,,102,POINT (125862 -81702165)
2016,Junio,Paraguay,12,17,,29,POINT (3451668 -76532004)
2016,Junio,Paraguay,63,76,,139,POINT (4697157 -74140516)
2016,Junio,Paraguay,2,3,,5,POINT (4815189 -75736374)
2016,Junio,Paraguay,5,18,,23,POINT (6170465 -7542726)
2016,Junio,Perú,142,198,,340,POINT (-4191162 -69941498)
2016,Junio,Perú,1,0,,1,POINT (-4214082 -69941431)
2016,Junio,Perú,1,1,,2,POINT (0.185957 -7478366)
2016,Junio,Perú,27,59,,86,POINT (0.81488 -77356)
2016,Junio,Perú,0,3,,3,POINT (10406342 -75527794)
2016,Junio,Perú,4,7,,11,POINT (10446304 -75516486)
2016,Junio,Perú,2,10,,12,POINT (10886686 -74776479)
2016,Junio,Perú,85,73,,158,POINT (125862 -81702165)
2016,Junio,Perú,291,477,,768,POINT (3451668 -76532004)
2016,Junio,Perú,0,1,,1,POINT (3884426 -77061029)
2016,Junio,Perú,5701,8065,,13766,POINT (4697157 -74140516)
2016,Junio,Perú,2,2,,4,POINT (4815189 -75736374)
2016,Junio,Perú,807,1141,,1948,POINT (6170465 -7542726)
2016,Junio,Perú,0,2,,2,POINT (7128047 -73181317)
2016,Junio,Perú,1,0,,1,POINT (7927233 -72508188)
2016,Junio,Polonia,2,0,,2,POINT (10886686 -74776479)
2016,Junio,Polonia,0,2,,2,POINT (3451668 -76532004)
2016,Junio,Polonia,15,23,,38,POINT (4697157 -74140516)
2016,Junio,Polonia,2,1,,3,POINT (6170465 -7542726)
2016,Junio,Portugal,0,9,,9,POINT (10406342 -75527794)
2016,Junio,Portugal,0,1,,1,POINT (10886686 -74776479)
2016,Junio,Portugal,1,5,,6,POINT (3451668 -76532004)
2016,Junio,Portugal,16,47,,63,POINT (4697157 -74140516)
2016,Junio,Portugal,0,5,,5,POINT (6170465 -7542726)
2016,Junio,Polinesia Francesa/Colectividad de Ultramar Francesa,0,1,,1,POINT (4697157 -74140516)
2016,Junio,Puerto Rico/Territorio de Estados Unidos,1,5,,6,POINT (10446304 -75516486)
2016,Junio,Puerto Rico/Territorio de Estados Unidos,10,47,,57,POINT (10886686 -74776479)
2016,Junio,Puerto Rico/Territorio de Estados Unidos,3,1,,4,POINT (125862 -81702165)
2016,Junio,Puerto Rico/Territorio de Estados Unidos,49,56,,105,POINT (3451668 -76532004)
2016,Junio,Puerto Rico/Territorio de Estados Unidos,510,579,,1089,POINT (4697157 -74140516)
2016,Junio,Puerto Rico/Territorio de Estados Unidos,2,9,,11,POINT (4815189 -75736374)
2016,Junio,Puerto Rico/Territorio de Estados Unidos,26,75,,101,POINT (6170465 -7542726)
2016,Junio,Puerto Rico/Territorio de Estados Unidos,2,6,,8,POINT (7128047 -73181317)
2016,Junio,Puerto Rico/Territorio de Estados Unidos,9,1,,10,POINT (7927233 -72508188)
2016,Junio,Reino Unido de Gran Bretaña e Irlanda del Norte,3,0,,3,POINT (10446304 -75516486)
2016,Junio,Reino Unido de Gran Bretaña e Irlanda del Norte,1,2,,3,POINT (10886686 -74776479)
2016,Junio,Reino Unido de Gran Bretaña e Irlanda del Norte,0,1,,1,POINT (11247723 -74213989)
2016,Junio,Reino Unido de Gran Bretaña e Irlanda del Norte,8,12,,20,POINT (3451668 -76532004)
2016,Junio,Reino Unido de Gran Bretaña e Irlanda del Norte,564,983,,1547,POINT (4697157 -74140516)
2016,Junio,Reino Unido de Gran Bretaña e Irlanda del Norte,4,5,,9,POINT (4815189 -75736374)
2016,Junio,Reino Unido de Gran Bretaña e Irlanda del Norte,17,24,,41,POINT (6170465 -7542726)
2016,Junio,Reino Unido de Gran Bretaña e Irlanda del Norte,1,1,,2,POINT (7128047 -73181317)
2016,Junio,Federación de Rusia,1,0,,1,POINT (10446304 -75516486)
2016,Junio,Federación de Rusia,0,2,,2,POINT (3451668 -76532004)
2016,Junio,Federación de Rusia,0,2,,2,POINT (3884426 -77061029)
2016,Junio,Federación de Rusia,12,24,,36,POINT (4697157 -74140516)
2016,Junio,Federación de Rusia,1,1,,2,POINT (6170465 -7542726)
2016,Junio,Federación de Rusia,1,0,,1,POINT (7927233 -72508188)
2016,Junio,República Dominicana,1,11,,12,POINT (10406342 -75527794)
2016,Junio,República Dominicana,3,11,,14,POINT (10446304 -75516486)
2016,Junio,República Dominicana,6,11,,17,POINT (10886686 -74776479)
2016,Junio,República Dominicana,1,3,,4,POINT (10970933 -74765343)
2016,Junio,República Dominicana,3,4,,7,POINT (125862 -81702165)
2016,Junio,República Dominicana,18,36,,54,POINT (3451668 -76532004)
2016,Junio,República Dominicana,473,706,,1179,POINT (4697157 -74140516)
2016,Junio,República Dominicana,2,4,,6,POINT (4815189 -75736374)
2016,Junio,República Dominicana,40,80,,120,POINT (6170465 -7542726)
2016,Junio,República Dominicana,5,6,,11,POINT (7128047 -73181317)
2016,Junio,República Dominicana,4,4,,8,POINT (7927233 -72508188)
2016,Junio,República Democrática Popular de Corea,0,1,,1,POINT (3451668 -76532004)
2016,Junio,Rumania,0,1,,1,POINT (3451668 -76532004)
2016,Junio,Rumania,1,8,,9,POINT (4697157 -74140516)
2016,Junio,Rwanda,0,1,,1,POINT (4697157 -74140516)
2016,Junio,San Cristóbal y Nevis,0,1,,1,POINT (4697157 -74140516)
2016,Junio,Santa Lucia,0,1,,1,POINT (3451668 -76532004)
2016,Junio,Senegal,1,1,,2,POINT (4697157 -74140516)
2016,Junio,Singapur,3,5,,8,POINT (4697157 -74140516)
2016,Junio,Sudáfrica,0,1,,1,POINT (10886686 -74776479)
2016,Junio,Sudáfrica,0,2,,2,POINT (3451668 -76532004)
2016,Junio,Sudáfrica,6,19,,25,POINT (4697157 -74140516)
2016,Junio,Sudáfrica,0,2,,2,POINT (4815189 -75736374)
2016,Junio,Suecia,5,4,,9,POINT (10886686 -74776479)
2016,Junio,Suecia,18,15,,33,POINT (3451668 -76532004)
2016,Junio,Suecia,55,54,,109,POINT (4697157 -74140516)
2016,Junio,Suecia,2,3,,5,POINT (4815189 -75736374)
2016,Junio,Suecia,6,10,,16,POINT (6170465 -7542726)
2016,Junio,Suiza,0,1,,1,POINT (10446304 -75516486)
2016,Junio,Suiza,0,1,,1,POINT (10886686 -74776479)
2016,Junio,Suiza,0,1,,1,POINT (125862 -81702165)
2016,Junio,Suiza,18,24,,42,POINT (3451668 -76532004)
2016,Junio,Suiza,56,77,,133,POINT (4697157 -74140516)
2016,Junio,Suiza,12,22,,34,POINT (6170465 -7542726)
2016,Junio,Suiza,1,0,,1,POINT (7128047 -73181317)
2016,Junio,Surinam,0,1,,1,POINT (10406342 -75527794)
2016,Junio,Surinam,0,1,,1,POINT (4697157 -74140516)
2016,Junio,Surinam,2,7,,9,POINT (6170465 -7542726)
2016,Junio,Taiwán,4,1,,5,POINT (4697157 -74140516)
2016,Junio,Tailandia,4,2,,6,POINT (4697157 -74140516)
2016,Junio,Trinidad y Tobago,0,13,,13,POINT (10406342 -75527794)
2016,Junio,Trinidad y Tobago,0,1,,1,POINT (10886686 -74776479)
2016,Junio,Trinidad y Tobago,0,1,,1,POINT (11247723 -74213989)
2016,Junio,Trinidad y Tobago,4,2,,6,POINT (3451668 -76532004)
2016,Junio,Trinidad y Tobago,4,11,,15,POINT (4697157 -74140516)
2016,Junio,Trinidad y Tobago,1,3,,4,POINT (6170465 -7542726)
2016,Junio,Trinidad y Tobago,0,1,,1,POINT (7128047 -73181317)
2016,Junio,Trinidad y Tobago,0,1,,1,POINT (7927233 -72508188)
2016,Junio,Trinidad y Tobago,0,2,,2,POINT (9402597 -75681642)
2016,Junio,Túnez,0,2,,2,POINT (4697157 -74140516)
2016,Junio,Turkmenistán,3,6,,9,POINT (4697157 -74140516)
2016,Junio,Turquía,312,490,,802,POINT (4697157 -74140516)
2016,Junio,Turquía,2,2,,4,POINT (6170465 -7542726)
2016,Junio,Ucrania,0,1,,1,POINT (4697157 -74140516)
2016,Junio,Ucrania,0,1,,1,POINT (6170465 -7542726)
2016,Junio,Uruguay,0,1,,1,POINT (0.81488 -77356)
2016,Junio,Uruguay,3,3,,6,POINT (10446304 -75516486)
2016,Junio,Uruguay,17,15,,32,POINT (125862 -81702165)
2016,Junio,Uruguay,7,19,,26,POINT (3451668 -76532004)
2016,Junio,Uruguay,89,116,,205,POINT (4697157 -74140516)
2016,Junio,Uruguay,3,2,,5,POINT (4815189 -75736374)
2016,Junio,Uruguay,27,39,,66,POINT (6170465 -7542726)
2016,Junio,Uruguay,1,2,,3,POINT (7128047 -73181317)
2016,Junio,Venezuela,0,27,,27,POINT (10406342 -75527794)
2016,Junio,Venezuela,9,22,,31,POINT (10446304 -75516486)
2016,Junio,Venezuela,32,40,,72,POINT (10886686 -74776479)
2016,Junio,Venezuela,0,1,,1,POINT (11247723 -74213989)
2016,Junio,Venezuela,670,942,,1612,POINT (11360029 -72129595)
2016,Junio,Venezuela,4,4,,8,POINT (125862 -81702165)
2016,Junio,Venezuela,8,28,,36,POINT (3451668 -76532004)
2016,Junio,Venezuela,24,38,,62,POINT (3866713 -67927521)
2016,Junio,Venezuela,3351,4195,,7546,POINT (4697157 -74140516)
2016,Junio,Venezuela,1,4,,5,POINT (4815189 -75736374)
2016,Junio,Venezuela,659,733,,1392,POINT (6170465 -7542726)
2016,Junio,Venezuela,27,46,,73,POINT (6185536 -67484028)
2016,Junio,Venezuela,78,84,,162,POINT (7088729 -70740253)
2016,Junio,Venezuela,2,4,,6,POINT (7128047 -73181317)
2016,Junio,Venezuela,1466,2036,,3502,POINT (7819 -72453013)
2016,Junio,Venezuela,161,165,,326,POINT (7927233 -72508188)
2016,Junio,Vietnam,0,2,,2,POINT (6170465 -7542726)
2016,Junio,Islas Vírgenes Británicas/Territorio Británico de Ultramar,2,2,,4,POINT (4697157 -74140516)
2016,Junio,Desconocido,0,1,,1,POINT (-4191162 -69941498)
2016,Julio,Afganistán,0,1,,1,POINT (10886686 -74776479)
2016,Julio,Afganistán,0,1,,1,POINT (4697157 -74140516)
2016,Julio,Albania,1,0,,1,POINT (4697157 -74140516)
2016,Julio,Alemania,1,0,,1,POINT (10446304 -75516486)
2016,Julio,Alemania,5,7,,12,POINT (10886686 -74776479)
2016,Julio,Alemania,0,2,,2,POINT (11247723 -74213989)
2016,Julio,Alemania,1,2,,3,POINT (125862 -81702165)
2016,Julio,Alemania,62,54,,116,POINT (3451668 -76532004)
2016,Julio,Alemania,1587,2101,,3688,POINT (4697157 -74140516)
2016,Julio,Alemania,5,5,,10,POINT (4815189 -75736374)
2016,Julio,Alemania,68,65,,133,POINT (6170465 -7542726)
2016,Julio,Alemania,1,2,,3,POINT (7128047 -73181317)
2016,Julio,Andorra,1,0,,1,POINT (4697157 -74140516)
2016,Julio,Antigua y Barbuda,0,1,,1,POINT (10406342 -75527794)
2016,Julio,Antigua y Barbuda,0,1,,1,POINT (4697157 -74140516)
2016,Julio,Antigua y Barbuda,1,0,,1,POINT (6170465 -7542726)
2016,Julio,Países Bajos,3,16,,19,POINT (10406342 -75527794)
2016,Julio,Países Bajos,1,4,,5,POINT (10446304 -75516486)
2016,Julio,Países Bajos,202,204,,406,POINT (10886686 -74776479)
2016,Julio,Países Bajos,0,4,,4,POINT (11247723 -74213989)
2016,Julio,Países Bajos,116,164,,280,POINT (3451668 -76532004)
2016,Julio,Países Bajos,979,1339,,2318,POINT (4697157 -74140516)
2016,Julio,Países Bajos,10,7,,17,POINT (4815189 -75736374)
2016,Julio,Países Bajos,370,392,,762,POINT (6170465 -7542726)
2016,Julio,Países Bajos,4,3,,7,POINT (7128047 -73181317)
2016,Julio,Países Bajos,1,0,,1,POINT (7927233 -72508188)
2016,Julio,Arabia Saudita,5,6,,11,POINT (4697157 -74140516)
2016,Julio,Arabia Saudita,0,1,,1,POINT (4815189 -75736374)
2016,Julio,Arabia Saudita,0,1,,1,POINT (6170465 -7542726)
2016,Julio,Argelia,1,0,,1,POINT (3451668 -76532004)
2016,Julio,Argelia,1,4,,5,POINT (4697157 -74140516)
2016,Julio,Argentina,8,9,,17,POINT (0.81488 -77356)
2016,Julio,Argentina,0,4,,4,POINT (10406342 -75527794)
2016,Julio,Argentina,37,29,,66,POINT (10446304 -75516486)
2016,Julio,Argentina,8,10,,18,POINT (10886686 -74776479)
2016,Julio,Argentina,289,207,,496,POINT (125862 -81702165)
2016,Julio,Argentina,68,67,,135,POINT (3451668 -76532004)
2016,Julio,Argentina,0,9,,9,POINT (3884426 -77061029)
2016,Julio,Argentina,2648,3319,,5967,POINT (4697157 -74140516)
2016,Julio,Argentina,1,0,,1,POINT (4815189 -75736374)
2016,Julio,Argentina,76,134,,210,POINT (6170465 -7542726)
2016,Julio,Argentina,2,2,,4,POINT (7128047 -73181317)
2016,Julio,Aruba,3,9,,12,POINT (10406342 -75527794)
2016,Julio,Aruba,2,4,,6,POINT (10446304 -75516486)
2016,Julio,Aruba,17,25,,42,POINT (10886686 -74776479)
2016,Julio,Aruba,2,8,,10,POINT (11247723 -74213989)
2016,Julio,Aruba,26,38,,64,POINT (3451668 -76532004)
2016,Julio,Aruba,977,991,,1968,POINT (4697157 -74140516)
2016,Julio,Aruba,6,2,,8,POINT (4815189 -75736374)
2016,Julio,Aruba,173,189,,362,POINT (6170465 -7542726)
2016,Julio,Aruba,12,9,,21,POINT (7128047 -73181317)
2016,Julio,Aruba,0,1,,1,POINT (7927233 -72508188)
2016,Julio,Australia,0,1,,1,POINT (10886686 -74776479)
2016,Julio,Australia,5,7,,12,POINT (3451668 -76532004)
2016,Julio,Australia,44,53,,97,POINT (4697157 -74140516)
2016,Julio,Australia,9,17,,26,POINT (6170465 -7542726)
2016,Julio,Australia,1,0,,1,POINT (7128047 -73181317)
2016,Julio,Austria,0,2,,2,POINT (125862 -81702165)
2016,Julio,Austria,6,3,,9,POINT (3451668 -76532004)
2016,Julio,Austria,39,46,,85,POINT (4697157 -74140516)
2016,Julio,Austria,7,9,,16,POINT (6170465 -7542726)
2016,Julio,Bahamas,0,1,,1,POINT (10406342 -75527794)
2016,Julio,Bahamas,0,1,,1,POINT (3451668 -76532004)
2016,Julio,Bahamas,3,4,,7,POINT (4697157 -74140516)
2016,Julio,Bahamas,0,1,,1,POINT (4815189 -75736374)
2016,Julio,Bahamas,9,2,,11,POINT (6170465 -7542726)
2016,Julio,Bahamas,1,0,,1,POINT (7927233 -72508188)
2016,Julio,Bahamas,0,2,,2,POINT (9402597 -75681642)
2016,Julio,Bahréin,1,1,,2,POINT (10446304 -75516486)
2016,Julio,Bahréin,1,1,,2,POINT (4697157 -74140516)
2016,Julio,Bangladesh,0,1,,1,POINT (4697157 -74140516)
2016,Julio,Barbados,1,1,,2,POINT (3451668 -76532004)
2016,Julio,Barbados,40,49,,89,POINT (4697157 -74140516)
2016,Julio,Barbados,1,0,,1,POINT (6170465 -7542726)
2016,Julio,Barbados,0,1,,1,POINT (7128047 -73181317)
2016,Julio,República de Belarús,0,1,,1,POINT (11360029 -72129595)
2016,Julio,República de Belarús,0,5,,5,POINT (4697157 -74140516)
2016,Julio,Bélgica,1,1,,2,POINT (10446304 -75516486)
2016,Julio,Bélgica,2,0,,2,POINT (10886686 -74776479)
2016,Julio,Bélgica,8,10,,18,POINT (3451668 -76532004)
2016,Julio,Bélgica,67,71,,138,POINT (4697157 -74140516)
2016,Julio,Bélgica,23,33,,56,POINT (6170465 -7542726)
2016,Julio,Belice,1,0,,1,POINT (3451668 -76532004)
2016,Julio,Belice,1,3,,4,POINT (4697157 -74140516)
2016,Julio,Bermudas/Territorio Británico de Ultramar,0,9,,9,POINT (10406342 -75527794)
2016,Julio,Bolivia,2,2,,4,POINT (0.81488 -77356)
2016,Julio,Bolivia,1,2,,3,POINT (10446304 -75516486)
2016,Julio,Bolivia,32,21,,53,POINT (125862 -81702165)
2016,Julio,Bolivia,25,25,,50,POINT (3451668 -76532004)
2016,Julio,Bolivia,615,654,,1269,POINT (4697157 -74140516)
2016,Julio,Bolivia,49,52,,101,POINT (6170465 -7542726)
2016,Julio,Bolivia,4,0,,4,POINT (7128047 -73181317)
2016,Julio,Botsuana,1,0,,1,POINT (4697157 -74140516)
2016,Julio,Brasil,164,203,,367,POINT (-4191162 -69941498)
2016,Julio,Brasil,1,3,,4,POINT (-4214082 -69941431)
2016,Julio,Brasil,1,4,,5,POINT (0.81488 -77356)
2016,Julio,Brasil,0,8,,8,POINT (10406342 -75527794)
2016,Julio,Brasil,49,37,,86,POINT (10446304 -75516486)
2016,Julio,Brasil,13,12,,25,POINT (10886686 -74776479)
2016,Julio,Brasil,496,372,,868,POINT (125862 -81702165)
2016,Julio,Brasil,84,88,,172,POINT (3451668 -76532004)
2016,Julio,Brasil,4639,5714,,10353,POINT (4697157 -74140516)
2016,Julio,Brasil,1,8,,9,POINT (4815189 -75736374)
2016,Julio,Brasil,108,274,,382,POINT (6170465 -7542726)
2016,Julio,Brasil,0,2,,2,POINT (7128047 -73181317)
2016,Julio,Brasil,0,4,,4,POINT (7927233 -72508188)
2016,Julio,Bulgaria,1,1,,2,POINT (4697157 -74140516)
2016,Julio,Bulgaria,1,0,,1,POINT (6170465 -7542726)
2016,Julio,Bulgaria,0,1,,1,POINT (7927233 -72508188)
2016,Julio,Burkina Faso,0,4,,4,POINT (6170465 -7542726)
2016,Julio,Cabo Verde,0,1,,1,POINT (4697157 -74140516)
2016,Julio,Islas Caimán/Territorio Británico de Ultramar,0,2,,2,POINT (125862 -81702165)
2016,Julio,Islas Caimán/Territorio Británico de Ultramar,2,2,,4,POINT (4697157 -74140516)
2016,Julio,Canadá,37,12,,49,POINT (10446304 -75516486)
2016,Julio,Canadá,6,5,,11,POINT (10886686 -74776479)
2016,Julio,Canadá,1,1,,2,POINT (125862 -81702165)
2016,Julio,Canadá,55,56,,111,POINT (3451668 -76532004)
2016,Julio,Canadá,698,925,,1623,POINT (4697157 -74140516)
2016,Julio,Canadá,9,8,,17,POINT (4815189 -75736374)
2016,Julio,Canadá,126,218,,344,POINT (6170465 -7542726)
2016,Julio,Canadá,12,9,,21,POINT (7128047 -73181317)
2016,Julio,Canadá,1,0,,1,POINT (7927233 -72508188)
2016,Julio,España,1,7,,8,POINT (10406342 -75527794)
2016,Julio,España,6,6,,12,POINT (10446304 -75516486)
2016,Julio,España,6,8,,14,POINT (10886686 -74776479)
2016,Julio,España,2,3,,5,POINT (125862 -81702165)
2016,Julio,España,530,761,,1291,POINT (3451668 -76532004)
2016,Julio,España,3876,5843,,9719,POINT (4697157 -74140516)
2016,Julio,España,5,6,,11,POINT (4815189 -75736374)
2016,Julio,España,304,490,,794,POINT (6170465 -7542726)
2016,Julio,España,1,2,,3,POINT (7128047 -73181317)
2016,Julio,España,2,5,,7,POINT (7927233 -72508188)
2016,Julio,República de Corea,0,2,,2,POINT (10406342 -75527794)
2016,Julio,República de Corea,1,0,,1,POINT (3451668 -76532004)
2016,Julio,República de Corea,16,19,,35,POINT (4697157 -74140516)
2016,Julio,República de Corea,0,1,,1,POINT (6170465 -7542726)
2016,Julio,Costa de Marfil,2,4,,6,POINT (4697157 -74140516)
2016,Julio,Costa Rica,0,9,,9,POINT (10406342 -75527794)
2016,Julio,Costa Rica,6,7,,13,POINT (10446304 -75516486)
2016,Julio,Costa Rica,8,22,,30,POINT (10886686 -74776479)
2016,Julio,Costa Rica,0,1,,1,POINT (11247723 -74213989)
2016,Julio,Costa Rica,0,3,,3,POINT (125744111 -81703935)
2016,Julio,Costa Rica,232,185,,417,POINT (125862 -81702165)
2016,Julio,Costa Rica,26,18,,44,POINT (3451668 -76532004)
2016,Julio,Costa Rica,1121,1540,,2661,POINT (4697157 -74140516)
2016,Julio,Costa Rica,14,19,,33,POINT (4815189 -75736374)
2016,Julio,Costa Rica,136,168,,304,POINT (6170465 -7542726)
2016,Julio,Costa Rica,3,0,,3,POINT (7128047 -73181317)
2016,Julio,Costa Rica,0,1,,1,POINT (7927233 -72508188)
2016,Julio,Croacia,0,1,,1,POINT (10886686 -74776479)
2016,Julio,Croacia,0,1,,1,POINT (3451668 -76532004)
2016,Julio,Croacia,0,1,,1,POINT (4697157 -74140516)
2016,Julio,Cuba,0,1,,1,POINT (10446304 -75516486)
2016,Julio,Cuba,4,16,,20,POINT (10886686 -74776479)
2016,Julio,Cuba,0,1,,1,POINT (11247723 -74213989)
2016,Julio,Cuba,4,3,,7,POINT (125744111 -81703935)
2016,Julio,Cuba,2,0,,2,POINT (125862 -81702165)
2016,Julio,Cuba,18,36,,54,POINT (3451668 -76532004)
2016,Julio,Cuba,369,563,,932,POINT (4697157 -74140516)
2016,Julio,Cuba,4,5,,9,POINT (4815189 -75736374)
2016,Julio,Cuba,30,37,,67,POINT (6170465 -7542726)
2016,Julio,Cuba,2,1,,3,POINT (7128047 -73181317)
2016,Julio,Cuba,0,3,,3,POINT (7927233 -72508188)
2016,Julio,República Checa,1,3,,4,POINT (3451668 -76532004)
2016,Julio,República Checa,4,9,,13,POINT (4697157 -74140516)
2016,Julio,República Checa,0,1,,1,POINT (7927233 -72508188)
2016,Julio,Chile,2,6,,8,POINT (0.81488 -77356)
2016,Julio,Chile,0,1,,1,POINT (10406342 -75527794)
2016,Julio,Chile,14,9,,23,POINT (10446304 -75516486)
2016,Julio,Chile,3,7,,10,POINT (10886686 -74776479)
2016,Julio,Chile,156,120,,276,POINT (125862 -81702165)
2016,Julio,Chile,66,62,,128,POINT (3451668 -76532004)
2016,Julio,Chile,5047,5889,,10936,POINT (4697157 -74140516)
2016,Julio,Chile,3,3,,6,POINT (4815189 -75736374)
2016,Julio,Chile,49,60,,109,POINT (6170465 -7542726)
2016,Julio,Chile,0,2,,2,POINT (7128047 -73181317)
2016,Julio,China,1,1,,2,POINT (10886686 -74776479)
2016,Julio,China,0,1,,1,POINT (3451668 -76532004)
2016,Julio,China,34,75,,109,POINT (4697157 -74140516)
2016,Julio,China,3,6,,9,POINT (6170465 -7542726)
2016,Julio,China,1,0,,1,POINT (7128047 -73181317)
2016,Julio,Dinamarca,1,0,,1,POINT (10446304 -75516486)
2016,Julio,Dinamarca,1,2,,3,POINT (10886686 -74776479)
2016,Julio,Dinamarca,1,0,,1,POINT (125862 -81702165)
2016,Julio,Dinamarca,1,0,,1,POINT (3451668 -76532004)
2016,Julio,Dinamarca,27,28,,55,POINT (4697157 -74140516)
2016,Julio,Dinamarca,6,3,,9,POINT (4815189 -75736374)
2016,Julio,Dinamarca,2,1,,3,POINT (6170465 -7542726)
2016,Julio,Dominica,0,1,,1,POINT (4697157 -74140516)
2016,Julio,Ecuador,0,3,,3,POINT (0.185957 -7478366)
2016,Julio,Ecuador,160,342,,502,POINT (0.33002 -76876446)
2016,Julio,Ecuador,1,1,,2,POINT (0.812436 -77847006)
2016,Julio,Ecuador,4502,5644,,10146,POINT (0.81488 -77356)
2016,Julio,Ecuador,52,159,,211,POINT (1800143 -78802679)
2016,Julio,Ecuador,0,1,,1,POINT (1812498 -78751321)
2016,Julio,Ecuador,187,168,,355,POINT (10446304 -75516486)
2016,Julio,Ecuador,1,0,,1,POINT (10886686 -74776479)
2016,Julio,Ecuador,0,2,,2,POINT (10970933 -74765343)
2016,Julio,Ecuador,9,5,,14,POINT (125862 -81702165)
2016,Julio,Ecuador,432,503,,935,POINT (3451668 -76532004)
2016,Julio,Ecuador,0,2,,2,POINT (3884426 -77061029)
2016,Julio,Ecuador,3570,4901,,8471,POINT (4697157 -74140516)
2016,Julio,Ecuador,3,12,,15,POINT (4815189 -75736374)
2016,Julio,Ecuador,86,261,,347,POINT (6170465 -7542726)
2016,Julio,Ecuador,0,1,,1,POINT (7128047 -73181317)
2016,Julio,Ecuador,0,2,,2,POINT (7927233 -72508188)
2016,Julio,Egipto,0,7,,7,POINT (4697157 -74140516)
2016,Julio,Egipto,1,0,,1,POINT (6170465 -7542726)
2016,Julio,El Salvador,3,1,,4,POINT (10446304 -75516486)
2016,Julio,El Salvador,1,2,,3,POINT (10886686 -74776479)
2016,Julio,El Salvador,21,17,,38,POINT (125862 -81702165)
2016,Julio,El Salvador,115,192,,307,POINT (3451668 -76532004)
2016,Julio,El Salvador,1058,1531,,2589,POINT (4697157 -74140516)
2016,Julio,El Salvador,205,308,,513,POINT (6170465 -7542726)
2016,Julio,El Salvador,0,1,,1,POINT (7128047 -73181317)
2016,Julio,Emiratos Árabes,8,24,,32,POINT (4697157 -74140516)
2016,Julio,Emiratos Árabes,3,3,,6,POINT (6170465 -7542726)
2016,Julio,Eritrea,1,1,,2,POINT (4697157 -74140516)
2016,Julio,Eslovaquia,1,2,,3,POINT (4697157 -74140516)
2016,Julio,Eslovenia,1,7,,8,POINT (4697157 -74140516)
2016,Julio,Eslovenia,1,1,,2,POINT (6170465 -7542726)
2016,Julio,Estados Unidos de América,0,16,,16,POINT (10406342 -75527794)
2016,Julio,Estados Unidos de América,4019,5026,,9045,POINT (10446304 -75516486)
2016,Julio,Estados Unidos de América,847,1210,,2057,POINT (10886686 -74776479)
2016,Julio,Estados Unidos de América,0,1,,1,POINT (10970933 -74765343)
2016,Julio,Estados Unidos de América,0,1,,1,POINT (11117206 -74232675)
2016,Julio,Estados Unidos de América,0,7,,7,POINT (11247723 -74213989)
2016,Julio,Estados Unidos de América,79,91,,170,POINT (125862 -81702165)
2016,Julio,Estados Unidos de América,1729,2030,,3759,POINT (3451668 -76532004)
2016,Julio,Estados Unidos de América,263,361,,624,POINT (445285 -75766353)
2016,Julio,Estados Unidos de América,10665,15956,,26621,POINT (4697157 -74140516)
2016,Julio,Estados Unidos de América,291,301,,592,POINT (4815189 -75736374)
2016,Julio,Estados Unidos de América,3903,6768,,10671,POINT (6170465 -7542726)
2016,Julio,Estados Unidos de América,35,60,,95,POINT (7128047 -73181317)
2016,Julio,Estados Unidos de América,57,56,,113,POINT (7927233 -72508188)
2016,Julio,Estados Unidos de América,0,2,,2,POINT (806667 -767333)
2016,Julio,Estados Unidos de América,1,22,,23,POINT (9402597 -75681642)
2016,Julio,Estonia,1,2,,3,POINT (4697157 -74140516)
2016,Julio,Etiopia,2,1,,3,POINT (4697157 -74140516)
2016,Julio,Filipinas,0,2,,2,POINT (10446304 -75516486)
2016,Julio,Filipinas,0,1,,1,POINT (10886686 -74776479)
2016,Julio,Filipinas,0,1,,1,POINT (125862 -81702165)
2016,Julio,Filipinas,0,1,,1,POINT (3451668 -76532004)
2016,Julio,Filipinas,3,10,,13,POINT (4697157 -74140516)
2016,Julio,Filipinas,0,1,,1,POINT (6170465 -7542726)
2016,Julio,Finlandia,7,3,,10,POINT (4697157 -74140516)
2016,Julio,Francia,0,3,,3,POINT (10406342 -75527794)
2016,Julio,Francia,1,2,,3,POINT (10446304 -75516486)
2016,Julio,Francia,0,5,,5,POINT (10886686 -74776479)
2016,Julio,Francia,1,0,,1,POINT (125862 -81702165)
2016,Julio,Francia,68,92,,160,POINT (3451668 -76532004)
2016,Julio,Francia,1,0,,1,POINT (3884426 -77061029)
2016,Julio,Francia,1546,2244,,3790,POINT (4697157 -74140516)
2016,Julio,Francia,3,11,,14,POINT (4815189 -75736374)
2016,Julio,Francia,78,102,,180,POINT (6170465 -7542726)
2016,Julio,Francia,1,0,,1,POINT (7128047 -73181317)
2016,Julio,Georgia,1,0,,1,POINT (4697157 -74140516)
2016,Julio,Ghana,1,0,,1,POINT (4697157 -74140516)
2016,Julio,Grecia,1,1,,2,POINT (3451668 -76532004)
2016,Julio,Grecia,5,4,,9,POINT (4697157 -74140516)
2016,Julio,Grecia,0,1,,1,POINT (6170465 -7542726)
2016,Julio,Guatemala,7,4,,11,POINT (10446304 -75516486)
2016,Julio,Guatemala,0,3,,3,POINT (10886686 -74776479)
2016,Julio,Guatemala,25,16,,41,POINT (125862 -81702165)
2016,Julio,Guatemala,8,31,,39,POINT (3451668 -76532004)
2016,Julio,Guatemala,336,609,,945,POINT (4697157 -74140516)
2016,Julio,Guatemala,5,13,,18,POINT (4815189 -75736374)
2016,Julio,Guatemala,81,140,,221,POINT (6170465 -7542726)
2016,Julio,Guatemala,4,2,,6,POINT (7128047 -73181317)
2016,Julio,Guatemala,3,2,,5,POINT (7927233 -72508188)
2016,Julio,Guyana,1,4,,5,POINT (4697157 -74140516)
2016,Julio,Guadalupe/Territorio Francés,0,2,,2,POINT (3451668 -76532004)
2016,Julio,Guadalupe/Territorio Francés,3,7,,10,POINT (4697157 -74140516)
2016,Julio,Guadalupe/Territorio Francés,0,1,,1,POINT (4815189 -75736374)
2016,Julio,Guayana Francesa/Departamento de Ultramar Francés,0,1,,1,POINT (4697157 -74140516)
2016,Julio,Haití,3,2,,5,POINT (4697157 -74140516)
2016,Julio,Haití,1,0,,1,POINT (6170465 -7542726)
2016,Julio,Honduras,5,3,,8,POINT (10446304 -75516486)
2016,Julio,Honduras,2,2,,4,POINT (10886686 -74776479)
2016,Julio,Honduras,3,24,,27,POINT (125744111 -81703935)
2016,Julio,Honduras,11,17,,28,POINT (3451668 -76532004)
2016,Julio,Honduras,81,125,,206,POINT (4697157 -74140516)
2016,Julio,Honduras,1,0,,1,POINT (4815189 -75736374)
2016,Julio,Honduras,58,61,,119,POINT (6170465 -7542726)
2016,Julio,Honduras,1,0,,1,POINT (7128047 -73181317)
2016,Julio,Honduras,0,1,,1,POINT (7927233 -72508188)
2016,Julio,Honduras,0,1,,1,POINT (863337 -7735002)
2016,Julio,Hong Kong,2,6,,8,POINT (4697157 -74140516)
2016,Julio,Hong Kong,1,2,,3,POINT (6170465 -7542726)
2016,Julio,Hungría,6,7,,13,POINT (4697157 -74140516)
2016,Julio,India,0,1,,1,POINT (10886686 -74776479)
2016,Julio,India,1,2,,3,POINT (3451668 -76532004)
2016,Julio,India,3,38,,41,POINT (4697157 -74140516)
2016,Julio,India,2,11,,13,POINT (6170465 -7542726)
2016,Julio,Indonesia,2,5,,7,POINT (4697157 -74140516)
2016,Julio,Irán,1,0,,1,POINT (4697157 -74140516)
2016,Julio,República de Irlanda,1,1,,2,POINT (3451668 -76532004)
2016,Julio,República de Irlanda,9,18,,27,POINT (4697157 -74140516)
2016,Julio,República de Irlanda,1,1,,2,POINT (4815189 -75736374)
2016,Julio,República de Irlanda,3,5,,8,POINT (6170465 -7542726)
2016,Julio,Israel,2,0,,2,POINT (10446304 -75516486)
2016,Julio,Israel,1,2,,3,POINT (3451668 -76532004)
2016,Julio,Israel,17,61,,78,POINT (4697157 -74140516)
2016,Julio,Israel,3,6,,9,POINT (6170465 -7542726)
2016,Julio,Italia,0,1,,1,POINT (10446304 -75516486)
2016,Julio,Italia,1,1,,2,POINT (10886686 -74776479)
2016,Julio,Italia,30,38,,68,POINT (3451668 -76532004)
2016,Julio,Italia,137,236,,373,POINT (4697157 -74140516)
2016,Julio,Italia,0,2,,2,POINT (4815189 -75736374)
2016,Julio,Italia,14,33,,47,POINT (6170465 -7542726)
2016,Julio,Italia,0,1,,1,POINT (7128047 -73181317)
2016,Julio,Italia,0,2,,2,POINT (7927233 -72508188)
2016,Julio,Jamaica,2,5,,7,POINT (10406342 -75527794)
2016,Julio,Jamaica,0,1,,1,POINT (10446304 -75516486)
2016,Julio,Jamaica,1,9,,10,POINT (10886686 -74776479)
2016,Julio,Jamaica,0,2,,2,POINT (10970933 -74765343)
2016,Julio,Jamaica,2,2,,4,POINT (125862 -81702165)
2016,Julio,Jamaica,2,3,,5,POINT (133387613 -81372937)
2016,Julio,Jamaica,6,1,,7,POINT (3451668 -76532004)
2016,Julio,Jamaica,6,6,,12,POINT (4697157 -74140516)
2016,Julio,Jamaica,2,5,,7,POINT (6170465 -7542726)
2016,Julio,Jamaica,0,1,,1,POINT (7927233 -72508188)
2016,Julio,Japón,0,1,,1,POINT (10886686 -74776479)
2016,Julio,Japón,1,1,,2,POINT (3451668 -76532004)
2016,Julio,Japón,16,22,,38,POINT (4697157 -74140516)
2016,Julio,Japón,8,18,,26,POINT (6170465 -7542726)
2016,Julio,Jordania,1,0,,1,POINT (4697157 -74140516)
2016,Julio,Kazajistán,1,0,,1,POINT (4697157 -74140516)
2016,Julio,Kenia,1,2,,3,POINT (3451668 -76532004)
2016,Julio,Kenia,4,7,,11,POINT (4697157 -74140516)
2016,Julio,Letonia,1,0,,1,POINT (4697157 -74140516)
2016,Julio,Lituania,1,1,,2,POINT (3451668 -76532004)
2016,Julio,Lituania,2,5,,7,POINT (4697157 -74140516)
2016,Julio,Líbano,5,7,,12,POINT (4697157 -74140516)
2016,Julio,Luxemburgo,0,1,,1,POINT (3451668 -76532004)
2016,Julio,Luxemburgo,2,0,,2,POINT (4697157 -74140516)
2016,Julio,Luxemburgo,1,0,,1,POINT (6170465 -7542726)
2016,Julio,Malasia,2,5,,7,POINT (4697157 -74140516)
2016,Julio,Maldivas,0,1,,1,POINT (4697157 -74140516)
2016,Julio,Malta,3,3,,6,POINT (4697157 -74140516)
2016,Julio,Marruecos,0,1,,1,POINT (10970933 -74765343)
2016,Julio,Marruecos,2,2,,4,POINT (4697157 -74140516)
2016,Julio,Mauricio,1,0,,1,POINT (6170465 -7542726)
2016,Julio,Mauritania,1,0,,1,POINT (4697157 -74140516)
2016,Julio,Martinica/Departamento de Ultramar Francés,0,2,,2,POINT (4697157 -74140516)
2016,Julio,Martinica/Departamento de Ultramar Francés,1,0,,1,POINT (4815189 -75736374)
2016,Julio,México,1,11,,12,POINT (10406342 -75527794)
2016,Julio,México,27,35,,62,POINT (10446304 -75516486)
2016,Julio,México,38,36,,74,POINT (10886686 -74776479)
2016,Julio,México,0,1,,1,POINT (11247723 -74213989)
2016,Julio,México,20,27,,47,POINT (125862 -81702165)
2016,Julio,México,71,179,,250,POINT (3451668 -76532004)
2016,Julio,México,5943,8354,,14297,POINT (4697157 -74140516)
2016,Julio,México,64,50,,114,POINT (4815189 -75736374)
2016,Julio,México,886,1608,,2494,POINT (6170465 -7542726)
2016,Julio,México,25,33,,58,POINT (7128047 -73181317)
2016,Julio,México,15,11,,26,POINT (7927233 -72508188)
2016,Julio,Nicaragua,0,1,,1,POINT (10406342 -75527794)
2016,Julio,Nicaragua,1,1,,2,POINT (10446304 -75516486)
2016,Julio,Nicaragua,0,2,,2,POINT (10886686 -74776479)
2016,Julio,Nicaragua,2,4,,6,POINT (125744111 -81703935)
2016,Julio,Nicaragua,2,0,,2,POINT (125862 -81702165)
2016,Julio,Nicaragua,2,3,,5,POINT (3451668 -76532004)
2016,Julio,Nicaragua,34,57,,91,POINT (4697157 -74140516)
2016,Julio,Nicaragua,1,1,,2,POINT (4815189 -75736374)
2016,Julio,Nicaragua,7,19,,26,POINT (6170465 -7542726)
2016,Julio,Nicaragua,1,2,,3,POINT (7128047 -73181317)
2016,Julio,Nicaragua,0,1,,1,POINT (7927233 -72508188)
2016,Julio,Noruega,1,0,,1,POINT (10886686 -74776479)
2016,Julio,Noruega,1,2,,3,POINT (3451668 -76532004)
2016,Julio,Noruega,17,21,,38,POINT (4697157 -74140516)
2016,Julio,Noruega,7,7,,14,POINT (6170465 -7542726)
2016,Julio,Nueva Zelanda,10,7,,17,POINT (4697157 -74140516)
2016,Julio,Nueva Zelanda,3,6,,9,POINT (6170465 -7542726)
2016,Julio,Panamá,160,240,,400,POINT (10406342 -75527794)
2016,Julio,Panamá,3309,3621,,6930,POINT (10446304 -75516486)
2016,Julio,Panamá,363,620,,983,POINT (10886686 -74776479)
2016,Julio,Panamá,1,26,,27,POINT (10970933 -74765343)
2016,Julio,Panamá,1,3,,4,POINT (11247723 -74213989)
2016,Julio,Panamá,2,4,,6,POINT (125744111 -81703935)
2016,Julio,Panamá,159,158,,317,POINT (125862 -81702165)
2016,Julio,Panamá,340,516,,856,POINT (3451668 -76532004)
2016,Julio,Panamá,2,6,,8,POINT (3884426 -77061029)
2016,Julio,Panamá,22,48,,70,POINT (445285 -75766353)
2016,Julio,Panamá,4460,6142,,10602,POINT (4697157 -74140516)
2016,Julio,Panamá,116,135,,251,POINT (4815189 -75736374)
2016,Julio,Panamá,2252,2900,,5152,POINT (6170465 -7542726)
2016,Julio,Panamá,2,2,,4,POINT (7102626 -77762647)
2016,Julio,Panamá,21,39,,60,POINT (7128047 -73181317)
2016,Julio,Panamá,34,52,,86,POINT (7927233 -72508188)
2016,Julio,Panamá,125,129,,254,POINT (863337 -7735002)
2016,Julio,Paraguay,4,5,,9,POINT (10446304 -75516486)
2016,Julio,Paraguay,0,2,,2,POINT (10886686 -74776479)
2016,Julio,Paraguay,66,52,,118,POINT (125862 -81702165)
2016,Julio,Paraguay,16,9,,25,POINT (3451668 -76532004)
2016,Julio,Paraguay,48,55,,103,POINT (4697157 -74140516)
2016,Julio,Paraguay,0,6,,6,POINT (4815189 -75736374)
2016,Julio,Paraguay,13,35,,48,POINT (6170465 -7542726)
2016,Julio,Paraguay,4,4,,8,POINT (7927233 -72508188)
2016,Julio,Perú,210,294,,504,POINT (-4191162 -69941498)
2016,Julio,Perú,0,2,,2,POINT (0.185957 -7478366)
2016,Julio,Perú,135,94,,229,POINT (0.81488 -77356)
2016,Julio,Perú,0,28,,28,POINT (10406342 -75527794)
2016,Julio,Perú,25,17,,42,POINT (10446304 -75516486)
2016,Julio,Perú,3,2,,5,POINT (10886686 -74776479)
2016,Julio,Perú,116,80,,196,POINT (125862 -81702165)
2016,Julio,Perú,437,548,,985,POINT (3451668 -76532004)
2016,Julio,Perú,0,16,,16,POINT (3884426 -77061029)
2016,Julio,Perú,6675,8213,,14888,POINT (4697157 -74140516)
2016,Julio,Perú,0,2,,2,POINT (4815189 -75736374)
2016,Julio,Perú,572,769,,1341,POINT (6170465 -7542726)
2016,Julio,Perú,2,3,,5,POINT (7128047 -73181317)
2016,Julio,Perú,1,2,,3,POINT (7927233 -72508188)
2016,Julio,Palestina,1,0,,1,POINT (4697157 -74140516)
2016,Julio,Polonia,0,1,,1,POINT (3451668 -76532004)
2016,Julio,Polonia,23,31,,54,POINT (4697157 -74140516)
2016,Julio,Polonia,0,4,,4,POINT (6170465 -7542726)
2016,Julio,Portugal,1,5,,6,POINT (3451668 -76532004)
2016,Julio,Portugal,17,48,,65,POINT (4697157 -74140516)
2016,Julio,Portugal,3,18,,21,POINT (6170465 -7542726)
2016,Julio,Polinesia Francesa/Colectividad de Ultramar Francesa,2,0,,2,POINT (4697157 -74140516)
2016,Julio,Puerto Rico/Territorio de Estados Unidos,6,6,,12,POINT (10446304 -75516486)
2016,Julio,Puerto Rico/Territorio de Estados Unidos,8,42,,50,POINT (10886686 -74776479)
2016,Julio,Puerto Rico/Territorio de Estados Unidos,1,0,,1,POINT (125862 -81702165)
2016,Julio,Puerto Rico/Territorio de Estados Unidos,25,44,,69,POINT (3451668 -76532004)
2016,Julio,Puerto Rico/Territorio de Estados Unidos,695,677,,1372,POINT (4697157 -74140516)
2016,Julio,Puerto Rico/Territorio de Estados Unidos,4,19,,23,POINT (4815189 -75736374)
2016,Julio,Puerto Rico/Territorio de Estados Unidos,117,166,,283,POINT (6170465 -7542726)
2016,Julio,Puerto Rico/Territorio de Estados Unidos,2,6,,8,POINT (7128047 -73181317)
2016,Julio,Puerto Rico/Territorio de Estados Unidos,8,7,,15,POINT (7927233 -72508188)
2016,Julio,Qatar,5,32,,37,POINT (4697157 -74140516)
2016,Julio,Reino Unido de Gran Bretaña e Irlanda del Norte,0,2,,2,POINT (10446304 -75516486)
2016,Julio,Reino Unido de Gran Bretaña e Irlanda del Norte,0,1,,1,POINT (10886686 -74776479)
2016,Julio,Reino Unido de Gran Bretaña e Irlanda del Norte,0,2,,2,POINT (11247723 -74213989)
2016,Julio,Reino Unido de Gran Bretaña e Irlanda del Norte,69,72,,141,POINT (3451668 -76532004)
2016,Julio,Reino Unido de Gran Bretaña e Irlanda del Norte,807,1142,,1949,POINT (4697157 -74140516)
2016,Julio,Reino Unido de Gran Bretaña e Irlanda del Norte,0,1,,1,POINT (4815189 -75736374)
2016,Julio,Reino Unido de Gran Bretaña e Irlanda del Norte,64,66,,130,POINT (6170465 -7542726)
2016,Julio,República CentroÁfricana,2,1,,3,POINT (4697157 -74140516)
2016,Julio,Federación de Rusia,4,3,,7,POINT (3451668 -76532004)
2016,Julio,Federación de Rusia,13,19,,32,POINT (4697157 -74140516)
2016,Julio,Federación de Rusia,0,2,,2,POINT (4815189 -75736374)
2016,Julio,Federación de Rusia,1,0,,1,POINT (7128047 -73181317)
2016,Julio,República Dominicana,0,12,,12,POINT (10406342 -75527794)
2016,Julio,República Dominicana,3,5,,8,POINT (10446304 -75516486)
2016,Julio,República Dominicana,17,23,,40,POINT (10886686 -74776479)
2016,Julio,República Dominicana,3,10,,13,POINT (125862 -81702165)
2016,Julio,República Dominicana,17,24,,41,POINT (3451668 -76532004)
2016,Julio,República Dominicana,714,962,,1676,POINT (4697157 -74140516)
2016,Julio,República Dominicana,3,15,,18,POINT (4815189 -75736374)
2016,Julio,República Dominicana,86,88,,174,POINT (6170465 -7542726)
2016,Julio,República Dominicana,4,4,,8,POINT (7128047 -73181317)
2016,Julio,República Dominicana,4,5,,9,POINT (7927233 -72508188)
2016,Julio,Rumania,0,1,,1,POINT (10446304 -75516486)
2016,Julio,Rumania,1,0,,1,POINT (3451668 -76532004)
2016,Julio,Rumania,5,10,,15,POINT (4697157 -74140516)
2016,Julio,Rumania,0,1,,1,POINT (6170465 -7542726)
2016,Julio,Rwanda,1,0,,1,POINT (4697157 -74140516)
2016,Julio,San Cristóbal y Nevis,2,0,,2,POINT (4697157 -74140516)
2016,Julio,Santa Lucia,1,1,,2,POINT (3451668 -76532004)
2016,Julio,Santa Sede/Ciudad del Vaticano,0,1,,1,POINT (4697157 -74140516)
2016,Julio,Senegal,1,1,,2,POINT (4697157 -74140516)
2016,Julio,Serbia,2,1,,3,POINT (4697157 -74140516)
2016,Julio,Singapur,5,4,,9,POINT (4697157 -74140516)
2016,Julio,Singapur,0,1,,1,POINT (6170465 -7542726)
2016,Julio,Sri Lanka,0,1,,1,POINT (4697157 -74140516)
2016,Julio,Sudáfrica,0,2,,2,POINT (3451668 -76532004)
2016,Julio,Sudáfrica,4,7,,11,POINT (4697157 -74140516)
2016,Julio,Sudáfrica,1,0,,1,POINT (6170465 -7542726)
2016,Julio,Suecia,0,1,,1,POINT (10446304 -75516486)
2016,Julio,Suecia,0,1,,1,POINT (10886686 -74776479)
2016,Julio,Suecia,3,6,,9,POINT (3451668 -76532004)
2016,Julio,Suecia,9,26,,35,POINT (4697157 -74140516)
2016,Julio,Suecia,1,0,,1,POINT (4815189 -75736374)
2016,Julio,Suecia,8,11,,19,POINT (6170465 -7542726)
2016,Julio,Suecia,0,3,,3,POINT (7128047 -73181317)
2016,Julio,Suiza,1,2,,3,POINT (10886686 -74776479)
2016,Julio,Suiza,2,2,,4,POINT (125862 -81702165)
2016,Julio,Suiza,32,44,,76,POINT (3451668 -76532004)
2016,Julio,Suiza,175,203,,378,POINT (4697157 -74140516)
2016,Julio,Suiza,0,1,,1,POINT (4815189 -75736374)
2016,Julio,Suiza,36,51,,87,POINT (6170465 -7542726)
2016,Julio,Surinam,0,15,,15,POINT (10406342 -75527794)
2016,Julio,Surinam,0,1,,1,POINT (10886686 -74776479)
2016,Julio,Surinam,1,2,,3,POINT (4697157 -74140516)
2016,Julio,Surinam,1,1,,2,POINT (6170465 -7542726)
2016,Julio,Tailandia,4,2,,6,POINT (4697157 -74140516)
2016,Julio,Tailandia,1,2,,3,POINT (6170465 -7542726)
2016,Julio,Trinidad y Tobago,0,7,,7,POINT (10406342 -75527794)
2016,Julio,Trinidad y Tobago,0,1,,1,POINT (10886686 -74776479)
2016,Julio,Trinidad y Tobago,3,8,,11,POINT (3451668 -76532004)
2016,Julio,Trinidad y Tobago,13,5,,18,POINT (4697157 -74140516)
2016,Julio,Trinidad y Tobago,1,0,,1,POINT (4815189 -75736374)
2016,Julio,Trinidad y Tobago,1,10,,11,POINT (6170465 -7542726)
2016,Julio,Trinidad y Tobago,3,4,,7,POINT (7128047 -73181317)
2016,Julio,Trinidad y Tobago,1,0,,1,POINT (7927233 -72508188)
2016,Julio,Túnez,2,2,,4,POINT (4697157 -74140516)
2016,Julio,Turkmenistán,6,3,,9,POINT (4697157 -74140516)
2016,Julio,Turquía,0,8,,8,POINT (10970933 -74765343)
2016,Julio,Turquía,1,0,,1,POINT (3451668 -76532004)
2016,Julio,Turquía,452,594,,1046,POINT (4697157 -74140516)
2016,Julio,Turquía,0,1,,1,POINT (6170465 -7542726)
2016,Julio,Ucrania,0,1,,1,POINT (10886686 -74776479)
2016,Julio,Ucrania,1,0,,1,POINT (6170465 -7542726)
2016,Julio,Uruguay,1,6,,7,POINT (10446304 -75516486)
2016,Julio,Uruguay,0,3,,3,POINT (10886686 -74776479)
2016,Julio,Uruguay,20,12,,32,POINT (125862 -81702165)
2016,Julio,Uruguay,6,10,,16,POINT (3451668 -76532004)
2016,Julio,Uruguay,63,107,,170,POINT (4697157 -74140516)
2016,Julio,Uruguay,3,0,,3,POINT (4815189 -75736374)
2016,Julio,Uruguay,44,38,,82,POINT (6170465 -7542726)
2016,Julio,Vanuatu,0,1,,1,POINT (4697157 -74140516)
2016,Julio,Venezuela,0,1,,1,POINT (10406342 -75527794)
2016,Julio,Venezuela,29,40,,69,POINT (10446304 -75516486)
2016,Julio,Venezuela,18,51,,69,POINT (10886686 -74776479)
2016,Julio,Venezuela,1,10,,11,POINT (11117206 -74232675)
2016,Julio,Venezuela,0,1,,1,POINT (11247723 -74213989)
2016,Julio,Venezuela,2209,2843,,5052,POINT (11360029 -72129595)
2016,Julio,Venezuela,2,4,,6,POINT (125862 -81702165)
2016,Julio,Venezuela,8,25,,33,POINT (3451668 -76532004)
2016,Julio,Venezuela,9,23,,32,POINT (3866713 -67927521)
2016,Julio,Venezuela,4487,4615,,9102,POINT (4697157 -74140516)
2016,Julio,Venezuela,1,3,,4,POINT (4815189 -75736374)
2016,Julio,Venezuela,963,959,,1922,POINT (6170465 -7542726)
2016,Julio,Venezuela,31,43,,74,POINT (6185536 -67484028)
2016,Julio,Venezuela,44,45,,89,POINT (7088729 -70740253)
2016,Julio,Venezuela,5,3,,8,POINT (7128047 -73181317)
2016,Julio,Venezuela,2517,3113,,5630,POINT (7819 -72453013)
2016,Julio,Venezuela,263,288,,551,POINT (7927233 -72508188)
2016,Julio,Venezuela,18,22,,40,POINT (836068 -72409396)
2016,Julio,Vietnam,0,3,,3,POINT (4697157 -74140516)
2016,Julio,Vietnam,0,1,,1,POINT (6170465 -7542726)
2016,Julio,Islas Vírgenes Británicas/Territorio Británico de Ultramar,2,0,,2,POINT (4697157 -74140516)
2016,Julio,Islas Vírgenes Británicas/Territorio Británico de Ultramar,0,1,,1,POINT (6170465 -7542726)
2016,Julio,República Árabe de Yemen,0,1,,1,POINT (4697157 -74140516)
2016,Julio,Zimbabue,0,1,,1,POINT (4697157 -74140516)
2016,Agosto,Afganistán,0,1,,1,POINT (6170465 -7542726)
2016,Agosto,Albania,1,0,,1,POINT (3451668 -76532004)
2016,Agosto,Albania,2,1,,3,POINT (4697157 -74140516)
2016,Agosto,Albania,0,1,,1,POINT (6170465 -7542726)
2016,Agosto,Alemania,0,3,,3,POINT (10406342 -75527794)
2016,Agosto,Alemania,2,2,,4,POINT (10446304 -75516486)
2016,Agosto,Alemania,7,10,,17,POINT (10886686 -74776479)
2016,Agosto,Alemania,0,1,,1,POINT (11247723 -74213989)
2016,Agosto,Alemania,31,39,,70,POINT (3451668 -76532004)
2016,Agosto,Alemania,1631,2188,,3819,POINT (4697157 -74140516)
2016,Agosto,Alemania,0,6,,6,POINT (4815189 -75736374)
2016,Agosto,Alemania,49,60,,109,POINT (6170465 -7542726)
2016,Agosto,Alemania,0,1,,1,POINT (7128047 -73181317)
2016,Agosto,Andorra,0,1,,1,POINT (3451668 -76532004)
2016,Agosto,Andorra,0,1,,1,POINT (6170465 -7542726)
2016,Agosto,Angola,0,1,,1,POINT (4697157 -74140516)
2016,Agosto,Antigua y Barbuda,0,1,,1,POINT (10406342 -75527794)
2016,Agosto,Antigua y Barbuda,0,3,,3,POINT (4697157 -74140516)
2016,Agosto,Antigua y Barbuda,0,1,,1,POINT (6170465 -7542726)
2016,Agosto,Países Bajos,0,8,,8,POINT (10406342 -75527794)
2016,Agosto,Países Bajos,2,4,,6,POINT (10446304 -75516486)
2016,Agosto,Países Bajos,80,108,,188,POINT (10886686 -74776479)
2016,Agosto,Países Bajos,2,4,,6,POINT (11247723 -74213989)
2016,Agosto,Países Bajos,83,148,,231,POINT (3451668 -76532004)
2016,Agosto,Países Bajos,734,988,,1722,POINT (4697157 -74140516)
2016,Agosto,Países Bajos,1,3,,4,POINT (4815189 -75736374)
2016,Agosto,Países Bajos,235,282,,517,POINT (6170465 -7542726)
2016,Agosto,Países Bajos,1,2,,3,POINT (7128047 -73181317)
2016,Agosto,Arabia Saudita,0,2,,2,POINT (4697157 -74140516)
2016,Agosto,Argelia,0,1,,1,POINT (3451668 -76532004)
2016,Agosto,Argelia,7,3,,10,POINT (4697157 -74140516)
2016,Agosto,Argelia,0,1,,1,POINT (6170465 -7542726)
2016,Agosto,Argentina,13,7,,20,POINT (0.81488 -77356)
2016,Agosto,Argentina,0,1,,1,POINT (10406342 -75527794)
2016,Agosto,Argentina,35,22,,57,POINT (10446304 -75516486)
2016,Agosto,Argentina,9,10,,19,POINT (10886686 -74776479)
2016,Agosto,Argentina,194,131,,325,POINT (125862 -81702165)
2016,Agosto,Argentina,73,76,,149,POINT (3451668 -76532004)
2016,Agosto,Argentina,2603,3989,,6592,POINT (4697157 -74140516)
2016,Agosto,Argentina,0,4,,4,POINT (4815189 -75736374)
2016,Agosto,Argentina,72,147,,219,POINT (6170465 -7542726)
2016,Agosto,Argentina,2,1,,3,POINT (7128047 -73181317)
2016,Agosto,República de Armenia,1,0,,1,POINT (4697157 -74140516)
2016,Agosto,Aruba,1,17,,18,POINT (10406342 -75527794)
2016,Agosto,Aruba,4,6,,10,POINT (10886686 -74776479)
2016,Agosto,Aruba,3,7,,10,POINT (11247723 -74213989)
2016,Agosto,Aruba,11,12,,23,POINT (3451668 -76532004)
2016,Agosto,Aruba,651,785,,1436,POINT (4697157 -74140516)
2016,Agosto,Aruba,0,1,,1,POINT (4815189 -75736374)
2016,Agosto,Aruba,113,126,,239,POINT (6170465 -7542726)
2016,Agosto,Aruba,9,4,,13,POINT (7128047 -73181317)
2016,Agosto,Aruba,0,1,,1,POINT (7927233 -72508188)
2016,Agosto,Australia,1,1,,2,POINT (10446304 -75516486)
2016,Agosto,Australia,0,1,,1,POINT (10886686 -74776479)
2016,Agosto,Australia,0,2,,2,POINT (125862 -81702165)
2016,Agosto,Australia,0,1,,1,POINT (3451668 -76532004)
2016,Agosto,Australia,35,59,,94,POINT (4697157 -74140516)
2016,Agosto,Australia,0,1,,1,POINT (4815189 -75736374)
2016,Agosto,Australia,10,18,,28,POINT (6170465 -7542726)
2016,Agosto,Austria,2,1,,3,POINT (3451668 -76532004)
2016,Agosto,Austria,22,42,,64,POINT (4697157 -74140516)
2016,Agosto,Austria,1,2,,3,POINT (6170465 -7542726)
2016,Agosto,Azerbaiyán,0,2,,2,POINT (4697157 -74140516)
2016,Agosto,Bahamas,2,9,,11,POINT (10406342 -75527794)
2016,Agosto,Bahamas,0,2,,2,POINT (11247723 -74213989)
2016,Agosto,Bahamas,1,0,,1,POINT (3451668 -76532004)
2016,Agosto,Bahamas,3,6,,9,POINT (4697157 -74140516)
2016,Agosto,Bahamas,4,5,,9,POINT (6170465 -7542726)
2016,Agosto,Bahréin,1,0,,1,POINT (10446304 -75516486)
2016,Agosto,Bangladesh,0,1,,1,POINT (4697157 -74140516)
2016,Agosto,Barbados,42,53,,95,POINT (4697157 -74140516)
2016,Agosto,República de Belarús,3,1,,4,POINT (4697157 -74140516)
2016,Agosto,República de Belarús,1,0,,1,POINT (7819 -72453013)
2016,Agosto,República de Belarús,1,0,,1,POINT (836068 -72409396)
2016,Agosto,Bélgica,1,0,,1,POINT (10446304 -75516486)
2016,Agosto,Bélgica,5,8,,13,POINT (3451668 -76532004)
2016,Agosto,Bélgica,33,36,,69,POINT (4697157 -74140516)
2016,Agosto,Bélgica,7,11,,18,POINT (6170465 -7542726)
2016,Agosto,Belice,5,4,,9,POINT (4697157 -74140516)
2016,Agosto,Benín,1,3,,4,POINT (4697157 -74140516)
2016,Agosto,Bermudas/Territorio Británico de Ultramar,0,1,,1,POINT (4697157 -74140516)
2016,Agosto,Bolivia,0,1,,1,POINT (0.81488 -77356)
2016,Agosto,Bolivia,4,3,,7,POINT (10446304 -75516486)
2016,Agosto,Bolivia,19,7,,26,POINT (125862 -81702165)
2016,Agosto,Bolivia,12,22,,34,POINT (3451668 -76532004)
2016,Agosto,Bolivia,432,541,,973,POINT (4697157 -74140516)
2016,Agosto,Bolivia,1,1,,2,POINT (4815189 -75736374)
2016,Agosto,Bolivia,28,42,,70,POINT (6170465 -7542726)
2016,Agosto,Bolivia,0,1,,1,POINT (7128047 -73181317)
2016,Agosto,Brasil,129,178,,307,POINT (-4191162 -69941498)
2016,Agosto,Brasil,0,8,,8,POINT (10406342 -75527794)
2016,Agosto,Brasil,55,43,,98,POINT (10446304 -75516486)
2016,Agosto,Brasil,7,10,,17,POINT (10886686 -74776479)
2016,Agosto,Brasil,439,306,,745,POINT (125862 -81702165)
2016,Agosto,Brasil,24,62,,86,POINT (3451668 -76532004)
2016,Agosto,Brasil,0,6,,6,POINT (3866713 -67927521)
2016,Agosto,Brasil,4295,5875,,10170,POINT (4697157 -74140516)
2016,Agosto,Brasil,2,5,,7,POINT (4815189 -75736374)
2016,Agosto,Brasil,82,128,,210,POINT (6170465 -7542726)
2016,Agosto,Brasil,0,1,,1,POINT (7128047 -73181317)
2016,Agosto,Brasil,0,1,,1,POINT (7927233 -72508188)
2016,Agosto,Bulgaria,1,3,,4,POINT (4697157 -74140516)
2016,Agosto,Islas Caimán/Territorio Británico de Ultramar,9,9,,18,POINT (125862 -81702165)
2016,Agosto,Islas Caimán/Territorio Británico de Ultramar,1,2,,3,POINT (133387613 -81372937)
2016,Agosto,Camboya,1,0,,1,POINT (4697157 -74140516)
2016,Agosto,Camerún,1,1,,2,POINT (7088729 -70740253)
2016,Agosto,Canadá,13,20,,33,POINT (10446304 -75516486)
2016,Agosto,Canadá,3,9,,12,POINT (10886686 -74776479)
2016,Agosto,Canadá,0,1,,1,POINT (10970933 -74765343)
2016,Agosto,Canadá,0,2,,2,POINT (125862 -81702165)
2016,Agosto,Canadá,35,62,,97,POINT (3451668 -76532004)
2016,Agosto,Canadá,628,913,,1541,POINT (4697157 -74140516)
2016,Agosto,Canadá,8,16,,24,POINT (4815189 -75736374)
2016,Agosto,Canadá,74,143,,217,POINT (6170465 -7542726)
2016,Agosto,Canadá,4,5,,9,POINT (7128047 -73181317)
2016,Agosto,Canadá,1,0,,1,POINT (7927233 -72508188)
2016,Agosto,Chad,1,2,,3,POINT (4697157 -74140516)
2016,Agosto,España,0,1,,1,POINT (10406342 -75527794)
2016,Agosto,España,1,2,,3,POINT (10446304 -75516486)
2016,Agosto,España,4,24,,28,POINT (10886686 -74776479)
2016,Agosto,España,3,4,,7,POINT (125862 -81702165)
2016,Agosto,España,501,735,,1236,POINT (3451668 -76532004)
2016,Agosto,España,4331,6282,,10613,POINT (4697157 -74140516)
2016,Agosto,España,5,8,,13,POINT (4815189 -75736374)
2016,Agosto,España,322,502,,824,POINT (6170465 -7542726)
2016,Agosto,España,1,4,,5,POINT (7128047 -73181317)
2016,Agosto,España,0,1,,1,POINT (7927233 -72508188)
2016,Agosto,República Del Congo,1,0,,1,POINT (4697157 -74140516)
2016,Agosto,República de Corea,9,23,,32,POINT (4697157 -74140516)
2016,Agosto,República de Corea,1,5,,6,POINT (6170465 -7542726)
2016,Agosto,Islas Malvinas,0,2,,2,POINT (3451668 -76532004)
2016,Agosto,Costa de Marfil,0,1,,1,POINT (10446304 -75516486)
2016,Agosto,Costa de Marfil,0,1,,1,POINT (3451668 -76532004)
2016,Agosto,Costa de Marfil,2,2,,4,POINT (4697157 -74140516)
2016,Agosto,Costa Rica,0,3,,3,POINT (10406342 -75527794)
2016,Agosto,Costa Rica,12,18,,30,POINT (10446304 -75516486)
2016,Agosto,Costa Rica,9,10,,19,POINT (10886686 -74776479)
2016,Agosto,Costa Rica,0,1,,1,POINT (10970933 -74765343)
2016,Agosto,Costa Rica,0,1,,1,POINT (11247723 -74213989)
2016,Agosto,Costa Rica,98,69,,167,POINT (125862 -81702165)
2016,Agosto,Costa Rica,19,37,,56,POINT (3451668 -76532004)
2016,Agosto,Costa Rica,1059,1621,,2680,POINT (4697157 -74140516)
2016,Agosto,Costa Rica,7,11,,18,POINT (4815189 -75736374)
2016,Agosto,Costa Rica,96,166,,262,POINT (6170465 -7542726)
2016,Agosto,Costa Rica,6,4,,10,POINT (7128047 -73181317)
2016,Agosto,Croacia,1,3,,4,POINT (3451668 -76532004)
2016,Agosto,Croacia,1,4,,5,POINT (4697157 -74140516)
2016,Agosto,Croacia,0,1,,1,POINT (6170465 -7542726)
2016,Agosto,Cuba,2,4,,6,POINT (10446304 -75516486)
2016,Agosto,Cuba,1,10,,11,POINT (10886686 -74776479)
2016,Agosto,Cuba,2,2,,4,POINT (125862 -81702165)
2016,Agosto,Cuba,12,16,,28,POINT (3451668 -76532004)
2016,Agosto,Cuba,301,498,,799,POINT (4697157 -74140516)
2016,Agosto,Cuba,3,5,,8,POINT (4815189 -75736374)
2016,Agosto,Cuba,11,49,,60,POINT (6170465 -7542726)
2016,Agosto,Cuba,1,1,,2,POINT (7128047 -73181317)
2016,Agosto,Cuba,1,0,,1,POINT (7927233 -72508188)
2016,Agosto,Curazao,1,2,,3,POINT (4697157 -74140516)
2016,Agosto,Curazao,0,2,,2,POINT (6170465 -7542726)
2016,Agosto,República Checa,0,1,,1,POINT (3451668 -76532004)
2016,Agosto,República Checa,3,6,,9,POINT (4697157 -74140516)
2016,Agosto,República Checa,1,0,,1,POINT (6170465 -7542726)
2016,Agosto,Chile,3,6,,9,POINT (0.81488 -77356)
2016,Agosto,Chile,18,8,,26,POINT (10446304 -75516486)
2016,Agosto,Chile,0,1,,1,POINT (10886686 -74776479)
2016,Agosto,Chile,100,59,,159,POINT (125862 -81702165)
2016,Agosto,Chile,40,41,,81,POINT (3451668 -76532004)
2016,Agosto,Chile,5561,6806,,12367,POINT (4697157 -74140516)
2016,Agosto,Chile,3,9,,12,POINT (4815189 -75736374)
2016,Agosto,Chile,21,49,,70,POINT (6170465 -7542726)
2016,Agosto,Chile,0,1,,1,POINT (7128047 -73181317)
2016,Agosto,Chile,0,4,,4,POINT (7927233 -72508188)
2016,Agosto,China,5,7,,12,POINT (3451668 -76532004)
2016,Agosto,China,49,87,,136,POINT (4697157 -74140516)
2016,Agosto,China,1,7,,8,POINT (6170465 -7542726)
2016,Agosto,Dinamarca,1,0,,1,POINT (10446304 -75516486)
2016,Agosto,Dinamarca,1,3,,4,POINT (3451668 -76532004)
2016,Agosto,Dinamarca,9,10,,19,POINT (4697157 -74140516)
2016,Agosto,Dinamarca,3,2,,5,POINT (6170465 -7542726)
2016,Agosto,Dinamarca,0,1,,1,POINT (7128047 -73181317)
2016,Agosto,Dominica,0,1,,1,POINT (4697157 -74140516)
2016,Agosto,Ecuador,0,3,,3,POINT (0.185957 -7478366)
2016,Agosto,Ecuador,178,318,,496,POINT (0.33002 -76876446)
2016,Agosto,Ecuador,21,32,,53,POINT (0.812436 -77847006)
2016,Agosto,Ecuador,5454,6733,,12187,POINT (0.81488 -77356)
2016,Agosto,Ecuador,31,152,,183,POINT (1800143 -78802679)
2016,Agosto,Ecuador,0,2,,2,POINT (10406342 -75527794)
2016,Agosto,Ecuador,499,347,,846,POINT (10446304 -75516486)
2016,Agosto,Ecuador,2,1,,3,POINT (10886686 -74776479)
2016,Agosto,Ecuador,0,3,,3,POINT (10970933 -74765343)
2016,Agosto,Ecuador,19,15,,34,POINT (125862 -81702165)
2016,Agosto,Ecuador,517,581,,1098,POINT (3451668 -76532004)
2016,Agosto,Ecuador,1,1,,2,POINT (3884426 -77061029)
2016,Agosto,Ecuador,4209,5417,,9626,POINT (4697157 -74140516)
2016,Agosto,Ecuador,0,2,,2,POINT (4815189 -75736374)
2016,Agosto,Ecuador,18,61,,79,POINT (6170465 -7542726)
2016,Agosto,Ecuador,2,0,,2,POINT (7128047 -73181317)
2016,Agosto,Ecuador,1,1,,2,POINT (7927233 -72508188)
2016,Agosto,Egipto,1,11,,12,POINT (4697157 -74140516)
2016,Agosto,El Salvador,10,21,,31,POINT (10446304 -75516486)
2016,Agosto,El Salvador,31,29,,60,POINT (125862 -81702165)
2016,Agosto,El Salvador,121,168,,289,POINT (3451668 -76532004)
2016,Agosto,El Salvador,1104,1539,,2643,POINT (4697157 -74140516)
2016,Agosto,El Salvador,174,274,,448,POINT (6170465 -7542726)
2016,Agosto,El Salvador,0,1,,1,POINT (7927233 -72508188)
2016,Agosto,Emiratos Árabes,2,5,,7,POINT (4697157 -74140516)
2016,Agosto,Emiratos Árabes,0,1,,1,POINT (6170465 -7542726)
2016,Agosto,Emiratos Árabes,0,1,,1,POINT (7128047 -73181317)
2016,Agosto,Eslovaquia,2,1,,3,POINT (4697157 -74140516)
2016,Agosto,Eslovaquia,0,1,,1,POINT (6170465 -7542726)
2016,Agosto,Estados Unidos de América,1,23,,24,POINT (10406342 -75527794)
2016,Agosto,Estados Unidos de América,3681,4950,,8631,POINT (10446304 -75516486)
2016,Agosto,Estados Unidos de América,520,907,,1427,POINT (10886686 -74776479)
2016,Agosto,Estados Unidos de América,0,4,,4,POINT (10970933 -74765343)
2016,Agosto,Estados Unidos de América,0,3,,3,POINT (11117206 -74232675)
2016,Agosto,Estados Unidos de América,1,8,,9,POINT (11247723 -74213989)
2016,Agosto,Estados Unidos de América,22,29,,51,POINT (125862 -81702165)
2016,Agosto,Estados Unidos de América,1234,1627,,2861,POINT (3451668 -76532004)
2016,Agosto,Estados Unidos de América,193,253,,446,POINT (445285 -75766353)
2016,Agosto,Estados Unidos de América,9028,15232,,24260,POINT (4697157 -74140516)
2016,Agosto,Estados Unidos de América,192,234,,426,POINT (4815189 -75736374)
2016,Agosto,Estados Unidos de América,2975,6299,,9274,POINT (6170465 -7542726)
2016,Agosto,Estados Unidos de América,26,38,,64,POINT (7128047 -73181317)
2016,Agosto,Estados Unidos de América,33,36,,69,POINT (7927233 -72508188)
2016,Agosto,Estados Unidos de América,0,36,,36,POINT (9402597 -75681642)
2016,Agosto,Estonia,1,0,,1,POINT (4697157 -74140516)
2016,Agosto,Etiopia,0,1,,1,POINT (4697157 -74140516)
2016,Agosto,Filipinas,0,3,,3,POINT (10446304 -75516486)
2016,Agosto,Filipinas,0,6,,6,POINT (10886686 -74776479)
2016,Agosto,Filipinas,0,2,,2,POINT (3451668 -76532004)
2016,Agosto,Filipinas,4,11,,15,POINT (4697157 -74140516)
2016,Agosto,Filipinas,1,0,,1,POINT (6170465 -7542726)
2016,Agosto,Finlandia,3,7,,10,POINT (4697157 -74140516)
2016,Agosto,Finlandia,1,1,,2,POINT (6170465 -7542726)
2016,Agosto,Francia,1,3,,4,POINT (10446304 -75516486)
2016,Agosto,Francia,2,3,,5,POINT (10886686 -74776479)
2016,Agosto,Francia,42,56,,98,POINT (3451668 -76532004)
2016,Agosto,Francia,1524,2317,,3841,POINT (4697157 -74140516)
2016,Agosto,Francia,10,13,,23,POINT (4815189 -75736374)
2016,Agosto,Francia,37,51,,88,POINT (6170465 -7542726)
2016,Agosto,Francia,0,1,,1,POINT (7128047 -73181317)
2016,Agosto,Grecia,2,5,,7,POINT (4697157 -74140516)
2016,Agosto,Grecia,0,2,,2,POINT (6170465 -7542726)
2016,Agosto,Grecia,0,1,,1,POINT (7927233 -72508188)
2016,Agosto,Guatemala,0,1,,1,POINT (10406342 -75527794)
2016,Agosto,Guatemala,18,13,,31,POINT (10446304 -75516486)
2016,Agosto,Guatemala,0,7,,7,POINT (10886686 -74776479)
2016,Agosto,Guatemala,18,26,,44,POINT (125862 -81702165)
2016,Agosto,Guatemala,14,57,,71,POINT (3451668 -76532004)
2016,Agosto,Guatemala,409,689,,1098,POINT (4697157 -74140516)
2016,Agosto,Guatemala,2,3,,5,POINT (4815189 -75736374)
2016,Agosto,Guatemala,62,170,,232,POINT (6170465 -7542726)
2016,Agosto,Guatemala,7,3,,10,POINT (7128047 -73181317)
2016,Agosto,Guatemala,3,0,,3,POINT (7927233 -72508188)
2016,Agosto,Guyana,0,1,,1,POINT (11247723 -74213989)
2016,Agosto,Guyana,0,1,,1,POINT (3451668 -76532004)
2016,Agosto,Guyana,1,3,,4,POINT (4697157 -74140516)
2016,Agosto,Guyana,1,0,,1,POINT (6170465 -7542726)
2016,Agosto,Guyana,1,0,,1,POINT (7128047 -73181317)
2016,Agosto,Guinea Ecuatorial,1,0,,1,POINT (3451668 -76532004)
2016,Agosto,Guadalupe/Territorio Francés,1,0,,1,POINT (4697157 -74140516)
2016,Agosto,Guadalupe/Territorio Francés,0,1,,1,POINT (6170465 -7542726)
2016,Agosto,Guadalupe/Territorio Francés,1,0,,1,POINT (7128047 -73181317)
2016,Agosto,Guayana Francesa/Departamento de Ultramar Francés,1,1,,2,POINT (4697157 -74140516)
2016,Agosto,Haití,0,1,,1,POINT (10406342 -75527794)
2016,Agosto,Haití,1,1,,2,POINT (6170465 -7542726)
2016,Agosto,Honduras,1,1,,2,POINT (10446304 -75516486)
2016,Agosto,Honduras,3,2,,5,POINT (10886686 -74776479)
2016,Agosto,Honduras,0,37,,37,POINT (125744111 -81703935)
2016,Agosto,Honduras,1,2,,3,POINT (125862 -81702165)
2016,Agosto,Honduras,7,11,,18,POINT (3451668 -76532004)
2016,Agosto,Honduras,62,111,,173,POINT (4697157 -74140516)
2016,Agosto,Honduras,1,2,,3,POINT (4815189 -75736374)
2016,Agosto,Honduras,44,53,,97,POINT (6170465 -7542726)
2016,Agosto,Honduras,1,0,,1,POINT (7128047 -73181317)
2016,Agosto,Honduras,0,1,,1,POINT (7927233 -72508188)
2016,Agosto,Hong Kong,2,8,,10,POINT (4697157 -74140516)
2016,Agosto,Hong Kong,0,1,,1,POINT (6170465 -7542726)
2016,Agosto,Hungría,5,3,,8,POINT (4697157 -74140516)
2016,Agosto,India,0,1,,1,POINT (3451668 -76532004)
2016,Agosto,India,5,45,,50,POINT (4697157 -74140516)
2016,Agosto,India,0,7,,7,POINT (6170465 -7542726)
2016,Agosto,India,1,2,,3,POINT (7128047 -73181317)
2016,Agosto,Indonesia,0,1,,1,POINT (10886686 -74776479)
2016,Agosto,Indonesia,2,3,,5,POINT (4697157 -74140516)
2016,Agosto,Irán,0,3,,3,POINT (4697157 -74140516)
2016,Agosto,República de Irlanda,0,1,,1,POINT (10446304 -75516486)
2016,Agosto,República de Irlanda,3,12,,15,POINT (4697157 -74140516)
2016,Agosto,República de Irlanda,0,4,,4,POINT (6170465 -7542726)
2016,Agosto,Israel,0,2,,2,POINT (10446304 -75516486)
2016,Agosto,Israel,0,3,,3,POINT (125862 -81702165)
2016,Agosto,Israel,7,3,,10,POINT (3451668 -76532004)
2016,Agosto,Israel,34,79,,113,POINT (4697157 -74140516)
2016,Agosto,Israel,3,11,,14,POINT (6170465 -7542726)
2016,Agosto,Italia,2,2,,4,POINT (10446304 -75516486)
2016,Agosto,Italia,0,1,,1,POINT (10886686 -74776479)
2016,Agosto,Italia,3,3,,6,POINT (125862 -81702165)
2016,Agosto,Italia,21,36,,57,POINT (3451668 -76532004)
2016,Agosto,Italia,201,341,,542,POINT (4697157 -74140516)
2016,Agosto,Italia,2,3,,5,POINT (4815189 -75736374)
2016,Agosto,Italia,22,46,,68,POINT (6170465 -7542726)
2016,Agosto,Italia,1,0,,1,POINT (7927233 -72508188)
2016,Agosto,Jamaica,2,9,,11,POINT (10406342 -75527794)
2016,Agosto,Jamaica,0,2,,2,POINT (10446304 -75516486)
2016,Agosto,Jamaica,0,1,,1,POINT (10886686 -74776479)
2016,Agosto,Jamaica,0,3,,3,POINT (10970933 -74765343)
2016,Agosto,Jamaica,0,7,,7,POINT (11247723 -74213989)
2016,Agosto,Jamaica,0,2,,2,POINT (125744111 -81703935)
2016,Agosto,Jamaica,1,0,,1,POINT (125862 -81702165)
2016,Agosto,Jamaica,1,0,,1,POINT (3451668 -76532004)
2016,Agosto,Jamaica,4,7,,11,POINT (4697157 -74140516)
2016,Agosto,Jamaica,8,6,,14,POINT (6170465 -7542726)
2016,Agosto,Japón,1,2,,3,POINT (3451668 -76532004)
2016,Agosto,Japón,11,27,,38,POINT (4697157 -74140516)
2016,Agosto,Japón,1,4,,5,POINT (6170465 -7542726)
2016,Agosto,Jordania,0,1,,1,POINT (4697157 -74140516)
2016,Agosto,Kenia,2,3,,5,POINT (3451668 -76532004)
2016,Agosto,Kenia,0,1,,1,POINT (4697157 -74140516)
2016,Agosto,Kenia,0,1,,1,POINT (6170465 -7542726)
2016,Agosto,Kuwait,0,1,,1,POINT (4697157 -74140516)
2016,Agosto,Letonia,0,1,,1,POINT (4697157 -74140516)
2016,Agosto,Lituania,3,4,,7,POINT (4697157 -74140516)
2016,Agosto,Líbano,5,6,,11,POINT (4697157 -74140516)
2016,Agosto,Luxemburgo,0,2,,2,POINT (3451668 -76532004)
2016,Agosto,Luxemburgo,4,6,,10,POINT (4697157 -74140516)
2016,Agosto,Luxemburgo,0,1,,1,POINT (6170465 -7542726)
2016,Agosto,Malasia,0,7,,7,POINT (4697157 -74140516)
2016,Agosto,Marruecos,4,4,,8,POINT (4697157 -74140516)
2016,Agosto,Marruecos,0,1,,1,POINT (6170465 -7542726)
2016,Agosto,Islas Marshall,0,1,,1,POINT (4697157 -74140516)
2016,Agosto,Mauricio,0,1,,1,POINT (6170465 -7542726)
2016,Agosto,Martinica/Departamento de Ultramar Francés,0,2,,2,POINT (10406342 -75527794)
2016,Agosto,Martinica/Departamento de Ultramar Francés,1,2,,3,POINT (3451668 -76532004)
2016,Agosto,Martinica/Departamento de Ultramar Francés,0,1,,1,POINT (4697157 -74140516)
2016,Agosto,México,1,1,,2,POINT (10406342 -75527794)
2016,Agosto,México,37,62,,99,POINT (10446304 -75516486)
2016,Agosto,México,9,22,,31,POINT (10886686 -74776479)
2016,Agosto,México,0,1,,1,POINT (11247723 -74213989)
2016,Agosto,México,3,6,,9,POINT (125862 -81702165)
2016,Agosto,México,41,161,,202,POINT (3451668 -76532004)
2016,Agosto,México,4985,8196,,13181,POINT (4697157 -74140516)
2016,Agosto,México,10,14,,24,POINT (4815189 -75736374)
2016,Agosto,México,580,1390,,1970,POINT (6170465 -7542726)
2016,Agosto,México,4,14,,18,POINT (7128047 -73181317)
2016,Agosto,México,5,7,,12,POINT (7927233 -72508188)
2016,Agosto,República de Moldavia,1,0,,1,POINT (4697157 -74140516)
2016,Agosto,Mozambique,2,0,,2,POINT (4697157 -74140516)
2016,Agosto,Nicaragua,4,2,,6,POINT (10446304 -75516486)
2016,Agosto,Nicaragua,1,1,,2,POINT (10886686 -74776479)
2016,Agosto,Nicaragua,13,20,,33,POINT (125744111 -81703935)
2016,Agosto,Nicaragua,6,11,,17,POINT (3451668 -76532004)
2016,Agosto,Nicaragua,38,55,,93,POINT (4697157 -74140516)
2016,Agosto,Nicaragua,0,6,,6,POINT (4815189 -75736374)
2016,Agosto,Nicaragua,8,8,,16,POINT (6170465 -7542726)
2016,Agosto,Nicaragua,0,4,,4,POINT (7128047 -73181317)
2016,Agosto,Nigeria,0,1,,1,POINT (3451668 -76532004)
2016,Agosto,Nigeria,0,1,,1,POINT (4697157 -74140516)
2016,Agosto,Níger,1,0,,1,POINT (4697157 -74140516)
2016,Agosto,Noruega,0,2,,2,POINT (10886686 -74776479)
2016,Agosto,Noruega,2,3,,5,POINT (3451668 -76532004)
2016,Agosto,Noruega,15,22,,37,POINT (4697157 -74140516)
2016,Agosto,Noruega,1,0,,1,POINT (4815189 -75736374)
2016,Agosto,Noruega,0,1,,1,POINT (6170465 -7542726)
2016,Agosto,Noruega,0,1,,1,POINT (7128047 -73181317)
2016,Agosto,Nueva Caledonia/Territorio francés,0,1,,1,POINT (6170465 -7542726)
2016,Agosto,Nueva Zelanda,3,7,,10,POINT (4697157 -74140516)
2016,Agosto,Nueva Zelanda,3,7,,10,POINT (6170465 -7542726)
2016,Agosto,Panamá,166,274,,440,POINT (10406342 -75527794)
2016,Agosto,Panamá,3048,3602,,6650,POINT (10446304 -75516486)
2016,Agosto,Panamá,314,582,,896,POINT (10886686 -74776479)
2016,Agosto,Panamá,0,76,,76,POINT (10970933 -74765343)
2016,Agosto,Panamá,1,0,,1,POINT (11247723 -74213989)
2016,Agosto,Panamá,1,2,,3,POINT (125744111 -81703935)
2016,Agosto,Panamá,229,220,,449,POINT (125862 -81702165)
2016,Agosto,Panamá,352,558,,910,POINT (3451668 -76532004)
2016,Agosto,Panamá,0,15,,15,POINT (3884426 -77061029)
2016,Agosto,Panamá,35,38,,73,POINT (445285 -75766353)
2016,Agosto,Panamá,4920,6744,,11664,POINT (4697157 -74140516)
2016,Agosto,Panamá,48,111,,159,POINT (4815189 -75736374)
2016,Agosto,Panamá,2390,3371,,5761,POINT (6170465 -7542726)
2016,Agosto,Panamá,7,15,,22,POINT (7102626 -77762647)
2016,Agosto,Panamá,22,31,,53,POINT (7128047 -73181317)
2016,Agosto,Panamá,26,41,,67,POINT (7927233 -72508188)
2016,Agosto,Panamá,0,1,,1,POINT (806667 -767333)
2016,Agosto,Panamá,99,120,,219,POINT (863337 -7735002)
2016,Agosto,Paraguay,8,9,,17,POINT (10446304 -75516486)
2016,Agosto,Paraguay,0,14,,14,POINT (10886686 -74776479)
2016,Agosto,Paraguay,64,36,,100,POINT (125862 -81702165)
2016,Agosto,Paraguay,20,11,,31,POINT (3451668 -76532004)
2016,Agosto,Paraguay,34,46,,80,POINT (4697157 -74140516)
2016,Agosto,Paraguay,0,1,,1,POINT (4815189 -75736374)
2016,Agosto,Paraguay,12,43,,55,POINT (6170465 -7542726)
2016,Agosto,Paraguay,1,0,,1,POINT (7128047 -73181317)
2016,Agosto,Paraguay,2,1,,3,POINT (7927233 -72508188)
2016,Agosto,Perú,88,167,,255,POINT (-4191162 -69941498)
2016,Agosto,Perú,10,22,,32,POINT (0.81488 -77356)
2016,Agosto,Perú,10,12,,22,POINT (10446304 -75516486)
2016,Agosto,Perú,177,107,,284,POINT (125862 -81702165)
2016,Agosto,Perú,312,475,,787,POINT (3451668 -76532004)
2016,Agosto,Perú,6447,8179,,14626,POINT (4697157 -74140516)
2016,Agosto,Perú,0,1,,1,POINT (4815189 -75736374)
2016,Agosto,Perú,540,910,,1450,POINT (6170465 -7542726)
2016,Agosto,Perú,2,1,,3,POINT (7128047 -73181317)
2016,Agosto,Perú,0,3,,3,POINT (7927233 -72508188)
2016,Agosto,Polonia,0,2,,2,POINT (3451668 -76532004)
2016,Agosto,Polonia,16,21,,37,POINT (4697157 -74140516)
2016,Agosto,Polonia,1,0,,1,POINT (6170465 -7542726)
2016,Agosto,Portugal,0,1,,1,POINT (10886686 -74776479)
2016,Agosto,Portugal,1,1,,2,POINT (125862 -81702165)
2016,Agosto,Portugal,1,6,,7,POINT (3451668 -76532004)
2016,Agosto,Portugal,45,73,,118,POINT (4697157 -74140516)
2016,Agosto,Portugal,3,7,,10,POINT (6170465 -7542726)
2016,Agosto,Puerto Rico/Territorio de Estados Unidos,0,3,,3,POINT (10406342 -75527794)
2016,Agosto,Puerto Rico/Territorio de Estados Unidos,1,3,,4,POINT (10446304 -75516486)
2016,Agosto,Puerto Rico/Territorio de Estados Unidos,7,38,,45,POINT (10886686 -74776479)
2016,Agosto,Puerto Rico/Territorio de Estados Unidos,3,6,,9,POINT (125862 -81702165)
2016,Agosto,Puerto Rico/Territorio de Estados Unidos,20,54,,74,POINT (3451668 -76532004)
2016,Agosto,Puerto Rico/Territorio de Estados Unidos,345,523,,868,POINT (4697157 -74140516)
2016,Agosto,Puerto Rico/Territorio de Estados Unidos,4,10,,14,POINT (4815189 -75736374)
2016,Agosto,Puerto Rico/Territorio de Estados Unidos,42,169,,211,POINT (6170465 -7542726)
2016,Agosto,Puerto Rico/Territorio de Estados Unidos,0,4,,4,POINT (7128047 -73181317)
2016,Agosto,Qatar,1,1,,2,POINT (4697157 -74140516)
2016,Agosto,Reino Unido de Gran Bretaña e Irlanda del Norte,4,1,,5,POINT (10446304 -75516486)
2016,Agosto,Reino Unido de Gran Bretaña e Irlanda del Norte,0,1,,1,POINT (10886686 -74776479)
2016,Agosto,Reino Unido de Gran Bretaña e Irlanda del Norte,1,1,,2,POINT (125862 -81702165)
2016,Agosto,Reino Unido de Gran Bretaña e Irlanda del Norte,17,23,,40,POINT (3451668 -76532004)
2016,Agosto,Reino Unido de Gran Bretaña e Irlanda del Norte,637,964,,1601,POINT (4697157 -74140516)
2016,Agosto,Reino Unido de Gran Bretaña e Irlanda del Norte,0,1,,1,POINT (4815189 -75736374)
2016,Agosto,Reino Unido de Gran Bretaña e Irlanda del Norte,32,39,,71,POINT (6170465 -7542726)
2016,Agosto,República CentroÁfricana,2,2,,4,POINT (4697157 -74140516)
2016,Agosto,Federación de Rusia,1,0,,1,POINT (3451668 -76532004)
2016,Agosto,Federación de Rusia,18,23,,41,POINT (4697157 -74140516)
2016,Agosto,Federación de Rusia,1,0,,1,POINT (6170465 -7542726)
2016,Agosto,República Dominicana,1,3,,4,POINT (10406342 -75527794)
2016,Agosto,República Dominicana,7,10,,17,POINT (10446304 -75516486)
2016,Agosto,República Dominicana,9,22,,31,POINT (10886686 -74776479)
2016,Agosto,República Dominicana,0,1,,1,POINT (10970933 -74765343)
2016,Agosto,República Dominicana,1,1,,2,POINT (125862 -81702165)
2016,Agosto,República Dominicana,26,48,,74,POINT (3451668 -76532004)
2016,Agosto,República Dominicana,794,951,,1745,POINT (4697157 -74140516)
2016,Agosto,República Dominicana,7,17,,24,POINT (4815189 -75736374)
2016,Agosto,República Dominicana,72,170,,242,POINT (6170465 -7542726)
2016,Agosto,República Dominicana,0,6,,6,POINT (7128047 -73181317)
2016,Agosto,República Dominicana,4,6,,10,POINT (7927233 -72508188)
2016,Agosto,Reunión,0,1,,1,POINT (4697157 -74140516)
2016,Agosto,Rumania,2,1,,3,POINT (3451668 -76532004)
2016,Agosto,Rumania,2,1,,3,POINT (4697157 -74140516)
2016,Agosto,Rumania,1,1,,2,POINT (6170465 -7542726)
2016,Agosto,San Cristóbal y Nevis,0,1,,1,POINT (4697157 -74140516)
2016,Agosto,San Cristóbal y Nevis,1,0,,1,POINT (6170465 -7542726)
2016,Agosto,Senegal,3,0,,3,POINT (4697157 -74140516)
2016,Agosto,Serbia,0,1,,1,POINT (4697157 -74140516)
2016,Agosto,Serbia,1,1,,2,POINT (6170465 -7542726)
2016,Agosto,Singapur,2,7,,9,POINT (4697157 -74140516)
2016,Agosto,Singapur,1,1,,2,POINT (6170465 -7542726)
2016,Agosto,Sudáfrica,7,6,,13,POINT (4697157 -74140516)
2016,Agosto,Suecia,0,1,,1,POINT (10886686 -74776479)
2016,Agosto,Suecia,3,5,,8,POINT (3451668 -76532004)
2016,Agosto,Suecia,14,20,,34,POINT (4697157 -74140516)
2016,Agosto,Suecia,0,1,,1,POINT (4815189 -75736374)
2016,Agosto,Suecia,3,3,,6,POINT (6170465 -7542726)
2016,Agosto,Suiza,1,1,,2,POINT (10446304 -75516486)
2016,Agosto,Suiza,0,1,,1,POINT (10886686 -74776479)
2016,Agosto,Suiza,1,0,,1,POINT (125862 -81702165)
2016,Agosto,Suiza,13,14,,27,POINT (3451668 -76532004)
2016,Agosto,Suiza,61,75,,136,POINT (4697157 -74140516)
2016,Agosto,Suiza,10,13,,23,POINT (6170465 -7542726)
2016,Agosto,Surinam,1,8,,9,POINT (4697157 -74140516)
2016,Agosto,Surinam,12,6,,18,POINT (6170465 -7542726)
2016,Agosto,Taiwán,0,1,,1,POINT (10446304 -75516486)
2016,Agosto,Taiwán,0,1,,1,POINT (3451668 -76532004)
2016,Agosto,Taiwán,1,2,,3,POINT (4697157 -74140516)
2016,Agosto,Tailandia,0,1,,1,POINT (3451668 -76532004)
2016,Agosto,Tailandia,1,6,,7,POINT (4697157 -74140516)
2016,Agosto,Tanzania,2,2,,4,POINT (4815189 -75736374)
2016,Agosto,Trinidad y Tobago,0,1,,1,POINT (10406342 -75527794)
2016,Agosto,Trinidad y Tobago,1,0,,1,POINT (10886686 -74776479)
2016,Agosto,Trinidad y Tobago,5,5,,10,POINT (3451668 -76532004)
2016,Agosto,Trinidad y Tobago,8,15,,23,POINT (4697157 -74140516)
2016,Agosto,Trinidad y Tobago,3,16,,19,POINT (6170465 -7542726)
2016,Agosto,Trinidad y Tobago,0,2,,2,POINT (7128047 -73181317)
2016,Agosto,Trinidad y Tobago,3,2,,5,POINT (7927233 -72508188)
2016,Agosto,Túnez,2,0,,2,POINT (4697157 -74140516)
2016,Agosto,Turkmenistán,5,7,,12,POINT (4697157 -74140516)
2016,Agosto,Turquía,359,475,,834,POINT (4697157 -74140516)
2016,Agosto,Turquía,1,1,,2,POINT (6170465 -7542726)
2016,Agosto,Ucrania,3,4,,7,POINT (4697157 -74140516)
2016,Agosto,Ucrania,0,1,,1,POINT (6170465 -7542726)
2016,Agosto,Uruguay,0,1,,1,POINT (0.81488 -77356)
2016,Agosto,Uruguay,7,3,,10,POINT (10446304 -75516486)
2016,Agosto,Uruguay,33,25,,58,POINT (125862 -81702165)
2016,Agosto,Uruguay,9,21,,30,POINT (3451668 -76532004)
2016,Agosto,Uruguay,97,130,,227,POINT (4697157 -74140516)
2016,Agosto,Uruguay,1,1,,2,POINT (4815189 -75736374)
2016,Agosto,Uruguay,40,51,,91,POINT (6170465 -7542726)
2016,Agosto,Uruguay,0,1,,1,POINT (7128047 -73181317)
2016,Agosto,Uruguay,0,2,,2,POINT (7927233 -72508188)
2016,Agosto,Vanuatu,1,0,,1,POINT (11360029 -72129595)
2016,Agosto,Venezuela,0,11,,11,POINT (10406342 -75527794)
2016,Agosto,Venezuela,5,6,,11,POINT (10446304 -75516486)
2016,Agosto,Venezuela,46,156,,202,POINT (10886686 -74776479)
2016,Agosto,Venezuela,8298,8635,,16933,POINT (11360029 -72129595)
2016,Agosto,Venezuela,0,1,,1,POINT (125862 -81702165)
2016,Agosto,Venezuela,27,23,,50,POINT (3451668 -76532004)
2016,Agosto,Venezuela,14,15,,29,POINT (3866713 -67927521)
2016,Agosto,Venezuela,4337,4693,,9030,POINT (4697157 -74140516)
2016,Agosto,Venezuela,6,11,,17,POINT (4815189 -75736374)
2016,Agosto,Venezuela,828,912,,1740,POINT (6170465 -7542726)
2016,Agosto,Venezuela,1342,1695,,3037,POINT (6185536 -67484028)
2016,Agosto,Venezuela,5234,4834,,10068,POINT (7088729 -70740253)
2016,Agosto,Venezuela,10,8,,18,POINT (7128047 -73181317)
2016,Agosto,Venezuela,6171,7462,,13633,POINT (7819 -72453013)
2016,Agosto,Venezuela,0,2,,2,POINT (7927233 -72508188)
2016,Agosto,Venezuela,436,444,,880,POINT (836068 -72409396)
2016,Septiembre,Albania,0,1,,1,POINT (4697157 -74140516)
2016,Septiembre,Alemania,0,1,,1,POINT (10406342 -75527794)
2016,Septiembre,Alemania,1,3,,4,POINT (10446304 -75516486)
2016,Septiembre,Alemania,2,4,,6,POINT (10886686 -74776479)
2016,Septiembre,Alemania,3,0,,3,POINT (125862 -81702165)
2016,Septiembre,Alemania,61,52,,113,POINT (3451668 -76532004)
2016,Septiembre,Alemania,1198,2133,,3331,POINT (4697157 -74140516)
2016,Septiembre,Alemania,0,5,,5,POINT (4815189 -75736374)
2016,Septiembre,Alemania,16,34,,50,POINT (6170465 -7542726)
2016,Septiembre,Alemania,0,1,,1,POINT (7128047 -73181317)
2016,Septiembre,Alemania,0,1,,1,POINT (806667 -767333)
2016,Septiembre,Andorra,0,2,,2,POINT (4697157 -74140516)
2016,Septiembre,Angola,0,1,,1,POINT (3451668 -76532004)
2016,Septiembre,Angola,2,0,,2,POINT (4697157 -74140516)
2016,Septiembre,Angola,2,2,,4,POINT (4697157 -74140516)
2016,Septiembre,Angola,1,0,,1,POINT (6170465 -7542726)
2016,Septiembre,Países Bajos,1,1,,2,POINT (10446304 -75516486)
2016,Septiembre,Países Bajos,62,120,,182,POINT (10886686 -74776479)
2016,Septiembre,Países Bajos,2,10,,12,POINT (11247723 -74213989)
2016,Septiembre,Países Bajos,66,131,,197,POINT (3451668 -76532004)
2016,Septiembre,Países Bajos,682,990,,1672,POINT (4697157 -74140516)
2016,Septiembre,Países Bajos,0,3,,3,POINT (4815189 -75736374)
2016,Septiembre,Países Bajos,156,220,,376,POINT (6170465 -7542726)
2016,Septiembre,Países Bajos,4,1,,5,POINT (7128047 -73181317)
2016,Septiembre,Países Bajos,0,1,,1,POINT (806667 -767333)
2016,Septiembre,Arabia Saudita,1,0,,1,POINT (3451668 -76532004)
2016,Septiembre,Arabia Saudita,0,2,,2,POINT (4697157 -74140516)
2016,Septiembre,Arabia Saudita,1,1,,2,POINT (6170465 -7542726)
2016,Septiembre,Argelia,4,5,,9,POINT (4697157 -74140516)
2016,Septiembre,Argentina,7,4,,11,POINT (0.81488 -77356)
2016,Septiembre,Argentina,0,1,,1,POINT (10406342 -75527794)
2016,Septiembre,Argentina,37,36,,73,POINT (10446304 -75516486)
2016,Septiembre,Argentina,2,7,,9,POINT (10886686 -74776479)
2016,Septiembre,Argentina,132,99,,231,POINT (125862 -81702165)
2016,Septiembre,Argentina,54,93,,147,POINT (3451668 -76532004)
2016,Septiembre,Argentina,2226,3050,,5276,POINT (4697157 -74140516)
2016,Septiembre,Argentina,4,4,,8,POINT (4815189 -75736374)
2016,Septiembre,Argentina,75,163,,238,POINT (6170465 -7542726)
2016,Septiembre,Argentina,1,1,,2,POINT (7128047 -73181317)
2016,Septiembre,República de Armenia,0,1,,1,POINT (4697157 -74140516)
2016,Septiembre,Aruba,62,78,,140,POINT (10406342 -75527794)
2016,Septiembre,Aruba,10,10,,20,POINT (10886686 -74776479)
2016,Septiembre,Aruba,5,10,,15,POINT (11247723 -74213989)
2016,Septiembre,Aruba,3,8,,11,POINT (3451668 -76532004)
2016,Septiembre,Aruba,635,704,,1339,POINT (4697157 -74140516)
2016,Septiembre,Aruba,0,2,,2,POINT (4815189 -75736374)
2016,Septiembre,Aruba,87,82,,169,POINT (6170465 -7542726)
2016,Septiembre,Aruba,10,10,,20,POINT (7128047 -73181317)
2016,Septiembre,Australia,1,1,,2,POINT (10446304 -75516486)
2016,Septiembre,Australia,1,0,,1,POINT (125862 -81702165)
2016,Septiembre,Australia,2,4,,6,POINT (3451668 -76532004)
2016,Septiembre,Australia,37,37,,74,POINT (4697157 -74140516)
2016,Septiembre,Australia,12,11,,23,POINT (6170465 -7542726)
2016,Septiembre,Australia,2,1,,3,POINT (7128047 -73181317)
2016,Septiembre,Austria,1,0,,1,POINT (125862 -81702165)
2016,Septiembre,Austria,0,1,,1,POINT (3451668 -76532004)
2016,Septiembre,Austria,9,17,,26,POINT (4697157 -74140516)
2016,Septiembre,Austria,2,2,,4,POINT (6170465 -7542726)
2016,Septiembre,Azerbaiyán,0,1,,1,POINT (6170465 -7542726)
2016,Septiembre,Bahamas,0,4,,4,POINT (10446304 -75516486)
2016,Septiembre,Bahamas,0,2,,2,POINT (10886686 -74776479)
2016,Septiembre,Bahamas,2,1,,3,POINT (3451668 -76532004)
2016,Septiembre,Bahamas,3,3,,6,POINT (4697157 -74140516)
2016,Septiembre,Bahamas,2,3,,5,POINT (6170465 -7542726)
2016,Septiembre,Bahréin,0,2,,2,POINT (10446304 -75516486)
2016,Septiembre,Bahréin,2,1,,3,POINT (4697157 -74140516)
2016,Septiembre,Barbados,10,17,,27,POINT (4697157 -74140516)
2016,Septiembre,República de Belarús,2,0,,2,POINT (4697157 -74140516)
2016,Septiembre,República de Belarús,1,0,,1,POINT (7819 -72453013)
2016,Septiembre,Bélgica,3,9,,12,POINT (3451668 -76532004)
2016,Septiembre,Bélgica,27,54,,81,POINT (4697157 -74140516)
2016,Septiembre,Bélgica,5,11,,16,POINT (6170465 -7542726)
2016,Septiembre,Belice,1,3,,4,POINT (4697157 -74140516)
2016,Septiembre,Benín,0,1,,1,POINT (4697157 -74140516)
2016,Septiembre,Bermudas/Territorio Británico de Ultramar,1,0,,1,POINT (4697157 -74140516)
2016,Septiembre,Bolivia,11,13,,24,POINT (10446304 -75516486)
2016,Septiembre,Bolivia,1,7,,8,POINT (10886686 -74776479)
2016,Septiembre,Bolivia,13,17,,30,POINT (125862 -81702165)
2016,Septiembre,Bolivia,31,25,,56,POINT (3451668 -76532004)
2016,Septiembre,Bolivia,467,631,,1098,POINT (4697157 -74140516)
2016,Septiembre,Bolivia,0,1,,1,POINT (4815189 -75736374)
2016,Septiembre,Bolivia,37,73,,110,POINT (6170465 -7542726)
2016,Septiembre,Bosnia y Herzegovina,0,2,,2,POINT (4697157 -74140516)
2016,Septiembre,Brasil,190,200,,390,POINT (-4191162 -69941498)
2016,Septiembre,Brasil,0,1,,1,POINT (0.81488 -77356)
2016,Septiembre,Brasil,0,2,,2,POINT (10406342 -75527794)
2016,Septiembre,Brasil,98,64,,162,POINT (10446304 -75516486)
2016,Septiembre,Brasil,16,24,,40,POINT (10886686 -74776479)
2016,Septiembre,Brasil,368,271,,639,POINT (125862 -81702165)
2016,Septiembre,Brasil,102,115,,217,POINT (3451668 -76532004)
2016,Septiembre,Brasil,1,1,,2,POINT (3866713 -67927521)
2016,Septiembre,Brasil,5006,6291,,11297,POINT (4697157 -74140516)
2016,Septiembre,Brasil,3,1,,4,POINT (4815189 -75736374)
2016,Septiembre,Brasil,72,174,,246,POINT (6170465 -7542726)
2016,Septiembre,Brasil,1,1,,2,POINT (7927233 -72508188)
2016,Septiembre,Brunei Darussalam,0,1,,1,POINT (4697157 -74140516)
2016,Septiembre,Bulgaria,0,1,,1,POINT (3451668 -76532004)
2016,Septiembre,Bulgaria,1,3,,4,POINT (4697157 -74140516)
2016,Septiembre,Bulgaria,0,1,,1,POINT (6170465 -7542726)
2016,Septiembre,Islas Caimán/Territorio Británico de Ultramar,0,2,,2,POINT (125744111 -81703935)
2016,Septiembre,Islas Caimán/Territorio Británico de Ultramar,1,2,,3,POINT (125862 -81702165)
2016,Septiembre,Canadá,11,18,,29,POINT (10446304 -75516486)
2016,Septiembre,Canadá,1,6,,7,POINT (10886686 -74776479)
2016,Septiembre,Canadá,1,3,,4,POINT (125862 -81702165)
2016,Septiembre,Canadá,25,34,,59,POINT (3451668 -76532004)
2016,Septiembre,Canadá,490,856,,1346,POINT (4697157 -74140516)
2016,Septiembre,Canadá,1,3,,4,POINT (4815189 -75736374)
2016,Septiembre,Canadá,46,85,,131,POINT (6170465 -7542726)
2016,Septiembre,Canadá,1,2,,3,POINT (7128047 -73181317)
2016,Septiembre,Canadá,0,1,,1,POINT (7927233 -72508188)
2016,Septiembre,España,0,2,,2,POINT (10406342 -75527794)
2016,Septiembre,España,10,35,,45,POINT (10446304 -75516486)
2016,Septiembre,España,1,2,,3,POINT (10886686 -74776479)
2016,Septiembre,España,327,597,,924,POINT (3451668 -76532004)
2016,Septiembre,España,3353,5791,,9144,POINT (4697157 -74140516)
2016,Septiembre,España,6,8,,14,POINT (4815189 -75736374)
2016,Septiembre,España,242,481,,723,POINT (6170465 -7542726)
2016,Septiembre,España,0,1,,1,POINT (7128047 -73181317)
2016,Septiembre,República Democrática del Congo,1,1,,2,POINT (4697157 -74140516)
2016,Septiembre,República de Corea,9,24,,33,POINT (4697157 -74140516)
2016,Septiembre,República de Corea,1,3,,4,POINT (6170465 -7542726)
2016,Septiembre,Costa de Marfil,1,1,,2,POINT (3451668 -76532004)
2016,Septiembre,Costa de Marfil,6,3,,9,POINT (4697157 -74140516)
2016,Septiembre,Costa Rica,2,19,,21,POINT (10406342 -75527794)
2016,Septiembre,Costa Rica,11,12,,23,POINT (10446304 -75516486)
2016,Septiembre,Costa Rica,4,8,,12,POINT (10886686 -74776479)
2016,Septiembre,Costa Rica,1,5,,6,POINT (125744111 -81703935)
2016,Septiembre,Costa Rica,118,76,,194,POINT (125862 -81702165)
2016,Septiembre,Costa Rica,1,9,,10,POINT (133387613 -81372937)
2016,Septiembre,Costa Rica,19,33,,52,POINT (3451668 -76532004)
2016,Septiembre,Costa Rica,936,1445,,2381,POINT (4697157 -74140516)
2016,Septiembre,Costa Rica,4,2,,6,POINT (4815189 -75736374)
2016,Septiembre,Costa Rica,68,115,,183,POINT (6170465 -7542726)
2016,Septiembre,Costa Rica,2,8,,10,POINT (7128047 -73181317)
2016,Septiembre,Costa Rica,0,4,,4,POINT (806667 -767333)
2016,Septiembre,Croacia,2,6,,8,POINT (4697157 -74140516)
2016,Septiembre,Cuba,39,144,,183,POINT (10446304 -75516486)
2016,Septiembre,Cuba,14,10,,24,POINT (10886686 -74776479)
2016,Septiembre,Cuba,1,3,,4,POINT (125862 -81702165)
2016,Septiembre,Cuba,15,20,,35,POINT (3451668 -76532004)
2016,Septiembre,Cuba,250,450,,700,POINT (4697157 -74140516)
2016,Septiembre,Cuba,4,6,,10,POINT (4815189 -75736374)
2016,Septiembre,Cuba,19,28,,47,POINT (6170465 -7542726)
2016,Septiembre,Cuba,1,3,,4,POINT (7128047 -73181317)
2016,Septiembre,Cuba,0,1,,1,POINT (7927233 -72508188)
2016,Septiembre,Curazao,1,1,,2,POINT (4697157 -74140516)
2016,Septiembre,República Checa,0,1,,1,POINT (3451668 -76532004)
2016,Septiembre,República Checa,10,9,,19,POINT (4697157 -74140516)
2016,Septiembre,Chile,1,6,,7,POINT (0.81488 -77356)
2016,Septiembre,Chile,0,3,,3,POINT (10406342 -75527794)
2016,Septiembre,Chile,18,37,,55,POINT (10446304 -75516486)
2016,Septiembre,Chile,2,2,,4,POINT (10886686 -74776479)
2016,Septiembre,Chile,45,43,,88,POINT (125862 -81702165)
2016,Septiembre,Chile,34,44,,78,POINT (3451668 -76532004)
2016,Septiembre,Chile,0,2,,2,POINT (3884426 -77061029)
2016,Septiembre,Chile,4743,5869,,10612,POINT (4697157 -74140516)
2016,Septiembre,Chile,2,1,,3,POINT (4815189 -75736374)
2016,Septiembre,Chile,22,47,,69,POINT (6170465 -7542726)
2016,Septiembre,Chile,3,1,,4,POINT (7128047 -73181317)
2016,Septiembre,China,3,5,,8,POINT (3451668 -76532004)
2016,Septiembre,China,30,91,,121,POINT (4697157 -74140516)
2016,Septiembre,China,2,10,,12,POINT (6170465 -7542726)
2016,Septiembre,Dinamarca,1,2,,3,POINT (3451668 -76532004)
2016,Septiembre,Dinamarca,10,22,,32,POINT (4697157 -74140516)
2016,Septiembre,Dinamarca,1,5,,6,POINT (6170465 -7542726)
2016,Septiembre,Dominica,1,0,,1,POINT (3451668 -76532004)
2016,Septiembre,Dominica,0,1,,1,POINT (6170465 -7542726)
2016,Septiembre,Ecuador,0,3,,3,POINT (0.185957 -7478366)
2016,Septiembre,Ecuador,77,216,,293,POINT (0.33002 -76876446)
2016,Septiembre,Ecuador,2,2,,4,POINT (0.812436 -77847006)
2016,Septiembre,Ecuador,2846,4344,,7190,POINT (0.81488 -77356)
2016,Septiembre,Ecuador,45,131,,176,POINT (1800143 -78802679)
2016,Septiembre,Ecuador,0,1,,1,POINT (10406342 -75527794)
2016,Septiembre,Ecuador,64,59,,123,POINT (10446304 -75516486)
2016,Septiembre,Ecuador,3,16,,19,POINT (10886686 -74776479)
2016,Septiembre,Ecuador,8,10,,18,POINT (125862 -81702165)
2016,Septiembre,Ecuador,390,513,,903,POINT (3451668 -76532004)
2016,Septiembre,Ecuador,3111,4618,,7729,POINT (4697157 -74140516)
2016,Septiembre,Ecuador,32,68,,100,POINT (6170465 -7542726)
2016,Septiembre,Ecuador,2,2,,4,POINT (7128047 -73181317)
2016,Septiembre,Egipto,0,2,,2,POINT (3451668 -76532004)
2016,Septiembre,Egipto,1,8,,9,POINT (4697157 -74140516)
2016,Septiembre,Egipto,0,8,,8,POINT (6170465 -7542726)
2016,Septiembre,El Salvador,6,7,,13,POINT (10446304 -75516486)
2016,Septiembre,El Salvador,15,15,,30,POINT (125862 -81702165)
2016,Septiembre,El Salvador,115,177,,292,POINT (3451668 -76532004)
2016,Septiembre,El Salvador,1005,1512,,2517,POINT (4697157 -74140516)
2016,Septiembre,El Salvador,0,1,,1,POINT (4815189 -75736374)
2016,Septiembre,El Salvador,149,258,,407,POINT (6170465 -7542726)
2016,Septiembre,El Salvador,0,1,,1,POINT (7128047 -73181317)
2016,Septiembre,Emiratos Árabes,3,4,,7,POINT (4697157 -74140516)
2016,Septiembre,Eritrea,1,0,,1,POINT (4697157 -74140516)
2016,Septiembre,Eslovaquia,1,1,,2,POINT (4697157 -74140516)
2016,Septiembre,Eslovenia,3,2,,5,POINT (4697157 -74140516)
2016,Septiembre,Eslovenia,0,1,,1,POINT (6170465 -7542726)
2016,Septiembre,Estados Unidos de América,2,45,,47,POINT (10406342 -75527794)
2016,Septiembre,Estados Unidos de América,2509,4099,,6608,POINT (10446304 -75516486)
2016,Septiembre,Estados Unidos de América,337,736,,1073,POINT (10886686 -74776479)
2016,Septiembre,Estados Unidos de América,0,12,,12,POINT (10970933 -74765343)
2016,Septiembre,Estados Unidos de América,0,14,,14,POINT (11247723 -74213989)
2016,Septiembre,Estados Unidos de América,7,20,,27,POINT (125862 -81702165)
2016,Septiembre,Estados Unidos de América,693,1208,,1901,POINT (3451668 -76532004)
2016,Septiembre,Estados Unidos de América,0,14,,14,POINT (3884426 -77061029)
2016,Septiembre,Estados Unidos de América,153,197,,350,POINT (445285 -75766353)
2016,Septiembre,Estados Unidos de América,7052,13740,,20792,POINT (4697157 -74140516)
2016,Septiembre,Estados Unidos de América,52,94,,146,POINT (4815189 -75736374)
2016,Septiembre,Estados Unidos de América,1652,4471,,6123,POINT (6170465 -7542726)
2016,Septiembre,Estados Unidos de América,9,30,,39,POINT (7128047 -73181317)
2016,Septiembre,Estados Unidos de América,43,44,,87,POINT (7927233 -72508188)
2016,Septiembre,Estados Unidos de América,0,1,,1,POINT (806667 -767333)
2016,Septiembre,Estados Unidos de América,0,12,,12,POINT (9402597 -75681642)
2016,Septiembre,Estonia,4,1,,5,POINT (4697157 -74140516)
2016,Septiembre,Filipinas,0,3,,3,POINT (10886686 -74776479)
2016,Septiembre,Filipinas,0,15,,15,POINT (3451668 -76532004)
2016,Septiembre,Filipinas,2,6,,8,POINT (4697157 -74140516)
2016,Septiembre,Filipinas,1,1,,2,POINT (6170465 -7542726)
2016,Septiembre,Finlandia,3,4,,7,POINT (4697157 -74140516)
2016,Septiembre,Francia,1,0,,1,POINT (10406342 -75527794)
2016,Septiembre,Francia,0,2,,2,POINT (10446304 -75516486)
2016,Septiembre,Francia,24,38,,62,POINT (3451668 -76532004)
2016,Septiembre,Francia,0,1,,1,POINT (3884426 -77061029)
2016,Septiembre,Francia,1088,1929,,3017,POINT (4697157 -74140516)
2016,Septiembre,Francia,1,0,,1,POINT (4815189 -75736374)
2016,Septiembre,Francia,15,43,,58,POINT (6170465 -7542726)
2016,Septiembre,Septiembre,1,1,,2,POINT (4697157 -74140516)
2016,Septiembre,Granada,0,2,,2,POINT (10406342 -75527794)
2016,Septiembre,Granada,1,0,,1,POINT (3451668 -76532004)
2016,Septiembre,Grecia,0,1,,1,POINT (10886686 -74776479)
2016,Septiembre,Grecia,1,6,,7,POINT (4697157 -74140516)
2016,Septiembre,Grecia,0,2,,2,POINT (6170465 -7542726)
2016,Septiembre,Guatemala,17,25,,42,POINT (10446304 -75516486)
2016,Septiembre,Guatemala,4,4,,8,POINT (10886686 -74776479)
2016,Septiembre,Guatemala,0,1,,1,POINT (10970933 -74765343)
2016,Septiembre,Guatemala,14,19,,33,POINT (125862 -81702165)
2016,Septiembre,Guatemala,31,113,,144,POINT (3451668 -76532004)
2016,Septiembre,Guatemala,0,2,,2,POINT (3884426 -77061029)
2016,Septiembre,Guatemala,419,649,,1068,POINT (4697157 -74140516)
2016,Septiembre,Guatemala,0,3,,3,POINT (4815189 -75736374)
2016,Septiembre,Guatemala,37,120,,157,POINT (6170465 -7542726)
2016,Septiembre,Guatemala,2,0,,2,POINT (7927233 -72508188)
2016,Septiembre,Guyana,0,1,,1,POINT (10406342 -75527794)
2016,Septiembre,Guyana,1,3,,4,POINT (3451668 -76532004)
2016,Septiembre,Guyana,1,3,,4,POINT (4697157 -74140516)
2016,Septiembre,Guyana,0,1,,1,POINT (6170465 -7542726)
2016,Septiembre,Guyana,0,1,,1,POINT (7128047 -73181317)
2016,Septiembre,Guadalupe/Territorio Francés,0,1,,1,POINT (4697157 -74140516)
2016,Septiembre,Haití,0,1,,1,POINT (10406342 -75527794)
2016,Septiembre,Haití,1,4,,5,POINT (4697157 -74140516)
2016,Septiembre,Haití,0,3,,3,POINT (6170465 -7542726)
2016,Septiembre,Haití,0,1,,1,POINT (7128047 -73181317)
2016,Septiembre,Honduras,2,8,,10,POINT (10446304 -75516486)
2016,Septiembre,Honduras,2,1,,3,POINT (10886686 -74776479)
2016,Septiembre,Honduras,0,1,,1,POINT (125744111 -81703935)
2016,Septiembre,Honduras,1,2,,3,POINT (133387613 -81372937)
2016,Septiembre,Honduras,15,17,,32,POINT (3451668 -76532004)
2016,Septiembre,Honduras,98,115,,213,POINT (4697157 -74140516)
2016,Septiembre,Honduras,0,3,,3,POINT (4815189 -75736374)
2016,Septiembre,Honduras,26,28,,54,POINT (6170465 -7542726)
2016,Septiembre,Hong Kong,4,5,,9,POINT (4697157 -74140516)
2016,Septiembre,Hungría,0,3,,3,POINT (4697157 -74140516)
2016,Septiembre,India,0,2,,2,POINT (10446304 -75516486)
2016,Septiembre,India,0,1,,1,POINT (10886686 -74776479)
2016,Septiembre,India,0,2,,2,POINT (3451668 -76532004)
2016,Septiembre,India,7,36,,43,POINT (4697157 -74140516)
2016,Septiembre,India,0,2,,2,POINT (4815189 -75736374)
2016,Septiembre,India,2,6,,8,POINT (6170465 -7542726)
2016,Septiembre,India,0,1,,1,POINT (7128047 -73181317)
2016,Septiembre,Indonesia,1,4,,5,POINT (4697157 -74140516)
2016,Septiembre,Indonesia,0,1,,1,POINT (6170465 -7542726)
2016,Septiembre,Irán,1,10,,11,POINT (4697157 -74140516)
2016,Septiembre,República de Irlanda,0,1,,1,POINT (10446304 -75516486)
2016,Septiembre,República de Irlanda,4,1,,5,POINT (3451668 -76532004)
2016,Septiembre,República de Irlanda,13,14,,27,POINT (4697157 -74140516)
2016,Septiembre,República de Irlanda,0,3,,3,POINT (6170465 -7542726)
2016,Septiembre,Islandia,2,0,,2,POINT (4697157 -74140516)
2016,Septiembre,Israel,1,1,,2,POINT (3451668 -76532004)
2016,Septiembre,Israel,28,63,,91,POINT (4697157 -74140516)
2016,Septiembre,Israel,0,4,,4,POINT (6170465 -7542726)
2016,Septiembre,Italia,0,1,,1,POINT (10446304 -75516486)
2016,Septiembre,Italia,1,0,,1,POINT (125862 -81702165)
2016,Septiembre,Italia,16,69,,85,POINT (3451668 -76532004)
2016,Septiembre,Italia,69,223,,292,POINT (4697157 -74140516)
2016,Septiembre,Italia,11,32,,43,POINT (6170465 -7542726)
2016,Septiembre,Jamaica,3,27,,30,POINT (10406342 -75527794)
2016,Septiembre,Jamaica,1,5,,6,POINT (10446304 -75516486)
2016,Septiembre,Jamaica,0,1,,1,POINT (10886686 -74776479)
2016,Septiembre,Jamaica,3,12,,15,POINT (125862 -81702165)
2016,Septiembre,Jamaica,4,1,,5,POINT (3451668 -76532004)
2016,Septiembre,Jamaica,2,13,,15,POINT (4697157 -74140516)
2016,Septiembre,Jamaica,1,2,,3,POINT (6170465 -7542726)
2016,Septiembre,Jamaica,1,1,,2,POINT (7128047 -73181317)
2016,Septiembre,Japón,1,9,,10,POINT (3451668 -76532004)
2016,Septiembre,Japón,9,24,,33,POINT (4697157 -74140516)
2016,Septiembre,Japón,0,4,,4,POINT (6170465 -7542726)
2016,Septiembre,Kazajistán,0,6,,6,POINT (4697157 -74140516)
2016,Septiembre,Kenia,0,2,,2,POINT (6170465 -7542726)
2016,Septiembre,Kuwait,0,1,,1,POINT (3451668 -76532004)
2016,Septiembre,Letonia,1,0,,1,POINT (3451668 -76532004)
2016,Septiembre,Letonia,0,2,,2,POINT (4697157 -74140516)
2016,Septiembre,Lituania,1,2,,3,POINT (4697157 -74140516)
2016,Septiembre,Líbano,5,12,,17,POINT (4697157 -74140516)
2016,Septiembre,Liberia,0,1,,1,POINT (4697157 -74140516)
2016,Septiembre,Libia,0,1,,1,POINT (4697157 -74140516)
2016,Septiembre,Luxemburgo,2,4,,6,POINT (4697157 -74140516)
2016,Septiembre,Luxemburgo,0,1,,1,POINT (6170465 -7542726)
2016,Septiembre,Malasia,1,3,,4,POINT (10446304 -75516486)
2016,Septiembre,Malasia,1,3,,4,POINT (4697157 -74140516)
2016,Septiembre,Malasia,0,1,,1,POINT (6170465 -7542726)
2016,Septiembre,Malta,0,1,,1,POINT (4697157 -74140516)
2016,Septiembre,Marruecos,0,16,,16,POINT (4697157 -74140516)
2016,Septiembre,Marruecos,0,1,,1,POINT (6170465 -7542726)
2016,Septiembre,Mauricio,0,1,,1,POINT (4697157 -74140516)
2016,Septiembre,Martinica/Departamento de Ultramar Francés,0,1,,1,POINT (4697157 -74140516)
2016,Septiembre,México,3,24,,27,POINT (10406342 -75527794)
2016,Septiembre,México,56,114,,170,POINT (10446304 -75516486)
2016,Septiembre,México,8,14,,22,POINT (10886686 -74776479)
2016,Septiembre,México,9,8,,17,POINT (125862 -81702165)
2016,Septiembre,México,64,129,,193,POINT (3451668 -76532004)
2016,Septiembre,México,5371,9057,,14428,POINT (4697157 -74140516)
2016,Septiembre,México,7,12,,19,POINT (4815189 -75736374)
2016,Septiembre,México,481,1140,,1621,POINT (6170465 -7542726)
2016,Septiembre,México,6,20,,26,POINT (7128047 -73181317)
2016,Septiembre,México,8,5,,13,POINT (7927233 -72508188)
2016,Septiembre,República de Moldavia,1,0,,1,POINT (4697157 -74140516)
2016,Septiembre,Mozambique,0,12,,12,POINT (4697157 -74140516)
2016,Septiembre,Nauru,0,1,,1,POINT (6170465 -7542726)
2016,Septiembre,Nicaragua,0,4,,4,POINT (10446304 -75516486)
2016,Septiembre,Nicaragua,4,1,,5,POINT (10886686 -74776479)
2016,Septiembre,Nicaragua,0,12,,12,POINT (125744111 -81703935)
2016,Septiembre,Nicaragua,1,1,,2,POINT (125862 -81702165)
2016,Septiembre,Nicaragua,7,9,,16,POINT (3451668 -76532004)
2016,Septiembre,Nicaragua,35,33,,68,POINT (4697157 -74140516)
2016,Septiembre,Nicaragua,0,9,,9,POINT (4815189 -75736374)
2016,Septiembre,Nicaragua,7,19,,26,POINT (6170465 -7542726)
2016,Septiembre,Nicaragua,0,5,,5,POINT (7128047 -73181317)
2016,Septiembre,Noruega,0,1,,1,POINT (10886686 -74776479)
2016,Septiembre,Noruega,0,1,,1,POINT (3451668 -76532004)
2016,Septiembre,Noruega,12,8,,20,POINT (4697157 -74140516)
2016,Septiembre,Noruega,2,0,,2,POINT (6170465 -7542726)
2016,Septiembre,Nueva Zelanda,0,1,,1,POINT (3451668 -76532004)
2016,Septiembre,Nueva Zelanda,6,6,,12,POINT (4697157 -74140516)
2016,Septiembre,Nueva Zelanda,0,1,,1,POINT (7128047 -73181317)
2016,Septiembre,Papúa Nueva Guinea,1,0,,1,POINT (4697157 -74140516)
2016,Septiembre,Panamá,109,214,,323,POINT (10406342 -75527794)
2016,Septiembre,Panamá,3032,3500,,6532,POINT (10446304 -75516486)
2016,Septiembre,Panamá,189,508,,697,POINT (10886686 -74776479)
2016,Septiembre,Panamá,0,9,,9,POINT (10970933 -74765343)
2016,Septiembre,Panamá,0,1,,1,POINT (125744111 -81703935)
2016,Septiembre,Panamá,117,119,,236,POINT (125862 -81702165)
2016,Septiembre,Panamá,472,661,,1133,POINT (3451668 -76532004)
2016,Septiembre,Panamá,0,12,,12,POINT (3884426 -77061029)
2016,Septiembre,Panamá,64,79,,143,POINT (445285 -75766353)
2016,Septiembre,Panamá,5016,6649,,11665,POINT (4697157 -74140516)
2016,Septiembre,Panamá,46,87,,133,POINT (4815189 -75736374)
2016,Septiembre,Panamá,2355,2934,,5289,POINT (6170465 -7542726)
2016,Septiembre,Panamá,0,2,,2,POINT (7102626 -77762647)
2016,Septiembre,Panamá,22,38,,60,POINT (7128047 -73181317)
2016,Septiembre,Panamá,51,36,,87,POINT (7927233 -72508188)
2016,Septiembre,Panamá,69,86,,155,POINT (863337 -7735002)
2016,Septiembre,Paraguay,14,14,,28,POINT (10446304 -75516486)
2016,Septiembre,Paraguay,2,1,,3,POINT (10886686 -74776479)
2016,Septiembre,Paraguay,72,46,,118,POINT (125862 -81702165)
2016,Septiembre,Paraguay,13,34,,47,POINT (3451668 -76532004)
2016,Septiembre,Paraguay,67,79,,146,POINT (4697157 -74140516)
2016,Septiembre,Paraguay,24,59,,83,POINT (6170465 -7542726)
2016,Septiembre,Paraguay,0,2,,2,POINT (7927233 -72508188)
2016,Septiembre,Perú,67,121,,188,POINT (-4191162 -69941498)
2016,Septiembre,Perú,0,1,,1,POINT (0.185957 -7478366)
2016,Septiembre,Perú,4,13,,17,POINT (0.81488 -77356)
2016,Septiembre,Perú,0,2,,2,POINT (10406342 -75527794)
2016,Septiembre,Perú,15,27,,42,POINT (10446304 -75516486)
2016,Septiembre,Perú,0,3,,3,POINT (10886686 -74776479)
2016,Septiembre,Perú,0,1,,1,POINT (10970933 -74765343)
2016,Septiembre,Perú,0,1,,1,POINT (11247723 -74213989)
2016,Septiembre,Perú,91,64,,155,POINT (125862 -81702165)
2016,Septiembre,Perú,303,470,,773,POINT (3451668 -76532004)
2016,Septiembre,Perú,5864,7614,,13478,POINT (4697157 -74140516)
2016,Septiembre,Perú,7,6,,13,POINT (4815189 -75736374)
2016,Septiembre,Perú,501,785,,1286,POINT (6170465 -7542726)
2016,Septiembre,Perú,0,3,,3,POINT (7128047 -73181317)
2016,Septiembre,Perú,0,2,,2,POINT (7927233 -72508188)
2016,Septiembre,Palestina,1,0,,1,POINT (4697157 -74140516)
2016,Septiembre,Polonia,3,2,,5,POINT (3451668 -76532004)
2016,Septiembre,Polonia,8,17,,25,POINT (4697157 -74140516)
2016,Septiembre,Polonia,1,4,,5,POINT (6170465 -7542726)
2016,Septiembre,Portugal,1,7,,8,POINT (10446304 -75516486)
2016,Septiembre,Portugal,0,1,,1,POINT (10886686 -74776479)
2016,Septiembre,Portugal,1,25,,26,POINT (3451668 -76532004)
2016,Septiembre,Portugal,25,64,,89,POINT (4697157 -74140516)
2016,Septiembre,Portugal,1,9,,10,POINT (6170465 -7542726)
2016,Septiembre,Puerto Rico/Territorio de Estados Unidos,0,2,,2,POINT (10406342 -75527794)
2016,Septiembre,Puerto Rico/Territorio de Estados Unidos,2,9,,11,POINT (10446304 -75516486)
2016,Septiembre,Puerto Rico/Territorio de Estados Unidos,1,43,,44,POINT (10886686 -74776479)
2016,Septiembre,Puerto Rico/Territorio de Estados Unidos,24,29,,53,POINT (3451668 -76532004)
2016,Septiembre,Puerto Rico/Territorio de Estados Unidos,296,367,,663,POINT (4697157 -74140516)
2016,Septiembre,Puerto Rico/Territorio de Estados Unidos,3,5,,8,POINT (4815189 -75736374)
2016,Septiembre,Puerto Rico/Territorio de Estados Unidos,43,98,,141,POINT (6170465 -7542726)
2016,Septiembre,Puerto Rico/Territorio de Estados Unidos,1,2,,3,POINT (7128047 -73181317)
2016,Septiembre,Puerto Rico/Territorio de Estados Unidos,0,1,,1,POINT (7927233 -72508188)
2016,Septiembre,Qatar,2,0,,2,POINT (4697157 -74140516)
2016,Septiembre,Reino Unido de Gran Bretaña e Irlanda del Norte,0,1,,1,POINT (125862 -81702165)
2016,Septiembre,Reino Unido de Gran Bretaña e Irlanda del Norte,5,13,,18,POINT (3451668 -76532004)
2016,Septiembre,Reino Unido de Gran Bretaña e Irlanda del Norte,554,978,,1532,POINT (4697157 -74140516)
2016,Septiembre,Reino Unido de Gran Bretaña e Irlanda del Norte,7,25,,32,POINT (6170465 -7542726)
2016,Septiembre,Reino Unido de Gran Bretaña e Irlanda del Norte,2,2,,4,POINT (7128047 -73181317)
2016,Septiembre,República CentroÁfricana,0,1,,1,POINT (4697157 -74140516)
2016,Septiembre,Federación de Rusia,0,1,,1,POINT (3451668 -76532004)
2016,Septiembre,Federación de Rusia,22,33,,55,POINT (4697157 -74140516)
2016,Septiembre,Federación de Rusia,0,1,,1,POINT (4815189 -75736374)
2016,Septiembre,Federación de Rusia,2,6,,8,POINT (6170465 -7542726)
2016,Septiembre,Federación de Rusia,0,2,,2,POINT (806667 -767333)
2016,Septiembre,República Dominicana,0,8,,8,POINT (10406342 -75527794)
2016,Septiembre,República Dominicana,14,47,,61,POINT (10446304 -75516486)
2016,Septiembre,República Dominicana,17,30,,47,POINT (10886686 -74776479)
2016,Septiembre,República Dominicana,0,1,,1,POINT (10970933 -74765343)
2016,Septiembre,República Dominicana,0,1,,1,POINT (11117206 -74232675)
2016,Septiembre,República Dominicana,18,25,,43,POINT (3451668 -76532004)
2016,Septiembre,República Dominicana,656,905,,1561,POINT (4697157 -74140516)
2016,Septiembre,República Dominicana,5,6,,11,POINT (4815189 -75736374)
2016,Septiembre,República Dominicana,59,82,,141,POINT (6170465 -7542726)
2016,Septiembre,República Dominicana,3,3,,6,POINT (7128047 -73181317)
2016,Septiembre,República Dominicana,2,3,,5,POINT (7927233 -72508188)
2016,Septiembre,Reunión,0,1,,1,POINT (4697157 -74140516)
2016,Septiembre,República Democrática Popular de Corea,1,0,,1,POINT (4697157 -74140516)
2016,Septiembre,Rumania,2,3,,5,POINT (10446304 -75516486)
2016,Septiembre,Rumania,3,5,,8,POINT (3451668 -76532004)
2016,Septiembre,Rumania,6,9,,15,POINT (4697157 -74140516)
2016,Septiembre,Rumania,0,2,,2,POINT (6170465 -7542726)
2016,Septiembre,Rwanda,0,2,,2,POINT (4697157 -74140516)
2016,Septiembre,San Cristóbal y Nevis,0,1,,1,POINT (4697157 -74140516)
2016,Septiembre,San Cristóbal y Nevis,1,0,,1,POINT (6170465 -7542726)
2016,Septiembre,Santa Lucia,2,2,,4,POINT (4697157 -74140516)
2016,Septiembre,Santa Sede/Ciudad del Vaticano,1,0,,1,POINT (4697157 -74140516)
2016,Septiembre,Serbia,0,2,,2,POINT (4697157 -74140516)
2016,Septiembre,Singapur,1,2,,3,POINT (4697157 -74140516)
2016,Septiembre,Singapur,1,0,,1,POINT (6170465 -7542726)
2016,Septiembre,Sudáfrica,2,6,,8,POINT (4697157 -74140516)
2016,Septiembre,Sudáfrica,1,1,,2,POINT (6170465 -7542726)
2016,Septiembre,Suecia,1,0,,1,POINT (10446304 -75516486)
2016,Septiembre,Suecia,0,1,,1,POINT (10886686 -74776479)
2016,Septiembre,Suecia,1,5,,6,POINT (3451668 -76532004)
2016,Septiembre,Suecia,22,32,,54,POINT (4697157 -74140516)
2016,Septiembre,Suecia,2,5,,7,POINT (6170465 -7542726)
2016,Septiembre,Suiza,0,1,,1,POINT (10446304 -75516486)
2016,Septiembre,Suiza,0,1,,1,POINT (10886686 -74776479)
2016,Septiembre,Suiza,10,13,,23,POINT (3451668 -76532004)
2016,Septiembre,Suiza,50,70,,120,POINT (4697157 -74140516)
2016,Septiembre,Suiza,0,1,,1,POINT (4815189 -75736374)
2016,Septiembre,Suiza,6,13,,19,POINT (6170465 -7542726)
2016,Septiembre,Suiza,0,1,,1,POINT (7128047 -73181317)
2016,Septiembre,Surinam,2,3,,5,POINT (3451668 -76532004)
2016,Septiembre,Surinam,6,3,,9,POINT (4697157 -74140516)
2016,Septiembre,Surinam,4,3,,7,POINT (6170465 -7542726)
2016,Septiembre,Taiwán,1,1,,2,POINT (3451668 -76532004)
2016,Septiembre,Taiwán,2,6,,8,POINT (4697157 -74140516)
2016,Septiembre,Tailandia,8,19,,27,POINT (4697157 -74140516)
2016,Septiembre,Tailandia,0,1,,1,POINT (6170465 -7542726)
2016,Septiembre,Tanzania,3,0,,3,POINT (4697157 -74140516)
2016,Septiembre,Togo,0,1,,1,POINT (4697157 -74140516)
2016,Septiembre,Trinidad y Tobago,3,0,,3,POINT (10446304 -75516486)
2016,Septiembre,Trinidad y Tobago,1,0,,1,POINT (125862 -81702165)
2016,Septiembre,Trinidad y Tobago,1,1,,2,POINT (3451668 -76532004)
2016,Septiembre,Trinidad y Tobago,8,12,,20,POINT (4697157 -74140516)
2016,Septiembre,Trinidad y Tobago,3,5,,8,POINT (6170465 -7542726)
2016,Septiembre,Trinidad y Tobago,0,1,,1,POINT (7128047 -73181317)
2016,Septiembre,Trinidad y Tobago,0,4,,4,POINT (7927233 -72508188)
2016,Septiembre,Túnez,1,1,,2,POINT (4697157 -74140516)
2016,Septiembre,Turkmenistán,0,5,,5,POINT (4697157 -74140516)
2016,Septiembre,Turquía,0,1,,1,POINT (11247723 -74213989)
2016,Septiembre,Turquía,0,2,,2,POINT (3451668 -76532004)
2016,Septiembre,Turquía,342,581,,923,POINT (4697157 -74140516)
2016,Septiembre,Turquía,0,3,,3,POINT (6170465 -7542726)
2016,Septiembre,Ucrania,1,4,,5,POINT (4697157 -74140516)
2016,Septiembre,Uruguay,12,12,,24,POINT (10446304 -75516486)
2016,Septiembre,Uruguay,2,13,,15,POINT (10886686 -74776479)
2016,Septiembre,Uruguay,29,20,,49,POINT (125862 -81702165)
2016,Septiembre,Uruguay,18,24,,42,POINT (3451668 -76532004)
2016,Septiembre,Uruguay,82,119,,201,POINT (4697157 -74140516)
2016,Septiembre,Uruguay,1,1,,2,POINT (4815189 -75736374)
2016,Septiembre,Uruguay,42,59,,101,POINT (6170465 -7542726)
2016,Septiembre,Venezuela,0,2,,2,POINT (10406342 -75527794)
2016,Septiembre,Venezuela,15,114,,129,POINT (10446304 -75516486)
2016,Septiembre,Venezuela,11,98,,109,POINT (10886686 -74776479)
2016,Septiembre,Venezuela,0,1,,1,POINT (11117206 -74232675)
2016,Septiembre,Venezuela,0,1,,1,POINT (11247723 -74213989)
2016,Septiembre,Venezuela,4588,5586,,10174,POINT (11360029 -72129595)
2016,Septiembre,Venezuela,3,3,,6,POINT (125862 -81702165)
2016,Septiembre,Venezuela,9,31,,40,POINT (3451668 -76532004)
2016,Septiembre,Venezuela,23,21,,44,POINT (3866713 -67927521)
2016,Septiembre,Venezuela,3273,3718,,6991,POINT (4697157 -74140516)
2016,Septiembre,Venezuela,3,2,,5,POINT (4815189 -75736374)
2016,Septiembre,Venezuela,492,564,,1056,POINT (6170465 -7542726)
2016,Septiembre,Venezuela,1864,2356,,4220,POINT (6185536 -67484028)
2016,Septiembre,Venezuela,5522,5453,,10975,POINT (7088729 -70740253)
2016,Septiembre,Venezuela,2,2,,4,POINT (7128047 -73181317)
2016,Septiembre,Venezuela,6120,8063,,14183,POINT (7819 -72453013)
2016,Septiembre,Venezuela,1,7,,8,POINT (7927233 -72508188)
2016,Septiembre,Venezuela,125,137,,262,POINT (836068 -72409396)
2016,Septiembre,Vietnam,0,1,,1,POINT (4697157 -74140516)
2016,Septiembre,Islas Vírgenes Estadounidenses/Territorio de Estados Unidos,0,2,,2,POINT (10446304 -75516486)
2016,Septiembre,Anguila/Territorio Británico de Ultramar,0,1,,1,POINT (3451668 -76532004)
2016,Septiembre,Desconocido,0,1,,1,POINT (-4191162 -69941498)
2016,Septiembre,Desconocido,0,1,,1,POINT (445285 -75766353)
2016,Septiembre,Desconocido,0,1,,1,POINT (4697157 -74140516)
2016,Octubre,Albania,1,1,,2,POINT (4697157 -74140516)
2016,Octubre,Alemania,1,0,,1,POINT (10446304 -75516486)
2016,Octubre,Alemania,2,0,,2,POINT (10886686 -74776479)
2016,Octubre,Alemania,0,2,,2,POINT (11247723 -74213989)
2016,Octubre,Alemania,1,0,,1,POINT (125862 -81702165)
2016,Octubre,Alemania,23,37,,60,POINT (3451668 -76532004)
2016,Octubre,Alemania,1359,2385,,3744,POINT (4697157 -74140516)
2016,Octubre,Alemania,4,1,,5,POINT (4815189 -75736374)
2016,Octubre,Alemania,19,34,,53,POINT (6170465 -7542726)
2016,Octubre,Andorra,1,0,,1,POINT (4697157 -74140516)
2016,Octubre,Angola,0,6,,6,POINT (9402597 -75681642)
2016,Octubre,Antigua y Barbuda,0,4,,4,POINT (4697157 -74140516)
2016,Octubre,Países Bajos,5,14,,19,POINT (10406342 -75527794)
2016,Octubre,Países Bajos,0,1,,1,POINT (10446304 -75516486)
2016,Octubre,Países Bajos,50,90,,140,POINT (10886686 -74776479)
2016,Octubre,Países Bajos,1,3,,4,POINT (10970933 -74765343)
2016,Octubre,Países Bajos,3,6,,9,POINT (11247723 -74213989)
2016,Octubre,Países Bajos,82,120,,202,POINT (3451668 -76532004)
2016,Octubre,Países Bajos,767,1092,,1859,POINT (4697157 -74140516)
2016,Octubre,Países Bajos,3,2,,5,POINT (4815189 -75736374)
2016,Octubre,Países Bajos,229,245,,474,POINT (6170465 -7542726)
2016,Octubre,Países Bajos,2,1,,3,POINT (7128047 -73181317)
2016,Octubre,Arabia Saudita,1,1,,2,POINT (4697157 -74140516)
2016,Octubre,Argelia,0,4,,4,POINT (4697157 -74140516)
2016,Octubre,Argentina,2,17,,19,POINT (0.81488 -77356)
2016,Octubre,Argentina,0,8,,8,POINT (10406342 -75527794)
2016,Octubre,Argentina,59,41,,100,POINT (10446304 -75516486)
2016,Octubre,Argentina,1,7,,8,POINT (10886686 -74776479)
2016,Octubre,Argentina,195,118,,313,POINT (125862 -81702165)
2016,Octubre,Argentina,75,84,,159,POINT (3451668 -76532004)
2016,Octubre,Argentina,2266,3097,,5363,POINT (4697157 -74140516)
2016,Octubre,Argentina,2,3,,5,POINT (4815189 -75736374)
2016,Octubre,Argentina,94,179,,273,POINT (6170465 -7542726)
2016,Octubre,Argentina,0,2,,2,POINT (7128047 -73181317)
2016,Octubre,República de Armenia,1,1,,2,POINT (4697157 -74140516)
2016,Octubre,Aruba,9,10,,19,POINT (10406342 -75527794)
2016,Octubre,Aruba,5,7,,12,POINT (10886686 -74776479)
2016,Octubre,Aruba,10,16,,26,POINT (11247723 -74213989)
2016,Octubre,Aruba,3,2,,5,POINT (3451668 -76532004)
2016,Octubre,Aruba,683,777,,1460,POINT (4697157 -74140516)
2016,Octubre,Aruba,81,109,,190,POINT (6170465 -7542726)
2016,Octubre,Aruba,13,8,,21,POINT (7128047 -73181317)
2016,Octubre,Australia,1,1,,2,POINT (10446304 -75516486)
2016,Octubre,Australia,0,1,,1,POINT (10886686 -74776479)
2016,Octubre,Australia,3,6,,9,POINT (3451668 -76532004)
2016,Octubre,Australia,36,52,,88,POINT (4697157 -74140516)
2016,Octubre,Australia,3,1,,4,POINT (4815189 -75736374)
2016,Octubre,Australia,10,12,,22,POINT (6170465 -7542726)
2016,Octubre,Austria,4,5,,9,POINT (3451668 -76532004)
2016,Octubre,Austria,23,30,,53,POINT (4697157 -74140516)
2016,Octubre,Austria,0,4,,4,POINT (6170465 -7542726)
2016,Octubre,Austria,0,1,,1,POINT (7128047 -73181317)
2016,Octubre,Azerbaiyán,0,1,,1,POINT (4697157 -74140516)
2016,Octubre,Bahamas,2,6,,8,POINT (10406342 -75527794)
2016,Octubre,Bahamas,1,0,,1,POINT (4697157 -74140516)
2016,Octubre,Bahréin,1,1,,2,POINT (10446304 -75516486)
2016,Octubre,Bahréin,0,1,,1,POINT (11360029 -72129595)
2016,Octubre,Bahréin,0,1,,1,POINT (4697157 -74140516)
2016,Octubre,Barbados,0,1,,1,POINT (3451668 -76532004)
2016,Octubre,Barbados,37,38,,75,POINT (4697157 -74140516)
2016,Octubre,Barbados,0,1,,1,POINT (6170465 -7542726)
2016,Octubre,República de Belarús,1,9,,10,POINT (4697157 -74140516)
2016,Octubre,República de Belarús,0,1,,1,POINT (7819 -72453013)
2016,Octubre,Bélgica,0,5,,5,POINT (10406342 -75527794)
2016,Octubre,Bélgica,4,8,,12,POINT (3451668 -76532004)
2016,Octubre,Bélgica,34,61,,95,POINT (4697157 -74140516)
2016,Octubre,Bélgica,0,1,,1,POINT (4815189 -75736374)
2016,Octubre,Bélgica,2,7,,9,POINT (6170465 -7542726)
2016,Octubre,Belice,0,5,,5,POINT (10406342 -75527794)
2016,Octubre,Belice,1,5,,6,POINT (4697157 -74140516)
2016,Octubre,Belice,0,1,,1,POINT (6170465 -7542726)
2016,Octubre,Benín,2,2,,4,POINT (4697157 -74140516)
2016,Octubre,Bolivia,2,0,,2,POINT (0.81488 -77356)
2016,Octubre,Bolivia,8,5,,13,POINT (10446304 -75516486)
2016,Octubre,Bolivia,2,55,,57,POINT (10886686 -74776479)
2016,Octubre,Bolivia,9,20,,29,POINT (125862 -81702165)
2016,Octubre,Bolivia,16,17,,33,POINT (3451668 -76532004)
2016,Octubre,Bolivia,511,623,,1134,POINT (4697157 -74140516)
2016,Octubre,Bolivia,55,46,,101,POINT (6170465 -7542726)
2016,Octubre,Botsuana,0,1,,1,POINT (4697157 -74140516)
2016,Octubre,Brasil,195,201,,396,POINT (-4191162 -69941498)
2016,Octubre,Brasil,0,1,,1,POINT (0.81488 -77356)
2016,Octubre,Brasil,0,1,,1,POINT (10406342 -75527794)
2016,Octubre,Brasil,105,95,,200,POINT (10446304 -75516486)
2016,Octubre,Brasil,5,42,,47,POINT (10886686 -74776479)
2016,Octubre,Brasil,387,269,,656,POINT (125862 -81702165)
2016,Octubre,Brasil,92,101,,193,POINT (3451668 -76532004)
2016,Octubre,Brasil,2,6,,8,POINT (3866713 -67927521)
2016,Octubre,Brasil,5012,6151,,11163,POINT (4697157 -74140516)
2016,Octubre,Brasil,0,5,,5,POINT (4815189 -75736374)
2016,Octubre,Brasil,63,137,,200,POINT (6170465 -7542726)
2016,Octubre,Brasil,2,2,,4,POINT (7128047 -73181317)
2016,Octubre,Bulgaria,0,1,,1,POINT (10446304 -75516486)
2016,Octubre,Bulgaria,2,0,,2,POINT (10886686 -74776479)
2016,Octubre,Bulgaria,0,5,,5,POINT (4697157 -74140516)
2016,Octubre,Cabo Verde,1,0,,1,POINT (4697157 -74140516)
2016,Octubre,Islas Caimán/Territorio Británico de Ultramar,0,6,,6,POINT (10406342 -75527794)
2016,Octubre,Islas Caimán/Territorio Británico de Ultramar,1,3,,4,POINT (10446304 -75516486)
2016,Octubre,Islas Caimán/Territorio Británico de Ultramar,0,2,,2,POINT (10886686 -74776479)
2016,Octubre,Islas Caimán/Territorio Británico de Ultramar,1,5,,6,POINT (125744111 -81703935)
2016,Octubre,Islas Caimán/Territorio Británico de Ultramar,0,5,,5,POINT (125862 -81702165)
2016,Octubre,Islas Caimán/Territorio Británico de Ultramar,1,0,,1,POINT (4697157 -74140516)
2016,Octubre,Canadá,17,16,,33,POINT (10446304 -75516486)
2016,Octubre,Canadá,2,5,,7,POINT (10886686 -74776479)
2016,Octubre,Canadá,0,1,,1,POINT (11247723 -74213989)
2016,Octubre,Canadá,2,2,,4,POINT (125862 -81702165)
2016,Octubre,Canadá,24,34,,58,POINT (3451668 -76532004)
2016,Octubre,Canadá,559,994,,1553,POINT (4697157 -74140516)
2016,Octubre,Canadá,1,3,,4,POINT (4815189 -75736374)
2016,Octubre,Canadá,59,130,,189,POINT (6170465 -7542726)
2016,Octubre,Canadá,3,4,,7,POINT (7128047 -73181317)
2016,Octubre,España,8,32,,40,POINT (10446304 -75516486)
2016,Octubre,España,2,2,,4,POINT (10886686 -74776479)
2016,Octubre,España,0,4,,4,POINT (10970933 -74765343)
2016,Octubre,España,448,718,,1166,POINT (3451668 -76532004)
2016,Octubre,España,3646,6236,,9882,POINT (4697157 -74140516)
2016,Octubre,España,0,3,,3,POINT (4815189 -75736374)
2016,Octubre,España,219,472,,691,POINT (6170465 -7542726)
2016,Octubre,España,0,1,,1,POINT (7128047 -73181317)
2016,Octubre,España,0,3,,3,POINT (806667 -767333)
2016,Octubre,República Del Congo,0,2,,2,POINT (4697157 -74140516)
2016,Octubre,República Democrática del Congo,0,1,,1,POINT (4697157 -74140516)
2016,Octubre,República de Corea,0,3,,3,POINT (10886686 -74776479)
2016,Octubre,República de Corea,2,0,,2,POINT (125862 -81702165)
2016,Octubre,República de Corea,0,1,,1,POINT (3451668 -76532004)
2016,Octubre,República de Corea,9,19,,28,POINT (4697157 -74140516)
2016,Octubre,República de Corea,4,7,,11,POINT (4815189 -75736374)
2016,Octubre,República de Corea,1,6,,7,POINT (6170465 -7542726)
2016,Octubre,Costa de Marfil,0,1,,1,POINT (10446304 -75516486)
2016,Octubre,Costa de Marfil,8,6,,14,POINT (4697157 -74140516)
2016,Octubre,Costa Rica,22,52,,74,POINT (10406342 -75527794)
2016,Octubre,Costa Rica,10,15,,25,POINT (10446304 -75516486)
2016,Octubre,Costa Rica,1,13,,14,POINT (10886686 -74776479)
2016,Octubre,Costa Rica,0,9,,9,POINT (125744111 -81703935)
2016,Octubre,Costa Rica,104,82,,186,POINT (125862 -81702165)
2016,Octubre,Costa Rica,0,8,,8,POINT (133387613 -81372937)
2016,Octubre,Costa Rica,16,34,,50,POINT (3451668 -76532004)
2016,Octubre,Costa Rica,1016,1448,,2464,POINT (4697157 -74140516)
2016,Octubre,Costa Rica,6,20,,26,POINT (4815189 -75736374)
2016,Octubre,Costa Rica,89,145,,234,POINT (6170465 -7542726)
2016,Octubre,Costa Rica,5,2,,7,POINT (7128047 -73181317)
2016,Octubre,Croacia,0,1,,1,POINT (10886686 -74776479)
2016,Octubre,Croacia,0,1,,1,POINT (3451668 -76532004)
2016,Octubre,Croacia,2,4,,6,POINT (4697157 -74140516)
2016,Octubre,Cuba,47,50,,97,POINT (10446304 -75516486)
2016,Octubre,Cuba,11,10,,21,POINT (10886686 -74776479)
2016,Octubre,Cuba,22,23,,45,POINT (3451668 -76532004)
2016,Octubre,Cuba,315,545,,860,POINT (4697157 -74140516)
2016,Octubre,Cuba,2,1,,3,POINT (4815189 -75736374)
2016,Octubre,Cuba,18,26,,44,POINT (6170465 -7542726)
2016,Octubre,Cuba,6,6,,12,POINT (7128047 -73181317)
2016,Octubre,Curazao,3,2,,5,POINT (4697157 -74140516)
2016,Octubre,República Checa,1,0,,1,POINT (3451668 -76532004)
2016,Octubre,República Checa,8,6,,14,POINT (4697157 -74140516)
2016,Octubre,República Checa,1,0,,1,POINT (6170465 -7542726)
2016,Octubre,Chile,1,2,,3,POINT (0.81488 -77356)
2016,Octubre,Chile,25,38,,63,POINT (10446304 -75516486)
2016,Octubre,Chile,20,9,,29,POINT (10886686 -74776479)
2016,Octubre,Chile,38,29,,67,POINT (125862 -81702165)
2016,Octubre,Chile,111,224,,335,POINT (3451668 -76532004)
2016,Octubre,Chile,5680,6457,,12137,POINT (4697157 -74140516)
2016,Octubre,Chile,1,2,,3,POINT (4815189 -75736374)
2016,Octubre,Chile,24,53,,77,POINT (6170465 -7542726)
2016,Octubre,Chile,1,1,,2,POINT (7128047 -73181317)
2016,Octubre,China,1,0,,1,POINT (10886686 -74776479)
2016,Octubre,China,0,3,,3,POINT (3451668 -76532004)
2016,Octubre,China,42,89,,131,POINT (4697157 -74140516)
2016,Octubre,China,1,0,,1,POINT (4815189 -75736374)
2016,Octubre,China,1,2,,3,POINT (6170465 -7542726)
2016,Octubre,China,0,1,,1,POINT (7128047 -73181317)
2016,Octubre,Chipre,0,1,,1,POINT (4697157 -74140516)
2016,Octubre,Dinamarca,2,0,,2,POINT (10446304 -75516486)
2016,Octubre,Dinamarca,13,21,,34,POINT (4697157 -74140516)
2016,Octubre,Dinamarca,2,0,,2,POINT (6170465 -7542726)
2016,Octubre,Dominica,0,1,,1,POINT (3451668 -76532004)
2016,Octubre,Ecuador,0,2,,2,POINT (0.185957 -7478366)
2016,Octubre,Ecuador,112,268,,380,POINT (0.33002 -76876446)
2016,Octubre,Ecuador,8,4,,12,POINT (0.812436 -77847006)
2016,Octubre,Ecuador,3452,5046,,8498,POINT (0.81488 -77356)
2016,Octubre,Ecuador,53,119,,172,POINT (1800143 -78802679)
2016,Octubre,Ecuador,0,1,,1,POINT (10406342 -75527794)
2016,Octubre,Ecuador,7,16,,23,POINT (10446304 -75516486)
2016,Octubre,Ecuador,4,4,,8,POINT (10886686 -74776479)
2016,Octubre,Ecuador,4,2,,6,POINT (125862 -81702165)
2016,Octubre,Ecuador,450,485,,935,POINT (3451668 -76532004)
2016,Octubre,Ecuador,0,2,,2,POINT (3884426 -77061029)
2016,Octubre,Ecuador,3358,5120,,8478,POINT (4697157 -74140516)
2016,Octubre,Ecuador,8,9,,17,POINT (4815189 -75736374)
2016,Octubre,Ecuador,49,71,,120,POINT (6170465 -7542726)
2016,Octubre,Ecuador,3,2,,5,POINT (7128047 -73181317)
2016,Octubre,Egipto,1,4,,5,POINT (4697157 -74140516)
2016,Octubre,El Salvador,11,10,,21,POINT (10446304 -75516486)
2016,Octubre,El Salvador,2,3,,5,POINT (10886686 -74776479)
2016,Octubre,El Salvador,21,28,,49,POINT (125862 -81702165)
2016,Octubre,El Salvador,107,162,,269,POINT (3451668 -76532004)
2016,Octubre,El Salvador,1033,1519,,2552,POINT (4697157 -74140516)
2016,Octubre,El Salvador,0,3,,3,POINT (4815189 -75736374)
2016,Octubre,El Salvador,159,277,,436,POINT (6170465 -7542726)
2016,Octubre,Emiratos Árabes,2,10,,12,POINT (4697157 -74140516)
2016,Octubre,Eritrea,1,0,,1,POINT (4697157 -74140516)
2016,Octubre,Eslovaquia,4,6,,10,POINT (4697157 -74140516)
2016,Octubre,Eslovenia,0,1,,1,POINT (10886686 -74776479)
2016,Octubre,Eslovenia,0,1,,1,POINT (3451668 -76532004)
2016,Octubre,Eslovenia,3,1,,4,POINT (4697157 -74140516)
2016,Octubre,Eslovenia,0,2,,2,POINT (6170465 -7542726)
2016,Octubre,Estados Unidos de América,5,33,,38,POINT (10406342 -75527794)
2016,Octubre,Estados Unidos de América,1972,3106,,5078,POINT (10446304 -75516486)
2016,Octubre,Estados Unidos de América,330,754,,1084,POINT (10886686 -74776479)
2016,Octubre,Estados Unidos de América,0,2,,2,POINT (10970933 -74765343)
2016,Octubre,Estados Unidos de América,0,1,,1,POINT (11117206 -74232675)
2016,Octubre,Estados Unidos de América,2,24,,26,POINT (11247723 -74213989)
2016,Octubre,Estados Unidos de América,7,18,,25,POINT (125862 -81702165)
2016,Octubre,Estados Unidos de América,681,1137,,1818,POINT (3451668 -76532004)
2016,Octubre,Estados Unidos de América,0,1,,1,POINT (3884426 -77061029)
2016,Octubre,Estados Unidos de América,78,158,,236,POINT (445285 -75766353)
2016,Octubre,Estados Unidos de América,7397,13616,,21013,POINT (4697157 -74140516)
2016,Octubre,Estados Unidos de América,72,139,,211,POINT (4815189 -75736374)
2016,Octubre,Estados Unidos de América,1305,3825,,5130,POINT (6170465 -7542726)
2016,Octubre,Estados Unidos de América,16,37,,53,POINT (7128047 -73181317)
2016,Octubre,Estados Unidos de América,4,3,,7,POINT (7927233 -72508188)
2016,Octubre,Estados Unidos de América,0,11,,11,POINT (9402597 -75681642)
2016,Octubre,Estonia,4,4,,8,POINT (4697157 -74140516)
2016,Octubre,Etiopia,0,1,,1,POINT (4697157 -74140516)
2016,Octubre,Islas Fiji,1,0,,1,POINT (4697157 -74140516)
2016,Octubre,Filipinas,0,3,,3,POINT (10886686 -74776479)
2016,Octubre,Filipinas,0,1,,1,POINT (3451668 -76532004)
2016,Octubre,Filipinas,4,20,,24,POINT (4697157 -74140516)
2016,Octubre,Finlandia,2,0,,2,POINT (3451668 -76532004)
2016,Octubre,Finlandia,3,8,,11,POINT (4697157 -74140516)
2016,Octubre,Francia,0,1,,1,POINT (10406342 -75527794)
2016,Octubre,Francia,2,0,,2,POINT (10446304 -75516486)
2016,Octubre,Francia,2,2,,4,POINT (10886686 -74776479)
2016,Octubre,Francia,25,58,,83,POINT (3451668 -76532004)
2016,Octubre,Francia,1317,2087,,3404,POINT (4697157 -74140516)
2016,Octubre,Francia,35,58,,93,POINT (6170465 -7542726)
2016,Octubre,Francia,1,1,,2,POINT (7128047 -73181317)
2016,Octubre,Georgia,0,1,,1,POINT (3451668 -76532004)
2016,Octubre,Ghana,0,2,,2,POINT (3451668 -76532004)
2016,Octubre,Ghana,0,1,,1,POINT (4697157 -74140516)
2016,Octubre,Granada,0,2,,2,POINT (11247723 -74213989)
2016,Octubre,Granada,1,0,,1,POINT (4697157 -74140516)
2016,Octubre,Grecia,0,1,,1,POINT (3451668 -76532004)
2016,Octubre,Grecia,9,7,,16,POINT (4697157 -74140516)
2016,Octubre,Guatemala,29,31,,60,POINT (10446304 -75516486)
2016,Octubre,Guatemala,2,7,,9,POINT (10886686 -74776479)
2016,Octubre,Guatemala,10,12,,22,POINT (125862 -81702165)
2016,Octubre,Guatemala,22,46,,68,POINT (3451668 -76532004)
2016,Octubre,Guatemala,398,643,,1041,POINT (4697157 -74140516)
2016,Octubre,Guatemala,3,3,,6,POINT (4815189 -75736374)
2016,Octubre,Guatemala,70,157,,227,POINT (6170465 -7542726)
2016,Octubre,Guatemala,2,10,,12,POINT (7128047 -73181317)
2016,Octubre,Guyana,1,1,,2,POINT (3451668 -76532004)
2016,Octubre,Guyana,1,2,,3,POINT (4697157 -74140516)
2016,Octubre,Guinea Ecuatorial,0,1,,1,POINT (4697157 -74140516)
2016,Octubre,Guadalupe/Territorio Francés,1,0,,1,POINT (3451668 -76532004)
2016,Octubre,Guadalupe/Territorio Francés,1,2,,3,POINT (4697157 -74140516)
2016,Octubre,Guadalupe/Territorio Francés,0,1,,1,POINT (4815189 -75736374)
2016,Octubre,Guadalupe/Territorio Francés,0,1,,1,POINT (6170465 -7542726)
2016,Octubre,Guayana Francesa/Departamento de Ultramar Francés,3,1,,4,POINT (4697157 -74140516)
2016,Octubre,Haití,0,1,,1,POINT (10446304 -75516486)
2016,Octubre,Haití,0,1,,1,POINT (10886686 -74776479)
2016,Octubre,Haití,4,2,,6,POINT (4697157 -74140516)
2016,Octubre,Haití,0,8,,8,POINT (6170465 -7542726)
2016,Octubre,Honduras,7,26,,33,POINT (10446304 -75516486)
2016,Octubre,Honduras,4,8,,12,POINT (10886686 -74776479)
2016,Octubre,Honduras,0,4,,4,POINT (125744111 -81703935)
2016,Octubre,Honduras,62,51,,113,POINT (125862 -81702165)
2016,Octubre,Honduras,17,48,,65,POINT (3451668 -76532004)
2016,Octubre,Honduras,132,138,,270,POINT (4697157 -74140516)
2016,Octubre,Honduras,1,4,,5,POINT (4815189 -75736374)
2016,Octubre,Honduras,58,85,,143,POINT (6170465 -7542726)
2016,Octubre,Honduras,1,0,,1,POINT (7128047 -73181317)
2016,Octubre,Hong Kong,1,0,,1,POINT (4697157 -74140516)
2016,Octubre,Hungría,5,6,,11,POINT (4697157 -74140516)
2016,Octubre,Hungría,0,1,,1,POINT (6170465 -7542726)
2016,Octubre,India,0,3,,3,POINT (10886686 -74776479)
2016,Octubre,India,1,2,,3,POINT (3451668 -76532004)
2016,Octubre,India,6,23,,29,POINT (4697157 -74140516)
2016,Octubre,India,1,8,,9,POINT (6170465 -7542726)
2016,Octubre,Indonesia,0,2,,2,POINT (4697157 -74140516)
2016,Octubre,Irán,0,4,,4,POINT (4697157 -74140516)
2016,Octubre,República de Irlanda,1,1,,2,POINT (3451668 -76532004)
2016,Octubre,República de Irlanda,16,12,,28,POINT (4697157 -74140516)
2016,Octubre,República de Irlanda,2,3,,5,POINT (6170465 -7542726)
2016,Octubre,Islandia,0,1,,1,POINT (4697157 -74140516)
2016,Octubre,Israel,1,0,,1,POINT (10886686 -74776479)
2016,Octubre,Israel,0,6,,6,POINT (3451668 -76532004)
2016,Octubre,Israel,18,48,,66,POINT (4697157 -74140516)
2016,Octubre,Israel,3,5,,8,POINT (6170465 -7542726)
2016,Octubre,Italia,0,2,,2,POINT (10446304 -75516486)
2016,Octubre,Italia,0,2,,2,POINT (10886686 -74776479)
2016,Octubre,Italia,20,29,,49,POINT (3451668 -76532004)
2016,Octubre,Italia,91,238,,329,POINT (4697157 -74140516)
2016,Octubre,Italia,11,41,,52,POINT (6170465 -7542726)
2016,Octubre,Italia,0,1,,1,POINT (7128047 -73181317)
2016,Octubre,Jamaica,1,6,,7,POINT (10406342 -75527794)
2016,Octubre,Jamaica,1,3,,4,POINT (10886686 -74776479)
2016,Octubre,Jamaica,0,1,,1,POINT (125862 -81702165)
2016,Octubre,Jamaica,1,2,,3,POINT (133387613 -81372937)
2016,Octubre,Jamaica,4,4,,8,POINT (3451668 -76532004)
2016,Octubre,Jamaica,12,7,,19,POINT (4697157 -74140516)
2016,Octubre,Jamaica,0,7,,7,POINT (6170465 -7542726)
2016,Octubre,Jamaica,2,1,,3,POINT (7128047 -73181317)
2016,Octubre,Japón,1,0,,1,POINT (10446304 -75516486)
2016,Octubre,Japón,1,1,,2,POINT (3451668 -76532004)
2016,Octubre,Japón,3,30,,33,POINT (4697157 -74140516)
2016,Octubre,Japón,2,7,,9,POINT (6170465 -7542726)
2016,Octubre,Jordania,1,0,,1,POINT (4697157 -74140516)
2016,Octubre,Kazajistán,1,1,,2,POINT (4697157 -74140516)
2016,Octubre,Kenia,1,3,,4,POINT (3451668 -76532004)
2016,Octubre,Kenia,2,2,,4,POINT (4697157 -74140516)
2016,Octubre,Kuwait,0,1,,1,POINT (3451668 -76532004)
2016,Octubre,República de Kosovo,0,1,,1,POINT (4697157 -74140516)
2016,Octubre,Lesoto,0,1,,1,POINT (4697157 -74140516)
2016,Octubre,Lituania,6,4,,10,POINT (4697157 -74140516)
2016,Octubre,Líbano,0,1,,1,POINT (10886686 -74776479)
2016,Octubre,Líbano,5,10,,15,POINT (4697157 -74140516)
2016,Octubre,Luxemburgo,0,1,,1,POINT (4697157 -74140516)
2016,Octubre,Malasia,0,1,,1,POINT (3451668 -76532004)
2016,Octubre,Malasia,2,5,,7,POINT (4697157 -74140516)
2016,Octubre,Malta,1,0,,1,POINT (3451668 -76532004)
2016,Octubre,Malta,1,0,,1,POINT (6170465 -7542726)
2016,Octubre,Marruecos,0,1,,1,POINT (10406342 -75527794)
2016,Octubre,Marruecos,4,1,,5,POINT (4697157 -74140516)
2016,Octubre,Mauricio,0,1,,1,POINT (4697157 -74140516)
2016,Octubre,Mauritania,1,0,,1,POINT (4697157 -74140516)
2016,Octubre,México,1,1,,2,POINT (10406342 -75527794)
2016,Octubre,México,19,48,,67,POINT (10446304 -75516486)
2016,Octubre,México,9,31,,40,POINT (10886686 -74776479)
2016,Octubre,México,0,4,,4,POINT (125744111 -81703935)
2016,Octubre,México,2,6,,8,POINT (125862 -81702165)
2016,Octubre,México,56,172,,228,POINT (3451668 -76532004)
2016,Octubre,México,0,2,,2,POINT (3884426 -77061029)
2016,Octubre,México,1,1,,2,POINT (445285 -75766353)
2016,Octubre,México,4807,8189,,12996,POINT (4697157 -74140516)
2016,Octubre,México,5,11,,16,POINT (4815189 -75736374)
2016,Octubre,México,439,1063,,1502,POINT (6170465 -7542726)
2016,Octubre,México,10,16,,26,POINT (7128047 -73181317)
2016,Octubre,México,1,1,,2,POINT (7927233 -72508188)
2016,Octubre,Mónaco,1,0,,1,POINT (4697157 -74140516)
2016,Octubre,Nepal,0,1,,1,POINT (4697157 -74140516)
2016,Octubre,Nicaragua,2,6,,8,POINT (10446304 -75516486)
2016,Octubre,Nicaragua,0,8,,8,POINT (125744111 -81703935)
2016,Octubre,Nicaragua,0,1,,1,POINT (125862 -81702165)
2016,Octubre,Nicaragua,6,5,,11,POINT (3451668 -76532004)
2016,Octubre,Nicaragua,34,44,,78,POINT (4697157 -74140516)
2016,Octubre,Nicaragua,3,10,,13,POINT (4815189 -75736374)
2016,Octubre,Nicaragua,8,15,,23,POINT (6170465 -7542726)
2016,Octubre,Nicaragua,1,0,,1,POINT (7128047 -73181317)
2016,Octubre,Nigeria,2,1,,3,POINT (4697157 -74140516)
2016,Octubre,Noruega,0,1,,1,POINT (10886686 -74776479)
2016,Octubre,Noruega,2,4,,6,POINT (3451668 -76532004)
2016,Octubre,Noruega,17,17,,34,POINT (4697157 -74140516)
2016,Octubre,Noruega,1,2,,3,POINT (6170465 -7542726)
2016,Octubre,Nueva Zelanda,2,4,,6,POINT (4697157 -74140516)
2016,Octubre,Nueva Zelanda,0,1,,1,POINT (4815189 -75736374)
2016,Octubre,Nueva Zelanda,2,6,,8,POINT (6170465 -7542726)
2016,Octubre,Pakistán,0,2,,2,POINT (4697157 -74140516)
2016,Octubre,Panamá,1351,998,,2349,POINT (10406342 -75527794)
2016,Octubre,Panamá,3356,3511,,6867,POINT (10446304 -75516486)
2016,Octubre,Panamá,267,588,,855,POINT (10886686 -74776479)
2016,Octubre,Panamá,0,12,,12,POINT (10970933 -74765343)
2016,Octubre,Panamá,7,5,,12,POINT (125744111 -81703935)
2016,Octubre,Panamá,511,379,,890,POINT (125862 -81702165)
2016,Octubre,Panamá,2,1,,3,POINT (133387613 -81372937)
2016,Octubre,Panamá,360,605,,965,POINT (3451668 -76532004)
2016,Octubre,Panamá,0,23,,23,POINT (3884426 -77061029)
2016,Octubre,Panamá,55,73,,128,POINT (445285 -75766353)
2016,Octubre,Panamá,4274,6101,,10375,POINT (4697157 -74140516)
2016,Octubre,Panamá,39,96,,135,POINT (4815189 -75736374)
2016,Octubre,Panamá,1909,2699,,4608,POINT (6170465 -7542726)
2016,Octubre,Panamá,3,1,,4,POINT (6222552 -77401154)
2016,Octubre,Panamá,1,3,,4,POINT (7102626 -77762647)
2016,Octubre,Panamá,20,38,,58,POINT (7128047 -73181317)
2016,Octubre,Panamá,30,32,,62,POINT (7927233 -72508188)
2016,Octubre,Panamá,0,6,,6,POINT (806667 -767333)
2016,Octubre,Panamá,52,57,,109,POINT (863337 -7735002)
2016,Octubre,Panamá,0,1,,1,POINT (9402597 -75681642)
2016,Octubre,Paraguay,9,10,,19,POINT (10446304 -75516486)
2016,Octubre,Paraguay,1,9,,10,POINT (10886686 -74776479)
2016,Octubre,Paraguay,53,27,,80,POINT (125862 -81702165)
2016,Octubre,Paraguay,3,4,,7,POINT (3451668 -76532004)
2016,Octubre,Paraguay,70,69,,139,POINT (4697157 -74140516)
2016,Octubre,Paraguay,1,2,,3,POINT (4815189 -75736374)
2016,Octubre,Paraguay,48,126,,174,POINT (6170465 -7542726)
2016,Octubre,Paraguay,0,3,,3,POINT (7128047 -73181317)
2016,Octubre,Perú,75,133,,208,POINT (-4191162 -69941498)
2016,Octubre,Perú,6,4,,10,POINT (0.185957 -7478366)
2016,Octubre,Perú,1,9,,10,POINT (0.81488 -77356)
2016,Octubre,Perú,1,16,,17,POINT (10406342 -75527794)
2016,Octubre,Perú,18,42,,60,POINT (10446304 -75516486)
2016,Octubre,Perú,8,12,,20,POINT (10886686 -74776479)
2016,Octubre,Perú,0,1,,1,POINT (10970933 -74765343)
2016,Octubre,Perú,165,120,,285,POINT (125862 -81702165)
2016,Octubre,Perú,338,506,,844,POINT (3451668 -76532004)
2016,Octubre,Perú,6908,9090,,15998,POINT (4697157 -74140516)
2016,Octubre,Perú,6,2,,8,POINT (4815189 -75736374)
2016,Octubre,Perú,462,760,,1222,POINT (6170465 -7542726)
2016,Octubre,Perú,2,2,,4,POINT (7128047 -73181317)
2016,Octubre,Polonia,1,1,,2,POINT (3451668 -76532004)
2016,Octubre,Polonia,23,25,,48,POINT (4697157 -74140516)
2016,Octubre,Polonia,0,3,,3,POINT (6170465 -7542726)
2016,Octubre,Portugal,0,7,,7,POINT (10446304 -75516486)
2016,Octubre,Portugal,0,2,,2,POINT (10886686 -74776479)
2016,Octubre,Portugal,1,6,,7,POINT (3451668 -76532004)
2016,Octubre,Portugal,25,95,,120,POINT (4697157 -74140516)
2016,Octubre,Portugal,4,3,,7,POINT (6170465 -7542726)
2016,Octubre,Portugal,0,1,,1,POINT (7128047 -73181317)
2016,Octubre,Polinesia Francesa/Colectividad de Ultramar Francesa,1,0,,1,POINT (125862 -81702165)
2016,Octubre,Puerto Rico/Territorio de Estados Unidos,8,9,,17,POINT (10446304 -75516486)
2016,Octubre,Puerto Rico/Territorio de Estados Unidos,4,23,,27,POINT (10886686 -74776479)
2016,Octubre,Puerto Rico/Territorio de Estados Unidos,0,2,,2,POINT (125862 -81702165)
2016,Octubre,Puerto Rico/Territorio de Estados Unidos,23,43,,66,POINT (3451668 -76532004)
2016,Octubre,Puerto Rico/Territorio de Estados Unidos,340,413,,753,POINT (4697157 -74140516)
2016,Octubre,Puerto Rico/Territorio de Estados Unidos,9,11,,20,POINT (4815189 -75736374)
2016,Octubre,Puerto Rico/Territorio de Estados Unidos,66,149,,215,POINT (6170465 -7542726)
2016,Octubre,Puerto Rico/Territorio de Estados Unidos,1,1,,2,POINT (7128047 -73181317)
2016,Octubre,Reino Unido de Gran Bretaña e Irlanda del Norte,0,1,,1,POINT (10446304 -75516486)
2016,Octubre,Reino Unido de Gran Bretaña e Irlanda del Norte,0,1,,1,POINT (10886686 -74776479)
2016,Octubre,Reino Unido de Gran Bretaña e Irlanda del Norte,13,27,,40,POINT (3451668 -76532004)
2016,Octubre,Reino Unido de Gran Bretaña e Irlanda del Norte,788,1308,,2096,POINT (4697157 -74140516)
2016,Octubre,Reino Unido de Gran Bretaña e Irlanda del Norte,1,1,,2,POINT (4815189 -75736374)
2016,Octubre,Reino Unido de Gran Bretaña e Irlanda del Norte,7,25,,32,POINT (6170465 -7542726)
2016,Octubre,Reino Unido de Gran Bretaña e Irlanda del Norte,0,1,,1,POINT (7128047 -73181317)
2016,Octubre,Reino Unido de Gran Bretaña e Irlanda del Norte,0,2,,2,POINT (806667 -767333)
2016,Octubre,República CentroÁfricana,1,1,,2,POINT (4697157 -74140516)
2016,Octubre,Federación de Rusia,0,11,,11,POINT (10406342 -75527794)
2016,Octubre,Federación de Rusia,1,2,,3,POINT (3451668 -76532004)
2016,Octubre,Federación de Rusia,35,51,,86,POINT (4697157 -74140516)
2016,Octubre,Federación de Rusia,0,6,,6,POINT (6170465 -7542726)
2016,Octubre,Federación de Rusia,0,4,,4,POINT (806667 -767333)
2016,Octubre,República Dominicana,1,14,,15,POINT (10406342 -75527794)
2016,Octubre,República Dominicana,19,75,,94,POINT (10446304 -75516486)
2016,Octubre,República Dominicana,4,45,,49,POINT (10886686 -74776479)
2016,Octubre,República Dominicana,39,51,,90,POINT (3451668 -76532004)
2016,Octubre,República Dominicana,718,951,,1669,POINT (4697157 -74140516)
2016,Octubre,República Dominicana,8,20,,28,POINT (4815189 -75736374)
2016,Octubre,República Dominicana,31,85,,116,POINT (6170465 -7542726)
2016,Octubre,República Dominicana,2,7,,9,POINT (7128047 -73181317)
2016,Octubre,Rumania,1,2,,3,POINT (3451668 -76532004)
2016,Octubre,Rumania,5,13,,18,POINT (4697157 -74140516)
2016,Octubre,Rumania,0,2,,2,POINT (6170465 -7542726)
2016,Octubre,Rwanda,0,1,,1,POINT (4697157 -74140516)
2016,Octubre,San  Vicente y las Granadinas,0,1,,1,POINT (4697157 -74140516)
2016,Octubre,Senegal,3,0,,3,POINT (6170465 -7542726)
2016,Octubre,Serbia,0,1,,1,POINT (3451668 -76532004)
2016,Octubre,Serbia,1,1,,2,POINT (4697157 -74140516)
2016,Octubre,Serbia,1,0,,1,POINT (6170465 -7542726)
2016,Octubre,Sierra Leona,0,2,,2,POINT (4697157 -74140516)
2016,Octubre,Singapur,0,3,,3,POINT (4697157 -74140516)
2016,Octubre,Singapur,0,1,,1,POINT (6170465 -7542726)
2016,Octubre,Singapur,0,1,,1,POINT (7128047 -73181317)
2016,Octubre,República Árabe Siria,1,0,,1,POINT (4697157 -74140516)
2016,Octubre,Sudáfrica,8,16,,24,POINT (4697157 -74140516)
2016,Octubre,Sudáfrica,1,1,,2,POINT (6170465 -7542726)
2016,Octubre,Suecia,0,1,,1,POINT (10446304 -75516486)
2016,Octubre,Suecia,0,1,,1,POINT (3451668 -76532004)
2016,Octubre,Suecia,25,38,,63,POINT (4697157 -74140516)
2016,Octubre,Suecia,0,1,,1,POINT (4815189 -75736374)
2016,Octubre,Suecia,1,4,,5,POINT (6170465 -7542726)
2016,Octubre,Suecia,1,0,,1,POINT (7128047 -73181317)
2016,Octubre,Suiza,3,1,,4,POINT (10446304 -75516486)
2016,Octubre,Suiza,0,1,,1,POINT (125862 -81702165)
2016,Octubre,Suiza,17,26,,43,POINT (3451668 -76532004)
2016,Octubre,Suiza,70,104,,174,POINT (4697157 -74140516)
2016,Octubre,Suiza,6,20,,26,POINT (6170465 -7542726)
2016,Octubre,Surinam,0,1,,1,POINT (10406342 -75527794)
2016,Octubre,Surinam,5,4,,9,POINT (4697157 -74140516)
2016,Octubre,Surinam,2,5,,7,POINT (6170465 -7542726)
2016,Octubre,Taiwán,1,0,,1,POINT (3451668 -76532004)
2016,Octubre,Taiwán,3,3,,6,POINT (4697157 -74140516)
2016,Octubre,Taiwán,2,2,,4,POINT (6170465 -7542726)
2016,Octubre,Tailandia,1,5,,6,POINT (4697157 -74140516)
2016,Octubre,Trinidad y Tobago,1,1,,2,POINT (10406342 -75527794)
2016,Octubre,Trinidad y Tobago,4,42,,46,POINT (10970933 -74765343)
2016,Octubre,Trinidad y Tobago,1,3,,4,POINT (3451668 -76532004)
2016,Octubre,Trinidad y Tobago,4,14,,18,POINT (4697157 -74140516)
2016,Octubre,Trinidad y Tobago,0,3,,3,POINT (6170465 -7542726)
2016,Octubre,Túnez,0,2,,2,POINT (4697157 -74140516)
2016,Octubre,Turkmenistán,2,8,,10,POINT (4697157 -74140516)
2016,Octubre,Turquía,0,5,,5,POINT (10970933 -74765343)
2016,Octubre,Turquía,367,586,,953,POINT (4697157 -74140516)
2016,Octubre,Turquía,1,2,,3,POINT (6170465 -7542726)
2016,Octubre,Turquía,0,1,,1,POINT (806667 -767333)
2016,Octubre,Ucrania,5,2,,7,POINT (4697157 -74140516)
2016,Octubre,Ucrania,1,0,,1,POINT (6170465 -7542726)
2016,Octubre,Uganda,1,0,,1,POINT (3451668 -76532004)
2016,Octubre,Uruguay,1,1,,2,POINT (0.81488 -77356)
2016,Octubre,Uruguay,6,4,,10,POINT (10446304 -75516486)
2016,Octubre,Uruguay,8,69,,77,POINT (10886686 -74776479)
2016,Octubre,Uruguay,33,19,,52,POINT (125862 -81702165)
2016,Octubre,Uruguay,7,17,,24,POINT (3451668 -76532004)
2016,Octubre,Uruguay,87,141,,228,POINT (4697157 -74140516)
2016,Octubre,Uruguay,1,0,,1,POINT (4815189 -75736374)
2016,Octubre,Uruguay,42,62,,104,POINT (6170465 -7542726)
2016,Octubre,Uruguay,1,0,,1,POINT (7128047 -73181317)
2016,Octubre,Venezuela,0,5,,5,POINT (10406342 -75527794)
2016,Octubre,Venezuela,32,78,,110,POINT (10446304 -75516486)
2016,Octubre,Venezuela,19,59,,78,POINT (10886686 -74776479)
2016,Octubre,Venezuela,0,7,,7,POINT (10970933 -74765343)
2016,Octubre,Venezuela,0,1,,1,POINT (11247723 -74213989)
2016,Octubre,Venezuela,4332,5126,,9458,POINT (11360029 -72129595)
2016,Octubre,Venezuela,0,2,,2,POINT (125862 -81702165)
2016,Octubre,Venezuela,14,32,,46,POINT (3451668 -76532004)
2016,Octubre,Venezuela,17,17,,34,POINT (3866713 -67927521)
2016,Octubre,Venezuela,0,1,,1,POINT (3884426 -77061029)
2016,Octubre,Venezuela,3437,3950,,7387,POINT (4697157 -74140516)
2016,Octubre,Venezuela,6,8,,14,POINT (4815189 -75736374)
2016,Octubre,Venezuela,577,621,,1198,POINT (6170465 -7542726)
2016,Octubre,Venezuela,1382,1840,,3222,POINT (6185536 -67484028)
2016,Octubre,Venezuela,87,112,,199,POINT (7088729 -70740253)
2016,Octubre,Venezuela,2,1,,3,POINT (7128047 -73181317)
2016,Octubre,Venezuela,6722,8714,,15436,POINT (7819 -72453013)
2016,Octubre,Venezuela,67,84,,151,POINT (836068 -72409396)
2016,Octubre,Vietnam,0,1,,1,POINT (3451668 -76532004)
2016,Octubre,Vietnam,0,5,,5,POINT (4697157 -74140516)
2016,Octubre,Zambia,0,1,,1,POINT (4697157 -74140516)
2016,Octubre,Islas Turcas y Caicos/Territorio Británico de Ultramar,0,11,,11,POINT (10446304 -75516486)
2016,Octubre,Desconocido,1,0,,1,POINT (11360029 -72129595)
2016,Noviembre,Afganistán,0,1,,1,POINT (3451668 -76532004)
2016,Noviembre,Afganistán,0,2,,2,POINT (6170465 -7542726)
2016,Noviembre,Albania,0,1,,1,POINT (4697157 -74140516)
2016,Noviembre,Alemania,1,0,,1,POINT (0.81488 -77356)
2016,Noviembre,Alemania,0,1,,1,POINT (10446304 -75516486)
2016,Noviembre,Alemania,1,2,,3,POINT (10886686 -74776479)
2016,Noviembre,Alemania,33,42,,75,POINT (3451668 -76532004)
2016,Noviembre,Alemania,1079,1911,,2990,POINT (4697157 -74140516)
2016,Noviembre,Alemania,0,2,,2,POINT (4815189 -75736374)
2016,Noviembre,Alemania,25,31,,56,POINT (6170465 -7542726)
2016,Noviembre,Alemania,0,1,,1,POINT (7128047 -73181317)
2016,Noviembre,Angola,0,1,,1,POINT (4697157 -74140516)
2016,Noviembre,Antigua y Barbuda,0,2,,2,POINT (10406342 -75527794)
2016,Noviembre,Antigua y Barbuda,3,0,,3,POINT (3451668 -76532004)
2016,Noviembre,Antigua y Barbuda,1,5,,6,POINT (4697157 -74140516)
2016,Noviembre,Países Bajos,9,19,,28,POINT (10406342 -75527794)
2016,Noviembre,Países Bajos,2,8,,10,POINT (10446304 -75516486)
2016,Noviembre,Países Bajos,40,64,,104,POINT (10886686 -74776479)
2016,Noviembre,Países Bajos,7,11,,18,POINT (11247723 -74213989)
2016,Noviembre,Países Bajos,79,163,,242,POINT (3451668 -76532004)
2016,Noviembre,Países Bajos,778,1148,,1926,POINT (4697157 -74140516)
2016,Noviembre,Países Bajos,0,3,,3,POINT (4815189 -75736374)
2016,Noviembre,Países Bajos,229,292,,521,POINT (6170465 -7542726)
2016,Noviembre,Países Bajos,5,2,,7,POINT (7128047 -73181317)
2016,Noviembre,Argelia,1,10,,11,POINT (4697157 -74140516)
2016,Noviembre,Argelia,0,2,,2,POINT (6170465 -7542726)
2016,Noviembre,Argentina,2,7,,9,POINT (0.81488 -77356)
2016,Noviembre,Argentina,0,32,,32,POINT (10406342 -75527794)
2016,Noviembre,Argentina,26,14,,40,POINT (10446304 -75516486)
2016,Noviembre,Argentina,3,8,,11,POINT (10886686 -74776479)
2016,Noviembre,Argentina,161,89,,250,POINT (125862 -81702165)
2016,Noviembre,Argentina,39,105,,144,POINT (3451668 -76532004)
2016,Noviembre,Argentina,2612,3562,,6174,POINT (4697157 -74140516)
2016,Noviembre,Argentina,0,1,,1,POINT (4815189 -75736374)
2016,Noviembre,Argentina,75,169,,244,POINT (6170465 -7542726)
2016,Noviembre,Argentina,2,2,,4,POINT (7128047 -73181317)
2016,Noviembre,República de Armenia,0,1,,1,POINT (4697157 -74140516)
2016,Noviembre,Aruba,4,13,,17,POINT (10406342 -75527794)
2016,Noviembre,Aruba,2,4,,6,POINT (10446304 -75516486)
2016,Noviembre,Aruba,2,2,,4,POINT (10886686 -74776479)
2016,Noviembre,Aruba,0,1,,1,POINT (11117206 -74232675)
2016,Noviembre,Aruba,17,23,,40,POINT (11247723 -74213989)
2016,Noviembre,Aruba,5,12,,17,POINT (3451668 -76532004)
2016,Noviembre,Aruba,626,736,,1362,POINT (4697157 -74140516)
2016,Noviembre,Aruba,1,2,,3,POINT (4815189 -75736374)
2016,Noviembre,Aruba,38,50,,88,POINT (6170465 -7542726)
2016,Noviembre,Aruba,13,9,,22,POINT (7128047 -73181317)
2016,Noviembre,Australia,2,1,,3,POINT (10886686 -74776479)
2016,Noviembre,Australia,5,5,,10,POINT (3451668 -76532004)
2016,Noviembre,Australia,39,78,,117,POINT (4697157 -74140516)
2016,Noviembre,Australia,10,17,,27,POINT (6170465 -7542726)
2016,Noviembre,Australia,1,2,,3,POINT (7128047 -73181317)
2016,Noviembre,Austria,1,0,,1,POINT (3451668 -76532004)
2016,Noviembre,Austria,10,42,,52,POINT (4697157 -74140516)
2016,Noviembre,Austria,3,2,,5,POINT (6170465 -7542726)
2016,Noviembre,Azerbaiyán,1,1,,2,POINT (4697157 -74140516)
2016,Noviembre,Bahamas,2,3,,5,POINT (10406342 -75527794)
2016,Noviembre,Bahamas,1,1,,2,POINT (3451668 -76532004)
2016,Noviembre,Bahamas,0,1,,1,POINT (4697157 -74140516)
2016,Noviembre,Bahamas,0,2,,2,POINT (4815189 -75736374)
2016,Noviembre,Bahréin,0,1,,1,POINT (4697157 -74140516)
2016,Noviembre,Barbados,1,0,,1,POINT (10886686 -74776479)
2016,Noviembre,Barbados,43,53,,96,POINT (4697157 -74140516)
2016,Noviembre,República de Belarús,0,2,,2,POINT (4697157 -74140516)
2016,Noviembre,República de Belarús,2,0,,2,POINT (7819 -72453013)
2016,Noviembre,Bélgica,0,2,,2,POINT (3451668 -76532004)
2016,Noviembre,Bélgica,53,63,,116,POINT (4697157 -74140516)
2016,Noviembre,Bélgica,3,11,,14,POINT (6170465 -7542726)
2016,Noviembre,Belice,2,6,,8,POINT (4697157 -74140516)
2016,Noviembre,Belice,1,0,,1,POINT (6170465 -7542726)
2016,Noviembre,Benín,0,2,,2,POINT (4697157 -74140516)
2016,Noviembre,Benín,1,0,,1,POINT (6170465 -7542726)
2016,Noviembre,Bolivia,2,2,,4,POINT (10446304 -75516486)
2016,Noviembre,Bolivia,0,1,,1,POINT (10886686 -74776479)
2016,Noviembre,Bolivia,17,13,,30,POINT (125862 -81702165)
2016,Noviembre,Bolivia,17,28,,45,POINT (3451668 -76532004)
2016,Noviembre,Bolivia,456,578,,1034,POINT (4697157 -74140516)
2016,Noviembre,Bolivia,4,3,,7,POINT (4815189 -75736374)
2016,Noviembre,Bolivia,40,62,,102,POINT (6170465 -7542726)
2016,Noviembre,Bolivia,0,2,,2,POINT (7128047 -73181317)
2016,Noviembre,Brasil,197,217,,414,POINT (-4191162 -69941498)
2016,Noviembre,Brasil,0,6,,6,POINT (10406342 -75527794)
2016,Noviembre,Brasil,47,30,,77,POINT (10446304 -75516486)
2016,Noviembre,Brasil,2,5,,7,POINT (10886686 -74776479)
2016,Noviembre,Brasil,429,309,,738,POINT (125862 -81702165)
2016,Noviembre,Brasil,41,90,,131,POINT (3451668 -76532004)
2016,Noviembre,Brasil,0,5,,5,POINT (3866713 -67927521)
2016,Noviembre,Brasil,4530,6424,,10954,POINT (4697157 -74140516)
2016,Noviembre,Brasil,1,0,,1,POINT (4815189 -75736374)
2016,Noviembre,Brasil,98,296,,394,POINT (6170465 -7542726)
2016,Noviembre,Bulgaria,1,2,,3,POINT (4697157 -74140516)
2016,Noviembre,Bután,0,1,,1,POINT (4697157 -74140516)
2016,Noviembre,Cabo Verde,0,2,,2,POINT (4697157 -74140516)
2016,Noviembre,Islas Caimán/Territorio Británico de Ultramar,0,1,,1,POINT (10446304 -75516486)
2016,Noviembre,Islas Caimán/Territorio Británico de Ultramar,0,3,,3,POINT (10886686 -74776479)
2016,Noviembre,Islas Caimán/Territorio Británico de Ultramar,0,2,,2,POINT (125862 -81702165)
2016,Noviembre,Islas Caimán/Territorio Británico de Ultramar,1,2,,3,POINT (4697157 -74140516)
2016,Noviembre,Camerún,0,1,,1,POINT (4697157 -74140516)
2016,Noviembre,Canadá,0,1,,1,POINT (10406342 -75527794)
2016,Noviembre,Canadá,5,25,,30,POINT (10446304 -75516486)
2016,Noviembre,Canadá,1,16,,17,POINT (10886686 -74776479)
2016,Noviembre,Canadá,2,1,,3,POINT (125862 -81702165)
2016,Noviembre,Canadá,21,44,,65,POINT (3451668 -76532004)
2016,Noviembre,Canadá,660,1119,,1779,POINT (4697157 -74140516)
2016,Noviembre,Canadá,5,7,,12,POINT (4815189 -75736374)
2016,Noviembre,Canadá,89,185,,274,POINT (6170465 -7542726)
2016,Noviembre,Canadá,1,1,,2,POINT (7128047 -73181317)
2016,Noviembre,España,0,1,,1,POINT (10406342 -75527794)
2016,Noviembre,España,1,3,,4,POINT (10886686 -74776479)
2016,Noviembre,España,0,2,,2,POINT (11247723 -74213989)
2016,Noviembre,España,570,804,,1374,POINT (3451668 -76532004)
2016,Noviembre,España,3961,7015,,10976,POINT (4697157 -74140516)
2016,Noviembre,España,6,7,,13,POINT (4815189 -75736374)
2016,Noviembre,España,252,623,,875,POINT (6170465 -7542726)
2016,Noviembre,República Del Congo,0,3,,3,POINT (4697157 -74140516)
2016,Noviembre,Comoras,0,1,,1,POINT (4697157 -74140516)
2016,Noviembre,República de Corea,0,1,,1,POINT (10446304 -75516486)
2016,Noviembre,República de Corea,0,2,,2,POINT (10886686 -74776479)
2016,Noviembre,República de Corea,0,1,,1,POINT (3884426 -77061029)
2016,Noviembre,República de Corea,9,17,,26,POINT (4697157 -74140516)
2016,Noviembre,República de Corea,0,5,,5,POINT (6170465 -7542726)
2016,Noviembre,Costa de Marfil,0,1,,1,POINT (3451668 -76532004)
2016,Noviembre,Costa de Marfil,5,5,,10,POINT (4697157 -74140516)
2016,Noviembre,Costa Rica,1,7,,8,POINT (10406342 -75527794)
2016,Noviembre,Costa Rica,8,2,,10,POINT (10446304 -75516486)
2016,Noviembre,Costa Rica,9,6,,15,POINT (10886686 -74776479)
2016,Noviembre,Costa Rica,0,1,,1,POINT (11117206 -74232675)
2016,Noviembre,Costa Rica,0,1,,1,POINT (125744111 -81703935)
2016,Noviembre,Costa Rica,197,161,,358,POINT (125862 -81702165)
2016,Noviembre,Costa Rica,18,25,,43,POINT (3451668 -76532004)
2016,Noviembre,Costa Rica,1040,1541,,2581,POINT (4697157 -74140516)
2016,Noviembre,Costa Rica,4,5,,9,POINT (4815189 -75736374)
2016,Noviembre,Costa Rica,57,129,,186,POINT (6170465 -7542726)
2016,Noviembre,Costa Rica,5,2,,7,POINT (7128047 -73181317)
2016,Noviembre,Croacia,1,3,,4,POINT (4697157 -74140516)
2016,Noviembre,Cuba,0,1,,1,POINT (10406342 -75527794)
2016,Noviembre,Cuba,2,3,,5,POINT (10446304 -75516486)
2016,Noviembre,Cuba,2,6,,8,POINT (10886686 -74776479)
2016,Noviembre,Cuba,0,1,,1,POINT (11247723 -74213989)
2016,Noviembre,Cuba,0,5,,5,POINT (125744111 -81703935)
2016,Noviembre,Cuba,1,2,,3,POINT (133387613 -81372937)
2016,Noviembre,Cuba,12,10,,22,POINT (3451668 -76532004)
2016,Noviembre,Cuba,313,560,,873,POINT (4697157 -74140516)
2016,Noviembre,Cuba,4,1,,5,POINT (4815189 -75736374)
2016,Noviembre,Cuba,21,27,,48,POINT (6170465 -7542726)
2016,Noviembre,Cuba,4,2,,6,POINT (7128047 -73181317)
2016,Noviembre,Curazao,1,4,,5,POINT (4697157 -74140516)
2016,Noviembre,Curazao,0,1,,1,POINT (6170465 -7542726)
2016,Noviembre,Curazao,0,1,,1,POINT (125862 -81702165)
2016,Noviembre,Curazao,0,1,,1,POINT (3451668 -76532004)
2016,Noviembre,Curazao,6,5,,11,POINT (4697157 -74140516)
2016,Noviembre,Curazao,0,3,,3,POINT (6170465 -7542726)
2016,Noviembre,Chile,4,15,,19,POINT (10446304 -75516486)
2016,Noviembre,Chile,33,266,,299,POINT (10886686 -74776479)
2016,Noviembre,Chile,39,25,,64,POINT (125862 -81702165)
2016,Noviembre,Chile,30,54,,84,POINT (3451668 -76532004)
2016,Noviembre,Chile,4930,6822,,11752,POINT (4697157 -74140516)
2016,Noviembre,Chile,3,1,,4,POINT (4815189 -75736374)
2016,Noviembre,Chile,20,51,,71,POINT (6170465 -7542726)
2016,Noviembre,China,2,0,,2,POINT (10886686 -74776479)
2016,Noviembre,China,0,1,,1,POINT (3451668 -76532004)
2016,Noviembre,China,47,114,,161,POINT (4697157 -74140516)
2016,Noviembre,China,0,2,,2,POINT (6170465 -7542726)
2016,Noviembre,Dinamarca,2,5,,7,POINT (3451668 -76532004)
2016,Noviembre,Dinamarca,8,25,,33,POINT (4697157 -74140516)
2016,Noviembre,Dinamarca,1,4,,5,POINT (6170465 -7542726)
2016,Noviembre,Dominica,0,4,,4,POINT (10446304 -75516486)
2016,Noviembre,Dominica,0,1,,1,POINT (4697157 -74140516)
2016,Noviembre,Ecuador,1,0,,1,POINT (0.185957 -7478366)
2016,Noviembre,Ecuador,155,366,,521,POINT (0.33002 -76876446)
2016,Noviembre,Ecuador,1,3,,4,POINT (0.812436 -77847006)
2016,Noviembre,Ecuador,4018,5523,,9541,POINT (0.81488 -77356)
2016,Noviembre,Ecuador,36,64,,100,POINT (1800143 -78802679)
2016,Noviembre,Ecuador,72,55,,127,POINT (10446304 -75516486)
2016,Noviembre,Ecuador,0,1,,1,POINT (10886686 -74776479)
2016,Noviembre,Ecuador,1,1,,2,POINT (125862 -81702165)
2016,Noviembre,Ecuador,442,552,,994,POINT (3451668 -76532004)
2016,Noviembre,Ecuador,0,1,,1,POINT (3884426 -77061029)
2016,Noviembre,Ecuador,3192,4730,,7922,POINT (4697157 -74140516)
2016,Noviembre,Ecuador,2,4,,6,POINT (4815189 -75736374)
2016,Noviembre,Ecuador,31,66,,97,POINT (6170465 -7542726)
2016,Noviembre,Egipto,0,2,,2,POINT (4697157 -74140516)
2016,Noviembre,El Salvador,2,2,,4,POINT (10446304 -75516486)
2016,Noviembre,El Salvador,4,0,,4,POINT (10886686 -74776479)
2016,Noviembre,El Salvador,30,21,,51,POINT (125862 -81702165)
2016,Noviembre,El Salvador,109,181,,290,POINT (3451668 -76532004)
2016,Noviembre,El Salvador,1186,1584,,2770,POINT (4697157 -74140516)
2016,Noviembre,El Salvador,1,2,,3,POINT (4815189 -75736374)
2016,Noviembre,El Salvador,207,330,,537,POINT (6170465 -7542726)
2016,Noviembre,El Salvador,0,8,,8,POINT (7128047 -73181317)
2016,Noviembre,Emiratos Árabes,4,8,,12,POINT (4697157 -74140516)
2016,Noviembre,Emiratos Árabes,1,3,,4,POINT (6170465 -7542726)
2016,Noviembre,Eslovaquia,0,2,,2,POINT (3451668 -76532004)
2016,Noviembre,Eslovaquia,1,4,,5,POINT (4697157 -74140516)
2016,Noviembre,Eslovenia,0,1,,1,POINT (3451668 -76532004)
2016,Noviembre,Eslovenia,3,3,,6,POINT (4697157 -74140516)
2016,Noviembre,Estados Unidos de América,9,49,,58,POINT (10406342 -75527794)
2016,Noviembre,Estados Unidos de América,2359,3823,,6182,POINT (10446304 -75516486)
2016,Noviembre,Estados Unidos de América,541,1040,,1581,POINT (10886686 -74776479)
2016,Noviembre,Estados Unidos de América,0,3,,3,POINT (10970933 -74765343)
2016,Noviembre,Estados Unidos de América,0,19,,19,POINT (11247723 -74213989)
2016,Noviembre,Estados Unidos de América,0,4,,4,POINT (125744111 -81703935)
2016,Noviembre,Estados Unidos de América,20,20,,40,POINT (125862 -81702165)
2016,Noviembre,Estados Unidos de América,795,1276,,2071,POINT (3451668 -76532004)
2016,Noviembre,Estados Unidos de América,0,5,,5,POINT (3884426 -77061029)
2016,Noviembre,Estados Unidos de América,99,138,,237,POINT (445285 -75766353)
2016,Noviembre,Estados Unidos de América,8326,14704,,23030,POINT (4697157 -74140516)
2016,Noviembre,Estados Unidos de América,70,139,,209,POINT (4815189 -75736374)
2016,Noviembre,Estados Unidos de América,1666,4273,,5939,POINT (6170465 -7542726)
2016,Noviembre,Estados Unidos de América,23,39,,62,POINT (7128047 -73181317)
2016,Noviembre,Estados Unidos de América,0,6,,6,POINT (7927233 -72508188)
2016,Noviembre,Estados Unidos de América,0,1,,1,POINT (806667 -767333)
2016,Noviembre,Estados Unidos de América,0,20,,20,POINT (9402597 -75681642)
2016,Noviembre,Estonia,3,0,,3,POINT (4697157 -74140516)
2016,Noviembre,Filipinas,0,2,,2,POINT (10446304 -75516486)
2016,Noviembre,Filipinas,0,3,,3,POINT (10886686 -74776479)
2016,Noviembre,Filipinas,0,5,,5,POINT (3451668 -76532004)
2016,Noviembre,Filipinas,4,8,,12,POINT (4697157 -74140516)
2016,Noviembre,Finlandia,5,10,,15,POINT (4697157 -74140516)
2016,Noviembre,Francia,4,3,,7,POINT (10446304 -75516486)
2016,Noviembre,Francia,1,4,,5,POINT (10886686 -74776479)
2016,Noviembre,Francia,0,1,,1,POINT (11247723 -74213989)
2016,Noviembre,Francia,19,34,,53,POINT (3451668 -76532004)
2016,Noviembre,Francia,1195,2147,,3342,POINT (4697157 -74140516)
2016,Noviembre,Francia,10,36,,46,POINT (6170465 -7542726)
2016,Noviembre,Georgia,1,0,,1,POINT (4697157 -74140516)
2016,Noviembre,Ghana,1,0,,1,POINT (3451668 -76532004)
2016,Noviembre,Ghana,1,1,,2,POINT (4697157 -74140516)
2016,Noviembre,Gibraltar/Territorio Británico de Ultramar,1,2,,3,POINT (0.81488 -77356)
2016,Noviembre,Gibraltar/Territorio Británico de Ultramar,0,1,,1,POINT (3451668 -76532004)
2016,Noviembre,Grecia,1,0,,1,POINT (10446304 -75516486)
2016,Noviembre,Grecia,4,11,,15,POINT (4697157 -74140516)
2016,Noviembre,Grecia,0,3,,3,POINT (6170465 -7542726)
2016,Noviembre,Groenlandia,1,0,,1,POINT (4697157 -74140516)
2016,Noviembre,Guatemala,0,1,,1,POINT (10406342 -75527794)
2016,Noviembre,Guatemala,7,10,,17,POINT (10446304 -75516486)
2016,Noviembre,Guatemala,5,5,,10,POINT (10886686 -74776479)
2016,Noviembre,Guatemala,11,7,,18,POINT (125862 -81702165)
2016,Noviembre,Guatemala,3,3,,6,POINT (133387613 -81372937)
2016,Noviembre,Guatemala,33,44,,77,POINT (3451668 -76532004)
2016,Noviembre,Guatemala,530,788,,1318,POINT (4697157 -74140516)
2016,Noviembre,Guatemala,3,11,,14,POINT (4815189 -75736374)
2016,Noviembre,Guatemala,34,72,,106,POINT (6170465 -7542726)
2016,Noviembre,Guatemala,3,1,,4,POINT (7128047 -73181317)
2016,Noviembre,Guyana,0,1,,1,POINT (10406342 -75527794)
2016,Noviembre,Guyana,1,2,,3,POINT (4697157 -74140516)
2016,Noviembre,Guyana,0,2,,2,POINT (6170465 -7542726)
2016,Noviembre,Guadalupe/Territorio Francés,0,1,,1,POINT (3451668 -76532004)
2016,Noviembre,Guadalupe/Territorio Francés,1,2,,3,POINT (4697157 -74140516)
2016,Noviembre,Guadalupe/Territorio Francés,0,1,,1,POINT (6170465 -7542726)
2016,Noviembre,Haití,6,2,,8,POINT (4697157 -74140516)
2016,Noviembre,Honduras,0,1,,1,POINT (10446304 -75516486)
2016,Noviembre,Honduras,3,1,,4,POINT (10886686 -74776479)
2016,Noviembre,Honduras,11,18,,29,POINT (3451668 -76532004)
2016,Noviembre,Honduras,90,110,,200,POINT (4697157 -74140516)
2016,Noviembre,Honduras,6,2,,8,POINT (4815189 -75736374)
2016,Noviembre,Honduras,36,54,,90,POINT (6170465 -7542726)
2016,Noviembre,Honduras,0,1,,1,POINT (7128047 -73181317)
2016,Noviembre,Hong Kong,0,1,,1,POINT (4697157 -74140516)
2016,Noviembre,Hungría,2,10,,12,POINT (4697157 -74140516)
2016,Noviembre,Hungría,0,2,,2,POINT (6170465 -7542726)
2016,Noviembre,India,0,2,,2,POINT (10446304 -75516486)
2016,Noviembre,India,0,3,,3,POINT (10886686 -74776479)
2016,Noviembre,India,0,2,,2,POINT (3451668 -76532004)
2016,Noviembre,India,6,38,,44,POINT (4697157 -74140516)
2016,Noviembre,India,0,1,,1,POINT (4815189 -75736374)
2016,Noviembre,India,0,6,,6,POINT (6170465 -7542726)
2016,Noviembre,Indonesia,0,1,,1,POINT (10886686 -74776479)
2016,Noviembre,Indonesia,2,0,,2,POINT (3451668 -76532004)
2016,Noviembre,Indonesia,2,3,,5,POINT (4697157 -74140516)
2016,Noviembre,Iraq,0,1,,1,POINT (4697157 -74140516)
2016,Noviembre,Irán,0,2,,2,POINT (4697157 -74140516)
2016,Noviembre,República de Irlanda,0,1,,1,POINT (3451668 -76532004)
2016,Noviembre,República de Irlanda,5,15,,20,POINT (4697157 -74140516)
2016,Noviembre,República de Irlanda,0,3,,3,POINT (6170465 -7542726)
2016,Noviembre,República de Irlanda,0,1,,1,POINT (7128047 -73181317)
2016,Noviembre,Islandia,1,1,,2,POINT (4697157 -74140516)
2016,Noviembre,Israel,0,1,,1,POINT (10886686 -74776479)
2016,Noviembre,Israel,1,4,,5,POINT (3451668 -76532004)
2016,Noviembre,Israel,27,61,,88,POINT (4697157 -74140516)
2016,Noviembre,Israel,0,7,,7,POINT (6170465 -7542726)
2016,Noviembre,Italia,3,2,,5,POINT (10886686 -74776479)
2016,Noviembre,Italia,19,51,,70,POINT (3451668 -76532004)
2016,Noviembre,Italia,127,317,,444,POINT (4697157 -74140516)
2016,Noviembre,Italia,1,0,,1,POINT (4815189 -75736374)
2016,Noviembre,Italia,23,47,,70,POINT (6170465 -7542726)
2016,Noviembre,Jamaica,2,10,,12,POINT (10406342 -75527794)
2016,Noviembre,Jamaica,0,2,,2,POINT (10446304 -75516486)
2016,Noviembre,Jamaica,0,5,,5,POINT (10886686 -74776479)
2016,Noviembre,Jamaica,0,1,,1,POINT (3451668 -76532004)
2016,Noviembre,Jamaica,5,13,,18,POINT (4697157 -74140516)
2016,Noviembre,Jamaica,0,3,,3,POINT (6170465 -7542726)
2016,Noviembre,Japón,1,0,,1,POINT (10886686 -74776479)
2016,Noviembre,Japón,2,0,,2,POINT (3451668 -76532004)
2016,Noviembre,Japón,9,20,,29,POINT (4697157 -74140516)
2016,Noviembre,Japón,7,3,,10,POINT (6170465 -7542726)
2016,Noviembre,Jordania,0,2,,2,POINT (4697157 -74140516)
2016,Noviembre,Kenia,1,1,,2,POINT (3451668 -76532004)
2016,Noviembre,Kenia,5,2,,7,POINT (4697157 -74140516)
2016,Noviembre,Kuwait,0,1,,1,POINT (6170465 -7542726)
2016,Noviembre,Lesoto,0,1,,1,POINT (6170465 -7542726)
2016,Noviembre,Letonia,5,3,,8,POINT (4697157 -74140516)
2016,Noviembre,Lituania,5,2,,7,POINT (4697157 -74140516)
2016,Noviembre,Líbano,5,6,,11,POINT (4697157 -74140516)
2016,Noviembre,Liechtenstein,0,1,,1,POINT (6170465 -7542726)
2016,Noviembre,Luxemburgo,1,3,,4,POINT (4697157 -74140516)
2016,Noviembre,Malasia,0,4,,4,POINT (4697157 -74140516)
2016,Noviembre,Malasia,2,2,,4,POINT (6170465 -7542726)
2016,Noviembre,Malí,0,2,,2,POINT (4697157 -74140516)
2016,Noviembre,Malta,1,2,,3,POINT (4697157 -74140516)
2016,Noviembre,Marruecos,1,0,,1,POINT (4697157 -74140516)
2016,Noviembre,Marruecos,0,1,,1,POINT (6170465 -7542726)
2016,Noviembre,Martinica/Departamento de Ultramar Francés,1,1,,2,POINT (10406342 -75527794)
2016,Noviembre,México,0,2,,2,POINT (10406342 -75527794)
2016,Noviembre,México,10,36,,46,POINT (10446304 -75516486)
2016,Noviembre,México,13,33,,46,POINT (10886686 -74776479)
2016,Noviembre,México,2,7,,9,POINT (125862 -81702165)
2016,Noviembre,México,75,189,,264,POINT (3451668 -76532004)
2016,Noviembre,México,4855,8681,,13536,POINT (4697157 -74140516)
2016,Noviembre,México,7,17,,24,POINT (4815189 -75736374)
2016,Noviembre,México,423,1109,,1532,POINT (6170465 -7542726)
2016,Noviembre,México,4,12,,16,POINT (7128047 -73181317)
2016,Noviembre,Mónaco,1,2,,3,POINT (4697157 -74140516)
2016,Noviembre,Mozambique,0,1,,1,POINT (4697157 -74140516)
2016,Noviembre,Myanmar,0,1,,1,POINT (10886686 -74776479)
2016,Noviembre,Myanmar,1,0,,1,POINT (4697157 -74140516)
2016,Noviembre,Nauru,0,1,,1,POINT (4697157 -74140516)
2016,Noviembre,Nepal,0,1,,1,POINT (4697157 -74140516)
2016,Noviembre,Nicaragua,0,1,,1,POINT (10406342 -75527794)
2016,Noviembre,Nicaragua,1,1,,2,POINT (10446304 -75516486)
2016,Noviembre,Nicaragua,0,1,,1,POINT (10886686 -74776479)
2016,Noviembre,Nicaragua,7,16,,23,POINT (3451668 -76532004)
2016,Noviembre,Nicaragua,0,2,,2,POINT (3884426 -77061029)
2016,Noviembre,Nicaragua,44,33,,77,POINT (4697157 -74140516)
2016,Noviembre,Nicaragua,3,2,,5,POINT (4815189 -75736374)
2016,Noviembre,Nicaragua,10,6,,16,POINT (6170465 -7542726)
2016,Noviembre,Nicaragua,1,1,,2,POINT (7128047 -73181317)
2016,Noviembre,Nigeria,0,1,,1,POINT (4697157 -74140516)
2016,Noviembre,Nigeria,0,1,,1,POINT (6170465 -7542726)
2016,Noviembre,Noruega,0,1,,1,POINT (10886686 -74776479)
2016,Noviembre,Noruega,3,5,,8,POINT (3451668 -76532004)
2016,Noviembre,Noruega,23,35,,58,POINT (4697157 -74140516)
2016,Noviembre,Noruega,2,2,,4,POINT (6170465 -7542726)
2016,Noviembre,Nueva Zelanda,0,1,,1,POINT (3451668 -76532004)
2016,Noviembre,Nueva Zelanda,4,2,,6,POINT (4697157 -74140516)
2016,Noviembre,Nueva Zelanda,2,7,,9,POINT (6170465 -7542726)
2016,Noviembre,Panamá,723,663,,1386,POINT (10406342 -75527794)
2016,Noviembre,Panamá,3147,3557,,6704,POINT (10446304 -75516486)
2016,Noviembre,Panamá,241,575,,816,POINT (10886686 -74776479)
2016,Noviembre,Panamá,0,80,,80,POINT (10970933 -74765343)
2016,Noviembre,Panamá,2,2,,4,POINT (11247723 -74213989)
2016,Noviembre,Panamá,5,7,,12,POINT (125744111 -81703935)
2016,Noviembre,Panamá,532,399,,931,POINT (125862 -81702165)
2016,Noviembre,Panamá,2,2,,4,POINT (133387613 -81372937)
2016,Noviembre,Panamá,403,644,,1047,POINT (3451668 -76532004)
2016,Noviembre,Panamá,0,17,,17,POINT (3884426 -77061029)
2016,Noviembre,Panamá,63,67,,130,POINT (445285 -75766353)
2016,Noviembre,Panamá,5151,6778,,11929,POINT (4697157 -74140516)
2016,Noviembre,Panamá,68,126,,194,POINT (4815189 -75736374)
2016,Noviembre,Panamá,3029,3613,,6642,POINT (6170465 -7542726)
2016,Noviembre,Panamá,0,4,,4,POINT (7102626 -77762647)
2016,Noviembre,Panamá,8,10,,18,POINT (7128047 -73181317)
2016,Noviembre,Panamá,0,3,,3,POINT (7927233 -72508188)
2016,Noviembre,Panamá,98,114,,212,POINT (863337 -7735002)
2016,Noviembre,Paraguay,4,2,,6,POINT (10446304 -75516486)
2016,Noviembre,Paraguay,2,5,,7,POINT (10886686 -74776479)
2016,Noviembre,Paraguay,22,17,,39,POINT (125862 -81702165)
2016,Noviembre,Paraguay,3,3,,6,POINT (3451668 -76532004)
2016,Noviembre,Paraguay,66,75,,141,POINT (4697157 -74140516)
2016,Noviembre,Paraguay,2,1,,3,POINT (4815189 -75736374)
2016,Noviembre,Paraguay,39,98,,137,POINT (6170465 -7542726)
2016,Noviembre,Perú,135,162,,297,POINT (-4191162 -69941498)
2016,Noviembre,Perú,0,10,,10,POINT (0.81488 -77356)
2016,Noviembre,Perú,0,5,,5,POINT (10406342 -75527794)
2016,Noviembre,Perú,10,6,,16,POINT (10446304 -75516486)
2016,Noviembre,Perú,2,4,,6,POINT (10886686 -74776479)
2016,Noviembre,Perú,134,86,,220,POINT (125862 -81702165)
2016,Noviembre,Perú,284,462,,746,POINT (3451668 -76532004)
2016,Noviembre,Perú,0,2,,2,POINT (3884426 -77061029)
2016,Noviembre,Perú,6279,8399,,14678,POINT (4697157 -74140516)
2016,Noviembre,Perú,0,3,,3,POINT (4815189 -75736374)
2016,Noviembre,Perú,453,757,,1210,POINT (6170465 -7542726)
2016,Noviembre,Polonia,27,32,,59,POINT (4697157 -74140516)
2016,Noviembre,Polonia,0,3,,3,POINT (6170465 -7542726)
2016,Noviembre,Portugal,1,0,,1,POINT (10886686 -74776479)
2016,Noviembre,Portugal,1,0,,1,POINT (125862 -81702165)
2016,Noviembre,Portugal,0,4,,4,POINT (3451668 -76532004)
2016,Noviembre,Portugal,32,68,,100,POINT (4697157 -74140516)
2016,Noviembre,Portugal,2,8,,10,POINT (6170465 -7542726)
2016,Noviembre,Puerto Rico/Territorio de Estados Unidos,0,5,,5,POINT (10446304 -75516486)
2016,Noviembre,Puerto Rico/Territorio de Estados Unidos,6,46,,52,POINT (10886686 -74776479)
2016,Noviembre,Puerto Rico/Territorio de Estados Unidos,0,3,,3,POINT (125862 -81702165)
2016,Noviembre,Puerto Rico/Territorio de Estados Unidos,24,28,,52,POINT (3451668 -76532004)
2016,Noviembre,Puerto Rico/Territorio de Estados Unidos,465,573,,1038,POINT (4697157 -74140516)
2016,Noviembre,Puerto Rico/Territorio de Estados Unidos,1,7,,8,POINT (4815189 -75736374)
2016,Noviembre,Puerto Rico/Territorio de Estados Unidos,43,92,,135,POINT (6170465 -7542726)
2016,Noviembre,Puerto Rico/Territorio de Estados Unidos,4,6,,10,POINT (7128047 -73181317)
2016,Noviembre,Reino Unido de Gran Bretaña e Irlanda del Norte,0,1,,1,POINT (10446304 -75516486)
2016,Noviembre,Reino Unido de Gran Bretaña e Irlanda del Norte,1,3,,4,POINT (10886686 -74776479)
2016,Noviembre,Reino Unido de Gran Bretaña e Irlanda del Norte,4,9,,13,POINT (3451668 -76532004)
2016,Noviembre,Reino Unido de Gran Bretaña e Irlanda del Norte,698,1416,,2114,POINT (4697157 -74140516)
2016,Noviembre,Reino Unido de Gran Bretaña e Irlanda del Norte,0,1,,1,POINT (4815189 -75736374)
2016,Noviembre,Reino Unido de Gran Bretaña e Irlanda del Norte,24,36,,60,POINT (6170465 -7542726)
2016,Noviembre,Federación de Rusia,3,0,,3,POINT (3451668 -76532004)
2016,Noviembre,Federación de Rusia,25,38,,63,POINT (4697157 -74140516)
2016,Noviembre,Federación de Rusia,1,1,,2,POINT (6170465 -7542726)
2016,Noviembre,República Dominicana,1,11,,12,POINT (10406342 -75527794)
2016,Noviembre,República Dominicana,6,12,,18,POINT (10446304 -75516486)
2016,Noviembre,República Dominicana,11,23,,34,POINT (10886686 -74776479)
2016,Noviembre,República Dominicana,1,1,,2,POINT (125862 -81702165)
2016,Noviembre,República Dominicana,12,32,,44,POINT (3451668 -76532004)
2016,Noviembre,República Dominicana,881,1127,,2008,POINT (4697157 -74140516)
2016,Noviembre,República Dominicana,4,5,,9,POINT (4815189 -75736374)
2016,Noviembre,República Dominicana,41,79,,120,POINT (6170465 -7542726)
2016,Noviembre,República Dominicana,5,9,,14,POINT (7128047 -73181317)
2016,Noviembre,Rumania,4,8,,12,POINT (4697157 -74140516)
2016,Noviembre,Rumania,2,0,,2,POINT (6170465 -7542726)
2016,Noviembre,Rwanda,1,0,,1,POINT (4697157 -74140516)
2016,Noviembre,San Cristóbal y Nevis,1,0,,1,POINT (3451668 -76532004)
2016,Noviembre,Santa Lucia,0,1,,1,POINT (3451668 -76532004)
2016,Noviembre,Santa Lucia,0,1,,1,POINT (4697157 -74140516)
2016,Noviembre,Senegal,0,1,,1,POINT (4697157 -74140516)
2016,Noviembre,Singapur,0,1,,1,POINT (3451668 -76532004)
2016,Noviembre,Singapur,4,4,,8,POINT (4697157 -74140516)
2016,Noviembre,Sri Lanka,0,1,,1,POINT (4697157 -74140516)
2016,Noviembre,Sudáfrica,2,7,,9,POINT (4697157 -74140516)
2016,Noviembre,Suecia,6,8,,14,POINT (3451668 -76532004)
2016,Noviembre,Suecia,20,27,,47,POINT (4697157 -74140516)
2016,Noviembre,Suecia,8,6,,14,POINT (6170465 -7542726)
2016,Noviembre,Suiza,0,1,,1,POINT (10446304 -75516486)
2016,Noviembre,Suiza,0,1,,1,POINT (10886686 -74776479)
2016,Noviembre,Suiza,5,10,,15,POINT (3451668 -76532004)
2016,Noviembre,Suiza,71,99,,170,POINT (4697157 -74140516)
2016,Noviembre,Suiza,12,25,,37,POINT (6170465 -7542726)
2016,Noviembre,Suiza,1,0,,1,POINT (7128047 -73181317)
2016,Noviembre,Surinam,0,2,,2,POINT (6170465 -7542726)
2016,Noviembre,Taiwán,0,2,,2,POINT (4697157 -74140516)
2016,Noviembre,Taiwán,0,2,,2,POINT (6170465 -7542726)
2016,Noviembre,Tailandia,7,5,,12,POINT (4697157 -74140516)
2016,Noviembre,Trinidad y Tobago,0,127,,127,POINT (10406342 -75527794)
2016,Noviembre,Trinidad y Tobago,0,1,,1,POINT (10446304 -75516486)
2016,Noviembre,Trinidad y Tobago,0,1,,1,POINT (10886686 -74776479)
2016,Noviembre,Trinidad y Tobago,0,1,,1,POINT (125862 -81702165)
2016,Noviembre,Trinidad y Tobago,2,1,,3,POINT (3451668 -76532004)
2016,Noviembre,Trinidad y Tobago,6,8,,14,POINT (4697157 -74140516)
2016,Noviembre,Trinidad y Tobago,1,1,,2,POINT (4815189 -75736374)
2016,Noviembre,Trinidad y Tobago,1,10,,11,POINT (6170465 -7542726)
2016,Noviembre,Trinidad y Tobago,2,2,,4,POINT (7128047 -73181317)
2016,Noviembre,Túnez,0,1,,1,POINT (4697157 -74140516)
2016,Noviembre,Turkmenistán,6,11,,17,POINT (4697157 -74140516)
2016,Noviembre,Turquía,0,1,,1,POINT (3451668 -76532004)
2016,Noviembre,Turquía,317,615,,932,POINT (4697157 -74140516)
2016,Noviembre,Turquía,0,1,,1,POINT (6170465 -7542726)
2016,Noviembre,Ucrania,0,1,,1,POINT (10886686 -74776479)
2016,Noviembre,Ucrania,1,4,,5,POINT (4697157 -74140516)
2016,Noviembre,Ucrania,0,2,,2,POINT (6170465 -7542726)
2016,Noviembre,Uganda,1,0,,1,POINT (3451668 -76532004)
2016,Noviembre,Uganda,0,1,,1,POINT (4697157 -74140516)
2016,Noviembre,Uruguay,2,0,,2,POINT (10446304 -75516486)
2016,Noviembre,Uruguay,3,2,,5,POINT (10886686 -74776479)
2016,Noviembre,Uruguay,18,12,,30,POINT (125862 -81702165)
2016,Noviembre,Uruguay,9,16,,25,POINT (3451668 -76532004)
2016,Noviembre,Uruguay,106,128,,234,POINT (4697157 -74140516)
2016,Noviembre,Uruguay,0,3,,3,POINT (4815189 -75736374)
2016,Noviembre,Uruguay,24,49,,73,POINT (6170465 -7542726)
2016,Noviembre,Venezuela,0,4,,4,POINT (10406342 -75527794)
2016,Noviembre,Venezuela,7,17,,24,POINT (10446304 -75516486)
2016,Noviembre,Venezuela,31,65,,96,POINT (10886686 -74776479)
2016,Noviembre,Venezuela,0,11,,11,POINT (11117206 -74232675)
2016,Noviembre,Venezuela,4334,5075,,9409,POINT (11360029 -72129595)
2016,Noviembre,Venezuela,2,0,,2,POINT (125862 -81702165)
2016,Noviembre,Venezuela,9,54,,63,POINT (3451668 -76532004)
2016,Noviembre,Venezuela,44,36,,80,POINT (3866713 -67927521)
2016,Noviembre,Venezuela,3419,4073,,7492,POINT (4697157 -74140516)
2016,Noviembre,Venezuela,3,3,,6,POINT (4815189 -75736374)
2016,Noviembre,Venezuela,563,570,,1133,POINT (6170465 -7542726)
2016,Noviembre,Venezuela,785,1024,,1809,POINT (6185536 -67484028)
2016,Noviembre,Venezuela,117,161,,278,POINT (7088729 -70740253)
2016,Noviembre,Venezuela,2,7,,9,POINT (7128047 -73181317)
2016,Noviembre,Venezuela,6800,8672,,15472,POINT (7819 -72453013)
2016,Noviembre,Venezuela,75,75,,150,POINT (836068 -72409396)
2016,Noviembre,Vietnam,4,5,,9,POINT (4697157 -74140516)
2016,Noviembre,Islas Vírgenes Estadounidenses/Territorio de Estados Unidos,1,7,,8,POINT (10406342 -75527794)
2016,Noviembre,Zambia,0,1,,1,POINT (3451668 -76532004)
2016,Noviembre,Zimbabue,1,0,,1,POINT (3451668 -76532004)
2016,Noviembre,Zimbabue,1,0,,1,POINT (4697157 -74140516)
2016,Diciembre,Afganistán,1,1,,2,POINT (4697157 -74140516)
2016,Diciembre,Albania,1,0,,1,POINT (4697157 -74140516)
2016,Diciembre,Alemania,1,1,,2,POINT (0.81488 -77356)
2016,Diciembre,Alemania,1,0,,1,POINT (10446304 -75516486)
2016,Diciembre,Alemania,7,19,,26,POINT (10886686 -74776479)
2016,Diciembre,Alemania,0,2,,2,POINT (10970933 -74765343)
2016,Diciembre,Alemania,3,1,,4,POINT (125862 -81702165)
2016,Diciembre,Alemania,39,71,,110,POINT (3451668 -76532004)
2016,Diciembre,Alemania,1492,2354,,3846,POINT (4697157 -74140516)
2016,Diciembre,Alemania,1,2,,3,POINT (4815189 -75736374)
2016,Diciembre,Alemania,30,49,,79,POINT (6170465 -7542726)
2016,Diciembre,Antigua y Barbuda,0,2,,2,POINT (6170465 -7542726)
2016,Diciembre,Países Bajos,6,27,,33,POINT (10406342 -75527794)
2016,Diciembre,Países Bajos,0,4,,4,POINT (10446304 -75516486)
2016,Diciembre,Países Bajos,97,150,,247,POINT (10886686 -74776479)
2016,Diciembre,Países Bajos,1,1,,2,POINT (10970933 -74765343)
2016,Diciembre,Países Bajos,1,2,,3,POINT (11247723 -74213989)
2016,Diciembre,Países Bajos,126,267,,393,POINT (3451668 -76532004)
2016,Diciembre,Países Bajos,814,1274,,2088,POINT (4697157 -74140516)
2016,Diciembre,Países Bajos,1,6,,7,POINT (4815189 -75736374)
2016,Diciembre,Países Bajos,187,304,,491,POINT (6170465 -7542726)
2016,Diciembre,Países Bajos,0,4,,4,POINT (7128047 -73181317)
2016,Diciembre,Arabia Saudita,1,0,,1,POINT (3451668 -76532004)
2016,Diciembre,Arabia Saudita,1,5,,6,POINT (4697157 -74140516)
2016,Diciembre,Argelia,4,6,,10,POINT (4697157 -74140516)
2016,Diciembre,Argelia,0,1,,1,POINT (6170465 -7542726)
2016,Diciembre,Argentina,3,5,,8,POINT (0.81488 -77356)
2016,Diciembre,Argentina,21,27,,48,POINT (10446304 -75516486)
2016,Diciembre,Argentina,9,20,,29,POINT (10886686 -74776479)
2016,Diciembre,Argentina,103,92,,195,POINT (125862 -81702165)
2016,Diciembre,Argentina,61,58,,119,POINT (3451668 -76532004)
2016,Diciembre,Argentina,3389,4334,,7723,POINT (4697157 -74140516)
2016,Diciembre,Argentina,2,2,,4,POINT (4815189 -75736374)
2016,Diciembre,Argentina,182,276,,458,POINT (6170465 -7542726)
2016,Diciembre,República de Armenia,1,0,,1,POINT (4697157 -74140516)
2016,Diciembre,Aruba,21,35,,56,POINT (10406342 -75527794)
2016,Diciembre,Aruba,23,30,,53,POINT (10446304 -75516486)
2016,Diciembre,Aruba,5,15,,20,POINT (10886686 -74776479)
2016,Diciembre,Aruba,19,30,,49,POINT (11247723 -74213989)
2016,Diciembre,Aruba,6,3,,9,POINT (3451668 -76532004)
2016,Diciembre,Aruba,662,868,,1530,POINT (4697157 -74140516)
2016,Diciembre,Aruba,0,1,,1,POINT (4815189 -75736374)
2016,Diciembre,Aruba,81,102,,183,POINT (6170465 -7542726)
2016,Diciembre,Aruba,8,13,,21,POINT (7128047 -73181317)
2016,Diciembre,Australia,3,2,,5,POINT (10446304 -75516486)
2016,Diciembre,Australia,3,4,,7,POINT (10886686 -74776479)
2016,Diciembre,Australia,6,19,,25,POINT (3451668 -76532004)
2016,Diciembre,Australia,69,95,,164,POINT (4697157 -74140516)
2016,Diciembre,Australia,0,1,,1,POINT (4815189 -75736374)
2016,Diciembre,Australia,22,39,,61,POINT (6170465 -7542726)
2016,Diciembre,Australia,0,1,,1,POINT (7128047 -73181317)
2016,Diciembre,Austria,1,1,,2,POINT (10886686 -74776479)
2016,Diciembre,Austria,3,7,,10,POINT (3451668 -76532004)
2016,Diciembre,Austria,27,45,,72,POINT (4697157 -74140516)
2016,Diciembre,Austria,4,1,,5,POINT (6170465 -7542726)
2016,Diciembre,Bahamas,1,5,,6,POINT (10406342 -75527794)
2016,Diciembre,Bahamas,1,2,,3,POINT (10446304 -75516486)
2016,Diciembre,Bahamas,3,8,,11,POINT (10886686 -74776479)
2016,Diciembre,Bahamas,0,2,,2,POINT (11247723 -74213989)
2016,Diciembre,Bahamas,3,3,,6,POINT (3451668 -76532004)
2016,Diciembre,Bahamas,1,3,,4,POINT (4697157 -74140516)
2016,Diciembre,Bahamas,1,4,,5,POINT (6170465 -7542726)
2016,Diciembre,Bahréin,1,1,,2,POINT (10446304 -75516486)
2016,Diciembre,Bahréin,0,1,,1,POINT (3451668 -76532004)
2016,Diciembre,Bahréin,1,1,,2,POINT (4697157 -74140516)
2016,Diciembre,Bahréin,0,2,,2,POINT (6170465 -7542726)
2016,Diciembre,Barbados,73,82,,155,POINT (4697157 -74140516)
2016,Diciembre,República de Belarús,2,4,,6,POINT (4697157 -74140516)
2016,Diciembre,República de Belarús,0,1,,1,POINT (6170465 -7542726)
2016,Diciembre,República de Belarús,0,1,,1,POINT (7819 -72453013)
2016,Diciembre,Bélgica,0,1,,1,POINT (10446304 -75516486)
2016,Diciembre,Bélgica,2,3,,5,POINT (10886686 -74776479)
2016,Diciembre,Bélgica,9,12,,21,POINT (3451668 -76532004)
2016,Diciembre,Bélgica,56,84,,140,POINT (4697157 -74140516)
2016,Diciembre,Bélgica,10,25,,35,POINT (6170465 -7542726)
2016,Diciembre,Belice,1,1,,2,POINT (133387613 -81372937)
2016,Diciembre,Belice,0,1,,1,POINT (3451668 -76532004)
2016,Diciembre,Belice,0,1,,1,POINT (4697157 -74140516)
2016,Diciembre,Belice,0,3,,3,POINT (6170465 -7542726)
2016,Diciembre,Bermudas/Territorio Británico de Ultramar,1,0,,1,POINT (4697157 -74140516)
2016,Diciembre,Bolivia,2,3,,5,POINT (-4191162 -69941498)
2016,Diciembre,Bolivia,1,0,,1,POINT (0.81488 -77356)
2016,Diciembre,Bolivia,4,4,,8,POINT (10446304 -75516486)
2016,Diciembre,Bolivia,25,16,,41,POINT (125862 -81702165)
2016,Diciembre,Bolivia,7,12,,19,POINT (3451668 -76532004)
2016,Diciembre,Bolivia,717,708,,1425,POINT (4697157 -74140516)
2016,Diciembre,Bolivia,3,1,,4,POINT (4815189 -75736374)
2016,Diciembre,Bolivia,73,97,,170,POINT (6170465 -7542726)
2016,Diciembre,Bolivia,2,0,,2,POINT (7128047 -73181317)
2016,Diciembre,Brasil,274,256,,530,POINT (-4191162 -69941498)
2016,Diciembre,Brasil,0,1,,1,POINT (10406342 -75527794)
2016,Diciembre,Brasil,21,12,,33,POINT (10446304 -75516486)
2016,Diciembre,Brasil,3,3,,6,POINT (10886686 -74776479)
2016,Diciembre,Brasil,479,374,,853,POINT (125862 -81702165)
2016,Diciembre,Brasil,33,54,,87,POINT (3451668 -76532004)
2016,Diciembre,Brasil,2,3,,5,POINT (3866713 -67927521)
2016,Diciembre,Brasil,4941,5769,,10710,POINT (4697157 -74140516)
2016,Diciembre,Brasil,2,2,,4,POINT (4815189 -75736374)
2016,Diciembre,Brasil,62,117,,179,POINT (6170465 -7542726)
2016,Diciembre,Brasil,1,0,,1,POINT (7128047 -73181317)
2016,Diciembre,Bulgaria,1,1,,2,POINT (4697157 -74140516)
2016,Diciembre,Islas Caimán/Territorio Británico de Ultramar,2,3,,5,POINT (10406342 -75527794)
2016,Diciembre,Islas Caimán/Territorio Británico de Ultramar,5,33,,38,POINT (125862 -81702165)
2016,Diciembre,Camerún,5,2,,7,POINT (4697157 -74140516)
2016,Diciembre,Canadá,0,2,,2,POINT (10406342 -75527794)
2016,Diciembre,Canadá,244,271,,515,POINT (10446304 -75516486)
2016,Diciembre,Canadá,22,29,,51,POINT (10886686 -74776479)
2016,Diciembre,Canadá,149,143,,292,POINT (125862 -81702165)
2016,Diciembre,Canadá,96,101,,197,POINT (3451668 -76532004)
2016,Diciembre,Canadá,861,1211,,2072,POINT (4697157 -74140516)
2016,Diciembre,Canadá,13,28,,41,POINT (4815189 -75736374)
2016,Diciembre,Canadá,183,296,,479,POINT (6170465 -7542726)
2016,Diciembre,Canadá,6,16,,22,POINT (7128047 -73181317)
2016,Diciembre,España,3,3,,6,POINT (10406342 -75527794)
2016,Diciembre,España,1,4,,5,POINT (10446304 -75516486)
2016,Diciembre,España,1,6,,7,POINT (10886686 -74776479)
2016,Diciembre,España,711,1099,,1810,POINT (3451668 -76532004)
2016,Diciembre,España,4509,7253,,11762,POINT (4697157 -74140516)
2016,Diciembre,España,1,4,,5,POINT (4815189 -75736374)
2016,Diciembre,España,384,794,,1178,POINT (6170465 -7542726)
2016,Diciembre,República Del Congo,1,0,,1,POINT (4697157 -74140516)
2016,Diciembre,Comoras,0,1,,1,POINT (4697157 -74140516)
2016,Diciembre,República de Corea,0,3,,3,POINT (3451668 -76532004)
2016,Diciembre,República de Corea,10,9,,19,POINT (4697157 -74140516)
2016,Diciembre,República de Corea,0,4,,4,POINT (6170465 -7542726)
2016,Diciembre,Costa de Marfil,1,0,,1,POINT (3451668 -76532004)
2016,Diciembre,Costa de Marfil,5,10,,15,POINT (4697157 -74140516)
2016,Diciembre,Costa de Marfil,0,1,,1,POINT (6170465 -7542726)
2016,Diciembre,Costa Rica,11,28,,39,POINT (10406342 -75527794)
2016,Diciembre,Costa Rica,3,6,,9,POINT (10446304 -75516486)
2016,Diciembre,Costa Rica,23,21,,44,POINT (10886686 -74776479)
2016,Diciembre,Costa Rica,0,2,,2,POINT (125744111 -81703935)
2016,Diciembre,Costa Rica,166,140,,306,POINT (125862 -81702165)
2016,Diciembre,Costa Rica,52,59,,111,POINT (3451668 -76532004)
2016,Diciembre,Costa Rica,1358,1586,,2944,POINT (4697157 -74140516)
2016,Diciembre,Costa Rica,12,18,,30,POINT (4815189 -75736374)
2016,Diciembre,Costa Rica,146,186,,332,POINT (6170465 -7542726)
2016,Diciembre,Costa Rica,8,2,,10,POINT (7128047 -73181317)
2016,Diciembre,Croacia,0,1,,1,POINT (10886686 -74776479)
2016,Diciembre,Croacia,0,3,,3,POINT (3451668 -76532004)
2016,Diciembre,Croacia,3,6,,9,POINT (4697157 -74140516)
2016,Diciembre,Cuba,0,3,,3,POINT (10406342 -75527794)
2016,Diciembre,Cuba,2,5,,7,POINT (10446304 -75516486)
2016,Diciembre,Cuba,5,6,,11,POINT (10886686 -74776479)
2016,Diciembre,Cuba,20,39,,59,POINT (3451668 -76532004)
2016,Diciembre,Cuba,371,712,,1083,POINT (4697157 -74140516)
2016,Diciembre,Cuba,1,2,,3,POINT (4815189 -75736374)
2016,Diciembre,Cuba,14,12,,26,POINT (6170465 -7542726)
2016,Diciembre,Cuba,5,2,,7,POINT (7128047 -73181317)
2016,Diciembre,Curazao,2,3,,5,POINT (4697157 -74140516)
2016,Diciembre,Curazao,0,1,,1,POINT (6170465 -7542726)
2016,Diciembre,República Checa,1,0,,1,POINT (3451668 -76532004)
2016,Diciembre,República Checa,16,19,,35,POINT (4697157 -74140516)
2016,Diciembre,Chile,2,5,,7,POINT (0.81488 -77356)
2016,Diciembre,Chile,0,4,,4,POINT (10406342 -75527794)
2016,Diciembre,Chile,6,6,,12,POINT (10446304 -75516486)
2016,Diciembre,Chile,4,6,,10,POINT (10886686 -74776479)
2016,Diciembre,Chile,106,78,,184,POINT (125862 -81702165)
2016,Diciembre,Chile,57,88,,145,POINT (3451668 -76532004)
2016,Diciembre,Chile,4450,5686,,10136,POINT (4697157 -74140516)
2016,Diciembre,Chile,2,3,,5,POINT (4815189 -75736374)
2016,Diciembre,Chile,38,68,,106,POINT (6170465 -7542726)
2016,Diciembre,Chile,1,1,,2,POINT (7128047 -73181317)
2016,Diciembre,China,0,8,,8,POINT (3451668 -76532004)
2016,Diciembre,China,22,59,,81,POINT (4697157 -74140516)
2016,Diciembre,China,6,4,,10,POINT (6170465 -7542726)
2016,Diciembre,Dinamarca,3,5,,8,POINT (3451668 -76532004)
2016,Diciembre,Dinamarca,22,40,,62,POINT (4697157 -74140516)
2016,Diciembre,Dinamarca,1,2,,3,POINT (6170465 -7542726)
2016,Diciembre,Dinamarca,0,1,,1,POINT (7128047 -73181317)
2016,Diciembre,Dominica,0,1,,1,POINT (4697157 -74140516)
2016,Diciembre,Ecuador,151,363,,514,POINT (0.33002 -76876446)
2016,Diciembre,Ecuador,1,2,,3,POINT (0.812436 -77847006)
2016,Diciembre,Ecuador,4737,6955,,11692,POINT (0.81488 -77356)
2016,Diciembre,Ecuador,62,68,,130,POINT (1800143 -78802679)
2016,Diciembre,Ecuador,0,2,,2,POINT (10406342 -75527794)
2016,Diciembre,Ecuador,1,2,,3,POINT (10446304 -75516486)
2016,Diciembre,Ecuador,2,1,,3,POINT (10886686 -74776479)
2016,Diciembre,Ecuador,9,5,,14,POINT (125862 -81702165)
2016,Diciembre,Ecuador,489,508,,997,POINT (3451668 -76532004)
2016,Diciembre,Ecuador,3235,4135,,7370,POINT (4697157 -74140516)
2016,Diciembre,Ecuador,1,1,,2,POINT (4815189 -75736374)
2016,Diciembre,Ecuador,22,32,,54,POINT (6170465 -7542726)
2016,Diciembre,Ecuador,3,1,,4,POINT (7128047 -73181317)
2016,Diciembre,Egipto,6,15,,21,POINT (4697157 -74140516)
2016,Diciembre,El Salvador,7,10,,17,POINT (10446304 -75516486)
2016,Diciembre,El Salvador,2,1,,3,POINT (10886686 -74776479)
2016,Diciembre,El Salvador,13,18,,31,POINT (125862 -81702165)
2016,Diciembre,El Salvador,134,211,,345,POINT (3451668 -76532004)
2016,Diciembre,El Salvador,1081,1372,,2453,POINT (4697157 -74140516)
2016,Diciembre,El Salvador,2,1,,3,POINT (4815189 -75736374)
2016,Diciembre,El Salvador,194,287,,481,POINT (6170465 -7542726)
2016,Diciembre,El Salvador,0,1,,1,POINT (7128047 -73181317)
2016,Diciembre,Emiratos Árabes,0,1,,1,POINT (10446304 -75516486)
2016,Diciembre,Emiratos Árabes,8,9,,17,POINT (4697157 -74140516)
2016,Diciembre,Eslovaquia,2,3,,5,POINT (4697157 -74140516)
2016,Diciembre,Eslovenia,2,5,,7,POINT (4697157 -74140516)
2016,Diciembre,Eslovenia,0,1,,1,POINT (6170465 -7542726)
2016,Diciembre,Estados Unidos de América,10,66,,76,POINT (10406342 -75527794)
2016,Diciembre,Estados Unidos de América,3384,4699,,8083,POINT (10446304 -75516486)
2016,Diciembre,Estados Unidos de América,853,1422,,2275,POINT (10886686 -74776479)
2016,Diciembre,Estados Unidos de América,0,6,,6,POINT (10970933 -74765343)
2016,Diciembre,Estados Unidos de América,0,1,,1,POINT (11117206 -74232675)
2016,Diciembre,Estados Unidos de América,0,14,,14,POINT (11247723 -74213989)
2016,Diciembre,Estados Unidos de América,48,52,,100,POINT (125862 -81702165)
2016,Diciembre,Estados Unidos de América,1831,2715,,4546,POINT (3451668 -76532004)
2016,Diciembre,Estados Unidos de América,150,194,,344,POINT (445285 -75766353)
2016,Diciembre,Estados Unidos de América,10566,17230,,27796,POINT (4697157 -74140516)
2016,Diciembre,Estados Unidos de América,239,338,,577,POINT (4815189 -75736374)
2016,Diciembre,Estados Unidos de América,3307,6213,,9520,POINT (6170465 -7542726)
2016,Diciembre,Estados Unidos de América,63,85,,148,POINT (7128047 -73181317)
2016,Diciembre,Estados Unidos de América,0,29,,29,POINT (9402597 -75681642)
2016,Diciembre,Estonia,3,0,,3,POINT (4697157 -74140516)
2016,Diciembre,Estonia,0,2,,2,POINT (6170465 -7542726)
2016,Diciembre,Etiopia,0,1,,1,POINT (4697157 -74140516)
2016,Diciembre,Filipinas,0,1,,1,POINT (10446304 -75516486)
2016,Diciembre,Filipinas,0,6,,6,POINT (10886686 -74776479)
2016,Diciembre,Filipinas,0,3,,3,POINT (3451668 -76532004)
2016,Diciembre,Filipinas,0,7,,7,POINT (3884426 -77061029)
2016,Diciembre,Filipinas,3,7,,10,POINT (4697157 -74140516)
2016,Diciembre,Filipinas,0,1,,1,POINT (7128047 -73181317)
2016,Diciembre,Finlandia,0,3,,3,POINT (3451668 -76532004)
2016,Diciembre,Finlandia,13,16,,29,POINT (4697157 -74140516)
2016,Diciembre,Finlandia,0,2,,2,POINT (6170465 -7542726)
2016,Diciembre,Francia,1,3,,4,POINT (10406342 -75527794)
2016,Diciembre,Francia,3,3,,6,POINT (10446304 -75516486)
2016,Diciembre,Francia,3,4,,7,POINT (10886686 -74776479)
2016,Diciembre,Francia,1,0,,1,POINT (125862 -81702165)
2016,Diciembre,Francia,61,102,,163,POINT (3451668 -76532004)
2016,Diciembre,Francia,1505,2540,,4045,POINT (4697157 -74140516)
2016,Diciembre,Francia,1,3,,4,POINT (4815189 -75736374)
2016,Diciembre,Francia,26,62,,88,POINT (6170465 -7542726)
2016,Diciembre,Gabón,0,1,,1,POINT (4697157 -74140516)
2016,Diciembre,Georgia,0,1,,1,POINT (4697157 -74140516)
2016,Diciembre,Ghana,0,1,,1,POINT (3451668 -76532004)
2016,Diciembre,Ghana,0,1,,1,POINT (4697157 -74140516)
2016,Diciembre,Gibraltar/Territorio Británico de Ultramar,1,1,,2,POINT (0.81488 -77356)
2016,Diciembre,Grecia,0,1,,1,POINT (3451668 -76532004)
2016,Diciembre,Grecia,8,15,,23,POINT (4697157 -74140516)
2016,Diciembre,Grecia,1,1,,2,POINT (6170465 -7542726)
2016,Diciembre,Groenlandia,0,2,,2,POINT (4697157 -74140516)
2016,Diciembre,Guatemala,1,2,,3,POINT (10406342 -75527794)
2016,Diciembre,Guatemala,3,2,,5,POINT (10446304 -75516486)
2016,Diciembre,Guatemala,6,5,,11,POINT (10886686 -74776479)
2016,Diciembre,Guatemala,92,83,,175,POINT (125862 -81702165)
2016,Diciembre,Guatemala,31,35,,66,POINT (3451668 -76532004)
2016,Diciembre,Guatemala,0,6,,6,POINT (3884426 -77061029)
2016,Diciembre,Guatemala,429,563,,992,POINT (4697157 -74140516)
2016,Diciembre,Guatemala,7,2,,9,POINT (4815189 -75736374)
2016,Diciembre,Guatemala,80,133,,213,POINT (6170465 -7542726)
2016,Diciembre,Guatemala,1,1,,2,POINT (7128047 -73181317)
2016,Diciembre,Guyana,4,3,,7,POINT (4697157 -74140516)
2016,Diciembre,Guyana,0,1,,1,POINT (806667 -767333)
2016,Diciembre,Guinea Ecuatorial,0,1,,1,POINT (4697157 -74140516)
2016,Diciembre,Guadalupe/Territorio Francés,1,2,,3,POINT (4697157 -74140516)
2016,Diciembre,Guadalupe/Territorio Francés,1,0,,1,POINT (6170465 -7542726)
2016,Diciembre,Haití,0,2,,2,POINT (3451668 -76532004)
2016,Diciembre,Haití,1,2,,3,POINT (4697157 -74140516)
2016,Diciembre,Haití,0,1,,1,POINT (4815189 -75736374)
2016,Diciembre,Haití,1,1,,2,POINT (6170465 -7542726)
2016,Diciembre,Haití,0,1,,1,POINT (7128047 -73181317)
2016,Diciembre,Honduras,1,1,,2,POINT (10446304 -75516486)
2016,Diciembre,Honduras,2,2,,4,POINT (125862 -81702165)
2016,Diciembre,Honduras,3,3,,6,POINT (133387613 -81372937)
2016,Diciembre,Honduras,30,42,,72,POINT (3451668 -76532004)
2016,Diciembre,Honduras,61,73,,134,POINT (4697157 -74140516)
2016,Diciembre,Honduras,1,1,,2,POINT (4815189 -75736374)
2016,Diciembre,Honduras,49,45,,94,POINT (6170465 -7542726)
2016,Diciembre,Honduras,1,1,,2,POINT (7128047 -73181317)
2016,Diciembre,Hong Kong,1,5,,6,POINT (4697157 -74140516)
2016,Diciembre,Hong Kong,1,0,,1,POINT (6170465 -7542726)
2016,Diciembre,Hungría,9,3,,12,POINT (4697157 -74140516)
2016,Diciembre,Hungría,0,1,,1,POINT (6170465 -7542726)
2016,Diciembre,India,0,2,,2,POINT (10446304 -75516486)
2016,Diciembre,India,0,2,,2,POINT (11247723 -74213989)
2016,Diciembre,India,1,1,,2,POINT (3451668 -76532004)
2016,Diciembre,India,5,26,,31,POINT (4697157 -74140516)
2016,Diciembre,India,0,4,,4,POINT (4815189 -75736374)
2016,Diciembre,India,5,3,,8,POINT (6170465 -7542726)
2016,Diciembre,Indonesia,0,1,,1,POINT (10886686 -74776479)
2016,Diciembre,Indonesia,0,4,,4,POINT (4697157 -74140516)
2016,Diciembre,Irán,0,1,,1,POINT (3451668 -76532004)
2016,Diciembre,República de Irlanda,1,5,,6,POINT (3451668 -76532004)
2016,Diciembre,República de Irlanda,11,14,,25,POINT (4697157 -74140516)
2016,Diciembre,República de Irlanda,2,2,,4,POINT (6170465 -7542726)
2016,Diciembre,República de Irlanda,0,1,,1,POINT (7128047 -73181317)
2016,Diciembre,Islandia,1,2,,3,POINT (4697157 -74140516)
2016,Diciembre,Islandia,0,1,,1,POINT (6170465 -7542726)
2016,Diciembre,Israel,0,1,,1,POINT (10886686 -74776479)
2016,Diciembre,Israel,4,1,,5,POINT (3451668 -76532004)
2016,Diciembre,Israel,24,46,,70,POINT (4697157 -74140516)
2016,Diciembre,Israel,2,4,,6,POINT (6170465 -7542726)
2016,Diciembre,Italia,0,2,,2,POINT (10446304 -75516486)
2016,Diciembre,Italia,3,0,,3,POINT (10886686 -74776479)
2016,Diciembre,Italia,0,1,,1,POINT (125862 -81702165)
2016,Diciembre,Italia,23,74,,97,POINT (3451668 -76532004)
2016,Diciembre,Italia,217,446,,663,POINT (4697157 -74140516)
2016,Diciembre,Italia,1,3,,4,POINT (4815189 -75736374)
2016,Diciembre,Italia,32,54,,86,POINT (6170465 -7542726)
2016,Diciembre,Italia,1,1,,2,POINT (7128047 -73181317)
2016,Diciembre,Jamaica,1,19,,20,POINT (10406342 -75527794)
2016,Diciembre,Jamaica,1,40,,41,POINT (10446304 -75516486)
2016,Diciembre,Jamaica,0,2,,2,POINT (10886686 -74776479)
2016,Diciembre,Jamaica,0,2,,2,POINT (125862 -81702165)
2016,Diciembre,Jamaica,0,4,,4,POINT (3451668 -76532004)
2016,Diciembre,Jamaica,3,10,,13,POINT (4697157 -74140516)
2016,Diciembre,Jamaica,1,3,,4,POINT (6170465 -7542726)
2016,Diciembre,Japón,1,0,,1,POINT (10886686 -74776479)
2016,Diciembre,Japón,6,10,,16,POINT (3451668 -76532004)
2016,Diciembre,Japón,22,31,,53,POINT (4697157 -74140516)
2016,Diciembre,Japón,5,5,,10,POINT (6170465 -7542726)
2016,Diciembre,Jordania,1,2,,3,POINT (4697157 -74140516)
2016,Diciembre,Kenia,2,0,,2,POINT (4697157 -74140516)
2016,Diciembre,Kuwait,0,1,,1,POINT (3451668 -76532004)
2016,Diciembre,Letonia,0,1,,1,POINT (10446304 -75516486)
2016,Diciembre,Letonia,2,0,,2,POINT (4697157 -74140516)
2016,Diciembre,Lituania,3,2,,5,POINT (4697157 -74140516)
2016,Diciembre,Líbano,5,7,,12,POINT (4697157 -74140516)
2016,Diciembre,Luxemburgo,1,2,,3,POINT (3451668 -76532004)
2016,Diciembre,Luxemburgo,0,3,,3,POINT (4697157 -74140516)
2016,Diciembre,Madagascar,1,0,,1,POINT (4697157 -74140516)
2016,Diciembre,Malasia,0,2,,2,POINT (4697157 -74140516)
2016,Diciembre,Malasia,0,2,,2,POINT (6170465 -7542726)
2016,Diciembre,Malta,2,4,,6,POINT (4697157 -74140516)
2016,Diciembre,Malta,0,1,,1,POINT (6170465 -7542726)
2016,Diciembre,Marruecos,3,4,,7,POINT (4697157 -74140516)
2016,Diciembre,Martinica/Departamento de Ultramar Francés,0,1,,1,POINT (7128047 -73181317)
2016,Diciembre,México,0,6,,6,POINT (10406342 -75527794)
2016,Diciembre,México,16,18,,34,POINT (10446304 -75516486)
2016,Diciembre,México,16,38,,54,POINT (10886686 -74776479)
2016,Diciembre,México,0,2,,2,POINT (125862 -81702165)
2016,Diciembre,México,82,141,,223,POINT (3451668 -76532004)
2016,Diciembre,México,0,2,,2,POINT (3884426 -77061029)
2016,Diciembre,México,5630,8033,,13663,POINT (4697157 -74140516)
2016,Diciembre,México,23,37,,60,POINT (4815189 -75736374)
2016,Diciembre,México,523,1090,,1613,POINT (6170465 -7542726)
2016,Diciembre,México,13,29,,42,POINT (7128047 -73181317)
2016,Diciembre,Mónaco,0,1,,1,POINT (3451668 -76532004)
2016,Diciembre,Mónaco,1,0,,1,POINT (4697157 -74140516)
2016,Diciembre,Myanmar,1,0,,1,POINT (4697157 -74140516)
2016,Diciembre,Namibia,1,1,,2,POINT (4697157 -74140516)
2016,Diciembre,Nicaragua,2,3,,5,POINT (10446304 -75516486)
2016,Diciembre,Nicaragua,2,0,,2,POINT (10886686 -74776479)
2016,Diciembre,Nicaragua,1,2,,3,POINT (125862 -81702165)
2016,Diciembre,Nicaragua,9,10,,19,POINT (3451668 -76532004)
2016,Diciembre,Nicaragua,33,28,,61,POINT (4697157 -74140516)
2016,Diciembre,Nicaragua,1,1,,2,POINT (4815189 -75736374)
2016,Diciembre,Nicaragua,6,19,,25,POINT (6170465 -7542726)
2016,Diciembre,Nicaragua,0,3,,3,POINT (7128047 -73181317)
2016,Diciembre,Nigeria,1,0,,1,POINT (3451668 -76532004)
2016,Diciembre,Noruega,9,14,,23,POINT (3451668 -76532004)
2016,Diciembre,Noruega,25,35,,60,POINT (4697157 -74140516)
2016,Diciembre,Noruega,4,6,,10,POINT (6170465 -7542726)
2016,Diciembre,Nueva Zelanda,9,10,,19,POINT (4697157 -74140516)
2016,Diciembre,Nueva Zelanda,0,2,,2,POINT (6170465 -7542726)
2016,Diciembre,Omán,0,1,,1,POINT (4697157 -74140516)
2016,Diciembre,Papúa Nueva Guinea,0,1,,1,POINT (4697157 -74140516)
2016,Diciembre,Pakistán,0,1,,1,POINT (3451668 -76532004)
2016,Diciembre,Panamá,374,481,,855,POINT (10406342 -75527794)
2016,Diciembre,Panamá,3255,3739,,6994,POINT (10446304 -75516486)
2016,Diciembre,Panamá,340,681,,1021,POINT (10886686 -74776479)
2016,Diciembre,Panamá,2,25,,27,POINT (10970933 -74765343)
2016,Diciembre,Panamá,0,4,,4,POINT (11117206 -74232675)
2016,Diciembre,Panamá,0,1,,1,POINT (11247723 -74213989)
2016,Diciembre,Panamá,2,12,,14,POINT (125744111 -81703935)
2016,Diciembre,Panamá,237,249,,486,POINT (125862 -81702165)
2016,Diciembre,Panamá,4,7,,11,POINT (133387613 -81372937)
2016,Diciembre,Panamá,457,736,,1193,POINT (3451668 -76532004)
2016,Diciembre,Panamá,0,12,,12,POINT (3884426 -77061029)
2016,Diciembre,Panamá,50,77,,127,POINT (445285 -75766353)
2016,Diciembre,Panamá,4166,5893,,10059,POINT (4697157 -74140516)
2016,Diciembre,Panamá,91,149,,240,POINT (4815189 -75736374)
2016,Diciembre,Panamá,2373,3345,,5718,POINT (6170465 -7542726)
2016,Diciembre,Panamá,3,2,,5,POINT (6222552 -77401154)
2016,Diciembre,Panamá,6,13,,19,POINT (7102626 -77762647)
2016,Diciembre,Panamá,18,34,,52,POINT (7128047 -73181317)
2016,Diciembre,Panamá,1,0,,1,POINT (806667 -767333)
2016,Diciembre,Panamá,126,165,,291,POINT (863337 -7735002)
2016,Diciembre,Paraguay,0,3,,3,POINT (10886686 -74776479)
2016,Diciembre,Paraguay,24,27,,51,POINT (125862 -81702165)
2016,Diciembre,Paraguay,7,5,,12,POINT (3451668 -76532004)
2016,Diciembre,Paraguay,83,62,,145,POINT (4697157 -74140516)
2016,Diciembre,Paraguay,70,89,,159,POINT (6170465 -7542726)
2016,Diciembre,Paraguay,0,1,,1,POINT (7128047 -73181317)
2016,Diciembre,Perú,126,174,,300,POINT (-4191162 -69941498)
2016,Diciembre,Perú,3,1,,4,POINT (0.185957 -7478366)
2016,Diciembre,Perú,4,4,,8,POINT (0.81488 -77356)
2016,Diciembre,Perú,9,9,,18,POINT (10446304 -75516486)
2016,Diciembre,Perú,2,2,,4,POINT (10886686 -74776479)
2016,Diciembre,Perú,71,52,,123,POINT (125862 -81702165)
2016,Diciembre,Perú,257,358,,615,POINT (3451668 -76532004)
2016,Diciembre,Perú,5573,7244,,12817,POINT (4697157 -74140516)
2016,Diciembre,Perú,0,4,,4,POINT (4815189 -75736374)
2016,Diciembre,Perú,473,726,,1199,POINT (6170465 -7542726)
2016,Diciembre,Perú,1,0,,1,POINT (7128047 -73181317)
2016,Diciembre,Palestina,0,2,,2,POINT (4697157 -74140516)
2016,Diciembre,Polonia,0,2,,2,POINT (10446304 -75516486)
2016,Diciembre,Polonia,0,3,,3,POINT (10886686 -74776479)
2016,Diciembre,Polonia,22,22,,44,POINT (4697157 -74140516)
2016,Diciembre,Portugal,4,7,,11,POINT (3451668 -76532004)
2016,Diciembre,Portugal,22,60,,82,POINT (4697157 -74140516)
2016,Diciembre,Portugal,5,3,,8,POINT (6170465 -7542726)
2016,Diciembre,Puerto Rico/Territorio de Estados Unidos,1,2,,3,POINT (10406342 -75527794)
2016,Diciembre,Puerto Rico/Territorio de Estados Unidos,1,3,,4,POINT (10446304 -75516486)
2016,Diciembre,Puerto Rico/Territorio de Estados Unidos,10,63,,73,POINT (10886686 -74776479)
2016,Diciembre,Puerto Rico/Territorio de Estados Unidos,0,9,,9,POINT (125862 -81702165)
2016,Diciembre,Puerto Rico/Territorio de Estados Unidos,25,100,,125,POINT (3451668 -76532004)
2016,Diciembre,Puerto Rico/Territorio de Estados Unidos,540,687,,1227,POINT (4697157 -74140516)
2016,Diciembre,Puerto Rico/Territorio de Estados Unidos,13,22,,35,POINT (4815189 -75736374)
2016,Diciembre,Puerto Rico/Territorio de Estados Unidos,51,137,,188,POINT (6170465 -7542726)
2016,Diciembre,Puerto Rico/Territorio de Estados Unidos,2,11,,13,POINT (7128047 -73181317)
2016,Diciembre,Qatar,1,1,,2,POINT (3451668 -76532004)
2016,Diciembre,Qatar,1,2,,3,POINT (4697157 -74140516)
2016,Diciembre,Reino Unido de Gran Bretaña e Irlanda del Norte,0,1,,1,POINT (10446304 -75516486)
2016,Diciembre,Reino Unido de Gran Bretaña e Irlanda del Norte,0,1,,1,POINT (10886686 -74776479)
2016,Diciembre,Reino Unido de Gran Bretaña e Irlanda del Norte,34,39,,73,POINT (3451668 -76532004)
2016,Diciembre,Reino Unido de Gran Bretaña e Irlanda del Norte,1028,1744,,2772,POINT (4697157 -74140516)
2016,Diciembre,Reino Unido de Gran Bretaña e Irlanda del Norte,40,71,,111,POINT (6170465 -7542726)
2016,Diciembre,Reino Unido de Gran Bretaña e Irlanda del Norte,0,1,,1,POINT (7128047 -73181317)
2016,Diciembre,República CentroÁfricana,0,2,,2,POINT (3451668 -76532004)
2016,Diciembre,República CentroÁfricana,1,0,,1,POINT (4697157 -74140516)
2016,Diciembre,Federación de Rusia,0,9,,9,POINT (10406342 -75527794)
2016,Diciembre,Federación de Rusia,1,0,,1,POINT (10446304 -75516486)
2016,Diciembre,Federación de Rusia,1,1,,2,POINT (10886686 -74776479)
2016,Diciembre,Federación de Rusia,2,1,,3,POINT (3451668 -76532004)
2016,Diciembre,Federación de Rusia,27,21,,48,POINT (4697157 -74140516)
2016,Diciembre,Federación de Rusia,1,10,,11,POINT (6170465 -7542726)
2016,Diciembre,República Dominicana,0,11,,11,POINT (10406342 -75527794)
2016,Diciembre,República Dominicana,0,6,,6,POINT (10446304 -75516486)
2016,Diciembre,República Dominicana,1,13,,14,POINT (10886686 -74776479)
2016,Diciembre,República Dominicana,0,2,,2,POINT (125862 -81702165)
2016,Diciembre,República Dominicana,8,20,,28,POINT (3451668 -76532004)
2016,Diciembre,República Dominicana,858,1021,,1879,POINT (4697157 -74140516)
2016,Diciembre,República Dominicana,5,8,,13,POINT (4815189 -75736374)
2016,Diciembre,República Dominicana,29,42,,71,POINT (6170465 -7542726)
2016,Diciembre,República Dominicana,5,7,,12,POINT (7128047 -73181317)
2016,Diciembre,Reunión,1,0,,1,POINT (4697157 -74140516)
2016,Diciembre,República Democrática Popular de Corea,1,0,,1,POINT (6170465 -7542726)
2016,Diciembre,Rumania,1,0,,1,POINT (3451668 -76532004)
2016,Diciembre,Rumania,3,10,,13,POINT (4697157 -74140516)
2016,Diciembre,Sahara Occidental/Desierto Sahara,1,0,,1,POINT (10446304 -75516486)
2016,Diciembre,San  Vicente y las Granadinas,2,3,,5,POINT (4697157 -74140516)
2016,Diciembre,Santa Lucia,0,1,,1,POINT (4697157 -74140516)
2016,Diciembre,Santa Lucia,1,0,,1,POINT (6170465 -7542726)
2016,Diciembre,Santa Sede/Ciudad del Vaticano,1,0,,1,POINT (3451668 -76532004)
2016,Diciembre,Serbia,2,5,,7,POINT (4697157 -74140516)
2016,Diciembre,Singapur,0,3,,3,POINT (11247723 -74213989)
2016,Diciembre,Singapur,1,1,,2,POINT (3451668 -76532004)
2016,Diciembre,Singapur,0,7,,7,POINT (4697157 -74140516)
2016,Diciembre,Sri Lanka,1,0,,1,POINT (4697157 -74140516)
2016,Diciembre,Sudáfrica,7,5,,12,POINT (4697157 -74140516)
2016,Diciembre,Sudáfrica,1,2,,3,POINT (6170465 -7542726)
2016,Diciembre,Suecia,0,2,,2,POINT (10446304 -75516486)
2016,Diciembre,Suecia,2,2,,4,POINT (10886686 -74776479)
2016,Diciembre,Suecia,21,21,,42,POINT (3451668 -76532004)
2016,Diciembre,Suecia,91,79,,170,POINT (4697157 -74140516)
2016,Diciembre,Suecia,8,12,,20,POINT (6170465 -7542726)
2016,Diciembre,Suiza,0,3,,3,POINT (10886686 -74776479)
2016,Diciembre,Suiza,26,75,,101,POINT (3451668 -76532004)
2016,Diciembre,Suiza,139,261,,400,POINT (4697157 -74140516)
2016,Diciembre,Suiza,0,1,,1,POINT (4815189 -75736374)
2016,Diciembre,Suiza,12,42,,54,POINT (6170465 -7542726)
2016,Diciembre,Suiza,0,1,,1,POINT (7128047 -73181317)
2016,Diciembre,Surinam,0,1,,1,POINT (10406342 -75527794)
2016,Diciembre,Surinam,60,73,,133,POINT (10886686 -74776479)
2016,Diciembre,Surinam,8,7,,15,POINT (4697157 -74140516)
2016,Diciembre,Surinam,6,7,,13,POINT (6170465 -7542726)
2016,Diciembre,Taiwán,1,0,,1,POINT (3451668 -76532004)
2016,Diciembre,Taiwán,0,2,,2,POINT (4697157 -74140516)
2016,Diciembre,Taiwán,1,3,,4,POINT (6170465 -7542726)
2016,Diciembre,República de Tayikistán,0,1,,1,POINT (4697157 -74140516)
2016,Diciembre,Tailandia,0,1,,1,POINT (3451668 -76532004)
2016,Diciembre,Tailandia,1,2,,3,POINT (4697157 -74140516)
2016,Diciembre,Tailandia,1,0,,1,POINT (6170465 -7542726)
2016,Diciembre,Trinidad y Tobago,0,1,,1,POINT (10406342 -75527794)
2016,Diciembre,Trinidad y Tobago,0,23,,23,POINT (10970933 -74765343)
2016,Diciembre,Trinidad y Tobago,1,7,,8,POINT (3451668 -76532004)
2016,Diciembre,Trinidad y Tobago,6,25,,31,POINT (4697157 -74140516)
2016,Diciembre,Trinidad y Tobago,0,2,,2,POINT (4815189 -75736374)
2016,Diciembre,Trinidad y Tobago,2,17,,19,POINT (6170465 -7542726)
2016,Diciembre,Trinidad y Tobago,1,1,,2,POINT (7128047 -73181317)
2016,Diciembre,Turkmenistán,2,5,,7,POINT (4697157 -74140516)
2016,Diciembre,Turquía,350,602,,952,POINT (4697157 -74140516)
2016,Diciembre,Ucrania,2,1,,3,POINT (4697157 -74140516)
2016,Diciembre,Uruguay,0,1,,1,POINT (10446304 -75516486)
2016,Diciembre,Uruguay,3,1,,4,POINT (10886686 -74776479)
2016,Diciembre,Uruguay,24,19,,43,POINT (125862 -81702165)
2016,Diciembre,Uruguay,12,27,,39,POINT (3451668 -76532004)
2016,Diciembre,Uruguay,139,162,,301,POINT (4697157 -74140516)
2016,Diciembre,Uruguay,1,1,,2,POINT (4815189 -75736374)
2016,Diciembre,Uruguay,29,52,,81,POINT (6170465 -7542726)
2016,Diciembre,Uruguay,2,1,,3,POINT (7128047 -73181317)
2016,Diciembre,Venezuela,0,18,,18,POINT (10406342 -75527794)
2016,Diciembre,Venezuela,18,37,,55,POINT (10446304 -75516486)
2016,Diciembre,Venezuela,20,42,,62,POINT (10886686 -74776479)
2016,Diciembre,Venezuela,0,1,,1,POINT (10970933 -74765343)
2016,Diciembre,Venezuela,1,4,,5,POINT (11117206 -74232675)
2016,Diciembre,Venezuela,3834,3982,,7816,POINT (11360029 -72129595)
2016,Diciembre,Venezuela,9,9,,18,POINT (125862 -81702165)
2016,Diciembre,Venezuela,14,28,,42,POINT (3451668 -76532004)
2016,Diciembre,Venezuela,40,38,,78,POINT (3866713 -67927521)
2016,Diciembre,Venezuela,4172,4077,,8249,POINT (4697157 -74140516)
2016,Diciembre,Venezuela,4,7,,11,POINT (4815189 -75736374)
2016,Diciembre,Venezuela,705,703,,1408,POINT (6170465 -7542726)
2016,Diciembre,Venezuela,415,580,,995,POINT (6185536 -67484028)
2016,Diciembre,Venezuela,118,165,,283,POINT (7088729 -70740253)
2016,Diciembre,Venezuela,5,9,,14,POINT (7128047 -73181317)
2016,Diciembre,Venezuela,8818,8976,,17794,POINT (7819 -72453013)
2016,Diciembre,Venezuela,1,1,,2,POINT (7927233 -72508188)
2016,Diciembre,Venezuela,155,163,,318,POINT (836068 -72409396)
2016,Diciembre,Vietnam,0,3,,3,POINT (3451668 -76532004)
2016,Diciembre,República Árabe de Yemen,1,0,,1,POINT (4697157 -74140516)
2016,Diciembre,Desconocido,267,958,,1225,POINT (4697157 -74140516)
2017,Enero,Afganistán,1,0,,1,POINT (10446304 -75516486)
2017,Enero,Afganistán,1,0,,1,POINT (4697157 -74140516)
2017,Enero,Albania,1,1,,2,POINT (4697157 -74140516)
2017,Enero,Alemania,0,1,,1,POINT (0.81488 -77356)
2017,Enero,Alemania,0,1,,1,POINT (10406342 -75527794)
2017,Enero,Alemania,2,2,,4,POINT (10446304 -75516486)
2017,Enero,Alemania,7,9,,16,POINT (10886686 -74776479)
2017,Enero,Alemania,0,2,,2,POINT (125862 -81702165)
2017,Enero,Alemania,28,46,,74,POINT (3451668 -76532004)
2017,Enero,Alemania,1298,1964,,3262,POINT (4697157 -74140516)
2017,Enero,Alemania,1,5,,6,POINT (4815189 -75736374)
2017,Enero,Alemania,41,62,,103,POINT (6170465 -7542726)
2017,Enero,Alemania,1,1,,2,POINT (7128047 -73181317)
2017,Enero,Antigua y Barbuda,0,2,,2,POINT (10406342 -75527794)
2017,Enero,Antigua y Barbuda,0,3,,3,POINT (4697157 -74140516)
2017,Enero,Países Bajos,16,30,,46,POINT (10406342 -75527794)
2017,Enero,Países Bajos,1,5,,6,POINT (10446304 -75516486)
2017,Enero,Países Bajos,76,106,,182,POINT (10886686 -74776479)
2017,Enero,Países Bajos,31,60,,91,POINT (11247723 -74213989)
2017,Enero,Países Bajos,106,193,,299,POINT (3451668 -76532004)
2017,Enero,Países Bajos,1,0,,1,POINT (445285 -75766353)
2017,Enero,Países Bajos,944,1280,,2224,POINT (4697157 -74140516)
2017,Enero,Países Bajos,1,5,,6,POINT (4815189 -75736374)
2017,Enero,Países Bajos,166,248,,414,POINT (6170465 -7542726)
2017,Enero,Arabia Saudita,0,1,,1,POINT (4697157 -74140516)
2017,Enero,Argelia,4,5,,9,POINT (4697157 -74140516)
2017,Enero,Argelia,0,1,,1,POINT (6170465 -7542726)
2017,Enero,Argentina,1,6,,7,POINT (-4191162 -69941498)
2017,Enero,Argentina,9,15,,24,POINT (0.81488 -77356)
2017,Enero,Argentina,59,54,,113,POINT (10446304 -75516486)
2017,Enero,Argentina,7,10,,17,POINT (10886686 -74776479)
2017,Enero,Argentina,380,276,,656,POINT (125862 -81702165)
2017,Enero,Argentina,68,59,,127,POINT (3451668 -76532004)
2017,Enero,Argentina,5509,5558,,11067,POINT (4697157 -74140516)
2017,Enero,Argentina,2,5,,7,POINT (4815189 -75736374)
2017,Enero,Argentina,94,119,,213,POINT (6170465 -7542726)
2017,Enero,Argentina,0,1,,1,POINT (7128047 -73181317)
2017,Enero,República de Armenia,1,0,,1,POINT (4697157 -74140516)
2017,Enero,Aruba,12,27,,39,POINT (10406342 -75527794)
2017,Enero,Aruba,3,1,,4,POINT (10446304 -75516486)
2017,Enero,Aruba,2,1,,3,POINT (10970933 -74765343)
2017,Enero,Aruba,12,12,,24,POINT (11247723 -74213989)
2017,Enero,Aruba,6,2,,8,POINT (3451668 -76532004)
2017,Enero,Aruba,715,756,,1471,POINT (4697157 -74140516)
2017,Enero,Aruba,38,55,,93,POINT (6170465 -7542726)
2017,Enero,Aruba,10,13,,23,POINT (7128047 -73181317)
2017,Enero,Australia,1,1,,2,POINT (10446304 -75516486)
2017,Enero,Australia,3,2,,5,POINT (10886686 -74776479)
2017,Enero,Australia,1,0,,1,POINT (125862 -81702165)
2017,Enero,Australia,1,2,,3,POINT (3451668 -76532004)
2017,Enero,Australia,40,41,,81,POINT (4697157 -74140516)
2017,Enero,Australia,8,30,,38,POINT (6170465 -7542726)
2017,Enero,Austria,0,3,,3,POINT (3451668 -76532004)
2017,Enero,Austria,22,37,,59,POINT (4697157 -74140516)
2017,Enero,Austria,5,9,,14,POINT (6170465 -7542726)
2017,Enero,Azerbaiyán,1,1,,2,POINT (4697157 -74140516)
2017,Enero,Bahamas,2,11,,13,POINT (10406342 -75527794)
2017,Enero,Bahamas,1,2,,3,POINT (10446304 -75516486)
2017,Enero,Bahamas,0,1,,1,POINT (4697157 -74140516)
2017,Enero,Bahamas,1,0,,1,POINT (4815189 -75736374)
2017,Enero,Bahamas,2,3,,5,POINT (6170465 -7542726)
2017,Enero,Bahréin,1,0,,1,POINT (10446304 -75516486)
2017,Enero,Bahréin,0,2,,2,POINT (4697157 -74140516)
2017,Enero,Barbados,41,63,,104,POINT (4697157 -74140516)
2017,Enero,República de Belarús,1,0,,1,POINT (3451668 -76532004)
2017,Enero,República de Belarús,5,3,,8,POINT (4697157 -74140516)
2017,Enero,República de Belarús,2,1,,3,POINT (7819 -72453013)
2017,Enero,Bélgica,4,9,,13,POINT (3451668 -76532004)
2017,Enero,Bélgica,42,65,,107,POINT (4697157 -74140516)
2017,Enero,Bélgica,6,9,,15,POINT (6170465 -7542726)
2017,Enero,Bélgica,0,1,,1,POINT (7128047 -73181317)
2017,Enero,Bélgica,0,1,,1,POINT (7819 -72453013)
2017,Enero,Belice,1,1,,2,POINT (4697157 -74140516)
2017,Enero,Belice,0,5,,5,POINT (6170465 -7542726)
2017,Enero,Benín,1,1,,2,POINT (4697157 -74140516)
2017,Enero,Bolivia,0,1,,1,POINT (0.81488 -77356)
2017,Enero,Bolivia,1,4,,5,POINT (10446304 -75516486)
2017,Enero,Bolivia,47,32,,79,POINT (125862 -81702165)
2017,Enero,Bolivia,23,28,,51,POINT (3451668 -76532004)
2017,Enero,Bolivia,500,529,,1029,POINT (4697157 -74140516)
2017,Enero,Bolivia,1,0,,1,POINT (4815189 -75736374)
2017,Enero,Bolivia,31,29,,60,POINT (6170465 -7542726)
2017,Enero,Brasil,276,292,,568,POINT (-4191162 -69941498)
2017,Enero,Brasil,1,2,,3,POINT (0.81488 -77356)
2017,Enero,Brasil,0,5,,5,POINT (10406342 -75527794)
2017,Enero,Brasil,53,19,,72,POINT (10446304 -75516486)
2017,Enero,Brasil,2,5,,7,POINT (10886686 -74776479)
2017,Enero,Brasil,391,307,,698,POINT (125862 -81702165)
2017,Enero,Brasil,96,116,,212,POINT (3451668 -76532004)
2017,Enero,Brasil,0,1,,1,POINT (3866713 -67927521)
2017,Enero,Brasil,5105,6086,,11191,POINT (4697157 -74140516)
2017,Enero,Brasil,3,1,,4,POINT (4815189 -75736374)
2017,Enero,Brasil,157,205,,362,POINT (6170465 -7542726)
2017,Enero,Brasil,0,1,,1,POINT (7128047 -73181317)
2017,Enero,Bulgaria,1,1,,2,POINT (4697157 -74140516)
2017,Enero,Cabo Verde,1,0,,1,POINT (4697157 -74140516)
2017,Enero,Islas Caimán/Territorio Británico de Ultramar,4,5,,9,POINT (10406342 -75527794)
2017,Enero,Islas Caimán/Territorio Británico de Ultramar,1,0,,1,POINT (10886686 -74776479)
2017,Enero,Islas Caimán/Territorio Británico de Ultramar,1,7,,8,POINT (125862 -81702165)
2017,Enero,Islas Caimán/Territorio Británico de Ultramar,0,3,,3,POINT (4697157 -74140516)
2017,Enero,Canadá,539,563,,1102,POINT (10446304 -75516486)
2017,Enero,Canadá,6,7,,13,POINT (10886686 -74776479)
2017,Enero,Canadá,332,292,,624,POINT (125862 -81702165)
2017,Enero,Canadá,38,59,,97,POINT (3451668 -76532004)
2017,Enero,Canadá,799,1092,,1891,POINT (4697157 -74140516)
2017,Enero,Canadá,4,8,,12,POINT (4815189 -75736374)
2017,Enero,Canadá,113,205,,318,POINT (6170465 -7542726)
2017,Enero,Canadá,4,10,,14,POINT (7128047 -73181317)
2017,Enero,Chad,0,1,,1,POINT (4697157 -74140516)
2017,Enero,España,0,8,,8,POINT (10406342 -75527794)
2017,Enero,España,1,6,,7,POINT (10446304 -75516486)
2017,Enero,España,4,8,,12,POINT (10886686 -74776479)
2017,Enero,España,0,3,,3,POINT (10970933 -74765343)
2017,Enero,España,581,832,,1413,POINT (3451668 -76532004)
2017,Enero,España,0,1,,1,POINT (3884426 -77061029)
2017,Enero,España,4315,7147,,11462,POINT (4697157 -74140516)
2017,Enero,España,3,9,,12,POINT (4815189 -75736374)
2017,Enero,España,348,696,,1044,POINT (6170465 -7542726)
2017,Enero,España,1,0,,1,POINT (7128047 -73181317)
2017,Enero,República de Corea,3,0,,3,POINT (10446304 -75516486)
2017,Enero,República de Corea,15,18,,33,POINT (4697157 -74140516)
2017,Enero,República de Corea,0,1,,1,POINT (4815189 -75736374)
2017,Enero,República de Corea,8,8,,16,POINT (6170465 -7542726)
2017,Enero,Costa de Marfil,0,2,,2,POINT (3451668 -76532004)
2017,Enero,Costa de Marfil,5,3,,8,POINT (4697157 -74140516)
2017,Enero,Costa Rica,4,13,,17,POINT (10406342 -75527794)
2017,Enero,Costa Rica,8,8,,16,POINT (10446304 -75516486)
2017,Enero,Costa Rica,8,15,,23,POINT (10886686 -74776479)
2017,Enero,Costa Rica,0,3,,3,POINT (11117206 -74232675)
2017,Enero,Costa Rica,0,1,,1,POINT (125744111 -81703935)
2017,Enero,Costa Rica,242,177,,419,POINT (125862 -81702165)
2017,Enero,Costa Rica,19,54,,73,POINT (3451668 -76532004)
2017,Enero,Costa Rica,1227,1495,,2722,POINT (4697157 -74140516)
2017,Enero,Costa Rica,8,11,,19,POINT (4815189 -75736374)
2017,Enero,Costa Rica,100,147,,247,POINT (6170465 -7542726)
2017,Enero,Costa Rica,4,4,,8,POINT (7128047 -73181317)
2017,Enero,Croacia,0,2,,2,POINT (3451668 -76532004)
2017,Enero,Croacia,2,2,,4,POINT (4697157 -74140516)
2017,Enero,Croacia,0,1,,1,POINT (6170465 -7542726)
2017,Enero,Cuba,1,3,,4,POINT (10406342 -75527794)
2017,Enero,Cuba,0,1,,1,POINT (10446304 -75516486)
2017,Enero,Cuba,8,9,,17,POINT (10886686 -74776479)
2017,Enero,Cuba,1,3,,4,POINT (133387613 -81372937)
2017,Enero,Cuba,13,28,,41,POINT (3451668 -76532004)
2017,Enero,Cuba,428,777,,1205,POINT (4697157 -74140516)
2017,Enero,Cuba,2,3,,5,POINT (4815189 -75736374)
2017,Enero,Cuba,19,21,,40,POINT (6170465 -7542726)
2017,Enero,Cuba,1,6,,7,POINT (7128047 -73181317)
2017,Enero,Curazao,0,1,,1,POINT (10446304 -75516486)
2017,Enero,Curazao,0,10,,10,POINT (4697157 -74140516)
2017,Enero,República Checa,2,2,,4,POINT (10446304 -75516486)
2017,Enero,República Checa,0,1,,1,POINT (3451668 -76532004)
2017,Enero,República Checa,11,11,,22,POINT (4697157 -74140516)
2017,Enero,República Checa,0,1,,1,POINT (6170465 -7542726)
2017,Enero,Chile,5,6,,11,POINT (0.81488 -77356)
2017,Enero,Chile,2,0,,2,POINT (1800143 -78802679)
2017,Enero,Chile,18,16,,34,POINT (10446304 -75516486)
2017,Enero,Chile,12,13,,25,POINT (10886686 -74776479)
2017,Enero,Chile,1,1,,2,POINT (11117206 -74232675)
2017,Enero,Chile,102,67,,169,POINT (125862 -81702165)
2017,Enero,Chile,51,57,,108,POINT (3451668 -76532004)
2017,Enero,Chile,5323,5897,,11220,POINT (4697157 -74140516)
2017,Enero,Chile,1,5,,6,POINT (4815189 -75736374)
2017,Enero,Chile,46,50,,96,POINT (6170465 -7542726)
2017,Enero,Chile,1,1,,2,POINT (7128047 -73181317)
2017,Enero,China,0,1,,1,POINT (10406342 -75527794)
2017,Enero,China,2,1,,3,POINT (3451668 -76532004)
2017,Enero,China,0,1,,1,POINT (3884426 -77061029)
2017,Enero,China,31,67,,98,POINT (4697157 -74140516)
2017,Enero,China,5,4,,9,POINT (6170465 -7542726)
2017,Enero,Dinamarca,3,2,,5,POINT (10886686 -74776479)
2017,Enero,Dinamarca,0,2,,2,POINT (3451668 -76532004)
2017,Enero,Dinamarca,21,39,,60,POINT (4697157 -74140516)
2017,Enero,Dinamarca,6,5,,11,POINT (6170465 -7542726)
2017,Enero,Dominica,0,1,,1,POINT (4697157 -74140516)
2017,Enero,Dominica,0,1,,1,POINT (6170465 -7542726)
2017,Enero,Ecuador,91,305,,396,POINT (0.33002 -76876446)
2017,Enero,Ecuador,3,1,,4,POINT (0.812436 -77847006)
2017,Enero,Ecuador,3698,5501,,9199,POINT (0.81488 -77356)
2017,Enero,Ecuador,26,55,,81,POINT (1800143 -78802679)
2017,Enero,Ecuador,0,2,,2,POINT (10406342 -75527794)
2017,Enero,Ecuador,0,1,,1,POINT (10446304 -75516486)
2017,Enero,Ecuador,0,7,,7,POINT (10886686 -74776479)
2017,Enero,Ecuador,1,0,,1,POINT (125862 -81702165)
2017,Enero,Ecuador,285,386,,671,POINT (3451668 -76532004)
2017,Enero,Ecuador,3018,4380,,7398,POINT (4697157 -74140516)
2017,Enero,Ecuador,0,2,,2,POINT (4815189 -75736374)
2017,Enero,Ecuador,52,86,,138,POINT (6170465 -7542726)
2017,Enero,Ecuador,1,2,,3,POINT (7128047 -73181317)
2017,Enero,Ecuador,0,1,,1,POINT (7819 -72453013)
2017,Enero,Egipto,1,0,,1,POINT (10886686 -74776479)
2017,Enero,Egipto,0,2,,2,POINT (4697157 -74140516)
2017,Enero,El Salvador,3,10,,13,POINT (10446304 -75516486)
2017,Enero,El Salvador,2,2,,4,POINT (10886686 -74776479)
2017,Enero,El Salvador,8,3,,11,POINT (125862 -81702165)
2017,Enero,El Salvador,126,173,,299,POINT (3451668 -76532004)
2017,Enero,El Salvador,982,1269,,2251,POINT (4697157 -74140516)
2017,Enero,El Salvador,0,1,,1,POINT (4815189 -75736374)
2017,Enero,El Salvador,138,227,,365,POINT (6170465 -7542726)
2017,Enero,El Salvador,1,0,,1,POINT (7128047 -73181317)
2017,Enero,Emiratos Árabes,1,1,,2,POINT (10446304 -75516486)
2017,Enero,Emiratos Árabes,1,0,,1,POINT (3451668 -76532004)
2017,Enero,Emiratos Árabes,1,2,,3,POINT (4697157 -74140516)
2017,Enero,Eslovaquia,0,4,,4,POINT (3451668 -76532004)
2017,Enero,Eslovaquia,13,9,,22,POINT (4697157 -74140516)
2017,Enero,Eslovaquia,2,0,,2,POINT (6170465 -7542726)
2017,Enero,Eslovenia,1,3,,4,POINT (4697157 -74140516)
2017,Enero,Eslovenia,0,1,,1,POINT (6170465 -7542726)
2017,Enero,Estados Unidos de América,6,29,,35,POINT (10406342 -75527794)
2017,Enero,Estados Unidos de América,2727,4016,,6743,POINT (10446304 -75516486)
2017,Enero,Estados Unidos de América,446,721,,1167,POINT (10886686 -74776479)
2017,Enero,Estados Unidos de América,0,9,,9,POINT (10970933 -74765343)
2017,Enero,Estados Unidos de América,1,19,,20,POINT (11247723 -74213989)
2017,Enero,Estados Unidos de América,22,30,,52,POINT (125862 -81702165)
2017,Enero,Estados Unidos de América,837,1271,,2108,POINT (3451668 -76532004)
2017,Enero,Estados Unidos de América,0,3,,3,POINT (3884426 -77061029)
2017,Enero,Estados Unidos de América,66,107,,173,POINT (445285 -75766353)
2017,Enero,Estados Unidos de América,7848,12908,,20756,POINT (4697157 -74140516)
2017,Enero,Estados Unidos de América,104,172,,276,POINT (4815189 -75736374)
2017,Enero,Estados Unidos de América,1692,4135,,5827,POINT (6170465 -7542726)
2017,Enero,Estados Unidos de América,23,42,,65,POINT (7128047 -73181317)
2017,Enero,Estados Unidos de América,0,6,,6,POINT (9402597 -75681642)
2017,Enero,Estonia,1,2,,3,POINT (4697157 -74140516)
2017,Enero,Etiopia,0,1,,1,POINT (4697157 -74140516)
2017,Enero,Filipinas,0,1,,1,POINT (10446304 -75516486)
2017,Enero,Filipinas,0,3,,3,POINT (10886686 -74776479)
2017,Enero,Filipinas,0,5,,5,POINT (3451668 -76532004)
2017,Enero,Filipinas,0,2,,2,POINT (4697157 -74140516)
2017,Enero,Filipinas,1,1,,2,POINT (6170465 -7542726)
2017,Enero,Finlandia,0,1,,1,POINT (3451668 -76532004)
2017,Enero,Finlandia,9,15,,24,POINT (4697157 -74140516)
2017,Enero,Finlandia,0,1,,1,POINT (4815189 -75736374)
2017,Enero,Francia,1,4,,5,POINT (10446304 -75516486)
2017,Enero,Francia,3,6,,9,POINT (10886686 -74776479)
2017,Enero,Francia,0,1,,1,POINT (11247723 -74213989)
2017,Enero,Francia,37,76,,113,POINT (3451668 -76532004)
2017,Enero,Francia,1558,2511,,4069,POINT (4697157 -74140516)
2017,Enero,Francia,1,3,,4,POINT (4815189 -75736374)
2017,Enero,Francia,39,74,,113,POINT (6170465 -7542726)
2017,Enero,Georgia,0,1,,1,POINT (4697157 -74140516)
2017,Enero,Gibraltar/Territorio Británico de Ultramar,9,3,,12,POINT (0.81488 -77356)
2017,Enero,Gibraltar/Territorio Británico de Ultramar,0,3,,3,POINT (11247723 -74213989)
2017,Enero,Granada,0,1,,1,POINT (11247723 -74213989)
2017,Enero,Granada,1,1,,2,POINT (4697157 -74140516)
2017,Enero,Grecia,0,1,,1,POINT (3451668 -76532004)
2017,Enero,Grecia,4,10,,14,POINT (4697157 -74140516)
2017,Enero,Grecia,0,1,,1,POINT (7128047 -73181317)
2017,Enero,Guatemala,8,9,,17,POINT (10446304 -75516486)
2017,Enero,Guatemala,6,9,,15,POINT (10886686 -74776479)
2017,Enero,Guatemala,2,3,,5,POINT (11117206 -74232675)
2017,Enero,Guatemala,6,9,,15,POINT (125862 -81702165)
2017,Enero,Guatemala,1,1,,2,POINT (133387613 -81372937)
2017,Enero,Guatemala,30,49,,79,POINT (3451668 -76532004)
2017,Enero,Guatemala,266,523,,789,POINT (4697157 -74140516)
2017,Enero,Guatemala,0,4,,4,POINT (4815189 -75736374)
2017,Enero,Guatemala,45,92,,137,POINT (6170465 -7542726)
2017,Enero,Guatemala,3,0,,3,POINT (7128047 -73181317)
2017,Enero,Guyana,2,0,,2,POINT (3451668 -76532004)
2017,Enero,Guyana,0,1,,1,POINT (4697157 -74140516)
2017,Enero,Guyana,0,1,,1,POINT (6170465 -7542726)
2017,Enero,Guadalupe/Territorio Francés,2,5,,7,POINT (4697157 -74140516)
2017,Enero,Guayana Francesa/Departamento de Ultramar Francés,0,1,,1,POINT (6170465 -7542726)
2017,Enero,Haití,0,1,,1,POINT (3451668 -76532004)
2017,Enero,Haití,2,3,,5,POINT (4697157 -74140516)
2017,Enero,Haití,1,0,,1,POINT (7128047 -73181317)
2017,Enero,Honduras,0,1,,1,POINT (10406342 -75527794)
2017,Enero,Honduras,1,2,,3,POINT (10446304 -75516486)
2017,Enero,Honduras,1,2,,3,POINT (10886686 -74776479)
2017,Enero,Honduras,1,0,,1,POINT (11117206 -74232675)
2017,Enero,Honduras,8,16,,24,POINT (133387613 -81372937)
2017,Enero,Honduras,8,16,,24,POINT (3451668 -76532004)
2017,Enero,Honduras,46,73,,119,POINT (4697157 -74140516)
2017,Enero,Honduras,1,4,,5,POINT (4815189 -75736374)
2017,Enero,Honduras,31,61,,92,POINT (6170465 -7542726)
2017,Enero,Honduras,1,0,,1,POINT (7128047 -73181317)
2017,Enero,Hong Kong,3,4,,7,POINT (4697157 -74140516)
2017,Enero,Hungría,1,0,,1,POINT (3451668 -76532004)
2017,Enero,Hungría,5,7,,12,POINT (4697157 -74140516)
2017,Enero,Hungría,0,1,,1,POINT (6170465 -7542726)
2017,Enero,India,0,1,,1,POINT (10886686 -74776479)
2017,Enero,India,2,3,,5,POINT (3451668 -76532004)
2017,Enero,India,5,39,,44,POINT (4697157 -74140516)
2017,Enero,India,1,20,,21,POINT (6170465 -7542726)
2017,Enero,Indonesia,0,1,,1,POINT (3451668 -76532004)
2017,Enero,Indonesia,5,3,,8,POINT (4697157 -74140516)
2017,Enero,Iraq,0,2,,2,POINT (4697157 -74140516)
2017,Enero,Irán,1,0,,1,POINT (4697157 -74140516)
2017,Enero,República de Irlanda,0,1,,1,POINT (10886686 -74776479)
2017,Enero,República de Irlanda,1,1,,2,POINT (3451668 -76532004)
2017,Enero,República de Irlanda,10,15,,25,POINT (4697157 -74140516)
2017,Enero,República de Irlanda,4,4,,8,POINT (6170465 -7542726)
2017,Enero,República de Irlanda,0,1,,1,POINT (7128047 -73181317)
2017,Enero,Islandia,0,2,,2,POINT (4697157 -74140516)
2017,Enero,Islandia,0,1,,1,POINT (6170465 -7542726)
2017,Enero,Israel,2,2,,4,POINT (10446304 -75516486)
2017,Enero,Israel,0,4,,4,POINT (3451668 -76532004)
2017,Enero,Israel,14,53,,67,POINT (4697157 -74140516)
2017,Enero,Israel,3,9,,12,POINT (6170465 -7542726)
2017,Enero,Italia,2,3,,5,POINT (10446304 -75516486)
2017,Enero,Italia,0,7,,7,POINT (10886686 -74776479)
2017,Enero,Italia,1,1,,2,POINT (125862 -81702165)
2017,Enero,Italia,11,44,,55,POINT (3451668 -76532004)
2017,Enero,Italia,168,392,,560,POINT (4697157 -74140516)
2017,Enero,Italia,0,8,,8,POINT (4815189 -75736374)
2017,Enero,Italia,29,76,,105,POINT (6170465 -7542726)
2017,Enero,Italia,0,1,,1,POINT (7128047 -73181317)
2017,Enero,Jamaica,35,34,,69,POINT (10406342 -75527794)
2017,Enero,Jamaica,1,1,,2,POINT (10886686 -74776479)
2017,Enero,Jamaica,1,2,,3,POINT (125744111 -81703935)
2017,Enero,Jamaica,1,1,,2,POINT (125862 -81702165)
2017,Enero,Jamaica,0,3,,3,POINT (133387613 -81372937)
2017,Enero,Jamaica,5,4,,9,POINT (3451668 -76532004)
2017,Enero,Jamaica,3,10,,13,POINT (4697157 -74140516)
2017,Enero,Jamaica,1,3,,4,POINT (6170465 -7542726)
2017,Enero,Japón,1,1,,2,POINT (3451668 -76532004)
2017,Enero,Japón,12,29,,41,POINT (4697157 -74140516)
2017,Enero,Japón,1,9,,10,POINT (6170465 -7542726)
2017,Enero,Kenia,1,1,,2,POINT (4697157 -74140516)
2017,Enero,Kiribati,0,1,,1,POINT (10446304 -75516486)
2017,Enero,Kuwait,0,1,,1,POINT (4697157 -74140516)
2017,Enero,Letonia,2,2,,4,POINT (4697157 -74140516)
2017,Enero,Lituania,5,4,,9,POINT (4697157 -74140516)
2017,Enero,Lituania,1,0,,1,POINT (6170465 -7542726)
2017,Enero,Líbano,3,4,,7,POINT (4697157 -74140516)
2017,Enero,Liechtenstein,0,1,,1,POINT (4697157 -74140516)
2017,Enero,Luxemburgo,2,2,,4,POINT (4697157 -74140516)
2017,Enero,Luxemburgo,0,1,,1,POINT (6170465 -7542726)
2017,Enero,Malasia,1,0,,1,POINT (4697157 -74140516)
2017,Enero,Malta,0,1,,1,POINT (4697157 -74140516)
2017,Enero,Marruecos,0,2,,2,POINT (10406342 -75527794)
2017,Enero,Marruecos,0,1,,1,POINT (4697157 -74140516)
2017,Enero,Marruecos,2,4,,6,POINT (6170465 -7542726)
2017,Enero,Mauricio,0,1,,1,POINT (4697157 -74140516)
2017,Enero,Martinica/Departamento de Ultramar Francés,0,5,,5,POINT (11247723 -74213989)
2017,Enero,Martinica/Departamento de Ultramar Francés,0,2,,2,POINT (4697157 -74140516)
2017,Enero,México,0,5,,5,POINT (10406342 -75527794)
2017,Enero,México,6,12,,18,POINT (10446304 -75516486)
2017,Enero,México,18,30,,48,POINT (10886686 -74776479)
2017,Enero,México,0,1,,1,POINT (10970933 -74765343)
2017,Enero,México,0,1,,1,POINT (11247723 -74213989)
2017,Enero,México,1,0,,1,POINT (125744111 -81703935)
2017,Enero,México,1,1,,2,POINT (125862 -81702165)
2017,Enero,México,56,169,,225,POINT (3451668 -76532004)
2017,Enero,México,4853,7477,,12330,POINT (4697157 -74140516)
2017,Enero,México,6,19,,25,POINT (4815189 -75736374)
2017,Enero,México,446,1069,,1515,POINT (6170465 -7542726)
2017,Enero,México,5,8,,13,POINT (7128047 -73181317)
2017,Enero,México,0,1,,1,POINT (7819 -72453013)
2017,Enero,Mónaco,0,1,,1,POINT (6170465 -7542726)
2017,Enero,Nicaragua,2,0,,2,POINT (10446304 -75516486)
2017,Enero,Nicaragua,1,1,,2,POINT (10886686 -74776479)
2017,Enero,Nicaragua,1,1,,2,POINT (125862 -81702165)
2017,Enero,Nicaragua,21,27,,48,POINT (3451668 -76532004)
2017,Enero,Nicaragua,35,47,,82,POINT (4697157 -74140516)
2017,Enero,Nicaragua,9,15,,24,POINT (4815189 -75736374)
2017,Enero,Nicaragua,11,24,,35,POINT (6170465 -7542726)
2017,Enero,Nicaragua,1,1,,2,POINT (7128047 -73181317)
2017,Enero,Nigeria,1,1,,2,POINT (4697157 -74140516)
2017,Enero,Noruega,1,2,,3,POINT (10886686 -74776479)
2017,Enero,Noruega,1,4,,5,POINT (3451668 -76532004)
2017,Enero,Noruega,11,20,,31,POINT (4697157 -74140516)
2017,Enero,Noruega,2,4,,6,POINT (6170465 -7542726)
2017,Enero,Nueva Zelanda,2,2,,4,POINT (4697157 -74140516)
2017,Enero,Nueva Zelanda,2,3,,5,POINT (6170465 -7542726)
2017,Enero,Nueva Zelanda,0,2,,2,POINT (7128047 -73181317)
2017,Enero,Papúa Nueva Guinea,2,3,,5,POINT (10446304 -75516486)
2017,Enero,Pakistán,0,1,,1,POINT (6170465 -7542726)
2017,Enero,Panamá,901,821,,1722,POINT (10406342 -75527794)
2017,Enero,Panamá,3949,4242,,8191,POINT (10446304 -75516486)
2017,Enero,Panamá,328,602,,930,POINT (10886686 -74776479)
2017,Enero,Panamá,0,10,,10,POINT (10970933 -74765343)
2017,Enero,Panamá,0,1,,1,POINT (11117206 -74232675)
2017,Enero,Panamá,7,16,,23,POINT (125744111 -81703935)
2017,Enero,Panamá,739,597,,1336,POINT (125862 -81702165)
2017,Enero,Panamá,10,11,,21,POINT (133387613 -81372937)
2017,Enero,Panamá,415,554,,969,POINT (3451668 -76532004)
2017,Enero,Panamá,0,54,,54,POINT (3884426 -77061029)
2017,Enero,Panamá,46,85,,131,POINT (445285 -75766353)
2017,Enero,Panamá,4027,5713,,9740,POINT (4697157 -74140516)
2017,Enero,Panamá,68,113,,181,POINT (4815189 -75736374)
2017,Enero,Panamá,2474,3065,,5539,POINT (6170465 -7542726)
2017,Enero,Panamá,3,4,,7,POINT (6222552 -77401154)
2017,Enero,Panamá,4,9,,13,POINT (7102626 -77762647)
2017,Enero,Panamá,13,26,,39,POINT (7128047 -73181317)
2017,Enero,Panamá,114,143,,257,POINT (863337 -7735002)
2017,Enero,Panamá,9,2,,11,POINT (9402597 -75681642)
2017,Enero,Paraguay,6,3,,9,POINT (10446304 -75516486)
2017,Enero,Paraguay,4,2,,6,POINT (10886686 -74776479)
2017,Enero,Paraguay,113,65,,178,POINT (125862 -81702165)
2017,Enero,Paraguay,4,6,,10,POINT (3451668 -76532004)
2017,Enero,Paraguay,77,94,,171,POINT (4697157 -74140516)
2017,Enero,Paraguay,2,1,,3,POINT (4815189 -75736374)
2017,Enero,Paraguay,10,17,,27,POINT (6170465 -7542726)
2017,Enero,Perú,126,200,,326,POINT (-4191162 -69941498)
2017,Enero,Perú,8,22,,30,POINT (0.81488 -77356)
2017,Enero,Perú,1310,952,,2262,POINT (10446304 -75516486)
2017,Enero,Perú,14,13,,27,POINT (10886686 -74776479)
2017,Enero,Perú,246,166,,412,POINT (125862 -81702165)
2017,Enero,Perú,372,477,,849,POINT (3451668 -76532004)
2017,Enero,Perú,0,3,,3,POINT (3884426 -77061029)
2017,Enero,Perú,5768,7080,,12848,POINT (4697157 -74140516)
2017,Enero,Perú,3,5,,8,POINT (4815189 -75736374)
2017,Enero,Perú,532,844,,1376,POINT (6170465 -7542726)
2017,Enero,Perú,2,7,,9,POINT (7128047 -73181317)
2017,Enero,Polonia,1,1,,2,POINT (10446304 -75516486)
2017,Enero,Polonia,3,6,,9,POINT (3451668 -76532004)
2017,Enero,Polonia,19,21,,40,POINT (4697157 -74140516)
2017,Enero,Polonia,0,4,,4,POINT (4815189 -75736374)
2017,Enero,Polonia,1,6,,7,POINT (6170465 -7542726)
2017,Enero,Portugal,0,1,,1,POINT (10886686 -74776479)
2017,Enero,Portugal,3,8,,11,POINT (3451668 -76532004)
2017,Enero,Portugal,36,85,,121,POINT (4697157 -74140516)
2017,Enero,Portugal,1,13,,14,POINT (6170465 -7542726)
2017,Enero,Puerto Rico/Territorio de Estados Unidos,0,2,,2,POINT (10406342 -75527794)
2017,Enero,Puerto Rico/Territorio de Estados Unidos,2,8,,10,POINT (10446304 -75516486)
2017,Enero,Puerto Rico/Territorio de Estados Unidos,3,43,,46,POINT (10886686 -74776479)
2017,Enero,Puerto Rico/Territorio de Estados Unidos,16,37,,53,POINT (3451668 -76532004)
2017,Enero,Puerto Rico/Territorio de Estados Unidos,306,409,,715,POINT (4697157 -74140516)
2017,Enero,Puerto Rico/Territorio de Estados Unidos,2,5,,7,POINT (4815189 -75736374)
2017,Enero,Puerto Rico/Territorio de Estados Unidos,54,81,,135,POINT (6170465 -7542726)
2017,Enero,Puerto Rico/Territorio de Estados Unidos,1,2,,3,POINT (7128047 -73181317)
2017,Enero,Reino Unido de Gran Bretaña e Irlanda del Norte,2,1,,3,POINT (10446304 -75516486)
2017,Enero,Reino Unido de Gran Bretaña e Irlanda del Norte,0,1,,1,POINT (10886686 -74776479)
2017,Enero,Reino Unido de Gran Bretaña e Irlanda del Norte,0,1,,1,POINT (10970933 -74765343)
2017,Enero,Reino Unido de Gran Bretaña e Irlanda del Norte,1,4,,5,POINT (11117206 -74232675)
2017,Enero,Reino Unido de Gran Bretaña e Irlanda del Norte,10,24,,34,POINT (3451668 -76532004)
2017,Enero,Reino Unido de Gran Bretaña e Irlanda del Norte,1012,1587,,2599,POINT (4697157 -74140516)
2017,Enero,Reino Unido de Gran Bretaña e Irlanda del Norte,15,42,,57,POINT (6170465 -7542726)
2017,Enero,Reino Unido de Gran Bretaña e Irlanda del Norte,1,0,,1,POINT (7128047 -73181317)
2017,Enero,República CentroÁfricana,1,0,,1,POINT (4697157 -74140516)
2017,Enero,Federación de Rusia,1,1,,2,POINT (10886686 -74776479)
2017,Enero,Federación de Rusia,3,8,,11,POINT (3451668 -76532004)
2017,Enero,Federación de Rusia,29,59,,88,POINT (4697157 -74140516)
2017,Enero,Federación de Rusia,2,0,,2,POINT (6170465 -7542726)
2017,Enero,República Dominicana,1,3,,4,POINT (-4191162 -69941498)
2017,Enero,República Dominicana,1,4,,5,POINT (10406342 -75527794)
2017,Enero,República Dominicana,5,21,,26,POINT (10446304 -75516486)
2017,Enero,República Dominicana,7,20,,27,POINT (10886686 -74776479)
2017,Enero,República Dominicana,0,1,,1,POINT (10970933 -74765343)
2017,Enero,República Dominicana,0,2,,2,POINT (11247723 -74213989)
2017,Enero,República Dominicana,0,1,,1,POINT (125862 -81702165)
2017,Enero,República Dominicana,18,25,,43,POINT (3451668 -76532004)
2017,Enero,República Dominicana,713,981,,1694,POINT (4697157 -74140516)
2017,Enero,República Dominicana,3,25,,28,POINT (4815189 -75736374)
2017,Enero,República Dominicana,58,89,,147,POINT (6170465 -7542726)
2017,Enero,República Dominicana,4,8,,12,POINT (7128047 -73181317)
2017,Enero,Reunión,1,1,,2,POINT (4697157 -74140516)
2017,Enero,Rumania,9,10,,19,POINT (4697157 -74140516)
2017,Enero,Rumania,1,0,,1,POINT (6170465 -7542726)
2017,Enero,San Cristóbal y Nevis,0,1,,1,POINT (4697157 -74140516)
2017,Enero,Santa Lucia,1,1,,2,POINT (3451668 -76532004)
2017,Enero,Santa Lucia,1,2,,3,POINT (4697157 -74140516)
2017,Enero,Serbia,0,2,,2,POINT (3451668 -76532004)
2017,Enero,Serbia,0,4,,4,POINT (6170465 -7542726)
2017,Enero,Singapur,0,2,,2,POINT (3451668 -76532004)
2017,Enero,Singapur,1,1,,2,POINT (4697157 -74140516)
2017,Enero,Singapur,1,0,,1,POINT (6170465 -7542726)
2017,Enero,Sri Lanka,0,1,,1,POINT (4697157 -74140516)
2017,Enero,Sudáfrica,4,5,,9,POINT (4697157 -74140516)
2017,Enero,Sudáfrica,1,2,,3,POINT (6170465 -7542726)
2017,Enero,Suecia,0,5,,5,POINT (10886686 -74776479)
2017,Enero,Suecia,3,13,,16,POINT (3451668 -76532004)
2017,Enero,Suecia,55,60,,115,POINT (4697157 -74140516)
2017,Enero,Suecia,0,2,,2,POINT (4815189 -75736374)
2017,Enero,Suecia,4,14,,18,POINT (6170465 -7542726)
2017,Enero,Suiza,1,1,,2,POINT (10406342 -75527794)
2017,Enero,Suiza,0,2,,2,POINT (10446304 -75516486)
2017,Enero,Suiza,1,0,,1,POINT (10886686 -74776479)
2017,Enero,Suiza,4,2,,6,POINT (125862 -81702165)
2017,Enero,Suiza,16,30,,46,POINT (3451668 -76532004)
2017,Enero,Suiza,99,134,,233,POINT (4697157 -74140516)
2017,Enero,Suiza,19,27,,46,POINT (6170465 -7542726)
2017,Enero,Surinam,1,3,,4,POINT (4697157 -74140516)
2017,Enero,Surinam,0,2,,2,POINT (6170465 -7542726)
2017,Enero,Taiwán,0,1,,1,POINT (10886686 -74776479)
2017,Enero,Taiwán,5,1,,6,POINT (4697157 -74140516)
2017,Enero,Taiwán,3,3,,6,POINT (6170465 -7542726)
2017,Enero,Tailandia,1,2,,3,POINT (4697157 -74140516)
2017,Enero,Tailandia,0,1,,1,POINT (6170465 -7542726)
2017,Enero,Trinidad y Tobago,0,5,,5,POINT (10406342 -75527794)
2017,Enero,Trinidad y Tobago,1,3,,4,POINT (10886686 -74776479)
2017,Enero,Trinidad y Tobago,5,41,,46,POINT (3451668 -76532004)
2017,Enero,Trinidad y Tobago,5,8,,13,POINT (4697157 -74140516)
2017,Enero,Trinidad y Tobago,0,5,,5,POINT (6170465 -7542726)
2017,Enero,Túnez,1,1,,2,POINT (4697157 -74140516)
2017,Enero,Turkmenistán,4,9,,13,POINT (4697157 -74140516)
2017,Enero,Turkmenistán,0,1,,1,POINT (7819 -72453013)
2017,Enero,Turquía,1,1,,2,POINT (10886686 -74776479)
2017,Enero,Turquía,0,3,,3,POINT (10970933 -74765343)
2017,Enero,Turquía,0,3,,3,POINT (3451668 -76532004)
2017,Enero,Turquía,0,1,,1,POINT (3884426 -77061029)
2017,Enero,Turquía,278,399,,677,POINT (4697157 -74140516)
2017,Enero,Turquía,0,6,,6,POINT (6170465 -7542726)
2017,Enero,Ucrania,0,1,,1,POINT (10886686 -74776479)
2017,Enero,Ucrania,1,1,,2,POINT (3451668 -76532004)
2017,Enero,Ucrania,1,10,,11,POINT (4697157 -74140516)
2017,Enero,Ucrania,1,0,,1,POINT (6170465 -7542726)
2017,Enero,Uganda,0,2,,2,POINT (4697157 -74140516)
2017,Enero,Uruguay,1,5,,6,POINT (-4191162 -69941498)
2017,Enero,Uruguay,4,1,,5,POINT (10446304 -75516486)
2017,Enero,Uruguay,6,3,,9,POINT (10886686 -74776479)
2017,Enero,Uruguay,31,20,,51,POINT (125862 -81702165)
2017,Enero,Uruguay,15,30,,45,POINT (3451668 -76532004)
2017,Enero,Uruguay,122,142,,264,POINT (4697157 -74140516)
2017,Enero,Uruguay,3,5,,8,POINT (4815189 -75736374)
2017,Enero,Uruguay,43,37,,80,POINT (6170465 -7542726)
2017,Enero,Venezuela,16,31,,47,POINT (10446304 -75516486)
2017,Enero,Venezuela,19,74,,93,POINT (10886686 -74776479)
2017,Enero,Venezuela,4116,5697,,9813,POINT (11360029 -72129595)
2017,Enero,Venezuela,8,30,,38,POINT (3451668 -76532004)
2017,Enero,Venezuela,49,39,,88,POINT (3866713 -67927521)
2017,Enero,Venezuela,3162,3400,,6562,POINT (4697157 -74140516)
2017,Enero,Venezuela,3,8,,11,POINT (4815189 -75736374)
2017,Enero,Venezuela,418,515,,933,POINT (6170465 -7542726)
2017,Enero,Venezuela,403,553,,956,POINT (6185536 -67484028)
2017,Enero,Venezuela,113,137,,250,POINT (7088729 -70740253)
2017,Enero,Venezuela,6,8,,14,POINT (7128047 -73181317)
2017,Enero,Venezuela,8660,12338,,20998,POINT (7819 -72453013)
2017,Enero,Venezuela,0,2,,2,POINT (7927233 -72508188)
2017,Enero,Venezuela,244,301,,545,POINT (836068 -72409396)
2017,Enero,Vietnam,1,1,,2,POINT (4697157 -74140516)
2017,Enero,Vietnam,0,1,,1,POINT (7819 -72453013)
2017,Enero,Islas Vírgenes Británicas/Territorio Británico de Ultramar,1,1,,2,POINT (4697157 -74140516)
2017,Enero,Islas Vírgenes Británicas/Territorio Británico de Ultramar,1,1,,2,POINT (6170465 -7542726)
2017,Enero,Zimbabue,0,1,,1,POINT (4697157 -74140516)
2017,Febrero,Afganistán,0,1,,1,POINT (10446304 -75516486)
2017,Febrero,Alemania,6,6,,12,POINT (10886686 -74776479)
2017,Febrero,Alemania,0,1,,1,POINT (11247723 -74213989)
2017,Febrero,Alemania,1,2,,3,POINT (125862 -81702165)
2017,Febrero,Alemania,48,83,,131,POINT (3451668 -76532004)
2017,Febrero,Alemania,1624,2283,,3907,POINT (4697157 -74140516)
2017,Febrero,Alemania,1,1,,2,POINT (4815189 -75736374)
2017,Febrero,Alemania,34,61,,95,POINT (6170465 -7542726)
2017,Febrero,Alemania,0,1,,1,POINT (7128047 -73181317)
2017,Febrero,Antigua y Barbuda,2,5,,7,POINT (10406342 -75527794)
2017,Febrero,Antigua y Barbuda,0,1,,1,POINT (3451668 -76532004)
2017,Febrero,Antigua y Barbuda,1,0,,1,POINT (4697157 -74140516)
2017,Febrero,Antigua y Barbuda,0,1,,1,POINT (6170465 -7542726)
2017,Febrero,Países Bajos,23,41,,64,POINT (10406342 -75527794)
2017,Febrero,Países Bajos,3,3,,6,POINT (10446304 -75516486)
2017,Febrero,Países Bajos,11,23,,34,POINT (10886686 -74776479)
2017,Febrero,Países Bajos,12,20,,32,POINT (11247723 -74213989)
2017,Febrero,Países Bajos,105,166,,271,POINT (3451668 -76532004)
2017,Febrero,Países Bajos,1045,1420,,2465,POINT (4697157 -74140516)
2017,Febrero,Países Bajos,2,5,,7,POINT (4815189 -75736374)
2017,Febrero,Países Bajos,59,85,,144,POINT (6170465 -7542726)
2017,Febrero,Países Bajos,7,8,,15,POINT (7128047 -73181317)
2017,Febrero,Argelia,1,0,,1,POINT (3451668 -76532004)
2017,Febrero,Argelia,2,6,,8,POINT (4697157 -74140516)
2017,Febrero,Argentina,7,9,,16,POINT (0.81488 -77356)
2017,Febrero,Argentina,18,98,,116,POINT (10446304 -75516486)
2017,Febrero,Argentina,6,10,,16,POINT (10886686 -74776479)
2017,Febrero,Argentina,284,240,,524,POINT (125862 -81702165)
2017,Febrero,Argentina,50,63,,113,POINT (3451668 -76532004)
2017,Febrero,Argentina,4315,4925,,9240,POINT (4697157 -74140516)
2017,Febrero,Argentina,3,5,,8,POINT (4815189 -75736374)
2017,Febrero,Argentina,93,104,,197,POINT (6170465 -7542726)
2017,Febrero,Argentina,2,1,,3,POINT (7128047 -73181317)
2017,Febrero,República de Armenia,1,1,,2,POINT (4697157 -74140516)
2017,Febrero,Aruba,6,18,,24,POINT (10406342 -75527794)
2017,Febrero,Aruba,5,1,,6,POINT (10886686 -74776479)
2017,Febrero,Aruba,27,35,,62,POINT (11247723 -74213989)
2017,Febrero,Aruba,11,10,,21,POINT (3451668 -76532004)
2017,Febrero,Aruba,713,923,,1636,POINT (4697157 -74140516)
2017,Febrero,Aruba,0,1,,1,POINT (4815189 -75736374)
2017,Febrero,Aruba,10,12,,22,POINT (6170465 -7542726)
2017,Febrero,Aruba,12,10,,22,POINT (7128047 -73181317)
2017,Febrero,Australia,0,1,,1,POINT (10886686 -74776479)
2017,Febrero,Australia,3,6,,9,POINT (3451668 -76532004)
2017,Febrero,Australia,37,57,,94,POINT (4697157 -74140516)
2017,Febrero,Australia,8,14,,22,POINT (6170465 -7542726)
2017,Febrero,Austria,0,1,,1,POINT (10886686 -74776479)
2017,Febrero,Austria,3,4,,7,POINT (3451668 -76532004)
2017,Febrero,Austria,37,63,,100,POINT (4697157 -74140516)
2017,Febrero,Austria,3,2,,5,POINT (6170465 -7542726)
2017,Febrero,Azerbaiyán,0,1,,1,POINT (3451668 -76532004)
2017,Febrero,Azerbaiyán,1,4,,5,POINT (4697157 -74140516)
2017,Febrero,Bahamas,0,1,,1,POINT (3451668 -76532004)
2017,Febrero,Bahamas,1,6,,7,POINT (4697157 -74140516)
2017,Febrero,Bahamas,0,2,,2,POINT (6170465 -7542726)
2017,Febrero,Bahamas,1,1,,2,POINT (7128047 -73181317)
2017,Febrero,Bahréin,0,1,,1,POINT (10446304 -75516486)
2017,Febrero,Bahréin,1,0,,1,POINT (3451668 -76532004)
2017,Febrero,Barbados,33,53,,86,POINT (4697157 -74140516)
2017,Febrero,República de Belarús,1,0,,1,POINT (11360029 -72129595)
2017,Febrero,República de Belarús,1,4,,5,POINT (3451668 -76532004)
2017,Febrero,República de Belarús,0,1,,1,POINT (4697157 -74140516)
2017,Febrero,Bélgica,1,0,,1,POINT (10886686 -74776479)
2017,Febrero,Bélgica,0,2,,2,POINT (11247723 -74213989)
2017,Febrero,Bélgica,15,13,,28,POINT (3451668 -76532004)
2017,Febrero,Bélgica,55,72,,127,POINT (4697157 -74140516)
2017,Febrero,Bélgica,12,16,,28,POINT (6170465 -7542726)
2017,Febrero,Belice,0,1,,1,POINT (11117206 -74232675)
2017,Febrero,Belice,1,2,,3,POINT (125744111 -81703935)
2017,Febrero,Belice,1,2,,3,POINT (3451668 -76532004)
2017,Febrero,Belice,2,5,,7,POINT (4697157 -74140516)
2017,Febrero,Belice,0,3,,3,POINT (6170465 -7542726)
2017,Febrero,Benín,1,1,,2,POINT (10446304 -75516486)
2017,Febrero,Benín,0,1,,1,POINT (3451668 -76532004)
2017,Febrero,Bermudas/Territorio Británico de Ultramar,0,1,,1,POINT (4697157 -74140516)
2017,Febrero,Bolivia,3,1,,4,POINT (0.81488 -77356)
2017,Febrero,Bolivia,2,1,,3,POINT (10446304 -75516486)
2017,Febrero,Bolivia,4,5,,9,POINT (10886686 -74776479)
2017,Febrero,Bolivia,31,18,,49,POINT (125862 -81702165)
2017,Febrero,Bolivia,26,19,,45,POINT (3451668 -76532004)
2017,Febrero,Bolivia,408,518,,926,POINT (4697157 -74140516)
2017,Febrero,Bolivia,0,2,,2,POINT (4815189 -75736374)
2017,Febrero,Bolivia,24,28,,52,POINT (6170465 -7542726)
2017,Febrero,Bosnia y Herzegovina,1,0,,1,POINT (3451668 -76532004)
2017,Febrero,Brasil,263,257,,520,POINT (-4191162 -69941498)
2017,Febrero,Brasil,1,1,,2,POINT (-4214082 -69941431)
2017,Febrero,Brasil,2,1,,3,POINT (0.81488 -77356)
2017,Febrero,Brasil,0,2,,2,POINT (10406342 -75527794)
2017,Febrero,Brasil,15,5,,20,POINT (10446304 -75516486)
2017,Febrero,Brasil,3,3,,6,POINT (10886686 -74776479)
2017,Febrero,Brasil,0,1,,1,POINT (10970933 -74765343)
2017,Febrero,Brasil,478,384,,862,POINT (125862 -81702165)
2017,Febrero,Brasil,129,143,,272,POINT (3451668 -76532004)
2017,Febrero,Brasil,0,1,,1,POINT (3866713 -67927521)
2017,Febrero,Brasil,4739,5882,,10621,POINT (4697157 -74140516)
2017,Febrero,Brasil,5,3,,8,POINT (4815189 -75736374)
2017,Febrero,Brasil,139,160,,299,POINT (6170465 -7542726)
2017,Febrero,Brasil,1,3,,4,POINT (7128047 -73181317)
2017,Febrero,Bulgaria,1,2,,3,POINT (4697157 -74140516)
2017,Febrero,Burundi,0,1,,1,POINT (4697157 -74140516)
2017,Febrero,Islas Caimán/Territorio Británico de Ultramar,2,2,,4,POINT (10406342 -75527794)
2017,Febrero,Islas Caimán/Territorio Británico de Ultramar,2,2,,4,POINT (133387613 -81372937)
2017,Febrero,Islas Caimán/Territorio Británico de Ultramar,2,7,,9,POINT (4697157 -74140516)
2017,Febrero,Camboya,1,1,,2,POINT (4697157 -74140516)
2017,Febrero,Camerún,0,1,,1,POINT (4697157 -74140516)
2017,Febrero,Canadá,560,595,,1155,POINT (10446304 -75516486)
2017,Febrero,Canadá,7,10,,17,POINT (10886686 -74776479)
2017,Febrero,Canadá,316,285,,601,POINT (125862 -81702165)
2017,Febrero,Canadá,47,59,,106,POINT (3451668 -76532004)
2017,Febrero,Canadá,792,1197,,1989,POINT (4697157 -74140516)
2017,Febrero,Canadá,1,6,,7,POINT (4815189 -75736374)
2017,Febrero,Canadá,102,192,,294,POINT (6170465 -7542726)
2017,Febrero,Canadá,3,4,,7,POINT (7128047 -73181317)
2017,Febrero,España,2,3,,5,POINT (10886686 -74776479)
2017,Febrero,España,0,8,,8,POINT (10970933 -74765343)
2017,Febrero,España,398,658,,1056,POINT (3451668 -76532004)
2017,Febrero,España,3729,6316,,10045,POINT (4697157 -74140516)
2017,Febrero,España,2,5,,7,POINT (4815189 -75736374)
2017,Febrero,España,273,542,,815,POINT (6170465 -7542726)
2017,Febrero,España,0,1,,1,POINT (7128047 -73181317)
2017,Febrero,República Del Congo,0,2,,2,POINT (4697157 -74140516)
2017,Febrero,República de Corea,1,2,,3,POINT (3451668 -76532004)
2017,Febrero,República de Corea,20,16,,36,POINT (4697157 -74140516)
2017,Febrero,República de Corea,1,0,,1,POINT (4815189 -75736374)
2017,Febrero,República de Corea,0,6,,6,POINT (6170465 -7542726)
2017,Febrero,Costa de Marfil,2,1,,3,POINT (3451668 -76532004)
2017,Febrero,Costa de Marfil,4,8,,12,POINT (4697157 -74140516)
2017,Febrero,Costa Rica,3,9,,12,POINT (10406342 -75527794)
2017,Febrero,Costa Rica,2,2,,4,POINT (10446304 -75516486)
2017,Febrero,Costa Rica,3,6,,9,POINT (10886686 -74776479)
2017,Febrero,Costa Rica,0,3,,3,POINT (10970933 -74765343)
2017,Febrero,Costa Rica,307,268,,575,POINT (125862 -81702165)
2017,Febrero,Costa Rica,0,2,,2,POINT (133387613 -81372937)
2017,Febrero,Costa Rica,9,34,,43,POINT (3451668 -76532004)
2017,Febrero,Costa Rica,917,1321,,2238,POINT (4697157 -74140516)
2017,Febrero,Costa Rica,1,6,,7,POINT (4815189 -75736374)
2017,Febrero,Costa Rica,70,129,,199,POINT (6170465 -7542726)
2017,Febrero,Costa Rica,1,2,,3,POINT (7128047 -73181317)
2017,Febrero,Croacia,0,3,,3,POINT (3451668 -76532004)
2017,Febrero,Croacia,1,2,,3,POINT (4697157 -74140516)
2017,Febrero,Croacia,0,1,,1,POINT (6170465 -7542726)
2017,Febrero,Cuba,1,10,,11,POINT (10886686 -74776479)
2017,Febrero,Cuba,0,2,,2,POINT (125744111 -81703935)
2017,Febrero,Cuba,12,35,,47,POINT (3451668 -76532004)
2017,Febrero,Cuba,402,668,,1070,POINT (4697157 -74140516)
2017,Febrero,Cuba,17,16,,33,POINT (6170465 -7542726)
2017,Febrero,Cuba,1,2,,3,POINT (7128047 -73181317)
2017,Febrero,Curazao,2,7,,9,POINT (4697157 -74140516)
2017,Febrero,República Checa,0,3,,3,POINT (3451668 -76532004)
2017,Febrero,República Checa,15,22,,37,POINT (4697157 -74140516)
2017,Febrero,República Checa,3,3,,6,POINT (6170465 -7542726)
2017,Febrero,Chile,7,9,,16,POINT (0.81488 -77356)
2017,Febrero,Chile,27,26,,53,POINT (10446304 -75516486)
2017,Febrero,Chile,8,11,,19,POINT (10886686 -74776479)
2017,Febrero,Chile,182,151,,333,POINT (125862 -81702165)
2017,Febrero,Chile,39,80,,119,POINT (3451668 -76532004)
2017,Febrero,Chile,5526,6046,,11572,POINT (4697157 -74140516)
2017,Febrero,Chile,7,2,,9,POINT (4815189 -75736374)
2017,Febrero,Chile,29,57,,86,POINT (6170465 -7542726)
2017,Febrero,Chile,0,2,,2,POINT (7128047 -73181317)
2017,Febrero,China,2,5,,7,POINT (3451668 -76532004)
2017,Febrero,China,26,94,,120,POINT (4697157 -74140516)
2017,Febrero,China,1,3,,4,POINT (6170465 -7542726)
2017,Febrero,Dinamarca,4,3,,7,POINT (3451668 -76532004)
2017,Febrero,Dinamarca,17,39,,56,POINT (4697157 -74140516)
2017,Febrero,Dinamarca,4,2,,6,POINT (6170465 -7542726)
2017,Febrero,Dominica,0,2,,2,POINT (3451668 -76532004)
2017,Febrero,Dominica,1,1,,2,POINT (4697157 -74140516)
2017,Febrero,Ecuador,1,0,,1,POINT (0.185957 -7478366)
2017,Febrero,Ecuador,123,296,,419,POINT (0.33002 -76876446)
2017,Febrero,Ecuador,1,0,,1,POINT (0.812436 -77847006)
2017,Febrero,Ecuador,3415,4904,,8319,POINT (0.81488 -77356)
2017,Febrero,Ecuador,28,54,,82,POINT (1800143 -78802679)
2017,Febrero,Ecuador,57,40,,97,POINT (10446304 -75516486)
2017,Febrero,Ecuador,2,3,,5,POINT (10886686 -74776479)
2017,Febrero,Ecuador,3,2,,5,POINT (125862 -81702165)
2017,Febrero,Ecuador,374,351,,725,POINT (3451668 -76532004)
2017,Febrero,Ecuador,1,4,,5,POINT (3884426 -77061029)
2017,Febrero,Ecuador,3241,4449,,7690,POINT (4697157 -74140516)
2017,Febrero,Ecuador,30,69,,99,POINT (6170465 -7542726)
2017,Febrero,Ecuador,0,2,,2,POINT (7128047 -73181317)
2017,Febrero,Egipto,2,8,,10,POINT (4697157 -74140516)
2017,Febrero,El Salvador,0,4,,4,POINT (10446304 -75516486)
2017,Febrero,El Salvador,2,3,,5,POINT (10886686 -74776479)
2017,Febrero,El Salvador,7,8,,15,POINT (125862 -81702165)
2017,Febrero,El Salvador,113,184,,297,POINT (3451668 -76532004)
2017,Febrero,El Salvador,1001,1414,,2415,POINT (4697157 -74140516)
2017,Febrero,El Salvador,0,1,,1,POINT (4815189 -75736374)
2017,Febrero,El Salvador,173,267,,440,POINT (6170465 -7542726)
2017,Febrero,Emiratos Árabes,0,2,,2,POINT (10886686 -74776479)
2017,Febrero,Emiratos Árabes,2,2,,4,POINT (4697157 -74140516)
2017,Febrero,Emiratos Árabes,0,1,,1,POINT (6170465 -7542726)
2017,Febrero,Eritrea,0,1,,1,POINT (6170465 -7542726)
2017,Febrero,Eslovaquia,2,7,,9,POINT (4697157 -74140516)
2017,Febrero,Eslovenia,9,6,,15,POINT (4697157 -74140516)
2017,Febrero,Estados Unidos de América,0,57,,57,POINT (10406342 -75527794)
2017,Febrero,Estados Unidos de América,3508,4699,,8207,POINT (10446304 -75516486)
2017,Febrero,Estados Unidos de América,572,1023,,1595,POINT (10886686 -74776479)
2017,Febrero,Estados Unidos de América,0,6,,6,POINT (10970933 -74765343)
2017,Febrero,Estados Unidos de América,0,20,,20,POINT (11247723 -74213989)
2017,Febrero,Estados Unidos de América,11,19,,30,POINT (125862 -81702165)
2017,Febrero,Estados Unidos de América,932,1424,,2356,POINT (3451668 -76532004)
2017,Febrero,Estados Unidos de América,88,136,,224,POINT (445285 -75766353)
2017,Febrero,Estados Unidos de América,8740,14852,,23592,POINT (4697157 -74140516)
2017,Febrero,Estados Unidos de América,79,152,,231,POINT (4815189 -75736374)
2017,Febrero,Estados Unidos de América,1898,4982,,6880,POINT (6170465 -7542726)
2017,Febrero,Estados Unidos de América,24,39,,63,POINT (7128047 -73181317)
2017,Febrero,Estados Unidos de América,1,17,,18,POINT (9402597 -75681642)
2017,Febrero,Estonia,9,22,,31,POINT (4697157 -74140516)
2017,Febrero,Estonia,0,1,,1,POINT (6170465 -7542726)
2017,Febrero,Filipinas,0,1,,1,POINT (10446304 -75516486)
2017,Febrero,Filipinas,0,1,,1,POINT (10886686 -74776479)
2017,Febrero,Filipinas,1,9,,10,POINT (3451668 -76532004)
2017,Febrero,Filipinas,6,13,,19,POINT (4697157 -74140516)
2017,Febrero,Filipinas,0,3,,3,POINT (6170465 -7542726)
2017,Febrero,Finlandia,0,1,,1,POINT (3451668 -76532004)
2017,Febrero,Finlandia,13,10,,23,POINT (4697157 -74140516)
2017,Febrero,Finlandia,0,1,,1,POINT (6170465 -7542726)
2017,Febrero,Francia,2,1,,3,POINT (10406342 -75527794)
2017,Febrero,Francia,3,8,,11,POINT (10886686 -74776479)
2017,Febrero,Francia,53,85,,138,POINT (3451668 -76532004)
2017,Febrero,Francia,1765,2727,,4492,POINT (4697157 -74140516)
2017,Febrero,Francia,1,2,,3,POINT (4815189 -75736374)
2017,Febrero,Francia,37,62,,99,POINT (6170465 -7542726)
2017,Febrero,Granada,0,1,,1,POINT (125862 -81702165)
2017,Febrero,Grecia,8,6,,14,POINT (4697157 -74140516)
2017,Febrero,Grecia,1,0,,1,POINT (6170465 -7542726)
2017,Febrero,Guatemala,4,6,,10,POINT (10446304 -75516486)
2017,Febrero,Guatemala,1,2,,3,POINT (10886686 -74776479)
2017,Febrero,Guatemala,10,15,,25,POINT (125862 -81702165)
2017,Febrero,Guatemala,15,39,,54,POINT (3451668 -76532004)
2017,Febrero,Guatemala,317,576,,893,POINT (4697157 -74140516)
2017,Febrero,Guatemala,2,8,,10,POINT (4815189 -75736374)
2017,Febrero,Guatemala,59,120,,179,POINT (6170465 -7542726)
2017,Febrero,Guatemala,1,2,,3,POINT (7128047 -73181317)
2017,Febrero,Guyana,1,2,,3,POINT (10406342 -75527794)
2017,Febrero,Guyana,1,1,,2,POINT (4697157 -74140516)
2017,Febrero,Guyana,1,0,,1,POINT (6170465 -7542726)
2017,Febrero,Guinea Ecuatorial,1,0,,1,POINT (3451668 -76532004)
2017,Febrero,Guinea Ecuatorial,1,0,,1,POINT (6170465 -7542726)
2017,Febrero,Guadalupe/Territorio Francés,5,10,,15,POINT (11247723 -74213989)
2017,Febrero,Guadalupe/Territorio Francés,0,1,,1,POINT (4697157 -74140516)
2017,Febrero,Guadalupe/Territorio Francés,0,1,,1,POINT (6170465 -7542726)
2017,Febrero,Guayana Francesa/Departamento de Ultramar Francés,1,1,,2,POINT (3451668 -76532004)
2017,Febrero,Haití,0,4,,4,POINT (10406342 -75527794)
2017,Febrero,Haití,0,1,,1,POINT (10886686 -74776479)
2017,Febrero,Haití,0,7,,7,POINT (10970933 -74765343)
2017,Febrero,Haití,0,1,,1,POINT (3451668 -76532004)
2017,Febrero,Haití,2,2,,4,POINT (4697157 -74140516)
2017,Febrero,Haití,0,2,,2,POINT (6170465 -7542726)
2017,Febrero,Honduras,0,1,,1,POINT (10406342 -75527794)
2017,Febrero,Honduras,1,3,,4,POINT (10886686 -74776479)
2017,Febrero,Honduras,0,1,,1,POINT (10970933 -74765343)
2017,Febrero,Honduras,1,1,,2,POINT (133387613 -81372937)
2017,Febrero,Honduras,7,8,,15,POINT (3451668 -76532004)
2017,Febrero,Honduras,43,70,,113,POINT (4697157 -74140516)
2017,Febrero,Honduras,2,1,,3,POINT (4815189 -75736374)
2017,Febrero,Honduras,31,38,,69,POINT (6170465 -7542726)
2017,Febrero,Honduras,0,3,,3,POINT (7128047 -73181317)
2017,Febrero,Hong Kong,2,4,,6,POINT (4697157 -74140516)
2017,Febrero,Hungría,1,1,,2,POINT (3451668 -76532004)
2017,Febrero,Hungría,4,5,,9,POINT (4697157 -74140516)
2017,Febrero,India,0,2,,2,POINT (10446304 -75516486)
2017,Febrero,India,1,4,,5,POINT (3451668 -76532004)
2017,Febrero,India,6,26,,32,POINT (4697157 -74140516)
2017,Febrero,India,2,5,,7,POINT (6170465 -7542726)
2017,Febrero,Indonesia,0,3,,3,POINT (3451668 -76532004)
2017,Febrero,Indonesia,2,1,,3,POINT (4697157 -74140516)
2017,Febrero,Iraq,0,2,,2,POINT (4697157 -74140516)
2017,Febrero,República de Irlanda,0,1,,1,POINT (3451668 -76532004)
2017,Febrero,República de Irlanda,7,13,,20,POINT (4697157 -74140516)
2017,Febrero,República de Irlanda,0,3,,3,POINT (6170465 -7542726)
2017,Febrero,Isla de Man,1,0,,1,POINT (4697157 -74140516)
2017,Febrero,Israel,1,1,,2,POINT (3451668 -76532004)
2017,Febrero,Israel,17,66,,83,POINT (4697157 -74140516)
2017,Febrero,Israel,2,5,,7,POINT (6170465 -7542726)
2017,Febrero,Italia,0,1,,1,POINT (10886686 -74776479)
2017,Febrero,Italia,0,1,,1,POINT (125862 -81702165)
2017,Febrero,Italia,29,70,,99,POINT (3451668 -76532004)
2017,Febrero,Italia,194,384,,578,POINT (4697157 -74140516)
2017,Febrero,Italia,0,6,,6,POINT (4815189 -75736374)
2017,Febrero,Italia,18,70,,88,POINT (6170465 -7542726)
2017,Febrero,Jamaica,0,3,,3,POINT (10406342 -75527794)
2017,Febrero,Jamaica,4,4,,8,POINT (10446304 -75516486)
2017,Febrero,Jamaica,0,5,,5,POINT (10886686 -74776479)
2017,Febrero,Jamaica,1,2,,3,POINT (11247723 -74213989)
2017,Febrero,Jamaica,2,5,,7,POINT (133387613 -81372937)
2017,Febrero,Jamaica,3,2,,5,POINT (3451668 -76532004)
2017,Febrero,Jamaica,4,4,,8,POINT (4697157 -74140516)
2017,Febrero,Jamaica,0,1,,1,POINT (4815189 -75736374)
2017,Febrero,Jamaica,2,0,,2,POINT (6170465 -7542726)
2017,Febrero,Japón,4,10,,14,POINT (3451668 -76532004)
2017,Febrero,Japón,12,23,,35,POINT (4697157 -74140516)
2017,Febrero,Japón,1,6,,7,POINT (6170465 -7542726)
2017,Febrero,Jordania,1,0,,1,POINT (4697157 -74140516)
2017,Febrero,Kazajistán,1,1,,2,POINT (4697157 -74140516)
2017,Febrero,Kenia,0,1,,1,POINT (3451668 -76532004)
2017,Febrero,Kenia,3,2,,5,POINT (4697157 -74140516)
2017,Febrero,Kuwait,0,1,,1,POINT (4697157 -74140516)
2017,Febrero,Letonia,0,1,,1,POINT (4697157 -74140516)
2017,Febrero,Lituania,1,5,,6,POINT (4697157 -74140516)
2017,Febrero,Líbano,2,5,,7,POINT (4697157 -74140516)
2017,Febrero,Libia,2,0,,2,POINT (4697157 -74140516)
2017,Febrero,Liechtenstein,0,1,,1,POINT (4697157 -74140516)
2017,Febrero,Luxemburgo,0,1,,1,POINT (3451668 -76532004)
2017,Febrero,Luxemburgo,2,5,,7,POINT (4697157 -74140516)
2017,Febrero,Malasia,0,3,,3,POINT (4697157 -74140516)
2017,Febrero,Malta,1,4,,5,POINT (4697157 -74140516)
2017,Febrero,Malta,0,1,,1,POINT (6170465 -7542726)
2017,Febrero,Marruecos,1,1,,2,POINT (4697157 -74140516)
2017,Febrero,Martinica/Departamento de Ultramar Francés,3,2,,5,POINT (11247723 -74213989)
2017,Febrero,México,0,4,,4,POINT (10406342 -75527794)
2017,Febrero,México,15,36,,51,POINT (10446304 -75516486)
2017,Febrero,México,9,21,,30,POINT (10886686 -74776479)
2017,Febrero,México,0,4,,4,POINT (10970933 -74765343)
2017,Febrero,México,3,0,,3,POINT (125862 -81702165)
2017,Febrero,México,57,141,,198,POINT (3451668 -76532004)
2017,Febrero,México,4556,8024,,12580,POINT (4697157 -74140516)
2017,Febrero,México,5,13,,18,POINT (4815189 -75736374)
2017,Febrero,México,468,1171,,1639,POINT (6170465 -7542726)
2017,Febrero,México,0,9,,9,POINT (7128047 -73181317)
2017,Febrero,República de Moldavia,1,0,,1,POINT (4697157 -74140516)
2017,Febrero,Mónaco,1,1,,2,POINT (4697157 -74140516)
2017,Febrero,Nicaragua,0,14,,14,POINT (10406342 -75527794)
2017,Febrero,Nicaragua,0,1,,1,POINT (10446304 -75516486)
2017,Febrero,Nicaragua,0,2,,2,POINT (10886686 -74776479)
2017,Febrero,Nicaragua,0,2,,2,POINT (11117206 -74232675)
2017,Febrero,Nicaragua,2,0,,2,POINT (125862 -81702165)
2017,Febrero,Nicaragua,3,8,,11,POINT (3451668 -76532004)
2017,Febrero,Nicaragua,0,1,,1,POINT (3884426 -77061029)
2017,Febrero,Nicaragua,26,35,,61,POINT (4697157 -74140516)
2017,Febrero,Nicaragua,3,1,,4,POINT (4815189 -75736374)
2017,Febrero,Nicaragua,13,18,,31,POINT (6170465 -7542726)
2017,Febrero,Nicaragua,1,0,,1,POINT (7128047 -73181317)
2017,Febrero,Nigeria,0,4,,4,POINT (4697157 -74140516)
2017,Febrero,Nigeria,0,2,,2,POINT (6170465 -7542726)
2017,Febrero,Noruega,0,1,,1,POINT (10446304 -75516486)
2017,Febrero,Noruega,0,1,,1,POINT (10886686 -74776479)
2017,Febrero,Noruega,4,1,,5,POINT (3451668 -76532004)
2017,Febrero,Noruega,17,16,,33,POINT (4697157 -74140516)
2017,Febrero,Noruega,0,1,,1,POINT (4815189 -75736374)
2017,Febrero,Noruega,2,4,,6,POINT (6170465 -7542726)
2017,Febrero,Nueva Caledonia/Territorio francés,0,2,,2,POINT (3451668 -76532004)
2017,Febrero,Nueva Zelanda,6,4,,10,POINT (3451668 -76532004)
2017,Febrero,Nueva Zelanda,1,6,,7,POINT (4697157 -74140516)
2017,Febrero,Nueva Zelanda,2,4,,6,POINT (6170465 -7542726)
2017,Febrero,Panamá,1,1,,2,POINT (1800143 -78802679)
2017,Febrero,Panamá,1525,1272,,2797,POINT (10406342 -75527794)
2017,Febrero,Panamá,3911,4073,,7984,POINT (10446304 -75516486)
2017,Febrero,Panamá,445,770,,1215,POINT (10886686 -74776479)
2017,Febrero,Panamá,0,9,,9,POINT (10970933 -74765343)
2017,Febrero,Panamá,1,2,,3,POINT (11247723 -74213989)
2017,Febrero,Panamá,4,11,,15,POINT (125744111 -81703935)
2017,Febrero,Panamá,651,593,,1244,POINT (125862 -81702165)
2017,Febrero,Panamá,4,4,,8,POINT (133387613 -81372937)
2017,Febrero,Panamá,406,602,,1008,POINT (3451668 -76532004)
2017,Febrero,Panamá,0,46,,46,POINT (3884426 -77061029)
2017,Febrero,Panamá,58,73,,131,POINT (445285 -75766353)
2017,Febrero,Panamá,5262,6925,,12187,POINT (4697157 -74140516)
2017,Febrero,Panamá,62,126,,188,POINT (4815189 -75736374)
2017,Febrero,Panamá,3095,3545,,6640,POINT (6170465 -7542726)
2017,Febrero,Panamá,0,1,,1,POINT (6222552 -77401154)
2017,Febrero,Panamá,3,1,,4,POINT (7102626 -77762647)
2017,Febrero,Panamá,13,17,,30,POINT (7128047 -73181317)
2017,Febrero,Panamá,112,150,,262,POINT (863337 -7735002)
2017,Febrero,Paraguay,0,1,,1,POINT (10446304 -75516486)
2017,Febrero,Paraguay,0,2,,2,POINT (10886686 -74776479)
2017,Febrero,Paraguay,64,42,,106,POINT (125862 -81702165)
2017,Febrero,Paraguay,9,46,,55,POINT (3451668 -76532004)
2017,Febrero,Paraguay,57,58,,115,POINT (4697157 -74140516)
2017,Febrero,Paraguay,1,0,,1,POINT (4815189 -75736374)
2017,Febrero,Paraguay,19,17,,36,POINT (6170465 -7542726)
2017,Febrero,Paraguay,2,2,,4,POINT (7128047 -73181317)
2017,Febrero,Perú,126,223,,349,POINT (-4191162 -69941498)
2017,Febrero,Perú,5,7,,12,POINT (-4214082 -69941431)
2017,Febrero,Perú,1,0,,1,POINT (0.185957 -7478366)
2017,Febrero,Perú,19,32,,51,POINT (0.81488 -77356)
2017,Febrero,Perú,0,1,,1,POINT (10406342 -75527794)
2017,Febrero,Perú,1129,890,,2019,POINT (10446304 -75516486)
2017,Febrero,Perú,8,9,,17,POINT (10886686 -74776479)
2017,Febrero,Perú,430,327,,757,POINT (125862 -81702165)
2017,Febrero,Perú,443,587,,1030,POINT (3451668 -76532004)
2017,Febrero,Perú,6257,7637,,13894,POINT (4697157 -74140516)
2017,Febrero,Perú,5,3,,8,POINT (4815189 -75736374)
2017,Febrero,Perú,624,834,,1458,POINT (6170465 -7542726)
2017,Febrero,Perú,3,4,,7,POINT (7128047 -73181317)
2017,Febrero,Perú,0,1,,1,POINT (9402597 -75681642)
2017,Febrero,Palestina,0,1,,1,POINT (4697157 -74140516)
2017,Febrero,Polonia,3,5,,8,POINT (3451668 -76532004)
2017,Febrero,Polonia,9,23,,32,POINT (4697157 -74140516)
2017,Febrero,Polonia,4,1,,5,POINT (6170465 -7542726)
2017,Febrero,Portugal,0,5,,5,POINT (3451668 -76532004)
2017,Febrero,Portugal,27,49,,76,POINT (4697157 -74140516)
2017,Febrero,Portugal,2,5,,7,POINT (6170465 -7542726)
2017,Febrero,Puerto Rico/Territorio de Estados Unidos,0,3,,3,POINT (10406342 -75527794)
2017,Febrero,Puerto Rico/Territorio de Estados Unidos,1,3,,4,POINT (10446304 -75516486)
2017,Febrero,Puerto Rico/Territorio de Estados Unidos,8,30,,38,POINT (10886686 -74776479)
2017,Febrero,Puerto Rico/Territorio de Estados Unidos,0,1,,1,POINT (11247723 -74213989)
2017,Febrero,Puerto Rico/Territorio de Estados Unidos,1,0,,1,POINT (125862 -81702165)
2017,Febrero,Puerto Rico/Territorio de Estados Unidos,28,49,,77,POINT (3451668 -76532004)
2017,Febrero,Puerto Rico/Territorio de Estados Unidos,342,489,,831,POINT (4697157 -74140516)
2017,Febrero,Puerto Rico/Territorio de Estados Unidos,7,12,,19,POINT (4815189 -75736374)
2017,Febrero,Puerto Rico/Territorio de Estados Unidos,41,80,,121,POINT (6170465 -7542726)
2017,Febrero,Puerto Rico/Territorio de Estados Unidos,1,3,,4,POINT (7128047 -73181317)
2017,Febrero,Qatar,1,0,,1,POINT (4697157 -74140516)
2017,Febrero,Reino Unido de Gran Bretaña e Irlanda del Norte,0,1,,1,POINT (10886686 -74776479)
2017,Febrero,Reino Unido de Gran Bretaña e Irlanda del Norte,4,14,,18,POINT (3451668 -76532004)
2017,Febrero,Reino Unido de Gran Bretaña e Irlanda del Norte,874,1391,,2265,POINT (4697157 -74140516)
2017,Febrero,Reino Unido de Gran Bretaña e Irlanda del Norte,23,42,,65,POINT (6170465 -7542726)
2017,Febrero,República CentroÁfricana,0,1,,1,POINT (4697157 -74140516)
2017,Febrero,Federación de Rusia,3,12,,15,POINT (3451668 -76532004)
2017,Febrero,Federación de Rusia,7,27,,34,POINT (4697157 -74140516)
2017,Febrero,Federación de Rusia,1,1,,2,POINT (6170465 -7542726)
2017,Febrero,República Dominicana,3,10,,13,POINT (10406342 -75527794)
2017,Febrero,República Dominicana,6,13,,19,POINT (10446304 -75516486)
2017,Febrero,República Dominicana,57,40,,97,POINT (10886686 -74776479)
2017,Febrero,República Dominicana,1,2,,3,POINT (11117206 -74232675)
2017,Febrero,República Dominicana,11,31,,42,POINT (3451668 -76532004)
2017,Febrero,República Dominicana,680,1026,,1706,POINT (4697157 -74140516)
2017,Febrero,República Dominicana,5,6,,11,POINT (4815189 -75736374)
2017,Febrero,República Dominicana,32,70,,102,POINT (6170465 -7542726)
2017,Febrero,República Dominicana,3,4,,7,POINT (7128047 -73181317)
2017,Febrero,Reunión,0,1,,1,POINT (4697157 -74140516)
2017,Febrero,República Democrática Popular de Corea,0,2,,2,POINT (4697157 -74140516)
2017,Febrero,Rumania,0,1,,1,POINT (3451668 -76532004)
2017,Febrero,Rumania,3,10,,13,POINT (4697157 -74140516)
2017,Febrero,San Cristóbal y Nevis,0,1,,1,POINT (4697157 -74140516)
2017,Febrero,Santa Lucia,1,0,,1,POINT (10886686 -74776479)
2017,Febrero,Santa Lucia,0,1,,1,POINT (4697157 -74140516)
2017,Febrero,Santa Sede/Ciudad del Vaticano,1,1,,2,POINT (4697157 -74140516)
2017,Febrero,Serbia,1,3,,4,POINT (4697157 -74140516)
2017,Febrero,Singapur,0,4,,4,POINT (11247723 -74213989)
2017,Febrero,Singapur,0,4,,4,POINT (4697157 -74140516)
2017,Febrero,República Árabe Siria,0,1,,1,POINT (4697157 -74140516)
2017,Febrero,Sudáfrica,4,6,,10,POINT (4697157 -74140516)
2017,Febrero,Suecia,6,10,,16,POINT (3451668 -76532004)
2017,Febrero,Suecia,32,49,,81,POINT (4697157 -74140516)
2017,Febrero,Suecia,1,0,,1,POINT (4815189 -75736374)
2017,Febrero,Suecia,5,5,,10,POINT (6170465 -7542726)
2017,Febrero,Suecia,1,1,,2,POINT (7128047 -73181317)
2017,Febrero,Suiza,2,0,,2,POINT (10886686 -74776479)
2017,Febrero,Suiza,9,21,,30,POINT (3451668 -76532004)
2017,Febrero,Suiza,106,140,,246,POINT (4697157 -74140516)
2017,Febrero,Suiza,30,52,,82,POINT (6170465 -7542726)
2017,Febrero,Surinam,6,1,,7,POINT (4697157 -74140516)
2017,Febrero,Surinam,0,1,,1,POINT (6170465 -7542726)
2017,Febrero,Taiwán,0,2,,2,POINT (3451668 -76532004)
2017,Febrero,Taiwán,0,4,,4,POINT (4697157 -74140516)
2017,Febrero,Taiwán,2,2,,4,POINT (6170465 -7542726)
2017,Febrero,Tailandia,0,4,,4,POINT (4697157 -74140516)
2017,Febrero,Tailandia,1,0,,1,POINT (6170465 -7542726)
2017,Febrero,Trinidad y Tobago,0,1,,1,POINT (10406342 -75527794)
2017,Febrero,Trinidad y Tobago,1,1,,2,POINT (10446304 -75516486)
2017,Febrero,Trinidad y Tobago,3,0,,3,POINT (10886686 -74776479)
2017,Febrero,Trinidad y Tobago,1,7,,8,POINT (3451668 -76532004)
2017,Febrero,Trinidad y Tobago,10,5,,15,POINT (4697157 -74140516)
2017,Febrero,Trinidad y Tobago,6,20,,26,POINT (6170465 -7542726)
2017,Febrero,Trinidad y Tobago,2,3,,5,POINT (7128047 -73181317)
2017,Febrero,Túnez,1,3,,4,POINT (4697157 -74140516)
2017,Febrero,Túnez,0,1,,1,POINT (7819 -72453013)
2017,Febrero,Turkmenistán,2,3,,5,POINT (4697157 -74140516)
2017,Febrero,Turkmenistán,0,1,,1,POINT (6170465 -7542726)
2017,Febrero,Turquía,0,1,,1,POINT (11247723 -74213989)
2017,Febrero,Turquía,1,1,,2,POINT (3451668 -76532004)
2017,Febrero,Turquía,226,369,,595,POINT (4697157 -74140516)
2017,Febrero,Turquía,1,3,,4,POINT (6170465 -7542726)
2017,Febrero,Ucrania,4,5,,9,POINT (3451668 -76532004)
2017,Febrero,Ucrania,0,2,,2,POINT (4697157 -74140516)
2017,Febrero,Uruguay,0,5,,5,POINT (10886686 -74776479)
2017,Febrero,Uruguay,38,21,,59,POINT (125862 -81702165)
2017,Febrero,Uruguay,15,19,,34,POINT (3451668 -76532004)
2017,Febrero,Uruguay,77,116,,193,POINT (4697157 -74140516)
2017,Febrero,Uruguay,1,1,,2,POINT (4815189 -75736374)
2017,Febrero,Uruguay,45,37,,82,POINT (6170465 -7542726)
2017,Febrero,Uruguay,1,1,,2,POINT (7128047 -73181317)
2017,Febrero,Vanuatu,1,0,,1,POINT (7819 -72453013)
2017,Febrero,Venezuela,0,4,,4,POINT (10406342 -75527794)
2017,Febrero,Venezuela,5,11,,16,POINT (10446304 -75516486)
2017,Febrero,Venezuela,24,73,,97,POINT (10886686 -74776479)
2017,Febrero,Venezuela,0,1,,1,POINT (10970933 -74765343)
2017,Febrero,Venezuela,11,8,,19,POINT (11117206 -74232675)
2017,Febrero,Venezuela,4617,5720,,10337,POINT (11360029 -72129595)
2017,Febrero,Venezuela,1,0,,1,POINT (125862 -81702165)
2017,Febrero,Venezuela,9,20,,29,POINT (3451668 -76532004)
2017,Febrero,Venezuela,53,46,,99,POINT (3866713 -67927521)
2017,Febrero,Venezuela,2710,3151,,5861,POINT (4697157 -74140516)
2017,Febrero,Venezuela,3,3,,6,POINT (4815189 -75736374)
2017,Febrero,Venezuela,400,458,,858,POINT (6170465 -7542726)
2017,Febrero,Venezuela,517,710,,1227,POINT (6185536 -67484028)
2017,Febrero,Venezuela,77,82,,159,POINT (7088729 -70740253)
2017,Febrero,Venezuela,2,1,,3,POINT (7128047 -73181317)
2017,Febrero,Venezuela,7026,9695,,16721,POINT (7819 -72453013)
2017,Febrero,Venezuela,1,10,,11,POINT (7927233 -72508188)
2017,Febrero,Venezuela,159,217,,376,POINT (836068 -72409396)
2017,Febrero,Vietnam,0,2,,2,POINT (4697157 -74140516)
2017,Febrero,Islas Vírgenes Británicas/Territorio Británico de Ultramar,15,32,,47,POINT (10406342 -75527794)
2017,Febrero,Islas Vírgenes Británicas/Territorio Británico de Ultramar,1,4,,5,POINT (4697157 -74140516)
2017,Febrero,Islas Vírgenes Británicas/Territorio Británico de Ultramar,2,0,,2,POINT (6170465 -7542726)
2017,Febrero,Islas Vírgenes Estadounidenses/Territorio de Estados Unidos,0,1,,1,POINT (10406342 -75527794)
2017,Marzo,Albania,1,0,,1,POINT (3451668 -76532004)
2017,Marzo,Albania,1,1,,2,POINT (4697157 -74140516)
2017,Marzo,Alemania,3,5,,8,POINT (10446304 -75516486)
2017,Marzo,Alemania,5,2,,7,POINT (10886686 -74776479)
2017,Marzo,Alemania,34,55,,89,POINT (3451668 -76532004)
2017,Marzo,Alemania,1533,2388,,3921,POINT (4697157 -74140516)
2017,Marzo,Alemania,0,3,,3,POINT (4815189 -75736374)
2017,Marzo,Alemania,36,72,,108,POINT (6170465 -7542726)
2017,Marzo,Alemania,3,0,,3,POINT (7128047 -73181317)
2017,Marzo,Andorra,0,1,,1,POINT (4697157 -74140516)
2017,Marzo,Angola,2,5,,7,POINT (4697157 -74140516)
2017,Marzo,Antigua y Barbuda,0,5,,5,POINT (10406342 -75527794)
2017,Marzo,Antigua y Barbuda,1,4,,5,POINT (4697157 -74140516)
2017,Marzo,Países Bajos,34,91,,125,POINT (10406342 -75527794)
2017,Marzo,Países Bajos,30,49,,79,POINT (10446304 -75516486)
2017,Marzo,Países Bajos,5,5,,10,POINT (10886686 -74776479)
2017,Marzo,Países Bajos,0,5,,5,POINT (11247723 -74213989)
2017,Marzo,Países Bajos,64,126,,190,POINT (3451668 -76532004)
2017,Marzo,Países Bajos,950,1254,,2204,POINT (4697157 -74140516)
2017,Marzo,Países Bajos,0,1,,1,POINT (4815189 -75736374)
2017,Marzo,Países Bajos,63,106,,169,POINT (6170465 -7542726)
2017,Marzo,Países Bajos,4,4,,8,POINT (7128047 -73181317)
2017,Marzo,Arabia Saudita,0,2,,2,POINT (4697157 -74140516)
2017,Marzo,Argelia,0,1,,1,POINT (10886686 -74776479)
2017,Marzo,Argelia,4,4,,8,POINT (4697157 -74140516)
2017,Marzo,Argelia,1,0,,1,POINT (6170465 -7542726)
2017,Marzo,Argentina,2,15,,17,POINT (0.81488 -77356)
2017,Marzo,Argentina,71,60,,131,POINT (10446304 -75516486)
2017,Marzo,Argentina,1,6,,7,POINT (10886686 -74776479)
2017,Marzo,Argentina,296,251,,547,POINT (125862 -81702165)
2017,Marzo,Argentina,48,65,,113,POINT (3451668 -76532004)
2017,Marzo,Argentina,5119,5608,,10727,POINT (4697157 -74140516)
2017,Marzo,Argentina,0,2,,2,POINT (4815189 -75736374)
2017,Marzo,Argentina,50,99,,149,POINT (6170465 -7542726)
2017,Marzo,Argentina,0,1,,1,POINT (7128047 -73181317)
2017,Marzo,Aruba,8,15,,23,POINT (10406342 -75527794)
2017,Marzo,Aruba,3,4,,7,POINT (10446304 -75516486)
2017,Marzo,Aruba,1,2,,3,POINT (10886686 -74776479)
2017,Marzo,Aruba,9,16,,25,POINT (11247723 -74213989)
2017,Marzo,Aruba,8,11,,19,POINT (3451668 -76532004)
2017,Marzo,Aruba,876,963,,1839,POINT (4697157 -74140516)
2017,Marzo,Aruba,0,1,,1,POINT (4815189 -75736374)
2017,Marzo,Aruba,9,10,,19,POINT (6170465 -7542726)
2017,Marzo,Aruba,21,18,,39,POINT (7128047 -73181317)
2017,Marzo,Australia,2,1,,3,POINT (10446304 -75516486)
2017,Marzo,Australia,0,4,,4,POINT (10886686 -74776479)
2017,Marzo,Australia,2,4,,6,POINT (3451668 -76532004)
2017,Marzo,Australia,35,45,,80,POINT (4697157 -74140516)
2017,Marzo,Australia,0,2,,2,POINT (4815189 -75736374)
2017,Marzo,Australia,10,22,,32,POINT (6170465 -7542726)
2017,Marzo,Austria,1,1,,2,POINT (125862 -81702165)
2017,Marzo,Austria,0,2,,2,POINT (3451668 -76532004)
2017,Marzo,Austria,18,35,,53,POINT (4697157 -74140516)
2017,Marzo,Austria,0,1,,1,POINT (4815189 -75736374)
2017,Marzo,Austria,3,6,,9,POINT (6170465 -7542726)
2017,Marzo,Bahamas,32,44,,76,POINT (10446304 -75516486)
2017,Marzo,Bahamas,1,0,,1,POINT (3451668 -76532004)
2017,Marzo,Bahamas,0,2,,2,POINT (4697157 -74140516)
2017,Marzo,Bahamas,1,2,,3,POINT (6170465 -7542726)
2017,Marzo,Bahréin,0,1,,1,POINT (4697157 -74140516)
2017,Marzo,Barbados,0,1,,1,POINT (3451668 -76532004)
2017,Marzo,Barbados,46,53,,99,POINT (4697157 -74140516)
2017,Marzo,República de Belarús,0,1,,1,POINT (10886686 -74776479)
2017,Marzo,República de Belarús,0,1,,1,POINT (4697157 -74140516)
2017,Marzo,República de Belarús,1,0,,1,POINT (7819 -72453013)
2017,Marzo,República de Belarús,0,1,,1,POINT (836068 -72409396)
2017,Marzo,Bélgica,1,3,,4,POINT (10886686 -74776479)
2017,Marzo,Bélgica,4,17,,21,POINT (3451668 -76532004)
2017,Marzo,Bélgica,36,70,,106,POINT (4697157 -74140516)
2017,Marzo,Bélgica,11,18,,29,POINT (6170465 -7542726)
2017,Marzo,Bélgica,0,1,,1,POINT (806667 -767333)
2017,Marzo,Belice,1,2,,3,POINT (133387613 -81372937)
2017,Marzo,Belice,3,7,,10,POINT (4697157 -74140516)
2017,Marzo,Belice,0,1,,1,POINT (6170465 -7542726)
2017,Marzo,Benín,1,0,,1,POINT (10446304 -75516486)
2017,Marzo,Bermudas/Territorio Británico de Ultramar,0,1,,1,POINT (4697157 -74140516)
2017,Marzo,Bolivia,0,3,,3,POINT (-4191162 -69941498)
2017,Marzo,Bolivia,0,1,,1,POINT (0.81488 -77356)
2017,Marzo,Bolivia,7,3,,10,POINT (10446304 -75516486)
2017,Marzo,Bolivia,3,74,,77,POINT (10886686 -74776479)
2017,Marzo,Bolivia,19,16,,35,POINT (125862 -81702165)
2017,Marzo,Bolivia,11,24,,35,POINT (3451668 -76532004)
2017,Marzo,Bolivia,327,463,,790,POINT (4697157 -74140516)
2017,Marzo,Bolivia,0,1,,1,POINT (4815189 -75736374)
2017,Marzo,Bolivia,17,28,,45,POINT (6170465 -7542726)
2017,Marzo,Bolivia,2,0,,2,POINT (7128047 -73181317)
2017,Marzo,Brasil,176,237,,413,POINT (-4191162 -69941498)
2017,Marzo,Brasil,2,5,,7,POINT (-4214082 -69941431)
2017,Marzo,Brasil,0,1,,1,POINT (0.81488 -77356)
2017,Marzo,Brasil,0,4,,4,POINT (10406342 -75527794)
2017,Marzo,Brasil,30,27,,57,POINT (10446304 -75516486)
2017,Marzo,Brasil,5,4,,9,POINT (10886686 -74776479)
2017,Marzo,Brasil,465,388,,853,POINT (125862 -81702165)
2017,Marzo,Brasil,88,85,,173,POINT (3451668 -76532004)
2017,Marzo,Brasil,0,4,,4,POINT (3866713 -67927521)
2017,Marzo,Brasil,4400,6205,,10605,POINT (4697157 -74140516)
2017,Marzo,Brasil,7,13,,20,POINT (4815189 -75736374)
2017,Marzo,Brasil,121,143,,264,POINT (6170465 -7542726)
2017,Marzo,Brasil,0,4,,4,POINT (7128047 -73181317)
2017,Marzo,Bulgaria,3,5,,8,POINT (4697157 -74140516)
2017,Marzo,Bulgaria,2,5,,7,POINT (6170465 -7542726)
2017,Marzo,Burundi,0,1,,1,POINT (4697157 -74140516)
2017,Marzo,Cabo Verde,0,1,,1,POINT (0.33002 -76876446)
2017,Marzo,Islas Caimán/Territorio Británico de Ultramar,0,1,,1,POINT (125862 -81702165)
2017,Marzo,Islas Caimán/Territorio Británico de Ultramar,1,0,,1,POINT (3451668 -76532004)
2017,Marzo,Camboya,0,1,,1,POINT (4697157 -74140516)
2017,Marzo,Canadá,478,495,,973,POINT (10446304 -75516486)
2017,Marzo,Canadá,4,9,,13,POINT (10886686 -74776479)
2017,Marzo,Canadá,370,353,,723,POINT (125862 -81702165)
2017,Marzo,Canadá,38,71,,109,POINT (3451668 -76532004)
2017,Marzo,Canadá,789,1173,,1962,POINT (4697157 -74140516)
2017,Marzo,Canadá,9,11,,20,POINT (4815189 -75736374)
2017,Marzo,Canadá,113,184,,297,POINT (6170465 -7542726)
2017,Marzo,Canadá,1,4,,5,POINT (7128047 -73181317)
2017,Marzo,España,0,11,,11,POINT (10406342 -75527794)
2017,Marzo,España,0,5,,5,POINT (10886686 -74776479)
2017,Marzo,España,349,526,,875,POINT (3451668 -76532004)
2017,Marzo,España,3275,5995,,9270,POINT (4697157 -74140516)
2017,Marzo,España,3,6,,9,POINT (4815189 -75736374)
2017,Marzo,España,301,597,,898,POINT (6170465 -7542726)
2017,Marzo,República de Corea,1,0,,1,POINT (3451668 -76532004)
2017,Marzo,República de Corea,10,14,,24,POINT (4697157 -74140516)
2017,Marzo,República de Corea,0,5,,5,POINT (6170465 -7542726)
2017,Marzo,Costa de Marfil,7,2,,9,POINT (4697157 -74140516)
2017,Marzo,Costa Rica,2,8,,10,POINT (10406342 -75527794)
2017,Marzo,Costa Rica,0,3,,3,POINT (10446304 -75516486)
2017,Marzo,Costa Rica,6,14,,20,POINT (10886686 -74776479)
2017,Marzo,Costa Rica,291,237,,528,POINT (125862 -81702165)
2017,Marzo,Costa Rica,0,1,,1,POINT (133387613 -81372937)
2017,Marzo,Costa Rica,25,33,,58,POINT (3451668 -76532004)
2017,Marzo,Costa Rica,1096,1705,,2801,POINT (4697157 -74140516)
2017,Marzo,Costa Rica,4,8,,12,POINT (4815189 -75736374)
2017,Marzo,Costa Rica,80,133,,213,POINT (6170465 -7542726)
2017,Marzo,Costa Rica,1,4,,5,POINT (7128047 -73181317)
2017,Marzo,Croacia,2,6,,8,POINT (3451668 -76532004)
2017,Marzo,Croacia,3,7,,10,POINT (4697157 -74140516)
2017,Marzo,Croacia,0,1,,1,POINT (6170465 -7542726)
2017,Marzo,Cuba,0,3,,3,POINT (10446304 -75516486)
2017,Marzo,Cuba,0,1,,1,POINT (10886686 -74776479)
2017,Marzo,Cuba,0,2,,2,POINT (10970933 -74765343)
2017,Marzo,Cuba,9,9,,18,POINT (3451668 -76532004)
2017,Marzo,Cuba,318,525,,843,POINT (4697157 -74140516)
2017,Marzo,Cuba,1,2,,3,POINT (4815189 -75736374)
2017,Marzo,Cuba,13,18,,31,POINT (6170465 -7542726)
2017,Marzo,Cuba,1,1,,2,POINT (7128047 -73181317)
2017,Marzo,Curazao,4,1,,5,POINT (4697157 -74140516)
2017,Marzo,República Checa,4,5,,9,POINT (4697157 -74140516)
2017,Marzo,República Checa,0,2,,2,POINT (6170465 -7542726)
2017,Marzo,Chile,1,3,,4,POINT (0.81488 -77356)
2017,Marzo,Chile,12,11,,23,POINT (10446304 -75516486)
2017,Marzo,Chile,2,5,,7,POINT (10886686 -74776479)
2017,Marzo,Chile,161,133,,294,POINT (125862 -81702165)
2017,Marzo,Chile,32,33,,65,POINT (3451668 -76532004)
2017,Marzo,Chile,4848,6180,,11028,POINT (4697157 -74140516)
2017,Marzo,Chile,2,5,,7,POINT (4815189 -75736374)
2017,Marzo,Chile,21,66,,87,POINT (6170465 -7542726)
2017,Marzo,Chile,0,2,,2,POINT (7128047 -73181317)
2017,Marzo,China,0,3,,3,POINT (10886686 -74776479)
2017,Marzo,China,0,1,,1,POINT (3451668 -76532004)
2017,Marzo,China,0,5,,5,POINT (3884426 -77061029)
2017,Marzo,China,38,98,,136,POINT (4697157 -74140516)
2017,Marzo,China,0,6,,6,POINT (6170465 -7542726)
2017,Marzo,China,1,1,,2,POINT (7128047 -73181317)
2017,Marzo,Chipre,0,2,,2,POINT (4697157 -74140516)
2017,Marzo,Dinamarca,1,2,,3,POINT (10446304 -75516486)
2017,Marzo,Dinamarca,0,1,,1,POINT (10886686 -74776479)
2017,Marzo,Dinamarca,0,4,,4,POINT (3451668 -76532004)
2017,Marzo,Dinamarca,20,30,,50,POINT (4697157 -74140516)
2017,Marzo,Dinamarca,3,1,,4,POINT (6170465 -7542726)
2017,Marzo,Ecuador,107,360,,467,POINT (0.33002 -76876446)
2017,Marzo,Ecuador,0,1,,1,POINT (0.812436 -77847006)
2017,Marzo,Ecuador,3621,4774,,8395,POINT (0.81488 -77356)
2017,Marzo,Ecuador,42,58,,100,POINT (1800143 -78802679)
2017,Marzo,Ecuador,0,1,,1,POINT (10406342 -75527794)
2017,Marzo,Ecuador,0,4,,4,POINT (10446304 -75516486)
2017,Marzo,Ecuador,4,6,,10,POINT (10886686 -74776479)
2017,Marzo,Ecuador,11,2,,13,POINT (125862 -81702165)
2017,Marzo,Ecuador,511,559,,1070,POINT (3451668 -76532004)
2017,Marzo,Ecuador,0,8,,8,POINT (3884426 -77061029)
2017,Marzo,Ecuador,3485,5247,,8732,POINT (4697157 -74140516)
2017,Marzo,Ecuador,27,55,,82,POINT (6170465 -7542726)
2017,Marzo,Ecuador,0,1,,1,POINT (7128047 -73181317)
2017,Marzo,Egipto,1,3,,4,POINT (4697157 -74140516)
2017,Marzo,El Salvador,2,1,,3,POINT (10446304 -75516486)
2017,Marzo,El Salvador,4,7,,11,POINT (10886686 -74776479)
2017,Marzo,El Salvador,0,6,,6,POINT (125862 -81702165)
2017,Marzo,El Salvador,129,183,,312,POINT (3451668 -76532004)
2017,Marzo,El Salvador,991,1500,,2491,POINT (4697157 -74140516)
2017,Marzo,El Salvador,0,1,,1,POINT (4815189 -75736374)
2017,Marzo,El Salvador,165,257,,422,POINT (6170465 -7542726)
2017,Marzo,Emiratos Árabes,1,0,,1,POINT (3451668 -76532004)
2017,Marzo,Emiratos Árabes,3,2,,5,POINT (4697157 -74140516)
2017,Marzo,Eritrea,0,1,,1,POINT (4697157 -74140516)
2017,Marzo,Eslovaquia,0,3,,3,POINT (3451668 -76532004)
2017,Marzo,Eslovaquia,4,4,,8,POINT (4697157 -74140516)
2017,Marzo,Eslovenia,4,3,,7,POINT (4697157 -74140516)
2017,Marzo,Eslovenia,0,3,,3,POINT (6170465 -7542726)
2017,Marzo,Estados Unidos de América,2,41,,43,POINT (10406342 -75527794)
2017,Marzo,Estados Unidos de América,3609,5173,,8782,POINT (10446304 -75516486)
2017,Marzo,Estados Unidos de América,523,765,,1288,POINT (10886686 -74776479)
2017,Marzo,Estados Unidos de América,0,2,,2,POINT (10970933 -74765343)
2017,Marzo,Estados Unidos de América,0,2,,2,POINT (11117206 -74232675)
2017,Marzo,Estados Unidos de América,0,22,,22,POINT (11247723 -74213989)
2017,Marzo,Estados Unidos de América,34,80,,114,POINT (1152863 -72919186)
2017,Marzo,Estados Unidos de América,21,32,,53,POINT (125862 -81702165)
2017,Marzo,Estados Unidos de América,1141,1366,,2507,POINT (3451668 -76532004)
2017,Marzo,Estados Unidos de América,1,19,,20,POINT (3884426 -77061029)
2017,Marzo,Estados Unidos de América,76,136,,212,POINT (445285 -75766353)
2017,Marzo,Estados Unidos de América,9225,15753,,24978,POINT (4697157 -74140516)
2017,Marzo,Estados Unidos de América,107,139,,246,POINT (4815189 -75736374)
2017,Marzo,Estados Unidos de América,2189,5638,,7827,POINT (6170465 -7542726)
2017,Marzo,Estados Unidos de América,25,33,,58,POINT (7128047 -73181317)
2017,Marzo,Estados Unidos de América,0,25,,25,POINT (9402597 -75681642)
2017,Marzo,Estonia,1,1,,2,POINT (4697157 -74140516)
2017,Marzo,Etiopia,0,2,,2,POINT (4697157 -74140516)
2017,Marzo,Filipinas,0,1,,1,POINT (10446304 -75516486)
2017,Marzo,Filipinas,0,2,,2,POINT (10886686 -74776479)
2017,Marzo,Filipinas,0,10,,10,POINT (3451668 -76532004)
2017,Marzo,Filipinas,1,2,,3,POINT (4697157 -74140516)
2017,Marzo,Filipinas,1,0,,1,POINT (6170465 -7542726)
2017,Marzo,Finlandia,6,8,,14,POINT (4697157 -74140516)
2017,Marzo,Finlandia,0,3,,3,POINT (6170465 -7542726)
2017,Marzo,Francia,1,2,,3,POINT (10446304 -75516486)
2017,Marzo,Francia,2,4,,6,POINT (10886686 -74776479)
2017,Marzo,Francia,22,27,,49,POINT (3451668 -76532004)
2017,Marzo,Francia,1379,2311,,3690,POINT (4697157 -74140516)
2017,Marzo,Francia,0,1,,1,POINT (4815189 -75736374)
2017,Marzo,Francia,31,58,,89,POINT (6170465 -7542726)
2017,Marzo,Francia,0,2,,2,POINT (7128047 -73181317)
2017,Marzo,Ghana,1,2,,3,POINT (4697157 -74140516)
2017,Marzo,Granada,1,1,,2,POINT (10406342 -75527794)
2017,Marzo,Granada,0,1,,1,POINT (4697157 -74140516)
2017,Marzo,Granada,1,0,,1,POINT (6170465 -7542726)
2017,Marzo,Grecia,0,2,,2,POINT (3451668 -76532004)
2017,Marzo,Grecia,3,7,,10,POINT (4697157 -74140516)
2017,Marzo,Grecia,0,2,,2,POINT (6170465 -7542726)
2017,Marzo,Guatemala,1,6,,7,POINT (10446304 -75516486)
2017,Marzo,Guatemala,1,0,,1,POINT (10886686 -74776479)
2017,Marzo,Guatemala,38,33,,71,POINT (125862 -81702165)
2017,Marzo,Guatemala,17,25,,42,POINT (3451668 -76532004)
2017,Marzo,Guatemala,347,651,,998,POINT (4697157 -74140516)
2017,Marzo,Guatemala,3,5,,8,POINT (4815189 -75736374)
2017,Marzo,Guatemala,34,122,,156,POINT (6170465 -7542726)
2017,Marzo,Guyana,1,0,,1,POINT (3451668 -76532004)
2017,Marzo,Guyana,3,1,,4,POINT (4697157 -74140516)
2017,Marzo,Guyana,0,2,,2,POINT (4815189 -75736374)
2017,Marzo,Guyana,1,2,,3,POINT (6170465 -7542726)
2017,Marzo,Guadalupe/Territorio Francés,0,1,,1,POINT (4697157 -74140516)
2017,Marzo,Guayana Francesa/Departamento de Ultramar Francés,2,1,,3,POINT (6170465 -7542726)
2017,Marzo,Haití,0,1,,1,POINT (10406342 -75527794)
2017,Marzo,Haití,1,0,,1,POINT (3451668 -76532004)
2017,Marzo,Haití,1,4,,5,POINT (4697157 -74140516)
2017,Marzo,Haití,1,0,,1,POINT (7128047 -73181317)
2017,Marzo,Honduras,1,0,,1,POINT (10446304 -75516486)
2017,Marzo,Honduras,1,3,,4,POINT (10886686 -74776479)
2017,Marzo,Honduras,1,2,,3,POINT (125862 -81702165)
2017,Marzo,Honduras,4,5,,9,POINT (133387613 -81372937)
2017,Marzo,Honduras,15,7,,22,POINT (3451668 -76532004)
2017,Marzo,Honduras,62,85,,147,POINT (4697157 -74140516)
2017,Marzo,Honduras,3,18,,21,POINT (4815189 -75736374)
2017,Marzo,Honduras,18,20,,38,POINT (6170465 -7542726)
2017,Marzo,Hong Kong,3,1,,4,POINT (4697157 -74140516)
2017,Marzo,Hong Kong,1,0,,1,POINT (7128047 -73181317)
2017,Marzo,Hungría,0,1,,1,POINT (3451668 -76532004)
2017,Marzo,Hungría,6,6,,12,POINT (4697157 -74140516)
2017,Marzo,Hungría,1,2,,3,POINT (6170465 -7542726)
2017,Marzo,India,0,2,,2,POINT (10886686 -74776479)
2017,Marzo,India,1,5,,6,POINT (3451668 -76532004)
2017,Marzo,India,3,36,,39,POINT (4697157 -74140516)
2017,Marzo,India,3,6,,9,POINT (6170465 -7542726)
2017,Marzo,Indonesia,0,3,,3,POINT (3451668 -76532004)
2017,Marzo,Indonesia,0,2,,2,POINT (4697157 -74140516)
2017,Marzo,Iraq,0,1,,1,POINT (4697157 -74140516)
2017,Marzo,Irán,0,1,,1,POINT (6170465 -7542726)
2017,Marzo,República de Irlanda,0,3,,3,POINT (3451668 -76532004)
2017,Marzo,República de Irlanda,14,24,,38,POINT (4697157 -74140516)
2017,Marzo,República de Irlanda,4,10,,14,POINT (6170465 -7542726)
2017,Marzo,Islandia,0,2,,2,POINT (4697157 -74140516)
2017,Marzo,Isla de Man,0,1,,1,POINT (10446304 -75516486)
2017,Marzo,Israel,1,2,,3,POINT (10446304 -75516486)
2017,Marzo,Israel,1,0,,1,POINT (10886686 -74776479)
2017,Marzo,Israel,2,0,,2,POINT (125862 -81702165)
2017,Marzo,Israel,4,5,,9,POINT (3451668 -76532004)
2017,Marzo,Israel,22,90,,112,POINT (4697157 -74140516)
2017,Marzo,Israel,2,6,,8,POINT (6170465 -7542726)
2017,Marzo,Islas Aland/Provincia de Finlandia,1,0,,1,POINT (3451668 -76532004)
2017,Marzo,Italia,0,3,,3,POINT (10446304 -75516486)
2017,Marzo,Italia,2,1,,3,POINT (10886686 -74776479)
2017,Marzo,Italia,18,43,,61,POINT (3451668 -76532004)
2017,Marzo,Italia,114,264,,378,POINT (4697157 -74140516)
2017,Marzo,Italia,1,2,,3,POINT (4815189 -75736374)
2017,Marzo,Italia,13,36,,49,POINT (6170465 -7542726)
2017,Marzo,Jamaica,0,2,,2,POINT (10446304 -75516486)
2017,Marzo,Jamaica,3,2,,5,POINT (3451668 -76532004)
2017,Marzo,Jamaica,3,9,,12,POINT (4697157 -74140516)
2017,Marzo,Jamaica,0,2,,2,POINT (6170465 -7542726)
2017,Marzo,Japón,1,0,,1,POINT (10446304 -75516486)
2017,Marzo,Japón,0,2,,2,POINT (10886686 -74776479)
2017,Marzo,Japón,1,3,,4,POINT (3451668 -76532004)
2017,Marzo,Japón,6,27,,33,POINT (4697157 -74140516)
2017,Marzo,Japón,3,2,,5,POINT (6170465 -7542726)
2017,Marzo,Jordania,0,1,,1,POINT (3451668 -76532004)
2017,Marzo,Jordania,1,0,,1,POINT (4697157 -74140516)
2017,Marzo,Kazajistán,1,1,,2,POINT (6170465 -7542726)
2017,Marzo,Kenia,0,1,,1,POINT (4697157 -74140516)
2017,Marzo,Kuwait,0,1,,1,POINT (4697157 -74140516)
2017,Marzo,Letonia,1,0,,1,POINT (3451668 -76532004)
2017,Marzo,Letonia,1,8,,9,POINT (4697157 -74140516)
2017,Marzo,Letonia,1,1,,2,POINT (6170465 -7542726)
2017,Marzo,Lituania,0,1,,1,POINT (10886686 -74776479)
2017,Marzo,Lituania,0,3,,3,POINT (10970933 -74765343)
2017,Marzo,Lituania,5,3,,8,POINT (4697157 -74140516)
2017,Marzo,Líbano,1,5,,6,POINT (4697157 -74140516)
2017,Marzo,Liechtenstein,0,1,,1,POINT (6170465 -7542726)
2017,Marzo,Luxemburgo,2,4,,6,POINT (4697157 -74140516)
2017,Marzo,Malasia,1,4,,5,POINT (4697157 -74140516)
2017,Marzo,Malawi,1,1,,2,POINT (4697157 -74140516)
2017,Marzo,Maldivas,0,1,,1,POINT (4697157 -74140516)
2017,Marzo,Malta,1,0,,1,POINT (4697157 -74140516)
2017,Marzo,Marruecos,0,2,,2,POINT (4697157 -74140516)
2017,Marzo,Martinica/Departamento de Ultramar Francés,1,2,,3,POINT (10406342 -75527794)
2017,Marzo,Martinica/Departamento de Ultramar Francés,0,1,,1,POINT (10446304 -75516486)
2017,Marzo,México,1,14,,15,POINT (10406342 -75527794)
2017,Marzo,México,9,29,,38,POINT (10446304 -75516486)
2017,Marzo,México,12,38,,50,POINT (10886686 -74776479)
2017,Marzo,México,65,136,,201,POINT (3451668 -76532004)
2017,Marzo,México,4867,8814,,13681,POINT (4697157 -74140516)
2017,Marzo,México,8,21,,29,POINT (4815189 -75736374)
2017,Marzo,México,472,1394,,1866,POINT (6170465 -7542726)
2017,Marzo,México,1,3,,4,POINT (7128047 -73181317)
2017,Marzo,Mónaco,0,1,,1,POINT (3451668 -76532004)
2017,Marzo,Mónaco,1,1,,2,POINT (4697157 -74140516)
2017,Marzo,Nicaragua,0,1,,1,POINT (10446304 -75516486)
2017,Marzo,Nicaragua,0,2,,2,POINT (10886686 -74776479)
2017,Marzo,Nicaragua,0,1,,1,POINT (10970933 -74765343)
2017,Marzo,Nicaragua,1,2,,3,POINT (125862 -81702165)
2017,Marzo,Nicaragua,5,4,,9,POINT (3451668 -76532004)
2017,Marzo,Nicaragua,21,61,,82,POINT (4697157 -74140516)
2017,Marzo,Nicaragua,3,4,,7,POINT (4815189 -75736374)
2017,Marzo,Nicaragua,2,18,,20,POINT (6170465 -7542726)
2017,Marzo,Nicaragua,0,2,,2,POINT (7128047 -73181317)
2017,Marzo,Noruega,1,2,,3,POINT (3451668 -76532004)
2017,Marzo,Noruega,25,28,,53,POINT (4697157 -74140516)
2017,Marzo,Noruega,0,1,,1,POINT (4815189 -75736374)
2017,Marzo,Noruega,4,2,,6,POINT (6170465 -7542726)
2017,Marzo,Nueva Zelanda,1,0,,1,POINT (3451668 -76532004)
2017,Marzo,Nueva Zelanda,5,9,,14,POINT (4697157 -74140516)
2017,Marzo,Nueva Zelanda,0,1,,1,POINT (6170465 -7542726)
2017,Marzo,Omán,0,2,,2,POINT (4697157 -74140516)
2017,Marzo,Pakistán,0,3,,3,POINT (4697157 -74140516)
2017,Marzo,Pakistán,0,2,,2,POINT (6170465 -7542726)
2017,Marzo,Panamá,1397,1126,,2523,POINT (10406342 -75527794)
2017,Marzo,Panamá,3869,4347,,8216,POINT (10446304 -75516486)
2017,Marzo,Panamá,240,494,,734,POINT (10886686 -74776479)
2017,Marzo,Panamá,0,16,,16,POINT (10970933 -74765343)
2017,Marzo,Panamá,0,1,,1,POINT (11247723 -74213989)
2017,Marzo,Panamá,18,33,,51,POINT (125744111 -81703935)
2017,Marzo,Panamá,206,192,,398,POINT (125862 -81702165)
2017,Marzo,Panamá,6,8,,14,POINT (133387613 -81372937)
2017,Marzo,Panamá,290,455,,745,POINT (3451668 -76532004)
2017,Marzo,Panamá,0,55,,55,POINT (3884426 -77061029)
2017,Marzo,Panamá,31,55,,86,POINT (445285 -75766353)
2017,Marzo,Panamá,3932,6017,,9949,POINT (4697157 -74140516)
2017,Marzo,Panamá,39,78,,117,POINT (4815189 -75736374)
2017,Marzo,Panamá,1603,2604,,4207,POINT (6170465 -7542726)
2017,Marzo,Panamá,0,1,,1,POINT (6222552 -77401154)
2017,Marzo,Panamá,4,10,,14,POINT (7102626 -77762647)
2017,Marzo,Panamá,11,18,,29,POINT (7128047 -73181317)
2017,Marzo,Panamá,165,155,,320,POINT (863337 -7735002)
2017,Marzo,Panamá,6,6,,12,POINT (9402597 -75681642)
2017,Marzo,Paraguay,1,0,,1,POINT (0.81488 -77356)
2017,Marzo,Paraguay,3,0,,3,POINT (10886686 -74776479)
2017,Marzo,Paraguay,73,62,,135,POINT (125862 -81702165)
2017,Marzo,Paraguay,10,5,,15,POINT (3451668 -76532004)
2017,Marzo,Paraguay,60,75,,135,POINT (4697157 -74140516)
2017,Marzo,Paraguay,3,4,,7,POINT (4815189 -75736374)
2017,Marzo,Paraguay,7,13,,20,POINT (6170465 -7542726)
2017,Marzo,Perú,116,192,,308,POINT (-4191162 -69941498)
2017,Marzo,Perú,54,57,,111,POINT (-4214082 -69941431)
2017,Marzo,Perú,1,13,,14,POINT (0.81488 -77356)
2017,Marzo,Perú,1190,878,,2068,POINT (10446304 -75516486)
2017,Marzo,Perú,5,14,,19,POINT (10886686 -74776479)
2017,Marzo,Perú,236,179,,415,POINT (125862 -81702165)
2017,Marzo,Perú,380,510,,890,POINT (3451668 -76532004)
2017,Marzo,Perú,6392,8638,,15030,POINT (4697157 -74140516)
2017,Marzo,Perú,1,0,,1,POINT (4815189 -75736374)
2017,Marzo,Perú,591,955,,1546,POINT (6170465 -7542726)
2017,Marzo,Perú,1,4,,5,POINT (7128047 -73181317)
2017,Marzo,Polonia,0,1,,1,POINT (10446304 -75516486)
2017,Marzo,Polonia,15,22,,37,POINT (4697157 -74140516)
2017,Marzo,Polonia,2,1,,3,POINT (6170465 -7542726)
2017,Marzo,Portugal,3,8,,11,POINT (3451668 -76532004)
2017,Marzo,Portugal,31,90,,121,POINT (4697157 -74140516)
2017,Marzo,Portugal,0,3,,3,POINT (6170465 -7542726)
2017,Marzo,Puerto Rico/Territorio de Estados Unidos,1,1,,2,POINT (10446304 -75516486)
2017,Marzo,Puerto Rico/Territorio de Estados Unidos,7,45,,52,POINT (10886686 -74776479)
2017,Marzo,Puerto Rico/Territorio de Estados Unidos,30,67,,97,POINT (3451668 -76532004)
2017,Marzo,Puerto Rico/Territorio de Estados Unidos,299,558,,857,POINT (4697157 -74140516)
2017,Marzo,Puerto Rico/Territorio de Estados Unidos,3,4,,7,POINT (4815189 -75736374)
2017,Marzo,Puerto Rico/Territorio de Estados Unidos,72,196,,268,POINT (6170465 -7542726)
2017,Marzo,Puerto Rico/Territorio de Estados Unidos,2,2,,4,POINT (7128047 -73181317)
2017,Marzo,Reino Unido de Gran Bretaña e Irlanda del Norte,1,1,,2,POINT (10446304 -75516486)
2017,Marzo,Reino Unido de Gran Bretaña e Irlanda del Norte,0,2,,2,POINT (10886686 -74776479)
2017,Marzo,Reino Unido de Gran Bretaña e Irlanda del Norte,6,12,,18,POINT (3451668 -76532004)
2017,Marzo,Reino Unido de Gran Bretaña e Irlanda del Norte,780,1394,,2174,POINT (4697157 -74140516)
2017,Marzo,Reino Unido de Gran Bretaña e Irlanda del Norte,18,32,,50,POINT (6170465 -7542726)
2017,Marzo,Reino Unido de Gran Bretaña e Irlanda del Norte,4,1,,5,POINT (7128047 -73181317)
2017,Marzo,República CentroÁfricana,0,2,,2,POINT (3451668 -76532004)
2017,Marzo,República CentroÁfricana,1,1,,2,POINT (4697157 -74140516)
2017,Marzo,Federación de Rusia,0,5,,5,POINT (10406342 -75527794)
2017,Marzo,Federación de Rusia,1,0,,1,POINT (10446304 -75516486)
2017,Marzo,Federación de Rusia,2,4,,6,POINT (3451668 -76532004)
2017,Marzo,Federación de Rusia,0,2,,2,POINT (3884426 -77061029)
2017,Marzo,Federación de Rusia,19,21,,40,POINT (4697157 -74140516)
2017,Marzo,Federación de Rusia,2,1,,3,POINT (6170465 -7542726)
2017,Marzo,República Dominicana,0,17,,17,POINT (10406342 -75527794)
2017,Marzo,República Dominicana,3,2,,5,POINT (10446304 -75516486)
2017,Marzo,República Dominicana,7,23,,30,POINT (10886686 -74776479)
2017,Marzo,República Dominicana,0,5,,5,POINT (11117206 -74232675)
2017,Marzo,República Dominicana,20,27,,47,POINT (3451668 -76532004)
2017,Marzo,República Dominicana,598,912,,1510,POINT (4697157 -74140516)
2017,Marzo,República Dominicana,14,26,,40,POINT (4815189 -75736374)
2017,Marzo,República Dominicana,28,55,,83,POINT (6170465 -7542726)
2017,Marzo,República Dominicana,2,4,,6,POINT (7128047 -73181317)
2017,Marzo,Reunión,0,2,,2,POINT (4697157 -74140516)
2017,Marzo,Rumania,5,14,,19,POINT (4697157 -74140516)
2017,Marzo,Rumania,1,4,,5,POINT (6170465 -7542726)
2017,Marzo,San Cristóbal y Nevis,0,1,,1,POINT (6170465 -7542726)
2017,Marzo,San Marino,0,2,,2,POINT (10406342 -75527794)
2017,Marzo,San  Vicente y las Granadinas,1,2,,3,POINT (10406342 -75527794)
2017,Marzo,San  Vicente y las Granadinas,1,1,,2,POINT (4697157 -74140516)
2017,Marzo,Santa Lucia,1,0,,1,POINT (6170465 -7542726)
2017,Marzo,Senegal,1,0,,1,POINT (4697157 -74140516)
2017,Marzo,Serbia,1,1,,2,POINT (3451668 -76532004)
2017,Marzo,Serbia,0,2,,2,POINT (6170465 -7542726)
2017,Marzo,Singapur,0,1,,1,POINT (11247723 -74213989)
2017,Marzo,Singapur,0,3,,3,POINT (4697157 -74140516)
2017,Marzo,Singapur,0,1,,1,POINT (6170465 -7542726)
2017,Marzo,República Árabe Siria,1,0,,1,POINT (4697157 -74140516)
2017,Marzo,Somalia,0,3,,3,POINT (4697157 -74140516)
2017,Marzo,Sri Lanka,0,1,,1,POINT (3451668 -76532004)
2017,Marzo,Sri Lanka,0,1,,1,POINT (4697157 -74140516)
2017,Marzo,Sudáfrica,0,1,,1,POINT (3451668 -76532004)
2017,Marzo,Sudáfrica,6,6,,12,POINT (4697157 -74140516)
2017,Marzo,Sudáfrica,0,2,,2,POINT (6170465 -7542726)
2017,Marzo,Sudán,0,1,,1,POINT (4697157 -74140516)
2017,Marzo,Suecia,0,1,,1,POINT (10886686 -74776479)
2017,Marzo,Suecia,1,3,,4,POINT (3451668 -76532004)
2017,Marzo,Suecia,35,59,,94,POINT (4697157 -74140516)
2017,Marzo,Suecia,2,1,,3,POINT (4815189 -75736374)
2017,Marzo,Suecia,1,4,,5,POINT (6170465 -7542726)
2017,Marzo,Suiza,1,0,,1,POINT (10446304 -75516486)
2017,Marzo,Suiza,1,1,,2,POINT (125862 -81702165)
2017,Marzo,Suiza,8,27,,35,POINT (3451668 -76532004)
2017,Marzo,Suiza,90,100,,190,POINT (4697157 -74140516)
2017,Marzo,Suiza,15,34,,49,POINT (6170465 -7542726)
2017,Marzo,Surinam,3,8,,11,POINT (4697157 -74140516)
2017,Marzo,Taiwán,0,2,,2,POINT (10886686 -74776479)
2017,Marzo,Taiwán,1,0,,1,POINT (3451668 -76532004)
2017,Marzo,Taiwán,1,4,,5,POINT (4697157 -74140516)
2017,Marzo,Taiwán,1,1,,2,POINT (6170465 -7542726)
2017,Marzo,Tailandia,1,0,,1,POINT (10886686 -74776479)
2017,Marzo,Tailandia,1,3,,4,POINT (4697157 -74140516)
2017,Marzo,República Democrática de Timor Oriental,0,1,,1,POINT (4697157 -74140516)
2017,Marzo,Trinidad y Tobago,0,4,,4,POINT (10406342 -75527794)
2017,Marzo,Trinidad y Tobago,0,1,,1,POINT (10886686 -74776479)
2017,Marzo,Trinidad y Tobago,0,1,,1,POINT (125862 -81702165)
2017,Marzo,Trinidad y Tobago,0,8,,8,POINT (3451668 -76532004)
2017,Marzo,Trinidad y Tobago,4,15,,19,POINT (4697157 -74140516)
2017,Marzo,Trinidad y Tobago,0,1,,1,POINT (4815189 -75736374)
2017,Marzo,Trinidad y Tobago,1,3,,4,POINT (6170465 -7542726)
2017,Marzo,Trinidad y Tobago,0,1,,1,POINT (7128047 -73181317)
2017,Marzo,Túnez,0,2,,2,POINT (4697157 -74140516)
2017,Marzo,Turkmenistán,0,2,,2,POINT (4697157 -74140516)
2017,Marzo,Turquía,6,6,,12,POINT (3451668 -76532004)
2017,Marzo,Turquía,175,408,,583,POINT (4697157 -74140516)
2017,Marzo,Turquía,0,5,,5,POINT (6170465 -7542726)
2017,Marzo,Ucrania,0,2,,2,POINT (3451668 -76532004)
2017,Marzo,Ucrania,2,1,,3,POINT (4697157 -74140516)
2017,Marzo,Uganda,1,2,,3,POINT (4697157 -74140516)
2017,Marzo,Uruguay,6,4,,10,POINT (10446304 -75516486)
2017,Marzo,Uruguay,2,3,,5,POINT (10886686 -74776479)
2017,Marzo,Uruguay,29,30,,59,POINT (125862 -81702165)
2017,Marzo,Uruguay,8,22,,30,POINT (3451668 -76532004)
2017,Marzo,Uruguay,79,115,,194,POINT (4697157 -74140516)
2017,Marzo,Uruguay,25,43,,68,POINT (6170465 -7542726)
2017,Marzo,Venezuela,14,50,,64,POINT (10446304 -75516486)
2017,Marzo,Venezuela,19,82,,101,POINT (10886686 -74776479)
2017,Marzo,Venezuela,0,1,,1,POINT (10970933 -74765343)
2017,Marzo,Venezuela,0,1,,1,POINT (11247723 -74213989)
2017,Marzo,Venezuela,4080,5005,,9085,POINT (11360029 -72129595)
2017,Marzo,Venezuela,0,1,,1,POINT (125862 -81702165)
2017,Marzo,Venezuela,23,24,,47,POINT (3451668 -76532004)
2017,Marzo,Venezuela,167,179,,346,POINT (3866713 -67927521)
2017,Marzo,Venezuela,2535,3221,,5756,POINT (4697157 -74140516)
2017,Marzo,Venezuela,1,2,,3,POINT (4815189 -75736374)
2017,Marzo,Venezuela,391,475,,866,POINT (6170465 -7542726)
2017,Marzo,Venezuela,323,484,,807,POINT (6185536 -67484028)
2017,Marzo,Venezuela,89,130,,219,POINT (7088729 -70740253)
2017,Marzo,Venezuela,4,8,,12,POINT (7128047 -73181317)
2017,Marzo,Venezuela,7200,9792,,16992,POINT (7819 -72453013)
2017,Marzo,Venezuela,0,5,,5,POINT (7927233 -72508188)
2017,Marzo,Venezuela,240,349,,589,POINT (836068 -72409396)
2017,Marzo,Vietnam,4,3,,7,POINT (4697157 -74140516)
2017,Marzo,Islas Vírgenes Británicas/Territorio Británico de Ultramar,1,4,,5,POINT (10406342 -75527794)
2017,Marzo,Islas Vírgenes Británicas/Territorio Británico de Ultramar,0,9,,9,POINT (10446304 -75516486)
2017,Marzo,Islas Vírgenes Estadounidenses/Territorio de Estados Unidos,2,5,,7,POINT (10446304 -75516486)
2017,Marzo,Zimbabue,0,2,,2,POINT (4697157 -74140516)
2017,Abril,Albania,0,1,,1,POINT (4697157 -74140516)
2017,Abril,Albania,2,0,,2,POINT (7819 -72453013)
2017,Abril,Alemania,2,1,,3,POINT (0.81488 -77356)
2017,Abril,Alemania,0,1,,1,POINT (10446304 -75516486)
2017,Abril,Alemania,3,6,,9,POINT (10886686 -74776479)
2017,Abril,Alemania,0,2,,2,POINT (11247723 -74213989)
2017,Abril,Alemania,17,12,,29,POINT (3451668 -76532004)
2017,Abril,Alemania,1352,1991,,3343,POINT (4697157 -74140516)
2017,Abril,Alemania,0,1,,1,POINT (4815189 -75736374)
2017,Abril,Alemania,31,46,,77,POINT (6170465 -7542726)
2017,Abril,Alemania,0,2,,2,POINT (806667 -767333)
2017,Abril,Andorra,2,2,,4,POINT (4697157 -74140516)
2017,Abril,Angola,0,1,,1,POINT (6170465 -7542726)
2017,Abril,Antigua y Barbuda,0,5,,5,POINT (10406342 -75527794)
2017,Abril,Antigua y Barbuda,2,4,,6,POINT (4697157 -74140516)
2017,Abril,Países Bajos,2,6,,8,POINT (10406342 -75527794)
2017,Abril,Países Bajos,179,315,,494,POINT (10446304 -75516486)
2017,Abril,Países Bajos,11,15,,26,POINT (10886686 -74776479)
2017,Abril,Países Bajos,2,1,,3,POINT (11117206 -74232675)
2017,Abril,Países Bajos,4,5,,9,POINT (11247723 -74213989)
2017,Abril,Países Bajos,21,24,,45,POINT (3451668 -76532004)
2017,Abril,Países Bajos,0,1,,1,POINT (3884426 -77061029)
2017,Abril,Países Bajos,1087,1417,,2504,POINT (4697157 -74140516)
2017,Abril,Países Bajos,0,4,,4,POINT (4815189 -75736374)
2017,Abril,Países Bajos,119,120,,239,POINT (6170465 -7542726)
2017,Abril,Países Bajos,3,7,,10,POINT (7128047 -73181317)
2017,Abril,Arabia Saudita,0,2,,2,POINT (4697157 -74140516)
2017,Abril,Argelia,1,0,,1,POINT (10446304 -75516486)
2017,Abril,Argelia,0,3,,3,POINT (4697157 -74140516)
2017,Abril,Argentina,3,13,,16,POINT (0.81488 -77356)
2017,Abril,Argentina,123,83,,206,POINT (10446304 -75516486)
2017,Abril,Argentina,4,8,,12,POINT (10886686 -74776479)
2017,Abril,Argentina,147,103,,250,POINT (125862 -81702165)
2017,Abril,Argentina,25,76,,101,POINT (3451668 -76532004)
2017,Abril,Argentina,4033,4535,,8568,POINT (4697157 -74140516)
2017,Abril,Argentina,0,2,,2,POINT (4815189 -75736374)
2017,Abril,Argentina,48,97,,145,POINT (6170465 -7542726)
2017,Abril,Argentina,0,1,,1,POINT (7128047 -73181317)
2017,Abril,Aruba,17,35,,52,POINT (10406342 -75527794)
2017,Abril,Aruba,0,2,,2,POINT (10446304 -75516486)
2017,Abril,Aruba,4,3,,7,POINT (10886686 -74776479)
2017,Abril,Aruba,0,2,,2,POINT (11117206 -74232675)
2017,Abril,Aruba,3,13,,16,POINT (11247723 -74213989)
2017,Abril,Aruba,16,13,,29,POINT (3451668 -76532004)
2017,Abril,Aruba,960,1059,,2019,POINT (4697157 -74140516)
2017,Abril,Aruba,59,57,,116,POINT (4815189 -75736374)
2017,Abril,Aruba,21,33,,54,POINT (6170465 -7542726)
2017,Abril,Aruba,6,3,,9,POINT (7128047 -73181317)
2017,Abril,Australia,1,1,,2,POINT (10446304 -75516486)
2017,Abril,Australia,6,4,,10,POINT (3451668 -76532004)
2017,Abril,Australia,29,54,,83,POINT (4697157 -74140516)
2017,Abril,Australia,0,1,,1,POINT (4815189 -75736374)
2017,Abril,Australia,11,24,,35,POINT (6170465 -7542726)
2017,Abril,Austria,2,0,,2,POINT (3451668 -76532004)
2017,Abril,Austria,17,26,,43,POINT (4697157 -74140516)
2017,Abril,Austria,2,2,,4,POINT (6170465 -7542726)
2017,Abril,Bahamas,0,2,,2,POINT (10406342 -75527794)
2017,Abril,Bahamas,2,3,,5,POINT (10446304 -75516486)
2017,Abril,Bahamas,0,1,,1,POINT (3451668 -76532004)
2017,Abril,Bahamas,2,2,,4,POINT (4697157 -74140516)
2017,Abril,Bahamas,2,6,,8,POINT (6170465 -7542726)
2017,Abril,Bahréin,3,4,,7,POINT (10446304 -75516486)
2017,Abril,Bahréin,1,0,,1,POINT (4697157 -74140516)
2017,Abril,Barbados,51,60,,111,POINT (4697157 -74140516)
2017,Abril,Barbados,0,1,,1,POINT (4815189 -75736374)
2017,Abril,República de Belarús,1,0,,1,POINT (11360029 -72129595)
2017,Abril,República de Belarús,4,1,,5,POINT (4697157 -74140516)
2017,Abril,Bélgica,0,1,,1,POINT (10406342 -75527794)
2017,Abril,Bélgica,1,0,,1,POINT (10886686 -74776479)
2017,Abril,Bélgica,1,9,,10,POINT (3451668 -76532004)
2017,Abril,Bélgica,27,63,,90,POINT (4697157 -74140516)
2017,Abril,Bélgica,0,2,,2,POINT (4815189 -75736374)
2017,Abril,Bélgica,6,10,,16,POINT (6170465 -7542726)
2017,Abril,Bélgica,1,1,,2,POINT (7128047 -73181317)
2017,Abril,Belice,2,0,,2,POINT (3451668 -76532004)
2017,Abril,Belice,1,3,,4,POINT (4697157 -74140516)
2017,Abril,Belice,1,1,,2,POINT (6170465 -7542726)
2017,Abril,Bermudas/Territorio Británico de Ultramar,0,1,,1,POINT (4697157 -74140516)
2017,Abril,Bolivia,2,1,,3,POINT (0.81488 -77356)
2017,Abril,Bolivia,3,1,,4,POINT (10446304 -75516486)
2017,Abril,Bolivia,22,20,,42,POINT (125862 -81702165)
2017,Abril,Bolivia,26,20,,46,POINT (3451668 -76532004)
2017,Abril,Bolivia,379,524,,903,POINT (4697157 -74140516)
2017,Abril,Bolivia,2,0,,2,POINT (4815189 -75736374)
2017,Abril,Bolivia,17,19,,36,POINT (6170465 -7542726)
2017,Abril,Bosnia y Herzegovina,0,1,,1,POINT (4697157 -74140516)
2017,Abril,Brasil,145,161,,306,POINT (-4191162 -69941498)
2017,Abril,Brasil,19,20,,39,POINT (-4214082 -69941431)
2017,Abril,Brasil,0,5,,5,POINT (10406342 -75527794)
2017,Abril,Brasil,27,16,,43,POINT (10446304 -75516486)
2017,Abril,Brasil,3,0,,3,POINT (10886686 -74776479)
2017,Abril,Brasil,376,274,,650,POINT (125862 -81702165)
2017,Abril,Brasil,66,85,,151,POINT (3451668 -76532004)
2017,Abril,Brasil,1,2,,3,POINT (3866713 -67927521)
2017,Abril,Brasil,4733,6124,,10857,POINT (4697157 -74140516)
2017,Abril,Brasil,0,3,,3,POINT (4815189 -75736374)
2017,Abril,Brasil,71,141,,212,POINT (6170465 -7542726)
2017,Abril,Brasil,2,1,,3,POINT (7128047 -73181317)
2017,Abril,Bulgaria,3,3,,6,POINT (4697157 -74140516)
2017,Abril,Burkina Faso,0,2,,2,POINT (4697157 -74140516)
2017,Abril,Burkina Faso,0,1,,1,POINT (6170465 -7542726)
2017,Abril,Islas Caimán/Territorio Británico de Ultramar,6,14,,20,POINT (125862 -81702165)
2017,Abril,Islas Caimán/Territorio Británico de Ultramar,1,2,,3,POINT (133387613 -81372937)
2017,Abril,Islas Caimán/Territorio Británico de Ultramar,0,1,,1,POINT (6170465 -7542726)
2017,Abril,Canadá,0,2,,2,POINT (10406342 -75527794)
2017,Abril,Canadá,24,40,,64,POINT (10446304 -75516486)
2017,Abril,Canadá,1,6,,7,POINT (10886686 -74776479)
2017,Abril,Canadá,0,1,,1,POINT (1152863 -72919186)
2017,Abril,Canadá,0,1,,1,POINT (125862 -81702165)
2017,Abril,Canadá,27,39,,66,POINT (3451668 -76532004)
2017,Abril,Canadá,648,969,,1617,POINT (4697157 -74140516)
2017,Abril,Canadá,1,7,,8,POINT (4815189 -75736374)
2017,Abril,Canadá,84,211,,295,POINT (6170465 -7542726)
2017,Abril,Canadá,2,4,,6,POINT (7128047 -73181317)
2017,Abril,Chad,0,1,,1,POINT (4697157 -74140516)
2017,Abril,España,1,4,,5,POINT (10406342 -75527794)
2017,Abril,España,2,5,,7,POINT (10446304 -75516486)
2017,Abril,España,1,1,,2,POINT (10886686 -74776479)
2017,Abril,España,422,562,,984,POINT (3451668 -76532004)
2017,Abril,España,3611,5619,,9230,POINT (4697157 -74140516)
2017,Abril,España,2,1,,3,POINT (4815189 -75736374)
2017,Abril,España,496,816,,1312,POINT (6170465 -7542726)
2017,Abril,España,1,2,,3,POINT (7128047 -73181317)
2017,Abril,República de Corea,0,4,,4,POINT (3884426 -77061029)
2017,Abril,República de Corea,10,19,,29,POINT (4697157 -74140516)
2017,Abril,República de Corea,0,3,,3,POINT (6170465 -7542726)
2017,Abril,Costa de Marfil,1,0,,1,POINT (10446304 -75516486)
2017,Abril,Costa de Marfil,0,2,,2,POINT (3451668 -76532004)
2017,Abril,Costa de Marfil,7,3,,10,POINT (4697157 -74140516)
2017,Abril,Costa de Marfil,0,1,,1,POINT (6170465 -7542726)
2017,Abril,Costa Rica,1,3,,4,POINT (10406342 -75527794)
2017,Abril,Costa Rica,191,127,,318,POINT (10446304 -75516486)
2017,Abril,Costa Rica,8,8,,16,POINT (10886686 -74776479)
2017,Abril,Costa Rica,0,3,,3,POINT (11117206 -74232675)
2017,Abril,Costa Rica,319,248,,567,POINT (125862 -81702165)
2017,Abril,Costa Rica,34,46,,80,POINT (3451668 -76532004)
2017,Abril,Costa Rica,1553,1890,,3443,POINT (4697157 -74140516)
2017,Abril,Costa Rica,6,6,,12,POINT (4815189 -75736374)
2017,Abril,Costa Rica,75,135,,210,POINT (6170465 -7542726)
2017,Abril,Costa Rica,0,1,,1,POINT (7128047 -73181317)
2017,Abril,Costa Rica,0,1,,1,POINT (806667 -767333)
2017,Abril,Croacia,0,5,,5,POINT (3451668 -76532004)
2017,Abril,Croacia,0,5,,5,POINT (4697157 -74140516)
2017,Abril,Croacia,1,1,,2,POINT (6170465 -7542726)
2017,Abril,Cuba,0,1,,1,POINT (10446304 -75516486)
2017,Abril,Cuba,5,13,,18,POINT (10886686 -74776479)
2017,Abril,Cuba,0,1,,1,POINT (125862 -81702165)
2017,Abril,Cuba,1,1,,2,POINT (133387613 -81372937)
2017,Abril,Cuba,27,33,,60,POINT (3451668 -76532004)
2017,Abril,Cuba,388,555,,943,POINT (4697157 -74140516)
2017,Abril,Cuba,1,4,,5,POINT (4815189 -75736374)
2017,Abril,Cuba,22,24,,46,POINT (6170465 -7542726)
2017,Abril,Cuba,1,2,,3,POINT (7128047 -73181317)
2017,Abril,Curazao,0,3,,3,POINT (4697157 -74140516)
2017,Abril,República Checa,1,0,,1,POINT (3451668 -76532004)
2017,Abril,República Checa,3,7,,10,POINT (4697157 -74140516)
2017,Abril,Chile,4,5,,9,POINT (0.81488 -77356)
2017,Abril,Chile,16,17,,33,POINT (10446304 -75516486)
2017,Abril,Chile,4,4,,8,POINT (10886686 -74776479)
2017,Abril,Chile,130,115,,245,POINT (125862 -81702165)
2017,Abril,Chile,30,53,,83,POINT (3451668 -76532004)
2017,Abril,Chile,4658,5789,,10447,POINT (4697157 -74140516)
2017,Abril,Chile,3,5,,8,POINT (4815189 -75736374)
2017,Abril,Chile,19,45,,64,POINT (6170465 -7542726)
2017,Abril,Chile,1,1,,2,POINT (7128047 -73181317)
2017,Abril,China,2,3,,5,POINT (3451668 -76532004)
2017,Abril,China,18,91,,109,POINT (4697157 -74140516)
2017,Abril,China,0,4,,4,POINT (6170465 -7542726)
2017,Abril,Dinamarca,0,1,,1,POINT (10886686 -74776479)
2017,Abril,Dinamarca,0,3,,3,POINT (3451668 -76532004)
2017,Abril,Dinamarca,10,15,,25,POINT (4697157 -74140516)
2017,Abril,Dinamarca,2,3,,5,POINT (6170465 -7542726)
2017,Abril,Dominica,0,1,,1,POINT (3451668 -76532004)
2017,Abril,Dominica,1,0,,1,POINT (4697157 -74140516)
2017,Abril,Ecuador,1,0,,1,POINT (0.185957 -7478366)
2017,Abril,Ecuador,94,351,,445,POINT (0.33002 -76876446)
2017,Abril,Ecuador,4120,5400,,9520,POINT (0.81488 -77356)
2017,Abril,Ecuador,38,58,,96,POINT (1800143 -78802679)
2017,Abril,Ecuador,0,1,,1,POINT (10406342 -75527794)
2017,Abril,Ecuador,3,8,,11,POINT (10446304 -75516486)
2017,Abril,Ecuador,0,1,,1,POINT (10886686 -74776479)
2017,Abril,Ecuador,10,6,,16,POINT (125862 -81702165)
2017,Abril,Ecuador,495,558,,1053,POINT (3451668 -76532004)
2017,Abril,Ecuador,3409,4602,,8011,POINT (4697157 -74140516)
2017,Abril,Ecuador,1,2,,3,POINT (4815189 -75736374)
2017,Abril,Ecuador,28,55,,83,POINT (6170465 -7542726)
2017,Abril,Ecuador,2,2,,4,POINT (7128047 -73181317)
2017,Abril,Egipto,0,3,,3,POINT (4697157 -74140516)
2017,Abril,El Salvador,1,2,,3,POINT (10446304 -75516486)
2017,Abril,El Salvador,0,1,,1,POINT (10886686 -74776479)
2017,Abril,El Salvador,13,13,,26,POINT (125862 -81702165)
2017,Abril,El Salvador,112,178,,290,POINT (3451668 -76532004)
2017,Abril,El Salvador,1129,1495,,2624,POINT (4697157 -74140516)
2017,Abril,El Salvador,0,1,,1,POINT (4815189 -75736374)
2017,Abril,El Salvador,168,275,,443,POINT (6170465 -7542726)
2017,Abril,Emiratos Árabes,1,0,,1,POINT (10446304 -75516486)
2017,Abril,Emiratos Árabes,0,4,,4,POINT (4697157 -74140516)
2017,Abril,Eslovaquia,3,2,,5,POINT (4697157 -74140516)
2017,Abril,Eslovenia,0,1,,1,POINT (3451668 -76532004)
2017,Abril,Eslovenia,0,4,,4,POINT (4697157 -74140516)
2017,Abril,Estados Unidos de América,0,4,,4,POINT (1800143 -78802679)
2017,Abril,Estados Unidos de América,5,55,,60,POINT (10406342 -75527794)
2017,Abril,Estados Unidos de América,4,24,,28,POINT (10433609 -73247863)
2017,Abril,Estados Unidos de América,2970,4194,,7164,POINT (10446304 -75516486)
2017,Abril,Estados Unidos de América,531,959,,1490,POINT (10886686 -74776479)
2017,Abril,Estados Unidos de América,0,24,,24,POINT (10970933 -74765343)
2017,Abril,Estados Unidos de América,0,21,,21,POINT (11247723 -74213989)
2017,Abril,Estados Unidos de América,3,87,,90,POINT (1152863 -72919186)
2017,Abril,Estados Unidos de América,8,15,,23,POINT (125862 -81702165)
2017,Abril,Estados Unidos de América,1164,1469,,2633,POINT (3451668 -76532004)
2017,Abril,Estados Unidos de América,0,4,,4,POINT (3884426 -77061029)
2017,Abril,Estados Unidos de América,73,127,,200,POINT (445285 -75766353)
2017,Abril,Estados Unidos de América,8325,14329,,22654,POINT (4697157 -74140516)
2017,Abril,Estados Unidos de América,83,167,,250,POINT (4815189 -75736374)
2017,Abril,Estados Unidos de América,2239,5211,,7450,POINT (6170465 -7542726)
2017,Abril,Estados Unidos de América,23,38,,61,POINT (7128047 -73181317)
2017,Abril,Estados Unidos de América,0,13,,13,POINT (9402597 -75681642)
2017,Abril,Estonia,1,1,,2,POINT (3451668 -76532004)
2017,Abril,Etiopia,0,1,,1,POINT (4697157 -74140516)
2017,Abril,Filipinas,0,1,,1,POINT (10886686 -74776479)
2017,Abril,Filipinas,0,8,,8,POINT (3451668 -76532004)
2017,Abril,Filipinas,4,20,,24,POINT (4697157 -74140516)
2017,Abril,Filipinas,0,2,,2,POINT (6170465 -7542726)
2017,Abril,Finlandia,1,0,,1,POINT (10886686 -74776479)
2017,Abril,Finlandia,2,0,,2,POINT (3451668 -76532004)
2017,Abril,Finlandia,2,5,,7,POINT (4697157 -74140516)
2017,Abril,Finlandia,1,1,,2,POINT (6170465 -7542726)
2017,Abril,Francia,3,1,,4,POINT (10446304 -75516486)
2017,Abril,Francia,1,1,,2,POINT (10886686 -74776479)
2017,Abril,Francia,20,31,,51,POINT (3451668 -76532004)
2017,Abril,Francia,1395,2216,,3611,POINT (4697157 -74140516)
2017,Abril,Francia,1,8,,9,POINT (4815189 -75736374)
2017,Abril,Francia,38,50,,88,POINT (6170465 -7542726)
2017,Abril,Georgia,0,4,,4,POINT (4697157 -74140516)
2017,Abril,Gibraltar/Territorio Británico de Ultramar,0,1,,1,POINT (11247723 -74213989)
2017,Abril,Gibraltar/Territorio Británico de Ultramar,1,0,,1,POINT (4697157 -74140516)
2017,Abril,Grecia,0,1,,1,POINT (3451668 -76532004)
2017,Abril,Grecia,1,7,,8,POINT (4697157 -74140516)
2017,Abril,Grecia,0,1,,1,POINT (6170465 -7542726)
2017,Abril,Groenlandia,0,1,,1,POINT (4697157 -74140516)
2017,Abril,Guatemala,1,7,,8,POINT (10406342 -75527794)
2017,Abril,Guatemala,16,26,,42,POINT (10446304 -75516486)
2017,Abril,Guatemala,0,5,,5,POINT (10886686 -74776479)
2017,Abril,Guatemala,45,35,,80,POINT (125862 -81702165)
2017,Abril,Guatemala,18,46,,64,POINT (3451668 -76532004)
2017,Abril,Guatemala,343,548,,891,POINT (4697157 -74140516)
2017,Abril,Guatemala,2,7,,9,POINT (4815189 -75736374)
2017,Abril,Guatemala,48,102,,150,POINT (6170465 -7542726)
2017,Abril,Guatemala,2,2,,4,POINT (7128047 -73181317)
2017,Abril,Guyana,2,2,,4,POINT (3451668 -76532004)
2017,Abril,Guyana,1,2,,3,POINT (4697157 -74140516)
2017,Abril,Guyana,1,0,,1,POINT (6170465 -7542726)
2017,Abril,Guadalupe/Territorio Francés,0,1,,1,POINT (10446304 -75516486)
2017,Abril,Guadalupe/Territorio Francés,1,4,,5,POINT (4697157 -74140516)
2017,Abril,Guayana Francesa/Departamento de Ultramar Francés,0,1,,1,POINT (4815189 -75736374)
2017,Abril,Haití,0,1,,1,POINT (10406342 -75527794)
2017,Abril,Haití,2,1,,3,POINT (10446304 -75516486)
2017,Abril,Haití,0,3,,3,POINT (4697157 -74140516)
2017,Abril,Haití,0,1,,1,POINT (6170465 -7542726)
2017,Abril,Honduras,0,1,,1,POINT (10406342 -75527794)
2017,Abril,Honduras,4,6,,10,POINT (10446304 -75516486)
2017,Abril,Honduras,2,0,,2,POINT (10886686 -74776479)
2017,Abril,Honduras,0,1,,1,POINT (11247723 -74213989)
2017,Abril,Honduras,3,2,,5,POINT (125862 -81702165)
2017,Abril,Honduras,3,5,,8,POINT (133387613 -81372937)
2017,Abril,Honduras,16,20,,36,POINT (3451668 -76532004)
2017,Abril,Honduras,107,108,,215,POINT (4697157 -74140516)
2017,Abril,Honduras,1,3,,4,POINT (4815189 -75736374)
2017,Abril,Honduras,34,77,,111,POINT (6170465 -7542726)
2017,Abril,Honduras,2,0,,2,POINT (7128047 -73181317)
2017,Abril,Hong Kong,1,2,,3,POINT (4697157 -74140516)
2017,Abril,Hungría,2,3,,5,POINT (4697157 -74140516)
2017,Abril,Hungría,0,1,,1,POINT (6170465 -7542726)
2017,Abril,India,0,1,,1,POINT (10446304 -75516486)
2017,Abril,India,1,0,,1,POINT (3451668 -76532004)
2017,Abril,India,7,32,,39,POINT (4697157 -74140516)
2017,Abril,India,1,0,,1,POINT (4815189 -75736374)
2017,Abril,India,2,5,,7,POINT (6170465 -7542726)
2017,Abril,Indonesia,0,1,,1,POINT (3451668 -76532004)
2017,Abril,Indonesia,1,2,,3,POINT (4697157 -74140516)
2017,Abril,República de Irlanda,1,2,,3,POINT (3451668 -76532004)
2017,Abril,República de Irlanda,5,14,,19,POINT (4697157 -74140516)
2017,Abril,República de Irlanda,2,3,,5,POINT (6170465 -7542726)
2017,Abril,República de Irlanda,0,1,,1,POINT (7128047 -73181317)
2017,Abril,Islandia,2,1,,3,POINT (4697157 -74140516)
2017,Abril,Israel,1,0,,1,POINT (3451668 -76532004)
2017,Abril,Israel,32,111,,143,POINT (4697157 -74140516)
2017,Abril,Israel,4,11,,15,POINT (6170465 -7542726)
2017,Abril,Italia,73,78,,151,POINT (10446304 -75516486)
2017,Abril,Italia,0,2,,2,POINT (10886686 -74776479)
2017,Abril,Italia,10,26,,36,POINT (3451668 -76532004)
2017,Abril,Italia,86,217,,303,POINT (4697157 -74140516)
2017,Abril,Italia,21,50,,71,POINT (6170465 -7542726)
2017,Abril,Jamaica,2,4,,6,POINT (10406342 -75527794)
2017,Abril,Jamaica,0,1,,1,POINT (10886686 -74776479)
2017,Abril,Jamaica,0,30,,30,POINT (10970933 -74765343)
2017,Abril,Jamaica,1,2,,3,POINT (133387613 -81372937)
2017,Abril,Jamaica,4,1,,5,POINT (3451668 -76532004)
2017,Abril,Jamaica,4,17,,21,POINT (4697157 -74140516)
2017,Abril,Jamaica,0,3,,3,POINT (6170465 -7542726)
2017,Abril,Japón,1,2,,3,POINT (3451668 -76532004)
2017,Abril,Japón,10,15,,25,POINT (4697157 -74140516)
2017,Abril,Japón,1,1,,2,POINT (4815189 -75736374)
2017,Abril,Japón,0,2,,2,POINT (6170465 -7542726)
2017,Abril,Jordania,3,2,,5,POINT (4697157 -74140516)
2017,Abril,Kazajistán,2,0,,2,POINT (4697157 -74140516)
2017,Abril,Kenia,1,3,,4,POINT (4697157 -74140516)
2017,Abril,Lesoto,0,1,,1,POINT (3451668 -76532004)
2017,Abril,Lesoto,0,1,,1,POINT (4697157 -74140516)
2017,Abril,Letonia,0,1,,1,POINT (4697157 -74140516)
2017,Abril,Lituania,1,0,,1,POINT (10446304 -75516486)
2017,Abril,Lituania,1,5,,6,POINT (4697157 -74140516)
2017,Abril,Líbano,5,4,,9,POINT (4697157 -74140516)
2017,Abril,Liechtenstein,1,1,,2,POINT (4697157 -74140516)
2017,Abril,Luxemburgo,1,0,,1,POINT (4697157 -74140516)
2017,Abril,Luxemburgo,0,2,,2,POINT (6170465 -7542726)
2017,Abril,Malasia,1,4,,5,POINT (4697157 -74140516)
2017,Abril,Malí,0,1,,1,POINT (4697157 -74140516)
2017,Abril,Malta,0,2,,2,POINT (4697157 -74140516)
2017,Abril,Marruecos,0,1,,1,POINT (10406342 -75527794)
2017,Abril,Marruecos,1,0,,1,POINT (3451668 -76532004)
2017,Abril,Mauricio,0,1,,1,POINT (4697157 -74140516)
2017,Abril,México,4,9,,13,POINT (10406342 -75527794)
2017,Abril,México,150,146,,296,POINT (10446304 -75516486)
2017,Abril,México,32,19,,51,POINT (10886686 -74776479)
2017,Abril,México,0,1,,1,POINT (10970933 -74765343)
2017,Abril,México,0,3,,3,POINT (125862 -81702165)
2017,Abril,México,1,3,,4,POINT (133387613 -81372937)
2017,Abril,México,100,193,,293,POINT (3451668 -76532004)
2017,Abril,México,5795,8455,,14250,POINT (4697157 -74140516)
2017,Abril,México,8,19,,27,POINT (4815189 -75736374)
2017,Abril,México,645,1454,,2099,POINT (6170465 -7542726)
2017,Abril,México,10,16,,26,POINT (7128047 -73181317)
2017,Abril,República de Moldavia,1,0,,1,POINT (4697157 -74140516)
2017,Abril,Mónaco,0,4,,4,POINT (4697157 -74140516)
2017,Abril,Montenegro,0,1,,1,POINT (10886686 -74776479)
2017,Abril,Mozambique,0,1,,1,POINT (3451668 -76532004)
2017,Abril,Myanmar,0,1,,1,POINT (3451668 -76532004)
2017,Abril,Myanmar,1,1,,2,POINT (4697157 -74140516)
2017,Abril,Nauru,1,0,,1,POINT (4697157 -74140516)
2017,Abril,Nicaragua,3,5,,8,POINT (10446304 -75516486)
2017,Abril,Nicaragua,0,5,,5,POINT (125744111 -81703935)
2017,Abril,Nicaragua,0,4,,4,POINT (125862 -81702165)
2017,Abril,Nicaragua,8,14,,22,POINT (3451668 -76532004)
2017,Abril,Nicaragua,23,42,,65,POINT (4697157 -74140516)
2017,Abril,Nicaragua,1,5,,6,POINT (4815189 -75736374)
2017,Abril,Nicaragua,12,16,,28,POINT (6170465 -7542726)
2017,Abril,Nicaragua,3,2,,5,POINT (7128047 -73181317)
2017,Abril,Noruega,0,16,,16,POINT (10970933 -74765343)
2017,Abril,Noruega,1,2,,3,POINT (3451668 -76532004)
2017,Abril,Noruega,14,17,,31,POINT (4697157 -74140516)
2017,Abril,Noruega,2,4,,6,POINT (6170465 -7542726)
2017,Abril,Nueva Zelanda,1,0,,1,POINT (3451668 -76532004)
2017,Abril,Nueva Zelanda,2,8,,10,POINT (4697157 -74140516)
2017,Abril,Omán,1,1,,2,POINT (4697157 -74140516)
2017,Abril,Panamá,1462,1038,,2500,POINT (10406342 -75527794)
2017,Abril,Panamá,3753,3886,,7639,POINT (10446304 -75516486)
2017,Abril,Panamá,360,596,,956,POINT (10886686 -74776479)
2017,Abril,Panamá,0,34,,34,POINT (10970933 -74765343)
2017,Abril,Panamá,1,1,,2,POINT (11247723 -74213989)
2017,Abril,Panamá,10,26,,36,POINT (125744111 -81703935)
2017,Abril,Panamá,191,192,,383,POINT (125862 -81702165)
2017,Abril,Panamá,3,3,,6,POINT (133387613 -81372937)
2017,Abril,Panamá,349,511,,860,POINT (3451668 -76532004)
2017,Abril,Panamá,0,25,,25,POINT (3884426 -77061029)
2017,Abril,Panamá,38,54,,92,POINT (445285 -75766353)
2017,Abril,Panamá,4427,5741,,10168,POINT (4697157 -74140516)
2017,Abril,Panamá,52,80,,132,POINT (4815189 -75736374)
2017,Abril,Panamá,2256,2741,,4997,POINT (6170465 -7542726)
2017,Abril,Panamá,2,1,,3,POINT (6222552 -77401154)
2017,Abril,Panamá,5,6,,11,POINT (7102626 -77762647)
2017,Abril,Panamá,14,27,,41,POINT (7128047 -73181317)
2017,Abril,Panamá,133,131,,264,POINT (863337 -7735002)
2017,Abril,Panamá,0,4,,4,POINT (9402597 -75681642)
2017,Abril,Paraguay,2,2,,4,POINT (10446304 -75516486)
2017,Abril,Paraguay,0,2,,2,POINT (10886686 -74776479)
2017,Abril,Paraguay,20,15,,35,POINT (125862 -81702165)
2017,Abril,Paraguay,5,26,,31,POINT (3451668 -76532004)
2017,Abril,Paraguay,91,108,,199,POINT (4697157 -74140516)
2017,Abril,Paraguay,1,0,,1,POINT (4815189 -75736374)
2017,Abril,Paraguay,12,12,,24,POINT (6170465 -7542726)
2017,Abril,Perú,36,70,,106,POINT (-4191162 -69941498)
2017,Abril,Perú,145,184,,329,POINT (-4214082 -69941431)
2017,Abril,Perú,1,2,,3,POINT (0.185957 -7478366)
2017,Abril,Perú,2,10,,12,POINT (0.81488 -77356)
2017,Abril,Perú,1276,927,,2203,POINT (10446304 -75516486)
2017,Abril,Perú,5,3,,8,POINT (10886686 -74776479)
2017,Abril,Perú,0,2,,2,POINT (10970933 -74765343)
2017,Abril,Perú,195,150,,345,POINT (125862 -81702165)
2017,Abril,Perú,304,339,,643,POINT (3451668 -76532004)
2017,Abril,Perú,0,43,,43,POINT (3884426 -77061029)
2017,Abril,Perú,6158,7981,,14139,POINT (4697157 -74140516)
2017,Abril,Perú,3,3,,6,POINT (4815189 -75736374)
2017,Abril,Perú,471,650,,1121,POINT (6170465 -7542726)
2017,Abril,Perú,0,2,,2,POINT (7128047 -73181317)
2017,Abril,Perú,1,0,,1,POINT (7819 -72453013)
2017,Abril,Palestina,1,0,,1,POINT (4697157 -74140516)
2017,Abril,Polonia,2,0,,2,POINT (3451668 -76532004)
2017,Abril,Polonia,11,28,,39,POINT (4697157 -74140516)
2017,Abril,Polonia,2,2,,4,POINT (6170465 -7542726)
2017,Abril,Portugal,2,5,,7,POINT (3451668 -76532004)
2017,Abril,Portugal,20,55,,75,POINT (4697157 -74140516)
2017,Abril,Portugal,8,9,,17,POINT (6170465 -7542726)
2017,Abril,Polinesia Francesa/Colectividad de Ultramar Francesa,1,0,,1,POINT (4697157 -74140516)
2017,Abril,Puerto Rico/Territorio de Estados Unidos,4,0,,4,POINT (10446304 -75516486)
2017,Abril,Puerto Rico/Territorio de Estados Unidos,4,31,,35,POINT (10886686 -74776479)
2017,Abril,Puerto Rico/Territorio de Estados Unidos,2,1,,3,POINT (11247723 -74213989)
2017,Abril,Puerto Rico/Territorio de Estados Unidos,0,2,,2,POINT (125862 -81702165)
2017,Abril,Puerto Rico/Territorio de Estados Unidos,16,38,,54,POINT (3451668 -76532004)
2017,Abril,Puerto Rico/Territorio de Estados Unidos,419,509,,928,POINT (4697157 -74140516)
2017,Abril,Puerto Rico/Territorio de Estados Unidos,2,5,,7,POINT (4815189 -75736374)
2017,Abril,Puerto Rico/Territorio de Estados Unidos,33,87,,120,POINT (6170465 -7542726)
2017,Abril,Puerto Rico/Territorio de Estados Unidos,0,1,,1,POINT (7128047 -73181317)
2017,Abril,Reino Unido de Gran Bretaña e Irlanda del Norte,2,0,,2,POINT (10446304 -75516486)
2017,Abril,Reino Unido de Gran Bretaña e Irlanda del Norte,0,3,,3,POINT (10886686 -74776479)
2017,Abril,Reino Unido de Gran Bretaña e Irlanda del Norte,0,3,,3,POINT (11247723 -74213989)
2017,Abril,Reino Unido de Gran Bretaña e Irlanda del Norte,9,13,,22,POINT (3451668 -76532004)
2017,Abril,Reino Unido de Gran Bretaña e Irlanda del Norte,812,1297,,2109,POINT (4697157 -74140516)
2017,Abril,Reino Unido de Gran Bretaña e Irlanda del Norte,28,49,,77,POINT (6170465 -7542726)
2017,Abril,República CentroÁfricana,1,0,,1,POINT (4697157 -74140516)
2017,Abril,Federación de Rusia,20,56,,76,POINT (4697157 -74140516)
2017,Abril,Federación de Rusia,3,1,,4,POINT (6170465 -7542726)
2017,Abril,República Dominicana,0,32,,32,POINT (10406342 -75527794)
2017,Abril,República Dominicana,1,4,,5,POINT (10433609 -73247863)
2017,Abril,República Dominicana,6,15,,21,POINT (10446304 -75516486)
2017,Abril,República Dominicana,9,22,,31,POINT (10886686 -74776479)
2017,Abril,República Dominicana,0,4,,4,POINT (11247723 -74213989)
2017,Abril,República Dominicana,19,20,,39,POINT (3451668 -76532004)
2017,Abril,República Dominicana,1013,1163,,2176,POINT (4697157 -74140516)
2017,Abril,República Dominicana,16,15,,31,POINT (4815189 -75736374)
2017,Abril,República Dominicana,62,77,,139,POINT (6170465 -7542726)
2017,Abril,República Dominicana,2,4,,6,POINT (7128047 -73181317)
2017,Abril,Reunión,0,1,,1,POINT (4697157 -74140516)
2017,Abril,Rumania,2,1,,3,POINT (3451668 -76532004)
2017,Abril,Rumania,7,4,,11,POINT (4697157 -74140516)
2017,Abril,Rumania,1,1,,2,POINT (6170465 -7542726)
2017,Abril,San Marino,1,1,,2,POINT (4697157 -74140516)
2017,Abril,San  Vicente y las Granadinas,1,4,,5,POINT (10406342 -75527794)
2017,Abril,Senegal,0,1,,1,POINT (4697157 -74140516)
2017,Abril,Singapur,4,2,,6,POINT (4697157 -74140516)
2017,Abril,Singapur,1,0,,1,POINT (6170465 -7542726)
2017,Abril,Sudáfrica,0,1,,1,POINT (3451668 -76532004)
2017,Abril,Sudáfrica,8,6,,14,POINT (4697157 -74140516)
2017,Abril,Suecia,0,1,,1,POINT (10886686 -74776479)
2017,Abril,Suecia,2,0,,2,POINT (3451668 -76532004)
2017,Abril,Suecia,27,32,,59,POINT (4697157 -74140516)
2017,Abril,Suecia,0,1,,1,POINT (4815189 -75736374)
2017,Abril,Suecia,2,6,,8,POINT (6170465 -7542726)
2017,Abril,Suiza,0,1,,1,POINT (10886686 -74776479)
2017,Abril,Suiza,7,9,,16,POINT (3451668 -76532004)
2017,Abril,Suiza,97,125,,222,POINT (4697157 -74140516)
2017,Abril,Suiza,13,20,,33,POINT (6170465 -7542726)
2017,Abril,Suiza,0,1,,1,POINT (7128047 -73181317)
2017,Abril,Surinam,2,4,,6,POINT (4697157 -74140516)
2017,Abril,Surinam,0,1,,1,POINT (6170465 -7542726)
2017,Abril,Taiwán,1,4,,5,POINT (4697157 -74140516)
2017,Abril,Taiwán,0,1,,1,POINT (6170465 -7542726)
2017,Abril,Tailandia,3,0,,3,POINT (4697157 -74140516)
2017,Abril,Trinidad y Tobago,0,13,,13,POINT (10406342 -75527794)
2017,Abril,Trinidad y Tobago,1,5,,6,POINT (10446304 -75516486)
2017,Abril,Trinidad y Tobago,0,1,,1,POINT (10886686 -74776479)
2017,Abril,Trinidad y Tobago,0,1,,1,POINT (125862 -81702165)
2017,Abril,Trinidad y Tobago,0,11,,11,POINT (3451668 -76532004)
2017,Abril,Trinidad y Tobago,1,4,,5,POINT (4697157 -74140516)
2017,Abril,Trinidad y Tobago,1,4,,5,POINT (6170465 -7542726)
2017,Abril,Trinidad y Tobago,0,1,,1,POINT (7128047 -73181317)
2017,Abril,Turkmenistán,2,2,,4,POINT (4697157 -74140516)
2017,Abril,Turquía,0,4,,4,POINT (10406342 -75527794)
2017,Abril,Turquía,201,363,,564,POINT (4697157 -74140516)
2017,Abril,Turquía,1,0,,1,POINT (4815189 -75736374)
2017,Abril,Turquía,0,1,,1,POINT (6170465 -7542726)
2017,Abril,Ucrania,0,5,,5,POINT (10886686 -74776479)
2017,Abril,Ucrania,0,5,,5,POINT (3451668 -76532004)
2017,Abril,Ucrania,0,3,,3,POINT (4697157 -74140516)
2017,Abril,Uruguay,0,1,,1,POINT (0.81488 -77356)
2017,Abril,Uruguay,13,4,,17,POINT (10446304 -75516486)
2017,Abril,Uruguay,1,0,,1,POINT (10886686 -74776479)
2017,Abril,Uruguay,35,27,,62,POINT (125862 -81702165)
2017,Abril,Uruguay,23,33,,56,POINT (3451668 -76532004)
2017,Abril,Uruguay,100,148,,248,POINT (4697157 -74140516)
2017,Abril,Uruguay,1,1,,2,POINT (4815189 -75736374)
2017,Abril,Uruguay,23,25,,48,POINT (6170465 -7542726)
2017,Abril,Uruguay,0,1,,1,POINT (7128047 -73181317)
2017,Abril,Venezuela,0,4,,4,POINT (10406342 -75527794)
2017,Abril,Venezuela,6,16,,22,POINT (10433609 -73247863)
2017,Abril,Venezuela,10,13,,23,POINT (10446304 -75516486)
2017,Abril,Venezuela,8,50,,58,POINT (10886686 -74776479)
2017,Abril,Venezuela,0,6,,6,POINT (10970933 -74765343)
2017,Abril,Venezuela,5168,5629,,10797,POINT (11360029 -72129595)
2017,Abril,Venezuela,1,1,,2,POINT (125862 -81702165)
2017,Abril,Venezuela,14,20,,34,POINT (3451668 -76532004)
2017,Abril,Venezuela,106,120,,226,POINT (3866713 -67927521)
2017,Abril,Venezuela,3498,3621,,7119,POINT (4697157 -74140516)
2017,Abril,Venezuela,1,3,,4,POINT (4815189 -75736374)
2017,Abril,Venezuela,548,561,,1109,POINT (6170465 -7542726)
2017,Abril,Venezuela,127,175,,302,POINT (6185536 -67484028)
2017,Abril,Venezuela,113,119,,232,POINT (7088729 -70740253)
2017,Abril,Venezuela,11,11,,22,POINT (7128047 -73181317)
2017,Abril,Venezuela,7956,10225,,18181,POINT (7819 -72453013)
2017,Abril,Venezuela,3,7,,10,POINT (7927233 -72508188)
2017,Abril,Venezuela,255,269,,524,POINT (836068 -72409396)
2017,Abril,Vietnam,0,1,,1,POINT (4697157 -74140516)
2017,Abril,Islas Vírgenes Británicas/Territorio Británico de Ultramar,0,3,,3,POINT (11247723 -74213989)
2017,Abril,Islas Vírgenes Estadounidenses/Territorio de Estados Unidos,0,8,,8,POINT (4697157 -74140516)
2017,Mayo,Afganistán,0,1,,1,POINT (4697157 -74140516)
2017,Mayo,Albania,1,3,,4,POINT (4697157 -74140516)
2017,Mayo,Alemania,1,1,,2,POINT (0.81488 -77356)
2017,Mayo,Alemania,3,1,,4,POINT (10446304 -75516486)
2017,Mayo,Alemania,3,2,,5,POINT (10886686 -74776479)
2017,Mayo,Alemania,0,1,,1,POINT (11247723 -74213989)
2017,Mayo,Alemania,15,13,,28,POINT (3451668 -76532004)
2017,Mayo,Alemania,978,1877,,2855,POINT (4697157 -74140516)
2017,Mayo,Alemania,3,3,,6,POINT (4815189 -75736374)
2017,Mayo,Alemania,17,27,,44,POINT (6170465 -7542726)
2017,Mayo,Angola,0,2,,2,POINT (4697157 -74140516)
2017,Mayo,Antigua y Barbuda,0,9,,9,POINT (10406342 -75527794)
2017,Mayo,Antigua y Barbuda,0,1,,1,POINT (6170465 -7542726)
2017,Mayo,Países Bajos,4,23,,27,POINT (10406342 -75527794)
2017,Mayo,Países Bajos,124,220,,344,POINT (10446304 -75516486)
2017,Mayo,Países Bajos,4,5,,9,POINT (10886686 -74776479)
2017,Mayo,Países Bajos,0,1,,1,POINT (11247723 -74213989)
2017,Mayo,Países Bajos,29,33,,62,POINT (3451668 -76532004)
2017,Mayo,Países Bajos,791,1162,,1953,POINT (4697157 -74140516)
2017,Mayo,Países Bajos,0,5,,5,POINT (4815189 -75736374)
2017,Mayo,Países Bajos,80,116,,196,POINT (6170465 -7542726)
2017,Mayo,Países Bajos,4,3,,7,POINT (7128047 -73181317)
2017,Mayo,Arabia Saudita,0,1,,1,POINT (3451668 -76532004)
2017,Mayo,Arabia Saudita,2,0,,2,POINT (4697157 -74140516)
2017,Mayo,Argelia,3,0,,3,POINT (4697157 -74140516)
2017,Mayo,Argentina,5,9,,14,POINT (0.81488 -77356)
2017,Mayo,Argentina,119,87,,206,POINT (10446304 -75516486)
2017,Mayo,Argentina,9,4,,13,POINT (10886686 -74776479)
2017,Mayo,Argentina,151,103,,254,POINT (125862 -81702165)
2017,Mayo,Argentina,12,26,,38,POINT (3451668 -76532004)
2017,Mayo,Argentina,3953,4623,,8576,POINT (4697157 -74140516)
2017,Mayo,Argentina,1,1,,2,POINT (4815189 -75736374)
2017,Mayo,Argentina,21,70,,91,POINT (6170465 -7542726)
2017,Mayo,Aruba,4,7,,11,POINT (10406342 -75527794)
2017,Mayo,Aruba,0,2,,2,POINT (10886686 -74776479)
2017,Mayo,Aruba,18,39,,57,POINT (11247723 -74213989)
2017,Mayo,Aruba,6,9,,15,POINT (3451668 -76532004)
2017,Mayo,Aruba,764,908,,1672,POINT (4697157 -74140516)
2017,Mayo,Aruba,0,2,,2,POINT (4815189 -75736374)
2017,Mayo,Aruba,7,13,,20,POINT (6170465 -7542726)
2017,Mayo,Aruba,22,11,,33,POINT (7128047 -73181317)
2017,Mayo,Australia,1,0,,1,POINT (10446304 -75516486)
2017,Mayo,Australia,2,0,,2,POINT (10886686 -74776479)
2017,Mayo,Australia,0,1,,1,POINT (125862 -81702165)
2017,Mayo,Australia,0,3,,3,POINT (3451668 -76532004)
2017,Mayo,Australia,43,45,,88,POINT (4697157 -74140516)
2017,Mayo,Australia,9,15,,24,POINT (6170465 -7542726)
2017,Mayo,Australia,0,1,,1,POINT (7128047 -73181317)
2017,Mayo,Austria,1,0,,1,POINT (3451668 -76532004)
2017,Mayo,Austria,15,18,,33,POINT (4697157 -74140516)
2017,Mayo,Austria,1,1,,2,POINT (6170465 -7542726)
2017,Mayo,Azerbaiyán,0,2,,2,POINT (4697157 -74140516)
2017,Mayo,Bahamas,0,1,,1,POINT (10406342 -75527794)
2017,Mayo,Bahamas,0,4,,4,POINT (3451668 -76532004)
2017,Mayo,Bahamas,1,0,,1,POINT (4697157 -74140516)
2017,Mayo,Bahamas,0,1,,1,POINT (4815189 -75736374)
2017,Mayo,Bahamas,0,6,,6,POINT (6170465 -7542726)
2017,Mayo,Bahréin,0,2,,2,POINT (10446304 -75516486)
2017,Mayo,Bahréin,1,0,,1,POINT (6170465 -7542726)
2017,Mayo,Bangladesh,0,2,,2,POINT (4697157 -74140516)
2017,Mayo,Barbados,50,67,,117,POINT (4697157 -74140516)
2017,Mayo,República de Belarús,3,1,,4,POINT (4697157 -74140516)
2017,Mayo,Bélgica,0,2,,2,POINT (11247723 -74213989)
2017,Mayo,Bélgica,2,7,,9,POINT (3451668 -76532004)
2017,Mayo,Bélgica,22,32,,54,POINT (4697157 -74140516)
2017,Mayo,Bélgica,0,1,,1,POINT (4815189 -75736374)
2017,Mayo,Bélgica,6,7,,13,POINT (6170465 -7542726)
2017,Mayo,Belice,1,1,,2,POINT (10446304 -75516486)
2017,Mayo,Belice,1,1,,2,POINT (133387613 -81372937)
2017,Mayo,Belice,4,3,,7,POINT (4697157 -74140516)
2017,Mayo,Belice,0,1,,1,POINT (6170465 -7542726)
2017,Mayo,Benín,0,1,,1,POINT (4697157 -74140516)
2017,Mayo,Bermudas/Territorio Británico de Ultramar,2,0,,2,POINT (6170465 -7542726)
2017,Mayo,Bolivia,6,4,,10,POINT (10446304 -75516486)
2017,Mayo,Bolivia,1,1,,2,POINT (10886686 -74776479)
2017,Mayo,Bolivia,90,27,,117,POINT (125862 -81702165)
2017,Mayo,Bolivia,13,15,,28,POINT (3451668 -76532004)
2017,Mayo,Bolivia,531,608,,1139,POINT (4697157 -74140516)
2017,Mayo,Bolivia,1,2,,3,POINT (4815189 -75736374)
2017,Mayo,Bolivia,26,28,,54,POINT (6170465 -7542726)
2017,Mayo,Bolivia,0,1,,1,POINT (7128047 -73181317)
2017,Mayo,Brasil,134,162,,296,POINT (-4191162 -69941498)
2017,Mayo,Brasil,16,18,,34,POINT (-4214082 -69941431)
2017,Mayo,Brasil,1,1,,2,POINT (0.81488 -77356)
2017,Mayo,Brasil,0,4,,4,POINT (10406342 -75527794)
2017,Mayo,Brasil,57,64,,121,POINT (10446304 -75516486)
2017,Mayo,Brasil,3,8,,11,POINT (10886686 -74776479)
2017,Mayo,Brasil,0,1,,1,POINT (11247723 -74213989)
2017,Mayo,Brasil,333,293,,626,POINT (125862 -81702165)
2017,Mayo,Brasil,19,46,,65,POINT (3451668 -76532004)
2017,Mayo,Brasil,4491,6146,,10637,POINT (4697157 -74140516)
2017,Mayo,Brasil,1,2,,3,POINT (4815189 -75736374)
2017,Mayo,Brasil,107,165,,272,POINT (6170465 -7542726)
2017,Mayo,Brasil,0,2,,2,POINT (7128047 -73181317)
2017,Mayo,Brunei Darussalam,1,0,,1,POINT (4697157 -74140516)
2017,Mayo,Bulgaria,1,0,,1,POINT (4697157 -74140516)
2017,Mayo,Bulgaria,0,2,,2,POINT (6170465 -7542726)
2017,Mayo,Islas Caimán/Territorio Británico de Ultramar,0,2,,2,POINT (10406342 -75527794)
2017,Mayo,Islas Caimán/Territorio Británico de Ultramar,0,3,,3,POINT (10886686 -74776479)
2017,Mayo,Islas Caimán/Territorio Británico de Ultramar,0,4,,4,POINT (125744111 -81703935)
2017,Mayo,Islas Caimán/Territorio Británico de Ultramar,1,2,,3,POINT (125862 -81702165)
2017,Mayo,Islas Caimán/Territorio Británico de Ultramar,1,1,,2,POINT (133387613 -81372937)
2017,Mayo,Islas Caimán/Territorio Británico de Ultramar,0,1,,1,POINT (3451668 -76532004)
2017,Mayo,Islas Caimán/Territorio Británico de Ultramar,0,1,,1,POINT (4697157 -74140516)
2017,Mayo,Camerún,0,1,,1,POINT (4697157 -74140516)
2017,Mayo,Canadá,12,12,,24,POINT (10446304 -75516486)
2017,Mayo,Canadá,8,5,,13,POINT (10886686 -74776479)
2017,Mayo,Canadá,0,5,,5,POINT (10970933 -74765343)
2017,Mayo,Canadá,37,33,,70,POINT (3451668 -76532004)
2017,Mayo,Canadá,0,9,,9,POINT (3884426 -77061029)
2017,Mayo,Canadá,636,984,,1620,POINT (4697157 -74140516)
2017,Mayo,Canadá,4,11,,15,POINT (4815189 -75736374)
2017,Mayo,Canadá,66,151,,217,POINT (6170465 -7542726)
2017,Mayo,Canadá,1,3,,4,POINT (7128047 -73181317)
2017,Mayo,España,0,3,,3,POINT (10406342 -75527794)
2017,Mayo,España,0,2,,2,POINT (10446304 -75516486)
2017,Mayo,España,1,5,,6,POINT (10886686 -74776479)
2017,Mayo,España,0,2,,2,POINT (11247723 -74213989)
2017,Mayo,España,3,2,,5,POINT (125862 -81702165)
2017,Mayo,España,229,375,,604,POINT (3451668 -76532004)
2017,Mayo,España,2610,5028,,7638,POINT (4697157 -74140516)
2017,Mayo,España,4,5,,9,POINT (4815189 -75736374)
2017,Mayo,España,316,581,,897,POINT (6170465 -7542726)
2017,Mayo,República Del Congo,1,0,,1,POINT (4697157 -74140516)
2017,Mayo,República Democrática del Congo,0,2,,2,POINT (4697157 -74140516)
2017,Mayo,República de Corea,0,2,,2,POINT (3451668 -76532004)
2017,Mayo,República de Corea,4,22,,26,POINT (4697157 -74140516)
2017,Mayo,República de Corea,1,5,,6,POINT (6170465 -7542726)
2017,Mayo,Costa de Marfil,2,6,,8,POINT (4697157 -74140516)
2017,Mayo,Costa Rica,14,9,,23,POINT (10446304 -75516486)
2017,Mayo,Costa Rica,6,11,,17,POINT (10886686 -74776479)
2017,Mayo,Costa Rica,1,5,,6,POINT (11247723 -74213989)
2017,Mayo,Costa Rica,279,212,,491,POINT (125862 -81702165)
2017,Mayo,Costa Rica,35,36,,71,POINT (3451668 -76532004)
2017,Mayo,Costa Rica,0,1,,1,POINT (445285 -75766353)
2017,Mayo,Costa Rica,1126,1599,,2725,POINT (4697157 -74140516)
2017,Mayo,Costa Rica,1,22,,23,POINT (4815189 -75736374)
2017,Mayo,Costa Rica,109,164,,273,POINT (6170465 -7542726)
2017,Mayo,Costa Rica,2,4,,6,POINT (7128047 -73181317)
2017,Mayo,Croacia,1,3,,4,POINT (4697157 -74140516)
2017,Mayo,Croacia,1,0,,1,POINT (4815189 -75736374)
2017,Mayo,Croacia,1,0,,1,POINT (6170465 -7542726)
2017,Mayo,Cuba,0,1,,1,POINT (10406342 -75527794)
2017,Mayo,Cuba,1,3,,4,POINT (10446304 -75516486)
2017,Mayo,Cuba,2,9,,11,POINT (10886686 -74776479)
2017,Mayo,Cuba,1,4,,5,POINT (125744111 -81703935)
2017,Mayo,Cuba,9,11,,20,POINT (3451668 -76532004)
2017,Mayo,Cuba,328,489,,817,POINT (4697157 -74140516)
2017,Mayo,Cuba,1,1,,2,POINT (4815189 -75736374)
2017,Mayo,Cuba,16,37,,53,POINT (6170465 -7542726)
2017,Mayo,Curazao,0,1,,1,POINT (10446304 -75516486)
2017,Mayo,Curazao,0,5,,5,POINT (4697157 -74140516)
2017,Mayo,República Checa,1,4,,5,POINT (4697157 -74140516)
2017,Mayo,República Checa,0,1,,1,POINT (6170465 -7542726)
2017,Mayo,Chile,2,4,,6,POINT (0.81488 -77356)
2017,Mayo,Chile,19,11,,30,POINT (10446304 -75516486)
2017,Mayo,Chile,3,5,,8,POINT (10886686 -74776479)
2017,Mayo,Chile,72,62,,134,POINT (125862 -81702165)
2017,Mayo,Chile,14,26,,40,POINT (3451668 -76532004)
2017,Mayo,Chile,4637,5994,,10631,POINT (4697157 -74140516)
2017,Mayo,Chile,0,2,,2,POINT (4815189 -75736374)
2017,Mayo,Chile,23,48,,71,POINT (6170465 -7542726)
2017,Mayo,China,1,6,,7,POINT (3451668 -76532004)
2017,Mayo,China,39,97,,136,POINT (4697157 -74140516)
2017,Mayo,China,8,18,,26,POINT (6170465 -7542726)
2017,Mayo,Dinamarca,0,1,,1,POINT (3451668 -76532004)
2017,Mayo,Dinamarca,3,13,,16,POINT (4697157 -74140516)
2017,Mayo,Dinamarca,2,1,,3,POINT (6170465 -7542726)
2017,Mayo,Dominica,1,1,,2,POINT (3451668 -76532004)
2017,Mayo,Dominica,0,1,,1,POINT (6170465 -7542726)
2017,Mayo,Ecuador,0,1,,1,POINT (0.185957 -7478366)
2017,Mayo,Ecuador,151,474,,625,POINT (0.33002 -76876446)
2017,Mayo,Ecuador,3392,5858,,9250,POINT (0.81488 -77356)
2017,Mayo,Ecuador,34,54,,88,POINT (1800143 -78802679)
2017,Mayo,Ecuador,0,4,,4,POINT (10406342 -75527794)
2017,Mayo,Ecuador,66,73,,139,POINT (10446304 -75516486)
2017,Mayo,Ecuador,2,4,,6,POINT (10886686 -74776479)
2017,Mayo,Ecuador,9,8,,17,POINT (125862 -81702165)
2017,Mayo,Ecuador,415,467,,882,POINT (3451668 -76532004)
2017,Mayo,Ecuador,0,7,,7,POINT (3884426 -77061029)
2017,Mayo,Ecuador,3361,4681,,8042,POINT (4697157 -74140516)
2017,Mayo,Ecuador,0,1,,1,POINT (4815189 -75736374)
2017,Mayo,Ecuador,54,174,,228,POINT (6170465 -7542726)
2017,Mayo,Egipto,1,3,,4,POINT (4697157 -74140516)
2017,Mayo,El Salvador,1,2,,3,POINT (10446304 -75516486)
2017,Mayo,El Salvador,0,1,,1,POINT (10886686 -74776479)
2017,Mayo,El Salvador,13,6,,19,POINT (125862 -81702165)
2017,Mayo,El Salvador,110,166,,276,POINT (3451668 -76532004)
2017,Mayo,El Salvador,0,2,,2,POINT (3884426 -77061029)
2017,Mayo,El Salvador,1003,1489,,2492,POINT (4697157 -74140516)
2017,Mayo,El Salvador,0,1,,1,POINT (4815189 -75736374)
2017,Mayo,El Salvador,169,296,,465,POINT (6170465 -7542726)
2017,Mayo,Emiratos Árabes,1,3,,4,POINT (4697157 -74140516)
2017,Mayo,Eslovaquia,1,0,,1,POINT (6170465 -7542726)
2017,Mayo,Eslovenia,2,5,,7,POINT (4697157 -74140516)
2017,Mayo,Eslovenia,0,1,,1,POINT (6170465 -7542726)
2017,Mayo,Estados Unidos de América,1,20,,21,POINT (10406342 -75527794)
2017,Mayo,Estados Unidos de América,0,2,,2,POINT (10433609 -73247863)
2017,Mayo,Estados Unidos de América,2689,3610,,6299,POINT (10446304 -75516486)
2017,Mayo,Estados Unidos de América,513,953,,1466,POINT (10886686 -74776479)
2017,Mayo,Estados Unidos de América,0,1,,1,POINT (10970933 -74765343)
2017,Mayo,Estados Unidos de América,0,3,,3,POINT (11117206 -74232675)
2017,Mayo,Estados Unidos de América,0,14,,14,POINT (11247723 -74213989)
2017,Mayo,Estados Unidos de América,23,20,,43,POINT (125862 -81702165)
2017,Mayo,Estados Unidos de América,1250,1597,,2847,POINT (3451668 -76532004)
2017,Mayo,Estados Unidos de América,0,2,,2,POINT (3884426 -77061029)
2017,Mayo,Estados Unidos de América,161,215,,376,POINT (445285 -75766353)
2017,Mayo,Estados Unidos de América,8799,15858,,24657,POINT (4697157 -74140516)
2017,Mayo,Estados Unidos de América,121,154,,275,POINT (4815189 -75736374)
2017,Mayo,Estados Unidos de América,2419,6078,,8497,POINT (6170465 -7542726)
2017,Mayo,Estados Unidos de América,27,40,,67,POINT (7128047 -73181317)
2017,Mayo,Estados Unidos de América,1,25,,26,POINT (9402597 -75681642)
2017,Mayo,Estonia,1,0,,1,POINT (4697157 -74140516)
2017,Mayo,Estonia,1,0,,1,POINT (6170465 -7542726)
2017,Mayo,Filipinas,0,2,,2,POINT (10886686 -74776479)
2017,Mayo,Filipinas,1,8,,9,POINT (3451668 -76532004)
2017,Mayo,Filipinas,0,2,,2,POINT (3884426 -77061029)
2017,Mayo,Filipinas,1,3,,4,POINT (4697157 -74140516)
2017,Mayo,Filipinas,0,2,,2,POINT (4815189 -75736374)
2017,Mayo,Filipinas,1,0,,1,POINT (6170465 -7542726)
2017,Mayo,Finlandia,5,7,,12,POINT (4697157 -74140516)
2017,Mayo,Finlandia,1,3,,4,POINT (6170465 -7542726)
2017,Mayo,Francia,1,0,,1,POINT (10446304 -75516486)
2017,Mayo,Francia,1,3,,4,POINT (10886686 -74776479)
2017,Mayo,Francia,27,31,,58,POINT (3451668 -76532004)
2017,Mayo,Francia,2,0,,2,POINT (445285 -75766353)
2017,Mayo,Francia,1123,1897,,3020,POINT (4697157 -74140516)
2017,Mayo,Francia,23,36,,59,POINT (6170465 -7542726)
2017,Mayo,Francia,0,1,,1,POINT (7128047 -73181317)
2017,Mayo,Georgia,0,1,,1,POINT (4697157 -74140516)
2017,Mayo,Ghana,0,1,,1,POINT (10446304 -75516486)
2017,Mayo,Gibraltar/Territorio Británico de Ultramar,0,1,,1,POINT (0.81488 -77356)
2017,Mayo,Gibraltar/Territorio Británico de Ultramar,0,1,,1,POINT (4697157 -74140516)
2017,Mayo,Granada,0,6,,6,POINT (10406342 -75527794)
2017,Mayo,Granada,0,1,,1,POINT (3451668 -76532004)
2017,Mayo,Grecia,0,1,,1,POINT (3451668 -76532004)
2017,Mayo,Grecia,1,1,,2,POINT (4697157 -74140516)
2017,Mayo,Guatemala,0,1,,1,POINT (10406342 -75527794)
2017,Mayo,Guatemala,7,11,,18,POINT (10446304 -75516486)
2017,Mayo,Guatemala,2,10,,12,POINT (10886686 -74776479)
2017,Mayo,Guatemala,44,30,,74,POINT (125862 -81702165)
2017,Mayo,Guatemala,11,39,,50,POINT (3451668 -76532004)
2017,Mayo,Guatemala,366,585,,951,POINT (4697157 -74140516)
2017,Mayo,Guatemala,2,12,,14,POINT (4815189 -75736374)
2017,Mayo,Guatemala,58,107,,165,POINT (6170465 -7542726)
2017,Mayo,Guatemala,3,12,,15,POINT (7128047 -73181317)
2017,Mayo,Guyana,2,1,,3,POINT (3451668 -76532004)
2017,Mayo,Guyana,0,1,,1,POINT (4697157 -74140516)
2017,Mayo,Guyana,1,0,,1,POINT (6170465 -7542726)
2017,Mayo,Guinea Ecuatorial,0,1,,1,POINT (4697157 -74140516)
2017,Mayo,Guadalupe/Territorio Francés,0,1,,1,POINT (11247723 -74213989)
2017,Mayo,Guadalupe/Territorio Francés,1,0,,1,POINT (3451668 -76532004)
2017,Mayo,Guadalupe/Territorio Francés,2,3,,5,POINT (4697157 -74140516)
2017,Mayo,Guadalupe/Territorio Francés,0,1,,1,POINT (4815189 -75736374)
2017,Mayo,Guayana Francesa/Departamento de Ultramar Francés,0,2,,2,POINT (3451668 -76532004)
2017,Mayo,Haití,0,1,,1,POINT (10446304 -75516486)
2017,Mayo,Haití,0,1,,1,POINT (4697157 -74140516)
2017,Mayo,Haití,3,3,,6,POINT (6170465 -7542726)
2017,Mayo,Honduras,1,2,,3,POINT (10446304 -75516486)
2017,Mayo,Honduras,1,2,,3,POINT (10886686 -74776479)
2017,Mayo,Honduras,19,10,,29,POINT (125862 -81702165)
2017,Mayo,Honduras,6,9,,15,POINT (133387613 -81372937)
2017,Mayo,Honduras,16,10,,26,POINT (3451668 -76532004)
2017,Mayo,Honduras,55,77,,132,POINT (4697157 -74140516)
2017,Mayo,Honduras,23,54,,77,POINT (6170465 -7542726)
2017,Mayo,Hong Kong,0,1,,1,POINT (3451668 -76532004)
2017,Mayo,Hong Kong,2,5,,7,POINT (4697157 -74140516)
2017,Mayo,Hungría,5,5,,10,POINT (4697157 -74140516)
2017,Mayo,India,0,4,,4,POINT (10886686 -74776479)
2017,Mayo,India,0,2,,2,POINT (3451668 -76532004)
2017,Mayo,India,2,24,,26,POINT (4697157 -74140516)
2017,Mayo,India,1,5,,6,POINT (6170465 -7542726)
2017,Mayo,India,0,2,,2,POINT (7128047 -73181317)
2017,Mayo,Irán,1,1,,2,POINT (4697157 -74140516)
2017,Mayo,República de Irlanda,1,1,,2,POINT (10446304 -75516486)
2017,Mayo,República de Irlanda,2,2,,4,POINT (3451668 -76532004)
2017,Mayo,República de Irlanda,13,12,,25,POINT (4697157 -74140516)
2017,Mayo,República de Irlanda,3,3,,6,POINT (6170465 -7542726)
2017,Mayo,Islandia,2,3,,5,POINT (4697157 -74140516)
2017,Mayo,Islandia,1,1,,2,POINT (4815189 -75736374)
2017,Mayo,Israel,0,1,,1,POINT (10446304 -75516486)
2017,Mayo,Israel,0,1,,1,POINT (10886686 -74776479)
2017,Mayo,Israel,1,2,,3,POINT (3451668 -76532004)
2017,Mayo,Israel,30,79,,109,POINT (4697157 -74140516)
2017,Mayo,Israel,2,5,,7,POINT (6170465 -7542726)
2017,Mayo,Italia,0,2,,2,POINT (10406342 -75527794)
2017,Mayo,Italia,1,6,,7,POINT (10886686 -74776479)
2017,Mayo,Italia,11,30,,41,POINT (3451668 -76532004)
2017,Mayo,Italia,61,181,,242,POINT (4697157 -74140516)
2017,Mayo,Italia,2,2,,4,POINT (4815189 -75736374)
2017,Mayo,Italia,9,32,,41,POINT (6170465 -7542726)
2017,Mayo,Jamaica,4,11,,15,POINT (10406342 -75527794)
2017,Mayo,Jamaica,0,7,,7,POINT (10446304 -75516486)
2017,Mayo,Jamaica,0,1,,1,POINT (10970933 -74765343)
2017,Mayo,Jamaica,7,8,,15,POINT (133387613 -81372937)
2017,Mayo,Jamaica,1,1,,2,POINT (3451668 -76532004)
2017,Mayo,Jamaica,5,5,,10,POINT (4697157 -74140516)
2017,Mayo,Jamaica,0,2,,2,POINT (6170465 -7542726)
2017,Mayo,Japón,0,1,,1,POINT (10886686 -74776479)
2017,Mayo,Japón,0,1,,1,POINT (3451668 -76532004)
2017,Mayo,Japón,6,17,,23,POINT (4697157 -74140516)
2017,Mayo,Japón,0,1,,1,POINT (4815189 -75736374)
2017,Mayo,Japón,1,3,,4,POINT (6170465 -7542726)
2017,Mayo,Kazajistán,0,1,,1,POINT (4697157 -74140516)
2017,Mayo,Kenia,0,3,,3,POINT (3451668 -76532004)
2017,Mayo,Kenia,0,1,,1,POINT (4697157 -74140516)
2017,Mayo,República de Kosovo,1,0,,1,POINT (4697157 -74140516)
2017,Mayo,Letonia,0,1,,1,POINT (4697157 -74140516)
2017,Mayo,Lituania,0,2,,2,POINT (4697157 -74140516)
2017,Mayo,Líbano,3,6,,9,POINT (4697157 -74140516)
2017,Mayo,Liechtenstein,1,0,,1,POINT (3451668 -76532004)
2017,Mayo,Liechtenstein,0,2,,2,POINT (4697157 -74140516)
2017,Mayo,Luxemburgo,2,2,,4,POINT (4697157 -74140516)
2017,Mayo,Malasia,2,1,,3,POINT (4697157 -74140516)
2017,Mayo,Malta,0,2,,2,POINT (4697157 -74140516)
2017,Mayo,Marruecos,0,1,,1,POINT (10406342 -75527794)
2017,Mayo,Marruecos,0,2,,2,POINT (4697157 -74140516)
2017,Mayo,Martinica/Departamento de Ultramar Francés,1,2,,3,POINT (11247723 -74213989)
2017,Mayo,México,1,23,,24,POINT (10406342 -75527794)
2017,Mayo,México,113,106,,219,POINT (10446304 -75516486)
2017,Mayo,México,14,27,,41,POINT (10886686 -74776479)
2017,Mayo,México,0,13,,13,POINT (11247723 -74213989)
2017,Mayo,México,61,153,,214,POINT (3451668 -76532004)
2017,Mayo,México,5233,8481,,13714,POINT (4697157 -74140516)
2017,Mayo,México,6,14,,20,POINT (4815189 -75736374)
2017,Mayo,México,525,1232,,1757,POINT (6170465 -7542726)
2017,Mayo,México,2,14,,16,POINT (7128047 -73181317)
2017,Mayo,República de Moldavia,1,0,,1,POINT (4697157 -74140516)
2017,Mayo,Mónaco,0,1,,1,POINT (6170465 -7542726)
2017,Mayo,Montenegro,0,1,,1,POINT (4697157 -74140516)
2017,Mayo,Nepal,0,1,,1,POINT (4815189 -75736374)
2017,Mayo,Nicaragua,0,2,,2,POINT (10446304 -75516486)
2017,Mayo,Nicaragua,0,2,,2,POINT (10886686 -74776479)
2017,Mayo,Nicaragua,4,13,,17,POINT (125744111 -81703935)
2017,Mayo,Nicaragua,0,2,,2,POINT (125862 -81702165)
2017,Mayo,Nicaragua,5,6,,11,POINT (3451668 -76532004)
2017,Mayo,Nicaragua,36,39,,75,POINT (4697157 -74140516)
2017,Mayo,Nicaragua,0,1,,1,POINT (4815189 -75736374)
2017,Mayo,Nicaragua,11,32,,43,POINT (6170465 -7542726)
2017,Mayo,Nicaragua,0,5,,5,POINT (7128047 -73181317)
2017,Mayo,Nigeria,0,1,,1,POINT (10886686 -74776479)
2017,Mayo,Nigeria,1,1,,2,POINT (4697157 -74140516)
2017,Mayo,Noruega,0,1,,1,POINT (10886686 -74776479)
2017,Mayo,Noruega,2,1,,3,POINT (3451668 -76532004)
2017,Mayo,Noruega,7,13,,20,POINT (4697157 -74140516)
2017,Mayo,Noruega,0,1,,1,POINT (4815189 -75736374)
2017,Mayo,Noruega,0,3,,3,POINT (6170465 -7542726)
2017,Mayo,Nueva Zelanda,1,0,,1,POINT (3451668 -76532004)
2017,Mayo,Nueva Zelanda,8,6,,14,POINT (4697157 -74140516)
2017,Mayo,Nueva Zelanda,1,1,,2,POINT (6170465 -7542726)
2017,Mayo,Panamá,1494,1264,,2758,POINT (10406342 -75527794)
2017,Mayo,Panamá,3309,3534,,6843,POINT (10446304 -75516486)
2017,Mayo,Panamá,255,494,,749,POINT (10886686 -74776479)
2017,Mayo,Panamá,0,19,,19,POINT (10970933 -74765343)
2017,Mayo,Panamá,1,2,,3,POINT (11247723 -74213989)
2017,Mayo,Panamá,6,26,,32,POINT (125744111 -81703935)
2017,Mayo,Panamá,85,64,,149,POINT (125862 -81702165)
2017,Mayo,Panamá,1,1,,2,POINT (133387613 -81372937)
2017,Mayo,Panamá,356,549,,905,POINT (3451668 -76532004)
2017,Mayo,Panamá,0,11,,11,POINT (3884426 -77061029)
2017,Mayo,Panamá,29,47,,76,POINT (445285 -75766353)
2017,Mayo,Panamá,3899,6174,,10073,POINT (4697157 -74140516)
2017,Mayo,Panamá,22,74,,96,POINT (4815189 -75736374)
2017,Mayo,Panamá,1609,2576,,4185,POINT (6170465 -7542726)
2017,Mayo,Panamá,1,2,,3,POINT (6222552 -77401154)
2017,Mayo,Panamá,2,3,,5,POINT (7102626 -77762647)
2017,Mayo,Panamá,18,35,,53,POINT (7128047 -73181317)
2017,Mayo,Panamá,69,118,,187,POINT (863337 -7735002)
2017,Mayo,Paraguay,5,5,,10,POINT (10446304 -75516486)
2017,Mayo,Paraguay,1,1,,2,POINT (10886686 -74776479)
2017,Mayo,Paraguay,72,50,,122,POINT (125862 -81702165)
2017,Mayo,Paraguay,6,8,,14,POINT (3451668 -76532004)
2017,Mayo,Paraguay,84,97,,181,POINT (4697157 -74140516)
2017,Mayo,Paraguay,0,1,,1,POINT (4815189 -75736374)
2017,Mayo,Paraguay,20,38,,58,POINT (6170465 -7542726)
2017,Mayo,Perú,94,102,,196,POINT (-4191162 -69941498)
2017,Mayo,Perú,134,200,,334,POINT (-4214082 -69941431)
2017,Mayo,Perú,1,3,,4,POINT (0.185957 -7478366)
2017,Mayo,Perú,8,13,,21,POINT (0.81488 -77356)
2017,Mayo,Perú,1214,876,,2090,POINT (10446304 -75516486)
2017,Mayo,Perú,4,11,,15,POINT (10886686 -74776479)
2017,Mayo,Perú,215,145,,360,POINT (125862 -81702165)
2017,Mayo,Perú,224,260,,484,POINT (3451668 -76532004)
2017,Mayo,Perú,0,2,,2,POINT (3884426 -77061029)
2017,Mayo,Perú,6485,8413,,14898,POINT (4697157 -74140516)
2017,Mayo,Perú,4,8,,12,POINT (4815189 -75736374)
2017,Mayo,Perú,356,516,,872,POINT (6170465 -7542726)
2017,Mayo,Perú,1,1,,2,POINT (7128047 -73181317)
2017,Mayo,Polonia,15,18,,33,POINT (4697157 -74140516)
2017,Mayo,Portugal,0,1,,1,POINT (10886686 -74776479)
2017,Mayo,Portugal,0,1,,1,POINT (125862 -81702165)
2017,Mayo,Portugal,0,3,,3,POINT (3451668 -76532004)
2017,Mayo,Portugal,17,54,,71,POINT (4697157 -74140516)
2017,Mayo,Portugal,4,6,,10,POINT (6170465 -7542726)
2017,Mayo,Polinesia Francesa/Colectividad de Ultramar Francesa,0,1,,1,POINT (4697157 -74140516)
2017,Mayo,Puerto Rico/Territorio de Estados Unidos,1,1,,2,POINT (10406342 -75527794)
2017,Mayo,Puerto Rico/Territorio de Estados Unidos,5,2,,7,POINT (10446304 -75516486)
2017,Mayo,Puerto Rico/Territorio de Estados Unidos,9,14,,23,POINT (10886686 -74776479)
2017,Mayo,Puerto Rico/Territorio de Estados Unidos,1,3,,4,POINT (125862 -81702165)
2017,Mayo,Puerto Rico/Territorio de Estados Unidos,39,38,,77,POINT (3451668 -76532004)
2017,Mayo,Puerto Rico/Territorio de Estados Unidos,477,552,,1029,POINT (4697157 -74140516)
2017,Mayo,Puerto Rico/Territorio de Estados Unidos,0,4,,4,POINT (4815189 -75736374)
2017,Mayo,Puerto Rico/Territorio de Estados Unidos,34,126,,160,POINT (6170465 -7542726)
2017,Mayo,Puerto Rico/Territorio de Estados Unidos,2,3,,5,POINT (7128047 -73181317)
2017,Mayo,Qatar,1,0,,1,POINT (4697157 -74140516)
2017,Mayo,Reino Unido de Gran Bretaña e Irlanda del Norte,1,0,,1,POINT (10446304 -75516486)
2017,Mayo,Reino Unido de Gran Bretaña e Irlanda del Norte,1,0,,1,POINT (10886686 -74776479)
2017,Mayo,Reino Unido de Gran Bretaña e Irlanda del Norte,9,8,,17,POINT (3451668 -76532004)
2017,Mayo,Reino Unido de Gran Bretaña e Irlanda del Norte,600,1019,,1619,POINT (4697157 -74140516)
2017,Mayo,Reino Unido de Gran Bretaña e Irlanda del Norte,15,31,,46,POINT (6170465 -7542726)
2017,Mayo,Federación de Rusia,13,13,,26,POINT (4697157 -74140516)
2017,Mayo,Federación de Rusia,1,2,,3,POINT (6170465 -7542726)
2017,Mayo,República Dominicana,2,18,,20,POINT (10406342 -75527794)
2017,Mayo,República Dominicana,1,14,,15,POINT (10446304 -75516486)
2017,Mayo,República Dominicana,7,15,,22,POINT (10886686 -74776479)
2017,Mayo,República Dominicana,0,2,,2,POINT (11247723 -74213989)
2017,Mayo,República Dominicana,16,37,,53,POINT (3451668 -76532004)
2017,Mayo,República Dominicana,746,948,,1694,POINT (4697157 -74140516)
2017,Mayo,República Dominicana,3,11,,14,POINT (4815189 -75736374)
2017,Mayo,República Dominicana,35,109,,144,POINT (6170465 -7542726)
2017,Mayo,República Dominicana,3,8,,11,POINT (7128047 -73181317)
2017,Mayo,Reunión,1,0,,1,POINT (4697157 -74140516)
2017,Mayo,República Democrática Popular de Corea,0,1,,1,POINT (4815189 -75736374)
2017,Mayo,Rumania,1,5,,6,POINT (4697157 -74140516)
2017,Mayo,Rumania,5,2,,7,POINT (6170465 -7542726)
2017,Mayo,Rwanda,0,4,,4,POINT (3451668 -76532004)
2017,Mayo,San Cristóbal y Nevis,1,2,,3,POINT (4697157 -74140516)
2017,Mayo,San  Vicente y las Granadinas,0,2,,2,POINT (6170465 -7542726)
2017,Mayo,Santa Lucia,1,1,,2,POINT (6170465 -7542726)
2017,Mayo,Serbia,0,1,,1,POINT (4697157 -74140516)
2017,Mayo,Singapur,0,4,,4,POINT (11247723 -74213989)
2017,Mayo,Singapur,0,1,,1,POINT (3451668 -76532004)
2017,Mayo,Singapur,2,3,,5,POINT (4697157 -74140516)
2017,Mayo,Singapur,1,0,,1,POINT (4815189 -75736374)
2017,Mayo,Singapur,0,1,,1,POINT (6170465 -7542726)
2017,Mayo,Sudáfrica,3,4,,7,POINT (4697157 -74140516)
2017,Mayo,Sudáfrica,1,2,,3,POINT (6170465 -7542726)
2017,Mayo,Sudán,0,1,,1,POINT (4697157 -74140516)
2017,Mayo,Suecia,0,2,,2,POINT (3451668 -76532004)
2017,Mayo,Suecia,11,28,,39,POINT (4697157 -74140516)
2017,Mayo,Suecia,4,4,,8,POINT (6170465 -7542726)
2017,Mayo,Suiza,1,1,,2,POINT (10446304 -75516486)
2017,Mayo,Suiza,6,8,,14,POINT (3451668 -76532004)
2017,Mayo,Suiza,36,69,,105,POINT (4697157 -74140516)
2017,Mayo,Suiza,0,1,,1,POINT (4815189 -75736374)
2017,Mayo,Suiza,7,8,,15,POINT (6170465 -7542726)
2017,Mayo,Surinam,0,3,,3,POINT (10406342 -75527794)
2017,Mayo,Surinam,1,2,,3,POINT (4697157 -74140516)
2017,Mayo,Surinam,0,2,,2,POINT (6170465 -7542726)
2017,Mayo,Taiwán,0,1,,1,POINT (3451668 -76532004)
2017,Mayo,Taiwán,3,4,,7,POINT (4697157 -74140516)
2017,Mayo,Taiwán,2,2,,4,POINT (6170465 -7542726)
2017,Mayo,Tailandia,1,1,,2,POINT (4697157 -74140516)
2017,Mayo,Tailandia,0,3,,3,POINT (6170465 -7542726)
2017,Mayo,Tanzania,0,1,,1,POINT (4697157 -74140516)
2017,Mayo,Trinidad y Tobago,0,2,,2,POINT (10406342 -75527794)
2017,Mayo,Trinidad y Tobago,0,1,,1,POINT (10446304 -75516486)
2017,Mayo,Trinidad y Tobago,1,11,,12,POINT (10886686 -74776479)
2017,Mayo,Trinidad y Tobago,2,2,,4,POINT (3451668 -76532004)
2017,Mayo,Trinidad y Tobago,3,6,,9,POINT (4697157 -74140516)
2017,Mayo,Trinidad y Tobago,0,1,,1,POINT (4815189 -75736374)
2017,Mayo,Trinidad y Tobago,3,5,,8,POINT (6170465 -7542726)
2017,Mayo,Trinidad y Tobago,0,2,,2,POINT (7128047 -73181317)
2017,Mayo,Túnez,1,2,,3,POINT (4697157 -74140516)
2017,Mayo,Turkmenistán,4,7,,11,POINT (4697157 -74140516)
2017,Mayo,Turquía,0,1,,1,POINT (10406342 -75527794)
2017,Mayo,Turquía,0,1,,1,POINT (10886686 -74776479)
2017,Mayo,Turquía,0,1,,1,POINT (3451668 -76532004)
2017,Mayo,Turquía,191,327,,518,POINT (4697157 -74140516)
2017,Mayo,Turquía,0,4,,4,POINT (6170465 -7542726)
2017,Mayo,Ucrania,0,3,,3,POINT (3451668 -76532004)
2017,Mayo,Ucrania,2,3,,5,POINT (4697157 -74140516)
2017,Mayo,Ucrania,0,1,,1,POINT (6170465 -7542726)
2017,Mayo,Uganda,4,4,,8,POINT (3451668 -76532004)
2017,Mayo,Uruguay,5,7,,12,POINT (10446304 -75516486)
2017,Mayo,Uruguay,46,43,,89,POINT (125862 -81702165)
2017,Mayo,Uruguay,5,7,,12,POINT (3451668 -76532004)
2017,Mayo,Uruguay,227,272,,499,POINT (4697157 -74140516)
2017,Mayo,Uruguay,6,5,,11,POINT (4815189 -75736374)
2017,Mayo,Uruguay,13,33,,46,POINT (6170465 -7542726)
2017,Mayo,Venezuela,0,10,,10,POINT (10406342 -75527794)
2017,Mayo,Venezuela,0,3,,3,POINT (10433609 -73247863)
2017,Mayo,Venezuela,7,43,,50,POINT (10446304 -75516486)
2017,Mayo,Venezuela,21,58,,79,POINT (10886686 -74776479)
2017,Mayo,Venezuela,1,8,,9,POINT (11117206 -74232675)
2017,Mayo,Venezuela,5810,6768,,12578,POINT (11360029 -72129595)
2017,Mayo,Venezuela,1,0,,1,POINT (125862 -81702165)
2017,Mayo,Venezuela,14,15,,29,POINT (3451668 -76532004)
2017,Mayo,Venezuela,11,17,,28,POINT (3866713 -67927521)
2017,Mayo,Venezuela,3145,3565,,6710,POINT (4697157 -74140516)
2017,Mayo,Venezuela,3,5,,8,POINT (4815189 -75736374)
2017,Mayo,Venezuela,375,481,,856,POINT (6170465 -7542726)
2017,Mayo,Venezuela,15,23,,38,POINT (6185536 -67484028)
2017,Mayo,Venezuela,184,194,,378,POINT (7088729 -70740253)
2017,Mayo,Venezuela,2,1,,3,POINT (7128047 -73181317)
2017,Mayo,Venezuela,7773,10764,,18537,POINT (7819 -72453013)
2017,Mayo,Venezuela,1,2,,3,POINT (7927233 -72508188)
2017,Mayo,Venezuela,451,594,,1045,POINT (836068 -72409396)
2017,Mayo,Vietnam,0,1,,1,POINT (4697157 -74140516)
2017,Mayo,Zambia,2,3,,5,POINT (3451668 -76532004)
2017,Mayo,Zimbabue,1,2,,3,POINT (3451668 -76532004)
2017,Mayo,Anguila/Territorio Británico de Ultramar,0,1,,1,POINT (3451668 -76532004)
2017,Junio,Afganistán,0,1,,1,POINT (3451668 -76532004)
2017,Junio,Alemania,1,0,,1,POINT (0.81488 -77356)
2017,Junio,Alemania,0,3,,3,POINT (10406342 -75527794)
2017,Junio,Alemania,2,5,,7,POINT (10446304 -75516486)
2017,Junio,Alemania,3,8,,11,POINT (10886686 -74776479)
2017,Junio,Alemania,1,2,,3,POINT (125862 -81702165)
2017,Junio,Alemania,26,29,,55,POINT (3451668 -76532004)
2017,Junio,Alemania,1284,1948,,3232,POINT (4697157 -74140516)
2017,Junio,Alemania,0,1,,1,POINT (4815189 -75736374)
2017,Junio,Alemania,48,40,,88,POINT (6170465 -7542726)
2017,Junio,Andorra,0,2,,2,POINT (3451668 -76532004)
2017,Junio,Andorra,0,1,,1,POINT (4815189 -75736374)
2017,Junio,Angola,0,1,,1,POINT (4697157 -74140516)
2017,Junio,Antigua y Barbuda,0,5,,5,POINT (10406342 -75527794)
2017,Junio,Antigua y Barbuda,0,2,,2,POINT (4697157 -74140516)
2017,Junio,Países Bajos,2,6,,8,POINT (10406342 -75527794)
2017,Junio,Países Bajos,108,196,,304,POINT (10446304 -75516486)
2017,Junio,Países Bajos,7,5,,12,POINT (10886686 -74776479)
2017,Junio,Países Bajos,0,3,,3,POINT (10970933 -74765343)
2017,Junio,Países Bajos,3,3,,6,POINT (11247723 -74213989)
2017,Junio,Países Bajos,18,30,,48,POINT (3451668 -76532004)
2017,Junio,Países Bajos,763,1054,,1817,POINT (4697157 -74140516)
2017,Junio,Países Bajos,1,1,,2,POINT (4815189 -75736374)
2017,Junio,Países Bajos,67,112,,179,POINT (6170465 -7542726)
2017,Junio,Países Bajos,2,3,,5,POINT (7128047 -73181317)
2017,Junio,Arabia Saudita,1,2,,3,POINT (3451668 -76532004)
2017,Junio,Arabia Saudita,3,3,,6,POINT (4697157 -74140516)
2017,Junio,Argelia,0,2,,2,POINT (4697157 -74140516)
2017,Junio,Argentina,12,13,,25,POINT (0.81488 -77356)
2017,Junio,Argentina,60,37,,97,POINT (10446304 -75516486)
2017,Junio,Argentina,0,5,,5,POINT (10886686 -74776479)
2017,Junio,Argentina,172,146,,318,POINT (125862 -81702165)
2017,Junio,Argentina,14,16,,30,POINT (3451668 -76532004)
2017,Junio,Argentina,3418,4223,,7641,POINT (4697157 -74140516)
2017,Junio,Argentina,1,5,,6,POINT (4815189 -75736374)
2017,Junio,Argentina,36,88,,124,POINT (6170465 -7542726)
2017,Junio,Argentina,1,1,,2,POINT (7128047 -73181317)
2017,Junio,República de Armenia,0,1,,1,POINT (10446304 -75516486)
2017,Junio,Aruba,5,4,,9,POINT (10406342 -75527794)
2017,Junio,Aruba,0,1,,1,POINT (10886686 -74776479)
2017,Junio,Aruba,9,29,,38,POINT (11247723 -74213989)
2017,Junio,Aruba,5,5,,10,POINT (3451668 -76532004)
2017,Junio,Aruba,725,833,,1558,POINT (4697157 -74140516)
2017,Junio,Aruba,6,12,,18,POINT (6170465 -7542726)
2017,Junio,Aruba,14,12,,26,POINT (7128047 -73181317)
2017,Junio,Australia,2,2,,4,POINT (10446304 -75516486)
2017,Junio,Australia,1,0,,1,POINT (10886686 -74776479)
2017,Junio,Australia,6,8,,14,POINT (3451668 -76532004)
2017,Junio,Australia,45,84,,129,POINT (4697157 -74140516)
2017,Junio,Australia,0,1,,1,POINT (4815189 -75736374)
2017,Junio,Australia,14,14,,28,POINT (6170465 -7542726)
2017,Junio,Austria,1,1,,2,POINT (3451668 -76532004)
2017,Junio,Austria,23,29,,52,POINT (4697157 -74140516)
2017,Junio,Austria,1,2,,3,POINT (6170465 -7542726)
2017,Junio,Bahamas,0,1,,1,POINT (10446304 -75516486)
2017,Junio,Bahamas,0,1,,1,POINT (10886686 -74776479)
2017,Junio,Bahamas,2,1,,3,POINT (4697157 -74140516)
2017,Junio,Bahamas,0,1,,1,POINT (6170465 -7542726)
2017,Junio,Bahréin,1,1,,2,POINT (10446304 -75516486)
2017,Junio,Bahréin,0,2,,2,POINT (6170465 -7542726)
2017,Junio,Barbados,37,52,,89,POINT (4697157 -74140516)
2017,Junio,Barbados,0,1,,1,POINT (6170465 -7542726)
2017,Junio,República de Belarús,1,0,,1,POINT (4697157 -74140516)
2017,Junio,República de Belarús,2,1,,3,POINT (7819 -72453013)
2017,Junio,Bélgica,3,2,,5,POINT (10446304 -75516486)
2017,Junio,Bélgica,1,0,,1,POINT (10886686 -74776479)
2017,Junio,Bélgica,0,1,,1,POINT (11247723 -74213989)
2017,Junio,Bélgica,3,7,,10,POINT (3451668 -76532004)
2017,Junio,Bélgica,46,59,,105,POINT (4697157 -74140516)
2017,Junio,Bélgica,0,1,,1,POINT (4815189 -75736374)
2017,Junio,Bélgica,22,19,,41,POINT (6170465 -7542726)
2017,Junio,Belice,0,2,,2,POINT (3451668 -76532004)
2017,Junio,Belice,2,2,,4,POINT (4697157 -74140516)
2017,Junio,Belice,1,2,,3,POINT (6170465 -7542726)
2017,Junio,Bermudas/Territorio Británico de Ultramar,1,0,,1,POINT (4697157 -74140516)
2017,Junio,Bermudas/Territorio Británico de Ultramar,0,1,,1,POINT (6170465 -7542726)
2017,Junio,Bolivia,0,4,,4,POINT (0.81488 -77356)
2017,Junio,Bolivia,13,5,,18,POINT (10446304 -75516486)
2017,Junio,Bolivia,1,0,,1,POINT (10886686 -74776479)
2017,Junio,Bolivia,9,12,,21,POINT (125862 -81702165)
2017,Junio,Bolivia,13,10,,23,POINT (3451668 -76532004)
2017,Junio,Bolivia,463,513,,976,POINT (4697157 -74140516)
2017,Junio,Bolivia,1,1,,2,POINT (4815189 -75736374)
2017,Junio,Bolivia,14,20,,34,POINT (6170465 -7542726)
2017,Junio,Bosnia y Herzegovina,0,1,,1,POINT (4697157 -74140516)
2017,Junio,Brasil,170,214,,384,POINT (-4191162 -69941498)
2017,Junio,Brasil,32,39,,71,POINT (-4214082 -69941431)
2017,Junio,Brasil,1,1,,2,POINT (0.81488 -77356)
2017,Junio,Brasil,0,6,,6,POINT (10406342 -75527794)
2017,Junio,Brasil,51,44,,95,POINT (10446304 -75516486)
2017,Junio,Brasil,9,5,,14,POINT (10886686 -74776479)
2017,Junio,Brasil,371,278,,649,POINT (125862 -81702165)
2017,Junio,Brasil,27,36,,63,POINT (3451668 -76532004)
2017,Junio,Brasil,0,1,,1,POINT (3866713 -67927521)
2017,Junio,Brasil,4385,5644,,10029,POINT (4697157 -74140516)
2017,Junio,Brasil,5,4,,9,POINT (4815189 -75736374)
2017,Junio,Brasil,79,127,,206,POINT (6170465 -7542726)
2017,Junio,Brasil,2,2,,4,POINT (7128047 -73181317)
2017,Junio,Brunei Darussalam,1,0,,1,POINT (4697157 -74140516)
2017,Junio,Bulgaria,1,5,,6,POINT (4697157 -74140516)
2017,Junio,Bulgaria,0,1,,1,POINT (6170465 -7542726)
2017,Junio,Burundi,0,1,,1,POINT (4697157 -74140516)
2017,Junio,Islas Caimán/Territorio Británico de Ultramar,0,1,,1,POINT (125862 -81702165)
2017,Junio,Islas Caimán/Territorio Británico de Ultramar,1,4,,5,POINT (4697157 -74140516)
2017,Junio,Islas Caimán/Territorio Británico de Ultramar,0,1,,1,POINT (6170465 -7542726)
2017,Junio,Canadá,9,8,,17,POINT (10446304 -75516486)
2017,Junio,Canadá,7,10,,17,POINT (10886686 -74776479)
2017,Junio,Canadá,0,1,,1,POINT (125862 -81702165)
2017,Junio,Canadá,47,56,,103,POINT (3451668 -76532004)
2017,Junio,Canadá,0,11,,11,POINT (3884426 -77061029)
2017,Junio,Canadá,0,1,,1,POINT (445285 -75766353)
2017,Junio,Canadá,760,1035,,1795,POINT (4697157 -74140516)
2017,Junio,Canadá,5,2,,7,POINT (4815189 -75736374)
2017,Junio,Canadá,63,168,,231,POINT (6170465 -7542726)
2017,Junio,Canadá,2,2,,4,POINT (7128047 -73181317)
2017,Junio,España,1,4,,5,POINT (10446304 -75516486)
2017,Junio,España,1,9,,10,POINT (10886686 -74776479)
2017,Junio,España,1,4,,5,POINT (125862 -81702165)
2017,Junio,España,419,514,,933,POINT (3451668 -76532004)
2017,Junio,España,2817,4643,,7460,POINT (4697157 -74140516)
2017,Junio,España,9,9,,18,POINT (4815189 -75736374)
2017,Junio,España,497,800,,1297,POINT (6170465 -7542726)
2017,Junio,España,0,1,,1,POINT (7128047 -73181317)
2017,Junio,Comoras,0,1,,1,POINT (4697157 -74140516)
2017,Junio,República de Corea,0,1,,1,POINT (10886686 -74776479)
2017,Junio,República de Corea,18,18,,36,POINT (4697157 -74140516)
2017,Junio,República de Corea,10,9,,19,POINT (6170465 -7542726)
2017,Junio,Costa de Marfil,0,1,,1,POINT (3451668 -76532004)
2017,Junio,Costa de Marfil,5,7,,12,POINT (4697157 -74140516)
2017,Junio,Costa Rica,3,4,,7,POINT (10406342 -75527794)
2017,Junio,Costa Rica,10,10,,20,POINT (10446304 -75516486)
2017,Junio,Costa Rica,8,14,,22,POINT (10886686 -74776479)
2017,Junio,Costa Rica,0,1,,1,POINT (11247723 -74213989)
2017,Junio,Costa Rica,0,3,,3,POINT (125744111 -81703935)
2017,Junio,Costa Rica,41,39,,80,POINT (125862 -81702165)
2017,Junio,Costa Rica,26,44,,70,POINT (3451668 -76532004)
2017,Junio,Costa Rica,0,1,,1,POINT (3884426 -77061029)
2017,Junio,Costa Rica,1452,1877,,3329,POINT (4697157 -74140516)
2017,Junio,Costa Rica,0,5,,5,POINT (4815189 -75736374)
2017,Junio,Costa Rica,61,93,,154,POINT (6170465 -7542726)
2017,Junio,Costa Rica,0,8,,8,POINT (7128047 -73181317)
2017,Junio,Croacia,1,4,,5,POINT (4697157 -74140516)
2017,Junio,Croacia,0,1,,1,POINT (6170465 -7542726)
2017,Junio,Cuba,0,1,,1,POINT (10406342 -75527794)
2017,Junio,Cuba,2,2,,4,POINT (10446304 -75516486)
2017,Junio,Cuba,3,8,,11,POINT (10886686 -74776479)
2017,Junio,Cuba,1,1,,2,POINT (125862 -81702165)
2017,Junio,Cuba,1,1,,2,POINT (133387613 -81372937)
2017,Junio,Cuba,16,20,,36,POINT (3451668 -76532004)
2017,Junio,Cuba,357,579,,936,POINT (4697157 -74140516)
2017,Junio,Cuba,1,2,,3,POINT (4815189 -75736374)
2017,Junio,Cuba,17,19,,36,POINT (6170465 -7542726)
2017,Junio,Curazao,6,6,,12,POINT (4697157 -74140516)
2017,Junio,República Checa,0,1,,1,POINT (3451668 -76532004)
2017,Junio,República Checa,9,5,,14,POINT (4697157 -74140516)
2017,Junio,Chile,2,6,,8,POINT (0.81488 -77356)
2017,Junio,Chile,22,17,,39,POINT (10446304 -75516486)
2017,Junio,Chile,1,7,,8,POINT (10886686 -74776479)
2017,Junio,Chile,124,93,,217,POINT (125862 -81702165)
2017,Junio,Chile,31,52,,83,POINT (3451668 -76532004)
2017,Junio,Chile,4407,5749,,10156,POINT (4697157 -74140516)
2017,Junio,Chile,1,3,,4,POINT (4815189 -75736374)
2017,Junio,Chile,10,32,,42,POINT (6170465 -7542726)
2017,Junio,Chile,0,7,,7,POINT (7128047 -73181317)
2017,Junio,China,2,0,,2,POINT (10446304 -75516486)
2017,Junio,China,1,3,,4,POINT (10886686 -74776479)
2017,Junio,China,1,7,,8,POINT (3451668 -76532004)
2017,Junio,China,42,74,,116,POINT (4697157 -74140516)
2017,Junio,China,0,4,,4,POINT (6170465 -7542726)
2017,Junio,Dinamarca,1,1,,2,POINT (10886686 -74776479)
2017,Junio,Dinamarca,4,5,,9,POINT (3451668 -76532004)
2017,Junio,Dinamarca,20,20,,40,POINT (4697157 -74140516)
2017,Junio,Dinamarca,2,6,,8,POINT (6170465 -7542726)
2017,Junio,Dinamarca,0,1,,1,POINT (7128047 -73181317)
2017,Junio,Dominica,1,1,,2,POINT (4697157 -74140516)
2017,Junio,Ecuador,2,2,,4,POINT (0.185957 -7478366)
2017,Junio,Ecuador,127,409,,536,POINT (0.33002 -76876446)
2017,Junio,Ecuador,1,3,,4,POINT (0.812436 -77847006)
2017,Junio,Ecuador,3222,4954,,8176,POINT (0.81488 -77356)
2017,Junio,Ecuador,31,73,,104,POINT (1800143 -78802679)
2017,Junio,Ecuador,0,1,,1,POINT (10406342 -75527794)
2017,Junio,Ecuador,4,3,,7,POINT (10446304 -75516486)
2017,Junio,Ecuador,6,7,,13,POINT (10886686 -74776479)
2017,Junio,Ecuador,11,14,,25,POINT (125862 -81702165)
2017,Junio,Ecuador,255,317,,572,POINT (3451668 -76532004)
2017,Junio,Ecuador,0,1,,1,POINT (3884426 -77061029)
2017,Junio,Ecuador,2753,4343,,7096,POINT (4697157 -74140516)
2017,Junio,Ecuador,3,3,,6,POINT (4815189 -75736374)
2017,Junio,Ecuador,22,45,,67,POINT (6170465 -7542726)
2017,Junio,Ecuador,0,1,,1,POINT (7128047 -73181317)
2017,Junio,Egipto,2,3,,5,POINT (4697157 -74140516)
2017,Junio,El Salvador,1,0,,1,POINT (10446304 -75516486)
2017,Junio,El Salvador,1,2,,3,POINT (10886686 -74776479)
2017,Junio,El Salvador,4,7,,11,POINT (11117206 -74232675)
2017,Junio,El Salvador,2,2,,4,POINT (125862 -81702165)
2017,Junio,El Salvador,168,191,,359,POINT (3451668 -76532004)
2017,Junio,El Salvador,748,1104,,1852,POINT (4697157 -74140516)
2017,Junio,El Salvador,169,269,,438,POINT (6170465 -7542726)
2017,Junio,Emiratos Árabes,2,1,,3,POINT (3451668 -76532004)
2017,Junio,Emiratos Árabes,3,8,,11,POINT (4697157 -74140516)
2017,Junio,Emiratos Árabes,3,1,,4,POINT (6170465 -7542726)
2017,Junio,Eslovaquia,1,2,,3,POINT (4697157 -74140516)
2017,Junio,Eslovenia,0,1,,1,POINT (3451668 -76532004)
2017,Junio,Eslovenia,6,10,,16,POINT (4697157 -74140516)
2017,Junio,Eslovenia,1,0,,1,POINT (6170465 -7542726)
2017,Junio,Estados Unidos de América,2,27,,29,POINT (10406342 -75527794)
2017,Junio,Estados Unidos de América,3188,4299,,7487,POINT (10446304 -75516486)
2017,Junio,Estados Unidos de América,958,1417,,2375,POINT (10886686 -74776479)
2017,Junio,Estados Unidos de América,0,17,,17,POINT (10970933 -74765343)
2017,Junio,Estados Unidos de América,0,19,,19,POINT (11247723 -74213989)
2017,Junio,Estados Unidos de América,38,51,,89,POINT (125862 -81702165)
2017,Junio,Estados Unidos de América,2056,2516,,4572,POINT (3451668 -76532004)
2017,Junio,Estados Unidos de América,333,377,,710,POINT (445285 -75766353)
2017,Junio,Estados Unidos de América,12285,18211,,30496,POINT (4697157 -74140516)
2017,Junio,Estados Unidos de América,314,365,,679,POINT (4815189 -75736374)
2017,Junio,Estados Unidos de América,3719,6438,,10157,POINT (6170465 -7542726)
2017,Junio,Estados Unidos de América,44,84,,128,POINT (7128047 -73181317)
2017,Junio,Estados Unidos de América,0,23,,23,POINT (9402597 -75681642)
2017,Junio,Estonia,3,2,,5,POINT (4697157 -74140516)
2017,Junio,Filipinas,0,4,,4,POINT (10446304 -75516486)
2017,Junio,Filipinas,0,4,,4,POINT (10886686 -74776479)
2017,Junio,Filipinas,0,16,,16,POINT (3451668 -76532004)
2017,Junio,Filipinas,6,6,,12,POINT (4697157 -74140516)
2017,Junio,Finlandia,2,4,,6,POINT (4697157 -74140516)
2017,Junio,Finlandia,3,4,,7,POINT (6170465 -7542726)
2017,Junio,Francia,1,4,,5,POINT (10446304 -75516486)
2017,Junio,Francia,1,2,,3,POINT (10886686 -74776479)
2017,Junio,Francia,1,0,,1,POINT (125862 -81702165)
2017,Junio,Francia,28,45,,73,POINT (3451668 -76532004)
2017,Junio,Francia,1166,1974,,3140,POINT (4697157 -74140516)
2017,Junio,Francia,2,7,,9,POINT (4815189 -75736374)
2017,Junio,Francia,28,44,,72,POINT (6170465 -7542726)
2017,Junio,Georgia,0,2,,2,POINT (3451668 -76532004)
2017,Junio,Georgia,0,1,,1,POINT (4697157 -74140516)
2017,Junio,Ghana,0,2,,2,POINT (4697157 -74140516)
2017,Junio,Gibraltar/Territorio Británico de Ultramar,1,1,,2,POINT (0.81488 -77356)
2017,Junio,Granada,3,4,,7,POINT (10406342 -75527794)
2017,Junio,Grecia,3,6,,9,POINT (4697157 -74140516)
2017,Junio,Grecia,1,1,,2,POINT (6170465 -7542726)
2017,Junio,Grecia,0,1,,1,POINT (7128047 -73181317)
2017,Junio,Guatemala,14,12,,26,POINT (10446304 -75516486)
2017,Junio,Guatemala,7,8,,15,POINT (10886686 -74776479)
2017,Junio,Guatemala,3,2,,5,POINT (125862 -81702165)
2017,Junio,Guatemala,23,41,,64,POINT (3451668 -76532004)
2017,Junio,Guatemala,347,565,,912,POINT (4697157 -74140516)
2017,Junio,Guatemala,2,4,,6,POINT (4815189 -75736374)
2017,Junio,Guatemala,40,71,,111,POINT (6170465 -7542726)
2017,Junio,Guatemala,0,2,,2,POINT (7128047 -73181317)
2017,Junio,Guyana,1,0,,1,POINT (3451668 -76532004)
2017,Junio,Guyana,2,0,,2,POINT (4697157 -74140516)
2017,Junio,Guyana,0,1,,1,POINT (6170465 -7542726)
2017,Junio,Guyana,0,1,,1,POINT (806667 -767333)
2017,Junio,Guinea,0,1,,1,POINT (10406342 -75527794)
2017,Junio,Guinea,0,1,,1,POINT (4697157 -74140516)
2017,Junio,Guadalupe/Territorio Francés,0,2,,2,POINT (10970933 -74765343)
2017,Junio,Guadalupe/Territorio Francés,1,3,,4,POINT (4697157 -74140516)
2017,Junio,Guadalupe/Territorio Francés,1,0,,1,POINT (6170465 -7542726)
2017,Junio,Guam/Territorio no incorporado de Estados Unidos,1,0,,1,POINT (4697157 -74140516)
2017,Junio,Guayana Francesa/Departamento de Ultramar Francés,0,2,,2,POINT (10406342 -75527794)
2017,Junio,Guayana Francesa/Departamento de Ultramar Francés,1,2,,3,POINT (4697157 -74140516)
2017,Junio,Guayana Francesa/Departamento de Ultramar Francés,1,0,,1,POINT (6170465 -7542726)
2017,Junio,Haití,0,4,,4,POINT (10970933 -74765343)
2017,Junio,Haití,3,3,,6,POINT (4697157 -74140516)
2017,Junio,Haití,3,2,,5,POINT (6170465 -7542726)
2017,Junio,Honduras,0,2,,2,POINT (10446304 -75516486)
2017,Junio,Honduras,3,5,,8,POINT (10886686 -74776479)
2017,Junio,Honduras,1,3,,4,POINT (125744111 -81703935)
2017,Junio,Honduras,1,5,,6,POINT (125862 -81702165)
2017,Junio,Honduras,11,20,,31,POINT (3451668 -76532004)
2017,Junio,Honduras,42,65,,107,POINT (4697157 -74140516)
2017,Junio,Honduras,0,2,,2,POINT (4815189 -75736374)
2017,Junio,Honduras,23,38,,61,POINT (6170465 -7542726)
2017,Junio,Honduras,1,2,,3,POINT (7128047 -73181317)
2017,Junio,Hong Kong,0,1,,1,POINT (3451668 -76532004)
2017,Junio,Hong Kong,4,0,,4,POINT (4697157 -74140516)
2017,Junio,Hong Kong,0,2,,2,POINT (6170465 -7542726)
2017,Junio,Hungría,1,0,,1,POINT (3451668 -76532004)
2017,Junio,Hungría,6,4,,10,POINT (4697157 -74140516)
2017,Junio,India,0,3,,3,POINT (10886686 -74776479)
2017,Junio,India,0,3,,3,POINT (3451668 -76532004)
2017,Junio,India,7,19,,26,POINT (4697157 -74140516)
2017,Junio,India,2,4,,6,POINT (6170465 -7542726)
2017,Junio,Indonesia,0,2,,2,POINT (4697157 -74140516)
2017,Junio,Iraq,0,1,,1,POINT (4697157 -74140516)
2017,Junio,Irán,0,2,,2,POINT (4697157 -74140516)
2017,Junio,Irán,0,1,,1,POINT (4815189 -75736374)
2017,Junio,República de Irlanda,16,19,,35,POINT (4697157 -74140516)
2017,Junio,República de Irlanda,3,5,,8,POINT (6170465 -7542726)
2017,Junio,Islandia,3,1,,4,POINT (6170465 -7542726)
2017,Junio,Israel,0,3,,3,POINT (3451668 -76532004)
2017,Junio,Israel,23,63,,86,POINT (4697157 -74140516)
2017,Junio,Israel,0,3,,3,POINT (6170465 -7542726)
2017,Junio,Italia,1,6,,7,POINT (10446304 -75516486)
2017,Junio,Italia,2,5,,7,POINT (10886686 -74776479)
2017,Junio,Italia,1,0,,1,POINT (125862 -81702165)
2017,Junio,Italia,15,25,,40,POINT (3451668 -76532004)
2017,Junio,Italia,104,221,,325,POINT (4697157 -74140516)
2017,Junio,Italia,17,55,,72,POINT (6170465 -7542726)
2017,Junio,Jamaica,0,3,,3,POINT (10406342 -75527794)
2017,Junio,Jamaica,1,2,,3,POINT (10446304 -75516486)
2017,Junio,Jamaica,0,1,,1,POINT (10886686 -74776479)
2017,Junio,Jamaica,0,30,,30,POINT (10970933 -74765343)
2017,Junio,Jamaica,1,2,,3,POINT (133387613 -81372937)
2017,Junio,Jamaica,3,9,,12,POINT (4697157 -74140516)
2017,Junio,Japón,0,3,,3,POINT (3451668 -76532004)
2017,Junio,Japón,8,18,,26,POINT (4697157 -74140516)
2017,Junio,Japón,2,1,,3,POINT (6170465 -7542726)
2017,Junio,Jordania,2,0,,2,POINT (4697157 -74140516)
2017,Junio,Kenia,1,1,,2,POINT (3451668 -76532004)
2017,Junio,Kenia,1,1,,2,POINT (4697157 -74140516)
2017,Junio,Kirguistán,0,1,,1,POINT (4697157 -74140516)
2017,Junio,Kuwait,0,2,,2,POINT (4697157 -74140516)
2017,Junio,Letonia,1,5,,6,POINT (4697157 -74140516)
2017,Junio,Lituania,0,1,,1,POINT (3451668 -76532004)
2017,Junio,Lituania,0,1,,1,POINT (4697157 -74140516)
2017,Junio,Líbano,3,8,,11,POINT (4697157 -74140516)
2017,Junio,Liechtenstein,1,0,,1,POINT (4697157 -74140516)
2017,Junio,Luxemburgo,0,3,,3,POINT (4697157 -74140516)
2017,Junio,Luxemburgo,1,0,,1,POINT (6170465 -7542726)
2017,Junio,Luxemburgo,1,0,,1,POINT (7128047 -73181317)
2017,Junio,Madagascar,2,0,,2,POINT (4697157 -74140516)
2017,Junio,Malasia,0,2,,2,POINT (4697157 -74140516)
2017,Junio,Malta,1,1,,2,POINT (4697157 -74140516)
2017,Junio,Malta,0,1,,1,POINT (6170465 -7542726)
2017,Junio,Marruecos,0,2,,2,POINT (10970933 -74765343)
2017,Junio,Marruecos,0,2,,2,POINT (4697157 -74140516)
2017,Junio,México,0,11,,11,POINT (10406342 -75527794)
2017,Junio,México,33,60,,93,POINT (10446304 -75516486)
2017,Junio,México,22,41,,63,POINT (10886686 -74776479)
2017,Junio,México,0,1,,1,POINT (11247723 -74213989)
2017,Junio,México,1,1,,2,POINT (125862 -81702165)
2017,Junio,México,130,257,,387,POINT (3451668 -76532004)
2017,Junio,México,5340,8380,,13720,POINT (4697157 -74140516)
2017,Junio,México,11,29,,40,POINT (4815189 -75736374)
2017,Junio,México,548,1157,,1705,POINT (6170465 -7542726)
2017,Junio,México,7,12,,19,POINT (7128047 -73181317)
2017,Junio,Mónaco,0,1,,1,POINT (4697157 -74140516)
2017,Junio,Nauru,0,1,,1,POINT (4697157 -74140516)
2017,Junio,Nicaragua,0,2,,2,POINT (10446304 -75516486)
2017,Junio,Nicaragua,0,4,,4,POINT (125744111 -81703935)
2017,Junio,Nicaragua,3,13,,16,POINT (3451668 -76532004)
2017,Junio,Nicaragua,41,40,,81,POINT (4697157 -74140516)
2017,Junio,Nicaragua,3,0,,3,POINT (4815189 -75736374)
2017,Junio,Nicaragua,6,12,,18,POINT (6170465 -7542726)
2017,Junio,Nicaragua,1,2,,3,POINT (7128047 -73181317)
2017,Junio,Nigeria,0,23,,23,POINT (11247723 -74213989)
2017,Junio,Nigeria,1,3,,4,POINT (4697157 -74140516)
2017,Junio,Noruega,9,2,,11,POINT (3451668 -76532004)
2017,Junio,Noruega,38,56,,94,POINT (4697157 -74140516)
2017,Junio,Noruega,0,2,,2,POINT (4815189 -75736374)
2017,Junio,Noruega,2,5,,7,POINT (6170465 -7542726)
2017,Junio,Noruega,2,1,,3,POINT (7128047 -73181317)
2017,Junio,Nueva Zelanda,1,0,,1,POINT (3451668 -76532004)
2017,Junio,Nueva Zelanda,8,10,,18,POINT (4697157 -74140516)
2017,Junio,Nueva Zelanda,4,0,,4,POINT (6170465 -7542726)
2017,Junio,Omán,2,0,,2,POINT (4697157 -74140516)
2017,Junio,Omán,1,0,,1,POINT (6170465 -7542726)
2017,Junio,Papúa Nueva Guinea,1,0,,1,POINT (4697157 -74140516)
2017,Junio,Panamá,0,1,,1,POINT (1800143 -78802679)
2017,Junio,Panamá,951,919,,1870,POINT (10406342 -75527794)
2017,Junio,Panamá,3470,3687,,7157,POINT (10446304 -75516486)
2017,Junio,Panamá,358,645,,1003,POINT (10886686 -74776479)
2017,Junio,Panamá,0,30,,30,POINT (10970933 -74765343)
2017,Junio,Panamá,0,3,,3,POINT (11247723 -74213989)
2017,Junio,Panamá,5,8,,13,POINT (125744111 -81703935)
2017,Junio,Panamá,164,147,,311,POINT (125862 -81702165)
2017,Junio,Panamá,2,1,,3,POINT (133387613 -81372937)
2017,Junio,Panamá,368,529,,897,POINT (3451668 -76532004)
2017,Junio,Panamá,0,27,,27,POINT (3884426 -77061029)
2017,Junio,Panamá,58,53,,111,POINT (445285 -75766353)
2017,Junio,Panamá,3968,5690,,9658,POINT (4697157 -74140516)
2017,Junio,Panamá,25,65,,90,POINT (4815189 -75736374)
2017,Junio,Panamá,1879,2431,,4310,POINT (6170465 -7542726)
2017,Junio,Panamá,0,1,,1,POINT (7102626 -77762647)
2017,Junio,Panamá,21,31,,52,POINT (7128047 -73181317)
2017,Junio,Panamá,0,1,,1,POINT (806667 -767333)
2017,Junio,Panamá,91,114,,205,POINT (863337 -7735002)
2017,Junio,Paraguay,1,0,,1,POINT (0.81488 -77356)
2017,Junio,Paraguay,0,2,,2,POINT (10446304 -75516486)
2017,Junio,Paraguay,3,4,,7,POINT (10886686 -74776479)
2017,Junio,Paraguay,69,35,,104,POINT (125862 -81702165)
2017,Junio,Paraguay,3,8,,11,POINT (3451668 -76532004)
2017,Junio,Paraguay,85,116,,201,POINT (4697157 -74140516)
2017,Junio,Paraguay,1,2,,3,POINT (4815189 -75736374)
2017,Junio,Paraguay,13,12,,25,POINT (6170465 -7542726)
2017,Junio,Paraguay,0,1,,1,POINT (7128047 -73181317)
2017,Junio,Perú,24,54,,78,POINT (-4191162 -69941498)
2017,Junio,Perú,170,206,,376,POINT (-4214082 -69941431)
2017,Junio,Perú,24,50,,74,POINT (0.185957 -7478366)
2017,Junio,Perú,5,22,,27,POINT (0.81488 -77356)
2017,Junio,Perú,0,5,,5,POINT (10406342 -75527794)
2017,Junio,Perú,1022,806,,1828,POINT (10446304 -75516486)
2017,Junio,Perú,9,3,,12,POINT (10886686 -74776479)
2017,Junio,Perú,293,140,,433,POINT (125862 -81702165)
2017,Junio,Perú,222,286,,508,POINT (3451668 -76532004)
2017,Junio,Perú,0,2,,2,POINT (3884426 -77061029)
2017,Junio,Perú,5437,7540,,12977,POINT (4697157 -74140516)
2017,Junio,Perú,8,6,,14,POINT (4815189 -75736374)
2017,Junio,Perú,289,466,,755,POINT (6170465 -7542726)
2017,Junio,Perú,0,1,,1,POINT (7128047 -73181317)
2017,Junio,Polonia,1,0,,1,POINT (3451668 -76532004)
2017,Junio,Polonia,6,16,,22,POINT (4697157 -74140516)
2017,Junio,Polonia,1,4,,5,POINT (6170465 -7542726)
2017,Junio,Portugal,0,1,,1,POINT (3451668 -76532004)
2017,Junio,Portugal,28,44,,72,POINT (4697157 -74140516)
2017,Junio,Portugal,7,10,,17,POINT (6170465 -7542726)
2017,Junio,Polinesia Francesa/Colectividad de Ultramar Francesa,0,1,,1,POINT (3451668 -76532004)
2017,Junio,Polinesia Francesa/Colectividad de Ultramar Francesa,0,2,,2,POINT (4697157 -74140516)
2017,Junio,Puerto Rico/Territorio de Estados Unidos,1,1,,2,POINT (10446304 -75516486)
2017,Junio,Puerto Rico/Territorio de Estados Unidos,3,17,,20,POINT (10886686 -74776479)
2017,Junio,Puerto Rico/Territorio de Estados Unidos,1,1,,2,POINT (125862 -81702165)
2017,Junio,Puerto Rico/Territorio de Estados Unidos,43,66,,109,POINT (3451668 -76532004)
2017,Junio,Puerto Rico/Territorio de Estados Unidos,604,676,,1280,POINT (4697157 -74140516)
2017,Junio,Puerto Rico/Territorio de Estados Unidos,2,8,,10,POINT (4815189 -75736374)
2017,Junio,Puerto Rico/Territorio de Estados Unidos,63,122,,185,POINT (6170465 -7542726)
2017,Junio,Puerto Rico/Territorio de Estados Unidos,1,1,,2,POINT (7128047 -73181317)
2017,Junio,Qatar,1,0,,1,POINT (3451668 -76532004)
2017,Junio,Qatar,1,1,,2,POINT (4697157 -74140516)
2017,Junio,Qatar,0,2,,2,POINT (6170465 -7542726)
2017,Junio,Reino Unido de Gran Bretaña e Irlanda del Norte,0,1,,1,POINT (10446304 -75516486)
2017,Junio,Reino Unido de Gran Bretaña e Irlanda del Norte,0,1,,1,POINT (10886686 -74776479)
2017,Junio,Reino Unido de Gran Bretaña e Irlanda del Norte,13,18,,31,POINT (3451668 -76532004)
2017,Junio,Reino Unido de Gran Bretaña e Irlanda del Norte,672,1067,,1739,POINT (4697157 -74140516)
2017,Junio,Reino Unido de Gran Bretaña e Irlanda del Norte,21,47,,68,POINT (6170465 -7542726)
2017,Junio,República CentroÁfricana,1,0,,1,POINT (10886686 -74776479)
2017,Junio,República CentroÁfricana,1,0,,1,POINT (3451668 -76532004)
2017,Junio,República CentroÁfricana,2,2,,4,POINT (4697157 -74140516)
2017,Junio,Federación de Rusia,0,2,,2,POINT (10406342 -75527794)
2017,Junio,Federación de Rusia,1,2,,3,POINT (10446304 -75516486)
2017,Junio,Federación de Rusia,17,35,,52,POINT (4697157 -74140516)
2017,Junio,Federación de Rusia,1,2,,3,POINT (6170465 -7542726)
2017,Junio,República Dominicana,0,10,,10,POINT (10406342 -75527794)
2017,Junio,República Dominicana,10,20,,30,POINT (10446304 -75516486)
2017,Junio,República Dominicana,16,28,,44,POINT (10886686 -74776479)
2017,Junio,República Dominicana,0,1,,1,POINT (125862 -81702165)
2017,Junio,República Dominicana,17,24,,41,POINT (3451668 -76532004)
2017,Junio,República Dominicana,758,1020,,1778,POINT (4697157 -74140516)
2017,Junio,República Dominicana,4,10,,14,POINT (4815189 -75736374)
2017,Junio,República Dominicana,35,61,,96,POINT (6170465 -7542726)
2017,Junio,República Dominicana,4,5,,9,POINT (7128047 -73181317)
2017,Junio,Reunión,0,1,,1,POINT (4697157 -74140516)
2017,Junio,República Democrática Popular de Corea,0,1,,1,POINT (4697157 -74140516)
2017,Junio,Rumania,0,1,,1,POINT (3451668 -76532004)
2017,Junio,Rumania,7,9,,16,POINT (4697157 -74140516)
2017,Junio,San  Vicente y las Granadinas,0,2,,2,POINT (10406342 -75527794)
2017,Junio,San  Vicente y las Granadinas,0,3,,3,POINT (4697157 -74140516)
2017,Junio,Santa Lucia,0,1,,1,POINT (4697157 -74140516)
2017,Junio,Santa Sede/Ciudad del Vaticano,1,0,,1,POINT (4697157 -74140516)
2017,Junio,Serbia,0,1,,1,POINT (4697157 -74140516)
2017,Junio,Sierra Leona,0,1,,1,POINT (10446304 -75516486)
2017,Junio,Singapur,7,8,,15,POINT (4697157 -74140516)
2017,Junio,Singapur,1,2,,3,POINT (6170465 -7542726)
2017,Junio,Sri Lanka,1,0,,1,POINT (11360029 -72129595)
2017,Junio,Sudáfrica,3,5,,8,POINT (4697157 -74140516)
2017,Junio,Suecia,0,1,,1,POINT (10446304 -75516486)
2017,Junio,Suecia,1,0,,1,POINT (10886686 -74776479)
2017,Junio,Suecia,6,8,,14,POINT (3451668 -76532004)
2017,Junio,Suecia,30,57,,87,POINT (4697157 -74140516)
2017,Junio,Suecia,1,0,,1,POINT (4815189 -75736374)
2017,Junio,Suecia,22,16,,38,POINT (6170465 -7542726)
2017,Junio,Suiza,1,1,,2,POINT (10446304 -75516486)
2017,Junio,Suiza,0,1,,1,POINT (10886686 -74776479)
2017,Junio,Suiza,17,24,,41,POINT (3451668 -76532004)
2017,Junio,Suiza,73,84,,157,POINT (4697157 -74140516)
2017,Junio,Suiza,0,1,,1,POINT (4815189 -75736374)
2017,Junio,Suiza,10,19,,29,POINT (6170465 -7542726)
2017,Junio,Taiwán,3,3,,6,POINT (3451668 -76532004)
2017,Junio,Taiwán,3,6,,9,POINT (4697157 -74140516)
2017,Junio,Taiwán,1,0,,1,POINT (6170465 -7542726)
2017,Junio,Tailandia,6,4,,10,POINT (4697157 -74140516)
2017,Junio,Tanzania,1,1,,2,POINT (4697157 -74140516)
2017,Junio,Trinidad y Tobago,1,3,,4,POINT (10446304 -75516486)
2017,Junio,Trinidad y Tobago,3,5,,8,POINT (3451668 -76532004)
2017,Junio,Trinidad y Tobago,5,15,,20,POINT (4697157 -74140516)
2017,Junio,Trinidad y Tobago,1,2,,3,POINT (4815189 -75736374)
2017,Junio,Trinidad y Tobago,2,3,,5,POINT (6170465 -7542726)
2017,Junio,Trinidad y Tobago,1,1,,2,POINT (7128047 -73181317)
2017,Junio,Túnez,1,3,,4,POINT (4697157 -74140516)
2017,Junio,Túnez,1,0,,1,POINT (6170465 -7542726)
2017,Junio,Turkmenistán,4,3,,7,POINT (4697157 -74140516)
2017,Junio,Turquía,0,3,,3,POINT (10406342 -75527794)
2017,Junio,Turquía,265,394,,659,POINT (4697157 -74140516)
2017,Junio,Turquía,0,1,,1,POINT (6170465 -7542726)
2017,Junio,Ucrania,0,1,,1,POINT (10886686 -74776479)
2017,Junio,Ucrania,0,1,,1,POINT (3451668 -76532004)
2017,Junio,Ucrania,1,0,,1,POINT (4697157 -74140516)
2017,Junio,Ucrania,0,1,,1,POINT (6170465 -7542726)
2017,Junio,Uganda,2,0,,2,POINT (4697157 -74140516)
2017,Junio,Uruguay,0,3,,3,POINT (0.81488 -77356)
2017,Junio,Uruguay,7,7,,14,POINT (10446304 -75516486)
2017,Junio,Uruguay,14,7,,21,POINT (125862 -81702165)
2017,Junio,Uruguay,6,11,,17,POINT (3451668 -76532004)
2017,Junio,Uruguay,508,562,,1070,POINT (4697157 -74140516)
2017,Junio,Uruguay,11,33,,44,POINT (6170465 -7542726)
2017,Junio,Venezuela,0,10,,10,POINT (10406342 -75527794)
2017,Junio,Venezuela,7,25,,32,POINT (10446304 -75516486)
2017,Junio,Venezuela,6,46,,52,POINT (10886686 -74776479)
2017,Junio,Venezuela,5009,5745,,10754,POINT (11360029 -72129595)
2017,Junio,Venezuela,1,0,,1,POINT (125862 -81702165)
2017,Junio,Venezuela,8,15,,23,POINT (3451668 -76532004)
2017,Junio,Venezuela,2,12,,14,POINT (3866713 -67927521)
2017,Junio,Venezuela,3191,3644,,6835,POINT (4697157 -74140516)
2017,Junio,Venezuela,4,6,,10,POINT (4815189 -75736374)
2017,Junio,Venezuela,431,503,,934,POINT (6170465 -7542726)
2017,Junio,Venezuela,14,15,,29,POINT (6185536 -67484028)
2017,Junio,Venezuela,143,181,,324,POINT (7088729 -70740253)
2017,Junio,Venezuela,4,6,,10,POINT (7128047 -73181317)
2017,Junio,Venezuela,9674,13026,,22700,POINT (7819 -72453013)
2017,Junio,Venezuela,245,316,,561,POINT (836068 -72409396)
2017,Junio,Vietnam,0,1,,1,POINT (3451668 -76532004)
2017,Junio,Vietnam,2,2,,4,POINT (4697157 -74140516)
2017,Junio,Islas Vírgenes Británicas/Territorio Británico de Ultramar,0,3,,3,POINT (11247723 -74213989)
2017,Julio,Afganistán,1,0,,1,POINT (10446304 -75516486)
2017,Julio,Afganistán,1,2,,3,POINT (4697157 -74140516)
2017,Julio,Albania,0,1,,1,POINT (4697157 -74140516)
2017,Julio,Alemania,3,0,,3,POINT (0.81488 -77356)
2017,Julio,Alemania,4,5,,9,POINT (10446304 -75516486)
2017,Julio,Alemania,17,9,,26,POINT (10886686 -74776479)
2017,Julio,Alemania,0,2,,2,POINT (11247723 -74213989)
2017,Julio,Alemania,56,56,,112,POINT (3451668 -76532004)
2017,Julio,Alemania,1812,2233,,4045,POINT (4697157 -74140516)
2017,Julio,Alemania,6,9,,15,POINT (4815189 -75736374)
2017,Julio,Alemania,85,93,,178,POINT (6170465 -7542726)
2017,Julio,Alemania,2,0,,2,POINT (7128047 -73181317)
2017,Julio,Andorra,1,0,,1,POINT (6170465 -7542726)
2017,Julio,Antigua y Barbuda,1,4,,5,POINT (10406342 -75527794)
2017,Julio,Antigua y Barbuda,0,1,,1,POINT (4697157 -74140516)
2017,Julio,Antigua y Barbuda,0,1,,1,POINT (6170465 -7542726)
2017,Julio,Países Bajos,0,5,,5,POINT (10406342 -75527794)
2017,Julio,Países Bajos,205,297,,502,POINT (10446304 -75516486)
2017,Julio,Países Bajos,5,6,,11,POINT (10886686 -74776479)
2017,Julio,Países Bajos,0,46,,46,POINT (10970933 -74765343)
2017,Julio,Países Bajos,5,13,,18,POINT (11247723 -74213989)
2017,Julio,Países Bajos,45,63,,108,POINT (3451668 -76532004)
2017,Julio,Países Bajos,1305,1589,,2894,POINT (4697157 -74140516)
2017,Julio,Países Bajos,8,7,,15,POINT (4815189 -75736374)
2017,Julio,Países Bajos,201,242,,443,POINT (6170465 -7542726)
2017,Julio,Países Bajos,4,0,,4,POINT (7128047 -73181317)
2017,Julio,Arabia Saudita,0,1,,1,POINT (11247723 -74213989)
2017,Julio,Arabia Saudita,0,3,,3,POINT (4697157 -74140516)
2017,Julio,Arabia Saudita,1,0,,1,POINT (6170465 -7542726)
2017,Julio,Argelia,1,0,,1,POINT (10446304 -75516486)
2017,Julio,Argelia,0,1,,1,POINT (3451668 -76532004)
2017,Julio,Argelia,3,2,,5,POINT (4697157 -74140516)
2017,Julio,Argentina,9,13,,22,POINT (0.81488 -77356)
2017,Julio,Argentina,96,70,,166,POINT (10446304 -75516486)
2017,Julio,Argentina,3,7,,10,POINT (10886686 -74776479)
2017,Julio,Argentina,170,136,,306,POINT (125862 -81702165)
2017,Julio,Argentina,30,30,,60,POINT (3451668 -76532004)
2017,Julio,Argentina,5201,5396,,10597,POINT (4697157 -74140516)
2017,Julio,Argentina,4,2,,6,POINT (4815189 -75736374)
2017,Julio,Argentina,22,62,,84,POINT (6170465 -7542726)
2017,Julio,Argentina,1,1,,2,POINT (7128047 -73181317)
2017,Julio,República de Armenia,1,0,,1,POINT (4697157 -74140516)
2017,Julio,Aruba,1,4,,5,POINT (10406342 -75527794)
2017,Julio,Aruba,3,1,,4,POINT (10886686 -74776479)
2017,Julio,Aruba,7,10,,17,POINT (11247723 -74213989)
2017,Julio,Aruba,1,1,,2,POINT (125862 -81702165)
2017,Julio,Aruba,1,8,,9,POINT (2947286 -7529321)
2017,Julio,Aruba,13,8,,21,POINT (3451668 -76532004)
2017,Julio,Aruba,1416,1436,,2852,POINT (4697157 -74140516)
2017,Julio,Aruba,2,2,,4,POINT (4815189 -75736374)
2017,Julio,Aruba,40,47,,87,POINT (6170465 -7542726)
2017,Julio,Aruba,11,14,,25,POINT (7128047 -73181317)
2017,Julio,Australia,1,7,,8,POINT (10446304 -75516486)
2017,Julio,Australia,1,2,,3,POINT (10886686 -74776479)
2017,Julio,Australia,1,4,,5,POINT (3451668 -76532004)
2017,Julio,Australia,48,84,,132,POINT (4697157 -74140516)
2017,Julio,Australia,18,24,,42,POINT (6170465 -7542726)
2017,Julio,Australia,0,1,,1,POINT (7128047 -73181317)
2017,Julio,Austria,1,0,,1,POINT (10446304 -75516486)
2017,Julio,Austria,2,1,,3,POINT (10886686 -74776479)
2017,Julio,Austria,1,4,,5,POINT (3451668 -76532004)
2017,Julio,Austria,52,50,,102,POINT (4697157 -74140516)
2017,Julio,Austria,0,1,,1,POINT (4815189 -75736374)
2017,Julio,Austria,7,10,,17,POINT (6170465 -7542726)
2017,Julio,Azerbaiyán,0,1,,1,POINT (4697157 -74140516)
2017,Julio,Bahamas,0,2,,2,POINT (3451668 -76532004)
2017,Julio,Bahamas,3,3,,6,POINT (4697157 -74140516)
2017,Julio,Bahamas,11,6,,17,POINT (6170465 -7542726)
2017,Julio,Bahamas,1,0,,1,POINT (7128047 -73181317)
2017,Julio,Bahréin,0,1,,1,POINT (10406342 -75527794)
2017,Julio,Bahréin,2,1,,3,POINT (4697157 -74140516)
2017,Julio,Barbados,102,140,,242,POINT (4697157 -74140516)
2017,Julio,República de Belarús,2,1,,3,POINT (4697157 -74140516)
2017,Julio,República de Belarús,2,0,,2,POINT (7819 -72453013)
2017,Julio,Bélgica,1,3,,4,POINT (10446304 -75516486)
2017,Julio,Bélgica,0,3,,3,POINT (11247723 -74213989)
2017,Julio,Bélgica,12,21,,33,POINT (3451668 -76532004)
2017,Julio,Bélgica,88,110,,198,POINT (4697157 -74140516)
2017,Julio,Bélgica,0,4,,4,POINT (4815189 -75736374)
2017,Julio,Bélgica,20,39,,59,POINT (6170465 -7542726)
2017,Julio,Bélgica,0,1,,1,POINT (7128047 -73181317)
2017,Julio,Belice,1,1,,2,POINT (10886686 -74776479)
2017,Julio,Belice,3,4,,7,POINT (4697157 -74140516)
2017,Julio,Belice,0,2,,2,POINT (6170465 -7542726)
2017,Julio,Benín,1,0,,1,POINT (125862 -81702165)
2017,Julio,Benín,0,1,,1,POINT (3451668 -76532004)
2017,Julio,Benín,0,2,,2,POINT (4697157 -74140516)
2017,Julio,Bermudas/Territorio Británico de Ultramar,0,1,,1,POINT (4697157 -74140516)
2017,Julio,Bolivia,0,1,,1,POINT (0.81488 -77356)
2017,Julio,Bolivia,10,4,,14,POINT (10446304 -75516486)
2017,Julio,Bolivia,0,3,,3,POINT (10886686 -74776479)
2017,Julio,Bolivia,18,18,,36,POINT (125862 -81702165)
2017,Julio,Bolivia,8,12,,20,POINT (3451668 -76532004)
2017,Julio,Bolivia,578,576,,1154,POINT (4697157 -74140516)
2017,Julio,Bolivia,2,0,,2,POINT (4815189 -75736374)
2017,Julio,Bolivia,15,29,,44,POINT (6170465 -7542726)
2017,Julio,Bosnia y Herzegovina,1,0,,1,POINT (10886686 -74776479)
2017,Julio,Bosnia y Herzegovina,0,1,,1,POINT (6170465 -7542726)
2017,Julio,Brasil,227,187,,414,POINT (-4191162 -69941498)
2017,Julio,Brasil,26,31,,57,POINT (-4214082 -69941431)
2017,Julio,Brasil,4,4,,8,POINT (0.81488 -77356)
2017,Julio,Brasil,0,5,,5,POINT (10406342 -75527794)
2017,Julio,Brasil,49,39,,88,POINT (10446304 -75516486)
2017,Julio,Brasil,6,14,,20,POINT (10886686 -74776479)
2017,Julio,Brasil,2,6,,8,POINT (11117206 -74232675)
2017,Julio,Brasil,3,123,,126,POINT (11247723 -74213989)
2017,Julio,Brasil,220,188,,408,POINT (125862 -81702165)
2017,Julio,Brasil,21,33,,54,POINT (3451668 -76532004)
2017,Julio,Brasil,1,2,,3,POINT (3866713 -67927521)
2017,Julio,Brasil,5661,6607,,12268,POINT (4697157 -74140516)
2017,Julio,Brasil,2,2,,4,POINT (4815189 -75736374)
2017,Julio,Brasil,66,194,,260,POINT (6170465 -7542726)
2017,Julio,Brasil,3,1,,4,POINT (7128047 -73181317)
2017,Julio,Brunei Darussalam,1,0,,1,POINT (4697157 -74140516)
2017,Julio,Bulgaria,1,1,,2,POINT (4697157 -74140516)
2017,Julio,Bulgaria,0,2,,2,POINT (6170465 -7542726)
2017,Julio,Cabo Verde,0,1,,1,POINT (3451668 -76532004)
2017,Julio,Islas Caimán/Territorio Británico de Ultramar,2,1,,3,POINT (3451668 -76532004)
2017,Julio,Islas Caimán/Territorio Británico de Ultramar,1,4,,5,POINT (4697157 -74140516)
2017,Julio,Islas Caimán/Territorio Británico de Ultramar,0,3,,3,POINT (6170465 -7542726)
2017,Julio,Camboya,0,1,,1,POINT (4697157 -74140516)
2017,Julio,Camerún,0,5,,5,POINT (4697157 -74140516)
2017,Julio,Canadá,14,19,,33,POINT (10446304 -75516486)
2017,Julio,Canadá,8,17,,25,POINT (10886686 -74776479)
2017,Julio,Canadá,1,0,,1,POINT (125862 -81702165)
2017,Julio,Canadá,57,41,,98,POINT (3451668 -76532004)
2017,Julio,Canadá,1,0,,1,POINT (445285 -75766353)
2017,Julio,Canadá,1002,1255,,2257,POINT (4697157 -74140516)
2017,Julio,Canadá,9,11,,20,POINT (4815189 -75736374)
2017,Julio,Canadá,103,198,,301,POINT (6170465 -7542726)
2017,Julio,Canadá,2,6,,8,POINT (7128047 -73181317)
2017,Julio,Chad,5,2,,7,POINT (4697157 -74140516)
2017,Julio,España,0,1,,1,POINT (10406342 -75527794)
2017,Julio,España,0,2,,2,POINT (10446304 -75516486)
2017,Julio,España,3,7,,10,POINT (10886686 -74776479)
2017,Julio,España,0,3,,3,POINT (10970933 -74765343)
2017,Julio,España,0,7,,7,POINT (11247723 -74213989)
2017,Julio,España,513,727,,1240,POINT (3451668 -76532004)
2017,Julio,España,3929,5510,,9439,POINT (4697157 -74140516)
2017,Julio,España,2,2,,4,POINT (4815189 -75736374)
2017,Julio,España,688,937,,1625,POINT (6170465 -7542726)
2017,Julio,España,4,1,,5,POINT (7128047 -73181317)
2017,Julio,República de Corea,8,21,,29,POINT (4697157 -74140516)
2017,Julio,República de Corea,4,7,,11,POINT (6170465 -7542726)
2017,Julio,Costa de Marfil,0,1,,1,POINT (3451668 -76532004)
2017,Julio,Costa de Marfil,10,2,,12,POINT (4697157 -74140516)
2017,Julio,Costa Rica,27,16,,43,POINT (10446304 -75516486)
2017,Julio,Costa Rica,3,7,,10,POINT (10886686 -74776479)
2017,Julio,Costa Rica,70,46,,116,POINT (125862 -81702165)
2017,Julio,Costa Rica,22,32,,54,POINT (3451668 -76532004)
2017,Julio,Costa Rica,1695,2039,,3734,POINT (4697157 -74140516)
2017,Julio,Costa Rica,7,3,,10,POINT (4815189 -75736374)
2017,Julio,Costa Rica,113,143,,256,POINT (6170465 -7542726)
2017,Julio,Costa Rica,1,2,,3,POINT (7128047 -73181317)
2017,Julio,Croacia,3,7,,10,POINT (4697157 -74140516)
2017,Julio,Cuba,0,3,,3,POINT (10446304 -75516486)
2017,Julio,Cuba,6,12,,18,POINT (10886686 -74776479)
2017,Julio,Cuba,14,10,,24,POINT (3451668 -76532004)
2017,Julio,Cuba,563,699,,1262,POINT (4697157 -74140516)
2017,Julio,Cuba,0,2,,2,POINT (4815189 -75736374)
2017,Julio,Cuba,16,18,,34,POINT (6170465 -7542726)
2017,Julio,Cuba,1,2,,3,POINT (7128047 -73181317)
2017,Julio,Curazao,4,1,,5,POINT (4697157 -74140516)
2017,Julio,República Checa,1,0,,1,POINT (10886686 -74776479)
2017,Julio,República Checa,0,1,,1,POINT (3451668 -76532004)
2017,Julio,República Checa,6,7,,13,POINT (4697157 -74140516)
2017,Julio,República Checa,2,0,,2,POINT (6170465 -7542726)
2017,Julio,Chile,3,4,,7,POINT (0.81488 -77356)
2017,Julio,Chile,0,5,,5,POINT (10406342 -75527794)
2017,Julio,Chile,17,12,,29,POINT (10446304 -75516486)
2017,Julio,Chile,6,2,,8,POINT (10886686 -74776479)
2017,Julio,Chile,201,148,,349,POINT (125862 -81702165)
2017,Julio,Chile,18,21,,39,POINT (3451668 -76532004)
2017,Julio,Chile,5785,6340,,12125,POINT (4697157 -74140516)
2017,Julio,Chile,2,4,,6,POINT (4815189 -75736374)
2017,Julio,Chile,18,37,,55,POINT (6170465 -7542726)
2017,Julio,Chile,0,1,,1,POINT (7128047 -73181317)
2017,Julio,China,1,0,,1,POINT (10446304 -75516486)
2017,Julio,China,1,2,,3,POINT (10886686 -74776479)
2017,Julio,China,2,2,,4,POINT (3451668 -76532004)
2017,Julio,China,32,69,,101,POINT (4697157 -74140516)
2017,Julio,China,0,1,,1,POINT (4815189 -75736374)
2017,Julio,China,1,11,,12,POINT (6170465 -7542726)
2017,Julio,China,1,0,,1,POINT (7128047 -73181317)
2017,Julio,Chipre,0,1,,1,POINT (3451668 -76532004)
2017,Julio,Chipre,1,2,,3,POINT (4697157 -74140516)
2017,Julio,Dinamarca,1,1,,2,POINT (10446304 -75516486)
2017,Julio,Dinamarca,0,2,,2,POINT (10886686 -74776479)
2017,Julio,Dinamarca,2,0,,2,POINT (125862 -81702165)
2017,Julio,Dinamarca,0,1,,1,POINT (3451668 -76532004)
2017,Julio,Dinamarca,21,21,,42,POINT (4697157 -74140516)
2017,Julio,Dinamarca,2,5,,7,POINT (4815189 -75736374)
2017,Julio,Dinamarca,4,8,,12,POINT (6170465 -7542726)
2017,Julio,Ecuador,0,2,,2,POINT (0.185957 -7478366)
2017,Julio,Ecuador,171,501,,672,POINT (0.33002 -76876446)
2017,Julio,Ecuador,4,2,,6,POINT (0.812436 -77847006)
2017,Julio,Ecuador,4752,6231,,10983,POINT (0.81488 -77356)
2017,Julio,Ecuador,32,108,,140,POINT (1800143 -78802679)
2017,Julio,Ecuador,0,1,,1,POINT (10406342 -75527794)
2017,Julio,Ecuador,168,79,,247,POINT (10446304 -75516486)
2017,Julio,Ecuador,1,2,,3,POINT (10886686 -74776479)
2017,Julio,Ecuador,0,5,,5,POINT (10970933 -74765343)
2017,Julio,Ecuador,19,21,,40,POINT (125862 -81702165)
2017,Julio,Ecuador,433,506,,939,POINT (3451668 -76532004)
2017,Julio,Ecuador,3850,5201,,9051,POINT (4697157 -74140516)
2017,Julio,Ecuador,17,26,,43,POINT (6170465 -7542726)
2017,Julio,Ecuador,1,2,,3,POINT (7128047 -73181317)
2017,Julio,Ecuador,0,2,,2,POINT (7819 -72453013)
2017,Julio,Egipto,1,0,,1,POINT (3451668 -76532004)
2017,Julio,Egipto,6,10,,16,POINT (4697157 -74140516)
2017,Julio,Egipto,0,1,,1,POINT (6170465 -7542726)
2017,Julio,El Salvador,2,2,,4,POINT (10446304 -75516486)
2017,Julio,El Salvador,1,2,,3,POINT (10886686 -74776479)
2017,Julio,El Salvador,5,4,,9,POINT (125862 -81702165)
2017,Julio,El Salvador,112,160,,272,POINT (3451668 -76532004)
2017,Julio,El Salvador,949,1287,,2236,POINT (4697157 -74140516)
2017,Julio,El Salvador,1,1,,2,POINT (4815189 -75736374)
2017,Julio,El Salvador,192,304,,496,POINT (6170465 -7542726)
2017,Julio,Emiratos Árabes,2,1,,3,POINT (3451668 -76532004)
2017,Julio,Emiratos Árabes,5,11,,16,POINT (4697157 -74140516)
2017,Julio,Emiratos Árabes,2,3,,5,POINT (6170465 -7542726)
2017,Julio,Eslovaquia,3,1,,4,POINT (3451668 -76532004)
2017,Julio,Eslovaquia,1,1,,2,POINT (4697157 -74140516)
2017,Julio,Eslovenia,0,1,,1,POINT (10886686 -74776479)
2017,Julio,Eslovenia,1,5,,6,POINT (4697157 -74140516)
2017,Julio,Eslovenia,0,1,,1,POINT (6170465 -7542726)
2017,Julio,Estados Unidos de América,0,24,,24,POINT (10406342 -75527794)
2017,Julio,Estados Unidos de América,3480,4446,,7926,POINT (10446304 -75516486)
2017,Julio,Estados Unidos de América,877,1274,,2151,POINT (10886686 -74776479)
2017,Julio,Estados Unidos de América,0,2,,2,POINT (10970933 -74765343)
2017,Julio,Estados Unidos de América,0,13,,13,POINT (11247723 -74213989)
2017,Julio,Estados Unidos de América,59,64,,123,POINT (125862 -81702165)
2017,Julio,Estados Unidos de América,1609,1983,,3592,POINT (3451668 -76532004)
2017,Julio,Estados Unidos de América,0,1,,1,POINT (3884426 -77061029)
2017,Julio,Estados Unidos de América,264,315,,579,POINT (445285 -75766353)
2017,Julio,Estados Unidos de América,12977,18986,,31963,POINT (4697157 -74140516)
2017,Julio,Estados Unidos de América,285,341,,626,POINT (4815189 -75736374)
2017,Julio,Estados Unidos de América,4011,6817,,10828,POINT (6170465 -7542726)
2017,Julio,Estados Unidos de América,59,74,,133,POINT (7128047 -73181317)
2017,Julio,Estados Unidos de América,0,12,,12,POINT (9402597 -75681642)
2017,Julio,Estonia,1,0,,1,POINT (10446304 -75516486)
2017,Julio,Estonia,0,1,,1,POINT (10886686 -74776479)
2017,Julio,Estonia,2,2,,4,POINT (4697157 -74140516)
2017,Julio,Estonia,1,0,,1,POINT (6170465 -7542726)
2017,Julio,Etiopia,0,1,,1,POINT (4697157 -74140516)
2017,Julio,Filipinas,0,1,,1,POINT (3451668 -76532004)
2017,Julio,Filipinas,4,8,,12,POINT (4697157 -74140516)
2017,Julio,Filipinas,1,0,,1,POINT (6170465 -7542726)
2017,Julio,Finlandia,0,1,,1,POINT (10886686 -74776479)
2017,Julio,Finlandia,1,0,,1,POINT (3451668 -76532004)
2017,Julio,Finlandia,6,5,,11,POINT (4697157 -74140516)
2017,Julio,Finlandia,1,6,,7,POINT (6170465 -7542726)
2017,Julio,Francia,0,1,,1,POINT (10406342 -75527794)
2017,Julio,Francia,11,3,,14,POINT (10446304 -75516486)
2017,Julio,Francia,5,8,,13,POINT (10886686 -74776479)
2017,Julio,Francia,75,106,,181,POINT (3451668 -76532004)
2017,Julio,Francia,1913,2642,,4555,POINT (4697157 -74140516)
2017,Julio,Francia,10,17,,27,POINT (4815189 -75736374)
2017,Julio,Francia,91,144,,235,POINT (6170465 -7542726)
2017,Julio,Francia,2,5,,7,POINT (7128047 -73181317)
2017,Julio,Georgia,0,1,,1,POINT (10886686 -74776479)
2017,Julio,Gibraltar/Territorio Británico de Ultramar,0,2,,2,POINT (0.81488 -77356)
2017,Julio,Grecia,0,1,,1,POINT (10886686 -74776479)
2017,Julio,Grecia,2,5,,7,POINT (4697157 -74140516)
2017,Julio,Grecia,0,1,,1,POINT (6170465 -7542726)
2017,Julio,Guatemala,3,1,,4,POINT (10446304 -75516486)
2017,Julio,Guatemala,4,12,,16,POINT (10886686 -74776479)
2017,Julio,Guatemala,1,1,,2,POINT (125862 -81702165)
2017,Julio,Guatemala,11,31,,42,POINT (3451668 -76532004)
2017,Julio,Guatemala,367,679,,1046,POINT (4697157 -74140516)
2017,Julio,Guatemala,5,9,,14,POINT (4815189 -75736374)
2017,Julio,Guatemala,61,113,,174,POINT (6170465 -7542726)
2017,Julio,Guatemala,3,2,,5,POINT (7128047 -73181317)
2017,Julio,Guyana,1,1,,2,POINT (4697157 -74140516)
2017,Julio,Guinea,1,0,,1,POINT (0.81488 -77356)
2017,Julio,Guinea Ecuatorial,0,1,,1,POINT (4697157 -74140516)
2017,Julio,Guadalupe/Territorio Francés,0,1,,1,POINT (10886686 -74776479)
2017,Julio,Guadalupe/Territorio Francés,1,0,,1,POINT (3451668 -76532004)
2017,Julio,Guam/Territorio no incorporado de Estados Unidos,1,0,,1,POINT (4697157 -74140516)
2017,Julio,Guayana Francesa/Departamento de Ultramar Francés,0,1,,1,POINT (4697157 -74140516)
2017,Julio,Guayana Francesa/Departamento de Ultramar Francés,0,1,,1,POINT (6170465 -7542726)
2017,Julio,Haití,0,3,,3,POINT (11247723 -74213989)
2017,Julio,Haití,8,25,,33,POINT (4697157 -74140516)
2017,Julio,Haití,1,0,,1,POINT (4815189 -75736374)
2017,Julio,Haití,3,4,,7,POINT (6170465 -7542726)
2017,Julio,Honduras,0,7,,7,POINT (10406342 -75527794)
2017,Julio,Honduras,3,2,,5,POINT (10446304 -75516486)
2017,Julio,Honduras,3,4,,7,POINT (10886686 -74776479)
2017,Julio,Honduras,0,1,,1,POINT (10970933 -74765343)
2017,Julio,Honduras,0,11,,11,POINT (125744111 -81703935)
2017,Julio,Honduras,1,0,,1,POINT (125862 -81702165)
2017,Julio,Honduras,1,1,,2,POINT (133387613 -81372937)
2017,Julio,Honduras,10,28,,38,POINT (3451668 -76532004)
2017,Julio,Honduras,63,90,,153,POINT (4697157 -74140516)
2017,Julio,Honduras,0,2,,2,POINT (4815189 -75736374)
2017,Julio,Honduras,38,84,,122,POINT (6170465 -7542726)
2017,Julio,Hong Kong,1,0,,1,POINT (3451668 -76532004)
2017,Julio,Hong Kong,1,2,,3,POINT (4697157 -74140516)
2017,Julio,Hungría,1,0,,1,POINT (10886686 -74776479)
2017,Julio,Hungría,1,0,,1,POINT (3451668 -76532004)
2017,Julio,Hungría,3,11,,14,POINT (4697157 -74140516)
2017,Julio,Hungría,0,1,,1,POINT (6170465 -7542726)
2017,Julio,India,0,5,,5,POINT (10446304 -75516486)
2017,Julio,India,0,1,,1,POINT (10886686 -74776479)
2017,Julio,India,0,1,,1,POINT (3451668 -76532004)
2017,Julio,India,0,1,,1,POINT (3884426 -77061029)
2017,Julio,India,11,30,,41,POINT (4697157 -74140516)
2017,Julio,India,0,6,,6,POINT (6170465 -7542726)
2017,Julio,Indonesia,1,7,,8,POINT (4697157 -74140516)
2017,Julio,Irán,3,1,,4,POINT (4697157 -74140516)
2017,Julio,Irán,1,1,,2,POINT (4815189 -75736374)
2017,Julio,República de Irlanda,0,1,,1,POINT (10446304 -75516486)
2017,Julio,República de Irlanda,1,2,,3,POINT (125862 -81702165)
2017,Julio,República de Irlanda,1,1,,2,POINT (3451668 -76532004)
2017,Julio,República de Irlanda,14,17,,31,POINT (4697157 -74140516)
2017,Julio,República de Irlanda,4,6,,10,POINT (6170465 -7542726)
2017,Julio,Islandia,3,3,,6,POINT (4697157 -74140516)
2017,Julio,Islandia,2,2,,4,POINT (6170465 -7542726)
2017,Julio,Israel,1,2,,3,POINT (3451668 -76532004)
2017,Julio,Israel,21,46,,67,POINT (4697157 -74140516)
2017,Julio,Israel,4,12,,16,POINT (6170465 -7542726)
2017,Julio,Italia,0,3,,3,POINT (10406342 -75527794)
2017,Julio,Italia,1,2,,3,POINT (10446304 -75516486)
2017,Julio,Italia,3,5,,8,POINT (10886686 -74776479)
2017,Julio,Italia,2,1,,3,POINT (125862 -81702165)
2017,Julio,Italia,14,32,,46,POINT (3451668 -76532004)
2017,Julio,Italia,138,236,,374,POINT (4697157 -74140516)
2017,Julio,Italia,2,1,,3,POINT (4815189 -75736374)
2017,Julio,Italia,27,55,,82,POINT (6170465 -7542726)
2017,Julio,Jamaica,0,2,,2,POINT (10406342 -75527794)
2017,Julio,Jamaica,1,8,,9,POINT (10446304 -75516486)
2017,Julio,Jamaica,1,1,,2,POINT (10886686 -74776479)
2017,Julio,Jamaica,0,1,,1,POINT (11247723 -74213989)
2017,Julio,Jamaica,0,1,,1,POINT (125862 -81702165)
2017,Julio,Jamaica,4,7,,11,POINT (133387613 -81372937)
2017,Julio,Jamaica,0,2,,2,POINT (3451668 -76532004)
2017,Julio,Jamaica,7,3,,10,POINT (4697157 -74140516)
2017,Julio,Jamaica,2,0,,2,POINT (6170465 -7542726)
2017,Julio,Jamaica,0,2,,2,POINT (6218835 -75586989)
2017,Julio,Japón,1,2,,3,POINT (10886686 -74776479)
2017,Julio,Japón,1,0,,1,POINT (3451668 -76532004)
2017,Julio,Japón,12,23,,35,POINT (4697157 -74140516)
2017,Julio,Japón,0,1,,1,POINT (4815189 -75736374)
2017,Julio,Japón,9,5,,14,POINT (6170465 -7542726)
2017,Julio,Kenia,3,3,,6,POINT (4697157 -74140516)
2017,Julio,Kenia,0,1,,1,POINT (6170465 -7542726)
2017,Julio,República de Kosovo,0,1,,1,POINT (4697157 -74140516)
2017,Julio,República Democrática Popular  Lao,1,0,,1,POINT (4697157 -74140516)
2017,Julio,Lesoto,0,1,,1,POINT (4697157 -74140516)
2017,Julio,Letonia,1,1,,2,POINT (4697157 -74140516)
2017,Julio,Lituania,2,1,,3,POINT (4697157 -74140516)
2017,Julio,Líbano,3,4,,7,POINT (4697157 -74140516)
2017,Julio,Liechtenstein,1,1,,2,POINT (4697157 -74140516)
2017,Julio,Luxemburgo,3,2,,5,POINT (4697157 -74140516)
2017,Julio,Macao,0,1,,1,POINT (4697157 -74140516)
2017,Julio,Madagascar,1,0,,1,POINT (4697157 -74140516)
2017,Julio,Malasia,0,5,,5,POINT (4697157 -74140516)
2017,Julio,Maldivas,0,1,,1,POINT (4697157 -74140516)
2017,Julio,Malta,2,1,,3,POINT (10886686 -74776479)
2017,Julio,Malta,2,3,,5,POINT (4697157 -74140516)
2017,Julio,Malta,0,1,,1,POINT (6170465 -7542726)
2017,Julio,Marruecos,1,2,,3,POINT (4697157 -74140516)
2017,Julio,Martinica/Departamento de Ultramar Francés,1,2,,3,POINT (11247723 -74213989)
2017,Julio,Martinica/Departamento de Ultramar Francés,0,1,,1,POINT (7128047 -73181317)
2017,Julio,México,0,14,,14,POINT (10406342 -75527794)
2017,Julio,México,24,37,,61,POINT (10446304 -75516486)
2017,Julio,México,30,46,,76,POINT (10886686 -74776479)
2017,Julio,México,0,3,,3,POINT (10970933 -74765343)
2017,Julio,México,0,2,,2,POINT (11117206 -74232675)
2017,Julio,México,2,5,,7,POINT (125862 -81702165)
2017,Julio,México,92,138,,230,POINT (3451668 -76532004)
2017,Julio,México,7387,10497,,17884,POINT (4697157 -74140516)
2017,Julio,México,17,12,,29,POINT (4815189 -75736374)
2017,Julio,México,741,1390,,2131,POINT (6170465 -7542726)
2017,Julio,México,20,19,,39,POINT (7128047 -73181317)
2017,Julio,Mongolia,1,0,,1,POINT (4697157 -74140516)
2017,Julio,Montenegro,1,0,,1,POINT (6170465 -7542726)
2017,Julio,Mozambique,1,1,,2,POINT (4697157 -74140516)
2017,Julio,Myanmar,2,0,,2,POINT (4697157 -74140516)
2017,Julio,Nicaragua,2,2,,4,POINT (10886686 -74776479)
2017,Julio,Nicaragua,15,35,,50,POINT (3451668 -76532004)
2017,Julio,Nicaragua,36,57,,93,POINT (4697157 -74140516)
2017,Julio,Nicaragua,1,0,,1,POINT (4815189 -75736374)
2017,Julio,Nicaragua,19,35,,54,POINT (6170465 -7542726)
2017,Julio,Nicaragua,2,1,,3,POINT (7128047 -73181317)
2017,Julio,Nigeria,0,1,,1,POINT (4697157 -74140516)
2017,Julio,Noruega,1,1,,2,POINT (10446304 -75516486)
2017,Julio,Noruega,2,2,,4,POINT (10886686 -74776479)
2017,Julio,Noruega,5,3,,8,POINT (3451668 -76532004)
2017,Julio,Noruega,43,33,,76,POINT (4697157 -74140516)
2017,Julio,Noruega,10,12,,22,POINT (6170465 -7542726)
2017,Julio,Nueva Zelanda,3,0,,3,POINT (10446304 -75516486)
2017,Julio,Nueva Zelanda,2,1,,3,POINT (3451668 -76532004)
2017,Julio,Nueva Zelanda,8,12,,20,POINT (4697157 -74140516)
2017,Julio,Nueva Zelanda,2,1,,3,POINT (6170465 -7542726)
2017,Julio,Pakistán,0,1,,1,POINT (4697157 -74140516)
2017,Julio,Panamá,1032,897,,1929,POINT (10406342 -75527794)
2017,Julio,Panamá,3682,3857,,7539,POINT (10446304 -75516486)
2017,Julio,Panamá,475,677,,1152,POINT (10886686 -74776479)
2017,Julio,Panamá,0,12,,12,POINT (10970933 -74765343)
2017,Julio,Panamá,0,6,,6,POINT (125744111 -81703935)
2017,Julio,Panamá,175,193,,368,POINT (125862 -81702165)
2017,Julio,Panamá,439,594,,1033,POINT (3451668 -76532004)
2017,Julio,Panamá,0,7,,7,POINT (3884426 -77061029)
2017,Julio,Panamá,0,1,,1,POINT (4253669 -74642361)
2017,Julio,Panamá,27,52,,79,POINT (445285 -75766353)
2017,Julio,Panamá,4449,6086,,10535,POINT (4697157 -74140516)
2017,Julio,Panamá,55,93,,148,POINT (4815189 -75736374)
2017,Julio,Panamá,1984,2709,,4693,POINT (6170465 -7542726)
2017,Julio,Panamá,2,1,,3,POINT (7102626 -77762647)
2017,Julio,Panamá,11,20,,31,POINT (7128047 -73181317)
2017,Julio,Panamá,1,1,,2,POINT (7927233 -72508188)
2017,Julio,Panamá,125,151,,276,POINT (863337 -7735002)
2017,Julio,Paraguay,7,1,,8,POINT (10446304 -75516486)
2017,Julio,Paraguay,2,5,,7,POINT (10886686 -74776479)
2017,Julio,Paraguay,49,35,,84,POINT (125862 -81702165)
2017,Julio,Paraguay,7,11,,18,POINT (3451668 -76532004)
2017,Julio,Paraguay,62,62,,124,POINT (4697157 -74140516)
2017,Julio,Paraguay,1,0,,1,POINT (4815189 -75736374)
2017,Julio,Paraguay,4,11,,15,POINT (6170465 -7542726)
2017,Julio,Paraguay,2,0,,2,POINT (7128047 -73181317)
2017,Julio,Perú,109,150,,259,POINT (-4191162 -69941498)
2017,Julio,Perú,158,204,,362,POINT (-4214082 -69941431)
2017,Julio,Perú,1,1,,2,POINT (0.185957 -7478366)
2017,Julio,Perú,7,21,,28,POINT (0.81488 -77356)
2017,Julio,Perú,1245,998,,2243,POINT (10446304 -75516486)
2017,Julio,Perú,3,2,,5,POINT (10886686 -74776479)
2017,Julio,Perú,280,158,,438,POINT (125862 -81702165)
2017,Julio,Perú,219,245,,464,POINT (3451668 -76532004)
2017,Julio,Perú,7919,9056,,16975,POINT (4697157 -74140516)
2017,Julio,Perú,2,5,,7,POINT (4815189 -75736374)
2017,Julio,Perú,211,285,,496,POINT (6170465 -7542726)
2017,Julio,Polonia,0,2,,2,POINT (10446304 -75516486)
2017,Julio,Polonia,0,1,,1,POINT (10886686 -74776479)
2017,Julio,Polonia,0,1,,1,POINT (11247723 -74213989)
2017,Julio,Polonia,1,0,,1,POINT (3451668 -76532004)
2017,Julio,Polonia,14,10,,24,POINT (4697157 -74140516)
2017,Julio,Polonia,1,5,,6,POINT (6170465 -7542726)
2017,Julio,Portugal,1,1,,2,POINT (10446304 -75516486)
2017,Julio,Portugal,5,13,,18,POINT (3451668 -76532004)
2017,Julio,Portugal,18,41,,59,POINT (4697157 -74140516)
2017,Julio,Portugal,0,1,,1,POINT (4815189 -75736374)
2017,Julio,Portugal,3,17,,20,POINT (6170465 -7542726)
2017,Julio,Puerto Rico/Territorio de Estados Unidos,0,13,,13,POINT (10406342 -75527794)
2017,Julio,Puerto Rico/Territorio de Estados Unidos,1,3,,4,POINT (10446304 -75516486)
2017,Julio,Puerto Rico/Territorio de Estados Unidos,5,16,,21,POINT (10886686 -74776479)
2017,Julio,Puerto Rico/Territorio de Estados Unidos,5,2,,7,POINT (125862 -81702165)
2017,Julio,Puerto Rico/Territorio de Estados Unidos,46,46,,92,POINT (3451668 -76532004)
2017,Julio,Puerto Rico/Territorio de Estados Unidos,771,791,,1562,POINT (4697157 -74140516)
2017,Julio,Puerto Rico/Territorio de Estados Unidos,7,8,,15,POINT (4815189 -75736374)
2017,Julio,Puerto Rico/Territorio de Estados Unidos,164,240,,404,POINT (6170465 -7542726)
2017,Julio,Puerto Rico/Territorio de Estados Unidos,2,2,,4,POINT (7128047 -73181317)
2017,Julio,Reino Unido de Gran Bretaña e Irlanda del Norte,5,6,,11,POINT (10446304 -75516486)
2017,Julio,Reino Unido de Gran Bretaña e Irlanda del Norte,2,2,,4,POINT (10886686 -74776479)
2017,Julio,Reino Unido de Gran Bretaña e Irlanda del Norte,35,41,,76,POINT (3451668 -76532004)
2017,Julio,Reino Unido de Gran Bretaña e Irlanda del Norte,864,1146,,2010,POINT (4697157 -74140516)
2017,Julio,Reino Unido de Gran Bretaña e Irlanda del Norte,1,0,,1,POINT (4815189 -75736374)
2017,Julio,Reino Unido de Gran Bretaña e Irlanda del Norte,39,56,,95,POINT (6170465 -7542726)
2017,Julio,Reino Unido de Gran Bretaña e Irlanda del Norte,2,1,,3,POINT (7128047 -73181317)
2017,Julio,República CentroÁfricana,3,2,,5,POINT (4697157 -74140516)
2017,Julio,Federación de Rusia,0,5,,5,POINT (10406342 -75527794)
2017,Julio,Federación de Rusia,1,0,,1,POINT (10886686 -74776479)
2017,Julio,Federación de Rusia,0,1,,1,POINT (11247723 -74213989)
2017,Julio,Federación de Rusia,0,2,,2,POINT (3451668 -76532004)
2017,Julio,Federación de Rusia,11,19,,30,POINT (4697157 -74140516)
2017,Julio,Federación de Rusia,2,1,,3,POINT (6170465 -7542726)
2017,Julio,República Dominicana,1,13,,14,POINT (10406342 -75527794)
2017,Julio,República Dominicana,2,6,,8,POINT (10446304 -75516486)
2017,Julio,República Dominicana,6,38,,44,POINT (10886686 -74776479)
2017,Julio,República Dominicana,1,3,,4,POINT (11117206 -74232675)
2017,Julio,República Dominicana,0,1,,1,POINT (125862 -81702165)
2017,Julio,República Dominicana,9,31,,40,POINT (3451668 -76532004)
2017,Julio,República Dominicana,868,1201,,2069,POINT (4697157 -74140516)
2017,Julio,República Dominicana,9,9,,18,POINT (4815189 -75736374)
2017,Julio,República Dominicana,41,54,,95,POINT (6170465 -7542726)
2017,Julio,República Dominicana,3,2,,5,POINT (7128047 -73181317)
2017,Julio,Reunión,1,0,,1,POINT (4697157 -74140516)
2017,Julio,República Democrática Popular de Corea,0,1,,1,POINT (4697157 -74140516)
2017,Julio,Rumania,0,2,,2,POINT (10446304 -75516486)
2017,Julio,Rumania,1,3,,4,POINT (3451668 -76532004)
2017,Julio,Rumania,4,1,,5,POINT (4697157 -74140516)
2017,Julio,Rumania,0,3,,3,POINT (6170465 -7542726)
2017,Julio,San Cristóbal y Nevis,0,1,,1,POINT (6170465 -7542726)
2017,Julio,San Marino,1,1,,2,POINT (4697157 -74140516)
2017,Julio,San  Vicente y las Granadinas,0,3,,3,POINT (4697157 -74140516)
2017,Julio,San  Vicente y las Granadinas,2,0,,2,POINT (6170465 -7542726)
2017,Julio,Santa Lucia,3,7,,10,POINT (10406342 -75527794)
2017,Julio,Santa Lucia,1,0,,1,POINT (6170465 -7542726)
2017,Julio,Serbia,1,0,,1,POINT (10886686 -74776479)
2017,Julio,Serbia,1,0,,1,POINT (4697157 -74140516)
2017,Julio,Serbia,1,1,,2,POINT (6170465 -7542726)
2017,Julio,Singapur,5,8,,13,POINT (4697157 -74140516)
2017,Julio,Singapur,1,0,,1,POINT (6170465 -7542726)
2017,Julio,República Árabe Siria,1,0,,1,POINT (4697157 -74140516)
2017,Julio,Sri Lanka,0,1,,1,POINT (4697157 -74140516)
2017,Julio,Sudáfrica,0,1,,1,POINT (10446304 -75516486)
2017,Julio,Sudáfrica,9,7,,16,POINT (4697157 -74140516)
2017,Julio,Sudáfrica,1,1,,2,POINT (6170465 -7542726)
2017,Julio,Suecia,1,1,,2,POINT (10446304 -75516486)
2017,Julio,Suecia,2,4,,6,POINT (10886686 -74776479)
2017,Julio,Suecia,5,7,,12,POINT (3451668 -76532004)
2017,Julio,Suecia,21,23,,44,POINT (4697157 -74140516)
2017,Julio,Suecia,2,3,,5,POINT (4815189 -75736374)
2017,Julio,Suecia,4,9,,13,POINT (6170465 -7542726)
2017,Julio,Suiza,1,0,,1,POINT (10446304 -75516486)
2017,Julio,Suiza,1,0,,1,POINT (10886686 -74776479)
2017,Julio,Suiza,1,1,,2,POINT (125862 -81702165)
2017,Julio,Suiza,29,31,,60,POINT (3451668 -76532004)
2017,Julio,Suiza,191,207,,398,POINT (4697157 -74140516)
2017,Julio,Suiza,8,4,,12,POINT (4815189 -75736374)
2017,Julio,Suiza,27,34,,61,POINT (6170465 -7542726)
2017,Julio,Surinam,1,1,,2,POINT (4697157 -74140516)
2017,Julio,Surinam,0,2,,2,POINT (6170465 -7542726)
2017,Julio,Taiwán,0,1,,1,POINT (3451668 -76532004)
2017,Julio,Taiwán,1,6,,7,POINT (4697157 -74140516)
2017,Julio,Taiwán,2,0,,2,POINT (6170465 -7542726)
2017,Julio,República de Tayikistán,1,0,,1,POINT (3451668 -76532004)
2017,Julio,Tailandia,3,1,,4,POINT (4697157 -74140516)
2017,Julio,Tailandia,2,0,,2,POINT (6170465 -7542726)
2017,Julio,Tanzania,0,1,,1,POINT (4697157 -74140516)
2017,Julio,Trinidad y Tobago,0,3,,3,POINT (10406342 -75527794)
2017,Julio,Trinidad y Tobago,2,1,,3,POINT (10446304 -75516486)
2017,Julio,Trinidad y Tobago,0,1,,1,POINT (10886686 -74776479)
2017,Julio,Trinidad y Tobago,0,1,,1,POINT (11247723 -74213989)
2017,Julio,Trinidad y Tobago,5,6,,11,POINT (3451668 -76532004)
2017,Julio,Trinidad y Tobago,7,8,,15,POINT (4697157 -74140516)
2017,Julio,Trinidad y Tobago,3,4,,7,POINT (4815189 -75736374)
2017,Julio,Trinidad y Tobago,7,2,,9,POINT (6170465 -7542726)
2017,Julio,Trinidad y Tobago,1,7,,8,POINT (7128047 -73181317)
2017,Julio,Túnez,0,1,,1,POINT (10886686 -74776479)
2017,Julio,Turkmenistán,1,7,,8,POINT (4697157 -74140516)
2017,Julio,Turquía,0,1,,1,POINT (10886686 -74776479)
2017,Julio,Turquía,0,5,,5,POINT (3451668 -76532004)
2017,Julio,Turquía,439,557,,996,POINT (4697157 -74140516)
2017,Julio,Ucrania,0,2,,2,POINT (3451668 -76532004)
2017,Julio,Ucrania,2,2,,4,POINT (4697157 -74140516)
2017,Julio,Ucrania,0,1,,1,POINT (6170465 -7542726)
2017,Julio,Uganda,0,2,,2,POINT (6170465 -7542726)
2017,Julio,Uruguay,6,6,,12,POINT (10446304 -75516486)
2017,Julio,Uruguay,1,1,,2,POINT (10886686 -74776479)
2017,Julio,Uruguay,36,33,,69,POINT (125862 -81702165)
2017,Julio,Uruguay,7,9,,16,POINT (3451668 -76532004)
2017,Julio,Uruguay,449,429,,878,POINT (4697157 -74140516)
2017,Julio,Uruguay,1,1,,2,POINT (4815189 -75736374)
2017,Julio,Uruguay,19,17,,36,POINT (6170465 -7542726)
2017,Julio,Venezuela,0,5,,5,POINT (10406342 -75527794)
2017,Julio,Venezuela,3,19,,22,POINT (10446304 -75516486)
2017,Julio,Venezuela,17,47,,64,POINT (10886686 -74776479)
2017,Julio,Venezuela,0,1,,1,POINT (10970933 -74765343)
2017,Julio,Venezuela,7076,7243,,14319,POINT (11360029 -72129595)
2017,Julio,Venezuela,1,1,,2,POINT (125862 -81702165)
2017,Julio,Venezuela,25,34,,59,POINT (3451668 -76532004)
2017,Julio,Venezuela,12,18,,30,POINT (3866713 -67927521)
2017,Julio,Venezuela,4785,4542,,9327,POINT (4697157 -74140516)
2017,Julio,Venezuela,3,3,,6,POINT (4815189 -75736374)
2017,Julio,Venezuela,713,715,,1428,POINT (6170465 -7542726)
2017,Julio,Venezuela,17,16,,33,POINT (6185536 -67484028)
2017,Julio,Venezuela,179,175,,354,POINT (7088729 -70740253)
2017,Julio,Venezuela,19406,22408,,41814,POINT (7819 -72453013)
2017,Julio,Venezuela,3,5,,8,POINT (7927233 -72508188)
2017,Julio,Venezuela,0,4,,4,POINT (806667 -767333)
2017,Julio,Venezuela,854,811,,1665,POINT (836068 -72409396)
2017,Julio,Vietnam,1,1,,2,POINT (4697157 -74140516)
2017,Julio,Islas Vírgenes Británicas/Territorio Británico de Ultramar,1,1,,2,POINT (6170465 -7542726)
2017,Julio,Zambia,0,1,,1,POINT (6170465 -7542726)
2017,Julio,Zimbabue,0,1,,1,POINT (10886686 -74776479)
2017,Julio,Islas Turcas y Caicos/Territorio Británico de Ultramar,2,3,,5,POINT (4697157 -74140516)
2017,Agosto,Afganistán,2,2,,4,POINT (4697157 -74140516)
2017,Agosto,Alemania,1,0,,1,POINT (0.81488 -77356)
2017,Agosto,Alemania,6,5,,11,POINT (10446304 -75516486)
2017,Agosto,Alemania,6,8,,14,POINT (10886686 -74776479)
2017,Agosto,Alemania,1,1,,2,POINT (125862 -81702165)
2017,Agosto,Alemania,33,23,,56,POINT (3451668 -76532004)
2017,Agosto,Alemania,0,2,,2,POINT (3884426 -77061029)
2017,Agosto,Alemania,1834,2432,,4266,POINT (4697157 -74140516)
2017,Agosto,Alemania,5,5,,10,POINT (4815189 -75736374)
2017,Agosto,Alemania,54,65,,119,POINT (6170465 -7542726)
2017,Agosto,Andorra,2,1,,3,POINT (6170465 -7542726)
2017,Agosto,Andorra,0,1,,1,POINT (9402597 -75681642)
2017,Agosto,Angola,0,11,,11,POINT (9402597 -75681642)
2017,Agosto,Antigua y Barbuda,1,3,,4,POINT (4697157 -74140516)
2017,Agosto,Países Bajos,0,16,,16,POINT (10406342 -75527794)
2017,Agosto,Países Bajos,151,299,,450,POINT (10446304 -75516486)
2017,Agosto,Países Bajos,11,5,,16,POINT (10886686 -74776479)
2017,Agosto,Países Bajos,0,12,,12,POINT (10970933 -74765343)
2017,Agosto,Países Bajos,22,33,,55,POINT (3451668 -76532004)
2017,Agosto,Países Bajos,1127,1477,,2604,POINT (4697157 -74140516)
2017,Agosto,Países Bajos,6,6,,12,POINT (4815189 -75736374)
2017,Agosto,Países Bajos,87,105,,192,POINT (6170465 -7542726)
2017,Agosto,Países Bajos,6,5,,11,POINT (7128047 -73181317)
2017,Agosto,Arabia Saudita,0,2,,2,POINT (4697157 -74140516)
2017,Agosto,Argelia,5,8,,13,POINT (4697157 -74140516)
2017,Agosto,Argentina,6,8,,14,POINT (0.81488 -77356)
2017,Agosto,Argentina,81,60,,141,POINT (10446304 -75516486)
2017,Agosto,Argentina,5,5,,10,POINT (10886686 -74776479)
2017,Agosto,Argentina,218,196,,414,POINT (125862 -81702165)
2017,Agosto,Argentina,33,32,,65,POINT (3451668 -76532004)
2017,Agosto,Argentina,3832,4628,,8460,POINT (4697157 -74140516)
2017,Agosto,Argentina,6,6,,12,POINT (4815189 -75736374)
2017,Agosto,Argentina,29,69,,98,POINT (6170465 -7542726)
2017,Agosto,Argentina,1,3,,4,POINT (7128047 -73181317)
2017,Agosto,República de Armenia,2,0,,2,POINT (4697157 -74140516)
2017,Agosto,Aruba,71,57,,128,POINT (10406342 -75527794)
2017,Agosto,Aruba,8,60,,68,POINT (11247723 -74213989)
2017,Agosto,Aruba,11,6,,17,POINT (3451668 -76532004)
2017,Agosto,Aruba,1022,1155,,2177,POINT (4697157 -74140516)
2017,Agosto,Aruba,1,3,,4,POINT (4815189 -75736374)
2017,Agosto,Aruba,4,7,,11,POINT (6170465 -7542726)
2017,Agosto,Aruba,19,13,,32,POINT (7128047 -73181317)
2017,Agosto,Australia,0,1,,1,POINT (10886686 -74776479)
2017,Agosto,Australia,2,1,,3,POINT (125862 -81702165)
2017,Agosto,Australia,3,4,,7,POINT (3451668 -76532004)
2017,Agosto,Australia,51,69,,120,POINT (4697157 -74140516)
2017,Agosto,Australia,2,1,,3,POINT (4815189 -75736374)
2017,Agosto,Australia,7,19,,26,POINT (6170465 -7542726)
2017,Agosto,Australia,0,1,,1,POINT (7128047 -73181317)
2017,Agosto,Austria,3,1,,4,POINT (3451668 -76532004)
2017,Agosto,Austria,29,29,,58,POINT (4697157 -74140516)
2017,Agosto,Austria,0,1,,1,POINT (4815189 -75736374)
2017,Agosto,Austria,5,9,,14,POINT (6170465 -7542726)
2017,Agosto,Bahamas,0,4,,4,POINT (10446304 -75516486)
2017,Agosto,Bahamas,3,1,,4,POINT (3451668 -76532004)
2017,Agosto,Bahamas,0,2,,2,POINT (4697157 -74140516)
2017,Agosto,Bahamas,0,1,,1,POINT (4815189 -75736374)
2017,Agosto,Bahamas,0,1,,1,POINT (7128047 -73181317)
2017,Agosto,Bahréin,1,0,,1,POINT (10446304 -75516486)
2017,Agosto,Bahréin,2,0,,2,POINT (11360029 -72129595)
2017,Agosto,Bahréin,0,1,,1,POINT (3451668 -76532004)
2017,Agosto,Bahréin,0,1,,1,POINT (4697157 -74140516)
2017,Agosto,Barbados,5,5,,10,POINT (4697157 -74140516)
2017,Agosto,República de Belarús,1,1,,2,POINT (11360029 -72129595)
2017,Agosto,República de Belarús,0,2,,2,POINT (4697157 -74140516)
2017,Agosto,República de Belarús,9,6,,15,POINT (7819 -72453013)
2017,Agosto,Bélgica,0,2,,2,POINT (11247723 -74213989)
2017,Agosto,Bélgica,1,0,,1,POINT (125862 -81702165)
2017,Agosto,Bélgica,8,8,,16,POINT (3451668 -76532004)
2017,Agosto,Bélgica,72,68,,140,POINT (4697157 -74140516)
2017,Agosto,Bélgica,2,1,,3,POINT (4815189 -75736374)
2017,Agosto,Bélgica,5,12,,17,POINT (6170465 -7542726)
2017,Agosto,Belice,0,1,,1,POINT (3451668 -76532004)
2017,Agosto,Belice,2,2,,4,POINT (4697157 -74140516)
2017,Agosto,Belice,0,2,,2,POINT (6170465 -7542726)
2017,Agosto,Bermudas/Territorio Británico de Ultramar,2,4,,6,POINT (3451668 -76532004)
2017,Agosto,Bolivia,0,1,,1,POINT (0.81488 -77356)
2017,Agosto,Bolivia,6,8,,14,POINT (10446304 -75516486)
2017,Agosto,Bolivia,0,1,,1,POINT (10886686 -74776479)
2017,Agosto,Bolivia,14,13,,27,POINT (125862 -81702165)
2017,Agosto,Bolivia,4,11,,15,POINT (3451668 -76532004)
2017,Agosto,Bolivia,550,633,,1183,POINT (4697157 -74140516)
2017,Agosto,Bolivia,14,29,,43,POINT (6170465 -7542726)
2017,Agosto,Brasil,211,235,,446,POINT (-4191162 -69941498)
2017,Agosto,Brasil,1,0,,1,POINT (-4214082 -69941431)
2017,Agosto,Brasil,2,0,,2,POINT (0.81488 -77356)
2017,Agosto,Brasil,0,3,,3,POINT (10406342 -75527794)
2017,Agosto,Brasil,68,42,,110,POINT (10446304 -75516486)
2017,Agosto,Brasil,1,7,,8,POINT (10886686 -74776479)
2017,Agosto,Brasil,0,5,,5,POINT (11247723 -74213989)
2017,Agosto,Brasil,389,332,,721,POINT (125862 -81702165)
2017,Agosto,Brasil,25,27,,52,POINT (3451668 -76532004)
2017,Agosto,Brasil,0,3,,3,POINT (3866713 -67927521)
2017,Agosto,Brasil,5401,6771,,12172,POINT (4697157 -74140516)
2017,Agosto,Brasil,3,2,,5,POINT (4815189 -75736374)
2017,Agosto,Brasil,61,98,,159,POINT (6170465 -7542726)
2017,Agosto,Brunei Darussalam,0,1,,1,POINT (4697157 -74140516)
2017,Agosto,Bulgaria,1,3,,4,POINT (4697157 -74140516)
2017,Agosto,Bulgaria,1,1,,2,POINT (6170465 -7542726)
2017,Agosto,Cabo Verde,0,1,,1,POINT (4697157 -74140516)
2017,Agosto,Islas Caimán/Territorio Británico de Ultramar,1,2,,3,POINT (125862 -81702165)
2017,Agosto,Camboya,0,1,,1,POINT (3451668 -76532004)
2017,Agosto,Camerún,0,1,,1,POINT (4697157 -74140516)
2017,Agosto,Canadá,14,25,,39,POINT (10446304 -75516486)
2017,Agosto,Canadá,11,12,,23,POINT (10886686 -74776479)
2017,Agosto,Canadá,2,4,,6,POINT (125862 -81702165)
2017,Agosto,Canadá,40,46,,86,POINT (3451668 -76532004)
2017,Agosto,Canadá,862,1211,,2073,POINT (4697157 -74140516)
2017,Agosto,Canadá,9,8,,17,POINT (4815189 -75736374)
2017,Agosto,Canadá,95,148,,243,POINT (6170465 -7542726)
2017,Agosto,Canadá,0,1,,1,POINT (7128047 -73181317)
2017,Agosto,España,1,4,,5,POINT (10446304 -75516486)
2017,Agosto,España,6,10,,16,POINT (10886686 -74776479)
2017,Agosto,España,4,7,,11,POINT (125862 -81702165)
2017,Agosto,España,548,672,,1220,POINT (3451668 -76532004)
2017,Agosto,España,4815,6378,,11193,POINT (4697157 -74140516)
2017,Agosto,España,7,10,,17,POINT (4815189 -75736374)
2017,Agosto,España,743,1092,,1835,POINT (6170465 -7542726)
2017,Agosto,España,0,1,,1,POINT (7128047 -73181317)
2017,Agosto,República de Corea,8,16,,24,POINT (4697157 -74140516)
2017,Agosto,República de Corea,0,3,,3,POINT (4815189 -75736374)
2017,Agosto,República de Corea,7,4,,11,POINT (6170465 -7542726)
2017,Agosto,Costa de Marfil,4,8,,12,POINT (4697157 -74140516)
2017,Agosto,Costa Rica,2,4,,6,POINT (10406342 -75527794)
2017,Agosto,Costa Rica,8,9,,17,POINT (10446304 -75516486)
2017,Agosto,Costa Rica,6,9,,15,POINT (10886686 -74776479)
2017,Agosto,Costa Rica,0,1,,1,POINT (11247723 -74213989)
2017,Agosto,Costa Rica,0,2,,2,POINT (125744111 -81703935)
2017,Agosto,Costa Rica,58,39,,97,POINT (125862 -81702165)
2017,Agosto,Costa Rica,2,1,,3,POINT (133387613 -81372937)
2017,Agosto,Costa Rica,14,33,,47,POINT (3451668 -76532004)
2017,Agosto,Costa Rica,1456,2073,,3529,POINT (4697157 -74140516)
2017,Agosto,Costa Rica,2,2,,4,POINT (4815189 -75736374)
2017,Agosto,Costa Rica,70,131,,201,POINT (6170465 -7542726)
2017,Agosto,Costa Rica,3,3,,6,POINT (7128047 -73181317)
2017,Agosto,Croacia,1,0,,1,POINT (3451668 -76532004)
2017,Agosto,Croacia,0,2,,2,POINT (4697157 -74140516)
2017,Agosto,Croacia,0,1,,1,POINT (6170465 -7542726)
2017,Agosto,Cuba,4,1,,5,POINT (10406342 -75527794)
2017,Agosto,Cuba,3,3,,6,POINT (10446304 -75516486)
2017,Agosto,Cuba,10,25,,35,POINT (10886686 -74776479)
2017,Agosto,Cuba,4,1,,5,POINT (125862 -81702165)
2017,Agosto,Cuba,13,21,,34,POINT (3451668 -76532004)
2017,Agosto,Cuba,469,761,,1230,POINT (4697157 -74140516)
2017,Agosto,Cuba,4,2,,6,POINT (4815189 -75736374)
2017,Agosto,Cuba,11,12,,23,POINT (6170465 -7542726)
2017,Agosto,Cuba,2,5,,7,POINT (7128047 -73181317)
2017,Agosto,Curazao,3,3,,6,POINT (4697157 -74140516)
2017,Agosto,República Checa,7,6,,13,POINT (4697157 -74140516)
2017,Agosto,Chile,1,1,,2,POINT (0.81488 -77356)
2017,Agosto,Chile,23,30,,53,POINT (10446304 -75516486)
2017,Agosto,Chile,1,3,,4,POINT (10886686 -74776479)
2017,Agosto,Chile,187,121,,308,POINT (125862 -81702165)
2017,Agosto,Chile,7,13,,20,POINT (3451668 -76532004)
2017,Agosto,Chile,5552,6723,,12275,POINT (4697157 -74140516)
2017,Agosto,Chile,3,4,,7,POINT (4815189 -75736374)
2017,Agosto,Chile,12,33,,45,POINT (6170465 -7542726)
2017,Agosto,Chile,1,0,,1,POINT (7128047 -73181317)
2017,Agosto,China,0,1,,1,POINT (10446304 -75516486)
2017,Agosto,China,0,1,,1,POINT (10886686 -74776479)
2017,Agosto,China,0,2,,2,POINT (3451668 -76532004)
2017,Agosto,China,28,79,,107,POINT (4697157 -74140516)
2017,Agosto,China,0,2,,2,POINT (4815189 -75736374)
2017,Agosto,China,4,3,,7,POINT (6170465 -7542726)
2017,Agosto,Chipre,1,0,,1,POINT (4697157 -74140516)
2017,Agosto,Dinamarca,0,1,,1,POINT (3451668 -76532004)
2017,Agosto,Dinamarca,14,23,,37,POINT (4697157 -74140516)
2017,Agosto,Dinamarca,0,1,,1,POINT (4815189 -75736374)
2017,Agosto,Dinamarca,1,3,,4,POINT (6170465 -7542726)
2017,Agosto,Dominica,0,1,,1,POINT (10446304 -75516486)
2017,Agosto,Ecuador,2,0,,2,POINT (0.185957 -7478366)
2017,Agosto,Ecuador,186,472,,658,POINT (0.33002 -76876446)
2017,Agosto,Ecuador,7,9,,16,POINT (0.812436 -77847006)
2017,Agosto,Ecuador,5947,7187,,13134,POINT (0.81488 -77356)
2017,Agosto,Ecuador,33,176,,209,POINT (1800143 -78802679)
2017,Agosto,Ecuador,0,1,,1,POINT (10406342 -75527794)
2017,Agosto,Ecuador,442,304,,746,POINT (10446304 -75516486)
2017,Agosto,Ecuador,1,9,,10,POINT (10886686 -74776479)
2017,Agosto,Ecuador,0,5,,5,POINT (11117206 -74232675)
2017,Agosto,Ecuador,19,13,,32,POINT (125862 -81702165)
2017,Agosto,Ecuador,682,912,,1594,POINT (3451668 -76532004)
2017,Agosto,Ecuador,0,3,,3,POINT (3884426 -77061029)
2017,Agosto,Ecuador,4110,5101,,9211,POINT (4697157 -74140516)
2017,Agosto,Ecuador,2,1,,3,POINT (4815189 -75736374)
2017,Agosto,Ecuador,10,25,,35,POINT (6170465 -7542726)
2017,Agosto,Ecuador,2,1,,3,POINT (7128047 -73181317)
2017,Agosto,Ecuador,0,1,,1,POINT (7819 -72453013)
2017,Agosto,Egipto,4,5,,9,POINT (4697157 -74140516)
2017,Agosto,El Salvador,6,4,,10,POINT (10446304 -75516486)
2017,Agosto,El Salvador,0,3,,3,POINT (10886686 -74776479)
2017,Agosto,El Salvador,6,4,,10,POINT (125862 -81702165)
2017,Agosto,El Salvador,121,166,,287,POINT (3451668 -76532004)
2017,Agosto,El Salvador,960,1240,,2200,POINT (4697157 -74140516)
2017,Agosto,El Salvador,0,1,,1,POINT (4815189 -75736374)
2017,Agosto,El Salvador,201,408,,609,POINT (6170465 -7542726)
2017,Agosto,Emiratos Árabes,1,1,,2,POINT (3451668 -76532004)
2017,Agosto,Emiratos Árabes,0,5,,5,POINT (4697157 -74140516)
2017,Agosto,Eslovaquia,0,2,,2,POINT (3451668 -76532004)
2017,Agosto,Eslovaquia,1,2,,3,POINT (4697157 -74140516)
2017,Agosto,Eslovenia,0,1,,1,POINT (10446304 -75516486)
2017,Agosto,Eslovenia,1,3,,4,POINT (4697157 -74140516)
2017,Agosto,Eslovenia,0,4,,4,POINT (6170465 -7542726)
2017,Agosto,Estados Unidos de América,0,5,,5,POINT (1800143 -78802679)
2017,Agosto,Estados Unidos de América,5,48,,53,POINT (10406342 -75527794)
2017,Agosto,Estados Unidos de América,3168,4771,,7939,POINT (10446304 -75516486)
2017,Agosto,Estados Unidos de América,713,1106,,1819,POINT (10886686 -74776479)
2017,Agosto,Estados Unidos de América,0,14,,14,POINT (10970933 -74765343)
2017,Agosto,Estados Unidos de América,0,12,,12,POINT (11247723 -74213989)
2017,Agosto,Estados Unidos de América,40,49,,89,POINT (125862 -81702165)
2017,Agosto,Estados Unidos de América,1356,1760,,3116,POINT (3451668 -76532004)
2017,Agosto,Estados Unidos de América,0,4,,4,POINT (3884426 -77061029)
2017,Agosto,Estados Unidos de América,248,309,,557,POINT (445285 -75766353)
2017,Agosto,Estados Unidos de América,11098,17822,,28920,POINT (4697157 -74140516)
2017,Agosto,Estados Unidos de América,179,243,,422,POINT (4815189 -75736374)
2017,Agosto,Estados Unidos de América,3153,6738,,9891,POINT (6170465 -7542726)
2017,Agosto,Estados Unidos de América,36,62,,98,POINT (7128047 -73181317)
2017,Agosto,Estados Unidos de América,0,14,,14,POINT (9402597 -75681642)
2017,Agosto,Estonia,1,1,,2,POINT (6170465 -7542726)
2017,Agosto,Etiopia,0,1,,1,POINT (4697157 -74140516)
2017,Agosto,Filipinas,0,4,,4,POINT (10446304 -75516486)
2017,Agosto,Filipinas,0,5,,5,POINT (10886686 -74776479)
2017,Agosto,Filipinas,0,3,,3,POINT (3451668 -76532004)
2017,Agosto,Filipinas,4,6,,10,POINT (4697157 -74140516)
2017,Agosto,Finlandia,3,2,,5,POINT (3451668 -76532004)
2017,Agosto,Finlandia,6,7,,13,POINT (4697157 -74140516)
2017,Agosto,Finlandia,1,2,,3,POINT (6170465 -7542726)
2017,Agosto,Francia,2,4,,6,POINT (10446304 -75516486)
2017,Agosto,Francia,9,13,,22,POINT (10886686 -74776479)
2017,Agosto,Francia,35,58,,93,POINT (3451668 -76532004)
2017,Agosto,Francia,1979,2794,,4773,POINT (4697157 -74140516)
2017,Agosto,Francia,10,6,,16,POINT (4815189 -75736374)
2017,Agosto,Francia,50,88,,138,POINT (6170465 -7542726)
2017,Agosto,Francia,1,5,,6,POINT (7128047 -73181317)
2017,Agosto,Gambia,0,1,,1,POINT (4697157 -74140516)
2017,Agosto,Georgia,0,1,,1,POINT (4697157 -74140516)
2017,Agosto,Gibraltar/Territorio Británico de Ultramar,1,1,,2,POINT (0.81488 -77356)
2017,Agosto,Granada,0,1,,1,POINT (4697157 -74140516)
2017,Agosto,Grecia,2,6,,8,POINT (4697157 -74140516)
2017,Agosto,Guatemala,10,14,,24,POINT (10446304 -75516486)
2017,Agosto,Guatemala,2,4,,6,POINT (10886686 -74776479)
2017,Agosto,Guatemala,14,45,,59,POINT (3451668 -76532004)
2017,Agosto,Guatemala,355,670,,1025,POINT (4697157 -74140516)
2017,Agosto,Guatemala,6,6,,12,POINT (4815189 -75736374)
2017,Agosto,Guatemala,42,116,,158,POINT (6170465 -7542726)
2017,Agosto,Guatemala,4,2,,6,POINT (7128047 -73181317)
2017,Agosto,Guyana,0,1,,1,POINT (10886686 -74776479)
2017,Agosto,Guyana,1,2,,3,POINT (4697157 -74140516)
2017,Agosto,Guyana,3,1,,4,POINT (6170465 -7542726)
2017,Agosto,Guadalupe/Territorio Francés,1,2,,3,POINT (4697157 -74140516)
2017,Agosto,Guayana Francesa/Departamento de Ultramar Francés,1,1,,2,POINT (3451668 -76532004)
2017,Agosto,Guayana Francesa/Departamento de Ultramar Francés,0,1,,1,POINT (4697157 -74140516)
2017,Agosto,Haití,4,3,,7,POINT (4697157 -74140516)
2017,Agosto,Haití,0,1,,1,POINT (6170465 -7542726)
2017,Agosto,Honduras,5,15,,20,POINT (10446304 -75516486)
2017,Agosto,Honduras,0,3,,3,POINT (10886686 -74776479)
2017,Agosto,Honduras,0,69,,69,POINT (125744111 -81703935)
2017,Agosto,Honduras,0,2,,2,POINT (125862 -81702165)
2017,Agosto,Honduras,18,21,,39,POINT (3451668 -76532004)
2017,Agosto,Honduras,66,100,,166,POINT (4697157 -74140516)
2017,Agosto,Honduras,0,2,,2,POINT (4815189 -75736374)
2017,Agosto,Honduras,30,37,,67,POINT (6170465 -7542726)
2017,Agosto,Honduras,1,0,,1,POINT (7128047 -73181317)
2017,Agosto,Hong Kong,3,6,,9,POINT (4697157 -74140516)
2017,Agosto,Hungría,1,3,,4,POINT (4697157 -74140516)
2017,Agosto,Hungría,0,2,,2,POINT (6170465 -7542726)
2017,Agosto,India,2,2,,4,POINT (10886686 -74776479)
2017,Agosto,India,0,2,,2,POINT (3451668 -76532004)
2017,Agosto,India,12,44,,56,POINT (4697157 -74140516)
2017,Agosto,India,0,1,,1,POINT (6170465 -7542726)
2017,Agosto,Indonesia,1,1,,2,POINT (4697157 -74140516)
2017,Agosto,Indonesia,1,0,,1,POINT (6170465 -7542726)
2017,Agosto,Iraq,0,1,,1,POINT (4697157 -74140516)
2017,Agosto,Irán,1,0,,1,POINT (4697157 -74140516)
2017,Agosto,República de Irlanda,0,1,,1,POINT (3451668 -76532004)
2017,Agosto,República de Irlanda,9,15,,24,POINT (4697157 -74140516)
2017,Agosto,República de Irlanda,1,12,,13,POINT (6170465 -7542726)
2017,Agosto,Islandia,0,1,,1,POINT (4697157 -74140516)
2017,Agosto,Israel,0,3,,3,POINT (10446304 -75516486)
2017,Agosto,Israel,0,2,,2,POINT (10886686 -74776479)
2017,Agosto,Israel,1,3,,4,POINT (3451668 -76532004)
2017,Agosto,Israel,42,77,,119,POINT (4697157 -74140516)
2017,Agosto,Israel,3,8,,11,POINT (6170465 -7542726)
2017,Agosto,Italia,3,20,,23,POINT (10446304 -75516486)
2017,Agosto,Italia,2,1,,3,POINT (10886686 -74776479)
2017,Agosto,Italia,0,6,,6,POINT (10970933 -74765343)
2017,Agosto,Italia,1,3,,4,POINT (125862 -81702165)
2017,Agosto,Italia,9,24,,33,POINT (3451668 -76532004)
2017,Agosto,Italia,268,421,,689,POINT (4697157 -74140516)
2017,Agosto,Italia,1,2,,3,POINT (4815189 -75736374)
2017,Agosto,Italia,34,72,,106,POINT (6170465 -7542726)
2017,Agosto,Jamaica,1,4,,5,POINT (10406342 -75527794)
2017,Agosto,Jamaica,1,9,,10,POINT (10886686 -74776479)
2017,Agosto,Jamaica,0,8,,8,POINT (125862 -81702165)
2017,Agosto,Jamaica,0,2,,2,POINT (133387613 -81372937)
2017,Agosto,Jamaica,1,0,,1,POINT (3451668 -76532004)
2017,Agosto,Jamaica,4,7,,11,POINT (4697157 -74140516)
2017,Agosto,Jamaica,1,4,,5,POINT (6170465 -7542726)
2017,Agosto,Jamaica,3,0,,3,POINT (7128047 -73181317)
2017,Agosto,Japón,0,1,,1,POINT (10886686 -74776479)
2017,Agosto,Japón,0,1,,1,POINT (3451668 -76532004)
2017,Agosto,Japón,22,40,,62,POINT (4697157 -74140516)
2017,Agosto,Japón,0,1,,1,POINT (4815189 -75736374)
2017,Agosto,Japón,0,4,,4,POINT (6170465 -7542726)
2017,Agosto,Kenia,2,3,,5,POINT (3451668 -76532004)
2017,Agosto,Kenia,3,1,,4,POINT (4697157 -74140516)
2017,Agosto,Kuwait,0,1,,1,POINT (3451668 -76532004)
2017,Agosto,Lituania,2,1,,3,POINT (4697157 -74140516)
2017,Agosto,Líbano,7,8,,15,POINT (4697157 -74140516)
2017,Agosto,Liechtenstein,2,0,,2,POINT (4697157 -74140516)
2017,Agosto,Luxemburgo,3,3,,6,POINT (4697157 -74140516)
2017,Agosto,Luxemburgo,1,1,,2,POINT (6170465 -7542726)
2017,Agosto,Malasia,3,1,,4,POINT (4697157 -74140516)
2017,Agosto,Malasia,1,0,,1,POINT (6170465 -7542726)
2017,Agosto,Malta,4,1,,5,POINT (4697157 -74140516)
2017,Agosto,Marruecos,0,1,,1,POINT (10406342 -75527794)
2017,Agosto,México,0,4,,4,POINT (10406342 -75527794)
2017,Agosto,México,14,40,,54,POINT (10446304 -75516486)
2017,Agosto,México,18,30,,48,POINT (10886686 -74776479)
2017,Agosto,México,3,4,,7,POINT (125862 -81702165)
2017,Agosto,México,65,121,,186,POINT (3451668 -76532004)
2017,Agosto,México,6325,9901,,16226,POINT (4697157 -74140516)
2017,Agosto,México,39,65,,104,POINT (4815189 -75736374)
2017,Agosto,México,706,1516,,2222,POINT (6170465 -7542726)
2017,Agosto,México,4,13,,17,POINT (7128047 -73181317)
2017,Agosto,México,0,3,,3,POINT (9402597 -75681642)
2017,Agosto,Mónaco,1,0,,1,POINT (4697157 -74140516)
2017,Agosto,Mongolia,1,0,,1,POINT (4697157 -74140516)
2017,Agosto,Montenegro,1,0,,1,POINT (4697157 -74140516)
2017,Agosto,Nepal,0,1,,1,POINT (3451668 -76532004)
2017,Agosto,Nepal,1,0,,1,POINT (4697157 -74140516)
2017,Agosto,Nicaragua,0,2,,2,POINT (10406342 -75527794)
2017,Agosto,Nicaragua,1,0,,1,POINT (10886686 -74776479)
2017,Agosto,Nicaragua,1,1,,2,POINT (125862 -81702165)
2017,Agosto,Nicaragua,17,21,,38,POINT (3451668 -76532004)
2017,Agosto,Nicaragua,26,58,,84,POINT (4697157 -74140516)
2017,Agosto,Nicaragua,1,4,,5,POINT (4815189 -75736374)
2017,Agosto,Nicaragua,6,22,,28,POINT (6170465 -7542726)
2017,Agosto,Nigeria,0,2,,2,POINT (4697157 -74140516)
2017,Agosto,Níger,1,0,,1,POINT (4697157 -74140516)
2017,Agosto,Noruega,0,1,,1,POINT (10446304 -75516486)
2017,Agosto,Noruega,1,0,,1,POINT (10886686 -74776479)
2017,Agosto,Noruega,2,3,,5,POINT (3451668 -76532004)
2017,Agosto,Noruega,12,11,,23,POINT (4697157 -74140516)
2017,Agosto,Noruega,0,1,,1,POINT (4815189 -75736374)
2017,Agosto,Noruega,1,2,,3,POINT (6170465 -7542726)
2017,Agosto,Nueva Zelanda,1,1,,2,POINT (10446304 -75516486)
2017,Agosto,Nueva Zelanda,1,1,,2,POINT (3451668 -76532004)
2017,Agosto,Nueva Zelanda,4,3,,7,POINT (4697157 -74140516)
2017,Agosto,Nueva Zelanda,1,3,,4,POINT (6170465 -7542726)
2017,Agosto,Panamá,1002,891,,1893,POINT (10406342 -75527794)
2017,Agosto,Panamá,3888,4053,,7941,POINT (10446304 -75516486)
2017,Agosto,Panamá,322,668,,990,POINT (10886686 -74776479)
2017,Agosto,Panamá,1,109,,110,POINT (10970933 -74765343)
2017,Agosto,Panamá,1,4,,5,POINT (11247723 -74213989)
2017,Agosto,Panamá,1,2,,3,POINT (125744111 -81703935)
2017,Agosto,Panamá,94,105,,199,POINT (125862 -81702165)
2017,Agosto,Panamá,5,7,,12,POINT (133387613 -81372937)
2017,Agosto,Panamá,414,663,,1077,POINT (3451668 -76532004)
2017,Agosto,Panamá,1,26,,27,POINT (3884426 -77061029)
2017,Agosto,Panamá,30,52,,82,POINT (445285 -75766353)
2017,Agosto,Panamá,4275,6116,,10391,POINT (4697157 -74140516)
2017,Agosto,Panamá,41,103,,144,POINT (4815189 -75736374)
2017,Agosto,Panamá,2257,3281,,5538,POINT (6170465 -7542726)
2017,Agosto,Panamá,0,1,,1,POINT (6222552 -77401154)
2017,Agosto,Panamá,5,15,,20,POINT (7102626 -77762647)
2017,Agosto,Panamá,11,25,,36,POINT (7128047 -73181317)
2017,Agosto,Panamá,129,154,,283,POINT (863337 -7735002)
2017,Agosto,Panamá,0,7,,7,POINT (9402597 -75681642)
2017,Agosto,Paraguay,8,3,,11,POINT (10446304 -75516486)
2017,Agosto,Paraguay,3,2,,5,POINT (10886686 -74776479)
2017,Agosto,Paraguay,104,67,,171,POINT (125862 -81702165)
2017,Agosto,Paraguay,2,5,,7,POINT (3451668 -76532004)
2017,Agosto,Paraguay,59,77,,136,POINT (4697157 -74140516)
2017,Agosto,Paraguay,1,1,,2,POINT (4815189 -75736374)
2017,Agosto,Paraguay,10,20,,30,POINT (6170465 -7542726)
2017,Agosto,Perú,149,189,,338,POINT (-4191162 -69941498)
2017,Agosto,Perú,8,6,,14,POINT (-4214082 -69941431)
2017,Agosto,Perú,14,16,,30,POINT (0.81488 -77356)
2017,Agosto,Perú,1210,892,,2102,POINT (10446304 -75516486)
2017,Agosto,Perú,1,8,,9,POINT (10886686 -74776479)
2017,Agosto,Perú,277,168,,445,POINT (125862 -81702165)
2017,Agosto,Perú,204,285,,489,POINT (3451668 -76532004)
2017,Agosto,Perú,0,6,,6,POINT (3884426 -77061029)
2017,Agosto,Perú,7283,8905,,16188,POINT (4697157 -74140516)
2017,Agosto,Perú,8,9,,17,POINT (4815189 -75736374)
2017,Agosto,Perú,325,574,,899,POINT (6170465 -7542726)
2017,Agosto,Perú,1,1,,2,POINT (7128047 -73181317)
2017,Agosto,Polonia,1,0,,1,POINT (10886686 -74776479)
2017,Agosto,Polonia,14,16,,30,POINT (4697157 -74140516)
2017,Agosto,Polonia,1,2,,3,POINT (6170465 -7542726)
2017,Agosto,Portugal,2,3,,5,POINT (10446304 -75516486)
2017,Agosto,Portugal,0,1,,1,POINT (10886686 -74776479)
2017,Agosto,Portugal,0,1,,1,POINT (125862 -81702165)
2017,Agosto,Portugal,3,11,,14,POINT (3451668 -76532004)
2017,Agosto,Portugal,54,51,,105,POINT (4697157 -74140516)
2017,Agosto,Portugal,12,15,,27,POINT (6170465 -7542726)
2017,Agosto,Puerto Rico/Territorio de Estados Unidos,1,13,,14,POINT (10406342 -75527794)
2017,Agosto,Puerto Rico/Territorio de Estados Unidos,2,11,,13,POINT (10446304 -75516486)
2017,Agosto,Puerto Rico/Territorio de Estados Unidos,10,35,,45,POINT (10886686 -74776479)
2017,Agosto,Puerto Rico/Territorio de Estados Unidos,31,69,,100,POINT (3451668 -76532004)
2017,Agosto,Puerto Rico/Territorio de Estados Unidos,561,852,,1413,POINT (4697157 -74140516)
2017,Agosto,Puerto Rico/Territorio de Estados Unidos,1,15,,16,POINT (4815189 -75736374)
2017,Agosto,Puerto Rico/Territorio de Estados Unidos,78,198,,276,POINT (6170465 -7542726)
2017,Agosto,Puerto Rico/Territorio de Estados Unidos,1,1,,2,POINT (7128047 -73181317)
2017,Agosto,Reino Unido de Gran Bretaña e Irlanda del Norte,2,3,,5,POINT (10446304 -75516486)
2017,Agosto,Reino Unido de Gran Bretaña e Irlanda del Norte,2,4,,6,POINT (10886686 -74776479)
2017,Agosto,Reino Unido de Gran Bretaña e Irlanda del Norte,13,14,,27,POINT (3451668 -76532004)
2017,Agosto,Reino Unido de Gran Bretaña e Irlanda del Norte,826,1169,,1995,POINT (4697157 -74140516)
2017,Agosto,Reino Unido de Gran Bretaña e Irlanda del Norte,0,2,,2,POINT (4815189 -75736374)
2017,Agosto,Reino Unido de Gran Bretaña e Irlanda del Norte,26,44,,70,POINT (6170465 -7542726)
2017,Agosto,República CentroÁfricana,2,2,,4,POINT (4697157 -74140516)
2017,Agosto,República CentroÁfricana,0,1,,1,POINT (6170465 -7542726)
2017,Agosto,Federación de Rusia,0,5,,5,POINT (10406342 -75527794)
2017,Agosto,Federación de Rusia,22,29,,51,POINT (4697157 -74140516)
2017,Agosto,Federación de Rusia,0,3,,3,POINT (6170465 -7542726)
2017,Agosto,República Dominicana,0,17,,17,POINT (10406342 -75527794)
2017,Agosto,República Dominicana,3,23,,26,POINT (10446304 -75516486)
2017,Agosto,República Dominicana,6,24,,30,POINT (10886686 -74776479)
2017,Agosto,República Dominicana,0,4,,4,POINT (10970933 -74765343)
2017,Agosto,República Dominicana,0,1,,1,POINT (11247723 -74213989)
2017,Agosto,República Dominicana,1,0,,1,POINT (125862 -81702165)
2017,Agosto,República Dominicana,14,21,,35,POINT (3451668 -76532004)
2017,Agosto,República Dominicana,1081,1420,,2501,POINT (4697157 -74140516)
2017,Agosto,República Dominicana,9,5,,14,POINT (4815189 -75736374)
2017,Agosto,República Dominicana,48,91,,139,POINT (6170465 -7542726)
2017,Agosto,República Dominicana,1,5,,6,POINT (7128047 -73181317)
2017,Agosto,República Democrática Popular de Corea,0,1,,1,POINT (4697157 -74140516)
2017,Agosto,Rumania,0,2,,2,POINT (3451668 -76532004)
2017,Agosto,Rumania,3,5,,8,POINT (4697157 -74140516)
2017,Agosto,Rumania,0,1,,1,POINT (6170465 -7542726)
2017,Agosto,Rwanda,0,1,,1,POINT (3451668 -76532004)
2017,Agosto,San  Vicente y las Granadinas,1,0,,1,POINT (4697157 -74140516)
2017,Agosto,Santa Lucia,1,1,,2,POINT (4697157 -74140516)
2017,Agosto,Santa Sede/Ciudad del Vaticano,0,1,,1,POINT (6170465 -7542726)
2017,Agosto,Santo Tomé y Príncipe,0,1,,1,POINT (4697157 -74140516)
2017,Agosto,Islas Svalbard,0,1,,1,POINT (7927233 -72508188)
2017,Agosto,Singapur,1,4,,5,POINT (4697157 -74140516)
2017,Agosto,Sudáfrica,0,1,,1,POINT (1800143 -78802679)
2017,Agosto,Sudáfrica,4,5,,9,POINT (4697157 -74140516)
2017,Agosto,Suecia,7,5,,12,POINT (3451668 -76532004)
2017,Agosto,Suecia,13,22,,35,POINT (4697157 -74140516)
2017,Agosto,Suecia,0,10,,10,POINT (6170465 -7542726)
2017,Agosto,Suiza,0,1,,1,POINT (125862 -81702165)
2017,Agosto,Suiza,13,17,,30,POINT (3451668 -76532004)
2017,Agosto,Suiza,76,92,,168,POINT (4697157 -74140516)
2017,Agosto,Suiza,1,1,,2,POINT (4815189 -75736374)
2017,Agosto,Suiza,6,16,,22,POINT (6170465 -7542726)
2017,Agosto,Surinam,1,2,,3,POINT (4697157 -74140516)
2017,Agosto,Surinam,0,2,,2,POINT (6170465 -7542726)
2017,Agosto,Suazilandia,1,1,,2,POINT (4697157 -74140516)
2017,Agosto,Taiwán,0,4,,4,POINT (4697157 -74140516)
2017,Agosto,Taiwán,2,2,,4,POINT (6170465 -7542726)
2017,Agosto,Tailandia,1,1,,2,POINT (4697157 -74140516)
2017,Agosto,Tanzania,0,1,,1,POINT (4697157 -74140516)
2017,Agosto,Trinidad y Tobago,1,1,,2,POINT (10446304 -75516486)
2017,Agosto,Trinidad y Tobago,1,1,,2,POINT (10886686 -74776479)
2017,Agosto,Trinidad y Tobago,4,4,,8,POINT (3451668 -76532004)
2017,Agosto,Trinidad y Tobago,14,13,,27,POINT (4697157 -74140516)
2017,Agosto,Trinidad y Tobago,0,1,,1,POINT (4815189 -75736374)
2017,Agosto,Trinidad y Tobago,3,5,,8,POINT (6170465 -7542726)
2017,Agosto,Túnez,0,4,,4,POINT (4697157 -74140516)
2017,Agosto,Turkmenistán,5,6,,11,POINT (4697157 -74140516)
2017,Agosto,Turquía,0,3,,3,POINT (3451668 -76532004)
2017,Agosto,Turquía,427,510,,937,POINT (4697157 -74140516)
2017,Agosto,Turquía,0,2,,2,POINT (6170465 -7542726)
2017,Agosto,Ucrania,4,9,,13,POINT (4697157 -74140516)
2017,Agosto,Ucrania,1,0,,1,POINT (6170465 -7542726)
2017,Agosto,Uganda,0,1,,1,POINT (3451668 -76532004)
2017,Agosto,Uganda,1,1,,2,POINT (4697157 -74140516)
2017,Agosto,Uruguay,5,5,,10,POINT (10446304 -75516486)
2017,Agosto,Uruguay,40,28,,68,POINT (125862 -81702165)
2017,Agosto,Uruguay,7,11,,18,POINT (3451668 -76532004)
2017,Agosto,Uruguay,426,523,,949,POINT (4697157 -74140516)
2017,Agosto,Uruguay,0,2,,2,POINT (4815189 -75736374)
2017,Agosto,Uruguay,11,24,,35,POINT (6170465 -7542726)
2017,Agosto,Uruguay,1,0,,1,POINT (7128047 -73181317)
2017,Agosto,Venezuela,1,28,,29,POINT (10406342 -75527794)
2017,Agosto,Venezuela,10,29,,39,POINT (10446304 -75516486)
2017,Agosto,Venezuela,24,69,,93,POINT (10886686 -74776479)
2017,Agosto,Venezuela,0,1,,1,POINT (11117206 -74232675)
2017,Agosto,Venezuela,1,3,,4,POINT (11247723 -74213989)
2017,Agosto,Venezuela,9677,10072,,19749,POINT (11360029 -72129595)
2017,Agosto,Venezuela,3,3,,6,POINT (125862 -81702165)
2017,Agosto,Venezuela,22,23,,45,POINT (3451668 -76532004)
2017,Agosto,Venezuela,15,19,,34,POINT (3866713 -67927521)
2017,Agosto,Venezuela,3015,2904,,5919,POINT (4697157 -74140516)
2017,Agosto,Venezuela,2,3,,5,POINT (4815189 -75736374)
2017,Agosto,Venezuela,573,678,,1251,POINT (6170465 -7542726)
2017,Agosto,Venezuela,26,29,,55,POINT (6185536 -67484028)
2017,Agosto,Venezuela,299,318,,617,POINT (7088729 -70740253)
2017,Agosto,Venezuela,3,5,,8,POINT (7128047 -73181317)
2017,Agosto,Venezuela,23560,27330,,50890,POINT (7819 -72453013)
2017,Agosto,Venezuela,4,26,,30,POINT (7927233 -72508188)
2017,Agosto,Venezuela,850,868,,1718,POINT (836068 -72409396)
2017,Agosto,Vietnam,2,0,,2,POINT (4697157 -74140516)
2017,Agosto,República Árabe de Yemen,0,1,,1,POINT (4697157 -74140516)
2017,Agosto,Desconocido,224,506,,730,POINT (6170465 -7542726)
2017,Septiembre,Afganistán,1,0,,1,POINT (4697157 -74140516)
2017,Septiembre,Albania,1,0,,1,POINT (3451668 -76532004)
2017,Septiembre,Albania,0,1,,1,POINT (4697157 -74140516)
2017,Septiembre,Alemania,1,0,,1,POINT (0.81488 -77356)
2017,Septiembre,Alemania,3,0,,3,POINT (10446304 -75516486)
2017,Septiembre,Alemania,2,4,,6,POINT (10886686 -74776479)
2017,Septiembre,Alemania,0,2,,2,POINT (125862 -81702165)
2017,Septiembre,Alemania,18,23,,41,POINT (3451668 -76532004)
2017,Septiembre,Alemania,1347,2181,,3528,POINT (4697157 -74140516)
2017,Septiembre,Alemania,2,4,,6,POINT (4815189 -75736374)
2017,Septiembre,Alemania,1,2,,3,POINT (7128047 -73181317)
2017,Septiembre,Andorra,0,1,,1,POINT (4697157 -74140516)
2017,Septiembre,Antigua y Barbuda,0,4,,4,POINT (10406342 -75527794)
2017,Septiembre,Antigua y Barbuda,0,1,,1,POINT (3451668 -76532004)
2017,Septiembre,Antigua y Barbuda,1,3,,4,POINT (4697157 -74140516)
2017,Septiembre,Países Bajos,2,2,,4,POINT (10406342 -75527794)
2017,Septiembre,Países Bajos,182,323,,505,POINT (10446304 -75516486)
2017,Septiembre,Países Bajos,9,19,,28,POINT (10886686 -74776479)
2017,Septiembre,Países Bajos,0,3,,3,POINT (10970933 -74765343)
2017,Septiembre,Países Bajos,5,3,,8,POINT (11247723 -74213989)
2017,Septiembre,Países Bajos,3,13,,16,POINT (3451668 -76532004)
2017,Septiembre,Países Bajos,889,1199,,2088,POINT (4697157 -74140516)
2017,Septiembre,Países Bajos,2,3,,5,POINT (4815189 -75736374)
2017,Septiembre,Países Bajos,19,34,,53,POINT (6170465 -7542726)
2017,Septiembre,Países Bajos,0,2,,2,POINT (6218835 -75586989)
2017,Septiembre,Países Bajos,0,1,,1,POINT (7128047 -73181317)
2017,Septiembre,Arabia Saudita,2,2,,4,POINT (4697157 -74140516)
2017,Septiembre,Argelia,1,1,,2,POINT (4697157 -74140516)
2017,Septiembre,Argentina,4,3,,7,POINT (0.81488 -77356)
2017,Septiembre,Argentina,0,8,,8,POINT (10406342 -75527794)
2017,Septiembre,Argentina,135,90,,225,POINT (10446304 -75516486)
2017,Septiembre,Argentina,12,22,,34,POINT (10886686 -74776479)
2017,Septiembre,Argentina,29,13,,42,POINT (125862 -81702165)
2017,Septiembre,Argentina,32,41,,73,POINT (3451668 -76532004)
2017,Septiembre,Argentina,3182,3878,,7060,POINT (4697157 -74140516)
2017,Septiembre,Argentina,6,11,,17,POINT (4815189 -75736374)
2017,Septiembre,Argentina,2,15,,17,POINT (6170465 -7542726)
2017,Septiembre,Argentina,1,3,,4,POINT (7128047 -73181317)
2017,Septiembre,Aruba,11,14,,25,POINT (10406342 -75527794)
2017,Septiembre,Aruba,1,1,,2,POINT (10446304 -75516486)
2017,Septiembre,Aruba,0,1,,1,POINT (10886686 -74776479)
2017,Septiembre,Aruba,1,1,,2,POINT (10970933 -74765343)
2017,Septiembre,Aruba,11,20,,31,POINT (11247723 -74213989)
2017,Septiembre,Aruba,5,12,,17,POINT (1152863 -72919186)
2017,Septiembre,Aruba,5,1,,6,POINT (3451668 -76532004)
2017,Septiembre,Aruba,706,862,,1568,POINT (4697157 -74140516)
2017,Septiembre,Aruba,0,2,,2,POINT (4815189 -75736374)
2017,Septiembre,Aruba,0,1,,1,POINT (6170465 -7542726)
2017,Septiembre,Aruba,32,19,,51,POINT (7128047 -73181317)
2017,Septiembre,Australia,1,1,,2,POINT (10446304 -75516486)
2017,Septiembre,Australia,0,1,,1,POINT (125862 -81702165)
2017,Septiembre,Australia,7,7,,14,POINT (3451668 -76532004)
2017,Septiembre,Australia,32,46,,78,POINT (4697157 -74140516)
2017,Septiembre,Australia,0,1,,1,POINT (7128047 -73181317)
2017,Septiembre,Austria,1,2,,3,POINT (10446304 -75516486)
2017,Septiembre,Austria,0,1,,1,POINT (3451668 -76532004)
2017,Septiembre,Austria,10,21,,31,POINT (4697157 -74140516)
2017,Septiembre,Bahamas,2,2,,4,POINT (10446304 -75516486)
2017,Septiembre,Bahamas,0,1,,1,POINT (3451668 -76532004)
2017,Septiembre,Bahamas,5,14,,19,POINT (4697157 -74140516)
2017,Septiembre,Bahréin,2,0,,2,POINT (4697157 -74140516)
2017,Septiembre,Barbados,0,1,,1,POINT (10446304 -75516486)
2017,Septiembre,Barbados,3,0,,3,POINT (4697157 -74140516)
2017,Septiembre,República de Belarús,1,0,,1,POINT (11360029 -72129595)
2017,Septiembre,República de Belarús,0,2,,2,POINT (7819 -72453013)
2017,Septiembre,Bélgica,0,2,,2,POINT (10446304 -75516486)
2017,Septiembre,Bélgica,1,0,,1,POINT (125862 -81702165)
2017,Septiembre,Bélgica,3,8,,11,POINT (3451668 -76532004)
2017,Septiembre,Bélgica,46,53,,99,POINT (4697157 -74140516)
2017,Septiembre,Bélgica,0,1,,1,POINT (4815189 -75736374)
2017,Septiembre,Belice,0,1,,1,POINT (3451668 -76532004)
2017,Septiembre,Belice,0,3,,3,POINT (4697157 -74140516)
2017,Septiembre,Bolivia,0,1,,1,POINT (0.81488 -77356)
2017,Septiembre,Bolivia,29,14,,43,POINT (10446304 -75516486)
2017,Septiembre,Bolivia,1,0,,1,POINT (10886686 -74776479)
2017,Septiembre,Bolivia,7,1,,8,POINT (125862 -81702165)
2017,Septiembre,Bolivia,37,43,,80,POINT (3451668 -76532004)
2017,Septiembre,Bolivia,448,560,,1008,POINT (4697157 -74140516)
2017,Septiembre,Bolivia,1,2,,3,POINT (4815189 -75736374)
2017,Septiembre,Brasil,312,283,,595,POINT (-4191162 -69941498)
2017,Septiembre,Brasil,0,1,,1,POINT (-4214082 -69941431)
2017,Septiembre,Brasil,0,1,,1,POINT (0.81488 -77356)
2017,Septiembre,Brasil,0,17,,17,POINT (10406342 -75527794)
2017,Septiembre,Brasil,127,99,,226,POINT (10446304 -75516486)
2017,Septiembre,Brasil,1,75,,76,POINT (10886686 -74776479)
2017,Septiembre,Brasil,0,6,,6,POINT (11247723 -74213989)
2017,Septiembre,Brasil,123,109,,232,POINT (125862 -81702165)
2017,Septiembre,Brasil,35,57,,92,POINT (3451668 -76532004)
2017,Septiembre,Brasil,4982,5762,,10744,POINT (4697157 -74140516)
2017,Septiembre,Brasil,3,5,,8,POINT (4815189 -75736374)
2017,Septiembre,Brasil,1,5,,6,POINT (6170465 -7542726)
2017,Septiembre,Brasil,2,2,,4,POINT (7128047 -73181317)
2017,Septiembre,Bulgaria,0,2,,2,POINT (4697157 -74140516)
2017,Septiembre,Islas Caimán/Territorio Británico de Ultramar,2,2,,4,POINT (10446304 -75516486)
2017,Septiembre,Islas Caimán/Territorio Británico de Ultramar,0,4,,4,POINT (125862 -81702165)
2017,Septiembre,Islas Caimán/Territorio Británico de Ultramar,0,2,,2,POINT (4697157 -74140516)
2017,Septiembre,Camboya,0,1,,1,POINT (4697157 -74140516)
2017,Septiembre,Canadá,15,23,,38,POINT (10446304 -75516486)
2017,Septiembre,Canadá,2,13,,15,POINT (10886686 -74776479)
2017,Septiembre,Canadá,2,0,,2,POINT (125862 -81702165)
2017,Septiembre,Canadá,36,53,,89,POINT (3451668 -76532004)
2017,Septiembre,Canadá,0,6,,6,POINT (3884426 -77061029)
2017,Septiembre,Canadá,425,685,,1110,POINT (4697157 -74140516)
2017,Septiembre,Canadá,2,4,,6,POINT (4815189 -75736374)
2017,Septiembre,Canadá,0,4,,4,POINT (7128047 -73181317)
2017,Septiembre,España,0,1,,1,POINT (10406342 -75527794)
2017,Septiembre,España,5,5,,10,POINT (10446304 -75516486)
2017,Septiembre,España,2,2,,4,POINT (10886686 -74776479)
2017,Septiembre,España,166,279,,445,POINT (3451668 -76532004)
2017,Septiembre,España,3384,5386,,8770,POINT (4697157 -74140516)
2017,Septiembre,España,4,12,,16,POINT (4815189 -75736374)
2017,Septiembre,España,534,1030,,1564,POINT (6170465 -7542726)
2017,Septiembre,España,0,2,,2,POINT (7128047 -73181317)
2017,Septiembre,República de Corea,1,5,,6,POINT (3451668 -76532004)
2017,Septiembre,República de Corea,7,13,,20,POINT (4697157 -74140516)
2017,Septiembre,República de Corea,0,2,,2,POINT (4815189 -75736374)
2017,Septiembre,Costa de Marfil,7,1,,8,POINT (4697157 -74140516)
2017,Septiembre,Costa Rica,0,3,,3,POINT (10406342 -75527794)
2017,Septiembre,Costa Rica,14,14,,28,POINT (10446304 -75516486)
2017,Septiembre,Costa Rica,6,6,,12,POINT (10886686 -74776479)
2017,Septiembre,Costa Rica,1,0,,1,POINT (11117206 -74232675)
2017,Septiembre,Costa Rica,0,1,,1,POINT (125744111 -81703935)
2017,Septiembre,Costa Rica,7,7,,14,POINT (125862 -81702165)
2017,Septiembre,Costa Rica,32,43,,75,POINT (3451668 -76532004)
2017,Septiembre,Costa Rica,0,1,,1,POINT (3884426 -77061029)
2017,Septiembre,Costa Rica,1490,1770,,3260,POINT (4697157 -74140516)
2017,Septiembre,Costa Rica,6,2,,8,POINT (4815189 -75736374)
2017,Septiembre,Costa Rica,0,8,,8,POINT (6170465 -7542726)
2017,Septiembre,Costa Rica,3,2,,5,POINT (7128047 -73181317)
2017,Septiembre,Croacia,0,4,,4,POINT (3884426 -77061029)
2017,Septiembre,Croacia,1,6,,7,POINT (4697157 -74140516)
2017,Septiembre,Cuba,2,11,,13,POINT (10886686 -74776479)
2017,Septiembre,Cuba,24,16,,40,POINT (3451668 -76532004)
2017,Septiembre,Cuba,315,545,,860,POINT (4697157 -74140516)
2017,Septiembre,Cuba,3,10,,13,POINT (4815189 -75736374)
2017,Septiembre,Curazao,5,5,,10,POINT (4697157 -74140516)
2017,Septiembre,República Checa,0,1,,1,POINT (3451668 -76532004)
2017,Septiembre,República Checa,5,4,,9,POINT (4697157 -74140516)
2017,Septiembre,Chile,3,3,,6,POINT (0.81488 -77356)
2017,Septiembre,Chile,41,34,,75,POINT (10446304 -75516486)
2017,Septiembre,Chile,4,8,,12,POINT (10886686 -74776479)
2017,Septiembre,Chile,18,11,,29,POINT (125862 -81702165)
2017,Septiembre,Chile,24,35,,59,POINT (3451668 -76532004)
2017,Septiembre,Chile,0,1,,1,POINT (3884426 -77061029)
2017,Septiembre,Chile,4671,5618,,10289,POINT (4697157 -74140516)
2017,Septiembre,Chile,2,3,,5,POINT (4815189 -75736374)
2017,Septiembre,Chile,0,1,,1,POINT (6170465 -7542726)
2017,Septiembre,Chile,0,1,,1,POINT (7128047 -73181317)
2017,Septiembre,China,0,2,,2,POINT (10446304 -75516486)
2017,Septiembre,China,0,1,,1,POINT (10886686 -74776479)
2017,Septiembre,China,2,2,,4,POINT (3451668 -76532004)
2017,Septiembre,China,17,61,,78,POINT (4697157 -74140516)
2017,Septiembre,Dinamarca,0,2,,2,POINT (3451668 -76532004)
2017,Septiembre,Dinamarca,4,6,,10,POINT (4697157 -74140516)
2017,Septiembre,Dinamarca,0,1,,1,POINT (7128047 -73181317)
2017,Septiembre,Ecuador,0,5,,5,POINT (-4214082 -69941431)
2017,Septiembre,Ecuador,124,441,,565,POINT (0.33002 -76876446)
2017,Septiembre,Ecuador,1,3,,4,POINT (0.812436 -77847006)
2017,Septiembre,Ecuador,4365,5599,,9964,POINT (0.81488 -77356)
2017,Septiembre,Ecuador,36,311,,347,POINT (1800143 -78802679)
2017,Septiembre,Ecuador,7,17,,24,POINT (10446304 -75516486)
2017,Septiembre,Ecuador,4,5,,9,POINT (10886686 -74776479)
2017,Septiembre,Ecuador,0,6,,6,POINT (10970933 -74765343)
2017,Septiembre,Ecuador,2,2,,4,POINT (125862 -81702165)
2017,Septiembre,Ecuador,312,361,,673,POINT (3451668 -76532004)
2017,Septiembre,Ecuador,2475,3432,,5907,POINT (4697157 -74140516)
2017,Septiembre,Ecuador,2,2,,4,POINT (4815189 -75736374)
2017,Septiembre,Ecuador,0,1,,1,POINT (6170465 -7542726)
2017,Septiembre,Ecuador,1,1,,2,POINT (7128047 -73181317)
2017,Septiembre,Egipto,0,2,,2,POINT (4697157 -74140516)
2017,Septiembre,El Salvador,6,3,,9,POINT (10446304 -75516486)
2017,Septiembre,El Salvador,2,0,,2,POINT (10886686 -74776479)
2017,Septiembre,El Salvador,90,159,,249,POINT (3451668 -76532004)
2017,Septiembre,El Salvador,1223,1603,,2826,POINT (4697157 -74140516)
2017,Septiembre,El Salvador,2,1,,3,POINT (4815189 -75736374)
2017,Septiembre,El Salvador,345,690,,1035,POINT (6170465 -7542726)
2017,Septiembre,Emiratos Árabes,6,6,,12,POINT (4697157 -74140516)
2017,Septiembre,Eslovaquia,1,1,,2,POINT (10446304 -75516486)
2017,Septiembre,Eslovaquia,0,3,,3,POINT (4697157 -74140516)
2017,Septiembre,Eslovenia,0,1,,1,POINT (4697157 -74140516)
2017,Septiembre,Estados Unidos de América,0,37,,37,POINT (10406342 -75527794)
2017,Septiembre,Estados Unidos de América,2019,3265,,5284,POINT (10446304 -75516486)
2017,Septiembre,Estados Unidos de América,440,849,,1289,POINT (10886686 -74776479)
2017,Septiembre,Estados Unidos de América,0,4,,4,POINT (10970933 -74765343)
2017,Septiembre,Estados Unidos de América,0,27,,27,POINT (11247723 -74213989)
2017,Septiembre,Estados Unidos de América,1,2,,3,POINT (125744111 -81703935)
2017,Septiembre,Estados Unidos de América,1,10,,11,POINT (125862 -81702165)
2017,Septiembre,Estados Unidos de América,742,1146,,1888,POINT (3451668 -76532004)
2017,Septiembre,Estados Unidos de América,103,200,,303,POINT (445285 -75766353)
2017,Septiembre,Estados Unidos de América,7912,13710,,21622,POINT (4697157 -74140516)
2017,Septiembre,Estados Unidos de América,61,119,,180,POINT (4815189 -75736374)
2017,Septiembre,Estados Unidos de América,1722,4168,,5890,POINT (6170465 -7542726)
2017,Septiembre,Estados Unidos de América,16,46,,62,POINT (7128047 -73181317)
2017,Septiembre,Estados Unidos de América,0,16,,16,POINT (9402597 -75681642)
2017,Septiembre,Estonia,0,2,,2,POINT (4697157 -74140516)
2017,Septiembre,Etiopia,0,1,,1,POINT (4697157 -74140516)
2017,Septiembre,Filipinas,0,2,,2,POINT (10446304 -75516486)
2017,Septiembre,Filipinas,0,1,,1,POINT (11247723 -74213989)
2017,Septiembre,Filipinas,0,10,,10,POINT (3451668 -76532004)
2017,Septiembre,Filipinas,0,2,,2,POINT (3884426 -77061029)
2017,Septiembre,Filipinas,3,5,,8,POINT (4697157 -74140516)
2017,Septiembre,Finlandia,1,0,,1,POINT (3451668 -76532004)
2017,Septiembre,Finlandia,0,5,,5,POINT (4697157 -74140516)
2017,Septiembre,Francia,0,5,,5,POINT (10406342 -75527794)
2017,Septiembre,Francia,0,1,,1,POINT (10446304 -75516486)
2017,Septiembre,Francia,1,1,,2,POINT (10886686 -74776479)
2017,Septiembre,Francia,11,29,,40,POINT (3451668 -76532004)
2017,Septiembre,Francia,1285,2154,,3439,POINT (4697157 -74140516)
2017,Septiembre,Francia,1,4,,5,POINT (4815189 -75736374)
2017,Septiembre,Ghana,1,2,,3,POINT (4697157 -74140516)
2017,Septiembre,Gibraltar/Territorio Británico de Ultramar,0,2,,2,POINT (0.81488 -77356)
2017,Septiembre,Grecia,4,6,,10,POINT (4697157 -74140516)
2017,Septiembre,Guatemala,0,2,,2,POINT (10406342 -75527794)
2017,Septiembre,Guatemala,14,14,,28,POINT (10446304 -75516486)
2017,Septiembre,Guatemala,4,2,,6,POINT (10886686 -74776479)
2017,Septiembre,Guatemala,0,1,,1,POINT (133387613 -81372937)
2017,Septiembre,Guatemala,29,56,,85,POINT (3451668 -76532004)
2017,Septiembre,Guatemala,316,457,,773,POINT (4697157 -74140516)
2017,Septiembre,Guatemala,2,11,,13,POINT (4815189 -75736374)
2017,Septiembre,Guatemala,2,4,,6,POINT (7128047 -73181317)
2017,Septiembre,Guyana,0,3,,3,POINT (10406342 -75527794)
2017,Septiembre,Guyana,0,1,,1,POINT (10886686 -74776479)
2017,Septiembre,Guyana,1,0,,1,POINT (3451668 -76532004)
2017,Septiembre,Guadalupe/Territorio Francés,0,1,,1,POINT (4697157 -74140516)
2017,Septiembre,Guayana Francesa/Departamento de Ultramar Francés,0,1,,1,POINT (10406342 -75527794)
2017,Septiembre,Haití,0,1,,1,POINT (10406342 -75527794)
2017,Septiembre,Honduras,0,1,,1,POINT (10406342 -75527794)
2017,Septiembre,Honduras,5,2,,7,POINT (10446304 -75516486)
2017,Septiembre,Honduras,0,6,,6,POINT (10886686 -74776479)
2017,Septiembre,Honduras,0,8,,8,POINT (125744111 -81703935)
2017,Septiembre,Honduras,0,1,,1,POINT (125862 -81702165)
2017,Septiembre,Honduras,8,5,,13,POINT (133387613 -81372937)
2017,Septiembre,Honduras,10,29,,39,POINT (3451668 -76532004)
2017,Septiembre,Honduras,67,63,,130,POINT (4697157 -74140516)
2017,Septiembre,Honduras,2,3,,5,POINT (4815189 -75736374)
2017,Septiembre,Hong Kong,0,2,,2,POINT (10446304 -75516486)
2017,Septiembre,Hong Kong,0,1,,1,POINT (3451668 -76532004)
2017,Septiembre,Hong Kong,1,1,,2,POINT (4697157 -74140516)
2017,Septiembre,Hungría,0,1,,1,POINT (3451668 -76532004)
2017,Septiembre,Hungría,2,3,,5,POINT (4697157 -74140516)
2017,Septiembre,Hungría,0,1,,1,POINT (4815189 -75736374)
2017,Septiembre,India,0,4,,4,POINT (10446304 -75516486)
2017,Septiembre,India,0,1,,1,POINT (3451668 -76532004)
2017,Septiembre,India,0,4,,4,POINT (3884426 -77061029)
2017,Septiembre,India,3,35,,38,POINT (4697157 -74140516)
2017,Septiembre,India,0,1,,1,POINT (4815189 -75736374)
2017,Septiembre,Indonesia,0,1,,1,POINT (10446304 -75516486)
2017,Septiembre,Indonesia,0,2,,2,POINT (4697157 -74140516)
2017,Septiembre,Iraq,0,1,,1,POINT (4697157 -74140516)
2017,Septiembre,República de Irlanda,0,1,,1,POINT (3451668 -76532004)
2017,Septiembre,República de Irlanda,10,10,,20,POINT (4697157 -74140516)
2017,Septiembre,Israel,26,73,,99,POINT (4697157 -74140516)
2017,Septiembre,Italia,0,9,,9,POINT (10446304 -75516486)
2017,Septiembre,Italia,8,22,,30,POINT (3451668 -76532004)
2017,Septiembre,Italia,91,244,,335,POINT (4697157 -74140516)
2017,Septiembre,Italia,0,2,,2,POINT (4815189 -75736374)
2017,Septiembre,Jamaica,0,2,,2,POINT (10406342 -75527794)
2017,Septiembre,Jamaica,1,0,,1,POINT (10446304 -75516486)
2017,Septiembre,Jamaica,0,3,,3,POINT (10886686 -74776479)
2017,Septiembre,Jamaica,0,3,,3,POINT (125744111 -81703935)
2017,Septiembre,Jamaica,3,15,,18,POINT (125862 -81702165)
2017,Septiembre,Jamaica,1,0,,1,POINT (3451668 -76532004)
2017,Septiembre,Jamaica,1,1,,2,POINT (4697157 -74140516)
2017,Septiembre,Jamaica,0,1,,1,POINT (7128047 -73181317)
2017,Septiembre,Japón,0,1,,1,POINT (10886686 -74776479)
2017,Septiembre,Japón,0,1,,1,POINT (3451668 -76532004)
2017,Septiembre,Japón,8,21,,29,POINT (4697157 -74140516)
2017,Septiembre,Japón,0,1,,1,POINT (4815189 -75736374)
2017,Septiembre,Japón,0,2,,2,POINT (7128047 -73181317)
2017,Septiembre,Jordania,1,0,,1,POINT (4697157 -74140516)
2017,Septiembre,Kazajistán,0,1,,1,POINT (10446304 -75516486)
2017,Septiembre,Kenia,1,0,,1,POINT (3451668 -76532004)
2017,Septiembre,Kenia,0,5,,5,POINT (4697157 -74140516)
2017,Septiembre,República Democrática Popular  Lao,1,0,,1,POINT (4697157 -74140516)
2017,Septiembre,Letonia,1,2,,3,POINT (4697157 -74140516)
2017,Septiembre,Líbano,6,6,,12,POINT (4697157 -74140516)
2017,Septiembre,Luxemburgo,0,4,,4,POINT (4697157 -74140516)
2017,Septiembre,Macedonia,0,1,,1,POINT (4697157 -74140516)
2017,Septiembre,Madagascar,1,0,,1,POINT (4697157 -74140516)
2017,Septiembre,Malasia,0,3,,3,POINT (4697157 -74140516)
2017,Septiembre,Malta,1,0,,1,POINT (4697157 -74140516)
2017,Septiembre,Marruecos,0,2,,2,POINT (4697157 -74140516)
2017,Septiembre,Islas Marshall,0,2,,2,POINT (10970933 -74765343)
2017,Septiembre,México,3,1,,4,POINT (10406342 -75527794)
2017,Septiembre,México,31,55,,86,POINT (10446304 -75516486)
2017,Septiembre,México,8,21,,29,POINT (10886686 -74776479)
2017,Septiembre,México,0,3,,3,POINT (10970933 -74765343)
2017,Septiembre,México,74,182,,256,POINT (3451668 -76532004)
2017,Septiembre,México,0,4,,4,POINT (3884426 -77061029)
2017,Septiembre,México,5625,9103,,14728,POINT (4697157 -74140516)
2017,Septiembre,México,21,43,,64,POINT (4815189 -75736374)
2017,Septiembre,México,556,1255,,1811,POINT (6170465 -7542726)
2017,Septiembre,México,8,27,,35,POINT (7128047 -73181317)
2017,Septiembre,Montenegro,0,1,,1,POINT (3451668 -76532004)
2017,Septiembre,Nicaragua,5,0,,5,POINT (10446304 -75516486)
2017,Septiembre,Nicaragua,2,0,,2,POINT (10886686 -74776479)
2017,Septiembre,Nicaragua,0,6,,6,POINT (125744111 -81703935)
2017,Septiembre,Nicaragua,11,11,,22,POINT (3451668 -76532004)
2017,Septiembre,Nicaragua,21,24,,45,POINT (4697157 -74140516)
2017,Septiembre,Nicaragua,3,6,,9,POINT (4815189 -75736374)
2017,Septiembre,Nicaragua,0,3,,3,POINT (7128047 -73181317)
2017,Septiembre,Nigeria,3,2,,5,POINT (4697157 -74140516)
2017,Septiembre,Noruega,0,1,,1,POINT (10446304 -75516486)
2017,Septiembre,Noruega,2,3,,5,POINT (3451668 -76532004)
2017,Septiembre,Noruega,13,18,,31,POINT (4697157 -74140516)
2017,Septiembre,Nueva Zelanda,1,1,,2,POINT (10446304 -75516486)
2017,Septiembre,Nueva Zelanda,1,0,,1,POINT (3451668 -76532004)
2017,Septiembre,Nueva Zelanda,4,9,,13,POINT (4697157 -74140516)
2017,Septiembre,Omán,0,1,,1,POINT (4697157 -74140516)
2017,Septiembre,Pakistán,0,1,,1,POINT (4697157 -74140516)
2017,Septiembre,Panamá,1264,1086,,2350,POINT (10406342 -75527794)
2017,Septiembre,Panamá,4649,4513,,9162,POINT (10446304 -75516486)
2017,Septiembre,Panamá,366,802,,1168,POINT (10886686 -74776479)
2017,Septiembre,Panamá,0,55,,55,POINT (10970933 -74765343)
2017,Septiembre,Panamá,3,10,,13,POINT (125744111 -81703935)
2017,Septiembre,Panamá,875,636,,1511,POINT (125862 -81702165)
2017,Septiembre,Panamá,389,578,,967,POINT (3451668 -76532004)
2017,Septiembre,Panamá,1,32,,33,POINT (3884426 -77061029)
2017,Septiembre,Panamá,71,58,,129,POINT (445285 -75766353)
2017,Septiembre,Panamá,5625,7229,,12854,POINT (4697157 -74140516)
2017,Septiembre,Panamá,73,141,,214,POINT (4815189 -75736374)
2017,Septiembre,Panamá,3075,4521,,7596,POINT (6170465 -7542726)
2017,Septiembre,Panamá,1,2,,3,POINT (6222552 -77401154)
2017,Septiembre,Panamá,1,6,,7,POINT (7102626 -77762647)
2017,Septiembre,Panamá,17,39,,56,POINT (7128047 -73181317)
2017,Septiembre,Panamá,0,2,,2,POINT (806667 -767333)
2017,Septiembre,Panamá,75,99,,174,POINT (863337 -7735002)
2017,Septiembre,Panamá,0,15,,15,POINT (9402597 -75681642)
2017,Septiembre,Paraguay,10,9,,19,POINT (10446304 -75516486)
2017,Septiembre,Paraguay,0,2,,2,POINT (10886686 -74776479)
2017,Septiembre,Paraguay,12,12,,24,POINT (125862 -81702165)
2017,Septiembre,Paraguay,15,16,,31,POINT (3451668 -76532004)
2017,Septiembre,Paraguay,43,102,,145,POINT (4697157 -74140516)
2017,Septiembre,Paraguay,6,6,,12,POINT (4815189 -75736374)
2017,Septiembre,Paraguay,0,1,,1,POINT (7128047 -73181317)
2017,Septiembre,Perú,76,112,,188,POINT (-4191162 -69941498)
2017,Septiembre,Perú,13,37,,50,POINT (-4214082 -69941431)
2017,Septiembre,Perú,21,31,,52,POINT (0.81488 -77356)
2017,Septiembre,Perú,1392,1043,,2435,POINT (10446304 -75516486)
2017,Septiembre,Perú,48,47,,95,POINT (10886686 -74776479)
2017,Septiembre,Perú,37,25,,62,POINT (125862 -81702165)
2017,Septiembre,Perú,281,409,,690,POINT (3451668 -76532004)
2017,Septiembre,Perú,0,4,,4,POINT (3884426 -77061029)
2017,Septiembre,Perú,4927,6370,,11297,POINT (4697157 -74140516)
2017,Septiembre,Perú,11,7,,18,POINT (4815189 -75736374)
2017,Septiembre,Perú,436,934,,1370,POINT (6170465 -7542726)
2017,Septiembre,Perú,0,3,,3,POINT (7128047 -73181317)
2017,Septiembre,Polonia,0,1,,1,POINT (11247723 -74213989)
2017,Septiembre,Polonia,1,0,,1,POINT (3451668 -76532004)
2017,Septiembre,Polonia,12,17,,29,POINT (4697157 -74140516)
2017,Septiembre,Portugal,1,0,,1,POINT (10446304 -75516486)
2017,Septiembre,Portugal,0,1,,1,POINT (3451668 -76532004)
2017,Septiembre,Portugal,14,41,,55,POINT (4697157 -74140516)
2017,Septiembre,Polinesia Francesa/Colectividad de Ultramar Francesa,0,5,,5,POINT (10406342 -75527794)
2017,Septiembre,Puerto Rico/Territorio de Estados Unidos,0,5,,5,POINT (10406342 -75527794)
2017,Septiembre,Puerto Rico/Territorio de Estados Unidos,4,3,,7,POINT (10446304 -75516486)
2017,Septiembre,Puerto Rico/Territorio de Estados Unidos,1,22,,23,POINT (10886686 -74776479)
2017,Septiembre,Puerto Rico/Territorio de Estados Unidos,10,39,,49,POINT (3451668 -76532004)
2017,Septiembre,Puerto Rico/Territorio de Estados Unidos,296,383,,679,POINT (4697157 -74140516)
2017,Septiembre,Puerto Rico/Territorio de Estados Unidos,0,2,,2,POINT (4815189 -75736374)
2017,Septiembre,Puerto Rico/Territorio de Estados Unidos,0,3,,3,POINT (6170465 -7542726)
2017,Septiembre,Puerto Rico/Territorio de Estados Unidos,3,4,,7,POINT (7128047 -73181317)
2017,Septiembre,Qatar,0,2,,2,POINT (3451668 -76532004)
2017,Septiembre,Qatar,0,1,,1,POINT (4697157 -74140516)
2017,Septiembre,Reino Unido de Gran Bretaña e Irlanda del Norte,2,6,,8,POINT (10446304 -75516486)
2017,Septiembre,Reino Unido de Gran Bretaña e Irlanda del Norte,6,20,,26,POINT (3451668 -76532004)
2017,Septiembre,Reino Unido de Gran Bretaña e Irlanda del Norte,655,1057,,1712,POINT (4697157 -74140516)
2017,Septiembre,República CentroÁfricana,0,1,,1,POINT (4697157 -74140516)
2017,Septiembre,Federación de Rusia,0,15,,15,POINT (10406342 -75527794)
2017,Septiembre,Federación de Rusia,1,2,,3,POINT (3451668 -76532004)
2017,Septiembre,Federación de Rusia,15,10,,25,POINT (4697157 -74140516)
2017,Septiembre,Federación de Rusia,1,0,,1,POINT (4815189 -75736374)
2017,Septiembre,República Dominicana,0,12,,12,POINT (10406342 -75527794)
2017,Septiembre,República Dominicana,6,13,,19,POINT (10446304 -75516486)
2017,Septiembre,República Dominicana,0,2,,2,POINT (10886686 -74776479)
2017,Septiembre,República Dominicana,0,1,,1,POINT (10970933 -74765343)
2017,Septiembre,República Dominicana,9,19,,28,POINT (3451668 -76532004)
2017,Septiembre,República Dominicana,723,935,,1658,POINT (4697157 -74140516)
2017,Septiembre,República Dominicana,11,9,,20,POINT (4815189 -75736374)
2017,Septiembre,República Dominicana,3,8,,11,POINT (6170465 -7542726)
2017,Septiembre,República Dominicana,1,1,,2,POINT (7128047 -73181317)
2017,Septiembre,Rumania,3,3,,6,POINT (4697157 -74140516)
2017,Septiembre,Rwanda,0,1,,1,POINT (4697157 -74140516)
2017,Septiembre,Singapur,1,2,,3,POINT (4697157 -74140516)
2017,Septiembre,República Árabe Siria,2,1,,3,POINT (4697157 -74140516)
2017,Septiembre,Sri Lanka,0,1,,1,POINT (4697157 -74140516)
2017,Septiembre,Sudáfrica,1,0,,1,POINT (3451668 -76532004)
2017,Septiembre,Sudáfrica,1,4,,5,POINT (4697157 -74140516)
2017,Septiembre,Sudáfrica,1,0,,1,POINT (9402597 -75681642)
2017,Septiembre,Sudán,2,0,,2,POINT (4697157 -74140516)
2017,Septiembre,Suecia,0,1,,1,POINT (10446304 -75516486)
2017,Septiembre,Suecia,1,1,,2,POINT (10886686 -74776479)
2017,Septiembre,Suecia,0,1,,1,POINT (11247723 -74213989)
2017,Septiembre,Suecia,5,3,,8,POINT (3451668 -76532004)
2017,Septiembre,Suecia,10,14,,24,POINT (4697157 -74140516)
2017,Septiembre,Suecia,1,0,,1,POINT (7128047 -73181317)
2017,Septiembre,Suiza,2,2,,4,POINT (10446304 -75516486)
2017,Septiembre,Suiza,7,5,,12,POINT (3451668 -76532004)
2017,Septiembre,Suiza,31,53,,84,POINT (4697157 -74140516)
2017,Septiembre,Suiza,2,3,,5,POINT (4815189 -75736374)
2017,Septiembre,Surinam,1,0,,1,POINT (4697157 -74140516)
2017,Septiembre,Taiwán,0,1,,1,POINT (3451668 -76532004)
2017,Septiembre,Taiwán,1,2,,3,POINT (4697157 -74140516)
2017,Septiembre,Taiwán,0,2,,2,POINT (4815189 -75736374)
2017,Septiembre,Tailandia,1,0,,1,POINT (4697157 -74140516)
2017,Septiembre,Tanzania,0,1,,1,POINT (3451668 -76532004)
2017,Septiembre,Tanzania,1,0,,1,POINT (4697157 -74140516)
2017,Septiembre,Trinidad y Tobago,0,3,,3,POINT (11247723 -74213989)
2017,Septiembre,Trinidad y Tobago,0,12,,12,POINT (125862 -81702165)
2017,Septiembre,Trinidad y Tobago,1,3,,4,POINT (3451668 -76532004)
2017,Septiembre,Trinidad y Tobago,4,12,,16,POINT (4697157 -74140516)
2017,Septiembre,Trinidad y Tobago,1,3,,4,POINT (4815189 -75736374)
2017,Septiembre,Trinidad y Tobago,1,1,,2,POINT (6170465 -7542726)
2017,Septiembre,Trinidad y Tobago,1,5,,6,POINT (7128047 -73181317)
2017,Septiembre,Trinidad y Tobago,0,6,,6,POINT (9402597 -75681642)
2017,Septiembre,Túnez,0,1,,1,POINT (4697157 -74140516)
2017,Septiembre,Turkmenistán,1,0,,1,POINT (7819 -72453013)
2017,Septiembre,Turquía,0,2,,2,POINT (10970933 -74765343)
2017,Septiembre,Turquía,244,379,,623,POINT (4697157 -74140516)
2017,Septiembre,Ucrania,1,0,,1,POINT (3451668 -76532004)
2017,Septiembre,Ucrania,0,1,,1,POINT (4697157 -74140516)
2017,Septiembre,Uganda,0,3,,3,POINT (3451668 -76532004)
2017,Septiembre,Uruguay,15,14,,29,POINT (10446304 -75516486)
2017,Septiembre,Uruguay,2,4,,6,POINT (125862 -81702165)
2017,Septiembre,Uruguay,7,19,,26,POINT (3451668 -76532004)
2017,Septiembre,Uruguay,190,258,,448,POINT (4697157 -74140516)
2017,Septiembre,Uruguay,1,1,,2,POINT (4815189 -75736374)
2017,Septiembre,Uruguay,0,2,,2,POINT (7128047 -73181317)
2017,Septiembre,Vanuatu,1,0,,1,POINT (7819 -72453013)
2017,Septiembre,Venezuela,0,14,,14,POINT (10406342 -75527794)
2017,Septiembre,Venezuela,9,18,,27,POINT (10446304 -75516486)
2017,Septiembre,Venezuela,8,37,,45,POINT (10886686 -74776479)
2017,Septiembre,Venezuela,0,1,,1,POINT (10970933 -74765343)
2017,Septiembre,Venezuela,6905,7574,,14479,POINT (11360029 -72129595)
2017,Septiembre,Venezuela,17,22,,39,POINT (3451668 -76532004)
2017,Septiembre,Venezuela,13,12,,25,POINT (3866713 -67927521)
2017,Septiembre,Venezuela,1620,1720,,3340,POINT (4697157 -74140516)
2017,Septiembre,Venezuela,0,1,,1,POINT (4815189 -75736374)
2017,Septiembre,Venezuela,516,633,,1149,POINT (6170465 -7542726)
2017,Septiembre,Venezuela,30,25,,55,POINT (6185536 -67484028)
2017,Septiembre,Venezuela,186,204,,390,POINT (7088729 -70740253)
2017,Septiembre,Venezuela,1,3,,4,POINT (7128047 -73181317)
2017,Septiembre,Venezuela,20416,24712,,45128,POINT (7819 -72453013)
2017,Septiembre,Venezuela,0,13,,13,POINT (7927233 -72508188)
2017,Septiembre,Venezuela,611,694,,1305,POINT (836068 -72409396)
2017,Octubre,Afganistán,0,1,,1,POINT (10446304 -75516486)
2017,Octubre,Alemania,3,2,,5,POINT (10446304 -75516486)
2017,Octubre,Alemania,2,6,,8,POINT (10886686 -74776479)
2017,Octubre,Alemania,14,28,,42,POINT (3451668 -76532004)
2017,Octubre,Alemania,1648,2706,,4354,POINT (4697157 -74140516)
2017,Octubre,Alemania,1,3,,4,POINT (4815189 -75736374)
2017,Octubre,Alemania,1,2,,3,POINT (7128047 -73181317)
2017,Octubre,Antigua y Barbuda,0,2,,2,POINT (10406342 -75527794)
2017,Octubre,Países Bajos,2,4,,6,POINT (10406342 -75527794)
2017,Octubre,Países Bajos,189,333,,522,POINT (10446304 -75516486)
2017,Octubre,Países Bajos,22,27,,49,POINT (10886686 -74776479)
2017,Octubre,Países Bajos,9,28,,37,POINT (3451668 -76532004)
2017,Octubre,Países Bajos,852,1162,,2014,POINT (4697157 -74140516)
2017,Octubre,Países Bajos,0,1,,1,POINT (4815189 -75736374)
2017,Octubre,Países Bajos,9,23,,32,POINT (6170465 -7542726)
2017,Octubre,Argentina,4,6,,10,POINT (0.81488 -77356)
2017,Octubre,Argentina,95,61,,156,POINT (10446304 -75516486)
2017,Octubre,Argentina,7,36,,43,POINT (10886686 -74776479)
2017,Octubre,Argentina,17,67,,84,POINT (3451668 -76532004)
2017,Octubre,Argentina,1447,2251,,3698,POINT (4697157 -74140516)
2017,Octubre,Argentina,0,4,,4,POINT (4815189 -75736374)
2017,Octubre,Argentina,0,3,,3,POINT (7128047 -73181317)
2017,Octubre,Aruba,2,16,,18,POINT (10406342 -75527794)
2017,Octubre,Aruba,0,1,,1,POINT (10886686 -74776479)
2017,Octubre,Aruba,1,2,,3,POINT (10970933 -74765343)
2017,Octubre,Aruba,21,28,,49,POINT (11247723 -74213989)
2017,Octubre,Aruba,0,3,,3,POINT (1152863 -72919186)
2017,Octubre,Aruba,5,6,,11,POINT (3451668 -76532004)
2017,Octubre,Aruba,839,926,,1765,POINT (4697157 -74140516)
2017,Octubre,Aruba,1,0,,1,POINT (4815189 -75736374)
2017,Octubre,Aruba,14,17,,31,POINT (7128047 -73181317)
2017,Octubre,Australia,0,1,,1,POINT (10446304 -75516486)
2017,Octubre,Australia,3,5,,8,POINT (3451668 -76532004)
2017,Octubre,Austria,0,1,,1,POINT (3451668 -76532004)
2017,Octubre,Bahamas,0,1,,1,POINT (10406342 -75527794)
2017,Octubre,Bahamas,0,1,,1,POINT (10970933 -74765343)
2017,Octubre,Bahamas,1,2,,3,POINT (4697157 -74140516)
2017,Octubre,Bahréin,1,0,,1,POINT (10406342 -75527794)
2017,Octubre,Bahréin,1,0,,1,POINT (10446304 -75516486)
2017,Octubre,Bahréin,1,0,,1,POINT (3451668 -76532004)
2017,Octubre,Barbados,0,1,,1,POINT (3451668 -76532004)
2017,Octubre,Barbados,0,2,,2,POINT (4697157 -74140516)
2017,Octubre,República de Belarús,4,5,,9,POINT (7819 -72453013)
2017,Octubre,Bélgica,5,6,,11,POINT (3451668 -76532004)
2017,Octubre,Bélgica,0,1,,1,POINT (4815189 -75736374)
2017,Octubre,Belice,0,1,,1,POINT (3451668 -76532004)
2017,Octubre,Bermudas/Territorio Británico de Ultramar,3,6,,9,POINT (10406342 -75527794)
2017,Octubre,Bolivia,0,2,,2,POINT (0.81488 -77356)
2017,Octubre,Bolivia,20,13,,33,POINT (10446304 -75516486)
2017,Octubre,Bolivia,19,30,,49,POINT (3451668 -76532004)
2017,Octubre,Bolivia,329,469,,798,POINT (4697157 -74140516)
2017,Octubre,Bolivia,0,10,,10,POINT (6170465 -7542726)
2017,Octubre,Bolivia,10,8,,18,POINT (7128047 -73181317)
2017,Octubre,Brasil,180,197,,377,POINT (-4191162 -69941498)
2017,Octubre,Brasil,1,3,,4,POINT (-4214082 -69941431)
2017,Octubre,Brasil,6,1,,7,POINT (0.81488 -77356)
2017,Octubre,Brasil,1,5,,6,POINT (10406342 -75527794)
2017,Octubre,Brasil,172,121,,293,POINT (10446304 -75516486)
2017,Octubre,Brasil,49,118,,167,POINT (3451668 -76532004)
2017,Octubre,Brasil,3,1,,4,POINT (3866713 -67927521)
2017,Octubre,Brasil,3319,4115,,7434,POINT (4697157 -74140516)
2017,Octubre,Brasil,4,6,,10,POINT (4815189 -75736374)
2017,Octubre,Brasil,0,5,,5,POINT (6170465 -7542726)
2017,Octubre,Brasil,0,1,,1,POINT (7128047 -73181317)
2017,Octubre,Bulgaria,0,1,,1,POINT (4815189 -75736374)
2017,Octubre,Islas Caimán/Territorio Británico de Ultramar,1,0,,1,POINT (3451668 -76532004)
2017,Octubre,Islas Caimán/Territorio Británico de Ultramar,0,5,,5,POINT (4697157 -74140516)
2017,Octubre,Canadá,1,2,,3,POINT (10446304 -75516486)
2017,Octubre,Canadá,1,13,,14,POINT (10886686 -74776479)
2017,Octubre,Canadá,0,6,,6,POINT (11247723 -74213989)
2017,Octubre,Canadá,51,55,,106,POINT (3451668 -76532004)
2017,Octubre,Canadá,0,1,,1,POINT (3884426 -77061029)
2017,Octubre,Canadá,7,25,,32,POINT (4697157 -74140516)
2017,Octubre,Canadá,2,2,,4,POINT (4815189 -75736374)
2017,Octubre,Canadá,0,8,,8,POINT (6170465 -7542726)
2017,Octubre,Canadá,2,1,,3,POINT (7128047 -73181317)
2017,Octubre,España,0,1,,1,POINT (10406342 -75527794)
2017,Octubre,España,1,0,,1,POINT (10446304 -75516486)
2017,Octubre,España,0,6,,6,POINT (11247723 -74213989)
2017,Octubre,España,659,722,,1381,POINT (3451668 -76532004)
2017,Octubre,España,2642,4548,,7190,POINT (4697157 -74140516)
2017,Octubre,España,4,9,,13,POINT (4815189 -75736374)
2017,Octubre,España,401,877,,1278,POINT (6170465 -7542726)
2017,Octubre,España,1,1,,2,POINT (7128047 -73181317)
2017,Octubre,República de Corea,2,0,,2,POINT (10446304 -75516486)
2017,Octubre,República de Corea,2,3,,5,POINT (3451668 -76532004)
2017,Octubre,Costa Rica,15,14,,29,POINT (10406342 -75527794)
2017,Octubre,Costa Rica,12,9,,21,POINT (10446304 -75516486)
2017,Octubre,Costa Rica,51,44,,95,POINT (3451668 -76532004)
2017,Octubre,Costa Rica,1207,1637,,2844,POINT (4697157 -74140516)
2017,Octubre,Costa Rica,4,9,,13,POINT (4815189 -75736374)
2017,Octubre,Costa Rica,2,4,,6,POINT (6170465 -7542726)
2017,Octubre,Costa Rica,2,2,,4,POINT (7128047 -73181317)
2017,Octubre,Cuba,1,6,,7,POINT (10446304 -75516486)
2017,Octubre,Cuba,0,13,,13,POINT (10886686 -74776479)
2017,Octubre,Cuba,0,4,,4,POINT (125862 -81702165)
2017,Octubre,Cuba,21,29,,50,POINT (3451668 -76532004)
2017,Octubre,Cuba,285,518,,803,POINT (4697157 -74140516)
2017,Octubre,Cuba,3,0,,3,POINT (4815189 -75736374)
2017,Octubre,Cuba,2,1,,3,POINT (7128047 -73181317)
2017,Octubre,Curazao,1,15,,16,POINT (4697157 -74140516)
2017,Octubre,República Checa,0,2,,2,POINT (10446304 -75516486)
2017,Octubre,República Checa,1,0,,1,POINT (3451668 -76532004)
2017,Octubre,Chile,1,8,,9,POINT (0.81488 -77356)
2017,Octubre,Chile,32,26,,58,POINT (10446304 -75516486)
2017,Octubre,Chile,21,50,,71,POINT (3451668 -76532004)
2017,Octubre,Chile,4640,5190,,9830,POINT (4697157 -74140516)
2017,Octubre,Chile,6,8,,14,POINT (4815189 -75736374)
2017,Octubre,Chile,1,0,,1,POINT (7128047 -73181317)
2017,Octubre,China,1,0,,1,POINT (3451668 -76532004)
2017,Octubre,Dinamarca,1,1,,2,POINT (3451668 -76532004)
2017,Octubre,Ecuador,1,0,,1,POINT (0.185957 -7478366)
2017,Octubre,Ecuador,141,454,,595,POINT (0.33002 -76876446)
2017,Octubre,Ecuador,2,2,,4,POINT (0.812436 -77847006)
2017,Octubre,Ecuador,3929,5611,,9540,POINT (0.81488 -77356)
2017,Octubre,Ecuador,32,166,,198,POINT (1800143 -78802679)
2017,Octubre,Ecuador,0,13,,13,POINT (10406342 -75527794)
2017,Octubre,Ecuador,7,10,,17,POINT (10446304 -75516486)
2017,Octubre,Ecuador,0,4,,4,POINT (10886686 -74776479)
2017,Octubre,Ecuador,384,494,,878,POINT (3451668 -76532004)
2017,Octubre,Ecuador,0,4,,4,POINT (3884426 -77061029)
2017,Octubre,Ecuador,1029,1677,,2706,POINT (4697157 -74140516)
2017,Octubre,Ecuador,5,13,,18,POINT (4815189 -75736374)
2017,Octubre,Ecuador,0,7,,7,POINT (6170465 -7542726)
2017,Octubre,Ecuador,0,3,,3,POINT (7128047 -73181317)
2017,Octubre,El Salvador,0,2,,2,POINT (10446304 -75516486)
2017,Octubre,El Salvador,91,143,,234,POINT (3451668 -76532004)
2017,Octubre,El Salvador,1361,1936,,3297,POINT (4697157 -74140516)
2017,Octubre,El Salvador,3,2,,5,POINT (4815189 -75736374)
2017,Octubre,El Salvador,351,605,,956,POINT (6170465 -7542726)
2017,Octubre,Emiratos Árabes,1,1,,2,POINT (3451668 -76532004)
2017,Octubre,Emiratos Árabes,0,1,,1,POINT (4815189 -75736374)
2017,Octubre,Eslovaquia,0,1,,1,POINT (3451668 -76532004)
2017,Octubre,Eslovenia,0,1,,1,POINT (3451668 -76532004)
2017,Octubre,Estados Unidos de América,6,46,,52,POINT (10406342 -75527794)
2017,Octubre,Estados Unidos de América,1959,3124,,5083,POINT (10446304 -75516486)
2017,Octubre,Estados Unidos de América,430,870,,1300,POINT (10886686 -74776479)
2017,Octubre,Estados Unidos de América,0,5,,5,POINT (10970933 -74765343)
2017,Octubre,Estados Unidos de América,0,23,,23,POINT (11247723 -74213989)
2017,Octubre,Estados Unidos de América,900,1303,,2203,POINT (3451668 -76532004)
2017,Octubre,Estados Unidos de América,139,272,,411,POINT (445285 -75766353)
2017,Octubre,Estados Unidos de América,6957,13021,,19978,POINT (4697157 -74140516)
2017,Octubre,Estados Unidos de América,65,147,,212,POINT (4815189 -75736374)
2017,Octubre,Estados Unidos de América,1739,4597,,6336,POINT (6170465 -7542726)
2017,Octubre,Estados Unidos de América,15,37,,52,POINT (7128047 -73181317)
2017,Octubre,Estados Unidos de América,0,3,,3,POINT (7927233 -72508188)
2017,Octubre,Estados Unidos de América,0,5,,5,POINT (9402597 -75681642)
2017,Octubre,Filipinas,0,2,,2,POINT (10446304 -75516486)
2017,Octubre,Filipinas,1,4,,5,POINT (3451668 -76532004)
2017,Octubre,Finlandia,1,1,,2,POINT (3451668 -76532004)
2017,Octubre,Finlandia,0,1,,1,POINT (4815189 -75736374)
2017,Octubre,Francia,2,4,,6,POINT (10446304 -75516486)
2017,Octubre,Francia,1,8,,9,POINT (10886686 -74776479)
2017,Octubre,Francia,26,35,,61,POINT (3451668 -76532004)
2017,Octubre,Francia,1434,2115,,3549,POINT (4697157 -74140516)
2017,Octubre,Francia,2,2,,4,POINT (4815189 -75736374)
2017,Octubre,Francia,1,1,,2,POINT (7128047 -73181317)
2017,Octubre,Gibraltar/Territorio Británico de Ultramar,0,1,,1,POINT (0.81488 -77356)
2017,Octubre,Granada,0,1,,1,POINT (4697157 -74140516)
2017,Octubre,Grecia,0,1,,1,POINT (3451668 -76532004)
2017,Octubre,Guatemala,0,1,,1,POINT (10406342 -75527794)
2017,Octubre,Guatemala,8,9,,17,POINT (10446304 -75516486)
2017,Octubre,Guatemala,0,1,,1,POINT (11247723 -74213989)
2017,Octubre,Guatemala,29,67,,96,POINT (3451668 -76532004)
2017,Octubre,Guatemala,4,20,,24,POINT (4697157 -74140516)
2017,Octubre,Guatemala,6,15,,21,POINT (4815189 -75736374)
2017,Octubre,Guatemala,1,3,,4,POINT (7128047 -73181317)
2017,Octubre,Guyana,1,1,,2,POINT (10446304 -75516486)
2017,Octubre,Guyana,0,2,,2,POINT (3451668 -76532004)
2017,Octubre,Guadalupe/Territorio Francés,0,1,,1,POINT (10406342 -75527794)
2017,Octubre,Haití,0,11,,11,POINT (10406342 -75527794)
2017,Octubre,Honduras,9,5,,14,POINT (10446304 -75516486)
2017,Octubre,Honduras,1,5,,6,POINT (125744111 -81703935)
2017,Octubre,Honduras,1,6,,7,POINT (125862 -81702165)
2017,Octubre,Honduras,10,15,,25,POINT (3451668 -76532004)
2017,Octubre,Honduras,1,1,,2,POINT (4815189 -75736374)
2017,Octubre,Honduras,0,1,,1,POINT (7128047 -73181317)
2017,Octubre,India,1,4,,5,POINT (3451668 -76532004)
2017,Octubre,República de Irlanda,0,1,,1,POINT (10970933 -74765343)
2017,Octubre,República de Irlanda,0,1,,1,POINT (3451668 -76532004)
2017,Octubre,Islandia,0,2,,2,POINT (3451668 -76532004)
2017,Octubre,Israel,0,2,,2,POINT (3451668 -76532004)
2017,Octubre,Italia,4,2,,6,POINT (10446304 -75516486)
2017,Octubre,Italia,9,28,,37,POINT (3451668 -76532004)
2017,Octubre,Italia,1,3,,4,POINT (4815189 -75736374)
2017,Octubre,Jamaica,0,10,,10,POINT (10406342 -75527794)
2017,Octubre,Jamaica,0,1,,1,POINT (10446304 -75516486)
2017,Octubre,Jamaica,0,1,,1,POINT (125744111 -81703935)
2017,Octubre,Jamaica,0,1,,1,POINT (4697157 -74140516)
2017,Octubre,Jamaica,1,1,,2,POINT (7128047 -73181317)
2017,Octubre,Japón,1,2,,3,POINT (3451668 -76532004)
2017,Octubre,Kenia,0,1,,1,POINT (3451668 -76532004)
2017,Octubre,Letonia,0,1,,1,POINT (3451668 -76532004)
2017,Octubre,México,0,3,,3,POINT (10406342 -75527794)
2017,Octubre,México,31,60,,91,POINT (10446304 -75516486)
2017,Octubre,México,0,4,,4,POINT (10970933 -74765343)
2017,Octubre,México,0,1,,1,POINT (11247723 -74213989)
2017,Octubre,México,117,196,,313,POINT (3451668 -76532004)
2017,Octubre,México,1,0,,1,POINT (3884426 -77061029)
2017,Octubre,México,4984,7764,,12748,POINT (4697157 -74140516)
2017,Octubre,México,11,67,,78,POINT (4815189 -75736374)
2017,Octubre,México,529,1185,,1714,POINT (6170465 -7542726)
2017,Octubre,México,7,13,,20,POINT (7128047 -73181317)
2017,Octubre,Nicaragua,1,0,,1,POINT (10446304 -75516486)
2017,Octubre,Nicaragua,0,2,,2,POINT (125744111 -81703935)
2017,Octubre,Nicaragua,6,13,,19,POINT (3451668 -76532004)
2017,Octubre,Nicaragua,1,5,,6,POINT (4697157 -74140516)
2017,Octubre,Nicaragua,4,2,,6,POINT (4815189 -75736374)
2017,Octubre,Nicaragua,0,7,,7,POINT (6170465 -7542726)
2017,Octubre,Nicaragua,0,1,,1,POINT (7128047 -73181317)
2017,Octubre,Noruega,0,1,,1,POINT (10446304 -75516486)
2017,Octubre,Noruega,1,3,,4,POINT (3451668 -76532004)
2017,Octubre,Nueva Zelanda,4,3,,7,POINT (3451668 -76532004)
2017,Octubre,Panamá,1159,981,,2140,POINT (10406342 -75527794)
2017,Octubre,Panamá,4610,4652,,9262,POINT (10446304 -75516486)
2017,Octubre,Panamá,516,1046,,1562,POINT (10886686 -74776479)
2017,Octubre,Panamá,0,28,,28,POINT (10970933 -74765343)
2017,Octubre,Panamá,0,10,,10,POINT (11247723 -74213989)
2017,Octubre,Panamá,3,11,,14,POINT (125744111 -81703935)
2017,Octubre,Panamá,1586,1211,,2797,POINT (125862 -81702165)
2017,Octubre,Panamá,0,7,,7,POINT (133387613 -81372937)
2017,Octubre,Panamá,398,622,,1020,POINT (3451668 -76532004)
2017,Octubre,Panamá,0,9,,9,POINT (3884426 -77061029)
2017,Octubre,Panamá,69,94,,163,POINT (445285 -75766353)
2017,Octubre,Panamá,5651,8098,,13749,POINT (4697157 -74140516)
2017,Octubre,Panamá,65,126,,191,POINT (4815189 -75736374)
2017,Octubre,Panamá,2710,4731,,7441,POINT (6170465 -7542726)
2017,Octubre,Panamá,0,3,,3,POINT (7102626 -77762647)
2017,Octubre,Panamá,18,29,,47,POINT (7128047 -73181317)
2017,Octubre,Panamá,0,1,,1,POINT (806667 -767333)
2017,Octubre,Panamá,84,89,,173,POINT (863337 -7735002)
2017,Octubre,Panamá,0,9,,9,POINT (9402597 -75681642)
2017,Octubre,Paraguay,9,12,,21,POINT (10446304 -75516486)
2017,Octubre,Paraguay,9,20,,29,POINT (3451668 -76532004)
2017,Octubre,Paraguay,11,24,,35,POINT (4697157 -74140516)
2017,Octubre,Paraguay,3,3,,6,POINT (4815189 -75736374)
2017,Octubre,Paraguay,0,3,,3,POINT (6170465 -7542726)
2017,Octubre,Perú,71,108,,179,POINT (-4191162 -69941498)
2017,Octubre,Perú,14,32,,46,POINT (-4214082 -69941431)
2017,Octubre,Perú,8,12,,20,POINT (0.185957 -7478366)
2017,Octubre,Perú,47,68,,115,POINT (0.81488 -77356)
2017,Octubre,Perú,1267,1003,,2270,POINT (10446304 -75516486)
2017,Octubre,Perú,0,1,,1,POINT (10886686 -74776479)
2017,Octubre,Perú,349,497,,846,POINT (3451668 -76532004)
2017,Octubre,Perú,0,1,,1,POINT (3884426 -77061029)
2017,Octubre,Perú,3582,4659,,8241,POINT (4697157 -74140516)
2017,Octubre,Perú,2,9,,11,POINT (4815189 -75736374)
2017,Octubre,Perú,430,944,,1374,POINT (6170465 -7542726)
2017,Octubre,Perú,1,1,,2,POINT (7128047 -73181317)
2017,Octubre,Polonia,1,0,,1,POINT (10446304 -75516486)
2017,Octubre,Polonia,0,4,,4,POINT (3451668 -76532004)
2017,Octubre,Portugal,2,2,,4,POINT (10886686 -74776479)
2017,Octubre,Portugal,2,5,,7,POINT (3451668 -76532004)
2017,Octubre,Portugal,9,20,,29,POINT (4697157 -74140516)
2017,Octubre,Puerto Rico/Territorio de Estados Unidos,0,3,,3,POINT (10446304 -75516486)
2017,Octubre,Puerto Rico/Territorio de Estados Unidos,0,3,,3,POINT (10970933 -74765343)
2017,Octubre,Puerto Rico/Territorio de Estados Unidos,36,49,,85,POINT (3451668 -76532004)
2017,Octubre,Puerto Rico/Territorio de Estados Unidos,31,47,,78,POINT (4697157 -74140516)
2017,Octubre,Puerto Rico/Territorio de Estados Unidos,2,4,,6,POINT (4815189 -75736374)
2017,Octubre,Puerto Rico/Territorio de Estados Unidos,0,33,,33,POINT (6170465 -7542726)
2017,Octubre,Puerto Rico/Territorio de Estados Unidos,3,2,,5,POINT (7128047 -73181317)
2017,Octubre,Reino Unido de Gran Bretaña e Irlanda del Norte,6,14,,20,POINT (3451668 -76532004)
2017,Octubre,Reino Unido de Gran Bretaña e Irlanda del Norte,741,1154,,1895,POINT (4697157 -74140516)
2017,Octubre,Reino Unido de Gran Bretaña e Irlanda del Norte,0,4,,4,POINT (4815189 -75736374)
2017,Octubre,Reino Unido de Gran Bretaña e Irlanda del Norte,1,5,,6,POINT (6170465 -7542726)
2017,Octubre,Federación de Rusia,1,1,,2,POINT (3451668 -76532004)
2017,Octubre,Federación de Rusia,0,1,,1,POINT (7128047 -73181317)
2017,Octubre,República Dominicana,2,14,,16,POINT (10406342 -75527794)
2017,Octubre,República Dominicana,2,7,,9,POINT (10446304 -75516486)
2017,Octubre,República Dominicana,0,2,,2,POINT (10886686 -74776479)
2017,Octubre,República Dominicana,0,1,,1,POINT (11247723 -74213989)
2017,Octubre,República Dominicana,21,35,,56,POINT (3451668 -76532004)
2017,Octubre,República Dominicana,683,800,,1483,POINT (4697157 -74140516)
2017,Octubre,República Dominicana,4,7,,11,POINT (4815189 -75736374)
2017,Octubre,República Dominicana,4,13,,17,POINT (7128047 -73181317)
2017,Octubre,República Dominicana,0,1,,1,POINT (806667 -767333)
2017,Octubre,San  Vicente y las Granadinas,0,1,,1,POINT (4697157 -74140516)
2017,Octubre,Santa Lucia,0,2,,2,POINT (9402597 -75681642)
2017,Octubre,Senegal,0,7,,7,POINT (10970933 -74765343)
2017,Octubre,Singapur,0,3,,3,POINT (3451668 -76532004)
2017,Octubre,Sudáfrica,0,1,,1,POINT (10970933 -74765343)
2017,Octubre,Suecia,2,6,,8,POINT (10446304 -75516486)
2017,Octubre,Suecia,1,3,,4,POINT (3451668 -76532004)
2017,Octubre,Suecia,0,1,,1,POINT (7128047 -73181317)
2017,Octubre,Suiza,7,15,,22,POINT (3451668 -76532004)
2017,Octubre,Suiza,1,5,,6,POINT (4815189 -75736374)
2017,Octubre,Suiza,1,1,,2,POINT (7128047 -73181317)
2017,Octubre,Surinam,0,1,,1,POINT (806667 -767333)
2017,Octubre,Taiwán,0,6,,6,POINT (3451668 -76532004)
2017,Octubre,Trinidad y Tobago,1,3,,4,POINT (3451668 -76532004)
2017,Octubre,Trinidad y Tobago,0,7,,7,POINT (4697157 -74140516)
2017,Octubre,Trinidad y Tobago,0,1,,1,POINT (4815189 -75736374)
2017,Octubre,Trinidad y Tobago,0,1,,1,POINT (7128047 -73181317)
2017,Octubre,Turquía,2,2,,4,POINT (3451668 -76532004)
2017,Octubre,Turquía,233,371,,604,POINT (4697157 -74140516)
2017,Octubre,Ucrania,0,1,,1,POINT (3451668 -76532004)
2017,Octubre,Uruguay,18,6,,24,POINT (10446304 -75516486)
2017,Octubre,Uruguay,13,28,,41,POINT (3451668 -76532004)
2017,Octubre,Uruguay,5,10,,15,POINT (4697157 -74140516)
2017,Octubre,Venezuela,0,17,,17,POINT (10406342 -75527794)
2017,Octubre,Venezuela,3,18,,21,POINT (10446304 -75516486)
2017,Octubre,Venezuela,4,16,,20,POINT (10886686 -74776479)
2017,Octubre,Venezuela,0,1,,1,POINT (10970933 -74765343)
2017,Octubre,Venezuela,0,5,,5,POINT (11117206 -74232675)
2017,Octubre,Venezuela,6655,7340,,13995,POINT (11360029 -72129595)
2017,Octubre,Venezuela,12,50,,62,POINT (3451668 -76532004)
2017,Octubre,Venezuela,12,13,,25,POINT (3866713 -67927521)
2017,Octubre,Venezuela,173,354,,527,POINT (4697157 -74140516)
2017,Octubre,Venezuela,3,9,,12,POINT (4815189 -75736374)
2017,Octubre,Venezuela,526,646,,1172,POINT (6170465 -7542726)
2017,Octubre,Venezuela,15,24,,39,POINT (6185536 -67484028)
2017,Octubre,Venezuela,202,283,,485,POINT (7088729 -70740253)
2017,Octubre,Venezuela,1,7,,8,POINT (7128047 -73181317)
2017,Octubre,Venezuela,22981,28522,,51503,POINT (7819 -72453013)
2017,Octubre,Venezuela,4,65,,69,POINT (7927233 -72508188)
2017,Octubre,Venezuela,665,747,,1412,POINT (836068 -72409396)
2017,Octubre,Venezuela,0,7,,7,POINT (9402597 -75681642)
2017,Noviembre,Afganistán,2,0,,2,POINT (4697157 -74140516)
2017,Noviembre,Albania,1,0,,1,POINT (3451668 -76532004)
2017,Noviembre,Alemania,0,1,,1,POINT (0.81488 -77356)
2017,Noviembre,Alemania,0,4,,4,POINT (10406342 -75527794)
2017,Noviembre,Alemania,3,3,,6,POINT (10446304 -75516486)
2017,Noviembre,Alemania,8,4,,12,POINT (10886686 -74776479)
2017,Noviembre,Alemania,4,5,,9,POINT (125862 -81702165)
2017,Noviembre,Alemania,22,22,,44,POINT (3451668 -76532004)
2017,Noviembre,Alemania,1440,2403,,3843,POINT (4697157 -74140516)
2017,Noviembre,Alemania,2,2,,4,POINT (4815189 -75736374)
2017,Noviembre,Alemania,27,61,,88,POINT (6170465 -7542726)
2017,Noviembre,Alemania,1,2,,3,POINT (7128047 -73181317)
2017,Noviembre,Andorra,0,2,,2,POINT (4697157 -74140516)
2017,Noviembre,Andorra,0,1,,1,POINT (6170465 -7542726)
2017,Noviembre,Antigua y Barbuda,0,4,,4,POINT (10406342 -75527794)
2017,Noviembre,Antigua y Barbuda,0,1,,1,POINT (6170465 -7542726)
2017,Noviembre,Países Bajos,15,256,,271,POINT (10406342 -75527794)
2017,Noviembre,Países Bajos,212,373,,585,POINT (10446304 -75516486)
2017,Noviembre,Países Bajos,4,12,,16,POINT (10886686 -74776479)
2017,Noviembre,Países Bajos,0,1,,1,POINT (10970933 -74765343)
2017,Noviembre,Países Bajos,0,3,,3,POINT (125862 -81702165)
2017,Noviembre,Países Bajos,13,20,,33,POINT (3451668 -76532004)
2017,Noviembre,Países Bajos,1004,1411,,2415,POINT (4697157 -74140516)
2017,Noviembre,Países Bajos,2,6,,8,POINT (4815189 -75736374)
2017,Noviembre,Países Bajos,100,145,,245,POINT (6170465 -7542726)
2017,Noviembre,Arabia Saudita,0,2,,2,POINT (4697157 -74140516)
2017,Noviembre,Argelia,2,3,,5,POINT (4697157 -74140516)
2017,Noviembre,Argentina,4,6,,10,POINT (0.81488 -77356)
2017,Noviembre,Argentina,126,88,,214,POINT (10446304 -75516486)
2017,Noviembre,Argentina,4,5,,9,POINT (10886686 -74776479)
2017,Noviembre,Argentina,0,2,,2,POINT (10970933 -74765343)
2017,Noviembre,Argentina,157,95,,252,POINT (125862 -81702165)
2017,Noviembre,Argentina,36,70,,106,POINT (3451668 -76532004)
2017,Noviembre,Argentina,0,8,,8,POINT (3884426 -77061029)
2017,Noviembre,Argentina,3224,4160,,7384,POINT (4697157 -74140516)
2017,Noviembre,Argentina,9,13,,22,POINT (4815189 -75736374)
2017,Noviembre,Argentina,58,140,,198,POINT (6170465 -7542726)
2017,Noviembre,Argentina,0,1,,1,POINT (7128047 -73181317)
2017,Noviembre,Aruba,5,224,,229,POINT (10406342 -75527794)
2017,Noviembre,Aruba,0,1,,1,POINT (10446304 -75516486)
2017,Noviembre,Aruba,1,0,,1,POINT (10886686 -74776479)
2017,Noviembre,Aruba,40,66,,106,POINT (11247723 -74213989)
2017,Noviembre,Aruba,2,3,,5,POINT (1152863 -72919186)
2017,Noviembre,Aruba,0,1,,1,POINT (12165168 -71983761)
2017,Noviembre,Aruba,4,3,,7,POINT (3451668 -76532004)
2017,Noviembre,Aruba,673,844,,1517,POINT (4697157 -74140516)
2017,Noviembre,Aruba,1,3,,4,POINT (4815189 -75736374)
2017,Noviembre,Aruba,22,38,,60,POINT (6170465 -7542726)
2017,Noviembre,Aruba,6,6,,12,POINT (7128047 -73181317)
2017,Noviembre,Australia,1,0,,1,POINT (0.81488 -77356)
2017,Noviembre,Australia,4,4,,8,POINT (10886686 -74776479)
2017,Noviembre,Australia,0,1,,1,POINT (125862 -81702165)
2017,Noviembre,Australia,7,14,,21,POINT (3451668 -76532004)
2017,Noviembre,Australia,68,99,,167,POINT (4697157 -74140516)
2017,Noviembre,Australia,15,15,,30,POINT (6170465 -7542726)
2017,Noviembre,Australia,0,3,,3,POINT (7128047 -73181317)
2017,Noviembre,Austria,0,1,,1,POINT (3451668 -76532004)
2017,Noviembre,Austria,21,47,,68,POINT (4697157 -74140516)
2017,Noviembre,Austria,1,5,,6,POINT (6170465 -7542726)
2017,Noviembre,Azerbaiyán,1,0,,1,POINT (4697157 -74140516)
2017,Noviembre,Bahamas,12,22,,34,POINT (10406342 -75527794)
2017,Noviembre,Bahamas,3,3,,6,POINT (10446304 -75516486)
2017,Noviembre,Bahamas,0,2,,2,POINT (10886686 -74776479)
2017,Noviembre,Bahamas,1,1,,2,POINT (4697157 -74140516)
2017,Noviembre,Bahamas,0,1,,1,POINT (6170465 -7542726)
2017,Noviembre,Bahréin,0,1,,1,POINT (10446304 -75516486)
2017,Noviembre,Bahréin,0,1,,1,POINT (6170465 -7542726)
2017,Noviembre,Bahréin,1,0,,1,POINT (7819 -72453013)
2017,Noviembre,Barbados,1,8,,9,POINT (10886686 -74776479)
2017,Noviembre,Barbados,0,5,,5,POINT (4697157 -74140516)
2017,Noviembre,Barbados,0,1,,1,POINT (6170465 -7542726)
2017,Noviembre,República de Belarús,6,13,,19,POINT (7819 -72453013)
2017,Noviembre,Bélgica,0,2,,2,POINT (10446304 -75516486)
2017,Noviembre,Bélgica,0,1,,1,POINT (10886686 -74776479)
2017,Noviembre,Bélgica,0,1,,1,POINT (11247723 -74213989)
2017,Noviembre,Bélgica,6,9,,15,POINT (3451668 -76532004)
2017,Noviembre,Bélgica,44,68,,112,POINT (4697157 -74140516)
2017,Noviembre,Bélgica,9,10,,19,POINT (6170465 -7542726)
2017,Noviembre,Bélgica,1,0,,1,POINT (836068 -72409396)
2017,Noviembre,Belice,1,1,,2,POINT (10886686 -74776479)
2017,Noviembre,Belice,0,2,,2,POINT (4697157 -74140516)
2017,Noviembre,Belice,1,2,,3,POINT (6170465 -7542726)
2017,Noviembre,Benín,1,0,,1,POINT (10446304 -75516486)
2017,Noviembre,Benín,1,0,,1,POINT (4697157 -74140516)
2017,Noviembre,Bermudas/Territorio Británico de Ultramar,0,1,,1,POINT (6170465 -7542726)
2017,Noviembre,Bolivia,12,15,,27,POINT (10446304 -75516486)
2017,Noviembre,Bolivia,2,6,,8,POINT (10886686 -74776479)
2017,Noviembre,Bolivia,14,8,,22,POINT (125862 -81702165)
2017,Noviembre,Bolivia,28,34,,62,POINT (3451668 -76532004)
2017,Noviembre,Bolivia,615,776,,1391,POINT (4697157 -74140516)
2017,Noviembre,Bolivia,64,64,,128,POINT (6170465 -7542726)
2017,Noviembre,Bosnia y Herzegovina,0,1,,1,POINT (4697157 -74140516)
2017,Noviembre,Brasil,145,163,,308,POINT (-4191162 -69941498)
2017,Noviembre,Brasil,11,16,,27,POINT (-4214082 -69941431)
2017,Noviembre,Brasil,1,1,,2,POINT (0.81488 -77356)
2017,Noviembre,Brasil,0,3,,3,POINT (10406342 -75527794)
2017,Noviembre,Brasil,110,95,,205,POINT (10446304 -75516486)
2017,Noviembre,Brasil,5,56,,61,POINT (10886686 -74776479)
2017,Noviembre,Brasil,0,2,,2,POINT (11247723 -74213989)
2017,Noviembre,Brasil,374,298,,672,POINT (125862 -81702165)
2017,Noviembre,Brasil,72,114,,186,POINT (3451668 -76532004)
2017,Noviembre,Brasil,2,1,,3,POINT (3866713 -67927521)
2017,Noviembre,Brasil,5119,6075,,11194,POINT (4697157 -74140516)
2017,Noviembre,Brasil,1,8,,9,POINT (4815189 -75736374)
2017,Noviembre,Brasil,116,238,,354,POINT (6170465 -7542726)
2017,Noviembre,Brasil,1,0,,1,POINT (7128047 -73181317)
2017,Noviembre,Bulgaria,2,3,,5,POINT (4697157 -74140516)
2017,Noviembre,Bulgaria,0,2,,2,POINT (6170465 -7542726)
2017,Noviembre,Islas Caimán/Territorio Británico de Ultramar,0,9,,9,POINT (10406342 -75527794)
2017,Noviembre,Islas Caimán/Territorio Británico de Ultramar,1,3,,4,POINT (10886686 -74776479)
2017,Noviembre,Islas Caimán/Territorio Británico de Ultramar,0,1,,1,POINT (133387613 -81372937)
2017,Noviembre,Islas Caimán/Territorio Británico de Ultramar,0,1,,1,POINT (4697157 -74140516)
2017,Noviembre,Camboya,0,1,,1,POINT (4697157 -74140516)
2017,Noviembre,Camerún,1,0,,1,POINT (6170465 -7542726)
2017,Noviembre,Canadá,16,27,,43,POINT (10446304 -75516486)
2017,Noviembre,Canadá,7,17,,24,POINT (10886686 -74776479)
2017,Noviembre,Canadá,0,1,,1,POINT (10970933 -74765343)
2017,Noviembre,Canadá,0,1,,1,POINT (125862 -81702165)
2017,Noviembre,Canadá,48,54,,102,POINT (3451668 -76532004)
2017,Noviembre,Canadá,659,1047,,1706,POINT (4697157 -74140516)
2017,Noviembre,Canadá,1,7,,8,POINT (4815189 -75736374)
2017,Noviembre,Canadá,121,246,,367,POINT (6170465 -7542726)
2017,Noviembre,Canadá,6,6,,12,POINT (7128047 -73181317)
2017,Noviembre,España,2,4,,6,POINT (10446304 -75516486)
2017,Noviembre,España,3,4,,7,POINT (10886686 -74776479)
2017,Noviembre,España,0,3,,3,POINT (125862 -81702165)
2017,Noviembre,España,787,951,,1738,POINT (3451668 -76532004)
2017,Noviembre,España,0,1,,1,POINT (3884426 -77061029)
2017,Noviembre,España,3622,6407,,10029,POINT (4697157 -74140516)
2017,Noviembre,España,3,5,,8,POINT (4815189 -75736374)
2017,Noviembre,España,322,676,,998,POINT (6170465 -7542726)
2017,Noviembre,España,0,1,,1,POINT (7128047 -73181317)
2017,Noviembre,República Del Congo,2,0,,2,POINT (4697157 -74140516)
2017,Noviembre,Comoras,0,1,,1,POINT (4697157 -74140516)
2017,Noviembre,República Democrática del Congo,1,0,,1,POINT (4697157 -74140516)
2017,Noviembre,República de Corea,1,1,,2,POINT (10446304 -75516486)
2017,Noviembre,República de Corea,0,1,,1,POINT (3451668 -76532004)
2017,Noviembre,República de Corea,9,33,,42,POINT (4697157 -74140516)
2017,Noviembre,República de Corea,2,5,,7,POINT (6170465 -7542726)
2017,Noviembre,Costa de Marfil,0,1,,1,POINT (10446304 -75516486)
2017,Noviembre,Costa de Marfil,3,8,,11,POINT (4697157 -74140516)
2017,Noviembre,Costa Rica,7,41,,48,POINT (10406342 -75527794)
2017,Noviembre,Costa Rica,7,5,,12,POINT (10446304 -75516486)
2017,Noviembre,Costa Rica,9,23,,32,POINT (10886686 -74776479)
2017,Noviembre,Costa Rica,38,15,,53,POINT (125862 -81702165)
2017,Noviembre,Costa Rica,48,63,,111,POINT (3451668 -76532004)
2017,Noviembre,Costa Rica,1298,1960,,3258,POINT (4697157 -74140516)
2017,Noviembre,Costa Rica,4,6,,10,POINT (4815189 -75736374)
2017,Noviembre,Costa Rica,121,208,,329,POINT (6170465 -7542726)
2017,Noviembre,Costa Rica,0,4,,4,POINT (7128047 -73181317)
2017,Noviembre,Croacia,0,1,,1,POINT (3451668 -76532004)
2017,Noviembre,Croacia,2,11,,13,POINT (4697157 -74140516)
2017,Noviembre,Cuba,3,4,,7,POINT (10446304 -75516486)
2017,Noviembre,Cuba,9,12,,21,POINT (10886686 -74776479)
2017,Noviembre,Cuba,1,1,,2,POINT (125862 -81702165)
2017,Noviembre,Cuba,12,14,,26,POINT (3451668 -76532004)
2017,Noviembre,Cuba,339,610,,949,POINT (4697157 -74140516)
2017,Noviembre,Cuba,1,2,,3,POINT (4815189 -75736374)
2017,Noviembre,Cuba,22,12,,34,POINT (6170465 -7542726)
2017,Noviembre,Cuba,1,4,,5,POINT (7128047 -73181317)
2017,Noviembre,Curazao,6,18,,24,POINT (4697157 -74140516)
2017,Noviembre,República Checa,13,23,,36,POINT (4697157 -74140516)
2017,Noviembre,República Checa,0,2,,2,POINT (6170465 -7542726)
2017,Noviembre,Chile,7,9,,16,POINT (0.81488 -77356)
2017,Noviembre,Chile,51,28,,79,POINT (10446304 -75516486)
2017,Noviembre,Chile,3,6,,9,POINT (10886686 -74776479)
2017,Noviembre,Chile,40,30,,70,POINT (125862 -81702165)
2017,Noviembre,Chile,37,68,,105,POINT (3451668 -76532004)
2017,Noviembre,Chile,5138,6235,,11373,POINT (4697157 -74140516)
2017,Noviembre,Chile,2,2,,4,POINT (4815189 -75736374)
2017,Noviembre,Chile,19,89,,108,POINT (6170465 -7542726)
2017,Noviembre,Chile,2,0,,2,POINT (7128047 -73181317)
2017,Noviembre,China,1,0,,1,POINT (10886686 -74776479)
2017,Noviembre,China,2,3,,5,POINT (3451668 -76532004)
2017,Noviembre,China,25,69,,94,POINT (4697157 -74140516)
2017,Noviembre,China,0,2,,2,POINT (4815189 -75736374)
2017,Noviembre,China,5,19,,24,POINT (6170465 -7542726)
2017,Noviembre,Chipre,1,1,,2,POINT (4697157 -74140516)
2017,Noviembre,Dinamarca,0,3,,3,POINT (3451668 -76532004)
2017,Noviembre,Dinamarca,11,22,,33,POINT (4697157 -74140516)
2017,Noviembre,Dinamarca,1,1,,2,POINT (4815189 -75736374)
2017,Noviembre,Dinamarca,1,5,,6,POINT (6170465 -7542726)
2017,Noviembre,Dominica,1,1,,2,POINT (4697157 -74140516)
2017,Noviembre,Dominica,0,1,,1,POINT (6170465 -7542726)
2017,Noviembre,Ecuador,2,6,,8,POINT (0.185957 -7478366)
2017,Noviembre,Ecuador,165,424,,589,POINT (0.33002 -76876446)
2017,Noviembre,Ecuador,3,6,,9,POINT (0.812436 -77847006)
2017,Noviembre,Ecuador,4922,6346,,11268,POINT (0.81488 -77356)
2017,Noviembre,Ecuador,34,114,,148,POINT (1800143 -78802679)
2017,Noviembre,Ecuador,15,12,,27,POINT (10446304 -75516486)
2017,Noviembre,Ecuador,1,13,,14,POINT (10886686 -74776479)
2017,Noviembre,Ecuador,6,8,,14,POINT (125862 -81702165)
2017,Noviembre,Ecuador,493,563,,1056,POINT (3451668 -76532004)
2017,Noviembre,Ecuador,0,4,,4,POINT (3884426 -77061029)
2017,Noviembre,Ecuador,2798,4751,,7549,POINT (4697157 -74140516)
2017,Noviembre,Ecuador,2,7,,9,POINT (4815189 -75736374)
2017,Noviembre,Ecuador,41,64,,105,POINT (6170465 -7542726)
2017,Noviembre,Ecuador,1,1,,2,POINT (7128047 -73181317)
2017,Noviembre,Ecuador,1,0,,1,POINT (7819 -72453013)
2017,Noviembre,Egipto,0,1,,1,POINT (3451668 -76532004)
2017,Noviembre,Egipto,0,3,,3,POINT (4697157 -74140516)
2017,Noviembre,El Salvador,3,6,,9,POINT (10446304 -75516486)
2017,Noviembre,El Salvador,1,2,,3,POINT (10886686 -74776479)
2017,Noviembre,El Salvador,0,4,,4,POINT (11117206 -74232675)
2017,Noviembre,El Salvador,2,2,,4,POINT (125862 -81702165)
2017,Noviembre,El Salvador,159,194,,353,POINT (3451668 -76532004)
2017,Noviembre,El Salvador,1164,1729,,2893,POINT (4697157 -74140516)
2017,Noviembre,El Salvador,0,3,,3,POINT (4815189 -75736374)
2017,Noviembre,El Salvador,206,394,,600,POINT (6170465 -7542726)
2017,Noviembre,Emiratos Árabes,1,0,,1,POINT (10886686 -74776479)
2017,Noviembre,Emiratos Árabes,0,10,,10,POINT (4253669 -74642361)
2017,Noviembre,Emiratos Árabes,1,5,,6,POINT (4697157 -74140516)
2017,Noviembre,Emiratos Árabes,0,1,,1,POINT (6170465 -7542726)
2017,Noviembre,Eslovaquia,1,1,,2,POINT (3451668 -76532004)
2017,Noviembre,Eslovaquia,0,8,,8,POINT (4697157 -74140516)
2017,Noviembre,Eslovaquia,1,0,,1,POINT (6170465 -7542726)
2017,Noviembre,Eslovaquia,0,1,,1,POINT (7128047 -73181317)
2017,Noviembre,Eslovenia,6,8,,14,POINT (4697157 -74140516)
2017,Noviembre,Eslovenia,1,2,,3,POINT (6170465 -7542726)
2017,Noviembre,Estados Unidos de América,2,37,,39,POINT (10406342 -75527794)
2017,Noviembre,Estados Unidos de América,2370,3389,,5759,POINT (10446304 -75516486)
2017,Noviembre,Estados Unidos de América,544,1030,,1574,POINT (10886686 -74776479)
2017,Noviembre,Estados Unidos de América,0,2,,2,POINT (10970933 -74765343)
2017,Noviembre,Estados Unidos de América,0,14,,14,POINT (11247723 -74213989)
2017,Noviembre,Estados Unidos de América,0,2,,2,POINT (125744111 -81703935)
2017,Noviembre,Estados Unidos de América,12,17,,29,POINT (125862 -81702165)
2017,Noviembre,Estados Unidos de América,984,1512,,2496,POINT (3451668 -76532004)
2017,Noviembre,Estados Unidos de América,92,152,,244,POINT (445285 -75766353)
2017,Noviembre,Estados Unidos de América,9500,16697,,26197,POINT (4697157 -74140516)
2017,Noviembre,Estados Unidos de América,91,127,,218,POINT (4815189 -75736374)
2017,Noviembre,Estados Unidos de América,2598,6302,,8900,POINT (6170465 -7542726)
2017,Noviembre,Estados Unidos de América,16,51,,67,POINT (7128047 -73181317)
2017,Noviembre,Estados Unidos de América,0,2,,2,POINT (7927233 -72508188)
2017,Noviembre,Estados Unidos de América,0,7,,7,POINT (9402597 -75681642)
2017,Noviembre,Estonia,0,5,,5,POINT (4697157 -74140516)
2017,Noviembre,Estonia,1,0,,1,POINT (6170465 -7542726)
2017,Noviembre,Filipinas,0,1,,1,POINT (10406342 -75527794)
2017,Noviembre,Filipinas,0,3,,3,POINT (10446304 -75516486)
2017,Noviembre,Filipinas,0,2,,2,POINT (3451668 -76532004)
2017,Noviembre,Filipinas,0,1,,1,POINT (3884426 -77061029)
2017,Noviembre,Filipinas,3,6,,9,POINT (4697157 -74140516)
2017,Noviembre,Filipinas,1,1,,2,POINT (6170465 -7542726)
2017,Noviembre,Finlandia,0,1,,1,POINT (10446304 -75516486)
2017,Noviembre,Finlandia,5,9,,14,POINT (4697157 -74140516)
2017,Noviembre,Finlandia,1,2,,3,POINT (6170465 -7542726)
2017,Noviembre,Francia,3,3,,6,POINT (10446304 -75516486)
2017,Noviembre,Francia,1,6,,7,POINT (10886686 -74776479)
2017,Noviembre,Francia,23,36,,59,POINT (3451668 -76532004)
2017,Noviembre,Francia,1527,2381,,3908,POINT (4697157 -74140516)
2017,Noviembre,Francia,39,53,,92,POINT (6170465 -7542726)
2017,Noviembre,Francia,0,1,,1,POINT (7128047 -73181317)
2017,Noviembre,Georgia,0,1,,1,POINT (4697157 -74140516)
2017,Noviembre,Ghana,0,1,,1,POINT (4697157 -74140516)
2017,Noviembre,Ghana,0,1,,1,POINT (6170465 -7542726)
2017,Noviembre,Gibraltar/Territorio Británico de Ultramar,2,4,,6,POINT (0.81488 -77356)
2017,Noviembre,Gibraltar/Territorio Británico de Ultramar,0,4,,4,POINT (10406342 -75527794)
2017,Noviembre,Granada,0,2,,2,POINT (10886686 -74776479)
2017,Noviembre,Granada,0,1,,1,POINT (6170465 -7542726)
2017,Noviembre,Grecia,2,6,,8,POINT (3451668 -76532004)
2017,Noviembre,Grecia,3,13,,16,POINT (4697157 -74140516)
2017,Noviembre,Grecia,1,0,,1,POINT (6170465 -7542726)
2017,Noviembre,Guatemala,14,9,,23,POINT (10446304 -75516486)
2017,Noviembre,Guatemala,4,8,,12,POINT (10886686 -74776479)
2017,Noviembre,Guatemala,0,1,,1,POINT (10970933 -74765343)
2017,Noviembre,Guatemala,6,4,,10,POINT (125862 -81702165)
2017,Noviembre,Guatemala,1,1,,2,POINT (133387613 -81372937)
2017,Noviembre,Guatemala,61,94,,155,POINT (3451668 -76532004)
2017,Noviembre,Guatemala,164,254,,418,POINT (4697157 -74140516)
2017,Noviembre,Guatemala,3,6,,9,POINT (4815189 -75736374)
2017,Noviembre,Guatemala,78,144,,222,POINT (6170465 -7542726)
2017,Noviembre,Guatemala,7,6,,13,POINT (7128047 -73181317)
2017,Noviembre,Guyana,0,2,,2,POINT (125862 -81702165)
2017,Noviembre,Guyana,0,1,,1,POINT (3451668 -76532004)
2017,Noviembre,Guyana,0,1,,1,POINT (6170465 -7542726)
2017,Noviembre,Guadalupe/Territorio Francés,0,1,,1,POINT (10446304 -75516486)
2017,Noviembre,Guadalupe/Territorio Francés,0,1,,1,POINT (3451668 -76532004)
2017,Noviembre,Guadalupe/Territorio Francés,0,1,,1,POINT (4697157 -74140516)
2017,Noviembre,Haití,0,1,,1,POINT (10406342 -75527794)
2017,Noviembre,Haití,1,2,,3,POINT (4697157 -74140516)
2017,Noviembre,Haití,0,1,,1,POINT (6170465 -7542726)
2017,Noviembre,Honduras,0,7,,7,POINT (10406342 -75527794)
2017,Noviembre,Honduras,1,1,,2,POINT (10446304 -75516486)
2017,Noviembre,Honduras,1,6,,7,POINT (10886686 -74776479)
2017,Noviembre,Honduras,1,2,,3,POINT (133387613 -81372937)
2017,Noviembre,Honduras,20,25,,45,POINT (3451668 -76532004)
2017,Noviembre,Honduras,41,66,,107,POINT (4697157 -74140516)
2017,Noviembre,Honduras,0,2,,2,POINT (4815189 -75736374)
2017,Noviembre,Honduras,25,47,,72,POINT (6170465 -7542726)
2017,Noviembre,Hong Kong,1,3,,4,POINT (4697157 -74140516)
2017,Noviembre,Hong Kong,0,2,,2,POINT (6170465 -7542726)
2017,Noviembre,Hungría,6,8,,14,POINT (4697157 -74140516)
2017,Noviembre,Hungría,1,0,,1,POINT (6170465 -7542726)
2017,Noviembre,India,0,1,,1,POINT (10446304 -75516486)
2017,Noviembre,India,0,2,,2,POINT (10886686 -74776479)
2017,Noviembre,India,0,5,,5,POINT (3451668 -76532004)
2017,Noviembre,India,3,31,,34,POINT (4697157 -74140516)
2017,Noviembre,India,0,6,,6,POINT (6170465 -7542726)
2017,Noviembre,Indonesia,0,1,,1,POINT (4697157 -74140516)
2017,Noviembre,República de Irlanda,4,17,,21,POINT (4697157 -74140516)
2017,Noviembre,República de Irlanda,1,3,,4,POINT (6170465 -7542726)
2017,Noviembre,Islandia,1,0,,1,POINT (4697157 -74140516)
2017,Noviembre,Isla de Man,0,1,,1,POINT (4697157 -74140516)
2017,Noviembre,Israel,0,1,,1,POINT (10886686 -74776479)
2017,Noviembre,Israel,1,2,,3,POINT (3451668 -76532004)
2017,Noviembre,Israel,17,69,,86,POINT (4697157 -74140516)
2017,Noviembre,Israel,0,2,,2,POINT (6170465 -7542726)
2017,Noviembre,Italia,3,7,,10,POINT (10446304 -75516486)
2017,Noviembre,Italia,1,2,,3,POINT (10886686 -74776479)
2017,Noviembre,Italia,0,1,,1,POINT (125862 -81702165)
2017,Noviembre,Italia,10,40,,50,POINT (3451668 -76532004)
2017,Noviembre,Italia,89,218,,307,POINT (4697157 -74140516)
2017,Noviembre,Italia,0,4,,4,POINT (4815189 -75736374)
2017,Noviembre,Italia,17,58,,75,POINT (6170465 -7542726)
2017,Noviembre,Jamaica,0,8,,8,POINT (10406342 -75527794)
2017,Noviembre,Jamaica,0,3,,3,POINT (10446304 -75516486)
2017,Noviembre,Jamaica,0,3,,3,POINT (10886686 -74776479)
2017,Noviembre,Jamaica,0,5,,5,POINT (125744111 -81703935)
2017,Noviembre,Jamaica,1,1,,2,POINT (3451668 -76532004)
2017,Noviembre,Jamaica,7,13,,20,POINT (4697157 -74140516)
2017,Noviembre,Jamaica,0,2,,2,POINT (4815189 -75736374)
2017,Noviembre,Jamaica,1,5,,6,POINT (6170465 -7542726)
2017,Noviembre,Jamaica,0,6,,6,POINT (9402597 -75681642)
2017,Noviembre,Japón,1,1,,2,POINT (3451668 -76532004)
2017,Noviembre,Japón,13,28,,41,POINT (4697157 -74140516)
2017,Noviembre,Japón,0,1,,1,POINT (4815189 -75736374)
2017,Noviembre,Japón,4,22,,26,POINT (6170465 -7542726)
2017,Noviembre,Jordania,1,1,,2,POINT (4697157 -74140516)
2017,Noviembre,Kazajistán,1,2,,3,POINT (4697157 -74140516)
2017,Noviembre,Kenia,0,1,,1,POINT (4697157 -74140516)
2017,Noviembre,Kenia,0,1,,1,POINT (6170465 -7542726)
2017,Noviembre,Letonia,6,1,,7,POINT (4697157 -74140516)
2017,Noviembre,Lituania,1,3,,4,POINT (4697157 -74140516)
2017,Noviembre,Líbano,1,0,,1,POINT (3451668 -76532004)
2017,Noviembre,Líbano,1,4,,5,POINT (4697157 -74140516)
2017,Noviembre,Luxemburgo,1,0,,1,POINT (10446304 -75516486)
2017,Noviembre,Luxemburgo,2,3,,5,POINT (4697157 -74140516)
2017,Noviembre,Malasia,4,2,,6,POINT (4697157 -74140516)
2017,Noviembre,Malasia,1,2,,3,POINT (6170465 -7542726)
2017,Noviembre,Malta,1,1,,2,POINT (4697157 -74140516)
2017,Noviembre,Marruecos,0,1,,1,POINT (4697157 -74140516)
2017,Noviembre,Mauritania,0,1,,1,POINT (4697157 -74140516)
2017,Noviembre,Martinica/Departamento de Ultramar Francés,0,1,,1,POINT (10406342 -75527794)
2017,Noviembre,Martinica/Departamento de Ultramar Francés,1,0,,1,POINT (4697157 -74140516)
2017,Noviembre,México,0,11,,11,POINT (10406342 -75527794)
2017,Noviembre,México,26,26,,52,POINT (10446304 -75516486)
2017,Noviembre,México,33,43,,76,POINT (10886686 -74776479)
2017,Noviembre,México,0,6,,6,POINT (11247723 -74213989)
2017,Noviembre,México,4,2,,6,POINT (125862 -81702165)
2017,Noviembre,México,86,186,,272,POINT (3451668 -76532004)
2017,Noviembre,México,0,1,,1,POINT (3884426 -77061029)
2017,Noviembre,México,5497,9295,,14792,POINT (4697157 -74140516)
2017,Noviembre,México,17,34,,51,POINT (4815189 -75736374)
2017,Noviembre,México,785,1788,,2573,POINT (6170465 -7542726)
2017,Noviembre,México,13,39,,52,POINT (7128047 -73181317)
2017,Noviembre,República de Moldavia,1,1,,2,POINT (4697157 -74140516)
2017,Noviembre,Mónaco,0,1,,1,POINT (4697157 -74140516)
2017,Noviembre,Mongolia,0,3,,3,POINT (4697157 -74140516)
2017,Noviembre,Montenegro,0,1,,1,POINT (4697157 -74140516)
2017,Noviembre,Nauru,1,1,,2,POINT (4697157 -74140516)
2017,Noviembre,Nepal,0,1,,1,POINT (6170465 -7542726)
2017,Noviembre,Nicaragua,1,0,,1,POINT (10446304 -75516486)
2017,Noviembre,Nicaragua,1,1,,2,POINT (10886686 -74776479)
2017,Noviembre,Nicaragua,13,23,,36,POINT (3451668 -76532004)
2017,Noviembre,Nicaragua,37,46,,83,POINT (4697157 -74140516)
2017,Noviembre,Nicaragua,6,9,,15,POINT (4815189 -75736374)
2017,Noviembre,Nicaragua,13,54,,67,POINT (6170465 -7542726)
2017,Noviembre,Nicaragua,1,13,,14,POINT (7128047 -73181317)
2017,Noviembre,Nigeria,0,1,,1,POINT (4697157 -74140516)
2017,Noviembre,Noruega,1,2,,3,POINT (3451668 -76532004)
2017,Noviembre,Noruega,20,15,,35,POINT (4697157 -74140516)
2017,Noviembre,Noruega,1,2,,3,POINT (6170465 -7542726)
2017,Noviembre,Noruega,1,0,,1,POINT (7128047 -73181317)
2017,Noviembre,Nueva Caledonia/Territorio francés,0,1,,1,POINT (0.33002 -76876446)
2017,Noviembre,Nueva Zelanda,0,1,,1,POINT (3451668 -76532004)
2017,Noviembre,Nueva Zelanda,11,13,,24,POINT (4697157 -74140516)
2017,Noviembre,Nueva Zelanda,0,4,,4,POINT (6170465 -7542726)
2017,Noviembre,Papúa Nueva Guinea,1,0,,1,POINT (10446304 -75516486)
2017,Noviembre,Panamá,988,950,,1938,POINT (10406342 -75527794)
2017,Noviembre,Panamá,4455,4436,,8891,POINT (10446304 -75516486)
2017,Noviembre,Panamá,407,828,,1235,POINT (10886686 -74776479)
2017,Noviembre,Panamá,0,53,,53,POINT (10970933 -74765343)
2017,Noviembre,Panamá,2,4,,6,POINT (11247723 -74213989)
2017,Noviembre,Panamá,8,26,,34,POINT (125744111 -81703935)
2017,Noviembre,Panamá,834,642,,1476,POINT (125862 -81702165)
2017,Noviembre,Panamá,3,9,,12,POINT (133387613 -81372937)
2017,Noviembre,Panamá,503,618,,1121,POINT (3451668 -76532004)
2017,Noviembre,Panamá,0,31,,31,POINT (3884426 -77061029)
2017,Noviembre,Panamá,73,71,,144,POINT (445285 -75766353)
2017,Noviembre,Panamá,5832,7803,,13635,POINT (4697157 -74140516)
2017,Noviembre,Panamá,106,141,,247,POINT (4815189 -75736374)
2017,Noviembre,Panamá,3580,4085,,7665,POINT (6170465 -7542726)
2017,Noviembre,Panamá,0,2,,2,POINT (6222552 -77401154)
2017,Noviembre,Panamá,0,3,,3,POINT (7102626 -77762647)
2017,Noviembre,Panamá,31,41,,72,POINT (7128047 -73181317)
2017,Noviembre,Panamá,1,0,,1,POINT (7819 -72453013)
2017,Noviembre,Panamá,0,19,,19,POINT (806667 -767333)
2017,Noviembre,Panamá,87,95,,182,POINT (863337 -7735002)
2017,Noviembre,Paraguay,6,6,,12,POINT (10446304 -75516486)
2017,Noviembre,Paraguay,5,11,,16,POINT (10886686 -74776479)
2017,Noviembre,Paraguay,56,43,,99,POINT (125862 -81702165)
2017,Noviembre,Paraguay,4,16,,20,POINT (3451668 -76532004)
2017,Noviembre,Paraguay,83,116,,199,POINT (4697157 -74140516)
2017,Noviembre,Paraguay,1,2,,3,POINT (4815189 -75736374)
2017,Noviembre,Paraguay,11,32,,43,POINT (6170465 -7542726)
2017,Noviembre,Perú,49,55,,104,POINT (-4191162 -69941498)
2017,Noviembre,Perú,103,138,,241,POINT (-4214082 -69941431)
2017,Noviembre,Perú,9,17,,26,POINT (0.185957 -7478366)
2017,Noviembre,Perú,55,89,,144,POINT (0.81488 -77356)
2017,Noviembre,Perú,0,1,,1,POINT (10406342 -75527794)
2017,Noviembre,Perú,1211,1003,,2214,POINT (10446304 -75516486)
2017,Noviembre,Perú,2,3,,5,POINT (10886686 -74776479)
2017,Noviembre,Perú,122,63,,185,POINT (125862 -81702165)
2017,Noviembre,Perú,353,489,,842,POINT (3451668 -76532004)
2017,Noviembre,Perú,0,2,,2,POINT (3884426 -77061029)
2017,Noviembre,Perú,5844,8221,,14065,POINT (4697157 -74140516)
2017,Noviembre,Perú,4,5,,9,POINT (4815189 -75736374)
2017,Noviembre,Perú,398,844,,1242,POINT (6170465 -7542726)
2017,Noviembre,Perú,0,3,,3,POINT (7128047 -73181317)
2017,Noviembre,Polonia,2,1,,3,POINT (10446304 -75516486)
2017,Noviembre,Polonia,35,38,,73,POINT (4697157 -74140516)
2017,Noviembre,Polonia,2,4,,6,POINT (6170465 -7542726)
2017,Noviembre,Portugal,0,2,,2,POINT (10886686 -74776479)
2017,Noviembre,Portugal,5,7,,12,POINT (3451668 -76532004)
2017,Noviembre,Portugal,48,81,,129,POINT (4697157 -74140516)
2017,Noviembre,Portugal,4,8,,12,POINT (6170465 -7542726)
2017,Noviembre,Puerto Rico/Territorio de Estados Unidos,0,1,,1,POINT (10406342 -75527794)
2017,Noviembre,Puerto Rico/Territorio de Estados Unidos,4,6,,10,POINT (10446304 -75516486)
2017,Noviembre,Puerto Rico/Territorio de Estados Unidos,1,11,,12,POINT (10886686 -74776479)
2017,Noviembre,Puerto Rico/Territorio de Estados Unidos,0,2,,2,POINT (125862 -81702165)
2017,Noviembre,Puerto Rico/Territorio de Estados Unidos,10,28,,38,POINT (3451668 -76532004)
2017,Noviembre,Puerto Rico/Territorio de Estados Unidos,419,564,,983,POINT (4697157 -74140516)
2017,Noviembre,Puerto Rico/Territorio de Estados Unidos,7,13,,20,POINT (4815189 -75736374)
2017,Noviembre,Puerto Rico/Territorio de Estados Unidos,40,120,,160,POINT (6170465 -7542726)
2017,Noviembre,Puerto Rico/Territorio de Estados Unidos,0,4,,4,POINT (7128047 -73181317)
2017,Noviembre,Reino Unido de Gran Bretaña e Irlanda del Norte,4,2,,6,POINT (10446304 -75516486)
2017,Noviembre,Reino Unido de Gran Bretaña e Irlanda del Norte,0,3,,3,POINT (10886686 -74776479)
2017,Noviembre,Reino Unido de Gran Bretaña e Irlanda del Norte,10,13,,23,POINT (3451668 -76532004)
2017,Noviembre,Reino Unido de Gran Bretaña e Irlanda del Norte,806,1554,,2360,POINT (4697157 -74140516)
2017,Noviembre,Reino Unido de Gran Bretaña e Irlanda del Norte,19,50,,69,POINT (6170465 -7542726)
2017,Noviembre,República CentroÁfricana,0,1,,1,POINT (4697157 -74140516)
2017,Noviembre,Federación de Rusia,0,1,,1,POINT (10446304 -75516486)
2017,Noviembre,Federación de Rusia,0,1,,1,POINT (10886686 -74776479)
2017,Noviembre,Federación de Rusia,0,1,,1,POINT (3451668 -76532004)
2017,Noviembre,Federación de Rusia,17,26,,43,POINT (4697157 -74140516)
2017,Noviembre,Federación de Rusia,1,1,,2,POINT (6170465 -7542726)
2017,Noviembre,República Dominicana,0,9,,9,POINT (10406342 -75527794)
2017,Noviembre,República Dominicana,1,2,,3,POINT (10446304 -75516486)
2017,Noviembre,República Dominicana,48,111,,159,POINT (10886686 -74776479)
2017,Noviembre,República Dominicana,0,2,,2,POINT (10970933 -74765343)
2017,Noviembre,República Dominicana,0,1,,1,POINT (125862 -81702165)
2017,Noviembre,República Dominicana,18,29,,47,POINT (3451668 -76532004)
2017,Noviembre,República Dominicana,865,1123,,1988,POINT (4697157 -74140516)
2017,Noviembre,República Dominicana,6,13,,19,POINT (4815189 -75736374)
2017,Noviembre,República Dominicana,103,136,,239,POINT (6170465 -7542726)
2017,Noviembre,República Dominicana,3,0,,3,POINT (7128047 -73181317)
2017,Noviembre,Rumania,1,1,,2,POINT (3451668 -76532004)
2017,Noviembre,Rumania,4,5,,9,POINT (4697157 -74140516)
2017,Noviembre,Rumania,0,2,,2,POINT (6170465 -7542726)
2017,Noviembre,San Cristóbal y Nevis,1,1,,2,POINT (125862 -81702165)
2017,Noviembre,San Cristóbal y Nevis,3,2,,5,POINT (4697157 -74140516)
2017,Noviembre,San  Vicente y las Granadinas,1,1,,2,POINT (3451668 -76532004)
2017,Noviembre,Santa Lucia,1,1,,2,POINT (4697157 -74140516)
2017,Noviembre,Santa Lucia,1,3,,4,POINT (6170465 -7542726)
2017,Noviembre,Santa Sede/Ciudad del Vaticano,0,3,,3,POINT (4697157 -74140516)
2017,Noviembre,Senegal,0,1,,1,POINT (10970933 -74765343)
2017,Noviembre,Senegal,1,0,,1,POINT (3451668 -76532004)
2017,Noviembre,Serbia,1,1,,2,POINT (3451668 -76532004)
2017,Noviembre,Serbia,0,1,,1,POINT (4697157 -74140516)
2017,Noviembre,Serbia,1,0,,1,POINT (6170465 -7542726)
2017,Noviembre,Singapur,2,1,,3,POINT (3451668 -76532004)
2017,Noviembre,Singapur,2,5,,7,POINT (4697157 -74140516)
2017,Noviembre,Singapur,1,1,,2,POINT (6170465 -7542726)
2017,Noviembre,Sri Lanka,0,1,,1,POINT (4697157 -74140516)
2017,Noviembre,Sri Lanka,0,1,,1,POINT (6170465 -7542726)
2017,Noviembre,Sudáfrica,1,1,,2,POINT (10886686 -74776479)
2017,Noviembre,Sudáfrica,0,1,,1,POINT (10970933 -74765343)
2017,Noviembre,Sudáfrica,3,14,,17,POINT (4697157 -74140516)
2017,Noviembre,Sudáfrica,0,2,,2,POINT (6170465 -7542726)
2017,Noviembre,Suecia,1,0,,1,POINT (10446304 -75516486)
2017,Noviembre,Suecia,0,2,,2,POINT (10886686 -74776479)
2017,Noviembre,Suecia,1,6,,7,POINT (3451668 -76532004)
2017,Noviembre,Suecia,23,41,,64,POINT (4697157 -74140516)
2017,Noviembre,Suecia,0,2,,2,POINT (4815189 -75736374)
2017,Noviembre,Suecia,2,8,,10,POINT (6170465 -7542726)
2017,Noviembre,Suecia,0,1,,1,POINT (7128047 -73181317)
2017,Noviembre,Suiza,1,1,,2,POINT (125862 -81702165)
2017,Noviembre,Suiza,7,7,,14,POINT (3451668 -76532004)
2017,Noviembre,Suiza,70,115,,185,POINT (4697157 -74140516)
2017,Noviembre,Suiza,17,31,,48,POINT (6170465 -7542726)
2017,Noviembre,Suiza,1,4,,5,POINT (7927233 -72508188)
2017,Noviembre,Surinam,4,2,,6,POINT (4697157 -74140516)
2017,Noviembre,Surinam,0,1,,1,POINT (6170465 -7542726)
2017,Noviembre,Taiwán,4,2,,6,POINT (4697157 -74140516)
2017,Noviembre,República de Tayikistán,0,1,,1,POINT (4697157 -74140516)
2017,Noviembre,Tailandia,2,4,,6,POINT (4697157 -74140516)
2017,Noviembre,Tailandia,2,2,,4,POINT (6170465 -7542726)
2017,Noviembre,Tanzania,1,0,,1,POINT (4697157 -74140516)
2017,Noviembre,Togo,0,1,,1,POINT (6170465 -7542726)
2017,Noviembre,Trinidad y Tobago,1,1,,2,POINT (10886686 -74776479)
2017,Noviembre,Trinidad y Tobago,12,4,,16,POINT (3451668 -76532004)
2017,Noviembre,Trinidad y Tobago,2,10,,12,POINT (4697157 -74140516)
2017,Noviembre,Trinidad y Tobago,2,4,,6,POINT (4815189 -75736374)
2017,Noviembre,Trinidad y Tobago,4,14,,18,POINT (6170465 -7542726)
2017,Noviembre,Trinidad y Tobago,1,0,,1,POINT (7128047 -73181317)
2017,Noviembre,Túnez,2,3,,5,POINT (4697157 -74140516)
2017,Noviembre,Turkmenistán,5,0,,5,POINT (4697157 -74140516)
2017,Noviembre,Turquía,0,1,,1,POINT (3451668 -76532004)
2017,Noviembre,Turquía,231,353,,584,POINT (4697157 -74140516)
2017,Noviembre,Turquía,0,2,,2,POINT (6170465 -7542726)
2017,Noviembre,Ucrania,2,0,,2,POINT (10446304 -75516486)
2017,Noviembre,Ucrania,0,2,,2,POINT (10886686 -74776479)
2017,Noviembre,Ucrania,0,1,,1,POINT (3451668 -76532004)
2017,Noviembre,Ucrania,3,4,,7,POINT (4697157 -74140516)
2017,Noviembre,Ucrania,1,0,,1,POINT (6170465 -7542726)
2017,Noviembre,Uganda,1,0,,1,POINT (4697157 -74140516)
2017,Noviembre,Uganda,0,1,,1,POINT (6170465 -7542726)
2017,Noviembre,Uruguay,0,2,,2,POINT (0.81488 -77356)
2017,Noviembre,Uruguay,4,3,,7,POINT (10446304 -75516486)
2017,Noviembre,Uruguay,17,9,,26,POINT (125862 -81702165)
2017,Noviembre,Uruguay,21,24,,45,POINT (3451668 -76532004)
2017,Noviembre,Uruguay,233,356,,589,POINT (4697157 -74140516)
2017,Noviembre,Uruguay,0,1,,1,POINT (4815189 -75736374)
2017,Noviembre,Uruguay,8,41,,49,POINT (6170465 -7542726)
2017,Noviembre,Venezuela,0,4,,4,POINT (10406342 -75527794)
2017,Noviembre,Venezuela,4,16,,20,POINT (10446304 -75516486)
2017,Noviembre,Venezuela,19,78,,97,POINT (10886686 -74776479)
2017,Noviembre,Venezuela,0,1,,1,POINT (10970933 -74765343)
2017,Noviembre,Venezuela,0,6,,6,POINT (11117206 -74232675)
2017,Noviembre,Venezuela,6550,7478,,14028,POINT (11360029 -72129595)
2017,Noviembre,Venezuela,4,14,,18,POINT (1152863 -72919186)
2017,Noviembre,Venezuela,2,0,,2,POINT (125862 -81702165)
2017,Noviembre,Venezuela,29,52,,81,POINT (3451668 -76532004)
2017,Noviembre,Venezuela,15,14,,29,POINT (3866713 -67927521)
2017,Noviembre,Venezuela,2667,2949,,5616,POINT (4697157 -74140516)
2017,Noviembre,Venezuela,3,6,,9,POINT (4815189 -75736374)
2017,Noviembre,Venezuela,575,612,,1187,POINT (6170465 -7542726)
2017,Noviembre,Venezuela,53,47,,100,POINT (6185536 -67484028)
2017,Noviembre,Venezuela,1,7,,8,POINT (6218835 -75586989)
2017,Noviembre,Venezuela,262,298,,560,POINT (7088729 -70740253)
2017,Noviembre,Venezuela,3,4,,7,POINT (7128047 -73181317)
2017,Noviembre,Venezuela,27470,33868,,61338,POINT (7819 -72453013)
2017,Noviembre,Venezuela,3,19,,22,POINT (7927233 -72508188)
2017,Noviembre,Venezuela,846,905,,1751,POINT (836068 -72409396)
2017,Noviembre,Vietnam,3,1,,4,POINT (4697157 -74140516)
2017,Noviembre,Islas Vírgenes Británicas/Territorio Británico de Ultramar,0,1,,1,POINT (4697157 -74140516)
2017,Noviembre,Islas Vírgenes Británicas/Territorio Británico de Ultramar,3,1,,4,POINT (6170465 -7542726)
2017,Noviembre,Islas Vírgenes Estadounidenses/Territorio de Estados Unidos,0,7,,7,POINT (4697157 -74140516)
2017,Diciembre,Afganistán,0,2,,2,POINT (4697157 -74140516)
2017,Diciembre,Albania,0,1,,1,POINT (4697157 -74140516)
2017,Diciembre,Albania,0,2,,2,POINT (6170465 -7542726)
2017,Diciembre,Alemania,0,1,,1,POINT (0.81488 -77356)
2017,Diciembre,Alemania,11,13,,24,POINT (10446304 -75516486)
2017,Diciembre,Alemania,8,9,,17,POINT (10886686 -74776479)
2017,Diciembre,Alemania,3,5,,8,POINT (125862 -81702165)
2017,Diciembre,Alemania,37,57,,94,POINT (3451668 -76532004)
2017,Diciembre,Alemania,1547,2309,,3856,POINT (4697157 -74140516)
2017,Diciembre,Alemania,2,10,,12,POINT (4815189 -75736374)
2017,Diciembre,Alemania,57,102,,159,POINT (6170465 -7542726)
2017,Diciembre,Alemania,3,2,,5,POINT (7128047 -73181317)
2017,Diciembre,Andorra,2,2,,4,POINT (6170465 -7542726)
2017,Diciembre,Antigua y Barbuda,0,2,,2,POINT (10406342 -75527794)
2017,Diciembre,Antigua y Barbuda,2,1,,3,POINT (3451668 -76532004)
2017,Diciembre,Países Bajos,16,57,,73,POINT (10406342 -75527794)
2017,Diciembre,Países Bajos,253,396,,649,POINT (10446304 -75516486)
2017,Diciembre,Países Bajos,15,12,,27,POINT (10886686 -74776479)
2017,Diciembre,Países Bajos,0,17,,17,POINT (10970933 -74765343)
2017,Diciembre,Países Bajos,2,4,,6,POINT (125862 -81702165)
2017,Diciembre,Países Bajos,1,1,,2,POINT (133387613 -81372937)
2017,Diciembre,Países Bajos,31,43,,74,POINT (3451668 -76532004)
2017,Diciembre,Países Bajos,919,1369,,2288,POINT (4697157 -74140516)
2017,Diciembre,Países Bajos,2,8,,10,POINT (4815189 -75736374)
2017,Diciembre,Países Bajos,83,128,,211,POINT (6170465 -7542726)
2017,Diciembre,Países Bajos,2,2,,4,POINT (6218835 -75586989)
2017,Diciembre,Países Bajos,3,6,,9,POINT (7128047 -73181317)
2017,Diciembre,Arabia Saudita,0,2,,2,POINT (4697157 -74140516)
2017,Diciembre,Arabia Saudita,0,1,,1,POINT (4815189 -75736374)
2017,Diciembre,Arabia Saudita,0,1,,1,POINT (6170465 -7542726)
2017,Diciembre,Argelia,2,8,,10,POINT (4697157 -74140516)
2017,Diciembre,Argelia,0,1,,1,POINT (6170465 -7542726)
2017,Diciembre,Argentina,10,11,,21,POINT (0.81488 -77356)
2017,Diciembre,Argentina,1,0,,1,POINT (1800143 -78802679)
2017,Diciembre,Argentina,0,3,,3,POINT (10406342 -75527794)
2017,Diciembre,Argentina,87,73,,160,POINT (10446304 -75516486)
2017,Diciembre,Argentina,11,14,,25,POINT (10886686 -74776479)
2017,Diciembre,Argentina,208,196,,404,POINT (125862 -81702165)
2017,Diciembre,Argentina,68,93,,161,POINT (3451668 -76532004)
2017,Diciembre,Argentina,4682,5519,,10201,POINT (4697157 -74140516)
2017,Diciembre,Argentina,4,2,,6,POINT (4815189 -75736374)
2017,Diciembre,Argentina,74,127,,201,POINT (6170465 -7542726)
2017,Diciembre,Argentina,1,0,,1,POINT (7128047 -73181317)
2017,Diciembre,Aruba,9,6,,15,POINT (10406342 -75527794)
2017,Diciembre,Aruba,3,13,,16,POINT (10446304 -75516486)
2017,Diciembre,Aruba,0,1,,1,POINT (10886686 -74776479)
2017,Diciembre,Aruba,29,33,,62,POINT (11247723 -74213989)
2017,Diciembre,Aruba,0,4,,4,POINT (12165168 -71983761)
2017,Diciembre,Aruba,0,2,,2,POINT (3451668 -76532004)
2017,Diciembre,Aruba,886,1149,,2035,POINT (4697157 -74140516)
2017,Diciembre,Aruba,0,1,,1,POINT (4815189 -75736374)
2017,Diciembre,Aruba,23,36,,59,POINT (6170465 -7542726)
2017,Diciembre,Aruba,11,7,,18,POINT (7128047 -73181317)
2017,Diciembre,Australia,4,2,,6,POINT (10446304 -75516486)
2017,Diciembre,Australia,1,2,,3,POINT (10886686 -74776479)
2017,Diciembre,Australia,0,1,,1,POINT (125862 -81702165)
2017,Diciembre,Australia,10,14,,24,POINT (3451668 -76532004)
2017,Diciembre,Australia,124,178,,302,POINT (4697157 -74140516)
2017,Diciembre,Australia,3,6,,9,POINT (4815189 -75736374)
2017,Diciembre,Australia,22,47,,69,POINT (6170465 -7542726)
2017,Diciembre,Australia,0,1,,1,POINT (7128047 -73181317)
2017,Diciembre,Austria,0,1,,1,POINT (10446304 -75516486)
2017,Diciembre,Austria,1,1,,2,POINT (10886686 -74776479)
2017,Diciembre,Austria,0,1,,1,POINT (125862 -81702165)
2017,Diciembre,Austria,1,7,,8,POINT (3451668 -76532004)
2017,Diciembre,Austria,40,70,,110,POINT (4697157 -74140516)
2017,Diciembre,Austria,1,1,,2,POINT (4815189 -75736374)
2017,Diciembre,Austria,6,7,,13,POINT (6170465 -7542726)
2017,Diciembre,Bahamas,1,19,,20,POINT (10406342 -75527794)
2017,Diciembre,Bahamas,1,3,,4,POINT (10446304 -75516486)
2017,Diciembre,Bahamas,0,1,,1,POINT (10886686 -74776479)
2017,Diciembre,Bahamas,2,0,,2,POINT (3451668 -76532004)
2017,Diciembre,Bahamas,1,4,,5,POINT (4697157 -74140516)
2017,Diciembre,Bahamas,0,1,,1,POINT (4815189 -75736374)
2017,Diciembre,Bahamas,0,4,,4,POINT (6170465 -7542726)
2017,Diciembre,Bahréin,2,0,,2,POINT (10446304 -75516486)
2017,Diciembre,Bahréin,0,1,,1,POINT (11360029 -72129595)
2017,Diciembre,Bahréin,0,1,,1,POINT (4697157 -74140516)
2017,Diciembre,Bangladesh,1,0,,1,POINT (4697157 -74140516)
2017,Diciembre,Barbados,0,1,,1,POINT (10886686 -74776479)
2017,Diciembre,Barbados,1,2,,3,POINT (4697157 -74140516)
2017,Diciembre,Barbados,1,0,,1,POINT (4815189 -75736374)
2017,Diciembre,Barbados,0,1,,1,POINT (6170465 -7542726)
2017,Diciembre,República de Belarús,2,0,,2,POINT (11360029 -72129595)
2017,Diciembre,República de Belarús,0,1,,1,POINT (836068 -72409396)
2017,Diciembre,Bélgica,0,1,,1,POINT (10406342 -75527794)
2017,Diciembre,Bélgica,0,2,,2,POINT (10446304 -75516486)
2017,Diciembre,Bélgica,0,1,,1,POINT (125862 -81702165)
2017,Diciembre,Bélgica,1,11,,12,POINT (3451668 -76532004)
2017,Diciembre,Bélgica,67,98,,165,POINT (4697157 -74140516)
2017,Diciembre,Bélgica,1,2,,3,POINT (4815189 -75736374)
2017,Diciembre,Bélgica,14,26,,40,POINT (6170465 -7542726)
2017,Diciembre,Bélgica,0,1,,1,POINT (7819 -72453013)
2017,Diciembre,Belice,5,2,,7,POINT (4697157 -74140516)
2017,Diciembre,Belice,0,1,,1,POINT (6170465 -7542726)
2017,Diciembre,Benín,0,1,,1,POINT (4697157 -74140516)
2017,Diciembre,Bermudas/Territorio Británico de Ultramar,0,1,,1,POINT (4815189 -75736374)
2017,Diciembre,Bolivia,1,1,,2,POINT (0.81488 -77356)
2017,Diciembre,Bolivia,16,15,,31,POINT (10446304 -75516486)
2017,Diciembre,Bolivia,1,1,,2,POINT (10886686 -74776479)
2017,Diciembre,Bolivia,28,22,,50,POINT (125862 -81702165)
2017,Diciembre,Bolivia,39,17,,56,POINT (3451668 -76532004)
2017,Diciembre,Bolivia,729,742,,1471,POINT (4697157 -74140516)
2017,Diciembre,Bolivia,1,3,,4,POINT (4815189 -75736374)
2017,Diciembre,Bolivia,67,66,,133,POINT (6170465 -7542726)
2017,Diciembre,Brasil,227,233,,460,POINT (-4191162 -69941498)
2017,Diciembre,Brasil,23,26,,49,POINT (-4214082 -69941431)
2017,Diciembre,Brasil,3,1,,4,POINT (0.81488 -77356)
2017,Diciembre,Brasil,0,7,,7,POINT (10406342 -75527794)
2017,Diciembre,Brasil,118,77,,195,POINT (10446304 -75516486)
2017,Diciembre,Brasil,3,5,,8,POINT (10886686 -74776479)
2017,Diciembre,Brasil,0,1,,1,POINT (11247723 -74213989)
2017,Diciembre,Brasil,296,220,,516,POINT (125862 -81702165)
2017,Diciembre,Brasil,56,49,,105,POINT (3451668 -76532004)
2017,Diciembre,Brasil,6797,7075,,13872,POINT (4697157 -74140516)
2017,Diciembre,Brasil,1,3,,4,POINT (4815189 -75736374)
2017,Diciembre,Brasil,92,135,,227,POINT (6170465 -7542726)
2017,Diciembre,Brasil,0,3,,3,POINT (7088729 -70740253)
2017,Diciembre,Brasil,3,1,,4,POINT (7128047 -73181317)
2017,Diciembre,Bulgaria,2,10,,12,POINT (4697157 -74140516)
2017,Diciembre,Bulgaria,0,2,,2,POINT (6170465 -7542726)
2017,Diciembre,Islas Caimán/Territorio Británico de Ultramar,3,21,,24,POINT (10406342 -75527794)
2017,Diciembre,Islas Caimán/Territorio Británico de Ultramar,2,3,,5,POINT (10446304 -75516486)
2017,Diciembre,Islas Caimán/Territorio Británico de Ultramar,1,1,,2,POINT (125744111 -81703935)
2017,Diciembre,Islas Caimán/Territorio Británico de Ultramar,10,15,,25,POINT (125862 -81702165)
2017,Diciembre,Islas Caimán/Territorio Británico de Ultramar,0,1,,1,POINT (4815189 -75736374)
2017,Diciembre,Canadá,0,3,,3,POINT (10406342 -75527794)
2017,Diciembre,Canadá,357,400,,757,POINT (10446304 -75516486)
2017,Diciembre,Canadá,24,30,,54,POINT (10886686 -74776479)
2017,Diciembre,Canadá,4,3,,7,POINT (11117206 -74232675)
2017,Diciembre,Canadá,135,138,,273,POINT (125862 -81702165)
2017,Diciembre,Canadá,110,138,,248,POINT (3451668 -76532004)
2017,Diciembre,Canadá,1,0,,1,POINT (445285 -75766353)
2017,Diciembre,Canadá,1301,1897,,3198,POINT (4697157 -74140516)
2017,Diciembre,Canadá,17,35,,52,POINT (4815189 -75736374)
2017,Diciembre,Canadá,198,372,,570,POINT (6170465 -7542726)
2017,Diciembre,Canadá,21,11,,32,POINT (7128047 -73181317)
2017,Diciembre,Canadá,0,3,,3,POINT (9402597 -75681642)
2017,Diciembre,Chad,0,1,,1,POINT (4697157 -74140516)
2017,Diciembre,España,0,2,,2,POINT (10406342 -75527794)
2017,Diciembre,España,3,3,,6,POINT (10446304 -75516486)
2017,Diciembre,España,2,6,,8,POINT (10886686 -74776479)
2017,Diciembre,España,0,1,,1,POINT (10970933 -74765343)
2017,Diciembre,España,0,3,,3,POINT (11247723 -74213989)
2017,Diciembre,España,1,8,,9,POINT (125862 -81702165)
2017,Diciembre,España,910,1230,,2140,POINT (3451668 -76532004)
2017,Diciembre,España,4371,6933,,11304,POINT (4697157 -74140516)
2017,Diciembre,España,8,5,,13,POINT (4815189 -75736374)
2017,Diciembre,España,886,1369,,2255,POINT (6170465 -7542726)
2017,Diciembre,República Del Congo,1,0,,1,POINT (4697157 -74140516)
2017,Diciembre,República de Corea,0,1,,1,POINT (10886686 -74776479)
2017,Diciembre,República de Corea,0,1,,1,POINT (10970933 -74765343)
2017,Diciembre,República de Corea,0,1,,1,POINT (3451668 -76532004)
2017,Diciembre,República de Corea,24,24,,48,POINT (4697157 -74140516)
2017,Diciembre,República de Corea,1,1,,2,POINT (4815189 -75736374)
2017,Diciembre,República de Corea,4,2,,6,POINT (6170465 -7542726)
2017,Diciembre,Costa de Marfil,7,10,,17,POINT (4697157 -74140516)
2017,Diciembre,Costa de Marfil,0,1,,1,POINT (4815189 -75736374)
2017,Diciembre,Costa Rica,8,15,,23,POINT (10406342 -75527794)
2017,Diciembre,Costa Rica,39,41,,80,POINT (10446304 -75516486)
2017,Diciembre,Costa Rica,26,22,,48,POINT (10886686 -74776479)
2017,Diciembre,Costa Rica,0,1,,1,POINT (125744111 -81703935)
2017,Diciembre,Costa Rica,73,61,,134,POINT (125862 -81702165)
2017,Diciembre,Costa Rica,91,70,,161,POINT (3451668 -76532004)
2017,Diciembre,Costa Rica,1692,2017,,3709,POINT (4697157 -74140516)
2017,Diciembre,Costa Rica,20,29,,49,POINT (4815189 -75736374)
2017,Diciembre,Costa Rica,230,274,,504,POINT (6170465 -7542726)
2017,Diciembre,Costa Rica,2,5,,7,POINT (7128047 -73181317)
2017,Diciembre,Croacia,0,1,,1,POINT (3451668 -76532004)
2017,Diciembre,Croacia,2,9,,11,POINT (4697157 -74140516)
2017,Diciembre,Croacia,0,2,,2,POINT (6170465 -7542726)
2017,Diciembre,Cuba,0,2,,2,POINT (10406342 -75527794)
2017,Diciembre,Cuba,4,4,,8,POINT (10446304 -75516486)
2017,Diciembre,Cuba,7,9,,16,POINT (10886686 -74776479)
2017,Diciembre,Cuba,2,1,,3,POINT (125862 -81702165)
2017,Diciembre,Cuba,8,26,,34,POINT (3451668 -76532004)
2017,Diciembre,Cuba,543,865,,1408,POINT (4697157 -74140516)
2017,Diciembre,Cuba,0,1,,1,POINT (4815189 -75736374)
2017,Diciembre,Cuba,12,19,,31,POINT (6170465 -7542726)
2017,Diciembre,Cuba,2,1,,3,POINT (7128047 -73181317)
2017,Diciembre,Curazao,4,10,,14,POINT (4697157 -74140516)
2017,Diciembre,República Checa,7,9,,16,POINT (4697157 -74140516)
2017,Diciembre,República Checa,1,2,,3,POINT (6170465 -7542726)
2017,Diciembre,Chile,7,9,,16,POINT (0.81488 -77356)
2017,Diciembre,Chile,40,37,,77,POINT (10446304 -75516486)
2017,Diciembre,Chile,0,1,,1,POINT (10886686 -74776479)
2017,Diciembre,Chile,44,40,,84,POINT (125862 -81702165)
2017,Diciembre,Chile,46,68,,114,POINT (3451668 -76532004)
2017,Diciembre,Chile,0,1,,1,POINT (3884426 -77061029)
2017,Diciembre,Chile,4760,5917,,10677,POINT (4697157 -74140516)
2017,Diciembre,Chile,0,4,,4,POINT (4815189 -75736374)
2017,Diciembre,Chile,20,34,,54,POINT (6170465 -7542726)
2017,Diciembre,Chile,1,1,,2,POINT (7128047 -73181317)
2017,Diciembre,China,0,1,,1,POINT (11247723 -74213989)
2017,Diciembre,China,0,2,,2,POINT (3451668 -76532004)
2017,Diciembre,China,19,60,,79,POINT (4697157 -74140516)
2017,Diciembre,China,2,6,,8,POINT (6170465 -7542726)
2017,Diciembre,Chipre,1,0,,1,POINT (3451668 -76532004)
2017,Diciembre,Chipre,1,2,,3,POINT (4697157 -74140516)
2017,Diciembre,Dinamarca,0,2,,2,POINT (10886686 -74776479)
2017,Diciembre,Dinamarca,0,1,,1,POINT (3451668 -76532004)
2017,Diciembre,Dinamarca,46,57,,103,POINT (4697157 -74140516)
2017,Diciembre,Dinamarca,0,3,,3,POINT (4815189 -75736374)
2017,Diciembre,Dinamarca,4,5,,9,POINT (6170465 -7542726)
2017,Diciembre,Ecuador,219,464,,683,POINT (0.33002 -76876446)
2017,Diciembre,Ecuador,5,24,,29,POINT (0.812436 -77847006)
2017,Diciembre,Ecuador,7261,9780,,17041,POINT (0.81488 -77356)
2017,Diciembre,Ecuador,48,41,,89,POINT (1800143 -78802679)
2017,Diciembre,Ecuador,5,8,,13,POINT (10446304 -75516486)
2017,Diciembre,Ecuador,1,1,,2,POINT (10886686 -74776479)
2017,Diciembre,Ecuador,16,12,,28,POINT (125862 -81702165)
2017,Diciembre,Ecuador,488,502,,990,POINT (3451668 -76532004)
2017,Diciembre,Ecuador,3529,4500,,8029,POINT (4697157 -74140516)
2017,Diciembre,Ecuador,0,1,,1,POINT (4815189 -75736374)
2017,Diciembre,Ecuador,16,32,,48,POINT (6170465 -7542726)
2017,Diciembre,Ecuador,0,1,,1,POINT (7819 -72453013)
2017,Diciembre,Egipto,0,3,,3,POINT (4697157 -74140516)
2017,Diciembre,El Salvador,3,2,,5,POINT (10446304 -75516486)
2017,Diciembre,El Salvador,2,4,,6,POINT (10886686 -74776479)
2017,Diciembre,El Salvador,1,0,,1,POINT (125862 -81702165)
2017,Diciembre,El Salvador,183,256,,439,POINT (3451668 -76532004)
2017,Diciembre,El Salvador,878,1171,,2049,POINT (4697157 -74140516)
2017,Diciembre,El Salvador,0,1,,1,POINT (4815189 -75736374)
2017,Diciembre,El Salvador,232,319,,551,POINT (6170465 -7542726)
2017,Diciembre,El Salvador,0,2,,2,POINT (7128047 -73181317)
2017,Diciembre,Emiratos Árabes,14,14,,28,POINT (4697157 -74140516)
2017,Diciembre,Emiratos Árabes,0,1,,1,POINT (6170465 -7542726)
2017,Diciembre,Eritrea,0,1,,1,POINT (4697157 -74140516)
2017,Diciembre,Eslovaquia,7,6,,13,POINT (4697157 -74140516)
2017,Diciembre,Eslovaquia,1,0,,1,POINT (6170465 -7542726)
2017,Diciembre,Eslovenia,2,9,,11,POINT (4697157 -74140516)
2017,Diciembre,Estados Unidos de América,5,82,,87,POINT (10406342 -75527794)
2017,Diciembre,Estados Unidos de América,4599,6075,,10674,POINT (10446304 -75516486)
2017,Diciembre,Estados Unidos de América,825,1421,,2246,POINT (10886686 -74776479)
2017,Diciembre,Estados Unidos de América,0,1,,1,POINT (10970933 -74765343)
2017,Diciembre,Estados Unidos de América,8,30,,38,POINT (11247723 -74213989)
2017,Diciembre,Estados Unidos de América,68,80,,148,POINT (125862 -81702165)
2017,Diciembre,Estados Unidos de América,1645,2396,,4041,POINT (3451668 -76532004)
2017,Diciembre,Estados Unidos de América,0,2,,2,POINT (3884426 -77061029)
2017,Diciembre,Estados Unidos de América,158,231,,389,POINT (445285 -75766353)
2017,Diciembre,Estados Unidos de América,12548,20125,,32673,POINT (4697157 -74140516)
2017,Diciembre,Estados Unidos de América,269,352,,621,POINT (4815189 -75736374)
2017,Diciembre,Estados Unidos de América,3790,7183,,10973,POINT (6170465 -7542726)
2017,Diciembre,Estados Unidos de América,48,87,,135,POINT (7128047 -73181317)
2017,Diciembre,Estados Unidos de América,0,9,,9,POINT (9402597 -75681642)
2017,Diciembre,Estonia,2,0,,2,POINT (4697157 -74140516)
2017,Diciembre,Etiopia,0,1,,1,POINT (3451668 -76532004)
2017,Diciembre,Filipinas,0,1,,1,POINT (10446304 -75516486)
2017,Diciembre,Filipinas,0,2,,2,POINT (10886686 -74776479)
2017,Diciembre,Filipinas,0,4,,4,POINT (3451668 -76532004)
2017,Diciembre,Filipinas,0,3,,3,POINT (3884426 -77061029)
2017,Diciembre,Filipinas,3,9,,12,POINT (4697157 -74140516)
2017,Diciembre,Filipinas,0,1,,1,POINT (7128047 -73181317)
2017,Diciembre,Finlandia,1,2,,3,POINT (10446304 -75516486)
2017,Diciembre,Finlandia,1,4,,5,POINT (3451668 -76532004)
2017,Diciembre,Finlandia,16,21,,37,POINT (4697157 -74140516)
2017,Diciembre,Finlandia,2,0,,2,POINT (6170465 -7542726)
2017,Diciembre,Francia,6,11,,17,POINT (10446304 -75516486)
2017,Diciembre,Francia,4,6,,10,POINT (10886686 -74776479)
2017,Diciembre,Francia,2,1,,3,POINT (125862 -81702165)
2017,Diciembre,Francia,37,80,,117,POINT (3451668 -76532004)
2017,Diciembre,Francia,1822,2772,,4594,POINT (4697157 -74140516)
2017,Diciembre,Francia,5,6,,11,POINT (4815189 -75736374)
2017,Diciembre,Francia,70,119,,189,POINT (6170465 -7542726)
2017,Diciembre,Francia,0,1,,1,POINT (7128047 -73181317)
2017,Diciembre,Ghana,0,1,,1,POINT (4697157 -74140516)
2017,Diciembre,Gibraltar/Territorio Británico de Ultramar,0,1,,1,POINT (0.81488 -77356)
2017,Diciembre,Granada,205,144,,349,POINT (11247723 -74213989)
2017,Diciembre,Grecia,0,2,,2,POINT (10446304 -75516486)
2017,Diciembre,Grecia,9,8,,17,POINT (4697157 -74140516)
2017,Diciembre,Grecia,0,1,,1,POINT (6170465 -7542726)
2017,Diciembre,Groenlandia,1,0,,1,POINT (10406342 -75527794)
2017,Diciembre,Guatemala,0,1,,1,POINT (10406342 -75527794)
2017,Diciembre,Guatemala,14,13,,27,POINT (10446304 -75516486)
2017,Diciembre,Guatemala,6,6,,12,POINT (10886686 -74776479)
2017,Diciembre,Guatemala,7,10,,17,POINT (125862 -81702165)
2017,Diciembre,Guatemala,0,1,,1,POINT (133387613 -81372937)
2017,Diciembre,Guatemala,38,49,,87,POINT (3451668 -76532004)
2017,Diciembre,Guatemala,0,1,,1,POINT (3884426 -77061029)
2017,Diciembre,Guatemala,549,678,,1227,POINT (4697157 -74140516)
2017,Diciembre,Guatemala,10,9,,19,POINT (4815189 -75736374)
2017,Diciembre,Guatemala,54,98,,152,POINT (6170465 -7542726)
2017,Diciembre,Guatemala,7,9,,16,POINT (7128047 -73181317)
2017,Diciembre,Guyana,0,2,,2,POINT (4697157 -74140516)
2017,Diciembre,Guyana,0,1,,1,POINT (7128047 -73181317)
2017,Diciembre,Guadalupe/Territorio Francés,1,1,,2,POINT (10406342 -75527794)
2017,Diciembre,Guadalupe/Territorio Francés,2,6,,8,POINT (4697157 -74140516)
2017,Diciembre,Guam/Territorio no incorporado de Estados Unidos,1,0,,1,POINT (4697157 -74140516)
2017,Diciembre,Haití,0,10,,10,POINT (10406342 -75527794)
2017,Diciembre,Haití,0,2,,2,POINT (3451668 -76532004)
2017,Diciembre,Haití,7,7,,14,POINT (4697157 -74140516)
2017,Diciembre,Haití,0,1,,1,POINT (6170465 -7542726)
2017,Diciembre,Honduras,8,6,,14,POINT (10446304 -75516486)
2017,Diciembre,Honduras,3,3,,6,POINT (10886686 -74776479)
2017,Diciembre,Honduras,0,2,,2,POINT (125744111 -81703935)
2017,Diciembre,Honduras,1,2,,3,POINT (125862 -81702165)
2017,Diciembre,Honduras,1,2,,3,POINT (133387613 -81372937)
2017,Diciembre,Honduras,18,11,,29,POINT (3451668 -76532004)
2017,Diciembre,Honduras,82,73,,155,POINT (4697157 -74140516)
2017,Diciembre,Honduras,1,2,,3,POINT (4815189 -75736374)
2017,Diciembre,Honduras,27,38,,65,POINT (6170465 -7542726)
2017,Diciembre,Honduras,2,0,,2,POINT (7128047 -73181317)
2017,Diciembre,Hong Kong,0,2,,2,POINT (10446304 -75516486)
2017,Diciembre,Hong Kong,1,0,,1,POINT (3451668 -76532004)
2017,Diciembre,Hong Kong,4,7,,11,POINT (4697157 -74140516)
2017,Diciembre,Hong Kong,3,2,,5,POINT (6170465 -7542726)
2017,Diciembre,Hungría,1,1,,2,POINT (10446304 -75516486)
2017,Diciembre,Hungría,0,1,,1,POINT (3451668 -76532004)
2017,Diciembre,Hungría,7,16,,23,POINT (4697157 -74140516)
2017,Diciembre,India,0,3,,3,POINT (10886686 -74776479)
2017,Diciembre,India,0,3,,3,POINT (3451668 -76532004)
2017,Diciembre,India,8,31,,39,POINT (4697157 -74140516)
2017,Diciembre,India,0,6,,6,POINT (6170465 -7542726)
2017,Diciembre,Indonesia,0,5,,5,POINT (4697157 -74140516)
2017,Diciembre,Indonesia,1,0,,1,POINT (6170465 -7542726)
2017,Diciembre,Irán,0,1,,1,POINT (4697157 -74140516)
2017,Diciembre,República de Irlanda,0,1,,1,POINT (10886686 -74776479)
2017,Diciembre,República de Irlanda,1,2,,3,POINT (3451668 -76532004)
2017,Diciembre,República de Irlanda,12,25,,37,POINT (4697157 -74140516)
2017,Diciembre,República de Irlanda,3,11,,14,POINT (6170465 -7542726)
2017,Diciembre,Islandia,2,0,,2,POINT (4697157 -74140516)
2017,Diciembre,Israel,0,2,,2,POINT (3451668 -76532004)
2017,Diciembre,Israel,25,91,,116,POINT (4697157 -74140516)
2017,Diciembre,Israel,0,2,,2,POINT (4815189 -75736374)
2017,Diciembre,Israel,2,7,,9,POINT (6170465 -7542726)
2017,Diciembre,Italia,6,14,,20,POINT (10446304 -75516486)
2017,Diciembre,Italia,0,2,,2,POINT (10886686 -74776479)
2017,Diciembre,Italia,2,3,,5,POINT (125862 -81702165)
2017,Diciembre,Italia,17,59,,76,POINT (3451668 -76532004)
2017,Diciembre,Italia,185,402,,587,POINT (4697157 -74140516)
2017,Diciembre,Italia,3,2,,5,POINT (4815189 -75736374)
2017,Diciembre,Italia,23,82,,105,POINT (6170465 -7542726)
2017,Diciembre,Islas Christmas,0,1,,1,POINT (10446304 -75516486)
2017,Diciembre,Jamaica,2,11,,13,POINT (10406342 -75527794)
2017,Diciembre,Jamaica,1,1,,2,POINT (11247723 -74213989)
2017,Diciembre,Jamaica,1,1,,2,POINT (125862 -81702165)
2017,Diciembre,Jamaica,0,2,,2,POINT (3451668 -76532004)
2017,Diciembre,Jamaica,0,7,,7,POINT (4697157 -74140516)
2017,Diciembre,Jamaica,1,1,,2,POINT (6170465 -7542726)
2017,Diciembre,Japón,1,2,,3,POINT (10446304 -75516486)
2017,Diciembre,Japón,1,4,,5,POINT (3451668 -76532004)
2017,Diciembre,Japón,28,36,,64,POINT (4697157 -74140516)
2017,Diciembre,Japón,3,19,,22,POINT (6170465 -7542726)
2017,Diciembre,Japón,0,1,,1,POINT (7128047 -73181317)
2017,Diciembre,Jordania,0,1,,1,POINT (0.81488 -77356)
2017,Diciembre,Jordania,0,4,,4,POINT (4697157 -74140516)
2017,Diciembre,Kazajistán,0,2,,2,POINT (4697157 -74140516)
2017,Diciembre,Kenia,2,4,,6,POINT (4697157 -74140516)
2017,Diciembre,Letonia,0,2,,2,POINT (4697157 -74140516)
2017,Diciembre,Letonia,0,1,,1,POINT (4815189 -75736374)
2017,Diciembre,Lituania,3,2,,5,POINT (4697157 -74140516)
2017,Diciembre,Lituania,2,0,,2,POINT (6170465 -7542726)
2017,Diciembre,Líbano,0,1,,1,POINT (10886686 -74776479)
2017,Diciembre,Líbano,7,6,,13,POINT (4697157 -74140516)
2017,Diciembre,Libia,0,1,,1,POINT (4697157 -74140516)
2017,Diciembre,Liechtenstein,1,0,,1,POINT (4697157 -74140516)
2017,Diciembre,Luxemburgo,0,1,,1,POINT (3451668 -76532004)
2017,Diciembre,Luxemburgo,2,8,,10,POINT (4697157 -74140516)
2017,Diciembre,Luxemburgo,0,2,,2,POINT (4815189 -75736374)
2017,Diciembre,Madagascar,0,1,,1,POINT (7819 -72453013)
2017,Diciembre,Malasia,1,0,,1,POINT (4697157 -74140516)
2017,Diciembre,Malta,2,4,,6,POINT (4697157 -74140516)
2017,Diciembre,Marruecos,0,1,,1,POINT (10446304 -75516486)
2017,Diciembre,Marruecos,0,4,,4,POINT (4697157 -74140516)
2017,Diciembre,Marruecos,2,0,,2,POINT (6170465 -7542726)
2017,Diciembre,México,31,57,,88,POINT (10446304 -75516486)
2017,Diciembre,México,12,37,,49,POINT (10886686 -74776479)
2017,Diciembre,México,0,4,,4,POINT (10970933 -74765343)
2017,Diciembre,México,5,6,,11,POINT (125862 -81702165)
2017,Diciembre,México,116,175,,291,POINT (3451668 -76532004)
2017,Diciembre,México,6275,9106,,15381,POINT (4697157 -74140516)
2017,Diciembre,México,17,33,,50,POINT (4815189 -75736374)
2017,Diciembre,México,774,1327,,2101,POINT (6170465 -7542726)
2017,Diciembre,México,9,15,,24,POINT (7128047 -73181317)
2017,Diciembre,Mónaco,0,1,,1,POINT (4697157 -74140516)
2017,Diciembre,Mónaco,0,1,,1,POINT (6170465 -7542726)
2017,Diciembre,Mozambique,0,2,,2,POINT (4697157 -74140516)
2017,Diciembre,Nicaragua,5,1,,6,POINT (10446304 -75516486)
2017,Diciembre,Nicaragua,2,2,,4,POINT (10886686 -74776479)
2017,Diciembre,Nicaragua,1,1,,2,POINT (125744111 -81703935)
2017,Diciembre,Nicaragua,21,17,,38,POINT (3451668 -76532004)
2017,Diciembre,Nicaragua,38,51,,89,POINT (4697157 -74140516)
2017,Diciembre,Nicaragua,8,9,,17,POINT (4815189 -75736374)
2017,Diciembre,Nicaragua,11,18,,29,POINT (6170465 -7542726)
2017,Diciembre,Nicaragua,4,8,,12,POINT (7128047 -73181317)
2017,Diciembre,Noruega,3,1,,4,POINT (10446304 -75516486)
2017,Diciembre,Noruega,6,11,,17,POINT (3451668 -76532004)
2017,Diciembre,Noruega,42,46,,88,POINT (4697157 -74140516)
2017,Diciembre,Noruega,1,1,,2,POINT (4815189 -75736374)
2017,Diciembre,Noruega,3,8,,11,POINT (6170465 -7542726)
2017,Diciembre,Nueva Zelanda,1,1,,2,POINT (10446304 -75516486)
2017,Diciembre,Nueva Zelanda,1,0,,1,POINT (3451668 -76532004)
2017,Diciembre,Nueva Zelanda,13,20,,33,POINT (4697157 -74140516)
2017,Diciembre,Nueva Zelanda,2,1,,3,POINT (6170465 -7542726)
2017,Diciembre,Omán,0,1,,1,POINT (4697157 -74140516)
2017,Diciembre,Papúa Nueva Guinea,0,1,,1,POINT (10886686 -74776479)
2017,Diciembre,Pakistán,2,2,,4,POINT (4697157 -74140516)
2017,Diciembre,Palau,0,1,,1,POINT (4697157 -74140516)
2017,Diciembre,Panamá,723,747,,1470,POINT (10406342 -75527794)
2017,Diciembre,Panamá,4841,4940,,9781,POINT (10446304 -75516486)
2017,Diciembre,Panamá,332,640,,972,POINT (10886686 -74776479)
2017,Diciembre,Panamá,0,32,,32,POINT (10970933 -74765343)
2017,Diciembre,Panamá,1,1,,2,POINT (11247723 -74213989)
2017,Diciembre,Panamá,2,11,,13,POINT (12165168 -71983761)
2017,Diciembre,Panamá,8,15,,23,POINT (125744111 -81703935)
2017,Diciembre,Panamá,384,324,,708,POINT (125862 -81702165)
2017,Diciembre,Panamá,1,1,,2,POINT (133387613 -81372937)
2017,Diciembre,Panamá,494,729,,1223,POINT (3451668 -76532004)
2017,Diciembre,Panamá,0,22,,22,POINT (3884426 -77061029)
2017,Diciembre,Panamá,59,101,,160,POINT (445285 -75766353)
2017,Diciembre,Panamá,3859,5295,,9154,POINT (4697157 -74140516)
2017,Diciembre,Panamá,88,148,,236,POINT (4815189 -75736374)
2017,Diciembre,Panamá,2861,3865,,6726,POINT (6170465 -7542726)
2017,Diciembre,Panamá,1,0,,1,POINT (6222552 -77401154)
2017,Diciembre,Panamá,12,10,,22,POINT (7102626 -77762647)
2017,Diciembre,Panamá,18,39,,57,POINT (7128047 -73181317)
2017,Diciembre,Panamá,2,3,,5,POINT (806667 -767333)
2017,Diciembre,Panamá,92,111,,203,POINT (863337 -7735002)
2017,Diciembre,Paraguay,1,0,,1,POINT (0.81488 -77356)
2017,Diciembre,Paraguay,7,5,,12,POINT (10446304 -75516486)
2017,Diciembre,Paraguay,1,0,,1,POINT (10886686 -74776479)
2017,Diciembre,Paraguay,43,32,,75,POINT (125862 -81702165)
2017,Diciembre,Paraguay,7,1,,8,POINT (3451668 -76532004)
2017,Diciembre,Paraguay,58,58,,116,POINT (4697157 -74140516)
2017,Diciembre,Paraguay,2,0,,2,POINT (4815189 -75736374)
2017,Diciembre,Paraguay,6,5,,11,POINT (6170465 -7542726)
2017,Diciembre,Paraguay,0,1,,1,POINT (7128047 -73181317)
2017,Diciembre,Perú,24,31,,55,POINT (-4191162 -69941498)
2017,Diciembre,Perú,117,141,,258,POINT (-4214082 -69941431)
2017,Diciembre,Perú,1,4,,5,POINT (0.185957 -7478366)
2017,Diciembre,Perú,72,161,,233,POINT (0.81488 -77356)
2017,Diciembre,Perú,1243,1006,,2249,POINT (10446304 -75516486)
2017,Diciembre,Perú,4,16,,20,POINT (10886686 -74776479)
2017,Diciembre,Perú,255,180,,435,POINT (125862 -81702165)
2017,Diciembre,Perú,226,328,,554,POINT (3451668 -76532004)
2017,Diciembre,Perú,0,3,,3,POINT (3884426 -77061029)
2017,Diciembre,Perú,6119,7516,,13635,POINT (4697157 -74140516)
2017,Diciembre,Perú,4,5,,9,POINT (4815189 -75736374)
2017,Diciembre,Perú,408,697,,1105,POINT (6170465 -7542726)
2017,Diciembre,Perú,0,2,,2,POINT (7128047 -73181317)
2017,Diciembre,Polonia,1,0,,1,POINT (10446304 -75516486)
2017,Diciembre,Polonia,0,3,,3,POINT (3451668 -76532004)
2017,Diciembre,Polonia,22,17,,39,POINT (4697157 -74140516)
2017,Diciembre,Polonia,1,4,,5,POINT (6170465 -7542726)
2017,Diciembre,Portugal,0,1,,1,POINT (10886686 -74776479)
2017,Diciembre,Portugal,1,0,,1,POINT (125862 -81702165)
2017,Diciembre,Portugal,1,1,,2,POINT (3451668 -76532004)
2017,Diciembre,Portugal,41,58,,99,POINT (4697157 -74140516)
2017,Diciembre,Portugal,3,9,,12,POINT (6170465 -7542726)
2017,Diciembre,Polinesia Francesa/Colectividad de Ultramar Francesa,1,1,,2,POINT (3451668 -76532004)
2017,Diciembre,Polinesia Francesa/Colectividad de Ultramar Francesa,1,2,,3,POINT (4697157 -74140516)
2017,Diciembre,Puerto Rico/Territorio de Estados Unidos,0,1,,1,POINT (10406342 -75527794)
2017,Diciembre,Puerto Rico/Territorio de Estados Unidos,1,2,,3,POINT (10446304 -75516486)
2017,Diciembre,Puerto Rico/Territorio de Estados Unidos,8,37,,45,POINT (10886686 -74776479)
2017,Diciembre,Puerto Rico/Territorio de Estados Unidos,1,4,,5,POINT (125862 -81702165)
2017,Diciembre,Puerto Rico/Territorio de Estados Unidos,22,100,,122,POINT (3451668 -76532004)
2017,Diciembre,Puerto Rico/Territorio de Estados Unidos,531,875,,1406,POINT (4697157 -74140516)
2017,Diciembre,Puerto Rico/Territorio de Estados Unidos,5,9,,14,POINT (4815189 -75736374)
2017,Diciembre,Puerto Rico/Territorio de Estados Unidos,53,120,,173,POINT (6170465 -7542726)
2017,Diciembre,Puerto Rico/Territorio de Estados Unidos,3,4,,7,POINT (7128047 -73181317)
2017,Diciembre,Qatar,1,0,,1,POINT (3451668 -76532004)
2017,Diciembre,Qatar,0,1,,1,POINT (4697157 -74140516)
2017,Diciembre,Reino Unido de Gran Bretaña e Irlanda del Norte,0,9,,9,POINT (10446304 -75516486)
2017,Diciembre,Reino Unido de Gran Bretaña e Irlanda del Norte,1,1,,2,POINT (10886686 -74776479)
2017,Diciembre,Reino Unido de Gran Bretaña e Irlanda del Norte,24,28,,52,POINT (3451668 -76532004)
2017,Diciembre,Reino Unido de Gran Bretaña e Irlanda del Norte,1070,1791,,2861,POINT (4697157 -74140516)
2017,Diciembre,Reino Unido de Gran Bretaña e Irlanda del Norte,0,2,,2,POINT (4815189 -75736374)
2017,Diciembre,Reino Unido de Gran Bretaña e Irlanda del Norte,52,93,,145,POINT (6170465 -7542726)
2017,Diciembre,República CentroÁfricana,0,3,,3,POINT (10446304 -75516486)
2017,Diciembre,República CentroÁfricana,2,1,,3,POINT (4697157 -74140516)
2017,Diciembre,Federación de Rusia,0,2,,2,POINT (10886686 -74776479)
2017,Diciembre,Federación de Rusia,1,2,,3,POINT (125862 -81702165)
2017,Diciembre,Federación de Rusia,2,1,,3,POINT (3451668 -76532004)
2017,Diciembre,Federación de Rusia,25,48,,73,POINT (4697157 -74140516)
2017,Diciembre,Federación de Rusia,4,3,,7,POINT (6170465 -7542726)
2017,Diciembre,República Dominicana,0,8,,8,POINT (10406342 -75527794)
2017,Diciembre,República Dominicana,3,6,,9,POINT (10446304 -75516486)
2017,Diciembre,República Dominicana,4,25,,29,POINT (10886686 -74776479)
2017,Diciembre,República Dominicana,0,6,,6,POINT (10970933 -74765343)
2017,Diciembre,República Dominicana,1,2,,3,POINT (11117206 -74232675)
2017,Diciembre,República Dominicana,7,42,,49,POINT (3451668 -76532004)
2017,Diciembre,República Dominicana,826,1032,,1858,POINT (4697157 -74140516)
2017,Diciembre,República Dominicana,5,7,,12,POINT (4815189 -75736374)
2017,Diciembre,República Dominicana,41,61,,102,POINT (6170465 -7542726)
2017,Diciembre,República Dominicana,1,3,,4,POINT (7128047 -73181317)
2017,Diciembre,Rumania,9,10,,19,POINT (4697157 -74140516)
2017,Diciembre,Rumania,1,2,,3,POINT (6170465 -7542726)
2017,Diciembre,Sahara Occidental/Desierto Sahara,1,0,,1,POINT (10446304 -75516486)
2017,Diciembre,San Cristóbal y Nevis,1,0,,1,POINT (4697157 -74140516)
2017,Diciembre,San Cristóbal y Nevis,1,1,,2,POINT (7128047 -73181317)
2017,Diciembre,San Marino,0,2,,2,POINT (10886686 -74776479)
2017,Diciembre,San  Vicente y las Granadinas,0,1,,1,POINT (10446304 -75516486)
2017,Diciembre,San  Vicente y las Granadinas,0,2,,2,POINT (11247723 -74213989)
2017,Diciembre,Santa Elena/Territorio Británico de Ultramar,0,1,,1,POINT (4697157 -74140516)
2017,Diciembre,Santa Lucia,0,2,,2,POINT (10406342 -75527794)
2017,Diciembre,Santo Tomé y Príncipe,0,1,,1,POINT (10406342 -75527794)
2017,Diciembre,Senegal,0,1,,1,POINT (4697157 -74140516)
2017,Diciembre,Senegal,0,1,,1,POINT (6170465 -7542726)
2017,Diciembre,Serbia,0,2,,2,POINT (4697157 -74140516)
2017,Diciembre,Singapur,5,7,,12,POINT (4697157 -74140516)
2017,Diciembre,República Árabe Siria,0,1,,1,POINT (4697157 -74140516)
2017,Diciembre,Sudáfrica,0,1,,1,POINT (10446304 -75516486)
2017,Diciembre,Sudáfrica,13,8,,21,POINT (4697157 -74140516)
2017,Diciembre,Sudáfrica,1,0,,1,POINT (6170465 -7542726)
2017,Diciembre,Suecia,0,2,,2,POINT (10446304 -75516486)
2017,Diciembre,Suecia,2,2,,4,POINT (10886686 -74776479)
2017,Diciembre,Suecia,19,24,,43,POINT (3451668 -76532004)
2017,Diciembre,Suecia,78,113,,191,POINT (4697157 -74140516)
2017,Diciembre,Suecia,2,2,,4,POINT (4815189 -75736374)
2017,Diciembre,Suecia,21,22,,43,POINT (6170465 -7542726)
2017,Diciembre,Suecia,1,1,,2,POINT (7128047 -73181317)
2017,Diciembre,Suiza,1,2,,3,POINT (10446304 -75516486)
2017,Diciembre,Suiza,3,6,,9,POINT (10886686 -74776479)
2017,Diciembre,Suiza,0,1,,1,POINT (10970933 -74765343)
2017,Diciembre,Suiza,16,46,,62,POINT (3451668 -76532004)
2017,Diciembre,Suiza,203,278,,481,POINT (4697157 -74140516)
2017,Diciembre,Suiza,0,1,,1,POINT (4815189 -75736374)
2017,Diciembre,Suiza,31,60,,91,POINT (6170465 -7542726)
2017,Diciembre,Surinam,0,1,,1,POINT (10970933 -74765343)
2017,Diciembre,Surinam,2,5,,7,POINT (4697157 -74140516)
2017,Diciembre,Surinam,0,5,,5,POINT (6170465 -7542726)
2017,Diciembre,Taiwán,4,3,,7,POINT (4697157 -74140516)
2017,Diciembre,Taiwán,0,1,,1,POINT (6170465 -7542726)
2017,Diciembre,Tailandia,0,1,,1,POINT (3451668 -76532004)
2017,Diciembre,Tanzania,3,2,,5,POINT (4697157 -74140516)
2017,Diciembre,Trinidad y Tobago,0,2,,2,POINT (10406342 -75527794)
2017,Diciembre,Trinidad y Tobago,0,1,,1,POINT (10886686 -74776479)
2017,Diciembre,Trinidad y Tobago,15,15,,30,POINT (3451668 -76532004)
2017,Diciembre,Trinidad y Tobago,5,6,,11,POINT (4697157 -74140516)
2017,Diciembre,Trinidad y Tobago,0,3,,3,POINT (4815189 -75736374)
2017,Diciembre,Trinidad y Tobago,2,14,,16,POINT (6170465 -7542726)
2017,Diciembre,Trinidad y Tobago,0,3,,3,POINT (7128047 -73181317)
2017,Diciembre,Trinidad y Tobago,0,1,,1,POINT (9402597 -75681642)
2017,Diciembre,Túnez,2,3,,5,POINT (4697157 -74140516)
2017,Diciembre,Túnez,1,0,,1,POINT (6170465 -7542726)
2017,Diciembre,Turkmenistán,0,2,,2,POINT (4697157 -74140516)
2017,Diciembre,Turquía,1,1,,2,POINT (10446304 -75516486)
2017,Diciembre,Turquía,0,1,,1,POINT (3451668 -76532004)
2017,Diciembre,Turquía,351,517,,868,POINT (4697157 -74140516)
2017,Diciembre,Turquía,0,1,,1,POINT (6170465 -7542726)
2017,Diciembre,Ucrania,0,1,,1,POINT (10886686 -74776479)
2017,Diciembre,Ucrania,7,7,,14,POINT (4697157 -74140516)
2017,Diciembre,Uganda,1,0,,1,POINT (4697157 -74140516)
2017,Diciembre,Uruguay,0,1,,1,POINT (0.81488 -77356)
2017,Diciembre,Uruguay,4,6,,10,POINT (10446304 -75516486)
2017,Diciembre,Uruguay,0,3,,3,POINT (10886686 -74776479)
2017,Diciembre,Uruguay,22,13,,35,POINT (125862 -81702165)
2017,Diciembre,Uruguay,8,16,,24,POINT (3451668 -76532004)
2017,Diciembre,Uruguay,414,526,,940,POINT (4697157 -74140516)
2017,Diciembre,Uruguay,0,2,,2,POINT (4815189 -75736374)
2017,Diciembre,Uruguay,11,15,,26,POINT (6170465 -7542726)
2017,Diciembre,Uruguay,1,0,,1,POINT (7128047 -73181317)
2017,Diciembre,Vanuatu,0,1,,1,POINT (7819 -72453013)
2017,Diciembre,Venezuela,0,5,,5,POINT (10406342 -75527794)
2017,Diciembre,Venezuela,28,40,,68,POINT (10446304 -75516486)
2017,Diciembre,Venezuela,16,63,,79,POINT (10886686 -74776479)
2017,Diciembre,Venezuela,0,4,,4,POINT (10970933 -74765343)
2017,Diciembre,Venezuela,2,2,,4,POINT (11117206 -74232675)
2017,Diciembre,Venezuela,7412,7323,,14735,POINT (11360029 -72129595)
2017,Diciembre,Venezuela,9,10,,19,POINT (1152863 -72919186)
2017,Diciembre,Venezuela,32,46,,78,POINT (3451668 -76532004)
2017,Diciembre,Venezuela,12,9,,21,POINT (3866713 -67927521)
2017,Diciembre,Venezuela,3981,3648,,7629,POINT (4697157 -74140516)
2017,Diciembre,Venezuela,1,3,,4,POINT (4815189 -75736374)
2017,Diciembre,Venezuela,847,806,,1653,POINT (6170465 -7542726)
2017,Diciembre,Venezuela,26,30,,56,POINT (6185536 -67484028)
2017,Diciembre,Venezuela,1,2,,3,POINT (6218835 -75586989)
2017,Diciembre,Venezuela,369,403,,772,POINT (7088729 -70740253)
2017,Diciembre,Venezuela,5,12,,17,POINT (7128047 -73181317)
2017,Diciembre,Venezuela,32717,35264,,67981,POINT (7819 -72453013)
2017,Diciembre,Venezuela,8,8,,16,POINT (7927233 -72508188)
2017,Diciembre,Venezuela,1452,1354,,2806,POINT (836068 -72409396)
2017,Diciembre,Islas Vírgenes Británicas/Territorio Británico de Ultramar,0,4,,4,POINT (10406342 -75527794)
2017,Diciembre,Islas Vírgenes Británicas/Territorio Británico de Ultramar,3,1,,4,POINT (6170465 -7542726)
2017,Diciembre,Zambia,1,1,,2,POINT (6170465 -7542726)
2017,Diciembre,Zimbabue,0,1,,1,POINT (6170465 -7542726)
2017,Diciembre,Desconocido,30948,40454,,71402,POINT (4697157 -74140516)
2018,Enero,Afganistán,0,1,,1,POINT (10446304 -75516486)
2018,Enero,Afganistán,1,0,,1,POINT (4697157 -74140516)
2018,Enero,Albania,1,1,,2,POINT (10446304 -75516486)
2018,Enero,Albania,1,8,,9,POINT (4697157 -74140516)
2018,Enero,Albania,0,1,,1,POINT (6170465 -7542726)
2018,Enero,Albania,0,1,,1,POINT (836068 -72409396)
2018,Enero,Alemania,16,11,,27,POINT (-4191162 -69941498)
2018,Enero,Alemania,19,15,,34,POINT (-4214082 -69941431)
2018,Enero,Alemania,1,0,,1,POINT (0.185957 -7478366)
2018,Enero,Alemania,3,5,,8,POINT (0.33002 -76876446)
2018,Enero,Alemania,109,128,,237,POINT (0.81488 -77356)
2018,Enero,Alemania,49,56,,105,POINT (10406342 -75527794)
2018,Enero,Alemania,191,244,,435,POINT (10446304 -75516486)
2018,Enero,Alemania,26,54,,80,POINT (10886686 -74776479)
2018,Enero,Alemania,4,9,,13,POINT (11247723 -74213989)
2018,Enero,Alemania,2,1,,3,POINT (11360029 -72129595)
2018,Enero,Alemania,1,2,,3,POINT (125744111 -81703935)
2018,Enero,Alemania,0,7,,7,POINT (125862 -81702165)
2018,Enero,Alemania,0,1,,1,POINT (133387613 -81372937)
2018,Enero,Alemania,72,123,,195,POINT (3451668 -76532004)
2018,Enero,Alemania,1,2,,3,POINT (3884426 -77061029)
2018,Enero,Alemania,2,0,,2,POINT (445285 -75766353)
2018,Enero,Alemania,1934,2762,,4696,POINT (4697157 -74140516)
2018,Enero,Alemania,3,18,,21,POINT (4815189 -75736374)
2018,Enero,Alemania,191,312,,503,POINT (6170465 -7542726)
2018,Enero,Alemania,0,6,,6,POINT (7128047 -73181317)
2018,Enero,Alemania,4,5,,9,POINT (7819 -72453013)
2018,Enero,Alemania,15,19,,34,POINT (863337 -7735002)
2018,Enero,Andorra,3,11,,14,POINT (4697157 -74140516)
2018,Enero,Andorra,0,1,,1,POINT (6170465 -7542726)
2018,Enero,Angola,0,2,,2,POINT (4697157 -74140516)
2018,Enero,Antigua y Barbuda,0,1,,1,POINT (10886686 -74776479)
2018,Enero,Antigua y Barbuda,1,0,,1,POINT (4697157 -74140516)
2018,Enero,Países Bajos,0,1,,1,POINT (4697157 -74140516)
2018,Enero,Países Bajos,1,0,,1,POINT (6170465 -7542726)
2018,Enero,Arabia Saudita,0,15,,15,POINT (4697157 -74140516)
2018,Enero,Arabia Saudita,0,1,,1,POINT (6170465 -7542726)
2018,Enero,Argelia,4,9,,13,POINT (4697157 -74140516)
2018,Enero,Argelia,1,0,,1,POINT (6170465 -7542726)
2018,Enero,Argentina,6,5,,11,POINT (-4191162 -69941498)
2018,Enero,Argentina,11,17,,28,POINT (-4214082 -69941431)
2018,Enero,Argentina,6,11,,17,POINT (0.33002 -76876446)
2018,Enero,Argentina,0,1,,1,POINT (0.812436 -77847006)
2018,Enero,Argentina,226,334,,560,POINT (0.81488 -77356)
2018,Enero,Argentina,0,1,,1,POINT (1800143 -78802679)
2018,Enero,Argentina,275,200,,475,POINT (10406342 -75527794)
2018,Enero,Argentina,2164,1559,,3723,POINT (10446304 -75516486)
2018,Enero,Argentina,28,41,,69,POINT (10886686 -74776479)
2018,Enero,Argentina,0,1,,1,POINT (11117206 -74232675)
2018,Enero,Argentina,14,27,,41,POINT (11360029 -72129595)
2018,Enero,Argentina,425,320,,745,POINT (125862 -81702165)
2018,Enero,Argentina,87,109,,196,POINT (3451668 -76532004)
2018,Enero,Argentina,0,1,,1,POINT (445285 -75766353)
2018,Enero,Argentina,10812,9790,,20602,POINT (4697157 -74140516)
2018,Enero,Argentina,8,6,,14,POINT (4815189 -75736374)
2018,Enero,Argentina,179,266,,445,POINT (6170465 -7542726)
2018,Enero,Argentina,2,1,,3,POINT (7128047 -73181317)
2018,Enero,Argentina,11,29,,40,POINT (7819 -72453013)
2018,Enero,Argentina,0,6,,6,POINT (7927233 -72508188)
2018,Enero,Argentina,4,2,,6,POINT (836068 -72409396)
2018,Enero,Argentina,0,3,,3,POINT (863337 -7735002)
2018,Enero,República de Armenia,2,2,,4,POINT (4697157 -74140516)
2018,Enero,Aruba,1,0,,1,POINT (7128047 -73181317)
2018,Enero,Australia,1,2,,3,POINT (-4191162 -69941498)
2018,Enero,Australia,6,8,,14,POINT (-4214082 -69941431)
2018,Enero,Australia,1,1,,2,POINT (0.33002 -76876446)
2018,Enero,Australia,25,52,,77,POINT (0.81488 -77356)
2018,Enero,Australia,24,42,,66,POINT (10406342 -75527794)
2018,Enero,Australia,75,132,,207,POINT (10446304 -75516486)
2018,Enero,Australia,15,24,,39,POINT (10886686 -74776479)
2018,Enero,Australia,1,3,,4,POINT (11247723 -74213989)
2018,Enero,Australia,0,1,,1,POINT (11360029 -72129595)
2018,Enero,Australia,0,1,,1,POINT (125744111 -81703935)
2018,Enero,Australia,0,2,,2,POINT (125862 -81702165)
2018,Enero,Australia,0,1,,1,POINT (133387613 -81372937)
2018,Enero,Australia,15,24,,39,POINT (3451668 -76532004)
2018,Enero,Australia,1,1,,2,POINT (445285 -75766353)
2018,Enero,Australia,397,634,,1031,POINT (4697157 -74140516)
2018,Enero,Australia,0,1,,1,POINT (4815189 -75736374)
2018,Enero,Australia,55,149,,204,POINT (6170465 -7542726)
2018,Enero,Australia,0,2,,2,POINT (7128047 -73181317)
2018,Enero,Australia,0,2,,2,POINT (7819 -72453013)
2018,Enero,Australia,20,27,,47,POINT (863337 -7735002)
2018,Enero,Austria,0,2,,2,POINT (-4191162 -69941498)
2018,Enero,Austria,3,1,,4,POINT (-4214082 -69941431)
2018,Enero,Austria,4,3,,7,POINT (0.33002 -76876446)
2018,Enero,Austria,9,14,,23,POINT (0.81488 -77356)
2018,Enero,Austria,2,6,,8,POINT (10406342 -75527794)
2018,Enero,Austria,27,29,,56,POINT (10446304 -75516486)
2018,Enero,Austria,8,6,,14,POINT (10886686 -74776479)
2018,Enero,Austria,3,6,,9,POINT (11247723 -74213989)
2018,Enero,Austria,1,2,,3,POINT (125862 -81702165)
2018,Enero,Austria,6,16,,22,POINT (3451668 -76532004)
2018,Enero,Austria,221,344,,565,POINT (4697157 -74140516)
2018,Enero,Austria,0,1,,1,POINT (4815189 -75736374)
2018,Enero,Austria,22,43,,65,POINT (6170465 -7542726)
2018,Enero,Austria,0,1,,1,POINT (7128047 -73181317)
2018,Enero,Austria,1,3,,4,POINT (863337 -7735002)
2018,Enero,Azerbaiyán,0,1,,1,POINT (0.81488 -77356)
2018,Enero,Azerbaiyán,3,4,,7,POINT (4697157 -74140516)
2018,Enero,Bahamas,0,1,,1,POINT (0.81488 -77356)
2018,Enero,Bahamas,2,6,,8,POINT (10446304 -75516486)
2018,Enero,Bahamas,0,1,,1,POINT (10886686 -74776479)
2018,Enero,Bahamas,0,3,,3,POINT (3451668 -76532004)
2018,Enero,Bahamas,5,8,,13,POINT (4697157 -74140516)
2018,Enero,Bahamas,1,1,,2,POINT (6170465 -7542726)
2018,Enero,Bahamas,0,1,,1,POINT (7128047 -73181317)
2018,Enero,Bahréin,1,0,,1,POINT (4697157 -74140516)
2018,Enero,Bangladesh,0,1,,1,POINT (445285 -75766353)
2018,Enero,Bangladesh,0,3,,3,POINT (4697157 -74140516)
2018,Enero,Barbados,1,3,,4,POINT (10446304 -75516486)
2018,Enero,Barbados,0,1,,1,POINT (10886686 -74776479)
2018,Enero,Barbados,1,2,,3,POINT (3451668 -76532004)
2018,Enero,Barbados,4,10,,14,POINT (4697157 -74140516)
2018,Enero,Barbados,1,2,,3,POINT (6170465 -7542726)
2018,Enero,República de Belarús,1,0,,1,POINT (10446304 -75516486)
2018,Enero,República de Belarús,5,6,,11,POINT (4697157 -74140516)
2018,Enero,Bélgica,1,3,,4,POINT (-4191162 -69941498)
2018,Enero,Bélgica,1,0,,1,POINT (-4214082 -69941431)
2018,Enero,Bélgica,1,1,,2,POINT (0.33002 -76876446)
2018,Enero,Bélgica,10,14,,24,POINT (0.81488 -77356)
2018,Enero,Bélgica,3,8,,11,POINT (10406342 -75527794)
2018,Enero,Bélgica,28,54,,82,POINT (10446304 -75516486)
2018,Enero,Bélgica,4,6,,10,POINT (10886686 -74776479)
2018,Enero,Bélgica,0,3,,3,POINT (10970933 -74765343)
2018,Enero,Bélgica,15,21,,36,POINT (3451668 -76532004)
2018,Enero,Bélgica,313,506,,819,POINT (4697157 -74140516)
2018,Enero,Bélgica,0,1,,1,POINT (4815189 -75736374)
2018,Enero,Bélgica,33,69,,102,POINT (6170465 -7542726)
2018,Enero,Bélgica,2,0,,2,POINT (7819 -72453013)
2018,Enero,Bélgica,2,1,,3,POINT (863337 -7735002)
2018,Enero,Belice,0,1,,1,POINT (10446304 -75516486)
2018,Enero,Belice,0,1,,1,POINT (10886686 -74776479)
2018,Enero,Belice,0,1,,1,POINT (3451668 -76532004)
2018,Enero,Belice,5,5,,10,POINT (4697157 -74140516)
2018,Enero,Belice,2,3,,5,POINT (6170465 -7542726)
2018,Enero,Belice,0,2,,2,POINT (7819 -72453013)
2018,Enero,Bermudas/Territorio Británico de Ultramar,0,1,,1,POINT (3451668 -76532004)
2018,Enero,Bolivia,4,4,,8,POINT (-4191162 -69941498)
2018,Enero,Bolivia,0,1,,1,POINT (0.33002 -76876446)
2018,Enero,Bolivia,27,26,,53,POINT (0.81488 -77356)
2018,Enero,Bolivia,35,12,,47,POINT (10406342 -75527794)
2018,Enero,Bolivia,116,104,,220,POINT (10446304 -75516486)
2018,Enero,Bolivia,9,7,,16,POINT (10886686 -74776479)
2018,Enero,Bolivia,1,0,,1,POINT (11360029 -72129595)
2018,Enero,Bolivia,15,19,,34,POINT (125862 -81702165)
2018,Enero,Bolivia,24,24,,48,POINT (3451668 -76532004)
2018,Enero,Bolivia,975,877,,1852,POINT (4697157 -74140516)
2018,Enero,Bolivia,1,1,,2,POINT (4815189 -75736374)
2018,Enero,Bolivia,47,51,,98,POINT (6170465 -7542726)
2018,Enero,Bolivia,0,1,,1,POINT (7088729 -70740253)
2018,Enero,Bolivia,5,12,,17,POINT (7819 -72453013)
2018,Enero,Bolivia,0,2,,2,POINT (836068 -72409396)
2018,Enero,Bosnia y Herzegovina,0,1,,1,POINT (10406342 -75527794)
2018,Enero,Bosnia y Herzegovina,3,2,,5,POINT (4697157 -74140516)
2018,Enero,Brasil,143,130,,273,POINT (-4191162 -69941498)
2018,Enero,Brasil,5,4,,9,POINT (-4214082 -69941431)
2018,Enero,Brasil,1,0,,1,POINT (0.185957 -7478366)
2018,Enero,Brasil,1,3,,4,POINT (0.33002 -76876446)
2018,Enero,Brasil,38,60,,98,POINT (0.81488 -77356)
2018,Enero,Brasil,2,1,,3,POINT (1800143 -78802679)
2018,Enero,Brasil,305,244,,549,POINT (10406342 -75527794)
2018,Enero,Brasil,700,575,,1275,POINT (10446304 -75516486)
2018,Enero,Brasil,30,50,,80,POINT (10886686 -74776479)
2018,Enero,Brasil,2,7,,9,POINT (11360029 -72129595)
2018,Enero,Brasil,0,2,,2,POINT (125744111 -81703935)
2018,Enero,Brasil,204,175,,379,POINT (125862 -81702165)
2018,Enero,Brasil,103,119,,222,POINT (3451668 -76532004)
2018,Enero,Brasil,0,1,,1,POINT (3866713 -67927521)
2018,Enero,Brasil,9200,8774,,17974,POINT (4697157 -74140516)
2018,Enero,Brasil,7,5,,12,POINT (4815189 -75736374)
2018,Enero,Brasil,230,339,,569,POINT (6170465 -7542726)
2018,Enero,Brasil,2,0,,2,POINT (7088729 -70740253)
2018,Enero,Brasil,0,1,,1,POINT (7128047 -73181317)
2018,Enero,Brasil,9,12,,21,POINT (7819 -72453013)
2018,Enero,Brasil,1,0,,1,POINT (836068 -72409396)
2018,Enero,Brasil,0,3,,3,POINT (863337 -7735002)
2018,Enero,Bulgaria,3,5,,8,POINT (0.81488 -77356)
2018,Enero,Bulgaria,0,3,,3,POINT (10406342 -75527794)
2018,Enero,Bulgaria,9,6,,15,POINT (10446304 -75516486)
2018,Enero,Bulgaria,1,1,,2,POINT (10886686 -74776479)
2018,Enero,Bulgaria,0,1,,1,POINT (125862 -81702165)
2018,Enero,Bulgaria,2,8,,10,POINT (3451668 -76532004)
2018,Enero,Bulgaria,0,4,,4,POINT (3884426 -77061029)
2018,Enero,Bulgaria,1,0,,1,POINT (445285 -75766353)
2018,Enero,Bulgaria,35,35,,70,POINT (4697157 -74140516)
2018,Enero,Bulgaria,3,12,,15,POINT (6170465 -7542726)
2018,Enero,Bulgaria,0,1,,1,POINT (7819 -72453013)
2018,Enero,Bután,1,0,,1,POINT (4697157 -74140516)
2018,Enero,Cabo Verde,0,5,,5,POINT (10446304 -75516486)
2018,Enero,Islas Caimán/Territorio Británico de Ultramar,0,1,,1,POINT (125862 -81702165)
2018,Enero,Islas Caimán/Territorio Británico de Ultramar,0,1,,1,POINT (3451668 -76532004)
2018,Enero,Islas Caimán/Territorio Británico de Ultramar,0,1,,1,POINT (7128047 -73181317)
2018,Enero,Camerún,0,1,,1,POINT (0.81488 -77356)
2018,Enero,Camerún,0,1,,1,POINT (3451668 -76532004)
2018,Enero,Canadá,1,1,,2,POINT (-4191162 -69941498)
2018,Enero,Canadá,1,6,,7,POINT (-4214082 -69941431)
2018,Enero,Canadá,0,2,,2,POINT (0.33002 -76876446)
2018,Enero,Canadá,23,34,,57,POINT (0.81488 -77356)
2018,Enero,Canadá,17,19,,36,POINT (10406342 -75527794)
2018,Enero,Canadá,974,1098,,2072,POINT (10446304 -75516486)
2018,Enero,Canadá,51,66,,117,POINT (10886686 -74776479)
2018,Enero,Canadá,1,3,,4,POINT (11117206 -74232675)
2018,Enero,Canadá,4,2,,6,POINT (11247723 -74213989)
2018,Enero,Canadá,0,5,,5,POINT (125744111 -81703935)
2018,Enero,Canadá,285,288,,573,POINT (125862 -81702165)
2018,Enero,Canadá,0,2,,2,POINT (133387613 -81372937)
2018,Enero,Canadá,62,79,,141,POINT (3451668 -76532004)
2018,Enero,Canadá,2,1,,3,POINT (445285 -75766353)
2018,Enero,Canadá,1362,2136,,3498,POINT (4697157 -74140516)
2018,Enero,Canadá,12,21,,33,POINT (4815189 -75736374)
2018,Enero,Canadá,226,471,,697,POINT (6170465 -7542726)
2018,Enero,Canadá,2,8,,10,POINT (7128047 -73181317)
2018,Enero,Canadá,0,3,,3,POINT (7819 -72453013)
2018,Enero,Canadá,8,7,,15,POINT (863337 -7735002)
2018,Enero,República Democrática del Congo,1,5,,6,POINT (4697157 -74140516)
2018,Enero,República Democrática del Congo,2,0,,2,POINT (6170465 -7542726)
2018,Enero,República Democrática del Congo,0,1,,1,POINT (7819 -72453013)
2018,Enero,República de Corea,0,1,,1,POINT (-4191162 -69941498)
2018,Enero,República de Corea,25,18,,43,POINT (0.81488 -77356)
2018,Enero,República de Corea,1,2,,3,POINT (10406342 -75527794)
2018,Enero,República de Corea,14,6,,20,POINT (10446304 -75516486)
2018,Enero,República de Corea,1,7,,8,POINT (10886686 -74776479)
2018,Enero,República de Corea,0,1,,1,POINT (11247723 -74213989)
2018,Enero,República de Corea,2,2,,4,POINT (125862 -81702165)
2018,Enero,República de Corea,3,2,,5,POINT (3451668 -76532004)
2018,Enero,República de Corea,463,609,,1072,POINT (4697157 -74140516)
2018,Enero,República de Corea,25,52,,77,POINT (6170465 -7542726)
2018,Enero,República de Corea,3,7,,10,POINT (7819 -72453013)
2018,Enero,República de Corea,0,1,,1,POINT (863337 -7735002)
2018,Enero,Costa de Marfil,0,1,,1,POINT (10446304 -75516486)
2018,Enero,Costa de Marfil,1,2,,3,POINT (4697157 -74140516)
2018,Enero,Costa Rica,0,1,,1,POINT (-4214082 -69941431)
2018,Enero,Costa Rica,2,1,,3,POINT (0.33002 -76876446)
2018,Enero,Costa Rica,7,9,,16,POINT (0.81488 -77356)
2018,Enero,Costa Rica,2,1,,3,POINT (10406342 -75527794)
2018,Enero,Costa Rica,399,265,,664,POINT (10446304 -75516486)
2018,Enero,Costa Rica,32,32,,64,POINT (10886686 -74776479)
2018,Enero,Costa Rica,1,0,,1,POINT (11360029 -72129595)
2018,Enero,Costa Rica,123,84,,207,POINT (125862 -81702165)
2018,Enero,Costa Rica,94,118,,212,POINT (3451668 -76532004)
2018,Enero,Costa Rica,0,1,,1,POINT (445285 -75766353)
2018,Enero,Costa Rica,1541,1511,,3052,POINT (4697157 -74140516)
2018,Enero,Costa Rica,15,11,,26,POINT (4815189 -75736374)
2018,Enero,Costa Rica,233,257,,490,POINT (6170465 -7542726)
2018,Enero,Costa Rica,4,2,,6,POINT (7128047 -73181317)
2018,Enero,Costa Rica,0,3,,3,POINT (7819 -72453013)
2018,Enero,Croacia,1,1,,2,POINT (0.81488 -77356)
2018,Enero,Croacia,0,3,,3,POINT (10406342 -75527794)
2018,Enero,Croacia,12,16,,28,POINT (10446304 -75516486)
2018,Enero,Croacia,1,2,,3,POINT (10886686 -74776479)
2018,Enero,Croacia,0,3,,3,POINT (10970933 -74765343)
2018,Enero,Croacia,3,0,,3,POINT (3451668 -76532004)
2018,Enero,Croacia,29,65,,94,POINT (4697157 -74140516)
2018,Enero,Croacia,2,3,,5,POINT (6170465 -7542726)
2018,Enero,Croacia,0,2,,2,POINT (9402597 -75681642)
2018,Enero,Cuba,0,1,,1,POINT (0.33002 -76876446)
2018,Enero,Cuba,1,3,,4,POINT (0.81488 -77356)
2018,Enero,Cuba,0,9,,9,POINT (10406342 -75527794)
2018,Enero,Cuba,18,37,,55,POINT (10446304 -75516486)
2018,Enero,Cuba,11,29,,40,POINT (10886686 -74776479)
2018,Enero,Cuba,1,0,,1,POINT (125862 -81702165)
2018,Enero,Cuba,22,44,,66,POINT (3451668 -76532004)
2018,Enero,Cuba,892,885,,1777,POINT (4697157 -74140516)
2018,Enero,Cuba,2,5,,7,POINT (4815189 -75736374)
2018,Enero,Cuba,29,33,,62,POINT (6170465 -7542726)
2018,Enero,Cuba,0,1,,1,POINT (7088729 -70740253)
2018,Enero,Cuba,1,2,,3,POINT (7128047 -73181317)
2018,Enero,Cuba,0,2,,2,POINT (7819 -72453013)
2018,Enero,Cuba,1,0,,1,POINT (836068 -72409396)
2018,Enero,República Checa,5,7,,12,POINT (0.81488 -77356)
2018,Enero,República Checa,3,1,,4,POINT (10406342 -75527794)
2018,Enero,República Checa,12,8,,20,POINT (10446304 -75516486)
2018,Enero,República Checa,4,3,,7,POINT (10886686 -74776479)
2018,Enero,República Checa,4,6,,10,POINT (3451668 -76532004)
2018,Enero,República Checa,78,114,,192,POINT (4697157 -74140516)
2018,Enero,República Checa,1,1,,2,POINT (4815189 -75736374)
2018,Enero,República Checa,4,10,,14,POINT (6170465 -7542726)
2018,Enero,República Checa,0,1,,1,POINT (7819 -72453013)
2018,Enero,República Checa,1,3,,4,POINT (863337 -7735002)
2018,Enero,Chile,3,2,,5,POINT (-4191162 -69941498)
2018,Enero,Chile,6,2,,8,POINT (-4214082 -69941431)
2018,Enero,Chile,3,3,,6,POINT (0.33002 -76876446)
2018,Enero,Chile,104,157,,261,POINT (0.81488 -77356)
2018,Enero,Chile,0,1,,1,POINT (1800143 -78802679)
2018,Enero,Chile,65,52,,117,POINT (10406342 -75527794)
2018,Enero,Chile,195,185,,380,POINT (10446304 -75516486)
2018,Enero,Chile,8,14,,22,POINT (10886686 -74776479)
2018,Enero,Chile,2,5,,7,POINT (11360029 -72129595)
2018,Enero,Chile,0,3,,3,POINT (125744111 -81703935)
2018,Enero,Chile,62,39,,101,POINT (125862 -81702165)
2018,Enero,Chile,36,71,,107,POINT (3451668 -76532004)
2018,Enero,Chile,1,1,,2,POINT (3884426 -77061029)
2018,Enero,Chile,1,0,,1,POINT (445285 -75766353)
2018,Enero,Chile,4507,4909,,9416,POINT (4697157 -74140516)
2018,Enero,Chile,0,4,,4,POINT (4815189 -75736374)
2018,Enero,Chile,56,94,,150,POINT (6170465 -7542726)
2018,Enero,Chile,0,2,,2,POINT (7088729 -70740253)
2018,Enero,Chile,0,2,,2,POINT (7128047 -73181317)
2018,Enero,Chile,17,44,,61,POINT (7819 -72453013)
2018,Enero,Chile,0,6,,6,POINT (836068 -72409396)
2018,Enero,Chile,0,1,,1,POINT (863337 -7735002)
2018,Enero,China,0,1,,1,POINT (-4191162 -69941498)
2018,Enero,China,1,0,,1,POINT (0.33002 -76876446)
2018,Enero,China,11,9,,20,POINT (0.81488 -77356)
2018,Enero,China,13,27,,40,POINT (10446304 -75516486)
2018,Enero,China,21,12,,33,POINT (10886686 -74776479)
2018,Enero,China,0,2,,2,POINT (10970933 -74765343)
2018,Enero,China,1,1,,2,POINT (11247723 -74213989)
2018,Enero,China,3,6,,9,POINT (11360029 -72129595)
2018,Enero,China,0,1,,1,POINT (125862 -81702165)
2018,Enero,China,12,16,,28,POINT (3451668 -76532004)
2018,Enero,China,380,705,,1085,POINT (4697157 -74140516)
2018,Enero,China,2,0,,2,POINT (4815189 -75736374)
2018,Enero,China,39,63,,102,POINT (6170465 -7542726)
2018,Enero,China,0,1,,1,POINT (7088729 -70740253)
2018,Enero,China,2,0,,2,POINT (7128047 -73181317)
2018,Enero,China,6,16,,22,POINT (7819 -72453013)
2018,Enero,China,1,2,,3,POINT (836068 -72409396)
2018,Enero,China,0,2,,2,POINT (9402597 -75681642)
2018,Enero,Taiwán,1,0,,1,POINT (-4191162 -69941498)
2018,Enero,Taiwán,1,0,,1,POINT (0.33002 -76876446)
2018,Enero,Taiwán,1,3,,4,POINT (0.81488 -77356)
2018,Enero,Taiwán,6,3,,9,POINT (10446304 -75516486)
2018,Enero,Taiwán,3,7,,10,POINT (3451668 -76532004)
2018,Enero,Taiwán,46,67,,113,POINT (4697157 -74140516)
2018,Enero,Taiwán,6,16,,22,POINT (6170465 -7542726)
2018,Enero,Taiwán,1,0,,1,POINT (7819 -72453013)
2018,Enero,Chipre,0,1,,1,POINT (0.81488 -77356)
2018,Enero,Chipre,2,1,,3,POINT (10446304 -75516486)
2018,Enero,Chipre,1,0,,1,POINT (3451668 -76532004)
2018,Enero,Chipre,6,5,,11,POINT (4697157 -74140516)
2018,Enero,Chipre,0,1,,1,POINT (6170465 -7542726)
2018,Enero,Dinamarca,1,0,,1,POINT (-4191162 -69941498)
2018,Enero,Dinamarca,2,0,,2,POINT (-4214082 -69941431)
2018,Enero,Dinamarca,0,1,,1,POINT (0.33002 -76876446)
2018,Enero,Dinamarca,4,10,,14,POINT (0.81488 -77356)
2018,Enero,Dinamarca,4,10,,14,POINT (10406342 -75527794)
2018,Enero,Dinamarca,26,49,,75,POINT (10446304 -75516486)
2018,Enero,Dinamarca,11,11,,22,POINT (10886686 -74776479)
2018,Enero,Dinamarca,4,7,,11,POINT (11247723 -74213989)
2018,Enero,Dinamarca,0,1,,1,POINT (125744111 -81703935)
2018,Enero,Dinamarca,2,4,,6,POINT (125862 -81702165)
2018,Enero,Dinamarca,9,10,,19,POINT (3451668 -76532004)
2018,Enero,Dinamarca,0,1,,1,POINT (3866713 -67927521)
2018,Enero,Dinamarca,1,0,,1,POINT (445285 -75766353)
2018,Enero,Dinamarca,179,222,,401,POINT (4697157 -74140516)
2018,Enero,Dinamarca,0,1,,1,POINT (4815189 -75736374)
2018,Enero,Dinamarca,14,38,,52,POINT (6170465 -7542726)
2018,Enero,Dinamarca,0,1,,1,POINT (7128047 -73181317)
2018,Enero,Dinamarca,0,2,,2,POINT (7819 -72453013)
2018,Enero,Dinamarca,1,1,,2,POINT (836068 -72409396)
2018,Enero,Dinamarca,2,1,,3,POINT (863337 -7735002)
2018,Enero,Dominica,7,4,,11,POINT (4697157 -74140516)
2018,Enero,Dominica,0,4,,4,POINT (6170465 -7542726)
2018,Enero,Ecuador,0,1,,1,POINT (-4191162 -69941498)
2018,Enero,Ecuador,0,5,,5,POINT (-4214082 -69941431)
2018,Enero,Ecuador,79,291,,370,POINT (0.33002 -76876446)
2018,Enero,Ecuador,3,6,,9,POINT (0.812436 -77847006)
2018,Enero,Ecuador,1349,2140,,3489,POINT (0.81488 -77356)
2018,Enero,Ecuador,24,40,,64,POINT (1800143 -78802679)
2018,Enero,Ecuador,0,14,,14,POINT (10406342 -75527794)
2018,Enero,Ecuador,27,29,,56,POINT (10446304 -75516486)
2018,Enero,Ecuador,8,10,,18,POINT (10886686 -74776479)
2018,Enero,Ecuador,0,1,,1,POINT (10970933 -74765343)
2018,Enero,Ecuador,8,9,,17,POINT (11360029 -72129595)
2018,Enero,Ecuador,7,7,,14,POINT (125862 -81702165)
2018,Enero,Ecuador,359,389,,748,POINT (3451668 -76532004)
2018,Enero,Ecuador,0,2,,2,POINT (3866713 -67927521)
2018,Enero,Ecuador,1,3,,4,POINT (445285 -75766353)
2018,Enero,Ecuador,2721,3394,,6115,POINT (4697157 -74140516)
2018,Enero,Ecuador,2,2,,4,POINT (4815189 -75736374)
2018,Enero,Ecuador,76,138,,214,POINT (6170465 -7542726)
2018,Enero,Ecuador,2,2,,4,POINT (7088729 -70740253)
2018,Enero,Ecuador,1,3,,4,POINT (7128047 -73181317)
2018,Enero,Ecuador,145,314,,459,POINT (7819 -72453013)
2018,Enero,Ecuador,82,380,,462,POINT (7927233 -72508188)
2018,Enero,Ecuador,5,13,,18,POINT (836068 -72409396)
2018,Enero,Ecuador,0,5,,5,POINT (863337 -7735002)
2018,Enero,Egipto,0,3,,3,POINT (10446304 -75516486)
2018,Enero,Egipto,6,27,,33,POINT (4697157 -74140516)
2018,Enero,Egipto,0,2,,2,POINT (6170465 -7542726)
2018,Enero,El Salvador,0,1,,1,POINT (-4214082 -69941431)
2018,Enero,El Salvador,1,1,,2,POINT (0.33002 -76876446)
2018,Enero,El Salvador,3,3,,6,POINT (0.81488 -77356)
2018,Enero,El Salvador,34,24,,58,POINT (10446304 -75516486)
2018,Enero,El Salvador,5,6,,11,POINT (10886686 -74776479)
2018,Enero,El Salvador,9,9,,18,POINT (125862 -81702165)
2018,Enero,El Salvador,89,105,,194,POINT (3451668 -76532004)
2018,Enero,El Salvador,671,845,,1516,POINT (4697157 -74140516)
2018,Enero,El Salvador,3,5,,8,POINT (4815189 -75736374)
2018,Enero,El Salvador,131,189,,320,POINT (6170465 -7542726)
2018,Enero,Emiratos Árabes,0,1,,1,POINT (0.81488 -77356)
2018,Enero,Emiratos Árabes,1,13,,14,POINT (4697157 -74140516)
2018,Enero,España,5,2,,7,POINT (-4191162 -69941498)
2018,Enero,España,5,12,,17,POINT (-4214082 -69941431)
2018,Enero,España,6,14,,20,POINT (0.33002 -76876446)
2018,Enero,España,48,76,,124,POINT (0.81488 -77356)
2018,Enero,España,13,21,,34,POINT (10406342 -75527794)
2018,Enero,España,111,176,,287,POINT (10446304 -75516486)
2018,Enero,España,14,47,,61,POINT (10886686 -74776479)
2018,Enero,España,0,2,,2,POINT (10970933 -74765343)
2018,Enero,España,0,1,,1,POINT (11117206 -74232675)
2018,Enero,España,0,3,,3,POINT (11247723 -74213989)
2018,Enero,España,6,12,,18,POINT (11360029 -72129595)
2018,Enero,España,0,1,,1,POINT (125744111 -81703935)
2018,Enero,España,2,3,,5,POINT (125862 -81702165)
2018,Enero,España,447,634,,1081,POINT (3451668 -76532004)
2018,Enero,España,0,4,,4,POINT (445285 -75766353)
2018,Enero,España,2814,5473,,8287,POINT (4697157 -74140516)
2018,Enero,España,3,8,,11,POINT (4815189 -75736374)
2018,Enero,España,454,872,,1326,POINT (6170465 -7542726)
2018,Enero,España,1,0,,1,POINT (6185536 -67484028)
2018,Enero,España,2,1,,3,POINT (7128047 -73181317)
2018,Enero,España,31,51,,82,POINT (7819 -72453013)
2018,Enero,España,0,1,,1,POINT (7927233 -72508188)
2018,Enero,España,4,4,,8,POINT (836068 -72409396)
2018,Enero,España,4,3,,7,POINT (863337 -7735002)
2018,Enero,Eslovaquia,0,1,,1,POINT (0.81488 -77356)
2018,Enero,Eslovaquia,1,1,,2,POINT (10406342 -75527794)
2018,Enero,Eslovaquia,3,4,,7,POINT (10446304 -75516486)
2018,Enero,Eslovaquia,1,0,,1,POINT (10886686 -74776479)
2018,Enero,Eslovaquia,0,1,,1,POINT (11360029 -72129595)
2018,Enero,Eslovaquia,1,2,,3,POINT (3451668 -76532004)
2018,Enero,Eslovaquia,53,68,,121,POINT (4697157 -74140516)
2018,Enero,Eslovaquia,0,3,,3,POINT (4815189 -75736374)
2018,Enero,Eslovaquia,4,7,,11,POINT (6170465 -7542726)
2018,Enero,Eslovenia,1,2,,3,POINT (10446304 -75516486)
2018,Enero,Eslovenia,1,1,,2,POINT (3451668 -76532004)
2018,Enero,Eslovenia,41,59,,100,POINT (4697157 -74140516)
2018,Enero,Eslovenia,4,4,,8,POINT (6170465 -7542726)
2018,Enero,Eslovenia,0,1,,1,POINT (6185536 -67484028)
2018,Enero,Estados Unidos de América,13,15,,28,POINT (-4191162 -69941498)
2018,Enero,Estados Unidos de América,8,14,,22,POINT (-4214082 -69941431)
2018,Enero,Estados Unidos de América,4,6,,10,POINT (0.33002 -76876446)
2018,Enero,Estados Unidos de América,79,132,,211,POINT (0.81488 -77356)
2018,Enero,Estados Unidos de América,0,2,,2,POINT (1800143 -78802679)
2018,Enero,Estados Unidos de América,51,85,,136,POINT (10406342 -75527794)
2018,Enero,Estados Unidos de América,3861,5585,,9446,POINT (10446304 -75516486)
2018,Enero,Estados Unidos de América,496,760,,1256,POINT (10886686 -74776479)
2018,Enero,Estados Unidos de América,1,0,,1,POINT (11117206 -74232675)
2018,Enero,Estados Unidos de América,21,29,,50,POINT (11247723 -74213989)
2018,Enero,Estados Unidos de América,4,6,,10,POINT (11360029 -72129595)
2018,Enero,Estados Unidos de América,5,13,,18,POINT (125744111 -81703935)
2018,Enero,Estados Unidos de América,51,55,,106,POINT (125862 -81702165)
2018,Enero,Estados Unidos de América,0,1,,1,POINT (133387613 -81372937)
2018,Enero,Estados Unidos de América,918,1417,,2335,POINT (3451668 -76532004)
2018,Enero,Estados Unidos de América,61,112,,173,POINT (445285 -75766353)
2018,Enero,Estados Unidos de América,7366,12552,,19918,POINT (4697157 -74140516)
2018,Enero,Estados Unidos de América,147,222,,369,POINT (4815189 -75736374)
2018,Enero,Estados Unidos de América,2110,5418,,7528,POINT (6170465 -7542726)
2018,Enero,Estados Unidos de América,0,1,,1,POINT (7088729 -70740253)
2018,Enero,Estados Unidos de América,27,38,,65,POINT (7128047 -73181317)
2018,Enero,Estados Unidos de América,15,17,,32,POINT (7819 -72453013)
2018,Enero,Estados Unidos de América,0,2,,2,POINT (7927233 -72508188)
2018,Enero,Estados Unidos de América,0,6,,6,POINT (806667 -767333)
2018,Enero,Estados Unidos de América,4,3,,7,POINT (836068 -72409396)
2018,Enero,Estados Unidos de América,13,13,,26,POINT (863337 -7735002)
2018,Enero,Estonia,3,1,,4,POINT (0.81488 -77356)
2018,Enero,Estonia,0,12,,12,POINT (10406342 -75527794)
2018,Enero,Estonia,2,4,,6,POINT (10446304 -75516486)
2018,Enero,Estonia,4,2,,6,POINT (3451668 -76532004)
2018,Enero,Estonia,10,17,,27,POINT (4697157 -74140516)
2018,Enero,Estonia,2,3,,5,POINT (6170465 -7542726)
2018,Enero,Etiopia,0,1,,1,POINT (10446304 -75516486)
2018,Enero,Etiopia,1,4,,5,POINT (4697157 -74140516)
2018,Enero,Filipinas,1,0,,1,POINT (-4191162 -69941498)
2018,Enero,Filipinas,3,1,,4,POINT (0.81488 -77356)
2018,Enero,Filipinas,4,44,,48,POINT (10406342 -75527794)
2018,Enero,Filipinas,8,42,,50,POINT (10446304 -75516486)
2018,Enero,Filipinas,0,6,,6,POINT (10886686 -74776479)
2018,Enero,Filipinas,0,10,,10,POINT (10970933 -74765343)
2018,Enero,Filipinas,0,14,,14,POINT (11247723 -74213989)
2018,Enero,Filipinas,0,7,,7,POINT (125744111 -81703935)
2018,Enero,Filipinas,4,10,,14,POINT (3451668 -76532004)
2018,Enero,Filipinas,0,12,,12,POINT (3884426 -77061029)
2018,Enero,Filipinas,49,66,,115,POINT (4697157 -74140516)
2018,Enero,Filipinas,5,3,,8,POINT (6170465 -7542726)
2018,Enero,Filipinas,0,8,,8,POINT (9402597 -75681642)
2018,Enero,Finlandia,0,1,,1,POINT (-4214082 -69941431)
2018,Enero,Finlandia,7,6,,13,POINT (0.81488 -77356)
2018,Enero,Finlandia,1,4,,5,POINT (10406342 -75527794)
2018,Enero,Finlandia,15,18,,33,POINT (10446304 -75516486)
2018,Enero,Finlandia,0,4,,4,POINT (10886686 -74776479)
2018,Enero,Finlandia,5,2,,7,POINT (11247723 -74213989)
2018,Enero,Finlandia,9,3,,12,POINT (3451668 -76532004)
2018,Enero,Finlandia,69,63,,132,POINT (4697157 -74140516)
2018,Enero,Finlandia,7,6,,13,POINT (6170465 -7542726)
2018,Enero,Finlandia,1,0,,1,POINT (7819 -72453013)
2018,Enero,Finlandia,2,0,,2,POINT (863337 -7735002)
2018,Enero,Francia,10,9,,19,POINT (-4191162 -69941498)
2018,Enero,Francia,18,20,,38,POINT (-4214082 -69941431)
2018,Enero,Francia,7,6,,13,POINT (0.33002 -76876446)
2018,Enero,Francia,127,128,,255,POINT (0.81488 -77356)
2018,Enero,Francia,16,16,,32,POINT (10406342 -75527794)
2018,Enero,Francia,192,308,,500,POINT (10446304 -75516486)
2018,Enero,Francia,20,42,,62,POINT (10886686 -74776479)
2018,Enero,Francia,0,2,,2,POINT (10970933 -74765343)
2018,Enero,Francia,3,4,,7,POINT (11247723 -74213989)
2018,Enero,Francia,4,10,,14,POINT (11360029 -72129595)
2018,Enero,Francia,2,5,,7,POINT (125862 -81702165)
2018,Enero,Francia,5,5,,10,POINT (133387613 -81372937)
2018,Enero,Francia,91,159,,250,POINT (3451668 -76532004)
2018,Enero,Francia,1,1,,2,POINT (3866713 -67927521)
2018,Enero,Francia,0,1,,1,POINT (445285 -75766353)
2018,Enero,Francia,2845,3781,,6626,POINT (4697157 -74140516)
2018,Enero,Francia,3,5,,8,POINT (4815189 -75736374)
2018,Enero,Francia,206,395,,601,POINT (6170465 -7542726)
2018,Enero,Francia,2,14,,16,POINT (7819 -72453013)
2018,Enero,Francia,13,12,,25,POINT (863337 -7735002)
2018,Enero,Georgia,0,1,,1,POINT (3451668 -76532004)
2018,Enero,Georgia,3,3,,6,POINT (4697157 -74140516)
2018,Enero,Ghana,0,6,,6,POINT (0.81488 -77356)
2018,Enero,Ghana,0,2,,2,POINT (3451668 -76532004)
2018,Enero,Ghana,2,8,,10,POINT (4697157 -74140516)
2018,Enero,Granada,0,1,,1,POINT (10446304 -75516486)
2018,Enero,Granada,0,1,,1,POINT (4697157 -74140516)
2018,Enero,Granada,1,0,,1,POINT (6170465 -7542726)
2018,Enero,Grecia,1,0,,1,POINT (-4214082 -69941431)
2018,Enero,Grecia,1,2,,3,POINT (0.81488 -77356)
2018,Enero,Grecia,0,2,,2,POINT (10406342 -75527794)
2018,Enero,Grecia,4,15,,19,POINT (10446304 -75516486)
2018,Enero,Grecia,0,2,,2,POINT (10886686 -74776479)
2018,Enero,Grecia,0,1,,1,POINT (11247723 -74213989)
2018,Enero,Grecia,0,6,,6,POINT (3451668 -76532004)
2018,Enero,Grecia,31,48,,79,POINT (4697157 -74140516)
2018,Enero,Grecia,3,12,,15,POINT (6170465 -7542726)
2018,Enero,Grecia,0,2,,2,POINT (7819 -72453013)
2018,Enero,Guatemala,3,3,,6,POINT (0.81488 -77356)
2018,Enero,Guatemala,0,1,,1,POINT (1800143 -78802679)
2018,Enero,Guatemala,0,4,,4,POINT (10406342 -75527794)
2018,Enero,Guatemala,165,144,,309,POINT (10446304 -75516486)
2018,Enero,Guatemala,7,28,,35,POINT (10886686 -74776479)
2018,Enero,Guatemala,0,1,,1,POINT (11360029 -72129595)
2018,Enero,Guatemala,5,6,,11,POINT (125862 -81702165)
2018,Enero,Guatemala,17,40,,57,POINT (3451668 -76532004)
2018,Enero,Guatemala,341,581,,922,POINT (4697157 -74140516)
2018,Enero,Guatemala,7,10,,17,POINT (4815189 -75736374)
2018,Enero,Guatemala,63,149,,212,POINT (6170465 -7542726)
2018,Enero,Guatemala,3,0,,3,POINT (7128047 -73181317)
2018,Enero,Guatemala,0,6,,6,POINT (7819 -72453013)
2018,Enero,Guatemala,4,0,,4,POINT (836068 -72409396)
2018,Enero,Guyana,0,1,,1,POINT (10406342 -75527794)
2018,Enero,Guyana,0,2,,2,POINT (10446304 -75516486)
2018,Enero,Guyana,1,0,,1,POINT (10886686 -74776479)
2018,Enero,Guyana,6,10,,16,POINT (4697157 -74140516)
2018,Enero,Guyana,0,1,,1,POINT (6170465 -7542726)
2018,Enero,Haití,1,2,,3,POINT (10446304 -75516486)
2018,Enero,Haití,6,18,,24,POINT (4697157 -74140516)
2018,Enero,Haití,3,6,,9,POINT (6170465 -7542726)
2018,Enero,Honduras,8,7,,15,POINT (0.81488 -77356)
2018,Enero,Honduras,0,24,,24,POINT (10406342 -75527794)
2018,Enero,Honduras,53,46,,99,POINT (10446304 -75516486)
2018,Enero,Honduras,6,15,,21,POINT (10886686 -74776479)
2018,Enero,Honduras,0,2,,2,POINT (10970933 -74765343)
2018,Enero,Honduras,1,0,,1,POINT (125862 -81702165)
2018,Enero,Honduras,42,40,,82,POINT (3451668 -76532004)
2018,Enero,Honduras,186,198,,384,POINT (4697157 -74140516)
2018,Enero,Honduras,1,1,,2,POINT (4815189 -75736374)
2018,Enero,Honduras,45,93,,138,POINT (6170465 -7542726)
2018,Enero,Honduras,1,3,,4,POINT (7819 -72453013)
2018,Enero,Honduras,0,1,,1,POINT (863337 -7735002)
2018,Enero,Hong Kong,0,2,,2,POINT (0.81488 -77356)
2018,Enero,Hong Kong,0,1,,1,POINT (11360029 -72129595)
2018,Enero,Hong Kong,8,6,,14,POINT (4697157 -74140516)
2018,Enero,Hungría,1,2,,3,POINT (-4191162 -69941498)
2018,Enero,Hungría,1,4,,5,POINT (0.81488 -77356)
2018,Enero,Hungría,2,1,,3,POINT (10406342 -75527794)
2018,Enero,Hungría,9,13,,22,POINT (10446304 -75516486)
2018,Enero,Hungría,1,3,,4,POINT (10886686 -74776479)
2018,Enero,Hungría,1,1,,2,POINT (11247723 -74213989)
2018,Enero,Hungría,0,1,,1,POINT (125862 -81702165)
2018,Enero,Hungría,4,7,,11,POINT (3451668 -76532004)
2018,Enero,Hungría,60,86,,146,POINT (4697157 -74140516)
2018,Enero,Hungría,5,14,,19,POINT (6170465 -7542726)
2018,Enero,India,0,1,,1,POINT (-4214082 -69941431)
2018,Enero,India,4,7,,11,POINT (0.81488 -77356)
2018,Enero,India,0,16,,16,POINT (10406342 -75527794)
2018,Enero,India,12,43,,55,POINT (10446304 -75516486)
2018,Enero,India,0,5,,5,POINT (10886686 -74776479)
2018,Enero,India,2,1,,3,POINT (11247723 -74213989)
2018,Enero,India,5,11,,16,POINT (3451668 -76532004)
2018,Enero,India,0,4,,4,POINT (3884426 -77061029)
2018,Enero,India,0,1,,1,POINT (445285 -75766353)
2018,Enero,India,85,370,,455,POINT (4697157 -74140516)
2018,Enero,India,0,2,,2,POINT (4815189 -75736374)
2018,Enero,India,15,103,,118,POINT (6170465 -7542726)
2018,Enero,India,0,1,,1,POINT (7128047 -73181317)
2018,Enero,India,0,1,,1,POINT (9402597 -75681642)
2018,Enero,Indonesia,0,3,,3,POINT (10406342 -75527794)
2018,Enero,Indonesia,1,5,,6,POINT (10446304 -75516486)
2018,Enero,Indonesia,0,2,,2,POINT (10886686 -74776479)
2018,Enero,Indonesia,0,3,,3,POINT (10970933 -74765343)
2018,Enero,Indonesia,0,1,,1,POINT (125744111 -81703935)
2018,Enero,Indonesia,16,24,,40,POINT (4697157 -74140516)
2018,Enero,Indonesia,1,2,,3,POINT (6170465 -7542726)
2018,Enero,Iraq,0,2,,2,POINT (4697157 -74140516)
2018,Enero,Irán,1,1,,2,POINT (10446304 -75516486)
2018,Enero,Irán,9,13,,22,POINT (4697157 -74140516)
2018,Enero,Irán,0,1,,1,POINT (6170465 -7542726)
2018,Enero,República de Irlanda,0,2,,2,POINT (-4191162 -69941498)
2018,Enero,República de Irlanda,0,1,,1,POINT (-4214082 -69941431)
2018,Enero,República de Irlanda,9,6,,15,POINT (0.81488 -77356)
2018,Enero,República de Irlanda,4,3,,7,POINT (10406342 -75527794)
2018,Enero,República de Irlanda,23,45,,68,POINT (10446304 -75516486)
2018,Enero,República de Irlanda,0,5,,5,POINT (10886686 -74776479)
2018,Enero,República de Irlanda,3,3,,6,POINT (11247723 -74213989)
2018,Enero,República de Irlanda,1,10,,11,POINT (3451668 -76532004)
2018,Enero,República de Irlanda,120,214,,334,POINT (4697157 -74140516)
2018,Enero,República de Irlanda,16,37,,53,POINT (6170465 -7542726)
2018,Enero,República de Irlanda,0,1,,1,POINT (7819 -72453013)
2018,Enero,República de Irlanda,2,3,,5,POINT (863337 -7735002)
2018,Enero,Islandia,7,5,,12,POINT (10446304 -75516486)
2018,Enero,Islandia,0,1,,1,POINT (3451668 -76532004)
2018,Enero,Islandia,7,8,,15,POINT (4697157 -74140516)
2018,Enero,Islandia,3,0,,3,POINT (4815189 -75736374)
2018,Enero,Islandia,0,1,,1,POINT (6170465 -7542726)
2018,Enero,Israel,0,2,,2,POINT (-4191162 -69941498)
2018,Enero,Israel,0,2,,2,POINT (-4214082 -69941431)
2018,Enero,Israel,1,2,,3,POINT (0.33002 -76876446)
2018,Enero,Israel,3,18,,21,POINT (0.81488 -77356)
2018,Enero,Israel,1,2,,3,POINT (10406342 -75527794)
2018,Enero,Israel,22,87,,109,POINT (10446304 -75516486)
2018,Enero,Israel,2,3,,5,POINT (10886686 -74776479)
2018,Enero,Israel,1,1,,2,POINT (125862 -81702165)
2018,Enero,Israel,5,17,,22,POINT (3451668 -76532004)
2018,Enero,Israel,160,521,,681,POINT (4697157 -74140516)
2018,Enero,Israel,1,0,,1,POINT (4815189 -75736374)
2018,Enero,Israel,23,95,,118,POINT (6170465 -7542726)
2018,Enero,Israel,0,1,,1,POINT (7128047 -73181317)
2018,Enero,Israel,0,2,,2,POINT (863337 -7735002)
2018,Enero,Italia,2,1,,3,POINT (-4191162 -69941498)
2018,Enero,Italia,3,5,,8,POINT (-4214082 -69941431)
2018,Enero,Italia,2,11,,13,POINT (0.33002 -76876446)
2018,Enero,Italia,1,0,,1,POINT (0.812436 -77847006)
2018,Enero,Italia,25,47,,72,POINT (0.81488 -77356)
2018,Enero,Italia,11,32,,43,POINT (10406342 -75527794)
2018,Enero,Italia,104,303,,407,POINT (10446304 -75516486)
2018,Enero,Italia,16,36,,52,POINT (10886686 -74776479)
2018,Enero,Italia,1,5,,6,POINT (11247723 -74213989)
2018,Enero,Italia,1,10,,11,POINT (11360029 -72129595)
2018,Enero,Italia,10,9,,19,POINT (125862 -81702165)
2018,Enero,Italia,46,116,,162,POINT (3451668 -76532004)
2018,Enero,Italia,907,2096,,3003,POINT (4697157 -74140516)
2018,Enero,Italia,2,4,,6,POINT (4815189 -75736374)
2018,Enero,Italia,122,363,,485,POINT (6170465 -7542726)
2018,Enero,Italia,2,2,,4,POINT (6185536 -67484028)
2018,Enero,Italia,0,2,,2,POINT (7088729 -70740253)
2018,Enero,Italia,1,4,,5,POINT (7128047 -73181317)
2018,Enero,Italia,17,23,,40,POINT (7819 -72453013)
2018,Enero,Italia,3,3,,6,POINT (836068 -72409396)
2018,Enero,Italia,1,5,,6,POINT (863337 -7735002)
2018,Enero,Jamaica,5,11,,16,POINT (10446304 -75516486)
2018,Enero,Jamaica,2,3,,5,POINT (10886686 -74776479)
2018,Enero,Jamaica,0,1,,1,POINT (11360029 -72129595)
2018,Enero,Jamaica,1,0,,1,POINT (125862 -81702165)
2018,Enero,Jamaica,5,2,,7,POINT (3451668 -76532004)
2018,Enero,Jamaica,28,27,,55,POINT (4697157 -74140516)
2018,Enero,Jamaica,2,5,,7,POINT (6170465 -7542726)
2018,Enero,Japón,2,1,,3,POINT (-4214082 -69941431)
2018,Enero,Japón,2,17,,19,POINT (0.81488 -77356)
2018,Enero,Japón,0,1,,1,POINT (10406342 -75527794)
2018,Enero,Japón,16,22,,38,POINT (10446304 -75516486)
2018,Enero,Japón,1,7,,8,POINT (10886686 -74776479)
2018,Enero,Japón,0,1,,1,POINT (11247723 -74213989)
2018,Enero,Japón,4,6,,10,POINT (3451668 -76532004)
2018,Enero,Japón,215,445,,660,POINT (4697157 -74140516)
2018,Enero,Japón,1,0,,1,POINT (4815189 -75736374)
2018,Enero,Japón,11,68,,79,POINT (6170465 -7542726)
2018,Enero,Jordania,0,1,,1,POINT (0.81488 -77356)
2018,Enero,Jordania,0,3,,3,POINT (10446304 -75516486)
2018,Enero,Jordania,1,1,,2,POINT (4697157 -74140516)
2018,Enero,Jordania,1,1,,2,POINT (6170465 -7542726)
2018,Enero,Kazajistán,1,0,,1,POINT (10446304 -75516486)
2018,Enero,Kazajistán,0,1,,1,POINT (3451668 -76532004)
2018,Enero,Kazajistán,3,7,,10,POINT (4697157 -74140516)
2018,Enero,Kazajistán,1,0,,1,POINT (6170465 -7542726)
2018,Enero,Kenia,0,1,,1,POINT (0.81488 -77356)
2018,Enero,Kenia,0,1,,1,POINT (3451668 -76532004)
2018,Enero,Kenia,6,7,,13,POINT (4697157 -74140516)
2018,Enero,Kenia,1,2,,3,POINT (6170465 -7542726)
2018,Enero,Kirguistán,1,0,,1,POINT (4697157 -74140516)
2018,Enero,Kirguistán,1,1,,2,POINT (6170465 -7542726)
2018,Enero,Kuwait,0,1,,1,POINT (3451668 -76532004)
2018,Enero,Kuwait,0,6,,6,POINT (4697157 -74140516)
2018,Enero,República de Kosovo,0,1,,1,POINT (4697157 -74140516)
2018,Enero,República Democrática Popular  Lao,1,0,,1,POINT (4697157 -74140516)
2018,Enero,Letonia,1,0,,1,POINT (0.33002 -76876446)
2018,Enero,Letonia,3,3,,6,POINT (10446304 -75516486)
2018,Enero,Letonia,1,0,,1,POINT (10886686 -74776479)
2018,Enero,Letonia,0,1,,1,POINT (125862 -81702165)
2018,Enero,Letonia,0,1,,1,POINT (3451668 -76532004)
2018,Enero,Letonia,16,25,,41,POINT (4697157 -74140516)
2018,Enero,Letonia,1,0,,1,POINT (6170465 -7542726)
2018,Enero,Lituania,0,1,,1,POINT (0.81488 -77356)
2018,Enero,Lituania,1,2,,3,POINT (10406342 -75527794)
2018,Enero,Lituania,1,2,,3,POINT (10446304 -75516486)
2018,Enero,Lituania,0,1,,1,POINT (10886686 -74776479)
2018,Enero,Lituania,1,0,,1,POINT (125862 -81702165)
2018,Enero,Lituania,1,3,,4,POINT (3451668 -76532004)
2018,Enero,Lituania,16,36,,52,POINT (4697157 -74140516)
2018,Enero,Lituania,3,3,,6,POINT (6170465 -7542726)
2018,Enero,Lituania,1,0,,1,POINT (863337 -7735002)
2018,Enero,Líbano,2,1,,3,POINT (10886686 -74776479)
2018,Enero,Líbano,2,0,,2,POINT (11360029 -72129595)
2018,Enero,Líbano,9,26,,35,POINT (4697157 -74140516)
2018,Enero,Liberia,1,0,,1,POINT (3451668 -76532004)
2018,Enero,Libia,0,1,,1,POINT (4697157 -74140516)
2018,Enero,Libia,0,1,,1,POINT (6170465 -7542726)
2018,Enero,Liechtenstein,0,1,,1,POINT (10406342 -75527794)
2018,Enero,Liechtenstein,3,1,,4,POINT (4697157 -74140516)
2018,Enero,Liechtenstein,0,1,,1,POINT (863337 -7735002)
2018,Enero,Luxemburgo,1,0,,1,POINT (0.81488 -77356)
2018,Enero,Luxemburgo,1,1,,2,POINT (10446304 -75516486)
2018,Enero,Luxemburgo,1,1,,2,POINT (3451668 -76532004)
2018,Enero,Luxemburgo,13,15,,28,POINT (4697157 -74140516)
2018,Enero,Luxemburgo,1,1,,2,POINT (6170465 -7542726)
2018,Enero,Macedonia,0,1,,1,POINT (10446304 -75516486)
2018,Enero,Macedonia,0,1,,1,POINT (4697157 -74140516)
2018,Enero,Madagascar,2,1,,3,POINT (4697157 -74140516)
2018,Enero,Malasia,1,0,,1,POINT (-4191162 -69941498)
2018,Enero,Malasia,2,2,,4,POINT (10446304 -75516486)
2018,Enero,Malasia,1,1,,2,POINT (10886686 -74776479)
2018,Enero,Malasia,12,17,,29,POINT (4697157 -74140516)
2018,Enero,Malasia,0,1,,1,POINT (4815189 -75736374)
2018,Enero,Malasia,1,5,,6,POINT (6170465 -7542726)
2018,Enero,Malawi,0,1,,1,POINT (4697157 -74140516)
2018,Enero,Malí,0,2,,2,POINT (4697157 -74140516)
2018,Enero,Malta,0,1,,1,POINT (0.81488 -77356)
2018,Enero,Malta,1,2,,3,POINT (10446304 -75516486)
2018,Enero,Malta,5,11,,16,POINT (4697157 -74140516)
2018,Enero,Malta,1,0,,1,POINT (6170465 -7542726)
2018,Enero,Marruecos,0,1,,1,POINT (0.81488 -77356)
2018,Enero,Marruecos,0,1,,1,POINT (10446304 -75516486)
2018,Enero,Marruecos,0,1,,1,POINT (3451668 -76532004)
2018,Enero,Marruecos,14,14,,28,POINT (4697157 -74140516)
2018,Enero,Marruecos,1,2,,3,POINT (6170465 -7542726)
2018,Enero,Mauricio,0,1,,1,POINT (10406342 -75527794)
2018,Enero,Mauricio,0,2,,2,POINT (4697157 -74140516)
2018,Enero,Mauricio,1,0,,1,POINT (6170465 -7542726)
2018,Enero,México,0,1,,1,POINT (-4191162 -69941498)
2018,Enero,México,0,2,,2,POINT (-4214082 -69941431)
2018,Enero,México,0,1,,1,POINT (0.33002 -76876446)
2018,Enero,México,25,35,,60,POINT (0.81488 -77356)
2018,Enero,México,5,15,,20,POINT (10406342 -75527794)
2018,Enero,México,171,282,,453,POINT (10446304 -75516486)
2018,Enero,México,33,61,,94,POINT (10886686 -74776479)
2018,Enero,México,1,4,,5,POINT (11360029 -72129595)
2018,Enero,México,0,1,,1,POINT (125744111 -81703935)
2018,Enero,México,2,3,,5,POINT (125862 -81702165)
2018,Enero,México,81,156,,237,POINT (3451668 -76532004)
2018,Enero,México,1,0,,1,POINT (445285 -75766353)
2018,Enero,México,3763,6109,,9872,POINT (4697157 -74140516)
2018,Enero,México,12,22,,34,POINT (4815189 -75736374)
2018,Enero,México,556,1154,,1710,POINT (6170465 -7542726)
2018,Enero,México,0,1,,1,POINT (6185536 -67484028)
2018,Enero,México,4,1,,5,POINT (7088729 -70740253)
2018,Enero,México,5,14,,19,POINT (7128047 -73181317)
2018,Enero,México,17,35,,52,POINT (7819 -72453013)
2018,Enero,México,3,4,,7,POINT (7927233 -72508188)
2018,Enero,México,1,2,,3,POINT (836068 -72409396)
2018,Enero,México,1,0,,1,POINT (863337 -7735002)
2018,Enero,República de Moldavia,1,0,,1,POINT (10446304 -75516486)
2018,Enero,República de Moldavia,5,0,,5,POINT (4697157 -74140516)
2018,Enero,Mónaco,0,1,,1,POINT (10446304 -75516486)
2018,Enero,Mónaco,0,2,,2,POINT (3451668 -76532004)
2018,Enero,Mónaco,0,1,,1,POINT (4697157 -74140516)
2018,Enero,Mónaco,1,0,,1,POINT (6170465 -7542726)
2018,Enero,Mongolia,1,1,,2,POINT (10446304 -75516486)
2018,Enero,Mongolia,3,1,,4,POINT (4697157 -74140516)
2018,Enero,Montenegro,3,2,,5,POINT (10446304 -75516486)
2018,Enero,Montenegro,2,2,,4,POINT (4697157 -74140516)
2018,Enero,Montenegro,0,1,,1,POINT (6170465 -7542726)
2018,Enero,Mozambique,1,4,,5,POINT (4697157 -74140516)
2018,Enero,Myanmar,0,1,,1,POINT (10886686 -74776479)
2018,Enero,Myanmar,0,1,,1,POINT (11247723 -74213989)
2018,Enero,Myanmar,0,2,,2,POINT (4697157 -74140516)
2018,Enero,Nepal,1,0,,1,POINT (10446304 -75516486)
2018,Enero,Nepal,0,1,,1,POINT (3451668 -76532004)
2018,Enero,Nepal,1,1,,2,POINT (4697157 -74140516)
2018,Enero,Nicaragua,0,1,,1,POINT (0.81488 -77356)
2018,Enero,Nicaragua,0,5,,5,POINT (10406342 -75527794)
2018,Enero,Nicaragua,29,29,,58,POINT (10446304 -75516486)
2018,Enero,Nicaragua,1,2,,3,POINT (10886686 -74776479)
2018,Enero,Nicaragua,1,3,,4,POINT (125862 -81702165)
2018,Enero,Nicaragua,21,10,,31,POINT (3451668 -76532004)
2018,Enero,Nicaragua,1,0,,1,POINT (445285 -75766353)
2018,Enero,Nicaragua,98,77,,175,POINT (4697157 -74140516)
2018,Enero,Nicaragua,10,8,,18,POINT (4815189 -75736374)
2018,Enero,Nicaragua,19,27,,46,POINT (6170465 -7542726)
2018,Enero,Nicaragua,0,1,,1,POINT (7128047 -73181317)
2018,Enero,Nigeria,2,0,,2,POINT (0.81488 -77356)
2018,Enero,Nigeria,1,0,,1,POINT (3451668 -76532004)
2018,Enero,Nigeria,3,7,,10,POINT (4697157 -74140516)
2018,Enero,Nigeria,0,2,,2,POINT (6170465 -7542726)
2018,Enero,Níger,0,1,,1,POINT (4697157 -74140516)
2018,Enero,Noruega,1,0,,1,POINT (-4191162 -69941498)
2018,Enero,Noruega,0,1,,1,POINT (-4214082 -69941431)
2018,Enero,Noruega,3,6,,9,POINT (0.81488 -77356)
2018,Enero,Noruega,3,8,,11,POINT (10406342 -75527794)
2018,Enero,Noruega,37,50,,87,POINT (10446304 -75516486)
2018,Enero,Noruega,33,31,,64,POINT (11247723 -74213989)
2018,Enero,Noruega,9,10,,19,POINT (3451668 -76532004)
2018,Enero,Noruega,164,176,,340,POINT (4697157 -74140516)
2018,Enero,Noruega,17,22,,39,POINT (6170465 -7542726)
2018,Enero,Noruega,2,3,,5,POINT (863337 -7735002)
2018,Enero,Nueva Zelanda,1,1,,2,POINT (-4191162 -69941498)
2018,Enero,Nueva Zelanda,1,1,,2,POINT (0.33002 -76876446)
2018,Enero,Nueva Zelanda,7,8,,15,POINT (0.81488 -77356)
2018,Enero,Nueva Zelanda,6,5,,11,POINT (10406342 -75527794)
2018,Enero,Nueva Zelanda,21,24,,45,POINT (10446304 -75516486)
2018,Enero,Nueva Zelanda,2,6,,8,POINT (10886686 -74776479)
2018,Enero,Nueva Zelanda,1,1,,2,POINT (11247723 -74213989)
2018,Enero,Nueva Zelanda,0,1,,1,POINT (11360029 -72129595)
2018,Enero,Nueva Zelanda,1,2,,3,POINT (3451668 -76532004)
2018,Enero,Nueva Zelanda,71,101,,172,POINT (4697157 -74140516)
2018,Enero,Nueva Zelanda,16,30,,46,POINT (6170465 -7542726)
2018,Enero,Nueva Zelanda,3,3,,6,POINT (863337 -7735002)
2018,Enero,Omán,0,1,,1,POINT (4697157 -74140516)
2018,Enero,Países Bajos,0,2,,2,POINT (-4191162 -69941498)
2018,Enero,Países Bajos,2,7,,9,POINT (-4214082 -69941431)
2018,Enero,Países Bajos,2,5,,7,POINT (0.33002 -76876446)
2018,Enero,Países Bajos,42,43,,85,POINT (0.81488 -77356)
2018,Enero,Países Bajos,50,67,,117,POINT (10406342 -75527794)
2018,Enero,Países Bajos,150,218,,368,POINT (10446304 -75516486)
2018,Enero,Países Bajos,10,17,,27,POINT (10886686 -74776479)
2018,Enero,Países Bajos,0,3,,3,POINT (10970933 -74765343)
2018,Enero,Países Bajos,1,2,,3,POINT (11247723 -74213989)
2018,Enero,Países Bajos,1,8,,9,POINT (11360029 -72129595)
2018,Enero,Países Bajos,1,0,,1,POINT (133387613 -81372937)
2018,Enero,Países Bajos,27,44,,71,POINT (3451668 -76532004)
2018,Enero,Países Bajos,0,2,,2,POINT (445285 -75766353)
2018,Enero,Países Bajos,1396,1817,,3213,POINT (4697157 -74140516)
2018,Enero,Países Bajos,3,4,,7,POINT (4815189 -75736374)
2018,Enero,Países Bajos,161,226,,387,POINT (6170465 -7542726)
2018,Enero,Países Bajos,11,6,,17,POINT (7128047 -73181317)
2018,Enero,Países Bajos,0,11,,11,POINT (7819 -72453013)
2018,Enero,Países Bajos,0,1,,1,POINT (836068 -72409396)
2018,Enero,Países Bajos,5,7,,12,POINT (863337 -7735002)
2018,Enero,Pakistán,0,2,,2,POINT (10446304 -75516486)
2018,Enero,Pakistán,5,16,,21,POINT (4697157 -74140516)
2018,Enero,Pakistán,0,5,,5,POINT (6170465 -7542726)
2018,Enero,Panamá,0,1,,1,POINT (-4191162 -69941498)
2018,Enero,Panamá,1,5,,6,POINT (0.81488 -77356)
2018,Enero,Panamá,0,30,,30,POINT (10406342 -75527794)
2018,Enero,Panamá,665,652,,1317,POINT (10446304 -75516486)
2018,Enero,Panamá,119,137,,256,POINT (10886686 -74776479)
2018,Enero,Panamá,0,1,,1,POINT (11360029 -72129595)
2018,Enero,Panamá,73,69,,142,POINT (125862 -81702165)
2018,Enero,Panamá,335,225,,560,POINT (3451668 -76532004)
2018,Enero,Panamá,39,36,,75,POINT (445285 -75766353)
2018,Enero,Panamá,1476,1353,,2829,POINT (4697157 -74140516)
2018,Enero,Panamá,54,67,,121,POINT (4815189 -75736374)
2018,Enero,Panamá,2384,1569,,3953,POINT (6170465 -7542726)
2018,Enero,Panamá,2,6,,8,POINT (7102626 -77762647)
2018,Enero,Panamá,13,16,,29,POINT (7128047 -73181317)
2018,Enero,Panamá,3,4,,7,POINT (7819 -72453013)
2018,Enero,Panamá,0,1,,1,POINT (806667 -767333)
2018,Enero,Panamá,0,1,,1,POINT (836068 -72409396)
2018,Enero,Panamá,8,8,,16,POINT (863337 -7735002)
2018,Enero,Papúa Nueva Guinea,0,1,,1,POINT (10446304 -75516486)
2018,Enero,Paraguay,3,1,,4,POINT (0.81488 -77356)
2018,Enero,Paraguay,3,2,,5,POINT (10406342 -75527794)
2018,Enero,Paraguay,71,47,,118,POINT (10446304 -75516486)
2018,Enero,Paraguay,2,11,,13,POINT (10886686 -74776479)
2018,Enero,Paraguay,0,1,,1,POINT (11360029 -72129595)
2018,Enero,Paraguay,60,44,,104,POINT (125862 -81702165)
2018,Enero,Paraguay,13,10,,23,POINT (3451668 -76532004)
2018,Enero,Paraguay,310,199,,509,POINT (4697157 -74140516)
2018,Enero,Paraguay,1,2,,3,POINT (4815189 -75736374)
2018,Enero,Paraguay,17,24,,41,POINT (6170465 -7542726)
2018,Enero,Paraguay,0,1,,1,POINT (7819 -72453013)
2018,Enero,Paraguay,0,3,,3,POINT (7927233 -72508188)
2018,Enero,Perú,21,18,,39,POINT (-4191162 -69941498)
2018,Enero,Perú,64,75,,139,POINT (-4214082 -69941431)
2018,Enero,Perú,0,2,,2,POINT (0.185957 -7478366)
2018,Enero,Perú,14,15,,29,POINT (0.33002 -76876446)
2018,Enero,Perú,0,2,,2,POINT (0.812436 -77847006)
2018,Enero,Perú,250,515,,765,POINT (0.81488 -77356)
2018,Enero,Perú,33,38,,71,POINT (10406342 -75527794)
2018,Enero,Perú,518,361,,879,POINT (10446304 -75516486)
2018,Enero,Perú,12,15,,27,POINT (10886686 -74776479)
2018,Enero,Perú,0,5,,5,POINT (10970933 -74765343)
2018,Enero,Perú,0,1,,1,POINT (11247723 -74213989)
2018,Enero,Perú,8,18,,26,POINT (11360029 -72129595)
2018,Enero,Perú,341,276,,617,POINT (125862 -81702165)
2018,Enero,Perú,182,261,,443,POINT (3451668 -76532004)
2018,Enero,Perú,0,2,,2,POINT (3884426 -77061029)
2018,Enero,Perú,3471,4080,,7551,POINT (4697157 -74140516)
2018,Enero,Perú,2,7,,9,POINT (4815189 -75736374)
2018,Enero,Perú,330,533,,863,POINT (6170465 -7542726)
2018,Enero,Perú,0,1,,1,POINT (6185536 -67484028)
2018,Enero,Perú,0,2,,2,POINT (7088729 -70740253)
2018,Enero,Perú,4,2,,6,POINT (7128047 -73181317)
2018,Enero,Perú,98,213,,311,POINT (7819 -72453013)
2018,Enero,Perú,1,4,,5,POINT (836068 -72409396)
2018,Enero,Perú,2,0,,2,POINT (863337 -7735002)
2018,Enero,Palestina,1,2,,3,POINT (4697157 -74140516)
2018,Enero,Palestina,1,0,,1,POINT (6170465 -7542726)
2018,Enero,Polonia,0,1,,1,POINT (-4214082 -69941431)
2018,Enero,Polonia,0,1,,1,POINT (0.33002 -76876446)
2018,Enero,Polonia,3,8,,11,POINT (0.81488 -77356)
2018,Enero,Polonia,1,10,,11,POINT (10406342 -75527794)
2018,Enero,Polonia,30,58,,88,POINT (10446304 -75516486)
2018,Enero,Polonia,1,4,,5,POINT (10886686 -74776479)
2018,Enero,Polonia,1,1,,2,POINT (11247723 -74213989)
2018,Enero,Polonia,0,1,,1,POINT (125862 -81702165)
2018,Enero,Polonia,15,14,,29,POINT (3451668 -76532004)
2018,Enero,Polonia,0,2,,2,POINT (3884426 -77061029)
2018,Enero,Polonia,200,236,,436,POINT (4697157 -74140516)
2018,Enero,Polonia,2,11,,13,POINT (4815189 -75736374)
2018,Enero,Polonia,22,24,,46,POINT (6170465 -7542726)
2018,Enero,Polonia,0,8,,8,POINT (6185536 -67484028)
2018,Enero,Polonia,2,2,,4,POINT (863337 -7735002)
2018,Enero,Portugal,0,1,,1,POINT (-4214082 -69941431)
2018,Enero,Portugal,27,27,,54,POINT (0.81488 -77356)
2018,Enero,Portugal,31,26,,57,POINT (10446304 -75516486)
2018,Enero,Portugal,2,12,,14,POINT (10886686 -74776479)
2018,Enero,Portugal,1,1,,2,POINT (11247723 -74213989)
2018,Enero,Portugal,2,5,,7,POINT (11360029 -72129595)
2018,Enero,Portugal,1,2,,3,POINT (125862 -81702165)
2018,Enero,Portugal,23,35,,58,POINT (3451668 -76532004)
2018,Enero,Portugal,244,534,,778,POINT (4697157 -74140516)
2018,Enero,Portugal,0,1,,1,POINT (4815189 -75736374)
2018,Enero,Portugal,31,76,,107,POINT (6170465 -7542726)
2018,Enero,Portugal,1,2,,3,POINT (7088729 -70740253)
2018,Enero,Portugal,0,1,,1,POINT (7128047 -73181317)
2018,Enero,Portugal,11,19,,30,POINT (7819 -72453013)
2018,Enero,Portugal,1,0,,1,POINT (836068 -72409396)
2018,Enero,Puerto Rico/Territorio de Estados Unidos,1,0,,1,POINT (4697157 -74140516)
2018,Enero,Reino Unido de Gran Bretaña e Irlanda del Norte,3,1,,4,POINT (-4191162 -69941498)
2018,Enero,Reino Unido de Gran Bretaña e Irlanda del Norte,6,6,,12,POINT (-4214082 -69941431)
2018,Enero,Reino Unido de Gran Bretaña e Irlanda del Norte,5,4,,9,POINT (0.33002 -76876446)
2018,Enero,Reino Unido de Gran Bretaña e Irlanda del Norte,43,81,,124,POINT (0.81488 -77356)
2018,Enero,Reino Unido de Gran Bretaña e Irlanda del Norte,30,39,,69,POINT (10406342 -75527794)
2018,Enero,Reino Unido de Gran Bretaña e Irlanda del Norte,161,190,,351,POINT (10446304 -75516486)
2018,Enero,Reino Unido de Gran Bretaña e Irlanda del Norte,2,20,,22,POINT (10886686 -74776479)
2018,Enero,Reino Unido de Gran Bretaña e Irlanda del Norte,13,17,,30,POINT (11247723 -74213989)
2018,Enero,Reino Unido de Gran Bretaña e Irlanda del Norte,4,1,,5,POINT (11360029 -72129595)
2018,Enero,Reino Unido de Gran Bretaña e Irlanda del Norte,1,4,,5,POINT (125862 -81702165)
2018,Enero,Reino Unido de Gran Bretaña e Irlanda del Norte,26,62,,88,POINT (3451668 -76532004)
2018,Enero,Reino Unido de Gran Bretaña e Irlanda del Norte,1,0,,1,POINT (3884426 -77061029)
2018,Enero,Reino Unido de Gran Bretaña e Irlanda del Norte,0,2,,2,POINT (445285 -75766353)
2018,Enero,Reino Unido de Gran Bretaña e Irlanda del Norte,1220,2161,,3381,POINT (4697157 -74140516)
2018,Enero,Reino Unido de Gran Bretaña e Irlanda del Norte,1,7,,8,POINT (4815189 -75736374)
2018,Enero,Reino Unido de Gran Bretaña e Irlanda del Norte,112,236,,348,POINT (6170465 -7542726)
2018,Enero,Reino Unido de Gran Bretaña e Irlanda del Norte,1,1,,2,POINT (7128047 -73181317)
2018,Enero,Reino Unido de Gran Bretaña e Irlanda del Norte,3,4,,7,POINT (7819 -72453013)
2018,Enero,Reino Unido de Gran Bretaña e Irlanda del Norte,22,22,,44,POINT (863337 -7735002)
2018,Enero,República Dominicana,0,10,,10,POINT (-4191162 -69941498)
2018,Enero,República Dominicana,0,1,,1,POINT (0.33002 -76876446)
2018,Enero,República Dominicana,7,15,,22,POINT (0.81488 -77356)
2018,Enero,República Dominicana,2,3,,5,POINT (10406342 -75527794)
2018,Enero,República Dominicana,105,111,,216,POINT (10446304 -75516486)
2018,Enero,República Dominicana,18,30,,48,POINT (10886686 -74776479)
2018,Enero,República Dominicana,1,1,,2,POINT (11360029 -72129595)
2018,Enero,República Dominicana,0,2,,2,POINT (125862 -81702165)
2018,Enero,República Dominicana,25,30,,55,POINT (3451668 -76532004)
2018,Enero,República Dominicana,470,545,,1015,POINT (4697157 -74140516)
2018,Enero,República Dominicana,3,3,,6,POINT (4815189 -75736374)
2018,Enero,República Dominicana,58,75,,133,POINT (6170465 -7542726)
2018,Enero,República Dominicana,1,2,,3,POINT (7128047 -73181317)
2018,Enero,República Dominicana,4,10,,14,POINT (7819 -72453013)
2018,Enero,República Dominicana,0,1,,1,POINT (836068 -72409396)
2018,Enero,Rumania,3,0,,3,POINT (0.33002 -76876446)
2018,Enero,Rumania,5,6,,11,POINT (0.81488 -77356)
2018,Enero,Rumania,1,2,,3,POINT (10406342 -75527794)
2018,Enero,Rumania,10,27,,37,POINT (10446304 -75516486)
2018,Enero,Rumania,2,3,,5,POINT (10886686 -74776479)
2018,Enero,Rumania,0,1,,1,POINT (125862 -81702165)
2018,Enero,Rumania,6,3,,9,POINT (3451668 -76532004)
2018,Enero,Rumania,70,75,,145,POINT (4697157 -74140516)
2018,Enero,Rumania,13,8,,21,POINT (6170465 -7542726)
2018,Enero,Rumania,1,0,,1,POINT (7819 -72453013)
2018,Enero,Federación de Rusia,1,1,,2,POINT (-4191162 -69941498)
2018,Enero,Federación de Rusia,3,2,,5,POINT (-4214082 -69941431)
2018,Enero,Federación de Rusia,15,13,,28,POINT (0.81488 -77356)
2018,Enero,Federación de Rusia,3,10,,13,POINT (10406342 -75527794)
2018,Enero,Federación de Rusia,30,27,,57,POINT (10446304 -75516486)
2018,Enero,Federación de Rusia,4,4,,8,POINT (10886686 -74776479)
2018,Enero,Federación de Rusia,0,2,,2,POINT (10970933 -74765343)
2018,Enero,Federación de Rusia,0,3,,3,POINT (11247723 -74213989)
2018,Enero,Federación de Rusia,1,1,,2,POINT (125862 -81702165)
2018,Enero,Federación de Rusia,1,1,,2,POINT (133387613 -81372937)
2018,Enero,Federación de Rusia,5,16,,21,POINT (3451668 -76532004)
2018,Enero,Federación de Rusia,1,0,,1,POINT (445285 -75766353)
2018,Enero,Federación de Rusia,249,272,,521,POINT (4697157 -74140516)
2018,Enero,Federación de Rusia,0,1,,1,POINT (4815189 -75736374)
2018,Enero,Federación de Rusia,18,9,,27,POINT (6170465 -7542726)
2018,Enero,Federación de Rusia,2,3,,5,POINT (7819 -72453013)
2018,Enero,Federación de Rusia,1,0,,1,POINT (836068 -72409396)
2018,Enero,Federación de Rusia,1,4,,5,POINT (863337 -7735002)
2018,Enero,Federación de Rusia,0,5,,5,POINT (9402597 -75681642)
2018,Enero,Rwanda,0,1,,1,POINT (4697157 -74140516)
2018,Enero,San Cristóbal y Nevis,0,1,,1,POINT (10446304 -75516486)
2018,Enero,San Cristóbal y Nevis,3,4,,7,POINT (4697157 -74140516)
2018,Enero,San Cristóbal y Nevis,1,0,,1,POINT (7128047 -73181317)
2018,Enero,San Marino,1,1,,2,POINT (4697157 -74140516)
2018,Enero,San  Vicente y las Granadinas,0,1,,1,POINT (125862 -81702165)
2018,Enero,San  Vicente y las Granadinas,0,1,,1,POINT (3451668 -76532004)
2018,Enero,San  Vicente y las Granadinas,2,3,,5,POINT (4697157 -74140516)
2018,Enero,San  Vicente y las Granadinas,1,0,,1,POINT (6170465 -7542726)
2018,Enero,Santa Lucia,2,0,,2,POINT (10446304 -75516486)
2018,Enero,Santa Lucia,1,0,,1,POINT (10886686 -74776479)
2018,Enero,Santa Lucia,1,4,,5,POINT (4697157 -74140516)
2018,Enero,Santa Sede/Ciudad del Vaticano,0,1,,1,POINT (4697157 -74140516)
2018,Enero,Senegal,0,2,,2,POINT (4697157 -74140516)
2018,Enero,Serbia,0,1,,1,POINT (0.33002 -76876446)
2018,Enero,Serbia,1,2,,3,POINT (3451668 -76532004)
2018,Enero,Serbia,7,24,,31,POINT (4697157 -74140516)
2018,Enero,Serbia,1,3,,4,POINT (6170465 -7542726)
2018,Enero,Serbia,0,1,,1,POINT (7819 -72453013)
2018,Enero,Singapur,0,1,,1,POINT (-4214082 -69941431)
2018,Enero,Singapur,3,2,,5,POINT (10446304 -75516486)
2018,Enero,Singapur,0,3,,3,POINT (10886686 -74776479)
2018,Enero,Singapur,27,33,,60,POINT (4697157 -74140516)
2018,Enero,Singapur,2,2,,4,POINT (6170465 -7542726)
2018,Enero,República Árabe Siria,1,1,,2,POINT (4697157 -74140516)
2018,Enero,República Árabe Siria,0,1,,1,POINT (6170465 -7542726)
2018,Enero,Sri Lanka,0,4,,4,POINT (10406342 -75527794)
2018,Enero,Sri Lanka,0,5,,5,POINT (10446304 -75516486)
2018,Enero,Sri Lanka,2,2,,4,POINT (4697157 -74140516)
2018,Enero,Sri Lanka,0,2,,2,POINT (6170465 -7542726)
2018,Enero,Sudáfrica,1,1,,2,POINT (0.81488 -77356)
2018,Enero,Sudáfrica,3,7,,10,POINT (10406342 -75527794)
2018,Enero,Sudáfrica,3,2,,5,POINT (10446304 -75516486)
2018,Enero,Sudáfrica,4,5,,9,POINT (10886686 -74776479)
2018,Enero,Sudáfrica,0,1,,1,POINT (3451668 -76532004)
2018,Enero,Sudáfrica,23,35,,58,POINT (4697157 -74140516)
2018,Enero,Sudáfrica,1,1,,2,POINT (4815189 -75736374)
2018,Enero,Sudáfrica,1,2,,3,POINT (6170465 -7542726)
2018,Enero,Sudáfrica,0,1,,1,POINT (7819 -72453013)
2018,Enero,Suecia,0,1,,1,POINT (-4191162 -69941498)
2018,Enero,Suecia,3,4,,7,POINT (-4214082 -69941431)
2018,Enero,Suecia,9,18,,27,POINT (0.81488 -77356)
2018,Enero,Suecia,10,8,,18,POINT (10406342 -75527794)
2018,Enero,Suecia,76,92,,168,POINT (10446304 -75516486)
2018,Enero,Suecia,5,8,,13,POINT (10886686 -74776479)
2018,Enero,Suecia,1,6,,7,POINT (11247723 -74213989)
2018,Enero,Suecia,0,1,,1,POINT (11360029 -72129595)
2018,Enero,Suecia,0,2,,2,POINT (125862 -81702165)
2018,Enero,Suecia,17,20,,37,POINT (3451668 -76532004)
2018,Enero,Suecia,330,414,,744,POINT (4697157 -74140516)
2018,Enero,Suecia,0,2,,2,POINT (4815189 -75736374)
2018,Enero,Suecia,39,58,,97,POINT (6170465 -7542726)
2018,Enero,Suecia,0,2,,2,POINT (7088729 -70740253)
2018,Enero,Suecia,1,4,,5,POINT (7819 -72453013)
2018,Enero,Suecia,5,3,,8,POINT (863337 -7735002)
2018,Enero,Suiza,5,4,,9,POINT (-4191162 -69941498)
2018,Enero,Suiza,3,6,,9,POINT (-4214082 -69941431)
2018,Enero,Suiza,2,4,,6,POINT (0.33002 -76876446)
2018,Enero,Suiza,27,37,,64,POINT (0.81488 -77356)
2018,Enero,Suiza,24,13,,37,POINT (10406342 -75527794)
2018,Enero,Suiza,59,83,,142,POINT (10446304 -75516486)
2018,Enero,Suiza,7,10,,17,POINT (10886686 -74776479)
2018,Enero,Suiza,1,13,,14,POINT (11247723 -74213989)
2018,Enero,Suiza,4,3,,7,POINT (125862 -81702165)
2018,Enero,Suiza,31,51,,82,POINT (3451668 -76532004)
2018,Enero,Suiza,575,825,,1400,POINT (4697157 -74140516)
2018,Enero,Suiza,0,2,,2,POINT (4815189 -75736374)
2018,Enero,Suiza,66,114,,180,POINT (6170465 -7542726)
2018,Enero,Suiza,1,0,,1,POINT (6185536 -67484028)
2018,Enero,Suiza,2,1,,3,POINT (7819 -72453013)
2018,Enero,Suiza,0,2,,2,POINT (836068 -72409396)
2018,Enero,Suiza,6,6,,12,POINT (863337 -7735002)
2018,Enero,Surinam,8,29,,37,POINT (4697157 -74140516)
2018,Enero,Surinam,0,2,,2,POINT (6170465 -7542726)
2018,Enero,Taiwán,1,0,,1,POINT (4697157 -74140516)
2018,Enero,Tailandia,1,2,,3,POINT (10446304 -75516486)
2018,Enero,Tailandia,19,15,,34,POINT (4697157 -74140516)
2018,Enero,Tailandia,2,3,,5,POINT (6170465 -7542726)
2018,Enero,Tanzania,1,0,,1,POINT (4697157 -74140516)
2018,Enero,Togo,0,1,,1,POINT (4697157 -74140516)
2018,Enero,Trinidad y Tobago,1,0,,1,POINT (0.81488 -77356)
2018,Enero,Trinidad y Tobago,0,1,,1,POINT (10406342 -75527794)
2018,Enero,Trinidad y Tobago,5,5,,10,POINT (10446304 -75516486)
2018,Enero,Trinidad y Tobago,0,1,,1,POINT (10886686 -74776479)
2018,Enero,Trinidad y Tobago,4,6,,10,POINT (3451668 -76532004)
2018,Enero,Trinidad y Tobago,21,30,,51,POINT (4697157 -74140516)
2018,Enero,Trinidad y Tobago,3,13,,16,POINT (6170465 -7542726)
2018,Enero,Trinidad y Tobago,0,2,,2,POINT (7088729 -70740253)
2018,Enero,Trinidad y Tobago,0,1,,1,POINT (7128047 -73181317)
2018,Enero,Trinidad y Tobago,1,1,,2,POINT (7819 -72453013)
2018,Enero,Túnez,16,14,,30,POINT (10446304 -75516486)
2018,Enero,Túnez,6,8,,14,POINT (4697157 -74140516)
2018,Enero,Turquía,6,9,,15,POINT (0.81488 -77356)
2018,Enero,Turquía,0,2,,2,POINT (10406342 -75527794)
2018,Enero,Turquía,8,20,,28,POINT (10446304 -75516486)
2018,Enero,Turquía,2,5,,7,POINT (10886686 -74776479)
2018,Enero,Turquía,5,9,,14,POINT (3451668 -76532004)
2018,Enero,Turquía,182,377,,559,POINT (4697157 -74140516)
2018,Enero,Turquía,3,20,,23,POINT (6170465 -7542726)
2018,Enero,Ucrania,1,0,,1,POINT (0.33002 -76876446)
2018,Enero,Ucrania,2,2,,4,POINT (0.81488 -77356)
2018,Enero,Ucrania,1,6,,7,POINT (10406342 -75527794)
2018,Enero,Ucrania,3,5,,8,POINT (10446304 -75516486)
2018,Enero,Ucrania,0,9,,9,POINT (10886686 -74776479)
2018,Enero,Ucrania,0,11,,11,POINT (11247723 -74213989)
2018,Enero,Ucrania,1,2,,3,POINT (3451668 -76532004)
2018,Enero,Ucrania,36,19,,55,POINT (4697157 -74140516)
2018,Enero,Ucrania,6,2,,8,POINT (6170465 -7542726)
2018,Enero,Uganda,1,2,,3,POINT (4697157 -74140516)
2018,Enero,Uruguay,1,0,,1,POINT (-4214082 -69941431)
2018,Enero,Uruguay,7,24,,31,POINT (0.81488 -77356)
2018,Enero,Uruguay,8,4,,12,POINT (10406342 -75527794)
2018,Enero,Uruguay,89,62,,151,POINT (10446304 -75516486)
2018,Enero,Uruguay,4,4,,8,POINT (10886686 -74776479)
2018,Enero,Uruguay,3,4,,7,POINT (11360029 -72129595)
2018,Enero,Uruguay,5,4,,9,POINT (125862 -81702165)
2018,Enero,Uruguay,8,25,,33,POINT (3451668 -76532004)
2018,Enero,Uruguay,482,550,,1032,POINT (4697157 -74140516)
2018,Enero,Uruguay,2,0,,2,POINT (4815189 -75736374)
2018,Enero,Uruguay,37,46,,83,POINT (6170465 -7542726)
2018,Enero,Uruguay,3,3,,6,POINT (7128047 -73181317)
2018,Enero,Uruguay,4,7,,11,POINT (7819 -72453013)
2018,Enero,Uzbekistán,1,0,,1,POINT (10446304 -75516486)
2018,Enero,Uzbekistán,1,0,,1,POINT (4697157 -74140516)
2018,Enero,Venezuela,5,3,,8,POINT (-4191162 -69941498)
2018,Enero,Venezuela,0,1,,1,POINT (-4214082 -69941431)
2018,Enero,Venezuela,24,24,,48,POINT (0.33002 -76876446)
2018,Enero,Venezuela,2200,2314,,4514,POINT (0.81488 -77356)
2018,Enero,Venezuela,0,1,,1,POINT (1800143 -78802679)
2018,Enero,Venezuela,11,21,,32,POINT (10406342 -75527794)
2018,Enero,Venezuela,214,332,,546,POINT (10446304 -75516486)
2018,Enero,Venezuela,128,212,,340,POINT (10886686 -74776479)
2018,Enero,Venezuela,0,2,,2,POINT (10970933 -74765343)
2018,Enero,Venezuela,6,32,,38,POINT (11117206 -74232675)
2018,Enero,Venezuela,7809,10209,,18018,POINT (11360029 -72129595)
2018,Enero,Venezuela,7,2,,9,POINT (1152863 -72919186)
2018,Enero,Venezuela,0,3,,3,POINT (12165168 -71983761)
2018,Enero,Venezuela,2,1,,3,POINT (125862 -81702165)
2018,Enero,Venezuela,108,134,,242,POINT (3451668 -76532004)
2018,Enero,Venezuela,3,8,,11,POINT (3866713 -67927521)
2018,Enero,Venezuela,4,2,,6,POINT (445285 -75766353)
2018,Enero,Venezuela,7073,6646,,13719,POINT (4697157 -74140516)
2018,Enero,Venezuela,13,18,,31,POINT (4815189 -75736374)
2018,Enero,Venezuela,980,1123,,2103,POINT (6170465 -7542726)
2018,Enero,Venezuela,25,35,,60,POINT (6185536 -67484028)
2018,Enero,Venezuela,405,571,,976,POINT (7088729 -70740253)
2018,Enero,Venezuela,13,16,,29,POINT (7128047 -73181317)
2018,Enero,Venezuela,33395,47879,,81274,POINT (7819 -72453013)
2018,Enero,Venezuela,5,15,,20,POINT (7927233 -72508188)
2018,Enero,Venezuela,2086,2853,,4939,POINT (836068 -72409396)
2018,Enero,Venezuela,3,1,,4,POINT (863337 -7735002)
2018,Enero,Vietnam,1,0,,1,POINT (0.81488 -77356)
2018,Enero,Vietnam,0,1,,1,POINT (10886686 -74776479)
2018,Enero,Vietnam,3,8,,11,POINT (4697157 -74140516)
2018,Enero,República Árabe de Yemen,0,1,,1,POINT (4697157 -74140516)
2018,Enero,Zimbabue,0,1,,1,POINT (3451668 -76532004)
2018,Enero,Zimbabue,0,2,,2,POINT (4697157 -74140516)
2018,Enero,Islas Turcas y Caicos/Territorio Británico de Ultramar,0,1,,1,POINT (6170465 -7542726)
2018,Enero,Refugiado Otro,0,1,,1,POINT (4697157 -74140516)
2018,Enero,Refugiado,1,3,,4,POINT (10446304 -75516486)
2018,Enero,Refugiado,2,1,,3,POINT (4697157 -74140516)
2018,Enero,Refugiado,2,1,,3,POINT (6170465 -7542726)
2018,Enero,Desconocido,0,1,,1,POINT (0.812436 -77847006)
2018,Enero,Desconocido,1,5,,6,POINT (10446304 -75516486)
2018,Enero,Desconocido,1,0,,1,POINT (10886686 -74776479)
2018,Enero,Desconocido,0,2,,2,POINT (3451668 -76532004)
2018,Enero,Desconocido,57,110,,167,POINT (4697157 -74140516)
2018,Enero,Desconocido,0,4,,4,POINT (7819 -72453013)
2018,Febrero,Albania,1,0,,1,POINT (4697157 -74140516)
2018,Febrero,Albania,0,2,,2,POINT (6170465 -7542726)
2018,Febrero,Alemania,9,15,,24,POINT (-4191162 -69941498)
2018,Febrero,Alemania,15,12,,27,POINT (-4214082 -69941431)
2018,Febrero,Alemania,4,5,,9,POINT (0.33002 -76876446)
2018,Febrero,Alemania,0,1,,1,POINT (0.812436 -77847006)
2018,Febrero,Alemania,124,141,,265,POINT (0.81488 -77356)
2018,Febrero,Alemania,47,46,,93,POINT (10406342 -75527794)
2018,Febrero,Alemania,148,245,,393,POINT (10446304 -75516486)
2018,Febrero,Alemania,40,48,,88,POINT (10886686 -74776479)
2018,Febrero,Alemania,6,9,,15,POINT (11247723 -74213989)
2018,Febrero,Alemania,1,2,,3,POINT (11360029 -72129595)
2018,Febrero,Alemania,1,5,,6,POINT (125744111 -81703935)
2018,Febrero,Alemania,4,6,,10,POINT (125862 -81702165)
2018,Febrero,Alemania,4,4,,8,POINT (133387613 -81372937)
2018,Febrero,Alemania,75,92,,167,POINT (3451668 -76532004)
2018,Febrero,Alemania,2,0,,2,POINT (3884426 -77061029)
2018,Febrero,Alemania,1,0,,1,POINT (445285 -75766353)
2018,Febrero,Alemania,2390,3168,,5558,POINT (4697157 -74140516)
2018,Febrero,Alemania,2,4,,6,POINT (4815189 -75736374)
2018,Febrero,Alemania,184,319,,503,POINT (6170465 -7542726)
2018,Febrero,Alemania,2,3,,5,POINT (7128047 -73181317)
2018,Febrero,Alemania,5,11,,16,POINT (7819 -72453013)
2018,Febrero,Alemania,0,3,,3,POINT (836068 -72409396)
2018,Febrero,Alemania,17,21,,38,POINT (863337 -7735002)
2018,Febrero,Andorra,1,0,,1,POINT (-4214082 -69941431)
2018,Febrero,Andorra,0,1,,1,POINT (10446304 -75516486)
2018,Febrero,Andorra,1,10,,11,POINT (4697157 -74140516)
2018,Febrero,Andorra,2,2,,4,POINT (6170465 -7542726)
2018,Febrero,Angola,3,0,,3,POINT (3451668 -76532004)
2018,Febrero,Angola,1,3,,4,POINT (4697157 -74140516)
2018,Febrero,Antigua y Barbuda,1,1,,2,POINT (4697157 -74140516)
2018,Febrero,Antigua y Barbuda,1,0,,1,POINT (6170465 -7542726)
2018,Febrero,Países Bajos,1,3,,4,POINT (6170465 -7542726)
2018,Febrero,Arabia Saudita,0,1,,1,POINT (10446304 -75516486)
2018,Febrero,Arabia Saudita,0,6,,6,POINT (4697157 -74140516)
2018,Febrero,Arabia Saudita,0,1,,1,POINT (6170465 -7542726)
2018,Febrero,Argelia,0,1,,1,POINT (11247723 -74213989)
2018,Febrero,Argelia,1,4,,5,POINT (4697157 -74140516)
2018,Febrero,Argelia,0,1,,1,POINT (6170465 -7542726)
2018,Febrero,Argentina,2,4,,6,POINT (-4191162 -69941498)
2018,Febrero,Argentina,2,5,,7,POINT (-4214082 -69941431)
2018,Febrero,Argentina,10,10,,20,POINT (0.33002 -76876446)
2018,Febrero,Argentina,121,188,,309,POINT (0.81488 -77356)
2018,Febrero,Argentina,0,2,,2,POINT (1800143 -78802679)
2018,Febrero,Argentina,361,277,,638,POINT (10406342 -75527794)
2018,Febrero,Argentina,1551,1181,,2732,POINT (10446304 -75516486)
2018,Febrero,Argentina,39,67,,106,POINT (10886686 -74776479)
2018,Febrero,Argentina,3,8,,11,POINT (11360029 -72129595)
2018,Febrero,Argentina,408,339,,747,POINT (125862 -81702165)
2018,Febrero,Argentina,63,84,,147,POINT (3451668 -76532004)
2018,Febrero,Argentina,0,1,,1,POINT (445285 -75766353)
2018,Febrero,Argentina,8206,8665,,16871,POINT (4697157 -74140516)
2018,Febrero,Argentina,9,9,,18,POINT (4815189 -75736374)
2018,Febrero,Argentina,136,258,,394,POINT (6170465 -7542726)
2018,Febrero,Argentina,1,4,,5,POINT (7128047 -73181317)
2018,Febrero,Argentina,8,28,,36,POINT (7819 -72453013)
2018,Febrero,Argentina,2,5,,7,POINT (836068 -72409396)
2018,Febrero,Argentina,1,2,,3,POINT (863337 -7735002)
2018,Febrero,República de Armenia,1,0,,1,POINT (10446304 -75516486)
2018,Febrero,República de Armenia,1,1,,2,POINT (4697157 -74140516)
2018,Febrero,Australia,1,4,,5,POINT (-4191162 -69941498)
2018,Febrero,Australia,5,2,,7,POINT (-4214082 -69941431)
2018,Febrero,Australia,1,1,,2,POINT (0.33002 -76876446)
2018,Febrero,Australia,22,32,,54,POINT (0.81488 -77356)
2018,Febrero,Australia,15,27,,42,POINT (10406342 -75527794)
2018,Febrero,Australia,58,79,,137,POINT (10446304 -75516486)
2018,Febrero,Australia,3,18,,21,POINT (10886686 -74776479)
2018,Febrero,Australia,1,1,,2,POINT (11247723 -74213989)
2018,Febrero,Australia,0,1,,1,POINT (11360029 -72129595)
2018,Febrero,Australia,5,17,,22,POINT (3451668 -76532004)
2018,Febrero,Australia,284,493,,777,POINT (4697157 -74140516)
2018,Febrero,Australia,3,0,,3,POINT (4815189 -75736374)
2018,Febrero,Australia,29,93,,122,POINT (6170465 -7542726)
2018,Febrero,Australia,9,6,,15,POINT (863337 -7735002)
2018,Febrero,Austria,3,2,,5,POINT (-4214082 -69941431)
2018,Febrero,Austria,10,14,,24,POINT (0.81488 -77356)
2018,Febrero,Austria,7,6,,13,POINT (10406342 -75527794)
2018,Febrero,Austria,24,27,,51,POINT (10446304 -75516486)
2018,Febrero,Austria,0,7,,7,POINT (10886686 -74776479)
2018,Febrero,Austria,1,0,,1,POINT (11247723 -74213989)
2018,Febrero,Austria,0,1,,1,POINT (11360029 -72129595)
2018,Febrero,Austria,6,7,,13,POINT (3451668 -76532004)
2018,Febrero,Austria,0,1,,1,POINT (445285 -75766353)
2018,Febrero,Austria,306,367,,673,POINT (4697157 -74140516)
2018,Febrero,Austria,38,48,,86,POINT (6170465 -7542726)
2018,Febrero,Austria,0,1,,1,POINT (863337 -7735002)
2018,Febrero,Azerbaiyán,2,6,,8,POINT (4697157 -74140516)
2018,Febrero,Bahamas,4,4,,8,POINT (10446304 -75516486)
2018,Febrero,Bahamas,1,1,,2,POINT (10886686 -74776479)
2018,Febrero,Bahamas,1,0,,1,POINT (3451668 -76532004)
2018,Febrero,Bahamas,4,21,,25,POINT (4697157 -74140516)
2018,Febrero,Bahamas,1,2,,3,POINT (6170465 -7542726)
2018,Febrero,Bahréin,0,2,,2,POINT (4697157 -74140516)
2018,Febrero,Bangladesh,1,0,,1,POINT (4697157 -74140516)
2018,Febrero,Barbados,1,1,,2,POINT (10446304 -75516486)
2018,Febrero,Barbados,0,2,,2,POINT (10886686 -74776479)
2018,Febrero,Barbados,6,6,,12,POINT (4697157 -74140516)
2018,Febrero,Barbados,1,2,,3,POINT (6170465 -7542726)
2018,Febrero,República de Belarús,1,0,,1,POINT (10446304 -75516486)
2018,Febrero,República de Belarús,5,6,,11,POINT (4697157 -74140516)
2018,Febrero,Bélgica,7,4,,11,POINT (-4191162 -69941498)
2018,Febrero,Bélgica,1,2,,3,POINT (-4214082 -69941431)
2018,Febrero,Bélgica,2,0,,2,POINT (0.33002 -76876446)
2018,Febrero,Bélgica,4,8,,12,POINT (0.81488 -77356)
2018,Febrero,Bélgica,3,5,,8,POINT (10406342 -75527794)
2018,Febrero,Bélgica,27,55,,82,POINT (10446304 -75516486)
2018,Febrero,Bélgica,3,10,,13,POINT (10886686 -74776479)
2018,Febrero,Bélgica,0,1,,1,POINT (10970933 -74765343)
2018,Febrero,Bélgica,0,2,,2,POINT (11360029 -72129595)
2018,Febrero,Bélgica,0,2,,2,POINT (125744111 -81703935)
2018,Febrero,Bélgica,13,15,,28,POINT (3451668 -76532004)
2018,Febrero,Bélgica,261,406,,667,POINT (4697157 -74140516)
2018,Febrero,Bélgica,1,1,,2,POINT (4815189 -75736374)
2018,Febrero,Bélgica,45,81,,126,POINT (6170465 -7542726)
2018,Febrero,Bélgica,0,1,,1,POINT (7128047 -73181317)
2018,Febrero,Bélgica,1,3,,4,POINT (7819 -72453013)
2018,Febrero,Bélgica,0,1,,1,POINT (836068 -72409396)
2018,Febrero,Bélgica,0,1,,1,POINT (863337 -7735002)
2018,Febrero,Belice,0,1,,1,POINT (0.81488 -77356)
2018,Febrero,Belice,0,2,,2,POINT (10406342 -75527794)
2018,Febrero,Belice,0,1,,1,POINT (10446304 -75516486)
2018,Febrero,Belice,0,2,,2,POINT (11247723 -74213989)
2018,Febrero,Belice,2,6,,8,POINT (4697157 -74140516)
2018,Febrero,Belice,0,2,,2,POINT (6170465 -7542726)
2018,Febrero,Bermudas/Territorio Británico de Ultramar,1,0,,1,POINT (4697157 -74140516)
2018,Febrero,Bermudas/Territorio Británico de Ultramar,1,1,,2,POINT (6170465 -7542726)
2018,Febrero,Bolivia,1,0,,1,POINT (-4191162 -69941498)
2018,Febrero,Bolivia,1,0,,1,POINT (-4214082 -69941431)
2018,Febrero,Bolivia,1,0,,1,POINT (0.33002 -76876446)
2018,Febrero,Bolivia,11,18,,29,POINT (0.81488 -77356)
2018,Febrero,Bolivia,7,3,,10,POINT (10406342 -75527794)
2018,Febrero,Bolivia,189,129,,318,POINT (10446304 -75516486)
2018,Febrero,Bolivia,4,6,,10,POINT (10886686 -74776479)
2018,Febrero,Bolivia,0,2,,2,POINT (11360029 -72129595)
2018,Febrero,Bolivia,16,10,,26,POINT (125862 -81702165)
2018,Febrero,Bolivia,13,19,,32,POINT (3451668 -76532004)
2018,Febrero,Bolivia,558,548,,1106,POINT (4697157 -74140516)
2018,Febrero,Bolivia,3,0,,3,POINT (4815189 -75736374)
2018,Febrero,Bolivia,45,47,,92,POINT (6170465 -7542726)
2018,Febrero,Bolivia,8,9,,17,POINT (7819 -72453013)
2018,Febrero,Bolivia,0,1,,1,POINT (836068 -72409396)
2018,Febrero,Bosnia y Herzegovina,0,7,,7,POINT (4697157 -74140516)
2018,Febrero,Botsuana,0,1,,1,POINT (4697157 -74140516)
2018,Febrero,Botsuana,1,0,,1,POINT (6170465 -7542726)
2018,Febrero,Brasil,145,119,,264,POINT (-4191162 -69941498)
2018,Febrero,Brasil,1,2,,3,POINT (-4214082 -69941431)
2018,Febrero,Brasil,0,4,,4,POINT (0.33002 -76876446)
2018,Febrero,Brasil,24,35,,59,POINT (0.81488 -77356)
2018,Febrero,Brasil,452,299,,751,POINT (10406342 -75527794)
2018,Febrero,Brasil,1059,780,,1839,POINT (10446304 -75516486)
2018,Febrero,Brasil,33,104,,137,POINT (10886686 -74776479)
2018,Febrero,Brasil,1,0,,1,POINT (11247723 -74213989)
2018,Febrero,Brasil,3,4,,7,POINT (11360029 -72129595)
2018,Febrero,Brasil,2,3,,5,POINT (125744111 -81703935)
2018,Febrero,Brasil,351,289,,640,POINT (125862 -81702165)
2018,Febrero,Brasil,54,82,,136,POINT (3451668 -76532004)
2018,Febrero,Brasil,3,5,,8,POINT (3866713 -67927521)
2018,Febrero,Brasil,7086,7397,,14483,POINT (4697157 -74140516)
2018,Febrero,Brasil,1,1,,2,POINT (4815189 -75736374)
2018,Febrero,Brasil,131,221,,352,POINT (6170465 -7542726)
2018,Febrero,Brasil,0,2,,2,POINT (6185536 -67484028)
2018,Febrero,Brasil,0,1,,1,POINT (7088729 -70740253)
2018,Febrero,Brasil,1,1,,2,POINT (7128047 -73181317)
2018,Febrero,Brasil,10,11,,21,POINT (7819 -72453013)
2018,Febrero,Brasil,0,1,,1,POINT (836068 -72409396)
2018,Febrero,Brasil,2,2,,4,POINT (863337 -7735002)
2018,Febrero,Bulgaria,0,1,,1,POINT (0.33002 -76876446)
2018,Febrero,Bulgaria,1,0,,1,POINT (0.81488 -77356)
2018,Febrero,Bulgaria,0,1,,1,POINT (10406342 -75527794)
2018,Febrero,Bulgaria,6,4,,10,POINT (10446304 -75516486)
2018,Febrero,Bulgaria,0,1,,1,POINT (11247723 -74213989)
2018,Febrero,Bulgaria,4,2,,6,POINT (3451668 -76532004)
2018,Febrero,Bulgaria,33,37,,70,POINT (4697157 -74140516)
2018,Febrero,Bulgaria,0,1,,1,POINT (4815189 -75736374)
2018,Febrero,Bulgaria,11,9,,20,POINT (6170465 -7542726)
2018,Febrero,Burkina Faso,1,6,,7,POINT (4697157 -74140516)
2018,Febrero,Bután,0,1,,1,POINT (4697157 -74140516)
2018,Febrero,Islas Caimán/Territorio Británico de Ultramar,1,0,,1,POINT (10446304 -75516486)
2018,Febrero,Islas Caimán/Territorio Británico de Ultramar,1,1,,2,POINT (10886686 -74776479)
2018,Febrero,Islas Caimán/Territorio Británico de Ultramar,0,1,,1,POINT (125862 -81702165)
2018,Febrero,Islas Caimán/Territorio Británico de Ultramar,0,1,,1,POINT (4697157 -74140516)
2018,Febrero,Islas Caimán/Territorio Británico de Ultramar,0,1,,1,POINT (6170465 -7542726)
2018,Febrero,Camerún,1,1,,2,POINT (0.81488 -77356)
2018,Febrero,Camerún,0,1,,1,POINT (10446304 -75516486)
2018,Febrero,Camerún,0,3,,3,POINT (4697157 -74140516)
2018,Febrero,Camerún,0,1,,1,POINT (6170465 -7542726)
2018,Febrero,Canadá,0,3,,3,POINT (-4191162 -69941498)
2018,Febrero,Canadá,3,6,,9,POINT (-4214082 -69941431)
2018,Febrero,Canadá,16,30,,46,POINT (0.81488 -77356)
2018,Febrero,Canadá,35,41,,76,POINT (10406342 -75527794)
2018,Febrero,Canadá,926,979,,1905,POINT (10446304 -75516486)
2018,Febrero,Canadá,36,63,,99,POINT (10886686 -74776479)
2018,Febrero,Canadá,0,1,,1,POINT (11117206 -74232675)
2018,Febrero,Canadá,0,2,,2,POINT (11247723 -74213989)
2018,Febrero,Canadá,2,6,,8,POINT (11360029 -72129595)
2018,Febrero,Canadá,0,2,,2,POINT (125744111 -81703935)
2018,Febrero,Canadá,286,276,,562,POINT (125862 -81702165)
2018,Febrero,Canadá,54,73,,127,POINT (3451668 -76532004)
2018,Febrero,Canadá,3,5,,8,POINT (445285 -75766353)
2018,Febrero,Canadá,1427,2217,,3644,POINT (4697157 -74140516)
2018,Febrero,Canadá,3,10,,13,POINT (4815189 -75736374)
2018,Febrero,Canadá,260,591,,851,POINT (6170465 -7542726)
2018,Febrero,Canadá,4,6,,10,POINT (7128047 -73181317)
2018,Febrero,Canadá,1,5,,6,POINT (7819 -72453013)
2018,Febrero,Canadá,0,1,,1,POINT (836068 -72409396)
2018,Febrero,Canadá,7,14,,21,POINT (863337 -7735002)
2018,Febrero,Chad,1,0,,1,POINT (4697157 -74140516)
2018,Febrero,República Democrática del Congo,0,4,,4,POINT (4697157 -74140516)
2018,Febrero,República Democrática del Congo,0,1,,1,POINT (7819 -72453013)
2018,Febrero,República de Corea,1,4,,5,POINT (-4191162 -69941498)
2018,Febrero,República de Corea,3,0,,3,POINT (-4214082 -69941431)
2018,Febrero,República de Corea,0,1,,1,POINT (0.33002 -76876446)
2018,Febrero,República de Corea,11,13,,24,POINT (0.81488 -77356)
2018,Febrero,República de Corea,0,2,,2,POINT (10406342 -75527794)
2018,Febrero,República de Corea,3,6,,9,POINT (10446304 -75516486)
2018,Febrero,República de Corea,3,7,,10,POINT (10886686 -74776479)
2018,Febrero,República de Corea,0,2,,2,POINT (10970933 -74765343)
2018,Febrero,República de Corea,0,1,,1,POINT (11247723 -74213989)
2018,Febrero,República de Corea,5,6,,11,POINT (3451668 -76532004)
2018,Febrero,República de Corea,242,380,,622,POINT (4697157 -74140516)
2018,Febrero,República de Corea,18,33,,51,POINT (6170465 -7542726)
2018,Febrero,República de Corea,3,3,,6,POINT (7819 -72453013)
2018,Febrero,Costa de Marfil,0,1,,1,POINT (10446304 -75516486)
2018,Febrero,Costa de Marfil,0,3,,3,POINT (4697157 -74140516)
2018,Febrero,Costa Rica,1,1,,2,POINT (-4191162 -69941498)
2018,Febrero,Costa Rica,1,0,,1,POINT (0.33002 -76876446)
2018,Febrero,Costa Rica,3,3,,6,POINT (0.81488 -77356)
2018,Febrero,Costa Rica,1,1,,2,POINT (10406342 -75527794)
2018,Febrero,Costa Rica,138,120,,258,POINT (10446304 -75516486)
2018,Febrero,Costa Rica,9,28,,37,POINT (10886686 -74776479)
2018,Febrero,Costa Rica,19,21,,40,POINT (125862 -81702165)
2018,Febrero,Costa Rica,70,89,,159,POINT (3451668 -76532004)
2018,Febrero,Costa Rica,1010,1223,,2233,POINT (4697157 -74140516)
2018,Febrero,Costa Rica,3,8,,11,POINT (4815189 -75736374)
2018,Febrero,Costa Rica,139,229,,368,POINT (6170465 -7542726)
2018,Febrero,Costa Rica,4,1,,5,POINT (7128047 -73181317)
2018,Febrero,Costa Rica,1,2,,3,POINT (7819 -72453013)
2018,Febrero,Costa Rica,1,0,,1,POINT (836068 -72409396)
2018,Febrero,Croacia,0,1,,1,POINT (0.33002 -76876446)
2018,Febrero,Croacia,1,2,,3,POINT (0.81488 -77356)
2018,Febrero,Croacia,0,7,,7,POINT (10406342 -75527794)
2018,Febrero,Croacia,1,10,,11,POINT (10446304 -75516486)
2018,Febrero,Croacia,0,2,,2,POINT (10886686 -74776479)
2018,Febrero,Croacia,0,1,,1,POINT (10970933 -74765343)
2018,Febrero,Croacia,0,1,,1,POINT (3451668 -76532004)
2018,Febrero,Croacia,0,1,,1,POINT (3884426 -77061029)
2018,Febrero,Croacia,22,46,,68,POINT (4697157 -74140516)
2018,Febrero,Croacia,1,9,,10,POINT (6170465 -7542726)
2018,Febrero,Cuba,4,5,,9,POINT (0.81488 -77356)
2018,Febrero,Cuba,6,15,,21,POINT (10446304 -75516486)
2018,Febrero,Cuba,9,11,,20,POINT (10886686 -74776479)
2018,Febrero,Cuba,18,17,,35,POINT (3451668 -76532004)
2018,Febrero,Cuba,1057,798,,1855,POINT (4697157 -74140516)
2018,Febrero,Cuba,0,1,,1,POINT (4815189 -75736374)
2018,Febrero,Cuba,8,23,,31,POINT (6170465 -7542726)
2018,Febrero,Cuba,2,1,,3,POINT (7128047 -73181317)
2018,Febrero,Cuba,1,2,,3,POINT (7819 -72453013)
2018,Febrero,República Checa,0,1,,1,POINT (-4214082 -69941431)
2018,Febrero,República Checa,0,1,,1,POINT (0.33002 -76876446)
2018,Febrero,República Checa,6,7,,13,POINT (0.81488 -77356)
2018,Febrero,República Checa,1,0,,1,POINT (10406342 -75527794)
2018,Febrero,República Checa,10,25,,35,POINT (10446304 -75516486)
2018,Febrero,República Checa,0,3,,3,POINT (10886686 -74776479)
2018,Febrero,República Checa,1,1,,2,POINT (11247723 -74213989)
2018,Febrero,República Checa,6,5,,11,POINT (3451668 -76532004)
2018,Febrero,República Checa,81,109,,190,POINT (4697157 -74140516)
2018,Febrero,República Checa,5,13,,18,POINT (6170465 -7542726)
2018,Febrero,República Checa,0,1,,1,POINT (7819 -72453013)
2018,Febrero,República Checa,0,2,,2,POINT (863337 -7735002)
2018,Febrero,Chile,2,1,,3,POINT (-4191162 -69941498)
2018,Febrero,Chile,11,10,,21,POINT (-4214082 -69941431)
2018,Febrero,Chile,0,4,,4,POINT (0.33002 -76876446)
2018,Febrero,Chile,130,157,,287,POINT (0.81488 -77356)
2018,Febrero,Chile,548,406,,954,POINT (10406342 -75527794)
2018,Febrero,Chile,512,377,,889,POINT (10446304 -75516486)
2018,Febrero,Chile,21,23,,44,POINT (10886686 -74776479)
2018,Febrero,Chile,3,3,,6,POINT (11360029 -72129595)
2018,Febrero,Chile,0,1,,1,POINT (125744111 -81703935)
2018,Febrero,Chile,74,49,,123,POINT (125862 -81702165)
2018,Febrero,Chile,25,51,,76,POINT (3451668 -76532004)
2018,Febrero,Chile,0,2,,2,POINT (3884426 -77061029)
2018,Febrero,Chile,6797,6542,,13339,POINT (4697157 -74140516)
2018,Febrero,Chile,2,5,,7,POINT (4815189 -75736374)
2018,Febrero,Chile,57,113,,170,POINT (6170465 -7542726)
2018,Febrero,Chile,0,1,,1,POINT (7088729 -70740253)
2018,Febrero,Chile,9,19,,28,POINT (7819 -72453013)
2018,Febrero,Chile,4,5,,9,POINT (836068 -72409396)
2018,Febrero,Chile,0,1,,1,POINT (9402597 -75681642)
2018,Febrero,China,1,2,,3,POINT (-4191162 -69941498)
2018,Febrero,China,7,4,,11,POINT (0.81488 -77356)
2018,Febrero,China,0,6,,6,POINT (10406342 -75527794)
2018,Febrero,China,17,19,,36,POINT (10446304 -75516486)
2018,Febrero,China,0,8,,8,POINT (10886686 -74776479)
2018,Febrero,China,0,1,,1,POINT (11360029 -72129595)
2018,Febrero,China,12,18,,30,POINT (3451668 -76532004)
2018,Febrero,China,421,582,,1003,POINT (4697157 -74140516)
2018,Febrero,China,1,0,,1,POINT (4815189 -75736374)
2018,Febrero,China,39,47,,86,POINT (6170465 -7542726)
2018,Febrero,China,7,5,,12,POINT (7819 -72453013)
2018,Febrero,China,1,2,,3,POINT (836068 -72409396)
2018,Febrero,Taiwán,1,1,,2,POINT (0.81488 -77356)
2018,Febrero,Taiwán,3,3,,6,POINT (10406342 -75527794)
2018,Febrero,Taiwán,5,3,,8,POINT (10446304 -75516486)
2018,Febrero,Taiwán,0,2,,2,POINT (10886686 -74776479)
2018,Febrero,Taiwán,0,5,,5,POINT (3451668 -76532004)
2018,Febrero,Taiwán,96,79,,175,POINT (4697157 -74140516)
2018,Febrero,Taiwán,3,8,,11,POINT (6170465 -7542726)
2018,Febrero,Taiwán,0,1,,1,POINT (7128047 -73181317)
2018,Febrero,Taiwán,1,3,,4,POINT (7819 -72453013)
2018,Febrero,Chipre,2,1,,3,POINT (3451668 -76532004)
2018,Febrero,Chipre,12,12,,24,POINT (4697157 -74140516)
2018,Febrero,Dinamarca,3,2,,5,POINT (-4214082 -69941431)
2018,Febrero,Dinamarca,4,3,,7,POINT (0.81488 -77356)
2018,Febrero,Dinamarca,6,10,,16,POINT (10406342 -75527794)
2018,Febrero,Dinamarca,30,46,,76,POINT (10446304 -75516486)
2018,Febrero,Dinamarca,2,2,,4,POINT (10886686 -74776479)
2018,Febrero,Dinamarca,6,10,,16,POINT (3451668 -76532004)
2018,Febrero,Dinamarca,0,1,,1,POINT (3884426 -77061029)
2018,Febrero,Dinamarca,170,230,,400,POINT (4697157 -74140516)
2018,Febrero,Dinamarca,0,1,,1,POINT (4815189 -75736374)
2018,Febrero,Dinamarca,22,42,,64,POINT (6170465 -7542726)
2018,Febrero,Dominica,0,1,,1,POINT (3451668 -76532004)
2018,Febrero,Dominica,3,6,,9,POINT (4697157 -74140516)
2018,Febrero,Dominica,0,3,,3,POINT (6170465 -7542726)
2018,Febrero,Ecuador,1,3,,4,POINT (-4214082 -69941431)
2018,Febrero,Ecuador,2,0,,2,POINT (0.185957 -7478366)
2018,Febrero,Ecuador,61,285,,346,POINT (0.33002 -76876446)
2018,Febrero,Ecuador,17,15,,32,POINT (0.812436 -77847006)
2018,Febrero,Ecuador,1557,2278,,3835,POINT (0.81488 -77356)
2018,Febrero,Ecuador,9,15,,24,POINT (1800143 -78802679)
2018,Febrero,Ecuador,15,10,,25,POINT (10406342 -75527794)
2018,Febrero,Ecuador,75,68,,143,POINT (10446304 -75516486)
2018,Febrero,Ecuador,74,61,,135,POINT (10886686 -74776479)
2018,Febrero,Ecuador,6,17,,23,POINT (11360029 -72129595)
2018,Febrero,Ecuador,8,6,,14,POINT (125862 -81702165)
2018,Febrero,Ecuador,441,455,,896,POINT (3451668 -76532004)
2018,Febrero,Ecuador,0,1,,1,POINT (3866713 -67927521)
2018,Febrero,Ecuador,0,3,,3,POINT (3884426 -77061029)
2018,Febrero,Ecuador,0,1,,1,POINT (445285 -75766353)
2018,Febrero,Ecuador,2899,3643,,6542,POINT (4697157 -74140516)
2018,Febrero,Ecuador,43,127,,170,POINT (4815189 -75736374)
2018,Febrero,Ecuador,67,131,,198,POINT (6170465 -7542726)
2018,Febrero,Ecuador,3,4,,7,POINT (7128047 -73181317)
2018,Febrero,Ecuador,166,253,,419,POINT (7819 -72453013)
2018,Febrero,Ecuador,2,6,,8,POINT (836068 -72409396)
2018,Febrero,Egipto,0,1,,1,POINT (10446304 -75516486)
2018,Febrero,Egipto,2,34,,36,POINT (4697157 -74140516)
2018,Febrero,Egipto,0,4,,4,POINT (6170465 -7542726)
2018,Febrero,Egipto,0,2,,2,POINT (7819 -72453013)
2018,Febrero,El Salvador,1,1,,2,POINT (-4214082 -69941431)
2018,Febrero,El Salvador,3,3,,6,POINT (0.81488 -77356)
2018,Febrero,El Salvador,0,2,,2,POINT (10406342 -75527794)
2018,Febrero,El Salvador,37,34,,71,POINT (10446304 -75516486)
2018,Febrero,El Salvador,3,5,,8,POINT (10886686 -74776479)
2018,Febrero,El Salvador,2,2,,4,POINT (125862 -81702165)
2018,Febrero,El Salvador,84,89,,173,POINT (3451668 -76532004)
2018,Febrero,El Salvador,753,907,,1660,POINT (4697157 -74140516)
2018,Febrero,El Salvador,2,3,,5,POINT (4815189 -75736374)
2018,Febrero,El Salvador,156,179,,335,POINT (6170465 -7542726)
2018,Febrero,El Salvador,1,1,,2,POINT (7819 -72453013)
2018,Febrero,El Salvador,0,1,,1,POINT (863337 -7735002)
2018,Febrero,Emiratos Árabes,3,8,,11,POINT (4697157 -74140516)
2018,Febrero,Emiratos Árabes,0,4,,4,POINT (6170465 -7542726)
2018,Febrero,España,0,2,,2,POINT (-4191162 -69941498)
2018,Febrero,España,7,10,,17,POINT (-4214082 -69941431)
2018,Febrero,España,2,3,,5,POINT (0.33002 -76876446)
2018,Febrero,España,0,2,,2,POINT (0.812436 -77847006)
2018,Febrero,España,39,72,,111,POINT (0.81488 -77356)
2018,Febrero,España,27,25,,52,POINT (10406342 -75527794)
2018,Febrero,España,136,189,,325,POINT (10446304 -75516486)
2018,Febrero,España,23,54,,77,POINT (10886686 -74776479)
2018,Febrero,España,0,2,,2,POINT (10970933 -74765343)
2018,Febrero,España,0,7,,7,POINT (11247723 -74213989)
2018,Febrero,España,4,7,,11,POINT (11360029 -72129595)
2018,Febrero,España,6,5,,11,POINT (125862 -81702165)
2018,Febrero,España,1,1,,2,POINT (133387613 -81372937)
2018,Febrero,España,364,515,,879,POINT (3451668 -76532004)
2018,Febrero,España,1,2,,3,POINT (445285 -75766353)
2018,Febrero,España,2615,5344,,7959,POINT (4697157 -74140516)
2018,Febrero,España,9,8,,17,POINT (4815189 -75736374)
2018,Febrero,España,374,756,,1130,POINT (6170465 -7542726)
2018,Febrero,España,0,1,,1,POINT (6218835 -75586989)
2018,Febrero,España,0,2,,2,POINT (7088729 -70740253)
2018,Febrero,España,4,6,,10,POINT (7128047 -73181317)
2018,Febrero,España,27,47,,74,POINT (7819 -72453013)
2018,Febrero,España,7,7,,14,POINT (836068 -72409396)
2018,Febrero,España,0,6,,6,POINT (863337 -7735002)
2018,Febrero,Eritrea,1,0,,1,POINT (4697157 -74140516)
2018,Febrero,Eslovaquia,17,25,,42,POINT (0.81488 -77356)
2018,Febrero,Eslovaquia,0,1,,1,POINT (10406342 -75527794)
2018,Febrero,Eslovaquia,1,0,,1,POINT (10446304 -75516486)
2018,Febrero,Eslovaquia,0,2,,2,POINT (10886686 -74776479)
2018,Febrero,Eslovaquia,32,71,,103,POINT (4697157 -74140516)
2018,Febrero,Eslovaquia,3,3,,6,POINT (6170465 -7542726)
2018,Febrero,Eslovenia,1,2,,3,POINT (0.81488 -77356)
2018,Febrero,Eslovenia,0,5,,5,POINT (10446304 -75516486)
2018,Febrero,Eslovenia,2,2,,4,POINT (11247723 -74213989)
2018,Febrero,Eslovenia,1,1,,2,POINT (3451668 -76532004)
2018,Febrero,Eslovenia,27,32,,59,POINT (4697157 -74140516)
2018,Febrero,Eslovenia,0,2,,2,POINT (6170465 -7542726)
2018,Febrero,Eslovenia,0,1,,1,POINT (863337 -7735002)
2018,Febrero,Estados Unidos de América,5,17,,22,POINT (-4191162 -69941498)
2018,Febrero,Estados Unidos de América,11,10,,21,POINT (-4214082 -69941431)
2018,Febrero,Estados Unidos de América,3,7,,10,POINT (0.33002 -76876446)
2018,Febrero,Estados Unidos de América,52,95,,147,POINT (0.81488 -77356)
2018,Febrero,Estados Unidos de América,0,1,,1,POINT (1800143 -78802679)
2018,Febrero,Estados Unidos de América,76,90,,166,POINT (10406342 -75527794)
2018,Febrero,Estados Unidos de América,5116,6623,,11739,POINT (10446304 -75516486)
2018,Febrero,Estados Unidos de América,656,1190,,1846,POINT (10886686 -74776479)
2018,Febrero,Estados Unidos de América,0,1,,1,POINT (11117206 -74232675)
2018,Febrero,Estados Unidos de América,1,2,,3,POINT (11247723 -74213989)
2018,Febrero,Estados Unidos de América,1,3,,4,POINT (11360029 -72129595)
2018,Febrero,Estados Unidos de América,1,3,,4,POINT (125744111 -81703935)
2018,Febrero,Estados Unidos de América,27,39,,66,POINT (125862 -81702165)
2018,Febrero,Estados Unidos de América,3,4,,7,POINT (133387613 -81372937)
2018,Febrero,Estados Unidos de América,1081,1539,,2620,POINT (3451668 -76532004)
2018,Febrero,Estados Unidos de América,88,144,,232,POINT (445285 -75766353)
2018,Febrero,Estados Unidos de América,8745,14761,,23506,POINT (4697157 -74140516)
2018,Febrero,Estados Unidos de América,131,158,,289,POINT (4815189 -75736374)
2018,Febrero,Estados Unidos de América,2755,6528,,9283,POINT (6170465 -7542726)
2018,Febrero,Estados Unidos de América,0,1,,1,POINT (6218835 -75586989)
2018,Febrero,Estados Unidos de América,0,2,,2,POINT (6222552 -77401154)
2018,Febrero,Estados Unidos de América,23,45,,68,POINT (7128047 -73181317)
2018,Febrero,Estados Unidos de América,12,15,,27,POINT (7819 -72453013)
2018,Febrero,Estados Unidos de América,3,4,,7,POINT (836068 -72409396)
2018,Febrero,Estados Unidos de América,8,16,,24,POINT (863337 -7735002)
2018,Febrero,Estonia,1,1,,2,POINT (0.33002 -76876446)
2018,Febrero,Estonia,1,0,,1,POINT (0.81488 -77356)
2018,Febrero,Estonia,4,4,,8,POINT (10446304 -75516486)
2018,Febrero,Estonia,0,1,,1,POINT (10886686 -74776479)
2018,Febrero,Estonia,0,1,,1,POINT (10970933 -74765343)
2018,Febrero,Estonia,5,2,,7,POINT (3451668 -76532004)
2018,Febrero,Estonia,11,9,,20,POINT (4697157 -74140516)
2018,Febrero,Etiopia,0,2,,2,POINT (3451668 -76532004)
2018,Febrero,Etiopia,2,3,,5,POINT (4697157 -74140516)
2018,Febrero,Etiopia,0,1,,1,POINT (6170465 -7542726)
2018,Febrero,Islas Fiji,0,2,,2,POINT (6170465 -7542726)
2018,Febrero,Filipinas,2,0,,2,POINT (0.81488 -77356)
2018,Febrero,Filipinas,0,33,,33,POINT (10406342 -75527794)
2018,Febrero,Filipinas,3,38,,41,POINT (10446304 -75516486)
2018,Febrero,Filipinas,0,16,,16,POINT (10886686 -74776479)
2018,Febrero,Filipinas,0,19,,19,POINT (10970933 -74765343)
2018,Febrero,Filipinas,0,14,,14,POINT (11247723 -74213989)
2018,Febrero,Filipinas,3,18,,21,POINT (3451668 -76532004)
2018,Febrero,Filipinas,0,15,,15,POINT (3884426 -77061029)
2018,Febrero,Filipinas,40,70,,110,POINT (4697157 -74140516)
2018,Febrero,Filipinas,9,4,,13,POINT (6170465 -7542726)
2018,Febrero,Filipinas,0,3,,3,POINT (9402597 -75681642)
2018,Febrero,Finlandia,3,2,,5,POINT (0.81488 -77356)
2018,Febrero,Finlandia,2,3,,5,POINT (10406342 -75527794)
2018,Febrero,Finlandia,4,13,,17,POINT (10446304 -75516486)
2018,Febrero,Finlandia,4,6,,10,POINT (125862 -81702165)
2018,Febrero,Finlandia,6,2,,8,POINT (3451668 -76532004)
2018,Febrero,Finlandia,79,91,,170,POINT (4697157 -74140516)
2018,Febrero,Finlandia,8,12,,20,POINT (6170465 -7542726)
2018,Febrero,Francia,4,10,,14,POINT (-4191162 -69941498)
2018,Febrero,Francia,9,11,,20,POINT (-4214082 -69941431)
2018,Febrero,Francia,5,12,,17,POINT (0.33002 -76876446)
2018,Febrero,Francia,2,2,,4,POINT (0.812436 -77847006)
2018,Febrero,Francia,131,157,,288,POINT (0.81488 -77356)
2018,Febrero,Francia,22,20,,42,POINT (10406342 -75527794)
2018,Febrero,Francia,187,252,,439,POINT (10446304 -75516486)
2018,Febrero,Francia,26,39,,65,POINT (10886686 -74776479)
2018,Febrero,Francia,2,4,,6,POINT (11247723 -74213989)
2018,Febrero,Francia,2,1,,3,POINT (11360029 -72129595)
2018,Febrero,Francia,0,2,,2,POINT (125744111 -81703935)
2018,Febrero,Francia,1,3,,4,POINT (125862 -81702165)
2018,Febrero,Francia,3,10,,13,POINT (133387613 -81372937)
2018,Febrero,Francia,85,116,,201,POINT (3451668 -76532004)
2018,Febrero,Francia,3020,3866,,6886,POINT (4697157 -74140516)
2018,Febrero,Francia,1,4,,5,POINT (4815189 -75736374)
2018,Febrero,Francia,234,327,,561,POINT (6170465 -7542726)
2018,Febrero,Francia,0,2,,2,POINT (6185536 -67484028)
2018,Febrero,Francia,5,1,,6,POINT (7128047 -73181317)
2018,Febrero,Francia,0,8,,8,POINT (7819 -72453013)
2018,Febrero,Francia,0,2,,2,POINT (836068 -72409396)
2018,Febrero,Francia,7,3,,10,POINT (863337 -7735002)
2018,Febrero,Georgia,0,1,,1,POINT (10406342 -75527794)
2018,Febrero,Georgia,0,1,,1,POINT (10446304 -75516486)
2018,Febrero,Georgia,0,1,,1,POINT (10886686 -74776479)
2018,Febrero,Georgia,0,3,,3,POINT (11247723 -74213989)
2018,Febrero,Georgia,1,6,,7,POINT (4697157 -74140516)
2018,Febrero,Ghana,2,6,,8,POINT (0.81488 -77356)
2018,Febrero,Ghana,0,2,,2,POINT (10446304 -75516486)
2018,Febrero,Ghana,1,0,,1,POINT (3451668 -76532004)
2018,Febrero,Ghana,3,7,,10,POINT (4697157 -74140516)
2018,Febrero,Granada,0,2,,2,POINT (10446304 -75516486)
2018,Febrero,Granada,1,2,,3,POINT (4697157 -74140516)
2018,Febrero,Grecia,0,1,,1,POINT (-4214082 -69941431)
2018,Febrero,Grecia,1,1,,2,POINT (0.81488 -77356)
2018,Febrero,Grecia,0,2,,2,POINT (10406342 -75527794)
2018,Febrero,Grecia,6,9,,15,POINT (10446304 -75516486)
2018,Febrero,Grecia,0,2,,2,POINT (10886686 -74776479)
2018,Febrero,Grecia,0,1,,1,POINT (10970933 -74765343)
2018,Febrero,Grecia,0,1,,1,POINT (11247723 -74213989)
2018,Febrero,Grecia,38,89,,127,POINT (4697157 -74140516)
2018,Febrero,Grecia,0,1,,1,POINT (4815189 -75736374)
2018,Febrero,Grecia,2,10,,12,POINT (6170465 -7542726)
2018,Febrero,Grecia,0,3,,3,POINT (7819 -72453013)
2018,Febrero,Grecia,0,1,,1,POINT (863337 -7735002)
2018,Febrero,Guatemala,0,1,,1,POINT (-4214082 -69941431)
2018,Febrero,Guatemala,2,1,,3,POINT (0.81488 -77356)
2018,Febrero,Guatemala,1,1,,2,POINT (10406342 -75527794)
2018,Febrero,Guatemala,124,182,,306,POINT (10446304 -75516486)
2018,Febrero,Guatemala,8,18,,26,POINT (10886686 -74776479)
2018,Febrero,Guatemala,0,2,,2,POINT (11360029 -72129595)
2018,Febrero,Guatemala,3,1,,4,POINT (125862 -81702165)
2018,Febrero,Guatemala,38,57,,95,POINT (3451668 -76532004)
2018,Febrero,Guatemala,0,1,,1,POINT (445285 -75766353)
2018,Febrero,Guatemala,702,906,,1608,POINT (4697157 -74140516)
2018,Febrero,Guatemala,4,6,,10,POINT (4815189 -75736374)
2018,Febrero,Guatemala,82,169,,251,POINT (6170465 -7542726)
2018,Febrero,Guatemala,1,0,,1,POINT (7088729 -70740253)
2018,Febrero,Guatemala,3,2,,5,POINT (7128047 -73181317)
2018,Febrero,Guatemala,0,6,,6,POINT (7819 -72453013)
2018,Febrero,Guyana,1,1,,2,POINT (10446304 -75516486)
2018,Febrero,Guyana,2,2,,4,POINT (10886686 -74776479)
2018,Febrero,Guyana,1,0,,1,POINT (3451668 -76532004)
2018,Febrero,Guyana,2,7,,9,POINT (4697157 -74140516)
2018,Febrero,Guyana,3,2,,5,POINT (6170465 -7542726)
2018,Febrero,Guyana,2,1,,3,POINT (7819 -72453013)
2018,Febrero,Haití,5,10,,15,POINT (10446304 -75516486)
2018,Febrero,Haití,2,5,,7,POINT (10886686 -74776479)
2018,Febrero,Haití,0,1,,1,POINT (3451668 -76532004)
2018,Febrero,Haití,9,8,,17,POINT (4697157 -74140516)
2018,Febrero,Haití,16,20,,36,POINT (6170465 -7542726)
2018,Febrero,Honduras,1,0,,1,POINT (-4191162 -69941498)
2018,Febrero,Honduras,0,1,,1,POINT (0.81488 -77356)
2018,Febrero,Honduras,0,1,,1,POINT (1800143 -78802679)
2018,Febrero,Honduras,0,13,,13,POINT (10406342 -75527794)
2018,Febrero,Honduras,22,26,,48,POINT (10446304 -75516486)
2018,Febrero,Honduras,3,6,,9,POINT (10886686 -74776479)
2018,Febrero,Honduras,59,42,,101,POINT (3451668 -76532004)
2018,Febrero,Honduras,0,1,,1,POINT (445285 -75766353)
2018,Febrero,Honduras,338,334,,672,POINT (4697157 -74140516)
2018,Febrero,Honduras,1,1,,2,POINT (4815189 -75736374)
2018,Febrero,Honduras,57,78,,135,POINT (6170465 -7542726)
2018,Febrero,Honduras,2,2,,4,POINT (7128047 -73181317)
2018,Febrero,Hong Kong,2,1,,3,POINT (-4191162 -69941498)
2018,Febrero,Hong Kong,0,4,,4,POINT (0.81488 -77356)
2018,Febrero,Hong Kong,8,10,,18,POINT (4697157 -74140516)
2018,Febrero,Hungría,1,0,,1,POINT (10406342 -75527794)
2018,Febrero,Hungría,1,5,,6,POINT (10446304 -75516486)
2018,Febrero,Hungría,0,2,,2,POINT (10886686 -74776479)
2018,Febrero,Hungría,7,9,,16,POINT (3451668 -76532004)
2018,Febrero,Hungría,32,67,,99,POINT (4697157 -74140516)
2018,Febrero,Hungría,8,9,,17,POINT (6170465 -7542726)
2018,Febrero,India,2,4,,6,POINT (0.81488 -77356)
2018,Febrero,India,0,15,,15,POINT (10406342 -75527794)
2018,Febrero,India,23,43,,66,POINT (10446304 -75516486)
2018,Febrero,India,2,14,,16,POINT (10886686 -74776479)
2018,Febrero,India,0,3,,3,POINT (11247723 -74213989)
2018,Febrero,India,0,1,,1,POINT (125862 -81702165)
2018,Febrero,India,2,19,,21,POINT (3451668 -76532004)
2018,Febrero,India,64,335,,399,POINT (4697157 -74140516)
2018,Febrero,India,1,1,,2,POINT (4815189 -75736374)
2018,Febrero,India,5,59,,64,POINT (6170465 -7542726)
2018,Febrero,India,0,1,,1,POINT (7128047 -73181317)
2018,Febrero,India,0,3,,3,POINT (9402597 -75681642)
2018,Febrero,Indonesia,0,6,,6,POINT (10406342 -75527794)
2018,Febrero,Indonesia,3,7,,10,POINT (10446304 -75516486)
2018,Febrero,Indonesia,1,0,,1,POINT (10886686 -74776479)
2018,Febrero,Indonesia,0,3,,3,POINT (11247723 -74213989)
2018,Febrero,Indonesia,1,1,,2,POINT (3451668 -76532004)
2018,Febrero,Indonesia,18,41,,59,POINT (4697157 -74140516)
2018,Febrero,Indonesia,1,0,,1,POINT (6170465 -7542726)
2018,Febrero,Indonesia,1,1,,2,POINT (7128047 -73181317)
2018,Febrero,Iraq,0,1,,1,POINT (10446304 -75516486)
2018,Febrero,Iraq,0,1,,1,POINT (4697157 -74140516)
2018,Febrero,Irán,0,1,,1,POINT (10446304 -75516486)
2018,Febrero,Irán,0,1,,1,POINT (10886686 -74776479)
2018,Febrero,Irán,0,1,,1,POINT (11360029 -72129595)
2018,Febrero,Irán,2,12,,14,POINT (4697157 -74140516)
2018,Febrero,Irán,0,1,,1,POINT (4815189 -75736374)
2018,Febrero,República de Irlanda,0,1,,1,POINT (-4214082 -69941431)
2018,Febrero,República de Irlanda,6,11,,17,POINT (0.81488 -77356)
2018,Febrero,República de Irlanda,2,1,,3,POINT (10406342 -75527794)
2018,Febrero,República de Irlanda,19,37,,56,POINT (10446304 -75516486)
2018,Febrero,República de Irlanda,1,4,,5,POINT (10886686 -74776479)
2018,Febrero,República de Irlanda,3,4,,7,POINT (3451668 -76532004)
2018,Febrero,República de Irlanda,92,189,,281,POINT (4697157 -74140516)
2018,Febrero,República de Irlanda,10,33,,43,POINT (6170465 -7542726)
2018,Febrero,República de Irlanda,0,1,,1,POINT (6185536 -67484028)
2018,Febrero,República de Irlanda,4,2,,6,POINT (863337 -7735002)
2018,Febrero,Islandia,0,1,,1,POINT (10406342 -75527794)
2018,Febrero,Islandia,2,7,,9,POINT (10446304 -75516486)
2018,Febrero,Islandia,0,1,,1,POINT (10886686 -74776479)
2018,Febrero,Islandia,3,0,,3,POINT (3451668 -76532004)
2018,Febrero,Islandia,15,21,,36,POINT (4697157 -74140516)
2018,Febrero,Islandia,2,6,,8,POINT (6170465 -7542726)
2018,Febrero,Israel,0,1,,1,POINT (-4214082 -69941431)
2018,Febrero,Israel,6,13,,19,POINT (0.81488 -77356)
2018,Febrero,Israel,0,4,,4,POINT (10406342 -75527794)
2018,Febrero,Israel,23,93,,116,POINT (10446304 -75516486)
2018,Febrero,Israel,2,8,,10,POINT (10886686 -74776479)
2018,Febrero,Israel,0,1,,1,POINT (11247723 -74213989)
2018,Febrero,Israel,1,1,,2,POINT (125862 -81702165)
2018,Febrero,Israel,7,27,,34,POINT (3451668 -76532004)
2018,Febrero,Israel,256,770,,1026,POINT (4697157 -74140516)
2018,Febrero,Israel,27,91,,118,POINT (6170465 -7542726)
2018,Febrero,Israel,0,1,,1,POINT (7128047 -73181317)
2018,Febrero,Islas Aland/Provincia de Finlandia,0,1,,1,POINT (4697157 -74140516)
2018,Febrero,Italia,2,6,,8,POINT (-4191162 -69941498)
2018,Febrero,Italia,4,5,,9,POINT (-4214082 -69941431)
2018,Febrero,Italia,1,1,,2,POINT (0.33002 -76876446)
2018,Febrero,Italia,2,2,,4,POINT (0.812436 -77847006)
2018,Febrero,Italia,9,37,,46,POINT (0.81488 -77356)
2018,Febrero,Italia,1,2,,3,POINT (1800143 -78802679)
2018,Febrero,Italia,10,23,,33,POINT (10406342 -75527794)
2018,Febrero,Italia,109,172,,281,POINT (10446304 -75516486)
2018,Febrero,Italia,7,26,,33,POINT (10886686 -74776479)
2018,Febrero,Italia,1,0,,1,POINT (11117206 -74232675)
2018,Febrero,Italia,1,5,,6,POINT (11247723 -74213989)
2018,Febrero,Italia,0,10,,10,POINT (11360029 -72129595)
2018,Febrero,Italia,6,16,,22,POINT (125862 -81702165)
2018,Febrero,Italia,31,113,,144,POINT (3451668 -76532004)
2018,Febrero,Italia,0,2,,2,POINT (445285 -75766353)
2018,Febrero,Italia,958,2062,,3020,POINT (4697157 -74140516)
2018,Febrero,Italia,0,2,,2,POINT (4815189 -75736374)
2018,Febrero,Italia,73,242,,315,POINT (6170465 -7542726)
2018,Febrero,Italia,0,1,,1,POINT (7088729 -70740253)
2018,Febrero,Italia,3,3,,6,POINT (7128047 -73181317)
2018,Febrero,Italia,10,21,,31,POINT (7819 -72453013)
2018,Febrero,Italia,2,5,,7,POINT (836068 -72409396)
2018,Febrero,Italia,4,8,,12,POINT (863337 -7735002)
2018,Febrero,Jamaica,0,1,,1,POINT (0.81488 -77356)
2018,Febrero,Jamaica,9,8,,17,POINT (10446304 -75516486)
2018,Febrero,Jamaica,3,4,,7,POINT (10886686 -74776479)
2018,Febrero,Jamaica,1,0,,1,POINT (125862 -81702165)
2018,Febrero,Jamaica,1,3,,4,POINT (3451668 -76532004)
2018,Febrero,Jamaica,27,28,,55,POINT (4697157 -74140516)
2018,Febrero,Jamaica,9,16,,25,POINT (6170465 -7542726)
2018,Febrero,Jamaica,1,0,,1,POINT (7128047 -73181317)
2018,Febrero,Jamaica,1,0,,1,POINT (7819 -72453013)
2018,Febrero,Islas Salomón,0,1,,1,POINT (4697157 -74140516)
2018,Febrero,Japón,0,1,,1,POINT (-4191162 -69941498)
2018,Febrero,Japón,0,1,,1,POINT (-4214082 -69941431)
2018,Febrero,Japón,0,1,,1,POINT (0.33002 -76876446)
2018,Febrero,Japón,4,15,,19,POINT (0.81488 -77356)
2018,Febrero,Japón,0,2,,2,POINT (10406342 -75527794)
2018,Febrero,Japón,21,13,,34,POINT (10446304 -75516486)
2018,Febrero,Japón,4,10,,14,POINT (10886686 -74776479)
2018,Febrero,Japón,1,0,,1,POINT (125862 -81702165)
2018,Febrero,Japón,3,14,,17,POINT (3451668 -76532004)
2018,Febrero,Japón,220,571,,791,POINT (4697157 -74140516)
2018,Febrero,Japón,18,52,,70,POINT (6170465 -7542726)
2018,Febrero,Japón,0,1,,1,POINT (6222552 -77401154)
2018,Febrero,Japón,0,2,,2,POINT (7819 -72453013)
2018,Febrero,Japón,0,1,,1,POINT (863337 -7735002)
2018,Febrero,Jordania,1,10,,11,POINT (4697157 -74140516)
2018,Febrero,Kazajistán,0,1,,1,POINT (0.81488 -77356)
2018,Febrero,Kazajistán,3,0,,3,POINT (10446304 -75516486)
2018,Febrero,Kazajistán,6,4,,10,POINT (4697157 -74140516)
2018,Febrero,Kenia,0,1,,1,POINT (10446304 -75516486)
2018,Febrero,Kenia,1,3,,4,POINT (3451668 -76532004)
2018,Febrero,Kenia,9,6,,15,POINT (4697157 -74140516)
2018,Febrero,Kiribati,0,4,,4,POINT (10406342 -75527794)
2018,Febrero,Kiribati,0,1,,1,POINT (10446304 -75516486)
2018,Febrero,Kirguistán,1,0,,1,POINT (4697157 -74140516)
2018,Febrero,Kirguistán,0,1,,1,POINT (6170465 -7542726)
2018,Febrero,Kuwait,0,6,,6,POINT (4697157 -74140516)
2018,Febrero,República de Kosovo,0,2,,2,POINT (4697157 -74140516)
2018,Febrero,Letonia,0,2,,2,POINT (10406342 -75527794)
2018,Febrero,Letonia,4,2,,6,POINT (10446304 -75516486)
2018,Febrero,Letonia,0,1,,1,POINT (10970933 -74765343)
2018,Febrero,Letonia,2,0,,2,POINT (3451668 -76532004)
2018,Febrero,Letonia,8,18,,26,POINT (4697157 -74140516)
2018,Febrero,Letonia,1,2,,3,POINT (6170465 -7542726)
2018,Febrero,Lituania,0,2,,2,POINT (10406342 -75527794)
2018,Febrero,Lituania,2,1,,3,POINT (10446304 -75516486)
2018,Febrero,Lituania,0,2,,2,POINT (10886686 -74776479)
2018,Febrero,Lituania,1,4,,5,POINT (3451668 -76532004)
2018,Febrero,Lituania,50,35,,85,POINT (4697157 -74140516)
2018,Febrero,Lituania,2,4,,6,POINT (6170465 -7542726)
2018,Febrero,Líbano,1,3,,4,POINT (10446304 -75516486)
2018,Febrero,Líbano,0,1,,1,POINT (10886686 -74776479)
2018,Febrero,Líbano,2,0,,2,POINT (11360029 -72129595)
2018,Febrero,Líbano,18,22,,40,POINT (4697157 -74140516)
2018,Febrero,Líbano,0,1,,1,POINT (4815189 -75736374)
2018,Febrero,Líbano,2,3,,5,POINT (6170465 -7542726)
2018,Febrero,Líbano,1,1,,2,POINT (7128047 -73181317)
2018,Febrero,Liechtenstein,1,1,,2,POINT (4697157 -74140516)
2018,Febrero,Luxemburgo,0,1,,1,POINT (10406342 -75527794)
2018,Febrero,Luxemburgo,1,0,,1,POINT (10886686 -74776479)
2018,Febrero,Luxemburgo,1,0,,1,POINT (11247723 -74213989)
2018,Febrero,Luxemburgo,0,1,,1,POINT (3451668 -76532004)
2018,Febrero,Luxemburgo,9,17,,26,POINT (4697157 -74140516)
2018,Febrero,Luxemburgo,1,2,,3,POINT (6170465 -7542726)
2018,Febrero,Luxemburgo,0,1,,1,POINT (7819 -72453013)
2018,Febrero,Macedonia,0,1,,1,POINT (10406342 -75527794)
2018,Febrero,Macedonia,0,3,,3,POINT (4697157 -74140516)
2018,Febrero,Madagascar,1,0,,1,POINT (4697157 -74140516)
2018,Febrero,Malasia,1,1,,2,POINT (10406342 -75527794)
2018,Febrero,Malasia,1,2,,3,POINT (10446304 -75516486)
2018,Febrero,Malasia,0,1,,1,POINT (3451668 -76532004)
2018,Febrero,Malasia,23,14,,37,POINT (4697157 -74140516)
2018,Febrero,Malasia,1,0,,1,POINT (6170465 -7542726)
2018,Febrero,Malasia,1,1,,2,POINT (863337 -7735002)
2018,Febrero,Malasia,0,3,,3,POINT (9402597 -75681642)
2018,Febrero,Malawi,3,1,,4,POINT (4697157 -74140516)
2018,Febrero,Malí,0,1,,1,POINT (10446304 -75516486)
2018,Febrero,Malta,1,0,,1,POINT (0.33002 -76876446)
2018,Febrero,Malta,1,0,,1,POINT (0.81488 -77356)
2018,Febrero,Malta,1,1,,2,POINT (10446304 -75516486)
2018,Febrero,Malta,5,15,,20,POINT (4697157 -74140516)
2018,Febrero,Malta,0,1,,1,POINT (6170465 -7542726)
2018,Febrero,Marruecos,2,2,,4,POINT (0.81488 -77356)
2018,Febrero,Marruecos,1,1,,2,POINT (10446304 -75516486)
2018,Febrero,Marruecos,10,14,,24,POINT (4697157 -74140516)
2018,Febrero,Marruecos,0,2,,2,POINT (6170465 -7542726)
2018,Febrero,Mauricio,0,1,,1,POINT (10406342 -75527794)
2018,Febrero,Mauricio,0,1,,1,POINT (4697157 -74140516)
2018,Febrero,México,0,1,,1,POINT (-4191162 -69941498)
2018,Febrero,México,0,2,,2,POINT (-4214082 -69941431)
2018,Febrero,México,2,1,,3,POINT (0.33002 -76876446)
2018,Febrero,México,16,28,,44,POINT (0.81488 -77356)
2018,Febrero,México,0,1,,1,POINT (1800143 -78802679)
2018,Febrero,México,14,15,,29,POINT (10406342 -75527794)
2018,Febrero,México,152,212,,364,POINT (10446304 -75516486)
2018,Febrero,México,20,57,,77,POINT (10886686 -74776479)
2018,Febrero,México,3,4,,7,POINT (11360029 -72129595)
2018,Febrero,México,0,2,,2,POINT (125744111 -81703935)
2018,Febrero,México,4,4,,8,POINT (125862 -81702165)
2018,Febrero,México,0,8,,8,POINT (133387613 -81372937)
2018,Febrero,México,81,246,,327,POINT (3451668 -76532004)
2018,Febrero,México,0,2,,2,POINT (445285 -75766353)
2018,Febrero,México,3701,6794,,10495,POINT (4697157 -74140516)
2018,Febrero,México,31,35,,66,POINT (4815189 -75736374)
2018,Febrero,México,515,1226,,1741,POINT (6170465 -7542726)
2018,Febrero,México,3,0,,3,POINT (7088729 -70740253)
2018,Febrero,México,7,11,,18,POINT (7128047 -73181317)
2018,Febrero,México,20,26,,46,POINT (7819 -72453013)
2018,Febrero,México,2,10,,12,POINT (836068 -72409396)
2018,Febrero,República de Moldavia,1,0,,1,POINT (3451668 -76532004)
2018,Febrero,República de Moldavia,1,1,,2,POINT (4697157 -74140516)
2018,Febrero,Mónaco,0,1,,1,POINT (3451668 -76532004)
2018,Febrero,Mongolia,1,0,,1,POINT (4697157 -74140516)
2018,Febrero,Montenegro,0,5,,5,POINT (10446304 -75516486)
2018,Febrero,Montenegro,0,1,,1,POINT (11247723 -74213989)
2018,Febrero,Montenegro,2,1,,3,POINT (4697157 -74140516)
2018,Febrero,Mozambique,2,1,,3,POINT (4697157 -74140516)
2018,Febrero,Myanmar,0,4,,4,POINT (10406342 -75527794)
2018,Febrero,Myanmar,0,2,,2,POINT (10446304 -75516486)
2018,Febrero,Myanmar,1,0,,1,POINT (4697157 -74140516)
2018,Febrero,Namibia,0,1,,1,POINT (0.81488 -77356)
2018,Febrero,Nepal,1,5,,6,POINT (4697157 -74140516)
2018,Febrero,Nepal,0,1,,1,POINT (6170465 -7542726)
2018,Febrero,Nicaragua,1,0,,1,POINT (-4191162 -69941498)
2018,Febrero,Nicaragua,0,1,,1,POINT (10406342 -75527794)
2018,Febrero,Nicaragua,23,25,,48,POINT (10446304 -75516486)
2018,Febrero,Nicaragua,2,8,,10,POINT (10886686 -74776479)
2018,Febrero,Nicaragua,0,3,,3,POINT (125744111 -81703935)
2018,Febrero,Nicaragua,17,4,,21,POINT (3451668 -76532004)
2018,Febrero,Nicaragua,1,0,,1,POINT (445285 -75766353)
2018,Febrero,Nicaragua,97,81,,178,POINT (4697157 -74140516)
2018,Febrero,Nicaragua,4,5,,9,POINT (4815189 -75736374)
2018,Febrero,Nicaragua,14,27,,41,POINT (6170465 -7542726)
2018,Febrero,Nigeria,0,4,,4,POINT (0.81488 -77356)
2018,Febrero,Nigeria,1,0,,1,POINT (10446304 -75516486)
2018,Febrero,Nigeria,2,0,,2,POINT (3451668 -76532004)
2018,Febrero,Nigeria,4,7,,11,POINT (4697157 -74140516)
2018,Febrero,Nigeria,0,2,,2,POINT (6170465 -7542726)
2018,Febrero,Nigeria,0,1,,1,POINT (7819 -72453013)
2018,Febrero,Noruega,0,1,,1,POINT (-4214082 -69941431)
2018,Febrero,Noruega,2,2,,4,POINT (0.81488 -77356)
2018,Febrero,Noruega,5,2,,7,POINT (10406342 -75527794)
2018,Febrero,Noruega,22,35,,57,POINT (10446304 -75516486)
2018,Febrero,Noruega,0,1,,1,POINT (10886686 -74776479)
2018,Febrero,Noruega,1,1,,2,POINT (11247723 -74213989)
2018,Febrero,Noruega,0,1,,1,POINT (125862 -81702165)
2018,Febrero,Noruega,1,1,,2,POINT (133387613 -81372937)
2018,Febrero,Noruega,3,5,,8,POINT (3451668 -76532004)
2018,Febrero,Noruega,139,167,,306,POINT (4697157 -74140516)
2018,Febrero,Noruega,0,1,,1,POINT (4815189 -75736374)
2018,Febrero,Noruega,8,17,,25,POINT (6170465 -7542726)
2018,Febrero,Noruega,0,1,,1,POINT (7819 -72453013)
2018,Febrero,Noruega,1,0,,1,POINT (863337 -7735002)
2018,Febrero,Nueva Zelanda,0,2,,2,POINT (-4214082 -69941431)
2018,Febrero,Nueva Zelanda,5,2,,7,POINT (0.81488 -77356)
2018,Febrero,Nueva Zelanda,3,6,,9,POINT (10406342 -75527794)
2018,Febrero,Nueva Zelanda,12,15,,27,POINT (10446304 -75516486)
2018,Febrero,Nueva Zelanda,1,1,,2,POINT (10886686 -74776479)
2018,Febrero,Nueva Zelanda,1,1,,2,POINT (3451668 -76532004)
2018,Febrero,Nueva Zelanda,0,1,,1,POINT (445285 -75766353)
2018,Febrero,Nueva Zelanda,46,65,,111,POINT (4697157 -74140516)
2018,Febrero,Nueva Zelanda,1,2,,3,POINT (4815189 -75736374)
2018,Febrero,Nueva Zelanda,4,15,,19,POINT (6170465 -7542726)
2018,Febrero,Nueva Zelanda,2,1,,3,POINT (863337 -7735002)
2018,Febrero,Países Bajos,3,3,,6,POINT (-4191162 -69941498)
2018,Febrero,Países Bajos,2,5,,7,POINT (-4214082 -69941431)
2018,Febrero,Países Bajos,2,5,,7,POINT (0.33002 -76876446)
2018,Febrero,Países Bajos,27,23,,50,POINT (0.81488 -77356)
2018,Febrero,Países Bajos,31,38,,69,POINT (10406342 -75527794)
2018,Febrero,Países Bajos,146,190,,336,POINT (10446304 -75516486)
2018,Febrero,Países Bajos,16,22,,38,POINT (10886686 -74776479)
2018,Febrero,Países Bajos,0,1,,1,POINT (10970933 -74765343)
2018,Febrero,Países Bajos,2,4,,6,POINT (11247723 -74213989)
2018,Febrero,Países Bajos,0,2,,2,POINT (11360029 -72129595)
2018,Febrero,Países Bajos,2,2,,4,POINT (125862 -81702165)
2018,Febrero,Países Bajos,42,57,,99,POINT (3451668 -76532004)
2018,Febrero,Países Bajos,1464,1987,,3451,POINT (4697157 -74140516)
2018,Febrero,Países Bajos,2,6,,8,POINT (4815189 -75736374)
2018,Febrero,Países Bajos,112,206,,318,POINT (6170465 -7542726)
2018,Febrero,Países Bajos,0,1,,1,POINT (6218835 -75586989)
2018,Febrero,Países Bajos,6,6,,12,POINT (7128047 -73181317)
2018,Febrero,Países Bajos,1,6,,7,POINT (7819 -72453013)
2018,Febrero,Países Bajos,15,4,,19,POINT (863337 -7735002)
2018,Febrero,Pakistán,1,0,,1,POINT (-4214082 -69941431)
2018,Febrero,Pakistán,0,1,,1,POINT (0.81488 -77356)
2018,Febrero,Pakistán,1,3,,4,POINT (10446304 -75516486)
2018,Febrero,Pakistán,5,16,,21,POINT (4697157 -74140516)
2018,Febrero,Pakistán,0,1,,1,POINT (6170465 -7542726)
2018,Febrero,Pakistán,0,1,,1,POINT (7819 -72453013)
2018,Febrero,Panamá,6,6,,12,POINT (0.81488 -77356)
2018,Febrero,Panamá,0,10,,10,POINT (10406342 -75527794)
2018,Febrero,Panamá,766,688,,1454,POINT (10446304 -75516486)
2018,Febrero,Panamá,129,122,,251,POINT (10886686 -74776479)
2018,Febrero,Panamá,105,92,,197,POINT (125862 -81702165)
2018,Febrero,Panamá,390,343,,733,POINT (3451668 -76532004)
2018,Febrero,Panamá,30,57,,87,POINT (445285 -75766353)
2018,Febrero,Panamá,2541,2237,,4778,POINT (4697157 -74140516)
2018,Febrero,Panamá,68,55,,123,POINT (4815189 -75736374)
2018,Febrero,Panamá,2829,2178,,5007,POINT (6170465 -7542726)
2018,Febrero,Panamá,0,1,,1,POINT (6218835 -75586989)
2018,Febrero,Panamá,0,1,,1,POINT (6222552 -77401154)
2018,Febrero,Panamá,0,2,,2,POINT (7102626 -77762647)
2018,Febrero,Panamá,12,12,,24,POINT (7128047 -73181317)
2018,Febrero,Panamá,1,2,,3,POINT (7819 -72453013)
2018,Febrero,Panamá,0,1,,1,POINT (836068 -72409396)
2018,Febrero,Panamá,2,11,,13,POINT (863337 -7735002)
2018,Febrero,Paraguay,0,2,,2,POINT (-4214082 -69941431)
2018,Febrero,Paraguay,2,3,,5,POINT (0.81488 -77356)
2018,Febrero,Paraguay,5,4,,9,POINT (10406342 -75527794)
2018,Febrero,Paraguay,75,48,,123,POINT (10446304 -75516486)
2018,Febrero,Paraguay,12,158,,170,POINT (10886686 -74776479)
2018,Febrero,Paraguay,0,2,,2,POINT (11360029 -72129595)
2018,Febrero,Paraguay,47,28,,75,POINT (125862 -81702165)
2018,Febrero,Paraguay,9,2,,11,POINT (3451668 -76532004)
2018,Febrero,Paraguay,193,192,,385,POINT (4697157 -74140516)
2018,Febrero,Paraguay,10,16,,26,POINT (6170465 -7542726)
2018,Febrero,Paraguay,0,1,,1,POINT (836068 -72409396)
2018,Febrero,Perú,27,23,,50,POINT (-4191162 -69941498)
2018,Febrero,Perú,52,57,,109,POINT (-4214082 -69941431)
2018,Febrero,Perú,1,0,,1,POINT (0.185957 -7478366)
2018,Febrero,Perú,2,6,,8,POINT (0.33002 -76876446)
2018,Febrero,Perú,158,341,,499,POINT (0.81488 -77356)
2018,Febrero,Perú,50,25,,75,POINT (10406342 -75527794)
2018,Febrero,Perú,832,612,,1444,POINT (10446304 -75516486)
2018,Febrero,Perú,11,25,,36,POINT (10886686 -74776479)
2018,Febrero,Perú,13,21,,34,POINT (11360029 -72129595)
2018,Febrero,Perú,405,290,,695,POINT (125862 -81702165)
2018,Febrero,Perú,141,201,,342,POINT (3451668 -76532004)
2018,Febrero,Perú,3951,4509,,8460,POINT (4697157 -74140516)
2018,Febrero,Perú,3,4,,7,POINT (4815189 -75736374)
2018,Febrero,Perú,340,543,,883,POINT (6170465 -7542726)
2018,Febrero,Perú,2,1,,3,POINT (6185536 -67484028)
2018,Febrero,Perú,2,1,,3,POINT (7088729 -70740253)
2018,Febrero,Perú,8,6,,14,POINT (7128047 -73181317)
2018,Febrero,Perú,130,246,,376,POINT (7819 -72453013)
2018,Febrero,Perú,4,6,,10,POINT (836068 -72409396)
2018,Febrero,Palestina,1,0,,1,POINT (0.81488 -77356)
2018,Febrero,Palestina,2,6,,8,POINT (4697157 -74140516)
2018,Febrero,Polonia,4,3,,7,POINT (-4214082 -69941431)
2018,Febrero,Polonia,9,4,,13,POINT (0.33002 -76876446)
2018,Febrero,Polonia,13,8,,21,POINT (0.81488 -77356)
2018,Febrero,Polonia,1,4,,5,POINT (10406342 -75527794)
2018,Febrero,Polonia,36,32,,68,POINT (10446304 -75516486)
2018,Febrero,Polonia,0,2,,2,POINT (10886686 -74776479)
2018,Febrero,Polonia,0,1,,1,POINT (11247723 -74213989)
2018,Febrero,Polonia,0,1,,1,POINT (11360029 -72129595)
2018,Febrero,Polonia,0,1,,1,POINT (125862 -81702165)
2018,Febrero,Polonia,9,21,,30,POINT (3451668 -76532004)
2018,Febrero,Polonia,194,232,,426,POINT (4697157 -74140516)
2018,Febrero,Polonia,0,1,,1,POINT (4815189 -75736374)
2018,Febrero,Polonia,16,23,,39,POINT (6170465 -7542726)
2018,Febrero,Polonia,2,1,,3,POINT (7819 -72453013)
2018,Febrero,Polonia,0,4,,4,POINT (806667 -767333)
2018,Febrero,Polonia,2,4,,6,POINT (863337 -7735002)
2018,Febrero,Portugal,2,1,,3,POINT (-4191162 -69941498)
2018,Febrero,Portugal,1,0,,1,POINT (-4214082 -69941431)
2018,Febrero,Portugal,2,8,,10,POINT (0.81488 -77356)
2018,Febrero,Portugal,0,3,,3,POINT (10406342 -75527794)
2018,Febrero,Portugal,12,30,,42,POINT (10446304 -75516486)
2018,Febrero,Portugal,0,3,,3,POINT (10886686 -74776479)
2018,Febrero,Portugal,0,2,,2,POINT (11247723 -74213989)
2018,Febrero,Portugal,3,5,,8,POINT (11360029 -72129595)
2018,Febrero,Portugal,5,0,,5,POINT (125862 -81702165)
2018,Febrero,Portugal,12,33,,45,POINT (3451668 -76532004)
2018,Febrero,Portugal,224,415,,639,POINT (4697157 -74140516)
2018,Febrero,Portugal,1,2,,3,POINT (4815189 -75736374)
2018,Febrero,Portugal,17,54,,71,POINT (6170465 -7542726)
2018,Febrero,Portugal,1,0,,1,POINT (7128047 -73181317)
2018,Febrero,Portugal,8,20,,28,POINT (7819 -72453013)
2018,Febrero,Portugal,0,2,,2,POINT (836068 -72409396)
2018,Febrero,Puerto Rico/Territorio de Estados Unidos,2,0,,2,POINT (4697157 -74140516)
2018,Febrero,Qatar,0,1,,1,POINT (6170465 -7542726)
2018,Febrero,Reino Unido de Gran Bretaña e Irlanda del Norte,0,3,,3,POINT (-4191162 -69941498)
2018,Febrero,Reino Unido de Gran Bretaña e Irlanda del Norte,5,10,,15,POINT (-4214082 -69941431)
2018,Febrero,Reino Unido de Gran Bretaña e Irlanda del Norte,2,1,,3,POINT (0.33002 -76876446)
2018,Febrero,Reino Unido de Gran Bretaña e Irlanda del Norte,41,57,,98,POINT (0.81488 -77356)
2018,Febrero,Reino Unido de Gran Bretaña e Irlanda del Norte,13,23,,36,POINT (10406342 -75527794)
2018,Febrero,Reino Unido de Gran Bretaña e Irlanda del Norte,117,190,,307,POINT (10446304 -75516486)
2018,Febrero,Reino Unido de Gran Bretaña e Irlanda del Norte,8,18,,26,POINT (10886686 -74776479)
2018,Febrero,Reino Unido de Gran Bretaña e Irlanda del Norte,6,4,,10,POINT (11247723 -74213989)
2018,Febrero,Reino Unido de Gran Bretaña e Irlanda del Norte,0,1,,1,POINT (11360029 -72129595)
2018,Febrero,Reino Unido de Gran Bretaña e Irlanda del Norte,0,3,,3,POINT (125744111 -81703935)
2018,Febrero,Reino Unido de Gran Bretaña e Irlanda del Norte,1,2,,3,POINT (125862 -81702165)
2018,Febrero,Reino Unido de Gran Bretaña e Irlanda del Norte,1,1,,2,POINT (133387613 -81372937)
2018,Febrero,Reino Unido de Gran Bretaña e Irlanda del Norte,31,56,,87,POINT (3451668 -76532004)
2018,Febrero,Reino Unido de Gran Bretaña e Irlanda del Norte,1,0,,1,POINT (3884426 -77061029)
2018,Febrero,Reino Unido de Gran Bretaña e Irlanda del Norte,1,1,,2,POINT (445285 -75766353)
2018,Febrero,Reino Unido de Gran Bretaña e Irlanda del Norte,1186,2066,,3252,POINT (4697157 -74140516)
2018,Febrero,Reino Unido de Gran Bretaña e Irlanda del Norte,1,2,,3,POINT (4815189 -75736374)
2018,Febrero,Reino Unido de Gran Bretaña e Irlanda del Norte,112,250,,362,POINT (6170465 -7542726)
2018,Febrero,Reino Unido de Gran Bretaña e Irlanda del Norte,5,3,,8,POINT (6185536 -67484028)
2018,Febrero,Reino Unido de Gran Bretaña e Irlanda del Norte,1,1,,2,POINT (7128047 -73181317)
2018,Febrero,Reino Unido de Gran Bretaña e Irlanda del Norte,2,5,,7,POINT (7819 -72453013)
2018,Febrero,Reino Unido de Gran Bretaña e Irlanda del Norte,24,17,,41,POINT (863337 -7735002)
2018,Febrero,República Dominicana,4,9,,13,POINT (0.81488 -77356)
2018,Febrero,República Dominicana,0,1,,1,POINT (10406342 -75527794)
2018,Febrero,República Dominicana,36,121,,157,POINT (10446304 -75516486)
2018,Febrero,República Dominicana,55,83,,138,POINT (10886686 -74776479)
2018,Febrero,República Dominicana,0,3,,3,POINT (11117206 -74232675)
2018,Febrero,República Dominicana,1,5,,6,POINT (11360029 -72129595)
2018,Febrero,República Dominicana,1,2,,3,POINT (125862 -81702165)
2018,Febrero,República Dominicana,26,37,,63,POINT (3451668 -76532004)
2018,Febrero,República Dominicana,1,2,,3,POINT (445285 -75766353)
2018,Febrero,República Dominicana,548,726,,1274,POINT (4697157 -74140516)
2018,Febrero,República Dominicana,4,6,,10,POINT (4815189 -75736374)
2018,Febrero,República Dominicana,92,97,,189,POINT (6170465 -7542726)
2018,Febrero,República Dominicana,2,1,,3,POINT (7128047 -73181317)
2018,Febrero,República Dominicana,1,7,,8,POINT (7819 -72453013)
2018,Febrero,Rumania,1,0,,1,POINT (-4191162 -69941498)
2018,Febrero,Rumania,1,5,,6,POINT (0.81488 -77356)
2018,Febrero,Rumania,0,5,,5,POINT (10406342 -75527794)
2018,Febrero,Rumania,10,17,,27,POINT (10446304 -75516486)
2018,Febrero,Rumania,0,1,,1,POINT (10886686 -74776479)
2018,Febrero,Rumania,0,1,,1,POINT (10970933 -74765343)
2018,Febrero,Rumania,8,6,,14,POINT (3451668 -76532004)
2018,Febrero,Rumania,74,92,,166,POINT (4697157 -74140516)
2018,Febrero,Rumania,0,1,,1,POINT (4815189 -75736374)
2018,Febrero,Rumania,7,5,,12,POINT (6170465 -7542726)
2018,Febrero,Rumania,0,1,,1,POINT (7819 -72453013)
2018,Febrero,Federación de Rusia,3,1,,4,POINT (-4214082 -69941431)
2018,Febrero,Federación de Rusia,5,7,,12,POINT (0.81488 -77356)
2018,Febrero,Federación de Rusia,1,21,,22,POINT (10406342 -75527794)
2018,Febrero,Federación de Rusia,24,25,,49,POINT (10446304 -75516486)
2018,Febrero,Federación de Rusia,1,1,,2,POINT (10886686 -74776479)
2018,Febrero,Federación de Rusia,0,1,,1,POINT (10970933 -74765343)
2018,Febrero,Federación de Rusia,1,6,,7,POINT (11247723 -74213989)
2018,Febrero,Federación de Rusia,0,1,,1,POINT (125744111 -81703935)
2018,Febrero,Federación de Rusia,7,6,,13,POINT (3451668 -76532004)
2018,Febrero,Federación de Rusia,0,1,,1,POINT (3884426 -77061029)
2018,Febrero,Federación de Rusia,142,196,,338,POINT (4697157 -74140516)
2018,Febrero,Federación de Rusia,20,18,,38,POINT (6170465 -7542726)
2018,Febrero,Federación de Rusia,2,0,,2,POINT (7819 -72453013)
2018,Febrero,Federación de Rusia,2,0,,2,POINT (863337 -7735002)
2018,Febrero,Federación de Rusia,0,2,,2,POINT (9402597 -75681642)
2018,Febrero,Rwanda,0,2,,2,POINT (4697157 -74140516)
2018,Febrero,San Cristóbal y Nevis,3,3,,6,POINT (4697157 -74140516)
2018,Febrero,Samoa Estadounidense/Territorio no incorporado de Estados Unidos,1,0,,1,POINT (4697157 -74140516)
2018,Febrero,San Marino,0,1,,1,POINT (-4191162 -69941498)
2018,Febrero,San Marino,0,1,,1,POINT (4697157 -74140516)
2018,Febrero,San  Vicente y las Granadinas,0,1,,1,POINT (4697157 -74140516)
2018,Febrero,San  Vicente y las Granadinas,0,1,,1,POINT (6170465 -7542726)
2018,Febrero,Santa Lucia,0,2,,2,POINT (10446304 -75516486)
2018,Febrero,Santa Lucia,0,3,,3,POINT (4697157 -74140516)
2018,Febrero,Santa Lucia,0,1,,1,POINT (6170465 -7542726)
2018,Febrero,Senegal,0,1,,1,POINT (10446304 -75516486)
2018,Febrero,Senegal,1,1,,2,POINT (3451668 -76532004)
2018,Febrero,Senegal,1,0,,1,POINT (4697157 -74140516)
2018,Febrero,Serbia,0,1,,1,POINT (10406342 -75527794)
2018,Febrero,Serbia,2,0,,2,POINT (10446304 -75516486)
2018,Febrero,Serbia,12,20,,32,POINT (4697157 -74140516)
2018,Febrero,Serbia,1,4,,5,POINT (6170465 -7542726)
2018,Febrero,Serbia,0,1,,1,POINT (7819 -72453013)
2018,Febrero,Singapur,1,0,,1,POINT (0.81488 -77356)
2018,Febrero,Singapur,3,0,,3,POINT (10446304 -75516486)
2018,Febrero,Singapur,0,1,,1,POINT (10886686 -74776479)
2018,Febrero,Singapur,17,11,,28,POINT (4697157 -74140516)
2018,Febrero,República Árabe Siria,1,6,,7,POINT (4697157 -74140516)
2018,Febrero,República Árabe Siria,0,2,,2,POINT (6170465 -7542726)
2018,Febrero,República Árabe Siria,0,1,,1,POINT (7819 -72453013)
2018,Febrero,Sri Lanka,1,6,,7,POINT (10446304 -75516486)
2018,Febrero,Sri Lanka,3,4,,7,POINT (4697157 -74140516)
2018,Febrero,Sri Lanka,0,1,,1,POINT (6170465 -7542726)
2018,Febrero,Sudáfrica,1,0,,1,POINT (-4191162 -69941498)
2018,Febrero,Sudáfrica,0,2,,2,POINT (0.81488 -77356)
2018,Febrero,Sudáfrica,2,6,,8,POINT (10406342 -75527794)
2018,Febrero,Sudáfrica,3,2,,5,POINT (10446304 -75516486)
2018,Febrero,Sudáfrica,1,2,,3,POINT (10886686 -74776479)
2018,Febrero,Sudáfrica,1,1,,2,POINT (3451668 -76532004)
2018,Febrero,Sudáfrica,9,27,,36,POINT (4697157 -74140516)
2018,Febrero,Sudáfrica,1,3,,4,POINT (6170465 -7542726)
2018,Febrero,Suecia,0,2,,2,POINT (-4191162 -69941498)
2018,Febrero,Suecia,0,3,,3,POINT (-4214082 -69941431)
2018,Febrero,Suecia,1,0,,1,POINT (0.33002 -76876446)
2018,Febrero,Suecia,7,7,,14,POINT (0.81488 -77356)
2018,Febrero,Suecia,15,10,,25,POINT (10406342 -75527794)
2018,Febrero,Suecia,55,69,,124,POINT (10446304 -75516486)
2018,Febrero,Suecia,6,7,,13,POINT (10886686 -74776479)
2018,Febrero,Suecia,1,0,,1,POINT (125862 -81702165)
2018,Febrero,Suecia,9,12,,21,POINT (3451668 -76532004)
2018,Febrero,Suecia,293,375,,668,POINT (4697157 -74140516)
2018,Febrero,Suecia,30,60,,90,POINT (6170465 -7542726)
2018,Febrero,Suecia,2,1,,3,POINT (7819 -72453013)
2018,Febrero,Suecia,2,0,,2,POINT (863337 -7735002)
2018,Febrero,Suiza,2,5,,7,POINT (-4191162 -69941498)
2018,Febrero,Suiza,2,3,,5,POINT (-4214082 -69941431)
2018,Febrero,Suiza,1,3,,4,POINT (0.33002 -76876446)
2018,Febrero,Suiza,44,38,,82,POINT (0.81488 -77356)
2018,Febrero,Suiza,15,24,,39,POINT (10406342 -75527794)
2018,Febrero,Suiza,51,59,,110,POINT (10446304 -75516486)
2018,Febrero,Suiza,8,6,,14,POINT (10886686 -74776479)
2018,Febrero,Suiza,1,1,,2,POINT (11360029 -72129595)
2018,Febrero,Suiza,3,1,,4,POINT (125862 -81702165)
2018,Febrero,Suiza,0,1,,1,POINT (133387613 -81372937)
2018,Febrero,Suiza,19,31,,50,POINT (3451668 -76532004)
2018,Febrero,Suiza,597,830,,1427,POINT (4697157 -74140516)
2018,Febrero,Suiza,1,0,,1,POINT (4815189 -75736374)
2018,Febrero,Suiza,67,118,,185,POINT (6170465 -7542726)
2018,Febrero,Suiza,1,2,,3,POINT (7819 -72453013)
2018,Febrero,Suiza,5,4,,9,POINT (863337 -7735002)
2018,Febrero,Surinam,0,1,,1,POINT (10886686 -74776479)
2018,Febrero,Surinam,8,14,,22,POINT (4697157 -74140516)
2018,Febrero,Surinam,0,1,,1,POINT (6170465 -7542726)
2018,Febrero,Tailandia,0,1,,1,POINT (10406342 -75527794)
2018,Febrero,Tailandia,0,1,,1,POINT (10446304 -75516486)
2018,Febrero,Tailandia,5,7,,12,POINT (4697157 -74140516)
2018,Febrero,Tailandia,1,0,,1,POINT (6170465 -7542726)
2018,Febrero,Tanzania,1,1,,2,POINT (4697157 -74140516)
2018,Febrero,Tonga,0,1,,1,POINT (4697157 -74140516)
2018,Febrero,Trinidad y Tobago,0,1,,1,POINT (0.81488 -77356)
2018,Febrero,Trinidad y Tobago,5,5,,10,POINT (10446304 -75516486)
2018,Febrero,Trinidad y Tobago,2,3,,5,POINT (10886686 -74776479)
2018,Febrero,Trinidad y Tobago,6,7,,13,POINT (3451668 -76532004)
2018,Febrero,Trinidad y Tobago,9,37,,46,POINT (4697157 -74140516)
2018,Febrero,Trinidad y Tobago,1,1,,2,POINT (4815189 -75736374)
2018,Febrero,Trinidad y Tobago,5,10,,15,POINT (6170465 -7542726)
2018,Febrero,Trinidad y Tobago,0,1,,1,POINT (7819 -72453013)
2018,Febrero,Túnez,0,1,,1,POINT (0.33002 -76876446)
2018,Febrero,Túnez,0,1,,1,POINT (10406342 -75527794)
2018,Febrero,Túnez,0,2,,2,POINT (3451668 -76532004)
2018,Febrero,Túnez,0,8,,8,POINT (4697157 -74140516)
2018,Febrero,Turquía,0,1,,1,POINT (-4191162 -69941498)
2018,Febrero,Turquía,4,8,,12,POINT (0.81488 -77356)
2018,Febrero,Turquía,10,15,,25,POINT (10446304 -75516486)
2018,Febrero,Turquía,2,8,,10,POINT (10886686 -74776479)
2018,Febrero,Turquía,0,1,,1,POINT (11360029 -72129595)
2018,Febrero,Turquía,0,12,,12,POINT (3451668 -76532004)
2018,Febrero,Turquía,167,330,,497,POINT (4697157 -74140516)
2018,Febrero,Turquía,7,16,,23,POINT (6170465 -7542726)
2018,Febrero,Turquía,0,2,,2,POINT (7819 -72453013)
2018,Febrero,Turquía,0,1,,1,POINT (863337 -7735002)
2018,Febrero,Ucrania,4,13,,17,POINT (10406342 -75527794)
2018,Febrero,Ucrania,4,14,,18,POINT (10446304 -75516486)
2018,Febrero,Ucrania,0,4,,4,POINT (10886686 -74776479)
2018,Febrero,Ucrania,0,2,,2,POINT (11247723 -74213989)
2018,Febrero,Ucrania,0,1,,1,POINT (3451668 -76532004)
2018,Febrero,Ucrania,0,1,,1,POINT (3884426 -77061029)
2018,Febrero,Ucrania,27,19,,46,POINT (4697157 -74140516)
2018,Febrero,Ucrania,7,0,,7,POINT (6170465 -7542726)
2018,Febrero,Uganda,2,1,,3,POINT (0.81488 -77356)
2018,Febrero,Uganda,1,0,,1,POINT (4697157 -74140516)
2018,Febrero,Uruguay,1,0,,1,POINT (-4214082 -69941431)
2018,Febrero,Uruguay,2,0,,2,POINT (0.33002 -76876446)
2018,Febrero,Uruguay,5,14,,19,POINT (0.81488 -77356)
2018,Febrero,Uruguay,17,15,,32,POINT (10406342 -75527794)
2018,Febrero,Uruguay,76,70,,146,POINT (10446304 -75516486)
2018,Febrero,Uruguay,5,16,,21,POINT (10886686 -74776479)
2018,Febrero,Uruguay,0,1,,1,POINT (11360029 -72129595)
2018,Febrero,Uruguay,19,10,,29,POINT (125862 -81702165)
2018,Febrero,Uruguay,8,33,,41,POINT (3451668 -76532004)
2018,Febrero,Uruguay,425,566,,991,POINT (4697157 -74140516)
2018,Febrero,Uruguay,2,1,,3,POINT (4815189 -75736374)
2018,Febrero,Uruguay,33,42,,75,POINT (6170465 -7542726)
2018,Febrero,Uruguay,2,15,,17,POINT (7819 -72453013)
2018,Febrero,Uruguay,1,2,,3,POINT (836068 -72409396)
2018,Febrero,Uzbekistán,0,1,,1,POINT (6170465 -7542726)
2018,Febrero,Venezuela,2,15,,17,POINT (-4191162 -69941498)
2018,Febrero,Venezuela,1,5,,6,POINT (-4214082 -69941431)
2018,Febrero,Venezuela,24,30,,54,POINT (0.33002 -76876446)
2018,Febrero,Venezuela,0,1,,1,POINT (0.812436 -77847006)
2018,Febrero,Venezuela,1465,1736,,3201,POINT (0.81488 -77356)
2018,Febrero,Venezuela,1,0,,1,POINT (1800143 -78802679)
2018,Febrero,Venezuela,9,8,,17,POINT (10406342 -75527794)
2018,Febrero,Venezuela,156,229,,385,POINT (10446304 -75516486)
2018,Febrero,Venezuela,117,188,,305,POINT (10886686 -74776479)
2018,Febrero,Venezuela,28,62,,90,POINT (11117206 -74232675)
2018,Febrero,Venezuela,10064,12466,,22530,POINT (11360029 -72129595)
2018,Febrero,Venezuela,0,3,,3,POINT (1152863 -72919186)
2018,Febrero,Venezuela,1,4,,5,POINT (12165168 -71983761)
2018,Febrero,Venezuela,84,138,,222,POINT (3451668 -76532004)
2018,Febrero,Venezuela,14,8,,22,POINT (3866713 -67927521)
2018,Febrero,Venezuela,2,2,,4,POINT (445285 -75766353)
2018,Febrero,Venezuela,5009,5257,,10266,POINT (4697157 -74140516)
2018,Febrero,Venezuela,6,5,,11,POINT (4815189 -75736374)
2018,Febrero,Venezuela,742,818,,1560,POINT (6170465 -7542726)
2018,Febrero,Venezuela,41,37,,78,POINT (6185536 -67484028)
2018,Febrero,Venezuela,0,3,,3,POINT (6218835 -75586989)
2018,Febrero,Venezuela,756,1076,,1832,POINT (7088729 -70740253)
2018,Febrero,Venezuela,14,12,,26,POINT (7128047 -73181317)
2018,Febrero,Venezuela,34568,48041,,82609,POINT (7819 -72453013)
2018,Febrero,Venezuela,3,13,,16,POINT (7927233 -72508188)
2018,Febrero,Venezuela,2447,2963,,5410,POINT (836068 -72409396)
2018,Febrero,Vietnam,0,2,,2,POINT (10406342 -75527794)
2018,Febrero,Vietnam,4,1,,5,POINT (4697157 -74140516)
2018,Febrero,Vietnam,0,1,,1,POINT (6170465 -7542726)
2018,Febrero,Islas Vírgenes Británicas/Territorio Británico de Ultramar,1,1,,2,POINT (6170465 -7542726)
2018,Febrero,República Árabe de Yemen,0,1,,1,POINT (0.81488 -77356)
2018,Febrero,República Árabe de Yemen,0,1,,1,POINT (4697157 -74140516)
2018,Febrero,Zimbabue,0,1,,1,POINT (3451668 -76532004)
2018,Febrero,Zimbabue,1,1,,2,POINT (4697157 -74140516)
2018,Febrero,Refugiado Otro,0,5,,5,POINT (4697157 -74140516)
2018,Febrero,Refugiado,0,1,,1,POINT (10446304 -75516486)
2018,Febrero,Refugiado,3,4,,7,POINT (4697157 -74140516)
2018,Febrero,Refugiado,0,1,,1,POINT (6170465 -7542726)
2018,Febrero,Desconocido,0,2,,2,POINT (3451668 -76532004)
2018,Febrero,Desconocido,60,132,,192,POINT (4697157 -74140516)
2018,Febrero,Desconocido,1,6,,7,POINT (6170465 -7542726)
2018,Febrero,Desconocido,1,2,,3,POINT (7819 -72453013)
2018,Marzo,Afganistán,1,1,,2,POINT (10446304 -75516486)
2018,Marzo,Afganistán,0,2,,2,POINT (4697157 -74140516)
2018,Marzo,Afganistán,0,1,,1,POINT (6170465 -7542726)
2018,Marzo,Albania,1,0,,1,POINT (10446304 -75516486)
2018,Marzo,Albania,4,4,,8,POINT (4697157 -74140516)
2018,Marzo,Alemania,9,10,,19,POINT (-4191162 -69941498)
2018,Marzo,Alemania,11,29,,40,POINT (-4214082 -69941431)
2018,Marzo,Alemania,16,10,,26,POINT (0.33002 -76876446)
2018,Marzo,Alemania,98,102,,200,POINT (0.81488 -77356)
2018,Marzo,Alemania,57,52,,109,POINT (10406342 -75527794)
2018,Marzo,Alemania,244,276,,520,POINT (10446304 -75516486)
2018,Marzo,Alemania,41,41,,82,POINT (10886686 -74776479)
2018,Marzo,Alemania,1,3,,4,POINT (11247723 -74213989)
2018,Marzo,Alemania,4,4,,8,POINT (11360029 -72129595)
2018,Marzo,Alemania,3,4,,7,POINT (125862 -81702165)
2018,Marzo,Alemania,3,8,,11,POINT (133387613 -81372937)
2018,Marzo,Alemania,72,83,,155,POINT (3451668 -76532004)
2018,Marzo,Alemania,1,1,,2,POINT (445285 -75766353)
2018,Marzo,Alemania,2546,3558,,6104,POINT (4697157 -74140516)
2018,Marzo,Alemania,5,11,,16,POINT (4815189 -75736374)
2018,Marzo,Alemania,193,287,,480,POINT (6170465 -7542726)
2018,Marzo,Alemania,1,2,,3,POINT (7128047 -73181317)
2018,Marzo,Alemania,3,5,,8,POINT (7819 -72453013)
2018,Marzo,Alemania,2,2,,4,POINT (836068 -72409396)
2018,Marzo,Alemania,21,16,,37,POINT (863337 -7735002)
2018,Marzo,Andorra,2,7,,9,POINT (4697157 -74140516)
2018,Marzo,Andorra,0,1,,1,POINT (6170465 -7542726)
2018,Marzo,Angola,2,0,,2,POINT (10446304 -75516486)
2018,Marzo,Angola,0,1,,1,POINT (4697157 -74140516)
2018,Marzo,Angola,1,0,,1,POINT (6170465 -7542726)
2018,Marzo,Antigua y Barbuda,0,1,,1,POINT (10446304 -75516486)
2018,Marzo,Antigua y Barbuda,3,9,,12,POINT (4697157 -74140516)
2018,Marzo,Antigua y Barbuda,1,0,,1,POINT (6170465 -7542726)
2018,Marzo,Países Bajos,0,1,,1,POINT (4697157 -74140516)
2018,Marzo,Arabia Saudita,1,0,,1,POINT (0.81488 -77356)
2018,Marzo,Arabia Saudita,0,10,,10,POINT (4697157 -74140516)
2018,Marzo,Argelia,0,1,,1,POINT (125862 -81702165)
2018,Marzo,Argelia,1,4,,5,POINT (4697157 -74140516)
2018,Marzo,Argelia,1,1,,2,POINT (6170465 -7542726)
2018,Marzo,Argentina,5,10,,15,POINT (-4191162 -69941498)
2018,Marzo,Argentina,2,7,,9,POINT (-4214082 -69941431)
2018,Marzo,Argentina,8,8,,16,POINT (0.33002 -76876446)
2018,Marzo,Argentina,1,0,,1,POINT (0.812436 -77847006)
2018,Marzo,Argentina,97,158,,255,POINT (0.81488 -77356)
2018,Marzo,Argentina,387,280,,667,POINT (10406342 -75527794)
2018,Marzo,Argentina,2745,2003,,4748,POINT (10446304 -75516486)
2018,Marzo,Argentina,24,44,,68,POINT (10886686 -74776479)
2018,Marzo,Argentina,1,1,,2,POINT (11117206 -74232675)
2018,Marzo,Argentina,5,13,,18,POINT (11360029 -72129595)
2018,Marzo,Argentina,578,418,,996,POINT (125862 -81702165)
2018,Marzo,Argentina,54,80,,134,POINT (3451668 -76532004)
2018,Marzo,Argentina,2,2,,4,POINT (445285 -75766353)
2018,Marzo,Argentina,9272,9467,,18739,POINT (4697157 -74140516)
2018,Marzo,Argentina,6,5,,11,POINT (4815189 -75736374)
2018,Marzo,Argentina,266,368,,634,POINT (6170465 -7542726)
2018,Marzo,Argentina,1,1,,2,POINT (7088729 -70740253)
2018,Marzo,Argentina,0,1,,1,POINT (7102626 -77762647)
2018,Marzo,Argentina,0,1,,1,POINT (7128047 -73181317)
2018,Marzo,Argentina,6,23,,29,POINT (7819 -72453013)
2018,Marzo,Argentina,2,1,,3,POINT (836068 -72409396)
2018,Marzo,Argentina,8,1,,9,POINT (863337 -7735002)
2018,Marzo,República de Armenia,1,0,,1,POINT (4697157 -74140516)
2018,Marzo,República de Armenia,0,1,,1,POINT (6170465 -7542726)
2018,Marzo,Australia,4,2,,6,POINT (-4191162 -69941498)
2018,Marzo,Australia,3,4,,7,POINT (-4214082 -69941431)
2018,Marzo,Australia,1,1,,2,POINT (0.33002 -76876446)
2018,Marzo,Australia,1,0,,1,POINT (0.812436 -77847006)
2018,Marzo,Australia,23,27,,50,POINT (0.81488 -77356)
2018,Marzo,Australia,16,22,,38,POINT (10406342 -75527794)
2018,Marzo,Australia,46,59,,105,POINT (10446304 -75516486)
2018,Marzo,Australia,9,18,,27,POINT (10886686 -74776479)
2018,Marzo,Australia,1,1,,2,POINT (11247723 -74213989)
2018,Marzo,Australia,0,1,,1,POINT (11360029 -72129595)
2018,Marzo,Australia,0,2,,2,POINT (125744111 -81703935)
2018,Marzo,Australia,5,8,,13,POINT (3451668 -76532004)
2018,Marzo,Australia,306,558,,864,POINT (4697157 -74140516)
2018,Marzo,Australia,1,2,,3,POINT (4815189 -75736374)
2018,Marzo,Australia,32,98,,130,POINT (6170465 -7542726)
2018,Marzo,Australia,0,1,,1,POINT (7128047 -73181317)
2018,Marzo,Australia,0,3,,3,POINT (7819 -72453013)
2018,Marzo,Australia,3,11,,14,POINT (863337 -7735002)
2018,Marzo,Austria,0,1,,1,POINT (-4191162 -69941498)
2018,Marzo,Austria,1,1,,2,POINT (-4214082 -69941431)
2018,Marzo,Austria,3,2,,5,POINT (0.33002 -76876446)
2018,Marzo,Austria,5,8,,13,POINT (0.81488 -77356)
2018,Marzo,Austria,5,10,,15,POINT (10406342 -75527794)
2018,Marzo,Austria,22,22,,44,POINT (10446304 -75516486)
2018,Marzo,Austria,0,6,,6,POINT (10886686 -74776479)
2018,Marzo,Austria,0,1,,1,POINT (133387613 -81372937)
2018,Marzo,Austria,6,15,,21,POINT (3451668 -76532004)
2018,Marzo,Austria,196,354,,550,POINT (4697157 -74140516)
2018,Marzo,Austria,27,37,,64,POINT (6170465 -7542726)
2018,Marzo,Austria,0,1,,1,POINT (7128047 -73181317)
2018,Marzo,Austria,1,0,,1,POINT (7819 -72453013)
2018,Marzo,Austria,0,1,,1,POINT (863337 -7735002)
2018,Marzo,Azerbaiyán,4,4,,8,POINT (4697157 -74140516)
2018,Marzo,Azerbaiyán,1,2,,3,POINT (6170465 -7542726)
2018,Marzo,Bahamas,3,7,,10,POINT (10446304 -75516486)
2018,Marzo,Bahamas,0,1,,1,POINT (10886686 -74776479)
2018,Marzo,Bahamas,0,3,,3,POINT (3451668 -76532004)
2018,Marzo,Bahamas,5,10,,15,POINT (4697157 -74140516)
2018,Marzo,Bahamas,1,3,,4,POINT (6170465 -7542726)
2018,Marzo,Bahréin,1,1,,2,POINT (10446304 -75516486)
2018,Marzo,Bahréin,0,3,,3,POINT (4697157 -74140516)
2018,Marzo,Bangladesh,0,1,,1,POINT (10446304 -75516486)
2018,Marzo,Bangladesh,4,2,,6,POINT (4697157 -74140516)
2018,Marzo,Bangladesh,0,1,,1,POINT (6170465 -7542726)
2018,Marzo,Bangladesh,0,1,,1,POINT (9402597 -75681642)
2018,Marzo,Barbados,1,1,,2,POINT (3451668 -76532004)
2018,Marzo,Barbados,5,6,,11,POINT (4697157 -74140516)
2018,Marzo,Barbados,0,1,,1,POINT (4815189 -75736374)
2018,Marzo,Barbados,0,1,,1,POINT (6170465 -7542726)
2018,Marzo,República de Belarús,0,1,,1,POINT (10886686 -74776479)
2018,Marzo,República de Belarús,2,3,,5,POINT (4697157 -74140516)
2018,Marzo,República de Belarús,1,3,,4,POINT (6170465 -7542726)
2018,Marzo,Bélgica,1,1,,2,POINT (-4191162 -69941498)
2018,Marzo,Bélgica,2,2,,4,POINT (-4214082 -69941431)
2018,Marzo,Bélgica,1,1,,2,POINT (0.33002 -76876446)
2018,Marzo,Bélgica,11,12,,23,POINT (0.81488 -77356)
2018,Marzo,Bélgica,2,5,,7,POINT (10406342 -75527794)
2018,Marzo,Bélgica,41,56,,97,POINT (10446304 -75516486)
2018,Marzo,Bélgica,2,5,,7,POINT (10886686 -74776479)
2018,Marzo,Bélgica,0,1,,1,POINT (11360029 -72129595)
2018,Marzo,Bélgica,14,15,,29,POINT (3451668 -76532004)
2018,Marzo,Bélgica,307,486,,793,POINT (4697157 -74140516)
2018,Marzo,Bélgica,1,2,,3,POINT (4815189 -75736374)
2018,Marzo,Bélgica,26,58,,84,POINT (6170465 -7542726)
2018,Marzo,Bélgica,0,1,,1,POINT (7819 -72453013)
2018,Marzo,Belice,3,1,,4,POINT (0.81488 -77356)
2018,Marzo,Belice,0,4,,4,POINT (10446304 -75516486)
2018,Marzo,Belice,1,0,,1,POINT (3451668 -76532004)
2018,Marzo,Belice,8,14,,22,POINT (4697157 -74140516)
2018,Marzo,Belice,4,7,,11,POINT (6170465 -7542726)
2018,Marzo,Benín,2,3,,5,POINT (4697157 -74140516)
2018,Marzo,Bermudas/Territorio Británico de Ultramar,2,1,,3,POINT (10446304 -75516486)
2018,Marzo,Bermudas/Territorio Británico de Ultramar,0,4,,4,POINT (10886686 -74776479)
2018,Marzo,Bermudas/Territorio Británico de Ultramar,0,1,,1,POINT (3451668 -76532004)
2018,Marzo,Bermudas/Territorio Británico de Ultramar,1,2,,3,POINT (6170465 -7542726)
2018,Marzo,Bolivia,13,8,,21,POINT (0.81488 -77356)
2018,Marzo,Bolivia,1,0,,1,POINT (1800143 -78802679)
2018,Marzo,Bolivia,4,2,,6,POINT (10406342 -75527794)
2018,Marzo,Bolivia,132,103,,235,POINT (10446304 -75516486)
2018,Marzo,Bolivia,3,9,,12,POINT (10886686 -74776479)
2018,Marzo,Bolivia,1,1,,2,POINT (11360029 -72129595)
2018,Marzo,Bolivia,10,7,,17,POINT (125862 -81702165)
2018,Marzo,Bolivia,10,11,,21,POINT (3451668 -76532004)
2018,Marzo,Bolivia,0,1,,1,POINT (445285 -75766353)
2018,Marzo,Bolivia,490,592,,1082,POINT (4697157 -74140516)
2018,Marzo,Bolivia,3,4,,7,POINT (4815189 -75736374)
2018,Marzo,Bolivia,42,37,,79,POINT (6170465 -7542726)
2018,Marzo,Bolivia,2,10,,12,POINT (7819 -72453013)
2018,Marzo,Bosnia y Herzegovina,1,0,,1,POINT (10406342 -75527794)
2018,Marzo,Bosnia y Herzegovina,0,1,,1,POINT (10446304 -75516486)
2018,Marzo,Bosnia y Herzegovina,2,5,,7,POINT (4697157 -74140516)
2018,Marzo,Bosnia y Herzegovina,2,0,,2,POINT (6170465 -7542726)
2018,Marzo,Botsuana,1,0,,1,POINT (6170465 -7542726)
2018,Marzo,Brasil,59,69,,128,POINT (-4191162 -69941498)
2018,Marzo,Brasil,6,7,,13,POINT (-4214082 -69941431)
2018,Marzo,Brasil,19,29,,48,POINT (0.81488 -77356)
2018,Marzo,Brasil,875,558,,1433,POINT (10406342 -75527794)
2018,Marzo,Brasil,1200,845,,2045,POINT (10446304 -75516486)
2018,Marzo,Brasil,16,27,,43,POINT (10886686 -74776479)
2018,Marzo,Brasil,2,3,,5,POINT (11360029 -72129595)
2018,Marzo,Brasil,447,321,,768,POINT (125862 -81702165)
2018,Marzo,Brasil,36,85,,121,POINT (3451668 -76532004)
2018,Marzo,Brasil,0,4,,4,POINT (3866713 -67927521)
2018,Marzo,Brasil,6415,6817,,13232,POINT (4697157 -74140516)
2018,Marzo,Brasil,3,8,,11,POINT (4815189 -75736374)
2018,Marzo,Brasil,112,193,,305,POINT (6170465 -7542726)
2018,Marzo,Brasil,0,3,,3,POINT (7128047 -73181317)
2018,Marzo,Brasil,6,10,,16,POINT (7819 -72453013)
2018,Marzo,Brasil,0,2,,2,POINT (863337 -7735002)
2018,Marzo,Brasil,0,1,,1,POINT (9402597 -75681642)
2018,Marzo,Bulgaria,1,1,,2,POINT (0.81488 -77356)
2018,Marzo,Bulgaria,0,1,,1,POINT (10406342 -75527794)
2018,Marzo,Bulgaria,4,1,,5,POINT (10446304 -75516486)
2018,Marzo,Bulgaria,0,1,,1,POINT (10970933 -74765343)
2018,Marzo,Bulgaria,0,3,,3,POINT (125862 -81702165)
2018,Marzo,Bulgaria,3,1,,4,POINT (3451668 -76532004)
2018,Marzo,Bulgaria,32,47,,79,POINT (4697157 -74140516)
2018,Marzo,Bulgaria,0,1,,1,POINT (4815189 -75736374)
2018,Marzo,Bulgaria,5,10,,15,POINT (6170465 -7542726)
2018,Marzo,Burkina Faso,1,2,,3,POINT (4697157 -74140516)
2018,Marzo,Burkina Faso,1,0,,1,POINT (6170465 -7542726)
2018,Marzo,Burundi,1,0,,1,POINT (4697157 -74140516)
2018,Marzo,Bután,0,1,,1,POINT (4697157 -74140516)
2018,Marzo,Bután,0,1,,1,POINT (6170465 -7542726)
2018,Marzo,Cabo Verde,0,1,,1,POINT (3451668 -76532004)
2018,Marzo,Islas Caimán/Territorio Británico de Ultramar,1,1,,2,POINT (125862 -81702165)
2018,Marzo,Islas Caimán/Territorio Británico de Ultramar,1,2,,3,POINT (3451668 -76532004)
2018,Marzo,Camboya,2,0,,2,POINT (4697157 -74140516)
2018,Marzo,Camerún,3,6,,9,POINT (4697157 -74140516)
2018,Marzo,Camerún,1,0,,1,POINT (6170465 -7542726)
2018,Marzo,Canadá,0,3,,3,POINT (-4191162 -69941498)
2018,Marzo,Canadá,1,0,,1,POINT (-4214082 -69941431)
2018,Marzo,Canadá,2,0,,2,POINT (0.33002 -76876446)
2018,Marzo,Canadá,23,35,,58,POINT (0.81488 -77356)
2018,Marzo,Canadá,27,23,,50,POINT (10406342 -75527794)
2018,Marzo,Canadá,971,1017,,1988,POINT (10446304 -75516486)
2018,Marzo,Canadá,40,59,,99,POINT (10886686 -74776479)
2018,Marzo,Canadá,3,3,,6,POINT (11360029 -72129595)
2018,Marzo,Canadá,0,2,,2,POINT (125744111 -81703935)
2018,Marzo,Canadá,307,290,,597,POINT (125862 -81702165)
2018,Marzo,Canadá,1,4,,5,POINT (133387613 -81372937)
2018,Marzo,Canadá,89,77,,166,POINT (3451668 -76532004)
2018,Marzo,Canadá,2,7,,9,POINT (445285 -75766353)
2018,Marzo,Canadá,1518,2228,,3746,POINT (4697157 -74140516)
2018,Marzo,Canadá,5,18,,23,POINT (4815189 -75736374)
2018,Marzo,Canadá,225,475,,700,POINT (6170465 -7542726)
2018,Marzo,Canadá,1,0,,1,POINT (7088729 -70740253)
2018,Marzo,Canadá,7,12,,19,POINT (7128047 -73181317)
2018,Marzo,Canadá,0,2,,2,POINT (7819 -72453013)
2018,Marzo,Canadá,20,8,,28,POINT (863337 -7735002)
2018,Marzo,Chad,0,2,,2,POINT (4697157 -74140516)
2018,Marzo,Chad,0,1,,1,POINT (6170465 -7542726)
2018,Marzo,Comoras,0,1,,1,POINT (6170465 -7542726)
2018,Marzo,República Democrática del Congo,2,3,,5,POINT (4697157 -74140516)
2018,Marzo,República Democrática del Congo,0,1,,1,POINT (6170465 -7542726)
2018,Marzo,República Democrática del Congo,0,1,,1,POINT (7819 -72453013)
2018,Marzo,República de Corea,2,2,,4,POINT (-4191162 -69941498)
2018,Marzo,República de Corea,0,1,,1,POINT (0.185957 -7478366)
2018,Marzo,República de Corea,10,10,,20,POINT (0.81488 -77356)
2018,Marzo,República de Corea,1,0,,1,POINT (10406342 -75527794)
2018,Marzo,República de Corea,16,22,,38,POINT (10446304 -75516486)
2018,Marzo,República de Corea,0,2,,2,POINT (10886686 -74776479)
2018,Marzo,República de Corea,0,4,,4,POINT (11247723 -74213989)
2018,Marzo,República de Corea,4,4,,8,POINT (3451668 -76532004)
2018,Marzo,República de Corea,245,434,,679,POINT (4697157 -74140516)
2018,Marzo,República de Corea,0,2,,2,POINT (4815189 -75736374)
2018,Marzo,República de Corea,22,43,,65,POINT (6170465 -7542726)
2018,Marzo,República de Corea,0,2,,2,POINT (7819 -72453013)
2018,Marzo,Costa de Marfil,0,2,,2,POINT (10446304 -75516486)
2018,Marzo,Costa de Marfil,3,1,,4,POINT (4697157 -74140516)
2018,Marzo,Costa de Marfil,0,1,,1,POINT (6170465 -7542726)
2018,Marzo,Costa Rica,0,1,,1,POINT (-4191162 -69941498)
2018,Marzo,Costa Rica,5,4,,9,POINT (0.81488 -77356)
2018,Marzo,Costa Rica,3,4,,7,POINT (10406342 -75527794)
2018,Marzo,Costa Rica,175,138,,313,POINT (10446304 -75516486)
2018,Marzo,Costa Rica,31,36,,67,POINT (10886686 -74776479)
2018,Marzo,Costa Rica,2,0,,2,POINT (11360029 -72129595)
2018,Marzo,Costa Rica,92,81,,173,POINT (125862 -81702165)
2018,Marzo,Costa Rica,47,68,,115,POINT (3451668 -76532004)
2018,Marzo,Costa Rica,1280,1483,,2763,POINT (4697157 -74140516)
2018,Marzo,Costa Rica,7,12,,19,POINT (4815189 -75736374)
2018,Marzo,Costa Rica,193,300,,493,POINT (6170465 -7542726)
2018,Marzo,Costa Rica,2,3,,5,POINT (7128047 -73181317)
2018,Marzo,Croacia,3,0,,3,POINT (0.81488 -77356)
2018,Marzo,Croacia,0,5,,5,POINT (10406342 -75527794)
2018,Marzo,Croacia,2,5,,7,POINT (10446304 -75516486)
2018,Marzo,Croacia,0,1,,1,POINT (10886686 -74776479)
2018,Marzo,Croacia,0,1,,1,POINT (3451668 -76532004)
2018,Marzo,Croacia,33,59,,92,POINT (4697157 -74140516)
2018,Marzo,Croacia,1,2,,3,POINT (6170465 -7542726)
2018,Marzo,Croacia,0,2,,2,POINT (9402597 -75681642)
2018,Marzo,Cuba,0,2,,2,POINT (0.81488 -77356)
2018,Marzo,Cuba,0,8,,8,POINT (10406342 -75527794)
2018,Marzo,Cuba,10,31,,41,POINT (10446304 -75516486)
2018,Marzo,Cuba,20,25,,45,POINT (10886686 -74776479)
2018,Marzo,Cuba,18,30,,48,POINT (3451668 -76532004)
2018,Marzo,Cuba,618,569,,1187,POINT (4697157 -74140516)
2018,Marzo,Cuba,2,2,,4,POINT (4815189 -75736374)
2018,Marzo,Cuba,19,22,,41,POINT (6170465 -7542726)
2018,Marzo,Cuba,1,1,,2,POINT (7128047 -73181317)
2018,Marzo,Cuba,0,8,,8,POINT (7819 -72453013)
2018,Marzo,República Checa,0,1,,1,POINT (-4191162 -69941498)
2018,Marzo,República Checa,0,1,,1,POINT (-4214082 -69941431)
2018,Marzo,República Checa,1,1,,2,POINT (0.33002 -76876446)
2018,Marzo,República Checa,2,2,,4,POINT (0.812436 -77847006)
2018,Marzo,República Checa,14,9,,23,POINT (0.81488 -77356)
2018,Marzo,República Checa,2,0,,2,POINT (10406342 -75527794)
2018,Marzo,República Checa,8,14,,22,POINT (10446304 -75516486)
2018,Marzo,República Checa,0,1,,1,POINT (10886686 -74776479)
2018,Marzo,República Checa,6,2,,8,POINT (3451668 -76532004)
2018,Marzo,República Checa,73,113,,186,POINT (4697157 -74140516)
2018,Marzo,República Checa,2,10,,12,POINT (6170465 -7542726)
2018,Marzo,República Checa,0,1,,1,POINT (7819 -72453013)
2018,Marzo,Chile,3,2,,5,POINT (-4191162 -69941498)
2018,Marzo,Chile,1,4,,5,POINT (-4214082 -69941431)
2018,Marzo,Chile,1,4,,5,POINT (0.33002 -76876446)
2018,Marzo,Chile,62,84,,146,POINT (0.81488 -77356)
2018,Marzo,Chile,1,1,,2,POINT (1800143 -78802679)
2018,Marzo,Chile,166,119,,285,POINT (10406342 -75527794)
2018,Marzo,Chile,504,409,,913,POINT (10446304 -75516486)
2018,Marzo,Chile,27,30,,57,POINT (10886686 -74776479)
2018,Marzo,Chile,3,7,,10,POINT (11360029 -72129595)
2018,Marzo,Chile,0,3,,3,POINT (125744111 -81703935)
2018,Marzo,Chile,50,43,,93,POINT (125862 -81702165)
2018,Marzo,Chile,29,57,,86,POINT (3451668 -76532004)
2018,Marzo,Chile,4069,5090,,9159,POINT (4697157 -74140516)
2018,Marzo,Chile,1,4,,5,POINT (4815189 -75736374)
2018,Marzo,Chile,79,176,,255,POINT (6170465 -7542726)
2018,Marzo,Chile,0,2,,2,POINT (7128047 -73181317)
2018,Marzo,Chile,7,25,,32,POINT (7819 -72453013)
2018,Marzo,Chile,2,6,,8,POINT (836068 -72409396)
2018,Marzo,China,1,0,,1,POINT (-4191162 -69941498)
2018,Marzo,China,1,0,,1,POINT (-4214082 -69941431)
2018,Marzo,China,15,15,,30,POINT (0.81488 -77356)
2018,Marzo,China,4,3,,7,POINT (10406342 -75527794)
2018,Marzo,China,41,56,,97,POINT (10446304 -75516486)
2018,Marzo,China,7,21,,28,POINT (10886686 -74776479)
2018,Marzo,China,0,3,,3,POINT (10970933 -74765343)
2018,Marzo,China,0,5,,5,POINT (11247723 -74213989)
2018,Marzo,China,2,3,,5,POINT (125862 -81702165)
2018,Marzo,China,10,17,,27,POINT (3451668 -76532004)
2018,Marzo,China,0,4,,4,POINT (3884426 -77061029)
2018,Marzo,China,1,0,,1,POINT (445285 -75766353)
2018,Marzo,China,442,965,,1407,POINT (4697157 -74140516)
2018,Marzo,China,1,0,,1,POINT (4815189 -75736374)
2018,Marzo,China,38,87,,125,POINT (6170465 -7542726)
2018,Marzo,China,4,7,,11,POINT (7819 -72453013)
2018,Marzo,China,0,2,,2,POINT (836068 -72409396)
2018,Marzo,Taiwán,1,0,,1,POINT (-4191162 -69941498)
2018,Marzo,Taiwán,0,2,,2,POINT (0.81488 -77356)
2018,Marzo,Taiwán,0,1,,1,POINT (10406342 -75527794)
2018,Marzo,Taiwán,7,8,,15,POINT (10446304 -75516486)
2018,Marzo,Taiwán,0,2,,2,POINT (10886686 -74776479)
2018,Marzo,Taiwán,4,3,,7,POINT (3451668 -76532004)
2018,Marzo,Taiwán,128,129,,257,POINT (4697157 -74140516)
2018,Marzo,Taiwán,9,15,,24,POINT (6170465 -7542726)
2018,Marzo,Taiwán,2,1,,3,POINT (7819 -72453013)
2018,Marzo,Chipre,1,0,,1,POINT (10446304 -75516486)
2018,Marzo,Chipre,8,11,,19,POINT (4697157 -74140516)
2018,Marzo,Chipre,1,1,,2,POINT (6170465 -7542726)
2018,Marzo,Dinamarca,1,0,,1,POINT (-4214082 -69941431)
2018,Marzo,Dinamarca,6,8,,14,POINT (0.81488 -77356)
2018,Marzo,Dinamarca,4,5,,9,POINT (10406342 -75527794)
2018,Marzo,Dinamarca,27,52,,79,POINT (10446304 -75516486)
2018,Marzo,Dinamarca,2,4,,6,POINT (10886686 -74776479)
2018,Marzo,Dinamarca,0,1,,1,POINT (10970933 -74765343)
2018,Marzo,Dinamarca,8,9,,17,POINT (11247723 -74213989)
2018,Marzo,Dinamarca,0,1,,1,POINT (11360029 -72129595)
2018,Marzo,Dinamarca,1,4,,5,POINT (125862 -81702165)
2018,Marzo,Dinamarca,3,10,,13,POINT (3451668 -76532004)
2018,Marzo,Dinamarca,181,299,,480,POINT (4697157 -74140516)
2018,Marzo,Dinamarca,8,20,,28,POINT (6170465 -7542726)
2018,Marzo,Dinamarca,1,0,,1,POINT (7819 -72453013)
2018,Marzo,Dinamarca,4,0,,4,POINT (863337 -7735002)
2018,Marzo,Dominica,1,1,,2,POINT (10446304 -75516486)
2018,Marzo,Dominica,0,1,,1,POINT (3451668 -76532004)
2018,Marzo,Dominica,6,4,,10,POINT (4697157 -74140516)
2018,Marzo,Dominica,0,3,,3,POINT (6170465 -7542726)
2018,Marzo,Ecuador,1,0,,1,POINT (-4191162 -69941498)
2018,Marzo,Ecuador,1,2,,3,POINT (-4214082 -69941431)
2018,Marzo,Ecuador,1,0,,1,POINT (0.185957 -7478366)
2018,Marzo,Ecuador,76,282,,358,POINT (0.33002 -76876446)
2018,Marzo,Ecuador,6,15,,21,POINT (0.812436 -77847006)
2018,Marzo,Ecuador,2368,2839,,5207,POINT (0.81488 -77356)
2018,Marzo,Ecuador,32,37,,69,POINT (1800143 -78802679)
2018,Marzo,Ecuador,11,14,,25,POINT (10406342 -75527794)
2018,Marzo,Ecuador,49,51,,100,POINT (10446304 -75516486)
2018,Marzo,Ecuador,5,10,,15,POINT (10886686 -74776479)
2018,Marzo,Ecuador,5,15,,20,POINT (11360029 -72129595)
2018,Marzo,Ecuador,22,16,,38,POINT (125862 -81702165)
2018,Marzo,Ecuador,682,642,,1324,POINT (3451668 -76532004)
2018,Marzo,Ecuador,0,1,,1,POINT (445285 -75766353)
2018,Marzo,Ecuador,3322,4072,,7394,POINT (4697157 -74140516)
2018,Marzo,Ecuador,1,4,,5,POINT (4815189 -75736374)
2018,Marzo,Ecuador,73,190,,263,POINT (6170465 -7542726)
2018,Marzo,Ecuador,0,2,,2,POINT (7088729 -70740253)
2018,Marzo,Ecuador,0,2,,2,POINT (7128047 -73181317)
2018,Marzo,Ecuador,110,173,,283,POINT (7819 -72453013)
2018,Marzo,Ecuador,7,17,,24,POINT (836068 -72409396)
2018,Marzo,Egipto,0,3,,3,POINT (10446304 -75516486)
2018,Marzo,Egipto,0,4,,4,POINT (3451668 -76532004)
2018,Marzo,Egipto,8,20,,28,POINT (4697157 -74140516)
2018,Marzo,Egipto,0,1,,1,POINT (6170465 -7542726)
2018,Marzo,El Salvador,0,1,,1,POINT (0.81488 -77356)
2018,Marzo,El Salvador,0,2,,2,POINT (10406342 -75527794)
2018,Marzo,El Salvador,53,60,,113,POINT (10446304 -75516486)
2018,Marzo,El Salvador,10,23,,33,POINT (10886686 -74776479)
2018,Marzo,El Salvador,2,2,,4,POINT (125862 -81702165)
2018,Marzo,El Salvador,115,121,,236,POINT (3451668 -76532004)
2018,Marzo,El Salvador,1,0,,1,POINT (445285 -75766353)
2018,Marzo,El Salvador,877,954,,1831,POINT (4697157 -74140516)
2018,Marzo,El Salvador,2,1,,3,POINT (4815189 -75736374)
2018,Marzo,El Salvador,175,207,,382,POINT (6170465 -7542726)
2018,Marzo,El Salvador,1,4,,5,POINT (7128047 -73181317)
2018,Marzo,El Salvador,0,3,,3,POINT (7819 -72453013)
2018,Marzo,Emiratos Árabes,0,1,,1,POINT (-4214082 -69941431)
2018,Marzo,Emiratos Árabes,1,0,,1,POINT (10446304 -75516486)
2018,Marzo,Emiratos Árabes,1,15,,16,POINT (4697157 -74140516)
2018,Marzo,Emiratos Árabes,0,1,,1,POINT (6170465 -7542726)
2018,Marzo,Emiratos Árabes,0,3,,3,POINT (7128047 -73181317)
2018,Marzo,España,4,3,,7,POINT (-4191162 -69941498)
2018,Marzo,España,5,4,,9,POINT (-4214082 -69941431)
2018,Marzo,España,1,3,,4,POINT (0.33002 -76876446)
2018,Marzo,España,0,1,,1,POINT (0.812436 -77847006)
2018,Marzo,España,32,60,,92,POINT (0.81488 -77356)
2018,Marzo,España,10,23,,33,POINT (10406342 -75527794)
2018,Marzo,España,176,234,,410,POINT (10446304 -75516486)
2018,Marzo,España,21,60,,81,POINT (10886686 -74776479)
2018,Marzo,España,5,6,,11,POINT (11247723 -74213989)
2018,Marzo,España,4,4,,8,POINT (11360029 -72129595)
2018,Marzo,España,2,4,,6,POINT (125744111 -81703935)
2018,Marzo,España,5,4,,9,POINT (125862 -81702165)
2018,Marzo,España,1,1,,2,POINT (133387613 -81372937)
2018,Marzo,España,400,506,,906,POINT (3451668 -76532004)
2018,Marzo,España,0,1,,1,POINT (3884426 -77061029)
2018,Marzo,España,0,2,,2,POINT (445285 -75766353)
2018,Marzo,España,3532,5992,,9524,POINT (4697157 -74140516)
2018,Marzo,España,3,7,,10,POINT (4815189 -75736374)
2018,Marzo,España,466,814,,1280,POINT (6170465 -7542726)
2018,Marzo,España,1,1,,2,POINT (7088729 -70740253)
2018,Marzo,España,2,5,,7,POINT (7128047 -73181317)
2018,Marzo,España,20,40,,60,POINT (7819 -72453013)
2018,Marzo,España,0,1,,1,POINT (7927233 -72508188)
2018,Marzo,España,4,3,,7,POINT (836068 -72409396)
2018,Marzo,España,1,2,,3,POINT (863337 -7735002)
2018,Marzo,Eritrea,1,1,,2,POINT (4697157 -74140516)
2018,Marzo,Eslovaquia,1,0,,1,POINT (0.812436 -77847006)
2018,Marzo,Eslovaquia,1,1,,2,POINT (0.81488 -77356)
2018,Marzo,Eslovaquia,3,8,,11,POINT (10446304 -75516486)
2018,Marzo,Eslovaquia,1,1,,2,POINT (10886686 -74776479)
2018,Marzo,Eslovaquia,3,1,,4,POINT (11247723 -74213989)
2018,Marzo,Eslovaquia,32,57,,89,POINT (4697157 -74140516)
2018,Marzo,Eslovaquia,4,6,,10,POINT (6170465 -7542726)
2018,Marzo,Eslovaquia,1,0,,1,POINT (7128047 -73181317)
2018,Marzo,Eslovaquia,0,2,,2,POINT (7819 -72453013)
2018,Marzo,Eslovenia,0,3,,3,POINT (10446304 -75516486)
2018,Marzo,Eslovenia,0,1,,1,POINT (10886686 -74776479)
2018,Marzo,Eslovenia,1,0,,1,POINT (11360029 -72129595)
2018,Marzo,Eslovenia,50,73,,123,POINT (4697157 -74140516)
2018,Marzo,Eslovenia,2,1,,3,POINT (6170465 -7542726)
2018,Marzo,Estados Unidos de América,8,10,,18,POINT (-4191162 -69941498)
2018,Marzo,Estados Unidos de América,6,8,,14,POINT (-4214082 -69941431)
2018,Marzo,Estados Unidos de América,1,7,,8,POINT (0.33002 -76876446)
2018,Marzo,Estados Unidos de América,0,1,,1,POINT (0.812436 -77847006)
2018,Marzo,Estados Unidos de América,83,97,,180,POINT (0.81488 -77356)
2018,Marzo,Estados Unidos de América,60,87,,147,POINT (10406342 -75527794)
2018,Marzo,Estados Unidos de América,6605,7629,,14234,POINT (10446304 -75516486)
2018,Marzo,Estados Unidos de América,828,1246,,2074,POINT (10886686 -74776479)
2018,Marzo,Estados Unidos de América,5,4,,9,POINT (11117206 -74232675)
2018,Marzo,Estados Unidos de América,1,2,,3,POINT (11247723 -74213989)
2018,Marzo,Estados Unidos de América,1,4,,5,POINT (11360029 -72129595)
2018,Marzo,Estados Unidos de América,2,8,,10,POINT (125744111 -81703935)
2018,Marzo,Estados Unidos de América,45,45,,90,POINT (125862 -81702165)
2018,Marzo,Estados Unidos de América,11,15,,26,POINT (133387613 -81372937)
2018,Marzo,Estados Unidos de América,1368,1635,,3003,POINT (3451668 -76532004)
2018,Marzo,Estados Unidos de América,147,196,,343,POINT (445285 -75766353)
2018,Marzo,Estados Unidos de América,11231,16509,,27740,POINT (4697157 -74140516)
2018,Marzo,Estados Unidos de América,130,217,,347,POINT (4815189 -75736374)
2018,Marzo,Estados Unidos de América,3627,7083,,10710,POINT (6170465 -7542726)
2018,Marzo,Estados Unidos de América,0,4,,4,POINT (6218835 -75586989)
2018,Marzo,Estados Unidos de América,0,1,,1,POINT (7088729 -70740253)
2018,Marzo,Estados Unidos de América,1,0,,1,POINT (7102626 -77762647)
2018,Marzo,Estados Unidos de América,27,61,,88,POINT (7128047 -73181317)
2018,Marzo,Estados Unidos de América,18,16,,34,POINT (7819 -72453013)
2018,Marzo,Estados Unidos de América,2,3,,5,POINT (836068 -72409396)
2018,Marzo,Estados Unidos de América,8,14,,22,POINT (863337 -7735002)
2018,Marzo,Estonia,1,0,,1,POINT (0.33002 -76876446)
2018,Marzo,Estonia,2,1,,3,POINT (0.81488 -77356)
2018,Marzo,Estonia,5,3,,8,POINT (10446304 -75516486)
2018,Marzo,Estonia,2,1,,3,POINT (10886686 -74776479)
2018,Marzo,Estonia,2,1,,3,POINT (3451668 -76532004)
2018,Marzo,Estonia,16,24,,40,POINT (4697157 -74140516)
2018,Marzo,Estonia,1,2,,3,POINT (6170465 -7542726)
2018,Marzo,Estonia,0,2,,2,POINT (9402597 -75681642)
2018,Marzo,Etiopia,0,2,,2,POINT (10446304 -75516486)
2018,Marzo,Etiopia,3,3,,6,POINT (4697157 -74140516)
2018,Marzo,Etiopia,0,3,,3,POINT (6170465 -7542726)
2018,Marzo,Islas Fiji,0,1,,1,POINT (10406342 -75527794)
2018,Marzo,Islas Fiji,1,2,,3,POINT (4697157 -74140516)
2018,Marzo,Filipinas,1,1,,2,POINT (0.81488 -77356)
2018,Marzo,Filipinas,1,38,,39,POINT (10406342 -75527794)
2018,Marzo,Filipinas,9,51,,60,POINT (10446304 -75516486)
2018,Marzo,Filipinas,0,18,,18,POINT (10886686 -74776479)
2018,Marzo,Filipinas,0,27,,27,POINT (10970933 -74765343)
2018,Marzo,Filipinas,0,13,,13,POINT (11247723 -74213989)
2018,Marzo,Filipinas,1,20,,21,POINT (3451668 -76532004)
2018,Marzo,Filipinas,0,25,,25,POINT (3884426 -77061029)
2018,Marzo,Filipinas,1,0,,1,POINT (445285 -75766353)
2018,Marzo,Filipinas,46,84,,130,POINT (4697157 -74140516)
2018,Marzo,Filipinas,5,6,,11,POINT (6170465 -7542726)
2018,Marzo,Filipinas,0,13,,13,POINT (9402597 -75681642)
2018,Marzo,Finlandia,2,0,,2,POINT (-4214082 -69941431)
2018,Marzo,Finlandia,4,4,,8,POINT (0.81488 -77356)
2018,Marzo,Finlandia,1,0,,1,POINT (10406342 -75527794)
2018,Marzo,Finlandia,9,6,,15,POINT (10446304 -75516486)
2018,Marzo,Finlandia,3,5,,8,POINT (10886686 -74776479)
2018,Marzo,Finlandia,6,7,,13,POINT (3451668 -76532004)
2018,Marzo,Finlandia,52,72,,124,POINT (4697157 -74140516)
2018,Marzo,Finlandia,6,9,,15,POINT (6170465 -7542726)
2018,Marzo,Finlandia,1,1,,2,POINT (863337 -7735002)
2018,Marzo,Francia,4,12,,16,POINT (-4191162 -69941498)
2018,Marzo,Francia,12,15,,27,POINT (-4214082 -69941431)
2018,Marzo,Francia,9,16,,25,POINT (0.33002 -76876446)
2018,Marzo,Francia,121,116,,237,POINT (0.81488 -77356)
2018,Marzo,Francia,13,21,,34,POINT (10406342 -75527794)
2018,Marzo,Francia,192,256,,448,POINT (10446304 -75516486)
2018,Marzo,Francia,26,53,,79,POINT (10886686 -74776479)
2018,Marzo,Francia,1,8,,9,POINT (11247723 -74213989)
2018,Marzo,Francia,0,4,,4,POINT (11360029 -72129595)
2018,Marzo,Francia,0,2,,2,POINT (125744111 -81703935)
2018,Marzo,Francia,4,5,,9,POINT (125862 -81702165)
2018,Marzo,Francia,3,3,,6,POINT (133387613 -81372937)
2018,Marzo,Francia,66,109,,175,POINT (3451668 -76532004)
2018,Marzo,Francia,1,3,,4,POINT (3884426 -77061029)
2018,Marzo,Francia,1,2,,3,POINT (445285 -75766353)
2018,Marzo,Francia,2586,3445,,6031,POINT (4697157 -74140516)
2018,Marzo,Francia,4,9,,13,POINT (4815189 -75736374)
2018,Marzo,Francia,156,319,,475,POINT (6170465 -7542726)
2018,Marzo,Francia,0,2,,2,POINT (6185536 -67484028)
2018,Marzo,Francia,1,3,,4,POINT (7128047 -73181317)
2018,Marzo,Francia,1,11,,12,POINT (7819 -72453013)
2018,Marzo,Francia,1,1,,2,POINT (836068 -72409396)
2018,Marzo,Francia,4,7,,11,POINT (863337 -7735002)
2018,Marzo,Georgia,1,2,,3,POINT (10446304 -75516486)
2018,Marzo,Georgia,4,0,,4,POINT (4697157 -74140516)
2018,Marzo,Ghana,0,1,,1,POINT (0.81488 -77356)
2018,Marzo,Ghana,0,1,,1,POINT (10446304 -75516486)
2018,Marzo,Ghana,9,9,,18,POINT (4697157 -74140516)
2018,Marzo,Ghana,2,4,,6,POINT (6170465 -7542726)
2018,Marzo,Granada,2,5,,7,POINT (4697157 -74140516)
2018,Marzo,Granada,1,2,,3,POINT (6170465 -7542726)
2018,Marzo,Grecia,1,0,,1,POINT (0.33002 -76876446)
2018,Marzo,Grecia,1,1,,2,POINT (0.81488 -77356)
2018,Marzo,Grecia,0,2,,2,POINT (10406342 -75527794)
2018,Marzo,Grecia,5,15,,20,POINT (10446304 -75516486)
2018,Marzo,Grecia,0,5,,5,POINT (10886686 -74776479)
2018,Marzo,Grecia,1,3,,4,POINT (3451668 -76532004)
2018,Marzo,Grecia,0,2,,2,POINT (3884426 -77061029)
2018,Marzo,Grecia,44,96,,140,POINT (4697157 -74140516)
2018,Marzo,Grecia,0,10,,10,POINT (6170465 -7542726)
2018,Marzo,Grecia,0,1,,1,POINT (7819 -72453013)
2018,Marzo,Guatemala,1,1,,2,POINT (0.33002 -76876446)
2018,Marzo,Guatemala,1,1,,2,POINT (0.81488 -77356)
2018,Marzo,Guatemala,0,3,,3,POINT (10406342 -75527794)
2018,Marzo,Guatemala,171,199,,370,POINT (10446304 -75516486)
2018,Marzo,Guatemala,25,48,,73,POINT (10886686 -74776479)
2018,Marzo,Guatemala,0,2,,2,POINT (11360029 -72129595)
2018,Marzo,Guatemala,22,14,,36,POINT (125862 -81702165)
2018,Marzo,Guatemala,22,58,,80,POINT (3451668 -76532004)
2018,Marzo,Guatemala,460,732,,1192,POINT (4697157 -74140516)
2018,Marzo,Guatemala,1,5,,6,POINT (4815189 -75736374)
2018,Marzo,Guatemala,89,169,,258,POINT (6170465 -7542726)
2018,Marzo,Guatemala,6,6,,12,POINT (7128047 -73181317)
2018,Marzo,Guatemala,0,1,,1,POINT (7819 -72453013)
2018,Marzo,Guatemala,0,2,,2,POINT (863337 -7735002)
2018,Marzo,Guyana,2,4,,6,POINT (10446304 -75516486)
2018,Marzo,Guyana,0,1,,1,POINT (10886686 -74776479)
2018,Marzo,Guyana,0,1,,1,POINT (3451668 -76532004)
2018,Marzo,Guyana,9,13,,22,POINT (4697157 -74140516)
2018,Marzo,Guyana,0,1,,1,POINT (7819 -72453013)
2018,Marzo,Guinea,0,1,,1,POINT (4697157 -74140516)
2018,Marzo,Guinea Bissau,0,1,,1,POINT (4697157 -74140516)
2018,Marzo,Guinea Bissau,0,1,,1,POINT (6170465 -7542726)
2018,Marzo,Haití,0,1,,1,POINT (0.81488 -77356)
2018,Marzo,Haití,5,12,,17,POINT (10446304 -75516486)
2018,Marzo,Haití,0,3,,3,POINT (10886686 -74776479)
2018,Marzo,Haití,7,11,,18,POINT (4697157 -74140516)
2018,Marzo,Haití,2,2,,4,POINT (6170465 -7542726)
2018,Marzo,Haití,1,0,,1,POINT (7128047 -73181317)
2018,Marzo,Honduras,1,1,,2,POINT (0.81488 -77356)
2018,Marzo,Honduras,0,6,,6,POINT (10406342 -75527794)
2018,Marzo,Honduras,59,75,,134,POINT (10446304 -75516486)
2018,Marzo,Honduras,11,17,,28,POINT (10886686 -74776479)
2018,Marzo,Honduras,0,2,,2,POINT (125744111 -81703935)
2018,Marzo,Honduras,0,3,,3,POINT (125862 -81702165)
2018,Marzo,Honduras,66,40,,106,POINT (3451668 -76532004)
2018,Marzo,Honduras,1,1,,2,POINT (445285 -75766353)
2018,Marzo,Honduras,299,303,,602,POINT (4697157 -74140516)
2018,Marzo,Honduras,5,5,,10,POINT (4815189 -75736374)
2018,Marzo,Honduras,76,69,,145,POINT (6170465 -7542726)
2018,Marzo,Honduras,1,1,,2,POINT (7128047 -73181317)
2018,Marzo,Honduras,0,1,,1,POINT (863337 -7735002)
2018,Marzo,Hong Kong,1,0,,1,POINT (10446304 -75516486)
2018,Marzo,Hong Kong,13,11,,24,POINT (4697157 -74140516)
2018,Marzo,Hong Kong,1,0,,1,POINT (6170465 -7542726)
2018,Marzo,Hungría,0,1,,1,POINT (-4214082 -69941431)
2018,Marzo,Hungría,0,2,,2,POINT (0.81488 -77356)
2018,Marzo,Hungría,2,1,,3,POINT (10406342 -75527794)
2018,Marzo,Hungría,16,15,,31,POINT (10446304 -75516486)
2018,Marzo,Hungría,1,0,,1,POINT (10886686 -74776479)
2018,Marzo,Hungría,1,1,,2,POINT (3451668 -76532004)
2018,Marzo,Hungría,51,56,,107,POINT (4697157 -74140516)
2018,Marzo,Hungría,4,12,,16,POINT (6170465 -7542726)
2018,Marzo,Hungría,0,1,,1,POINT (863337 -7735002)
2018,Marzo,India,0,2,,2,POINT (0.81488 -77356)
2018,Marzo,India,0,13,,13,POINT (10406342 -75527794)
2018,Marzo,India,27,64,,91,POINT (10446304 -75516486)
2018,Marzo,India,2,11,,13,POINT (10886686 -74776479)
2018,Marzo,India,0,3,,3,POINT (10970933 -74765343)
2018,Marzo,India,2,11,,13,POINT (3451668 -76532004)
2018,Marzo,India,0,2,,2,POINT (3884426 -77061029)
2018,Marzo,India,114,403,,517,POINT (4697157 -74140516)
2018,Marzo,India,0,3,,3,POINT (4815189 -75736374)
2018,Marzo,India,12,61,,73,POINT (6170465 -7542726)
2018,Marzo,India,0,2,,2,POINT (7128047 -73181317)
2018,Marzo,India,0,1,,1,POINT (863337 -7735002)
2018,Marzo,India,0,4,,4,POINT (9402597 -75681642)
2018,Marzo,Indonesia,0,1,,1,POINT (0.81488 -77356)
2018,Marzo,Indonesia,1,4,,5,POINT (10406342 -75527794)
2018,Marzo,Indonesia,3,15,,18,POINT (10446304 -75516486)
2018,Marzo,Indonesia,16,34,,50,POINT (4697157 -74140516)
2018,Marzo,Indonesia,1,2,,3,POINT (6170465 -7542726)
2018,Marzo,Iraq,1,3,,4,POINT (4697157 -74140516)
2018,Marzo,Irán,1,0,,1,POINT (0.81488 -77356)
2018,Marzo,Irán,3,2,,5,POINT (10446304 -75516486)
2018,Marzo,Irán,2,15,,17,POINT (4697157 -74140516)
2018,Marzo,Irán,2,1,,3,POINT (6170465 -7542726)
2018,Marzo,República de Irlanda,0,1,,1,POINT (0.33002 -76876446)
2018,Marzo,República de Irlanda,8,10,,18,POINT (0.81488 -77356)
2018,Marzo,República de Irlanda,8,5,,13,POINT (10406342 -75527794)
2018,Marzo,República de Irlanda,25,35,,60,POINT (10446304 -75516486)
2018,Marzo,República de Irlanda,0,4,,4,POINT (10886686 -74776479)
2018,Marzo,República de Irlanda,0,1,,1,POINT (11360029 -72129595)
2018,Marzo,República de Irlanda,0,11,,11,POINT (3451668 -76532004)
2018,Marzo,República de Irlanda,166,271,,437,POINT (4697157 -74140516)
2018,Marzo,República de Irlanda,13,48,,61,POINT (6170465 -7542726)
2018,Marzo,República de Irlanda,0,3,,3,POINT (7819 -72453013)
2018,Marzo,República de Irlanda,5,4,,9,POINT (863337 -7735002)
2018,Marzo,Islandia,1,2,,3,POINT (0.81488 -77356)
2018,Marzo,Islandia,1,1,,2,POINT (10446304 -75516486)
2018,Marzo,Islandia,2,0,,2,POINT (3451668 -76532004)
2018,Marzo,Islandia,10,13,,23,POINT (4697157 -74140516)
2018,Marzo,Islandia,1,0,,1,POINT (4815189 -75736374)
2018,Marzo,Islandia,1,2,,3,POINT (6170465 -7542726)
2018,Marzo,Israel,2,2,,4,POINT (-4191162 -69941498)
2018,Marzo,Israel,5,11,,16,POINT (-4214082 -69941431)
2018,Marzo,Israel,0,3,,3,POINT (0.33002 -76876446)
2018,Marzo,Israel,11,15,,26,POINT (0.81488 -77356)
2018,Marzo,Israel,34,75,,109,POINT (10446304 -75516486)
2018,Marzo,Israel,5,8,,13,POINT (10886686 -74776479)
2018,Marzo,Israel,1,2,,3,POINT (11247723 -74213989)
2018,Marzo,Israel,4,0,,4,POINT (125862 -81702165)
2018,Marzo,Israel,5,12,,17,POINT (3451668 -76532004)
2018,Marzo,Israel,423,769,,1192,POINT (4697157 -74140516)
2018,Marzo,Israel,118,216,,334,POINT (6170465 -7542726)
2018,Marzo,Italia,0,2,,2,POINT (-4191162 -69941498)
2018,Marzo,Italia,3,3,,6,POINT (-4214082 -69941431)
2018,Marzo,Italia,2,3,,5,POINT (0.33002 -76876446)
2018,Marzo,Italia,22,28,,50,POINT (0.81488 -77356)
2018,Marzo,Italia,15,30,,45,POINT (10406342 -75527794)
2018,Marzo,Italia,91,191,,282,POINT (10446304 -75516486)
2018,Marzo,Italia,12,29,,41,POINT (10886686 -74776479)
2018,Marzo,Italia,0,8,,8,POINT (11360029 -72129595)
2018,Marzo,Italia,0,2,,2,POINT (125744111 -81703935)
2018,Marzo,Italia,7,10,,17,POINT (125862 -81702165)
2018,Marzo,Italia,0,2,,2,POINT (133387613 -81372937)
2018,Marzo,Italia,31,85,,116,POINT (3451668 -76532004)
2018,Marzo,Italia,0,1,,1,POINT (3884426 -77061029)
2018,Marzo,Italia,0,1,,1,POINT (445285 -75766353)
2018,Marzo,Italia,749,1772,,2521,POINT (4697157 -74140516)
2018,Marzo,Italia,2,5,,7,POINT (4815189 -75736374)
2018,Marzo,Italia,86,249,,335,POINT (6170465 -7542726)
2018,Marzo,Italia,6,6,,12,POINT (7088729 -70740253)
2018,Marzo,Italia,1,5,,6,POINT (7128047 -73181317)
2018,Marzo,Italia,11,20,,31,POINT (7819 -72453013)
2018,Marzo,Italia,0,4,,4,POINT (836068 -72409396)
2018,Marzo,Italia,4,4,,8,POINT (863337 -7735002)
2018,Marzo,Jamaica,0,1,,1,POINT (0.81488 -77356)
2018,Marzo,Jamaica,3,2,,5,POINT (10446304 -75516486)
2018,Marzo,Jamaica,3,2,,5,POINT (10886686 -74776479)
2018,Marzo,Jamaica,3,3,,6,POINT (3451668 -76532004)
2018,Marzo,Jamaica,32,34,,66,POINT (4697157 -74140516)
2018,Marzo,Jamaica,0,2,,2,POINT (4815189 -75736374)
2018,Marzo,Jamaica,7,7,,14,POINT (6170465 -7542726)
2018,Marzo,Japón,0,1,,1,POINT (-4191162 -69941498)
2018,Marzo,Japón,2,2,,4,POINT (-4214082 -69941431)
2018,Marzo,Japón,6,9,,15,POINT (0.81488 -77356)
2018,Marzo,Japón,0,2,,2,POINT (10406342 -75527794)
2018,Marzo,Japón,15,11,,26,POINT (10446304 -75516486)
2018,Marzo,Japón,1,5,,6,POINT (10886686 -74776479)
2018,Marzo,Japón,9,11,,20,POINT (3451668 -76532004)
2018,Marzo,Japón,230,521,,751,POINT (4697157 -74140516)
2018,Marzo,Japón,35,72,,107,POINT (6170465 -7542726)
2018,Marzo,Japón,0,1,,1,POINT (7819 -72453013)
2018,Marzo,Japón,0,1,,1,POINT (863337 -7735002)
2018,Marzo,Jordania,3,7,,10,POINT (4697157 -74140516)
2018,Marzo,Jordania,1,0,,1,POINT (6170465 -7542726)
2018,Marzo,Kazajistán,2,0,,2,POINT (10446304 -75516486)
2018,Marzo,Kazajistán,3,0,,3,POINT (4697157 -74140516)
2018,Marzo,Kazajistán,3,1,,4,POINT (6170465 -7542726)
2018,Marzo,Kenia,8,15,,23,POINT (4697157 -74140516)
2018,Marzo,Kenia,1,0,,1,POINT (4815189 -75736374)
2018,Marzo,Kenia,4,3,,7,POINT (6170465 -7542726)
2018,Marzo,Kirguistán,0,2,,2,POINT (6170465 -7542726)
2018,Marzo,Kuwait,1,0,,1,POINT (10446304 -75516486)
2018,Marzo,Kuwait,2,5,,7,POINT (4697157 -74140516)
2018,Marzo,Kuwait,0,1,,1,POINT (6170465 -7542726)
2018,Marzo,Kuwait,0,1,,1,POINT (7128047 -73181317)
2018,Marzo,República de Kosovo,2,2,,4,POINT (4697157 -74140516)
2018,Marzo,Lesoto,1,0,,1,POINT (4697157 -74140516)
2018,Marzo,Letonia,0,5,,5,POINT (10406342 -75527794)
2018,Marzo,Letonia,2,4,,6,POINT (10446304 -75516486)
2018,Marzo,Letonia,0,1,,1,POINT (10886686 -74776479)
2018,Marzo,Letonia,0,4,,4,POINT (11247723 -74213989)
2018,Marzo,Letonia,0,1,,1,POINT (3451668 -76532004)
2018,Marzo,Letonia,15,24,,39,POINT (4697157 -74140516)
2018,Marzo,Letonia,2,0,,2,POINT (6170465 -7542726)
2018,Marzo,Lituania,0,1,,1,POINT (-4191162 -69941498)
2018,Marzo,Lituania,1,1,,2,POINT (0.33002 -76876446)
2018,Marzo,Lituania,0,1,,1,POINT (0.81488 -77356)
2018,Marzo,Lituania,0,1,,1,POINT (10406342 -75527794)
2018,Marzo,Lituania,8,3,,11,POINT (10446304 -75516486)
2018,Marzo,Lituania,0,2,,2,POINT (10886686 -74776479)
2018,Marzo,Lituania,0,3,,3,POINT (3451668 -76532004)
2018,Marzo,Lituania,17,27,,44,POINT (4697157 -74140516)
2018,Marzo,Lituania,2,1,,3,POINT (6170465 -7542726)
2018,Marzo,Líbano,1,0,,1,POINT (0.81488 -77356)
2018,Marzo,Líbano,1,1,,2,POINT (10446304 -75516486)
2018,Marzo,Líbano,2,0,,2,POINT (10886686 -74776479)
2018,Marzo,Líbano,2,0,,2,POINT (11360029 -72129595)
2018,Marzo,Líbano,0,1,,1,POINT (125862 -81702165)
2018,Marzo,Líbano,15,33,,48,POINT (4697157 -74140516)
2018,Marzo,Líbano,2,1,,3,POINT (6170465 -7542726)
2018,Marzo,Líbano,1,0,,1,POINT (7128047 -73181317)
2018,Marzo,Liberia,1,0,,1,POINT (3451668 -76532004)
2018,Marzo,Liechtenstein,5,5,,10,POINT (4697157 -74140516)
2018,Marzo,Luxemburgo,0,1,,1,POINT (0.81488 -77356)
2018,Marzo,Luxemburgo,1,0,,1,POINT (10446304 -75516486)
2018,Marzo,Luxemburgo,13,28,,41,POINT (4697157 -74140516)
2018,Marzo,Luxemburgo,0,2,,2,POINT (6170465 -7542726)
2018,Marzo,Macedonia,0,2,,2,POINT (10446304 -75516486)
2018,Marzo,Macedonia,0,1,,1,POINT (3451668 -76532004)
2018,Marzo,Macedonia,1,0,,1,POINT (4697157 -74140516)
2018,Marzo,Madagascar,0,1,,1,POINT (4697157 -74140516)
2018,Marzo,Malasia,0,1,,1,POINT (0.81488 -77356)
2018,Marzo,Malasia,2,4,,6,POINT (10446304 -75516486)
2018,Marzo,Malasia,26,27,,53,POINT (4697157 -74140516)
2018,Marzo,Malasia,3,1,,4,POINT (6170465 -7542726)
2018,Marzo,Malasia,0,1,,1,POINT (9402597 -75681642)
2018,Marzo,Malawi,0,1,,1,POINT (4697157 -74140516)
2018,Marzo,Malawi,1,1,,2,POINT (6170465 -7542726)
2018,Marzo,Maldivas,1,0,,1,POINT (4697157 -74140516)
2018,Marzo,Malí,0,4,,4,POINT (4697157 -74140516)
2018,Marzo,Malta,0,1,,1,POINT (10446304 -75516486)
2018,Marzo,Malta,1,2,,3,POINT (3451668 -76532004)
2018,Marzo,Malta,4,11,,15,POINT (4697157 -74140516)
2018,Marzo,Malta,0,1,,1,POINT (6170465 -7542726)
2018,Marzo,Marruecos,0,1,,1,POINT (0.81488 -77356)
2018,Marzo,Marruecos,1,0,,1,POINT (3451668 -76532004)
2018,Marzo,Marruecos,9,8,,17,POINT (4697157 -74140516)
2018,Marzo,Marruecos,2,5,,7,POINT (6170465 -7542726)
2018,Marzo,Mauricio,2,1,,3,POINT (10406342 -75527794)
2018,Marzo,Mauricio,2,0,,2,POINT (10446304 -75516486)
2018,Marzo,Mauricio,0,1,,1,POINT (4697157 -74140516)
2018,Marzo,Mauritania,0,1,,1,POINT (4697157 -74140516)
2018,Marzo,México,0,1,,1,POINT (-4214082 -69941431)
2018,Marzo,México,1,1,,2,POINT (0.33002 -76876446)
2018,Marzo,México,2,3,,5,POINT (0.812436 -77847006)
2018,Marzo,México,21,43,,64,POINT (0.81488 -77356)
2018,Marzo,México,31,40,,71,POINT (10406342 -75527794)
2018,Marzo,México,294,412,,706,POINT (10446304 -75516486)
2018,Marzo,México,50,87,,137,POINT (10886686 -74776479)
2018,Marzo,México,2,4,,6,POINT (11360029 -72129595)
2018,Marzo,México,0,2,,2,POINT (125862 -81702165)
2018,Marzo,México,90,155,,245,POINT (3451668 -76532004)
2018,Marzo,México,0,1,,1,POINT (445285 -75766353)
2018,Marzo,México,5040,8189,,13229,POINT (4697157 -74140516)
2018,Marzo,México,4,19,,23,POINT (4815189 -75736374)
2018,Marzo,México,767,1395,,2162,POINT (6170465 -7542726)
2018,Marzo,México,2,0,,2,POINT (7088729 -70740253)
2018,Marzo,México,5,12,,17,POINT (7128047 -73181317)
2018,Marzo,México,10,28,,38,POINT (7819 -72453013)
2018,Marzo,México,0,2,,2,POINT (836068 -72409396)
2018,Marzo,México,1,4,,5,POINT (863337 -7735002)
2018,Marzo,República de Moldavia,6,3,,9,POINT (4697157 -74140516)
2018,Marzo,Mónaco,0,4,,4,POINT (10446304 -75516486)
2018,Marzo,Mónaco,1,3,,4,POINT (4697157 -74140516)
2018,Marzo,Montenegro,0,1,,1,POINT (10406342 -75527794)
2018,Marzo,Montenegro,0,1,,1,POINT (10446304 -75516486)
2018,Marzo,Montenegro,2,5,,7,POINT (4697157 -74140516)
2018,Marzo,Mozambique,2,0,,2,POINT (4697157 -74140516)
2018,Marzo,Myanmar,0,11,,11,POINT (10406342 -75527794)
2018,Marzo,Myanmar,0,10,,10,POINT (10446304 -75516486)
2018,Marzo,Myanmar,1,2,,3,POINT (4697157 -74140516)
2018,Marzo,Namibia,1,0,,1,POINT (4697157 -74140516)
2018,Marzo,Nepal,0,1,,1,POINT (10406342 -75527794)
2018,Marzo,Nepal,0,1,,1,POINT (10886686 -74776479)
2018,Marzo,Nepal,1,5,,6,POINT (4697157 -74140516)
2018,Marzo,Nepal,1,1,,2,POINT (6170465 -7542726)
2018,Marzo,Nicaragua,0,1,,1,POINT (0.81488 -77356)
2018,Marzo,Nicaragua,1,0,,1,POINT (10406342 -75527794)
2018,Marzo,Nicaragua,72,45,,117,POINT (10446304 -75516486)
2018,Marzo,Nicaragua,11,10,,21,POINT (10886686 -74776479)
2018,Marzo,Nicaragua,2,2,,4,POINT (125862 -81702165)
2018,Marzo,Nicaragua,11,11,,22,POINT (3451668 -76532004)
2018,Marzo,Nicaragua,109,106,,215,POINT (4697157 -74140516)
2018,Marzo,Nicaragua,2,4,,6,POINT (4815189 -75736374)
2018,Marzo,Nicaragua,25,24,,49,POINT (6170465 -7542726)
2018,Marzo,Nicaragua,2,1,,3,POINT (7128047 -73181317)
2018,Marzo,Nicaragua,1,0,,1,POINT (7819 -72453013)
2018,Marzo,Nigeria,1,2,,3,POINT (0.81488 -77356)
2018,Marzo,Nigeria,1,0,,1,POINT (10446304 -75516486)
2018,Marzo,Nigeria,3,12,,15,POINT (4697157 -74140516)
2018,Marzo,Nigeria,0,2,,2,POINT (6170465 -7542726)
2018,Marzo,Noruega,1,2,,3,POINT (-4191162 -69941498)
2018,Marzo,Noruega,0,1,,1,POINT (0.33002 -76876446)
2018,Marzo,Noruega,2,1,,3,POINT (0.81488 -77356)
2018,Marzo,Noruega,8,3,,11,POINT (10406342 -75527794)
2018,Marzo,Noruega,23,36,,59,POINT (10446304 -75516486)
2018,Marzo,Noruega,4,1,,5,POINT (10886686 -74776479)
2018,Marzo,Noruega,0,1,,1,POINT (11247723 -74213989)
2018,Marzo,Noruega,3,1,,4,POINT (125862 -81702165)
2018,Marzo,Noruega,6,7,,13,POINT (3451668 -76532004)
2018,Marzo,Noruega,158,172,,330,POINT (4697157 -74140516)
2018,Marzo,Noruega,17,20,,37,POINT (6170465 -7542726)
2018,Marzo,Noruega,2,1,,3,POINT (863337 -7735002)
2018,Marzo,Nueva Zelanda,9,8,,17,POINT (0.81488 -77356)
2018,Marzo,Nueva Zelanda,4,4,,8,POINT (10406342 -75527794)
2018,Marzo,Nueva Zelanda,8,14,,22,POINT (10446304 -75516486)
2018,Marzo,Nueva Zelanda,0,2,,2,POINT (10886686 -74776479)
2018,Marzo,Nueva Zelanda,3,4,,7,POINT (11247723 -74213989)
2018,Marzo,Nueva Zelanda,1,0,,1,POINT (125862 -81702165)
2018,Marzo,Nueva Zelanda,2,2,,4,POINT (133387613 -81372937)
2018,Marzo,Nueva Zelanda,0,3,,3,POINT (3451668 -76532004)
2018,Marzo,Nueva Zelanda,67,116,,183,POINT (4697157 -74140516)
2018,Marzo,Nueva Zelanda,12,19,,31,POINT (6170465 -7542726)
2018,Marzo,Nueva Zelanda,0,5,,5,POINT (863337 -7735002)
2018,Marzo,Omán,1,2,,3,POINT (4697157 -74140516)
2018,Marzo,Países Bajos,1,1,,2,POINT (-4191162 -69941498)
2018,Marzo,Países Bajos,5,2,,7,POINT (-4214082 -69941431)
2018,Marzo,Países Bajos,0,1,,1,POINT (0.33002 -76876446)
2018,Marzo,Países Bajos,26,27,,53,POINT (0.81488 -77356)
2018,Marzo,Países Bajos,38,43,,81,POINT (10406342 -75527794)
2018,Marzo,Países Bajos,127,172,,299,POINT (10446304 -75516486)
2018,Marzo,Países Bajos,12,28,,40,POINT (10886686 -74776479)
2018,Marzo,Países Bajos,0,3,,3,POINT (10970933 -74765343)
2018,Marzo,Países Bajos,0,2,,2,POINT (11117206 -74232675)
2018,Marzo,Países Bajos,1,3,,4,POINT (11247723 -74213989)
2018,Marzo,Países Bajos,0,1,,1,POINT (11360029 -72129595)
2018,Marzo,Países Bajos,0,1,,1,POINT (125862 -81702165)
2018,Marzo,Países Bajos,26,36,,62,POINT (3451668 -76532004)
2018,Marzo,Países Bajos,1677,2133,,3810,POINT (4697157 -74140516)
2018,Marzo,Países Bajos,1,6,,7,POINT (4815189 -75736374)
2018,Marzo,Países Bajos,179,218,,397,POINT (6170465 -7542726)
2018,Marzo,Países Bajos,7,15,,22,POINT (7128047 -73181317)
2018,Marzo,Países Bajos,1,12,,13,POINT (7819 -72453013)
2018,Marzo,Países Bajos,0,3,,3,POINT (836068 -72409396)
2018,Marzo,Países Bajos,12,2,,14,POINT (863337 -7735002)
2018,Marzo,Pakistán,2,1,,3,POINT (10446304 -75516486)
2018,Marzo,Pakistán,10,23,,33,POINT (4697157 -74140516)
2018,Marzo,Pakistán,0,1,,1,POINT (6170465 -7542726)
2018,Marzo,Panamá,1,1,,2,POINT (0.81488 -77356)
2018,Marzo,Panamá,0,14,,14,POINT (10406342 -75527794)
2018,Marzo,Panamá,543,543,,1086,POINT (10446304 -75516486)
2018,Marzo,Panamá,71,92,,163,POINT (10886686 -74776479)
2018,Marzo,Panamá,0,1,,1,POINT (10970933 -74765343)
2018,Marzo,Panamá,31,33,,64,POINT (125862 -81702165)
2018,Marzo,Panamá,184,196,,380,POINT (3451668 -76532004)
2018,Marzo,Panamá,9,22,,31,POINT (445285 -75766353)
2018,Marzo,Panamá,1510,1533,,3043,POINT (4697157 -74140516)
2018,Marzo,Panamá,28,42,,70,POINT (4815189 -75736374)
2018,Marzo,Panamá,1241,1130,,2371,POINT (6170465 -7542726)
2018,Marzo,Panamá,0,1,,1,POINT (6222552 -77401154)
2018,Marzo,Panamá,2,2,,4,POINT (7102626 -77762647)
2018,Marzo,Panamá,17,26,,43,POINT (7128047 -73181317)
2018,Marzo,Panamá,2,1,,3,POINT (7819 -72453013)
2018,Marzo,Panamá,2,5,,7,POINT (863337 -7735002)
2018,Marzo,Papúa Nueva Guinea,0,2,,2,POINT (4697157 -74140516)
2018,Marzo,Paraguay,0,3,,3,POINT (0.81488 -77356)
2018,Marzo,Paraguay,2,4,,6,POINT (10406342 -75527794)
2018,Marzo,Paraguay,76,50,,126,POINT (10446304 -75516486)
2018,Marzo,Paraguay,0,13,,13,POINT (10886686 -74776479)
2018,Marzo,Paraguay,66,49,,115,POINT (125862 -81702165)
2018,Marzo,Paraguay,13,14,,27,POINT (3451668 -76532004)
2018,Marzo,Paraguay,204,180,,384,POINT (4697157 -74140516)
2018,Marzo,Paraguay,0,1,,1,POINT (4815189 -75736374)
2018,Marzo,Paraguay,25,11,,36,POINT (6170465 -7542726)
2018,Marzo,Paraguay,2,1,,3,POINT (7128047 -73181317)
2018,Marzo,Paraguay,0,1,,1,POINT (7819 -72453013)
2018,Marzo,Perú,14,17,,31,POINT (-4191162 -69941498)
2018,Marzo,Perú,30,62,,92,POINT (-4214082 -69941431)
2018,Marzo,Perú,1,2,,3,POINT (0.185957 -7478366)
2018,Marzo,Perú,7,14,,21,POINT (0.33002 -76876446)
2018,Marzo,Perú,135,358,,493,POINT (0.81488 -77356)
2018,Marzo,Perú,49,29,,78,POINT (10406342 -75527794)
2018,Marzo,Perú,643,474,,1117,POINT (10446304 -75516486)
2018,Marzo,Perú,20,20,,40,POINT (10886686 -74776479)
2018,Marzo,Perú,0,2,,2,POINT (10970933 -74765343)
2018,Marzo,Perú,0,2,,2,POINT (11247723 -74213989)
2018,Marzo,Perú,5,18,,23,POINT (11360029 -72129595)
2018,Marzo,Perú,226,153,,379,POINT (125862 -81702165)
2018,Marzo,Perú,160,199,,359,POINT (3451668 -76532004)
2018,Marzo,Perú,0,6,,6,POINT (3884426 -77061029)
2018,Marzo,Perú,0,1,,1,POINT (445285 -75766353)
2018,Marzo,Perú,3977,4572,,8549,POINT (4697157 -74140516)
2018,Marzo,Perú,0,9,,9,POINT (4815189 -75736374)
2018,Marzo,Perú,426,639,,1065,POINT (6170465 -7542726)
2018,Marzo,Perú,0,1,,1,POINT (6185536 -67484028)
2018,Marzo,Perú,6,13,,19,POINT (7088729 -70740253)
2018,Marzo,Perú,2,1,,3,POINT (7128047 -73181317)
2018,Marzo,Perú,118,244,,362,POINT (7819 -72453013)
2018,Marzo,Perú,2,8,,10,POINT (836068 -72409396)
2018,Marzo,Palestina,1,4,,5,POINT (4697157 -74140516)
2018,Marzo,Polonia,0,1,,1,POINT (-4191162 -69941498)
2018,Marzo,Polonia,2,0,,2,POINT (-4214082 -69941431)
2018,Marzo,Polonia,0,2,,2,POINT (0.33002 -76876446)
2018,Marzo,Polonia,12,13,,25,POINT (0.81488 -77356)
2018,Marzo,Polonia,1,14,,15,POINT (10406342 -75527794)
2018,Marzo,Polonia,21,39,,60,POINT (10446304 -75516486)
2018,Marzo,Polonia,3,4,,7,POINT (10886686 -74776479)
2018,Marzo,Polonia,0,2,,2,POINT (10970933 -74765343)
2018,Marzo,Polonia,0,3,,3,POINT (11247723 -74213989)
2018,Marzo,Polonia,9,7,,16,POINT (3451668 -76532004)
2018,Marzo,Polonia,0,3,,3,POINT (3884426 -77061029)
2018,Marzo,Polonia,179,251,,430,POINT (4697157 -74140516)
2018,Marzo,Polonia,2,0,,2,POINT (4815189 -75736374)
2018,Marzo,Polonia,14,17,,31,POINT (6170465 -7542726)
2018,Marzo,Polonia,0,1,,1,POINT (7819 -72453013)
2018,Marzo,Polonia,0,3,,3,POINT (863337 -7735002)
2018,Marzo,Portugal,2,0,,2,POINT (-4191162 -69941498)
2018,Marzo,Portugal,1,0,,1,POINT (-4214082 -69941431)
2018,Marzo,Portugal,4,5,,9,POINT (0.81488 -77356)
2018,Marzo,Portugal,6,8,,14,POINT (10406342 -75527794)
2018,Marzo,Portugal,19,23,,42,POINT (10446304 -75516486)
2018,Marzo,Portugal,5,5,,10,POINT (10886686 -74776479)
2018,Marzo,Portugal,4,2,,6,POINT (11360029 -72129595)
2018,Marzo,Portugal,5,7,,12,POINT (125862 -81702165)
2018,Marzo,Portugal,47,35,,82,POINT (3451668 -76532004)
2018,Marzo,Portugal,273,510,,783,POINT (4697157 -74140516)
2018,Marzo,Portugal,21,46,,67,POINT (6170465 -7542726)
2018,Marzo,Portugal,8,13,,21,POINT (7819 -72453013)
2018,Marzo,Portugal,0,2,,2,POINT (836068 -72409396)
2018,Marzo,Puerto Rico/Territorio de Estados Unidos,0,1,,1,POINT (4697157 -74140516)
2018,Marzo,Qatar,0,2,,2,POINT (4697157 -74140516)
2018,Marzo,Reino Unido de Gran Bretaña e Irlanda del Norte,8,5,,13,POINT (-4191162 -69941498)
2018,Marzo,Reino Unido de Gran Bretaña e Irlanda del Norte,12,10,,22,POINT (-4214082 -69941431)
2018,Marzo,Reino Unido de Gran Bretaña e Irlanda del Norte,1,5,,6,POINT (0.33002 -76876446)
2018,Marzo,Reino Unido de Gran Bretaña e Irlanda del Norte,0,1,,1,POINT (0.812436 -77847006)
2018,Marzo,Reino Unido de Gran Bretaña e Irlanda del Norte,39,69,,108,POINT (0.81488 -77356)
2018,Marzo,Reino Unido de Gran Bretaña e Irlanda del Norte,32,31,,63,POINT (10406342 -75527794)
2018,Marzo,Reino Unido de Gran Bretaña e Irlanda del Norte,123,187,,310,POINT (10446304 -75516486)
2018,Marzo,Reino Unido de Gran Bretaña e Irlanda del Norte,5,37,,42,POINT (10886686 -74776479)
2018,Marzo,Reino Unido de Gran Bretaña e Irlanda del Norte,0,1,,1,POINT (11117206 -74232675)
2018,Marzo,Reino Unido de Gran Bretaña e Irlanda del Norte,5,4,,9,POINT (11247723 -74213989)
2018,Marzo,Reino Unido de Gran Bretaña e Irlanda del Norte,1,2,,3,POINT (11360029 -72129595)
2018,Marzo,Reino Unido de Gran Bretaña e Irlanda del Norte,1,3,,4,POINT (125862 -81702165)
2018,Marzo,Reino Unido de Gran Bretaña e Irlanda del Norte,0,2,,2,POINT (133387613 -81372937)
2018,Marzo,Reino Unido de Gran Bretaña e Irlanda del Norte,31,51,,82,POINT (3451668 -76532004)
2018,Marzo,Reino Unido de Gran Bretaña e Irlanda del Norte,1,1,,2,POINT (445285 -75766353)
2018,Marzo,Reino Unido de Gran Bretaña e Irlanda del Norte,1462,2481,,3943,POINT (4697157 -74140516)
2018,Marzo,Reino Unido de Gran Bretaña e Irlanda del Norte,1,2,,3,POINT (4815189 -75736374)
2018,Marzo,Reino Unido de Gran Bretaña e Irlanda del Norte,105,272,,377,POINT (6170465 -7542726)
2018,Marzo,Reino Unido de Gran Bretaña e Irlanda del Norte,1,0,,1,POINT (6185536 -67484028)
2018,Marzo,Reino Unido de Gran Bretaña e Irlanda del Norte,0,2,,2,POINT (7128047 -73181317)
2018,Marzo,Reino Unido de Gran Bretaña e Irlanda del Norte,2,2,,4,POINT (7819 -72453013)
2018,Marzo,Reino Unido de Gran Bretaña e Irlanda del Norte,0,1,,1,POINT (836068 -72409396)
2018,Marzo,Reino Unido de Gran Bretaña e Irlanda del Norte,26,31,,57,POINT (863337 -7735002)
2018,Marzo,República Dominicana,5,16,,21,POINT (0.81488 -77356)
2018,Marzo,República Dominicana,55,73,,128,POINT (10446304 -75516486)
2018,Marzo,República Dominicana,20,24,,44,POINT (10886686 -74776479)
2018,Marzo,República Dominicana,3,3,,6,POINT (11360029 -72129595)
2018,Marzo,República Dominicana,35,29,,64,POINT (3451668 -76532004)
2018,Marzo,República Dominicana,1,0,,1,POINT (445285 -75766353)
2018,Marzo,República Dominicana,873,893,,1766,POINT (4697157 -74140516)
2018,Marzo,República Dominicana,4,5,,9,POINT (4815189 -75736374)
2018,Marzo,República Dominicana,99,98,,197,POINT (6170465 -7542726)
2018,Marzo,República Dominicana,1,0,,1,POINT (7088729 -70740253)
2018,Marzo,República Dominicana,2,3,,5,POINT (7128047 -73181317)
2018,Marzo,República Dominicana,3,4,,7,POINT (7819 -72453013)
2018,Marzo,Rumania,1,8,,9,POINT (10406342 -75527794)
2018,Marzo,Rumania,7,23,,30,POINT (10446304 -75516486)
2018,Marzo,Rumania,0,1,,1,POINT (10886686 -74776479)
2018,Marzo,Rumania,6,3,,9,POINT (3451668 -76532004)
2018,Marzo,Rumania,71,86,,157,POINT (4697157 -74140516)
2018,Marzo,Rumania,1,0,,1,POINT (4815189 -75736374)
2018,Marzo,Rumania,13,10,,23,POINT (6170465 -7542726)
2018,Marzo,Rumania,0,1,,1,POINT (7819 -72453013)
2018,Marzo,Rumania,0,2,,2,POINT (9402597 -75681642)
2018,Marzo,Federación de Rusia,1,1,,2,POINT (-4191162 -69941498)
2018,Marzo,Federación de Rusia,1,1,,2,POINT (-4214082 -69941431)
2018,Marzo,Federación de Rusia,5,2,,7,POINT (0.81488 -77356)
2018,Marzo,Federación de Rusia,4,9,,13,POINT (10406342 -75527794)
2018,Marzo,Federación de Rusia,32,18,,50,POINT (10446304 -75516486)
2018,Marzo,Federación de Rusia,1,0,,1,POINT (10886686 -74776479)
2018,Marzo,Federación de Rusia,0,5,,5,POINT (10970933 -74765343)
2018,Marzo,Federación de Rusia,1,2,,3,POINT (11360029 -72129595)
2018,Marzo,Federación de Rusia,2,0,,2,POINT (125862 -81702165)
2018,Marzo,Federación de Rusia,6,5,,11,POINT (3451668 -76532004)
2018,Marzo,Federación de Rusia,0,4,,4,POINT (3884426 -77061029)
2018,Marzo,Federación de Rusia,150,207,,357,POINT (4697157 -74140516)
2018,Marzo,Federación de Rusia,0,1,,1,POINT (4815189 -75736374)
2018,Marzo,Federación de Rusia,15,17,,32,POINT (6170465 -7542726)
2018,Marzo,Federación de Rusia,1,0,,1,POINT (7128047 -73181317)
2018,Marzo,Federación de Rusia,0,1,,1,POINT (7819 -72453013)
2018,Marzo,Federación de Rusia,1,0,,1,POINT (836068 -72409396)
2018,Marzo,Federación de Rusia,0,1,,1,POINT (9402597 -75681642)
2018,Marzo,Rwanda,0,1,,1,POINT (3451668 -76532004)
2018,Marzo,San Cristóbal y Nevis,0,2,,2,POINT (10446304 -75516486)
2018,Marzo,San Cristóbal y Nevis,0,1,,1,POINT (3451668 -76532004)
2018,Marzo,San Cristóbal y Nevis,2,3,,5,POINT (4697157 -74140516)
2018,Marzo,San Cristóbal y Nevis,0,1,,1,POINT (6170465 -7542726)
2018,Marzo,San Cristóbal y Nevis,1,0,,1,POINT (7819 -72453013)
2018,Marzo,San Marino,0,1,,1,POINT (10446304 -75516486)
2018,Marzo,San Marino,1,2,,3,POINT (4697157 -74140516)
2018,Marzo,San  Vicente y las Granadinas,1,0,,1,POINT (10446304 -75516486)
2018,Marzo,San  Vicente y las Granadinas,1,1,,2,POINT (4697157 -74140516)
2018,Marzo,Santa Lucia,1,6,,7,POINT (10886686 -74776479)
2018,Marzo,Santa Lucia,1,0,,1,POINT (133387613 -81372937)
2018,Marzo,Santa Lucia,0,2,,2,POINT (3451668 -76532004)
2018,Marzo,Santa Lucia,1,3,,4,POINT (4697157 -74140516)
2018,Marzo,Santa Lucia,0,1,,1,POINT (6170465 -7542726)
2018,Marzo,Santa Sede/Ciudad del Vaticano,1,0,,1,POINT (4697157 -74140516)
2018,Marzo,Senegal,2,7,,9,POINT (4697157 -74140516)
2018,Marzo,Serbia,0,1,,1,POINT (0.81488 -77356)
2018,Marzo,Serbia,0,1,,1,POINT (10406342 -75527794)
2018,Marzo,Serbia,1,2,,3,POINT (10446304 -75516486)
2018,Marzo,Serbia,0,1,,1,POINT (3451668 -76532004)
2018,Marzo,Serbia,11,21,,32,POINT (4697157 -74140516)
2018,Marzo,Serbia,0,2,,2,POINT (6170465 -7542726)
2018,Marzo,Sierra Leona,0,1,,1,POINT (4697157 -74140516)
2018,Marzo,Singapur,1,0,,1,POINT (10406342 -75527794)
2018,Marzo,Singapur,4,5,,9,POINT (10446304 -75516486)
2018,Marzo,Singapur,27,26,,53,POINT (4697157 -74140516)
2018,Marzo,Singapur,4,11,,15,POINT (6170465 -7542726)
2018,Marzo,Singapur,0,1,,1,POINT (9402597 -75681642)
2018,Marzo,República Árabe Siria,0,1,,1,POINT (10446304 -75516486)
2018,Marzo,República Árabe Siria,1,0,,1,POINT (11360029 -72129595)
2018,Marzo,República Árabe Siria,0,1,,1,POINT (3451668 -76532004)
2018,Marzo,República Árabe Siria,0,3,,3,POINT (4697157 -74140516)
2018,Marzo,Sri Lanka,0,2,,2,POINT (10406342 -75527794)
2018,Marzo,Sri Lanka,0,1,,1,POINT (10446304 -75516486)
2018,Marzo,Sri Lanka,0,1,,1,POINT (3884426 -77061029)
2018,Marzo,Sri Lanka,1,2,,3,POINT (4697157 -74140516)
2018,Marzo,Sudáfrica,1,1,,2,POINT (0.81488 -77356)
2018,Marzo,Sudáfrica,3,5,,8,POINT (10406342 -75527794)
2018,Marzo,Sudáfrica,5,4,,9,POINT (10446304 -75516486)
2018,Marzo,Sudáfrica,1,3,,4,POINT (10886686 -74776479)
2018,Marzo,Sudáfrica,1,0,,1,POINT (11360029 -72129595)
2018,Marzo,Sudáfrica,2,1,,3,POINT (3451668 -76532004)
2018,Marzo,Sudáfrica,41,59,,100,POINT (4697157 -74140516)
2018,Marzo,Sudáfrica,2,4,,6,POINT (6170465 -7542726)
2018,Marzo,Sudáfrica,0,1,,1,POINT (7128047 -73181317)
2018,Marzo,Sudáfrica,0,2,,2,POINT (7819 -72453013)
2018,Marzo,Sudán,1,1,,2,POINT (4697157 -74140516)
2018,Marzo,Sudán,1,0,,1,POINT (6170465 -7542726)
2018,Marzo,Suecia,6,0,,6,POINT (-4191162 -69941498)
2018,Marzo,Suecia,2,2,,4,POINT (-4214082 -69941431)
2018,Marzo,Suecia,5,2,,7,POINT (0.33002 -76876446)
2018,Marzo,Suecia,9,10,,19,POINT (0.81488 -77356)
2018,Marzo,Suecia,18,15,,33,POINT (10406342 -75527794)
2018,Marzo,Suecia,66,65,,131,POINT (10446304 -75516486)
2018,Marzo,Suecia,4,6,,10,POINT (10886686 -74776479)
2018,Marzo,Suecia,4,9,,13,POINT (11247723 -74213989)
2018,Marzo,Suecia,0,4,,4,POINT (125862 -81702165)
2018,Marzo,Suecia,1,3,,4,POINT (133387613 -81372937)
2018,Marzo,Suecia,18,10,,28,POINT (3451668 -76532004)
2018,Marzo,Suecia,0,1,,1,POINT (445285 -75766353)
2018,Marzo,Suecia,218,296,,514,POINT (4697157 -74140516)
2018,Marzo,Suecia,0,2,,2,POINT (4815189 -75736374)
2018,Marzo,Suecia,36,51,,87,POINT (6170465 -7542726)
2018,Marzo,Suecia,1,0,,1,POINT (7128047 -73181317)
2018,Marzo,Suecia,0,3,,3,POINT (7819 -72453013)
2018,Marzo,Suecia,3,0,,3,POINT (863337 -7735002)
2018,Marzo,Suiza,4,1,,5,POINT (-4191162 -69941498)
2018,Marzo,Suiza,3,1,,4,POINT (-4214082 -69941431)
2018,Marzo,Suiza,3,1,,4,POINT (0.33002 -76876446)
2018,Marzo,Suiza,31,38,,69,POINT (0.81488 -77356)
2018,Marzo,Suiza,21,22,,43,POINT (10406342 -75527794)
2018,Marzo,Suiza,65,54,,119,POINT (10446304 -75516486)
2018,Marzo,Suiza,7,8,,15,POINT (10886686 -74776479)
2018,Marzo,Suiza,1,2,,3,POINT (11247723 -74213989)
2018,Marzo,Suiza,1,0,,1,POINT (11360029 -72129595)
2018,Marzo,Suiza,1,1,,2,POINT (125744111 -81703935)
2018,Marzo,Suiza,1,0,,1,POINT (125862 -81702165)
2018,Marzo,Suiza,22,27,,49,POINT (3451668 -76532004)
2018,Marzo,Suiza,0,2,,2,POINT (3884426 -77061029)
2018,Marzo,Suiza,544,770,,1314,POINT (4697157 -74140516)
2018,Marzo,Suiza,1,2,,3,POINT (4815189 -75736374)
2018,Marzo,Suiza,57,97,,154,POINT (6170465 -7542726)
2018,Marzo,Suiza,1,1,,2,POINT (7819 -72453013)
2018,Marzo,Suiza,0,1,,1,POINT (836068 -72409396)
2018,Marzo,Suiza,7,5,,12,POINT (863337 -7735002)
2018,Marzo,Surinam,16,25,,41,POINT (4697157 -74140516)
2018,Marzo,Surinam,0,1,,1,POINT (6170465 -7542726)
2018,Marzo,Surinam,1,1,,2,POINT (7128047 -73181317)
2018,Marzo,Suazilandia,2,0,,2,POINT (4697157 -74140516)
2018,Marzo,Taiwán,1,0,,1,POINT (4697157 -74140516)
2018,Marzo,Tailandia,1,0,,1,POINT (0.81488 -77356)
2018,Marzo,Tailandia,3,1,,4,POINT (10446304 -75516486)
2018,Marzo,Tailandia,19,24,,43,POINT (4697157 -74140516)
2018,Marzo,Tailandia,2,3,,5,POINT (6170465 -7542726)
2018,Marzo,Tanzania,4,4,,8,POINT (4697157 -74140516)
2018,Marzo,Tanzania,1,0,,1,POINT (6170465 -7542726)
2018,Marzo,Togo,1,1,,2,POINT (4697157 -74140516)
2018,Marzo,Togo,0,1,,1,POINT (6170465 -7542726)
2018,Marzo,Trinidad y Tobago,2,1,,3,POINT (0.81488 -77356)
2018,Marzo,Trinidad y Tobago,3,9,,12,POINT (10446304 -75516486)
2018,Marzo,Trinidad y Tobago,2,12,,14,POINT (10886686 -74776479)
2018,Marzo,Trinidad y Tobago,0,1,,1,POINT (11360029 -72129595)
2018,Marzo,Trinidad y Tobago,1,10,,11,POINT (3451668 -76532004)
2018,Marzo,Trinidad y Tobago,24,43,,67,POINT (4697157 -74140516)
2018,Marzo,Trinidad y Tobago,0,2,,2,POINT (4815189 -75736374)
2018,Marzo,Trinidad y Tobago,8,14,,22,POINT (6170465 -7542726)
2018,Marzo,Trinidad y Tobago,0,1,,1,POINT (7819 -72453013)
2018,Marzo,Túnez,0,1,,1,POINT (0.81488 -77356)
2018,Marzo,Túnez,1,0,,1,POINT (3451668 -76532004)
2018,Marzo,Túnez,3,6,,9,POINT (4697157 -74140516)
2018,Marzo,Túnez,0,1,,1,POINT (6170465 -7542726)
2018,Marzo,Turquía,0,2,,2,POINT (-4214082 -69941431)
2018,Marzo,Turquía,4,6,,10,POINT (0.81488 -77356)
2018,Marzo,Turquía,0,4,,4,POINT (10406342 -75527794)
2018,Marzo,Turquía,13,20,,33,POINT (10446304 -75516486)
2018,Marzo,Turquía,0,1,,1,POINT (10886686 -74776479)
2018,Marzo,Turquía,0,7,,7,POINT (11247723 -74213989)
2018,Marzo,Turquía,3,4,,7,POINT (3451668 -76532004)
2018,Marzo,Turquía,236,424,,660,POINT (4697157 -74140516)
2018,Marzo,Turquía,5,9,,14,POINT (6170465 -7542726)
2018,Marzo,Turquía,0,2,,2,POINT (7819 -72453013)
2018,Marzo,Turquía,0,5,,5,POINT (9402597 -75681642)
2018,Marzo,Ucrania,1,0,,1,POINT (0.81488 -77356)
2018,Marzo,Ucrania,0,8,,8,POINT (10406342 -75527794)
2018,Marzo,Ucrania,2,7,,9,POINT (10446304 -75516486)
2018,Marzo,Ucrania,0,7,,7,POINT (10886686 -74776479)
2018,Marzo,Ucrania,0,6,,6,POINT (10970933 -74765343)
2018,Marzo,Ucrania,0,4,,4,POINT (11247723 -74213989)
2018,Marzo,Ucrania,0,2,,2,POINT (3451668 -76532004)
2018,Marzo,Ucrania,32,20,,52,POINT (4697157 -74140516)
2018,Marzo,Ucrania,3,1,,4,POINT (6170465 -7542726)
2018,Marzo,Uganda,1,0,,1,POINT (0.81488 -77356)
2018,Marzo,Uganda,0,2,,2,POINT (4697157 -74140516)
2018,Marzo,Uganda,1,0,,1,POINT (6170465 -7542726)
2018,Marzo,Uruguay,1,2,,3,POINT (-4214082 -69941431)
2018,Marzo,Uruguay,3,2,,5,POINT (0.33002 -76876446)
2018,Marzo,Uruguay,0,1,,1,POINT (0.812436 -77847006)
2018,Marzo,Uruguay,5,11,,16,POINT (0.81488 -77356)
2018,Marzo,Uruguay,19,15,,34,POINT (10406342 -75527794)
2018,Marzo,Uruguay,110,90,,200,POINT (10446304 -75516486)
2018,Marzo,Uruguay,2,6,,8,POINT (10886686 -74776479)
2018,Marzo,Uruguay,18,21,,39,POINT (125862 -81702165)
2018,Marzo,Uruguay,0,1,,1,POINT (133387613 -81372937)
2018,Marzo,Uruguay,14,23,,37,POINT (3451668 -76532004)
2018,Marzo,Uruguay,552,685,,1237,POINT (4697157 -74140516)
2018,Marzo,Uruguay,0,1,,1,POINT (4815189 -75736374)
2018,Marzo,Uruguay,40,74,,114,POINT (6170465 -7542726)
2018,Marzo,Uruguay,2,2,,4,POINT (7819 -72453013)
2018,Marzo,Uruguay,0,1,,1,POINT (836068 -72409396)
2018,Marzo,Uzbekistán,0,7,,7,POINT (4697157 -74140516)
2018,Marzo,Vanuatu,1,0,,1,POINT (10406342 -75527794)
2018,Marzo,Venezuela,3,3,,6,POINT (-4191162 -69941498)
2018,Marzo,Venezuela,1,1,,2,POINT (-4214082 -69941431)
2018,Marzo,Venezuela,20,32,,52,POINT (0.33002 -76876446)
2018,Marzo,Venezuela,2,1,,3,POINT (0.812436 -77847006)
2018,Marzo,Venezuela,1552,2092,,3644,POINT (0.81488 -77356)
2018,Marzo,Venezuela,1,2,,3,POINT (1800143 -78802679)
2018,Marzo,Venezuela,17,14,,31,POINT (10406342 -75527794)
2018,Marzo,Venezuela,172,191,,363,POINT (10446304 -75516486)
2018,Marzo,Venezuela,116,191,,307,POINT (10886686 -74776479)
2018,Marzo,Venezuela,0,5,,5,POINT (10970933 -74765343)
2018,Marzo,Venezuela,9,21,,30,POINT (11117206 -74232675)
2018,Marzo,Venezuela,8988,10090,,19078,POINT (11360029 -72129595)
2018,Marzo,Venezuela,0,1,,1,POINT (1152863 -72919186)
2018,Marzo,Venezuela,0,8,,8,POINT (12165168 -71983761)
2018,Marzo,Venezuela,3,1,,4,POINT (125862 -81702165)
2018,Marzo,Venezuela,0,1,,1,POINT (133387613 -81372937)
2018,Marzo,Venezuela,101,109,,210,POINT (3451668 -76532004)
2018,Marzo,Venezuela,10,15,,25,POINT (3866713 -67927521)
2018,Marzo,Venezuela,3,1,,4,POINT (445285 -75766353)
2018,Marzo,Venezuela,5215,5546,,10761,POINT (4697157 -74140516)
2018,Marzo,Venezuela,9,9,,18,POINT (4815189 -75736374)
2018,Marzo,Venezuela,883,896,,1779,POINT (6170465 -7542726)
2018,Marzo,Venezuela,53,64,,117,POINT (6185536 -67484028)
2018,Marzo,Venezuela,892,1080,,1972,POINT (7088729 -70740253)
2018,Marzo,Venezuela,6,17,,23,POINT (7128047 -73181317)
2018,Marzo,Venezuela,32599,41798,,74397,POINT (7819 -72453013)
2018,Marzo,Venezuela,0,6,,6,POINT (7927233 -72508188)
2018,Marzo,Venezuela,2618,2992,,5610,POINT (836068 -72409396)
2018,Marzo,Vietnam,0,1,,1,POINT (10406342 -75527794)
2018,Marzo,Vietnam,5,2,,7,POINT (10446304 -75516486)
2018,Marzo,Vietnam,13,11,,24,POINT (4697157 -74140516)
2018,Marzo,República Árabe de Yemen,1,4,,5,POINT (0.81488 -77356)
2018,Marzo,Zambia,3,0,,3,POINT (4697157 -74140516)
2018,Marzo,Zimbabue,0,3,,3,POINT (4697157 -74140516)
2018,Marzo,Zimbabue,1,1,,2,POINT (6170465 -7542726)
2018,Marzo,Refugiado,0,1,,1,POINT (0.81488 -77356)
2018,Marzo,Refugiado,0,1,,1,POINT (125862 -81702165)
2018,Marzo,Refugiado,3,10,,13,POINT (4697157 -74140516)
2018,Marzo,Desconocido,1,0,,1,POINT (0.33002 -76876446)
2018,Marzo,Desconocido,1,2,,3,POINT (10446304 -75516486)
2018,Marzo,Desconocido,0,1,,1,POINT (3451668 -76532004)
2018,Marzo,Desconocido,80,132,,212,POINT (4697157 -74140516)
2018,Marzo,Desconocido,10,10,,20,POINT (6170465 -7542726)
2018,Marzo,Desconocido,1,2,,3,POINT (7088729 -70740253)
2018,Marzo,Desconocido,1,2,,3,POINT (7819 -72453013)
2018,Abril,Afganistán,0,1,,1,POINT (3451668 -76532004)
2018,Abril,Albania,1,0,,1,POINT (10406342 -75527794)
2018,Abril,Albania,0,1,,1,POINT (10446304 -75516486)
2018,Abril,Albania,2,1,,3,POINT (4697157 -74140516)
2018,Abril,Albania,0,1,,1,POINT (6170465 -7542726)
2018,Abril,Alemania,11,9,,20,POINT (-4191162 -69941498)
2018,Abril,Alemania,21,24,,45,POINT (-4214082 -69941431)
2018,Abril,Alemania,8,8,,16,POINT (0.33002 -76876446)
2018,Abril,Alemania,77,85,,162,POINT (0.81488 -77356)
2018,Abril,Alemania,39,51,,90,POINT (10406342 -75527794)
2018,Abril,Alemania,125,176,,301,POINT (10446304 -75516486)
2018,Abril,Alemania,17,15,,32,POINT (10886686 -74776479)
2018,Abril,Alemania,1,2,,3,POINT (11360029 -72129595)
2018,Abril,Alemania,1,0,,1,POINT (125744111 -81703935)
2018,Abril,Alemania,5,1,,6,POINT (125862 -81702165)
2018,Abril,Alemania,1,0,,1,POINT (133387613 -81372937)
2018,Abril,Alemania,49,76,,125,POINT (3451668 -76532004)
2018,Abril,Alemania,0,4,,4,POINT (3884426 -77061029)
2018,Abril,Alemania,0,2,,2,POINT (445285 -75766353)
2018,Abril,Alemania,1515,2391,,3906,POINT (4697157 -74140516)
2018,Abril,Alemania,2,8,,10,POINT (4815189 -75736374)
2018,Abril,Alemania,131,251,,382,POINT (6170465 -7542726)
2018,Abril,Alemania,1,2,,3,POINT (6185536 -67484028)
2018,Abril,Alemania,1,0,,1,POINT (7102626 -77762647)
2018,Abril,Alemania,0,1,,1,POINT (7128047 -73181317)
2018,Abril,Alemania,2,6,,8,POINT (7819 -72453013)
2018,Abril,Alemania,0,3,,3,POINT (836068 -72409396)
2018,Abril,Alemania,10,14,,24,POINT (863337 -7735002)
2018,Abril,Andorra,1,0,,1,POINT (0.81488 -77356)
2018,Abril,Andorra,1,7,,8,POINT (4697157 -74140516)
2018,Abril,Antigua y Barbuda,0,1,,1,POINT (10886686 -74776479)
2018,Abril,Antigua y Barbuda,1,5,,6,POINT (4697157 -74140516)
2018,Abril,Arabia Saudita,1,4,,5,POINT (4697157 -74140516)
2018,Abril,Arabia Saudita,0,2,,2,POINT (6170465 -7542726)
2018,Abril,Argelia,0,1,,1,POINT (10446304 -75516486)
2018,Abril,Argelia,1,4,,5,POINT (4697157 -74140516)
2018,Abril,Argentina,9,19,,28,POINT (-4191162 -69941498)
2018,Abril,Argentina,7,8,,15,POINT (-4214082 -69941431)
2018,Abril,Argentina,12,20,,32,POINT (0.33002 -76876446)
2018,Abril,Argentina,1,1,,2,POINT (0.812436 -77847006)
2018,Abril,Argentina,81,152,,233,POINT (0.81488 -77356)
2018,Abril,Argentina,0,1,,1,POINT (1800143 -78802679)
2018,Abril,Argentina,414,256,,670,POINT (10406342 -75527794)
2018,Abril,Argentina,0,1,,1,POINT (10433609 -73247863)
2018,Abril,Argentina,2461,1683,,4144,POINT (10446304 -75516486)
2018,Abril,Argentina,20,115,,135,POINT (10886686 -74776479)
2018,Abril,Argentina,7,8,,15,POINT (11360029 -72129595)
2018,Abril,Argentina,432,322,,754,POINT (125862 -81702165)
2018,Abril,Argentina,1,2,,3,POINT (133387613 -81372937)
2018,Abril,Argentina,39,59,,98,POINT (3451668 -76532004)
2018,Abril,Argentina,6889,7982,,14871,POINT (4697157 -74140516)
2018,Abril,Argentina,7,19,,26,POINT (4815189 -75736374)
2018,Abril,Argentina,251,378,,629,POINT (6170465 -7542726)
2018,Abril,Argentina,2,3,,5,POINT (7128047 -73181317)
2018,Abril,Argentina,13,15,,28,POINT (7819 -72453013)
2018,Abril,Argentina,3,2,,5,POINT (836068 -72409396)
2018,Abril,Argentina,4,1,,5,POINT (863337 -7735002)
2018,Abril,República de Armenia,3,3,,6,POINT (4697157 -74140516)
2018,Abril,Aruba,2,0,,2,POINT (4697157 -74140516)
2018,Abril,Australia,3,2,,5,POINT (-4191162 -69941498)
2018,Abril,Australia,3,2,,5,POINT (-4214082 -69941431)
2018,Abril,Australia,3,2,,5,POINT (0.33002 -76876446)
2018,Abril,Australia,19,15,,34,POINT (0.81488 -77356)
2018,Abril,Australia,8,21,,29,POINT (10406342 -75527794)
2018,Abril,Australia,59,67,,126,POINT (10446304 -75516486)
2018,Abril,Australia,7,22,,29,POINT (10886686 -74776479)
2018,Abril,Australia,1,1,,2,POINT (11247723 -74213989)
2018,Abril,Australia,0,1,,1,POINT (125744111 -81703935)
2018,Abril,Australia,0,1,,1,POINT (125862 -81702165)
2018,Abril,Australia,9,13,,22,POINT (3451668 -76532004)
2018,Abril,Australia,300,465,,765,POINT (4697157 -74140516)
2018,Abril,Australia,0,1,,1,POINT (4815189 -75736374)
2018,Abril,Australia,50,96,,146,POINT (6170465 -7542726)
2018,Abril,Australia,0,1,,1,POINT (7128047 -73181317)
2018,Abril,Australia,0,1,,1,POINT (7819 -72453013)
2018,Abril,Australia,5,10,,15,POINT (863337 -7735002)
2018,Abril,Austria,2,0,,2,POINT (-4214082 -69941431)
2018,Abril,Austria,2,3,,5,POINT (0.33002 -76876446)
2018,Abril,Austria,11,12,,23,POINT (0.81488 -77356)
2018,Abril,Austria,3,3,,6,POINT (10406342 -75527794)
2018,Abril,Austria,12,17,,29,POINT (10446304 -75516486)
2018,Abril,Austria,1,6,,7,POINT (10886686 -74776479)
2018,Abril,Austria,2,6,,8,POINT (3451668 -76532004)
2018,Abril,Austria,147,222,,369,POINT (4697157 -74140516)
2018,Abril,Austria,13,26,,39,POINT (6170465 -7542726)
2018,Abril,Austria,0,1,,1,POINT (863337 -7735002)
2018,Abril,Azerbaiyán,1,2,,3,POINT (4697157 -74140516)
2018,Abril,Azerbaiyán,1,0,,1,POINT (6170465 -7542726)
2018,Abril,Bahamas,5,7,,12,POINT (10446304 -75516486)
2018,Abril,Bahamas,0,1,,1,POINT (10886686 -74776479)
2018,Abril,Bahamas,5,1,,6,POINT (3451668 -76532004)
2018,Abril,Bahamas,3,8,,11,POINT (4697157 -74140516)
2018,Abril,Bahamas,4,1,,5,POINT (6170465 -7542726)
2018,Abril,Bahréin,0,1,,1,POINT (4697157 -74140516)
2018,Abril,Bangladesh,0,1,,1,POINT (10970933 -74765343)
2018,Abril,Bangladesh,0,3,,3,POINT (4697157 -74140516)
2018,Abril,Bangladesh,0,1,,1,POINT (6170465 -7542726)
2018,Abril,Barbados,3,3,,6,POINT (10446304 -75516486)
2018,Abril,Barbados,2,2,,4,POINT (10886686 -74776479)
2018,Abril,Barbados,0,2,,2,POINT (3451668 -76532004)
2018,Abril,Barbados,9,12,,21,POINT (4697157 -74140516)
2018,Abril,República de Belarús,0,1,,1,POINT (10406342 -75527794)
2018,Abril,República de Belarús,1,0,,1,POINT (10446304 -75516486)
2018,Abril,República de Belarús,2,6,,8,POINT (4697157 -74140516)
2018,Abril,Bélgica,3,2,,5,POINT (-4214082 -69941431)
2018,Abril,Bélgica,0,1,,1,POINT (0.33002 -76876446)
2018,Abril,Bélgica,10,13,,23,POINT (0.81488 -77356)
2018,Abril,Bélgica,3,3,,6,POINT (10406342 -75527794)
2018,Abril,Bélgica,34,51,,85,POINT (10446304 -75516486)
2018,Abril,Bélgica,0,6,,6,POINT (10886686 -74776479)
2018,Abril,Bélgica,0,4,,4,POINT (10970933 -74765343)
2018,Abril,Bélgica,0,1,,1,POINT (11360029 -72129595)
2018,Abril,Bélgica,1,3,,4,POINT (133387613 -81372937)
2018,Abril,Bélgica,8,17,,25,POINT (3451668 -76532004)
2018,Abril,Bélgica,182,404,,586,POINT (4697157 -74140516)
2018,Abril,Bélgica,21,38,,59,POINT (6170465 -7542726)
2018,Abril,Belice,0,1,,1,POINT (10446304 -75516486)
2018,Abril,Belice,0,1,,1,POINT (10886686 -74776479)
2018,Abril,Belice,0,2,,2,POINT (3451668 -76532004)
2018,Abril,Belice,8,11,,19,POINT (4697157 -74140516)
2018,Abril,Belice,0,3,,3,POINT (6170465 -7542726)
2018,Abril,Belice,0,3,,3,POINT (7819 -72453013)
2018,Abril,Bermudas/Territorio Británico de Ultramar,1,0,,1,POINT (10446304 -75516486)
2018,Abril,Bermudas/Territorio Británico de Ultramar,0,1,,1,POINT (4697157 -74140516)
2018,Abril,Bolivia,1,0,,1,POINT (0.812436 -77847006)
2018,Abril,Bolivia,17,10,,27,POINT (0.81488 -77356)
2018,Abril,Bolivia,26,22,,48,POINT (10406342 -75527794)
2018,Abril,Bolivia,126,97,,223,POINT (10446304 -75516486)
2018,Abril,Bolivia,5,7,,12,POINT (10886686 -74776479)
2018,Abril,Bolivia,23,18,,41,POINT (125862 -81702165)
2018,Abril,Bolivia,9,12,,21,POINT (3451668 -76532004)
2018,Abril,Bolivia,478,596,,1074,POINT (4697157 -74140516)
2018,Abril,Bolivia,4,1,,5,POINT (4815189 -75736374)
2018,Abril,Bolivia,35,60,,95,POINT (6170465 -7542726)
2018,Abril,Bolivia,0,1,,1,POINT (6185536 -67484028)
2018,Abril,Bolivia,0,1,,1,POINT (7128047 -73181317)
2018,Abril,Bolivia,17,12,,29,POINT (7819 -72453013)
2018,Abril,Bolivia,1,3,,4,POINT (836068 -72409396)
2018,Abril,Bosnia y Herzegovina,0,1,,1,POINT (10446304 -75516486)
2018,Abril,Bosnia y Herzegovina,5,11,,16,POINT (4697157 -74140516)
2018,Abril,Bosnia y Herzegovina,1,0,,1,POINT (6170465 -7542726)
2018,Abril,Brasil,92,133,,225,POINT (-4191162 -69941498)
2018,Abril,Brasil,4,5,,9,POINT (-4214082 -69941431)
2018,Abril,Brasil,0,2,,2,POINT (0.33002 -76876446)
2018,Abril,Brasil,27,40,,67,POINT (0.81488 -77356)
2018,Abril,Brasil,705,460,,1165,POINT (10406342 -75527794)
2018,Abril,Brasil,1209,832,,2041,POINT (10446304 -75516486)
2018,Abril,Brasil,11,19,,30,POINT (10886686 -74776479)
2018,Abril,Brasil,0,1,,1,POINT (11117206 -74232675)
2018,Abril,Brasil,3,1,,4,POINT (11360029 -72129595)
2018,Abril,Brasil,414,328,,742,POINT (125862 -81702165)
2018,Abril,Brasil,33,74,,107,POINT (3451668 -76532004)
2018,Abril,Brasil,1,5,,6,POINT (3866713 -67927521)
2018,Abril,Brasil,1,0,,1,POINT (445285 -75766353)
2018,Abril,Brasil,5778,6897,,12675,POINT (4697157 -74140516)
2018,Abril,Brasil,4,3,,7,POINT (4815189 -75736374)
2018,Abril,Brasil,124,267,,391,POINT (6170465 -7542726)
2018,Abril,Brasil,0,2,,2,POINT (7128047 -73181317)
2018,Abril,Brasil,9,11,,20,POINT (7819 -72453013)
2018,Abril,Brasil,3,6,,9,POINT (836068 -72409396)
2018,Abril,Bulgaria,0,1,,1,POINT (-4191162 -69941498)
2018,Abril,Bulgaria,2,0,,2,POINT (0.81488 -77356)
2018,Abril,Bulgaria,0,1,,1,POINT (10406342 -75527794)
2018,Abril,Bulgaria,5,3,,8,POINT (10446304 -75516486)
2018,Abril,Bulgaria,0,1,,1,POINT (10886686 -74776479)
2018,Abril,Bulgaria,1,0,,1,POINT (11360029 -72129595)
2018,Abril,Bulgaria,3,3,,6,POINT (3451668 -76532004)
2018,Abril,Bulgaria,54,55,,109,POINT (4697157 -74140516)
2018,Abril,Bulgaria,4,10,,14,POINT (6170465 -7542726)
2018,Abril,Burkina Faso,0,2,,2,POINT (4697157 -74140516)
2018,Abril,Cabo Verde,0,5,,5,POINT (10406342 -75527794)
2018,Abril,Cabo Verde,1,5,,6,POINT (4697157 -74140516)
2018,Abril,Cabo Verde,1,0,,1,POINT (6170465 -7542726)
2018,Abril,Islas Caimán/Territorio Británico de Ultramar,0,1,,1,POINT (10446304 -75516486)
2018,Abril,Islas Caimán/Territorio Británico de Ultramar,0,1,,1,POINT (10886686 -74776479)
2018,Abril,Islas Caimán/Territorio Británico de Ultramar,1,0,,1,POINT (3451668 -76532004)
2018,Abril,Islas Caimán/Territorio Británico de Ultramar,0,1,,1,POINT (6170465 -7542726)
2018,Abril,Camerún,1,1,,2,POINT (4697157 -74140516)
2018,Abril,Canadá,2,1,,3,POINT (-4191162 -69941498)
2018,Abril,Canadá,1,1,,2,POINT (-4214082 -69941431)
2018,Abril,Canadá,0,1,,1,POINT (0.812436 -77847006)
2018,Abril,Canadá,15,16,,31,POINT (0.81488 -77356)
2018,Abril,Canadá,8,8,,16,POINT (10406342 -75527794)
2018,Abril,Canadá,0,1,,1,POINT (10433609 -73247863)
2018,Abril,Canadá,299,363,,662,POINT (10446304 -75516486)
2018,Abril,Canadá,17,52,,69,POINT (10886686 -74776479)
2018,Abril,Canadá,1,1,,2,POINT (11360029 -72129595)
2018,Abril,Canadá,1,4,,5,POINT (125744111 -81703935)
2018,Abril,Canadá,4,3,,7,POINT (125862 -81702165)
2018,Abril,Canadá,1,2,,3,POINT (133387613 -81372937)
2018,Abril,Canadá,39,61,,100,POINT (3451668 -76532004)
2018,Abril,Canadá,2,4,,6,POINT (445285 -75766353)
2018,Abril,Canadá,1080,1766,,2846,POINT (4697157 -74140516)
2018,Abril,Canadá,5,12,,17,POINT (4815189 -75736374)
2018,Abril,Canadá,225,547,,772,POINT (6170465 -7542726)
2018,Abril,Canadá,4,3,,7,POINT (7128047 -73181317)
2018,Abril,Canadá,1,2,,3,POINT (7819 -72453013)
2018,Abril,Canadá,7,11,,18,POINT (863337 -7735002)
2018,Abril,República Democrática del Congo,3,4,,7,POINT (4697157 -74140516)
2018,Abril,República Democrática del Congo,0,1,,1,POINT (7819 -72453013)
2018,Abril,República de Corea,13,11,,24,POINT (0.81488 -77356)
2018,Abril,República de Corea,5,5,,10,POINT (10446304 -75516486)
2018,Abril,República de Corea,2,2,,4,POINT (10886686 -74776479)
2018,Abril,República de Corea,239,450,,689,POINT (4697157 -74140516)
2018,Abril,República de Corea,1,5,,6,POINT (4815189 -75736374)
2018,Abril,República de Corea,8,34,,42,POINT (6170465 -7542726)
2018,Abril,República de Corea,0,1,,1,POINT (7819 -72453013)
2018,Abril,República de Corea,0,1,,1,POINT (836068 -72409396)
2018,Abril,Costa de Marfil,3,0,,3,POINT (4697157 -74140516)
2018,Abril,Costa Rica,0,1,,1,POINT (0.33002 -76876446)
2018,Abril,Costa Rica,1,2,,3,POINT (0.81488 -77356)
2018,Abril,Costa Rica,169,176,,345,POINT (10446304 -75516486)
2018,Abril,Costa Rica,31,28,,59,POINT (10886686 -74776479)
2018,Abril,Costa Rica,1,1,,2,POINT (11360029 -72129595)
2018,Abril,Costa Rica,20,21,,41,POINT (125862 -81702165)
2018,Abril,Costa Rica,35,40,,75,POINT (3451668 -76532004)
2018,Abril,Costa Rica,0,1,,1,POINT (445285 -75766353)
2018,Abril,Costa Rica,1568,1966,,3534,POINT (4697157 -74140516)
2018,Abril,Costa Rica,8,15,,23,POINT (4815189 -75736374)
2018,Abril,Costa Rica,187,225,,412,POINT (6170465 -7542726)
2018,Abril,Costa Rica,2,2,,4,POINT (7128047 -73181317)
2018,Abril,Costa Rica,0,3,,3,POINT (7819 -72453013)
2018,Abril,Croacia,0,1,,1,POINT (10406342 -75527794)
2018,Abril,Croacia,1,5,,6,POINT (10446304 -75516486)
2018,Abril,Croacia,0,3,,3,POINT (10886686 -74776479)
2018,Abril,Croacia,0,6,,6,POINT (10970933 -74765343)
2018,Abril,Croacia,0,1,,1,POINT (3451668 -76532004)
2018,Abril,Croacia,23,44,,67,POINT (4697157 -74140516)
2018,Abril,Croacia,1,5,,6,POINT (6170465 -7542726)
2018,Abril,Cuba,0,4,,4,POINT (0.81488 -77356)
2018,Abril,Cuba,0,3,,3,POINT (10406342 -75527794)
2018,Abril,Cuba,16,18,,34,POINT (10446304 -75516486)
2018,Abril,Cuba,5,22,,27,POINT (10886686 -74776479)
2018,Abril,Cuba,1,0,,1,POINT (11360029 -72129595)
2018,Abril,Cuba,14,23,,37,POINT (3451668 -76532004)
2018,Abril,Cuba,0,1,,1,POINT (3884426 -77061029)
2018,Abril,Cuba,0,1,,1,POINT (445285 -75766353)
2018,Abril,Cuba,240,331,,571,POINT (4697157 -74140516)
2018,Abril,Cuba,2,2,,4,POINT (4815189 -75736374)
2018,Abril,Cuba,21,21,,42,POINT (6170465 -7542726)
2018,Abril,Cuba,0,1,,1,POINT (7088729 -70740253)
2018,Abril,Cuba,0,2,,2,POINT (7128047 -73181317)
2018,Abril,Cuba,2,2,,4,POINT (7819 -72453013)
2018,Abril,Curazao,0,2,,2,POINT (4697157 -74140516)
2018,Abril,República Checa,0,2,,2,POINT (-4214082 -69941431)
2018,Abril,República Checa,4,6,,10,POINT (0.81488 -77356)
2018,Abril,República Checa,1,0,,1,POINT (10406342 -75527794)
2018,Abril,República Checa,9,11,,20,POINT (10446304 -75516486)
2018,Abril,República Checa,1,1,,2,POINT (10886686 -74776479)
2018,Abril,República Checa,3,0,,3,POINT (3451668 -76532004)
2018,Abril,República Checa,63,115,,178,POINT (4697157 -74140516)
2018,Abril,República Checa,2,9,,11,POINT (6170465 -7542726)
2018,Abril,República Checa,17,2,,19,POINT (863337 -7735002)
2018,Abril,Chile,0,4,,4,POINT (-4191162 -69941498)
2018,Abril,Chile,4,6,,10,POINT (-4214082 -69941431)
2018,Abril,Chile,2,2,,4,POINT (0.33002 -76876446)
2018,Abril,Chile,1,0,,1,POINT (0.812436 -77847006)
2018,Abril,Chile,44,61,,105,POINT (0.81488 -77356)
2018,Abril,Chile,144,109,,253,POINT (10406342 -75527794)
2018,Abril,Chile,656,541,,1197,POINT (10446304 -75516486)
2018,Abril,Chile,19,24,,43,POINT (10886686 -74776479)
2018,Abril,Chile,0,3,,3,POINT (11247723 -74213989)
2018,Abril,Chile,1,9,,10,POINT (11360029 -72129595)
2018,Abril,Chile,0,1,,1,POINT (125744111 -81703935)
2018,Abril,Chile,150,119,,269,POINT (125862 -81702165)
2018,Abril,Chile,33,54,,87,POINT (3451668 -76532004)
2018,Abril,Chile,1,1,,2,POINT (3884426 -77061029)
2018,Abril,Chile,4229,5462,,9691,POINT (4697157 -74140516)
2018,Abril,Chile,5,5,,10,POINT (4815189 -75736374)
2018,Abril,Chile,91,197,,288,POINT (6170465 -7542726)
2018,Abril,Chile,0,1,,1,POINT (6185536 -67484028)
2018,Abril,Chile,2,2,,4,POINT (7128047 -73181317)
2018,Abril,Chile,17,30,,47,POINT (7819 -72453013)
2018,Abril,Chile,2,9,,11,POINT (836068 -72409396)
2018,Abril,Chile,0,1,,1,POINT (863337 -7735002)
2018,Abril,China,2,1,,3,POINT (-4191162 -69941498)
2018,Abril,China,0,1,,1,POINT (-4214082 -69941431)
2018,Abril,China,0,2,,2,POINT (0.33002 -76876446)
2018,Abril,China,7,10,,17,POINT (0.81488 -77356)
2018,Abril,China,18,16,,34,POINT (10446304 -75516486)
2018,Abril,China,5,14,,19,POINT (10886686 -74776479)
2018,Abril,China,0,2,,2,POINT (10970933 -74765343)
2018,Abril,China,0,2,,2,POINT (11247723 -74213989)
2018,Abril,China,1,0,,1,POINT (11360029 -72129595)
2018,Abril,China,1,0,,1,POINT (125862 -81702165)
2018,Abril,China,4,13,,17,POINT (3451668 -76532004)
2018,Abril,China,0,3,,3,POINT (3866713 -67927521)
2018,Abril,China,400,908,,1308,POINT (4697157 -74140516)
2018,Abril,China,0,1,,1,POINT (4815189 -75736374)
2018,Abril,China,49,79,,128,POINT (6170465 -7542726)
2018,Abril,China,4,7,,11,POINT (7819 -72453013)
2018,Abril,China,1,3,,4,POINT (836068 -72409396)
2018,Abril,Taiwán,3,0,,3,POINT (-4191162 -69941498)
2018,Abril,Taiwán,1,2,,3,POINT (-4214082 -69941431)
2018,Abril,Taiwán,3,0,,3,POINT (0.81488 -77356)
2018,Abril,Taiwán,2,5,,7,POINT (10446304 -75516486)
2018,Abril,Taiwán,2,2,,4,POINT (10886686 -74776479)
2018,Abril,Taiwán,5,3,,8,POINT (3451668 -76532004)
2018,Abril,Taiwán,58,92,,150,POINT (4697157 -74140516)
2018,Abril,Taiwán,6,16,,22,POINT (6170465 -7542726)
2018,Abril,Taiwán,2,2,,4,POINT (7819 -72453013)
2018,Abril,Chipre,2,4,,6,POINT (4697157 -74140516)
2018,Abril,Chipre,0,1,,1,POINT (6170465 -7542726)
2018,Abril,Dinamarca,2,0,,2,POINT (-4191162 -69941498)
2018,Abril,Dinamarca,8,9,,17,POINT (0.81488 -77356)
2018,Abril,Dinamarca,2,1,,3,POINT (10406342 -75527794)
2018,Abril,Dinamarca,21,30,,51,POINT (10446304 -75516486)
2018,Abril,Dinamarca,2,4,,6,POINT (10886686 -74776479)
2018,Abril,Dinamarca,0,1,,1,POINT (11247723 -74213989)
2018,Abril,Dinamarca,0,1,,1,POINT (125862 -81702165)
2018,Abril,Dinamarca,5,2,,7,POINT (3451668 -76532004)
2018,Abril,Dinamarca,104,172,,276,POINT (4697157 -74140516)
2018,Abril,Dinamarca,1,1,,2,POINT (4815189 -75736374)
2018,Abril,Dinamarca,15,19,,34,POINT (6170465 -7542726)
2018,Abril,Dinamarca,1,3,,4,POINT (863337 -7735002)
2018,Abril,Dominica,3,3,,6,POINT (4697157 -74140516)
2018,Abril,Dominica,0,3,,3,POINT (6170465 -7542726)
2018,Abril,Dominica,0,1,,1,POINT (7927233 -72508188)
2018,Abril,Ecuador,0,1,,1,POINT (-4191162 -69941498)
2018,Abril,Ecuador,40,231,,271,POINT (0.33002 -76876446)
2018,Abril,Ecuador,17,16,,33,POINT (0.812436 -77847006)
2018,Abril,Ecuador,1234,1947,,3181,POINT (0.81488 -77356)
2018,Abril,Ecuador,25,26,,51,POINT (1800143 -78802679)
2018,Abril,Ecuador,0,9,,9,POINT (1812498 -78751321)
2018,Abril,Ecuador,8,32,,40,POINT (10406342 -75527794)
2018,Abril,Ecuador,94,84,,178,POINT (10446304 -75516486)
2018,Abril,Ecuador,4,7,,11,POINT (10886686 -74776479)
2018,Abril,Ecuador,13,28,,41,POINT (11360029 -72129595)
2018,Abril,Ecuador,17,14,,31,POINT (125862 -81702165)
2018,Abril,Ecuador,449,435,,884,POINT (3451668 -76532004)
2018,Abril,Ecuador,0,1,,1,POINT (445285 -75766353)
2018,Abril,Ecuador,3146,4113,,7259,POINT (4697157 -74140516)
2018,Abril,Ecuador,3,4,,7,POINT (4815189 -75736374)
2018,Abril,Ecuador,61,109,,170,POINT (6170465 -7542726)
2018,Abril,Ecuador,0,1,,1,POINT (6185536 -67484028)
2018,Abril,Ecuador,0,1,,1,POINT (6222552 -77401154)
2018,Abril,Ecuador,1,0,,1,POINT (7088729 -70740253)
2018,Abril,Ecuador,1,1,,2,POINT (7128047 -73181317)
2018,Abril,Ecuador,153,193,,346,POINT (7819 -72453013)
2018,Abril,Ecuador,10,14,,24,POINT (836068 -72409396)
2018,Abril,Ecuador,0,1,,1,POINT (863337 -7735002)
2018,Abril,Egipto,0,1,,1,POINT (10406342 -75527794)
2018,Abril,Egipto,4,12,,16,POINT (4697157 -74140516)
2018,Abril,Egipto,0,1,,1,POINT (6170465 -7542726)
2018,Abril,El Salvador,1,0,,1,POINT (0.33002 -76876446)
2018,Abril,El Salvador,1,4,,5,POINT (0.81488 -77356)
2018,Abril,El Salvador,0,1,,1,POINT (10406342 -75527794)
2018,Abril,El Salvador,53,47,,100,POINT (10446304 -75516486)
2018,Abril,El Salvador,3,6,,9,POINT (10886686 -74776479)
2018,Abril,El Salvador,6,8,,14,POINT (125862 -81702165)
2018,Abril,El Salvador,39,35,,74,POINT (3451668 -76532004)
2018,Abril,El Salvador,763,967,,1730,POINT (4697157 -74140516)
2018,Abril,El Salvador,0,2,,2,POINT (4815189 -75736374)
2018,Abril,El Salvador,156,207,,363,POINT (6170465 -7542726)
2018,Abril,El Salvador,1,1,,2,POINT (7128047 -73181317)
2018,Abril,El Salvador,2,2,,4,POINT (7819 -72453013)
2018,Abril,El Salvador,0,2,,2,POINT (836068 -72409396)
2018,Abril,Emiratos Árabes,2,1,,3,POINT (10446304 -75516486)
2018,Abril,Emiratos Árabes,0,1,,1,POINT (10886686 -74776479)
2018,Abril,Emiratos Árabes,2,9,,11,POINT (4697157 -74140516)
2018,Abril,Emiratos Árabes,0,2,,2,POINT (6170465 -7542726)
2018,Abril,España,0,1,,1,POINT (-4191162 -69941498)
2018,Abril,España,6,5,,11,POINT (-4214082 -69941431)
2018,Abril,España,2,3,,5,POINT (0.33002 -76876446)
2018,Abril,España,28,53,,81,POINT (0.81488 -77356)
2018,Abril,España,0,1,,1,POINT (1800143 -78802679)
2018,Abril,España,16,24,,40,POINT (10406342 -75527794)
2018,Abril,España,0,2,,2,POINT (10433609 -73247863)
2018,Abril,España,95,204,,299,POINT (10446304 -75516486)
2018,Abril,España,13,43,,56,POINT (10886686 -74776479)
2018,Abril,España,0,1,,1,POINT (11247723 -74213989)
2018,Abril,España,2,6,,8,POINT (11360029 -72129595)
2018,Abril,España,0,2,,2,POINT (125744111 -81703935)
2018,Abril,España,10,10,,20,POINT (125862 -81702165)
2018,Abril,España,358,445,,803,POINT (3451668 -76532004)
2018,Abril,España,2,0,,2,POINT (445285 -75766353)
2018,Abril,España,3074,5988,,9062,POINT (4697157 -74140516)
2018,Abril,España,7,14,,21,POINT (4815189 -75736374)
2018,Abril,España,348,634,,982,POINT (6170465 -7542726)
2018,Abril,España,0,2,,2,POINT (6185536 -67484028)
2018,Abril,España,1,6,,7,POINT (7088729 -70740253)
2018,Abril,España,1,1,,2,POINT (7128047 -73181317)
2018,Abril,España,29,29,,58,POINT (7819 -72453013)
2018,Abril,España,1,4,,5,POINT (836068 -72409396)
2018,Abril,España,2,4,,6,POINT (863337 -7735002)
2018,Abril,Eslovaquia,3,1,,4,POINT (0.81488 -77356)
2018,Abril,Eslovaquia,0,5,,5,POINT (10446304 -75516486)
2018,Abril,Eslovaquia,69,85,,154,POINT (4697157 -74140516)
2018,Abril,Eslovaquia,1,6,,7,POINT (6170465 -7542726)
2018,Abril,Eslovenia,2,1,,3,POINT (0.81488 -77356)
2018,Abril,Eslovenia,5,8,,13,POINT (10446304 -75516486)
2018,Abril,Eslovenia,0,2,,2,POINT (10886686 -74776479)
2018,Abril,Eslovenia,0,1,,1,POINT (125862 -81702165)
2018,Abril,Eslovenia,1,0,,1,POINT (3451668 -76532004)
2018,Abril,Eslovenia,29,53,,82,POINT (4697157 -74140516)
2018,Abril,Eslovenia,1,6,,7,POINT (6170465 -7542726)
2018,Abril,Eslovenia,1,1,,2,POINT (7819 -72453013)
2018,Abril,Eslovenia,0,1,,1,POINT (836068 -72409396)
2018,Abril,Estados Unidos de América,2,10,,12,POINT (-4191162 -69941498)
2018,Abril,Estados Unidos de América,4,4,,8,POINT (-4214082 -69941431)
2018,Abril,Estados Unidos de América,1,1,,2,POINT (0.33002 -76876446)
2018,Abril,Estados Unidos de América,33,67,,100,POINT (0.81488 -77356)
2018,Abril,Estados Unidos de América,51,81,,132,POINT (10406342 -75527794)
2018,Abril,Estados Unidos de América,6,13,,19,POINT (10433609 -73247863)
2018,Abril,Estados Unidos de América,4479,6348,,10827,POINT (10446304 -75516486)
2018,Abril,Estados Unidos de América,475,895,,1370,POINT (10886686 -74776479)
2018,Abril,Estados Unidos de América,0,1,,1,POINT (10970933 -74765343)
2018,Abril,Estados Unidos de América,3,11,,14,POINT (11247723 -74213989)
2018,Abril,Estados Unidos de América,3,5,,8,POINT (11360029 -72129595)
2018,Abril,Estados Unidos de América,1,9,,10,POINT (125744111 -81703935)
2018,Abril,Estados Unidos de América,25,38,,63,POINT (125862 -81702165)
2018,Abril,Estados Unidos de América,6,8,,14,POINT (133387613 -81372937)
2018,Abril,Estados Unidos de América,1022,1341,,2363,POINT (3451668 -76532004)
2018,Abril,Estados Unidos de América,83,176,,259,POINT (445285 -75766353)
2018,Abril,Estados Unidos de América,7829,14047,,21876,POINT (4697157 -74140516)
2018,Abril,Estados Unidos de América,104,158,,262,POINT (4815189 -75736374)
2018,Abril,Estados Unidos de América,2543,6654,,9197,POINT (6170465 -7542726)
2018,Abril,Estados Unidos de América,0,4,,4,POINT (6218835 -75586989)
2018,Abril,Estados Unidos de América,2,0,,2,POINT (7088729 -70740253)
2018,Abril,Estados Unidos de América,24,43,,67,POINT (7128047 -73181317)
2018,Abril,Estados Unidos de América,5,13,,18,POINT (7819 -72453013)
2018,Abril,Estados Unidos de América,2,2,,4,POINT (836068 -72409396)
2018,Abril,Estados Unidos de América,8,13,,21,POINT (863337 -7735002)
2018,Abril,Estonia,0,4,,4,POINT (10406342 -75527794)
2018,Abril,Estonia,4,2,,6,POINT (10446304 -75516486)
2018,Abril,Estonia,1,0,,1,POINT (3451668 -76532004)
2018,Abril,Estonia,6,8,,14,POINT (4697157 -74140516)
2018,Abril,Estonia,1,2,,3,POINT (6170465 -7542726)
2018,Abril,Etiopia,0,1,,1,POINT (3451668 -76532004)
2018,Abril,Etiopia,0,5,,5,POINT (4697157 -74140516)
2018,Abril,Filipinas,3,42,,45,POINT (10406342 -75527794)
2018,Abril,Filipinas,17,69,,86,POINT (10446304 -75516486)
2018,Abril,Filipinas,1,8,,9,POINT (10886686 -74776479)
2018,Abril,Filipinas,0,18,,18,POINT (10970933 -74765343)
2018,Abril,Filipinas,0,12,,12,POINT (11247723 -74213989)
2018,Abril,Filipinas,0,1,,1,POINT (11360029 -72129595)
2018,Abril,Filipinas,4,8,,12,POINT (3451668 -76532004)
2018,Abril,Filipinas,0,11,,11,POINT (3884426 -77061029)
2018,Abril,Filipinas,46,79,,125,POINT (4697157 -74140516)
2018,Abril,Filipinas,1,0,,1,POINT (4815189 -75736374)
2018,Abril,Filipinas,3,2,,5,POINT (6170465 -7542726)
2018,Abril,Filipinas,0,17,,17,POINT (9402597 -75681642)
2018,Abril,Finlandia,1,1,,2,POINT (0.33002 -76876446)
2018,Abril,Finlandia,4,5,,9,POINT (0.81488 -77356)
2018,Abril,Finlandia,2,1,,3,POINT (10406342 -75527794)
2018,Abril,Finlandia,3,7,,10,POINT (10446304 -75516486)
2018,Abril,Finlandia,1,1,,2,POINT (10886686 -74776479)
2018,Abril,Finlandia,9,1,,10,POINT (3451668 -76532004)
2018,Abril,Finlandia,37,66,,103,POINT (4697157 -74140516)
2018,Abril,Finlandia,0,1,,1,POINT (4815189 -75736374)
2018,Abril,Finlandia,3,15,,18,POINT (6170465 -7542726)
2018,Abril,Francia,13,7,,20,POINT (-4191162 -69941498)
2018,Abril,Francia,17,18,,35,POINT (-4214082 -69941431)
2018,Abril,Francia,6,9,,15,POINT (0.33002 -76876446)
2018,Abril,Francia,1,1,,2,POINT (0.812436 -77847006)
2018,Abril,Francia,96,118,,214,POINT (0.81488 -77356)
2018,Abril,Francia,10,14,,24,POINT (10406342 -75527794)
2018,Abril,Francia,165,210,,375,POINT (10446304 -75516486)
2018,Abril,Francia,13,28,,41,POINT (10886686 -74776479)
2018,Abril,Francia,1,1,,2,POINT (10970933 -74765343)
2018,Abril,Francia,1,3,,4,POINT (11247723 -74213989)
2018,Abril,Francia,1,5,,6,POINT (11360029 -72129595)
2018,Abril,Francia,1,7,,8,POINT (125744111 -81703935)
2018,Abril,Francia,5,2,,7,POINT (125862 -81702165)
2018,Abril,Francia,4,4,,8,POINT (133387613 -81372937)
2018,Abril,Francia,53,96,,149,POINT (3451668 -76532004)
2018,Abril,Francia,0,1,,1,POINT (445285 -75766353)
2018,Abril,Francia,2163,2971,,5134,POINT (4697157 -74140516)
2018,Abril,Francia,6,9,,15,POINT (4815189 -75736374)
2018,Abril,Francia,118,259,,377,POINT (6170465 -7542726)
2018,Abril,Francia,1,0,,1,POINT (7088729 -70740253)
2018,Abril,Francia,1,1,,2,POINT (7128047 -73181317)
2018,Abril,Francia,2,5,,7,POINT (7819 -72453013)
2018,Abril,Francia,0,1,,1,POINT (836068 -72409396)
2018,Abril,Francia,1,12,,13,POINT (863337 -7735002)
2018,Abril,Gabón,0,1,,1,POINT (4697157 -74140516)
2018,Abril,Georgia,0,1,,1,POINT (10406342 -75527794)
2018,Abril,Georgia,1,1,,2,POINT (10446304 -75516486)
2018,Abril,Georgia,2,1,,3,POINT (4697157 -74140516)
2018,Abril,Ghana,0,2,,2,POINT (0.81488 -77356)
2018,Abril,Ghana,2,13,,15,POINT (4697157 -74140516)
2018,Abril,Ghana,1,2,,3,POINT (6170465 -7542726)
2018,Abril,Granada,0,1,,1,POINT (10406342 -75527794)
2018,Abril,Granada,1,0,,1,POINT (10446304 -75516486)
2018,Abril,Granada,0,1,,1,POINT (10886686 -74776479)
2018,Abril,Granada,0,4,,4,POINT (4697157 -74140516)
2018,Abril,Granada,0,1,,1,POINT (6170465 -7542726)
2018,Abril,Grecia,0,2,,2,POINT (0.81488 -77356)
2018,Abril,Grecia,1,4,,5,POINT (10406342 -75527794)
2018,Abril,Grecia,6,9,,15,POINT (10446304 -75516486)
2018,Abril,Grecia,0,1,,1,POINT (10886686 -74776479)
2018,Abril,Grecia,2,2,,4,POINT (3451668 -76532004)
2018,Abril,Grecia,32,79,,111,POINT (4697157 -74140516)
2018,Abril,Grecia,0,5,,5,POINT (6170465 -7542726)
2018,Abril,Grecia,0,1,,1,POINT (7819 -72453013)
2018,Abril,Grecia,0,2,,2,POINT (806667 -767333)
2018,Abril,Grecia,0,3,,3,POINT (9402597 -75681642)
2018,Abril,Guatemala,2,0,,2,POINT (-4191162 -69941498)
2018,Abril,Guatemala,3,4,,7,POINT (0.81488 -77356)
2018,Abril,Guatemala,1,3,,4,POINT (10406342 -75527794)
2018,Abril,Guatemala,111,195,,306,POINT (10446304 -75516486)
2018,Abril,Guatemala,10,15,,25,POINT (10886686 -74776479)
2018,Abril,Guatemala,0,3,,3,POINT (11360029 -72129595)
2018,Abril,Guatemala,14,10,,24,POINT (125862 -81702165)
2018,Abril,Guatemala,16,34,,50,POINT (3451668 -76532004)
2018,Abril,Guatemala,1,0,,1,POINT (445285 -75766353)
2018,Abril,Guatemala,383,767,,1150,POINT (4697157 -74140516)
2018,Abril,Guatemala,3,4,,7,POINT (4815189 -75736374)
2018,Abril,Guatemala,57,157,,214,POINT (6170465 -7542726)
2018,Abril,Guatemala,0,2,,2,POINT (6185536 -67484028)
2018,Abril,Guatemala,2,3,,5,POINT (7128047 -73181317)
2018,Abril,Guatemala,0,7,,7,POINT (7819 -72453013)
2018,Abril,Guyana,1,1,,2,POINT (-4191162 -69941498)
2018,Abril,Guyana,2,1,,3,POINT (10446304 -75516486)
2018,Abril,Guyana,1,1,,2,POINT (10886686 -74776479)
2018,Abril,Guyana,0,1,,1,POINT (11360029 -72129595)
2018,Abril,Guyana,0,1,,1,POINT (125862 -81702165)
2018,Abril,Guyana,0,1,,1,POINT (3451668 -76532004)
2018,Abril,Guyana,17,24,,41,POINT (4697157 -74140516)
2018,Abril,Guyana,2,1,,3,POINT (7819 -72453013)
2018,Abril,Haití,0,5,,5,POINT (10446304 -75516486)
2018,Abril,Haití,1,2,,3,POINT (10886686 -74776479)
2018,Abril,Haití,13,19,,32,POINT (4697157 -74140516)
2018,Abril,Haití,2,9,,11,POINT (6170465 -7542726)
2018,Abril,Honduras,1,1,,2,POINT (0.81488 -77356)
2018,Abril,Honduras,0,7,,7,POINT (10406342 -75527794)
2018,Abril,Honduras,65,71,,136,POINT (10446304 -75516486)
2018,Abril,Honduras,10,16,,26,POINT (10886686 -74776479)
2018,Abril,Honduras,0,2,,2,POINT (11360029 -72129595)
2018,Abril,Honduras,0,3,,3,POINT (125862 -81702165)
2018,Abril,Honduras,41,26,,67,POINT (3451668 -76532004)
2018,Abril,Honduras,0,1,,1,POINT (445285 -75766353)
2018,Abril,Honduras,238,355,,593,POINT (4697157 -74140516)
2018,Abril,Honduras,41,59,,100,POINT (6170465 -7542726)
2018,Abril,Honduras,1,6,,7,POINT (7128047 -73181317)
2018,Abril,Honduras,0,2,,2,POINT (7819 -72453013)
2018,Abril,Honduras,0,1,,1,POINT (836068 -72409396)
2018,Abril,Hong Kong,1,1,,2,POINT (-4191162 -69941498)
2018,Abril,Hong Kong,0,1,,1,POINT (0.81488 -77356)
2018,Abril,Hong Kong,1,1,,2,POINT (10446304 -75516486)
2018,Abril,Hong Kong,6,13,,19,POINT (4697157 -74140516)
2018,Abril,Hungría,1,1,,2,POINT (0.81488 -77356)
2018,Abril,Hungría,2,0,,2,POINT (10406342 -75527794)
2018,Abril,Hungría,18,16,,34,POINT (10446304 -75516486)
2018,Abril,Hungría,4,3,,7,POINT (3451668 -76532004)
2018,Abril,Hungría,36,66,,102,POINT (4697157 -74140516)
2018,Abril,Hungría,5,7,,12,POINT (6170465 -7542726)
2018,Abril,India,0,1,,1,POINT (0.81488 -77356)
2018,Abril,India,0,9,,9,POINT (10406342 -75527794)
2018,Abril,India,11,60,,71,POINT (10446304 -75516486)
2018,Abril,India,1,18,,19,POINT (10886686 -74776479)
2018,Abril,India,0,3,,3,POINT (10970933 -74765343)
2018,Abril,India,0,1,,1,POINT (11247723 -74213989)
2018,Abril,India,2,6,,8,POINT (3451668 -76532004)
2018,Abril,India,0,3,,3,POINT (3884426 -77061029)
2018,Abril,India,87,358,,445,POINT (4697157 -74140516)
2018,Abril,India,0,3,,3,POINT (4815189 -75736374)
2018,Abril,India,14,69,,83,POINT (6170465 -7542726)
2018,Abril,India,0,1,,1,POINT (7128047 -73181317)
2018,Abril,India,0,3,,3,POINT (9402597 -75681642)
2018,Abril,Indonesia,1,2,,3,POINT (0.81488 -77356)
2018,Abril,Indonesia,0,2,,2,POINT (10406342 -75527794)
2018,Abril,Indonesia,2,3,,5,POINT (10446304 -75516486)
2018,Abril,Indonesia,0,1,,1,POINT (10886686 -74776479)
2018,Abril,Indonesia,0,1,,1,POINT (10970933 -74765343)
2018,Abril,Indonesia,8,22,,30,POINT (4697157 -74140516)
2018,Abril,Indonesia,2,2,,4,POINT (6170465 -7542726)
2018,Abril,Indonesia,0,2,,2,POINT (9402597 -75681642)
2018,Abril,Iraq,1,2,,3,POINT (4697157 -74140516)
2018,Abril,Irán,1,1,,2,POINT (10446304 -75516486)
2018,Abril,Irán,6,14,,20,POINT (4697157 -74140516)
2018,Abril,Irán,0,2,,2,POINT (6170465 -7542726)
2018,Abril,República de Irlanda,1,1,,2,POINT (-4191162 -69941498)
2018,Abril,República de Irlanda,2,4,,6,POINT (-4214082 -69941431)
2018,Abril,República de Irlanda,0,1,,1,POINT (0.33002 -76876446)
2018,Abril,República de Irlanda,8,11,,19,POINT (0.81488 -77356)
2018,Abril,República de Irlanda,2,4,,6,POINT (10406342 -75527794)
2018,Abril,República de Irlanda,17,25,,42,POINT (10446304 -75516486)
2018,Abril,República de Irlanda,1,3,,4,POINT (10886686 -74776479)
2018,Abril,República de Irlanda,0,1,,1,POINT (11247723 -74213989)
2018,Abril,República de Irlanda,6,6,,12,POINT (3451668 -76532004)
2018,Abril,República de Irlanda,139,212,,351,POINT (4697157 -74140516)
2018,Abril,República de Irlanda,8,43,,51,POINT (6170465 -7542726)
2018,Abril,República de Irlanda,3,4,,7,POINT (863337 -7735002)
2018,Abril,Islandia,0,1,,1,POINT (0.81488 -77356)
2018,Abril,Islandia,0,3,,3,POINT (10446304 -75516486)
2018,Abril,Islandia,0,1,,1,POINT (3451668 -76532004)
2018,Abril,Islandia,4,11,,15,POINT (4697157 -74140516)
2018,Abril,Islandia,3,0,,3,POINT (6170465 -7542726)
2018,Abril,Israel,1,5,,6,POINT (-4191162 -69941498)
2018,Abril,Israel,3,9,,12,POINT (-4214082 -69941431)
2018,Abril,Israel,1,1,,2,POINT (0.33002 -76876446)
2018,Abril,Israel,17,50,,67,POINT (0.81488 -77356)
2018,Abril,Israel,3,2,,5,POINT (10406342 -75527794)
2018,Abril,Israel,56,102,,158,POINT (10446304 -75516486)
2018,Abril,Israel,0,7,,7,POINT (10886686 -74776479)
2018,Abril,Israel,2,3,,5,POINT (125862 -81702165)
2018,Abril,Israel,19,38,,57,POINT (3451668 -76532004)
2018,Abril,Israel,658,1267,,1925,POINT (4697157 -74140516)
2018,Abril,Israel,0,1,,1,POINT (4815189 -75736374)
2018,Abril,Israel,134,196,,330,POINT (6170465 -7542726)
2018,Abril,Italia,1,2,,3,POINT (-4191162 -69941498)
2018,Abril,Italia,3,7,,10,POINT (-4214082 -69941431)
2018,Abril,Italia,5,6,,11,POINT (0.33002 -76876446)
2018,Abril,Italia,18,23,,41,POINT (0.81488 -77356)
2018,Abril,Italia,11,16,,27,POINT (10406342 -75527794)
2018,Abril,Italia,57,142,,199,POINT (10446304 -75516486)
2018,Abril,Italia,5,26,,31,POINT (10886686 -74776479)
2018,Abril,Italia,1,1,,2,POINT (11117206 -74232675)
2018,Abril,Italia,0,3,,3,POINT (11360029 -72129595)
2018,Abril,Italia,0,2,,2,POINT (125744111 -81703935)
2018,Abril,Italia,5,7,,12,POINT (125862 -81702165)
2018,Abril,Italia,33,75,,108,POINT (3451668 -76532004)
2018,Abril,Italia,0,1,,1,POINT (445285 -75766353)
2018,Abril,Italia,724,1686,,2410,POINT (4697157 -74140516)
2018,Abril,Italia,0,7,,7,POINT (4815189 -75736374)
2018,Abril,Italia,73,215,,288,POINT (6170465 -7542726)
2018,Abril,Italia,2,0,,2,POINT (6185536 -67484028)
2018,Abril,Italia,0,3,,3,POINT (7088729 -70740253)
2018,Abril,Italia,0,1,,1,POINT (7102626 -77762647)
2018,Abril,Italia,2,6,,8,POINT (7128047 -73181317)
2018,Abril,Italia,16,14,,30,POINT (7819 -72453013)
2018,Abril,Italia,1,1,,2,POINT (836068 -72409396)
2018,Abril,Italia,4,5,,9,POINT (863337 -7735002)
2018,Abril,Jamaica,0,1,,1,POINT (0.81488 -77356)
2018,Abril,Jamaica,4,8,,12,POINT (10446304 -75516486)
2018,Abril,Jamaica,3,2,,5,POINT (10886686 -74776479)
2018,Abril,Jamaica,0,1,,1,POINT (125862 -81702165)
2018,Abril,Jamaica,7,0,,7,POINT (3451668 -76532004)
2018,Abril,Jamaica,26,32,,58,POINT (4697157 -74140516)
2018,Abril,Jamaica,5,12,,17,POINT (6170465 -7542726)
2018,Abril,Japón,1,1,,2,POINT (-4191162 -69941498)
2018,Abril,Japón,2,1,,3,POINT (-4214082 -69941431)
2018,Abril,Japón,16,14,,30,POINT (0.81488 -77356)
2018,Abril,Japón,0,1,,1,POINT (10406342 -75527794)
2018,Abril,Japón,7,10,,17,POINT (10446304 -75516486)
2018,Abril,Japón,2,5,,7,POINT (10886686 -74776479)
2018,Abril,Japón,5,5,,10,POINT (3451668 -76532004)
2018,Abril,Japón,148,462,,610,POINT (4697157 -74140516)
2018,Abril,Japón,1,4,,5,POINT (4815189 -75736374)
2018,Abril,Japón,17,48,,65,POINT (6170465 -7542726)
2018,Abril,Japón,0,1,,1,POINT (7128047 -73181317)
2018,Abril,Japón,0,3,,3,POINT (7819 -72453013)
2018,Abril,Japón,0,1,,1,POINT (836068 -72409396)
2018,Abril,Jordania,1,1,,2,POINT (10446304 -75516486)
2018,Abril,Jordania,1,0,,1,POINT (3451668 -76532004)
2018,Abril,Jordania,4,6,,10,POINT (4697157 -74140516)
2018,Abril,Kazajistán,1,1,,2,POINT (10446304 -75516486)
2018,Abril,Kazajistán,1,1,,2,POINT (4697157 -74140516)
2018,Abril,Kenia,0,3,,3,POINT (10446304 -75516486)
2018,Abril,Kenia,4,12,,16,POINT (4697157 -74140516)
2018,Abril,Kenia,2,0,,2,POINT (6170465 -7542726)
2018,Abril,Kuwait,0,7,,7,POINT (4697157 -74140516)
2018,Abril,República de Kosovo,1,0,,1,POINT (4697157 -74140516)
2018,Abril,Letonia,0,1,,1,POINT (-4191162 -69941498)
2018,Abril,Letonia,1,1,,2,POINT (0.33002 -76876446)
2018,Abril,Letonia,0,1,,1,POINT (0.81488 -77356)
2018,Abril,Letonia,1,0,,1,POINT (10446304 -75516486)
2018,Abril,Letonia,5,13,,18,POINT (4697157 -74140516)
2018,Abril,Letonia,2,3,,5,POINT (6170465 -7542726)
2018,Abril,Lituania,1,1,,2,POINT (0.81488 -77356)
2018,Abril,Lituania,0,4,,4,POINT (10406342 -75527794)
2018,Abril,Lituania,6,6,,12,POINT (10446304 -75516486)
2018,Abril,Lituania,1,2,,3,POINT (3451668 -76532004)
2018,Abril,Lituania,20,13,,33,POINT (4697157 -74140516)
2018,Abril,Lituania,1,2,,3,POINT (6170465 -7542726)
2018,Abril,Líbano,2,0,,2,POINT (10886686 -74776479)
2018,Abril,Líbano,1,0,,1,POINT (11360029 -72129595)
2018,Abril,Líbano,13,23,,36,POINT (4697157 -74140516)
2018,Abril,Líbano,1,0,,1,POINT (6170465 -7542726)
2018,Abril,Líbano,1,1,,2,POINT (7128047 -73181317)
2018,Abril,Liberia,1,0,,1,POINT (3451668 -76532004)
2018,Abril,Liechtenstein,1,1,,2,POINT (4697157 -74140516)
2018,Abril,Liechtenstein,0,2,,2,POINT (6170465 -7542726)
2018,Abril,Luxemburgo,1,1,,2,POINT (0.81488 -77356)
2018,Abril,Luxemburgo,2,1,,3,POINT (10446304 -75516486)
2018,Abril,Luxemburgo,6,8,,14,POINT (4697157 -74140516)
2018,Abril,Luxemburgo,1,2,,3,POINT (6170465 -7542726)
2018,Abril,Macedonia,0,1,,1,POINT (3451668 -76532004)
2018,Abril,Macedonia,2,3,,5,POINT (4697157 -74140516)
2018,Abril,Madagascar,2,1,,3,POINT (4697157 -74140516)
2018,Abril,Malasia,1,0,,1,POINT (-4214082 -69941431)
2018,Abril,Malasia,3,6,,9,POINT (10446304 -75516486)
2018,Abril,Malasia,33,41,,74,POINT (4697157 -74140516)
2018,Abril,Malasia,1,5,,6,POINT (6170465 -7542726)
2018,Abril,Malasia,1,0,,1,POINT (7819 -72453013)
2018,Abril,Malasia,0,2,,2,POINT (9402597 -75681642)
2018,Abril,Malawi,0,2,,2,POINT (4697157 -74140516)
2018,Abril,Maldivas,1,0,,1,POINT (10446304 -75516486)
2018,Abril,Malí,0,1,,1,POINT (4697157 -74140516)
2018,Abril,Malta,1,4,,5,POINT (4697157 -74140516)
2018,Abril,Malta,0,1,,1,POINT (6170465 -7542726)
2018,Abril,Marruecos,0,2,,2,POINT (10446304 -75516486)
2018,Abril,Marruecos,1,0,,1,POINT (3451668 -76532004)
2018,Abril,Marruecos,14,16,,30,POINT (4697157 -74140516)
2018,Abril,Marruecos,0,1,,1,POINT (6170465 -7542726)
2018,Abril,Marruecos,0,1,,1,POINT (7819 -72453013)
2018,Abril,Mauricio,0,2,,2,POINT (10406342 -75527794)
2018,Abril,Mauricio,0,4,,4,POINT (4697157 -74140516)
2018,Abril,México,0,2,,2,POINT (-4191162 -69941498)
2018,Abril,México,0,4,,4,POINT (-4214082 -69941431)
2018,Abril,México,2,1,,3,POINT (0.33002 -76876446)
2018,Abril,México,19,32,,51,POINT (0.81488 -77356)
2018,Abril,México,21,19,,40,POINT (10406342 -75527794)
2018,Abril,México,3,7,,10,POINT (10433609 -73247863)
2018,Abril,México,223,320,,543,POINT (10446304 -75516486)
2018,Abril,México,35,66,,101,POINT (10886686 -74776479)
2018,Abril,México,1,4,,5,POINT (11360029 -72129595)
2018,Abril,México,0,1,,1,POINT (125744111 -81703935)
2018,Abril,México,2,4,,6,POINT (125862 -81702165)
2018,Abril,México,0,1,,1,POINT (133387613 -81372937)
2018,Abril,México,67,152,,219,POINT (3451668 -76532004)
2018,Abril,México,1,1,,2,POINT (445285 -75766353)
2018,Abril,México,4212,7667,,11879,POINT (4697157 -74140516)
2018,Abril,México,5,13,,18,POINT (4815189 -75736374)
2018,Abril,México,613,1539,,2152,POINT (6170465 -7542726)
2018,Abril,México,0,1,,1,POINT (6222552 -77401154)
2018,Abril,México,6,6,,12,POINT (7088729 -70740253)
2018,Abril,México,4,9,,13,POINT (7128047 -73181317)
2018,Abril,México,31,27,,58,POINT (7819 -72453013)
2018,Abril,México,0,1,,1,POINT (806667 -767333)
2018,Abril,México,4,9,,13,POINT (836068 -72409396)
2018,Abril,México,2,0,,2,POINT (863337 -7735002)
2018,Abril,República de Moldavia,2,2,,4,POINT (4697157 -74140516)
2018,Abril,República de Moldavia,0,1,,1,POINT (6170465 -7542726)
2018,Abril,Mónaco,1,1,,2,POINT (4697157 -74140516)
2018,Abril,Mongolia,1,0,,1,POINT (4697157 -74140516)
2018,Abril,Montenegro,0,1,,1,POINT (10406342 -75527794)
2018,Abril,Montenegro,0,1,,1,POINT (10446304 -75516486)
2018,Abril,Montenegro,1,3,,4,POINT (4697157 -74140516)
2018,Abril,Mozambique,1,3,,4,POINT (4697157 -74140516)
2018,Abril,Myanmar,1,0,,1,POINT (10446304 -75516486)
2018,Abril,Namibia,0,1,,1,POINT (10446304 -75516486)
2018,Abril,Namibia,1,0,,1,POINT (3451668 -76532004)
2018,Abril,Nepal,2,4,,6,POINT (4697157 -74140516)
2018,Abril,Nicaragua,18,21,,39,POINT (10446304 -75516486)
2018,Abril,Nicaragua,0,8,,8,POINT (10886686 -74776479)
2018,Abril,Nicaragua,7,6,,13,POINT (125744111 -81703935)
2018,Abril,Nicaragua,7,4,,11,POINT (3451668 -76532004)
2018,Abril,Nicaragua,81,111,,192,POINT (4697157 -74140516)
2018,Abril,Nicaragua,0,2,,2,POINT (4815189 -75736374)
2018,Abril,Nicaragua,18,27,,45,POINT (6170465 -7542726)
2018,Abril,Nigeria,0,1,,1,POINT (3451668 -76532004)
2018,Abril,Nigeria,0,5,,5,POINT (4697157 -74140516)
2018,Abril,Nigeria,1,0,,1,POINT (6170465 -7542726)
2018,Abril,Noruega,0,1,,1,POINT (0.33002 -76876446)
2018,Abril,Noruega,3,2,,5,POINT (0.81488 -77356)
2018,Abril,Noruega,2,1,,3,POINT (10406342 -75527794)
2018,Abril,Noruega,16,14,,30,POINT (10446304 -75516486)
2018,Abril,Noruega,1,1,,2,POINT (10886686 -74776479)
2018,Abril,Noruega,1,2,,3,POINT (11247723 -74213989)
2018,Abril,Noruega,1,0,,1,POINT (125862 -81702165)
2018,Abril,Noruega,5,6,,11,POINT (3451668 -76532004)
2018,Abril,Noruega,70,114,,184,POINT (4697157 -74140516)
2018,Abril,Noruega,0,1,,1,POINT (4815189 -75736374)
2018,Abril,Noruega,13,7,,20,POINT (6170465 -7542726)
2018,Abril,Noruega,0,1,,1,POINT (863337 -7735002)
2018,Abril,Nueva Zelanda,3,6,,9,POINT (0.81488 -77356)
2018,Abril,Nueva Zelanda,5,10,,15,POINT (10406342 -75527794)
2018,Abril,Nueva Zelanda,16,18,,34,POINT (10446304 -75516486)
2018,Abril,Nueva Zelanda,1,5,,6,POINT (10886686 -74776479)
2018,Abril,Nueva Zelanda,0,1,,1,POINT (133387613 -81372937)
2018,Abril,Nueva Zelanda,1,3,,4,POINT (3451668 -76532004)
2018,Abril,Nueva Zelanda,71,109,,180,POINT (4697157 -74140516)
2018,Abril,Nueva Zelanda,11,17,,28,POINT (6170465 -7542726)
2018,Abril,Nueva Zelanda,1,1,,2,POINT (863337 -7735002)
2018,Abril,Omán,0,1,,1,POINT (4697157 -74140516)
2018,Abril,Países Bajos,0,2,,2,POINT (-4191162 -69941498)
2018,Abril,Países Bajos,4,3,,7,POINT (-4214082 -69941431)
2018,Abril,Países Bajos,2,3,,5,POINT (0.33002 -76876446)
2018,Abril,Países Bajos,20,31,,51,POINT (0.81488 -77356)
2018,Abril,Países Bajos,31,32,,63,POINT (10406342 -75527794)
2018,Abril,Países Bajos,102,185,,287,POINT (10446304 -75516486)
2018,Abril,Países Bajos,11,22,,33,POINT (10886686 -74776479)
2018,Abril,Países Bajos,0,1,,1,POINT (10970933 -74765343)
2018,Abril,Países Bajos,1,4,,5,POINT (11360029 -72129595)
2018,Abril,Países Bajos,2,0,,2,POINT (125744111 -81703935)
2018,Abril,Países Bajos,35,47,,82,POINT (3451668 -76532004)
2018,Abril,Países Bajos,0,1,,1,POINT (445285 -75766353)
2018,Abril,Países Bajos,1689,2024,,3713,POINT (4697157 -74140516)
2018,Abril,Países Bajos,4,7,,11,POINT (4815189 -75736374)
2018,Abril,Países Bajos,124,219,,343,POINT (6170465 -7542726)
2018,Abril,Países Bajos,0,1,,1,POINT (6185536 -67484028)
2018,Abril,Países Bajos,0,1,,1,POINT (7088729 -70740253)
2018,Abril,Países Bajos,4,2,,6,POINT (7128047 -73181317)
2018,Abril,Países Bajos,3,1,,4,POINT (7819 -72453013)
2018,Abril,Países Bajos,1,3,,4,POINT (7927233 -72508188)
2018,Abril,Países Bajos,0,3,,3,POINT (836068 -72409396)
2018,Abril,Países Bajos,8,12,,20,POINT (863337 -7735002)
2018,Abril,Pakistán,3,13,,16,POINT (4697157 -74140516)
2018,Abril,Pakistán,0,1,,1,POINT (6170465 -7542726)
2018,Abril,Panamá,0,2,,2,POINT (0.81488 -77356)
2018,Abril,Panamá,0,25,,25,POINT (10406342 -75527794)
2018,Abril,Panamá,1,1,,2,POINT (10433609 -73247863)
2018,Abril,Panamá,430,445,,875,POINT (10446304 -75516486)
2018,Abril,Panamá,91,126,,217,POINT (10886686 -74776479)
2018,Abril,Panamá,1,4,,5,POINT (11360029 -72129595)
2018,Abril,Panamá,0,3,,3,POINT (125744111 -81703935)
2018,Abril,Panamá,52,35,,87,POINT (125862 -81702165)
2018,Abril,Panamá,217,204,,421,POINT (3451668 -76532004)
2018,Abril,Panamá,20,11,,31,POINT (445285 -75766353)
2018,Abril,Panamá,1515,1662,,3177,POINT (4697157 -74140516)
2018,Abril,Panamá,28,55,,83,POINT (4815189 -75736374)
2018,Abril,Panamá,1254,1192,,2446,POINT (6170465 -7542726)
2018,Abril,Panamá,2,3,,5,POINT (7102626 -77762647)
2018,Abril,Panamá,13,22,,35,POINT (7128047 -73181317)
2018,Abril,Panamá,4,0,,4,POINT (7819 -72453013)
2018,Abril,Panamá,0,1,,1,POINT (836068 -72409396)
2018,Abril,Panamá,2,3,,5,POINT (863337 -7735002)
2018,Abril,Paraguay,0,1,,1,POINT (-4191162 -69941498)
2018,Abril,Paraguay,2,3,,5,POINT (0.81488 -77356)
2018,Abril,Paraguay,6,1,,7,POINT (10406342 -75527794)
2018,Abril,Paraguay,77,51,,128,POINT (10446304 -75516486)
2018,Abril,Paraguay,5,7,,12,POINT (10886686 -74776479)
2018,Abril,Paraguay,63,39,,102,POINT (125862 -81702165)
2018,Abril,Paraguay,10,2,,12,POINT (3451668 -76532004)
2018,Abril,Paraguay,167,155,,322,POINT (4697157 -74140516)
2018,Abril,Paraguay,0,2,,2,POINT (4815189 -75736374)
2018,Abril,Paraguay,26,27,,53,POINT (6170465 -7542726)
2018,Abril,Paraguay,0,2,,2,POINT (7128047 -73181317)
2018,Abril,Perú,18,20,,38,POINT (-4191162 -69941498)
2018,Abril,Perú,29,38,,67,POINT (-4214082 -69941431)
2018,Abril,Perú,2,13,,15,POINT (0.33002 -76876446)
2018,Abril,Perú,96,268,,364,POINT (0.81488 -77356)
2018,Abril,Perú,36,35,,71,POINT (10406342 -75527794)
2018,Abril,Perú,801,530,,1331,POINT (10446304 -75516486)
2018,Abril,Perú,9,18,,27,POINT (10886686 -74776479)
2018,Abril,Perú,0,1,,1,POINT (10970933 -74765343)
2018,Abril,Perú,9,20,,29,POINT (11360029 -72129595)
2018,Abril,Perú,323,214,,537,POINT (125862 -81702165)
2018,Abril,Perú,77,127,,204,POINT (3451668 -76532004)
2018,Abril,Perú,0,1,,1,POINT (3866713 -67927521)
2018,Abril,Perú,0,2,,2,POINT (445285 -75766353)
2018,Abril,Perú,3543,4478,,8021,POINT (4697157 -74140516)
2018,Abril,Perú,7,6,,13,POINT (4815189 -75736374)
2018,Abril,Perú,373,602,,975,POINT (6170465 -7542726)
2018,Abril,Perú,6,6,,12,POINT (7088729 -70740253)
2018,Abril,Perú,6,7,,13,POINT (7128047 -73181317)
2018,Abril,Perú,122,212,,334,POINT (7819 -72453013)
2018,Abril,Perú,5,13,,18,POINT (836068 -72409396)
2018,Abril,Perú,0,1,,1,POINT (863337 -7735002)
2018,Abril,Palestina,0,1,,1,POINT (10886686 -74776479)
2018,Abril,Palestina,2,0,,2,POINT (4697157 -74140516)
2018,Abril,Polonia,2,3,,5,POINT (-4214082 -69941431)
2018,Abril,Polonia,3,2,,5,POINT (0.33002 -76876446)
2018,Abril,Polonia,9,4,,13,POINT (0.81488 -77356)
2018,Abril,Polonia,1,8,,9,POINT (10406342 -75527794)
2018,Abril,Polonia,12,33,,45,POINT (10446304 -75516486)
2018,Abril,Polonia,0,2,,2,POINT (10886686 -74776479)
2018,Abril,Polonia,0,2,,2,POINT (10970933 -74765343)
2018,Abril,Polonia,0,2,,2,POINT (11247723 -74213989)
2018,Abril,Polonia,0,1,,1,POINT (11360029 -72129595)
2018,Abril,Polonia,1,0,,1,POINT (125862 -81702165)
2018,Abril,Polonia,8,1,,9,POINT (3451668 -76532004)
2018,Abril,Polonia,164,189,,353,POINT (4697157 -74140516)
2018,Abril,Polonia,11,19,,30,POINT (6170465 -7542726)
2018,Abril,Polonia,1,0,,1,POINT (6185536 -67484028)
2018,Abril,Polonia,0,1,,1,POINT (863337 -7735002)
2018,Abril,Portugal,0,1,,1,POINT (-4191162 -69941498)
2018,Abril,Portugal,0,1,,1,POINT (0.812436 -77847006)
2018,Abril,Portugal,1,7,,8,POINT (0.81488 -77356)
2018,Abril,Portugal,7,3,,10,POINT (10406342 -75527794)
2018,Abril,Portugal,19,32,,51,POINT (10446304 -75516486)
2018,Abril,Portugal,2,4,,6,POINT (10886686 -74776479)
2018,Abril,Portugal,1,0,,1,POINT (11247723 -74213989)
2018,Abril,Portugal,1,6,,7,POINT (11360029 -72129595)
2018,Abril,Portugal,0,1,,1,POINT (133387613 -81372937)
2018,Abril,Portugal,32,38,,70,POINT (3451668 -76532004)
2018,Abril,Portugal,217,512,,729,POINT (4697157 -74140516)
2018,Abril,Portugal,0,2,,2,POINT (4815189 -75736374)
2018,Abril,Portugal,32,55,,87,POINT (6170465 -7542726)
2018,Abril,Portugal,0,1,,1,POINT (7088729 -70740253)
2018,Abril,Portugal,1,0,,1,POINT (7128047 -73181317)
2018,Abril,Portugal,6,17,,23,POINT (7819 -72453013)
2018,Abril,Portugal,2,2,,4,POINT (836068 -72409396)
2018,Abril,Qatar,1,3,,4,POINT (10446304 -75516486)
2018,Abril,Qatar,0,1,,1,POINT (3451668 -76532004)
2018,Abril,Qatar,0,1,,1,POINT (4697157 -74140516)
2018,Abril,Reino Unido de Gran Bretaña e Irlanda del Norte,3,15,,18,POINT (-4191162 -69941498)
2018,Abril,Reino Unido de Gran Bretaña e Irlanda del Norte,11,10,,21,POINT (-4214082 -69941431)
2018,Abril,Reino Unido de Gran Bretaña e Irlanda del Norte,4,4,,8,POINT (0.33002 -76876446)
2018,Abril,Reino Unido de Gran Bretaña e Irlanda del Norte,63,72,,135,POINT (0.81488 -77356)
2018,Abril,Reino Unido de Gran Bretaña e Irlanda del Norte,28,36,,64,POINT (10406342 -75527794)
2018,Abril,Reino Unido de Gran Bretaña e Irlanda del Norte,113,179,,292,POINT (10446304 -75516486)
2018,Abril,Reino Unido de Gran Bretaña e Irlanda del Norte,9,31,,40,POINT (10886686 -74776479)
2018,Abril,Reino Unido de Gran Bretaña e Irlanda del Norte,0,2,,2,POINT (11247723 -74213989)
2018,Abril,Reino Unido de Gran Bretaña e Irlanda del Norte,0,2,,2,POINT (11360029 -72129595)
2018,Abril,Reino Unido de Gran Bretaña e Irlanda del Norte,0,1,,1,POINT (125744111 -81703935)
2018,Abril,Reino Unido de Gran Bretaña e Irlanda del Norte,3,1,,4,POINT (125862 -81702165)
2018,Abril,Reino Unido de Gran Bretaña e Irlanda del Norte,1,0,,1,POINT (133387613 -81372937)
2018,Abril,Reino Unido de Gran Bretaña e Irlanda del Norte,15,43,,58,POINT (3451668 -76532004)
2018,Abril,Reino Unido de Gran Bretaña e Irlanda del Norte,1223,2063,,3286,POINT (4697157 -74140516)
2018,Abril,Reino Unido de Gran Bretaña e Irlanda del Norte,1,3,,4,POINT (4815189 -75736374)
2018,Abril,Reino Unido de Gran Bretaña e Irlanda del Norte,89,198,,287,POINT (6170465 -7542726)
2018,Abril,Reino Unido de Gran Bretaña e Irlanda del Norte,1,1,,2,POINT (7102626 -77762647)
2018,Abril,Reino Unido de Gran Bretaña e Irlanda del Norte,0,4,,4,POINT (7128047 -73181317)
2018,Abril,Reino Unido de Gran Bretaña e Irlanda del Norte,1,1,,2,POINT (7819 -72453013)
2018,Abril,Reino Unido de Gran Bretaña e Irlanda del Norte,2,0,,2,POINT (7927233 -72508188)
2018,Abril,Reino Unido de Gran Bretaña e Irlanda del Norte,1,1,,2,POINT (836068 -72409396)
2018,Abril,Reino Unido de Gran Bretaña e Irlanda del Norte,19,25,,44,POINT (863337 -7735002)
2018,Abril,República Dominicana,0,1,,1,POINT (-4191162 -69941498)
2018,Abril,República Dominicana,2,13,,15,POINT (0.81488 -77356)
2018,Abril,República Dominicana,13,9,,22,POINT (10406342 -75527794)
2018,Abril,República Dominicana,61,87,,148,POINT (10446304 -75516486)
2018,Abril,República Dominicana,22,29,,51,POINT (10886686 -74776479)
2018,Abril,República Dominicana,3,4,,7,POINT (11360029 -72129595)
2018,Abril,República Dominicana,1,1,,2,POINT (125862 -81702165)
2018,Abril,República Dominicana,26,23,,49,POINT (3451668 -76532004)
2018,Abril,República Dominicana,1,0,,1,POINT (445285 -75766353)
2018,Abril,República Dominicana,634,654,,1288,POINT (4697157 -74140516)
2018,Abril,República Dominicana,5,3,,8,POINT (4815189 -75736374)
2018,Abril,República Dominicana,63,74,,137,POINT (6170465 -7542726)
2018,Abril,República Dominicana,1,3,,4,POINT (7128047 -73181317)
2018,Abril,República Dominicana,1,1,,2,POINT (7819 -72453013)
2018,Abril,Rumania,1,0,,1,POINT (0.81488 -77356)
2018,Abril,Rumania,1,9,,10,POINT (10406342 -75527794)
2018,Abril,Rumania,5,10,,15,POINT (10446304 -75516486)
2018,Abril,Rumania,0,1,,1,POINT (10970933 -74765343)
2018,Abril,Rumania,10,1,,11,POINT (3451668 -76532004)
2018,Abril,Rumania,0,1,,1,POINT (3884426 -77061029)
2018,Abril,Rumania,83,58,,141,POINT (4697157 -74140516)
2018,Abril,Rumania,8,14,,22,POINT (6170465 -7542726)
2018,Abril,Rumania,0,1,,1,POINT (7128047 -73181317)
2018,Abril,Federación de Rusia,2,0,,2,POINT (-4214082 -69941431)
2018,Abril,Federación de Rusia,3,5,,8,POINT (0.81488 -77356)
2018,Abril,Federación de Rusia,1,8,,9,POINT (10406342 -75527794)
2018,Abril,Federación de Rusia,22,20,,42,POINT (10446304 -75516486)
2018,Abril,Federación de Rusia,1,2,,3,POINT (10886686 -74776479)
2018,Abril,Federación de Rusia,0,3,,3,POINT (10970933 -74765343)
2018,Abril,Federación de Rusia,4,0,,4,POINT (125862 -81702165)
2018,Abril,Federación de Rusia,4,3,,7,POINT (3451668 -76532004)
2018,Abril,Federación de Rusia,156,194,,350,POINT (4697157 -74140516)
2018,Abril,Federación de Rusia,16,21,,37,POINT (6170465 -7542726)
2018,Abril,Federación de Rusia,0,2,,2,POINT (7819 -72453013)
2018,Abril,Federación de Rusia,0,1,,1,POINT (9402597 -75681642)
2018,Abril,Rwanda,1,1,,2,POINT (4697157 -74140516)
2018,Abril,San Cristóbal y Nevis,3,3,,6,POINT (4697157 -74140516)
2018,Abril,San Cristóbal y Nevis,0,1,,1,POINT (7927233 -72508188)
2018,Abril,San Marino,1,1,,2,POINT (4697157 -74140516)
2018,Abril,San Marino,0,1,,1,POINT (6170465 -7542726)
2018,Abril,San  Vicente y las Granadinas,0,1,,1,POINT (10446304 -75516486)
2018,Abril,San  Vicente y las Granadinas,0,2,,2,POINT (10886686 -74776479)
2018,Abril,Santa Lucia,3,8,,11,POINT (4697157 -74140516)
2018,Abril,Santa Sede/Ciudad del Vaticano,0,2,,2,POINT (4697157 -74140516)
2018,Abril,Senegal,0,1,,1,POINT (11360029 -72129595)
2018,Abril,Senegal,0,2,,2,POINT (4697157 -74140516)
2018,Abril,Serbia,1,3,,4,POINT (10446304 -75516486)
2018,Abril,Serbia,0,1,,1,POINT (3451668 -76532004)
2018,Abril,Serbia,11,27,,38,POINT (4697157 -74140516)
2018,Abril,Serbia,0,2,,2,POINT (6170465 -7542726)
2018,Abril,Seychelles,0,1,,1,POINT (4697157 -74140516)
2018,Abril,Sierra Leona,0,1,,1,POINT (4697157 -74140516)
2018,Abril,Singapur,2,0,,2,POINT (0.81488 -77356)
2018,Abril,Singapur,1,3,,4,POINT (10446304 -75516486)
2018,Abril,Singapur,0,1,,1,POINT (10886686 -74776479)
2018,Abril,Singapur,16,22,,38,POINT (4697157 -74140516)
2018,Abril,Singapur,1,0,,1,POINT (4815189 -75736374)
2018,Abril,Singapur,3,6,,9,POINT (6170465 -7542726)
2018,Abril,Singapur,0,1,,1,POINT (836068 -72409396)
2018,Abril,República Árabe Siria,0,5,,5,POINT (4697157 -74140516)
2018,Abril,Sri Lanka,2,0,,2,POINT (10446304 -75516486)
2018,Abril,Sri Lanka,0,1,,1,POINT (10970933 -74765343)
2018,Abril,Sri Lanka,1,3,,4,POINT (4697157 -74140516)
2018,Abril,Sudáfrica,2,7,,9,POINT (10406342 -75527794)
2018,Abril,Sudáfrica,2,5,,7,POINT (10446304 -75516486)
2018,Abril,Sudáfrica,1,5,,6,POINT (10886686 -74776479)
2018,Abril,Sudáfrica,16,49,,65,POINT (4697157 -74140516)
2018,Abril,Sudáfrica,2,5,,7,POINT (6170465 -7542726)
2018,Abril,Sudán,0,2,,2,POINT (4697157 -74140516)
2018,Abril,Suecia,2,3,,5,POINT (0.33002 -76876446)
2018,Abril,Suecia,12,14,,26,POINT (0.81488 -77356)
2018,Abril,Suecia,5,7,,12,POINT (10406342 -75527794)
2018,Abril,Suecia,16,24,,40,POINT (10446304 -75516486)
2018,Abril,Suecia,1,5,,6,POINT (10886686 -74776479)
2018,Abril,Suecia,3,9,,12,POINT (11247723 -74213989)
2018,Abril,Suecia,2,0,,2,POINT (11360029 -72129595)
2018,Abril,Suecia,1,0,,1,POINT (133387613 -81372937)
2018,Abril,Suecia,11,8,,19,POINT (3451668 -76532004)
2018,Abril,Suecia,186,256,,442,POINT (4697157 -74140516)
2018,Abril,Suecia,19,39,,58,POINT (6170465 -7542726)
2018,Abril,Suecia,1,0,,1,POINT (7128047 -73181317)
2018,Abril,Suecia,0,1,,1,POINT (7819 -72453013)
2018,Abril,Suecia,2,3,,5,POINT (863337 -7735002)
2018,Abril,Suiza,6,4,,10,POINT (-4191162 -69941498)
2018,Abril,Suiza,2,4,,6,POINT (-4214082 -69941431)
2018,Abril,Suiza,0,1,,1,POINT (0.33002 -76876446)
2018,Abril,Suiza,13,16,,29,POINT (0.81488 -77356)
2018,Abril,Suiza,24,18,,42,POINT (10406342 -75527794)
2018,Abril,Suiza,67,54,,121,POINT (10446304 -75516486)
2018,Abril,Suiza,2,4,,6,POINT (10886686 -74776479)
2018,Abril,Suiza,2,5,,7,POINT (11247723 -74213989)
2018,Abril,Suiza,0,1,,1,POINT (11360029 -72129595)
2018,Abril,Suiza,3,4,,7,POINT (125862 -81702165)
2018,Abril,Suiza,22,32,,54,POINT (3451668 -76532004)
2018,Abril,Suiza,436,679,,1115,POINT (4697157 -74140516)
2018,Abril,Suiza,35,66,,101,POINT (6170465 -7542726)
2018,Abril,Suiza,2,4,,6,POINT (7819 -72453013)
2018,Abril,Suiza,6,9,,15,POINT (863337 -7735002)
2018,Abril,Surinam,25,25,,50,POINT (4697157 -74140516)
2018,Abril,Surinam,1,3,,4,POINT (6170465 -7542726)
2018,Abril,Taiwán,1,0,,1,POINT (4697157 -74140516)
2018,Abril,Tailandia,1,2,,3,POINT (10446304 -75516486)
2018,Abril,Tailandia,2,0,,2,POINT (3451668 -76532004)
2018,Abril,Tailandia,35,31,,66,POINT (4697157 -74140516)
2018,Abril,Tailandia,2,0,,2,POINT (6170465 -7542726)
2018,Abril,Tailandia,1,0,,1,POINT (863337 -7735002)
2018,Abril,Tanzania,0,1,,1,POINT (4697157 -74140516)
2018,Abril,Togo,0,1,,1,POINT (10446304 -75516486)
2018,Abril,Trinidad y Tobago,14,15,,29,POINT (10446304 -75516486)
2018,Abril,Trinidad y Tobago,2,4,,6,POINT (10886686 -74776479)
2018,Abril,Trinidad y Tobago,3,3,,6,POINT (3451668 -76532004)
2018,Abril,Trinidad y Tobago,23,43,,66,POINT (4697157 -74140516)
2018,Abril,Trinidad y Tobago,0,2,,2,POINT (4815189 -75736374)
2018,Abril,Trinidad y Tobago,2,7,,9,POINT (6170465 -7542726)
2018,Abril,Trinidad y Tobago,0,3,,3,POINT (7128047 -73181317)
2018,Abril,Trinidad y Tobago,0,1,,1,POINT (7819 -72453013)
2018,Abril,Trinidad y Tobago,1,1,,2,POINT (7927233 -72508188)
2018,Abril,Túnez,1,0,,1,POINT (3451668 -76532004)
2018,Abril,Túnez,3,9,,12,POINT (4697157 -74140516)
2018,Abril,Turquía,1,0,,1,POINT (-4214082 -69941431)
2018,Abril,Turquía,1,3,,4,POINT (0.81488 -77356)
2018,Abril,Turquía,0,1,,1,POINT (10406342 -75527794)
2018,Abril,Turquía,2,14,,16,POINT (10446304 -75516486)
2018,Abril,Turquía,1,0,,1,POINT (10886686 -74776479)
2018,Abril,Turquía,0,7,,7,POINT (10970933 -74765343)
2018,Abril,Turquía,0,3,,3,POINT (11247723 -74213989)
2018,Abril,Turquía,0,5,,5,POINT (3451668 -76532004)
2018,Abril,Turquía,197,390,,587,POINT (4697157 -74140516)
2018,Abril,Turquía,8,22,,30,POINT (6170465 -7542726)
2018,Abril,Turquía,0,2,,2,POINT (9402597 -75681642)
2018,Abril,Ucrania,0,4,,4,POINT (10406342 -75527794)
2018,Abril,Ucrania,2,5,,7,POINT (10446304 -75516486)
2018,Abril,Ucrania,0,7,,7,POINT (10886686 -74776479)
2018,Abril,Ucrania,0,5,,5,POINT (10970933 -74765343)
2018,Abril,Ucrania,0,2,,2,POINT (11247723 -74213989)
2018,Abril,Ucrania,0,1,,1,POINT (3451668 -76532004)
2018,Abril,Ucrania,0,1,,1,POINT (3884426 -77061029)
2018,Abril,Ucrania,24,18,,42,POINT (4697157 -74140516)
2018,Abril,Ucrania,3,4,,7,POINT (6170465 -7542726)
2018,Abril,Ucrania,0,1,,1,POINT (9402597 -75681642)
2018,Abril,Uganda,1,0,,1,POINT (10446304 -75516486)
2018,Abril,Uganda,0,1,,1,POINT (4697157 -74140516)
2018,Abril,Uganda,1,0,,1,POINT (6170465 -7542726)
2018,Abril,Uruguay,1,0,,1,POINT (-4191162 -69941498)
2018,Abril,Uruguay,1,2,,3,POINT (-4214082 -69941431)
2018,Abril,Uruguay,0,1,,1,POINT (0.33002 -76876446)
2018,Abril,Uruguay,9,13,,22,POINT (0.81488 -77356)
2018,Abril,Uruguay,42,21,,63,POINT (10406342 -75527794)
2018,Abril,Uruguay,127,94,,221,POINT (10446304 -75516486)
2018,Abril,Uruguay,2,9,,11,POINT (10886686 -74776479)
2018,Abril,Uruguay,0,1,,1,POINT (11360029 -72129595)
2018,Abril,Uruguay,18,16,,34,POINT (125862 -81702165)
2018,Abril,Uruguay,11,64,,75,POINT (3451668 -76532004)
2018,Abril,Uruguay,0,1,,1,POINT (445285 -75766353)
2018,Abril,Uruguay,573,781,,1354,POINT (4697157 -74140516)
2018,Abril,Uruguay,3,4,,7,POINT (4815189 -75736374)
2018,Abril,Uruguay,45,78,,123,POINT (6170465 -7542726)
2018,Abril,Uruguay,0,2,,2,POINT (7128047 -73181317)
2018,Abril,Uruguay,5,11,,16,POINT (7819 -72453013)
2018,Abril,Uruguay,0,1,,1,POINT (836068 -72409396)
2018,Abril,Uzbekistán,1,0,,1,POINT (6170465 -7542726)
2018,Abril,Venezuela,1,6,,7,POINT (-4191162 -69941498)
2018,Abril,Venezuela,39,51,,90,POINT (0.33002 -76876446)
2018,Abril,Venezuela,6,1,,7,POINT (0.812436 -77847006)
2018,Abril,Venezuela,1590,2241,,3831,POINT (0.81488 -77356)
2018,Abril,Venezuela,1,3,,4,POINT (1800143 -78802679)
2018,Abril,Venezuela,7,36,,43,POINT (10406342 -75527794)
2018,Abril,Venezuela,15,35,,50,POINT (10433609 -73247863)
2018,Abril,Venezuela,114,155,,269,POINT (10446304 -75516486)
2018,Abril,Venezuela,92,165,,257,POINT (10886686 -74776479)
2018,Abril,Venezuela,8,19,,27,POINT (11117206 -74232675)
2018,Abril,Venezuela,8482,9745,,18227,POINT (11360029 -72129595)
2018,Abril,Venezuela,6,6,,12,POINT (1152863 -72919186)
2018,Abril,Venezuela,4,1,,5,POINT (125862 -81702165)
2018,Abril,Venezuela,64,98,,162,POINT (3451668 -76532004)
2018,Abril,Venezuela,11,10,,21,POINT (3866713 -67927521)
2018,Abril,Venezuela,0,1,,1,POINT (445285 -75766353)
2018,Abril,Venezuela,5750,6043,,11793,POINT (4697157 -74140516)
2018,Abril,Venezuela,7,7,,14,POINT (4815189 -75736374)
2018,Abril,Venezuela,1446,1683,,3129,POINT (6170465 -7542726)
2018,Abril,Venezuela,73,48,,121,POINT (6185536 -67484028)
2018,Abril,Venezuela,4,10,,14,POINT (6218835 -75586989)
2018,Abril,Venezuela,896,1176,,2072,POINT (7088729 -70740253)
2018,Abril,Venezuela,25,31,,56,POINT (7128047 -73181317)
2018,Abril,Venezuela,34810,42529,,77339,POINT (7819 -72453013)
2018,Abril,Venezuela,12,25,,37,POINT (7927233 -72508188)
2018,Abril,Venezuela,2660,2901,,5561,POINT (836068 -72409396)
2018,Abril,Vietnam,1,1,,2,POINT (10446304 -75516486)
2018,Abril,Vietnam,2,0,,2,POINT (3451668 -76532004)
2018,Abril,Vietnam,2,5,,7,POINT (4697157 -74140516)
2018,Abril,Vietnam,1,0,,1,POINT (6170465 -7542726)
2018,Abril,Islas Vírgenes Británicas/Territorio Británico de Ultramar,0,1,,1,POINT (6170465 -7542726)
2018,Abril,República Árabe de Yemen,0,1,,1,POINT (0.81488 -77356)
2018,Abril,República Árabe de Yemen,0,3,,3,POINT (4697157 -74140516)
2018,Abril,Zambia,1,0,,1,POINT (10446304 -75516486)
2018,Abril,Zambia,0,1,,1,POINT (4697157 -74140516)
2018,Abril,Zimbabue,0,1,,1,POINT (3451668 -76532004)
2018,Abril,Zimbabue,0,3,,3,POINT (4697157 -74140516)
2018,Abril,Anguila/Territorio Británico de Ultramar,1,0,,1,POINT (4697157 -74140516)
2018,Abril,Refugiado,1,0,,1,POINT (3451668 -76532004)
2018,Abril,Refugiado,7,4,,11,POINT (4697157 -74140516)
2018,Abril,Refugiado,2,3,,5,POINT (6170465 -7542726)
2018,Abril,Desconocido,19,23,,42,POINT (10446304 -75516486)
2018,Abril,Desconocido,0,1,,1,POINT (10886686 -74776479)
2018,Abril,Desconocido,0,1,,1,POINT (3451668 -76532004)
2018,Abril,Desconocido,98,176,,274,POINT (4697157 -74140516)
2018,Abril,Desconocido,0,6,,6,POINT (6170465 -7542726)
2018,Abril,República CentroÁfricana,1,0,,1,POINT (4697157 -74140516)
2018,Mayo,Albania,1,3,,4,POINT (4697157 -74140516)
2018,Mayo,Albania,1,0,,1,POINT (6170465 -7542726)
2018,Mayo,Alemania,5,4,,9,POINT (-4191162 -69941498)
2018,Mayo,Alemania,15,20,,35,POINT (-4214082 -69941431)
2018,Mayo,Alemania,8,3,,11,POINT (0.33002 -76876446)
2018,Mayo,Alemania,68,99,,167,POINT (0.81488 -77356)
2018,Mayo,Alemania,20,40,,60,POINT (10406342 -75527794)
2018,Mayo,Alemania,107,166,,273,POINT (10446304 -75516486)
2018,Mayo,Alemania,22,23,,45,POINT (10886686 -74776479)
2018,Mayo,Alemania,0,2,,2,POINT (10970933 -74765343)
2018,Mayo,Alemania,1,2,,3,POINT (11247723 -74213989)
2018,Mayo,Alemania,1,6,,7,POINT (11360029 -72129595)
2018,Mayo,Alemania,1,3,,4,POINT (125862 -81702165)
2018,Mayo,Alemania,1,5,,6,POINT (133387613 -81372937)
2018,Mayo,Alemania,43,48,,91,POINT (3451668 -76532004)
2018,Mayo,Alemania,0,2,,2,POINT (3884426 -77061029)
2018,Mayo,Alemania,0,1,,1,POINT (445285 -75766353)
2018,Mayo,Alemania,1455,2189,,3644,POINT (4697157 -74140516)
2018,Mayo,Alemania,1,5,,6,POINT (4815189 -75736374)
2018,Mayo,Alemania,81,189,,270,POINT (6170465 -7542726)
2018,Mayo,Alemania,1,3,,4,POINT (7128047 -73181317)
2018,Mayo,Alemania,1,1,,2,POINT (836068 -72409396)
2018,Mayo,Alemania,9,6,,15,POINT (863337 -7735002)
2018,Mayo,Andorra,0,2,,2,POINT (10446304 -75516486)
2018,Mayo,Andorra,1,7,,8,POINT (4697157 -74140516)
2018,Mayo,Antigua y Barbuda,0,1,,1,POINT (10446304 -75516486)
2018,Mayo,Antigua y Barbuda,1,7,,8,POINT (4697157 -74140516)
2018,Mayo,Antigua y Barbuda,0,2,,2,POINT (6170465 -7542726)
2018,Mayo,Países Bajos,0,1,,1,POINT (10886686 -74776479)
2018,Mayo,Arabia Saudita,0,6,,6,POINT (4697157 -74140516)
2018,Mayo,Arabia Saudita,0,1,,1,POINT (6170465 -7542726)
2018,Mayo,Argelia,1,0,,1,POINT (10446304 -75516486)
2018,Mayo,Argelia,1,0,,1,POINT (3451668 -76532004)
2018,Mayo,Argelia,2,2,,4,POINT (4697157 -74140516)
2018,Mayo,Argentina,3,6,,9,POINT (-4191162 -69941498)
2018,Mayo,Argentina,3,6,,9,POINT (-4214082 -69941431)
2018,Mayo,Argentina,9,23,,32,POINT (0.33002 -76876446)
2018,Mayo,Argentina,83,117,,200,POINT (0.81488 -77356)
2018,Mayo,Argentina,118,84,,202,POINT (10406342 -75527794)
2018,Mayo,Argentina,1973,1283,,3256,POINT (10446304 -75516486)
2018,Mayo,Argentina,22,45,,67,POINT (10886686 -74776479)
2018,Mayo,Argentina,4,5,,9,POINT (11360029 -72129595)
2018,Mayo,Argentina,295,209,,504,POINT (125862 -81702165)
2018,Mayo,Argentina,35,55,,90,POINT (3451668 -76532004)
2018,Mayo,Argentina,1,1,,2,POINT (3866713 -67927521)
2018,Mayo,Argentina,0,2,,2,POINT (445285 -75766353)
2018,Mayo,Argentina,5368,6258,,11626,POINT (4697157 -74140516)
2018,Mayo,Argentina,3,9,,12,POINT (4815189 -75736374)
2018,Mayo,Argentina,254,476,,730,POINT (6170465 -7542726)
2018,Mayo,Argentina,0,1,,1,POINT (7088729 -70740253)
2018,Mayo,Argentina,2,3,,5,POINT (7128047 -73181317)
2018,Mayo,Argentina,7,13,,20,POINT (7819 -72453013)
2018,Mayo,Argentina,0,3,,3,POINT (836068 -72409396)
2018,Mayo,Argentina,0,2,,2,POINT (863337 -7735002)
2018,Mayo,República de Armenia,1,0,,1,POINT (3451668 -76532004)
2018,Mayo,República de Armenia,1,2,,3,POINT (4697157 -74140516)
2018,Mayo,República de Armenia,1,0,,1,POINT (6170465 -7542726)
2018,Mayo,Australia,0,1,,1,POINT (-4191162 -69941498)
2018,Mayo,Australia,3,2,,5,POINT (-4214082 -69941431)
2018,Mayo,Australia,16,32,,48,POINT (0.81488 -77356)
2018,Mayo,Australia,15,20,,35,POINT (10406342 -75527794)
2018,Mayo,Australia,47,73,,120,POINT (10446304 -75516486)
2018,Mayo,Australia,7,25,,32,POINT (10886686 -74776479)
2018,Mayo,Australia,0,1,,1,POINT (11360029 -72129595)
2018,Mayo,Australia,1,0,,1,POINT (125862 -81702165)
2018,Mayo,Australia,7,14,,21,POINT (3451668 -76532004)
2018,Mayo,Australia,311,532,,843,POINT (4697157 -74140516)
2018,Mayo,Australia,48,100,,148,POINT (6170465 -7542726)
2018,Mayo,Australia,1,1,,2,POINT (7128047 -73181317)
2018,Mayo,Australia,0,1,,1,POINT (7819 -72453013)
2018,Mayo,Australia,10,6,,16,POINT (863337 -7735002)
2018,Mayo,Austria,1,0,,1,POINT (-4214082 -69941431)
2018,Mayo,Austria,2,1,,3,POINT (0.33002 -76876446)
2018,Mayo,Austria,9,8,,17,POINT (0.81488 -77356)
2018,Mayo,Austria,2,3,,5,POINT (10406342 -75527794)
2018,Mayo,Austria,12,17,,29,POINT (10446304 -75516486)
2018,Mayo,Austria,2,0,,2,POINT (10886686 -74776479)
2018,Mayo,Austria,0,1,,1,POINT (11247723 -74213989)
2018,Mayo,Austria,8,11,,19,POINT (3451668 -76532004)
2018,Mayo,Austria,122,240,,362,POINT (4697157 -74140516)
2018,Mayo,Austria,1,1,,2,POINT (4815189 -75736374)
2018,Mayo,Austria,8,27,,35,POINT (6170465 -7542726)
2018,Mayo,Austria,2,0,,2,POINT (863337 -7735002)
2018,Mayo,Azerbaiyán,2,1,,3,POINT (10446304 -75516486)
2018,Mayo,Azerbaiyán,0,5,,5,POINT (4697157 -74140516)
2018,Mayo,Azerbaiyán,0,2,,2,POINT (6170465 -7542726)
2018,Mayo,Bahamas,2,10,,12,POINT (10446304 -75516486)
2018,Mayo,Bahamas,0,3,,3,POINT (10886686 -74776479)
2018,Mayo,Bahamas,2,1,,3,POINT (3451668 -76532004)
2018,Mayo,Bahamas,1,8,,9,POINT (4697157 -74140516)
2018,Mayo,Bahamas,0,2,,2,POINT (6170465 -7542726)
2018,Mayo,Bahréin,0,1,,1,POINT (4697157 -74140516)
2018,Mayo,Bangladesh,4,1,,5,POINT (4697157 -74140516)
2018,Mayo,Barbados,2,1,,3,POINT (10446304 -75516486)
2018,Mayo,Barbados,2,2,,4,POINT (10886686 -74776479)
2018,Mayo,Barbados,2,1,,3,POINT (3451668 -76532004)
2018,Mayo,Barbados,14,19,,33,POINT (4697157 -74140516)
2018,Mayo,Barbados,1,1,,2,POINT (6170465 -7542726)
2018,Mayo,República de Belarús,2,0,,2,POINT (10446304 -75516486)
2018,Mayo,República de Belarús,6,1,,7,POINT (4697157 -74140516)
2018,Mayo,República de Belarús,1,0,,1,POINT (7102626 -77762647)
2018,Mayo,Bélgica,0,1,,1,POINT (-4191162 -69941498)
2018,Mayo,Bélgica,2,5,,7,POINT (-4214082 -69941431)
2018,Mayo,Bélgica,0,1,,1,POINT (0.33002 -76876446)
2018,Mayo,Bélgica,11,23,,34,POINT (0.81488 -77356)
2018,Mayo,Bélgica,5,4,,9,POINT (10406342 -75527794)
2018,Mayo,Bélgica,26,45,,71,POINT (10446304 -75516486)
2018,Mayo,Bélgica,1,7,,8,POINT (10886686 -74776479)
2018,Mayo,Bélgica,1,0,,1,POINT (11360029 -72129595)
2018,Mayo,Bélgica,0,1,,1,POINT (133387613 -81372937)
2018,Mayo,Bélgica,11,14,,25,POINT (3451668 -76532004)
2018,Mayo,Bélgica,0,8,,8,POINT (3884426 -77061029)
2018,Mayo,Bélgica,150,305,,455,POINT (4697157 -74140516)
2018,Mayo,Bélgica,21,38,,59,POINT (6170465 -7542726)
2018,Mayo,Bélgica,0,1,,1,POINT (7128047 -73181317)
2018,Mayo,Bélgica,0,2,,2,POINT (7819 -72453013)
2018,Mayo,Bélgica,3,0,,3,POINT (863337 -7735002)
2018,Mayo,Belice,0,1,,1,POINT (0.81488 -77356)
2018,Mayo,Belice,0,2,,2,POINT (10446304 -75516486)
2018,Mayo,Belice,1,0,,1,POINT (125862 -81702165)
2018,Mayo,Belice,0,1,,1,POINT (3451668 -76532004)
2018,Mayo,Belice,2,5,,7,POINT (4697157 -74140516)
2018,Mayo,Belice,5,1,,6,POINT (6170465 -7542726)
2018,Mayo,Bermudas/Territorio Británico de Ultramar,2,1,,3,POINT (10446304 -75516486)
2018,Mayo,Bermudas/Territorio Británico de Ultramar,0,1,,1,POINT (3451668 -76532004)
2018,Mayo,Bolivia,1,0,,1,POINT (-4191162 -69941498)
2018,Mayo,Bolivia,0,1,,1,POINT (0.33002 -76876446)
2018,Mayo,Bolivia,1,0,,1,POINT (0.812436 -77847006)
2018,Mayo,Bolivia,16,16,,32,POINT (0.81488 -77356)
2018,Mayo,Bolivia,1,1,,2,POINT (10406342 -75527794)
2018,Mayo,Bolivia,185,100,,285,POINT (10446304 -75516486)
2018,Mayo,Bolivia,1,2,,3,POINT (10886686 -74776479)
2018,Mayo,Bolivia,41,14,,55,POINT (125862 -81702165)
2018,Mayo,Bolivia,9,10,,19,POINT (3451668 -76532004)
2018,Mayo,Bolivia,0,1,,1,POINT (445285 -75766353)
2018,Mayo,Bolivia,504,486,,990,POINT (4697157 -74140516)
2018,Mayo,Bolivia,3,3,,6,POINT (4815189 -75736374)
2018,Mayo,Bolivia,38,34,,72,POINT (6170465 -7542726)
2018,Mayo,Bolivia,0,1,,1,POINT (7128047 -73181317)
2018,Mayo,Bolivia,0,6,,6,POINT (7819 -72453013)
2018,Mayo,Bosnia y Herzegovina,2,1,,3,POINT (10446304 -75516486)
2018,Mayo,Bosnia y Herzegovina,4,7,,11,POINT (4697157 -74140516)
2018,Mayo,Botsuana,0,1,,1,POINT (4697157 -74140516)
2018,Mayo,Brasil,98,102,,200,POINT (-4191162 -69941498)
2018,Mayo,Brasil,4,3,,7,POINT (-4214082 -69941431)
2018,Mayo,Brasil,0,2,,2,POINT (0.33002 -76876446)
2018,Mayo,Brasil,19,29,,48,POINT (0.81488 -77356)
2018,Mayo,Brasil,122,71,,193,POINT (10406342 -75527794)
2018,Mayo,Brasil,878,649,,1527,POINT (10446304 -75516486)
2018,Mayo,Brasil,20,27,,47,POINT (10886686 -74776479)
2018,Mayo,Brasil,1,1,,2,POINT (11360029 -72129595)
2018,Mayo,Brasil,292,223,,515,POINT (125862 -81702165)
2018,Mayo,Brasil,43,53,,96,POINT (3451668 -76532004)
2018,Mayo,Brasil,4,6,,10,POINT (3866713 -67927521)
2018,Mayo,Brasil,5559,6701,,12260,POINT (4697157 -74140516)
2018,Mayo,Brasil,2,6,,8,POINT (4815189 -75736374)
2018,Mayo,Brasil,125,249,,374,POINT (6170465 -7542726)
2018,Mayo,Brasil,0,1,,1,POINT (6185536 -67484028)
2018,Mayo,Brasil,0,2,,2,POINT (7128047 -73181317)
2018,Mayo,Brasil,1,9,,10,POINT (7819 -72453013)
2018,Mayo,Brasil,0,4,,4,POINT (836068 -72409396)
2018,Mayo,Brasil,0,1,,1,POINT (863337 -7735002)
2018,Mayo,Brunei Darussalam,1,0,,1,POINT (4697157 -74140516)
2018,Mayo,Bulgaria,1,1,,2,POINT (0.33002 -76876446)
2018,Mayo,Bulgaria,1,2,,3,POINT (0.81488 -77356)
2018,Mayo,Bulgaria,3,1,,4,POINT (10446304 -75516486)
2018,Mayo,Bulgaria,1,0,,1,POINT (10886686 -74776479)
2018,Mayo,Bulgaria,3,2,,5,POINT (3451668 -76532004)
2018,Mayo,Bulgaria,40,39,,79,POINT (4697157 -74140516)
2018,Mayo,Bulgaria,2,4,,6,POINT (6170465 -7542726)
2018,Mayo,Burkina Faso,0,2,,2,POINT (4697157 -74140516)
2018,Mayo,Burkina Faso,1,0,,1,POINT (6170465 -7542726)
2018,Mayo,Bután,0,1,,1,POINT (10446304 -75516486)
2018,Mayo,Islas Caimán/Territorio Británico de Ultramar,1,0,,1,POINT (10446304 -75516486)
2018,Mayo,Islas Caimán/Territorio Británico de Ultramar,1,0,,1,POINT (10886686 -74776479)
2018,Mayo,Islas Caimán/Territorio Británico de Ultramar,0,1,,1,POINT (125862 -81702165)
2018,Mayo,Islas Caimán/Territorio Británico de Ultramar,4,1,,5,POINT (4697157 -74140516)
2018,Mayo,Islas Caimán/Territorio Británico de Ultramar,0,1,,1,POINT (6170465 -7542726)
2018,Mayo,Camboya,0,1,,1,POINT (10446304 -75516486)
2018,Mayo,Camerún,0,1,,1,POINT (10446304 -75516486)
2018,Mayo,Camerún,0,4,,4,POINT (4697157 -74140516)
2018,Mayo,Camerún,1,1,,2,POINT (6170465 -7542726)
2018,Mayo,Canadá,2,2,,4,POINT (-4191162 -69941498)
2018,Mayo,Canadá,10,7,,17,POINT (-4214082 -69941431)
2018,Mayo,Canadá,0,1,,1,POINT (0.33002 -76876446)
2018,Mayo,Canadá,0,1,,1,POINT (0.812436 -77847006)
2018,Mayo,Canadá,18,10,,28,POINT (0.81488 -77356)
2018,Mayo,Canadá,15,14,,29,POINT (10406342 -75527794)
2018,Mayo,Canadá,208,224,,432,POINT (10446304 -75516486)
2018,Mayo,Canadá,29,48,,77,POINT (10886686 -74776479)
2018,Mayo,Canadá,0,1,,1,POINT (11360029 -72129595)
2018,Mayo,Canadá,3,3,,6,POINT (125862 -81702165)
2018,Mayo,Canadá,1,0,,1,POINT (133387613 -81372937)
2018,Mayo,Canadá,52,67,,119,POINT (3451668 -76532004)
2018,Mayo,Canadá,2,2,,4,POINT (445285 -75766353)
2018,Mayo,Canadá,1059,1608,,2667,POINT (4697157 -74140516)
2018,Mayo,Canadá,22,17,,39,POINT (4815189 -75736374)
2018,Mayo,Canadá,194,404,,598,POINT (6170465 -7542726)
2018,Mayo,Canadá,0,2,,2,POINT (6185536 -67484028)
2018,Mayo,Canadá,2,5,,7,POINT (7128047 -73181317)
2018,Mayo,Canadá,1,8,,9,POINT (7819 -72453013)
2018,Mayo,Canadá,7,3,,10,POINT (863337 -7735002)
2018,Mayo,República Del Congo,0,1,,1,POINT (0.81488 -77356)
2018,Mayo,República Democrática del Congo,1,0,,1,POINT (0.81488 -77356)
2018,Mayo,República Democrática del Congo,0,1,,1,POINT (10446304 -75516486)
2018,Mayo,República Democrática del Congo,5,3,,8,POINT (4697157 -74140516)
2018,Mayo,República Democrática del Congo,1,0,,1,POINT (6170465 -7542726)
2018,Mayo,República de Corea,0,1,,1,POINT (0.33002 -76876446)
2018,Mayo,República de Corea,13,17,,30,POINT (0.81488 -77356)
2018,Mayo,República de Corea,0,1,,1,POINT (10406342 -75527794)
2018,Mayo,República de Corea,10,9,,19,POINT (10446304 -75516486)
2018,Mayo,República de Corea,0,3,,3,POINT (10886686 -74776479)
2018,Mayo,República de Corea,1,1,,2,POINT (11360029 -72129595)
2018,Mayo,República de Corea,7,17,,24,POINT (3451668 -76532004)
2018,Mayo,República de Corea,190,381,,571,POINT (4697157 -74140516)
2018,Mayo,República de Corea,0,1,,1,POINT (4815189 -75736374)
2018,Mayo,República de Corea,13,29,,42,POINT (6170465 -7542726)
2018,Mayo,República de Corea,2,0,,2,POINT (7819 -72453013)
2018,Mayo,Costa de Marfil,0,1,,1,POINT (4697157 -74140516)
2018,Mayo,Costa de Marfil,0,1,,1,POINT (6170465 -7542726)
2018,Mayo,Costa Rica,2,2,,4,POINT (0.81488 -77356)
2018,Mayo,Costa Rica,0,1,,1,POINT (1800143 -78802679)
2018,Mayo,Costa Rica,159,113,,272,POINT (10446304 -75516486)
2018,Mayo,Costa Rica,22,25,,47,POINT (10886686 -74776479)
2018,Mayo,Costa Rica,1,0,,1,POINT (11360029 -72129595)
2018,Mayo,Costa Rica,45,39,,84,POINT (125862 -81702165)
2018,Mayo,Costa Rica,24,47,,71,POINT (3451668 -76532004)
2018,Mayo,Costa Rica,0,1,,1,POINT (3884426 -77061029)
2018,Mayo,Costa Rica,0,1,,1,POINT (445285 -75766353)
2018,Mayo,Costa Rica,1282,1795,,3077,POINT (4697157 -74140516)
2018,Mayo,Costa Rica,7,2,,9,POINT (4815189 -75736374)
2018,Mayo,Costa Rica,160,217,,377,POINT (6170465 -7542726)
2018,Mayo,Costa Rica,0,4,,4,POINT (6218835 -75586989)
2018,Mayo,Costa Rica,0,2,,2,POINT (7128047 -73181317)
2018,Mayo,Costa Rica,1,0,,1,POINT (7819 -72453013)
2018,Mayo,Croacia,2,1,,3,POINT (10446304 -75516486)
2018,Mayo,Croacia,0,2,,2,POINT (10886686 -74776479)
2018,Mayo,Croacia,0,1,,1,POINT (3451668 -76532004)
2018,Mayo,Croacia,0,6,,6,POINT (3884426 -77061029)
2018,Mayo,Croacia,10,40,,50,POINT (4697157 -74140516)
2018,Mayo,Croacia,1,5,,6,POINT (6170465 -7542726)
2018,Mayo,Cuba,1,0,,1,POINT (-4191162 -69941498)
2018,Mayo,Cuba,0,1,,1,POINT (0.81488 -77356)
2018,Mayo,Cuba,0,2,,2,POINT (10406342 -75527794)
2018,Mayo,Cuba,13,19,,32,POINT (10446304 -75516486)
2018,Mayo,Cuba,7,21,,28,POINT (10886686 -74776479)
2018,Mayo,Cuba,0,1,,1,POINT (11247723 -74213989)
2018,Mayo,Cuba,21,23,,44,POINT (3451668 -76532004)
2018,Mayo,Cuba,0,1,,1,POINT (445285 -75766353)
2018,Mayo,Cuba,178,319,,497,POINT (4697157 -74140516)
2018,Mayo,Cuba,1,4,,5,POINT (4815189 -75736374)
2018,Mayo,Cuba,19,26,,45,POINT (6170465 -7542726)
2018,Mayo,Cuba,0,1,,1,POINT (6185536 -67484028)
2018,Mayo,Cuba,2,2,,4,POINT (7819 -72453013)
2018,Mayo,Curazao,0,1,,1,POINT (4697157 -74140516)
2018,Mayo,República Checa,1,0,,1,POINT (-4214082 -69941431)
2018,Mayo,República Checa,4,9,,13,POINT (0.81488 -77356)
2018,Mayo,República Checa,12,12,,24,POINT (10446304 -75516486)
2018,Mayo,República Checa,0,2,,2,POINT (10886686 -74776479)
2018,Mayo,República Checa,1,3,,4,POINT (133387613 -81372937)
2018,Mayo,República Checa,3,10,,13,POINT (3451668 -76532004)
2018,Mayo,República Checa,35,70,,105,POINT (4697157 -74140516)
2018,Mayo,República Checa,2,5,,7,POINT (6170465 -7542726)
2018,Mayo,Chile,1,2,,3,POINT (-4191162 -69941498)
2018,Mayo,Chile,1,4,,5,POINT (-4214082 -69941431)
2018,Mayo,Chile,3,0,,3,POINT (0.33002 -76876446)
2018,Mayo,Chile,45,100,,145,POINT (0.81488 -77356)
2018,Mayo,Chile,2,1,,3,POINT (1800143 -78802679)
2018,Mayo,Chile,89,80,,169,POINT (10406342 -75527794)
2018,Mayo,Chile,603,505,,1108,POINT (10446304 -75516486)
2018,Mayo,Chile,16,17,,33,POINT (10886686 -74776479)
2018,Mayo,Chile,0,21,,21,POINT (11360029 -72129595)
2018,Mayo,Chile,140,100,,240,POINT (125862 -81702165)
2018,Mayo,Chile,29,57,,86,POINT (3451668 -76532004)
2018,Mayo,Chile,0,1,,1,POINT (445285 -75766353)
2018,Mayo,Chile,4277,5487,,9764,POINT (4697157 -74140516)
2018,Mayo,Chile,3,5,,8,POINT (4815189 -75736374)
2018,Mayo,Chile,133,459,,592,POINT (6170465 -7542726)
2018,Mayo,Chile,8,25,,33,POINT (7819 -72453013)
2018,Mayo,Chile,3,6,,9,POINT (836068 -72409396)
2018,Mayo,China,1,1,,2,POINT (-4191162 -69941498)
2018,Mayo,China,1,0,,1,POINT (-4214082 -69941431)
2018,Mayo,China,5,5,,10,POINT (0.81488 -77356)
2018,Mayo,China,0,4,,4,POINT (10406342 -75527794)
2018,Mayo,China,22,23,,45,POINT (10446304 -75516486)
2018,Mayo,China,8,21,,29,POINT (10886686 -74776479)
2018,Mayo,China,0,1,,1,POINT (10970933 -74765343)
2018,Mayo,China,0,5,,5,POINT (11247723 -74213989)
2018,Mayo,China,0,4,,4,POINT (11360029 -72129595)
2018,Mayo,China,16,24,,40,POINT (3451668 -76532004)
2018,Mayo,China,0,4,,4,POINT (3884426 -77061029)
2018,Mayo,China,397,935,,1332,POINT (4697157 -74140516)
2018,Mayo,China,0,1,,1,POINT (4815189 -75736374)
2018,Mayo,China,60,94,,154,POINT (6170465 -7542726)
2018,Mayo,China,1,1,,2,POINT (7128047 -73181317)
2018,Mayo,China,3,4,,7,POINT (7819 -72453013)
2018,Mayo,China,2,1,,3,POINT (836068 -72409396)
2018,Mayo,China,0,1,,1,POINT (9402597 -75681642)
2018,Mayo,Taiwán,3,3,,6,POINT (0.81488 -77356)
2018,Mayo,Taiwán,0,1,,1,POINT (10406342 -75527794)
2018,Mayo,Taiwán,2,3,,5,POINT (10446304 -75516486)
2018,Mayo,Taiwán,1,1,,2,POINT (3451668 -76532004)
2018,Mayo,Taiwán,71,80,,151,POINT (4697157 -74140516)
2018,Mayo,Taiwán,7,17,,24,POINT (6170465 -7542726)
2018,Mayo,Taiwán,0,4,,4,POINT (7819 -72453013)
2018,Mayo,Chipre,0,1,,1,POINT (10446304 -75516486)
2018,Mayo,Chipre,3,4,,7,POINT (4697157 -74140516)
2018,Mayo,Chipre,2,3,,5,POINT (6170465 -7542726)
2018,Mayo,Dinamarca,2,6,,8,POINT (-4214082 -69941431)
2018,Mayo,Dinamarca,1,1,,2,POINT (0.33002 -76876446)
2018,Mayo,Dinamarca,5,5,,10,POINT (0.81488 -77356)
2018,Mayo,Dinamarca,1,2,,3,POINT (10406342 -75527794)
2018,Mayo,Dinamarca,12,22,,34,POINT (10446304 -75516486)
2018,Mayo,Dinamarca,1,2,,3,POINT (10886686 -74776479)
2018,Mayo,Dinamarca,0,1,,1,POINT (10970933 -74765343)
2018,Mayo,Dinamarca,3,6,,9,POINT (3451668 -76532004)
2018,Mayo,Dinamarca,84,123,,207,POINT (4697157 -74140516)
2018,Mayo,Dinamarca,0,1,,1,POINT (4815189 -75736374)
2018,Mayo,Dinamarca,5,13,,18,POINT (6170465 -7542726)
2018,Mayo,Dinamarca,0,2,,2,POINT (7819 -72453013)
2018,Mayo,Dinamarca,1,0,,1,POINT (863337 -7735002)
2018,Mayo,Dominica,0,2,,2,POINT (10446304 -75516486)
2018,Mayo,Dominica,1,1,,2,POINT (10886686 -74776479)
2018,Mayo,Dominica,0,1,,1,POINT (3451668 -76532004)
2018,Mayo,Dominica,2,0,,2,POINT (4697157 -74140516)
2018,Mayo,Dominica,0,2,,2,POINT (6170465 -7542726)
2018,Mayo,Ecuador,0,1,,1,POINT (-4214082 -69941431)
2018,Mayo,Ecuador,43,185,,228,POINT (0.33002 -76876446)
2018,Mayo,Ecuador,24,25,,49,POINT (0.812436 -77847006)
2018,Mayo,Ecuador,1059,1314,,2373,POINT (0.81488 -77356)
2018,Mayo,Ecuador,11,19,,30,POINT (1800143 -78802679)
2018,Mayo,Ecuador,11,10,,21,POINT (10406342 -75527794)
2018,Mayo,Ecuador,71,63,,134,POINT (10446304 -75516486)
2018,Mayo,Ecuador,16,14,,30,POINT (10886686 -74776479)
2018,Mayo,Ecuador,11,10,,21,POINT (11360029 -72129595)
2018,Mayo,Ecuador,32,37,,69,POINT (125862 -81702165)
2018,Mayo,Ecuador,390,389,,779,POINT (3451668 -76532004)
2018,Mayo,Ecuador,1,0,,1,POINT (3866713 -67927521)
2018,Mayo,Ecuador,0,2,,2,POINT (445285 -75766353)
2018,Mayo,Ecuador,3066,3704,,6770,POINT (4697157 -74140516)
2018,Mayo,Ecuador,3,5,,8,POINT (4815189 -75736374)
2018,Mayo,Ecuador,57,85,,142,POINT (6170465 -7542726)
2018,Mayo,Ecuador,1,3,,4,POINT (7088729 -70740253)
2018,Mayo,Ecuador,103,158,,261,POINT (7819 -72453013)
2018,Mayo,Ecuador,2,12,,14,POINT (836068 -72409396)
2018,Mayo,Ecuador,0,1,,1,POINT (863337 -7735002)
2018,Mayo,Egipto,1,1,,2,POINT (10446304 -75516486)
2018,Mayo,Egipto,0,2,,2,POINT (3451668 -76532004)
2018,Mayo,Egipto,7,24,,31,POINT (4697157 -74140516)
2018,Mayo,Egipto,0,4,,4,POINT (6170465 -7542726)
2018,Mayo,Egipto,0,1,,1,POINT (7128047 -73181317)
2018,Mayo,El Salvador,1,4,,5,POINT (0.81488 -77356)
2018,Mayo,El Salvador,0,2,,2,POINT (10406342 -75527794)
2018,Mayo,El Salvador,48,45,,93,POINT (10446304 -75516486)
2018,Mayo,El Salvador,24,19,,43,POINT (10886686 -74776479)
2018,Mayo,El Salvador,1,1,,2,POINT (125862 -81702165)
2018,Mayo,El Salvador,7,12,,19,POINT (3451668 -76532004)
2018,Mayo,El Salvador,793,945,,1738,POINT (4697157 -74140516)
2018,Mayo,El Salvador,4,2,,6,POINT (4815189 -75736374)
2018,Mayo,El Salvador,171,239,,410,POINT (6170465 -7542726)
2018,Mayo,Emiratos Árabes,1,6,,7,POINT (10446304 -75516486)
2018,Mayo,Emiratos Árabes,1,5,,6,POINT (4697157 -74140516)
2018,Mayo,España,1,3,,4,POINT (-4191162 -69941498)
2018,Mayo,España,5,8,,13,POINT (-4214082 -69941431)
2018,Mayo,España,3,6,,9,POINT (0.33002 -76876446)
2018,Mayo,España,33,41,,74,POINT (0.81488 -77356)
2018,Mayo,España,11,19,,30,POINT (10406342 -75527794)
2018,Mayo,España,117,186,,303,POINT (10446304 -75516486)
2018,Mayo,España,25,56,,81,POINT (10886686 -74776479)
2018,Mayo,España,0,1,,1,POINT (11117206 -74232675)
2018,Mayo,España,0,2,,2,POINT (11247723 -74213989)
2018,Mayo,España,1,3,,4,POINT (11360029 -72129595)
2018,Mayo,España,8,15,,23,POINT (125862 -81702165)
2018,Mayo,España,347,413,,760,POINT (3451668 -76532004)
2018,Mayo,España,2864,5536,,8400,POINT (4697157 -74140516)
2018,Mayo,España,1,13,,14,POINT (4815189 -75736374)
2018,Mayo,España,341,710,,1051,POINT (6170465 -7542726)
2018,Mayo,España,0,1,,1,POINT (7088729 -70740253)
2018,Mayo,España,0,3,,3,POINT (7128047 -73181317)
2018,Mayo,España,15,48,,63,POINT (7819 -72453013)
2018,Mayo,España,4,7,,11,POINT (836068 -72409396)
2018,Mayo,España,1,4,,5,POINT (863337 -7735002)
2018,Mayo,Eslovaquia,0,2,,2,POINT (0.81488 -77356)
2018,Mayo,Eslovaquia,0,1,,1,POINT (10406342 -75527794)
2018,Mayo,Eslovaquia,6,6,,12,POINT (10446304 -75516486)
2018,Mayo,Eslovaquia,1,0,,1,POINT (3451668 -76532004)
2018,Mayo,Eslovaquia,17,32,,49,POINT (4697157 -74140516)
2018,Mayo,Eslovaquia,4,5,,9,POINT (6170465 -7542726)
2018,Mayo,Eslovenia,1,0,,1,POINT (0.81488 -77356)
2018,Mayo,Eslovenia,1,1,,2,POINT (3451668 -76532004)
2018,Mayo,Eslovenia,8,15,,23,POINT (4697157 -74140516)
2018,Mayo,Eslovenia,0,4,,4,POINT (6170465 -7542726)
2018,Mayo,Estados Unidos de América,10,11,,21,POINT (-4191162 -69941498)
2018,Mayo,Estados Unidos de América,19,21,,40,POINT (-4214082 -69941431)
2018,Mayo,Estados Unidos de América,4,5,,9,POINT (0.33002 -76876446)
2018,Mayo,Estados Unidos de América,1,0,,1,POINT (0.812436 -77847006)
2018,Mayo,Estados Unidos de América,71,62,,133,POINT (0.81488 -77356)
2018,Mayo,Estados Unidos de América,26,42,,68,POINT (10406342 -75527794)
2018,Mayo,Estados Unidos de América,5194,6737,,11931,POINT (10446304 -75516486)
2018,Mayo,Estados Unidos de América,606,1011,,1617,POINT (10886686 -74776479)
2018,Mayo,Estados Unidos de América,3,6,,9,POINT (11247723 -74213989)
2018,Mayo,Estados Unidos de América,1,5,,6,POINT (11360029 -72129595)
2018,Mayo,Estados Unidos de América,0,6,,6,POINT (125744111 -81703935)
2018,Mayo,Estados Unidos de América,40,46,,86,POINT (125862 -81702165)
2018,Mayo,Estados Unidos de América,2,8,,10,POINT (133387613 -81372937)
2018,Mayo,Estados Unidos de América,1171,1583,,2754,POINT (3451668 -76532004)
2018,Mayo,Estados Unidos de América,183,239,,422,POINT (445285 -75766353)
2018,Mayo,Estados Unidos de América,9211,15113,,24324,POINT (4697157 -74140516)
2018,Mayo,Estados Unidos de América,143,161,,304,POINT (4815189 -75736374)
2018,Mayo,Estados Unidos de América,2865,6813,,9678,POINT (6170465 -7542726)
2018,Mayo,Estados Unidos de América,0,1,,1,POINT (6185536 -67484028)
2018,Mayo,Estados Unidos de América,0,1,,1,POINT (7088729 -70740253)
2018,Mayo,Estados Unidos de América,37,63,,100,POINT (7128047 -73181317)
2018,Mayo,Estados Unidos de América,13,14,,27,POINT (7819 -72453013)
2018,Mayo,Estados Unidos de América,2,3,,5,POINT (836068 -72409396)
2018,Mayo,Estados Unidos de América,4,9,,13,POINT (863337 -7735002)
2018,Mayo,Estonia,1,0,,1,POINT (10446304 -75516486)
2018,Mayo,Estonia,1,0,,1,POINT (3451668 -76532004)
2018,Mayo,Estonia,6,8,,14,POINT (4697157 -74140516)
2018,Mayo,Estonia,2,1,,3,POINT (6170465 -7542726)
2018,Mayo,Etiopia,0,1,,1,POINT (3884426 -77061029)
2018,Mayo,Etiopia,0,1,,1,POINT (4697157 -74140516)
2018,Mayo,Islas Fiji,1,0,,1,POINT (10446304 -75516486)
2018,Mayo,Islas Fiji,0,1,,1,POINT (4697157 -74140516)
2018,Mayo,Filipinas,2,0,,2,POINT (0.81488 -77356)
2018,Mayo,Filipinas,2,31,,33,POINT (10406342 -75527794)
2018,Mayo,Filipinas,6,86,,92,POINT (10446304 -75516486)
2018,Mayo,Filipinas,1,15,,16,POINT (10886686 -74776479)
2018,Mayo,Filipinas,0,25,,25,POINT (10970933 -74765343)
2018,Mayo,Filipinas,0,26,,26,POINT (11247723 -74213989)
2018,Mayo,Filipinas,1,1,,2,POINT (125862 -81702165)
2018,Mayo,Filipinas,4,11,,15,POINT (3451668 -76532004)
2018,Mayo,Filipinas,0,20,,20,POINT (3884426 -77061029)
2018,Mayo,Filipinas,39,78,,117,POINT (4697157 -74140516)
2018,Mayo,Filipinas,7,5,,12,POINT (6170465 -7542726)
2018,Mayo,Filipinas,0,1,,1,POINT (9402597 -75681642)
2018,Mayo,Finlandia,0,1,,1,POINT (-4214082 -69941431)
2018,Mayo,Finlandia,4,2,,6,POINT (0.81488 -77356)
2018,Mayo,Finlandia,6,6,,12,POINT (10446304 -75516486)
2018,Mayo,Finlandia,10,4,,14,POINT (3451668 -76532004)
2018,Mayo,Finlandia,42,61,,103,POINT (4697157 -74140516)
2018,Mayo,Finlandia,0,1,,1,POINT (4815189 -75736374)
2018,Mayo,Finlandia,6,6,,12,POINT (6170465 -7542726)
2018,Mayo,Finlandia,1,0,,1,POINT (863337 -7735002)
2018,Mayo,Francia,9,10,,19,POINT (-4191162 -69941498)
2018,Mayo,Francia,26,14,,40,POINT (-4214082 -69941431)
2018,Mayo,Francia,4,10,,14,POINT (0.33002 -76876446)
2018,Mayo,Francia,1,0,,1,POINT (0.812436 -77847006)
2018,Mayo,Francia,101,122,,223,POINT (0.81488 -77356)
2018,Mayo,Francia,1,1,,2,POINT (1800143 -78802679)
2018,Mayo,Francia,16,15,,31,POINT (10406342 -75527794)
2018,Mayo,Francia,112,158,,270,POINT (10446304 -75516486)
2018,Mayo,Francia,5,20,,25,POINT (10886686 -74776479)
2018,Mayo,Francia,1,1,,2,POINT (10970933 -74765343)
2018,Mayo,Francia,1,2,,3,POINT (11247723 -74213989)
2018,Mayo,Francia,1,6,,7,POINT (11360029 -72129595)
2018,Mayo,Francia,1,1,,2,POINT (125744111 -81703935)
2018,Mayo,Francia,1,3,,4,POINT (125862 -81702165)
2018,Mayo,Francia,2,2,,4,POINT (133387613 -81372937)
2018,Mayo,Francia,59,84,,143,POINT (3451668 -76532004)
2018,Mayo,Francia,1,0,,1,POINT (445285 -75766353)
2018,Mayo,Francia,1504,2343,,3847,POINT (4697157 -74140516)
2018,Mayo,Francia,10,9,,19,POINT (4815189 -75736374)
2018,Mayo,Francia,113,218,,331,POINT (6170465 -7542726)
2018,Mayo,Francia,0,1,,1,POINT (7088729 -70740253)
2018,Mayo,Francia,2,4,,6,POINT (7128047 -73181317)
2018,Mayo,Francia,12,10,,22,POINT (7819 -72453013)
2018,Mayo,Francia,2,1,,3,POINT (836068 -72409396)
2018,Mayo,Francia,8,11,,19,POINT (863337 -7735002)
2018,Mayo,Gabón,1,0,,1,POINT (3451668 -76532004)
2018,Mayo,Georgia,0,1,,1,POINT (11247723 -74213989)
2018,Mayo,Georgia,1,7,,8,POINT (4697157 -74140516)
2018,Mayo,Ghana,0,1,,1,POINT (0.81488 -77356)
2018,Mayo,Ghana,1,3,,4,POINT (10446304 -75516486)
2018,Mayo,Ghana,1,0,,1,POINT (3451668 -76532004)
2018,Mayo,Ghana,2,1,,3,POINT (4697157 -74140516)
2018,Mayo,Granada,0,1,,1,POINT (10446304 -75516486)
2018,Mayo,Granada,3,3,,6,POINT (4697157 -74140516)
2018,Mayo,Grecia,1,0,,1,POINT (0.81488 -77356)
2018,Mayo,Grecia,0,2,,2,POINT (10406342 -75527794)
2018,Mayo,Grecia,2,13,,15,POINT (10446304 -75516486)
2018,Mayo,Grecia,0,1,,1,POINT (10970933 -74765343)
2018,Mayo,Grecia,0,1,,1,POINT (3451668 -76532004)
2018,Mayo,Grecia,21,71,,92,POINT (4697157 -74140516)
2018,Mayo,Grecia,3,3,,6,POINT (6170465 -7542726)
2018,Mayo,Grecia,0,1,,1,POINT (7819 -72453013)
2018,Mayo,Grecia,0,1,,1,POINT (806667 -767333)
2018,Mayo,Grecia,1,0,,1,POINT (836068 -72409396)
2018,Mayo,Grecia,0,5,,5,POINT (9402597 -75681642)
2018,Mayo,Guatemala,3,4,,7,POINT (0.81488 -77356)
2018,Mayo,Guatemala,0,1,,1,POINT (10406342 -75527794)
2018,Mayo,Guatemala,86,92,,178,POINT (10446304 -75516486)
2018,Mayo,Guatemala,11,14,,25,POINT (10886686 -74776479)
2018,Mayo,Guatemala,6,2,,8,POINT (125862 -81702165)
2018,Mayo,Guatemala,12,22,,34,POINT (3451668 -76532004)
2018,Mayo,Guatemala,385,764,,1149,POINT (4697157 -74140516)
2018,Mayo,Guatemala,8,14,,22,POINT (4815189 -75736374)
2018,Mayo,Guatemala,75,179,,254,POINT (6170465 -7542726)
2018,Mayo,Guatemala,1,2,,3,POINT (7128047 -73181317)
2018,Mayo,Guatemala,1,2,,3,POINT (7819 -72453013)
2018,Mayo,Guatemala,2,0,,2,POINT (836068 -72409396)
2018,Mayo,Guyana,0,1,,1,POINT (0.81488 -77356)
2018,Mayo,Guyana,0,1,,1,POINT (10446304 -75516486)
2018,Mayo,Guyana,1,6,,7,POINT (10886686 -74776479)
2018,Mayo,Guyana,1,0,,1,POINT (3451668 -76532004)
2018,Mayo,Guyana,4,12,,16,POINT (4697157 -74140516)
2018,Mayo,Guyana,1,1,,2,POINT (6170465 -7542726)
2018,Mayo,Guyana,1,1,,2,POINT (7819 -72453013)
2018,Mayo,Haití,4,9,,13,POINT (10446304 -75516486)
2018,Mayo,Haití,0,3,,3,POINT (10886686 -74776479)
2018,Mayo,Haití,2,0,,2,POINT (3451668 -76532004)
2018,Mayo,Haití,11,15,,26,POINT (4697157 -74140516)
2018,Mayo,Haití,1,0,,1,POINT (6170465 -7542726)
2018,Mayo,Honduras,0,3,,3,POINT (0.81488 -77356)
2018,Mayo,Honduras,1,0,,1,POINT (10406342 -75527794)
2018,Mayo,Honduras,33,41,,74,POINT (10446304 -75516486)
2018,Mayo,Honduras,6,8,,14,POINT (10886686 -74776479)
2018,Mayo,Honduras,0,1,,1,POINT (11360029 -72129595)
2018,Mayo,Honduras,3,2,,5,POINT (125862 -81702165)
2018,Mayo,Honduras,0,1,,1,POINT (133387613 -81372937)
2018,Mayo,Honduras,21,16,,37,POINT (3451668 -76532004)
2018,Mayo,Honduras,1,0,,1,POINT (445285 -75766353)
2018,Mayo,Honduras,258,321,,579,POINT (4697157 -74140516)
2018,Mayo,Honduras,0,7,,7,POINT (4815189 -75736374)
2018,Mayo,Honduras,59,67,,126,POINT (6170465 -7542726)
2018,Mayo,Honduras,1,1,,2,POINT (7128047 -73181317)
2018,Mayo,Honduras,0,1,,1,POINT (863337 -7735002)
2018,Mayo,Honduras,0,1,,1,POINT (9402597 -75681642)
2018,Mayo,Hong Kong,0,2,,2,POINT (0.81488 -77356)
2018,Mayo,Hong Kong,9,13,,22,POINT (4697157 -74140516)
2018,Mayo,Hong Kong,0,1,,1,POINT (6170465 -7542726)
2018,Mayo,Hungría,1,0,,1,POINT (-4191162 -69941498)
2018,Mayo,Hungría,0,1,,1,POINT (-4214082 -69941431)
2018,Mayo,Hungría,0,1,,1,POINT (0.81488 -77356)
2018,Mayo,Hungría,6,6,,12,POINT (10446304 -75516486)
2018,Mayo,Hungría,1,0,,1,POINT (10886686 -74776479)
2018,Mayo,Hungría,2,3,,5,POINT (3451668 -76532004)
2018,Mayo,Hungría,26,58,,84,POINT (4697157 -74140516)
2018,Mayo,Hungría,4,4,,8,POINT (6170465 -7542726)
2018,Mayo,India,0,1,,1,POINT (0.81488 -77356)
2018,Mayo,India,0,8,,8,POINT (10406342 -75527794)
2018,Mayo,India,18,52,,70,POINT (10446304 -75516486)
2018,Mayo,India,2,11,,13,POINT (10886686 -74776479)
2018,Mayo,India,1,0,,1,POINT (10970933 -74765343)
2018,Mayo,India,1,6,,7,POINT (11247723 -74213989)
2018,Mayo,India,1,10,,11,POINT (3451668 -76532004)
2018,Mayo,India,0,1,,1,POINT (3884426 -77061029)
2018,Mayo,India,101,445,,546,POINT (4697157 -74140516)
2018,Mayo,India,0,4,,4,POINT (4815189 -75736374)
2018,Mayo,India,5,63,,68,POINT (6170465 -7542726)
2018,Mayo,India,0,2,,2,POINT (7128047 -73181317)
2018,Mayo,India,0,4,,4,POINT (9402597 -75681642)
2018,Mayo,Indonesia,0,2,,2,POINT (0.81488 -77356)
2018,Mayo,Indonesia,1,1,,2,POINT (10406342 -75527794)
2018,Mayo,Indonesia,3,11,,14,POINT (10446304 -75516486)
2018,Mayo,Indonesia,0,6,,6,POINT (3884426 -77061029)
2018,Mayo,Indonesia,27,34,,61,POINT (4697157 -74140516)
2018,Mayo,Indonesia,1,1,,2,POINT (6170465 -7542726)
2018,Mayo,Irán,1,0,,1,POINT (10446304 -75516486)
2018,Mayo,Irán,7,18,,25,POINT (4697157 -74140516)
2018,Mayo,Irán,2,1,,3,POINT (6170465 -7542726)
2018,Mayo,República de Irlanda,2,1,,3,POINT (-4214082 -69941431)
2018,Mayo,República de Irlanda,0,1,,1,POINT (0.33002 -76876446)
2018,Mayo,República de Irlanda,9,20,,29,POINT (0.81488 -77356)
2018,Mayo,República de Irlanda,10,10,,20,POINT (10406342 -75527794)
2018,Mayo,República de Irlanda,19,19,,38,POINT (10446304 -75516486)
2018,Mayo,República de Irlanda,2,4,,6,POINT (10886686 -74776479)
2018,Mayo,República de Irlanda,3,4,,7,POINT (3451668 -76532004)
2018,Mayo,República de Irlanda,128,209,,337,POINT (4697157 -74140516)
2018,Mayo,República de Irlanda,0,1,,1,POINT (4815189 -75736374)
2018,Mayo,República de Irlanda,16,29,,45,POINT (6170465 -7542726)
2018,Mayo,República de Irlanda,8,8,,16,POINT (863337 -7735002)
2018,Mayo,Islandia,0,2,,2,POINT (10446304 -75516486)
2018,Mayo,Islandia,0,1,,1,POINT (10886686 -74776479)
2018,Mayo,Islandia,2,1,,3,POINT (3451668 -76532004)
2018,Mayo,Islandia,3,3,,6,POINT (4697157 -74140516)
2018,Mayo,Islandia,4,4,,8,POINT (6170465 -7542726)
2018,Mayo,Israel,2,1,,3,POINT (-4191162 -69941498)
2018,Mayo,Israel,4,6,,10,POINT (-4214082 -69941431)
2018,Mayo,Israel,42,81,,123,POINT (0.81488 -77356)
2018,Mayo,Israel,1,2,,3,POINT (10406342 -75527794)
2018,Mayo,Israel,13,37,,50,POINT (10446304 -75516486)
2018,Mayo,Israel,1,2,,3,POINT (125862 -81702165)
2018,Mayo,Israel,16,29,,45,POINT (3451668 -76532004)
2018,Mayo,Israel,0,1,,1,POINT (445285 -75766353)
2018,Mayo,Israel,330,717,,1047,POINT (4697157 -74140516)
2018,Mayo,Israel,0,1,,1,POINT (4815189 -75736374)
2018,Mayo,Israel,62,118,,180,POINT (6170465 -7542726)
2018,Mayo,Israel,1,0,,1,POINT (863337 -7735002)
2018,Mayo,Italia,3,5,,8,POINT (-4191162 -69941498)
2018,Mayo,Italia,4,4,,8,POINT (-4214082 -69941431)
2018,Mayo,Italia,0,2,,2,POINT (0.33002 -76876446)
2018,Mayo,Italia,0,1,,1,POINT (0.812436 -77847006)
2018,Mayo,Italia,14,25,,39,POINT (0.81488 -77356)
2018,Mayo,Italia,3,5,,8,POINT (10406342 -75527794)
2018,Mayo,Italia,78,140,,218,POINT (10446304 -75516486)
2018,Mayo,Italia,11,33,,44,POINT (10886686 -74776479)
2018,Mayo,Italia,0,5,,5,POINT (11360029 -72129595)
2018,Mayo,Italia,10,8,,18,POINT (125862 -81702165)
2018,Mayo,Italia,33,87,,120,POINT (3451668 -76532004)
2018,Mayo,Italia,0,1,,1,POINT (3884426 -77061029)
2018,Mayo,Italia,575,1525,,2100,POINT (4697157 -74140516)
2018,Mayo,Italia,3,2,,5,POINT (4815189 -75736374)
2018,Mayo,Italia,61,184,,245,POINT (6170465 -7542726)
2018,Mayo,Italia,2,0,,2,POINT (7128047 -73181317)
2018,Mayo,Italia,9,14,,23,POINT (7819 -72453013)
2018,Mayo,Italia,2,2,,4,POINT (836068 -72409396)
2018,Mayo,Italia,2,1,,3,POINT (863337 -7735002)
2018,Mayo,Jamaica,6,7,,13,POINT (10446304 -75516486)
2018,Mayo,Jamaica,0,3,,3,POINT (10886686 -74776479)
2018,Mayo,Jamaica,0,3,,3,POINT (125862 -81702165)
2018,Mayo,Jamaica,6,4,,10,POINT (3451668 -76532004)
2018,Mayo,Jamaica,20,30,,50,POINT (4697157 -74140516)
2018,Mayo,Jamaica,1,7,,8,POINT (6170465 -7542726)
2018,Mayo,Jamaica,1,0,,1,POINT (7819 -72453013)
2018,Mayo,Japón,1,0,,1,POINT (-4191162 -69941498)
2018,Mayo,Japón,7,17,,24,POINT (0.81488 -77356)
2018,Mayo,Japón,10,25,,35,POINT (10446304 -75516486)
2018,Mayo,Japón,1,7,,8,POINT (10886686 -74776479)
2018,Mayo,Japón,17,22,,39,POINT (3451668 -76532004)
2018,Mayo,Japón,115,457,,572,POINT (4697157 -74140516)
2018,Mayo,Japón,8,43,,51,POINT (6170465 -7542726)
2018,Mayo,Japón,1,2,,3,POINT (863337 -7735002)
2018,Mayo,Jordania,1,0,,1,POINT (0.81488 -77356)
2018,Mayo,Jordania,1,3,,4,POINT (4697157 -74140516)
2018,Mayo,Kazajistán,5,4,,9,POINT (10446304 -75516486)
2018,Mayo,Kazajistán,0,2,,2,POINT (3451668 -76532004)
2018,Mayo,Kazajistán,5,6,,11,POINT (4697157 -74140516)
2018,Mayo,Kazajistán,0,1,,1,POINT (6170465 -7542726)
2018,Mayo,Kenia,1,0,,1,POINT (0.81488 -77356)
2018,Mayo,Kenia,3,2,,5,POINT (10446304 -75516486)
2018,Mayo,Kenia,2,9,,11,POINT (4697157 -74140516)
2018,Mayo,Kenia,0,1,,1,POINT (6170465 -7542726)
2018,Mayo,Kirguistán,1,0,,1,POINT (4697157 -74140516)
2018,Mayo,Kirguistán,1,0,,1,POINT (6170465 -7542726)
2018,Mayo,Kuwait,1,1,,2,POINT (10446304 -75516486)
2018,Mayo,Kuwait,0,1,,1,POINT (4697157 -74140516)
2018,Mayo,Kuwait,1,0,,1,POINT (6170465 -7542726)
2018,Mayo,República de Kosovo,0,1,,1,POINT (10446304 -75516486)
2018,Mayo,República de Kosovo,5,0,,5,POINT (4697157 -74140516)
2018,Mayo,Letonia,0,2,,2,POINT (0.81488 -77356)
2018,Mayo,Letonia,0,1,,1,POINT (10406342 -75527794)
2018,Mayo,Letonia,1,0,,1,POINT (10446304 -75516486)
2018,Mayo,Letonia,0,1,,1,POINT (125862 -81702165)
2018,Mayo,Letonia,4,4,,8,POINT (4697157 -74140516)
2018,Mayo,Letonia,2,1,,3,POINT (6170465 -7542726)
2018,Mayo,Lituania,3,4,,7,POINT (0.81488 -77356)
2018,Mayo,Lituania,0,2,,2,POINT (10406342 -75527794)
2018,Mayo,Lituania,3,8,,11,POINT (10446304 -75516486)
2018,Mayo,Lituania,1,0,,1,POINT (133387613 -81372937)
2018,Mayo,Lituania,0,4,,4,POINT (3451668 -76532004)
2018,Mayo,Lituania,16,15,,31,POINT (4697157 -74140516)
2018,Mayo,Lituania,0,1,,1,POINT (4815189 -75736374)
2018,Mayo,Lituania,3,5,,8,POINT (6170465 -7542726)
2018,Mayo,Líbano,0,1,,1,POINT (0.81488 -77356)
2018,Mayo,Líbano,1,0,,1,POINT (10446304 -75516486)
2018,Mayo,Líbano,1,1,,2,POINT (10886686 -74776479)
2018,Mayo,Líbano,1,3,,4,POINT (11360029 -72129595)
2018,Mayo,Líbano,1,0,,1,POINT (3451668 -76532004)
2018,Mayo,Líbano,13,31,,44,POINT (4697157 -74140516)
2018,Mayo,Líbano,1,3,,4,POINT (6170465 -7542726)
2018,Mayo,Libia,0,1,,1,POINT (4697157 -74140516)
2018,Mayo,Liechtenstein,0,2,,2,POINT (4697157 -74140516)
2018,Mayo,Liechtenstein,0,1,,1,POINT (6170465 -7542726)
2018,Mayo,Luxemburgo,1,0,,1,POINT (-4191162 -69941498)
2018,Mayo,Luxemburgo,1,1,,2,POINT (-4214082 -69941431)
2018,Mayo,Luxemburgo,0,1,,1,POINT (10446304 -75516486)
2018,Mayo,Luxemburgo,0,1,,1,POINT (3451668 -76532004)
2018,Mayo,Luxemburgo,0,6,,6,POINT (4697157 -74140516)
2018,Mayo,Luxemburgo,1,1,,2,POINT (4815189 -75736374)
2018,Mayo,Macedonia,0,1,,1,POINT (10446304 -75516486)
2018,Mayo,Macedonia,1,2,,3,POINT (4697157 -74140516)
2018,Mayo,Madagascar,1,0,,1,POINT (10446304 -75516486)
2018,Mayo,Madagascar,1,0,,1,POINT (4697157 -74140516)
2018,Mayo,Madagascar,1,0,,1,POINT (6170465 -7542726)
2018,Mayo,Malasia,2,0,,2,POINT (10406342 -75527794)
2018,Mayo,Malasia,1,0,,1,POINT (10446304 -75516486)
2018,Mayo,Malasia,0,1,,1,POINT (3451668 -76532004)
2018,Mayo,Malasia,29,30,,59,POINT (4697157 -74140516)
2018,Mayo,Malasia,5,9,,14,POINT (6170465 -7542726)
2018,Mayo,Malí,0,1,,1,POINT (4697157 -74140516)
2018,Mayo,Malí,1,0,,1,POINT (6170465 -7542726)
2018,Mayo,Malta,0,1,,1,POINT (10446304 -75516486)
2018,Mayo,Malta,3,5,,8,POINT (4697157 -74140516)
2018,Mayo,Malta,0,1,,1,POINT (6170465 -7542726)
2018,Mayo,Marruecos,6,11,,17,POINT (4697157 -74140516)
2018,Mayo,Marruecos,0,1,,1,POINT (6170465 -7542726)
2018,Mayo,Mauricio,0,2,,2,POINT (10406342 -75527794)
2018,Mayo,Mauricio,0,1,,1,POINT (10446304 -75516486)
2018,Mayo,Mauricio,0,3,,3,POINT (4697157 -74140516)
2018,Mayo,Mauricio,0,2,,2,POINT (6170465 -7542726)
2018,Mayo,México,0,1,,1,POINT (-4214082 -69941431)
2018,Mayo,México,2,0,,2,POINT (0.33002 -76876446)
2018,Mayo,México,1,0,,1,POINT (0.812436 -77847006)
2018,Mayo,México,9,20,,29,POINT (0.81488 -77356)
2018,Mayo,México,0,3,,3,POINT (10406342 -75527794)
2018,Mayo,México,498,540,,1038,POINT (10446304 -75516486)
2018,Mayo,México,50,79,,129,POINT (10886686 -74776479)
2018,Mayo,México,0,3,,3,POINT (11117206 -74232675)
2018,Mayo,México,0,2,,2,POINT (11247723 -74213989)
2018,Mayo,México,1,13,,14,POINT (11360029 -72129595)
2018,Mayo,México,0,1,,1,POINT (125744111 -81703935)
2018,Mayo,México,3,5,,8,POINT (125862 -81702165)
2018,Mayo,México,0,1,,1,POINT (133387613 -81372937)
2018,Mayo,México,77,170,,247,POINT (3451668 -76532004)
2018,Mayo,México,5,0,,5,POINT (445285 -75766353)
2018,Mayo,México,4346,7256,,11602,POINT (4697157 -74140516)
2018,Mayo,México,16,33,,49,POINT (4815189 -75736374)
2018,Mayo,México,597,1333,,1930,POINT (6170465 -7542726)
2018,Mayo,México,1,1,,2,POINT (7088729 -70740253)
2018,Mayo,México,1,10,,11,POINT (7128047 -73181317)
2018,Mayo,México,13,14,,27,POINT (7819 -72453013)
2018,Mayo,México,2,3,,5,POINT (836068 -72409396)
2018,Mayo,México,1,4,,5,POINT (863337 -7735002)
2018,Mayo,República de Moldavia,0,1,,1,POINT (10446304 -75516486)
2018,Mayo,República de Moldavia,1,1,,2,POINT (4697157 -74140516)
2018,Mayo,República de Moldavia,1,0,,1,POINT (7128047 -73181317)
2018,Mayo,Mónaco,1,2,,3,POINT (4697157 -74140516)
2018,Mayo,Mongolia,0,1,,1,POINT (10446304 -75516486)
2018,Mayo,Mongolia,3,10,,13,POINT (4697157 -74140516)
2018,Mayo,Mongolia,1,0,,1,POINT (6170465 -7542726)
2018,Mayo,Montenegro,0,1,,1,POINT (11247723 -74213989)
2018,Mayo,Montenegro,0,1,,1,POINT (3884426 -77061029)
2018,Mayo,Montenegro,0,3,,3,POINT (4697157 -74140516)
2018,Mayo,Mozambique,1,4,,5,POINT (4697157 -74140516)
2018,Mayo,Myanmar,0,1,,1,POINT (10886686 -74776479)
2018,Mayo,Myanmar,3,11,,14,POINT (4697157 -74140516)
2018,Mayo,Nepal,1,1,,2,POINT (10446304 -75516486)
2018,Mayo,Nepal,2,0,,2,POINT (10886686 -74776479)
2018,Mayo,Nepal,0,6,,6,POINT (4697157 -74140516)
2018,Mayo,Nicaragua,1,0,,1,POINT (-4191162 -69941498)
2018,Mayo,Nicaragua,16,15,,31,POINT (10446304 -75516486)
2018,Mayo,Nicaragua,2,0,,2,POINT (10886686 -74776479)
2018,Mayo,Nicaragua,0,2,,2,POINT (11360029 -72129595)
2018,Mayo,Nicaragua,8,14,,22,POINT (125744111 -81703935)
2018,Mayo,Nicaragua,1,0,,1,POINT (125862 -81702165)
2018,Mayo,Nicaragua,13,9,,22,POINT (3451668 -76532004)
2018,Mayo,Nicaragua,79,97,,176,POINT (4697157 -74140516)
2018,Mayo,Nicaragua,1,2,,3,POINT (4815189 -75736374)
2018,Mayo,Nicaragua,14,21,,35,POINT (6170465 -7542726)
2018,Mayo,Nicaragua,1,2,,3,POINT (7128047 -73181317)
2018,Mayo,Nicaragua,1,0,,1,POINT (7819 -72453013)
2018,Mayo,Nicaragua,1,2,,3,POINT (836068 -72409396)
2018,Mayo,Nigeria,1,1,,2,POINT (10446304 -75516486)
2018,Mayo,Nigeria,0,1,,1,POINT (10886686 -74776479)
2018,Mayo,Nigeria,1,0,,1,POINT (3451668 -76532004)
2018,Mayo,Nigeria,3,12,,15,POINT (4697157 -74140516)
2018,Mayo,Nigeria,0,3,,3,POINT (6170465 -7542726)
2018,Mayo,Noruega,3,0,,3,POINT (-4214082 -69941431)
2018,Mayo,Noruega,1,1,,2,POINT (0.81488 -77356)
2018,Mayo,Noruega,3,5,,8,POINT (10406342 -75527794)
2018,Mayo,Noruega,6,14,,20,POINT (10446304 -75516486)
2018,Mayo,Noruega,0,2,,2,POINT (10886686 -74776479)
2018,Mayo,Noruega,1,2,,3,POINT (125862 -81702165)
2018,Mayo,Noruega,8,3,,11,POINT (3451668 -76532004)
2018,Mayo,Noruega,81,83,,164,POINT (4697157 -74140516)
2018,Mayo,Noruega,0,1,,1,POINT (4815189 -75736374)
2018,Mayo,Noruega,8,18,,26,POINT (6170465 -7542726)
2018,Mayo,Noruega,1,2,,3,POINT (863337 -7735002)
2018,Mayo,Nueva Zelanda,1,1,,2,POINT (-4191162 -69941498)
2018,Mayo,Nueva Zelanda,5,11,,16,POINT (0.81488 -77356)
2018,Mayo,Nueva Zelanda,2,8,,10,POINT (10406342 -75527794)
2018,Mayo,Nueva Zelanda,14,16,,30,POINT (10446304 -75516486)
2018,Mayo,Nueva Zelanda,0,4,,4,POINT (10886686 -74776479)
2018,Mayo,Nueva Zelanda,0,1,,1,POINT (3451668 -76532004)
2018,Mayo,Nueva Zelanda,66,98,,164,POINT (4697157 -74140516)
2018,Mayo,Nueva Zelanda,5,28,,33,POINT (6170465 -7542726)
2018,Mayo,Nueva Zelanda,2,6,,8,POINT (863337 -7735002)
2018,Mayo,Países Bajos,1,1,,2,POINT (-4191162 -69941498)
2018,Mayo,Países Bajos,1,9,,10,POINT (-4214082 -69941431)
2018,Mayo,Países Bajos,2,3,,5,POINT (0.33002 -76876446)
2018,Mayo,Países Bajos,28,28,,56,POINT (0.81488 -77356)
2018,Mayo,Países Bajos,23,16,,39,POINT (10406342 -75527794)
2018,Mayo,Países Bajos,147,197,,344,POINT (10446304 -75516486)
2018,Mayo,Países Bajos,8,12,,20,POINT (10886686 -74776479)
2018,Mayo,Países Bajos,1,3,,4,POINT (11360029 -72129595)
2018,Mayo,Países Bajos,2,0,,2,POINT (125744111 -81703935)
2018,Mayo,Países Bajos,2,1,,3,POINT (125862 -81702165)
2018,Mayo,Países Bajos,1,0,,1,POINT (133387613 -81372937)
2018,Mayo,Países Bajos,32,49,,81,POINT (3451668 -76532004)
2018,Mayo,Países Bajos,0,2,,2,POINT (3884426 -77061029)
2018,Mayo,Países Bajos,1305,1715,,3020,POINT (4697157 -74140516)
2018,Mayo,Países Bajos,2,3,,5,POINT (4815189 -75736374)
2018,Mayo,Países Bajos,157,229,,386,POINT (6170465 -7542726)
2018,Mayo,Países Bajos,6,5,,11,POINT (7128047 -73181317)
2018,Mayo,Países Bajos,2,4,,6,POINT (7819 -72453013)
2018,Mayo,Países Bajos,9,4,,13,POINT (863337 -7735002)
2018,Mayo,Pakistán,0,1,,1,POINT (10406342 -75527794)
2018,Mayo,Pakistán,1,4,,5,POINT (10446304 -75516486)
2018,Mayo,Pakistán,2,11,,13,POINT (4697157 -74140516)
2018,Mayo,Pakistán,0,4,,4,POINT (6170465 -7542726)
2018,Mayo,Panamá,1,0,,1,POINT (-4191162 -69941498)
2018,Mayo,Panamá,3,5,,8,POINT (0.81488 -77356)
2018,Mayo,Panamá,0,2,,2,POINT (1800143 -78802679)
2018,Mayo,Panamá,3,14,,17,POINT (10406342 -75527794)
2018,Mayo,Panamá,403,442,,845,POINT (10446304 -75516486)
2018,Mayo,Panamá,78,106,,184,POINT (10886686 -74776479)
2018,Mayo,Panamá,0,1,,1,POINT (125744111 -81703935)
2018,Mayo,Panamá,23,26,,49,POINT (125862 -81702165)
2018,Mayo,Panamá,171,202,,373,POINT (3451668 -76532004)
2018,Mayo,Panamá,19,13,,32,POINT (445285 -75766353)
2018,Mayo,Panamá,1291,1464,,2755,POINT (4697157 -74140516)
2018,Mayo,Panamá,39,60,,99,POINT (4815189 -75736374)
2018,Mayo,Panamá,998,1015,,2013,POINT (6170465 -7542726)
2018,Mayo,Panamá,6,6,,12,POINT (7102626 -77762647)
2018,Mayo,Panamá,6,6,,12,POINT (7128047 -73181317)
2018,Mayo,Panamá,1,5,,6,POINT (7819 -72453013)
2018,Mayo,Panamá,0,2,,2,POINT (836068 -72409396)
2018,Mayo,Panamá,5,7,,12,POINT (863337 -7735002)
2018,Mayo,Panamá,0,1,,1,POINT (9402597 -75681642)
2018,Mayo,Paraguay,0,1,,1,POINT (0.33002 -76876446)
2018,Mayo,Paraguay,4,2,,6,POINT (0.81488 -77356)
2018,Mayo,Paraguay,1,0,,1,POINT (10406342 -75527794)
2018,Mayo,Paraguay,104,57,,161,POINT (10446304 -75516486)
2018,Mayo,Paraguay,12,16,,28,POINT (10886686 -74776479)
2018,Mayo,Paraguay,0,1,,1,POINT (11360029 -72129595)
2018,Mayo,Paraguay,82,45,,127,POINT (125862 -81702165)
2018,Mayo,Paraguay,12,6,,18,POINT (3451668 -76532004)
2018,Mayo,Paraguay,190,145,,335,POINT (4697157 -74140516)
2018,Mayo,Paraguay,0,1,,1,POINT (4815189 -75736374)
2018,Mayo,Paraguay,15,61,,76,POINT (6170465 -7542726)
2018,Mayo,Paraguay,0,2,,2,POINT (7819 -72453013)
2018,Mayo,Perú,18,17,,35,POINT (-4191162 -69941498)
2018,Mayo,Perú,23,39,,62,POINT (-4214082 -69941431)
2018,Mayo,Perú,1,4,,5,POINT (0.185957 -7478366)
2018,Mayo,Perú,4,9,,13,POINT (0.33002 -76876446)
2018,Mayo,Perú,70,252,,322,POINT (0.81488 -77356)
2018,Mayo,Perú,4,8,,12,POINT (10406342 -75527794)
2018,Mayo,Perú,909,552,,1461,POINT (10446304 -75516486)
2018,Mayo,Perú,24,33,,57,POINT (10886686 -74776479)
2018,Mayo,Perú,0,2,,2,POINT (11247723 -74213989)
2018,Mayo,Perú,6,18,,24,POINT (11360029 -72129595)
2018,Mayo,Perú,353,199,,552,POINT (125862 -81702165)
2018,Mayo,Perú,84,123,,207,POINT (3451668 -76532004)
2018,Mayo,Perú,1,0,,1,POINT (445285 -75766353)
2018,Mayo,Perú,3935,4532,,8467,POINT (4697157 -74140516)
2018,Mayo,Perú,6,9,,15,POINT (4815189 -75736374)
2018,Mayo,Perú,376,651,,1027,POINT (6170465 -7542726)
2018,Mayo,Perú,4,10,,14,POINT (7088729 -70740253)
2018,Mayo,Perú,0,1,,1,POINT (7128047 -73181317)
2018,Mayo,Perú,97,202,,299,POINT (7819 -72453013)
2018,Mayo,Perú,2,18,,20,POINT (836068 -72409396)
2018,Mayo,Perú,0,1,,1,POINT (863337 -7735002)
2018,Mayo,Palestina,0,1,,1,POINT (4697157 -74140516)
2018,Mayo,Polonia,1,2,,3,POINT (-4214082 -69941431)
2018,Mayo,Polonia,1,1,,2,POINT (0.33002 -76876446)
2018,Mayo,Polonia,2,2,,4,POINT (0.81488 -77356)
2018,Mayo,Polonia,1,14,,15,POINT (10406342 -75527794)
2018,Mayo,Polonia,23,26,,49,POINT (10446304 -75516486)
2018,Mayo,Polonia,2,2,,4,POINT (10886686 -74776479)
2018,Mayo,Polonia,0,2,,2,POINT (10970933 -74765343)
2018,Mayo,Polonia,2,3,,5,POINT (125744111 -81703935)
2018,Mayo,Polonia,1,0,,1,POINT (125862 -81702165)
2018,Mayo,Polonia,8,9,,17,POINT (3451668 -76532004)
2018,Mayo,Polonia,118,153,,271,POINT (4697157 -74140516)
2018,Mayo,Polonia,14,27,,41,POINT (6170465 -7542726)
2018,Mayo,Portugal,0,1,,1,POINT (-4214082 -69941431)
2018,Mayo,Portugal,0,1,,1,POINT (0.33002 -76876446)
2018,Mayo,Portugal,1,7,,8,POINT (0.81488 -77356)
2018,Mayo,Portugal,29,24,,53,POINT (10446304 -75516486)
2018,Mayo,Portugal,0,6,,6,POINT (10886686 -74776479)
2018,Mayo,Portugal,4,4,,8,POINT (11360029 -72129595)
2018,Mayo,Portugal,1,0,,1,POINT (125862 -81702165)
2018,Mayo,Portugal,6,11,,17,POINT (3451668 -76532004)
2018,Mayo,Portugal,173,426,,599,POINT (4697157 -74140516)
2018,Mayo,Portugal,10,42,,52,POINT (6170465 -7542726)
2018,Mayo,Portugal,8,13,,21,POINT (7819 -72453013)
2018,Mayo,Portugal,0,1,,1,POINT (836068 -72409396)
2018,Mayo,Portugal,1,0,,1,POINT (863337 -7735002)
2018,Mayo,Qatar,0,1,,1,POINT (4697157 -74140516)
2018,Mayo,Reino Unido de Gran Bretaña e Irlanda del Norte,4,2,,6,POINT (-4191162 -69941498)
2018,Mayo,Reino Unido de Gran Bretaña e Irlanda del Norte,3,8,,11,POINT (-4214082 -69941431)
2018,Mayo,Reino Unido de Gran Bretaña e Irlanda del Norte,4,5,,9,POINT (0.33002 -76876446)
2018,Mayo,Reino Unido de Gran Bretaña e Irlanda del Norte,97,137,,234,POINT (0.81488 -77356)
2018,Mayo,Reino Unido de Gran Bretaña e Irlanda del Norte,37,48,,85,POINT (10406342 -75527794)
2018,Mayo,Reino Unido de Gran Bretaña e Irlanda del Norte,121,164,,285,POINT (10446304 -75516486)
2018,Mayo,Reino Unido de Gran Bretaña e Irlanda del Norte,12,10,,22,POINT (10886686 -74776479)
2018,Mayo,Reino Unido de Gran Bretaña e Irlanda del Norte,1,0,,1,POINT (11247723 -74213989)
2018,Mayo,Reino Unido de Gran Bretaña e Irlanda del Norte,0,1,,1,POINT (11360029 -72129595)
2018,Mayo,Reino Unido de Gran Bretaña e Irlanda del Norte,1,1,,2,POINT (125744111 -81703935)
2018,Mayo,Reino Unido de Gran Bretaña e Irlanda del Norte,1,1,,2,POINT (125862 -81702165)
2018,Mayo,Reino Unido de Gran Bretaña e Irlanda del Norte,1,2,,3,POINT (133387613 -81372937)
2018,Mayo,Reino Unido de Gran Bretaña e Irlanda del Norte,27,41,,68,POINT (3451668 -76532004)
2018,Mayo,Reino Unido de Gran Bretaña e Irlanda del Norte,1,2,,3,POINT (445285 -75766353)
2018,Mayo,Reino Unido de Gran Bretaña e Irlanda del Norte,1002,1900,,2902,POINT (4697157 -74140516)
2018,Mayo,Reino Unido de Gran Bretaña e Irlanda del Norte,1,1,,2,POINT (4815189 -75736374)
2018,Mayo,Reino Unido de Gran Bretaña e Irlanda del Norte,92,238,,330,POINT (6170465 -7542726)
2018,Mayo,Reino Unido de Gran Bretaña e Irlanda del Norte,0,1,,1,POINT (6218835 -75586989)
2018,Mayo,Reino Unido de Gran Bretaña e Irlanda del Norte,0,3,,3,POINT (7819 -72453013)
2018,Mayo,Reino Unido de Gran Bretaña e Irlanda del Norte,30,27,,57,POINT (863337 -7735002)
2018,Mayo,República Dominicana,0,2,,2,POINT (-4191162 -69941498)
2018,Mayo,República Dominicana,4,8,,12,POINT (0.81488 -77356)
2018,Mayo,República Dominicana,1,4,,5,POINT (10406342 -75527794)
2018,Mayo,República Dominicana,55,67,,122,POINT (10446304 -75516486)
2018,Mayo,República Dominicana,21,58,,79,POINT (10886686 -74776479)
2018,Mayo,República Dominicana,0,6,,6,POINT (11360029 -72129595)
2018,Mayo,República Dominicana,25,27,,52,POINT (3451668 -76532004)
2018,Mayo,República Dominicana,1,0,,1,POINT (445285 -75766353)
2018,Mayo,República Dominicana,694,703,,1397,POINT (4697157 -74140516)
2018,Mayo,República Dominicana,2,9,,11,POINT (4815189 -75736374)
2018,Mayo,República Dominicana,74,128,,202,POINT (6170465 -7542726)
2018,Mayo,República Dominicana,1,1,,2,POINT (7128047 -73181317)
2018,Mayo,República Dominicana,2,2,,4,POINT (7819 -72453013)
2018,Mayo,Rumania,0,2,,2,POINT (0.81488 -77356)
2018,Mayo,Rumania,4,8,,12,POINT (10406342 -75527794)
2018,Mayo,Rumania,8,11,,19,POINT (10446304 -75516486)
2018,Mayo,Rumania,1,0,,1,POINT (11360029 -72129595)
2018,Mayo,Rumania,13,1,,14,POINT (3451668 -76532004)
2018,Mayo,Rumania,116,84,,200,POINT (4697157 -74140516)
2018,Mayo,Rumania,4,5,,9,POINT (6170465 -7542726)
2018,Mayo,Rumania,0,1,,1,POINT (7128047 -73181317)
2018,Mayo,Federación de Rusia,1,0,,1,POINT (-4191162 -69941498)
2018,Mayo,Federación de Rusia,0,1,,1,POINT (-4214082 -69941431)
2018,Mayo,Federación de Rusia,0,1,,1,POINT (0.33002 -76876446)
2018,Mayo,Federación de Rusia,4,9,,13,POINT (0.81488 -77356)
2018,Mayo,Federación de Rusia,0,10,,10,POINT (10406342 -75527794)
2018,Mayo,Federación de Rusia,18,27,,45,POINT (10446304 -75516486)
2018,Mayo,Federación de Rusia,4,2,,6,POINT (10886686 -74776479)
2018,Mayo,Federación de Rusia,0,4,,4,POINT (10970933 -74765343)
2018,Mayo,Federación de Rusia,0,3,,3,POINT (11247723 -74213989)
2018,Mayo,Federación de Rusia,1,0,,1,POINT (11360029 -72129595)
2018,Mayo,Federación de Rusia,4,6,,10,POINT (3451668 -76532004)
2018,Mayo,Federación de Rusia,150,147,,297,POINT (4697157 -74140516)
2018,Mayo,Federación de Rusia,7,21,,28,POINT (6170465 -7542726)
2018,Mayo,Federación de Rusia,1,2,,3,POINT (7128047 -73181317)
2018,Mayo,Federación de Rusia,0,1,,1,POINT (863337 -7735002)
2018,Mayo,Rwanda,0,1,,1,POINT (4697157 -74140516)
2018,Mayo,San Cristóbal y Nevis,0,1,,1,POINT (10446304 -75516486)
2018,Mayo,San Cristóbal y Nevis,2,2,,4,POINT (4697157 -74140516)
2018,Mayo,San  Vicente y las Granadinas,2,1,,3,POINT (10446304 -75516486)
2018,Mayo,San  Vicente y las Granadinas,0,1,,1,POINT (10886686 -74776479)
2018,Mayo,San  Vicente y las Granadinas,0,1,,1,POINT (125862 -81702165)
2018,Mayo,San  Vicente y las Granadinas,3,5,,8,POINT (4697157 -74140516)
2018,Mayo,San  Vicente y las Granadinas,0,1,,1,POINT (6170465 -7542726)
2018,Mayo,San  Vicente y las Granadinas,7,3,,10,POINT (7128047 -73181317)
2018,Mayo,Santa Lucia,1,1,,2,POINT (10446304 -75516486)
2018,Mayo,Santa Lucia,1,0,,1,POINT (10886686 -74776479)
2018,Mayo,Santa Lucia,4,6,,10,POINT (4697157 -74140516)
2018,Mayo,Santa Lucia,1,3,,4,POINT (6170465 -7542726)
2018,Mayo,Senegal,0,3,,3,POINT (4697157 -74140516)
2018,Mayo,Serbia,0,1,,1,POINT (-4214082 -69941431)
2018,Mayo,Serbia,2,5,,7,POINT (10446304 -75516486)
2018,Mayo,Serbia,0,1,,1,POINT (10886686 -74776479)
2018,Mayo,Serbia,0,1,,1,POINT (3884426 -77061029)
2018,Mayo,Serbia,11,16,,27,POINT (4697157 -74140516)
2018,Mayo,Serbia,0,6,,6,POINT (6170465 -7542726)
2018,Mayo,Singapur,1,1,,2,POINT (0.81488 -77356)
2018,Mayo,Singapur,3,1,,4,POINT (10446304 -75516486)
2018,Mayo,Singapur,1,0,,1,POINT (10886686 -74776479)
2018,Mayo,Singapur,1,0,,1,POINT (3451668 -76532004)
2018,Mayo,Singapur,29,41,,70,POINT (4697157 -74140516)
2018,Mayo,Singapur,3,2,,5,POINT (6170465 -7542726)
2018,Mayo,República Árabe Siria,0,1,,1,POINT (4697157 -74140516)
2018,Mayo,República Árabe Siria,0,1,,1,POINT (7088729 -70740253)
2018,Mayo,Sri Lanka,0,1,,1,POINT (10446304 -75516486)
2018,Mayo,Sri Lanka,0,1,,1,POINT (10886686 -74776479)
2018,Mayo,Sri Lanka,0,1,,1,POINT (10970933 -74765343)
2018,Mayo,Sri Lanka,0,2,,2,POINT (11247723 -74213989)
2018,Mayo,Sri Lanka,1,5,,6,POINT (4697157 -74140516)
2018,Mayo,Sri Lanka,0,1,,1,POINT (6170465 -7542726)
2018,Mayo,Sudáfrica,2,1,,3,POINT (0.81488 -77356)
2018,Mayo,Sudáfrica,0,2,,2,POINT (10406342 -75527794)
2018,Mayo,Sudáfrica,4,5,,9,POINT (10446304 -75516486)
2018,Mayo,Sudáfrica,1,5,,6,POINT (10886686 -74776479)
2018,Mayo,Sudáfrica,0,2,,2,POINT (3451668 -76532004)
2018,Mayo,Sudáfrica,0,2,,2,POINT (3884426 -77061029)
2018,Mayo,Sudáfrica,19,33,,52,POINT (4697157 -74140516)
2018,Mayo,Sudáfrica,2,6,,8,POINT (6170465 -7542726)
2018,Mayo,Sudán,1,2,,3,POINT (4697157 -74140516)
2018,Mayo,Suecia,1,2,,3,POINT (-4214082 -69941431)
2018,Mayo,Suecia,13,10,,23,POINT (0.81488 -77356)
2018,Mayo,Suecia,8,8,,16,POINT (10406342 -75527794)
2018,Mayo,Suecia,14,20,,34,POINT (10446304 -75516486)
2018,Mayo,Suecia,2,8,,10,POINT (10886686 -74776479)
2018,Mayo,Suecia,1,1,,2,POINT (133387613 -81372937)
2018,Mayo,Suecia,10,11,,21,POINT (3451668 -76532004)
2018,Mayo,Suecia,0,1,,1,POINT (445285 -75766353)
2018,Mayo,Suecia,118,194,,312,POINT (4697157 -74140516)
2018,Mayo,Suecia,0,1,,1,POINT (4815189 -75736374)
2018,Mayo,Suecia,10,25,,35,POINT (6170465 -7542726)
2018,Mayo,Suecia,0,1,,1,POINT (7128047 -73181317)
2018,Mayo,Suecia,4,3,,7,POINT (863337 -7735002)
2018,Mayo,Suiza,2,2,,4,POINT (-4191162 -69941498)
2018,Mayo,Suiza,5,6,,11,POINT (-4214082 -69941431)
2018,Mayo,Suiza,1,3,,4,POINT (0.33002 -76876446)
2018,Mayo,Suiza,19,26,,45,POINT (0.81488 -77356)
2018,Mayo,Suiza,27,18,,45,POINT (10406342 -75527794)
2018,Mayo,Suiza,36,36,,72,POINT (10446304 -75516486)
2018,Mayo,Suiza,4,5,,9,POINT (10886686 -74776479)
2018,Mayo,Suiza,1,1,,2,POINT (125744111 -81703935)
2018,Mayo,Suiza,0,2,,2,POINT (125862 -81702165)
2018,Mayo,Suiza,24,32,,56,POINT (3451668 -76532004)
2018,Mayo,Suiza,291,544,,835,POINT (4697157 -74140516)
2018,Mayo,Suiza,0,1,,1,POINT (4815189 -75736374)
2018,Mayo,Suiza,28,84,,112,POINT (6170465 -7542726)
2018,Mayo,Suiza,0,1,,1,POINT (7088729 -70740253)
2018,Mayo,Suiza,7,7,,14,POINT (863337 -7735002)
2018,Mayo,Surinam,0,1,,1,POINT (-4191162 -69941498)
2018,Mayo,Surinam,0,1,,1,POINT (0.81488 -77356)
2018,Mayo,Surinam,1,3,,4,POINT (10446304 -75516486)
2018,Mayo,Surinam,18,39,,57,POINT (4697157 -74140516)
2018,Mayo,Surinam,2,0,,2,POINT (6170465 -7542726)
2018,Mayo,Surinam,2,2,,4,POINT (7128047 -73181317)
2018,Mayo,Tailandia,1,2,,3,POINT (0.81488 -77356)
2018,Mayo,Tailandia,1,1,,2,POINT (10446304 -75516486)
2018,Mayo,Tailandia,13,22,,35,POINT (4697157 -74140516)
2018,Mayo,Tailandia,1,0,,1,POINT (6170465 -7542726)
2018,Mayo,Tanzania,0,1,,1,POINT (10446304 -75516486)
2018,Mayo,Tanzania,0,2,,2,POINT (4697157 -74140516)
2018,Mayo,Trinidad y Tobago,9,9,,18,POINT (10446304 -75516486)
2018,Mayo,Trinidad y Tobago,2,4,,6,POINT (10886686 -74776479)
2018,Mayo,Trinidad y Tobago,9,11,,20,POINT (3451668 -76532004)
2018,Mayo,Trinidad y Tobago,18,49,,67,POINT (4697157 -74140516)
2018,Mayo,Trinidad y Tobago,0,1,,1,POINT (4815189 -75736374)
2018,Mayo,Trinidad y Tobago,2,15,,17,POINT (6170465 -7542726)
2018,Mayo,Túnez,0,1,,1,POINT (3451668 -76532004)
2018,Mayo,Túnez,0,6,,6,POINT (4697157 -74140516)
2018,Mayo,Túnez,1,1,,2,POINT (6170465 -7542726)
2018,Mayo,Turquía,0,1,,1,POINT (-4214082 -69941431)
2018,Mayo,Turquía,3,7,,10,POINT (0.81488 -77356)
2018,Mayo,Turquía,0,2,,2,POINT (10406342 -75527794)
2018,Mayo,Turquía,4,8,,12,POINT (10446304 -75516486)
2018,Mayo,Turquía,0,1,,1,POINT (11360029 -72129595)
2018,Mayo,Turquía,1,4,,5,POINT (3451668 -76532004)
2018,Mayo,Turquía,156,297,,453,POINT (4697157 -74140516)
2018,Mayo,Turquía,1,17,,18,POINT (6170465 -7542726)
2018,Mayo,Turquía,0,4,,4,POINT (7819 -72453013)
2018,Mayo,Turquía,1,0,,1,POINT (863337 -7735002)
2018,Mayo,Ucrania,0,15,,15,POINT (10406342 -75527794)
2018,Mayo,Ucrania,3,6,,9,POINT (10446304 -75516486)
2018,Mayo,Ucrania,0,4,,4,POINT (10886686 -74776479)
2018,Mayo,Ucrania,0,2,,2,POINT (10970933 -74765343)
2018,Mayo,Ucrania,0,2,,2,POINT (11247723 -74213989)
2018,Mayo,Ucrania,0,1,,1,POINT (3451668 -76532004)
2018,Mayo,Ucrania,0,2,,2,POINT (3884426 -77061029)
2018,Mayo,Ucrania,18,26,,44,POINT (4697157 -74140516)
2018,Mayo,Ucrania,1,0,,1,POINT (6170465 -7542726)
2018,Mayo,Uganda,0,1,,1,POINT (10446304 -75516486)
2018,Mayo,Uganda,1,0,,1,POINT (4697157 -74140516)
2018,Mayo,Uruguay,1,1,,2,POINT (-4191162 -69941498)
2018,Mayo,Uruguay,0,1,,1,POINT (0.33002 -76876446)
2018,Mayo,Uruguay,5,9,,14,POINT (0.81488 -77356)
2018,Mayo,Uruguay,6,9,,15,POINT (10406342 -75527794)
2018,Mayo,Uruguay,111,105,,216,POINT (10446304 -75516486)
2018,Mayo,Uruguay,10,13,,23,POINT (10886686 -74776479)
2018,Mayo,Uruguay,0,3,,3,POINT (11360029 -72129595)
2018,Mayo,Uruguay,13,7,,20,POINT (125862 -81702165)
2018,Mayo,Uruguay,5,13,,18,POINT (3451668 -76532004)
2018,Mayo,Uruguay,558,704,,1262,POINT (4697157 -74140516)
2018,Mayo,Uruguay,2,1,,3,POINT (4815189 -75736374)
2018,Mayo,Uruguay,36,99,,135,POINT (6170465 -7542726)
2018,Mayo,Uruguay,3,4,,7,POINT (7819 -72453013)
2018,Mayo,Uzbekistán,1,1,,2,POINT (4697157 -74140516)
2018,Mayo,Venezuela,0,6,,6,POINT (-4191162 -69941498)
2018,Mayo,Venezuela,2,3,,5,POINT (-4214082 -69941431)
2018,Mayo,Venezuela,54,51,,105,POINT (0.33002 -76876446)
2018,Mayo,Venezuela,0,2,,2,POINT (0.812436 -77847006)
2018,Mayo,Venezuela,1759,2426,,4185,POINT (0.81488 -77356)
2018,Mayo,Venezuela,3,0,,3,POINT (1800143 -78802679)
2018,Mayo,Venezuela,4,3,,7,POINT (10406342 -75527794)
2018,Mayo,Venezuela,150,196,,346,POINT (10446304 -75516486)
2018,Mayo,Venezuela,109,205,,314,POINT (10886686 -74776479)
2018,Mayo,Venezuela,0,2,,2,POINT (11247723 -74213989)
2018,Mayo,Venezuela,7143,8040,,15183,POINT (11360029 -72129595)
2018,Mayo,Venezuela,6,5,,11,POINT (1152863 -72919186)
2018,Mayo,Venezuela,0,31,,31,POINT (12165168 -71983761)
2018,Mayo,Venezuela,8,3,,11,POINT (125862 -81702165)
2018,Mayo,Venezuela,72,107,,179,POINT (3451668 -76532004)
2018,Mayo,Venezuela,11,20,,31,POINT (3866713 -67927521)
2018,Mayo,Venezuela,6278,6305,,12583,POINT (4697157 -74140516)
2018,Mayo,Venezuela,8,24,,32,POINT (4815189 -75736374)
2018,Mayo,Venezuela,1195,1319,,2514,POINT (6170465 -7542726)
2018,Mayo,Venezuela,72,64,,136,POINT (6185536 -67484028)
2018,Mayo,Venezuela,874,1013,,1887,POINT (7088729 -70740253)
2018,Mayo,Venezuela,23,16,,39,POINT (7128047 -73181317)
2018,Mayo,Venezuela,33579,37933,,71512,POINT (7819 -72453013)
2018,Mayo,Venezuela,4,7,,11,POINT (7927233 -72508188)
2018,Mayo,Venezuela,2583,2689,,5272,POINT (836068 -72409396)
2018,Mayo,Vietnam,0,1,,1,POINT (0.81488 -77356)
2018,Mayo,Vietnam,0,1,,1,POINT (3451668 -76532004)
2018,Mayo,Vietnam,6,5,,11,POINT (4697157 -74140516)
2018,Mayo,República Árabe de Yemen,0,1,,1,POINT (4697157 -74140516)
2018,Mayo,Zambia,1,0,,1,POINT (10446304 -75516486)
2018,Mayo,Zimbabue,0,1,,1,POINT (10446304 -75516486)
2018,Mayo,Zimbabue,1,2,,3,POINT (4697157 -74140516)
2018,Mayo,Zimbabue,1,0,,1,POINT (6170465 -7542726)
2018,Mayo,Anguila/Territorio Británico de Ultramar,0,1,,1,POINT (4697157 -74140516)
2018,Mayo,Refugiado,2,0,,2,POINT (10446304 -75516486)
2018,Mayo,Refugiado,2,2,,4,POINT (4697157 -74140516)
2018,Mayo,Desconocido,6,8,,14,POINT (10446304 -75516486)
2018,Mayo,Desconocido,1,1,,2,POINT (3451668 -76532004)
2018,Mayo,Desconocido,79,152,,231,POINT (4697157 -74140516)
2018,Mayo,Desconocido,1,5,,6,POINT (6170465 -7542726)
2018,Mayo,Desconocido,1,0,,1,POINT (7088729 -70740253)
2018,Mayo,República CentroÁfricana,1,0,,1,POINT (3451668 -76532004)
2018,Junio,Afganistán,0,2,,2,POINT (4697157 -74140516)
2018,Junio,Albania,1,4,,5,POINT (4697157 -74140516)
2018,Junio,Albania,2,1,,3,POINT (6170465 -7542726)
2018,Junio,Alemania,4,5,,9,POINT (-4191162 -69941498)
2018,Junio,Alemania,15,22,,37,POINT (-4214082 -69941431)
2018,Junio,Alemania,2,4,,6,POINT (0.33002 -76876446)
2018,Junio,Alemania,91,73,,164,POINT (0.81488 -77356)
2018,Junio,Alemania,29,28,,57,POINT (10406342 -75527794)
2018,Junio,Alemania,104,134,,238,POINT (10446304 -75516486)
2018,Junio,Alemania,14,29,,43,POINT (10886686 -74776479)
2018,Junio,Alemania,1,3,,4,POINT (11247723 -74213989)
2018,Junio,Alemania,2,1,,3,POINT (11360029 -72129595)
2018,Junio,Alemania,1,3,,4,POINT (125862 -81702165)
2018,Junio,Alemania,32,58,,90,POINT (3451668 -76532004)
2018,Junio,Alemania,0,2,,2,POINT (3884426 -77061029)
2018,Junio,Alemania,1523,2128,,3651,POINT (4697157 -74140516)
2018,Junio,Alemania,2,4,,6,POINT (4815189 -75736374)
2018,Junio,Alemania,73,145,,218,POINT (6170465 -7542726)
2018,Junio,Alemania,1,1,,2,POINT (7128047 -73181317)
2018,Junio,Alemania,3,4,,7,POINT (7819 -72453013)
2018,Junio,Alemania,0,1,,1,POINT (836068 -72409396)
2018,Junio,Alemania,12,8,,20,POINT (863337 -7735002)
2018,Junio,Andorra,1,7,,8,POINT (4697157 -74140516)
2018,Junio,Antigua y Barbuda,1,1,,2,POINT (10446304 -75516486)
2018,Junio,Antigua y Barbuda,1,0,,1,POINT (10886686 -74776479)
2018,Junio,Antigua y Barbuda,3,6,,9,POINT (4697157 -74140516)
2018,Junio,Países Bajos,0,1,,1,POINT (4697157 -74140516)
2018,Junio,Arabia Saudita,0,1,,1,POINT (0.81488 -77356)
2018,Junio,Arabia Saudita,0,1,,1,POINT (10886686 -74776479)
2018,Junio,Arabia Saudita,0,13,,13,POINT (4697157 -74140516)
2018,Junio,Arabia Saudita,1,2,,3,POINT (6170465 -7542726)
2018,Junio,Arabia Saudita,0,1,,1,POINT (7128047 -73181317)
2018,Junio,Argelia,2,5,,7,POINT (4697157 -74140516)
2018,Junio,Argelia,0,2,,2,POINT (6170465 -7542726)
2018,Junio,Argentina,2,1,,3,POINT (-4191162 -69941498)
2018,Junio,Argentina,3,13,,16,POINT (-4214082 -69941431)
2018,Junio,Argentina,8,17,,25,POINT (0.33002 -76876446)
2018,Junio,Argentina,70,121,,191,POINT (0.81488 -77356)
2018,Junio,Argentina,0,1,,1,POINT (1800143 -78802679)
2018,Junio,Argentina,1272,529,,1801,POINT (10406342 -75527794)
2018,Junio,Argentina,1555,1143,,2698,POINT (10446304 -75516486)
2018,Junio,Argentina,13,33,,46,POINT (10886686 -74776479)
2018,Junio,Argentina,3,6,,9,POINT (11360029 -72129595)
2018,Junio,Argentina,397,333,,730,POINT (125862 -81702165)
2018,Junio,Argentina,0,3,,3,POINT (133387613 -81372937)
2018,Junio,Argentina,30,60,,90,POINT (3451668 -76532004)
2018,Junio,Argentina,0,1,,1,POINT (445285 -75766353)
2018,Junio,Argentina,3958,4673,,8631,POINT (4697157 -74140516)
2018,Junio,Argentina,3,8,,11,POINT (4815189 -75736374)
2018,Junio,Argentina,133,349,,482,POINT (6170465 -7542726)
2018,Junio,Argentina,0,1,,1,POINT (7128047 -73181317)
2018,Junio,Argentina,3,17,,20,POINT (7819 -72453013)
2018,Junio,Argentina,0,5,,5,POINT (836068 -72409396)
2018,Junio,Argentina,0,4,,4,POINT (863337 -7735002)
2018,Junio,República de Armenia,1,0,,1,POINT (4697157 -74140516)
2018,Junio,República de Armenia,0,1,,1,POINT (6170465 -7542726)
2018,Junio,Australia,1,0,,1,POINT (-4191162 -69941498)
2018,Junio,Australia,2,8,,10,POINT (-4214082 -69941431)
2018,Junio,Australia,1,0,,1,POINT (0.33002 -76876446)
2018,Junio,Australia,23,28,,51,POINT (0.81488 -77356)
2018,Junio,Australia,15,27,,42,POINT (10406342 -75527794)
2018,Junio,Australia,51,76,,127,POINT (10446304 -75516486)
2018,Junio,Australia,7,19,,26,POINT (10886686 -74776479)
2018,Junio,Australia,0,1,,1,POINT (11247723 -74213989)
2018,Junio,Australia,0,1,,1,POINT (11360029 -72129595)
2018,Junio,Australia,1,1,,2,POINT (125862 -81702165)
2018,Junio,Australia,10,15,,25,POINT (3451668 -76532004)
2018,Junio,Australia,352,579,,931,POINT (4697157 -74140516)
2018,Junio,Australia,38,80,,118,POINT (6170465 -7542726)
2018,Junio,Australia,0,1,,1,POINT (7819 -72453013)
2018,Junio,Australia,12,18,,30,POINT (863337 -7735002)
2018,Junio,Austria,1,1,,2,POINT (-4191162 -69941498)
2018,Junio,Austria,0,2,,2,POINT (-4214082 -69941431)
2018,Junio,Austria,2,0,,2,POINT (0.33002 -76876446)
2018,Junio,Austria,4,5,,9,POINT (0.81488 -77356)
2018,Junio,Austria,3,7,,10,POINT (10406342 -75527794)
2018,Junio,Austria,8,17,,25,POINT (10446304 -75516486)
2018,Junio,Austria,0,2,,2,POINT (10886686 -74776479)
2018,Junio,Austria,0,1,,1,POINT (125862 -81702165)
2018,Junio,Austria,1,4,,5,POINT (3451668 -76532004)
2018,Junio,Austria,112,178,,290,POINT (4697157 -74140516)
2018,Junio,Austria,12,21,,33,POINT (6170465 -7542726)
2018,Junio,Austria,1,1,,2,POINT (863337 -7735002)
2018,Junio,Azerbaiyán,1,3,,4,POINT (4697157 -74140516)
2018,Junio,Azerbaiyán,1,0,,1,POINT (6170465 -7542726)
2018,Junio,Bahamas,0,1,,1,POINT (10406342 -75527794)
2018,Junio,Bahamas,5,2,,7,POINT (10446304 -75516486)
2018,Junio,Bahamas,2,4,,6,POINT (3451668 -76532004)
2018,Junio,Bahamas,7,5,,12,POINT (4697157 -74140516)
2018,Junio,Bahamas,1,6,,7,POINT (6170465 -7542726)
2018,Junio,Bahréin,0,1,,1,POINT (10446304 -75516486)
2018,Junio,Bangladesh,1,0,,1,POINT (10446304 -75516486)
2018,Junio,Bangladesh,2,2,,4,POINT (4697157 -74140516)
2018,Junio,Barbados,1,0,,1,POINT (10406342 -75527794)
2018,Junio,Barbados,11,4,,15,POINT (10446304 -75516486)
2018,Junio,Barbados,0,2,,2,POINT (10886686 -74776479)
2018,Junio,Barbados,0,1,,1,POINT (3451668 -76532004)
2018,Junio,Barbados,6,11,,17,POINT (4697157 -74140516)
2018,Junio,Barbados,3,2,,5,POINT (6170465 -7542726)
2018,Junio,República de Belarús,1,0,,1,POINT (10446304 -75516486)
2018,Junio,República de Belarús,4,3,,7,POINT (4697157 -74140516)
2018,Junio,Bélgica,1,1,,2,POINT (-4191162 -69941498)
2018,Junio,Bélgica,3,1,,4,POINT (-4214082 -69941431)
2018,Junio,Bélgica,0,1,,1,POINT (0.33002 -76876446)
2018,Junio,Bélgica,11,14,,25,POINT (0.81488 -77356)
2018,Junio,Bélgica,2,3,,5,POINT (10406342 -75527794)
2018,Junio,Bélgica,17,27,,44,POINT (10446304 -75516486)
2018,Junio,Bélgica,4,6,,10,POINT (10886686 -74776479)
2018,Junio,Bélgica,0,1,,1,POINT (125744111 -81703935)
2018,Junio,Bélgica,15,25,,40,POINT (3451668 -76532004)
2018,Junio,Bélgica,276,425,,701,POINT (4697157 -74140516)
2018,Junio,Bélgica,35,51,,86,POINT (6170465 -7542726)
2018,Junio,Bélgica,0,2,,2,POINT (7128047 -73181317)
2018,Junio,Bélgica,2,1,,3,POINT (863337 -7735002)
2018,Junio,Belice,0,2,,2,POINT (10446304 -75516486)
2018,Junio,Belice,0,1,,1,POINT (125862 -81702165)
2018,Junio,Belice,0,1,,1,POINT (3451668 -76532004)
2018,Junio,Belice,9,11,,20,POINT (4697157 -74140516)
2018,Junio,Benín,1,0,,1,POINT (10886686 -74776479)
2018,Junio,Benín,0,3,,3,POINT (4697157 -74140516)
2018,Junio,Bermudas/Territorio Británico de Ultramar,0,2,,2,POINT (10446304 -75516486)
2018,Junio,Bermudas/Territorio Británico de Ultramar,0,1,,1,POINT (3451668 -76532004)
2018,Junio,Bermudas/Territorio Británico de Ultramar,0,1,,1,POINT (4697157 -74140516)
2018,Junio,Bolivia,1,0,,1,POINT (-4214082 -69941431)
2018,Junio,Bolivia,5,5,,10,POINT (0.81488 -77356)
2018,Junio,Bolivia,11,9,,20,POINT (10406342 -75527794)
2018,Junio,Bolivia,108,62,,170,POINT (10446304 -75516486)
2018,Junio,Bolivia,0,2,,2,POINT (10886686 -74776479)
2018,Junio,Bolivia,1,0,,1,POINT (11360029 -72129595)
2018,Junio,Bolivia,9,6,,15,POINT (125862 -81702165)
2018,Junio,Bolivia,22,29,,51,POINT (3451668 -76532004)
2018,Junio,Bolivia,627,716,,1343,POINT (4697157 -74140516)
2018,Junio,Bolivia,2,0,,2,POINT (4815189 -75736374)
2018,Junio,Bolivia,30,51,,81,POINT (6170465 -7542726)
2018,Junio,Bolivia,0,1,,1,POINT (7088729 -70740253)
2018,Junio,Bolivia,0,1,,1,POINT (7128047 -73181317)
2018,Junio,Bolivia,1,8,,9,POINT (7819 -72453013)
2018,Junio,Bosnia y Herzegovina,1,0,,1,POINT (10446304 -75516486)
2018,Junio,Bosnia y Herzegovina,0,1,,1,POINT (3451668 -76532004)
2018,Junio,Bosnia y Herzegovina,1,7,,8,POINT (4697157 -74140516)
2018,Junio,Botsuana,1,0,,1,POINT (6170465 -7542726)
2018,Junio,Brasil,119,116,,235,POINT (-4191162 -69941498)
2018,Junio,Brasil,1,6,,7,POINT (-4214082 -69941431)
2018,Junio,Brasil,1,2,,3,POINT (0.33002 -76876446)
2018,Junio,Brasil,0,1,,1,POINT (0.812436 -77847006)
2018,Junio,Brasil,15,47,,62,POINT (0.81488 -77356)
2018,Junio,Brasil,302,190,,492,POINT (10406342 -75527794)
2018,Junio,Brasil,827,602,,1429,POINT (10446304 -75516486)
2018,Junio,Brasil,9,23,,32,POINT (10886686 -74776479)
2018,Junio,Brasil,1,2,,3,POINT (11360029 -72129595)
2018,Junio,Brasil,344,271,,615,POINT (125862 -81702165)
2018,Junio,Brasil,33,48,,81,POINT (3451668 -76532004)
2018,Junio,Brasil,1,3,,4,POINT (3866713 -67927521)
2018,Junio,Brasil,4746,5864,,10610,POINT (4697157 -74140516)
2018,Junio,Brasil,3,2,,5,POINT (4815189 -75736374)
2018,Junio,Brasil,118,211,,329,POINT (6170465 -7542726)
2018,Junio,Brasil,1,0,,1,POINT (6185536 -67484028)
2018,Junio,Brasil,1,1,,2,POINT (7128047 -73181317)
2018,Junio,Brasil,5,7,,12,POINT (7819 -72453013)
2018,Junio,Brasil,2,2,,4,POINT (836068 -72409396)
2018,Junio,Brasil,0,2,,2,POINT (863337 -7735002)
2018,Junio,Brunei Darussalam,1,1,,2,POINT (4697157 -74140516)
2018,Junio,Bulgaria,0,1,,1,POINT (10406342 -75527794)
2018,Junio,Bulgaria,5,3,,8,POINT (10446304 -75516486)
2018,Junio,Bulgaria,1,0,,1,POINT (10886686 -74776479)
2018,Junio,Bulgaria,2,4,,6,POINT (3451668 -76532004)
2018,Junio,Bulgaria,25,20,,45,POINT (4697157 -74140516)
2018,Junio,Bulgaria,2,3,,5,POINT (6170465 -7542726)
2018,Junio,Burkina Faso,0,1,,1,POINT (4697157 -74140516)
2018,Junio,Burundi,0,2,,2,POINT (4697157 -74140516)
2018,Junio,Bután,1,0,,1,POINT (4697157 -74140516)
2018,Junio,Cabo Verde,0,1,,1,POINT (10446304 -75516486)
2018,Junio,Cabo Verde,1,1,,2,POINT (4697157 -74140516)
2018,Junio,Cabo Verde,1,0,,1,POINT (6170465 -7542726)
2018,Junio,Islas Caimán/Territorio Británico de Ultramar,3,1,,4,POINT (10446304 -75516486)
2018,Junio,Islas Caimán/Territorio Británico de Ultramar,0,1,,1,POINT (10886686 -74776479)
2018,Junio,Islas Caimán/Territorio Británico de Ultramar,3,1,,4,POINT (125862 -81702165)
2018,Junio,Islas Caimán/Territorio Británico de Ultramar,7,3,,10,POINT (4697157 -74140516)
2018,Junio,Islas Caimán/Territorio Británico de Ultramar,0,1,,1,POINT (6170465 -7542726)
2018,Junio,Camerún,0,1,,1,POINT (0.81488 -77356)
2018,Junio,Camerún,1,0,,1,POINT (10446304 -75516486)
2018,Junio,Camerún,4,2,,6,POINT (4697157 -74140516)
2018,Junio,Camerún,1,0,,1,POINT (4815189 -75736374)
2018,Junio,Canadá,1,1,,2,POINT (-4214082 -69941431)
2018,Junio,Canadá,0,1,,1,POINT (0.33002 -76876446)
2018,Junio,Canadá,15,12,,27,POINT (0.81488 -77356)
2018,Junio,Canadá,7,10,,17,POINT (10406342 -75527794)
2018,Junio,Canadá,178,245,,423,POINT (10446304 -75516486)
2018,Junio,Canadá,28,32,,60,POINT (10886686 -74776479)
2018,Junio,Canadá,0,1,,1,POINT (11360029 -72129595)
2018,Junio,Canadá,1,3,,4,POINT (125862 -81702165)
2018,Junio,Canadá,0,1,,1,POINT (133387613 -81372937)
2018,Junio,Canadá,57,52,,109,POINT (3451668 -76532004)
2018,Junio,Canadá,2,3,,5,POINT (445285 -75766353)
2018,Junio,Canadá,1075,1574,,2649,POINT (4697157 -74140516)
2018,Junio,Canadá,5,19,,24,POINT (4815189 -75736374)
2018,Junio,Canadá,183,391,,574,POINT (6170465 -7542726)
2018,Junio,Canadá,4,9,,13,POINT (7128047 -73181317)
2018,Junio,Canadá,1,1,,2,POINT (7819 -72453013)
2018,Junio,Canadá,0,1,,1,POINT (836068 -72409396)
2018,Junio,Canadá,0,2,,2,POINT (863337 -7735002)
2018,Junio,República Democrática del Congo,5,3,,8,POINT (4697157 -74140516)
2018,Junio,República de Corea,0,1,,1,POINT (-4191162 -69941498)
2018,Junio,República de Corea,2,2,,4,POINT (-4214082 -69941431)
2018,Junio,República de Corea,15,11,,26,POINT (0.81488 -77356)
2018,Junio,República de Corea,1,2,,3,POINT (10406342 -75527794)
2018,Junio,República de Corea,18,22,,40,POINT (10446304 -75516486)
2018,Junio,República de Corea,1,2,,3,POINT (10886686 -74776479)
2018,Junio,República de Corea,0,1,,1,POINT (125862 -81702165)
2018,Junio,República de Corea,2,3,,5,POINT (3451668 -76532004)
2018,Junio,República de Corea,251,402,,653,POINT (4697157 -74140516)
2018,Junio,República de Corea,9,33,,42,POINT (6170465 -7542726)
2018,Junio,República de Corea,1,3,,4,POINT (7819 -72453013)
2018,Junio,Costa de Marfil,0,3,,3,POINT (4697157 -74140516)
2018,Junio,Costa de Marfil,1,0,,1,POINT (6170465 -7542726)
2018,Junio,Costa Rica,5,3,,8,POINT (0.81488 -77356)
2018,Junio,Costa Rica,2,0,,2,POINT (10406342 -75527794)
2018,Junio,Costa Rica,151,108,,259,POINT (10446304 -75516486)
2018,Junio,Costa Rica,10,15,,25,POINT (10886686 -74776479)
2018,Junio,Costa Rica,1,0,,1,POINT (11360029 -72129595)
2018,Junio,Costa Rica,0,1,,1,POINT (125744111 -81703935)
2018,Junio,Costa Rica,46,28,,74,POINT (125862 -81702165)
2018,Junio,Costa Rica,31,49,,80,POINT (3451668 -76532004)
2018,Junio,Costa Rica,1,0,,1,POINT (445285 -75766353)
2018,Junio,Costa Rica,1432,1721,,3153,POINT (4697157 -74140516)
2018,Junio,Costa Rica,1,3,,4,POINT (4815189 -75736374)
2018,Junio,Costa Rica,119,178,,297,POINT (6170465 -7542726)
2018,Junio,Costa Rica,0,1,,1,POINT (7088729 -70740253)
2018,Junio,Costa Rica,2,6,,8,POINT (7128047 -73181317)
2018,Junio,Costa Rica,0,1,,1,POINT (863337 -7735002)
2018,Junio,Croacia,1,0,,1,POINT (-4214082 -69941431)
2018,Junio,Croacia,0,1,,1,POINT (10406342 -75527794)
2018,Junio,Croacia,1,3,,4,POINT (10446304 -75516486)
2018,Junio,Croacia,0,1,,1,POINT (11360029 -72129595)
2018,Junio,Croacia,0,2,,2,POINT (3884426 -77061029)
2018,Junio,Croacia,14,38,,52,POINT (4697157 -74140516)
2018,Junio,Croacia,1,4,,5,POINT (6170465 -7542726)
2018,Junio,Cuba,1,0,,1,POINT (-4191162 -69941498)
2018,Junio,Cuba,0,1,,1,POINT (0.33002 -76876446)
2018,Junio,Cuba,0,1,,1,POINT (0.81488 -77356)
2018,Junio,Cuba,9,24,,33,POINT (10446304 -75516486)
2018,Junio,Cuba,11,49,,60,POINT (10886686 -74776479)
2018,Junio,Cuba,0,1,,1,POINT (125744111 -81703935)
2018,Junio,Cuba,14,28,,42,POINT (3451668 -76532004)
2018,Junio,Cuba,217,399,,616,POINT (4697157 -74140516)
2018,Junio,Cuba,1,1,,2,POINT (4815189 -75736374)
2018,Junio,Cuba,24,36,,60,POINT (6170465 -7542726)
2018,Junio,Cuba,2,0,,2,POINT (7128047 -73181317)
2018,Junio,Cuba,1,1,,2,POINT (7819 -72453013)
2018,Junio,República Checa,0,1,,1,POINT (-4214082 -69941431)
2018,Junio,República Checa,3,5,,8,POINT (0.81488 -77356)
2018,Junio,República Checa,6,2,,8,POINT (10446304 -75516486)
2018,Junio,República Checa,4,3,,7,POINT (10886686 -74776479)
2018,Junio,República Checa,1,0,,1,POINT (133387613 -81372937)
2018,Junio,República Checa,5,3,,8,POINT (3451668 -76532004)
2018,Junio,República Checa,0,1,,1,POINT (3884426 -77061029)
2018,Junio,República Checa,38,83,,121,POINT (4697157 -74140516)
2018,Junio,República Checa,5,6,,11,POINT (6170465 -7542726)
2018,Junio,Chile,3,0,,3,POINT (-4191162 -69941498)
2018,Junio,Chile,2,5,,7,POINT (-4214082 -69941431)
2018,Junio,Chile,3,4,,7,POINT (0.33002 -76876446)
2018,Junio,Chile,31,61,,92,POINT (0.81488 -77356)
2018,Junio,Chile,152,100,,252,POINT (10406342 -75527794)
2018,Junio,Chile,573,451,,1024,POINT (10446304 -75516486)
2018,Junio,Chile,7,15,,22,POINT (10886686 -74776479)
2018,Junio,Chile,1,2,,3,POINT (11360029 -72129595)
2018,Junio,Chile,0,1,,1,POINT (125744111 -81703935)
2018,Junio,Chile,114,83,,197,POINT (125862 -81702165)
2018,Junio,Chile,22,48,,70,POINT (3451668 -76532004)
2018,Junio,Chile,0,2,,2,POINT (445285 -75766353)
2018,Junio,Chile,4032,5164,,9196,POINT (4697157 -74140516)
2018,Junio,Chile,0,5,,5,POINT (4815189 -75736374)
2018,Junio,Chile,75,128,,203,POINT (6170465 -7542726)
2018,Junio,Chile,0,3,,3,POINT (7088729 -70740253)
2018,Junio,Chile,0,1,,1,POINT (7128047 -73181317)
2018,Junio,Chile,9,23,,32,POINT (7819 -72453013)
2018,Junio,Chile,3,5,,8,POINT (836068 -72409396)
2018,Junio,Chile,1,1,,2,POINT (863337 -7735002)
2018,Junio,China,5,8,,13,POINT (0.81488 -77356)
2018,Junio,China,0,4,,4,POINT (10406342 -75527794)
2018,Junio,China,29,39,,68,POINT (10446304 -75516486)
2018,Junio,China,7,17,,24,POINT (10886686 -74776479)
2018,Junio,China,0,2,,2,POINT (10970933 -74765343)
2018,Junio,China,0,5,,5,POINT (11247723 -74213989)
2018,Junio,China,1,4,,5,POINT (11360029 -72129595)
2018,Junio,China,12,23,,35,POINT (3451668 -76532004)
2018,Junio,China,0,2,,2,POINT (3884426 -77061029)
2018,Junio,China,385,825,,1210,POINT (4697157 -74140516)
2018,Junio,China,1,0,,1,POINT (4815189 -75736374)
2018,Junio,China,69,142,,211,POINT (6170465 -7542726)
2018,Junio,China,0,3,,3,POINT (7819 -72453013)
2018,Junio,Taiwán,0,1,,1,POINT (-4191162 -69941498)
2018,Junio,Taiwán,1,1,,2,POINT (-4214082 -69941431)
2018,Junio,Taiwán,0,4,,4,POINT (0.81488 -77356)
2018,Junio,Taiwán,3,3,,6,POINT (10446304 -75516486)
2018,Junio,Taiwán,1,0,,1,POINT (10886686 -74776479)
2018,Junio,Taiwán,2,0,,2,POINT (3451668 -76532004)
2018,Junio,Taiwán,65,69,,134,POINT (4697157 -74140516)
2018,Junio,Taiwán,8,6,,14,POINT (6170465 -7542726)
2018,Junio,Chipre,1,1,,2,POINT (10446304 -75516486)
2018,Junio,Chipre,0,1,,1,POINT (3451668 -76532004)
2018,Junio,Chipre,9,5,,14,POINT (4697157 -74140516)
2018,Junio,Chipre,0,1,,1,POINT (6170465 -7542726)
2018,Junio,Dinamarca,6,8,,14,POINT (0.81488 -77356)
2018,Junio,Dinamarca,0,1,,1,POINT (10406342 -75527794)
2018,Junio,Dinamarca,13,16,,29,POINT (10446304 -75516486)
2018,Junio,Dinamarca,0,5,,5,POINT (10886686 -74776479)
2018,Junio,Dinamarca,1,0,,1,POINT (125744111 -81703935)
2018,Junio,Dinamarca,7,10,,17,POINT (3451668 -76532004)
2018,Junio,Dinamarca,132,200,,332,POINT (4697157 -74140516)
2018,Junio,Dinamarca,7,25,,32,POINT (6170465 -7542726)
2018,Junio,Dinamarca,1,2,,3,POINT (863337 -7735002)
2018,Junio,Dominica,1,1,,2,POINT (10446304 -75516486)
2018,Junio,Dominica,4,6,,10,POINT (4697157 -74140516)
2018,Junio,Dominica,0,1,,1,POINT (6170465 -7542726)
2018,Junio,Ecuador,0,2,,2,POINT (-4214082 -69941431)
2018,Junio,Ecuador,45,178,,223,POINT (0.33002 -76876446)
2018,Junio,Ecuador,19,30,,49,POINT (0.812436 -77847006)
2018,Junio,Ecuador,830,1451,,2281,POINT (0.81488 -77356)
2018,Junio,Ecuador,15,42,,57,POINT (1800143 -78802679)
2018,Junio,Ecuador,7,5,,12,POINT (10406342 -75527794)
2018,Junio,Ecuador,127,105,,232,POINT (10446304 -75516486)
2018,Junio,Ecuador,6,12,,18,POINT (10886686 -74776479)
2018,Junio,Ecuador,5,5,,10,POINT (11360029 -72129595)
2018,Junio,Ecuador,0,1,,1,POINT (125744111 -81703935)
2018,Junio,Ecuador,17,11,,28,POINT (125862 -81702165)
2018,Junio,Ecuador,329,394,,723,POINT (3451668 -76532004)
2018,Junio,Ecuador,1,0,,1,POINT (3866713 -67927521)
2018,Junio,Ecuador,1,2,,3,POINT (445285 -75766353)
2018,Junio,Ecuador,2751,3734,,6485,POINT (4697157 -74140516)
2018,Junio,Ecuador,1,0,,1,POINT (4815189 -75736374)
2018,Junio,Ecuador,88,114,,202,POINT (6170465 -7542726)
2018,Junio,Ecuador,0,1,,1,POINT (7088729 -70740253)
2018,Junio,Ecuador,1,0,,1,POINT (7128047 -73181317)
2018,Junio,Ecuador,84,116,,200,POINT (7819 -72453013)
2018,Junio,Ecuador,1,5,,6,POINT (836068 -72409396)
2018,Junio,Egipto,1,1,,2,POINT (10446304 -75516486)
2018,Junio,Egipto,1,2,,3,POINT (3451668 -76532004)
2018,Junio,Egipto,5,22,,27,POINT (4697157 -74140516)
2018,Junio,Egipto,1,2,,3,POINT (6170465 -7542726)
2018,Junio,El Salvador,0,2,,2,POINT (-4214082 -69941431)
2018,Junio,El Salvador,2,1,,3,POINT (0.81488 -77356)
2018,Junio,El Salvador,0,1,,1,POINT (10406342 -75527794)
2018,Junio,El Salvador,39,45,,84,POINT (10446304 -75516486)
2018,Junio,El Salvador,2,2,,4,POINT (10886686 -74776479)
2018,Junio,El Salvador,2,3,,5,POINT (125862 -81702165)
2018,Junio,El Salvador,8,8,,16,POINT (3451668 -76532004)
2018,Junio,El Salvador,682,927,,1609,POINT (4697157 -74140516)
2018,Junio,El Salvador,1,0,,1,POINT (4815189 -75736374)
2018,Junio,El Salvador,129,149,,278,POINT (6170465 -7542726)
2018,Junio,El Salvador,1,0,,1,POINT (7088729 -70740253)
2018,Junio,El Salvador,0,1,,1,POINT (7128047 -73181317)
2018,Junio,El Salvador,0,2,,2,POINT (7819 -72453013)
2018,Junio,El Salvador,0,1,,1,POINT (863337 -7735002)
2018,Junio,Emiratos Árabes,2,2,,4,POINT (10446304 -75516486)
2018,Junio,Emiratos Árabes,6,11,,17,POINT (4697157 -74140516)
2018,Junio,Emiratos Árabes,0,1,,1,POINT (6170465 -7542726)
2018,Junio,España,2,2,,4,POINT (-4191162 -69941498)
2018,Junio,España,3,6,,9,POINT (-4214082 -69941431)
2018,Junio,España,4,1,,5,POINT (0.33002 -76876446)
2018,Junio,España,30,41,,71,POINT (0.81488 -77356)
2018,Junio,España,17,22,,39,POINT (10406342 -75527794)
2018,Junio,España,101,153,,254,POINT (10446304 -75516486)
2018,Junio,España,27,63,,90,POINT (10886686 -74776479)
2018,Junio,España,0,1,,1,POINT (10970933 -74765343)
2018,Junio,España,0,2,,2,POINT (11247723 -74213989)
2018,Junio,España,1,9,,10,POINT (11360029 -72129595)
2018,Junio,España,0,2,,2,POINT (125862 -81702165)
2018,Junio,España,537,593,,1130,POINT (3451668 -76532004)
2018,Junio,España,1,0,,1,POINT (445285 -75766353)
2018,Junio,España,3099,5432,,8531,POINT (4697157 -74140516)
2018,Junio,España,8,10,,18,POINT (4815189 -75736374)
2018,Junio,España,438,730,,1168,POINT (6170465 -7542726)
2018,Junio,España,0,3,,3,POINT (7088729 -70740253)
2018,Junio,España,0,1,,1,POINT (7128047 -73181317)
2018,Junio,España,16,27,,43,POINT (7819 -72453013)
2018,Junio,España,3,1,,4,POINT (836068 -72409396)
2018,Junio,España,1,1,,2,POINT (863337 -7735002)
2018,Junio,Eslovaquia,4,0,,4,POINT (0.81488 -77356)
2018,Junio,Eslovaquia,2,0,,2,POINT (10446304 -75516486)
2018,Junio,Eslovaquia,1,1,,2,POINT (3451668 -76532004)
2018,Junio,Eslovaquia,22,20,,42,POINT (4697157 -74140516)
2018,Junio,Eslovaquia,1,4,,5,POINT (6170465 -7542726)
2018,Junio,Eslovenia,2,1,,3,POINT (10446304 -75516486)
2018,Junio,Eslovenia,1,1,,2,POINT (3451668 -76532004)
2018,Junio,Eslovenia,8,17,,25,POINT (4697157 -74140516)
2018,Junio,Eslovenia,0,4,,4,POINT (6170465 -7542726)
2018,Junio,Estados Unidos de América,22,28,,50,POINT (-4191162 -69941498)
2018,Junio,Estados Unidos de América,13,8,,21,POINT (-4214082 -69941431)
2018,Junio,Estados Unidos de América,1,3,,4,POINT (0.33002 -76876446)
2018,Junio,Estados Unidos de América,0,1,,1,POINT (0.812436 -77847006)
2018,Junio,Estados Unidos de América,34,55,,89,POINT (0.81488 -77356)
2018,Junio,Estados Unidos de América,14,40,,54,POINT (10406342 -75527794)
2018,Junio,Estados Unidos de América,5501,7292,,12793,POINT (10446304 -75516486)
2018,Junio,Estados Unidos de América,1042,1561,,2603,POINT (10886686 -74776479)
2018,Junio,Estados Unidos de América,1,2,,3,POINT (11247723 -74213989)
2018,Junio,Estados Unidos de América,7,8,,15,POINT (11360029 -72129595)
2018,Junio,Estados Unidos de América,1,12,,13,POINT (125744111 -81703935)
2018,Junio,Estados Unidos de América,74,72,,146,POINT (125862 -81702165)
2018,Junio,Estados Unidos de América,2,2,,4,POINT (133387613 -81372937)
2018,Junio,Estados Unidos de América,2022,2450,,4472,POINT (3451668 -76532004)
2018,Junio,Estados Unidos de América,273,294,,567,POINT (445285 -75766353)
2018,Junio,Estados Unidos de América,13650,19136,,32786,POINT (4697157 -74140516)
2018,Junio,Estados Unidos de América,309,373,,682,POINT (4815189 -75736374)
2018,Junio,Estados Unidos de América,4384,7645,,12029,POINT (6170465 -7542726)
2018,Junio,Estados Unidos de América,1,1,,2,POINT (7088729 -70740253)
2018,Junio,Estados Unidos de América,74,109,,183,POINT (7128047 -73181317)
2018,Junio,Estados Unidos de América,8,11,,19,POINT (7819 -72453013)
2018,Junio,Estados Unidos de América,0,3,,3,POINT (836068 -72409396)
2018,Junio,Estados Unidos de América,6,14,,20,POINT (863337 -7735002)
2018,Junio,Estonia,1,2,,3,POINT (0.81488 -77356)
2018,Junio,Estonia,0,1,,1,POINT (10406342 -75527794)
2018,Junio,Estonia,4,0,,4,POINT (3451668 -76532004)
2018,Junio,Estonia,6,4,,10,POINT (4697157 -74140516)
2018,Junio,Estonia,3,5,,8,POINT (6170465 -7542726)
2018,Junio,Etiopia,0,2,,2,POINT (10446304 -75516486)
2018,Junio,Etiopia,3,15,,18,POINT (4697157 -74140516)
2018,Junio,Filipinas,1,1,,2,POINT (0.81488 -77356)
2018,Junio,Filipinas,0,32,,32,POINT (10406342 -75527794)
2018,Junio,Filipinas,9,51,,60,POINT (10446304 -75516486)
2018,Junio,Filipinas,0,5,,5,POINT (10886686 -74776479)
2018,Junio,Filipinas,0,7,,7,POINT (10970933 -74765343)
2018,Junio,Filipinas,0,12,,12,POINT (11247723 -74213989)
2018,Junio,Filipinas,5,16,,21,POINT (3451668 -76532004)
2018,Junio,Filipinas,0,22,,22,POINT (3884426 -77061029)
2018,Junio,Filipinas,39,60,,99,POINT (4697157 -74140516)
2018,Junio,Filipinas,8,6,,14,POINT (6170465 -7542726)
2018,Junio,Filipinas,0,3,,3,POINT (9402597 -75681642)
2018,Junio,Finlandia,0,1,,1,POINT (-4214082 -69941431)
2018,Junio,Finlandia,2,0,,2,POINT (0.81488 -77356)
2018,Junio,Finlandia,6,2,,8,POINT (10446304 -75516486)
2018,Junio,Finlandia,3,1,,4,POINT (10886686 -74776479)
2018,Junio,Finlandia,5,4,,9,POINT (3451668 -76532004)
2018,Junio,Finlandia,47,50,,97,POINT (4697157 -74140516)
2018,Junio,Finlandia,7,11,,18,POINT (6170465 -7542726)
2018,Junio,Finlandia,1,1,,2,POINT (863337 -7735002)
2018,Junio,Francia,6,2,,8,POINT (-4191162 -69941498)
2018,Junio,Francia,19,25,,44,POINT (-4214082 -69941431)
2018,Junio,Francia,8,9,,17,POINT (0.33002 -76876446)
2018,Junio,Francia,0,1,,1,POINT (0.812436 -77847006)
2018,Junio,Francia,109,118,,227,POINT (0.81488 -77356)
2018,Junio,Francia,12,13,,25,POINT (10406342 -75527794)
2018,Junio,Francia,114,170,,284,POINT (10446304 -75516486)
2018,Junio,Francia,32,42,,74,POINT (10886686 -74776479)
2018,Junio,Francia,3,5,,8,POINT (11247723 -74213989)
2018,Junio,Francia,3,7,,10,POINT (11360029 -72129595)
2018,Junio,Francia,2,2,,4,POINT (125862 -81702165)
2018,Junio,Francia,1,1,,2,POINT (133387613 -81372937)
2018,Junio,Francia,54,86,,140,POINT (3451668 -76532004)
2018,Junio,Francia,1554,2314,,3868,POINT (4697157 -74140516)
2018,Junio,Francia,3,9,,12,POINT (4815189 -75736374)
2018,Junio,Francia,112,226,,338,POINT (6170465 -7542726)
2018,Junio,Francia,0,1,,1,POINT (7088729 -70740253)
2018,Junio,Francia,0,4,,4,POINT (7128047 -73181317)
2018,Junio,Francia,1,2,,3,POINT (7819 -72453013)
2018,Junio,Francia,2,0,,2,POINT (836068 -72409396)
2018,Junio,Francia,8,9,,17,POINT (863337 -7735002)
2018,Junio,Gabón,1,1,,2,POINT (4697157 -74140516)
2018,Junio,Georgia,1,0,,1,POINT (3451668 -76532004)
2018,Junio,Georgia,2,0,,2,POINT (4697157 -74140516)
2018,Junio,Ghana,1,0,,1,POINT (10446304 -75516486)
2018,Junio,Ghana,0,4,,4,POINT (4697157 -74140516)
2018,Junio,Granada,1,3,,4,POINT (3451668 -76532004)
2018,Junio,Granada,1,3,,4,POINT (4697157 -74140516)
2018,Junio,Grecia,0,3,,3,POINT (10406342 -75527794)
2018,Junio,Grecia,1,11,,12,POINT (10446304 -75516486)
2018,Junio,Grecia,0,2,,2,POINT (10970933 -74765343)
2018,Junio,Grecia,0,1,,1,POINT (11360029 -72129595)
2018,Junio,Grecia,0,1,,1,POINT (3451668 -76532004)
2018,Junio,Grecia,25,57,,82,POINT (4697157 -74140516)
2018,Junio,Grecia,2,5,,7,POINT (6170465 -7542726)
2018,Junio,Grecia,0,1,,1,POINT (9402597 -75681642)
2018,Junio,Guatemala,0,1,,1,POINT (-4214082 -69941431)
2018,Junio,Guatemala,0,3,,3,POINT (0.81488 -77356)
2018,Junio,Guatemala,5,7,,12,POINT (10406342 -75527794)
2018,Junio,Guatemala,186,204,,390,POINT (10446304 -75516486)
2018,Junio,Guatemala,12,16,,28,POINT (10886686 -74776479)
2018,Junio,Guatemala,1,2,,3,POINT (125744111 -81703935)
2018,Junio,Guatemala,18,5,,23,POINT (125862 -81702165)
2018,Junio,Guatemala,19,34,,53,POINT (3451668 -76532004)
2018,Junio,Guatemala,2,1,,3,POINT (445285 -75766353)
2018,Junio,Guatemala,524,769,,1293,POINT (4697157 -74140516)
2018,Junio,Guatemala,2,2,,4,POINT (4815189 -75736374)
2018,Junio,Guatemala,86,136,,222,POINT (6170465 -7542726)
2018,Junio,Guatemala,1,3,,4,POINT (7128047 -73181317)
2018,Junio,Guatemala,1,2,,3,POINT (7819 -72453013)
2018,Junio,Guyana,0,1,,1,POINT (-4191162 -69941498)
2018,Junio,Guyana,1,2,,3,POINT (10446304 -75516486)
2018,Junio,Guyana,0,1,,1,POINT (11360029 -72129595)
2018,Junio,Guyana,1,2,,3,POINT (3451668 -76532004)
2018,Junio,Guyana,5,9,,14,POINT (4697157 -74140516)
2018,Junio,Guyana,7,1,,8,POINT (6170465 -7542726)
2018,Junio,Guyana,0,1,,1,POINT (7819 -72453013)
2018,Junio,Guinea Ecuatorial,1,2,,3,POINT (4697157 -74140516)
2018,Junio,Haití,0,3,,3,POINT (10406342 -75527794)
2018,Junio,Haití,10,7,,17,POINT (10446304 -75516486)
2018,Junio,Haití,0,4,,4,POINT (10886686 -74776479)
2018,Junio,Haití,1,0,,1,POINT (3451668 -76532004)
2018,Junio,Haití,8,16,,24,POINT (4697157 -74140516)
2018,Junio,Haití,2,6,,8,POINT (6170465 -7542726)
2018,Junio,Honduras,2,6,,8,POINT (0.81488 -77356)
2018,Junio,Honduras,0,4,,4,POINT (10406342 -75527794)
2018,Junio,Honduras,51,53,,104,POINT (10446304 -75516486)
2018,Junio,Honduras,5,5,,10,POINT (10886686 -74776479)
2018,Junio,Honduras,0,23,,23,POINT (125744111 -81703935)
2018,Junio,Honduras,1,3,,4,POINT (125862 -81702165)
2018,Junio,Honduras,12,19,,31,POINT (3451668 -76532004)
2018,Junio,Honduras,2,1,,3,POINT (445285 -75766353)
2018,Junio,Honduras,245,292,,537,POINT (4697157 -74140516)
2018,Junio,Honduras,0,1,,1,POINT (4815189 -75736374)
2018,Junio,Honduras,43,71,,114,POINT (6170465 -7542726)
2018,Junio,Honduras,1,0,,1,POINT (836068 -72409396)
2018,Junio,Hong Kong,1,0,,1,POINT (0.33002 -76876446)
2018,Junio,Hong Kong,1,0,,1,POINT (0.81488 -77356)
2018,Junio,Hong Kong,3,0,,3,POINT (10446304 -75516486)
2018,Junio,Hong Kong,14,11,,25,POINT (4697157 -74140516)
2018,Junio,Hungría,0,2,,2,POINT (-4214082 -69941431)
2018,Junio,Hungría,0,1,,1,POINT (0.81488 -77356)
2018,Junio,Hungría,1,3,,4,POINT (10446304 -75516486)
2018,Junio,Hungría,1,1,,2,POINT (10886686 -74776479)
2018,Junio,Hungría,0,1,,1,POINT (3451668 -76532004)
2018,Junio,Hungría,26,46,,72,POINT (4697157 -74140516)
2018,Junio,Hungría,4,8,,12,POINT (6170465 -7542726)
2018,Junio,India,0,1,,1,POINT (0.33002 -76876446)
2018,Junio,India,1,3,,4,POINT (0.81488 -77356)
2018,Junio,India,3,11,,14,POINT (10406342 -75527794)
2018,Junio,India,25,83,,108,POINT (10446304 -75516486)
2018,Junio,India,1,21,,22,POINT (10886686 -74776479)
2018,Junio,India,0,6,,6,POINT (10970933 -74765343)
2018,Junio,India,0,4,,4,POINT (11247723 -74213989)
2018,Junio,India,2,17,,19,POINT (3451668 -76532004)
2018,Junio,India,0,2,,2,POINT (3884426 -77061029)
2018,Junio,India,100,364,,464,POINT (4697157 -74140516)
2018,Junio,India,1,0,,1,POINT (4815189 -75736374)
2018,Junio,India,10,56,,66,POINT (6170465 -7542726)
2018,Junio,India,1,0,,1,POINT (863337 -7735002)
2018,Junio,India,0,2,,2,POINT (9402597 -75681642)
2018,Junio,Indonesia,0,1,,1,POINT (10406342 -75527794)
2018,Junio,Indonesia,1,4,,5,POINT (10446304 -75516486)
2018,Junio,Indonesia,0,1,,1,POINT (11360029 -72129595)
2018,Junio,Indonesia,28,39,,67,POINT (4697157 -74140516)
2018,Junio,Indonesia,1,1,,2,POINT (6170465 -7542726)
2018,Junio,Iraq,1,3,,4,POINT (4697157 -74140516)
2018,Junio,Irán,1,2,,3,POINT (10446304 -75516486)
2018,Junio,Irán,3,18,,21,POINT (4697157 -74140516)
2018,Junio,Irán,0,1,,1,POINT (4815189 -75736374)
2018,Junio,Irán,0,2,,2,POINT (6170465 -7542726)
2018,Junio,República de Irlanda,4,4,,8,POINT (-4214082 -69941431)
2018,Junio,República de Irlanda,1,0,,1,POINT (0.33002 -76876446)
2018,Junio,República de Irlanda,12,19,,31,POINT (0.81488 -77356)
2018,Junio,República de Irlanda,6,5,,11,POINT (10406342 -75527794)
2018,Junio,República de Irlanda,36,44,,80,POINT (10446304 -75516486)
2018,Junio,República de Irlanda,1,1,,2,POINT (10886686 -74776479)
2018,Junio,República de Irlanda,1,5,,6,POINT (3451668 -76532004)
2018,Junio,República de Irlanda,177,252,,429,POINT (4697157 -74140516)
2018,Junio,República de Irlanda,17,44,,61,POINT (6170465 -7542726)
2018,Junio,República de Irlanda,3,9,,12,POINT (863337 -7735002)
2018,Junio,Islandia,0,1,,1,POINT (3451668 -76532004)
2018,Junio,Islandia,4,6,,10,POINT (4697157 -74140516)
2018,Junio,Islandia,2,3,,5,POINT (6170465 -7542726)
2018,Junio,Israel,0,2,,2,POINT (-4191162 -69941498)
2018,Junio,Israel,0,5,,5,POINT (-4214082 -69941431)
2018,Junio,Israel,1,1,,2,POINT (0.33002 -76876446)
2018,Junio,Israel,35,69,,104,POINT (0.81488 -77356)
2018,Junio,Israel,1,1,,2,POINT (10406342 -75527794)
2018,Junio,Israel,17,34,,51,POINT (10446304 -75516486)
2018,Junio,Israel,3,4,,7,POINT (10886686 -74776479)
2018,Junio,Israel,4,6,,10,POINT (125862 -81702165)
2018,Junio,Israel,7,25,,32,POINT (3451668 -76532004)
2018,Junio,Israel,153,433,,586,POINT (4697157 -74140516)
2018,Junio,Israel,35,90,,125,POINT (6170465 -7542726)
2018,Junio,Israel,0,1,,1,POINT (863337 -7735002)
2018,Junio,Italia,0,2,,2,POINT (-4191162 -69941498)
2018,Junio,Italia,3,1,,4,POINT (-4214082 -69941431)
2018,Junio,Italia,17,24,,41,POINT (0.81488 -77356)
2018,Junio,Italia,36,26,,62,POINT (10406342 -75527794)
2018,Junio,Italia,72,134,,206,POINT (10446304 -75516486)
2018,Junio,Italia,8,30,,38,POINT (10886686 -74776479)
2018,Junio,Italia,0,1,,1,POINT (11247723 -74213989)
2018,Junio,Italia,1,3,,4,POINT (11360029 -72129595)
2018,Junio,Italia,7,5,,12,POINT (125862 -81702165)
2018,Junio,Italia,48,91,,139,POINT (3451668 -76532004)
2018,Junio,Italia,0,1,,1,POINT (3884426 -77061029)
2018,Junio,Italia,683,1672,,2355,POINT (4697157 -74140516)
2018,Junio,Italia,0,4,,4,POINT (4815189 -75736374)
2018,Junio,Italia,77,191,,268,POINT (6170465 -7542726)
2018,Junio,Italia,0,2,,2,POINT (7088729 -70740253)
2018,Junio,Italia,0,1,,1,POINT (7128047 -73181317)
2018,Junio,Italia,8,14,,22,POINT (7819 -72453013)
2018,Junio,Italia,1,3,,4,POINT (836068 -72409396)
2018,Junio,Jamaica,0,1,,1,POINT (10406342 -75527794)
2018,Junio,Jamaica,9,12,,21,POINT (10446304 -75516486)
2018,Junio,Jamaica,1,2,,3,POINT (10886686 -74776479)
2018,Junio,Jamaica,4,16,,20,POINT (125862 -81702165)
2018,Junio,Jamaica,4,5,,9,POINT (3451668 -76532004)
2018,Junio,Jamaica,10,20,,30,POINT (4697157 -74140516)
2018,Junio,Jamaica,1,0,,1,POINT (4815189 -75736374)
2018,Junio,Jamaica,7,14,,21,POINT (6170465 -7542726)
2018,Junio,Jamaica,1,0,,1,POINT (7128047 -73181317)
2018,Junio,Japón,1,2,,3,POINT (-4191162 -69941498)
2018,Junio,Japón,1,1,,2,POINT (-4214082 -69941431)
2018,Junio,Japón,0,1,,1,POINT (0.33002 -76876446)
2018,Junio,Japón,6,11,,17,POINT (0.81488 -77356)
2018,Junio,Japón,14,12,,26,POINT (10406342 -75527794)
2018,Junio,Japón,36,35,,71,POINT (10446304 -75516486)
2018,Junio,Japón,2,11,,13,POINT (10886686 -74776479)
2018,Junio,Japón,1,0,,1,POINT (125862 -81702165)
2018,Junio,Japón,9,11,,20,POINT (3451668 -76532004)
2018,Junio,Japón,158,469,,627,POINT (4697157 -74140516)
2018,Junio,Japón,10,33,,43,POINT (6170465 -7542726)
2018,Junio,Jordania,1,0,,1,POINT (0.81488 -77356)
2018,Junio,Jordania,0,1,,1,POINT (10446304 -75516486)
2018,Junio,Jordania,1,5,,6,POINT (4697157 -74140516)
2018,Junio,Jordania,0,1,,1,POINT (6170465 -7542726)
2018,Junio,Kazajistán,1,2,,3,POINT (4697157 -74140516)
2018,Junio,Kenia,0,2,,2,POINT (10446304 -75516486)
2018,Junio,Kenia,8,7,,15,POINT (4697157 -74140516)
2018,Junio,Kirguistán,0,1,,1,POINT (4697157 -74140516)
2018,Junio,Kirguistán,0,2,,2,POINT (6170465 -7542726)
2018,Junio,Kuwait,0,1,,1,POINT (10446304 -75516486)
2018,Junio,Kuwait,4,4,,8,POINT (4697157 -74140516)
2018,Junio,República de Kosovo,0,1,,1,POINT (10446304 -75516486)
2018,Junio,República de Kosovo,0,1,,1,POINT (4697157 -74140516)
2018,Junio,Lesoto,0,1,,1,POINT (4697157 -74140516)
2018,Junio,Letonia,0,1,,1,POINT (0.81488 -77356)
2018,Junio,Letonia,0,1,,1,POINT (10406342 -75527794)
2018,Junio,Letonia,0,1,,1,POINT (10886686 -74776479)
2018,Junio,Letonia,0,3,,3,POINT (10970933 -74765343)
2018,Junio,Letonia,1,0,,1,POINT (3451668 -76532004)
2018,Junio,Letonia,6,13,,19,POINT (4697157 -74140516)
2018,Junio,Letonia,1,0,,1,POINT (6170465 -7542726)
2018,Junio,Lituania,1,0,,1,POINT (0.81488 -77356)
2018,Junio,Lituania,1,0,,1,POINT (10406342 -75527794)
2018,Junio,Lituania,3,0,,3,POINT (10446304 -75516486)
2018,Junio,Lituania,1,0,,1,POINT (10886686 -74776479)
2018,Junio,Lituania,6,3,,9,POINT (3451668 -76532004)
2018,Junio,Lituania,21,22,,43,POINT (4697157 -74140516)
2018,Junio,Lituania,6,3,,9,POINT (6170465 -7542726)
2018,Junio,Líbano,1,1,,2,POINT (10886686 -74776479)
2018,Junio,Líbano,5,3,,8,POINT (11360029 -72129595)
2018,Junio,Líbano,0,1,,1,POINT (3451668 -76532004)
2018,Junio,Líbano,14,25,,39,POINT (4697157 -74140516)
2018,Junio,Líbano,0,1,,1,POINT (6170465 -7542726)
2018,Junio,Líbano,0,1,,1,POINT (7128047 -73181317)
2018,Junio,Liechtenstein,0,1,,1,POINT (6170465 -7542726)
2018,Junio,Luxemburgo,1,0,,1,POINT (10446304 -75516486)
2018,Junio,Luxemburgo,1,0,,1,POINT (10886686 -74776479)
2018,Junio,Luxemburgo,16,14,,30,POINT (4697157 -74140516)
2018,Junio,Macedonia,1,1,,2,POINT (10446304 -75516486)
2018,Junio,Macedonia,0,1,,1,POINT (3451668 -76532004)
2018,Junio,Macedonia,0,2,,2,POINT (4697157 -74140516)
2018,Junio,Madagascar,0,1,,1,POINT (4697157 -74140516)
2018,Junio,Malasia,1,0,,1,POINT (0.81488 -77356)
2018,Junio,Malasia,1,2,,3,POINT (10446304 -75516486)
2018,Junio,Malasia,0,4,,4,POINT (3451668 -76532004)
2018,Junio,Malasia,27,17,,44,POINT (4697157 -74140516)
2018,Junio,Malasia,2,3,,5,POINT (6170465 -7542726)
2018,Junio,Malasia,0,1,,1,POINT (9402597 -75681642)
2018,Junio,Malawi,0,3,,3,POINT (4697157 -74140516)
2018,Junio,Maldivas,1,0,,1,POINT (4697157 -74140516)
2018,Junio,Malta,0,1,,1,POINT (-4191162 -69941498)
2018,Junio,Malta,0,1,,1,POINT (10446304 -75516486)
2018,Junio,Malta,2,7,,9,POINT (4697157 -74140516)
2018,Junio,Marruecos,3,2,,5,POINT (0.81488 -77356)
2018,Junio,Marruecos,0,1,,1,POINT (10446304 -75516486)
2018,Junio,Marruecos,0,1,,1,POINT (10886686 -74776479)
2018,Junio,Marruecos,0,1,,1,POINT (3451668 -76532004)
2018,Junio,Marruecos,10,12,,22,POINT (4697157 -74140516)
2018,Junio,Marruecos,0,1,,1,POINT (6170465 -7542726)
2018,Junio,Islas Marshall,1,0,,1,POINT (4697157 -74140516)
2018,Junio,Mauricio,5,2,,7,POINT (4697157 -74140516)
2018,Junio,Mauricio,0,1,,1,POINT (6170465 -7542726)
2018,Junio,Mauritania,0,1,,1,POINT (4697157 -74140516)
2018,Junio,México,1,2,,3,POINT (-4191162 -69941498)
2018,Junio,México,3,4,,7,POINT (-4214082 -69941431)
2018,Junio,México,0,2,,2,POINT (0.33002 -76876446)
2018,Junio,México,1,1,,2,POINT (0.812436 -77847006)
2018,Junio,México,48,35,,83,POINT (0.81488 -77356)
2018,Junio,México,17,18,,35,POINT (10406342 -75527794)
2018,Junio,México,234,350,,584,POINT (10446304 -75516486)
2018,Junio,México,62,105,,167,POINT (10886686 -74776479)
2018,Junio,México,4,4,,8,POINT (11360029 -72129595)
2018,Junio,México,0,1,,1,POINT (125744111 -81703935)
2018,Junio,México,99,192,,291,POINT (3451668 -76532004)
2018,Junio,México,2,3,,5,POINT (445285 -75766353)
2018,Junio,México,4449,6620,,11069,POINT (4697157 -74140516)
2018,Junio,México,13,30,,43,POINT (4815189 -75736374)
2018,Junio,México,588,1282,,1870,POINT (6170465 -7542726)
2018,Junio,México,4,9,,13,POINT (7128047 -73181317)
2018,Junio,México,16,28,,44,POINT (7819 -72453013)
2018,Junio,México,2,3,,5,POINT (836068 -72409396)
2018,Junio,México,1,1,,2,POINT (863337 -7735002)
2018,Junio,República de Moldavia,0,1,,1,POINT (3451668 -76532004)
2018,Junio,República de Moldavia,2,1,,3,POINT (4697157 -74140516)
2018,Junio,Mónaco,1,0,,1,POINT (4697157 -74140516)
2018,Junio,Mongolia,2,0,,2,POINT (4697157 -74140516)
2018,Junio,Montenegro,0,1,,1,POINT (11247723 -74213989)
2018,Junio,Montenegro,1,2,,3,POINT (4697157 -74140516)
2018,Junio,Mozambique,1,2,,3,POINT (4697157 -74140516)
2018,Junio,Myanmar,0,1,,1,POINT (10886686 -74776479)
2018,Junio,Myanmar,0,1,,1,POINT (10970933 -74765343)
2018,Junio,Myanmar,0,2,,2,POINT (4697157 -74140516)
2018,Junio,Nepal,0,1,,1,POINT (10446304 -75516486)
2018,Junio,Nepal,5,4,,9,POINT (4697157 -74140516)
2018,Junio,Nicaragua,1,1,,2,POINT (10406342 -75527794)
2018,Junio,Nicaragua,28,19,,47,POINT (10446304 -75516486)
2018,Junio,Nicaragua,4,1,,5,POINT (10886686 -74776479)
2018,Junio,Nicaragua,3,1,,4,POINT (125862 -81702165)
2018,Junio,Nicaragua,4,7,,11,POINT (3451668 -76532004)
2018,Junio,Nicaragua,84,90,,174,POINT (4697157 -74140516)
2018,Junio,Nicaragua,4,1,,5,POINT (4815189 -75736374)
2018,Junio,Nicaragua,14,14,,28,POINT (6170465 -7542726)
2018,Junio,Nicaragua,0,5,,5,POINT (7128047 -73181317)
2018,Junio,Nigeria,0,1,,1,POINT (0.81488 -77356)
2018,Junio,Nigeria,2,1,,3,POINT (10446304 -75516486)
2018,Junio,Nigeria,2,8,,10,POINT (4697157 -74140516)
2018,Junio,Nigeria,2,3,,5,POINT (6170465 -7542726)
2018,Junio,Níger,1,0,,1,POINT (4697157 -74140516)
2018,Junio,Noruega,1,0,,1,POINT (-4214082 -69941431)
2018,Junio,Noruega,2,3,,5,POINT (0.81488 -77356)
2018,Junio,Noruega,1,1,,2,POINT (10406342 -75527794)
2018,Junio,Noruega,22,17,,39,POINT (10446304 -75516486)
2018,Junio,Noruega,0,3,,3,POINT (10886686 -74776479)
2018,Junio,Noruega,11,7,,18,POINT (3451668 -76532004)
2018,Junio,Noruega,180,210,,390,POINT (4697157 -74140516)
2018,Junio,Noruega,1,1,,2,POINT (4815189 -75736374)
2018,Junio,Noruega,13,22,,35,POINT (6170465 -7542726)
2018,Junio,Noruega,0,1,,1,POINT (7128047 -73181317)
2018,Junio,Noruega,0,1,,1,POINT (7819 -72453013)
2018,Junio,Noruega,2,0,,2,POINT (863337 -7735002)
2018,Junio,Nueva Zelanda,1,1,,2,POINT (0.33002 -76876446)
2018,Junio,Nueva Zelanda,9,10,,19,POINT (0.81488 -77356)
2018,Junio,Nueva Zelanda,4,11,,15,POINT (10406342 -75527794)
2018,Junio,Nueva Zelanda,12,13,,25,POINT (10446304 -75516486)
2018,Junio,Nueva Zelanda,1,0,,1,POINT (10886686 -74776479)
2018,Junio,Nueva Zelanda,1,0,,1,POINT (3451668 -76532004)
2018,Junio,Nueva Zelanda,90,130,,220,POINT (4697157 -74140516)
2018,Junio,Nueva Zelanda,10,21,,31,POINT (6170465 -7542726)
2018,Junio,Nueva Zelanda,0,1,,1,POINT (863337 -7735002)
2018,Junio,Omán,0,1,,1,POINT (10886686 -74776479)
2018,Junio,Países Bajos,7,6,,13,POINT (-4191162 -69941498)
2018,Junio,Países Bajos,5,5,,10,POINT (-4214082 -69941431)
2018,Junio,Países Bajos,30,29,,59,POINT (0.81488 -77356)
2018,Junio,Países Bajos,32,43,,75,POINT (10406342 -75527794)
2018,Junio,Países Bajos,250,247,,497,POINT (10446304 -75516486)
2018,Junio,Países Bajos,9,17,,26,POINT (10886686 -74776479)
2018,Junio,Países Bajos,2,3,,5,POINT (11247723 -74213989)
2018,Junio,Países Bajos,1,2,,3,POINT (125862 -81702165)
2018,Junio,Países Bajos,35,58,,93,POINT (3451668 -76532004)
2018,Junio,Países Bajos,0,1,,1,POINT (445285 -75766353)
2018,Junio,Países Bajos,1254,1750,,3004,POINT (4697157 -74140516)
2018,Junio,Países Bajos,1,2,,3,POINT (4815189 -75736374)
2018,Junio,Países Bajos,71,130,,201,POINT (6170465 -7542726)
2018,Junio,Países Bajos,7,4,,11,POINT (7128047 -73181317)
2018,Junio,Países Bajos,0,4,,4,POINT (7819 -72453013)
2018,Junio,Países Bajos,0,1,,1,POINT (836068 -72409396)
2018,Junio,Pakistán,0,2,,2,POINT (10446304 -75516486)
2018,Junio,Pakistán,0,1,,1,POINT (10970933 -74765343)
2018,Junio,Pakistán,1,17,,18,POINT (4697157 -74140516)
2018,Junio,Pakistán,1,2,,3,POINT (6170465 -7542726)
2018,Junio,Panamá,5,8,,13,POINT (0.81488 -77356)
2018,Junio,Panamá,0,7,,7,POINT (10406342 -75527794)
2018,Junio,Panamá,510,563,,1073,POINT (10446304 -75516486)
2018,Junio,Panamá,48,67,,115,POINT (10886686 -74776479)
2018,Junio,Panamá,0,1,,1,POINT (11247723 -74213989)
2018,Junio,Panamá,1,0,,1,POINT (12165168 -71983761)
2018,Junio,Panamá,1,0,,1,POINT (125744111 -81703935)
2018,Junio,Panamá,38,54,,92,POINT (125862 -81702165)
2018,Junio,Panamá,205,178,,383,POINT (3451668 -76532004)
2018,Junio,Panamá,13,22,,35,POINT (445285 -75766353)
2018,Junio,Panamá,1351,1508,,2859,POINT (4697157 -74140516)
2018,Junio,Panamá,39,55,,94,POINT (4815189 -75736374)
2018,Junio,Panamá,1206,1029,,2235,POINT (6170465 -7542726)
2018,Junio,Panamá,0,2,,2,POINT (6222552 -77401154)
2018,Junio,Panamá,0,1,,1,POINT (7088729 -70740253)
2018,Junio,Panamá,1,3,,4,POINT (7102626 -77762647)
2018,Junio,Panamá,14,9,,23,POINT (7128047 -73181317)
2018,Junio,Panamá,1,0,,1,POINT (7819 -72453013)
2018,Junio,Panamá,0,2,,2,POINT (7927233 -72508188)
2018,Junio,Panamá,0,1,,1,POINT (836068 -72409396)
2018,Junio,Panamá,1,7,,8,POINT (863337 -7735002)
2018,Junio,Paraguay,1,0,,1,POINT (-4191162 -69941498)
2018,Junio,Paraguay,0,3,,3,POINT (0.81488 -77356)
2018,Junio,Paraguay,12,3,,15,POINT (10406342 -75527794)
2018,Junio,Paraguay,63,45,,108,POINT (10446304 -75516486)
2018,Junio,Paraguay,3,11,,14,POINT (10886686 -74776479)
2018,Junio,Paraguay,82,50,,132,POINT (125862 -81702165)
2018,Junio,Paraguay,22,8,,30,POINT (3451668 -76532004)
2018,Junio,Paraguay,219,210,,429,POINT (4697157 -74140516)
2018,Junio,Paraguay,2,1,,3,POINT (4815189 -75736374)
2018,Junio,Paraguay,13,31,,44,POINT (6170465 -7542726)
2018,Junio,Paraguay,1,0,,1,POINT (7088729 -70740253)
2018,Junio,Perú,11,16,,27,POINT (-4191162 -69941498)
2018,Junio,Perú,40,51,,91,POINT (-4214082 -69941431)
2018,Junio,Perú,1,1,,2,POINT (0.185957 -7478366)
2018,Junio,Perú,5,10,,15,POINT (0.33002 -76876446)
2018,Junio,Perú,0,2,,2,POINT (0.812436 -77847006)
2018,Junio,Perú,91,254,,345,POINT (0.81488 -77356)
2018,Junio,Perú,0,2,,2,POINT (1800143 -78802679)
2018,Junio,Perú,20,19,,39,POINT (10406342 -75527794)
2018,Junio,Perú,733,475,,1208,POINT (10446304 -75516486)
2018,Junio,Perú,2,15,,17,POINT (10886686 -74776479)
2018,Junio,Perú,0,19,,19,POINT (11360029 -72129595)
2018,Junio,Perú,0,3,,3,POINT (125744111 -81703935)
2018,Junio,Perú,232,154,,386,POINT (125862 -81702165)
2018,Junio,Perú,141,232,,373,POINT (3451668 -76532004)
2018,Junio,Perú,1,0,,1,POINT (445285 -75766353)
2018,Junio,Perú,3424,4237,,7661,POINT (4697157 -74140516)
2018,Junio,Perú,6,8,,14,POINT (4815189 -75736374)
2018,Junio,Perú,351,513,,864,POINT (6170465 -7542726)
2018,Junio,Perú,0,3,,3,POINT (6185536 -67484028)
2018,Junio,Perú,1,0,,1,POINT (7088729 -70740253)
2018,Junio,Perú,1,2,,3,POINT (7128047 -73181317)
2018,Junio,Perú,78,159,,237,POINT (7819 -72453013)
2018,Junio,Perú,8,3,,11,POINT (836068 -72409396)
2018,Junio,Palestina,2,0,,2,POINT (10886686 -74776479)
2018,Junio,Palestina,1,3,,4,POINT (4697157 -74140516)
2018,Junio,Polonia,1,1,,2,POINT (-4214082 -69941431)
2018,Junio,Polonia,12,9,,21,POINT (0.81488 -77356)
2018,Junio,Polonia,0,9,,9,POINT (10406342 -75527794)
2018,Junio,Polonia,8,14,,22,POINT (10446304 -75516486)
2018,Junio,Polonia,1,2,,3,POINT (10886686 -74776479)
2018,Junio,Polonia,0,1,,1,POINT (10970933 -74765343)
2018,Junio,Polonia,12,3,,15,POINT (3451668 -76532004)
2018,Junio,Polonia,0,1,,1,POINT (3884426 -77061029)
2018,Junio,Polonia,106,152,,258,POINT (4697157 -74140516)
2018,Junio,Polonia,7,21,,28,POINT (6170465 -7542726)
2018,Junio,Polonia,1,0,,1,POINT (7128047 -73181317)
2018,Junio,Polonia,0,3,,3,POINT (7819 -72453013)
2018,Junio,Portugal,1,1,,2,POINT (-4191162 -69941498)
2018,Junio,Portugal,3,1,,4,POINT (0.81488 -77356)
2018,Junio,Portugal,1,0,,1,POINT (10406342 -75527794)
2018,Junio,Portugal,8,16,,24,POINT (10446304 -75516486)
2018,Junio,Portugal,4,8,,12,POINT (10886686 -74776479)
2018,Junio,Portugal,2,4,,6,POINT (11360029 -72129595)
2018,Junio,Portugal,1,1,,2,POINT (125862 -81702165)
2018,Junio,Portugal,5,16,,21,POINT (3451668 -76532004)
2018,Junio,Portugal,165,411,,576,POINT (4697157 -74140516)
2018,Junio,Portugal,15,32,,47,POINT (6170465 -7542726)
2018,Junio,Portugal,8,12,,20,POINT (7819 -72453013)
2018,Junio,Portugal,0,2,,2,POINT (836068 -72409396)
2018,Junio,Qatar,0,1,,1,POINT (4697157 -74140516)
2018,Junio,Qatar,0,1,,1,POINT (6170465 -7542726)
2018,Junio,Reino Unido de Gran Bretaña e Irlanda del Norte,0,8,,8,POINT (-4191162 -69941498)
2018,Junio,Reino Unido de Gran Bretaña e Irlanda del Norte,3,11,,14,POINT (-4214082 -69941431)
2018,Junio,Reino Unido de Gran Bretaña e Irlanda del Norte,1,1,,2,POINT (0.33002 -76876446)
2018,Junio,Reino Unido de Gran Bretaña e Irlanda del Norte,79,116,,195,POINT (0.81488 -77356)
2018,Junio,Reino Unido de Gran Bretaña e Irlanda del Norte,16,24,,40,POINT (10406342 -75527794)
2018,Junio,Reino Unido de Gran Bretaña e Irlanda del Norte,113,167,,280,POINT (10446304 -75516486)
2018,Junio,Reino Unido de Gran Bretaña e Irlanda del Norte,7,19,,26,POINT (10886686 -74776479)
2018,Junio,Reino Unido de Gran Bretaña e Irlanda del Norte,2,5,,7,POINT (11247723 -74213989)
2018,Junio,Reino Unido de Gran Bretaña e Irlanda del Norte,2,0,,2,POINT (11360029 -72129595)
2018,Junio,Reino Unido de Gran Bretaña e Irlanda del Norte,0,1,,1,POINT (125862 -81702165)
2018,Junio,Reino Unido de Gran Bretaña e Irlanda del Norte,31,48,,79,POINT (3451668 -76532004)
2018,Junio,Reino Unido de Gran Bretaña e Irlanda del Norte,1154,2047,,3201,POINT (4697157 -74140516)
2018,Junio,Reino Unido de Gran Bretaña e Irlanda del Norte,0,4,,4,POINT (4815189 -75736374)
2018,Junio,Reino Unido de Gran Bretaña e Irlanda del Norte,123,225,,348,POINT (6170465 -7542726)
2018,Junio,Reino Unido de Gran Bretaña e Irlanda del Norte,0,2,,2,POINT (7819 -72453013)
2018,Junio,Reino Unido de Gran Bretaña e Irlanda del Norte,37,26,,63,POINT (863337 -7735002)
2018,Junio,República Dominicana,0,1,,1,POINT (-4214082 -69941431)
2018,Junio,República Dominicana,3,13,,16,POINT (0.81488 -77356)
2018,Junio,República Dominicana,0,1,,1,POINT (1800143 -78802679)
2018,Junio,República Dominicana,0,2,,2,POINT (10406342 -75527794)
2018,Junio,República Dominicana,64,92,,156,POINT (10446304 -75516486)
2018,Junio,República Dominicana,17,36,,53,POINT (10886686 -74776479)
2018,Junio,República Dominicana,1,9,,10,POINT (11360029 -72129595)
2018,Junio,República Dominicana,0,1,,1,POINT (12165168 -71983761)
2018,Junio,República Dominicana,2,2,,4,POINT (125862 -81702165)
2018,Junio,República Dominicana,22,20,,42,POINT (3451668 -76532004)
2018,Junio,República Dominicana,2,0,,2,POINT (445285 -75766353)
2018,Junio,República Dominicana,576,773,,1349,POINT (4697157 -74140516)
2018,Junio,República Dominicana,3,2,,5,POINT (4815189 -75736374)
2018,Junio,República Dominicana,61,63,,124,POINT (6170465 -7542726)
2018,Junio,República Dominicana,3,3,,6,POINT (7128047 -73181317)
2018,Junio,República Dominicana,3,2,,5,POINT (7819 -72453013)
2018,Junio,República Dominicana,0,1,,1,POINT (836068 -72409396)
2018,Junio,Rumania,3,3,,6,POINT (0.81488 -77356)
2018,Junio,Rumania,0,7,,7,POINT (10406342 -75527794)
2018,Junio,Rumania,6,13,,19,POINT (10446304 -75516486)
2018,Junio,Rumania,0,2,,2,POINT (10886686 -74776479)
2018,Junio,Rumania,0,1,,1,POINT (11247723 -74213989)
2018,Junio,Rumania,9,3,,12,POINT (3451668 -76532004)
2018,Junio,Rumania,0,3,,3,POINT (3884426 -77061029)
2018,Junio,Rumania,98,53,,151,POINT (4697157 -74140516)
2018,Junio,Rumania,9,9,,18,POINT (6170465 -7542726)
2018,Junio,Rumania,0,1,,1,POINT (7819 -72453013)
2018,Junio,Federación de Rusia,0,1,,1,POINT (-4214082 -69941431)
2018,Junio,Federación de Rusia,3,5,,8,POINT (0.81488 -77356)
2018,Junio,Federación de Rusia,0,5,,5,POINT (10406342 -75527794)
2018,Junio,Federación de Rusia,16,14,,30,POINT (10446304 -75516486)
2018,Junio,Federación de Rusia,0,1,,1,POINT (10886686 -74776479)
2018,Junio,Federación de Rusia,0,2,,2,POINT (10970933 -74765343)
2018,Junio,Federación de Rusia,0,1,,1,POINT (11360029 -72129595)
2018,Junio,Federación de Rusia,1,0,,1,POINT (125862 -81702165)
2018,Junio,Federación de Rusia,4,3,,7,POINT (3451668 -76532004)
2018,Junio,Federación de Rusia,116,117,,233,POINT (4697157 -74140516)
2018,Junio,Federación de Rusia,1,0,,1,POINT (4815189 -75736374)
2018,Junio,Federación de Rusia,20,16,,36,POINT (6170465 -7542726)
2018,Junio,Federación de Rusia,1,0,,1,POINT (7128047 -73181317)
2018,Junio,Federación de Rusia,2,0,,2,POINT (7819 -72453013)
2018,Junio,Rwanda,0,1,,1,POINT (4697157 -74140516)
2018,Junio,San Cristóbal y Nevis,1,1,,2,POINT (10446304 -75516486)
2018,Junio,San Cristóbal y Nevis,1,2,,3,POINT (4697157 -74140516)
2018,Junio,San Cristóbal y Nevis,0,4,,4,POINT (6170465 -7542726)
2018,Junio,San  Vicente y las Granadinas,0,3,,3,POINT (10446304 -75516486)
2018,Junio,San  Vicente y las Granadinas,0,1,,1,POINT (10886686 -74776479)
2018,Junio,San  Vicente y las Granadinas,0,1,,1,POINT (125862 -81702165)
2018,Junio,San  Vicente y las Granadinas,0,2,,2,POINT (4697157 -74140516)
2018,Junio,San  Vicente y las Granadinas,0,2,,2,POINT (6170465 -7542726)
2018,Junio,Santa Lucia,2,0,,2,POINT (10406342 -75527794)
2018,Junio,Santa Lucia,1,0,,1,POINT (10446304 -75516486)
2018,Junio,Santa Lucia,1,0,,1,POINT (10886686 -74776479)
2018,Junio,Santa Lucia,2,4,,6,POINT (4697157 -74140516)
2018,Junio,Santa Lucia,1,0,,1,POINT (6170465 -7542726)
2018,Junio,Santa Sede/Ciudad del Vaticano,0,1,,1,POINT (4697157 -74140516)
2018,Junio,Senegal,0,1,,1,POINT (11360029 -72129595)
2018,Junio,Serbia,0,1,,1,POINT (0.33002 -76876446)
2018,Junio,Serbia,2,5,,7,POINT (10446304 -75516486)
2018,Junio,Serbia,6,16,,22,POINT (4697157 -74140516)
2018,Junio,Serbia,4,2,,6,POINT (6170465 -7542726)
2018,Junio,Sierra Leona,0,1,,1,POINT (4697157 -74140516)
2018,Junio,Sierra Leona,0,1,,1,POINT (6170465 -7542726)
2018,Junio,Singapur,0,2,,2,POINT (0.81488 -77356)
2018,Junio,Singapur,3,4,,7,POINT (10446304 -75516486)
2018,Junio,Singapur,0,1,,1,POINT (3451668 -76532004)
2018,Junio,Singapur,28,42,,70,POINT (4697157 -74140516)
2018,Junio,Singapur,6,4,,10,POINT (6170465 -7542726)
2018,Junio,Singapur,0,1,,1,POINT (9402597 -75681642)
2018,Junio,República Árabe Siria,0,1,,1,POINT (10446304 -75516486)
2018,Junio,República Árabe Siria,1,3,,4,POINT (4697157 -74140516)
2018,Junio,Somalia,0,1,,1,POINT (4697157 -74140516)
2018,Junio,Sri Lanka,0,1,,1,POINT (10406342 -75527794)
2018,Junio,Sri Lanka,0,1,,1,POINT (10886686 -74776479)
2018,Junio,Sri Lanka,0,1,,1,POINT (3884426 -77061029)
2018,Junio,Sri Lanka,1,2,,3,POINT (4697157 -74140516)
2018,Junio,Sudáfrica,1,3,,4,POINT (10406342 -75527794)
2018,Junio,Sudáfrica,3,2,,5,POINT (10446304 -75516486)
2018,Junio,Sudáfrica,0,1,,1,POINT (10886686 -74776479)
2018,Junio,Sudáfrica,1,1,,2,POINT (11247723 -74213989)
2018,Junio,Sudáfrica,27,49,,76,POINT (4697157 -74140516)
2018,Junio,Sudáfrica,1,2,,3,POINT (6170465 -7542726)
2018,Junio,Sudán,2,3,,5,POINT (4697157 -74140516)
2018,Junio,Suecia,0,1,,1,POINT (-4191162 -69941498)
2018,Junio,Suecia,2,1,,3,POINT (-4214082 -69941431)
2018,Junio,Suecia,6,6,,12,POINT (0.81488 -77356)
2018,Junio,Suecia,4,4,,8,POINT (10406342 -75527794)
2018,Junio,Suecia,22,32,,54,POINT (10446304 -75516486)
2018,Junio,Suecia,5,6,,11,POINT (10886686 -74776479)
2018,Junio,Suecia,0,1,,1,POINT (11247723 -74213989)
2018,Junio,Suecia,0,1,,1,POINT (125744111 -81703935)
2018,Junio,Suecia,23,27,,50,POINT (3451668 -76532004)
2018,Junio,Suecia,211,309,,520,POINT (4697157 -74140516)
2018,Junio,Suecia,1,1,,2,POINT (4815189 -75736374)
2018,Junio,Suecia,14,42,,56,POINT (6170465 -7542726)
2018,Junio,Suecia,0,1,,1,POINT (836068 -72409396)
2018,Junio,Suecia,4,1,,5,POINT (863337 -7735002)
2018,Junio,Suiza,2,4,,6,POINT (-4191162 -69941498)
2018,Junio,Suiza,5,6,,11,POINT (-4214082 -69941431)
2018,Junio,Suiza,1,0,,1,POINT (0.33002 -76876446)
2018,Junio,Suiza,1,1,,2,POINT (0.812436 -77847006)
2018,Junio,Suiza,28,25,,53,POINT (0.81488 -77356)
2018,Junio,Suiza,16,15,,31,POINT (10406342 -75527794)
2018,Junio,Suiza,46,61,,107,POINT (10446304 -75516486)
2018,Junio,Suiza,5,4,,9,POINT (10886686 -74776479)
2018,Junio,Suiza,0,1,,1,POINT (11247723 -74213989)
2018,Junio,Suiza,2,4,,6,POINT (125862 -81702165)
2018,Junio,Suiza,2,0,,2,POINT (133387613 -81372937)
2018,Junio,Suiza,24,46,,70,POINT (3451668 -76532004)
2018,Junio,Suiza,373,593,,966,POINT (4697157 -74140516)
2018,Junio,Suiza,1,1,,2,POINT (4815189 -75736374)
2018,Junio,Suiza,34,70,,104,POINT (6170465 -7542726)
2018,Junio,Suiza,1,0,,1,POINT (7819 -72453013)
2018,Junio,Suiza,8,3,,11,POINT (863337 -7735002)
2018,Junio,Surinam,0,1,,1,POINT (-4191162 -69941498)
2018,Junio,Surinam,1,1,,2,POINT (10446304 -75516486)
2018,Junio,Surinam,3,32,,35,POINT (4697157 -74140516)
2018,Junio,Surinam,1,1,,2,POINT (6170465 -7542726)
2018,Junio,Surinam,1,1,,2,POINT (7128047 -73181317)
2018,Junio,Taiwán,1,0,,1,POINT (4697157 -74140516)
2018,Junio,República de Tayikistán,1,0,,1,POINT (4697157 -74140516)
2018,Junio,Tailandia,0,1,,1,POINT (0.81488 -77356)
2018,Junio,Tailandia,1,0,,1,POINT (10446304 -75516486)
2018,Junio,Tailandia,16,14,,30,POINT (4697157 -74140516)
2018,Junio,Tanzania,2,0,,2,POINT (4697157 -74140516)
2018,Junio,Tanzania,1,0,,1,POINT (6170465 -7542726)
2018,Junio,Togo,0,2,,2,POINT (4697157 -74140516)
2018,Junio,Trinidad y Tobago,0,1,,1,POINT (-4191162 -69941498)
2018,Junio,Trinidad y Tobago,11,5,,16,POINT (10446304 -75516486)
2018,Junio,Trinidad y Tobago,1,3,,4,POINT (10886686 -74776479)
2018,Junio,Trinidad y Tobago,1,0,,1,POINT (125862 -81702165)
2018,Junio,Trinidad y Tobago,0,1,,1,POINT (3451668 -76532004)
2018,Junio,Trinidad y Tobago,27,38,,65,POINT (4697157 -74140516)
2018,Junio,Trinidad y Tobago,8,15,,23,POINT (6170465 -7542726)
2018,Junio,Trinidad y Tobago,4,2,,6,POINT (7128047 -73181317)
2018,Junio,Trinidad y Tobago,0,2,,2,POINT (7819 -72453013)
2018,Junio,Túnez,0,1,,1,POINT (10446304 -75516486)
2018,Junio,Túnez,3,2,,5,POINT (4697157 -74140516)
2018,Junio,Turquía,2,0,,2,POINT (-4214082 -69941431)
2018,Junio,Turquía,0,1,,1,POINT (0.33002 -76876446)
2018,Junio,Turquía,2,3,,5,POINT (0.81488 -77356)
2018,Junio,Turquía,1,4,,5,POINT (10406342 -75527794)
2018,Junio,Turquía,3,7,,10,POINT (10446304 -75516486)
2018,Junio,Turquía,0,3,,3,POINT (10886686 -74776479)
2018,Junio,Turquía,2,3,,5,POINT (3451668 -76532004)
2018,Junio,Turquía,179,319,,498,POINT (4697157 -74140516)
2018,Junio,Turquía,6,16,,22,POINT (6170465 -7542726)
2018,Junio,Turquía,0,1,,1,POINT (7128047 -73181317)
2018,Junio,Turquía,0,1,,1,POINT (7819 -72453013)
2018,Junio,Turkmenistán,1,0,,1,POINT (4697157 -74140516)
2018,Junio,Ucrania,1,0,,1,POINT (-4191162 -69941498)
2018,Junio,Ucrania,0,7,,7,POINT (10406342 -75527794)
2018,Junio,Ucrania,2,9,,11,POINT (10446304 -75516486)
2018,Junio,Ucrania,0,1,,1,POINT (10886686 -74776479)
2018,Junio,Ucrania,0,1,,1,POINT (10970933 -74765343)
2018,Junio,Ucrania,7,1,,8,POINT (3451668 -76532004)
2018,Junio,Ucrania,0,3,,3,POINT (3884426 -77061029)
2018,Junio,Ucrania,0,1,,1,POINT (445285 -75766353)
2018,Junio,Ucrania,28,20,,48,POINT (4697157 -74140516)
2018,Junio,Ucrania,4,4,,8,POINT (6170465 -7542726)
2018,Junio,Uganda,0,1,,1,POINT (0.81488 -77356)
2018,Junio,Uganda,0,1,,1,POINT (1800143 -78802679)
2018,Junio,Uganda,1,0,,1,POINT (10446304 -75516486)
2018,Junio,Uganda,2,3,,5,POINT (4697157 -74140516)
2018,Junio,Uruguay,1,0,,1,POINT (-4191162 -69941498)
2018,Junio,Uruguay,0,1,,1,POINT (0.33002 -76876446)
2018,Junio,Uruguay,9,12,,21,POINT (0.81488 -77356)
2018,Junio,Uruguay,29,16,,45,POINT (10406342 -75527794)
2018,Junio,Uruguay,87,88,,175,POINT (10446304 -75516486)
2018,Junio,Uruguay,1,3,,4,POINT (10886686 -74776479)
2018,Junio,Uruguay,12,7,,19,POINT (125862 -81702165)
2018,Junio,Uruguay,4,18,,22,POINT (3451668 -76532004)
2018,Junio,Uruguay,565,641,,1206,POINT (4697157 -74140516)
2018,Junio,Uruguay,33,54,,87,POINT (6170465 -7542726)
2018,Junio,Uruguay,1,2,,3,POINT (7819 -72453013)
2018,Junio,Uzbekistán,1,1,,2,POINT (4697157 -74140516)
2018,Junio,Venezuela,3,6,,9,POINT (-4191162 -69941498)
2018,Junio,Venezuela,2,6,,8,POINT (-4214082 -69941431)
2018,Junio,Venezuela,45,53,,98,POINT (0.33002 -76876446)
2018,Junio,Venezuela,1,0,,1,POINT (0.812436 -77847006)
2018,Junio,Venezuela,1966,2434,,4400,POINT (0.81488 -77356)
2018,Junio,Venezuela,2,3,,5,POINT (1800143 -78802679)
2018,Junio,Venezuela,11,61,,72,POINT (10406342 -75527794)
2018,Junio,Venezuela,168,275,,443,POINT (10446304 -75516486)
2018,Junio,Venezuela,98,183,,281,POINT (10886686 -74776479)
2018,Junio,Venezuela,0,3,,3,POINT (10970933 -74765343)
2018,Junio,Venezuela,3,1,,4,POINT (11117206 -74232675)
2018,Junio,Venezuela,1,0,,1,POINT (11247723 -74213989)
2018,Junio,Venezuela,6375,7289,,13664,POINT (11360029 -72129595)
2018,Junio,Venezuela,1,2,,3,POINT (12165168 -71983761)
2018,Junio,Venezuela,0,1,,1,POINT (125744111 -81703935)
2018,Junio,Venezuela,2,5,,7,POINT (125862 -81702165)
2018,Junio,Venezuela,90,123,,213,POINT (3451668 -76532004)
2018,Junio,Venezuela,7,19,,26,POINT (3866713 -67927521)
2018,Junio,Venezuela,5151,5393,,10544,POINT (4697157 -74140516)
2018,Junio,Venezuela,8,7,,15,POINT (4815189 -75736374)
2018,Junio,Venezuela,849,829,,1678,POINT (6170465 -7542726)
2018,Junio,Venezuela,54,60,,114,POINT (6185536 -67484028)
2018,Junio,Venezuela,740,911,,1651,POINT (7088729 -70740253)
2018,Junio,Venezuela,14,17,,31,POINT (7128047 -73181317)
2018,Junio,Venezuela,26710,29983,,56693,POINT (7819 -72453013)
2018,Junio,Venezuela,4,14,,18,POINT (7927233 -72508188)
2018,Junio,Venezuela,2270,2189,,4459,POINT (836068 -72409396)
2018,Junio,Venezuela,0,1,,1,POINT (863337 -7735002)
2018,Junio,Vietnam,1,1,,2,POINT (10446304 -75516486)
2018,Junio,Vietnam,2,3,,5,POINT (4697157 -74140516)
2018,Junio,Vietnam,2,0,,2,POINT (6170465 -7542726)
2018,Junio,Islas Vírgenes Británicas/Territorio Británico de Ultramar,1,0,,1,POINT (4697157 -74140516)
2018,Junio,Islas Vírgenes Británicas/Territorio Británico de Ultramar,0,1,,1,POINT (6170465 -7542726)
2018,Junio,República Árabe de Yemen,0,1,,1,POINT (10446304 -75516486)
2018,Junio,República Árabe de Yemen,0,3,,3,POINT (4697157 -74140516)
2018,Junio,Zambia,0,2,,2,POINT (4697157 -74140516)
2018,Junio,Zimbabue,0,1,,1,POINT (3451668 -76532004)
2018,Junio,Zimbabue,0,2,,2,POINT (4697157 -74140516)
2018,Junio,Refugiado Otro,0,1,,1,POINT (4697157 -74140516)
2018,Junio,Refugiado,1,6,,7,POINT (4697157 -74140516)
2018,Junio,Refugiado,0,1,,1,POINT (6170465 -7542726)
2018,Junio,Desconocido,10,21,,31,POINT (10446304 -75516486)
2018,Junio,Desconocido,0,2,,2,POINT (10886686 -74776479)
2018,Junio,Desconocido,0,1,,1,POINT (125862 -81702165)
2018,Junio,Desconocido,0,1,,1,POINT (3451668 -76532004)
2018,Junio,Desconocido,97,165,,262,POINT (4697157 -74140516)
2018,Junio,Desconocido,2,2,,4,POINT (6170465 -7542726)
2018,Junio,Desconocido,2,0,,2,POINT (7088729 -70740253)
2018,Junio,Desconocido,0,2,,2,POINT (7819 -72453013)
2018,Junio,República CentroÁfricana,0,1,,1,POINT (4697157 -74140516)
2018,Julio,Afganistán,0,2,,2,POINT (4697157 -74140516)
2018,Julio,Albania,0,1,,1,POINT (10446304 -75516486)
2018,Julio,Albania,1,5,,6,POINT (4697157 -74140516)
2018,Julio,Albania,1,0,,1,POINT (6170465 -7542726)
2018,Julio,Alemania,14,23,,37,POINT (-4191162 -69941498)
2018,Julio,Alemania,4,9,,13,POINT (-4214082 -69941431)
2018,Julio,Alemania,5,1,,6,POINT (0.33002 -76876446)
2018,Julio,Alemania,122,94,,216,POINT (0.81488 -77356)
2018,Julio,Alemania,36,42,,78,POINT (10406342 -75527794)
2018,Julio,Alemania,153,186,,339,POINT (10446304 -75516486)
2018,Julio,Alemania,35,32,,67,POINT (10886686 -74776479)
2018,Julio,Alemania,1,1,,2,POINT (10970933 -74765343)
2018,Julio,Alemania,5,3,,8,POINT (11247723 -74213989)
2018,Julio,Alemania,1,2,,3,POINT (11360029 -72129595)
2018,Julio,Alemania,4,3,,7,POINT (125862 -81702165)
2018,Julio,Alemania,73,90,,163,POINT (3451668 -76532004)
2018,Julio,Alemania,1,1,,2,POINT (3884426 -77061029)
2018,Julio,Alemania,3,0,,3,POINT (445285 -75766353)
2018,Julio,Alemania,2248,2667,,4915,POINT (4697157 -74140516)
2018,Julio,Alemania,3,4,,7,POINT (4815189 -75736374)
2018,Julio,Alemania,186,270,,456,POINT (6170465 -7542726)
2018,Julio,Alemania,0,1,,1,POINT (6185536 -67484028)
2018,Julio,Alemania,0,2,,2,POINT (7128047 -73181317)
2018,Julio,Alemania,4,10,,14,POINT (7819 -72453013)
2018,Julio,Alemania,33,15,,48,POINT (863337 -7735002)
2018,Julio,Andorra,1,6,,7,POINT (4697157 -74140516)
2018,Julio,Angola,0,1,,1,POINT (10446304 -75516486)
2018,Julio,Angola,0,1,,1,POINT (4697157 -74140516)
2018,Julio,Antigua y Barbuda,7,16,,23,POINT (10886686 -74776479)
2018,Julio,Antigua y Barbuda,2,5,,7,POINT (4697157 -74140516)
2018,Julio,Antigua y Barbuda,2,0,,2,POINT (4815189 -75736374)
2018,Julio,Antigua y Barbuda,1,0,,1,POINT (6170465 -7542726)
2018,Julio,Arabia Saudita,2,20,,22,POINT (4697157 -74140516)
2018,Julio,Arabia Saudita,1,1,,2,POINT (6170465 -7542726)
2018,Julio,Argelia,4,9,,13,POINT (4697157 -74140516)
2018,Julio,Argelia,1,0,,1,POINT (6170465 -7542726)
2018,Julio,Argentina,6,6,,12,POINT (-4191162 -69941498)
2018,Julio,Argentina,2,8,,10,POINT (-4214082 -69941431)
2018,Julio,Argentina,8,11,,19,POINT (0.33002 -76876446)
2018,Julio,Argentina,73,128,,201,POINT (0.81488 -77356)
2018,Julio,Argentina,346,238,,584,POINT (10406342 -75527794)
2018,Julio,Argentina,1489,1087,,2576,POINT (10446304 -75516486)
2018,Julio,Argentina,22,69,,91,POINT (10886686 -74776479)
2018,Julio,Argentina,0,2,,2,POINT (11247723 -74213989)
2018,Julio,Argentina,9,7,,16,POINT (11360029 -72129595)
2018,Julio,Argentina,290,235,,525,POINT (125862 -81702165)
2018,Julio,Argentina,32,67,,99,POINT (3451668 -76532004)
2018,Julio,Argentina,0,1,,1,POINT (445285 -75766353)
2018,Julio,Argentina,4804,5317,,10121,POINT (4697157 -74140516)
2018,Julio,Argentina,14,11,,25,POINT (4815189 -75736374)
2018,Julio,Argentina,235,364,,599,POINT (6170465 -7542726)
2018,Julio,Argentina,0,1,,1,POINT (7128047 -73181317)
2018,Julio,Argentina,9,16,,25,POINT (7819 -72453013)
2018,Julio,Argentina,1,4,,5,POINT (836068 -72409396)
2018,Julio,Argentina,1,2,,3,POINT (863337 -7735002)
2018,Julio,República de Armenia,1,2,,3,POINT (4697157 -74140516)
2018,Julio,Australia,0,7,,7,POINT (-4191162 -69941498)
2018,Julio,Australia,1,6,,7,POINT (-4214082 -69941431)
2018,Julio,Australia,2,3,,5,POINT (0.33002 -76876446)
2018,Julio,Australia,34,31,,65,POINT (0.81488 -77356)
2018,Julio,Australia,20,37,,57,POINT (10406342 -75527794)
2018,Julio,Australia,71,97,,168,POINT (10446304 -75516486)
2018,Julio,Australia,3,21,,24,POINT (10886686 -74776479)
2018,Julio,Australia,4,16,,20,POINT (3451668 -76532004)
2018,Julio,Australia,361,536,,897,POINT (4697157 -74140516)
2018,Julio,Australia,1,0,,1,POINT (4815189 -75736374)
2018,Julio,Australia,49,80,,129,POINT (6170465 -7542726)
2018,Julio,Australia,1,2,,3,POINT (7819 -72453013)
2018,Julio,Australia,19,17,,36,POINT (863337 -7735002)
2018,Julio,Austria,1,1,,2,POINT (-4191162 -69941498)
2018,Julio,Austria,1,0,,1,POINT (0.33002 -76876446)
2018,Julio,Austria,9,9,,18,POINT (0.81488 -77356)
2018,Julio,Austria,4,8,,12,POINT (10406342 -75527794)
2018,Julio,Austria,30,28,,58,POINT (10446304 -75516486)
2018,Julio,Austria,3,4,,7,POINT (10886686 -74776479)
2018,Julio,Austria,2,1,,3,POINT (125862 -81702165)
2018,Julio,Austria,7,3,,10,POINT (3451668 -76532004)
2018,Julio,Austria,293,324,,617,POINT (4697157 -74140516)
2018,Julio,Austria,25,40,,65,POINT (6170465 -7542726)
2018,Julio,Austria,2,5,,7,POINT (863337 -7735002)
2018,Julio,Azerbaiyán,1,2,,3,POINT (4697157 -74140516)
2018,Julio,Bahamas,7,5,,12,POINT (10446304 -75516486)
2018,Julio,Bahamas,7,40,,47,POINT (10886686 -74776479)
2018,Julio,Bahamas,5,1,,6,POINT (3451668 -76532004)
2018,Julio,Bahamas,18,33,,51,POINT (4697157 -74140516)
2018,Julio,Bahamas,3,3,,6,POINT (6170465 -7542726)
2018,Julio,Bahamas,0,1,,1,POINT (836068 -72409396)
2018,Julio,Bahréin,0,1,,1,POINT (6170465 -7542726)
2018,Julio,Bangladesh,1,0,,1,POINT (0.81488 -77356)
2018,Julio,Bangladesh,0,1,,1,POINT (10970933 -74765343)
2018,Julio,Bangladesh,0,6,,6,POINT (4697157 -74140516)
2018,Julio,Bangladesh,1,0,,1,POINT (6170465 -7542726)
2018,Julio,Bangladesh,0,1,,1,POINT (9402597 -75681642)
2018,Julio,Barbados,14,1,,15,POINT (10446304 -75516486)
2018,Julio,Barbados,50,64,,114,POINT (10886686 -74776479)
2018,Julio,Barbados,4,11,,15,POINT (3451668 -76532004)
2018,Julio,Barbados,16,16,,32,POINT (4697157 -74140516)
2018,Julio,Barbados,0,1,,1,POINT (6170465 -7542726)
2018,Julio,República de Belarús,0,1,,1,POINT (3451668 -76532004)
2018,Julio,República de Belarús,3,4,,7,POINT (4697157 -74140516)
2018,Julio,Bélgica,2,6,,8,POINT (-4191162 -69941498)
2018,Julio,Bélgica,0,1,,1,POINT (0.33002 -76876446)
2018,Julio,Bélgica,15,8,,23,POINT (0.81488 -77356)
2018,Julio,Bélgica,4,4,,8,POINT (10406342 -75527794)
2018,Julio,Bélgica,37,57,,94,POINT (10446304 -75516486)
2018,Julio,Bélgica,0,2,,2,POINT (10886686 -74776479)
2018,Julio,Bélgica,0,9,,9,POINT (10970933 -74765343)
2018,Julio,Bélgica,0,1,,1,POINT (11360029 -72129595)
2018,Julio,Bélgica,2,1,,3,POINT (125862 -81702165)
2018,Julio,Bélgica,20,25,,45,POINT (3451668 -76532004)
2018,Julio,Bélgica,0,2,,2,POINT (3884426 -77061029)
2018,Julio,Bélgica,682,743,,1425,POINT (4697157 -74140516)
2018,Julio,Bélgica,58,94,,152,POINT (6170465 -7542726)
2018,Julio,Bélgica,0,2,,2,POINT (7128047 -73181317)
2018,Julio,Bélgica,0,1,,1,POINT (7819 -72453013)
2018,Julio,Belice,1,2,,3,POINT (10446304 -75516486)
2018,Julio,Belice,4,2,,6,POINT (10886686 -74776479)
2018,Julio,Belice,0,1,,1,POINT (125744111 -81703935)
2018,Julio,Belice,0,1,,1,POINT (125862 -81702165)
2018,Julio,Belice,7,9,,16,POINT (3451668 -76532004)
2018,Julio,Belice,11,13,,24,POINT (4697157 -74140516)
2018,Julio,Belice,6,7,,13,POINT (6170465 -7542726)
2018,Julio,Benín,0,3,,3,POINT (4697157 -74140516)
2018,Julio,Benín,0,1,,1,POINT (6170465 -7542726)
2018,Julio,Bermudas/Territorio Británico de Ultramar,0,1,,1,POINT (10446304 -75516486)
2018,Julio,Bermudas/Territorio Británico de Ultramar,5,8,,13,POINT (10886686 -74776479)
2018,Julio,Bermudas/Territorio Británico de Ultramar,1,8,,9,POINT (3451668 -76532004)
2018,Julio,Bermudas/Territorio Británico de Ultramar,4,5,,9,POINT (4697157 -74140516)
2018,Julio,Bermudas/Territorio Británico de Ultramar,0,4,,4,POINT (6170465 -7542726)
2018,Julio,Bolivia,1,0,,1,POINT (-4191162 -69941498)
2018,Julio,Bolivia,4,13,,17,POINT (0.81488 -77356)
2018,Julio,Bolivia,36,18,,54,POINT (10406342 -75527794)
2018,Julio,Bolivia,174,129,,303,POINT (10446304 -75516486)
2018,Julio,Bolivia,0,2,,2,POINT (10886686 -74776479)
2018,Julio,Bolivia,1,3,,4,POINT (11360029 -72129595)
2018,Julio,Bolivia,11,10,,21,POINT (125862 -81702165)
2018,Julio,Bolivia,29,59,,88,POINT (3451668 -76532004)
2018,Julio,Bolivia,0,1,,1,POINT (3866713 -67927521)
2018,Julio,Bolivia,692,707,,1399,POINT (4697157 -74140516)
2018,Julio,Bolivia,2,1,,3,POINT (4815189 -75736374)
2018,Julio,Bolivia,78,59,,137,POINT (6170465 -7542726)
2018,Julio,Bolivia,0,1,,1,POINT (7088729 -70740253)
2018,Julio,Bolivia,2,5,,7,POINT (7819 -72453013)
2018,Julio,Bosnia y Herzegovina,0,1,,1,POINT (10446304 -75516486)
2018,Julio,Bosnia y Herzegovina,0,1,,1,POINT (3451668 -76532004)
2018,Julio,Bosnia y Herzegovina,4,10,,14,POINT (4697157 -74140516)
2018,Julio,Brasil,84,95,,179,POINT (-4191162 -69941498)
2018,Julio,Brasil,2,2,,4,POINT (-4214082 -69941431)
2018,Julio,Brasil,0,4,,4,POINT (0.33002 -76876446)
2018,Julio,Brasil,12,39,,51,POINT (0.81488 -77356)
2018,Julio,Brasil,342,325,,667,POINT (10406342 -75527794)
2018,Julio,Brasil,930,722,,1652,POINT (10446304 -75516486)
2018,Julio,Brasil,13,26,,39,POINT (10886686 -74776479)
2018,Julio,Brasil,5,2,,7,POINT (11360029 -72129595)
2018,Julio,Brasil,279,228,,507,POINT (125862 -81702165)
2018,Julio,Brasil,59,50,,109,POINT (3451668 -76532004)
2018,Julio,Brasil,2,4,,6,POINT (3866713 -67927521)
2018,Julio,Brasil,0,1,,1,POINT (445285 -75766353)
2018,Julio,Brasil,6209,6895,,13104,POINT (4697157 -74140516)
2018,Julio,Brasil,2,3,,5,POINT (4815189 -75736374)
2018,Julio,Brasil,198,255,,453,POINT (6170465 -7542726)
2018,Julio,Brasil,1,3,,4,POINT (6185536 -67484028)
2018,Julio,Brasil,2,1,,3,POINT (7128047 -73181317)
2018,Julio,Brasil,4,8,,12,POINT (7819 -72453013)
2018,Julio,Brasil,1,2,,3,POINT (836068 -72409396)
2018,Julio,Brasil,0,2,,2,POINT (863337 -7735002)
2018,Julio,Bulgaria,1,1,,2,POINT (0.81488 -77356)
2018,Julio,Bulgaria,0,1,,1,POINT (10406342 -75527794)
2018,Julio,Bulgaria,0,4,,4,POINT (10446304 -75516486)
2018,Julio,Bulgaria,1,1,,2,POINT (10886686 -74776479)
2018,Julio,Bulgaria,0,1,,1,POINT (10970933 -74765343)
2018,Julio,Bulgaria,1,0,,1,POINT (3451668 -76532004)
2018,Julio,Bulgaria,18,25,,43,POINT (4697157 -74140516)
2018,Julio,Bulgaria,4,8,,12,POINT (6170465 -7542726)
2018,Julio,Bulgaria,0,1,,1,POINT (7819 -72453013)
2018,Julio,Bulgaria,0,1,,1,POINT (9402597 -75681642)
2018,Julio,Burkina Faso,0,1,,1,POINT (6170465 -7542726)
2018,Julio,Burundi,1,1,,2,POINT (4697157 -74140516)
2018,Julio,Bután,1,0,,1,POINT (0.81488 -77356)
2018,Julio,Bután,0,5,,5,POINT (4697157 -74140516)
2018,Julio,Cabo Verde,1,0,,1,POINT (6170465 -7542726)
2018,Julio,Islas Caimán/Territorio Británico de Ultramar,1,1,,2,POINT (10446304 -75516486)
2018,Julio,Islas Caimán/Territorio Británico de Ultramar,1,4,,5,POINT (10886686 -74776479)
2018,Julio,Islas Caimán/Territorio Británico de Ultramar,1,2,,3,POINT (125862 -81702165)
2018,Julio,Islas Caimán/Territorio Británico de Ultramar,1,1,,2,POINT (3451668 -76532004)
2018,Julio,Camboya,1,0,,1,POINT (10446304 -75516486)
2018,Julio,Camboya,0,3,,3,POINT (4697157 -74140516)
2018,Julio,Camerún,0,1,,1,POINT (10446304 -75516486)
2018,Julio,Camerún,2,3,,5,POINT (4697157 -74140516)
2018,Julio,Camerún,1,1,,2,POINT (6170465 -7542726)
2018,Julio,Canadá,8,2,,10,POINT (-4191162 -69941498)
2018,Julio,Canadá,1,1,,2,POINT (-4214082 -69941431)
2018,Julio,Canadá,19,22,,41,POINT (0.81488 -77356)
2018,Julio,Canadá,6,8,,14,POINT (10406342 -75527794)
2018,Julio,Canadá,241,249,,490,POINT (10446304 -75516486)
2018,Julio,Canadá,33,48,,81,POINT (10886686 -74776479)
2018,Julio,Canadá,1,0,,1,POINT (11117206 -74232675)
2018,Julio,Canadá,2,2,,4,POINT (11247723 -74213989)
2018,Julio,Canadá,2,1,,3,POINT (125744111 -81703935)
2018,Julio,Canadá,11,5,,16,POINT (125862 -81702165)
2018,Julio,Canadá,74,76,,150,POINT (3451668 -76532004)
2018,Julio,Canadá,3,3,,6,POINT (445285 -75766353)
2018,Julio,Canadá,1179,1782,,2961,POINT (4697157 -74140516)
2018,Julio,Canadá,13,19,,32,POINT (4815189 -75736374)
2018,Julio,Canadá,214,394,,608,POINT (6170465 -7542726)
2018,Julio,Canadá,1,3,,4,POINT (7128047 -73181317)
2018,Julio,Canadá,1,1,,2,POINT (7819 -72453013)
2018,Julio,Canadá,1,0,,1,POINT (836068 -72409396)
2018,Julio,Canadá,1,4,,5,POINT (863337 -7735002)
2018,Julio,Chad,1,0,,1,POINT (4697157 -74140516)
2018,Julio,República Democrática del Congo,8,6,,14,POINT (4697157 -74140516)
2018,Julio,República Democrática del Congo,0,1,,1,POINT (6170465 -7542726)
2018,Julio,República de Corea,1,3,,4,POINT (-4191162 -69941498)
2018,Julio,República de Corea,1,2,,3,POINT (-4214082 -69941431)
2018,Julio,República de Corea,8,20,,28,POINT (0.81488 -77356)
2018,Julio,República de Corea,3,8,,11,POINT (10446304 -75516486)
2018,Julio,República de Corea,0,2,,2,POINT (10886686 -74776479)
2018,Julio,República de Corea,0,1,,1,POINT (11360029 -72129595)
2018,Julio,República de Corea,3,2,,5,POINT (125862 -81702165)
2018,Julio,República de Corea,1,8,,9,POINT (3451668 -76532004)
2018,Julio,República de Corea,225,406,,631,POINT (4697157 -74140516)
2018,Julio,República de Corea,5,31,,36,POINT (6170465 -7542726)
2018,Julio,República de Corea,0,1,,1,POINT (863337 -7735002)
2018,Julio,Costa de Marfil,0,1,,1,POINT (3451668 -76532004)
2018,Julio,Costa de Marfil,2,5,,7,POINT (4697157 -74140516)
2018,Julio,Costa Rica,0,1,,1,POINT (-4214082 -69941431)
2018,Julio,Costa Rica,0,1,,1,POINT (0.81488 -77356)
2018,Julio,Costa Rica,222,167,,389,POINT (10446304 -75516486)
2018,Julio,Costa Rica,29,33,,62,POINT (10886686 -74776479)
2018,Julio,Costa Rica,2,0,,2,POINT (11360029 -72129595)
2018,Julio,Costa Rica,187,126,,313,POINT (125862 -81702165)
2018,Julio,Costa Rica,49,75,,124,POINT (3451668 -76532004)
2018,Julio,Costa Rica,0,5,,5,POINT (3884426 -77061029)
2018,Julio,Costa Rica,0,1,,1,POINT (445285 -75766353)
2018,Julio,Costa Rica,1688,1876,,3564,POINT (4697157 -74140516)
2018,Julio,Costa Rica,5,8,,13,POINT (4815189 -75736374)
2018,Julio,Costa Rica,171,170,,341,POINT (6170465 -7542726)
2018,Julio,Costa Rica,1,1,,2,POINT (7128047 -73181317)
2018,Julio,Costa Rica,1,5,,6,POINT (7819 -72453013)
2018,Julio,Costa Rica,0,2,,2,POINT (863337 -7735002)
2018,Julio,Croacia,1,0,,1,POINT (0.81488 -77356)
2018,Julio,Croacia,1,2,,3,POINT (10406342 -75527794)
2018,Julio,Croacia,0,4,,4,POINT (10446304 -75516486)
2018,Julio,Croacia,0,1,,1,POINT (11247723 -74213989)
2018,Julio,Croacia,1,1,,2,POINT (3451668 -76532004)
2018,Julio,Croacia,0,3,,3,POINT (3884426 -77061029)
2018,Julio,Croacia,12,24,,36,POINT (4697157 -74140516)
2018,Julio,Croacia,0,1,,1,POINT (6170465 -7542726)
2018,Julio,Cuba,1,3,,4,POINT (0.81488 -77356)
2018,Julio,Cuba,1,0,,1,POINT (10406342 -75527794)
2018,Julio,Cuba,13,48,,61,POINT (10446304 -75516486)
2018,Julio,Cuba,242,419,,661,POINT (10886686 -74776479)
2018,Julio,Cuba,1,0,,1,POINT (11360029 -72129595)
2018,Julio,Cuba,0,1,,1,POINT (125862 -81702165)
2018,Julio,Cuba,31,50,,81,POINT (3451668 -76532004)
2018,Julio,Cuba,300,540,,840,POINT (4697157 -74140516)
2018,Julio,Cuba,6,2,,8,POINT (4815189 -75736374)
2018,Julio,Cuba,34,39,,73,POINT (6170465 -7542726)
2018,Julio,Cuba,0,1,,1,POINT (7088729 -70740253)
2018,Julio,Cuba,1,2,,3,POINT (7128047 -73181317)
2018,Julio,Cuba,1,2,,3,POINT (7819 -72453013)
2018,Julio,Curazao,0,1,,1,POINT (4697157 -74140516)
2018,Julio,República Checa,4,3,,7,POINT (0.81488 -77356)
2018,Julio,República Checa,2,1,,3,POINT (10406342 -75527794)
2018,Julio,República Checa,3,3,,6,POINT (10446304 -75516486)
2018,Julio,República Checa,0,1,,1,POINT (10886686 -74776479)
2018,Julio,República Checa,2,1,,3,POINT (3451668 -76532004)
2018,Julio,República Checa,56,47,,103,POINT (4697157 -74140516)
2018,Julio,República Checa,1,0,,1,POINT (4815189 -75736374)
2018,Julio,República Checa,4,1,,5,POINT (6170465 -7542726)
2018,Julio,República Checa,1,0,,1,POINT (863337 -7735002)
2018,Julio,Chile,2,5,,7,POINT (-4191162 -69941498)
2018,Julio,Chile,3,1,,4,POINT (-4214082 -69941431)
2018,Julio,Chile,5,3,,8,POINT (0.33002 -76876446)
2018,Julio,Chile,48,73,,121,POINT (0.81488 -77356)
2018,Julio,Chile,0,3,,3,POINT (1800143 -78802679)
2018,Julio,Chile,204,337,,541,POINT (10406342 -75527794)
2018,Julio,Chile,514,350,,864,POINT (10446304 -75516486)
2018,Julio,Chile,9,19,,28,POINT (10886686 -74776479)
2018,Julio,Chile,0,3,,3,POINT (10970933 -74765343)
2018,Julio,Chile,2,11,,13,POINT (11360029 -72129595)
2018,Julio,Chile,209,146,,355,POINT (125862 -81702165)
2018,Julio,Chile,35,57,,92,POINT (3451668 -76532004)
2018,Julio,Chile,0,1,,1,POINT (445285 -75766353)
2018,Julio,Chile,5027,5464,,10491,POINT (4697157 -74140516)
2018,Julio,Chile,2,6,,8,POINT (4815189 -75736374)
2018,Julio,Chile,124,159,,283,POINT (6170465 -7542726)
2018,Julio,Chile,0,3,,3,POINT (7088729 -70740253)
2018,Julio,Chile,2,2,,4,POINT (7128047 -73181317)
2018,Julio,Chile,16,17,,33,POINT (7819 -72453013)
2018,Julio,Chile,3,2,,5,POINT (836068 -72409396)
2018,Julio,Chile,0,1,,1,POINT (863337 -7735002)
2018,Julio,China,1,0,,1,POINT (-4191162 -69941498)
2018,Julio,China,6,10,,16,POINT (0.81488 -77356)
2018,Julio,China,0,2,,2,POINT (10406342 -75527794)
2018,Julio,China,20,14,,34,POINT (10446304 -75516486)
2018,Julio,China,10,15,,25,POINT (10886686 -74776479)
2018,Julio,China,0,3,,3,POINT (10970933 -74765343)
2018,Julio,China,1,0,,1,POINT (11360029 -72129595)
2018,Julio,China,0,1,,1,POINT (125862 -81702165)
2018,Julio,China,11,16,,27,POINT (3451668 -76532004)
2018,Julio,China,479,837,,1316,POINT (4697157 -74140516)
2018,Julio,China,0,2,,2,POINT (4815189 -75736374)
2018,Julio,China,38,40,,78,POINT (6170465 -7542726)
2018,Julio,China,4,9,,13,POINT (7819 -72453013)
2018,Julio,China,0,2,,2,POINT (836068 -72409396)
2018,Julio,China,0,1,,1,POINT (863337 -7735002)
2018,Julio,China,0,1,,1,POINT (9402597 -75681642)
2018,Julio,Taiwán,0,2,,2,POINT (-4191162 -69941498)
2018,Julio,Taiwán,1,0,,1,POINT (-4214082 -69941431)
2018,Julio,Taiwán,5,2,,7,POINT (0.81488 -77356)
2018,Julio,Taiwán,1,0,,1,POINT (10406342 -75527794)
2018,Julio,Taiwán,5,5,,10,POINT (10446304 -75516486)
2018,Julio,Taiwán,1,1,,2,POINT (10886686 -74776479)
2018,Julio,Taiwán,4,2,,6,POINT (3451668 -76532004)
2018,Julio,Taiwán,78,63,,141,POINT (4697157 -74140516)
2018,Julio,Taiwán,1,1,,2,POINT (4815189 -75736374)
2018,Julio,Taiwán,6,12,,18,POINT (6170465 -7542726)
2018,Julio,Taiwán,1,0,,1,POINT (7128047 -73181317)
2018,Julio,Taiwán,1,1,,2,POINT (7819 -72453013)
2018,Julio,Taiwán,0,1,,1,POINT (863337 -7735002)
2018,Julio,Chipre,1,0,,1,POINT (0.81488 -77356)
2018,Julio,Chipre,0,1,,1,POINT (10446304 -75516486)
2018,Julio,Chipre,4,5,,9,POINT (4697157 -74140516)
2018,Julio,Dinamarca,0,2,,2,POINT (-4191162 -69941498)
2018,Julio,Dinamarca,1,3,,4,POINT (-4214082 -69941431)
2018,Julio,Dinamarca,0,1,,1,POINT (0.81488 -77356)
2018,Julio,Dinamarca,0,3,,3,POINT (10406342 -75527794)
2018,Julio,Dinamarca,23,30,,53,POINT (10446304 -75516486)
2018,Julio,Dinamarca,0,6,,6,POINT (10886686 -74776479)
2018,Julio,Dinamarca,5,13,,18,POINT (3451668 -76532004)
2018,Julio,Dinamarca,212,252,,464,POINT (4697157 -74140516)
2018,Julio,Dinamarca,1,3,,4,POINT (4815189 -75736374)
2018,Julio,Dinamarca,13,30,,43,POINT (6170465 -7542726)
2018,Julio,Dinamarca,0,1,,1,POINT (7128047 -73181317)
2018,Julio,Dominica,2,6,,8,POINT (10446304 -75516486)
2018,Julio,Dominica,0,1,,1,POINT (10886686 -74776479)
2018,Julio,Dominica,3,0,,3,POINT (3451668 -76532004)
2018,Julio,Dominica,3,2,,5,POINT (4697157 -74140516)
2018,Julio,Dominica,0,2,,2,POINT (6170465 -7542726)
2018,Julio,Ecuador,1,5,,6,POINT (-4191162 -69941498)
2018,Julio,Ecuador,0,1,,1,POINT (-4214082 -69941431)
2018,Julio,Ecuador,1,0,,1,POINT (0.185957 -7478366)
2018,Julio,Ecuador,68,212,,280,POINT (0.33002 -76876446)
2018,Julio,Ecuador,36,22,,58,POINT (0.812436 -77847006)
2018,Julio,Ecuador,1646,2258,,3904,POINT (0.81488 -77356)
2018,Julio,Ecuador,8,38,,46,POINT (1800143 -78802679)
2018,Julio,Ecuador,13,22,,35,POINT (10406342 -75527794)
2018,Julio,Ecuador,707,511,,1218,POINT (10446304 -75516486)
2018,Julio,Ecuador,6,8,,14,POINT (10886686 -74776479)
2018,Julio,Ecuador,6,9,,15,POINT (11360029 -72129595)
2018,Julio,Ecuador,20,18,,38,POINT (125862 -81702165)
2018,Julio,Ecuador,590,562,,1152,POINT (3451668 -76532004)
2018,Julio,Ecuador,1,2,,3,POINT (445285 -75766353)
2018,Julio,Ecuador,3837,4365,,8202,POINT (4697157 -74140516)
2018,Julio,Ecuador,1,2,,3,POINT (4815189 -75736374)
2018,Julio,Ecuador,59,104,,163,POINT (6170465 -7542726)
2018,Julio,Ecuador,1,4,,5,POINT (7088729 -70740253)
2018,Julio,Ecuador,1,0,,1,POINT (7128047 -73181317)
2018,Julio,Ecuador,138,166,,304,POINT (7819 -72453013)
2018,Julio,Ecuador,9,7,,16,POINT (836068 -72409396)
2018,Julio,Ecuador,0,1,,1,POINT (863337 -7735002)
2018,Julio,Egipto,0,1,,1,POINT (10446304 -75516486)
2018,Julio,Egipto,0,1,,1,POINT (10886686 -74776479)
2018,Julio,Egipto,10,23,,33,POINT (4697157 -74140516)
2018,Julio,Egipto,1,2,,3,POINT (6170465 -7542726)
2018,Julio,El Salvador,72,62,,134,POINT (10446304 -75516486)
2018,Julio,El Salvador,17,28,,45,POINT (10886686 -74776479)
2018,Julio,El Salvador,3,4,,7,POINT (125862 -81702165)
2018,Julio,El Salvador,120,158,,278,POINT (3451668 -76532004)
2018,Julio,El Salvador,1006,1145,,2151,POINT (4697157 -74140516)
2018,Julio,El Salvador,0,5,,5,POINT (4815189 -75736374)
2018,Julio,El Salvador,208,215,,423,POINT (6170465 -7542726)
2018,Julio,El Salvador,1,1,,2,POINT (7819 -72453013)
2018,Julio,Emiratos Árabes,0,5,,5,POINT (10446304 -75516486)
2018,Julio,Emiratos Árabes,4,14,,18,POINT (4697157 -74140516)
2018,Julio,España,5,6,,11,POINT (-4191162 -69941498)
2018,Julio,España,4,8,,12,POINT (-4214082 -69941431)
2018,Julio,España,2,1,,3,POINT (0.33002 -76876446)
2018,Julio,España,46,71,,117,POINT (0.81488 -77356)
2018,Julio,España,0,1,,1,POINT (1800143 -78802679)
2018,Julio,España,16,20,,36,POINT (10406342 -75527794)
2018,Julio,España,146,200,,346,POINT (10446304 -75516486)
2018,Julio,España,40,63,,103,POINT (10886686 -74776479)
2018,Julio,España,0,1,,1,POINT (11247723 -74213989)
2018,Julio,España,4,12,,16,POINT (11360029 -72129595)
2018,Julio,España,1,7,,8,POINT (125862 -81702165)
2018,Julio,España,632,789,,1421,POINT (3451668 -76532004)
2018,Julio,España,0,1,,1,POINT (445285 -75766353)
2018,Julio,España,3563,5783,,9346,POINT (4697157 -74140516)
2018,Julio,España,1,7,,8,POINT (4815189 -75736374)
2018,Julio,España,604,880,,1484,POINT (6170465 -7542726)
2018,Julio,España,1,0,,1,POINT (6185536 -67484028)
2018,Julio,España,0,4,,4,POINT (7088729 -70740253)
2018,Julio,España,5,4,,9,POINT (7128047 -73181317)
2018,Julio,España,17,32,,49,POINT (7819 -72453013)
2018,Julio,España,10,14,,24,POINT (836068 -72409396)
2018,Julio,España,3,3,,6,POINT (863337 -7735002)
2018,Julio,Eritrea,0,1,,1,POINT (4697157 -74140516)
2018,Julio,Eslovaquia,0,1,,1,POINT (10406342 -75527794)
2018,Julio,Eslovaquia,8,4,,12,POINT (10446304 -75516486)
2018,Julio,Eslovaquia,1,0,,1,POINT (11360029 -72129595)
2018,Julio,Eslovaquia,1,1,,2,POINT (3451668 -76532004)
2018,Julio,Eslovaquia,17,18,,35,POINT (4697157 -74140516)
2018,Julio,Eslovaquia,2,1,,3,POINT (6170465 -7542726)
2018,Julio,Eslovenia,0,1,,1,POINT (-4191162 -69941498)
2018,Julio,Eslovenia,3,3,,6,POINT (0.81488 -77356)
2018,Julio,Eslovenia,1,0,,1,POINT (3451668 -76532004)
2018,Julio,Eslovenia,7,15,,22,POINT (4697157 -74140516)
2018,Julio,Estados Unidos de América,19,24,,43,POINT (-4191162 -69941498)
2018,Julio,Estados Unidos de América,22,26,,48,POINT (-4214082 -69941431)
2018,Julio,Estados Unidos de América,4,5,,9,POINT (0.33002 -76876446)
2018,Julio,Estados Unidos de América,66,114,,180,POINT (0.81488 -77356)
2018,Julio,Estados Unidos de América,0,2,,2,POINT (1800143 -78802679)
2018,Julio,Estados Unidos de América,42,65,,107,POINT (10406342 -75527794)
2018,Julio,Estados Unidos de América,5661,6887,,12548,POINT (10446304 -75516486)
2018,Julio,Estados Unidos de América,1212,1820,,3032,POINT (10886686 -74776479)
2018,Julio,Estados Unidos de América,1,2,,3,POINT (11117206 -74232675)
2018,Julio,Estados Unidos de América,4,4,,8,POINT (11247723 -74213989)
2018,Julio,Estados Unidos de América,2,4,,6,POINT (11360029 -72129595)
2018,Julio,Estados Unidos de América,68,88,,156,POINT (125862 -81702165)
2018,Julio,Estados Unidos de América,2,2,,4,POINT (133387613 -81372937)
2018,Julio,Estados Unidos de América,1643,1925,,3568,POINT (3451668 -76532004)
2018,Julio,Estados Unidos de América,0,2,,2,POINT (3884426 -77061029)
2018,Julio,Estados Unidos de América,273,314,,587,POINT (445285 -75766353)
2018,Julio,Estados Unidos de América,12278,17186,,29464,POINT (4697157 -74140516)
2018,Julio,Estados Unidos de América,312,364,,676,POINT (4815189 -75736374)
2018,Julio,Estados Unidos de América,4298,7588,,11886,POINT (6170465 -7542726)
2018,Julio,Estados Unidos de América,55,86,,141,POINT (7128047 -73181317)
2018,Julio,Estados Unidos de América,10,15,,25,POINT (7819 -72453013)
2018,Julio,Estados Unidos de América,0,1,,1,POINT (836068 -72409396)
2018,Julio,Estados Unidos de América,20,19,,39,POINT (863337 -7735002)
2018,Julio,Estonia,2,3,,5,POINT (3451668 -76532004)
2018,Julio,Estonia,1,0,,1,POINT (445285 -75766353)
2018,Julio,Estonia,6,3,,9,POINT (4697157 -74140516)
2018,Julio,Estonia,1,0,,1,POINT (6170465 -7542726)
2018,Julio,Etiopia,1,0,,1,POINT (10446304 -75516486)
2018,Julio,Etiopia,0,1,,1,POINT (3451668 -76532004)
2018,Julio,Etiopia,4,6,,10,POINT (4697157 -74140516)
2018,Julio,Etiopia,0,1,,1,POINT (6170465 -7542726)
2018,Julio,Islas Fiji,0,1,,1,POINT (10446304 -75516486)
2018,Julio,Filipinas,1,0,,1,POINT (0.33002 -76876446)
2018,Julio,Filipinas,1,0,,1,POINT (0.81488 -77356)
2018,Julio,Filipinas,0,52,,52,POINT (10406342 -75527794)
2018,Julio,Filipinas,7,55,,62,POINT (10446304 -75516486)
2018,Julio,Filipinas,2,10,,12,POINT (10886686 -74776479)
2018,Julio,Filipinas,0,38,,38,POINT (10970933 -74765343)
2018,Julio,Filipinas,0,5,,5,POINT (11247723 -74213989)
2018,Julio,Filipinas,0,1,,1,POINT (11360029 -72129595)
2018,Julio,Filipinas,6,6,,12,POINT (3451668 -76532004)
2018,Julio,Filipinas,0,21,,21,POINT (3884426 -77061029)
2018,Julio,Filipinas,44,81,,125,POINT (4697157 -74140516)
2018,Julio,Filipinas,2,1,,3,POINT (4815189 -75736374)
2018,Julio,Filipinas,1,3,,4,POINT (6170465 -7542726)
2018,Julio,Filipinas,0,14,,14,POINT (9402597 -75681642)
2018,Julio,Finlandia,3,0,,3,POINT (0.33002 -76876446)
2018,Julio,Finlandia,4,1,,5,POINT (0.81488 -77356)
2018,Julio,Finlandia,8,5,,13,POINT (10446304 -75516486)
2018,Julio,Finlandia,2,3,,5,POINT (3451668 -76532004)
2018,Julio,Finlandia,43,43,,86,POINT (4697157 -74140516)
2018,Julio,Finlandia,3,8,,11,POINT (6170465 -7542726)
2018,Julio,Finlandia,1,1,,2,POINT (863337 -7735002)
2018,Julio,Francia,21,25,,46,POINT (-4191162 -69941498)
2018,Julio,Francia,8,19,,27,POINT (-4214082 -69941431)
2018,Julio,Francia,6,5,,11,POINT (0.33002 -76876446)
2018,Julio,Francia,117,149,,266,POINT (0.81488 -77356)
2018,Julio,Francia,6,5,,11,POINT (10406342 -75527794)
2018,Julio,Francia,212,280,,492,POINT (10446304 -75516486)
2018,Julio,Francia,44,61,,105,POINT (10886686 -74776479)
2018,Julio,Francia,2,2,,4,POINT (10970933 -74765343)
2018,Julio,Francia,1,3,,4,POINT (11247723 -74213989)
2018,Julio,Francia,3,2,,5,POINT (11360029 -72129595)
2018,Julio,Francia,5,2,,7,POINT (125862 -81702165)
2018,Julio,Francia,1,1,,2,POINT (133387613 -81372937)
2018,Julio,Francia,177,187,,364,POINT (3451668 -76532004)
2018,Julio,Francia,3270,4039,,7309,POINT (4697157 -74140516)
2018,Julio,Francia,21,31,,52,POINT (4815189 -75736374)
2018,Julio,Francia,279,432,,711,POINT (6170465 -7542726)
2018,Julio,Francia,4,10,,14,POINT (7128047 -73181317)
2018,Julio,Francia,4,11,,15,POINT (7819 -72453013)
2018,Julio,Francia,0,1,,1,POINT (836068 -72409396)
2018,Julio,Francia,4,6,,10,POINT (863337 -7735002)
2018,Julio,Francia,0,2,,2,POINT (9402597 -75681642)
2018,Julio,Gambia,0,1,,1,POINT (3451668 -76532004)
2018,Julio,Georgia,1,3,,4,POINT (10446304 -75516486)
2018,Julio,Georgia,0,4,,4,POINT (4697157 -74140516)
2018,Julio,Georgia,1,0,,1,POINT (6170465 -7542726)
2018,Julio,Ghana,0,1,,1,POINT (0.81488 -77356)
2018,Julio,Ghana,2,1,,3,POINT (10446304 -75516486)
2018,Julio,Ghana,5,7,,12,POINT (4697157 -74140516)
2018,Julio,Ghana,0,1,,1,POINT (9402597 -75681642)
2018,Julio,Granada,3,6,,9,POINT (10446304 -75516486)
2018,Julio,Granada,1,3,,4,POINT (10886686 -74776479)
2018,Julio,Granada,0,2,,2,POINT (10970933 -74765343)
2018,Julio,Granada,4,3,,7,POINT (4697157 -74140516)
2018,Julio,Grecia,1,0,,1,POINT (-4214082 -69941431)
2018,Julio,Grecia,1,0,,1,POINT (10406342 -75527794)
2018,Julio,Grecia,3,15,,18,POINT (10446304 -75516486)
2018,Julio,Grecia,0,1,,1,POINT (10886686 -74776479)
2018,Julio,Grecia,2,3,,5,POINT (3451668 -76532004)
2018,Julio,Grecia,32,62,,94,POINT (4697157 -74140516)
2018,Julio,Grecia,0,4,,4,POINT (6170465 -7542726)
2018,Julio,Grecia,0,2,,2,POINT (7819 -72453013)
2018,Julio,Grecia,0,1,,1,POINT (9402597 -75681642)
2018,Julio,Guatemala,1,0,,1,POINT (-4191162 -69941498)
2018,Julio,Guatemala,0,1,,1,POINT (0.185957 -7478366)
2018,Julio,Guatemala,0,1,,1,POINT (0.33002 -76876446)
2018,Julio,Guatemala,0,1,,1,POINT (0.812436 -77847006)
2018,Julio,Guatemala,1,2,,3,POINT (0.81488 -77356)
2018,Julio,Guatemala,0,3,,3,POINT (10406342 -75527794)
2018,Julio,Guatemala,89,118,,207,POINT (10446304 -75516486)
2018,Julio,Guatemala,46,69,,115,POINT (10886686 -74776479)
2018,Julio,Guatemala,0,4,,4,POINT (11360029 -72129595)
2018,Julio,Guatemala,6,4,,10,POINT (125862 -81702165)
2018,Julio,Guatemala,33,64,,97,POINT (3451668 -76532004)
2018,Julio,Guatemala,0,1,,1,POINT (445285 -75766353)
2018,Julio,Guatemala,570,1049,,1619,POINT (4697157 -74140516)
2018,Julio,Guatemala,6,2,,8,POINT (4815189 -75736374)
2018,Julio,Guatemala,82,160,,242,POINT (6170465 -7542726)
2018,Julio,Guatemala,0,2,,2,POINT (7819 -72453013)
2018,Julio,Guatemala,1,0,,1,POINT (836068 -72409396)
2018,Julio,Guyana,4,14,,18,POINT (10446304 -75516486)
2018,Julio,Guyana,2,14,,16,POINT (10886686 -74776479)
2018,Julio,Guyana,7,8,,15,POINT (3451668 -76532004)
2018,Julio,Guyana,27,52,,79,POINT (4697157 -74140516)
2018,Julio,Guyana,1,1,,2,POINT (6170465 -7542726)
2018,Julio,Guyana,1,0,,1,POINT (7088729 -70740253)
2018,Julio,Guyana,1,0,,1,POINT (7819 -72453013)
2018,Julio,Guinea,0,1,,1,POINT (4697157 -74140516)
2018,Julio,Guinea Ecuatorial,2,0,,2,POINT (10886686 -74776479)
2018,Julio,Haití,9,13,,22,POINT (10446304 -75516486)
2018,Julio,Haití,1,8,,9,POINT (10886686 -74776479)
2018,Julio,Haití,5,7,,12,POINT (3451668 -76532004)
2018,Julio,Haití,26,51,,77,POINT (4697157 -74140516)
2018,Julio,Haití,1,4,,5,POINT (6170465 -7542726)
2018,Julio,Honduras,1,1,,2,POINT (0.81488 -77356)
2018,Julio,Honduras,0,21,,21,POINT (10406342 -75527794)
2018,Julio,Honduras,75,66,,141,POINT (10446304 -75516486)
2018,Julio,Honduras,4,53,,57,POINT (10886686 -74776479)
2018,Julio,Honduras,0,1,,1,POINT (10970933 -74765343)
2018,Julio,Honduras,1,0,,1,POINT (11360029 -72129595)
2018,Julio,Honduras,0,23,,23,POINT (125744111 -81703935)
2018,Julio,Honduras,0,1,,1,POINT (125862 -81702165)
2018,Julio,Honduras,39,44,,83,POINT (3451668 -76532004)
2018,Julio,Honduras,1,0,,1,POINT (445285 -75766353)
2018,Julio,Honduras,289,355,,644,POINT (4697157 -74140516)
2018,Julio,Honduras,1,3,,4,POINT (4815189 -75736374)
2018,Julio,Honduras,74,70,,144,POINT (6170465 -7542726)
2018,Julio,Honduras,0,1,,1,POINT (7128047 -73181317)
2018,Julio,Honduras,3,0,,3,POINT (7819 -72453013)
2018,Julio,Honduras,0,1,,1,POINT (863337 -7735002)
2018,Julio,Hong Kong,9,5,,14,POINT (0.81488 -77356)
2018,Julio,Hong Kong,8,6,,14,POINT (4697157 -74140516)
2018,Julio,Hong Kong,1,1,,2,POINT (6170465 -7542726)
2018,Julio,Hungría,1,2,,3,POINT (0.81488 -77356)
2018,Julio,Hungría,0,1,,1,POINT (10406342 -75527794)
2018,Julio,Hungría,0,4,,4,POINT (10446304 -75516486)
2018,Julio,Hungría,2,1,,3,POINT (10886686 -74776479)
2018,Julio,Hungría,22,41,,63,POINT (4697157 -74140516)
2018,Julio,Hungría,2,9,,11,POINT (6170465 -7542726)
2018,Julio,Hungría,0,1,,1,POINT (836068 -72409396)
2018,Julio,India,5,8,,13,POINT (0.81488 -77356)
2018,Julio,India,0,4,,4,POINT (10406342 -75527794)
2018,Julio,India,19,53,,72,POINT (10446304 -75516486)
2018,Julio,India,0,9,,9,POINT (10886686 -74776479)
2018,Julio,India,0,1,,1,POINT (11117206 -74232675)
2018,Julio,India,0,1,,1,POINT (11247723 -74213989)
2018,Julio,India,13,17,,30,POINT (3451668 -76532004)
2018,Julio,India,109,396,,505,POINT (4697157 -74140516)
2018,Julio,India,0,1,,1,POINT (4815189 -75736374)
2018,Julio,India,16,61,,77,POINT (6170465 -7542726)
2018,Julio,India,0,1,,1,POINT (7128047 -73181317)
2018,Julio,India,0,1,,1,POINT (836068 -72409396)
2018,Julio,India,0,5,,5,POINT (9402597 -75681642)
2018,Julio,Indonesia,1,0,,1,POINT (10446304 -75516486)
2018,Julio,Indonesia,0,1,,1,POINT (10970933 -74765343)
2018,Julio,Indonesia,0,1,,1,POINT (3451668 -76532004)
2018,Julio,Indonesia,19,23,,42,POINT (4697157 -74140516)
2018,Julio,Indonesia,1,3,,4,POINT (6170465 -7542726)
2018,Julio,Iraq,3,2,,5,POINT (4697157 -74140516)
2018,Julio,Irán,0,1,,1,POINT (10406342 -75527794)
2018,Julio,Irán,0,1,,1,POINT (10446304 -75516486)
2018,Julio,Irán,0,1,,1,POINT (11360029 -72129595)
2018,Julio,Irán,8,13,,21,POINT (4697157 -74140516)
2018,Julio,Irán,0,1,,1,POINT (4815189 -75736374)
2018,Julio,Irán,0,1,,1,POINT (6170465 -7542726)
2018,Julio,República de Irlanda,1,3,,4,POINT (-4191162 -69941498)
2018,Julio,República de Irlanda,1,1,,2,POINT (-4214082 -69941431)
2018,Julio,República de Irlanda,0,1,,1,POINT (0.33002 -76876446)
2018,Julio,República de Irlanda,13,21,,34,POINT (0.81488 -77356)
2018,Julio,República de Irlanda,8,9,,17,POINT (10406342 -75527794)
2018,Julio,República de Irlanda,24,54,,78,POINT (10446304 -75516486)
2018,Julio,República de Irlanda,0,1,,1,POINT (10886686 -74776479)
2018,Julio,República de Irlanda,8,12,,20,POINT (3451668 -76532004)
2018,Julio,República de Irlanda,201,309,,510,POINT (4697157 -74140516)
2018,Julio,República de Irlanda,1,3,,4,POINT (4815189 -75736374)
2018,Julio,República de Irlanda,15,28,,43,POINT (6170465 -7542726)
2018,Julio,República de Irlanda,0,1,,1,POINT (7819 -72453013)
2018,Julio,República de Irlanda,21,13,,34,POINT (863337 -7735002)
2018,Julio,Islandia,5,6,,11,POINT (10446304 -75516486)
2018,Julio,Islandia,0,1,,1,POINT (10886686 -74776479)
2018,Julio,Islandia,3,1,,4,POINT (3451668 -76532004)
2018,Julio,Islandia,13,8,,21,POINT (4697157 -74140516)
2018,Julio,Islandia,1,4,,5,POINT (6170465 -7542726)
2018,Julio,Israel,2,4,,6,POINT (-4191162 -69941498)
2018,Julio,Israel,0,1,,1,POINT (-4214082 -69941431)
2018,Julio,Israel,0,1,,1,POINT (0.33002 -76876446)
2018,Julio,Israel,34,63,,97,POINT (0.81488 -77356)
2018,Julio,Israel,7,59,,66,POINT (10446304 -75516486)
2018,Julio,Israel,0,3,,3,POINT (10886686 -74776479)
2018,Julio,Israel,0,2,,2,POINT (125862 -81702165)
2018,Julio,Israel,8,17,,25,POINT (3451668 -76532004)
2018,Julio,Israel,2,2,,4,POINT (445285 -75766353)
2018,Julio,Israel,182,457,,639,POINT (4697157 -74140516)
2018,Julio,Israel,28,69,,97,POINT (6170465 -7542726)
2018,Julio,Israel,0,1,,1,POINT (7128047 -73181317)
2018,Julio,Israel,1,5,,6,POINT (863337 -7735002)
2018,Julio,Italia,0,1,,1,POINT (-4191162 -69941498)
2018,Julio,Italia,1,1,,2,POINT (-4214082 -69941431)
2018,Julio,Italia,19,18,,37,POINT (0.81488 -77356)
2018,Julio,Italia,15,21,,36,POINT (10406342 -75527794)
2018,Julio,Italia,75,125,,200,POINT (10446304 -75516486)
2018,Julio,Italia,31,40,,71,POINT (10886686 -74776479)
2018,Julio,Italia,0,5,,5,POINT (11247723 -74213989)
2018,Julio,Italia,4,7,,11,POINT (11360029 -72129595)
2018,Julio,Italia,0,2,,2,POINT (125744111 -81703935)
2018,Julio,Italia,2,1,,3,POINT (125862 -81702165)
2018,Julio,Italia,1,1,,2,POINT (133387613 -81372937)
2018,Julio,Italia,73,93,,166,POINT (3451668 -76532004)
2018,Julio,Italia,0,3,,3,POINT (445285 -75766353)
2018,Julio,Italia,929,1698,,2627,POINT (4697157 -74140516)
2018,Julio,Italia,1,6,,7,POINT (4815189 -75736374)
2018,Julio,Italia,99,217,,316,POINT (6170465 -7542726)
2018,Julio,Italia,0,1,,1,POINT (6185536 -67484028)
2018,Julio,Italia,1,2,,3,POINT (7088729 -70740253)
2018,Julio,Italia,2,3,,5,POINT (7128047 -73181317)
2018,Julio,Italia,12,15,,27,POINT (7819 -72453013)
2018,Julio,Italia,4,4,,8,POINT (836068 -72409396)
2018,Julio,Italia,0,3,,3,POINT (863337 -7735002)
2018,Julio,Jamaica,9,5,,14,POINT (10446304 -75516486)
2018,Julio,Jamaica,90,102,,192,POINT (10886686 -74776479)
2018,Julio,Jamaica,4,8,,12,POINT (3451668 -76532004)
2018,Julio,Jamaica,31,37,,68,POINT (4697157 -74140516)
2018,Julio,Jamaica,5,6,,11,POINT (6170465 -7542726)
2018,Julio,Japón,0,4,,4,POINT (-4191162 -69941498)
2018,Julio,Japón,0,2,,2,POINT (-4214082 -69941431)
2018,Julio,Japón,3,11,,14,POINT (0.81488 -77356)
2018,Julio,Japón,0,2,,2,POINT (10406342 -75527794)
2018,Julio,Japón,7,10,,17,POINT (10446304 -75516486)
2018,Julio,Japón,0,10,,10,POINT (10886686 -74776479)
2018,Julio,Japón,11,11,,22,POINT (3451668 -76532004)
2018,Julio,Japón,160,426,,586,POINT (4697157 -74140516)
2018,Julio,Japón,27,41,,68,POINT (6170465 -7542726)
2018,Julio,Japón,0,1,,1,POINT (7128047 -73181317)
2018,Julio,Japón,0,5,,5,POINT (7819 -72453013)
2018,Julio,Japón,1,0,,1,POINT (863337 -7735002)
2018,Julio,Jordania,1,7,,8,POINT (4697157 -74140516)
2018,Julio,Jordania,1,2,,3,POINT (6170465 -7542726)
2018,Julio,Kazajistán,1,0,,1,POINT (0.81488 -77356)
2018,Julio,Kazajistán,8,4,,12,POINT (4697157 -74140516)
2018,Julio,Kazajistán,1,0,,1,POINT (6170465 -7542726)
2018,Julio,Kenia,0,1,,1,POINT (0.33002 -76876446)
2018,Julio,Kenia,0,1,,1,POINT (10406342 -75527794)
2018,Julio,Kenia,0,1,,1,POINT (10446304 -75516486)
2018,Julio,Kenia,2,2,,4,POINT (3451668 -76532004)
2018,Julio,Kenia,11,14,,25,POINT (4697157 -74140516)
2018,Julio,Kuwait,0,3,,3,POINT (4697157 -74140516)
2018,Julio,República de Kosovo,1,0,,1,POINT (3451668 -76532004)
2018,Julio,República de Kosovo,1,1,,2,POINT (4697157 -74140516)
2018,Julio,República de Kosovo,0,1,,1,POINT (6170465 -7542726)
2018,Julio,República Democrática Popular  Lao,1,2,,3,POINT (4697157 -74140516)
2018,Julio,Letonia,1,2,,3,POINT (10446304 -75516486)
2018,Julio,Letonia,8,8,,16,POINT (4697157 -74140516)
2018,Julio,Letonia,1,1,,2,POINT (6170465 -7542726)
2018,Julio,Lituania,0,1,,1,POINT (0.33002 -76876446)
2018,Julio,Lituania,0,3,,3,POINT (10406342 -75527794)
2018,Julio,Lituania,2,1,,3,POINT (10446304 -75516486)
2018,Julio,Lituania,0,1,,1,POINT (10886686 -74776479)
2018,Julio,Lituania,0,1,,1,POINT (10970933 -74765343)
2018,Julio,Lituania,2,3,,5,POINT (3451668 -76532004)
2018,Julio,Lituania,22,12,,34,POINT (4697157 -74140516)
2018,Julio,Lituania,3,2,,5,POINT (6170465 -7542726)
2018,Julio,Líbano,2,1,,3,POINT (10446304 -75516486)
2018,Julio,Líbano,1,0,,1,POINT (10886686 -74776479)
2018,Julio,Líbano,1,0,,1,POINT (11360029 -72129595)
2018,Julio,Líbano,1,0,,1,POINT (3451668 -76532004)
2018,Julio,Líbano,11,28,,39,POINT (4697157 -74140516)
2018,Julio,Líbano,0,1,,1,POINT (4815189 -75736374)
2018,Julio,Líbano,0,5,,5,POINT (6170465 -7542726)
2018,Julio,Libia,0,1,,1,POINT (4697157 -74140516)
2018,Julio,Liechtenstein,1,1,,2,POINT (4697157 -74140516)
2018,Julio,Luxemburgo,1,0,,1,POINT (0.81488 -77356)
2018,Julio,Luxemburgo,1,0,,1,POINT (10446304 -75516486)
2018,Julio,Luxemburgo,0,2,,2,POINT (3451668 -76532004)
2018,Julio,Luxemburgo,13,17,,30,POINT (4697157 -74140516)
2018,Julio,Luxemburgo,3,2,,5,POINT (6170465 -7542726)
2018,Julio,Luxemburgo,2,0,,2,POINT (863337 -7735002)
2018,Julio,Macedonia,0,1,,1,POINT (10446304 -75516486)
2018,Julio,Macedonia,0,1,,1,POINT (4697157 -74140516)
2018,Julio,Macedonia,1,0,,1,POINT (6170465 -7542726)
2018,Julio,Madagascar,2,1,,3,POINT (4697157 -74140516)
2018,Julio,Malasia,1,3,,4,POINT (0.81488 -77356)
2018,Julio,Malasia,1,6,,7,POINT (10446304 -75516486)
2018,Julio,Malasia,0,1,,1,POINT (10886686 -74776479)
2018,Julio,Malasia,0,1,,1,POINT (3451668 -76532004)
2018,Julio,Malasia,21,24,,45,POINT (4697157 -74140516)
2018,Julio,Malasia,1,1,,2,POINT (6170465 -7542726)
2018,Julio,Malasia,0,1,,1,POINT (9402597 -75681642)
2018,Julio,Malta,0,1,,1,POINT (0.81488 -77356)
2018,Julio,Malta,3,4,,7,POINT (4697157 -74140516)
2018,Julio,Malta,0,2,,2,POINT (6170465 -7542726)
2018,Julio,Marruecos,1,0,,1,POINT (10446304 -75516486)
2018,Julio,Marruecos,0,1,,1,POINT (10886686 -74776479)
2018,Julio,Marruecos,1,1,,2,POINT (3451668 -76532004)
2018,Julio,Marruecos,15,17,,32,POINT (4697157 -74140516)
2018,Julio,Marruecos,1,5,,6,POINT (6170465 -7542726)
2018,Julio,Mauricio,0,1,,1,POINT (4697157 -74140516)
2018,Julio,México,4,3,,7,POINT (-4191162 -69941498)
2018,Julio,México,4,4,,8,POINT (0.33002 -76876446)
2018,Julio,México,37,56,,93,POINT (0.81488 -77356)
2018,Julio,México,39,62,,101,POINT (10406342 -75527794)
2018,Julio,México,357,429,,786,POINT (10446304 -75516486)
2018,Julio,México,308,438,,746,POINT (10886686 -74776479)
2018,Julio,México,0,4,,4,POINT (11247723 -74213989)
2018,Julio,México,3,1,,4,POINT (11360029 -72129595)
2018,Julio,México,8,4,,12,POINT (125862 -81702165)
2018,Julio,México,132,219,,351,POINT (3451668 -76532004)
2018,Julio,México,2,1,,3,POINT (445285 -75766353)
2018,Julio,México,6114,8600,,14714,POINT (4697157 -74140516)
2018,Julio,México,20,38,,58,POINT (4815189 -75736374)
2018,Julio,México,944,1442,,2386,POINT (6170465 -7542726)
2018,Julio,México,1,2,,3,POINT (6185536 -67484028)
2018,Julio,México,2,1,,3,POINT (7088729 -70740253)
2018,Julio,México,6,10,,16,POINT (7128047 -73181317)
2018,Julio,México,23,36,,59,POINT (7819 -72453013)
2018,Julio,México,2,4,,6,POINT (836068 -72409396)
2018,Julio,México,2,1,,3,POINT (863337 -7735002)
2018,Julio,República de Moldavia,9,2,,11,POINT (4697157 -74140516)
2018,Julio,Mónaco,1,2,,3,POINT (4697157 -74140516)
2018,Julio,Mónaco,0,2,,2,POINT (6170465 -7542726)
2018,Julio,Mongolia,8,1,,9,POINT (4697157 -74140516)
2018,Julio,Montenegro,1,0,,1,POINT (10446304 -75516486)
2018,Julio,Montenegro,1,1,,2,POINT (3451668 -76532004)
2018,Julio,Montenegro,2,1,,3,POINT (4697157 -74140516)
2018,Julio,Montenegro,0,2,,2,POINT (6170465 -7542726)
2018,Julio,Mozambique,0,5,,5,POINT (4697157 -74140516)
2018,Julio,Mozambique,1,1,,2,POINT (6170465 -7542726)
2018,Julio,Myanmar,0,1,,1,POINT (10406342 -75527794)
2018,Julio,Myanmar,0,2,,2,POINT (10446304 -75516486)
2018,Julio,Myanmar,7,10,,17,POINT (4697157 -74140516)
2018,Julio,Namibia,0,1,,1,POINT (4697157 -74140516)
2018,Julio,Nepal,2,5,,7,POINT (4697157 -74140516)
2018,Julio,Nicaragua,0,12,,12,POINT (10406342 -75527794)
2018,Julio,Nicaragua,16,13,,29,POINT (10446304 -75516486)
2018,Julio,Nicaragua,12,17,,29,POINT (10886686 -74776479)
2018,Julio,Nicaragua,4,3,,7,POINT (125862 -81702165)
2018,Julio,Nicaragua,45,29,,74,POINT (3451668 -76532004)
2018,Julio,Nicaragua,0,1,,1,POINT (3884426 -77061029)
2018,Julio,Nicaragua,1,1,,2,POINT (445285 -75766353)
2018,Julio,Nicaragua,108,156,,264,POINT (4697157 -74140516)
2018,Julio,Nicaragua,2,1,,3,POINT (4815189 -75736374)
2018,Julio,Nicaragua,46,61,,107,POINT (6170465 -7542726)
2018,Julio,Nicaragua,0,1,,1,POINT (7128047 -73181317)
2018,Julio,Nigeria,0,1,,1,POINT (10446304 -75516486)
2018,Julio,Nigeria,0,2,,2,POINT (11360029 -72129595)
2018,Julio,Nigeria,5,12,,17,POINT (4697157 -74140516)
2018,Julio,Nigeria,0,4,,4,POINT (6170465 -7542726)
2018,Julio,Noruega,5,1,,6,POINT (0.81488 -77356)
2018,Julio,Noruega,4,4,,8,POINT (10406342 -75527794)
2018,Julio,Noruega,61,41,,102,POINT (10446304 -75516486)
2018,Julio,Noruega,1,1,,2,POINT (10886686 -74776479)
2018,Julio,Noruega,1,1,,2,POINT (125862 -81702165)
2018,Julio,Noruega,19,16,,35,POINT (3451668 -76532004)
2018,Julio,Noruega,185,233,,418,POINT (4697157 -74140516)
2018,Julio,Noruega,25,32,,57,POINT (6170465 -7542726)
2018,Julio,Noruega,3,0,,3,POINT (7128047 -73181317)
2018,Julio,Noruega,1,2,,3,POINT (7819 -72453013)
2018,Julio,Nueva Zelanda,0,3,,3,POINT (-4191162 -69941498)
2018,Julio,Nueva Zelanda,0,2,,2,POINT (-4214082 -69941431)
2018,Julio,Nueva Zelanda,0,2,,2,POINT (0.33002 -76876446)
2018,Julio,Nueva Zelanda,8,10,,18,POINT (0.81488 -77356)
2018,Julio,Nueva Zelanda,4,14,,18,POINT (10406342 -75527794)
2018,Julio,Nueva Zelanda,16,16,,32,POINT (10446304 -75516486)
2018,Julio,Nueva Zelanda,0,2,,2,POINT (10886686 -74776479)
2018,Julio,Nueva Zelanda,3,2,,5,POINT (3451668 -76532004)
2018,Julio,Nueva Zelanda,72,106,,178,POINT (4697157 -74140516)
2018,Julio,Nueva Zelanda,0,1,,1,POINT (4815189 -75736374)
2018,Julio,Nueva Zelanda,9,23,,32,POINT (6170465 -7542726)
2018,Julio,Nueva Zelanda,0,1,,1,POINT (7128047 -73181317)
2018,Julio,Nueva Zelanda,2,5,,7,POINT (863337 -7735002)
2018,Julio,Omán,0,2,,2,POINT (4697157 -74140516)
2018,Julio,Países Bajos,6,6,,12,POINT (-4191162 -69941498)
2018,Julio,Países Bajos,2,8,,10,POINT (-4214082 -69941431)
2018,Julio,Países Bajos,0,1,,1,POINT (0.33002 -76876446)
2018,Julio,Países Bajos,21,29,,50,POINT (0.81488 -77356)
2018,Julio,Países Bajos,35,36,,71,POINT (10406342 -75527794)
2018,Julio,Países Bajos,361,334,,695,POINT (10446304 -75516486)
2018,Julio,Países Bajos,51,54,,105,POINT (10886686 -74776479)
2018,Julio,Países Bajos,0,3,,3,POINT (10970933 -74765343)
2018,Julio,Países Bajos,0,4,,4,POINT (11247723 -74213989)
2018,Julio,Países Bajos,1,3,,4,POINT (11360029 -72129595)
2018,Julio,Países Bajos,1,2,,3,POINT (125862 -81702165)
2018,Julio,Países Bajos,75,117,,192,POINT (3451668 -76532004)
2018,Julio,Países Bajos,0,5,,5,POINT (3884426 -77061029)
2018,Julio,Países Bajos,2849,3333,,6182,POINT (4697157 -74140516)
2018,Julio,Países Bajos,4,7,,11,POINT (4815189 -75736374)
2018,Julio,Países Bajos,251,318,,569,POINT (6170465 -7542726)
2018,Julio,Países Bajos,17,14,,31,POINT (7128047 -73181317)
2018,Julio,Países Bajos,0,1,,1,POINT (836068 -72409396)
2018,Julio,Países Bajos,13,16,,29,POINT (863337 -7735002)
2018,Julio,Pakistán,4,17,,21,POINT (4697157 -74140516)
2018,Julio,Pakistán,0,1,,1,POINT (6170465 -7542726)
2018,Julio,Panamá,0,9,,9,POINT (0.81488 -77356)
2018,Julio,Panamá,3,43,,46,POINT (10406342 -75527794)
2018,Julio,Panamá,491,560,,1051,POINT (10446304 -75516486)
2018,Julio,Panamá,31,70,,101,POINT (10886686 -74776479)
2018,Julio,Panamá,2,5,,7,POINT (11360029 -72129595)
2018,Julio,Panamá,46,47,,93,POINT (125862 -81702165)
2018,Julio,Panamá,394,218,,612,POINT (3451668 -76532004)
2018,Julio,Panamá,13,20,,33,POINT (445285 -75766353)
2018,Julio,Panamá,1329,1468,,2797,POINT (4697157 -74140516)
2018,Julio,Panamá,43,42,,85,POINT (4815189 -75736374)
2018,Julio,Panamá,850,909,,1759,POINT (6170465 -7542726)
2018,Julio,Panamá,0,2,,2,POINT (6222552 -77401154)
2018,Julio,Panamá,1,3,,4,POINT (7102626 -77762647)
2018,Julio,Panamá,7,11,,18,POINT (7128047 -73181317)
2018,Julio,Panamá,4,2,,6,POINT (7819 -72453013)
2018,Julio,Panamá,1,5,,6,POINT (863337 -7735002)
2018,Julio,Papúa Nueva Guinea,1,0,,1,POINT (4697157 -74140516)
2018,Julio,Paraguay,1,2,,3,POINT (0.81488 -77356)
2018,Julio,Paraguay,3,0,,3,POINT (10406342 -75527794)
2018,Julio,Paraguay,55,34,,89,POINT (10446304 -75516486)
2018,Julio,Paraguay,2,6,,8,POINT (10886686 -74776479)
2018,Julio,Paraguay,24,17,,41,POINT (125862 -81702165)
2018,Julio,Paraguay,7,3,,10,POINT (3451668 -76532004)
2018,Julio,Paraguay,151,146,,297,POINT (4697157 -74140516)
2018,Julio,Paraguay,1,1,,2,POINT (4815189 -75736374)
2018,Julio,Paraguay,36,27,,63,POINT (6170465 -7542726)
2018,Julio,Paraguay,1,0,,1,POINT (7128047 -73181317)
2018,Julio,Paraguay,0,3,,3,POINT (7819 -72453013)
2018,Julio,Perú,28,36,,64,POINT (-4191162 -69941498)
2018,Julio,Perú,46,78,,124,POINT (-4214082 -69941431)
2018,Julio,Perú,0,4,,4,POINT (0.185957 -7478366)
2018,Julio,Perú,6,13,,19,POINT (0.33002 -76876446)
2018,Julio,Perú,0,1,,1,POINT (0.812436 -77847006)
2018,Julio,Perú,127,320,,447,POINT (0.81488 -77356)
2018,Julio,Perú,39,123,,162,POINT (10406342 -75527794)
2018,Julio,Perú,1096,808,,1904,POINT (10446304 -75516486)
2018,Julio,Perú,6,8,,14,POINT (10886686 -74776479)
2018,Julio,Perú,0,1,,1,POINT (10970933 -74765343)
2018,Julio,Perú,0,1,,1,POINT (11247723 -74213989)
2018,Julio,Perú,6,29,,35,POINT (11360029 -72129595)
2018,Julio,Perú,153,112,,265,POINT (125862 -81702165)
2018,Julio,Perú,186,172,,358,POINT (3451668 -76532004)
2018,Julio,Perú,0,1,,1,POINT (3884426 -77061029)
2018,Julio,Perú,0,1,,1,POINT (445285 -75766353)
2018,Julio,Perú,4394,4914,,9308,POINT (4697157 -74140516)
2018,Julio,Perú,1,2,,3,POINT (4815189 -75736374)
2018,Julio,Perú,644,686,,1330,POINT (6170465 -7542726)
2018,Julio,Perú,0,1,,1,POINT (6185536 -67484028)
2018,Julio,Perú,0,1,,1,POINT (7088729 -70740253)
2018,Julio,Perú,95,148,,243,POINT (7819 -72453013)
2018,Julio,Perú,2,8,,10,POINT (836068 -72409396)
2018,Julio,Perú,0,1,,1,POINT (863337 -7735002)
2018,Julio,Palestina,1,0,,1,POINT (0.81488 -77356)
2018,Julio,Palestina,2,2,,4,POINT (4697157 -74140516)
2018,Julio,Polonia,1,0,,1,POINT (-4191162 -69941498)
2018,Julio,Polonia,1,1,,2,POINT (-4214082 -69941431)
2018,Julio,Polonia,4,5,,9,POINT (0.81488 -77356)
2018,Julio,Polonia,2,14,,16,POINT (10406342 -75527794)
2018,Julio,Polonia,7,23,,30,POINT (10446304 -75516486)
2018,Julio,Polonia,0,1,,1,POINT (10886686 -74776479)
2018,Julio,Polonia,0,2,,2,POINT (10970933 -74765343)
2018,Julio,Polonia,14,5,,19,POINT (3451668 -76532004)
2018,Julio,Polonia,194,181,,375,POINT (4697157 -74140516)
2018,Julio,Polonia,0,1,,1,POINT (4815189 -75736374)
2018,Julio,Polonia,16,17,,33,POINT (6170465 -7542726)
2018,Julio,Polonia,1,0,,1,POINT (7819 -72453013)
2018,Julio,Polonia,0,1,,1,POINT (836068 -72409396)
2018,Julio,Portugal,3,3,,6,POINT (-4191162 -69941498)
2018,Julio,Portugal,1,0,,1,POINT (-4214082 -69941431)
2018,Julio,Portugal,6,9,,15,POINT (0.81488 -77356)
2018,Julio,Portugal,4,21,,25,POINT (10406342 -75527794)
2018,Julio,Portugal,13,26,,39,POINT (10446304 -75516486)
2018,Julio,Portugal,2,3,,5,POINT (10886686 -74776479)
2018,Julio,Portugal,0,8,,8,POINT (11247723 -74213989)
2018,Julio,Portugal,3,1,,4,POINT (11360029 -72129595)
2018,Julio,Portugal,1,0,,1,POINT (125862 -81702165)
2018,Julio,Portugal,7,33,,40,POINT (3451668 -76532004)
2018,Julio,Portugal,235,416,,651,POINT (4697157 -74140516)
2018,Julio,Portugal,1,0,,1,POINT (4815189 -75736374)
2018,Julio,Portugal,23,43,,66,POINT (6170465 -7542726)
2018,Julio,Portugal,1,2,,3,POINT (7128047 -73181317)
2018,Julio,Portugal,5,17,,22,POINT (7819 -72453013)
2018,Julio,Portugal,2,1,,3,POINT (836068 -72409396)
2018,Julio,Portugal,0,1,,1,POINT (863337 -7735002)
2018,Julio,Qatar,0,1,,1,POINT (4697157 -74140516)
2018,Julio,Reino Unido de Gran Bretaña e Irlanda del Norte,5,20,,25,POINT (-4191162 -69941498)
2018,Julio,Reino Unido de Gran Bretaña e Irlanda del Norte,3,12,,15,POINT (-4214082 -69941431)
2018,Julio,Reino Unido de Gran Bretaña e Irlanda del Norte,1,5,,6,POINT (0.33002 -76876446)
2018,Julio,Reino Unido de Gran Bretaña e Irlanda del Norte,122,130,,252,POINT (0.81488 -77356)
2018,Julio,Reino Unido de Gran Bretaña e Irlanda del Norte,13,29,,42,POINT (10406342 -75527794)
2018,Julio,Reino Unido de Gran Bretaña e Irlanda del Norte,154,193,,347,POINT (10446304 -75516486)
2018,Julio,Reino Unido de Gran Bretaña e Irlanda del Norte,55,71,,126,POINT (10886686 -74776479)
2018,Julio,Reino Unido de Gran Bretaña e Irlanda del Norte,2,2,,4,POINT (11247723 -74213989)
2018,Julio,Reino Unido de Gran Bretaña e Irlanda del Norte,0,1,,1,POINT (11360029 -72129595)
2018,Julio,Reino Unido de Gran Bretaña e Irlanda del Norte,0,2,,2,POINT (125744111 -81703935)
2018,Julio,Reino Unido de Gran Bretaña e Irlanda del Norte,1,0,,1,POINT (125862 -81702165)
2018,Julio,Reino Unido de Gran Bretaña e Irlanda del Norte,126,122,,248,POINT (3451668 -76532004)
2018,Julio,Reino Unido de Gran Bretaña e Irlanda del Norte,1,2,,3,POINT (445285 -75766353)
2018,Julio,Reino Unido de Gran Bretaña e Irlanda del Norte,1490,2254,,3744,POINT (4697157 -74140516)
2018,Julio,Reino Unido de Gran Bretaña e Irlanda del Norte,0,1,,1,POINT (4815189 -75736374)
2018,Julio,Reino Unido de Gran Bretaña e Irlanda del Norte,136,254,,390,POINT (6170465 -7542726)
2018,Julio,Reino Unido de Gran Bretaña e Irlanda del Norte,3,4,,7,POINT (7128047 -73181317)
2018,Julio,Reino Unido de Gran Bretaña e Irlanda del Norte,1,4,,5,POINT (7819 -72453013)
2018,Julio,Reino Unido de Gran Bretaña e Irlanda del Norte,0,3,,3,POINT (836068 -72409396)
2018,Julio,Reino Unido de Gran Bretaña e Irlanda del Norte,33,34,,67,POINT (863337 -7735002)
2018,Julio,República Dominicana,0,1,,1,POINT (-4191162 -69941498)
2018,Julio,República Dominicana,8,18,,26,POINT (0.81488 -77356)
2018,Julio,República Dominicana,1,2,,3,POINT (10406342 -75527794)
2018,Julio,República Dominicana,48,75,,123,POINT (10446304 -75516486)
2018,Julio,República Dominicana,29,55,,84,POINT (10886686 -74776479)
2018,Julio,República Dominicana,1,0,,1,POINT (11247723 -74213989)
2018,Julio,República Dominicana,0,1,,1,POINT (11360029 -72129595)
2018,Julio,República Dominicana,1,0,,1,POINT (125862 -81702165)
2018,Julio,República Dominicana,33,44,,77,POINT (3451668 -76532004)
2018,Julio,República Dominicana,4,0,,4,POINT (445285 -75766353)
2018,Julio,República Dominicana,977,1259,,2236,POINT (4697157 -74140516)
2018,Julio,República Dominicana,8,3,,11,POINT (4815189 -75736374)
2018,Julio,República Dominicana,65,79,,144,POINT (6170465 -7542726)
2018,Julio,República Dominicana,1,2,,3,POINT (7128047 -73181317)
2018,Julio,República Dominicana,1,6,,7,POINT (7819 -72453013)
2018,Julio,República Dominicana,0,1,,1,POINT (836068 -72409396)
2018,Julio,Rumania,3,3,,6,POINT (0.81488 -77356)
2018,Julio,Rumania,0,3,,3,POINT (10406342 -75527794)
2018,Julio,Rumania,6,4,,10,POINT (10446304 -75516486)
2018,Julio,Rumania,0,1,,1,POINT (11360029 -72129595)
2018,Julio,Rumania,1,0,,1,POINT (125862 -81702165)
2018,Julio,Rumania,8,4,,12,POINT (3451668 -76532004)
2018,Julio,Rumania,0,1,,1,POINT (3884426 -77061029)
2018,Julio,Rumania,1,2,,3,POINT (445285 -75766353)
2018,Julio,Rumania,72,57,,129,POINT (4697157 -74140516)
2018,Julio,Rumania,7,7,,14,POINT (6170465 -7542726)
2018,Julio,Rumania,0,2,,2,POINT (7819 -72453013)
2018,Julio,Rumania,1,0,,1,POINT (863337 -7735002)
2018,Julio,Federación de Rusia,1,0,,1,POINT (-4191162 -69941498)
2018,Julio,Federación de Rusia,1,1,,2,POINT (-4214082 -69941431)
2018,Julio,Federación de Rusia,13,11,,24,POINT (0.81488 -77356)
2018,Julio,Federación de Rusia,0,5,,5,POINT (10406342 -75527794)
2018,Julio,Federación de Rusia,10,19,,29,POINT (10446304 -75516486)
2018,Julio,Federación de Rusia,3,5,,8,POINT (10886686 -74776479)
2018,Julio,Federación de Rusia,0,1,,1,POINT (10970933 -74765343)
2018,Julio,Federación de Rusia,0,3,,3,POINT (11247723 -74213989)
2018,Julio,Federación de Rusia,3,2,,5,POINT (3451668 -76532004)
2018,Julio,Federación de Rusia,148,167,,315,POINT (4697157 -74140516)
2018,Julio,Federación de Rusia,14,12,,26,POINT (6170465 -7542726)
2018,Julio,Federación de Rusia,2,0,,2,POINT (6185536 -67484028)
2018,Julio,Federación de Rusia,1,1,,2,POINT (7819 -72453013)
2018,Julio,Federación de Rusia,1,0,,1,POINT (836068 -72409396)
2018,Julio,Federación de Rusia,0,1,,1,POINT (863337 -7735002)
2018,Julio,Federación de Rusia,0,2,,2,POINT (9402597 -75681642)
2018,Julio,Rwanda,0,1,,1,POINT (3451668 -76532004)
2018,Julio,Rwanda,2,0,,2,POINT (4697157 -74140516)
2018,Julio,San Cristóbal y Nevis,0,1,,1,POINT (10446304 -75516486)
2018,Julio,San Cristóbal y Nevis,4,7,,11,POINT (10886686 -74776479)
2018,Julio,San Cristóbal y Nevis,3,14,,17,POINT (4697157 -74140516)
2018,Julio,San Cristóbal y Nevis,0,1,,1,POINT (6170465 -7542726)
2018,Julio,San  Vicente y las Granadinas,1,3,,4,POINT (10446304 -75516486)
2018,Julio,San  Vicente y las Granadinas,7,9,,16,POINT (10886686 -74776479)
2018,Julio,San  Vicente y las Granadinas,0,6,,6,POINT (3451668 -76532004)
2018,Julio,San  Vicente y las Granadinas,7,3,,10,POINT (4697157 -74140516)
2018,Julio,San  Vicente y las Granadinas,0,3,,3,POINT (6170465 -7542726)
2018,Julio,Santa Lucia,1,3,,4,POINT (10446304 -75516486)
2018,Julio,Santa Lucia,3,6,,9,POINT (10886686 -74776479)
2018,Julio,Santa Lucia,2,10,,12,POINT (4697157 -74140516)
2018,Julio,Santa Lucia,0,1,,1,POINT (6170465 -7542726)
2018,Julio,Santa Sede/Ciudad del Vaticano,0,1,,1,POINT (4697157 -74140516)
2018,Julio,Senegal,3,1,,4,POINT (4697157 -74140516)
2018,Julio,Serbia,0,1,,1,POINT (0.81488 -77356)
2018,Julio,Serbia,1,1,,2,POINT (10446304 -75516486)
2018,Julio,Serbia,0,2,,2,POINT (3451668 -76532004)
2018,Julio,Serbia,12,19,,31,POINT (4697157 -74140516)
2018,Julio,Serbia,3,3,,6,POINT (6170465 -7542726)
2018,Julio,Sierra Leona,0,2,,2,POINT (4697157 -74140516)
2018,Julio,Singapur,0,1,,1,POINT (0.81488 -77356)
2018,Julio,Singapur,1,0,,1,POINT (10406342 -75527794)
2018,Julio,Singapur,2,1,,3,POINT (10446304 -75516486)
2018,Julio,Singapur,21,36,,57,POINT (4697157 -74140516)
2018,Julio,Singapur,2,4,,6,POINT (6170465 -7542726)
2018,Julio,Singapur,0,1,,1,POINT (9402597 -75681642)
2018,Julio,República Árabe Siria,0,2,,2,POINT (4697157 -74140516)
2018,Julio,República Árabe Siria,0,1,,1,POINT (6170465 -7542726)
2018,Julio,Somalia,0,1,,1,POINT (4697157 -74140516)
2018,Julio,Sri Lanka,0,1,,1,POINT (10446304 -75516486)
2018,Julio,Sri Lanka,0,1,,1,POINT (10970933 -74765343)
2018,Julio,Sri Lanka,0,1,,1,POINT (3451668 -76532004)
2018,Julio,Sri Lanka,0,3,,3,POINT (4697157 -74140516)
2018,Julio,Sri Lanka,0,2,,2,POINT (6170465 -7542726)
2018,Julio,Sudáfrica,1,2,,3,POINT (10406342 -75527794)
2018,Julio,Sudáfrica,5,0,,5,POINT (10446304 -75516486)
2018,Julio,Sudáfrica,0,2,,2,POINT (10886686 -74776479)
2018,Julio,Sudáfrica,0,1,,1,POINT (11360029 -72129595)
2018,Julio,Sudáfrica,0,1,,1,POINT (3884426 -77061029)
2018,Julio,Sudáfrica,26,49,,75,POINT (4697157 -74140516)
2018,Julio,Sudáfrica,1,5,,6,POINT (6170465 -7542726)
2018,Julio,Sudáfrica,2,0,,2,POINT (863337 -7735002)
2018,Julio,Suecia,1,0,,1,POINT (-4191162 -69941498)
2018,Julio,Suecia,1,7,,8,POINT (-4214082 -69941431)
2018,Julio,Suecia,1,0,,1,POINT (0.33002 -76876446)
2018,Julio,Suecia,3,7,,10,POINT (0.81488 -77356)
2018,Julio,Suecia,4,3,,7,POINT (10406342 -75527794)
2018,Julio,Suecia,26,46,,72,POINT (10446304 -75516486)
2018,Julio,Suecia,1,2,,3,POINT (10886686 -74776479)
2018,Julio,Suecia,15,15,,30,POINT (3451668 -76532004)
2018,Julio,Suecia,177,246,,423,POINT (4697157 -74140516)
2018,Julio,Suecia,3,2,,5,POINT (4815189 -75736374)
2018,Julio,Suecia,21,41,,62,POINT (6170465 -7542726)
2018,Julio,Suecia,1,0,,1,POINT (7128047 -73181317)
2018,Julio,Suecia,0,2,,2,POINT (7819 -72453013)
2018,Julio,Suecia,0,2,,2,POINT (836068 -72409396)
2018,Julio,Suecia,3,1,,4,POINT (863337 -7735002)
2018,Julio,Suiza,3,6,,9,POINT (-4191162 -69941498)
2018,Julio,Suiza,0,4,,4,POINT (-4214082 -69941431)
2018,Julio,Suiza,1,3,,4,POINT (0.33002 -76876446)
2018,Julio,Suiza,0,1,,1,POINT (0.812436 -77847006)
2018,Julio,Suiza,27,30,,57,POINT (0.81488 -77356)
2018,Julio,Suiza,16,12,,28,POINT (10406342 -75527794)
2018,Julio,Suiza,62,76,,138,POINT (10446304 -75516486)
2018,Julio,Suiza,9,8,,17,POINT (10886686 -74776479)
2018,Julio,Suiza,0,2,,2,POINT (11247723 -74213989)
2018,Julio,Suiza,1,2,,3,POINT (125862 -81702165)
2018,Julio,Suiza,0,1,,1,POINT (133387613 -81372937)
2018,Julio,Suiza,31,61,,92,POINT (3451668 -76532004)
2018,Julio,Suiza,911,1076,,1987,POINT (4697157 -74140516)
2018,Julio,Suiza,1,2,,3,POINT (4815189 -75736374)
2018,Julio,Suiza,92,133,,225,POINT (6170465 -7542726)
2018,Julio,Suiza,0,1,,1,POINT (7128047 -73181317)
2018,Julio,Suiza,1,5,,6,POINT (7819 -72453013)
2018,Julio,Suiza,1,0,,1,POINT (836068 -72409396)
2018,Julio,Suiza,4,6,,10,POINT (863337 -7735002)
2018,Julio,Surinam,1,2,,3,POINT (10446304 -75516486)
2018,Julio,Surinam,3,2,,5,POINT (10886686 -74776479)
2018,Julio,Surinam,1,3,,4,POINT (3451668 -76532004)
2018,Julio,Surinam,23,33,,56,POINT (4697157 -74140516)
2018,Julio,Surinam,0,2,,2,POINT (6170465 -7542726)
2018,Julio,Taiwán,1,0,,1,POINT (4697157 -74140516)
2018,Julio,República de Tayikistán,0,1,,1,POINT (4697157 -74140516)
2018,Julio,Tailandia,0,1,,1,POINT (10406342 -75527794)
2018,Julio,Tailandia,2,1,,3,POINT (10446304 -75516486)
2018,Julio,Tailandia,1,0,,1,POINT (125862 -81702165)
2018,Julio,Tailandia,2,0,,2,POINT (3451668 -76532004)
2018,Julio,Tailandia,28,15,,43,POINT (4697157 -74140516)
2018,Julio,Tailandia,4,1,,5,POINT (6170465 -7542726)
2018,Julio,Tanzania,0,1,,1,POINT (10886686 -74776479)
2018,Julio,Tanzania,1,6,,7,POINT (4697157 -74140516)
2018,Julio,Togo,0,3,,3,POINT (4697157 -74140516)
2018,Julio,Togo,0,1,,1,POINT (7128047 -73181317)
2018,Julio,Trinidad y Tobago,3,0,,3,POINT (0.81488 -77356)
2018,Julio,Trinidad y Tobago,29,31,,60,POINT (10446304 -75516486)
2018,Julio,Trinidad y Tobago,73,96,,169,POINT (10886686 -74776479)
2018,Julio,Trinidad y Tobago,0,1,,1,POINT (125862 -81702165)
2018,Julio,Trinidad y Tobago,10,27,,37,POINT (3451668 -76532004)
2018,Julio,Trinidad y Tobago,53,107,,160,POINT (4697157 -74140516)
2018,Julio,Trinidad y Tobago,22,21,,43,POINT (6170465 -7542726)
2018,Julio,Trinidad y Tobago,1,1,,2,POINT (7128047 -73181317)
2018,Julio,Trinidad y Tobago,0,1,,1,POINT (7819 -72453013)
2018,Julio,Túnez,0,1,,1,POINT (0.81488 -77356)
2018,Julio,Túnez,5,10,,15,POINT (4697157 -74140516)
2018,Julio,Túnez,0,2,,2,POINT (6170465 -7542726)
2018,Julio,Turquía,0,3,,3,POINT (0.81488 -77356)
2018,Julio,Turquía,0,1,,1,POINT (10406342 -75527794)
2018,Julio,Turquía,5,8,,13,POINT (10446304 -75516486)
2018,Julio,Turquía,0,1,,1,POINT (11360029 -72129595)
2018,Julio,Turquía,0,1,,1,POINT (12165168 -71983761)
2018,Julio,Turquía,1,6,,7,POINT (3451668 -76532004)
2018,Julio,Turquía,150,246,,396,POINT (4697157 -74140516)
2018,Julio,Turquía,7,20,,27,POINT (6170465 -7542726)
2018,Julio,Turquía,0,1,,1,POINT (7819 -72453013)
2018,Julio,Ucrania,1,0,,1,POINT (0.81488 -77356)
2018,Julio,Ucrania,0,6,,6,POINT (10406342 -75527794)
2018,Julio,Ucrania,5,2,,7,POINT (10446304 -75516486)
2018,Julio,Ucrania,0,8,,8,POINT (10886686 -74776479)
2018,Julio,Ucrania,0,6,,6,POINT (10970933 -74765343)
2018,Julio,Ucrania,0,1,,1,POINT (11247723 -74213989)
2018,Julio,Ucrania,6,2,,8,POINT (3451668 -76532004)
2018,Julio,Ucrania,0,1,,1,POINT (3884426 -77061029)
2018,Julio,Ucrania,24,27,,51,POINT (4697157 -74140516)
2018,Julio,Ucrania,1,3,,4,POINT (6170465 -7542726)
2018,Julio,Ucrania,0,2,,2,POINT (9402597 -75681642)
2018,Julio,Uganda,1,4,,5,POINT (4697157 -74140516)
2018,Julio,Uruguay,0,2,,2,POINT (-4191162 -69941498)
2018,Julio,Uruguay,0,3,,3,POINT (0.33002 -76876446)
2018,Julio,Uruguay,0,1,,1,POINT (0.812436 -77847006)
2018,Julio,Uruguay,5,7,,12,POINT (0.81488 -77356)
2018,Julio,Uruguay,18,14,,32,POINT (10406342 -75527794)
2018,Julio,Uruguay,117,106,,223,POINT (10446304 -75516486)
2018,Julio,Uruguay,1,7,,8,POINT (10886686 -74776479)
2018,Julio,Uruguay,0,1,,1,POINT (11360029 -72129595)
2018,Julio,Uruguay,17,19,,36,POINT (125862 -81702165)
2018,Julio,Uruguay,8,22,,30,POINT (3451668 -76532004)
2018,Julio,Uruguay,518,567,,1085,POINT (4697157 -74140516)
2018,Julio,Uruguay,1,4,,5,POINT (4815189 -75736374)
2018,Julio,Uruguay,43,53,,96,POINT (6170465 -7542726)
2018,Julio,Uruguay,1,10,,11,POINT (7819 -72453013)
2018,Julio,Uruguay,0,1,,1,POINT (863337 -7735002)
2018,Julio,Uzbekistán,0,1,,1,POINT (10446304 -75516486)
2018,Julio,Uzbekistán,1,1,,2,POINT (4697157 -74140516)
2018,Julio,Venezuela,0,1,,1,POINT (-4191162 -69941498)
2018,Julio,Venezuela,4,0,,4,POINT (-4214082 -69941431)
2018,Julio,Venezuela,0,1,,1,POINT (0.185957 -7478366)
2018,Julio,Venezuela,64,65,,129,POINT (0.33002 -76876446)
2018,Julio,Venezuela,2566,3150,,5716,POINT (0.81488 -77356)
2018,Julio,Venezuela,3,5,,8,POINT (1800143 -78802679)
2018,Julio,Venezuela,13,13,,26,POINT (10406342 -75527794)
2018,Julio,Venezuela,276,361,,637,POINT (10446304 -75516486)
2018,Julio,Venezuela,306,586,,892,POINT (10886686 -74776479)
2018,Julio,Venezuela,1,3,,4,POINT (11117206 -74232675)
2018,Julio,Venezuela,1,0,,1,POINT (11247723 -74213989)
2018,Julio,Venezuela,8805,8320,,17125,POINT (11360029 -72129595)
2018,Julio,Venezuela,0,15,,15,POINT (12165168 -71983761)
2018,Julio,Venezuela,10,5,,15,POINT (125862 -81702165)
2018,Julio,Venezuela,146,175,,321,POINT (3451668 -76532004)
2018,Julio,Venezuela,14,12,,26,POINT (3866713 -67927521)
2018,Julio,Venezuela,1,0,,1,POINT (445285 -75766353)
2018,Julio,Venezuela,5395,5389,,10784,POINT (4697157 -74140516)
2018,Julio,Venezuela,9,16,,25,POINT (4815189 -75736374)
2018,Julio,Venezuela,871,896,,1767,POINT (6170465 -7542726)
2018,Julio,Venezuela,44,31,,75,POINT (6185536 -67484028)
2018,Julio,Venezuela,3,4,,7,POINT (6218835 -75586989)
2018,Julio,Venezuela,1139,1266,,2405,POINT (7088729 -70740253)
2018,Julio,Venezuela,12,7,,19,POINT (7128047 -73181317)
2018,Julio,Venezuela,36362,36633,,72995,POINT (7819 -72453013)
2018,Julio,Venezuela,1,3,,4,POINT (7927233 -72508188)
2018,Julio,Venezuela,3675,3143,,6818,POINT (836068 -72409396)
2018,Julio,Vietnam,2,0,,2,POINT (0.81488 -77356)
2018,Julio,Vietnam,0,1,,1,POINT (10446304 -75516486)
2018,Julio,Vietnam,1,2,,3,POINT (3451668 -76532004)
2018,Julio,Vietnam,8,6,,14,POINT (4697157 -74140516)
2018,Julio,Vietnam,1,0,,1,POINT (863337 -7735002)
2018,Julio,Islas Vírgenes Británicas/Territorio Británico de Ultramar,1,0,,1,POINT (10886686 -74776479)
2018,Julio,Islas Vírgenes Británicas/Territorio Británico de Ultramar,0,1,,1,POINT (4697157 -74140516)
2018,Julio,República Árabe de Yemen,0,2,,2,POINT (4697157 -74140516)
2018,Julio,Zimbabue,3,4,,7,POINT (4697157 -74140516)
2018,Julio,Zimbabue,1,0,,1,POINT (6170465 -7542726)
2018,Julio,Islas Turcas y Caicos/Territorio Británico de Ultramar,1,5,,6,POINT (10446304 -75516486)
2018,Julio,Islas Turcas y Caicos/Territorio Británico de Ultramar,1,0,,1,POINT (10886686 -74776479)
2018,Julio,Refugiado,1,0,,1,POINT (3451668 -76532004)
2018,Julio,Refugiado,0,3,,3,POINT (4697157 -74140516)
2018,Julio,Desconocido,0,1,,1,POINT (0.81488 -77356)
2018,Julio,Desconocido,1,3,,4,POINT (10446304 -75516486)
2018,Julio,Desconocido,1,0,,1,POINT (3451668 -76532004)
2018,Julio,Desconocido,81,150,,231,POINT (4697157 -74140516)
2018,Julio,Desconocido,0,4,,4,POINT (6170465 -7542726)
2018,Julio,Desconocido,0,1,,1,POINT (7819 -72453013)
2018,Julio,República CentroÁfricana,0,1,,1,POINT (3451668 -76532004)
2018,Agosto,Albania,0,2,,2,POINT (0.81488 -77356)
2018,Agosto,Albania,1,4,,5,POINT (4697157 -74140516)
2018,Agosto,Alemania,14,12,,26,POINT (-4191162 -69941498)
2018,Agosto,Alemania,7,7,,14,POINT (-4214082 -69941431)
2018,Agosto,Alemania,0,1,,1,POINT (0.185957 -7478366)
2018,Agosto,Alemania,4,9,,13,POINT (0.33002 -76876446)
2018,Agosto,Alemania,82,69,,151,POINT (0.81488 -77356)
2018,Agosto,Alemania,44,36,,80,POINT (10406342 -75527794)
2018,Agosto,Alemania,170,202,,372,POINT (10446304 -75516486)
2018,Agosto,Alemania,23,34,,57,POINT (10886686 -74776479)
2018,Agosto,Alemania,3,3,,6,POINT (11117206 -74232675)
2018,Agosto,Alemania,3,3,,6,POINT (11247723 -74213989)
2018,Agosto,Alemania,1,0,,1,POINT (11360029 -72129595)
2018,Agosto,Alemania,4,2,,6,POINT (125862 -81702165)
2018,Agosto,Alemania,4,4,,8,POINT (133387613 -81372937)
2018,Agosto,Alemania,78,80,,158,POINT (3451668 -76532004)
2018,Agosto,Alemania,2487,3007,,5494,POINT (4697157 -74140516)
2018,Agosto,Alemania,6,1,,7,POINT (4815189 -75736374)
2018,Agosto,Alemania,161,267,,428,POINT (6170465 -7542726)
2018,Agosto,Alemania,2,1,,3,POINT (7128047 -73181317)
2018,Agosto,Alemania,4,6,,10,POINT (7819 -72453013)
2018,Agosto,Alemania,1,0,,1,POINT (836068 -72409396)
2018,Agosto,Alemania,17,13,,30,POINT (863337 -7735002)
2018,Agosto,Andorra,1,1,,2,POINT (3451668 -76532004)
2018,Agosto,Andorra,3,7,,10,POINT (4697157 -74140516)
2018,Agosto,Angola,1,0,,1,POINT (4697157 -74140516)
2018,Agosto,Antigua y Barbuda,1,2,,3,POINT (10886686 -74776479)
2018,Agosto,Antigua y Barbuda,0,4,,4,POINT (4697157 -74140516)
2018,Agosto,Arabia Saudita,0,5,,5,POINT (10446304 -75516486)
2018,Agosto,Arabia Saudita,0,15,,15,POINT (4697157 -74140516)
2018,Agosto,Arabia Saudita,0,2,,2,POINT (6170465 -7542726)
2018,Agosto,Argelia,10,5,,15,POINT (4697157 -74140516)
2018,Agosto,Argelia,1,0,,1,POINT (6170465 -7542726)
2018,Agosto,Argentina,4,8,,12,POINT (-4191162 -69941498)
2018,Agosto,Argentina,1,6,,7,POINT (-4214082 -69941431)
2018,Agosto,Argentina,3,9,,12,POINT (0.33002 -76876446)
2018,Agosto,Argentina,0,1,,1,POINT (0.812436 -77847006)
2018,Agosto,Argentina,61,121,,182,POINT (0.81488 -77356)
2018,Agosto,Argentina,0,2,,2,POINT (1800143 -78802679)
2018,Agosto,Argentina,178,116,,294,POINT (10406342 -75527794)
2018,Agosto,Argentina,1663,1377,,3040,POINT (10446304 -75516486)
2018,Agosto,Argentina,21,56,,77,POINT (10886686 -74776479)
2018,Agosto,Argentina,0,2,,2,POINT (11117206 -74232675)
2018,Agosto,Argentina,8,8,,16,POINT (11360029 -72129595)
2018,Agosto,Argentina,343,276,,619,POINT (125862 -81702165)
2018,Agosto,Argentina,1,2,,3,POINT (133387613 -81372937)
2018,Agosto,Argentina,43,90,,133,POINT (3451668 -76532004)
2018,Agosto,Argentina,0,2,,2,POINT (445285 -75766353)
2018,Agosto,Argentina,3779,5364,,9143,POINT (4697157 -74140516)
2018,Agosto,Argentina,9,9,,18,POINT (4815189 -75736374)
2018,Agosto,Argentina,224,503,,727,POINT (6170465 -7542726)
2018,Agosto,Argentina,4,4,,8,POINT (7128047 -73181317)
2018,Agosto,Argentina,5,17,,22,POINT (7819 -72453013)
2018,Agosto,Argentina,21,24,,45,POINT (836068 -72409396)
2018,Agosto,República de Armenia,2,1,,3,POINT (4697157 -74140516)
2018,Agosto,Australia,6,1,,7,POINT (-4191162 -69941498)
2018,Agosto,Australia,0,1,,1,POINT (-4214082 -69941431)
2018,Agosto,Australia,0,1,,1,POINT (0.33002 -76876446)
2018,Agosto,Australia,21,35,,56,POINT (0.81488 -77356)
2018,Agosto,Australia,13,20,,33,POINT (10406342 -75527794)
2018,Agosto,Australia,67,77,,144,POINT (10446304 -75516486)
2018,Agosto,Australia,7,14,,21,POINT (10886686 -74776479)
2018,Agosto,Australia,0,1,,1,POINT (11247723 -74213989)
2018,Agosto,Australia,9,14,,23,POINT (3451668 -76532004)
2018,Agosto,Australia,0,2,,2,POINT (445285 -75766353)
2018,Agosto,Australia,287,577,,864,POINT (4697157 -74140516)
2018,Agosto,Australia,1,3,,4,POINT (4815189 -75736374)
2018,Agosto,Australia,44,104,,148,POINT (6170465 -7542726)
2018,Agosto,Australia,0,1,,1,POINT (7128047 -73181317)
2018,Agosto,Australia,0,1,,1,POINT (7819 -72453013)
2018,Agosto,Australia,10,9,,19,POINT (863337 -7735002)
2018,Agosto,Austria,0,4,,4,POINT (-4191162 -69941498)
2018,Agosto,Austria,0,3,,3,POINT (0.33002 -76876446)
2018,Agosto,Austria,12,11,,23,POINT (0.81488 -77356)
2018,Agosto,Austria,4,3,,7,POINT (10406342 -75527794)
2018,Agosto,Austria,22,13,,35,POINT (10446304 -75516486)
2018,Agosto,Austria,3,5,,8,POINT (10886686 -74776479)
2018,Agosto,Austria,0,2,,2,POINT (10970933 -74765343)
2018,Agosto,Austria,1,1,,2,POINT (133387613 -81372937)
2018,Agosto,Austria,6,10,,16,POINT (3451668 -76532004)
2018,Agosto,Austria,226,292,,518,POINT (4697157 -74140516)
2018,Agosto,Austria,13,31,,44,POINT (6170465 -7542726)
2018,Agosto,Austria,6,6,,12,POINT (863337 -7735002)
2018,Agosto,Azerbaiyán,1,7,,8,POINT (4697157 -74140516)
2018,Agosto,Bahamas,1,0,,1,POINT (10446304 -75516486)
2018,Agosto,Bahamas,4,1,,5,POINT (3451668 -76532004)
2018,Agosto,Bahamas,4,18,,22,POINT (4697157 -74140516)
2018,Agosto,Bahamas,3,8,,11,POINT (6170465 -7542726)
2018,Agosto,Bahréin,1,0,,1,POINT (4697157 -74140516)
2018,Agosto,Bangladesh,1,0,,1,POINT (10446304 -75516486)
2018,Agosto,Bangladesh,2,5,,7,POINT (4697157 -74140516)
2018,Agosto,Bangladesh,0,1,,1,POINT (6170465 -7542726)
2018,Agosto,Barbados,6,0,,6,POINT (10446304 -75516486)
2018,Agosto,Barbados,0,2,,2,POINT (3451668 -76532004)
2018,Agosto,Barbados,5,7,,12,POINT (4697157 -74140516)
2018,Agosto,Barbados,3,5,,8,POINT (6170465 -7542726)
2018,Agosto,República de Belarús,1,1,,2,POINT (10446304 -75516486)
2018,Agosto,República de Belarús,6,1,,7,POINT (4697157 -74140516)
2018,Agosto,Bélgica,4,2,,6,POINT (-4191162 -69941498)
2018,Agosto,Bélgica,2,2,,4,POINT (-4214082 -69941431)
2018,Agosto,Bélgica,0,5,,5,POINT (0.33002 -76876446)
2018,Agosto,Bélgica,12,18,,30,POINT (0.81488 -77356)
2018,Agosto,Bélgica,2,5,,7,POINT (10406342 -75527794)
2018,Agosto,Bélgica,21,34,,55,POINT (10446304 -75516486)
2018,Agosto,Bélgica,3,3,,6,POINT (10886686 -74776479)
2018,Agosto,Bélgica,0,1,,1,POINT (11360029 -72129595)
2018,Agosto,Bélgica,0,2,,2,POINT (125862 -81702165)
2018,Agosto,Bélgica,25,17,,42,POINT (3451668 -76532004)
2018,Agosto,Bélgica,421,524,,945,POINT (4697157 -74140516)
2018,Agosto,Bélgica,3,3,,6,POINT (4815189 -75736374)
2018,Agosto,Bélgica,32,55,,87,POINT (6170465 -7542726)
2018,Agosto,Bélgica,0,2,,2,POINT (7128047 -73181317)
2018,Agosto,Bélgica,5,4,,9,POINT (863337 -7735002)
2018,Agosto,Belice,0,1,,1,POINT (0.81488 -77356)
2018,Agosto,Belice,4,4,,8,POINT (10446304 -75516486)
2018,Agosto,Belice,4,20,,24,POINT (4697157 -74140516)
2018,Agosto,Belice,1,1,,2,POINT (6170465 -7542726)
2018,Agosto,Benín,2,1,,3,POINT (4697157 -74140516)
2018,Agosto,Bermudas/Territorio Británico de Ultramar,1,0,,1,POINT (10446304 -75516486)
2018,Agosto,Bermudas/Territorio Británico de Ultramar,0,3,,3,POINT (3451668 -76532004)
2018,Agosto,Bermudas/Territorio Británico de Ultramar,0,1,,1,POINT (4697157 -74140516)
2018,Agosto,Bermudas/Territorio Británico de Ultramar,0,2,,2,POINT (6170465 -7542726)
2018,Agosto,Bolivia,0,1,,1,POINT (-4191162 -69941498)
2018,Agosto,Bolivia,11,14,,25,POINT (0.81488 -77356)
2018,Agosto,Bolivia,14,11,,25,POINT (10406342 -75527794)
2018,Agosto,Bolivia,144,123,,267,POINT (10446304 -75516486)
2018,Agosto,Bolivia,2,3,,5,POINT (10886686 -74776479)
2018,Agosto,Bolivia,18,11,,29,POINT (125862 -81702165)
2018,Agosto,Bolivia,15,20,,35,POINT (3451668 -76532004)
2018,Agosto,Bolivia,643,662,,1305,POINT (4697157 -74140516)
2018,Agosto,Bolivia,49,58,,107,POINT (6170465 -7542726)
2018,Agosto,Bolivia,5,6,,11,POINT (7819 -72453013)
2018,Agosto,Bolivia,1,2,,3,POINT (836068 -72409396)
2018,Agosto,Bosnia y Herzegovina,0,1,,1,POINT (10446304 -75516486)
2018,Agosto,Bosnia y Herzegovina,3,7,,10,POINT (4697157 -74140516)
2018,Agosto,Brasil,107,87,,194,POINT (-4191162 -69941498)
2018,Agosto,Brasil,1,0,,1,POINT (-4214082 -69941431)
2018,Agosto,Brasil,2,2,,4,POINT (0.33002 -76876446)
2018,Agosto,Brasil,17,37,,54,POINT (0.81488 -77356)
2018,Agosto,Brasil,377,412,,789,POINT (10406342 -75527794)
2018,Agosto,Brasil,999,707,,1706,POINT (10446304 -75516486)
2018,Agosto,Brasil,16,35,,51,POINT (10886686 -74776479)
2018,Agosto,Brasil,3,3,,6,POINT (11360029 -72129595)
2018,Agosto,Brasil,363,279,,642,POINT (125862 -81702165)
2018,Agosto,Brasil,45,73,,118,POINT (3451668 -76532004)
2018,Agosto,Brasil,0,2,,2,POINT (3866713 -67927521)
2018,Agosto,Brasil,1,5,,6,POINT (4253669 -74642361)
2018,Agosto,Brasil,1,0,,1,POINT (445285 -75766353)
2018,Agosto,Brasil,5677,6729,,12406,POINT (4697157 -74140516)
2018,Agosto,Brasil,4,7,,11,POINT (4815189 -75736374)
2018,Agosto,Brasil,140,251,,391,POINT (6170465 -7542726)
2018,Agosto,Brasil,1,1,,2,POINT (6185536 -67484028)
2018,Agosto,Brasil,0,1,,1,POINT (7128047 -73181317)
2018,Agosto,Brasil,8,12,,20,POINT (7819 -72453013)
2018,Agosto,Brasil,9,12,,21,POINT (836068 -72409396)
2018,Agosto,Brasil,0,2,,2,POINT (863337 -7735002)
2018,Agosto,Bulgaria,0,4,,4,POINT (10446304 -75516486)
2018,Agosto,Bulgaria,0,6,,6,POINT (10886686 -74776479)
2018,Agosto,Bulgaria,0,4,,4,POINT (10970933 -74765343)
2018,Agosto,Bulgaria,1,2,,3,POINT (3451668 -76532004)
2018,Agosto,Bulgaria,35,19,,54,POINT (4697157 -74140516)
2018,Agosto,Bulgaria,6,8,,14,POINT (6170465 -7542726)
2018,Agosto,Bután,0,1,,1,POINT (3451668 -76532004)
2018,Agosto,Cabo Verde,1,0,,1,POINT (10446304 -75516486)
2018,Agosto,Cabo Verde,0,1,,1,POINT (7128047 -73181317)
2018,Agosto,Islas Caimán/Territorio Británico de Ultramar,0,1,,1,POINT (125862 -81702165)
2018,Agosto,Islas Caimán/Territorio Británico de Ultramar,1,0,,1,POINT (4697157 -74140516)
2018,Agosto,Camboya,1,0,,1,POINT (4697157 -74140516)
2018,Agosto,Camerún,2,4,,6,POINT (4697157 -74140516)
2018,Agosto,Canadá,2,4,,6,POINT (-4191162 -69941498)
2018,Agosto,Canadá,0,2,,2,POINT (-4214082 -69941431)
2018,Agosto,Canadá,0,2,,2,POINT (0.33002 -76876446)
2018,Agosto,Canadá,4,13,,17,POINT (0.81488 -77356)
2018,Agosto,Canadá,10,8,,18,POINT (10406342 -75527794)
2018,Agosto,Canadá,181,242,,423,POINT (10446304 -75516486)
2018,Agosto,Canadá,25,49,,74,POINT (10886686 -74776479)
2018,Agosto,Canadá,1,1,,2,POINT (11247723 -74213989)
2018,Agosto,Canadá,0,2,,2,POINT (11360029 -72129595)
2018,Agosto,Canadá,1,0,,1,POINT (125862 -81702165)
2018,Agosto,Canadá,49,69,,118,POINT (3451668 -76532004)
2018,Agosto,Canadá,4,4,,8,POINT (445285 -75766353)
2018,Agosto,Canadá,1119,1750,,2869,POINT (4697157 -74140516)
2018,Agosto,Canadá,7,9,,16,POINT (4815189 -75736374)
2018,Agosto,Canadá,227,412,,639,POINT (6170465 -7542726)
2018,Agosto,Canadá,4,6,,10,POINT (7128047 -73181317)
2018,Agosto,Canadá,1,2,,3,POINT (7819 -72453013)
2018,Agosto,Canadá,0,6,,6,POINT (863337 -7735002)
2018,Agosto,República Democrática del Congo,6,17,,23,POINT (4697157 -74140516)
2018,Agosto,República Democrática del Congo,1,0,,1,POINT (6170465 -7542726)
2018,Agosto,República de Corea,0,2,,2,POINT (-4191162 -69941498)
2018,Agosto,República de Corea,0,1,,1,POINT (-4214082 -69941431)
2018,Agosto,República de Corea,11,8,,19,POINT (0.81488 -77356)
2018,Agosto,República de Corea,0,1,,1,POINT (10406342 -75527794)
2018,Agosto,República de Corea,7,11,,18,POINT (10446304 -75516486)
2018,Agosto,República de Corea,0,2,,2,POINT (10886686 -74776479)
2018,Agosto,República de Corea,1,3,,4,POINT (11360029 -72129595)
2018,Agosto,República de Corea,3,7,,10,POINT (3451668 -76532004)
2018,Agosto,República de Corea,0,2,,2,POINT (3884426 -77061029)
2018,Agosto,República de Corea,252,458,,710,POINT (4697157 -74140516)
2018,Agosto,República de Corea,1,0,,1,POINT (4815189 -75736374)
2018,Agosto,República de Corea,15,34,,49,POINT (6170465 -7542726)
2018,Agosto,República de Corea,0,1,,1,POINT (7819 -72453013)
2018,Agosto,República de Corea,1,0,,1,POINT (836068 -72409396)
2018,Agosto,Costa de Marfil,2,8,,10,POINT (4697157 -74140516)
2018,Agosto,Costa Rica,0,2,,2,POINT (0.81488 -77356)
2018,Agosto,Costa Rica,1,0,,1,POINT (10406342 -75527794)
2018,Agosto,Costa Rica,161,109,,270,POINT (10446304 -75516486)
2018,Agosto,Costa Rica,11,22,,33,POINT (10886686 -74776479)
2018,Agosto,Costa Rica,0,4,,4,POINT (11117206 -74232675)
2018,Agosto,Costa Rica,0,2,,2,POINT (11360029 -72129595)
2018,Agosto,Costa Rica,24,21,,45,POINT (125862 -81702165)
2018,Agosto,Costa Rica,23,62,,85,POINT (3451668 -76532004)
2018,Agosto,Costa Rica,1251,1537,,2788,POINT (4697157 -74140516)
2018,Agosto,Costa Rica,5,10,,15,POINT (4815189 -75736374)
2018,Agosto,Costa Rica,163,231,,394,POINT (6170465 -7542726)
2018,Agosto,Costa Rica,0,1,,1,POINT (7102626 -77762647)
2018,Agosto,Costa Rica,1,5,,6,POINT (7128047 -73181317)
2018,Agosto,Costa Rica,3,3,,6,POINT (7819 -72453013)
2018,Agosto,Costa Rica,0,2,,2,POINT (836068 -72409396)
2018,Agosto,Costa Rica,0,2,,2,POINT (863337 -7735002)
2018,Agosto,Croacia,0,1,,1,POINT (10406342 -75527794)
2018,Agosto,Croacia,3,4,,7,POINT (10446304 -75516486)
2018,Agosto,Croacia,0,1,,1,POINT (10886686 -74776479)
2018,Agosto,Croacia,0,1,,1,POINT (11247723 -74213989)
2018,Agosto,Croacia,1,1,,2,POINT (3451668 -76532004)
2018,Agosto,Croacia,18,36,,54,POINT (4697157 -74140516)
2018,Agosto,Croacia,3,7,,10,POINT (6170465 -7542726)
2018,Agosto,Cuba,0,2,,2,POINT (0.33002 -76876446)
2018,Agosto,Cuba,0,4,,4,POINT (0.81488 -77356)
2018,Agosto,Cuba,2,1,,3,POINT (10406342 -75527794)
2018,Agosto,Cuba,11,15,,26,POINT (10446304 -75516486)
2018,Agosto,Cuba,12,26,,38,POINT (10886686 -74776479)
2018,Agosto,Cuba,2,1,,3,POINT (125862 -81702165)
2018,Agosto,Cuba,14,20,,34,POINT (3451668 -76532004)
2018,Agosto,Cuba,1,1,,2,POINT (445285 -75766353)
2018,Agosto,Cuba,225,300,,525,POINT (4697157 -74140516)
2018,Agosto,Cuba,2,7,,9,POINT (4815189 -75736374)
2018,Agosto,Cuba,41,37,,78,POINT (6170465 -7542726)
2018,Agosto,Cuba,0,1,,1,POINT (6185536 -67484028)
2018,Agosto,Cuba,0,1,,1,POINT (7088729 -70740253)
2018,Agosto,Cuba,1,3,,4,POINT (7128047 -73181317)
2018,Agosto,Cuba,1,1,,2,POINT (7819 -72453013)
2018,Agosto,República Checa,1,1,,2,POINT (-4214082 -69941431)
2018,Agosto,República Checa,4,7,,11,POINT (0.81488 -77356)
2018,Agosto,República Checa,2,3,,5,POINT (10446304 -75516486)
2018,Agosto,República Checa,0,1,,1,POINT (11360029 -72129595)
2018,Agosto,República Checa,6,1,,7,POINT (3451668 -76532004)
2018,Agosto,República Checa,45,58,,103,POINT (4697157 -74140516)
2018,Agosto,República Checa,11,3,,14,POINT (6170465 -7542726)
2018,Agosto,Chile,1,1,,2,POINT (-4191162 -69941498)
2018,Agosto,Chile,5,1,,6,POINT (-4214082 -69941431)
2018,Agosto,Chile,4,3,,7,POINT (0.33002 -76876446)
2018,Agosto,Chile,29,46,,75,POINT (0.81488 -77356)
2018,Agosto,Chile,1,2,,3,POINT (1800143 -78802679)
2018,Agosto,Chile,194,134,,328,POINT (10406342 -75527794)
2018,Agosto,Chile,550,366,,916,POINT (10446304 -75516486)
2018,Agosto,Chile,8,12,,20,POINT (10886686 -74776479)
2018,Agosto,Chile,4,12,,16,POINT (11360029 -72129595)
2018,Agosto,Chile,175,110,,285,POINT (125862 -81702165)
2018,Agosto,Chile,19,58,,77,POINT (3451668 -76532004)
2018,Agosto,Chile,1,1,,2,POINT (445285 -75766353)
2018,Agosto,Chile,4866,5870,,10736,POINT (4697157 -74140516)
2018,Agosto,Chile,5,7,,12,POINT (4815189 -75736374)
2018,Agosto,Chile,67,159,,226,POINT (6170465 -7542726)
2018,Agosto,Chile,1,0,,1,POINT (6185536 -67484028)
2018,Agosto,Chile,0,1,,1,POINT (7128047 -73181317)
2018,Agosto,Chile,10,34,,44,POINT (7819 -72453013)
2018,Agosto,Chile,15,15,,30,POINT (836068 -72409396)
2018,Agosto,Chile,1,1,,2,POINT (863337 -7735002)
2018,Agosto,China,1,1,,2,POINT (-4191162 -69941498)
2018,Agosto,China,1,0,,1,POINT (-4214082 -69941431)
2018,Agosto,China,3,7,,10,POINT (0.81488 -77356)
2018,Agosto,China,2,1,,3,POINT (10406342 -75527794)
2018,Agosto,China,24,20,,44,POINT (10446304 -75516486)
2018,Agosto,China,2,21,,23,POINT (10886686 -74776479)
2018,Agosto,China,0,13,,13,POINT (10970933 -74765343)
2018,Agosto,China,0,1,,1,POINT (11360029 -72129595)
2018,Agosto,China,11,20,,31,POINT (3451668 -76532004)
2018,Agosto,China,0,1,,1,POINT (3884426 -77061029)
2018,Agosto,China,1,0,,1,POINT (445285 -75766353)
2018,Agosto,China,393,843,,1236,POINT (4697157 -74140516)
2018,Agosto,China,40,68,,108,POINT (6170465 -7542726)
2018,Agosto,China,0,1,,1,POINT (7128047 -73181317)
2018,Agosto,China,2,7,,9,POINT (7819 -72453013)
2018,Agosto,China,0,5,,5,POINT (836068 -72409396)
2018,Agosto,China,1,0,,1,POINT (863337 -7735002)
2018,Agosto,Taiwán,0,1,,1,POINT (-4191162 -69941498)
2018,Agosto,Taiwán,3,3,,6,POINT (0.81488 -77356)
2018,Agosto,Taiwán,4,2,,6,POINT (10446304 -75516486)
2018,Agosto,Taiwán,3,2,,5,POINT (3451668 -76532004)
2018,Agosto,Taiwán,57,66,,123,POINT (4697157 -74140516)
2018,Agosto,Taiwán,2,6,,8,POINT (6170465 -7542726)
2018,Agosto,Taiwán,1,0,,1,POINT (7819 -72453013)
2018,Agosto,Taiwán,0,1,,1,POINT (836068 -72409396)
2018,Agosto,Taiwán,1,0,,1,POINT (863337 -7735002)
2018,Agosto,Chipre,4,3,,7,POINT (10446304 -75516486)
2018,Agosto,Chipre,1,3,,4,POINT (3451668 -76532004)
2018,Agosto,Chipre,6,7,,13,POINT (4697157 -74140516)
2018,Agosto,Chipre,2,2,,4,POINT (6170465 -7542726)
2018,Agosto,Dinamarca,1,1,,2,POINT (-4191162 -69941498)
2018,Agosto,Dinamarca,1,0,,1,POINT (0.33002 -76876446)
2018,Agosto,Dinamarca,5,2,,7,POINT (0.81488 -77356)
2018,Agosto,Dinamarca,1,0,,1,POINT (10406342 -75527794)
2018,Agosto,Dinamarca,15,24,,39,POINT (10446304 -75516486)
2018,Agosto,Dinamarca,0,6,,6,POINT (10886686 -74776479)
2018,Agosto,Dinamarca,1,13,,14,POINT (3451668 -76532004)
2018,Agosto,Dinamarca,87,142,,229,POINT (4697157 -74140516)
2018,Agosto,Dinamarca,0,1,,1,POINT (4815189 -75736374)
2018,Agosto,Dinamarca,6,15,,21,POINT (6170465 -7542726)
2018,Agosto,Dinamarca,0,1,,1,POINT (7128047 -73181317)
2018,Agosto,Dominica,0,3,,3,POINT (3451668 -76532004)
2018,Agosto,Dominica,2,0,,2,POINT (4697157 -74140516)
2018,Agosto,Dominica,0,2,,2,POINT (6170465 -7542726)
2018,Agosto,Ecuador,1,2,,3,POINT (-4214082 -69941431)
2018,Agosto,Ecuador,103,263,,366,POINT (0.33002 -76876446)
2018,Agosto,Ecuador,32,27,,59,POINT (0.812436 -77847006)
2018,Agosto,Ecuador,2533,2986,,5519,POINT (0.81488 -77356)
2018,Agosto,Ecuador,8,141,,149,POINT (1800143 -78802679)
2018,Agosto,Ecuador,46,97,,143,POINT (10406342 -75527794)
2018,Agosto,Ecuador,876,736,,1612,POINT (10446304 -75516486)
2018,Agosto,Ecuador,15,22,,37,POINT (10886686 -74776479)
2018,Agosto,Ecuador,8,8,,16,POINT (11360029 -72129595)
2018,Agosto,Ecuador,23,17,,40,POINT (125862 -81702165)
2018,Agosto,Ecuador,755,801,,1556,POINT (3451668 -76532004)
2018,Agosto,Ecuador,0,2,,2,POINT (3866713 -67927521)
2018,Agosto,Ecuador,1,4,,5,POINT (445285 -75766353)
2018,Agosto,Ecuador,4769,5253,,10022,POINT (4697157 -74140516)
2018,Agosto,Ecuador,1,7,,8,POINT (4815189 -75736374)
2018,Agosto,Ecuador,90,118,,208,POINT (6170465 -7542726)
2018,Agosto,Ecuador,0,3,,3,POINT (7088729 -70740253)
2018,Agosto,Ecuador,190,224,,414,POINT (7819 -72453013)
2018,Agosto,Ecuador,19,30,,49,POINT (836068 -72409396)
2018,Agosto,Ecuador,1,6,,7,POINT (863337 -7735002)
2018,Agosto,Egipto,1,2,,3,POINT (0.81488 -77356)
2018,Agosto,Egipto,0,1,,1,POINT (10406342 -75527794)
2018,Agosto,Egipto,0,3,,3,POINT (10446304 -75516486)
2018,Agosto,Egipto,0,1,,1,POINT (445285 -75766353)
2018,Agosto,Egipto,4,22,,26,POINT (4697157 -74140516)
2018,Agosto,Egipto,0,1,,1,POINT (6170465 -7542726)
2018,Agosto,Egipto,0,1,,1,POINT (7128047 -73181317)
2018,Agosto,El Salvador,2,0,,2,POINT (0.33002 -76876446)
2018,Agosto,El Salvador,0,2,,2,POINT (0.81488 -77356)
2018,Agosto,El Salvador,0,2,,2,POINT (10406342 -75527794)
2018,Agosto,El Salvador,90,76,,166,POINT (10446304 -75516486)
2018,Agosto,El Salvador,1,9,,10,POINT (10886686 -74776479)
2018,Agosto,El Salvador,1,0,,1,POINT (11360029 -72129595)
2018,Agosto,El Salvador,86,65,,151,POINT (125862 -81702165)
2018,Agosto,El Salvador,135,105,,240,POINT (3451668 -76532004)
2018,Agosto,El Salvador,751,879,,1630,POINT (4697157 -74140516)
2018,Agosto,El Salvador,2,2,,4,POINT (4815189 -75736374)
2018,Agosto,El Salvador,164,216,,380,POINT (6170465 -7542726)
2018,Agosto,El Salvador,0,5,,5,POINT (7819 -72453013)
2018,Agosto,El Salvador,0,1,,1,POINT (863337 -7735002)
2018,Agosto,Emiratos Árabes,0,2,,2,POINT (3451668 -76532004)
2018,Agosto,Emiratos Árabes,9,29,,38,POINT (4697157 -74140516)
2018,Agosto,Emiratos Árabes,5,2,,7,POINT (6170465 -7542726)
2018,Agosto,España,8,9,,17,POINT (-4191162 -69941498)
2018,Agosto,España,2,4,,6,POINT (-4214082 -69941431)
2018,Agosto,España,3,7,,10,POINT (0.33002 -76876446)
2018,Agosto,España,43,58,,101,POINT (0.81488 -77356)
2018,Agosto,España,0,1,,1,POINT (1800143 -78802679)
2018,Agosto,España,7,32,,39,POINT (10406342 -75527794)
2018,Agosto,España,163,276,,439,POINT (10446304 -75516486)
2018,Agosto,España,20,49,,69,POINT (10886686 -74776479)
2018,Agosto,España,0,2,,2,POINT (11117206 -74232675)
2018,Agosto,España,0,2,,2,POINT (11247723 -74213989)
2018,Agosto,España,3,10,,13,POINT (11360029 -72129595)
2018,Agosto,España,3,10,,13,POINT (125862 -81702165)
2018,Agosto,España,500,607,,1107,POINT (3451668 -76532004)
2018,Agosto,España,2,1,,3,POINT (445285 -75766353)
2018,Agosto,España,4861,6904,,11765,POINT (4697157 -74140516)
2018,Agosto,España,10,19,,29,POINT (4815189 -75736374)
2018,Agosto,España,733,1044,,1777,POINT (6170465 -7542726)
2018,Agosto,España,2,1,,3,POINT (7088729 -70740253)
2018,Agosto,España,3,5,,8,POINT (7128047 -73181317)
2018,Agosto,España,27,42,,69,POINT (7819 -72453013)
2018,Agosto,España,10,8,,18,POINT (836068 -72409396)
2018,Agosto,España,2,4,,6,POINT (863337 -7735002)
2018,Agosto,Eslovaquia,2,2,,4,POINT (-4191162 -69941498)
2018,Agosto,Eslovaquia,1,1,,2,POINT (0.81488 -77356)
2018,Agosto,Eslovaquia,3,3,,6,POINT (10446304 -75516486)
2018,Agosto,Eslovaquia,1,2,,3,POINT (3451668 -76532004)
2018,Agosto,Eslovaquia,28,26,,54,POINT (4697157 -74140516)
2018,Agosto,Eslovaquia,4,14,,18,POINT (6170465 -7542726)
2018,Agosto,Eslovenia,1,1,,2,POINT (0.81488 -77356)
2018,Agosto,Eslovenia,0,2,,2,POINT (3451668 -76532004)
2018,Agosto,Eslovenia,20,32,,52,POINT (4697157 -74140516)
2018,Agosto,Eslovenia,1,1,,2,POINT (6170465 -7542726)
2018,Agosto,Estados Unidos de América,16,46,,62,POINT (-4191162 -69941498)
2018,Agosto,Estados Unidos de América,1,2,,3,POINT (-4214082 -69941431)
2018,Agosto,Estados Unidos de América,0,1,,1,POINT (0.185957 -7478366)
2018,Agosto,Estados Unidos de América,1,4,,5,POINT (0.33002 -76876446)
2018,Agosto,Estados Unidos de América,58,70,,128,POINT (0.81488 -77356)
2018,Agosto,Estados Unidos de América,36,59,,95,POINT (10406342 -75527794)
2018,Agosto,Estados Unidos de América,5653,6953,,12606,POINT (10446304 -75516486)
2018,Agosto,Estados Unidos de América,696,1121,,1817,POINT (10886686 -74776479)
2018,Agosto,Estados Unidos de América,6,5,,11,POINT (11117206 -74232675)
2018,Agosto,Estados Unidos de América,8,33,,41,POINT (11247723 -74213989)
2018,Agosto,Estados Unidos de América,1,7,,8,POINT (11360029 -72129595)
2018,Agosto,Estados Unidos de América,2,4,,6,POINT (125744111 -81703935)
2018,Agosto,Estados Unidos de América,36,57,,93,POINT (125862 -81702165)
2018,Agosto,Estados Unidos de América,1,4,,5,POINT (133387613 -81372937)
2018,Agosto,Estados Unidos de América,1271,1693,,2964,POINT (3451668 -76532004)
2018,Agosto,Estados Unidos de América,191,281,,472,POINT (445285 -75766353)
2018,Agosto,Estados Unidos de América,10728,17331,,28059,POINT (4697157 -74140516)
2018,Agosto,Estados Unidos de América,211,313,,524,POINT (4815189 -75736374)
2018,Agosto,Estados Unidos de América,3628,8104,,11732,POINT (6170465 -7542726)
2018,Agosto,Estados Unidos de América,1,1,,2,POINT (6185536 -67484028)
2018,Agosto,Estados Unidos de América,0,2,,2,POINT (6222552 -77401154)
2018,Agosto,Estados Unidos de América,49,89,,138,POINT (7128047 -73181317)
2018,Agosto,Estados Unidos de América,21,12,,33,POINT (7819 -72453013)
2018,Agosto,Estados Unidos de América,0,1,,1,POINT (806667 -767333)
2018,Agosto,Estados Unidos de América,3,3,,6,POINT (836068 -72409396)
2018,Agosto,Estados Unidos de América,7,11,,18,POINT (863337 -7735002)
2018,Agosto,Estonia,1,1,,2,POINT (3451668 -76532004)
2018,Agosto,Estonia,1,6,,7,POINT (4697157 -74140516)
2018,Agosto,Estonia,2,4,,6,POINT (6170465 -7542726)
2018,Agosto,Estonia,1,0,,1,POINT (863337 -7735002)
2018,Agosto,Etiopia,3,13,,16,POINT (4697157 -74140516)
2018,Agosto,Filipinas,0,42,,42,POINT (10406342 -75527794)
2018,Agosto,Filipinas,9,49,,58,POINT (10446304 -75516486)
2018,Agosto,Filipinas,0,9,,9,POINT (10886686 -74776479)
2018,Agosto,Filipinas,0,21,,21,POINT (10970933 -74765343)
2018,Agosto,Filipinas,0,4,,4,POINT (11247723 -74213989)
2018,Agosto,Filipinas,6,9,,15,POINT (3451668 -76532004)
2018,Agosto,Filipinas,0,30,,30,POINT (3884426 -77061029)
2018,Agosto,Filipinas,51,48,,99,POINT (4697157 -74140516)
2018,Agosto,Filipinas,5,5,,10,POINT (6170465 -7542726)
2018,Agosto,Filipinas,1,0,,1,POINT (836068 -72409396)
2018,Agosto,Filipinas,0,1,,1,POINT (9402597 -75681642)
2018,Agosto,Finlandia,2,0,,2,POINT (-4214082 -69941431)
2018,Agosto,Finlandia,2,3,,5,POINT (0.81488 -77356)
2018,Agosto,Finlandia,5,6,,11,POINT (10446304 -75516486)
2018,Agosto,Finlandia,1,0,,1,POINT (10886686 -74776479)
2018,Agosto,Finlandia,6,1,,7,POINT (3451668 -76532004)
2018,Agosto,Finlandia,33,48,,81,POINT (4697157 -74140516)
2018,Agosto,Finlandia,2,9,,11,POINT (6170465 -7542726)
2018,Agosto,Francia,14,18,,32,POINT (-4191162 -69941498)
2018,Agosto,Francia,11,9,,20,POINT (-4214082 -69941431)
2018,Agosto,Francia,4,4,,8,POINT (0.33002 -76876446)
2018,Agosto,Francia,99,134,,233,POINT (0.81488 -77356)
2018,Agosto,Francia,16,20,,36,POINT (10406342 -75527794)
2018,Agosto,Francia,195,273,,468,POINT (10446304 -75516486)
2018,Agosto,Francia,23,30,,53,POINT (10886686 -74776479)
2018,Agosto,Francia,1,1,,2,POINT (11247723 -74213989)
2018,Agosto,Francia,3,4,,7,POINT (11360029 -72129595)
2018,Agosto,Francia,1,1,,2,POINT (125744111 -81703935)
2018,Agosto,Francia,3,5,,8,POINT (125862 -81702165)
2018,Agosto,Francia,2,4,,6,POINT (133387613 -81372937)
2018,Agosto,Francia,92,130,,222,POINT (3451668 -76532004)
2018,Agosto,Francia,0,5,,5,POINT (445285 -75766353)
2018,Agosto,Francia,2931,3908,,6839,POINT (4697157 -74140516)
2018,Agosto,Francia,18,17,,35,POINT (4815189 -75736374)
2018,Agosto,Francia,212,334,,546,POINT (6170465 -7542726)
2018,Agosto,Francia,2,3,,5,POINT (7128047 -73181317)
2018,Agosto,Francia,0,9,,9,POINT (7819 -72453013)
2018,Agosto,Francia,2,1,,3,POINT (836068 -72409396)
2018,Agosto,Francia,4,11,,15,POINT (863337 -7735002)
2018,Agosto,Georgia,8,5,,13,POINT (4697157 -74140516)
2018,Agosto,Ghana,0,3,,3,POINT (0.81488 -77356)
2018,Agosto,Ghana,0,1,,1,POINT (11360029 -72129595)
2018,Agosto,Ghana,2,3,,5,POINT (4697157 -74140516)
2018,Agosto,Ghana,0,1,,1,POINT (7819 -72453013)
2018,Agosto,Granada,1,1,,2,POINT (125862 -81702165)
2018,Agosto,Granada,2,4,,6,POINT (4697157 -74140516)
2018,Agosto,Grecia,0,1,,1,POINT (-4191162 -69941498)
2018,Agosto,Grecia,14,11,,25,POINT (0.81488 -77356)
2018,Agosto,Grecia,1,3,,4,POINT (10406342 -75527794)
2018,Agosto,Grecia,5,11,,16,POINT (10446304 -75516486)
2018,Agosto,Grecia,0,1,,1,POINT (10886686 -74776479)
2018,Agosto,Grecia,1,4,,5,POINT (3451668 -76532004)
2018,Agosto,Grecia,75,91,,166,POINT (4697157 -74140516)
2018,Agosto,Grecia,3,6,,9,POINT (6170465 -7542726)
2018,Agosto,Grecia,0,1,,1,POINT (836068 -72409396)
2018,Agosto,Grecia,0,2,,2,POINT (9402597 -75681642)
2018,Agosto,Guatemala,0,6,,6,POINT (0.81488 -77356)
2018,Agosto,Guatemala,0,1,,1,POINT (1800143 -78802679)
2018,Agosto,Guatemala,1,2,,3,POINT (10406342 -75527794)
2018,Agosto,Guatemala,102,103,,205,POINT (10446304 -75516486)
2018,Agosto,Guatemala,9,21,,30,POINT (10886686 -74776479)
2018,Agosto,Guatemala,5,1,,6,POINT (11360029 -72129595)
2018,Agosto,Guatemala,2,0,,2,POINT (125862 -81702165)
2018,Agosto,Guatemala,1,0,,1,POINT (133387613 -81372937)
2018,Agosto,Guatemala,18,63,,81,POINT (3451668 -76532004)
2018,Agosto,Guatemala,418,762,,1180,POINT (4697157 -74140516)
2018,Agosto,Guatemala,1,9,,10,POINT (4815189 -75736374)
2018,Agosto,Guatemala,106,210,,316,POINT (6170465 -7542726)
2018,Agosto,Guatemala,2,1,,3,POINT (7128047 -73181317)
2018,Agosto,Guatemala,0,4,,4,POINT (7819 -72453013)
2018,Agosto,Guatemala,2,0,,2,POINT (836068 -72409396)
2018,Agosto,Guatemala,0,1,,1,POINT (863337 -7735002)
2018,Agosto,Guyana,0,2,,2,POINT (10406342 -75527794)
2018,Agosto,Guyana,4,0,,4,POINT (10446304 -75516486)
2018,Agosto,Guyana,0,1,,1,POINT (10886686 -74776479)
2018,Agosto,Guyana,1,0,,1,POINT (3451668 -76532004)
2018,Agosto,Guyana,11,18,,29,POINT (4697157 -74140516)
2018,Agosto,Guyana,0,1,,1,POINT (4815189 -75736374)
2018,Agosto,Guyana,0,32,,32,POINT (6170465 -7542726)
2018,Agosto,Guyana,0,1,,1,POINT (7088729 -70740253)
2018,Agosto,Guyana,0,1,,1,POINT (7819 -72453013)
2018,Agosto,Guinea Ecuatorial,0,1,,1,POINT (4697157 -74140516)
2018,Agosto,Guinea Bissau,1,0,,1,POINT (0.81488 -77356)
2018,Agosto,Haití,0,1,,1,POINT (0.81488 -77356)
2018,Agosto,Haití,4,4,,8,POINT (10446304 -75516486)
2018,Agosto,Haití,1,0,,1,POINT (10886686 -74776479)
2018,Agosto,Haití,8,14,,22,POINT (4697157 -74140516)
2018,Agosto,Haití,1,2,,3,POINT (6170465 -7542726)
2018,Agosto,Honduras,1,3,,4,POINT (0.81488 -77356)
2018,Agosto,Honduras,1,11,,12,POINT (10406342 -75527794)
2018,Agosto,Honduras,43,36,,79,POINT (10446304 -75516486)
2018,Agosto,Honduras,7,10,,17,POINT (10886686 -74776479)
2018,Agosto,Honduras,0,1,,1,POINT (11360029 -72129595)
2018,Agosto,Honduras,0,11,,11,POINT (125744111 -81703935)
2018,Agosto,Honduras,0,2,,2,POINT (125862 -81702165)
2018,Agosto,Honduras,50,40,,90,POINT (3451668 -76532004)
2018,Agosto,Honduras,331,290,,621,POINT (4697157 -74140516)
2018,Agosto,Honduras,3,4,,7,POINT (4815189 -75736374)
2018,Agosto,Honduras,84,102,,186,POINT (6170465 -7542726)
2018,Agosto,Honduras,0,1,,1,POINT (7088729 -70740253)
2018,Agosto,Honduras,0,1,,1,POINT (7128047 -73181317)
2018,Agosto,Honduras,11,7,,18,POINT (836068 -72409396)
2018,Agosto,Hong Kong,2,1,,3,POINT (0.81488 -77356)
2018,Agosto,Hong Kong,8,10,,18,POINT (4697157 -74140516)
2018,Agosto,Hong Kong,1,0,,1,POINT (6170465 -7542726)
2018,Agosto,Hong Kong,1,0,,1,POINT (7819 -72453013)
2018,Agosto,Hungría,0,1,,1,POINT (0.33002 -76876446)
2018,Agosto,Hungría,1,1,,2,POINT (0.81488 -77356)
2018,Agosto,Hungría,5,4,,9,POINT (10446304 -75516486)
2018,Agosto,Hungría,0,4,,4,POINT (3451668 -76532004)
2018,Agosto,Hungría,25,43,,68,POINT (4697157 -74140516)
2018,Agosto,Hungría,4,7,,11,POINT (6170465 -7542726)
2018,Agosto,India,0,1,,1,POINT (-4191162 -69941498)
2018,Agosto,India,0,1,,1,POINT (0.81488 -77356)
2018,Agosto,India,0,4,,4,POINT (10406342 -75527794)
2018,Agosto,India,12,51,,63,POINT (10446304 -75516486)
2018,Agosto,India,2,28,,30,POINT (10886686 -74776479)
2018,Agosto,India,0,4,,4,POINT (10970933 -74765343)
2018,Agosto,India,0,1,,1,POINT (11247723 -74213989)
2018,Agosto,India,5,22,,27,POINT (3451668 -76532004)
2018,Agosto,India,0,1,,1,POINT (3884426 -77061029)
2018,Agosto,India,0,1,,1,POINT (445285 -75766353)
2018,Agosto,India,112,490,,602,POINT (4697157 -74140516)
2018,Agosto,India,1,2,,3,POINT (4815189 -75736374)
2018,Agosto,India,14,59,,73,POINT (6170465 -7542726)
2018,Agosto,Indonesia,0,1,,1,POINT (10406342 -75527794)
2018,Agosto,Indonesia,1,0,,1,POINT (10446304 -75516486)
2018,Agosto,Indonesia,0,1,,1,POINT (11360029 -72129595)
2018,Agosto,Indonesia,1,1,,2,POINT (3451668 -76532004)
2018,Agosto,Indonesia,17,30,,47,POINT (4697157 -74140516)
2018,Agosto,Indonesia,1,1,,2,POINT (6170465 -7542726)
2018,Agosto,Iraq,0,1,,1,POINT (10446304 -75516486)
2018,Agosto,Iraq,1,4,,5,POINT (4697157 -74140516)
2018,Agosto,Iraq,0,1,,1,POINT (6170465 -7542726)
2018,Agosto,Irán,3,1,,4,POINT (10446304 -75516486)
2018,Agosto,Irán,11,9,,20,POINT (4697157 -74140516)
2018,Agosto,Irán,2,2,,4,POINT (6170465 -7542726)
2018,Agosto,República de Irlanda,0,1,,1,POINT (-4191162 -69941498)
2018,Agosto,República de Irlanda,10,14,,24,POINT (0.81488 -77356)
2018,Agosto,República de Irlanda,7,4,,11,POINT (10406342 -75527794)
2018,Agosto,República de Irlanda,25,30,,55,POINT (10446304 -75516486)
2018,Agosto,República de Irlanda,2,0,,2,POINT (10886686 -74776479)
2018,Agosto,República de Irlanda,3,6,,9,POINT (3451668 -76532004)
2018,Agosto,República de Irlanda,0,1,,1,POINT (445285 -75766353)
2018,Agosto,República de Irlanda,168,235,,403,POINT (4697157 -74140516)
2018,Agosto,República de Irlanda,0,1,,1,POINT (4815189 -75736374)
2018,Agosto,República de Irlanda,21,55,,76,POINT (6170465 -7542726)
2018,Agosto,República de Irlanda,10,6,,16,POINT (863337 -7735002)
2018,Agosto,Islandia,0,1,,1,POINT (0.81488 -77356)
2018,Agosto,Islandia,5,8,,13,POINT (10446304 -75516486)
2018,Agosto,Islandia,0,1,,1,POINT (10886686 -74776479)
2018,Agosto,Islandia,5,10,,15,POINT (4697157 -74140516)
2018,Agosto,Islandia,0,1,,1,POINT (6170465 -7542726)
2018,Agosto,Israel,1,3,,4,POINT (-4191162 -69941498)
2018,Agosto,Israel,13,43,,56,POINT (0.81488 -77356)
2018,Agosto,Israel,1,2,,3,POINT (10406342 -75527794)
2018,Agosto,Israel,15,53,,68,POINT (10446304 -75516486)
2018,Agosto,Israel,1,7,,8,POINT (10886686 -74776479)
2018,Agosto,Israel,4,4,,8,POINT (125862 -81702165)
2018,Agosto,Israel,3,9,,12,POINT (3451668 -76532004)
2018,Agosto,Israel,205,472,,677,POINT (4697157 -74140516)
2018,Agosto,Israel,0,1,,1,POINT (4815189 -75736374)
2018,Agosto,Israel,22,56,,78,POINT (6170465 -7542726)
2018,Agosto,Israel,0,1,,1,POINT (863337 -7735002)
2018,Agosto,Italia,8,10,,18,POINT (-4191162 -69941498)
2018,Agosto,Italia,1,2,,3,POINT (-4214082 -69941431)
2018,Agosto,Italia,3,5,,8,POINT (0.33002 -76876446)
2018,Agosto,Italia,1,0,,1,POINT (0.812436 -77847006)
2018,Agosto,Italia,19,26,,45,POINT (0.81488 -77356)
2018,Agosto,Italia,9,19,,28,POINT (10406342 -75527794)
2018,Agosto,Italia,158,365,,523,POINT (10446304 -75516486)
2018,Agosto,Italia,21,35,,56,POINT (10886686 -74776479)
2018,Agosto,Italia,0,2,,2,POINT (11117206 -74232675)
2018,Agosto,Italia,2,13,,15,POINT (11360029 -72129595)
2018,Agosto,Italia,0,2,,2,POINT (125744111 -81703935)
2018,Agosto,Italia,10,13,,23,POINT (125862 -81702165)
2018,Agosto,Italia,53,139,,192,POINT (3451668 -76532004)
2018,Agosto,Italia,2,3,,5,POINT (445285 -75766353)
2018,Agosto,Italia,1709,2632,,4341,POINT (4697157 -74140516)
2018,Agosto,Italia,2,3,,5,POINT (4815189 -75736374)
2018,Agosto,Italia,103,305,,408,POINT (6170465 -7542726)
2018,Agosto,Italia,2,3,,5,POINT (7128047 -73181317)
2018,Agosto,Italia,10,17,,27,POINT (7819 -72453013)
2018,Agosto,Italia,2,7,,9,POINT (836068 -72409396)
2018,Agosto,Italia,2,3,,5,POINT (863337 -7735002)
2018,Agosto,Jamaica,0,3,,3,POINT (10406342 -75527794)
2018,Agosto,Jamaica,5,14,,19,POINT (10446304 -75516486)
2018,Agosto,Jamaica,1,1,,2,POINT (10886686 -74776479)
2018,Agosto,Jamaica,5,3,,8,POINT (3451668 -76532004)
2018,Agosto,Jamaica,36,46,,82,POINT (4697157 -74140516)
2018,Agosto,Jamaica,1,0,,1,POINT (4815189 -75736374)
2018,Agosto,Jamaica,2,9,,11,POINT (6170465 -7542726)
2018,Agosto,Jamaica,0,1,,1,POINT (7128047 -73181317)
2018,Agosto,Japón,0,1,,1,POINT (-4214082 -69941431)
2018,Agosto,Japón,6,12,,18,POINT (0.81488 -77356)
2018,Agosto,Japón,0,2,,2,POINT (10406342 -75527794)
2018,Agosto,Japón,7,29,,36,POINT (10446304 -75516486)
2018,Agosto,Japón,1,7,,8,POINT (10886686 -74776479)
2018,Agosto,Japón,0,4,,4,POINT (11117206 -74232675)
2018,Agosto,Japón,0,2,,2,POINT (11360029 -72129595)
2018,Agosto,Japón,0,4,,4,POINT (125862 -81702165)
2018,Agosto,Japón,8,16,,24,POINT (3451668 -76532004)
2018,Agosto,Japón,205,499,,704,POINT (4697157 -74140516)
2018,Agosto,Japón,35,30,,65,POINT (6170465 -7542726)
2018,Agosto,Japón,0,1,,1,POINT (7819 -72453013)
2018,Agosto,Japón,1,0,,1,POINT (863337 -7735002)
2018,Agosto,Jordania,1,0,,1,POINT (10446304 -75516486)
2018,Agosto,Jordania,5,8,,13,POINT (4697157 -74140516)
2018,Agosto,Jordania,0,1,,1,POINT (7128047 -73181317)
2018,Agosto,Kazajistán,1,1,,2,POINT (10446304 -75516486)
2018,Agosto,Kazajistán,10,4,,14,POINT (4697157 -74140516)
2018,Agosto,Kenia,1,0,,1,POINT (10886686 -74776479)
2018,Agosto,Kenia,5,3,,8,POINT (3451668 -76532004)
2018,Agosto,Kenia,3,5,,8,POINT (4697157 -74140516)
2018,Agosto,Kenia,3,1,,4,POINT (6170465 -7542726)
2018,Agosto,Kuwait,0,1,,1,POINT (0.81488 -77356)
2018,Agosto,Kuwait,0,3,,3,POINT (4697157 -74140516)
2018,Agosto,Kuwait,1,1,,2,POINT (6170465 -7542726)
2018,Agosto,República de Kosovo,0,1,,1,POINT (10406342 -75527794)
2018,Agosto,República de Kosovo,1,1,,2,POINT (4697157 -74140516)
2018,Agosto,Lesoto,0,1,,1,POINT (4697157 -74140516)
2018,Agosto,Letonia,0,4,,4,POINT (10406342 -75527794)
2018,Agosto,Letonia,0,2,,2,POINT (3451668 -76532004)
2018,Agosto,Letonia,9,5,,14,POINT (4697157 -74140516)
2018,Agosto,Letonia,1,5,,6,POINT (6170465 -7542726)
2018,Agosto,Lituania,1,0,,1,POINT (10406342 -75527794)
2018,Agosto,Lituania,0,4,,4,POINT (10446304 -75516486)
2018,Agosto,Lituania,0,1,,1,POINT (3451668 -76532004)
2018,Agosto,Lituania,18,10,,28,POINT (4697157 -74140516)
2018,Agosto,Lituania,3,3,,6,POINT (6170465 -7542726)
2018,Agosto,Líbano,1,4,,5,POINT (10446304 -75516486)
2018,Agosto,Líbano,1,3,,4,POINT (10886686 -74776479)
2018,Agosto,Líbano,20,36,,56,POINT (4697157 -74140516)
2018,Agosto,Líbano,0,2,,2,POINT (6170465 -7542726)
2018,Agosto,Líbano,0,1,,1,POINT (7128047 -73181317)
2018,Agosto,Libia,0,1,,1,POINT (10446304 -75516486)
2018,Agosto,Libia,0,1,,1,POINT (4697157 -74140516)
2018,Agosto,Liechtenstein,2,1,,3,POINT (4697157 -74140516)
2018,Agosto,Luxemburgo,1,0,,1,POINT (-4214082 -69941431)
2018,Agosto,Luxemburgo,0,1,,1,POINT (0.81488 -77356)
2018,Agosto,Luxemburgo,2,2,,4,POINT (10446304 -75516486)
2018,Agosto,Luxemburgo,0,1,,1,POINT (10886686 -74776479)
2018,Agosto,Luxemburgo,3,1,,4,POINT (3451668 -76532004)
2018,Agosto,Luxemburgo,13,25,,38,POINT (4697157 -74140516)
2018,Agosto,Luxemburgo,0,3,,3,POINT (4815189 -75736374)
2018,Agosto,Luxemburgo,5,2,,7,POINT (6170465 -7542726)
2018,Agosto,Macedonia,0,1,,1,POINT (-4191162 -69941498)
2018,Agosto,Macedonia,0,1,,1,POINT (10446304 -75516486)
2018,Agosto,Macedonia,0,2,,2,POINT (3451668 -76532004)
2018,Agosto,Macedonia,1,2,,3,POINT (4697157 -74140516)
2018,Agosto,Madagascar,1,0,,1,POINT (4697157 -74140516)
2018,Agosto,Madagascar,1,0,,1,POINT (6170465 -7542726)
2018,Agosto,Malasia,2,2,,4,POINT (10446304 -75516486)
2018,Agosto,Malasia,19,25,,44,POINT (4697157 -74140516)
2018,Agosto,Malasia,1,3,,4,POINT (6170465 -7542726)
2018,Agosto,Malawi,0,1,,1,POINT (3451668 -76532004)
2018,Agosto,Malawi,0,1,,1,POINT (4697157 -74140516)
2018,Agosto,Malí,2,0,,2,POINT (4697157 -74140516)
2018,Agosto,Malta,0,1,,1,POINT (10446304 -75516486)
2018,Agosto,Malta,11,14,,25,POINT (4697157 -74140516)
2018,Agosto,Malta,0,1,,1,POINT (4815189 -75736374)
2018,Agosto,Malta,0,1,,1,POINT (6170465 -7542726)
2018,Agosto,Marruecos,0,2,,2,POINT (0.81488 -77356)
2018,Agosto,Marruecos,2,4,,6,POINT (10446304 -75516486)
2018,Agosto,Marruecos,1,0,,1,POINT (10886686 -74776479)
2018,Agosto,Marruecos,12,26,,38,POINT (4697157 -74140516)
2018,Agosto,Marruecos,1,3,,4,POINT (6170465 -7542726)
2018,Agosto,Mauricio,0,1,,1,POINT (10406342 -75527794)
2018,Agosto,Mauricio,3,0,,3,POINT (10446304 -75516486)
2018,Agosto,Mauricio,0,1,,1,POINT (4697157 -74140516)
2018,Agosto,Mauricio,0,1,,1,POINT (6170465 -7542726)
2018,Agosto,México,1,0,,1,POINT (-4191162 -69941498)
2018,Agosto,México,8,1,,9,POINT (0.33002 -76876446)
2018,Agosto,México,24,32,,56,POINT (0.81488 -77356)
2018,Agosto,México,26,23,,49,POINT (10406342 -75527794)
2018,Agosto,México,217,307,,524,POINT (10446304 -75516486)
2018,Agosto,México,28,64,,92,POINT (10886686 -74776479)
2018,Agosto,México,3,4,,7,POINT (11360029 -72129595)
2018,Agosto,México,2,2,,4,POINT (125862 -81702165)
2018,Agosto,México,93,165,,258,POINT (3451668 -76532004)
2018,Agosto,México,1,2,,3,POINT (445285 -75766353)
2018,Agosto,México,4915,7905,,12820,POINT (4697157 -74140516)
2018,Agosto,México,21,37,,58,POINT (4815189 -75736374)
2018,Agosto,México,669,1701,,2370,POINT (6170465 -7542726)
2018,Agosto,México,1,1,,2,POINT (6185536 -67484028)
2018,Agosto,México,0,1,,1,POINT (7088729 -70740253)
2018,Agosto,México,0,1,,1,POINT (7102626 -77762647)
2018,Agosto,México,9,9,,18,POINT (7128047 -73181317)
2018,Agosto,México,29,40,,69,POINT (7819 -72453013)
2018,Agosto,México,1,6,,7,POINT (836068 -72409396)
2018,Agosto,República de Moldavia,3,2,,5,POINT (4697157 -74140516)
2018,Agosto,Mónaco,0,1,,1,POINT (10446304 -75516486)
2018,Agosto,Mónaco,1,2,,3,POINT (4697157 -74140516)
2018,Agosto,Mongolia,1,0,,1,POINT (3451668 -76532004)
2018,Agosto,Mongolia,3,0,,3,POINT (4697157 -74140516)
2018,Agosto,Montenegro,0,1,,1,POINT (-4191162 -69941498)
2018,Agosto,Montenegro,0,1,,1,POINT (10406342 -75527794)
2018,Agosto,Montenegro,0,1,,1,POINT (10446304 -75516486)
2018,Agosto,Montenegro,0,1,,1,POINT (3451668 -76532004)
2018,Agosto,Montenegro,1,3,,4,POINT (4697157 -74140516)
2018,Agosto,Montenegro,0,1,,1,POINT (9402597 -75681642)
2018,Agosto,Mozambique,1,4,,5,POINT (4697157 -74140516)
2018,Agosto,Myanmar,0,3,,3,POINT (10406342 -75527794)
2018,Agosto,Myanmar,0,3,,3,POINT (10446304 -75516486)
2018,Agosto,Myanmar,0,1,,1,POINT (4697157 -74140516)
2018,Agosto,Namibia,0,2,,2,POINT (10406342 -75527794)
2018,Agosto,Nepal,1,0,,1,POINT (10446304 -75516486)
2018,Agosto,Nepal,5,5,,10,POINT (4697157 -74140516)
2018,Agosto,Nepal,1,0,,1,POINT (6170465 -7542726)
2018,Agosto,Nicaragua,2,0,,2,POINT (0.81488 -77356)
2018,Agosto,Nicaragua,1,2,,3,POINT (10406342 -75527794)
2018,Agosto,Nicaragua,21,16,,37,POINT (10446304 -75516486)
2018,Agosto,Nicaragua,1,5,,6,POINT (10886686 -74776479)
2018,Agosto,Nicaragua,0,1,,1,POINT (11360029 -72129595)
2018,Agosto,Nicaragua,1,1,,2,POINT (125862 -81702165)
2018,Agosto,Nicaragua,11,13,,24,POINT (3451668 -76532004)
2018,Agosto,Nicaragua,98,96,,194,POINT (4697157 -74140516)
2018,Agosto,Nicaragua,3,4,,7,POINT (4815189 -75736374)
2018,Agosto,Nicaragua,23,35,,58,POINT (6170465 -7542726)
2018,Agosto,Nicaragua,2,1,,3,POINT (7128047 -73181317)
2018,Agosto,Nigeria,0,1,,1,POINT (0.81488 -77356)
2018,Agosto,Nigeria,1,2,,3,POINT (10446304 -75516486)
2018,Agosto,Nigeria,0,1,,1,POINT (11360029 -72129595)
2018,Agosto,Nigeria,1,0,,1,POINT (3451668 -76532004)
2018,Agosto,Nigeria,4,3,,7,POINT (4697157 -74140516)
2018,Agosto,Noruega,1,0,,1,POINT (0.33002 -76876446)
2018,Agosto,Noruega,2,5,,7,POINT (10406342 -75527794)
2018,Agosto,Noruega,9,10,,19,POINT (10446304 -75516486)
2018,Agosto,Noruega,2,0,,2,POINT (10886686 -74776479)
2018,Agosto,Noruega,0,1,,1,POINT (125862 -81702165)
2018,Agosto,Noruega,2,4,,6,POINT (3451668 -76532004)
2018,Agosto,Noruega,56,114,,170,POINT (4697157 -74140516)
2018,Agosto,Noruega,2,4,,6,POINT (4815189 -75736374)
2018,Agosto,Noruega,5,10,,15,POINT (6170465 -7542726)
2018,Agosto,Noruega,0,1,,1,POINT (7128047 -73181317)
2018,Agosto,Noruega,2,0,,2,POINT (863337 -7735002)
2018,Agosto,Nueva Zelanda,2,5,,7,POINT (-4191162 -69941498)
2018,Agosto,Nueva Zelanda,2,1,,3,POINT (-4214082 -69941431)
2018,Agosto,Nueva Zelanda,11,12,,23,POINT (0.81488 -77356)
2018,Agosto,Nueva Zelanda,8,11,,19,POINT (10406342 -75527794)
2018,Agosto,Nueva Zelanda,8,9,,17,POINT (10446304 -75516486)
2018,Agosto,Nueva Zelanda,4,5,,9,POINT (10886686 -74776479)
2018,Agosto,Nueva Zelanda,1,3,,4,POINT (11247723 -74213989)
2018,Agosto,Nueva Zelanda,79,131,,210,POINT (4697157 -74140516)
2018,Agosto,Nueva Zelanda,9,18,,27,POINT (6170465 -7542726)
2018,Agosto,Nueva Zelanda,0,1,,1,POINT (7819 -72453013)
2018,Agosto,Nueva Zelanda,2,3,,5,POINT (863337 -7735002)
2018,Agosto,Omán,0,1,,1,POINT (4697157 -74140516)
2018,Agosto,Países Bajos,3,25,,28,POINT (-4191162 -69941498)
2018,Agosto,Países Bajos,1,14,,15,POINT (-4214082 -69941431)
2018,Agosto,Países Bajos,15,25,,40,POINT (0.81488 -77356)
2018,Agosto,Países Bajos,22,21,,43,POINT (10406342 -75527794)
2018,Agosto,Países Bajos,284,326,,610,POINT (10446304 -75516486)
2018,Agosto,Países Bajos,12,11,,23,POINT (10886686 -74776479)
2018,Agosto,Países Bajos,0,1,,1,POINT (11247723 -74213989)
2018,Agosto,Países Bajos,0,2,,2,POINT (11360029 -72129595)
2018,Agosto,Países Bajos,1,2,,3,POINT (125862 -81702165)
2018,Agosto,Países Bajos,1,0,,1,POINT (133387613 -81372937)
2018,Agosto,Países Bajos,38,67,,105,POINT (3451668 -76532004)
2018,Agosto,Países Bajos,1,14,,15,POINT (3884426 -77061029)
2018,Agosto,Países Bajos,1815,2441,,4256,POINT (4697157 -74140516)
2018,Agosto,Países Bajos,1,8,,9,POINT (4815189 -75736374)
2018,Agosto,Países Bajos,139,193,,332,POINT (6170465 -7542726)
2018,Agosto,Países Bajos,14,13,,27,POINT (7128047 -73181317)
2018,Agosto,Países Bajos,2,4,,6,POINT (7819 -72453013)
2018,Agosto,Países Bajos,1,0,,1,POINT (836068 -72409396)
2018,Agosto,Países Bajos,7,13,,20,POINT (863337 -7735002)
2018,Agosto,Pakistán,0,1,,1,POINT (0.81488 -77356)
2018,Agosto,Pakistán,1,2,,3,POINT (10446304 -75516486)
2018,Agosto,Pakistán,6,22,,28,POINT (4697157 -74140516)
2018,Agosto,Pakistán,1,0,,1,POINT (6170465 -7542726)
2018,Agosto,Panamá,2,5,,7,POINT (0.81488 -77356)
2018,Agosto,Panamá,1,30,,31,POINT (10406342 -75527794)
2018,Agosto,Panamá,697,692,,1389,POINT (10446304 -75516486)
2018,Agosto,Panamá,105,129,,234,POINT (10886686 -74776479)
2018,Agosto,Panamá,0,1,,1,POINT (10970933 -74765343)
2018,Agosto,Panamá,0,2,,2,POINT (11117206 -74232675)
2018,Agosto,Panamá,1,0,,1,POINT (11360029 -72129595)
2018,Agosto,Panamá,1,0,,1,POINT (12165168 -71983761)
2018,Agosto,Panamá,0,1,,1,POINT (125744111 -81703935)
2018,Agosto,Panamá,21,38,,59,POINT (125862 -81702165)
2018,Agosto,Panamá,168,196,,364,POINT (3451668 -76532004)
2018,Agosto,Panamá,47,30,,77,POINT (445285 -75766353)
2018,Agosto,Panamá,1601,1635,,3236,POINT (4697157 -74140516)
2018,Agosto,Panamá,18,31,,49,POINT (4815189 -75736374)
2018,Agosto,Panamá,1618,1429,,3047,POINT (6170465 -7542726)
2018,Agosto,Panamá,9,9,,18,POINT (7102626 -77762647)
2018,Agosto,Panamá,24,19,,43,POINT (7128047 -73181317)
2018,Agosto,Panamá,2,2,,4,POINT (7819 -72453013)
2018,Agosto,Panamá,0,2,,2,POINT (806667 -767333)
2018,Agosto,Panamá,0,3,,3,POINT (836068 -72409396)
2018,Agosto,Panamá,1,8,,9,POINT (863337 -7735002)
2018,Agosto,Paraguay,1,2,,3,POINT (0.81488 -77356)
2018,Agosto,Paraguay,4,0,,4,POINT (10406342 -75527794)
2018,Agosto,Paraguay,99,50,,149,POINT (10446304 -75516486)
2018,Agosto,Paraguay,2,6,,8,POINT (10886686 -74776479)
2018,Agosto,Paraguay,57,41,,98,POINT (125862 -81702165)
2018,Agosto,Paraguay,18,13,,31,POINT (3451668 -76532004)
2018,Agosto,Paraguay,323,277,,600,POINT (4697157 -74140516)
2018,Agosto,Paraguay,1,0,,1,POINT (4815189 -75736374)
2018,Agosto,Paraguay,31,40,,71,POINT (6170465 -7542726)
2018,Agosto,Paraguay,1,4,,5,POINT (7128047 -73181317)
2018,Agosto,Paraguay,4,1,,5,POINT (7819 -72453013)
2018,Agosto,Paraguay,0,1,,1,POINT (836068 -72409396)
2018,Agosto,Perú,43,31,,74,POINT (-4191162 -69941498)
2018,Agosto,Perú,24,24,,48,POINT (-4214082 -69941431)
2018,Agosto,Perú,5,2,,7,POINT (0.185957 -7478366)
2018,Agosto,Perú,3,15,,18,POINT (0.33002 -76876446)
2018,Agosto,Perú,153,352,,505,POINT (0.81488 -77356)
2018,Agosto,Perú,92,69,,161,POINT (10406342 -75527794)
2018,Agosto,Perú,1260,935,,2195,POINT (10446304 -75516486)
2018,Agosto,Perú,11,23,,34,POINT (10886686 -74776479)
2018,Agosto,Perú,8,14,,22,POINT (11360029 -72129595)
2018,Agosto,Perú,237,155,,392,POINT (125862 -81702165)
2018,Agosto,Perú,191,185,,376,POINT (3451668 -76532004)
2018,Agosto,Perú,0,2,,2,POINT (3866713 -67927521)
2018,Agosto,Perú,0,1,,1,POINT (445285 -75766353)
2018,Agosto,Perú,4320,4848,,9168,POINT (4697157 -74140516)
2018,Agosto,Perú,6,7,,13,POINT (4815189 -75736374)
2018,Agosto,Perú,702,776,,1478,POINT (6170465 -7542726)
2018,Agosto,Perú,0,1,,1,POINT (6185536 -67484028)
2018,Agosto,Perú,1,2,,3,POINT (7088729 -70740253)
2018,Agosto,Perú,3,3,,6,POINT (7128047 -73181317)
2018,Agosto,Perú,74,151,,225,POINT (7819 -72453013)
2018,Agosto,Perú,7,17,,24,POINT (836068 -72409396)
2018,Agosto,Perú,0,3,,3,POINT (863337 -7735002)
2018,Agosto,Palestina,1,0,,1,POINT (10886686 -74776479)
2018,Agosto,Palestina,3,1,,4,POINT (4697157 -74140516)
2018,Agosto,Polonia,0,1,,1,POINT (-4191162 -69941498)
2018,Agosto,Polonia,1,0,,1,POINT (-4214082 -69941431)
2018,Agosto,Polonia,5,8,,13,POINT (0.81488 -77356)
2018,Agosto,Polonia,0,7,,7,POINT (10406342 -75527794)
2018,Agosto,Polonia,11,18,,29,POINT (10446304 -75516486)
2018,Agosto,Polonia,0,1,,1,POINT (10886686 -74776479)
2018,Agosto,Polonia,0,1,,1,POINT (11360029 -72129595)
2018,Agosto,Polonia,1,2,,3,POINT (125862 -81702165)
2018,Agosto,Polonia,6,0,,6,POINT (3451668 -76532004)
2018,Agosto,Polonia,0,1,,1,POINT (3884426 -77061029)
2018,Agosto,Polonia,155,140,,295,POINT (4697157 -74140516)
2018,Agosto,Polonia,6,15,,21,POINT (6170465 -7542726)
2018,Agosto,Polonia,0,1,,1,POINT (7128047 -73181317)
2018,Agosto,Portugal,0,1,,1,POINT (-4214082 -69941431)
2018,Agosto,Portugal,1,0,,1,POINT (0.33002 -76876446)
2018,Agosto,Portugal,15,13,,28,POINT (0.81488 -77356)
2018,Agosto,Portugal,0,1,,1,POINT (10406342 -75527794)
2018,Agosto,Portugal,24,30,,54,POINT (10446304 -75516486)
2018,Agosto,Portugal,7,10,,17,POINT (10886686 -74776479)
2018,Agosto,Portugal,4,5,,9,POINT (11360029 -72129595)
2018,Agosto,Portugal,0,1,,1,POINT (125862 -81702165)
2018,Agosto,Portugal,8,15,,23,POINT (3451668 -76532004)
2018,Agosto,Portugal,293,480,,773,POINT (4697157 -74140516)
2018,Agosto,Portugal,3,1,,4,POINT (4815189 -75736374)
2018,Agosto,Portugal,20,45,,65,POINT (6170465 -7542726)
2018,Agosto,Portugal,1,0,,1,POINT (7128047 -73181317)
2018,Agosto,Portugal,12,23,,35,POINT (7819 -72453013)
2018,Agosto,Puerto Rico/Territorio de Estados Unidos,0,1,,1,POINT (4697157 -74140516)
2018,Agosto,Qatar,0,2,,2,POINT (4697157 -74140516)
2018,Agosto,Qatar,0,1,,1,POINT (6170465 -7542726)
2018,Agosto,Reino Unido de Gran Bretaña e Irlanda del Norte,5,10,,15,POINT (-4191162 -69941498)
2018,Agosto,Reino Unido de Gran Bretaña e Irlanda del Norte,0,5,,5,POINT (-4214082 -69941431)
2018,Agosto,Reino Unido de Gran Bretaña e Irlanda del Norte,2,2,,4,POINT (0.33002 -76876446)
2018,Agosto,Reino Unido de Gran Bretaña e Irlanda del Norte,53,77,,130,POINT (0.81488 -77356)
2018,Agosto,Reino Unido de Gran Bretaña e Irlanda del Norte,19,27,,46,POINT (10406342 -75527794)
2018,Agosto,Reino Unido de Gran Bretaña e Irlanda del Norte,113,181,,294,POINT (10446304 -75516486)
2018,Agosto,Reino Unido de Gran Bretaña e Irlanda del Norte,18,30,,48,POINT (10886686 -74776479)
2018,Agosto,Reino Unido de Gran Bretaña e Irlanda del Norte,0,1,,1,POINT (11360029 -72129595)
2018,Agosto,Reino Unido de Gran Bretaña e Irlanda del Norte,1,1,,2,POINT (133387613 -81372937)
2018,Agosto,Reino Unido de Gran Bretaña e Irlanda del Norte,63,67,,130,POINT (3451668 -76532004)
2018,Agosto,Reino Unido de Gran Bretaña e Irlanda del Norte,1,1,,2,POINT (445285 -75766353)
2018,Agosto,Reino Unido de Gran Bretaña e Irlanda del Norte,1361,2300,,3661,POINT (4697157 -74140516)
2018,Agosto,Reino Unido de Gran Bretaña e Irlanda del Norte,0,8,,8,POINT (4815189 -75736374)
2018,Agosto,Reino Unido de Gran Bretaña e Irlanda del Norte,156,263,,419,POINT (6170465 -7542726)
2018,Agosto,Reino Unido de Gran Bretaña e Irlanda del Norte,0,1,,1,POINT (7088729 -70740253)
2018,Agosto,Reino Unido de Gran Bretaña e Irlanda del Norte,2,7,,9,POINT (7819 -72453013)
2018,Agosto,Reino Unido de Gran Bretaña e Irlanda del Norte,31,17,,48,POINT (863337 -7735002)
2018,Agosto,República Dominicana,2,0,,2,POINT (-4214082 -69941431)
2018,Agosto,República Dominicana,0,1,,1,POINT (0.33002 -76876446)
2018,Agosto,República Dominicana,8,16,,24,POINT (0.81488 -77356)
2018,Agosto,República Dominicana,0,1,,1,POINT (10406342 -75527794)
2018,Agosto,República Dominicana,57,86,,143,POINT (10446304 -75516486)
2018,Agosto,República Dominicana,27,52,,79,POINT (10886686 -74776479)
2018,Agosto,República Dominicana,2,7,,9,POINT (11360029 -72129595)
2018,Agosto,República Dominicana,0,1,,1,POINT (12165168 -71983761)
2018,Agosto,República Dominicana,2,5,,7,POINT (125862 -81702165)
2018,Agosto,República Dominicana,21,47,,68,POINT (3451668 -76532004)
2018,Agosto,República Dominicana,958,1136,,2094,POINT (4697157 -74140516)
2018,Agosto,República Dominicana,5,7,,12,POINT (4815189 -75736374)
2018,Agosto,República Dominicana,102,180,,282,POINT (6170465 -7542726)
2018,Agosto,República Dominicana,2,2,,4,POINT (7128047 -73181317)
2018,Agosto,República Dominicana,4,5,,9,POINT (7819 -72453013)
2018,Agosto,República Dominicana,1,0,,1,POINT (863337 -7735002)
2018,Agosto,Rumania,0,1,,1,POINT (-4214082 -69941431)
2018,Agosto,Rumania,0,1,,1,POINT (0.81488 -77356)
2018,Agosto,Rumania,1,0,,1,POINT (10406342 -75527794)
2018,Agosto,Rumania,4,7,,11,POINT (10446304 -75516486)
2018,Agosto,Rumania,0,1,,1,POINT (11247723 -74213989)
2018,Agosto,Rumania,7,2,,9,POINT (3451668 -76532004)
2018,Agosto,Rumania,0,2,,2,POINT (3884426 -77061029)
2018,Agosto,Rumania,54,56,,110,POINT (4697157 -74140516)
2018,Agosto,Rumania,9,5,,14,POINT (6170465 -7542726)
2018,Agosto,Rumania,0,1,,1,POINT (7819 -72453013)
2018,Agosto,Federación de Rusia,0,1,,1,POINT (0.33002 -76876446)
2018,Agosto,Federación de Rusia,3,7,,10,POINT (0.81488 -77356)
2018,Agosto,Federación de Rusia,0,14,,14,POINT (10406342 -75527794)
2018,Agosto,Federación de Rusia,14,22,,36,POINT (10446304 -75516486)
2018,Agosto,Federación de Rusia,0,2,,2,POINT (10886686 -74776479)
2018,Agosto,Federación de Rusia,0,1,,1,POINT (10970933 -74765343)
2018,Agosto,Federación de Rusia,0,1,,1,POINT (11247723 -74213989)
2018,Agosto,Federación de Rusia,3,3,,6,POINT (3451668 -76532004)
2018,Agosto,Federación de Rusia,0,1,,1,POINT (3884426 -77061029)
2018,Agosto,Federación de Rusia,172,169,,341,POINT (4697157 -74140516)
2018,Agosto,Federación de Rusia,13,13,,26,POINT (6170465 -7542726)
2018,Agosto,Federación de Rusia,0,2,,2,POINT (7819 -72453013)
2018,Agosto,Rwanda,0,2,,2,POINT (3451668 -76532004)
2018,Agosto,Rwanda,0,1,,1,POINT (4697157 -74140516)
2018,Agosto,San Cristóbal y Nevis,0,1,,1,POINT (10406342 -75527794)
2018,Agosto,San Cristóbal y Nevis,1,0,,1,POINT (10446304 -75516486)
2018,Agosto,San Cristóbal y Nevis,0,2,,2,POINT (3451668 -76532004)
2018,Agosto,San Cristóbal y Nevis,4,3,,7,POINT (4697157 -74140516)
2018,Agosto,Samoa Occidental,0,1,,1,POINT (4697157 -74140516)
2018,Agosto,San Marino,0,1,,1,POINT (4697157 -74140516)
2018,Agosto,San  Vicente y las Granadinas,1,1,,2,POINT (10886686 -74776479)
2018,Agosto,San  Vicente y las Granadinas,1,1,,2,POINT (4697157 -74140516)
2018,Agosto,Santa Lucia,2,0,,2,POINT (10446304 -75516486)
2018,Agosto,Santa Lucia,0,1,,1,POINT (11360029 -72129595)
2018,Agosto,Santa Lucia,0,1,,1,POINT (3451668 -76532004)
2018,Agosto,Santa Lucia,5,3,,8,POINT (4697157 -74140516)
2018,Agosto,Santa Lucia,3,1,,4,POINT (6170465 -7542726)
2018,Agosto,Santa Sede/Ciudad del Vaticano,0,4,,4,POINT (4697157 -74140516)
2018,Agosto,Senegal,1,1,,2,POINT (4697157 -74140516)
2018,Agosto,Serbia,0,1,,1,POINT (0.33002 -76876446)
2018,Agosto,Serbia,0,1,,1,POINT (10406342 -75527794)
2018,Agosto,Serbia,0,2,,2,POINT (10446304 -75516486)
2018,Agosto,Serbia,2,2,,4,POINT (3451668 -76532004)
2018,Agosto,Serbia,9,17,,26,POINT (4697157 -74140516)
2018,Agosto,Serbia,0,2,,2,POINT (6170465 -7542726)
2018,Agosto,Seychelles,0,1,,1,POINT (4697157 -74140516)
2018,Agosto,Singapur,1,0,,1,POINT (10406342 -75527794)
2018,Agosto,Singapur,5,2,,7,POINT (10446304 -75516486)
2018,Agosto,Singapur,0,1,,1,POINT (3451668 -76532004)
2018,Agosto,Singapur,23,30,,53,POINT (4697157 -74140516)
2018,Agosto,Singapur,2,0,,2,POINT (6170465 -7542726)
2018,Agosto,República Árabe Siria,0,1,,1,POINT (10446304 -75516486)
2018,Agosto,República Árabe Siria,3,3,,6,POINT (4697157 -74140516)
2018,Agosto,República Árabe Siria,0,2,,2,POINT (6170465 -7542726)
2018,Agosto,Sri Lanka,1,0,,1,POINT (10446304 -75516486)
2018,Agosto,Sri Lanka,0,1,,1,POINT (10886686 -74776479)
2018,Agosto,Sri Lanka,0,1,,1,POINT (10970933 -74765343)
2018,Agosto,Sri Lanka,1,8,,9,POINT (4697157 -74140516)
2018,Agosto,Sri Lanka,2,2,,4,POINT (6170465 -7542726)
2018,Agosto,Sudáfrica,1,0,,1,POINT (0.81488 -77356)
2018,Agosto,Sudáfrica,1,3,,4,POINT (10406342 -75527794)
2018,Agosto,Sudáfrica,2,3,,5,POINT (10446304 -75516486)
2018,Agosto,Sudáfrica,0,1,,1,POINT (10886686 -74776479)
2018,Agosto,Sudáfrica,1,3,,4,POINT (3451668 -76532004)
2018,Agosto,Sudáfrica,16,52,,68,POINT (4697157 -74140516)
2018,Agosto,Sudáfrica,0,1,,1,POINT (6170465 -7542726)
2018,Agosto,Sudán,0,1,,1,POINT (4697157 -74140516)
2018,Agosto,Suecia,1,0,,1,POINT (0.33002 -76876446)
2018,Agosto,Suecia,7,4,,11,POINT (0.81488 -77356)
2018,Agosto,Suecia,1,6,,7,POINT (10406342 -75527794)
2018,Agosto,Suecia,9,12,,21,POINT (10446304 -75516486)
2018,Agosto,Suecia,2,4,,6,POINT (10886686 -74776479)
2018,Agosto,Suecia,1,1,,2,POINT (11247723 -74213989)
2018,Agosto,Suecia,4,6,,10,POINT (3451668 -76532004)
2018,Agosto,Suecia,0,1,,1,POINT (445285 -75766353)
2018,Agosto,Suecia,130,189,,319,POINT (4697157 -74140516)
2018,Agosto,Suecia,1,3,,4,POINT (4815189 -75736374)
2018,Agosto,Suecia,17,39,,56,POINT (6170465 -7542726)
2018,Agosto,Suecia,0,1,,1,POINT (7819 -72453013)
2018,Agosto,Suecia,0,1,,1,POINT (863337 -7735002)
2018,Agosto,Suiza,9,13,,22,POINT (-4191162 -69941498)
2018,Agosto,Suiza,1,2,,3,POINT (-4214082 -69941431)
2018,Agosto,Suiza,1,0,,1,POINT (0.33002 -76876446)
2018,Agosto,Suiza,1,1,,2,POINT (0.812436 -77847006)
2018,Agosto,Suiza,18,18,,36,POINT (0.81488 -77356)
2018,Agosto,Suiza,10,15,,25,POINT (10406342 -75527794)
2018,Agosto,Suiza,45,50,,95,POINT (10446304 -75516486)
2018,Agosto,Suiza,1,4,,5,POINT (10886686 -74776479)
2018,Agosto,Suiza,1,1,,2,POINT (11360029 -72129595)
2018,Agosto,Suiza,1,0,,1,POINT (125744111 -81703935)
2018,Agosto,Suiza,0,1,,1,POINT (125862 -81702165)
2018,Agosto,Suiza,2,1,,3,POINT (133387613 -81372937)
2018,Agosto,Suiza,19,32,,51,POINT (3451668 -76532004)
2018,Agosto,Suiza,482,643,,1125,POINT (4697157 -74140516)
2018,Agosto,Suiza,0,2,,2,POINT (4815189 -75736374)
2018,Agosto,Suiza,41,84,,125,POINT (6170465 -7542726)
2018,Agosto,Suiza,1,1,,2,POINT (6222552 -77401154)
2018,Agosto,Suiza,1,0,,1,POINT (7819 -72453013)
2018,Agosto,Suiza,1,0,,1,POINT (836068 -72409396)
2018,Agosto,Suiza,5,4,,9,POINT (863337 -7735002)
2018,Agosto,Surinam,1,2,,3,POINT (10446304 -75516486)
2018,Agosto,Surinam,23,34,,57,POINT (4697157 -74140516)
2018,Agosto,Surinam,1,3,,4,POINT (6170465 -7542726)
2018,Agosto,Surinam,2,1,,3,POINT (7128047 -73181317)
2018,Agosto,Surinam,0,1,,1,POINT (836068 -72409396)
2018,Agosto,Suazilandia,0,1,,1,POINT (4697157 -74140516)
2018,Agosto,Taiwán,1,0,,1,POINT (4697157 -74140516)
2018,Agosto,Tailandia,1,0,,1,POINT (10446304 -75516486)
2018,Agosto,Tailandia,1,0,,1,POINT (3451668 -76532004)
2018,Agosto,Tailandia,19,19,,38,POINT (4697157 -74140516)
2018,Agosto,Tailandia,2,3,,5,POINT (6170465 -7542726)
2018,Agosto,Tanzania,1,0,,1,POINT (3451668 -76532004)
2018,Agosto,Tanzania,0,1,,1,POINT (4697157 -74140516)
2018,Agosto,Trinidad y Tobago,13,10,,23,POINT (10446304 -75516486)
2018,Agosto,Trinidad y Tobago,1,0,,1,POINT (11360029 -72129595)
2018,Agosto,Trinidad y Tobago,1,3,,4,POINT (125862 -81702165)
2018,Agosto,Trinidad y Tobago,5,8,,13,POINT (3451668 -76532004)
2018,Agosto,Trinidad y Tobago,61,88,,149,POINT (4697157 -74140516)
2018,Agosto,Trinidad y Tobago,6,14,,20,POINT (6170465 -7542726)
2018,Agosto,Trinidad y Tobago,3,2,,5,POINT (7128047 -73181317)
2018,Agosto,Túnez,0,1,,1,POINT (10406342 -75527794)
2018,Agosto,Túnez,5,7,,12,POINT (4697157 -74140516)
2018,Agosto,Turquía,1,1,,2,POINT (-4191162 -69941498)
2018,Agosto,Turquía,0,2,,2,POINT (-4214082 -69941431)
2018,Agosto,Turquía,2,6,,8,POINT (0.81488 -77356)
2018,Agosto,Turquía,0,2,,2,POINT (10406342 -75527794)
2018,Agosto,Turquía,15,8,,23,POINT (10446304 -75516486)
2018,Agosto,Turquía,1,1,,2,POINT (11247723 -74213989)
2018,Agosto,Turquía,0,1,,1,POINT (3451668 -76532004)
2018,Agosto,Turquía,339,406,,745,POINT (4697157 -74140516)
2018,Agosto,Turquía,12,15,,27,POINT (6170465 -7542726)
2018,Agosto,Turquía,0,1,,1,POINT (836068 -72409396)
2018,Agosto,Turquía,0,1,,1,POINT (863337 -7735002)
2018,Agosto,Turkmenistán,1,0,,1,POINT (4697157 -74140516)
2018,Agosto,Ucrania,0,10,,10,POINT (10406342 -75527794)
2018,Agosto,Ucrania,2,10,,12,POINT (10446304 -75516486)
2018,Agosto,Ucrania,0,2,,2,POINT (10886686 -74776479)
2018,Agosto,Ucrania,0,1,,1,POINT (11247723 -74213989)
2018,Agosto,Ucrania,1,0,,1,POINT (125862 -81702165)
2018,Agosto,Ucrania,4,1,,5,POINT (3451668 -76532004)
2018,Agosto,Ucrania,0,2,,2,POINT (3884426 -77061029)
2018,Agosto,Ucrania,28,38,,66,POINT (4697157 -74140516)
2018,Agosto,Ucrania,3,0,,3,POINT (6170465 -7542726)
2018,Agosto,Ucrania,1,0,,1,POINT (7128047 -73181317)
2018,Agosto,Ucrania,0,1,,1,POINT (9402597 -75681642)
2018,Agosto,Uganda,1,0,,1,POINT (3451668 -76532004)
2018,Agosto,Uganda,2,1,,3,POINT (4697157 -74140516)
2018,Agosto,Uganda,3,0,,3,POINT (6170465 -7542726)
2018,Agosto,Uruguay,2,0,,2,POINT (-4191162 -69941498)
2018,Agosto,Uruguay,0,3,,3,POINT (-4214082 -69941431)
2018,Agosto,Uruguay,2,11,,13,POINT (0.81488 -77356)
2018,Agosto,Uruguay,20,22,,42,POINT (10406342 -75527794)
2018,Agosto,Uruguay,149,111,,260,POINT (10446304 -75516486)
2018,Agosto,Uruguay,5,5,,10,POINT (10886686 -74776479)
2018,Agosto,Uruguay,0,2,,2,POINT (11360029 -72129595)
2018,Agosto,Uruguay,27,29,,56,POINT (125862 -81702165)
2018,Agosto,Uruguay,4,19,,23,POINT (3451668 -76532004)
2018,Agosto,Uruguay,619,755,,1374,POINT (4697157 -74140516)
2018,Agosto,Uruguay,0,2,,2,POINT (4815189 -75736374)
2018,Agosto,Uruguay,42,53,,95,POINT (6170465 -7542726)
2018,Agosto,Uruguay,0,1,,1,POINT (7128047 -73181317)
2018,Agosto,Uruguay,3,8,,11,POINT (7819 -72453013)
2018,Agosto,Uruguay,4,3,,7,POINT (836068 -72409396)
2018,Agosto,Uruguay,0,1,,1,POINT (863337 -7735002)
2018,Agosto,Venezuela,1,0,,1,POINT (4697157 -74140516)
2018,Agosto,Venezuela,5,8,,13,POINT (-4191162 -69941498)
2018,Agosto,Venezuela,0,1,,1,POINT (-4214082 -69941431)
2018,Agosto,Venezuela,128,154,,282,POINT (0.33002 -76876446)
2018,Agosto,Venezuela,3,3,,6,POINT (0.812436 -77847006)
2018,Agosto,Venezuela,2513,3169,,5682,POINT (0.81488 -77356)
2018,Agosto,Venezuela,5,1,,6,POINT (1800143 -78802679)
2018,Agosto,Venezuela,18,29,,47,POINT (10406342 -75527794)
2018,Agosto,Venezuela,206,227,,433,POINT (10446304 -75516486)
2018,Agosto,Venezuela,136,209,,345,POINT (10886686 -74776479)
2018,Agosto,Venezuela,0,8,,8,POINT (11117206 -74232675)
2018,Agosto,Venezuela,0,1,,1,POINT (11247723 -74213989)
2018,Agosto,Venezuela,10940,9426,,20366,POINT (11360029 -72129595)
2018,Agosto,Venezuela,1,34,,35,POINT (12165168 -71983761)
2018,Agosto,Venezuela,6,4,,10,POINT (125862 -81702165)
2018,Agosto,Venezuela,111,145,,256,POINT (3451668 -76532004)
2018,Agosto,Venezuela,7,4,,11,POINT (3866713 -67927521)
2018,Agosto,Venezuela,1,5,,6,POINT (445285 -75766353)
2018,Agosto,Venezuela,6062,6254,,12316,POINT (4697157 -74140516)
2018,Agosto,Venezuela,16,18,,34,POINT (4815189 -75736374)
2018,Agosto,Venezuela,1017,973,,1990,POINT (6170465 -7542726)
2018,Agosto,Venezuela,34,33,,67,POINT (6185536 -67484028)
2018,Agosto,Venezuela,1625,1634,,3259,POINT (7088729 -70740253)
2018,Agosto,Venezuela,9,5,,14,POINT (7128047 -73181317)
2018,Agosto,Venezuela,38931,35940,,74871,POINT (7819 -72453013)
2018,Agosto,Venezuela,5,8,,13,POINT (7927233 -72508188)
2018,Agosto,Venezuela,4649,3773,,8422,POINT (836068 -72409396)
2018,Agosto,Vietnam,1,1,,2,POINT (10446304 -75516486)
2018,Agosto,Vietnam,5,1,,6,POINT (3451668 -76532004)
2018,Agosto,Vietnam,6,4,,10,POINT (4697157 -74140516)
2018,Agosto,Vietnam,2,2,,4,POINT (6170465 -7542726)
2018,Agosto,Zambia,0,1,,1,POINT (3451668 -76532004)
2018,Agosto,Zambia,0,1,,1,POINT (4697157 -74140516)
2018,Agosto,Zimbabue,0,1,,1,POINT (10446304 -75516486)
2018,Agosto,Zimbabue,2,3,,5,POINT (4697157 -74140516)
2018,Agosto,Anguila/Territorio Británico de Ultramar,0,1,,1,POINT (4697157 -74140516)
2018,Agosto,Islas Turcas y Caicos/Territorio Británico de Ultramar,0,1,,1,POINT (4697157 -74140516)
2018,Agosto,Refugiado,3,2,,5,POINT (10886686 -74776479)
2018,Agosto,Refugiado,5,6,,11,POINT (4697157 -74140516)
2018,Agosto,Refugiado,0,1,,1,POINT (6170465 -7542726)
2018,Agosto,Desconocido,4,7,,11,POINT (10446304 -75516486)
2018,Agosto,Desconocido,0,2,,2,POINT (3451668 -76532004)
2018,Agosto,Desconocido,73,131,,204,POINT (4697157 -74140516)
2018,Agosto,Desconocido,1,2,,3,POINT (6170465 -7542726)
2018,Agosto,Desconocido,2,0,,2,POINT (7088729 -70740253)
2018,Agosto,Desconocido,1,0,,1,POINT (7819 -72453013)
2018,Septiembre,Albania,1,3,,4,POINT (10446304 -75516486)
2018,Septiembre,Albania,0,1,,1,POINT (3451668 -76532004)
2018,Septiembre,Albania,3,8,,11,POINT (4697157 -74140516)
2018,Septiembre,Albania,0,2,,2,POINT (6170465 -7542726)
2018,Septiembre,Alemania,20,17,,37,POINT (-4191162 -69941498)
2018,Septiembre,Alemania,4,3,,7,POINT (-4214082 -69941431)
2018,Septiembre,Alemania,1,1,,2,POINT (0.33002 -76876446)
2018,Septiembre,Alemania,43,53,,96,POINT (0.81488 -77356)
2018,Septiembre,Alemania,29,36,,65,POINT (10406342 -75527794)
2018,Septiembre,Alemania,134,182,,316,POINT (10446304 -75516486)
2018,Septiembre,Alemania,23,30,,53,POINT (10886686 -74776479)
2018,Septiembre,Alemania,2,2,,4,POINT (11247723 -74213989)
2018,Septiembre,Alemania,0,3,,3,POINT (11360029 -72129595)
2018,Septiembre,Alemania,5,3,,8,POINT (125862 -81702165)
2018,Septiembre,Alemania,63,84,,147,POINT (3451668 -76532004)
2018,Septiembre,Alemania,1,0,,1,POINT (3884426 -77061029)
2018,Septiembre,Alemania,1747,2593,,4340,POINT (4697157 -74140516)
2018,Septiembre,Alemania,3,6,,9,POINT (4815189 -75736374)
2018,Septiembre,Alemania,143,274,,417,POINT (6170465 -7542726)
2018,Septiembre,Alemania,0,2,,2,POINT (7128047 -73181317)
2018,Septiembre,Alemania,2,2,,4,POINT (7819 -72453013)
2018,Septiembre,Alemania,0,1,,1,POINT (836068 -72409396)
2018,Septiembre,Alemania,10,9,,19,POINT (863337 -7735002)
2018,Septiembre,Andorra,0,2,,2,POINT (10446304 -75516486)
2018,Septiembre,Andorra,1,8,,9,POINT (4697157 -74140516)
2018,Septiembre,Andorra,0,1,,1,POINT (6170465 -7542726)
2018,Septiembre,Angola,1,0,,1,POINT (4697157 -74140516)
2018,Septiembre,Angola,0,1,,1,POINT (6170465 -7542726)
2018,Septiembre,Antigua y Barbuda,2,1,,3,POINT (10446304 -75516486)
2018,Septiembre,Antigua y Barbuda,2,6,,8,POINT (4697157 -74140516)
2018,Septiembre,Antigua y Barbuda,2,2,,4,POINT (6170465 -7542726)
2018,Septiembre,Arabia Saudita,0,1,,1,POINT (10446304 -75516486)
2018,Septiembre,Arabia Saudita,0,4,,4,POINT (4697157 -74140516)
2018,Septiembre,Arabia Saudita,0,2,,2,POINT (6170465 -7542726)
2018,Septiembre,Argelia,0,1,,1,POINT (10446304 -75516486)
2018,Septiembre,Argelia,4,4,,8,POINT (4697157 -74140516)
2018,Septiembre,Argentina,4,6,,10,POINT (-4191162 -69941498)
2018,Septiembre,Argentina,1,7,,8,POINT (-4214082 -69941431)
2018,Septiembre,Argentina,10,21,,31,POINT (0.33002 -76876446)
2018,Septiembre,Argentina,62,108,,170,POINT (0.81488 -77356)
2018,Septiembre,Argentina,1,0,,1,POINT (1800143 -78802679)
2018,Septiembre,Argentina,390,228,,618,POINT (10406342 -75527794)
2018,Septiembre,Argentina,1587,1377,,2964,POINT (10446304 -75516486)
2018,Septiembre,Argentina,17,49,,66,POINT (10886686 -74776479)
2018,Septiembre,Argentina,5,7,,12,POINT (11360029 -72129595)
2018,Septiembre,Argentina,317,282,,599,POINT (125862 -81702165)
2018,Septiembre,Argentina,49,85,,134,POINT (3451668 -76532004)
2018,Septiembre,Argentina,0,1,,1,POINT (445285 -75766353)
2018,Septiembre,Argentina,3118,4528,,7646,POINT (4697157 -74140516)
2018,Septiembre,Argentina,5,11,,16,POINT (4815189 -75736374)
2018,Septiembre,Argentina,175,353,,528,POINT (6170465 -7542726)
2018,Septiembre,Argentina,3,3,,6,POINT (7128047 -73181317)
2018,Septiembre,Argentina,9,22,,31,POINT (7819 -72453013)
2018,Septiembre,Argentina,5,10,,15,POINT (836068 -72409396)
2018,Septiembre,República de Armenia,3,1,,4,POINT (4697157 -74140516)
2018,Septiembre,Australia,3,2,,5,POINT (-4191162 -69941498)
2018,Septiembre,Australia,3,2,,5,POINT (-4214082 -69941431)
2018,Septiembre,Australia,25,24,,49,POINT (0.81488 -77356)
2018,Septiembre,Australia,20,32,,52,POINT (10406342 -75527794)
2018,Septiembre,Australia,56,96,,152,POINT (10446304 -75516486)
2018,Septiembre,Australia,5,15,,20,POINT (10886686 -74776479)
2018,Septiembre,Australia,1,1,,2,POINT (11247723 -74213989)
2018,Septiembre,Australia,0,2,,2,POINT (11360029 -72129595)
2018,Septiembre,Australia,5,22,,27,POINT (3451668 -76532004)
2018,Septiembre,Australia,303,504,,807,POINT (4697157 -74140516)
2018,Septiembre,Australia,0,1,,1,POINT (4815189 -75736374)
2018,Septiembre,Australia,37,101,,138,POINT (6170465 -7542726)
2018,Septiembre,Australia,1,0,,1,POINT (7088729 -70740253)
2018,Septiembre,Australia,1,0,,1,POINT (7128047 -73181317)
2018,Septiembre,Australia,1,2,,3,POINT (7819 -72453013)
2018,Septiembre,Australia,13,9,,22,POINT (863337 -7735002)
2018,Septiembre,Austria,1,1,,2,POINT (-4191162 -69941498)
2018,Septiembre,Austria,1,4,,5,POINT (-4214082 -69941431)
2018,Septiembre,Austria,7,8,,15,POINT (0.81488 -77356)
2018,Septiembre,Austria,2,7,,9,POINT (10406342 -75527794)
2018,Septiembre,Austria,15,20,,35,POINT (10446304 -75516486)
2018,Septiembre,Austria,2,3,,5,POINT (10886686 -74776479)
2018,Septiembre,Austria,0,1,,1,POINT (11360029 -72129595)
2018,Septiembre,Austria,3,8,,11,POINT (3451668 -76532004)
2018,Septiembre,Austria,146,281,,427,POINT (4697157 -74140516)
2018,Septiembre,Austria,13,22,,35,POINT (6170465 -7542726)
2018,Septiembre,Austria,0,1,,1,POINT (7128047 -73181317)
2018,Septiembre,Austria,0,1,,1,POINT (7819 -72453013)
2018,Septiembre,Austria,1,1,,2,POINT (863337 -7735002)
2018,Septiembre,Azerbaiyán,2,3,,5,POINT (4697157 -74140516)
2018,Septiembre,Bahamas,0,1,,1,POINT (10406342 -75527794)
2018,Septiembre,Bahamas,6,5,,11,POINT (10446304 -75516486)
2018,Septiembre,Bahamas,0,2,,2,POINT (10886686 -74776479)
2018,Septiembre,Bahamas,0,1,,1,POINT (125862 -81702165)
2018,Septiembre,Bahamas,2,2,,4,POINT (3451668 -76532004)
2018,Septiembre,Bahamas,0,9,,9,POINT (4697157 -74140516)
2018,Septiembre,Bahamas,2,2,,4,POINT (6170465 -7542726)
2018,Septiembre,Bahréin,0,2,,2,POINT (4697157 -74140516)
2018,Septiembre,Bangladesh,0,1,,1,POINT (10446304 -75516486)
2018,Septiembre,Bangladesh,0,1,,1,POINT (3884426 -77061029)
2018,Septiembre,Bangladesh,0,2,,2,POINT (4697157 -74140516)
2018,Septiembre,Barbados,2,1,,3,POINT (10446304 -75516486)
2018,Septiembre,Barbados,0,2,,2,POINT (10886686 -74776479)
2018,Septiembre,Barbados,3,4,,7,POINT (3451668 -76532004)
2018,Septiembre,Barbados,6,9,,15,POINT (4697157 -74140516)
2018,Septiembre,Barbados,0,3,,3,POINT (6170465 -7542726)
2018,Septiembre,República de Belarús,1,0,,1,POINT (10446304 -75516486)
2018,Septiembre,República de Belarús,1,0,,1,POINT (3451668 -76532004)
2018,Septiembre,República de Belarús,4,1,,5,POINT (4697157 -74140516)
2018,Septiembre,Bélgica,2,7,,9,POINT (-4191162 -69941498)
2018,Septiembre,Bélgica,0,1,,1,POINT (-4214082 -69941431)
2018,Septiembre,Bélgica,3,10,,13,POINT (0.81488 -77356)
2018,Septiembre,Bélgica,4,7,,11,POINT (10406342 -75527794)
2018,Septiembre,Bélgica,27,50,,77,POINT (10446304 -75516486)
2018,Septiembre,Bélgica,4,12,,16,POINT (10886686 -74776479)
2018,Septiembre,Bélgica,1,0,,1,POINT (11247723 -74213989)
2018,Septiembre,Bélgica,0,1,,1,POINT (11360029 -72129595)
2018,Septiembre,Bélgica,0,1,,1,POINT (125862 -81702165)
2018,Septiembre,Bélgica,8,15,,23,POINT (3451668 -76532004)
2018,Septiembre,Bélgica,330,509,,839,POINT (4697157 -74140516)
2018,Septiembre,Bélgica,0,2,,2,POINT (4815189 -75736374)
2018,Septiembre,Bélgica,40,76,,116,POINT (6170465 -7542726)
2018,Septiembre,Bélgica,0,1,,1,POINT (7128047 -73181317)
2018,Septiembre,Bélgica,0,1,,1,POINT (7819 -72453013)
2018,Septiembre,Belice,2,2,,4,POINT (10446304 -75516486)
2018,Septiembre,Belice,0,1,,1,POINT (11360029 -72129595)
2018,Septiembre,Belice,3,4,,7,POINT (3451668 -76532004)
2018,Septiembre,Belice,17,25,,42,POINT (4697157 -74140516)
2018,Septiembre,Belice,0,3,,3,POINT (6170465 -7542726)
2018,Septiembre,Belice,0,1,,1,POINT (7128047 -73181317)
2018,Septiembre,Benín,0,1,,1,POINT (4697157 -74140516)
2018,Septiembre,Bermudas/Territorio Británico de Ultramar,1,1,,2,POINT (4697157 -74140516)
2018,Septiembre,Bolivia,1,1,,2,POINT (-4191162 -69941498)
2018,Septiembre,Bolivia,0,1,,1,POINT (0.33002 -76876446)
2018,Septiembre,Bolivia,9,12,,21,POINT (0.81488 -77356)
2018,Septiembre,Bolivia,40,28,,68,POINT (10406342 -75527794)
2018,Septiembre,Bolivia,233,190,,423,POINT (10446304 -75516486)
2018,Septiembre,Bolivia,3,6,,9,POINT (10886686 -74776479)
2018,Septiembre,Bolivia,25,20,,45,POINT (125862 -81702165)
2018,Septiembre,Bolivia,17,18,,35,POINT (3451668 -76532004)
2018,Septiembre,Bolivia,554,646,,1200,POINT (4697157 -74140516)
2018,Septiembre,Bolivia,1,0,,1,POINT (4815189 -75736374)
2018,Septiembre,Bolivia,58,66,,124,POINT (6170465 -7542726)
2018,Septiembre,Bolivia,0,1,,1,POINT (7128047 -73181317)
2018,Septiembre,Bolivia,0,6,,6,POINT (7819 -72453013)
2018,Septiembre,Bosnia y Herzegovina,0,1,,1,POINT (3451668 -76532004)
2018,Septiembre,Bosnia y Herzegovina,2,6,,8,POINT (4697157 -74140516)
2018,Septiembre,Botsuana,0,1,,1,POINT (10886686 -74776479)
2018,Septiembre,Brasil,132,119,,251,POINT (-4191162 -69941498)
2018,Septiembre,Brasil,1,0,,1,POINT (-4214082 -69941431)
2018,Septiembre,Brasil,1,1,,2,POINT (0.33002 -76876446)
2018,Septiembre,Brasil,28,34,,62,POINT (0.81488 -77356)
2018,Septiembre,Brasil,606,450,,1056,POINT (10406342 -75527794)
2018,Septiembre,Brasil,1043,823,,1866,POINT (10446304 -75516486)
2018,Septiembre,Brasil,6,23,,29,POINT (10886686 -74776479)
2018,Septiembre,Brasil,3,2,,5,POINT (11360029 -72129595)
2018,Septiembre,Brasil,252,231,,483,POINT (125862 -81702165)
2018,Septiembre,Brasil,39,86,,125,POINT (3451668 -76532004)
2018,Septiembre,Brasil,0,3,,3,POINT (3866713 -67927521)
2018,Septiembre,Brasil,5864,7040,,12904,POINT (4697157 -74140516)
2018,Septiembre,Brasil,0,4,,4,POINT (4815189 -75736374)
2018,Septiembre,Brasil,126,216,,342,POINT (6170465 -7542726)
2018,Septiembre,Brasil,2,2,,4,POINT (6185536 -67484028)
2018,Septiembre,Brasil,0,1,,1,POINT (7088729 -70740253)
2018,Septiembre,Brasil,3,4,,7,POINT (7128047 -73181317)
2018,Septiembre,Brasil,5,3,,8,POINT (7819 -72453013)
2018,Septiembre,Brasil,2,1,,3,POINT (836068 -72409396)
2018,Septiembre,Brasil,0,1,,1,POINT (863337 -7735002)
2018,Septiembre,Bulgaria,0,2,,2,POINT (10406342 -75527794)
2018,Septiembre,Bulgaria,3,10,,13,POINT (10446304 -75516486)
2018,Septiembre,Bulgaria,0,1,,1,POINT (3451668 -76532004)
2018,Septiembre,Bulgaria,38,43,,81,POINT (4697157 -74140516)
2018,Septiembre,Bulgaria,3,8,,11,POINT (6170465 -7542726)
2018,Septiembre,Bulgaria,0,2,,2,POINT (9402597 -75681642)
2018,Septiembre,Burkina Faso,1,3,,4,POINT (4697157 -74140516)
2018,Septiembre,Bután,1,1,,2,POINT (4697157 -74140516)
2018,Septiembre,Islas Caimán/Territorio Británico de Ultramar,1,2,,3,POINT (10446304 -75516486)
2018,Septiembre,Islas Caimán/Territorio Británico de Ultramar,0,1,,1,POINT (125862 -81702165)
2018,Septiembre,Islas Caimán/Territorio Británico de Ultramar,2,2,,4,POINT (4697157 -74140516)
2018,Septiembre,Camboya,0,1,,1,POINT (4697157 -74140516)
2018,Septiembre,Camerún,0,1,,1,POINT (10446304 -75516486)
2018,Septiembre,Camerún,3,3,,6,POINT (4697157 -74140516)
2018,Septiembre,Camerún,1,0,,1,POINT (6170465 -7542726)
2018,Septiembre,Canadá,0,1,,1,POINT (-4191162 -69941498)
2018,Septiembre,Canadá,7,8,,15,POINT (0.81488 -77356)
2018,Septiembre,Canadá,9,10,,19,POINT (10406342 -75527794)
2018,Septiembre,Canadá,198,263,,461,POINT (10446304 -75516486)
2018,Septiembre,Canadá,11,32,,43,POINT (10886686 -74776479)
2018,Septiembre,Canadá,0,2,,2,POINT (11360029 -72129595)
2018,Septiembre,Canadá,4,0,,4,POINT (125862 -81702165)
2018,Septiembre,Canadá,49,59,,108,POINT (3451668 -76532004)
2018,Septiembre,Canadá,1,2,,3,POINT (445285 -75766353)
2018,Septiembre,Canadá,811,1448,,2259,POINT (4697157 -74140516)
2018,Septiembre,Canadá,18,30,,48,POINT (4815189 -75736374)
2018,Septiembre,Canadá,135,334,,469,POINT (6170465 -7542726)
2018,Septiembre,Canadá,1,5,,6,POINT (7128047 -73181317)
2018,Septiembre,Canadá,0,1,,1,POINT (863337 -7735002)
2018,Septiembre,Chad,0,2,,2,POINT (4697157 -74140516)
2018,Septiembre,República Del Congo,0,1,,1,POINT (4697157 -74140516)
2018,Septiembre,República Democrática del Congo,10,1,,11,POINT (4697157 -74140516)
2018,Septiembre,República Democrática del Congo,3,0,,3,POINT (6170465 -7542726)
2018,Septiembre,República de Corea,0,1,,1,POINT (-4191162 -69941498)
2018,Septiembre,República de Corea,0,2,,2,POINT (-4214082 -69941431)
2018,Septiembre,República de Corea,1,0,,1,POINT (0.33002 -76876446)
2018,Septiembre,República de Corea,5,6,,11,POINT (0.81488 -77356)
2018,Septiembre,República de Corea,4,3,,7,POINT (10446304 -75516486)
2018,Septiembre,República de Corea,0,5,,5,POINT (10886686 -74776479)
2018,Septiembre,República de Corea,3,2,,5,POINT (125862 -81702165)
2018,Septiembre,República de Corea,0,3,,3,POINT (3451668 -76532004)
2018,Septiembre,República de Corea,204,390,,594,POINT (4697157 -74140516)
2018,Septiembre,República de Corea,0,1,,1,POINT (4815189 -75736374)
2018,Septiembre,República de Corea,12,38,,50,POINT (6170465 -7542726)
2018,Septiembre,República de Corea,1,2,,3,POINT (836068 -72409396)
2018,Septiembre,Costa de Marfil,0,1,,1,POINT (10446304 -75516486)
2018,Septiembre,Costa de Marfil,1,3,,4,POINT (4697157 -74140516)
2018,Septiembre,Costa de Marfil,0,1,,1,POINT (4815189 -75736374)
2018,Septiembre,Costa Rica,0,1,,1,POINT (-4191162 -69941498)
2018,Septiembre,Costa Rica,2,2,,4,POINT (0.81488 -77356)
2018,Septiembre,Costa Rica,4,6,,10,POINT (10406342 -75527794)
2018,Septiembre,Costa Rica,98,116,,214,POINT (10446304 -75516486)
2018,Septiembre,Costa Rica,5,13,,18,POINT (10886686 -74776479)
2018,Septiembre,Costa Rica,38,29,,67,POINT (125862 -81702165)
2018,Septiembre,Costa Rica,41,85,,126,POINT (3451668 -76532004)
2018,Septiembre,Costa Rica,1,1,,2,POINT (445285 -75766353)
2018,Septiembre,Costa Rica,1376,1678,,3054,POINT (4697157 -74140516)
2018,Septiembre,Costa Rica,5,8,,13,POINT (4815189 -75736374)
2018,Septiembre,Costa Rica,144,220,,364,POINT (6170465 -7542726)
2018,Septiembre,Costa Rica,1,6,,7,POINT (7128047 -73181317)
2018,Septiembre,Costa Rica,0,2,,2,POINT (7819 -72453013)
2018,Septiembre,Costa Rica,0,1,,1,POINT (836068 -72409396)
2018,Septiembre,Costa Rica,0,4,,4,POINT (863337 -7735002)
2018,Septiembre,Croacia,0,1,,1,POINT (0.81488 -77356)
2018,Septiembre,Croacia,0,2,,2,POINT (10406342 -75527794)
2018,Septiembre,Croacia,2,7,,9,POINT (10446304 -75516486)
2018,Septiembre,Croacia,1,1,,2,POINT (11360029 -72129595)
2018,Septiembre,Croacia,0,3,,3,POINT (3451668 -76532004)
2018,Septiembre,Croacia,10,44,,54,POINT (4697157 -74140516)
2018,Septiembre,Croacia,5,10,,15,POINT (6170465 -7542726)
2018,Septiembre,Cuba,0,1,,1,POINT (0.33002 -76876446)
2018,Septiembre,Cuba,1,0,,1,POINT (0.81488 -77356)
2018,Septiembre,Cuba,0,2,,2,POINT (10406342 -75527794)
2018,Septiembre,Cuba,8,12,,20,POINT (10446304 -75516486)
2018,Septiembre,Cuba,6,26,,32,POINT (10886686 -74776479)
2018,Septiembre,Cuba,20,48,,68,POINT (3451668 -76532004)
2018,Septiembre,Cuba,186,268,,454,POINT (4697157 -74140516)
2018,Septiembre,Cuba,2,4,,6,POINT (4815189 -75736374)
2018,Septiembre,Cuba,21,39,,60,POINT (6170465 -7542726)
2018,Septiembre,Cuba,1,2,,3,POINT (7128047 -73181317)
2018,Septiembre,Cuba,0,2,,2,POINT (7819 -72453013)
2018,Septiembre,República Checa,4,11,,15,POINT (0.81488 -77356)
2018,Septiembre,República Checa,0,1,,1,POINT (10406342 -75527794)
2018,Septiembre,República Checa,1,8,,9,POINT (10446304 -75516486)
2018,Septiembre,República Checa,2,2,,4,POINT (3451668 -76532004)
2018,Septiembre,República Checa,108,135,,243,POINT (4697157 -74140516)
2018,Septiembre,República Checa,5,2,,7,POINT (6170465 -7542726)
2018,Septiembre,República Checa,0,1,,1,POINT (863337 -7735002)
2018,Septiembre,Chile,1,2,,3,POINT (-4191162 -69941498)
2018,Septiembre,Chile,2,1,,3,POINT (-4214082 -69941431)
2018,Septiembre,Chile,2,2,,4,POINT (0.33002 -76876446)
2018,Septiembre,Chile,34,69,,103,POINT (0.81488 -77356)
2018,Septiembre,Chile,0,1,,1,POINT (1800143 -78802679)
2018,Septiembre,Chile,128,95,,223,POINT (10406342 -75527794)
2018,Septiembre,Chile,557,439,,996,POINT (10446304 -75516486)
2018,Septiembre,Chile,30,37,,67,POINT (10886686 -74776479)
2018,Septiembre,Chile,4,3,,7,POINT (11360029 -72129595)
2018,Septiembre,Chile,99,75,,174,POINT (125862 -81702165)
2018,Septiembre,Chile,33,70,,103,POINT (3451668 -76532004)
2018,Septiembre,Chile,1,1,,2,POINT (445285 -75766353)
2018,Septiembre,Chile,4566,5417,,9983,POINT (4697157 -74140516)
2018,Septiembre,Chile,0,2,,2,POINT (4815189 -75736374)
2018,Septiembre,Chile,54,166,,220,POINT (6170465 -7542726)
2018,Septiembre,Chile,0,3,,3,POINT (7128047 -73181317)
2018,Septiembre,Chile,10,24,,34,POINT (7819 -72453013)
2018,Septiembre,Chile,3,4,,7,POINT (836068 -72409396)
2018,Septiembre,Chile,0,1,,1,POINT (863337 -7735002)
2018,Septiembre,China,5,3,,8,POINT (0.81488 -77356)
2018,Septiembre,China,6,2,,8,POINT (10406342 -75527794)
2018,Septiembre,China,52,93,,145,POINT (10446304 -75516486)
2018,Septiembre,China,7,16,,23,POINT (10886686 -74776479)
2018,Septiembre,China,0,4,,4,POINT (11360029 -72129595)
2018,Septiembre,China,1,0,,1,POINT (125862 -81702165)
2018,Septiembre,China,10,20,,30,POINT (3451668 -76532004)
2018,Septiembre,China,1,0,,1,POINT (445285 -75766353)
2018,Septiembre,China,448,974,,1422,POINT (4697157 -74140516)
2018,Septiembre,China,1,2,,3,POINT (4815189 -75736374)
2018,Septiembre,China,38,60,,98,POINT (6170465 -7542726)
2018,Septiembre,China,3,7,,10,POINT (7819 -72453013)
2018,Septiembre,China,0,1,,1,POINT (836068 -72409396)
2018,Septiembre,Taiwán,0,1,,1,POINT (0.81488 -77356)
2018,Septiembre,Taiwán,5,3,,8,POINT (10406342 -75527794)
2018,Septiembre,Taiwán,7,11,,18,POINT (10446304 -75516486)
2018,Septiembre,Taiwán,1,1,,2,POINT (10886686 -74776479)
2018,Septiembre,Taiwán,0,1,,1,POINT (3451668 -76532004)
2018,Septiembre,Taiwán,83,108,,191,POINT (4697157 -74140516)
2018,Septiembre,Taiwán,6,11,,17,POINT (6170465 -7542726)
2018,Septiembre,Taiwán,0,2,,2,POINT (7819 -72453013)
2018,Septiembre,Chipre,0,1,,1,POINT (10446304 -75516486)
2018,Septiembre,Chipre,3,10,,13,POINT (4697157 -74140516)
2018,Septiembre,Chipre,0,1,,1,POINT (6170465 -7542726)
2018,Septiembre,Dinamarca,1,1,,2,POINT (0.81488 -77356)
2018,Septiembre,Dinamarca,1,2,,3,POINT (10406342 -75527794)
2018,Septiembre,Dinamarca,11,23,,34,POINT (10446304 -75516486)
2018,Septiembre,Dinamarca,2,2,,4,POINT (10886686 -74776479)
2018,Septiembre,Dinamarca,1,9,,10,POINT (3451668 -76532004)
2018,Septiembre,Dinamarca,0,1,,1,POINT (3884426 -77061029)
2018,Septiembre,Dinamarca,74,120,,194,POINT (4697157 -74140516)
2018,Septiembre,Dinamarca,0,1,,1,POINT (4815189 -75736374)
2018,Septiembre,Dinamarca,12,21,,33,POINT (6170465 -7542726)
2018,Septiembre,Dinamarca,2,1,,3,POINT (863337 -7735002)
2018,Septiembre,Dominica,2,2,,4,POINT (10446304 -75516486)
2018,Septiembre,Dominica,2,1,,3,POINT (3451668 -76532004)
2018,Septiembre,Dominica,2,0,,2,POINT (4697157 -74140516)
2018,Septiembre,Dominica,1,2,,3,POINT (6170465 -7542726)
2018,Septiembre,Ecuador,0,1,,1,POINT (-4191162 -69941498)
2018,Septiembre,Ecuador,0,10,,10,POINT (-4214082 -69941431)
2018,Septiembre,Ecuador,0,2,,2,POINT (0.185957 -7478366)
2018,Septiembre,Ecuador,43,217,,260,POINT (0.33002 -76876446)
2018,Septiembre,Ecuador,3,7,,10,POINT (0.812436 -77847006)
2018,Septiembre,Ecuador,1488,2500,,3988,POINT (0.81488 -77356)
2018,Septiembre,Ecuador,21,94,,115,POINT (1800143 -78802679)
2018,Septiembre,Ecuador,30,43,,73,POINT (10406342 -75527794)
2018,Septiembre,Ecuador,217,260,,477,POINT (10446304 -75516486)
2018,Septiembre,Ecuador,86,63,,149,POINT (10886686 -74776479)
2018,Septiembre,Ecuador,10,13,,23,POINT (11360029 -72129595)
2018,Septiembre,Ecuador,19,16,,35,POINT (125862 -81702165)
2018,Septiembre,Ecuador,572,703,,1275,POINT (3451668 -76532004)
2018,Septiembre,Ecuador,1,1,,2,POINT (445285 -75766353)
2018,Septiembre,Ecuador,3759,4906,,8665,POINT (4697157 -74140516)
2018,Septiembre,Ecuador,0,1,,1,POINT (4815189 -75736374)
2018,Septiembre,Ecuador,70,100,,170,POINT (6170465 -7542726)
2018,Septiembre,Ecuador,1,1,,2,POINT (7088729 -70740253)
2018,Septiembre,Ecuador,1,1,,2,POINT (7128047 -73181317)
2018,Septiembre,Ecuador,116,168,,284,POINT (7819 -72453013)
2018,Septiembre,Ecuador,3,10,,13,POINT (836068 -72409396)
2018,Septiembre,Ecuador,1,0,,1,POINT (863337 -7735002)
2018,Septiembre,Egipto,6,13,,19,POINT (10446304 -75516486)
2018,Septiembre,Egipto,0,2,,2,POINT (10886686 -74776479)
2018,Septiembre,Egipto,0,2,,2,POINT (3451668 -76532004)
2018,Septiembre,Egipto,8,31,,39,POINT (4697157 -74140516)
2018,Septiembre,Egipto,0,2,,2,POINT (6170465 -7542726)
2018,Septiembre,El Salvador,0,1,,1,POINT (-4191162 -69941498)
2018,Septiembre,El Salvador,0,1,,1,POINT (0.81488 -77356)
2018,Septiembre,El Salvador,0,1,,1,POINT (10406342 -75527794)
2018,Septiembre,El Salvador,31,32,,63,POINT (10446304 -75516486)
2018,Septiembre,El Salvador,10,8,,18,POINT (10886686 -74776479)
2018,Septiembre,El Salvador,88,132,,220,POINT (3451668 -76532004)
2018,Septiembre,El Salvador,0,1,,1,POINT (445285 -75766353)
2018,Septiembre,El Salvador,643,899,,1542,POINT (4697157 -74140516)
2018,Septiembre,El Salvador,2,2,,4,POINT (4815189 -75736374)
2018,Septiembre,El Salvador,114,201,,315,POINT (6170465 -7542726)
2018,Septiembre,El Salvador,1,1,,2,POINT (7128047 -73181317)
2018,Septiembre,El Salvador,1,1,,2,POINT (7819 -72453013)
2018,Septiembre,El Salvador,0,1,,1,POINT (836068 -72409396)
2018,Septiembre,El Salvador,0,1,,1,POINT (9402597 -75681642)
2018,Septiembre,Emiratos Árabes,0,15,,15,POINT (4697157 -74140516)
2018,Septiembre,Emiratos Árabes,0,2,,2,POINT (6170465 -7542726)
2018,Septiembre,España,1,3,,4,POINT (-4191162 -69941498)
2018,Septiembre,España,4,5,,9,POINT (-4214082 -69941431)
2018,Septiembre,España,6,5,,11,POINT (0.33002 -76876446)
2018,Septiembre,España,25,26,,51,POINT (0.81488 -77356)
2018,Septiembre,España,21,24,,45,POINT (10406342 -75527794)
2018,Septiembre,España,121,215,,336,POINT (10446304 -75516486)
2018,Septiembre,España,17,63,,80,POINT (10886686 -74776479)
2018,Septiembre,España,0,1,,1,POINT (11247723 -74213989)
2018,Septiembre,España,2,7,,9,POINT (11360029 -72129595)
2018,Septiembre,España,5,6,,11,POINT (125862 -81702165)
2018,Septiembre,España,215,363,,578,POINT (3451668 -76532004)
2018,Septiembre,España,1,0,,1,POINT (445285 -75766353)
2018,Septiembre,España,3324,5962,,9286,POINT (4697157 -74140516)
2018,Septiembre,España,7,16,,23,POINT (4815189 -75736374)
2018,Septiembre,España,330,678,,1008,POINT (6170465 -7542726)
2018,Septiembre,España,2,3,,5,POINT (7128047 -73181317)
2018,Septiembre,España,26,43,,69,POINT (7819 -72453013)
2018,Septiembre,España,2,7,,9,POINT (836068 -72409396)
2018,Septiembre,España,1,1,,2,POINT (863337 -7735002)
2018,Septiembre,Eritrea,0,1,,1,POINT (4697157 -74140516)
2018,Septiembre,Eslovaquia,3,1,,4,POINT (0.81488 -77356)
2018,Septiembre,Eslovaquia,0,1,,1,POINT (10406342 -75527794)
2018,Septiembre,Eslovaquia,2,3,,5,POINT (10446304 -75516486)
2018,Septiembre,Eslovaquia,25,53,,78,POINT (4697157 -74140516)
2018,Septiembre,Eslovaquia,2,4,,6,POINT (6170465 -7542726)
2018,Septiembre,Eslovaquia,1,0,,1,POINT (7819 -72453013)
2018,Septiembre,Eslovenia,0,1,,1,POINT (0.81488 -77356)
2018,Septiembre,Eslovenia,1,2,,3,POINT (10446304 -75516486)
2018,Septiembre,Eslovenia,30,28,,58,POINT (4697157 -74140516)
2018,Septiembre,Eslovenia,3,2,,5,POINT (6170465 -7542726)
2018,Septiembre,Estados Unidos de América,15,29,,44,POINT (-4191162 -69941498)
2018,Septiembre,Estados Unidos de América,4,9,,13,POINT (-4214082 -69941431)
2018,Septiembre,Estados Unidos de América,2,2,,4,POINT (0.33002 -76876446)
2018,Septiembre,Estados Unidos de América,23,58,,81,POINT (0.81488 -77356)
2018,Septiembre,Estados Unidos de América,51,74,,125,POINT (10406342 -75527794)
2018,Septiembre,Estados Unidos de América,3809,5568,,9377,POINT (10446304 -75516486)
2018,Septiembre,Estados Unidos de América,398,841,,1239,POINT (10886686 -74776479)
2018,Septiembre,Estados Unidos de América,6,8,,14,POINT (11247723 -74213989)
2018,Septiembre,Estados Unidos de América,1,3,,4,POINT (11360029 -72129595)
2018,Septiembre,Estados Unidos de América,39,41,,80,POINT (125862 -81702165)
2018,Septiembre,Estados Unidos de América,886,1372,,2258,POINT (3451668 -76532004)
2018,Septiembre,Estados Unidos de América,121,221,,342,POINT (445285 -75766353)
2018,Septiembre,Estados Unidos de América,7344,13368,,20712,POINT (4697157 -74140516)
2018,Septiembre,Estados Unidos de América,79,148,,227,POINT (4815189 -75736374)
2018,Septiembre,Estados Unidos de América,2158,6321,,8479,POINT (6170465 -7542726)
2018,Septiembre,Estados Unidos de América,0,1,,1,POINT (6185536 -67484028)
2018,Septiembre,Estados Unidos de América,1,0,,1,POINT (7088729 -70740253)
2018,Septiembre,Estados Unidos de América,20,36,,56,POINT (7128047 -73181317)
2018,Septiembre,Estados Unidos de América,6,14,,20,POINT (7819 -72453013)
2018,Septiembre,Estados Unidos de América,1,7,,8,POINT (836068 -72409396)
2018,Septiembre,Estados Unidos de América,15,16,,31,POINT (863337 -7735002)
2018,Septiembre,Estonia,12,9,,21,POINT (4697157 -74140516)
2018,Septiembre,Estonia,2,4,,6,POINT (6170465 -7542726)
2018,Septiembre,Etiopia,0,1,,1,POINT (3451668 -76532004)
2018,Septiembre,Etiopia,2,44,,46,POINT (4697157 -74140516)
2018,Septiembre,Etiopia,2,1,,3,POINT (6170465 -7542726)
2018,Septiembre,Filipinas,2,30,,32,POINT (10406342 -75527794)
2018,Septiembre,Filipinas,2,43,,45,POINT (10446304 -75516486)
2018,Septiembre,Filipinas,0,15,,15,POINT (10886686 -74776479)
2018,Septiembre,Filipinas,0,18,,18,POINT (11247723 -74213989)
2018,Septiembre,Filipinas,2,3,,5,POINT (3451668 -76532004)
2018,Septiembre,Filipinas,0,1,,1,POINT (3884426 -77061029)
2018,Septiembre,Filipinas,55,71,,126,POINT (4697157 -74140516)
2018,Septiembre,Filipinas,2,0,,2,POINT (4815189 -75736374)
2018,Septiembre,Filipinas,9,8,,17,POINT (6170465 -7542726)
2018,Septiembre,Filipinas,0,5,,5,POINT (9402597 -75681642)
2018,Septiembre,Finlandia,3,3,,6,POINT (0.81488 -77356)
2018,Septiembre,Finlandia,1,0,,1,POINT (10406342 -75527794)
2018,Septiembre,Finlandia,2,5,,7,POINT (10446304 -75516486)
2018,Septiembre,Finlandia,1,3,,4,POINT (3451668 -76532004)
2018,Septiembre,Finlandia,42,57,,99,POINT (4697157 -74140516)
2018,Septiembre,Finlandia,0,13,,13,POINT (6170465 -7542726)
2018,Septiembre,Francia,5,19,,24,POINT (-4191162 -69941498)
2018,Septiembre,Francia,5,6,,11,POINT (-4214082 -69941431)
2018,Septiembre,Francia,1,3,,4,POINT (0.33002 -76876446)
2018,Septiembre,Francia,51,78,,129,POINT (0.81488 -77356)
2018,Septiembre,Francia,5,14,,19,POINT (10406342 -75527794)
2018,Septiembre,Francia,105,183,,288,POINT (10446304 -75516486)
2018,Septiembre,Francia,19,23,,42,POINT (10886686 -74776479)
2018,Septiembre,Francia,0,1,,1,POINT (11247723 -74213989)
2018,Septiembre,Francia,1,3,,4,POINT (11360029 -72129595)
2018,Septiembre,Francia,1,1,,2,POINT (125862 -81702165)
2018,Septiembre,Francia,1,1,,2,POINT (133387613 -81372937)
2018,Septiembre,Francia,49,79,,128,POINT (3451668 -76532004)
2018,Septiembre,Francia,1,0,,1,POINT (445285 -75766353)
2018,Septiembre,Francia,1529,2442,,3971,POINT (4697157 -74140516)
2018,Septiembre,Francia,6,9,,15,POINT (4815189 -75736374)
2018,Septiembre,Francia,143,315,,458,POINT (6170465 -7542726)
2018,Septiembre,Francia,1,0,,1,POINT (6185536 -67484028)
2018,Septiembre,Francia,0,1,,1,POINT (7088729 -70740253)
2018,Septiembre,Francia,1,3,,4,POINT (7128047 -73181317)
2018,Septiembre,Francia,1,7,,8,POINT (7819 -72453013)
2018,Septiembre,Francia,0,1,,1,POINT (836068 -72409396)
2018,Septiembre,Francia,1,4,,5,POINT (863337 -7735002)
2018,Septiembre,Gambia,0,1,,1,POINT (4697157 -74140516)
2018,Septiembre,Georgia,0,4,,4,POINT (10446304 -75516486)
2018,Septiembre,Georgia,0,2,,2,POINT (11247723 -74213989)
2018,Septiembre,Georgia,2,5,,7,POINT (4697157 -74140516)
2018,Septiembre,Georgia,0,7,,7,POINT (9402597 -75681642)
2018,Septiembre,Ghana,0,1,,1,POINT (10446304 -75516486)
2018,Septiembre,Ghana,2,3,,5,POINT (4697157 -74140516)
2018,Septiembre,Granada,1,2,,3,POINT (10446304 -75516486)
2018,Septiembre,Granada,0,1,,1,POINT (11360029 -72129595)
2018,Septiembre,Granada,0,2,,2,POINT (4697157 -74140516)
2018,Septiembre,Grecia,0,1,,1,POINT (0.81488 -77356)
2018,Septiembre,Grecia,0,2,,2,POINT (10406342 -75527794)
2018,Septiembre,Grecia,3,4,,7,POINT (10446304 -75516486)
2018,Septiembre,Grecia,0,3,,3,POINT (10886686 -74776479)
2018,Septiembre,Grecia,0,2,,2,POINT (11247723 -74213989)
2018,Septiembre,Grecia,0,1,,1,POINT (3451668 -76532004)
2018,Septiembre,Grecia,1,0,,1,POINT (3884426 -77061029)
2018,Septiembre,Grecia,27,66,,93,POINT (4697157 -74140516)
2018,Septiembre,Grecia,2,9,,11,POINT (6170465 -7542726)
2018,Septiembre,Grecia,0,1,,1,POINT (7819 -72453013)
2018,Septiembre,Grecia,1,5,,6,POINT (9402597 -75681642)
2018,Septiembre,Guatemala,1,2,,3,POINT (0.81488 -77356)
2018,Septiembre,Guatemala,1,2,,3,POINT (10406342 -75527794)
2018,Septiembre,Guatemala,99,177,,276,POINT (10446304 -75516486)
2018,Septiembre,Guatemala,19,47,,66,POINT (10886686 -74776479)
2018,Septiembre,Guatemala,3,2,,5,POINT (125862 -81702165)
2018,Septiembre,Guatemala,26,90,,116,POINT (3451668 -76532004)
2018,Septiembre,Guatemala,496,877,,1373,POINT (4697157 -74140516)
2018,Septiembre,Guatemala,3,6,,9,POINT (4815189 -75736374)
2018,Septiembre,Guatemala,94,219,,313,POINT (6170465 -7542726)
2018,Septiembre,Guatemala,2,0,,2,POINT (7088729 -70740253)
2018,Septiembre,Guatemala,1,3,,4,POINT (7128047 -73181317)
2018,Septiembre,Guatemala,0,1,,1,POINT (7819 -72453013)
2018,Septiembre,Guyana,1,1,,2,POINT (10406342 -75527794)
2018,Septiembre,Guyana,2,7,,9,POINT (10446304 -75516486)
2018,Septiembre,Guyana,1,0,,1,POINT (10886686 -74776479)
2018,Septiembre,Guyana,3,1,,4,POINT (3451668 -76532004)
2018,Septiembre,Guyana,8,6,,14,POINT (4697157 -74140516)
2018,Septiembre,Guyana,2,8,,10,POINT (6170465 -7542726)
2018,Septiembre,Guyana,0,1,,1,POINT (7819 -72453013)
2018,Septiembre,Guinea Ecuatorial,0,1,,1,POINT (6170465 -7542726)
2018,Septiembre,Guinea Bissau,1,0,,1,POINT (3451668 -76532004)
2018,Septiembre,Guinea Bissau,1,0,,1,POINT (4697157 -74140516)
2018,Septiembre,Haití,0,1,,1,POINT (0.81488 -77356)
2018,Septiembre,Haití,2,6,,8,POINT (10446304 -75516486)
2018,Septiembre,Haití,4,7,,11,POINT (4697157 -74140516)
2018,Septiembre,Haití,1,4,,5,POINT (6170465 -7542726)
2018,Septiembre,Honduras,2,5,,7,POINT (0.81488 -77356)
2018,Septiembre,Honduras,1,10,,11,POINT (10406342 -75527794)
2018,Septiembre,Honduras,100,123,,223,POINT (10446304 -75516486)
2018,Septiembre,Honduras,8,9,,17,POINT (10886686 -74776479)
2018,Septiembre,Honduras,2,0,,2,POINT (125862 -81702165)
2018,Septiembre,Honduras,53,65,,118,POINT (3451668 -76532004)
2018,Septiembre,Honduras,0,3,,3,POINT (445285 -75766353)
2018,Septiembre,Honduras,336,385,,721,POINT (4697157 -74140516)
2018,Septiembre,Honduras,4,7,,11,POINT (4815189 -75736374)
2018,Septiembre,Honduras,66,95,,161,POINT (6170465 -7542726)
2018,Septiembre,Honduras,0,1,,1,POINT (7128047 -73181317)
2018,Septiembre,Honduras,0,1,,1,POINT (7819 -72453013)
2018,Septiembre,Honduras,0,1,,1,POINT (9402597 -75681642)
2018,Septiembre,Hong Kong,1,1,,2,POINT (0.81488 -77356)
2018,Septiembre,Hong Kong,2,2,,4,POINT (10446304 -75516486)
2018,Septiembre,Hong Kong,0,1,,1,POINT (11360029 -72129595)
2018,Septiembre,Hong Kong,11,14,,25,POINT (4697157 -74140516)
2018,Septiembre,Hungría,0,2,,2,POINT (-4191162 -69941498)
2018,Septiembre,Hungría,1,0,,1,POINT (0.81488 -77356)
2018,Septiembre,Hungría,1,2,,3,POINT (10406342 -75527794)
2018,Septiembre,Hungría,9,10,,19,POINT (10446304 -75516486)
2018,Septiembre,Hungría,0,1,,1,POINT (10886686 -74776479)
2018,Septiembre,Hungría,0,3,,3,POINT (3451668 -76532004)
2018,Septiembre,Hungría,18,40,,58,POINT (4697157 -74140516)
2018,Septiembre,Hungría,4,10,,14,POINT (6170465 -7542726)
2018,Septiembre,Hungría,0,1,,1,POINT (836068 -72409396)
2018,Septiembre,India,0,1,,1,POINT (0.81488 -77356)
2018,Septiembre,India,0,20,,20,POINT (10406342 -75527794)
2018,Septiembre,India,35,164,,199,POINT (10446304 -75516486)
2018,Septiembre,India,0,16,,16,POINT (10886686 -74776479)
2018,Septiembre,India,0,1,,1,POINT (11247723 -74213989)
2018,Septiembre,India,6,31,,37,POINT (3451668 -76532004)
2018,Septiembre,India,0,10,,10,POINT (3884426 -77061029)
2018,Septiembre,India,81,574,,655,POINT (4697157 -74140516)
2018,Septiembre,India,0,6,,6,POINT (4815189 -75736374)
2018,Septiembre,India,11,80,,91,POINT (6170465 -7542726)
2018,Septiembre,India,0,2,,2,POINT (9402597 -75681642)
2018,Septiembre,Indonesia,1,0,,1,POINT (0.81488 -77356)
2018,Septiembre,Indonesia,0,2,,2,POINT (10406342 -75527794)
2018,Septiembre,Indonesia,11,22,,33,POINT (10446304 -75516486)
2018,Septiembre,Indonesia,0,2,,2,POINT (10886686 -74776479)
2018,Septiembre,Indonesia,0,1,,1,POINT (11247723 -74213989)
2018,Septiembre,Indonesia,9,18,,27,POINT (4697157 -74140516)
2018,Septiembre,Indonesia,0,1,,1,POINT (6170465 -7542726)
2018,Septiembre,Iraq,0,1,,1,POINT (3451668 -76532004)
2018,Septiembre,Iraq,1,1,,2,POINT (4697157 -74140516)
2018,Septiembre,Irán,0,1,,1,POINT (11360029 -72129595)
2018,Septiembre,Irán,3,11,,14,POINT (4697157 -74140516)
2018,Septiembre,República de Irlanda,0,1,,1,POINT (-4214082 -69941431)
2018,Septiembre,República de Irlanda,6,11,,17,POINT (0.81488 -77356)
2018,Septiembre,República de Irlanda,7,5,,12,POINT (10406342 -75527794)
2018,Septiembre,República de Irlanda,22,31,,53,POINT (10446304 -75516486)
2018,Septiembre,República de Irlanda,0,1,,1,POINT (10886686 -74776479)
2018,Septiembre,República de Irlanda,0,1,,1,POINT (11360029 -72129595)
2018,Septiembre,República de Irlanda,2,5,,7,POINT (3451668 -76532004)
2018,Septiembre,República de Irlanda,116,208,,324,POINT (4697157 -74140516)
2018,Septiembre,República de Irlanda,22,50,,72,POINT (6170465 -7542726)
2018,Septiembre,República de Irlanda,8,4,,12,POINT (863337 -7735002)
2018,Septiembre,Islandia,1,0,,1,POINT (0.81488 -77356)
2018,Septiembre,Islandia,2,1,,3,POINT (10446304 -75516486)
2018,Septiembre,Islandia,4,5,,9,POINT (4697157 -74140516)
2018,Septiembre,Islandia,0,1,,1,POINT (6170465 -7542726)
2018,Septiembre,Israel,1,0,,1,POINT (-4191162 -69941498)
2018,Septiembre,Israel,0,1,,1,POINT (-4214082 -69941431)
2018,Septiembre,Israel,15,23,,38,POINT (0.81488 -77356)
2018,Septiembre,Israel,2,3,,5,POINT (10406342 -75527794)
2018,Septiembre,Israel,27,71,,98,POINT (10446304 -75516486)
2018,Septiembre,Israel,0,6,,6,POINT (10886686 -74776479)
2018,Septiembre,Israel,0,2,,2,POINT (125862 -81702165)
2018,Septiembre,Israel,6,22,,28,POINT (3451668 -76532004)
2018,Septiembre,Israel,1,2,,3,POINT (445285 -75766353)
2018,Septiembre,Israel,188,448,,636,POINT (4697157 -74140516)
2018,Septiembre,Israel,2,3,,5,POINT (4815189 -75736374)
2018,Septiembre,Israel,17,52,,69,POINT (6170465 -7542726)
2018,Septiembre,Israel,3,3,,6,POINT (863337 -7735002)
2018,Septiembre,Italia,2,0,,2,POINT (-4191162 -69941498)
2018,Septiembre,Italia,1,2,,3,POINT (-4214082 -69941431)
2018,Septiembre,Italia,2,2,,4,POINT (0.33002 -76876446)
2018,Septiembre,Italia,16,11,,27,POINT (0.81488 -77356)
2018,Septiembre,Italia,10,17,,27,POINT (10406342 -75527794)
2018,Septiembre,Italia,86,182,,268,POINT (10446304 -75516486)
2018,Septiembre,Italia,16,40,,56,POINT (10886686 -74776479)
2018,Septiembre,Italia,1,6,,7,POINT (11360029 -72129595)
2018,Septiembre,Italia,4,9,,13,POINT (125862 -81702165)
2018,Septiembre,Italia,23,79,,102,POINT (3451668 -76532004)
2018,Septiembre,Italia,676,1710,,2386,POINT (4697157 -74140516)
2018,Septiembre,Italia,1,5,,6,POINT (4815189 -75736374)
2018,Septiembre,Italia,71,177,,248,POINT (6170465 -7542726)
2018,Septiembre,Italia,1,0,,1,POINT (7088729 -70740253)
2018,Septiembre,Italia,0,3,,3,POINT (7128047 -73181317)
2018,Septiembre,Italia,11,19,,30,POINT (7819 -72453013)
2018,Septiembre,Italia,2,4,,6,POINT (836068 -72409396)
2018,Septiembre,Italia,0,4,,4,POINT (863337 -7735002)
2018,Septiembre,Jamaica,0,1,,1,POINT (10406342 -75527794)
2018,Septiembre,Jamaica,6,21,,27,POINT (10446304 -75516486)
2018,Septiembre,Jamaica,2,4,,6,POINT (10886686 -74776479)
2018,Septiembre,Jamaica,1,0,,1,POINT (125862 -81702165)
2018,Septiembre,Jamaica,0,2,,2,POINT (133387613 -81372937)
2018,Septiembre,Jamaica,2,1,,3,POINT (3451668 -76532004)
2018,Septiembre,Jamaica,33,26,,59,POINT (4697157 -74140516)
2018,Septiembre,Jamaica,4,17,,21,POINT (6170465 -7542726)
2018,Septiembre,Japón,3,5,,8,POINT (0.81488 -77356)
2018,Septiembre,Japón,1,4,,5,POINT (10406342 -75527794)
2018,Septiembre,Japón,15,27,,42,POINT (10446304 -75516486)
2018,Septiembre,Japón,0,2,,2,POINT (10886686 -74776479)
2018,Septiembre,Japón,1,14,,15,POINT (3451668 -76532004)
2018,Septiembre,Japón,214,503,,717,POINT (4697157 -74140516)
2018,Septiembre,Japón,0,2,,2,POINT (4815189 -75736374)
2018,Septiembre,Japón,35,80,,115,POINT (6170465 -7542726)
2018,Septiembre,Japón,1,1,,2,POINT (7819 -72453013)
2018,Septiembre,Japón,0,2,,2,POINT (863337 -7735002)
2018,Septiembre,Jordania,0,1,,1,POINT (10446304 -75516486)
2018,Septiembre,Jordania,0,10,,10,POINT (4697157 -74140516)
2018,Septiembre,Kazajistán,1,0,,1,POINT (0.81488 -77356)
2018,Septiembre,Kazajistán,2,2,,4,POINT (10406342 -75527794)
2018,Septiembre,Kazajistán,1,0,,1,POINT (10446304 -75516486)
2018,Septiembre,Kazajistán,3,2,,5,POINT (3451668 -76532004)
2018,Septiembre,Kazajistán,2,5,,7,POINT (4697157 -74140516)
2018,Septiembre,Kenia,2,0,,2,POINT (10446304 -75516486)
2018,Septiembre,Kenia,2,0,,2,POINT (3451668 -76532004)
2018,Septiembre,Kenia,11,8,,19,POINT (4697157 -74140516)
2018,Septiembre,Kenia,1,8,,9,POINT (6170465 -7542726)
2018,Septiembre,República de Kosovo,1,1,,2,POINT (4697157 -74140516)
2018,Septiembre,República de Kosovo,0,1,,1,POINT (6170465 -7542726)
2018,Septiembre,Letonia,1,0,,1,POINT (0.81488 -77356)
2018,Septiembre,Letonia,0,1,,1,POINT (10406342 -75527794)
2018,Septiembre,Letonia,6,8,,14,POINT (10446304 -75516486)
2018,Septiembre,Letonia,0,1,,1,POINT (10886686 -74776479)
2018,Septiembre,Letonia,0,1,,1,POINT (3884426 -77061029)
2018,Septiembre,Letonia,17,13,,30,POINT (4697157 -74140516)
2018,Septiembre,Letonia,0,1,,1,POINT (6170465 -7542726)
2018,Septiembre,Letonia,0,1,,1,POINT (806667 -767333)
2018,Septiembre,Letonia,1,1,,2,POINT (9402597 -75681642)
2018,Septiembre,Lituania,2,0,,2,POINT (0.81488 -77356)
2018,Septiembre,Lituania,0,3,,3,POINT (10406342 -75527794)
2018,Septiembre,Lituania,3,6,,9,POINT (10446304 -75516486)
2018,Septiembre,Lituania,1,0,,1,POINT (125862 -81702165)
2018,Septiembre,Lituania,1,2,,3,POINT (3451668 -76532004)
2018,Septiembre,Lituania,37,35,,72,POINT (4697157 -74140516)
2018,Septiembre,Lituania,2,3,,5,POINT (6170465 -7542726)
2018,Septiembre,Lituania,1,0,,1,POINT (7088729 -70740253)
2018,Septiembre,Líbano,1,0,,1,POINT (0.81488 -77356)
2018,Septiembre,Líbano,1,2,,3,POINT (10886686 -74776479)
2018,Septiembre,Líbano,0,1,,1,POINT (11360029 -72129595)
2018,Septiembre,Líbano,15,26,,41,POINT (4697157 -74140516)
2018,Septiembre,Líbano,1,3,,4,POINT (6170465 -7542726)
2018,Septiembre,Líbano,1,0,,1,POINT (7128047 -73181317)
2018,Septiembre,Liberia,0,1,,1,POINT (4697157 -74140516)
2018,Septiembre,Libia,1,0,,1,POINT (4697157 -74140516)
2018,Septiembre,Liechtenstein,0,1,,1,POINT (4697157 -74140516)
2018,Septiembre,Liechtenstein,0,1,,1,POINT (6170465 -7542726)
2018,Septiembre,Luxemburgo,0,1,,1,POINT (0.81488 -77356)
2018,Septiembre,Luxemburgo,4,14,,18,POINT (4697157 -74140516)
2018,Septiembre,Luxemburgo,2,0,,2,POINT (6170465 -7542726)
2018,Septiembre,Macedonia,1,0,,1,POINT (10406342 -75527794)
2018,Septiembre,Macedonia,2,2,,4,POINT (4697157 -74140516)
2018,Septiembre,Madagascar,3,1,,4,POINT (4697157 -74140516)
2018,Septiembre,Madagascar,1,0,,1,POINT (6170465 -7542726)
2018,Septiembre,Malasia,0,1,,1,POINT (10406342 -75527794)
2018,Septiembre,Malasia,3,17,,20,POINT (10446304 -75516486)
2018,Septiembre,Malasia,0,1,,1,POINT (3451668 -76532004)
2018,Septiembre,Malasia,0,1,,1,POINT (3884426 -77061029)
2018,Septiembre,Malasia,14,55,,69,POINT (4697157 -74140516)
2018,Septiembre,Malasia,1,0,,1,POINT (6170465 -7542726)
2018,Septiembre,Malasia,0,1,,1,POINT (7128047 -73181317)
2018,Septiembre,Malawi,2,1,,3,POINT (4697157 -74140516)
2018,Septiembre,Maldivas,1,0,,1,POINT (4697157 -74140516)
2018,Septiembre,Malí,1,0,,1,POINT (4697157 -74140516)
2018,Septiembre,Malta,0,1,,1,POINT (3451668 -76532004)
2018,Septiembre,Malta,1,3,,4,POINT (4697157 -74140516)
2018,Septiembre,Marruecos,2,1,,3,POINT (10446304 -75516486)
2018,Septiembre,Marruecos,16,21,,37,POINT (4697157 -74140516)
2018,Septiembre,Marruecos,2,3,,5,POINT (6170465 -7542726)
2018,Septiembre,Mauricio,0,1,,1,POINT (10406342 -75527794)
2018,Septiembre,Mauricio,1,0,,1,POINT (10446304 -75516486)
2018,Septiembre,Mauricio,0,3,,3,POINT (4697157 -74140516)
2018,Septiembre,Mauricio,0,1,,1,POINT (6170465 -7542726)
2018,Septiembre,México,0,4,,4,POINT (-4191162 -69941498)
2018,Septiembre,México,1,0,,1,POINT (0.33002 -76876446)
2018,Septiembre,México,16,21,,37,POINT (0.81488 -77356)
2018,Septiembre,México,17,22,,39,POINT (10406342 -75527794)
2018,Septiembre,México,245,387,,632,POINT (10446304 -75516486)
2018,Septiembre,México,32,64,,96,POINT (10886686 -74776479)
2018,Septiembre,México,1,0,,1,POINT (11247723 -74213989)
2018,Septiembre,México,3,2,,5,POINT (11360029 -72129595)
2018,Septiembre,México,2,5,,7,POINT (125862 -81702165)
2018,Septiembre,México,80,224,,304,POINT (3451668 -76532004)
2018,Septiembre,México,4,4,,8,POINT (445285 -75766353)
2018,Septiembre,México,4691,8144,,12835,POINT (4697157 -74140516)
2018,Septiembre,México,9,23,,32,POINT (4815189 -75736374)
2018,Septiembre,México,602,1471,,2073,POINT (6170465 -7542726)
2018,Septiembre,México,2,2,,4,POINT (6185536 -67484028)
2018,Septiembre,México,2,10,,12,POINT (7128047 -73181317)
2018,Septiembre,México,15,31,,46,POINT (7819 -72453013)
2018,Septiembre,México,0,4,,4,POINT (836068 -72409396)
2018,Septiembre,México,1,4,,5,POINT (863337 -7735002)
2018,Septiembre,República de Moldavia,3,2,,5,POINT (4697157 -74140516)
2018,Septiembre,Mongolia,4,5,,9,POINT (4697157 -74140516)
2018,Septiembre,Montenegro,0,1,,1,POINT (10406342 -75527794)
2018,Septiembre,Montenegro,0,5,,5,POINT (4697157 -74140516)
2018,Septiembre,Mozambique,1,1,,2,POINT (4697157 -74140516)
2018,Septiembre,Mozambique,0,1,,1,POINT (6170465 -7542726)
2018,Septiembre,Myanmar,0,2,,2,POINT (10406342 -75527794)
2018,Septiembre,Myanmar,0,1,,1,POINT (4697157 -74140516)
2018,Septiembre,Namibia,0,1,,1,POINT (0.81488 -77356)
2018,Septiembre,Namibia,0,1,,1,POINT (4697157 -74140516)
2018,Septiembre,Nepal,1,0,,1,POINT (10446304 -75516486)
2018,Septiembre,Nepal,0,1,,1,POINT (3451668 -76532004)
2018,Septiembre,Nepal,0,4,,4,POINT (4697157 -74140516)
2018,Septiembre,Nicaragua,1,0,,1,POINT (10406342 -75527794)
2018,Septiembre,Nicaragua,15,40,,55,POINT (10446304 -75516486)
2018,Septiembre,Nicaragua,3,3,,6,POINT (10886686 -74776479)
2018,Septiembre,Nicaragua,20,30,,50,POINT (3451668 -76532004)
2018,Septiembre,Nicaragua,106,122,,228,POINT (4697157 -74140516)
2018,Septiembre,Nicaragua,2,3,,5,POINT (4815189 -75736374)
2018,Septiembre,Nicaragua,17,44,,61,POINT (6170465 -7542726)
2018,Septiembre,Nicaragua,0,2,,2,POINT (7128047 -73181317)
2018,Septiembre,Nigeria,0,1,,1,POINT (10446304 -75516486)
2018,Septiembre,Nigeria,3,11,,14,POINT (4697157 -74140516)
2018,Septiembre,Nigeria,1,2,,3,POINT (6170465 -7542726)
2018,Septiembre,Níger,1,0,,1,POINT (3451668 -76532004)
2018,Septiembre,Noruega,0,1,,1,POINT (-4191162 -69941498)
2018,Septiembre,Noruega,0,1,,1,POINT (0.33002 -76876446)
2018,Septiembre,Noruega,0,1,,1,POINT (0.81488 -77356)
2018,Septiembre,Noruega,6,5,,11,POINT (10406342 -75527794)
2018,Septiembre,Noruega,10,12,,22,POINT (10446304 -75516486)
2018,Septiembre,Noruega,3,3,,6,POINT (10886686 -74776479)
2018,Septiembre,Noruega,1,0,,1,POINT (11360029 -72129595)
2018,Septiembre,Noruega,1,6,,7,POINT (3451668 -76532004)
2018,Septiembre,Noruega,57,112,,169,POINT (4697157 -74140516)
2018,Septiembre,Noruega,6,16,,22,POINT (6170465 -7542726)
2018,Septiembre,Noruega,0,1,,1,POINT (7128047 -73181317)
2018,Septiembre,Noruega,1,0,,1,POINT (863337 -7735002)
2018,Septiembre,Nueva Zelanda,0,1,,1,POINT (0.33002 -76876446)
2018,Septiembre,Nueva Zelanda,5,7,,12,POINT (0.81488 -77356)
2018,Septiembre,Nueva Zelanda,6,9,,15,POINT (10406342 -75527794)
2018,Septiembre,Nueva Zelanda,7,14,,21,POINT (10446304 -75516486)
2018,Septiembre,Nueva Zelanda,0,3,,3,POINT (10886686 -74776479)
2018,Septiembre,Nueva Zelanda,1,3,,4,POINT (3451668 -76532004)
2018,Septiembre,Nueva Zelanda,62,90,,152,POINT (4697157 -74140516)
2018,Septiembre,Nueva Zelanda,7,14,,21,POINT (6170465 -7542726)
2018,Septiembre,Nueva Zelanda,0,1,,1,POINT (863337 -7735002)
2018,Septiembre,Países Bajos,0,4,,4,POINT (-4191162 -69941498)
2018,Septiembre,Países Bajos,0,1,,1,POINT (-4214082 -69941431)
2018,Septiembre,Países Bajos,0,2,,2,POINT (0.33002 -76876446)
2018,Septiembre,Países Bajos,9,15,,24,POINT (0.81488 -77356)
2018,Septiembre,Países Bajos,12,11,,23,POINT (10406342 -75527794)
2018,Septiembre,Países Bajos,274,281,,555,POINT (10446304 -75516486)
2018,Septiembre,Países Bajos,11,18,,29,POINT (10886686 -74776479)
2018,Septiembre,Países Bajos,2,5,,7,POINT (11247723 -74213989)
2018,Septiembre,Países Bajos,2,1,,3,POINT (11360029 -72129595)
2018,Septiembre,Países Bajos,0,1,,1,POINT (125862 -81702165)
2018,Septiembre,Países Bajos,59,82,,141,POINT (3451668 -76532004)
2018,Septiembre,Países Bajos,1694,2169,,3863,POINT (4697157 -74140516)
2018,Septiembre,Países Bajos,1,8,,9,POINT (4815189 -75736374)
2018,Septiembre,Países Bajos,156,259,,415,POINT (6170465 -7542726)
2018,Septiembre,Países Bajos,4,4,,8,POINT (7128047 -73181317)
2018,Septiembre,Países Bajos,0,5,,5,POINT (7819 -72453013)
2018,Septiembre,Países Bajos,0,1,,1,POINT (836068 -72409396)
2018,Septiembre,Países Bajos,8,8,,16,POINT (863337 -7735002)
2018,Septiembre,Pakistán,0,1,,1,POINT (3451668 -76532004)
2018,Septiembre,Pakistán,0,20,,20,POINT (4697157 -74140516)
2018,Septiembre,Pakistán,0,2,,2,POINT (6170465 -7542726)
2018,Septiembre,Pakistán,0,1,,1,POINT (7819 -72453013)
2018,Septiembre,Pakistán,0,1,,1,POINT (9402597 -75681642)
2018,Septiembre,Panamá,1,0,,1,POINT (-4191162 -69941498)
2018,Septiembre,Panamá,2,2,,4,POINT (0.81488 -77356)
2018,Septiembre,Panamá,2,24,,26,POINT (10406342 -75527794)
2018,Septiembre,Panamá,680,613,,1293,POINT (10446304 -75516486)
2018,Septiembre,Panamá,58,100,,158,POINT (10886686 -74776479)
2018,Septiembre,Panamá,0,2,,2,POINT (11360029 -72129595)
2018,Septiembre,Panamá,72,38,,110,POINT (125862 -81702165)
2018,Septiembre,Panamá,389,330,,719,POINT (3451668 -76532004)
2018,Septiembre,Panamá,14,23,,37,POINT (445285 -75766353)
2018,Septiembre,Panamá,1793,1691,,3484,POINT (4697157 -74140516)
2018,Septiembre,Panamá,36,68,,104,POINT (4815189 -75736374)
2018,Septiembre,Panamá,1868,1454,,3322,POINT (6170465 -7542726)
2018,Septiembre,Panamá,0,1,,1,POINT (6218835 -75586989)
2018,Septiembre,Panamá,1,0,,1,POINT (6222552 -77401154)
2018,Septiembre,Panamá,1,3,,4,POINT (7102626 -77762647)
2018,Septiembre,Panamá,9,14,,23,POINT (7128047 -73181317)
2018,Septiembre,Panamá,3,7,,10,POINT (7819 -72453013)
2018,Septiembre,Panamá,0,2,,2,POINT (7927233 -72508188)
2018,Septiembre,Panamá,1,2,,3,POINT (863337 -7735002)
2018,Septiembre,Paraguay,5,6,,11,POINT (0.81488 -77356)
2018,Septiembre,Paraguay,10,6,,16,POINT (10406342 -75527794)
2018,Septiembre,Paraguay,109,70,,179,POINT (10446304 -75516486)
2018,Septiembre,Paraguay,12,7,,19,POINT (10886686 -74776479)
2018,Septiembre,Paraguay,120,83,,203,POINT (125862 -81702165)
2018,Septiembre,Paraguay,5,5,,10,POINT (3451668 -76532004)
2018,Septiembre,Paraguay,1,0,,1,POINT (445285 -75766353)
2018,Septiembre,Paraguay,247,225,,472,POINT (4697157 -74140516)
2018,Septiembre,Paraguay,31,26,,57,POINT (6170465 -7542726)
2018,Septiembre,Paraguay,0,2,,2,POINT (7819 -72453013)
2018,Septiembre,Perú,21,15,,36,POINT (-4191162 -69941498)
2018,Septiembre,Perú,23,27,,50,POINT (-4214082 -69941431)
2018,Septiembre,Perú,9,11,,20,POINT (0.33002 -76876446)
2018,Septiembre,Perú,134,280,,414,POINT (0.81488 -77356)
2018,Septiembre,Perú,30,27,,57,POINT (10406342 -75527794)
2018,Septiembre,Perú,1145,856,,2001,POINT (10446304 -75516486)
2018,Septiembre,Perú,20,21,,41,POINT (10886686 -74776479)
2018,Septiembre,Perú,2,19,,21,POINT (11360029 -72129595)
2018,Septiembre,Perú,269,182,,451,POINT (125862 -81702165)
2018,Septiembre,Perú,146,164,,310,POINT (3451668 -76532004)
2018,Septiembre,Perú,0,2,,2,POINT (445285 -75766353)
2018,Septiembre,Perú,3257,4542,,7799,POINT (4697157 -74140516)
2018,Septiembre,Perú,1,4,,5,POINT (4815189 -75736374)
2018,Septiembre,Perú,439,693,,1132,POINT (6170465 -7542726)
2018,Septiembre,Perú,0,1,,1,POINT (6185536 -67484028)
2018,Septiembre,Perú,2,5,,7,POINT (7088729 -70740253)
2018,Septiembre,Perú,0,2,,2,POINT (7128047 -73181317)
2018,Septiembre,Perú,91,129,,220,POINT (7819 -72453013)
2018,Septiembre,Perú,7,9,,16,POINT (836068 -72409396)
2018,Septiembre,Palestina,2,3,,5,POINT (4697157 -74140516)
2018,Septiembre,Palestina,1,1,,2,POINT (6170465 -7542726)
2018,Septiembre,Polonia,2,1,,3,POINT (-4191162 -69941498)
2018,Septiembre,Polonia,9,6,,15,POINT (0.81488 -77356)
2018,Septiembre,Polonia,1,3,,4,POINT (10406342 -75527794)
2018,Septiembre,Polonia,13,41,,54,POINT (10446304 -75516486)
2018,Septiembre,Polonia,1,0,,1,POINT (10886686 -74776479)
2018,Septiembre,Polonia,1,7,,8,POINT (3451668 -76532004)
2018,Septiembre,Polonia,150,203,,353,POINT (4697157 -74140516)
2018,Septiembre,Polonia,1,0,,1,POINT (4815189 -75736374)
2018,Septiembre,Polonia,11,12,,23,POINT (6170465 -7542726)
2018,Septiembre,Polonia,0,1,,1,POINT (7819 -72453013)
2018,Septiembre,Portugal,0,1,,1,POINT (0.33002 -76876446)
2018,Septiembre,Portugal,3,5,,8,POINT (0.81488 -77356)
2018,Septiembre,Portugal,4,3,,7,POINT (10406342 -75527794)
2018,Septiembre,Portugal,12,30,,42,POINT (10446304 -75516486)
2018,Septiembre,Portugal,5,14,,19,POINT (10886686 -74776479)
2018,Septiembre,Portugal,1,6,,7,POINT (11360029 -72129595)
2018,Septiembre,Portugal,1,1,,2,POINT (125862 -81702165)
2018,Septiembre,Portugal,5,6,,11,POINT (3451668 -76532004)
2018,Septiembre,Portugal,201,442,,643,POINT (4697157 -74140516)
2018,Septiembre,Portugal,1,2,,3,POINT (4815189 -75736374)
2018,Septiembre,Portugal,13,38,,51,POINT (6170465 -7542726)
2018,Septiembre,Portugal,6,19,,25,POINT (7819 -72453013)
2018,Septiembre,Portugal,0,2,,2,POINT (836068 -72409396)
2018,Septiembre,Puerto Rico/Territorio de Estados Unidos,0,2,,2,POINT (4697157 -74140516)
2018,Septiembre,Qatar,0,7,,7,POINT (4697157 -74140516)
2018,Septiembre,Qatar,0,1,,1,POINT (6170465 -7542726)
2018,Septiembre,Reino Unido de Gran Bretaña e Irlanda del Norte,1,4,,5,POINT (-4191162 -69941498)
2018,Septiembre,Reino Unido de Gran Bretaña e Irlanda del Norte,1,1,,2,POINT (0.33002 -76876446)
2018,Septiembre,Reino Unido de Gran Bretaña e Irlanda del Norte,29,40,,69,POINT (0.81488 -77356)
2018,Septiembre,Reino Unido de Gran Bretaña e Irlanda del Norte,11,18,,29,POINT (10406342 -75527794)
2018,Septiembre,Reino Unido de Gran Bretaña e Irlanda del Norte,123,199,,322,POINT (10446304 -75516486)
2018,Septiembre,Reino Unido de Gran Bretaña e Irlanda del Norte,7,15,,22,POINT (10886686 -74776479)
2018,Septiembre,Reino Unido de Gran Bretaña e Irlanda del Norte,0,1,,1,POINT (11247723 -74213989)
2018,Septiembre,Reino Unido de Gran Bretaña e Irlanda del Norte,2,0,,2,POINT (11360029 -72129595)
2018,Septiembre,Reino Unido de Gran Bretaña e Irlanda del Norte,2,2,,4,POINT (125862 -81702165)
2018,Septiembre,Reino Unido de Gran Bretaña e Irlanda del Norte,27,68,,95,POINT (3451668 -76532004)
2018,Septiembre,Reino Unido de Gran Bretaña e Irlanda del Norte,0,1,,1,POINT (445285 -75766353)
2018,Septiembre,Reino Unido de Gran Bretaña e Irlanda del Norte,914,1790,,2704,POINT (4697157 -74140516)
2018,Septiembre,Reino Unido de Gran Bretaña e Irlanda del Norte,0,2,,2,POINT (4815189 -75736374)
2018,Septiembre,Reino Unido de Gran Bretaña e Irlanda del Norte,71,209,,280,POINT (6170465 -7542726)
2018,Septiembre,Reino Unido de Gran Bretaña e Irlanda del Norte,0,2,,2,POINT (7088729 -70740253)
2018,Septiembre,Reino Unido de Gran Bretaña e Irlanda del Norte,0,5,,5,POINT (7819 -72453013)
2018,Septiembre,Reino Unido de Gran Bretaña e Irlanda del Norte,13,15,,28,POINT (863337 -7735002)
2018,Septiembre,República Dominicana,0,2,,2,POINT (-4191162 -69941498)
2018,Septiembre,República Dominicana,5,15,,20,POINT (0.81488 -77356)
2018,Septiembre,República Dominicana,45,27,,72,POINT (10406342 -75527794)
2018,Septiembre,República Dominicana,76,74,,150,POINT (10446304 -75516486)
2018,Septiembre,República Dominicana,15,52,,67,POINT (10886686 -74776479)
2018,Septiembre,República Dominicana,0,2,,2,POINT (11360029 -72129595)
2018,Septiembre,República Dominicana,5,5,,10,POINT (125862 -81702165)
2018,Septiembre,República Dominicana,19,44,,63,POINT (3451668 -76532004)
2018,Septiembre,República Dominicana,884,922,,1806,POINT (4697157 -74140516)
2018,Septiembre,República Dominicana,3,5,,8,POINT (4815189 -75736374)
2018,Septiembre,República Dominicana,59,114,,173,POINT (6170465 -7542726)
2018,Septiembre,República Dominicana,1,0,,1,POINT (6222552 -77401154)
2018,Septiembre,República Dominicana,1,5,,6,POINT (7128047 -73181317)
2018,Septiembre,República Dominicana,1,3,,4,POINT (7819 -72453013)
2018,Septiembre,Rumania,1,1,,2,POINT (0.81488 -77356)
2018,Septiembre,Rumania,1,7,,8,POINT (10406342 -75527794)
2018,Septiembre,Rumania,4,15,,19,POINT (10446304 -75516486)
2018,Septiembre,Rumania,0,2,,2,POINT (10886686 -74776479)
2018,Septiembre,Rumania,1,3,,4,POINT (3451668 -76532004)
2018,Septiembre,Rumania,104,99,,203,POINT (4697157 -74140516)
2018,Septiembre,Rumania,5,5,,10,POINT (6170465 -7542726)
2018,Septiembre,Federación de Rusia,3,3,,6,POINT (0.81488 -77356)
2018,Septiembre,Federación de Rusia,2,15,,17,POINT (10406342 -75527794)
2018,Septiembre,Federación de Rusia,22,26,,48,POINT (10446304 -75516486)
2018,Septiembre,Federación de Rusia,1,2,,3,POINT (10886686 -74776479)
2018,Septiembre,Federación de Rusia,1,0,,1,POINT (11360029 -72129595)
2018,Septiembre,Federación de Rusia,0,2,,2,POINT (125862 -81702165)
2018,Septiembre,Federación de Rusia,4,3,,7,POINT (3451668 -76532004)
2018,Septiembre,Federación de Rusia,0,1,,1,POINT (3884426 -77061029)
2018,Septiembre,Federación de Rusia,152,186,,338,POINT (4697157 -74140516)
2018,Septiembre,Federación de Rusia,1,1,,2,POINT (4815189 -75736374)
2018,Septiembre,Federación de Rusia,11,11,,22,POINT (6170465 -7542726)
2018,Septiembre,Federación de Rusia,0,1,,1,POINT (7128047 -73181317)
2018,Septiembre,Federación de Rusia,1,0,,1,POINT (7819 -72453013)
2018,Septiembre,Federación de Rusia,1,1,,2,POINT (9402597 -75681642)
2018,Septiembre,Rwanda,2,0,,2,POINT (10446304 -75516486)
2018,Septiembre,Rwanda,1,1,,2,POINT (4697157 -74140516)
2018,Septiembre,San Cristóbal y Nevis,0,1,,1,POINT (10446304 -75516486)
2018,Septiembre,San Cristóbal y Nevis,1,4,,5,POINT (4697157 -74140516)
2018,Septiembre,San  Vicente y las Granadinas,0,2,,2,POINT (10446304 -75516486)
2018,Septiembre,San  Vicente y las Granadinas,0,1,,1,POINT (10886686 -74776479)
2018,Septiembre,San  Vicente y las Granadinas,1,1,,2,POINT (4815189 -75736374)
2018,Septiembre,Santa Lucia,2,2,,4,POINT (10446304 -75516486)
2018,Septiembre,Santa Lucia,2,4,,6,POINT (4697157 -74140516)
2018,Septiembre,Santa Lucia,1,2,,3,POINT (6170465 -7542726)
2018,Septiembre,Santa Sede/Ciudad del Vaticano,0,1,,1,POINT (4697157 -74140516)
2018,Septiembre,Senegal,1,1,,2,POINT (4697157 -74140516)
2018,Septiembre,Serbia,0,1,,1,POINT (0.81488 -77356)
2018,Septiembre,Serbia,1,0,,1,POINT (10406342 -75527794)
2018,Septiembre,Serbia,1,3,,4,POINT (10446304 -75516486)
2018,Septiembre,Serbia,0,1,,1,POINT (10886686 -74776479)
2018,Septiembre,Serbia,0,1,,1,POINT (125862 -81702165)
2018,Septiembre,Serbia,2,0,,2,POINT (3451668 -76532004)
2018,Septiembre,Serbia,5,9,,14,POINT (4697157 -74140516)
2018,Septiembre,Serbia,1,4,,5,POINT (6170465 -7542726)
2018,Septiembre,Seychelles,0,1,,1,POINT (4697157 -74140516)
2018,Septiembre,Singapur,0,1,,1,POINT (0.81488 -77356)
2018,Septiembre,Singapur,3,8,,11,POINT (10446304 -75516486)
2018,Septiembre,Singapur,21,39,,60,POINT (4697157 -74140516)
2018,Septiembre,Singapur,0,2,,2,POINT (6170465 -7542726)
2018,Septiembre,República Árabe Siria,0,1,,1,POINT (10446304 -75516486)
2018,Septiembre,República Árabe Siria,2,7,,9,POINT (4697157 -74140516)
2018,Septiembre,República Árabe Siria,0,2,,2,POINT (6170465 -7542726)
2018,Septiembre,Sri Lanka,2,3,,5,POINT (10446304 -75516486)
2018,Septiembre,Sri Lanka,1,3,,4,POINT (4697157 -74140516)
2018,Septiembre,Sri Lanka,0,1,,1,POINT (6170465 -7542726)
2018,Septiembre,Sudáfrica,2,0,,2,POINT (0.81488 -77356)
2018,Septiembre,Sudáfrica,1,5,,6,POINT (10406342 -75527794)
2018,Septiembre,Sudáfrica,3,5,,8,POINT (10446304 -75516486)
2018,Septiembre,Sudáfrica,0,1,,1,POINT (10886686 -74776479)
2018,Septiembre,Sudáfrica,1,1,,2,POINT (133387613 -81372937)
2018,Septiembre,Sudáfrica,2,5,,7,POINT (3451668 -76532004)
2018,Septiembre,Sudáfrica,21,44,,65,POINT (4697157 -74140516)
2018,Septiembre,Sudáfrica,1,2,,3,POINT (6170465 -7542726)
2018,Septiembre,Sudáfrica,0,1,,1,POINT (7128047 -73181317)
2018,Septiembre,Sudán,0,1,,1,POINT (4697157 -74140516)
2018,Septiembre,Suecia,0,1,,1,POINT (-4191162 -69941498)
2018,Septiembre,Suecia,2,0,,2,POINT (-4214082 -69941431)
2018,Septiembre,Suecia,4,0,,4,POINT (0.81488 -77356)
2018,Septiembre,Suecia,1,1,,2,POINT (10406342 -75527794)
2018,Septiembre,Suecia,18,20,,38,POINT (10446304 -75516486)
2018,Septiembre,Suecia,4,5,,9,POINT (10886686 -74776479)
2018,Septiembre,Suecia,1,2,,3,POINT (11247723 -74213989)
2018,Septiembre,Suecia,0,1,,1,POINT (11360029 -72129595)
2018,Septiembre,Suecia,0,1,,1,POINT (125862 -81702165)
2018,Septiembre,Suecia,3,11,,14,POINT (3451668 -76532004)
2018,Septiembre,Suecia,1,0,,1,POINT (3884426 -77061029)
2018,Septiembre,Suecia,111,214,,325,POINT (4697157 -74140516)
2018,Septiembre,Suecia,16,34,,50,POINT (6170465 -7542726)
2018,Septiembre,Suecia,1,0,,1,POINT (7128047 -73181317)
2018,Septiembre,Suiza,2,2,,4,POINT (-4191162 -69941498)
2018,Septiembre,Suiza,1,2,,3,POINT (-4214082 -69941431)
2018,Septiembre,Suiza,3,1,,4,POINT (0.33002 -76876446)
2018,Septiembre,Suiza,11,21,,32,POINT (0.81488 -77356)
2018,Septiembre,Suiza,14,14,,28,POINT (10406342 -75527794)
2018,Septiembre,Suiza,59,50,,109,POINT (10446304 -75516486)
2018,Septiembre,Suiza,1,7,,8,POINT (10886686 -74776479)
2018,Septiembre,Suiza,5,2,,7,POINT (11247723 -74213989)
2018,Septiembre,Suiza,1,1,,2,POINT (125862 -81702165)
2018,Septiembre,Suiza,15,36,,51,POINT (3451668 -76532004)
2018,Septiembre,Suiza,383,589,,972,POINT (4697157 -74140516)
2018,Septiembre,Suiza,43,87,,130,POINT (6170465 -7542726)
2018,Septiembre,Suiza,1,0,,1,POINT (7088729 -70740253)
2018,Septiembre,Suiza,1,0,,1,POINT (7128047 -73181317)
2018,Septiembre,Suiza,1,1,,2,POINT (7819 -72453013)
2018,Septiembre,Suiza,3,2,,5,POINT (863337 -7735002)
2018,Septiembre,Surinam,16,24,,40,POINT (4697157 -74140516)
2018,Septiembre,Surinam,0,1,,1,POINT (6170465 -7542726)
2018,Septiembre,Tailandia,0,2,,2,POINT (10446304 -75516486)
2018,Septiembre,Tailandia,7,14,,21,POINT (4697157 -74140516)
2018,Septiembre,Tailandia,2,0,,2,POINT (6170465 -7542726)
2018,Septiembre,Tanzania,0,4,,4,POINT (4697157 -74140516)
2018,Septiembre,Trinidad y Tobago,7,14,,21,POINT (10446304 -75516486)
2018,Septiembre,Trinidad y Tobago,1,2,,3,POINT (10886686 -74776479)
2018,Septiembre,Trinidad y Tobago,0,1,,1,POINT (11247723 -74213989)
2018,Septiembre,Trinidad y Tobago,3,12,,15,POINT (3451668 -76532004)
2018,Septiembre,Trinidad y Tobago,28,35,,63,POINT (4697157 -74140516)
2018,Septiembre,Trinidad y Tobago,1,2,,3,POINT (4815189 -75736374)
2018,Septiembre,Trinidad y Tobago,3,16,,19,POINT (6170465 -7542726)
2018,Septiembre,Túnez,2,7,,9,POINT (4697157 -74140516)
2018,Septiembre,Turquía,0,1,,1,POINT (-4214082 -69941431)
2018,Septiembre,Turquía,1,0,,1,POINT (0.33002 -76876446)
2018,Septiembre,Turquía,0,2,,2,POINT (0.81488 -77356)
2018,Septiembre,Turquía,0,1,,1,POINT (10406342 -75527794)
2018,Septiembre,Turquía,3,10,,13,POINT (10446304 -75516486)
2018,Septiembre,Turquía,2,3,,5,POINT (10886686 -74776479)
2018,Septiembre,Turquía,1,2,,3,POINT (11247723 -74213989)
2018,Septiembre,Turquía,0,3,,3,POINT (3451668 -76532004)
2018,Septiembre,Turquía,178,301,,479,POINT (4697157 -74140516)
2018,Septiembre,Turquía,7,21,,28,POINT (6170465 -7542726)
2018,Septiembre,Turquía,0,1,,1,POINT (863337 -7735002)
2018,Septiembre,Ucrania,1,8,,9,POINT (10406342 -75527794)
2018,Septiembre,Ucrania,1,15,,16,POINT (10446304 -75516486)
2018,Septiembre,Ucrania,0,3,,3,POINT (10886686 -74776479)
2018,Septiembre,Ucrania,0,2,,2,POINT (11247723 -74213989)
2018,Septiembre,Ucrania,1,3,,4,POINT (3451668 -76532004)
2018,Septiembre,Ucrania,0,2,,2,POINT (3884426 -77061029)
2018,Septiembre,Ucrania,20,38,,58,POINT (4697157 -74140516)
2018,Septiembre,Ucrania,1,4,,5,POINT (6170465 -7542726)
2018,Septiembre,Ucrania,0,3,,3,POINT (9402597 -75681642)
2018,Septiembre,Uganda,0,1,,1,POINT (4697157 -74140516)
2018,Septiembre,Uganda,1,0,,1,POINT (6170465 -7542726)
2018,Septiembre,Uruguay,0,2,,2,POINT (-4191162 -69941498)
2018,Septiembre,Uruguay,0,1,,1,POINT (-4214082 -69941431)
2018,Septiembre,Uruguay,11,13,,24,POINT (0.81488 -77356)
2018,Septiembre,Uruguay,21,22,,43,POINT (10406342 -75527794)
2018,Septiembre,Uruguay,148,119,,267,POINT (10446304 -75516486)
2018,Septiembre,Uruguay,12,9,,21,POINT (10886686 -74776479)
2018,Septiembre,Uruguay,0,1,,1,POINT (11360029 -72129595)
2018,Septiembre,Uruguay,23,24,,47,POINT (125862 -81702165)
2018,Septiembre,Uruguay,7,26,,33,POINT (3451668 -76532004)
2018,Septiembre,Uruguay,467,602,,1069,POINT (4697157 -74140516)
2018,Septiembre,Uruguay,0,4,,4,POINT (4815189 -75736374)
2018,Septiembre,Uruguay,37,57,,94,POINT (6170465 -7542726)
2018,Septiembre,Uruguay,0,1,,1,POINT (7088729 -70740253)
2018,Septiembre,Uruguay,3,8,,11,POINT (7819 -72453013)
2018,Septiembre,Uruguay,0,2,,2,POINT (836068 -72409396)
2018,Septiembre,Uzbekistán,0,1,,1,POINT (4697157 -74140516)
2018,Septiembre,Venezuela,1,2,,3,POINT (-4191162 -69941498)
2018,Septiembre,Venezuela,2,3,,5,POINT (-4214082 -69941431)
2018,Septiembre,Venezuela,0,1,,1,POINT (0.185957 -7478366)
2018,Septiembre,Venezuela,58,98,,156,POINT (0.33002 -76876446)
2018,Septiembre,Venezuela,3492,4012,,7504,POINT (0.81488 -77356)
2018,Septiembre,Venezuela,2,1,,3,POINT (1800143 -78802679)
2018,Septiembre,Venezuela,16,28,,44,POINT (10406342 -75527794)
2018,Septiembre,Venezuela,203,225,,428,POINT (10446304 -75516486)
2018,Septiembre,Venezuela,116,180,,296,POINT (10886686 -74776479)
2018,Septiembre,Venezuela,0,2,,2,POINT (11117206 -74232675)
2018,Septiembre,Venezuela,7874,7088,,14962,POINT (11360029 -72129595)
2018,Septiembre,Venezuela,0,11,,11,POINT (12165168 -71983761)
2018,Septiembre,Venezuela,3,5,,8,POINT (125862 -81702165)
2018,Septiembre,Venezuela,118,124,,242,POINT (3451668 -76532004)
2018,Septiembre,Venezuela,5,9,,14,POINT (3866713 -67927521)
2018,Septiembre,Venezuela,3,3,,6,POINT (445285 -75766353)
2018,Septiembre,Venezuela,6755,6815,,13570,POINT (4697157 -74140516)
2018,Septiembre,Venezuela,8,12,,20,POINT (4815189 -75736374)
2018,Septiembre,Venezuela,839,955,,1794,POINT (6170465 -7542726)
2018,Septiembre,Venezuela,59,41,,100,POINT (6185536 -67484028)
2018,Septiembre,Venezuela,0,4,,4,POINT (6218835 -75586989)
2018,Septiembre,Venezuela,1063,1037,,2100,POINT (7088729 -70740253)
2018,Septiembre,Venezuela,11,16,,27,POINT (7128047 -73181317)
2018,Septiembre,Venezuela,27880,24472,,52352,POINT (7819 -72453013)
2018,Septiembre,Venezuela,2703,2291,,4994,POINT (836068 -72409396)
2018,Septiembre,Vietnam,6,4,,10,POINT (10446304 -75516486)
2018,Septiembre,Vietnam,11,14,,25,POINT (4697157 -74140516)
2018,Septiembre,Vietnam,1,0,,1,POINT (6170465 -7542726)
2018,Septiembre,República Árabe de Yemen,0,2,,2,POINT (4697157 -74140516)
2018,Septiembre,Zambia,0,1,,1,POINT (10446304 -75516486)
2018,Septiembre,Zambia,1,2,,3,POINT (4697157 -74140516)
2018,Septiembre,Zimbabue,0,1,,1,POINT (3451668 -76532004)
2018,Septiembre,Zimbabue,3,4,,7,POINT (4697157 -74140516)
2018,Septiembre,Zimbabue,0,1,,1,POINT (6170465 -7542726)
2018,Septiembre,Refugiado,4,7,,11,POINT (4697157 -74140516)
2018,Septiembre,Refugiado,1,1,,2,POINT (6170465 -7542726)
2018,Septiembre,Desconocido,3,8,,11,POINT (10446304 -75516486)
2018,Septiembre,Desconocido,1,0,,1,POINT (3451668 -76532004)
2018,Septiembre,Desconocido,90,154,,244,POINT (4697157 -74140516)
2018,Septiembre,Desconocido,1,7,,8,POINT (6170465 -7542726)
2018,Septiembre,Desconocido,1,0,,1,POINT (7128047 -73181317)
2018,Septiembre,Desconocido,1,0,,1,POINT (7819 -72453013)
2018,Octubre,Afganistán,0,1,,1,POINT (4697157 -74140516)
2018,Octubre,Albania,2,0,,2,POINT (10446304 -75516486)
2018,Octubre,Albania,0,1,,1,POINT (3451668 -76532004)
2018,Octubre,Albania,2,7,,9,POINT (4697157 -74140516)
2018,Octubre,Albania,0,2,,2,POINT (6170465 -7542726)
2018,Octubre,Albania,0,1,,1,POINT (7819 -72453013)
2018,Octubre,Alemania,5,7,,12,POINT (-4191162 -69941498)
2018,Octubre,Alemania,1,1,,2,POINT (-4214082 -69941431)
2018,Octubre,Alemania,2,4,,6,POINT (0.33002 -76876446)
2018,Octubre,Alemania,31,44,,75,POINT (0.81488 -77356)
2018,Octubre,Alemania,32,38,,70,POINT (10406342 -75527794)
2018,Octubre,Alemania,126,169,,295,POINT (10446304 -75516486)
2018,Octubre,Alemania,25,15,,40,POINT (10886686 -74776479)
2018,Octubre,Alemania,2,0,,2,POINT (11360029 -72129595)
2018,Octubre,Alemania,3,0,,3,POINT (125862 -81702165)
2018,Octubre,Alemania,52,68,,120,POINT (3451668 -76532004)
2018,Octubre,Alemania,1,2,,3,POINT (445285 -75766353)
2018,Octubre,Alemania,1786,2647,,4433,POINT (4697157 -74140516)
2018,Octubre,Alemania,3,1,,4,POINT (4815189 -75736374)
2018,Octubre,Alemania,118,196,,314,POINT (6170465 -7542726)
2018,Octubre,Alemania,2,8,,10,POINT (7819 -72453013)
2018,Octubre,Alemania,0,1,,1,POINT (836068 -72409396)
2018,Octubre,Alemania,8,13,,21,POINT (863337 -7735002)
2018,Octubre,Andorra,2,6,,8,POINT (4697157 -74140516)
2018,Octubre,Andorra,1,0,,1,POINT (6170465 -7542726)
2018,Octubre,Angola,1,1,,2,POINT (4697157 -74140516)
2018,Octubre,Antigua y Barbuda,1,2,,3,POINT (10446304 -75516486)
2018,Octubre,Antigua y Barbuda,2,1,,3,POINT (125862 -81702165)
2018,Octubre,Antigua y Barbuda,4,2,,6,POINT (4697157 -74140516)
2018,Octubre,Antigua y Barbuda,0,1,,1,POINT (6170465 -7542726)
2018,Octubre,Países Bajos,0,1,,1,POINT (4697157 -74140516)
2018,Octubre,Países Bajos,1,0,,1,POINT (6170465 -7542726)
2018,Octubre,Arabia Saudita,1,1,,2,POINT (3451668 -76532004)
2018,Octubre,Arabia Saudita,0,2,,2,POINT (4697157 -74140516)
2018,Octubre,Arabia Saudita,0,1,,1,POINT (6170465 -7542726)
2018,Octubre,Argelia,1,8,,9,POINT (4697157 -74140516)
2018,Octubre,Argelia,1,1,,2,POINT (6170465 -7542726)
2018,Octubre,Argentina,1,9,,10,POINT (-4191162 -69941498)
2018,Octubre,Argentina,0,2,,2,POINT (-4214082 -69941431)
2018,Octubre,Argentina,7,14,,21,POINT (0.33002 -76876446)
2018,Octubre,Argentina,61,92,,153,POINT (0.81488 -77356)
2018,Octubre,Argentina,0,2,,2,POINT (1800143 -78802679)
2018,Octubre,Argentina,166,131,,297,POINT (10406342 -75527794)
2018,Octubre,Argentina,1223,1007,,2230,POINT (10446304 -75516486)
2018,Octubre,Argentina,30,78,,108,POINT (10886686 -74776479)
2018,Octubre,Argentina,2,6,,8,POINT (11360029 -72129595)
2018,Octubre,Argentina,290,241,,531,POINT (125862 -81702165)
2018,Octubre,Argentina,47,83,,130,POINT (3451668 -76532004)
2018,Octubre,Argentina,0,1,,1,POINT (445285 -75766353)
2018,Octubre,Argentina,2920,4416,,7336,POINT (4697157 -74140516)
2018,Octubre,Argentina,2,18,,20,POINT (4815189 -75736374)
2018,Octubre,Argentina,143,364,,507,POINT (6170465 -7542726)
2018,Octubre,Argentina,1,2,,3,POINT (7128047 -73181317)
2018,Octubre,Argentina,6,20,,26,POINT (7819 -72453013)
2018,Octubre,Argentina,1,0,,1,POINT (836068 -72409396)
2018,Octubre,Argentina,0,2,,2,POINT (863337 -7735002)
2018,Octubre,República de Armenia,4,1,,5,POINT (4697157 -74140516)
2018,Octubre,Australia,2,2,,4,POINT (-4191162 -69941498)
2018,Octubre,Australia,1,3,,4,POINT (-4214082 -69941431)
2018,Octubre,Australia,13,26,,39,POINT (0.81488 -77356)
2018,Octubre,Australia,12,18,,30,POINT (10406342 -75527794)
2018,Octubre,Australia,68,69,,137,POINT (10446304 -75516486)
2018,Octubre,Australia,8,21,,29,POINT (10886686 -74776479)
2018,Octubre,Australia,0,1,,1,POINT (11360029 -72129595)
2018,Octubre,Australia,7,6,,13,POINT (3451668 -76532004)
2018,Octubre,Australia,291,549,,840,POINT (4697157 -74140516)
2018,Octubre,Australia,32,98,,130,POINT (6170465 -7542726)
2018,Octubre,Australia,22,17,,39,POINT (863337 -7735002)
2018,Octubre,Austria,0,1,,1,POINT (-4191162 -69941498)
2018,Octubre,Austria,0,1,,1,POINT (0.33002 -76876446)
2018,Octubre,Austria,1,0,,1,POINT (0.812436 -77847006)
2018,Octubre,Austria,3,5,,8,POINT (0.81488 -77356)
2018,Octubre,Austria,3,5,,8,POINT (10406342 -75527794)
2018,Octubre,Austria,11,19,,30,POINT (10446304 -75516486)
2018,Octubre,Austria,0,4,,4,POINT (10886686 -74776479)
2018,Octubre,Austria,2,2,,4,POINT (11247723 -74213989)
2018,Octubre,Austria,0,1,,1,POINT (11360029 -72129595)
2018,Octubre,Austria,1,0,,1,POINT (125862 -81702165)
2018,Octubre,Austria,4,9,,13,POINT (3451668 -76532004)
2018,Octubre,Austria,184,285,,469,POINT (4697157 -74140516)
2018,Octubre,Austria,18,21,,39,POINT (6170465 -7542726)
2018,Octubre,Azerbaiyán,5,8,,13,POINT (4697157 -74140516)
2018,Octubre,Bahamas,4,10,,14,POINT (10446304 -75516486)
2018,Octubre,Bahamas,5,4,,9,POINT (10886686 -74776479)
2018,Octubre,Bahamas,0,1,,1,POINT (125862 -81702165)
2018,Octubre,Bahamas,3,5,,8,POINT (3451668 -76532004)
2018,Octubre,Bahamas,8,8,,16,POINT (4697157 -74140516)
2018,Octubre,Bahamas,2,3,,5,POINT (6170465 -7542726)
2018,Octubre,Bahréin,1,0,,1,POINT (4697157 -74140516)
2018,Octubre,Bangladesh,0,2,,2,POINT (10446304 -75516486)
2018,Octubre,Barbados,8,7,,15,POINT (10446304 -75516486)
2018,Octubre,Barbados,2,3,,5,POINT (10886686 -74776479)
2018,Octubre,Barbados,5,8,,13,POINT (4697157 -74140516)
2018,Octubre,Barbados,1,2,,3,POINT (6170465 -7542726)
2018,Octubre,República de Belarús,2,1,,3,POINT (10446304 -75516486)
2018,Octubre,República de Belarús,5,3,,8,POINT (4697157 -74140516)
2018,Octubre,Bélgica,3,2,,5,POINT (-4191162 -69941498)
2018,Octubre,Bélgica,1,1,,2,POINT (-4214082 -69941431)
2018,Octubre,Bélgica,0,2,,2,POINT (0.33002 -76876446)
2018,Octubre,Bélgica,5,6,,11,POINT (0.81488 -77356)
2018,Octubre,Bélgica,2,2,,4,POINT (10406342 -75527794)
2018,Octubre,Bélgica,24,41,,65,POINT (10446304 -75516486)
2018,Octubre,Bélgica,1,3,,4,POINT (10886686 -74776479)
2018,Octubre,Bélgica,2,1,,3,POINT (11247723 -74213989)
2018,Octubre,Bélgica,1,0,,1,POINT (125862 -81702165)
2018,Octubre,Bélgica,9,22,,31,POINT (3451668 -76532004)
2018,Octubre,Bélgica,267,416,,683,POINT (4697157 -74140516)
2018,Octubre,Bélgica,1,3,,4,POINT (4815189 -75736374)
2018,Octubre,Bélgica,19,54,,73,POINT (6170465 -7542726)
2018,Octubre,Bélgica,0,2,,2,POINT (7128047 -73181317)
2018,Octubre,Bélgica,2,0,,2,POINT (863337 -7735002)
2018,Octubre,Belice,2,6,,8,POINT (10446304 -75516486)
2018,Octubre,Belice,2,2,,4,POINT (3451668 -76532004)
2018,Octubre,Belice,9,16,,25,POINT (4697157 -74140516)
2018,Octubre,Belice,0,4,,4,POINT (6170465 -7542726)
2018,Octubre,Benín,2,0,,2,POINT (10886686 -74776479)
2018,Octubre,Benín,0,6,,6,POINT (4697157 -74140516)
2018,Octubre,Benín,0,2,,2,POINT (6170465 -7542726)
2018,Octubre,Bermudas/Territorio Británico de Ultramar,0,5,,5,POINT (10446304 -75516486)
2018,Octubre,Bolivia,10,9,,19,POINT (0.81488 -77356)
2018,Octubre,Bolivia,23,11,,34,POINT (10406342 -75527794)
2018,Octubre,Bolivia,123,113,,236,POINT (10446304 -75516486)
2018,Octubre,Bolivia,2,16,,18,POINT (10886686 -74776479)
2018,Octubre,Bolivia,0,1,,1,POINT (11360029 -72129595)
2018,Octubre,Bolivia,31,18,,49,POINT (125862 -81702165)
2018,Octubre,Bolivia,31,24,,55,POINT (3451668 -76532004)
2018,Octubre,Bolivia,515,623,,1138,POINT (4697157 -74140516)
2018,Octubre,Bolivia,1,0,,1,POINT (4815189 -75736374)
2018,Octubre,Bolivia,47,51,,98,POINT (6170465 -7542726)
2018,Octubre,Bolivia,1,0,,1,POINT (7088729 -70740253)
2018,Octubre,Bolivia,1,3,,4,POINT (7819 -72453013)
2018,Octubre,Bolivia,0,1,,1,POINT (836068 -72409396)
2018,Octubre,Bosnia y Herzegovina,3,7,,10,POINT (4697157 -74140516)
2018,Octubre,Botsuana,1,0,,1,POINT (4697157 -74140516)
2018,Octubre,Brasil,90,108,,198,POINT (-4191162 -69941498)
2018,Octubre,Brasil,2,1,,3,POINT (-4214082 -69941431)
2018,Octubre,Brasil,0,2,,2,POINT (0.33002 -76876446)
2018,Octubre,Brasil,25,39,,64,POINT (0.81488 -77356)
2018,Octubre,Brasil,435,354,,789,POINT (10406342 -75527794)
2018,Octubre,Brasil,667,571,,1238,POINT (10446304 -75516486)
2018,Octubre,Brasil,16,37,,53,POINT (10886686 -74776479)
2018,Octubre,Brasil,0,1,,1,POINT (11247723 -74213989)
2018,Octubre,Brasil,0,3,,3,POINT (11360029 -72129595)
2018,Octubre,Brasil,177,143,,320,POINT (125862 -81702165)
2018,Octubre,Brasil,49,83,,132,POINT (3451668 -76532004)
2018,Octubre,Brasil,1,2,,3,POINT (3866713 -67927521)
2018,Octubre,Brasil,1,1,,2,POINT (445285 -75766353)
2018,Octubre,Brasil,5956,7143,,13099,POINT (4697157 -74140516)
2018,Octubre,Brasil,5,4,,9,POINT (4815189 -75736374)
2018,Octubre,Brasil,134,223,,357,POINT (6170465 -7542726)
2018,Octubre,Brasil,1,0,,1,POINT (6185536 -67484028)
2018,Octubre,Brasil,0,2,,2,POINT (7128047 -73181317)
2018,Octubre,Brasil,3,7,,10,POINT (7819 -72453013)
2018,Octubre,Brasil,0,2,,2,POINT (836068 -72409396)
2018,Octubre,Brasil,0,2,,2,POINT (863337 -7735002)
2018,Octubre,Brunei Darussalam,1,0,,1,POINT (10446304 -75516486)
2018,Octubre,Brunei Darussalam,1,0,,1,POINT (4697157 -74140516)
2018,Octubre,Bulgaria,2,2,,4,POINT (0.81488 -77356)
2018,Octubre,Bulgaria,0,1,,1,POINT (10406342 -75527794)
2018,Octubre,Bulgaria,9,3,,12,POINT (10446304 -75516486)
2018,Octubre,Bulgaria,35,44,,79,POINT (4697157 -74140516)
2018,Octubre,Bulgaria,0,4,,4,POINT (6170465 -7542726)
2018,Octubre,Burundi,0,1,,1,POINT (4697157 -74140516)
2018,Octubre,Cabo Verde,1,0,,1,POINT (3451668 -76532004)
2018,Octubre,Islas Caimán/Territorio Británico de Ultramar,2,0,,2,POINT (10446304 -75516486)
2018,Octubre,Camerún,0,1,,1,POINT (10446304 -75516486)
2018,Octubre,Camerún,0,1,,1,POINT (3451668 -76532004)
2018,Octubre,Camerún,3,7,,10,POINT (4697157 -74140516)
2018,Octubre,Camerún,1,2,,3,POINT (6170465 -7542726)
2018,Octubre,Canadá,2,2,,4,POINT (-4191162 -69941498)
2018,Octubre,Canadá,1,3,,4,POINT (0.33002 -76876446)
2018,Octubre,Canadá,9,9,,18,POINT (0.81488 -77356)
2018,Octubre,Canadá,16,12,,28,POINT (10406342 -75527794)
2018,Octubre,Canadá,217,291,,508,POINT (10446304 -75516486)
2018,Octubre,Canadá,18,38,,56,POINT (10886686 -74776479)
2018,Octubre,Canadá,3,6,,9,POINT (11247723 -74213989)
2018,Octubre,Canadá,2,2,,4,POINT (125862 -81702165)
2018,Octubre,Canadá,36,70,,106,POINT (3451668 -76532004)
2018,Octubre,Canadá,0,1,,1,POINT (445285 -75766353)
2018,Octubre,Canadá,939,1683,,2622,POINT (4697157 -74140516)
2018,Octubre,Canadá,7,14,,21,POINT (4815189 -75736374)
2018,Octubre,Canadá,138,368,,506,POINT (6170465 -7542726)
2018,Octubre,Canadá,2,6,,8,POINT (7128047 -73181317)
2018,Octubre,Canadá,3,6,,9,POINT (7819 -72453013)
2018,Octubre,Canadá,2,7,,9,POINT (863337 -7735002)
2018,Octubre,República Democrática del Congo,0,1,,1,POINT (10446304 -75516486)
2018,Octubre,República Democrática del Congo,2,5,,7,POINT (4697157 -74140516)
2018,Octubre,República Democrática del Congo,0,1,,1,POINT (7819 -72453013)
2018,Octubre,República de Corea,0,1,,1,POINT (-4214082 -69941431)
2018,Octubre,República de Corea,3,6,,9,POINT (0.81488 -77356)
2018,Octubre,República de Corea,5,7,,12,POINT (10446304 -75516486)
2018,Octubre,República de Corea,1,36,,37,POINT (10886686 -74776479)
2018,Octubre,República de Corea,0,1,,1,POINT (125862 -81702165)
2018,Octubre,República de Corea,2,3,,5,POINT (3451668 -76532004)
2018,Octubre,República de Corea,0,1,,1,POINT (445285 -75766353)
2018,Octubre,República de Corea,220,427,,647,POINT (4697157 -74140516)
2018,Octubre,República de Corea,11,33,,44,POINT (6170465 -7542726)
2018,Octubre,República de Corea,0,1,,1,POINT (7819 -72453013)
2018,Octubre,República de Corea,0,1,,1,POINT (836068 -72409396)
2018,Octubre,Costa de Marfil,0,1,,1,POINT (3451668 -76532004)
2018,Octubre,Costa de Marfil,0,1,,1,POINT (4697157 -74140516)
2018,Octubre,Costa Rica,0,1,,1,POINT (0.33002 -76876446)
2018,Octubre,Costa Rica,1,6,,7,POINT (0.81488 -77356)
2018,Octubre,Costa Rica,0,2,,2,POINT (10406342 -75527794)
2018,Octubre,Costa Rica,172,146,,318,POINT (10446304 -75516486)
2018,Octubre,Costa Rica,21,23,,44,POINT (10886686 -74776479)
2018,Octubre,Costa Rica,0,1,,1,POINT (125744111 -81703935)
2018,Octubre,Costa Rica,12,12,,24,POINT (125862 -81702165)
2018,Octubre,Costa Rica,55,56,,111,POINT (3451668 -76532004)
2018,Octubre,Costa Rica,1292,1727,,3019,POINT (4697157 -74140516)
2018,Octubre,Costa Rica,3,8,,11,POINT (4815189 -75736374)
2018,Octubre,Costa Rica,142,205,,347,POINT (6170465 -7542726)
2018,Octubre,Costa Rica,2,1,,3,POINT (7128047 -73181317)
2018,Octubre,Costa Rica,1,2,,3,POINT (7819 -72453013)
2018,Octubre,Costa Rica,2,0,,2,POINT (836068 -72409396)
2018,Octubre,Costa Rica,0,1,,1,POINT (863337 -7735002)
2018,Octubre,Croacia,1,1,,2,POINT (10406342 -75527794)
2018,Octubre,Croacia,1,1,,2,POINT (10446304 -75516486)
2018,Octubre,Croacia,2,2,,4,POINT (3451668 -76532004)
2018,Octubre,Croacia,15,48,,63,POINT (4697157 -74140516)
2018,Octubre,Croacia,2,7,,9,POINT (6170465 -7542726)
2018,Octubre,Cuba,0,2,,2,POINT (0.81488 -77356)
2018,Octubre,Cuba,0,13,,13,POINT (10406342 -75527794)
2018,Octubre,Cuba,14,39,,53,POINT (10446304 -75516486)
2018,Octubre,Cuba,11,27,,38,POINT (10886686 -74776479)
2018,Octubre,Cuba,1,1,,2,POINT (125862 -81702165)
2018,Octubre,Cuba,32,34,,66,POINT (3451668 -76532004)
2018,Octubre,Cuba,0,1,,1,POINT (445285 -75766353)
2018,Octubre,Cuba,180,276,,456,POINT (4697157 -74140516)
2018,Octubre,Cuba,2,2,,4,POINT (4815189 -75736374)
2018,Octubre,Cuba,24,32,,56,POINT (6170465 -7542726)
2018,Octubre,Cuba,2,2,,4,POINT (7128047 -73181317)
2018,Octubre,Cuba,2,2,,4,POINT (7819 -72453013)
2018,Octubre,Curazao,0,1,,1,POINT (4697157 -74140516)
2018,Octubre,República Checa,0,1,,1,POINT (-4191162 -69941498)
2018,Octubre,República Checa,1,8,,9,POINT (0.81488 -77356)
2018,Octubre,República Checa,1,2,,3,POINT (10406342 -75527794)
2018,Octubre,República Checa,2,11,,13,POINT (10446304 -75516486)
2018,Octubre,República Checa,0,26,,26,POINT (10886686 -74776479)
2018,Octubre,República Checa,1,5,,6,POINT (3451668 -76532004)
2018,Octubre,República Checa,50,101,,151,POINT (4697157 -74140516)
2018,Octubre,República Checa,6,12,,18,POINT (6170465 -7542726)
2018,Octubre,República Checa,0,1,,1,POINT (863337 -7735002)
2018,Octubre,Chile,2,1,,3,POINT (-4191162 -69941498)
2018,Octubre,Chile,1,2,,3,POINT (-4214082 -69941431)
2018,Octubre,Chile,2,3,,5,POINT (0.33002 -76876446)
2018,Octubre,Chile,31,60,,91,POINT (0.81488 -77356)
2018,Octubre,Chile,0,1,,1,POINT (1800143 -78802679)
2018,Octubre,Chile,70,48,,118,POINT (10406342 -75527794)
2018,Octubre,Chile,595,490,,1085,POINT (10446304 -75516486)
2018,Octubre,Chile,10,21,,31,POINT (10886686 -74776479)
2018,Octubre,Chile,3,4,,7,POINT (11360029 -72129595)
2018,Octubre,Chile,0,1,,1,POINT (125744111 -81703935)
2018,Octubre,Chile,178,120,,298,POINT (125862 -81702165)
2018,Octubre,Chile,29,64,,93,POINT (3451668 -76532004)
2018,Octubre,Chile,0,1,,1,POINT (445285 -75766353)
2018,Octubre,Chile,4439,5552,,9991,POINT (4697157 -74140516)
2018,Octubre,Chile,1,6,,7,POINT (4815189 -75736374)
2018,Octubre,Chile,57,150,,207,POINT (6170465 -7542726)
2018,Octubre,Chile,0,1,,1,POINT (7088729 -70740253)
2018,Octubre,Chile,15,32,,47,POINT (7819 -72453013)
2018,Octubre,Chile,6,8,,14,POINT (836068 -72409396)
2018,Octubre,Chile,2,2,,4,POINT (863337 -7735002)
2018,Octubre,China,7,8,,15,POINT (0.81488 -77356)
2018,Octubre,China,1,5,,6,POINT (10406342 -75527794)
2018,Octubre,China,17,31,,48,POINT (10446304 -75516486)
2018,Octubre,China,3,9,,12,POINT (10886686 -74776479)
2018,Octubre,China,0,2,,2,POINT (11247723 -74213989)
2018,Octubre,China,0,2,,2,POINT (11360029 -72129595)
2018,Octubre,China,12,16,,28,POINT (3451668 -76532004)
2018,Octubre,China,0,1,,1,POINT (3884426 -77061029)
2018,Octubre,China,310,762,,1072,POINT (4697157 -74140516)
2018,Octubre,China,3,2,,5,POINT (4815189 -75736374)
2018,Octubre,China,22,55,,77,POINT (6170465 -7542726)
2018,Octubre,China,2,2,,4,POINT (7819 -72453013)
2018,Octubre,China,1,1,,2,POINT (836068 -72409396)
2018,Octubre,Taiwán,2,1,,3,POINT (0.81488 -77356)
2018,Octubre,Taiwán,2,3,,5,POINT (10446304 -75516486)
2018,Octubre,Taiwán,2,1,,3,POINT (10886686 -74776479)
2018,Octubre,Taiwán,0,1,,1,POINT (3451668 -76532004)
2018,Octubre,Taiwán,53,105,,158,POINT (4697157 -74140516)
2018,Octubre,Taiwán,0,1,,1,POINT (4815189 -75736374)
2018,Octubre,Taiwán,6,13,,19,POINT (6170465 -7542726)
2018,Octubre,Taiwán,0,1,,1,POINT (7819 -72453013)
2018,Octubre,Chipre,1,0,,1,POINT (10446304 -75516486)
2018,Octubre,Chipre,0,1,,1,POINT (3451668 -76532004)
2018,Octubre,Chipre,6,12,,18,POINT (4697157 -74140516)
2018,Octubre,Chipre,0,1,,1,POINT (6170465 -7542726)
2018,Octubre,Dinamarca,2,3,,5,POINT (-4191162 -69941498)
2018,Octubre,Dinamarca,1,1,,2,POINT (0.81488 -77356)
2018,Octubre,Dinamarca,1,2,,3,POINT (10406342 -75527794)
2018,Octubre,Dinamarca,15,32,,47,POINT (10446304 -75516486)
2018,Octubre,Dinamarca,0,2,,2,POINT (10886686 -74776479)
2018,Octubre,Dinamarca,3,1,,4,POINT (11247723 -74213989)
2018,Octubre,Dinamarca,4,10,,14,POINT (3451668 -76532004)
2018,Octubre,Dinamarca,60,174,,234,POINT (4697157 -74140516)
2018,Octubre,Dinamarca,0,1,,1,POINT (4815189 -75736374)
2018,Octubre,Dinamarca,9,29,,38,POINT (6170465 -7542726)
2018,Octubre,Dinamarca,3,1,,4,POINT (863337 -7735002)
2018,Octubre,Dominica,1,0,,1,POINT (3451668 -76532004)
2018,Octubre,Dominica,3,1,,4,POINT (4697157 -74140516)
2018,Octubre,Dominica,0,3,,3,POINT (6170465 -7542726)
2018,Octubre,Ecuador,2,6,,8,POINT (-4191162 -69941498)
2018,Octubre,Ecuador,0,1,,1,POINT (-4214082 -69941431)
2018,Octubre,Ecuador,63,240,,303,POINT (0.33002 -76876446)
2018,Octubre,Ecuador,3,8,,11,POINT (0.812436 -77847006)
2018,Octubre,Ecuador,1540,2152,,3692,POINT (0.81488 -77356)
2018,Octubre,Ecuador,18,64,,82,POINT (1800143 -78802679)
2018,Octubre,Ecuador,7,10,,17,POINT (10406342 -75527794)
2018,Octubre,Ecuador,60,83,,143,POINT (10446304 -75516486)
2018,Octubre,Ecuador,18,30,,48,POINT (10886686 -74776479)
2018,Octubre,Ecuador,7,8,,15,POINT (11360029 -72129595)
2018,Octubre,Ecuador,22,17,,39,POINT (125862 -81702165)
2018,Octubre,Ecuador,593,603,,1196,POINT (3451668 -76532004)
2018,Octubre,Ecuador,0,1,,1,POINT (3866713 -67927521)
2018,Octubre,Ecuador,0,2,,2,POINT (445285 -75766353)
2018,Octubre,Ecuador,3365,4429,,7794,POINT (4697157 -74140516)
2018,Octubre,Ecuador,2,2,,4,POINT (4815189 -75736374)
2018,Octubre,Ecuador,54,97,,151,POINT (6170465 -7542726)
2018,Octubre,Ecuador,3,4,,7,POINT (7088729 -70740253)
2018,Octubre,Ecuador,1,1,,2,POINT (7128047 -73181317)
2018,Octubre,Ecuador,81,105,,186,POINT (7819 -72453013)
2018,Octubre,Ecuador,7,18,,25,POINT (836068 -72409396)
2018,Octubre,Egipto,2,2,,4,POINT (10446304 -75516486)
2018,Octubre,Egipto,0,1,,1,POINT (10886686 -74776479)
2018,Octubre,Egipto,0,2,,2,POINT (3451668 -76532004)
2018,Octubre,Egipto,8,22,,30,POINT (4697157 -74140516)
2018,Octubre,Egipto,1,3,,4,POINT (6170465 -7542726)
2018,Octubre,El Salvador,2,4,,6,POINT (0.81488 -77356)
2018,Octubre,El Salvador,0,1,,1,POINT (10406342 -75527794)
2018,Octubre,El Salvador,80,58,,138,POINT (10446304 -75516486)
2018,Octubre,El Salvador,8,28,,36,POINT (10886686 -74776479)
2018,Octubre,El Salvador,125,140,,265,POINT (3451668 -76532004)
2018,Octubre,El Salvador,756,977,,1733,POINT (4697157 -74140516)
2018,Octubre,El Salvador,2,0,,2,POINT (4815189 -75736374)
2018,Octubre,El Salvador,160,157,,317,POINT (6170465 -7542726)
2018,Octubre,El Salvador,0,2,,2,POINT (7128047 -73181317)
2018,Octubre,El Salvador,2,1,,3,POINT (7819 -72453013)
2018,Octubre,Emiratos Árabes,0,3,,3,POINT (10446304 -75516486)
2018,Octubre,Emiratos Árabes,0,14,,14,POINT (4697157 -74140516)
2018,Octubre,Emiratos Árabes,0,2,,2,POINT (6170465 -7542726)
2018,Octubre,España,10,8,,18,POINT (-4191162 -69941498)
2018,Octubre,España,2,2,,4,POINT (-4214082 -69941431)
2018,Octubre,España,2,4,,6,POINT (0.33002 -76876446)
2018,Octubre,España,0,1,,1,POINT (0.812436 -77847006)
2018,Octubre,España,41,35,,76,POINT (0.81488 -77356)
2018,Octubre,España,6,15,,21,POINT (10406342 -75527794)
2018,Octubre,España,101,195,,296,POINT (10446304 -75516486)
2018,Octubre,España,15,41,,56,POINT (10886686 -74776479)
2018,Octubre,España,1,0,,1,POINT (11117206 -74232675)
2018,Octubre,España,1,1,,2,POINT (11247723 -74213989)
2018,Octubre,España,3,8,,11,POINT (11360029 -72129595)
2018,Octubre,España,5,6,,11,POINT (125862 -81702165)
2018,Octubre,España,203,427,,630,POINT (3451668 -76532004)
2018,Octubre,España,0,1,,1,POINT (445285 -75766353)
2018,Octubre,España,3181,6373,,9554,POINT (4697157 -74140516)
2018,Octubre,España,6,18,,24,POINT (4815189 -75736374)
2018,Octubre,España,348,622,,970,POINT (6170465 -7542726)
2018,Octubre,España,0,1,,1,POINT (6185536 -67484028)
2018,Octubre,España,1,1,,2,POINT (7088729 -70740253)
2018,Octubre,España,1,2,,3,POINT (7128047 -73181317)
2018,Octubre,España,21,42,,63,POINT (7819 -72453013)
2018,Octubre,España,4,5,,9,POINT (836068 -72409396)
2018,Octubre,España,1,4,,5,POINT (863337 -7735002)
2018,Octubre,Eritrea,0,4,,4,POINT (4697157 -74140516)
2018,Octubre,Eslovaquia,0,1,,1,POINT (-4191162 -69941498)
2018,Octubre,Eslovaquia,0,1,,1,POINT (0.33002 -76876446)
2018,Octubre,Eslovaquia,0,1,,1,POINT (0.81488 -77356)
2018,Octubre,Eslovaquia,0,1,,1,POINT (10406342 -75527794)
2018,Octubre,Eslovaquia,1,4,,5,POINT (10446304 -75516486)
2018,Octubre,Eslovaquia,2,1,,3,POINT (10886686 -74776479)
2018,Octubre,Eslovaquia,0,1,,1,POINT (3451668 -76532004)
2018,Octubre,Eslovaquia,45,46,,91,POINT (4697157 -74140516)
2018,Octubre,Eslovaquia,1,3,,4,POINT (6170465 -7542726)
2018,Octubre,Eslovenia,1,0,,1,POINT (0.33002 -76876446)
2018,Octubre,Eslovenia,1,1,,2,POINT (10406342 -75527794)
2018,Octubre,Eslovenia,0,1,,1,POINT (10446304 -75516486)
2018,Octubre,Eslovenia,24,36,,60,POINT (4697157 -74140516)
2018,Octubre,Eslovenia,1,7,,8,POINT (6170465 -7542726)
2018,Octubre,Estados Unidos de América,11,35,,46,POINT (-4191162 -69941498)
2018,Octubre,Estados Unidos de América,8,6,,14,POINT (-4214082 -69941431)
2018,Octubre,Estados Unidos de América,5,2,,7,POINT (0.33002 -76876446)
2018,Octubre,Estados Unidos de América,54,54,,108,POINT (0.81488 -77356)
2018,Octubre,Estados Unidos de América,25,65,,90,POINT (10406342 -75527794)
2018,Octubre,Estados Unidos de América,3531,5193,,8724,POINT (10446304 -75516486)
2018,Octubre,Estados Unidos de América,499,922,,1421,POINT (10886686 -74776479)
2018,Octubre,Estados Unidos de América,1,0,,1,POINT (11117206 -74232675)
2018,Octubre,Estados Unidos de América,4,10,,14,POINT (11247723 -74213989)
2018,Octubre,Estados Unidos de América,2,5,,7,POINT (11360029 -72129595)
2018,Octubre,Estados Unidos de América,1,7,,8,POINT (125744111 -81703935)
2018,Octubre,Estados Unidos de América,20,42,,62,POINT (125862 -81702165)
2018,Octubre,Estados Unidos de América,918,1470,,2388,POINT (3451668 -76532004)
2018,Octubre,Estados Unidos de América,1,16,,17,POINT (3884426 -77061029)
2018,Octubre,Estados Unidos de América,108,190,,298,POINT (445285 -75766353)
2018,Octubre,Estados Unidos de América,7422,13811,,21233,POINT (4697157 -74140516)
2018,Octubre,Estados Unidos de América,115,176,,291,POINT (4815189 -75736374)
2018,Octubre,Estados Unidos de América,2222,6244,,8466,POINT (6170465 -7542726)
2018,Octubre,Estados Unidos de América,0,2,,2,POINT (6185536 -67484028)
2018,Octubre,Estados Unidos de América,29,43,,72,POINT (7128047 -73181317)
2018,Octubre,Estados Unidos de América,10,9,,19,POINT (7819 -72453013)
2018,Octubre,Estados Unidos de América,1,4,,5,POINT (7927233 -72508188)
2018,Octubre,Estados Unidos de América,4,7,,11,POINT (836068 -72409396)
2018,Octubre,Estados Unidos de América,5,17,,22,POINT (863337 -7735002)
2018,Octubre,Estonia,1,1,,2,POINT (0.81488 -77356)
2018,Octubre,Estonia,3,1,,4,POINT (10446304 -75516486)
2018,Octubre,Estonia,10,10,,20,POINT (4697157 -74140516)
2018,Octubre,Estonia,0,1,,1,POINT (6170465 -7542726)
2018,Octubre,Etiopia,0,1,,1,POINT (10886686 -74776479)
2018,Octubre,Etiopia,2,41,,43,POINT (4697157 -74140516)
2018,Octubre,Etiopia,0,1,,1,POINT (6170465 -7542726)
2018,Octubre,Filipinas,0,2,,2,POINT (0.81488 -77356)
2018,Octubre,Filipinas,1,40,,41,POINT (10406342 -75527794)
2018,Octubre,Filipinas,9,59,,68,POINT (10446304 -75516486)
2018,Octubre,Filipinas,0,15,,15,POINT (10886686 -74776479)
2018,Octubre,Filipinas,0,11,,11,POINT (10970933 -74765343)
2018,Octubre,Filipinas,0,14,,14,POINT (11247723 -74213989)
2018,Octubre,Filipinas,0,1,,1,POINT (125862 -81702165)
2018,Octubre,Filipinas,4,2,,6,POINT (3451668 -76532004)
2018,Octubre,Filipinas,0,2,,2,POINT (3884426 -77061029)
2018,Octubre,Filipinas,52,83,,135,POINT (4697157 -74140516)
2018,Octubre,Filipinas,4,6,,10,POINT (6170465 -7542726)
2018,Octubre,Filipinas,1,0,,1,POINT (836068 -72409396)
2018,Octubre,Filipinas,0,9,,9,POINT (9402597 -75681642)
2018,Octubre,Finlandia,1,1,,2,POINT (0.81488 -77356)
2018,Octubre,Finlandia,2,1,,3,POINT (10406342 -75527794)
2018,Octubre,Finlandia,4,9,,13,POINT (10446304 -75516486)
2018,Octubre,Finlandia,1,0,,1,POINT (10886686 -74776479)
2018,Octubre,Finlandia,3,6,,9,POINT (3451668 -76532004)
2018,Octubre,Finlandia,50,72,,122,POINT (4697157 -74140516)
2018,Octubre,Finlandia,0,1,,1,POINT (4815189 -75736374)
2018,Octubre,Finlandia,5,13,,18,POINT (6170465 -7542726)
2018,Octubre,Francia,3,8,,11,POINT (-4191162 -69941498)
2018,Octubre,Francia,2,4,,6,POINT (-4214082 -69941431)
2018,Octubre,Francia,0,1,,1,POINT (0.33002 -76876446)
2018,Octubre,Francia,41,59,,100,POINT (0.81488 -77356)
2018,Octubre,Francia,2,17,,19,POINT (10406342 -75527794)
2018,Octubre,Francia,102,152,,254,POINT (10446304 -75516486)
2018,Octubre,Francia,15,20,,35,POINT (10886686 -74776479)
2018,Octubre,Francia,4,5,,9,POINT (11247723 -74213989)
2018,Octubre,Francia,1,8,,9,POINT (11360029 -72129595)
2018,Octubre,Francia,7,4,,11,POINT (125862 -81702165)
2018,Octubre,Francia,46,126,,172,POINT (3451668 -76532004)
2018,Octubre,Francia,1779,2782,,4561,POINT (4697157 -74140516)
2018,Octubre,Francia,3,5,,8,POINT (4815189 -75736374)
2018,Octubre,Francia,101,240,,341,POINT (6170465 -7542726)
2018,Octubre,Francia,1,2,,3,POINT (7128047 -73181317)
2018,Octubre,Francia,5,6,,11,POINT (7819 -72453013)
2018,Octubre,Francia,1,7,,8,POINT (863337 -7735002)
2018,Octubre,Francia,0,1,,1,POINT (9402597 -75681642)
2018,Octubre,Gabón,0,1,,1,POINT (4697157 -74140516)
2018,Octubre,Georgia,0,2,,2,POINT (10886686 -74776479)
2018,Octubre,Georgia,0,2,,2,POINT (3451668 -76532004)
2018,Octubre,Georgia,0,2,,2,POINT (4697157 -74140516)
2018,Octubre,Georgia,0,2,,2,POINT (6170465 -7542726)
2018,Octubre,Ghana,0,2,,2,POINT (0.81488 -77356)
2018,Octubre,Ghana,3,3,,6,POINT (3451668 -76532004)
2018,Octubre,Ghana,7,8,,15,POINT (4697157 -74140516)
2018,Octubre,Granada,2,0,,2,POINT (10446304 -75516486)
2018,Octubre,Granada,1,1,,2,POINT (4697157 -74140516)
2018,Octubre,Grecia,0,4,,4,POINT (10406342 -75527794)
2018,Octubre,Grecia,0,16,,16,POINT (10446304 -75516486)
2018,Octubre,Grecia,0,2,,2,POINT (10886686 -74776479)
2018,Octubre,Grecia,0,4,,4,POINT (11247723 -74213989)
2018,Octubre,Grecia,1,5,,6,POINT (3451668 -76532004)
2018,Octubre,Grecia,40,82,,122,POINT (4697157 -74140516)
2018,Octubre,Grecia,3,7,,10,POINT (6170465 -7542726)
2018,Octubre,Guatemala,0,1,,1,POINT (0.33002 -76876446)
2018,Octubre,Guatemala,0,3,,3,POINT (0.81488 -77356)
2018,Octubre,Guatemala,0,2,,2,POINT (10406342 -75527794)
2018,Octubre,Guatemala,141,185,,326,POINT (10446304 -75516486)
2018,Octubre,Guatemala,13,46,,59,POINT (10886686 -74776479)
2018,Octubre,Guatemala,2,1,,3,POINT (125862 -81702165)
2018,Octubre,Guatemala,45,86,,131,POINT (3451668 -76532004)
2018,Octubre,Guatemala,465,901,,1366,POINT (4697157 -74140516)
2018,Octubre,Guatemala,4,4,,8,POINT (4815189 -75736374)
2018,Octubre,Guatemala,55,146,,201,POINT (6170465 -7542726)
2018,Octubre,Guatemala,0,1,,1,POINT (7088729 -70740253)
2018,Octubre,Guatemala,0,2,,2,POINT (7128047 -73181317)
2018,Octubre,Guatemala,0,1,,1,POINT (7819 -72453013)
2018,Octubre,Guatemala,1,0,,1,POINT (836068 -72409396)
2018,Octubre,Guyana,2,4,,6,POINT (10446304 -75516486)
2018,Octubre,Guyana,1,0,,1,POINT (10886686 -74776479)
2018,Octubre,Guyana,1,1,,2,POINT (3451668 -76532004)
2018,Octubre,Guyana,11,12,,23,POINT (4697157 -74140516)
2018,Octubre,Guyana,1,0,,1,POINT (4815189 -75736374)
2018,Octubre,Guyana,0,2,,2,POINT (6170465 -7542726)
2018,Octubre,Guyana,0,1,,1,POINT (7128047 -73181317)
2018,Octubre,Guyana,0,2,,2,POINT (7819 -72453013)
2018,Octubre,Guinea Ecuatorial,1,0,,1,POINT (6170465 -7542726)
2018,Octubre,Haití,0,2,,2,POINT (0.81488 -77356)
2018,Octubre,Haití,0,3,,3,POINT (10446304 -75516486)
2018,Octubre,Haití,0,1,,1,POINT (10886686 -74776479)
2018,Octubre,Haití,3,0,,3,POINT (3451668 -76532004)
2018,Octubre,Haití,14,28,,42,POINT (4697157 -74140516)
2018,Octubre,Haití,0,4,,4,POINT (6170465 -7542726)
2018,Octubre,Honduras,2,2,,4,POINT (0.81488 -77356)
2018,Octubre,Honduras,0,4,,4,POINT (10406342 -75527794)
2018,Octubre,Honduras,214,160,,374,POINT (10446304 -75516486)
2018,Octubre,Honduras,27,30,,57,POINT (10886686 -74776479)
2018,Octubre,Honduras,0,10,,10,POINT (125744111 -81703935)
2018,Octubre,Honduras,3,4,,7,POINT (125862 -81702165)
2018,Octubre,Honduras,63,59,,122,POINT (3451668 -76532004)
2018,Octubre,Honduras,3,12,,15,POINT (445285 -75766353)
2018,Octubre,Honduras,358,363,,721,POINT (4697157 -74140516)
2018,Octubre,Honduras,5,6,,11,POINT (4815189 -75736374)
2018,Octubre,Honduras,73,80,,153,POINT (6170465 -7542726)
2018,Octubre,Honduras,0,2,,2,POINT (7128047 -73181317)
2018,Octubre,Honduras,0,2,,2,POINT (7819 -72453013)
2018,Octubre,Hong Kong,10,2,,12,POINT (0.81488 -77356)
2018,Octubre,Hong Kong,0,1,,1,POINT (10446304 -75516486)
2018,Octubre,Hong Kong,6,17,,23,POINT (4697157 -74140516)
2018,Octubre,Hong Kong,0,1,,1,POINT (6170465 -7542726)
2018,Octubre,Hungría,2,1,,3,POINT (0.81488 -77356)
2018,Octubre,Hungría,5,19,,24,POINT (10446304 -75516486)
2018,Octubre,Hungría,60,88,,148,POINT (4697157 -74140516)
2018,Octubre,Hungría,0,1,,1,POINT (4815189 -75736374)
2018,Octubre,Hungría,4,5,,9,POINT (6170465 -7542726)
2018,Octubre,India,0,3,,3,POINT (0.81488 -77356)
2018,Octubre,India,1,13,,14,POINT (10406342 -75527794)
2018,Octubre,India,16,74,,90,POINT (10446304 -75516486)
2018,Octubre,India,3,10,,13,POINT (10886686 -74776479)
2018,Octubre,India,1,1,,2,POINT (125862 -81702165)
2018,Octubre,India,3,20,,23,POINT (3451668 -76532004)
2018,Octubre,India,0,6,,6,POINT (3884426 -77061029)
2018,Octubre,India,79,435,,514,POINT (4697157 -74140516)
2018,Octubre,India,5,60,,65,POINT (6170465 -7542726)
2018,Octubre,India,0,7,,7,POINT (9402597 -75681642)
2018,Octubre,Indonesia,0,2,,2,POINT (10406342 -75527794)
2018,Octubre,Indonesia,0,8,,8,POINT (10446304 -75516486)
2018,Octubre,Indonesia,0,2,,2,POINT (3451668 -76532004)
2018,Octubre,Indonesia,19,24,,43,POINT (4697157 -74140516)
2018,Octubre,Indonesia,2,0,,2,POINT (6170465 -7542726)
2018,Octubre,Iraq,0,1,,1,POINT (4697157 -74140516)
2018,Octubre,Irán,0,1,,1,POINT (10446304 -75516486)
2018,Octubre,Irán,1,13,,14,POINT (4697157 -74140516)
2018,Octubre,Irán,0,4,,4,POINT (6170465 -7542726)
2018,Octubre,República de Irlanda,8,9,,17,POINT (0.81488 -77356)
2018,Octubre,República de Irlanda,9,11,,20,POINT (10406342 -75527794)
2018,Octubre,República de Irlanda,25,31,,56,POINT (10446304 -75516486)
2018,Octubre,República de Irlanda,1,2,,3,POINT (10886686 -74776479)
2018,Octubre,República de Irlanda,1,1,,2,POINT (11247723 -74213989)
2018,Octubre,República de Irlanda,0,1,,1,POINT (11360029 -72129595)
2018,Octubre,República de Irlanda,0,1,,1,POINT (125862 -81702165)
2018,Octubre,República de Irlanda,4,5,,9,POINT (3451668 -76532004)
2018,Octubre,República de Irlanda,136,238,,374,POINT (4697157 -74140516)
2018,Octubre,República de Irlanda,9,32,,41,POINT (6170465 -7542726)
2018,Octubre,República de Irlanda,4,10,,14,POINT (863337 -7735002)
2018,Octubre,Islandia,3,5,,8,POINT (10446304 -75516486)
2018,Octubre,Islandia,7,6,,13,POINT (4697157 -74140516)
2018,Octubre,Islandia,1,1,,2,POINT (4815189 -75736374)
2018,Octubre,Islandia,1,1,,2,POINT (6170465 -7542726)
2018,Octubre,Israel,0,1,,1,POINT (-4191162 -69941498)
2018,Octubre,Israel,0,1,,1,POINT (0.33002 -76876446)
2018,Octubre,Israel,11,9,,20,POINT (0.81488 -77356)
2018,Octubre,Israel,0,1,,1,POINT (10406342 -75527794)
2018,Octubre,Israel,7,35,,42,POINT (10446304 -75516486)
2018,Octubre,Israel,1,3,,4,POINT (10886686 -74776479)
2018,Octubre,Israel,0,1,,1,POINT (125862 -81702165)
2018,Octubre,Israel,1,11,,12,POINT (3451668 -76532004)
2018,Octubre,Israel,101,416,,517,POINT (4697157 -74140516)
2018,Octubre,Israel,0,1,,1,POINT (4815189 -75736374)
2018,Octubre,Israel,17,76,,93,POINT (6170465 -7542726)
2018,Octubre,Israel,1,1,,2,POINT (863337 -7735002)
2018,Octubre,Italia,3,3,,6,POINT (-4191162 -69941498)
2018,Octubre,Italia,1,4,,5,POINT (-4214082 -69941431)
2018,Octubre,Italia,0,3,,3,POINT (0.33002 -76876446)
2018,Octubre,Italia,7,20,,27,POINT (0.81488 -77356)
2018,Octubre,Italia,4,22,,26,POINT (10406342 -75527794)
2018,Octubre,Italia,82,178,,260,POINT (10446304 -75516486)
2018,Octubre,Italia,10,42,,52,POINT (10886686 -74776479)
2018,Octubre,Italia,0,7,,7,POINT (11360029 -72129595)
2018,Octubre,Italia,0,5,,5,POINT (125862 -81702165)
2018,Octubre,Italia,32,92,,124,POINT (3451668 -76532004)
2018,Octubre,Italia,686,1804,,2490,POINT (4697157 -74140516)
2018,Octubre,Italia,0,1,,1,POINT (4815189 -75736374)
2018,Octubre,Italia,53,229,,282,POINT (6170465 -7542726)
2018,Octubre,Italia,1,1,,2,POINT (6185536 -67484028)
2018,Octubre,Italia,0,3,,3,POINT (7128047 -73181317)
2018,Octubre,Italia,13,25,,38,POINT (7819 -72453013)
2018,Octubre,Italia,0,1,,1,POINT (806667 -767333)
2018,Octubre,Italia,6,2,,8,POINT (836068 -72409396)
2018,Octubre,Italia,2,2,,4,POINT (863337 -7735002)
2018,Octubre,Jamaica,0,1,,1,POINT (10406342 -75527794)
2018,Octubre,Jamaica,10,31,,41,POINT (10446304 -75516486)
2018,Octubre,Jamaica,3,7,,10,POINT (10886686 -74776479)
2018,Octubre,Jamaica,7,4,,11,POINT (3451668 -76532004)
2018,Octubre,Jamaica,23,59,,82,POINT (4697157 -74140516)
2018,Octubre,Jamaica,8,12,,20,POINT (6170465 -7542726)
2018,Octubre,Jamaica,0,1,,1,POINT (836068 -72409396)
2018,Octubre,Japón,0,1,,1,POINT (-4214082 -69941431)
2018,Octubre,Japón,2,2,,4,POINT (0.81488 -77356)
2018,Octubre,Japón,0,5,,5,POINT (10406342 -75527794)
2018,Octubre,Japón,16,21,,37,POINT (10446304 -75516486)
2018,Octubre,Japón,3,26,,29,POINT (10886686 -74776479)
2018,Octubre,Japón,0,1,,1,POINT (11360029 -72129595)
2018,Octubre,Japón,3,11,,14,POINT (3451668 -76532004)
2018,Octubre,Japón,123,471,,594,POINT (4697157 -74140516)
2018,Octubre,Japón,1,0,,1,POINT (4815189 -75736374)
2018,Octubre,Japón,13,39,,52,POINT (6170465 -7542726)
2018,Octubre,Japón,0,2,,2,POINT (7819 -72453013)
2018,Octubre,Japón,0,1,,1,POINT (836068 -72409396)
2018,Octubre,Jordania,0,1,,1,POINT (10446304 -75516486)
2018,Octubre,Jordania,0,1,,1,POINT (10886686 -74776479)
2018,Octubre,Jordania,2,4,,6,POINT (4697157 -74140516)
2018,Octubre,Kazajistán,4,2,,6,POINT (4697157 -74140516)
2018,Octubre,Kenia,0,2,,2,POINT (3451668 -76532004)
2018,Octubre,Kenia,7,14,,21,POINT (4697157 -74140516)
2018,Octubre,Kenia,2,3,,5,POINT (6170465 -7542726)
2018,Octubre,Kirguistán,0,1,,1,POINT (4697157 -74140516)
2018,Octubre,Kirguistán,1,0,,1,POINT (6170465 -7542726)
2018,Octubre,Kuwait,1,2,,3,POINT (3451668 -76532004)
2018,Octubre,Kuwait,0,5,,5,POINT (4697157 -74140516)
2018,Octubre,Kuwait,1,0,,1,POINT (6170465 -7542726)
2018,Octubre,República de Kosovo,2,0,,2,POINT (4697157 -74140516)
2018,Octubre,República Democrática Popular  Lao,2,4,,6,POINT (4697157 -74140516)
2018,Octubre,Letonia,0,1,,1,POINT (0.81488 -77356)
2018,Octubre,Letonia,2,1,,3,POINT (10446304 -75516486)
2018,Octubre,Letonia,1,0,,1,POINT (125862 -81702165)
2018,Octubre,Letonia,6,10,,16,POINT (4697157 -74140516)
2018,Octubre,Letonia,3,2,,5,POINT (6170465 -7542726)
2018,Octubre,Lituania,0,1,,1,POINT (0.81488 -77356)
2018,Octubre,Lituania,2,4,,6,POINT (10446304 -75516486)
2018,Octubre,Lituania,2,3,,5,POINT (3451668 -76532004)
2018,Octubre,Lituania,32,29,,61,POINT (4697157 -74140516)
2018,Octubre,Lituania,2,2,,4,POINT (6170465 -7542726)
2018,Octubre,Líbano,1,0,,1,POINT (0.81488 -77356)
2018,Octubre,Líbano,0,2,,2,POINT (10446304 -75516486)
2018,Octubre,Líbano,1,2,,3,POINT (10886686 -74776479)
2018,Octubre,Líbano,0,2,,2,POINT (11360029 -72129595)
2018,Octubre,Líbano,2,1,,3,POINT (3451668 -76532004)
2018,Octubre,Líbano,13,31,,44,POINT (4697157 -74140516)
2018,Octubre,Líbano,1,1,,2,POINT (6170465 -7542726)
2018,Octubre,Libia,0,1,,1,POINT (4697157 -74140516)
2018,Octubre,Liechtenstein,2,1,,3,POINT (4697157 -74140516)
2018,Octubre,Luxemburgo,0,1,,1,POINT (10406342 -75527794)
2018,Octubre,Luxemburgo,1,1,,2,POINT (10446304 -75516486)
2018,Octubre,Luxemburgo,9,15,,24,POINT (4697157 -74140516)
2018,Octubre,Luxemburgo,1,0,,1,POINT (6170465 -7542726)
2018,Octubre,Macedonia,0,1,,1,POINT (10446304 -75516486)
2018,Octubre,Macedonia,0,1,,1,POINT (3451668 -76532004)
2018,Octubre,Macedonia,0,2,,2,POINT (4697157 -74140516)
2018,Octubre,Madagascar,2,0,,2,POINT (4697157 -74140516)
2018,Octubre,Madagascar,1,1,,2,POINT (6170465 -7542726)
2018,Octubre,Malasia,1,0,,1,POINT (0.81488 -77356)
2018,Octubre,Malasia,0,1,,1,POINT (10406342 -75527794)
2018,Octubre,Malasia,4,9,,13,POINT (10446304 -75516486)
2018,Octubre,Malasia,24,27,,51,POINT (4697157 -74140516)
2018,Octubre,Malasia,1,0,,1,POINT (6170465 -7542726)
2018,Octubre,Malasia,0,2,,2,POINT (9402597 -75681642)
2018,Octubre,Malawi,0,2,,2,POINT (4697157 -74140516)
2018,Octubre,Malta,0,1,,1,POINT (-4191162 -69941498)
2018,Octubre,Malta,1,1,,2,POINT (10446304 -75516486)
2018,Octubre,Malta,3,8,,11,POINT (4697157 -74140516)
2018,Octubre,Malta,1,1,,2,POINT (6170465 -7542726)
2018,Octubre,Marruecos,1,0,,1,POINT (10446304 -75516486)
2018,Octubre,Marruecos,0,1,,1,POINT (3451668 -76532004)
2018,Octubre,Marruecos,10,13,,23,POINT (4697157 -74140516)
2018,Octubre,Marruecos,0,3,,3,POINT (6170465 -7542726)
2018,Octubre,Mauricio,0,1,,1,POINT (3451668 -76532004)
2018,Octubre,Mauricio,0,4,,4,POINT (4697157 -74140516)
2018,Octubre,Mauricio,1,1,,2,POINT (6170465 -7542726)
2018,Octubre,México,3,2,,5,POINT (-4191162 -69941498)
2018,Octubre,México,1,1,,2,POINT (-4214082 -69941431)
2018,Octubre,México,2,1,,3,POINT (0.33002 -76876446)
2018,Octubre,México,46,35,,81,POINT (0.81488 -77356)
2018,Octubre,México,10,18,,28,POINT (10406342 -75527794)
2018,Octubre,México,204,267,,471,POINT (10446304 -75516486)
2018,Octubre,México,72,117,,189,POINT (10886686 -74776479)
2018,Octubre,México,1,3,,4,POINT (11360029 -72129595)
2018,Octubre,México,3,3,,6,POINT (125862 -81702165)
2018,Octubre,México,80,191,,271,POINT (3451668 -76532004)
2018,Octubre,México,1,2,,3,POINT (445285 -75766353)
2018,Octubre,México,4697,8176,,12873,POINT (4697157 -74140516)
2018,Octubre,México,11,32,,43,POINT (4815189 -75736374)
2018,Octubre,México,595,1338,,1933,POINT (6170465 -7542726)
2018,Octubre,México,7,1,,8,POINT (7088729 -70740253)
2018,Octubre,México,6,14,,20,POINT (7128047 -73181317)
2018,Octubre,México,13,34,,47,POINT (7819 -72453013)
2018,Octubre,México,2,3,,5,POINT (836068 -72409396)
2018,Octubre,República de Moldavia,2,1,,3,POINT (4697157 -74140516)
2018,Octubre,Mongolia,3,1,,4,POINT (4697157 -74140516)
2018,Octubre,Montenegro,0,1,,1,POINT (-4191162 -69941498)
2018,Octubre,Montenegro,0,2,,2,POINT (10446304 -75516486)
2018,Octubre,Montenegro,0,1,,1,POINT (10970933 -74765343)
2018,Octubre,Montenegro,0,1,,1,POINT (3451668 -76532004)
2018,Octubre,Montenegro,0,4,,4,POINT (4697157 -74140516)
2018,Octubre,Montenegro,0,1,,1,POINT (6170465 -7542726)
2018,Octubre,Mozambique,2,2,,4,POINT (4697157 -74140516)
2018,Octubre,Myanmar,0,3,,3,POINT (10406342 -75527794)
2018,Octubre,Myanmar,0,2,,2,POINT (10446304 -75516486)
2018,Octubre,Myanmar,1,1,,2,POINT (4697157 -74140516)
2018,Octubre,Nepal,0,4,,4,POINT (4697157 -74140516)
2018,Octubre,Nepal,0,1,,1,POINT (6170465 -7542726)
2018,Octubre,Nicaragua,1,0,,1,POINT (-4191162 -69941498)
2018,Octubre,Nicaragua,0,1,,1,POINT (0.81488 -77356)
2018,Octubre,Nicaragua,0,1,,1,POINT (10406342 -75527794)
2018,Octubre,Nicaragua,14,22,,36,POINT (10446304 -75516486)
2018,Octubre,Nicaragua,20,21,,41,POINT (10886686 -74776479)
2018,Octubre,Nicaragua,0,1,,1,POINT (11360029 -72129595)
2018,Octubre,Nicaragua,4,8,,12,POINT (125744111 -81703935)
2018,Octubre,Nicaragua,1,1,,2,POINT (125862 -81702165)
2018,Octubre,Nicaragua,42,39,,81,POINT (3451668 -76532004)
2018,Octubre,Nicaragua,0,1,,1,POINT (445285 -75766353)
2018,Octubre,Nicaragua,80,115,,195,POINT (4697157 -74140516)
2018,Octubre,Nicaragua,3,3,,6,POINT (4815189 -75736374)
2018,Octubre,Nicaragua,13,24,,37,POINT (6170465 -7542726)
2018,Octubre,Nicaragua,3,1,,4,POINT (7128047 -73181317)
2018,Octubre,Nigeria,3,8,,11,POINT (3451668 -76532004)
2018,Octubre,Nigeria,9,21,,30,POINT (4697157 -74140516)
2018,Octubre,Nigeria,0,1,,1,POINT (6170465 -7542726)
2018,Octubre,Nigeria,0,1,,1,POINT (7128047 -73181317)
2018,Octubre,Nigeria,0,1,,1,POINT (836068 -72409396)
2018,Octubre,Noruega,0,1,,1,POINT (0.33002 -76876446)
2018,Octubre,Noruega,4,3,,7,POINT (0.81488 -77356)
2018,Octubre,Noruega,2,0,,2,POINT (10406342 -75527794)
2018,Octubre,Noruega,15,22,,37,POINT (10446304 -75516486)
2018,Octubre,Noruega,2,2,,4,POINT (10886686 -74776479)
2018,Octubre,Noruega,3,3,,6,POINT (3451668 -76532004)
2018,Octubre,Noruega,78,136,,214,POINT (4697157 -74140516)
2018,Octubre,Noruega,7,11,,18,POINT (6170465 -7542726)
2018,Octubre,Noruega,0,1,,1,POINT (7128047 -73181317)
2018,Octubre,Nueva Zelanda,4,6,,10,POINT (0.81488 -77356)
2018,Octubre,Nueva Zelanda,3,7,,10,POINT (10406342 -75527794)
2018,Octubre,Nueva Zelanda,8,17,,25,POINT (10446304 -75516486)
2018,Octubre,Nueva Zelanda,2,1,,3,POINT (10886686 -74776479)
2018,Octubre,Nueva Zelanda,0,5,,5,POINT (3451668 -76532004)
2018,Octubre,Nueva Zelanda,71,97,,168,POINT (4697157 -74140516)
2018,Octubre,Nueva Zelanda,1,0,,1,POINT (4815189 -75736374)
2018,Octubre,Nueva Zelanda,13,17,,30,POINT (6170465 -7542726)
2018,Octubre,Nueva Zelanda,1,0,,1,POINT (7128047 -73181317)
2018,Octubre,Nueva Zelanda,5,2,,7,POINT (863337 -7735002)
2018,Octubre,Omán,0,3,,3,POINT (4697157 -74140516)
2018,Octubre,Países Bajos,5,5,,10,POINT (-4191162 -69941498)
2018,Octubre,Países Bajos,2,1,,3,POINT (-4214082 -69941431)
2018,Octubre,Países Bajos,1,3,,4,POINT (0.33002 -76876446)
2018,Octubre,Países Bajos,13,17,,30,POINT (0.81488 -77356)
2018,Octubre,Países Bajos,10,8,,18,POINT (10406342 -75527794)
2018,Octubre,Países Bajos,269,242,,511,POINT (10446304 -75516486)
2018,Octubre,Países Bajos,15,34,,49,POINT (10886686 -74776479)
2018,Octubre,Países Bajos,0,1,,1,POINT (11247723 -74213989)
2018,Octubre,Países Bajos,0,2,,2,POINT (11360029 -72129595)
2018,Octubre,Países Bajos,1,0,,1,POINT (125862 -81702165)
2018,Octubre,Países Bajos,41,73,,114,POINT (3451668 -76532004)
2018,Octubre,Países Bajos,1574,2123,,3697,POINT (4697157 -74140516)
2018,Octubre,Países Bajos,11,7,,18,POINT (4815189 -75736374)
2018,Octubre,Países Bajos,167,220,,387,POINT (6170465 -7542726)
2018,Octubre,Países Bajos,8,11,,19,POINT (7128047 -73181317)
2018,Octubre,Países Bajos,1,1,,2,POINT (7819 -72453013)
2018,Octubre,Países Bajos,1,0,,1,POINT (836068 -72409396)
2018,Octubre,Países Bajos,6,15,,21,POINT (863337 -7735002)
2018,Octubre,Pakistán,0,1,,1,POINT (0.81488 -77356)
2018,Octubre,Pakistán,0,4,,4,POINT (10446304 -75516486)
2018,Octubre,Pakistán,4,12,,16,POINT (4697157 -74140516)
2018,Octubre,Pakistán,0,1,,1,POINT (6170465 -7542726)
2018,Octubre,Pakistán,0,1,,1,POINT (9402597 -75681642)
2018,Octubre,Panamá,2,1,,3,POINT (0.81488 -77356)
2018,Octubre,Panamá,2,15,,17,POINT (10406342 -75527794)
2018,Octubre,Panamá,752,777,,1529,POINT (10446304 -75516486)
2018,Octubre,Panamá,110,128,,238,POINT (10886686 -74776479)
2018,Octubre,Panamá,14,6,,20,POINT (11117206 -74232675)
2018,Octubre,Panamá,1,1,,2,POINT (11360029 -72129595)
2018,Octubre,Panamá,55,54,,109,POINT (125862 -81702165)
2018,Octubre,Panamá,247,281,,528,POINT (3451668 -76532004)
2018,Octubre,Panamá,8,18,,26,POINT (445285 -75766353)
2018,Octubre,Panamá,1784,1872,,3656,POINT (4697157 -74140516)
2018,Octubre,Panamá,28,31,,59,POINT (4815189 -75736374)
2018,Octubre,Panamá,1370,1198,,2568,POINT (6170465 -7542726)
2018,Octubre,Panamá,0,1,,1,POINT (6218835 -75586989)
2018,Octubre,Panamá,0,2,,2,POINT (7102626 -77762647)
2018,Octubre,Panamá,10,9,,19,POINT (7128047 -73181317)
2018,Octubre,Panamá,0,2,,2,POINT (7819 -72453013)
2018,Octubre,Panamá,0,2,,2,POINT (836068 -72409396)
2018,Octubre,Panamá,1,4,,5,POINT (863337 -7735002)
2018,Octubre,Paraguay,2,0,,2,POINT (0.81488 -77356)
2018,Octubre,Paraguay,2,1,,3,POINT (10406342 -75527794)
2018,Octubre,Paraguay,116,71,,187,POINT (10446304 -75516486)
2018,Octubre,Paraguay,9,28,,37,POINT (10886686 -74776479)
2018,Octubre,Paraguay,45,31,,76,POINT (125862 -81702165)
2018,Octubre,Paraguay,8,28,,36,POINT (3451668 -76532004)
2018,Octubre,Paraguay,224,177,,401,POINT (4697157 -74140516)
2018,Octubre,Paraguay,5,3,,8,POINT (4815189 -75736374)
2018,Octubre,Paraguay,26,25,,51,POINT (6170465 -7542726)
2018,Octubre,Paraguay,1,0,,1,POINT (7088729 -70740253)
2018,Octubre,Paraguay,0,1,,1,POINT (7819 -72453013)
2018,Octubre,Paraguay,1,0,,1,POINT (836068 -72409396)
2018,Octubre,Perú,41,14,,55,POINT (-4191162 -69941498)
2018,Octubre,Perú,11,35,,46,POINT (-4214082 -69941431)
2018,Octubre,Perú,1,2,,3,POINT (0.185957 -7478366)
2018,Octubre,Perú,4,8,,12,POINT (0.33002 -76876446)
2018,Octubre,Perú,84,268,,352,POINT (0.81488 -77356)
2018,Octubre,Perú,54,16,,70,POINT (10406342 -75527794)
2018,Octubre,Perú,1379,897,,2276,POINT (10446304 -75516486)
2018,Octubre,Perú,17,36,,53,POINT (10886686 -74776479)
2018,Octubre,Perú,4,11,,15,POINT (11360029 -72129595)
2018,Octubre,Perú,414,314,,728,POINT (125862 -81702165)
2018,Octubre,Perú,220,205,,425,POINT (3451668 -76532004)
2018,Octubre,Perú,0,2,,2,POINT (445285 -75766353)
2018,Octubre,Perú,4387,5249,,9636,POINT (4697157 -74140516)
2018,Octubre,Perú,1,4,,5,POINT (4815189 -75736374)
2018,Octubre,Perú,557,760,,1317,POINT (6170465 -7542726)
2018,Octubre,Perú,3,3,,6,POINT (7088729 -70740253)
2018,Octubre,Perú,2,2,,4,POINT (7128047 -73181317)
2018,Octubre,Perú,61,147,,208,POINT (7819 -72453013)
2018,Octubre,Perú,5,5,,10,POINT (836068 -72409396)
2018,Octubre,Palestina,2,3,,5,POINT (4697157 -74140516)
2018,Octubre,Polonia,6,5,,11,POINT (0.81488 -77356)
2018,Octubre,Polonia,0,7,,7,POINT (10406342 -75527794)
2018,Octubre,Polonia,16,18,,34,POINT (10446304 -75516486)
2018,Octubre,Polonia,0,5,,5,POINT (10886686 -74776479)
2018,Octubre,Polonia,0,1,,1,POINT (11247723 -74213989)
2018,Octubre,Polonia,5,8,,13,POINT (3451668 -76532004)
2018,Octubre,Polonia,0,1,,1,POINT (3884426 -77061029)
2018,Octubre,Polonia,169,226,,395,POINT (4697157 -74140516)
2018,Octubre,Polonia,1,0,,1,POINT (4815189 -75736374)
2018,Octubre,Polonia,7,22,,29,POINT (6170465 -7542726)
2018,Octubre,Polonia,1,2,,3,POINT (7819 -72453013)
2018,Octubre,Polonia,2,2,,4,POINT (863337 -7735002)
2018,Octubre,Portugal,1,8,,9,POINT (0.81488 -77356)
2018,Octubre,Portugal,4,2,,6,POINT (10406342 -75527794)
2018,Octubre,Portugal,14,21,,35,POINT (10446304 -75516486)
2018,Octubre,Portugal,0,2,,2,POINT (10886686 -74776479)
2018,Octubre,Portugal,1,2,,3,POINT (11360029 -72129595)
2018,Octubre,Portugal,0,1,,1,POINT (125862 -81702165)
2018,Octubre,Portugal,7,8,,15,POINT (3451668 -76532004)
2018,Octubre,Portugal,0,1,,1,POINT (445285 -75766353)
2018,Octubre,Portugal,201,513,,714,POINT (4697157 -74140516)
2018,Octubre,Portugal,22,42,,64,POINT (6170465 -7542726)
2018,Octubre,Portugal,1,0,,1,POINT (7088729 -70740253)
2018,Octubre,Portugal,1,1,,2,POINT (7128047 -73181317)
2018,Octubre,Portugal,13,17,,30,POINT (7819 -72453013)
2018,Octubre,Portugal,2,0,,2,POINT (836068 -72409396)
2018,Octubre,Reino Unido de Gran Bretaña e Irlanda del Norte,2,8,,10,POINT (-4191162 -69941498)
2018,Octubre,Reino Unido de Gran Bretaña e Irlanda del Norte,1,3,,4,POINT (-4214082 -69941431)
2018,Octubre,Reino Unido de Gran Bretaña e Irlanda del Norte,1,1,,2,POINT (0.33002 -76876446)
2018,Octubre,Reino Unido de Gran Bretaña e Irlanda del Norte,24,43,,67,POINT (0.81488 -77356)
2018,Octubre,Reino Unido de Gran Bretaña e Irlanda del Norte,21,35,,56,POINT (10406342 -75527794)
2018,Octubre,Reino Unido de Gran Bretaña e Irlanda del Norte,114,165,,279,POINT (10446304 -75516486)
2018,Octubre,Reino Unido de Gran Bretaña e Irlanda del Norte,7,15,,22,POINT (10886686 -74776479)
2018,Octubre,Reino Unido de Gran Bretaña e Irlanda del Norte,1,1,,2,POINT (11247723 -74213989)
2018,Octubre,Reino Unido de Gran Bretaña e Irlanda del Norte,0,1,,1,POINT (125862 -81702165)
2018,Octubre,Reino Unido de Gran Bretaña e Irlanda del Norte,19,50,,69,POINT (3451668 -76532004)
2018,Octubre,Reino Unido de Gran Bretaña e Irlanda del Norte,0,1,,1,POINT (445285 -75766353)
2018,Octubre,Reino Unido de Gran Bretaña e Irlanda del Norte,1056,2027,,3083,POINT (4697157 -74140516)
2018,Octubre,Reino Unido de Gran Bretaña e Irlanda del Norte,0,4,,4,POINT (4815189 -75736374)
2018,Octubre,Reino Unido de Gran Bretaña e Irlanda del Norte,73,254,,327,POINT (6170465 -7542726)
2018,Octubre,Reino Unido de Gran Bretaña e Irlanda del Norte,1,2,,3,POINT (7128047 -73181317)
2018,Octubre,Reino Unido de Gran Bretaña e Irlanda del Norte,0,3,,3,POINT (7819 -72453013)
2018,Octubre,Reino Unido de Gran Bretaña e Irlanda del Norte,20,15,,35,POINT (863337 -7735002)
2018,Octubre,República Dominicana,8,15,,23,POINT (0.81488 -77356)
2018,Octubre,República Dominicana,3,3,,6,POINT (10406342 -75527794)
2018,Octubre,República Dominicana,65,100,,165,POINT (10446304 -75516486)
2018,Octubre,República Dominicana,19,57,,76,POINT (10886686 -74776479)
2018,Octubre,República Dominicana,0,4,,4,POINT (11360029 -72129595)
2018,Octubre,República Dominicana,0,1,,1,POINT (125862 -81702165)
2018,Octubre,República Dominicana,35,71,,106,POINT (3451668 -76532004)
2018,Octubre,República Dominicana,851,1057,,1908,POINT (4697157 -74140516)
2018,Octubre,República Dominicana,0,3,,3,POINT (4815189 -75736374)
2018,Octubre,República Dominicana,56,82,,138,POINT (6170465 -7542726)
2018,Octubre,República Dominicana,0,1,,1,POINT (7128047 -73181317)
2018,Octubre,República Dominicana,0,8,,8,POINT (7819 -72453013)
2018,Octubre,República Dominicana,0,1,,1,POINT (836068 -72409396)
2018,Octubre,Rumania,0,1,,1,POINT (0.81488 -77356)
2018,Octubre,Rumania,0,1,,1,POINT (10406342 -75527794)
2018,Octubre,Rumania,4,7,,11,POINT (10446304 -75516486)
2018,Octubre,Rumania,1,1,,2,POINT (125862 -81702165)
2018,Octubre,Rumania,1,4,,5,POINT (3451668 -76532004)
2018,Octubre,Rumania,77,97,,174,POINT (4697157 -74140516)
2018,Octubre,Rumania,3,7,,10,POINT (6170465 -7542726)
2018,Octubre,Rumania,5,3,,8,POINT (863337 -7735002)
2018,Octubre,Federación de Rusia,8,5,,13,POINT (0.81488 -77356)
2018,Octubre,Federación de Rusia,1,0,,1,POINT (10406342 -75527794)
2018,Octubre,Federación de Rusia,21,10,,31,POINT (10446304 -75516486)
2018,Octubre,Federación de Rusia,1,4,,5,POINT (10886686 -74776479)
2018,Octubre,Federación de Rusia,0,1,,1,POINT (10970933 -74765343)
2018,Octubre,Federación de Rusia,0,3,,3,POINT (11247723 -74213989)
2018,Octubre,Federación de Rusia,5,6,,11,POINT (3451668 -76532004)
2018,Octubre,Federación de Rusia,176,196,,372,POINT (4697157 -74140516)
2018,Octubre,Federación de Rusia,0,1,,1,POINT (4815189 -75736374)
2018,Octubre,Federación de Rusia,18,14,,32,POINT (6170465 -7542726)
2018,Octubre,Federación de Rusia,0,3,,3,POINT (7819 -72453013)
2018,Octubre,Federación de Rusia,0,1,,1,POINT (863337 -7735002)
2018,Octubre,Federación de Rusia,0,1,,1,POINT (9402597 -75681642)
2018,Octubre,Rwanda,0,1,,1,POINT (4697157 -74140516)
2018,Octubre,San Cristóbal y Nevis,1,1,,2,POINT (4697157 -74140516)
2018,Octubre,San Cristóbal y Nevis,1,0,,1,POINT (6170465 -7542726)
2018,Octubre,San Marino,0,1,,1,POINT (10446304 -75516486)
2018,Octubre,San  Vicente y las Granadinas,1,1,,2,POINT (10446304 -75516486)
2018,Octubre,San  Vicente y las Granadinas,1,1,,2,POINT (4697157 -74140516)
2018,Octubre,Santa Lucia,1,0,,1,POINT (10446304 -75516486)
2018,Octubre,Santa Lucia,0,1,,1,POINT (10886686 -74776479)
2018,Octubre,Santa Lucia,0,3,,3,POINT (4697157 -74140516)
2018,Octubre,Santa Lucia,0,3,,3,POINT (6170465 -7542726)
2018,Octubre,Santo Tomé y Príncipe,0,1,,1,POINT (4697157 -74140516)
2018,Octubre,Senegal,0,1,,1,POINT (10446304 -75516486)
2018,Octubre,Serbia,0,2,,2,POINT (10406342 -75527794)
2018,Octubre,Serbia,1,2,,3,POINT (10446304 -75516486)
2018,Octubre,Serbia,8,27,,35,POINT (4697157 -74140516)
2018,Octubre,Serbia,0,3,,3,POINT (6170465 -7542726)
2018,Octubre,Sierra Leona,1,0,,1,POINT (4697157 -74140516)
2018,Octubre,Sierra Leona,0,2,,2,POINT (6170465 -7542726)
2018,Octubre,Singapur,1,0,,1,POINT (-4191162 -69941498)
2018,Octubre,Singapur,1,1,,2,POINT (0.81488 -77356)
2018,Octubre,Singapur,1,5,,6,POINT (10446304 -75516486)
2018,Octubre,Singapur,1,0,,1,POINT (3451668 -76532004)
2018,Octubre,Singapur,20,39,,59,POINT (4697157 -74140516)
2018,Octubre,Singapur,3,0,,3,POINT (6170465 -7542726)
2018,Octubre,República Árabe Siria,0,2,,2,POINT (10446304 -75516486)
2018,Octubre,República Árabe Siria,0,4,,4,POINT (4697157 -74140516)
2018,Octubre,Sri Lanka,0,1,,1,POINT (10886686 -74776479)
2018,Octubre,Sri Lanka,1,6,,7,POINT (4697157 -74140516)
2018,Octubre,Sri Lanka,0,1,,1,POINT (6170465 -7542726)
2018,Octubre,Sudáfrica,1,5,,6,POINT (10406342 -75527794)
2018,Octubre,Sudáfrica,2,5,,7,POINT (10446304 -75516486)
2018,Octubre,Sudáfrica,2,5,,7,POINT (10886686 -74776479)
2018,Octubre,Sudáfrica,0,1,,1,POINT (11247723 -74213989)
2018,Octubre,Sudáfrica,0,1,,1,POINT (125744111 -81703935)
2018,Octubre,Sudáfrica,0,1,,1,POINT (3451668 -76532004)
2018,Octubre,Sudáfrica,23,76,,99,POINT (4697157 -74140516)
2018,Octubre,Sudáfrica,2,5,,7,POINT (6170465 -7542726)
2018,Octubre,Sudán,1,0,,1,POINT (4697157 -74140516)
2018,Octubre,Suecia,7,8,,15,POINT (0.81488 -77356)
2018,Octubre,Suecia,0,2,,2,POINT (10406342 -75527794)
2018,Octubre,Suecia,14,30,,44,POINT (10446304 -75516486)
2018,Octubre,Suecia,4,2,,6,POINT (10886686 -74776479)
2018,Octubre,Suecia,0,1,,1,POINT (11360029 -72129595)
2018,Octubre,Suecia,1,0,,1,POINT (125862 -81702165)
2018,Octubre,Suecia,4,24,,28,POINT (3451668 -76532004)
2018,Octubre,Suecia,155,324,,479,POINT (4697157 -74140516)
2018,Octubre,Suecia,1,2,,3,POINT (4815189 -75736374)
2018,Octubre,Suecia,21,38,,59,POINT (6170465 -7542726)
2018,Octubre,Suecia,0,1,,1,POINT (7819 -72453013)
2018,Octubre,Suiza,3,3,,6,POINT (-4191162 -69941498)
2018,Octubre,Suiza,0,2,,2,POINT (-4214082 -69941431)
2018,Octubre,Suiza,17,11,,28,POINT (0.81488 -77356)
2018,Octubre,Suiza,9,17,,26,POINT (10406342 -75527794)
2018,Octubre,Suiza,46,43,,89,POINT (10446304 -75516486)
2018,Octubre,Suiza,6,7,,13,POINT (10886686 -74776479)
2018,Octubre,Suiza,2,1,,3,POINT (11247723 -74213989)
2018,Octubre,Suiza,0,3,,3,POINT (125862 -81702165)
2018,Octubre,Suiza,16,31,,47,POINT (3451668 -76532004)
2018,Octubre,Suiza,0,2,,2,POINT (445285 -75766353)
2018,Octubre,Suiza,405,640,,1045,POINT (4697157 -74140516)
2018,Octubre,Suiza,3,4,,7,POINT (4815189 -75736374)
2018,Octubre,Suiza,35,90,,125,POINT (6170465 -7542726)
2018,Octubre,Suiza,2,0,,2,POINT (7819 -72453013)
2018,Octubre,Suiza,1,0,,1,POINT (836068 -72409396)
2018,Octubre,Suiza,1,4,,5,POINT (863337 -7735002)
2018,Octubre,Surinam,1,0,,1,POINT (10886686 -74776479)
2018,Octubre,Surinam,24,51,,75,POINT (4697157 -74140516)
2018,Octubre,Surinam,1,3,,4,POINT (6170465 -7542726)
2018,Octubre,Surinam,1,2,,3,POINT (7128047 -73181317)
2018,Octubre,Suazilandia,1,1,,2,POINT (4697157 -74140516)
2018,Octubre,Tailandia,1,0,,1,POINT (10446304 -75516486)
2018,Octubre,Tailandia,0,1,,1,POINT (10886686 -74776479)
2018,Octubre,Tailandia,15,9,,24,POINT (4697157 -74140516)
2018,Octubre,Tailandia,1,0,,1,POINT (6170465 -7542726)
2018,Octubre,Tanzania,0,1,,1,POINT (10446304 -75516486)
2018,Octubre,Tanzania,3,1,,4,POINT (4697157 -74140516)
2018,Octubre,Togo,0,1,,1,POINT (4697157 -74140516)
2018,Octubre,Tonga,1,0,,1,POINT (4697157 -74140516)
2018,Octubre,Trinidad y Tobago,0,2,,2,POINT (10406342 -75527794)
2018,Octubre,Trinidad y Tobago,10,19,,29,POINT (10446304 -75516486)
2018,Octubre,Trinidad y Tobago,5,2,,7,POINT (10886686 -74776479)
2018,Octubre,Trinidad y Tobago,5,7,,12,POINT (3451668 -76532004)
2018,Octubre,Trinidad y Tobago,20,51,,71,POINT (4697157 -74140516)
2018,Octubre,Trinidad y Tobago,0,2,,2,POINT (4815189 -75736374)
2018,Octubre,Trinidad y Tobago,1,5,,6,POINT (6170465 -7542726)
2018,Octubre,Trinidad y Tobago,1,0,,1,POINT (7819 -72453013)
2018,Octubre,Túnez,4,9,,13,POINT (4697157 -74140516)
2018,Octubre,Turquía,0,1,,1,POINT (-4191162 -69941498)
2018,Octubre,Turquía,1,2,,3,POINT (0.81488 -77356)
2018,Octubre,Turquía,0,6,,6,POINT (10406342 -75527794)
2018,Octubre,Turquía,8,13,,21,POINT (10446304 -75516486)
2018,Octubre,Turquía,0,4,,4,POINT (10886686 -74776479)
2018,Octubre,Turquía,1,7,,8,POINT (3451668 -76532004)
2018,Octubre,Turquía,148,346,,494,POINT (4697157 -74140516)
2018,Octubre,Turquía,4,14,,18,POINT (6170465 -7542726)
2018,Octubre,Tuvalu,0,4,,4,POINT (4697157 -74140516)
2018,Octubre,Turkmenistán,0,1,,1,POINT (4697157 -74140516)
2018,Octubre,Ucrania,2,0,,2,POINT (0.81488 -77356)
2018,Octubre,Ucrania,0,4,,4,POINT (10406342 -75527794)
2018,Octubre,Ucrania,0,5,,5,POINT (10446304 -75516486)
2018,Octubre,Ucrania,0,9,,9,POINT (10886686 -74776479)
2018,Octubre,Ucrania,0,5,,5,POINT (10970933 -74765343)
2018,Octubre,Ucrania,0,10,,10,POINT (11247723 -74213989)
2018,Octubre,Ucrania,1,1,,2,POINT (3451668 -76532004)
2018,Octubre,Ucrania,1,1,,2,POINT (445285 -75766353)
2018,Octubre,Ucrania,29,29,,58,POINT (4697157 -74140516)
2018,Octubre,Ucrania,1,3,,4,POINT (6170465 -7542726)
2018,Octubre,Ucrania,0,2,,2,POINT (9402597 -75681642)
2018,Octubre,Uganda,0,2,,2,POINT (3451668 -76532004)
2018,Octubre,Uganda,2,4,,6,POINT (4697157 -74140516)
2018,Octubre,Uganda,1,1,,2,POINT (6170465 -7542726)
2018,Octubre,Uruguay,3,11,,14,POINT (0.81488 -77356)
2018,Octubre,Uruguay,14,10,,24,POINT (10406342 -75527794)
2018,Octubre,Uruguay,122,95,,217,POINT (10446304 -75516486)
2018,Octubre,Uruguay,6,10,,16,POINT (10886686 -74776479)
2018,Octubre,Uruguay,0,1,,1,POINT (11360029 -72129595)
2018,Octubre,Uruguay,19,12,,31,POINT (125862 -81702165)
2018,Octubre,Uruguay,19,38,,57,POINT (3451668 -76532004)
2018,Octubre,Uruguay,477,593,,1070,POINT (4697157 -74140516)
2018,Octubre,Uruguay,1,0,,1,POINT (4815189 -75736374)
2018,Octubre,Uruguay,26,64,,90,POINT (6170465 -7542726)
2018,Octubre,Uruguay,0,1,,1,POINT (7128047 -73181317)
2018,Octubre,Uruguay,0,8,,8,POINT (7819 -72453013)
2018,Octubre,Uruguay,1,1,,2,POINT (836068 -72409396)
2018,Octubre,Uzbekistán,0,2,,2,POINT (4697157 -74140516)
2018,Octubre,Venezuela,4,10,,14,POINT (-4191162 -69941498)
2018,Octubre,Venezuela,0,1,,1,POINT (-4214082 -69941431)
2018,Octubre,Venezuela,0,1,,1,POINT (0.185957 -7478366)
2018,Octubre,Venezuela,92,94,,186,POINT (0.33002 -76876446)
2018,Octubre,Venezuela,4276,4900,,9176,POINT (0.81488 -77356)
2018,Octubre,Venezuela,5,2,,7,POINT (1800143 -78802679)
2018,Octubre,Venezuela,5,7,,12,POINT (10406342 -75527794)
2018,Octubre,Venezuela,173,175,,348,POINT (10446304 -75516486)
2018,Octubre,Venezuela,135,232,,367,POINT (10886686 -74776479)
2018,Octubre,Venezuela,4,11,,15,POINT (11117206 -74232675)
2018,Octubre,Venezuela,0,5,,5,POINT (11247723 -74213989)
2018,Octubre,Venezuela,7230,6377,,13607,POINT (11360029 -72129595)
2018,Octubre,Venezuela,1,6,,7,POINT (125862 -81702165)
2018,Octubre,Venezuela,94,133,,227,POINT (3451668 -76532004)
2018,Octubre,Venezuela,17,22,,39,POINT (3866713 -67927521)
2018,Octubre,Venezuela,1,2,,3,POINT (445285 -75766353)
2018,Octubre,Venezuela,6722,6937,,13659,POINT (4697157 -74140516)
2018,Octubre,Venezuela,8,14,,22,POINT (4815189 -75736374)
2018,Octubre,Venezuela,740,823,,1563,POINT (6170465 -7542726)
2018,Octubre,Venezuela,55,48,,103,POINT (6185536 -67484028)
2018,Octubre,Venezuela,1280,1311,,2591,POINT (7088729 -70740253)
2018,Octubre,Venezuela,16,13,,29,POINT (7128047 -73181317)
2018,Octubre,Venezuela,33390,28140,,61530,POINT (7819 -72453013)
2018,Octubre,Venezuela,4,11,,15,POINT (7927233 -72508188)
2018,Octubre,Venezuela,2794,2333,,5127,POINT (836068 -72409396)
2018,Octubre,Vietnam,1,0,,1,POINT (10446304 -75516486)
2018,Octubre,Vietnam,2,5,,7,POINT (4697157 -74140516)
2018,Octubre,República Árabe de Yemen,0,2,,2,POINT (4697157 -74140516)
2018,Octubre,Zambia,1,2,,3,POINT (4697157 -74140516)
2018,Octubre,Zimbabue,0,1,,1,POINT (10446304 -75516486)
2018,Octubre,Zimbabue,0,3,,3,POINT (3451668 -76532004)
2018,Octubre,Zimbabue,2,2,,4,POINT (4697157 -74140516)
2018,Octubre,Zimbabue,0,2,,2,POINT (6170465 -7542726)
2018,Octubre,Refugiado Otro,0,1,,1,POINT (4697157 -74140516)
2018,Octubre,Refugiado,0,1,,1,POINT (10446304 -75516486)
2018,Octubre,Refugiado,2,4,,6,POINT (4697157 -74140516)
2018,Octubre,Refugiado,0,1,,1,POINT (6170465 -7542726)
2018,Octubre,Desconocido,0,1,,1,POINT (0.81488 -77356)
2018,Octubre,Desconocido,10,23,,33,POINT (10446304 -75516486)
2018,Octubre,Desconocido,0,2,,2,POINT (10886686 -74776479)
2018,Octubre,Desconocido,1,0,,1,POINT (11360029 -72129595)
2018,Octubre,Desconocido,2,1,,3,POINT (3451668 -76532004)
2018,Octubre,Desconocido,84,168,,252,POINT (4697157 -74140516)
2018,Octubre,Desconocido,1,6,,7,POINT (6170465 -7542726)
2018,Octubre,Desconocido,1,0,,1,POINT (7088729 -70740253)
2018,Octubre,Desconocido,3,4,,7,POINT (7819 -72453013)
2018,Octubre,República CentroÁfricana,1,0,,1,POINT (4697157 -74140516)
2018,Noviembre,Afganistán,0,1,,1,POINT (4697157 -74140516)
2018,Noviembre,Albania,0,1,,1,POINT (-4191162 -69941498)
2018,Noviembre,Albania,3,1,,4,POINT (10446304 -75516486)
2018,Noviembre,Albania,5,17,,22,POINT (4697157 -74140516)
2018,Noviembre,Albania,0,2,,2,POINT (6170465 -7542726)
2018,Noviembre,Albania,0,1,,1,POINT (7819 -72453013)
2018,Noviembre,Alemania,18,17,,35,POINT (-4191162 -69941498)
2018,Noviembre,Alemania,7,14,,21,POINT (-4214082 -69941431)
2018,Noviembre,Alemania,1,3,,4,POINT (0.33002 -76876446)
2018,Noviembre,Alemania,59,60,,119,POINT (0.81488 -77356)
2018,Noviembre,Alemania,44,40,,84,POINT (10406342 -75527794)
2018,Noviembre,Alemania,130,243,,373,POINT (10446304 -75516486)
2018,Noviembre,Alemania,13,29,,42,POINT (10886686 -74776479)
2018,Noviembre,Alemania,0,1,,1,POINT (10970933 -74765343)
2018,Noviembre,Alemania,4,5,,9,POINT (11247723 -74213989)
2018,Noviembre,Alemania,0,1,,1,POINT (11360029 -72129595)
2018,Noviembre,Alemania,1,0,,1,POINT (125744111 -81703935)
2018,Noviembre,Alemania,3,5,,8,POINT (125862 -81702165)
2018,Noviembre,Alemania,1,0,,1,POINT (133387613 -81372937)
2018,Noviembre,Alemania,44,75,,119,POINT (3451668 -76532004)
2018,Noviembre,Alemania,0,1,,1,POINT (445285 -75766353)
2018,Noviembre,Alemania,2174,3259,,5433,POINT (4697157 -74140516)
2018,Noviembre,Alemania,5,8,,13,POINT (4815189 -75736374)
2018,Noviembre,Alemania,113,207,,320,POINT (6170465 -7542726)
2018,Noviembre,Alemania,0,4,,4,POINT (7128047 -73181317)
2018,Noviembre,Alemania,1,6,,7,POINT (7819 -72453013)
2018,Noviembre,Alemania,0,2,,2,POINT (836068 -72409396)
2018,Noviembre,Alemania,13,12,,25,POINT (863337 -7735002)
2018,Noviembre,Andorra,4,14,,18,POINT (4697157 -74140516)
2018,Noviembre,Angola,0,1,,1,POINT (10406342 -75527794)
2018,Noviembre,Angola,1,0,,1,POINT (4697157 -74140516)
2018,Noviembre,Angola,0,1,,1,POINT (6170465 -7542726)
2018,Noviembre,Antigua y Barbuda,0,2,,2,POINT (4697157 -74140516)
2018,Noviembre,Países Bajos,0,1,,1,POINT (10886686 -74776479)
2018,Noviembre,Países Bajos,0,1,,1,POINT (4697157 -74140516)
2018,Noviembre,Arabia Saudita,0,4,,4,POINT (10446304 -75516486)
2018,Noviembre,Arabia Saudita,0,1,,1,POINT (3451668 -76532004)
2018,Noviembre,Arabia Saudita,1,14,,15,POINT (4697157 -74140516)
2018,Noviembre,Argelia,1,2,,3,POINT (4697157 -74140516)
2018,Noviembre,Argentina,5,3,,8,POINT (-4191162 -69941498)
2018,Noviembre,Argentina,1,2,,3,POINT (-4214082 -69941431)
2018,Noviembre,Argentina,5,8,,13,POINT (0.33002 -76876446)
2018,Noviembre,Argentina,47,88,,135,POINT (0.81488 -77356)
2018,Noviembre,Argentina,1,0,,1,POINT (1800143 -78802679)
2018,Noviembre,Argentina,176,126,,302,POINT (10406342 -75527794)
2018,Noviembre,Argentina,1772,1179,,2951,POINT (10446304 -75516486)
2018,Noviembre,Argentina,22,45,,67,POINT (10886686 -74776479)
2018,Noviembre,Argentina,0,2,,2,POINT (11117206 -74232675)
2018,Noviembre,Argentina,3,10,,13,POINT (11360029 -72129595)
2018,Noviembre,Argentina,344,263,,607,POINT (125862 -81702165)
2018,Noviembre,Argentina,100,108,,208,POINT (3451668 -76532004)
2018,Noviembre,Argentina,3300,4441,,7741,POINT (4697157 -74140516)
2018,Noviembre,Argentina,3,10,,13,POINT (4815189 -75736374)
2018,Noviembre,Argentina,193,346,,539,POINT (6170465 -7542726)
2018,Noviembre,Argentina,0,1,,1,POINT (7088729 -70740253)
2018,Noviembre,Argentina,1,2,,3,POINT (7128047 -73181317)
2018,Noviembre,Argentina,5,13,,18,POINT (7819 -72453013)
2018,Noviembre,Argentina,1,0,,1,POINT (806667 -767333)
2018,Noviembre,Argentina,1,2,,3,POINT (836068 -72409396)
2018,Noviembre,Argentina,1,6,,7,POINT (863337 -7735002)
2018,Noviembre,República de Armenia,0,1,,1,POINT (10446304 -75516486)
2018,Noviembre,República de Armenia,1,0,,1,POINT (10886686 -74776479)
2018,Noviembre,República de Armenia,2,1,,3,POINT (4697157 -74140516)
2018,Noviembre,República de Armenia,0,2,,2,POINT (6170465 -7542726)
2018,Noviembre,Aruba,0,1,,1,POINT (4697157 -74140516)
2018,Noviembre,Australia,0,2,,2,POINT (-4191162 -69941498)
2018,Noviembre,Australia,0,1,,1,POINT (0.33002 -76876446)
2018,Noviembre,Australia,16,21,,37,POINT (0.81488 -77356)
2018,Noviembre,Australia,11,9,,20,POINT (10406342 -75527794)
2018,Noviembre,Australia,72,78,,150,POINT (10446304 -75516486)
2018,Noviembre,Australia,6,21,,27,POINT (10886686 -74776479)
2018,Noviembre,Australia,0,3,,3,POINT (11247723 -74213989)
2018,Noviembre,Australia,3,2,,5,POINT (125862 -81702165)
2018,Noviembre,Australia,9,20,,29,POINT (3451668 -76532004)
2018,Noviembre,Australia,363,711,,1074,POINT (4697157 -74140516)
2018,Noviembre,Australia,1,2,,3,POINT (4815189 -75736374)
2018,Noviembre,Australia,51,98,,149,POINT (6170465 -7542726)
2018,Noviembre,Australia,1,4,,5,POINT (7128047 -73181317)
2018,Noviembre,Australia,7,6,,13,POINT (863337 -7735002)
2018,Noviembre,Austria,0,3,,3,POINT (-4191162 -69941498)
2018,Noviembre,Austria,1,0,,1,POINT (0.33002 -76876446)
2018,Noviembre,Austria,9,11,,20,POINT (0.81488 -77356)
2018,Noviembre,Austria,0,2,,2,POINT (10406342 -75527794)
2018,Noviembre,Austria,21,23,,44,POINT (10446304 -75516486)
2018,Noviembre,Austria,1,5,,6,POINT (10886686 -74776479)
2018,Noviembre,Austria,1,3,,4,POINT (11247723 -74213989)
2018,Noviembre,Austria,4,7,,11,POINT (3451668 -76532004)
2018,Noviembre,Austria,0,1,,1,POINT (445285 -75766353)
2018,Noviembre,Austria,186,382,,568,POINT (4697157 -74140516)
2018,Noviembre,Austria,18,24,,42,POINT (6170465 -7542726)
2018,Noviembre,Austria,2,0,,2,POINT (7819 -72453013)
2018,Noviembre,Azerbaiyán,0,2,,2,POINT (10446304 -75516486)
2018,Noviembre,Azerbaiyán,1,6,,7,POINT (4697157 -74140516)
2018,Noviembre,Azerbaiyán,0,1,,1,POINT (6170465 -7542726)
2018,Noviembre,Bahamas,2,6,,8,POINT (10446304 -75516486)
2018,Noviembre,Bahamas,0,3,,3,POINT (10886686 -74776479)
2018,Noviembre,Bahamas,0,1,,1,POINT (3451668 -76532004)
2018,Noviembre,Bahamas,11,8,,19,POINT (4697157 -74140516)
2018,Noviembre,Bahamas,3,2,,5,POINT (6170465 -7542726)
2018,Noviembre,Bahréin,0,2,,2,POINT (6170465 -7542726)
2018,Noviembre,Bangladesh,0,1,,1,POINT (10446304 -75516486)
2018,Noviembre,Bangladesh,1,2,,3,POINT (4697157 -74140516)
2018,Noviembre,Bangladesh,0,1,,1,POINT (9402597 -75681642)
2018,Noviembre,Barbados,1,1,,2,POINT (10446304 -75516486)
2018,Noviembre,Barbados,2,2,,4,POINT (125862 -81702165)
2018,Noviembre,Barbados,1,0,,1,POINT (3451668 -76532004)
2018,Noviembre,Barbados,13,5,,18,POINT (4697157 -74140516)
2018,Noviembre,Barbados,1,2,,3,POINT (6170465 -7542726)
2018,Noviembre,Barbados,0,2,,2,POINT (7128047 -73181317)
2018,Noviembre,República de Belarús,8,7,,15,POINT (4697157 -74140516)
2018,Noviembre,República de Belarús,0,1,,1,POINT (6170465 -7542726)
2018,Noviembre,Bélgica,3,6,,9,POINT (-4191162 -69941498)
2018,Noviembre,Bélgica,1,2,,3,POINT (-4214082 -69941431)
2018,Noviembre,Bélgica,6,13,,19,POINT (0.81488 -77356)
2018,Noviembre,Bélgica,3,6,,9,POINT (10406342 -75527794)
2018,Noviembre,Bélgica,26,59,,85,POINT (10446304 -75516486)
2018,Noviembre,Bélgica,2,7,,9,POINT (10886686 -74776479)
2018,Noviembre,Bélgica,0,1,,1,POINT (11247723 -74213989)
2018,Noviembre,Bélgica,0,1,,1,POINT (11360029 -72129595)
2018,Noviembre,Bélgica,0,1,,1,POINT (125862 -81702165)
2018,Noviembre,Bélgica,11,21,,32,POINT (3451668 -76532004)
2018,Noviembre,Bélgica,0,4,,4,POINT (3884426 -77061029)
2018,Noviembre,Bélgica,367,588,,955,POINT (4697157 -74140516)
2018,Noviembre,Bélgica,0,2,,2,POINT (4815189 -75736374)
2018,Noviembre,Bélgica,37,64,,101,POINT (6170465 -7542726)
2018,Noviembre,Bélgica,1,2,,3,POINT (6185536 -67484028)
2018,Noviembre,Bélgica,0,3,,3,POINT (7128047 -73181317)
2018,Noviembre,Bélgica,4,2,,6,POINT (863337 -7735002)
2018,Noviembre,Belice,1,1,,2,POINT (10446304 -75516486)
2018,Noviembre,Belice,0,1,,1,POINT (10886686 -74776479)
2018,Noviembre,Belice,2,0,,2,POINT (125862 -81702165)
2018,Noviembre,Belice,4,9,,13,POINT (3451668 -76532004)
2018,Noviembre,Belice,11,15,,26,POINT (4697157 -74140516)
2018,Noviembre,Belice,0,6,,6,POINT (6170465 -7542726)
2018,Noviembre,Belice,0,1,,1,POINT (863337 -7735002)
2018,Noviembre,Bermudas/Territorio Británico de Ultramar,2,1,,3,POINT (10446304 -75516486)
2018,Noviembre,Bermudas/Territorio Británico de Ultramar,0,1,,1,POINT (3451668 -76532004)
2018,Noviembre,Bermudas/Territorio Británico de Ultramar,1,1,,2,POINT (4697157 -74140516)
2018,Noviembre,Bermudas/Territorio Británico de Ultramar,0,7,,7,POINT (6170465 -7542726)
2018,Noviembre,Bolivia,0,2,,2,POINT (0.33002 -76876446)
2018,Noviembre,Bolivia,6,10,,16,POINT (0.81488 -77356)
2018,Noviembre,Bolivia,10,11,,21,POINT (10406342 -75527794)
2018,Noviembre,Bolivia,149,116,,265,POINT (10446304 -75516486)
2018,Noviembre,Bolivia,0,2,,2,POINT (10886686 -74776479)
2018,Noviembre,Bolivia,1,0,,1,POINT (11360029 -72129595)
2018,Noviembre,Bolivia,31,20,,51,POINT (125862 -81702165)
2018,Noviembre,Bolivia,5,16,,21,POINT (3451668 -76532004)
2018,Noviembre,Bolivia,665,731,,1396,POINT (4697157 -74140516)
2018,Noviembre,Bolivia,2,0,,2,POINT (4815189 -75736374)
2018,Noviembre,Bolivia,65,63,,128,POINT (6170465 -7542726)
2018,Noviembre,Bolivia,0,1,,1,POINT (7088729 -70740253)
2018,Noviembre,Bolivia,1,2,,3,POINT (7128047 -73181317)
2018,Noviembre,Bolivia,1,8,,9,POINT (7819 -72453013)
2018,Noviembre,Bosnia y Herzegovina,1,8,,9,POINT (4697157 -74140516)
2018,Noviembre,Bosnia y Herzegovina,1,1,,2,POINT (6170465 -7542726)
2018,Noviembre,Brasil,101,95,,196,POINT (-4191162 -69941498)
2018,Noviembre,Brasil,1,4,,5,POINT (-4214082 -69941431)
2018,Noviembre,Brasil,0,1,,1,POINT (0.33002 -76876446)
2018,Noviembre,Brasil,21,31,,52,POINT (0.81488 -77356)
2018,Noviembre,Brasil,201,550,,751,POINT (10406342 -75527794)
2018,Noviembre,Brasil,895,669,,1564,POINT (10446304 -75516486)
2018,Noviembre,Brasil,7,34,,41,POINT (10886686 -74776479)
2018,Noviembre,Brasil,0,3,,3,POINT (11360029 -72129595)
2018,Noviembre,Brasil,233,193,,426,POINT (125862 -81702165)
2018,Noviembre,Brasil,90,130,,220,POINT (3451668 -76532004)
2018,Noviembre,Brasil,0,3,,3,POINT (3866713 -67927521)
2018,Noviembre,Brasil,0,3,,3,POINT (416909 -73612469)
2018,Noviembre,Brasil,5522,6823,,12345,POINT (4697157 -74140516)
2018,Noviembre,Brasil,1,10,,11,POINT (4815189 -75736374)
2018,Noviembre,Brasil,122,238,,360,POINT (6170465 -7542726)
2018,Noviembre,Brasil,4,3,,7,POINT (7128047 -73181317)
2018,Noviembre,Brasil,4,6,,10,POINT (7819 -72453013)
2018,Noviembre,Brasil,1,3,,4,POINT (836068 -72409396)
2018,Noviembre,Brasil,1,0,,1,POINT (863337 -7735002)
2018,Noviembre,Bulgaria,0,1,,1,POINT (0.81488 -77356)
2018,Noviembre,Bulgaria,0,4,,4,POINT (10406342 -75527794)
2018,Noviembre,Bulgaria,7,7,,14,POINT (10446304 -75516486)
2018,Noviembre,Bulgaria,1,1,,2,POINT (10886686 -74776479)
2018,Noviembre,Bulgaria,26,49,,75,POINT (4697157 -74140516)
2018,Noviembre,Bulgaria,1,5,,6,POINT (6170465 -7542726)
2018,Noviembre,Bulgaria,0,1,,1,POINT (806667 -767333)
2018,Noviembre,Burkina Faso,1,0,,1,POINT (3451668 -76532004)
2018,Noviembre,Burundi,0,1,,1,POINT (4697157 -74140516)
2018,Noviembre,Burundi,0,1,,1,POINT (6170465 -7542726)
2018,Noviembre,Bután,1,0,,1,POINT (0.81488 -77356)
2018,Noviembre,Bután,0,2,,2,POINT (4697157 -74140516)
2018,Noviembre,Cabo Verde,1,0,,1,POINT (4697157 -74140516)
2018,Noviembre,Islas Caimán/Territorio Británico de Ultramar,1,1,,2,POINT (10446304 -75516486)
2018,Noviembre,Camboya,0,1,,1,POINT (4697157 -74140516)
2018,Noviembre,Camerún,1,1,,2,POINT (10446304 -75516486)
2018,Noviembre,Camerún,2,6,,8,POINT (4697157 -74140516)
2018,Noviembre,Camerún,1,0,,1,POINT (6170465 -7542726)
2018,Noviembre,Canadá,2,0,,2,POINT (-4191162 -69941498)
2018,Noviembre,Canadá,1,2,,3,POINT (-4214082 -69941431)
2018,Noviembre,Canadá,0,1,,1,POINT (0.33002 -76876446)
2018,Noviembre,Canadá,4,9,,13,POINT (0.81488 -77356)
2018,Noviembre,Canadá,10,16,,26,POINT (10406342 -75527794)
2018,Noviembre,Canadá,239,330,,569,POINT (10446304 -75516486)
2018,Noviembre,Canadá,21,51,,72,POINT (10886686 -74776479)
2018,Noviembre,Canadá,4,12,,16,POINT (11117206 -74232675)
2018,Noviembre,Canadá,0,10,,10,POINT (11247723 -74213989)
2018,Noviembre,Canadá,2,1,,3,POINT (11360029 -72129595)
2018,Noviembre,Canadá,1,1,,2,POINT (125744111 -81703935)
2018,Noviembre,Canadá,6,5,,11,POINT (125862 -81702165)
2018,Noviembre,Canadá,75,73,,148,POINT (3451668 -76532004)
2018,Noviembre,Canadá,2,3,,5,POINT (445285 -75766353)
2018,Noviembre,Canadá,1287,2097,,3384,POINT (4697157 -74140516)
2018,Noviembre,Canadá,12,12,,24,POINT (4815189 -75736374)
2018,Noviembre,Canadá,193,511,,704,POINT (6170465 -7542726)
2018,Noviembre,Canadá,4,8,,12,POINT (7128047 -73181317)
2018,Noviembre,Canadá,2,4,,6,POINT (7819 -72453013)
2018,Noviembre,Canadá,5,10,,15,POINT (863337 -7735002)
2018,Noviembre,República Del Congo,0,1,,1,POINT (4697157 -74140516)
2018,Noviembre,República Democrática del Congo,0,4,,4,POINT (4697157 -74140516)
2018,Noviembre,República de Corea,0,1,,1,POINT (-4191162 -69941498)
2018,Noviembre,República de Corea,5,8,,13,POINT (0.81488 -77356)
2018,Noviembre,República de Corea,10,17,,27,POINT (10446304 -75516486)
2018,Noviembre,República de Corea,0,3,,3,POINT (10886686 -74776479)
2018,Noviembre,República de Corea,2,0,,2,POINT (125862 -81702165)
2018,Noviembre,República de Corea,1,6,,7,POINT (3451668 -76532004)
2018,Noviembre,República de Corea,272,503,,775,POINT (4697157 -74140516)
2018,Noviembre,República de Corea,0,3,,3,POINT (4815189 -75736374)
2018,Noviembre,República de Corea,11,23,,34,POINT (6170465 -7542726)
2018,Noviembre,República de Corea,0,1,,1,POINT (7819 -72453013)
2018,Noviembre,Costa de Marfil,0,1,,1,POINT (0.81488 -77356)
2018,Noviembre,Costa de Marfil,0,1,,1,POINT (6170465 -7542726)
2018,Noviembre,Costa Rica,0,3,,3,POINT (-4191162 -69941498)
2018,Noviembre,Costa Rica,6,4,,10,POINT (0.81488 -77356)
2018,Noviembre,Costa Rica,1,13,,14,POINT (10406342 -75527794)
2018,Noviembre,Costa Rica,239,238,,477,POINT (10446304 -75516486)
2018,Noviembre,Costa Rica,33,27,,60,POINT (10886686 -74776479)
2018,Noviembre,Costa Rica,10,10,,20,POINT (125862 -81702165)
2018,Noviembre,Costa Rica,54,63,,117,POINT (3451668 -76532004)
2018,Noviembre,Costa Rica,0,1,,1,POINT (445285 -75766353)
2018,Noviembre,Costa Rica,1376,1883,,3259,POINT (4697157 -74140516)
2018,Noviembre,Costa Rica,6,13,,19,POINT (4815189 -75736374)
2018,Noviembre,Costa Rica,158,218,,376,POINT (6170465 -7542726)
2018,Noviembre,Costa Rica,3,2,,5,POINT (7128047 -73181317)
2018,Noviembre,Costa Rica,2,4,,6,POINT (7819 -72453013)
2018,Noviembre,Costa Rica,0,1,,1,POINT (806667 -767333)
2018,Noviembre,Costa Rica,0,2,,2,POINT (863337 -7735002)
2018,Noviembre,Croacia,0,1,,1,POINT (-4191162 -69941498)
2018,Noviembre,Croacia,0,2,,2,POINT (-4214082 -69941431)
2018,Noviembre,Croacia,0,2,,2,POINT (10406342 -75527794)
2018,Noviembre,Croacia,2,9,,11,POINT (10446304 -75516486)
2018,Noviembre,Croacia,1,0,,1,POINT (10886686 -74776479)
2018,Noviembre,Croacia,0,1,,1,POINT (11247723 -74213989)
2018,Noviembre,Croacia,0,4,,4,POINT (3451668 -76532004)
2018,Noviembre,Croacia,0,2,,2,POINT (3884426 -77061029)
2018,Noviembre,Croacia,26,56,,82,POINT (4697157 -74140516)
2018,Noviembre,Croacia,0,8,,8,POINT (6170465 -7542726)
2018,Noviembre,Cuba,0,1,,1,POINT (-4191162 -69941498)
2018,Noviembre,Cuba,0,3,,3,POINT (0.81488 -77356)
2018,Noviembre,Cuba,0,2,,2,POINT (10406342 -75527794)
2018,Noviembre,Cuba,10,19,,29,POINT (10446304 -75516486)
2018,Noviembre,Cuba,14,20,,34,POINT (10886686 -74776479)
2018,Noviembre,Cuba,3,4,,7,POINT (125862 -81702165)
2018,Noviembre,Cuba,20,30,,50,POINT (3451668 -76532004)
2018,Noviembre,Cuba,214,328,,542,POINT (4697157 -74140516)
2018,Noviembre,Cuba,1,4,,5,POINT (4815189 -75736374)
2018,Noviembre,Cuba,33,35,,68,POINT (6170465 -7542726)
2018,Noviembre,Cuba,0,3,,3,POINT (7819 -72453013)
2018,Noviembre,República Checa,1,0,,1,POINT (0.33002 -76876446)
2018,Noviembre,República Checa,5,6,,11,POINT (0.81488 -77356)
2018,Noviembre,República Checa,0,4,,4,POINT (10406342 -75527794)
2018,Noviembre,República Checa,7,8,,15,POINT (10446304 -75516486)
2018,Noviembre,República Checa,0,1,,1,POINT (10886686 -74776479)
2018,Noviembre,República Checa,0,4,,4,POINT (11360029 -72129595)
2018,Noviembre,República Checa,1,1,,2,POINT (3451668 -76532004)
2018,Noviembre,República Checa,119,155,,274,POINT (4697157 -74140516)
2018,Noviembre,República Checa,5,10,,15,POINT (6170465 -7542726)
2018,Noviembre,República Checa,1,2,,3,POINT (863337 -7735002)
2018,Noviembre,Chile,1,0,,1,POINT (-4191162 -69941498)
2018,Noviembre,Chile,2,2,,4,POINT (0.33002 -76876446)
2018,Noviembre,Chile,41,63,,104,POINT (0.81488 -77356)
2018,Noviembre,Chile,199,111,,310,POINT (10406342 -75527794)
2018,Noviembre,Chile,590,399,,989,POINT (10446304 -75516486)
2018,Noviembre,Chile,20,22,,42,POINT (10886686 -74776479)
2018,Noviembre,Chile,0,7,,7,POINT (11360029 -72129595)
2018,Noviembre,Chile,0,1,,1,POINT (125744111 -81703935)
2018,Noviembre,Chile,227,182,,409,POINT (125862 -81702165)
2018,Noviembre,Chile,86,79,,165,POINT (3451668 -76532004)
2018,Noviembre,Chile,1,2,,3,POINT (445285 -75766353)
2018,Noviembre,Chile,3872,5087,,8959,POINT (4697157 -74140516)
2018,Noviembre,Chile,5,6,,11,POINT (4815189 -75736374)
2018,Noviembre,Chile,96,225,,321,POINT (6170465 -7542726)
2018,Noviembre,Chile,1,1,,2,POINT (6185536 -67484028)
2018,Noviembre,Chile,0,1,,1,POINT (7088729 -70740253)
2018,Noviembre,Chile,13,27,,40,POINT (7819 -72453013)
2018,Noviembre,Chile,5,9,,14,POINT (836068 -72409396)
2018,Noviembre,Chile,1,1,,2,POINT (863337 -7735002)
2018,Noviembre,China,0,1,,1,POINT (-4214082 -69941431)
2018,Noviembre,China,0,1,,1,POINT (0.33002 -76876446)
2018,Noviembre,China,3,5,,8,POINT (0.81488 -77356)
2018,Noviembre,China,2,2,,4,POINT (10406342 -75527794)
2018,Noviembre,China,29,29,,58,POINT (10446304 -75516486)
2018,Noviembre,China,3,25,,28,POINT (10886686 -74776479)
2018,Noviembre,China,0,14,,14,POINT (10970933 -74765343)
2018,Noviembre,China,0,5,,5,POINT (11247723 -74213989)
2018,Noviembre,China,0,2,,2,POINT (11360029 -72129595)
2018,Noviembre,China,2,2,,4,POINT (125862 -81702165)
2018,Noviembre,China,8,18,,26,POINT (3451668 -76532004)
2018,Noviembre,China,0,1,,1,POINT (445285 -75766353)
2018,Noviembre,China,390,944,,1334,POINT (4697157 -74140516)
2018,Noviembre,China,1,4,,5,POINT (4815189 -75736374)
2018,Noviembre,China,59,71,,130,POINT (6170465 -7542726)
2018,Noviembre,China,5,10,,15,POINT (7819 -72453013)
2018,Noviembre,Taiwán,0,1,,1,POINT (-4191162 -69941498)
2018,Noviembre,Taiwán,1,1,,2,POINT (0.81488 -77356)
2018,Noviembre,Taiwán,3,2,,5,POINT (10446304 -75516486)
2018,Noviembre,Taiwán,0,2,,2,POINT (10886686 -74776479)
2018,Noviembre,Taiwán,0,1,,1,POINT (10970933 -74765343)
2018,Noviembre,Taiwán,2,3,,5,POINT (3451668 -76532004)
2018,Noviembre,Taiwán,63,75,,138,POINT (4697157 -74140516)
2018,Noviembre,Taiwán,0,1,,1,POINT (4815189 -75736374)
2018,Noviembre,Taiwán,12,8,,20,POINT (6170465 -7542726)
2018,Noviembre,Taiwán,0,1,,1,POINT (7819 -72453013)
2018,Noviembre,Chipre,2,0,,2,POINT (-4214082 -69941431)
2018,Noviembre,Chipre,1,1,,2,POINT (10446304 -75516486)
2018,Noviembre,Chipre,0,1,,1,POINT (125862 -81702165)
2018,Noviembre,Chipre,3,4,,7,POINT (4697157 -74140516)
2018,Noviembre,Chipre,1,1,,2,POINT (6170465 -7542726)
2018,Noviembre,Dinamarca,1,1,,2,POINT (-4191162 -69941498)
2018,Noviembre,Dinamarca,0,1,,1,POINT (-4214082 -69941431)
2018,Noviembre,Dinamarca,5,1,,6,POINT (0.81488 -77356)
2018,Noviembre,Dinamarca,2,3,,5,POINT (10406342 -75527794)
2018,Noviembre,Dinamarca,12,25,,37,POINT (10446304 -75516486)
2018,Noviembre,Dinamarca,2,2,,4,POINT (10886686 -74776479)
2018,Noviembre,Dinamarca,2,2,,4,POINT (11247723 -74213989)
2018,Noviembre,Dinamarca,4,8,,12,POINT (3451668 -76532004)
2018,Noviembre,Dinamarca,106,166,,272,POINT (4697157 -74140516)
2018,Noviembre,Dinamarca,12,13,,25,POINT (6170465 -7542726)
2018,Noviembre,Dinamarca,2,0,,2,POINT (863337 -7735002)
2018,Noviembre,Dominica,0,1,,1,POINT (3451668 -76532004)
2018,Noviembre,Dominica,3,2,,5,POINT (4697157 -74140516)
2018,Noviembre,Dominica,0,1,,1,POINT (6170465 -7542726)
2018,Noviembre,Ecuador,0,1,,1,POINT (-4191162 -69941498)
2018,Noviembre,Ecuador,0,6,,6,POINT (-4214082 -69941431)
2018,Noviembre,Ecuador,93,261,,354,POINT (0.33002 -76876446)
2018,Noviembre,Ecuador,1,2,,3,POINT (0.812436 -77847006)
2018,Noviembre,Ecuador,1853,2314,,4167,POINT (0.81488 -77356)
2018,Noviembre,Ecuador,19,29,,48,POINT (1800143 -78802679)
2018,Noviembre,Ecuador,13,27,,40,POINT (10406342 -75527794)
2018,Noviembre,Ecuador,55,86,,141,POINT (10446304 -75516486)
2018,Noviembre,Ecuador,5,14,,19,POINT (10886686 -74776479)
2018,Noviembre,Ecuador,10,9,,19,POINT (11360029 -72129595)
2018,Noviembre,Ecuador,20,36,,56,POINT (125862 -81702165)
2018,Noviembre,Ecuador,519,518,,1037,POINT (3451668 -76532004)
2018,Noviembre,Ecuador,2,2,,4,POINT (3866713 -67927521)
2018,Noviembre,Ecuador,2,1,,3,POINT (445285 -75766353)
2018,Noviembre,Ecuador,3354,4306,,7660,POINT (4697157 -74140516)
2018,Noviembre,Ecuador,4,3,,7,POINT (4815189 -75736374)
2018,Noviembre,Ecuador,86,112,,198,POINT (6170465 -7542726)
2018,Noviembre,Ecuador,0,1,,1,POINT (6185536 -67484028)
2018,Noviembre,Ecuador,2,5,,7,POINT (7088729 -70740253)
2018,Noviembre,Ecuador,2,3,,5,POINT (7128047 -73181317)
2018,Noviembre,Ecuador,103,101,,204,POINT (7819 -72453013)
2018,Noviembre,Ecuador,2,5,,7,POINT (836068 -72409396)
2018,Noviembre,Egipto,0,1,,1,POINT (0.81488 -77356)
2018,Noviembre,Egipto,0,3,,3,POINT (10446304 -75516486)
2018,Noviembre,Egipto,0,3,,3,POINT (3451668 -76532004)
2018,Noviembre,Egipto,3,10,,13,POINT (4697157 -74140516)
2018,Noviembre,Egipto,0,4,,4,POINT (6170465 -7542726)
2018,Noviembre,El Salvador,0,1,,1,POINT (-4191162 -69941498)
2018,Noviembre,El Salvador,0,2,,2,POINT (0.33002 -76876446)
2018,Noviembre,El Salvador,2,2,,4,POINT (0.81488 -77356)
2018,Noviembre,El Salvador,311,283,,594,POINT (10446304 -75516486)
2018,Noviembre,El Salvador,15,8,,23,POINT (10886686 -74776479)
2018,Noviembre,El Salvador,1,0,,1,POINT (11360029 -72129595)
2018,Noviembre,El Salvador,0,2,,2,POINT (125862 -81702165)
2018,Noviembre,El Salvador,101,140,,241,POINT (3451668 -76532004)
2018,Noviembre,El Salvador,0,1,,1,POINT (445285 -75766353)
2018,Noviembre,El Salvador,779,1001,,1780,POINT (4697157 -74140516)
2018,Noviembre,El Salvador,1,1,,2,POINT (4815189 -75736374)
2018,Noviembre,El Salvador,49,84,,133,POINT (6170465 -7542726)
2018,Noviembre,El Salvador,0,1,,1,POINT (7128047 -73181317)
2018,Noviembre,El Salvador,1,2,,3,POINT (7819 -72453013)
2018,Noviembre,El Salvador,1,1,,2,POINT (863337 -7735002)
2018,Noviembre,Emiratos Árabes,3,6,,9,POINT (4697157 -74140516)
2018,Noviembre,Emiratos Árabes,0,1,,1,POINT (6170465 -7542726)
2018,Noviembre,España,1,6,,7,POINT (-4191162 -69941498)
2018,Noviembre,España,8,6,,14,POINT (-4214082 -69941431)
2018,Noviembre,España,2,6,,8,POINT (0.33002 -76876446)
2018,Noviembre,España,32,35,,67,POINT (0.81488 -77356)
2018,Noviembre,España,12,20,,32,POINT (10406342 -75527794)
2018,Noviembre,España,137,234,,371,POINT (10446304 -75516486)
2018,Noviembre,España,20,41,,61,POINT (10886686 -74776479)
2018,Noviembre,España,0,1,,1,POINT (11117206 -74232675)
2018,Noviembre,España,2,5,,7,POINT (11360029 -72129595)
2018,Noviembre,España,7,7,,14,POINT (125862 -81702165)
2018,Noviembre,España,263,457,,720,POINT (3451668 -76532004)
2018,Noviembre,España,1,3,,4,POINT (445285 -75766353)
2018,Noviembre,España,3158,6806,,9964,POINT (4697157 -74140516)
2018,Noviembre,España,3,9,,12,POINT (4815189 -75736374)
2018,Noviembre,España,396,816,,1212,POINT (6170465 -7542726)
2018,Noviembre,España,1,5,,6,POINT (7088729 -70740253)
2018,Noviembre,España,1,5,,6,POINT (7128047 -73181317)
2018,Noviembre,España,29,44,,73,POINT (7819 -72453013)
2018,Noviembre,España,7,10,,17,POINT (836068 -72409396)
2018,Noviembre,España,0,5,,5,POINT (863337 -7735002)
2018,Noviembre,Eslovaquia,3,5,,8,POINT (0.81488 -77356)
2018,Noviembre,Eslovaquia,0,1,,1,POINT (10406342 -75527794)
2018,Noviembre,Eslovaquia,8,2,,10,POINT (10446304 -75516486)
2018,Noviembre,Eslovaquia,1,4,,5,POINT (10886686 -74776479)
2018,Noviembre,Eslovaquia,3,3,,6,POINT (3451668 -76532004)
2018,Noviembre,Eslovaquia,56,61,,117,POINT (4697157 -74140516)
2018,Noviembre,Eslovaquia,0,1,,1,POINT (4815189 -75736374)
2018,Noviembre,Eslovaquia,6,13,,19,POINT (6170465 -7542726)
2018,Noviembre,Eslovenia,1,0,,1,POINT (0.81488 -77356)
2018,Noviembre,Eslovenia,1,0,,1,POINT (10446304 -75516486)
2018,Noviembre,Eslovenia,1,0,,1,POINT (11360029 -72129595)
2018,Noviembre,Eslovenia,2,1,,3,POINT (3451668 -76532004)
2018,Noviembre,Eslovenia,23,40,,63,POINT (4697157 -74140516)
2018,Noviembre,Eslovenia,1,9,,10,POINT (6170465 -7542726)
2018,Noviembre,Estados Unidos de América,6,10,,16,POINT (-4191162 -69941498)
2018,Noviembre,Estados Unidos de América,3,3,,6,POINT (-4214082 -69941431)
2018,Noviembre,Estados Unidos de América,0,5,,5,POINT (0.33002 -76876446)
2018,Noviembre,Estados Unidos de América,32,66,,98,POINT (0.81488 -77356)
2018,Noviembre,Estados Unidos de América,55,84,,139,POINT (10406342 -75527794)
2018,Noviembre,Estados Unidos de América,4589,6302,,10891,POINT (10446304 -75516486)
2018,Noviembre,Estados Unidos de América,611,1128,,1739,POINT (10886686 -74776479)
2018,Noviembre,Estados Unidos de América,0,4,,4,POINT (11117206 -74232675)
2018,Noviembre,Estados Unidos de América,15,12,,27,POINT (11247723 -74213989)
2018,Noviembre,Estados Unidos de América,3,0,,3,POINT (11360029 -72129595)
2018,Noviembre,Estados Unidos de América,1,0,,1,POINT (1152863 -72919186)
2018,Noviembre,Estados Unidos de América,5,4,,9,POINT (125744111 -81703935)
2018,Noviembre,Estados Unidos de América,44,53,,97,POINT (125862 -81702165)
2018,Noviembre,Estados Unidos de América,0,3,,3,POINT (133387613 -81372937)
2018,Noviembre,Estados Unidos de América,1015,1597,,2612,POINT (3451668 -76532004)
2018,Noviembre,Estados Unidos de América,0,1,,1,POINT (3884426 -77061029)
2018,Noviembre,Estados Unidos de América,1,4,,5,POINT (416909 -73612469)
2018,Noviembre,Estados Unidos de América,142,216,,358,POINT (445285 -75766353)
2018,Noviembre,Estados Unidos de América,9795,16974,,26769,POINT (4697157 -74140516)
2018,Noviembre,Estados Unidos de América,129,209,,338,POINT (4815189 -75736374)
2018,Noviembre,Estados Unidos de América,3061,7671,,10732,POINT (6170465 -7542726)
2018,Noviembre,Estados Unidos de América,1,0,,1,POINT (7088729 -70740253)
2018,Noviembre,Estados Unidos de América,28,57,,85,POINT (7128047 -73181317)
2018,Noviembre,Estados Unidos de América,8,15,,23,POINT (7819 -72453013)
2018,Noviembre,Estados Unidos de América,3,13,,16,POINT (806667 -767333)
2018,Noviembre,Estados Unidos de América,2,2,,4,POINT (836068 -72409396)
2018,Noviembre,Estados Unidos de América,10,15,,25,POINT (863337 -7735002)
2018,Noviembre,Estonia,1,7,,8,POINT (10446304 -75516486)
2018,Noviembre,Estonia,1,2,,3,POINT (10886686 -74776479)
2018,Noviembre,Estonia,0,5,,5,POINT (3451668 -76532004)
2018,Noviembre,Estonia,23,26,,49,POINT (4697157 -74140516)
2018,Noviembre,Estonia,3,1,,4,POINT (6170465 -7542726)
2018,Noviembre,Estonia,0,1,,1,POINT (7819 -72453013)
2018,Noviembre,Estonia,0,1,,1,POINT (863337 -7735002)
2018,Noviembre,Etiopia,1,45,,46,POINT (4697157 -74140516)
2018,Noviembre,Etiopia,0,4,,4,POINT (6170465 -7542726)
2018,Noviembre,Islas Fiji,1,3,,4,POINT (4697157 -74140516)
2018,Noviembre,Filipinas,5,92,,97,POINT (10406342 -75527794)
2018,Noviembre,Filipinas,10,54,,64,POINT (10446304 -75516486)
2018,Noviembre,Filipinas,0,17,,17,POINT (10886686 -74776479)
2018,Noviembre,Filipinas,0,14,,14,POINT (10970933 -74765343)
2018,Noviembre,Filipinas,0,14,,14,POINT (11247723 -74213989)
2018,Noviembre,Filipinas,0,6,,6,POINT (3451668 -76532004)
2018,Noviembre,Filipinas,0,13,,13,POINT (3884426 -77061029)
2018,Noviembre,Filipinas,49,74,,123,POINT (4697157 -74140516)
2018,Noviembre,Filipinas,6,3,,9,POINT (6170465 -7542726)
2018,Noviembre,Filipinas,0,1,,1,POINT (9402597 -75681642)
2018,Noviembre,Finlandia,1,0,,1,POINT (-4191162 -69941498)
2018,Noviembre,Finlandia,5,3,,8,POINT (0.81488 -77356)
2018,Noviembre,Finlandia,1,0,,1,POINT (10406342 -75527794)
2018,Noviembre,Finlandia,7,11,,18,POINT (10446304 -75516486)
2018,Noviembre,Finlandia,2,5,,7,POINT (10886686 -74776479)
2018,Noviembre,Finlandia,1,3,,4,POINT (3451668 -76532004)
2018,Noviembre,Finlandia,68,82,,150,POINT (4697157 -74140516)
2018,Noviembre,Finlandia,0,1,,1,POINT (4815189 -75736374)
2018,Noviembre,Finlandia,5,7,,12,POINT (6170465 -7542726)
2018,Noviembre,Francia,5,9,,14,POINT (-4191162 -69941498)
2018,Noviembre,Francia,10,20,,30,POINT (-4214082 -69941431)
2018,Noviembre,Francia,5,5,,10,POINT (0.33002 -76876446)
2018,Noviembre,Francia,57,80,,137,POINT (0.81488 -77356)
2018,Noviembre,Francia,25,110,,135,POINT (10406342 -75527794)
2018,Noviembre,Francia,157,263,,420,POINT (10446304 -75516486)
2018,Noviembre,Francia,11,24,,35,POINT (10886686 -74776479)
2018,Noviembre,Francia,2,3,,5,POINT (11247723 -74213989)
2018,Noviembre,Francia,1,3,,4,POINT (11360029 -72129595)
2018,Noviembre,Francia,1,3,,4,POINT (125744111 -81703935)
2018,Noviembre,Francia,0,1,,1,POINT (125862 -81702165)
2018,Noviembre,Francia,0,3,,3,POINT (133387613 -81372937)
2018,Noviembre,Francia,55,103,,158,POINT (3451668 -76532004)
2018,Noviembre,Francia,2132,2940,,5072,POINT (4697157 -74140516)
2018,Noviembre,Francia,8,7,,15,POINT (4815189 -75736374)
2018,Noviembre,Francia,178,318,,496,POINT (6170465 -7542726)
2018,Noviembre,Francia,0,1,,1,POINT (6185536 -67484028)
2018,Noviembre,Francia,1,1,,2,POINT (7088729 -70740253)
2018,Noviembre,Francia,3,8,,11,POINT (7128047 -73181317)
2018,Noviembre,Francia,4,3,,7,POINT (7819 -72453013)
2018,Noviembre,Francia,1,0,,1,POINT (836068 -72409396)
2018,Noviembre,Francia,5,13,,18,POINT (863337 -7735002)
2018,Noviembre,Francia,0,1,,1,POINT (9402597 -75681642)
2018,Noviembre,Gabón,1,0,,1,POINT (4697157 -74140516)
2018,Noviembre,Gambia,0,1,,1,POINT (4697157 -74140516)
2018,Noviembre,Georgia,0,6,,6,POINT (10446304 -75516486)
2018,Noviembre,Georgia,0,1,,1,POINT (10886686 -74776479)
2018,Noviembre,Georgia,0,1,,1,POINT (11247723 -74213989)
2018,Noviembre,Georgia,2,3,,5,POINT (4697157 -74140516)
2018,Noviembre,Ghana,0,1,,1,POINT (0.81488 -77356)
2018,Noviembre,Ghana,4,6,,10,POINT (4697157 -74140516)
2018,Noviembre,Ghana,1,1,,2,POINT (6170465 -7542726)
2018,Noviembre,Granada,1,0,,1,POINT (10406342 -75527794)
2018,Noviembre,Granada,0,1,,1,POINT (10446304 -75516486)
2018,Noviembre,Granada,0,3,,3,POINT (125862 -81702165)
2018,Noviembre,Granada,0,5,,5,POINT (4697157 -74140516)
2018,Noviembre,Granada,1,1,,2,POINT (6170465 -7542726)
2018,Noviembre,Grecia,1,0,,1,POINT (0.81488 -77356)
2018,Noviembre,Grecia,0,4,,4,POINT (10406342 -75527794)
2018,Noviembre,Grecia,3,19,,22,POINT (10446304 -75516486)
2018,Noviembre,Grecia,0,2,,2,POINT (10886686 -74776479)
2018,Noviembre,Grecia,0,2,,2,POINT (10970933 -74765343)
2018,Noviembre,Grecia,0,3,,3,POINT (3451668 -76532004)
2018,Noviembre,Grecia,0,1,,1,POINT (3884426 -77061029)
2018,Noviembre,Grecia,39,86,,125,POINT (4697157 -74140516)
2018,Noviembre,Grecia,1,17,,18,POINT (6170465 -7542726)
2018,Noviembre,Grecia,0,4,,4,POINT (806667 -767333)
2018,Noviembre,Grecia,1,1,,2,POINT (9402597 -75681642)
2018,Noviembre,Guatemala,1,3,,4,POINT (0.81488 -77356)
2018,Noviembre,Guatemala,4,4,,8,POINT (10406342 -75527794)
2018,Noviembre,Guatemala,217,218,,435,POINT (10446304 -75516486)
2018,Noviembre,Guatemala,10,16,,26,POINT (10886686 -74776479)
2018,Noviembre,Guatemala,0,1,,1,POINT (11360029 -72129595)
2018,Noviembre,Guatemala,10,7,,17,POINT (125862 -81702165)
2018,Noviembre,Guatemala,54,75,,129,POINT (3451668 -76532004)
2018,Noviembre,Guatemala,0,1,,1,POINT (445285 -75766353)
2018,Noviembre,Guatemala,651,964,,1615,POINT (4697157 -74140516)
2018,Noviembre,Guatemala,12,19,,31,POINT (4815189 -75736374)
2018,Noviembre,Guatemala,85,178,,263,POINT (6170465 -7542726)
2018,Noviembre,Guatemala,2,3,,5,POINT (7128047 -73181317)
2018,Noviembre,Guatemala,0,2,,2,POINT (7819 -72453013)
2018,Noviembre,Guatemala,1,0,,1,POINT (836068 -72409396)
2018,Noviembre,Guatemala,1,1,,2,POINT (863337 -7735002)
2018,Noviembre,Guyana,1,4,,5,POINT (10446304 -75516486)
2018,Noviembre,Guyana,0,1,,1,POINT (11360029 -72129595)
2018,Noviembre,Guyana,3,3,,6,POINT (3451668 -76532004)
2018,Noviembre,Guyana,9,12,,21,POINT (4697157 -74140516)
2018,Noviembre,Guyana,0,2,,2,POINT (6170465 -7542726)
2018,Noviembre,Guyana,1,0,,1,POINT (7128047 -73181317)
2018,Noviembre,Guyana,0,1,,1,POINT (7819 -72453013)
2018,Noviembre,Haití,1,0,,1,POINT (0.81488 -77356)
2018,Noviembre,Haití,2,2,,4,POINT (10446304 -75516486)
2018,Noviembre,Haití,0,1,,1,POINT (10886686 -74776479)
2018,Noviembre,Haití,6,11,,17,POINT (4697157 -74140516)
2018,Noviembre,Haití,2,6,,8,POINT (6170465 -7542726)
2018,Noviembre,Haití,0,1,,1,POINT (7819 -72453013)
2018,Noviembre,Honduras,3,4,,7,POINT (0.81488 -77356)
2018,Noviembre,Honduras,0,1,,1,POINT (1800143 -78802679)
2018,Noviembre,Honduras,2,3,,5,POINT (10406342 -75527794)
2018,Noviembre,Honduras,125,113,,238,POINT (10446304 -75516486)
2018,Noviembre,Honduras,15,19,,34,POINT (10886686 -74776479)
2018,Noviembre,Honduras,0,1,,1,POINT (11247723 -74213989)
2018,Noviembre,Honduras,0,3,,3,POINT (125744111 -81703935)
2018,Noviembre,Honduras,0,1,,1,POINT (125862 -81702165)
2018,Noviembre,Honduras,38,49,,87,POINT (3451668 -76532004)
2018,Noviembre,Honduras,0,1,,1,POINT (3884426 -77061029)
2018,Noviembre,Honduras,334,351,,685,POINT (4697157 -74140516)
2018,Noviembre,Honduras,4,10,,14,POINT (4815189 -75736374)
2018,Noviembre,Honduras,58,58,,116,POINT (6170465 -7542726)
2018,Noviembre,Honduras,1,6,,7,POINT (7128047 -73181317)
2018,Noviembre,Honduras,0,1,,1,POINT (7819 -72453013)
2018,Noviembre,Hong Kong,0,1,,1,POINT (-4191162 -69941498)
2018,Noviembre,Hong Kong,2,2,,4,POINT (10446304 -75516486)
2018,Noviembre,Hong Kong,12,12,,24,POINT (4697157 -74140516)
2018,Noviembre,Hong Kong,1,3,,4,POINT (6170465 -7542726)
2018,Noviembre,Hungría,0,1,,1,POINT (-4191162 -69941498)
2018,Noviembre,Hungría,1,0,,1,POINT (10406342 -75527794)
2018,Noviembre,Hungría,10,19,,29,POINT (10446304 -75516486)
2018,Noviembre,Hungría,0,3,,3,POINT (10886686 -74776479)
2018,Noviembre,Hungría,75,84,,159,POINT (4697157 -74140516)
2018,Noviembre,Hungría,6,8,,14,POINT (6170465 -7542726)
2018,Noviembre,Hungría,0,1,,1,POINT (7819 -72453013)
2018,Noviembre,India,0,2,,2,POINT (-4191162 -69941498)
2018,Noviembre,India,0,2,,2,POINT (0.81488 -77356)
2018,Noviembre,India,1,1,,2,POINT (1800143 -78802679)
2018,Noviembre,India,2,11,,13,POINT (10406342 -75527794)
2018,Noviembre,India,37,86,,123,POINT (10446304 -75516486)
2018,Noviembre,India,1,17,,18,POINT (10886686 -74776479)
2018,Noviembre,India,0,9,,9,POINT (10970933 -74765343)
2018,Noviembre,India,0,3,,3,POINT (11247723 -74213989)
2018,Noviembre,India,5,22,,27,POINT (3451668 -76532004)
2018,Noviembre,India,0,3,,3,POINT (3884426 -77061029)
2018,Noviembre,India,0,1,,1,POINT (445285 -75766353)
2018,Noviembre,India,98,446,,544,POINT (4697157 -74140516)
2018,Noviembre,India,0,4,,4,POINT (4815189 -75736374)
2018,Noviembre,India,18,102,,120,POINT (6170465 -7542726)
2018,Noviembre,India,0,1,,1,POINT (7128047 -73181317)
2018,Noviembre,India,0,1,,1,POINT (863337 -7735002)
2018,Noviembre,India,0,5,,5,POINT (9402597 -75681642)
2018,Noviembre,Indonesia,0,22,,22,POINT (10406342 -75527794)
2018,Noviembre,Indonesia,2,4,,6,POINT (10446304 -75516486)
2018,Noviembre,Indonesia,0,1,,1,POINT (3884426 -77061029)
2018,Noviembre,Indonesia,13,32,,45,POINT (4697157 -74140516)
2018,Noviembre,Indonesia,0,2,,2,POINT (6170465 -7542726)
2018,Noviembre,Irán,1,0,,1,POINT (0.81488 -77356)
2018,Noviembre,Irán,0,1,,1,POINT (10446304 -75516486)
2018,Noviembre,Irán,1,0,,1,POINT (10886686 -74776479)
2018,Noviembre,Irán,5,9,,14,POINT (4697157 -74140516)
2018,Noviembre,Irán,0,2,,2,POINT (6170465 -7542726)
2018,Noviembre,República de Irlanda,0,1,,1,POINT (-4191162 -69941498)
2018,Noviembre,República de Irlanda,0,1,,1,POINT (-4214082 -69941431)
2018,Noviembre,República de Irlanda,3,3,,6,POINT (0.33002 -76876446)
2018,Noviembre,República de Irlanda,3,10,,13,POINT (0.81488 -77356)
2018,Noviembre,República de Irlanda,10,0,,10,POINT (10406342 -75527794)
2018,Noviembre,República de Irlanda,10,29,,39,POINT (10446304 -75516486)
2018,Noviembre,República de Irlanda,1,2,,3,POINT (10886686 -74776479)
2018,Noviembre,República de Irlanda,0,9,,9,POINT (3451668 -76532004)
2018,Noviembre,República de Irlanda,142,254,,396,POINT (4697157 -74140516)
2018,Noviembre,República de Irlanda,6,30,,36,POINT (6170465 -7542726)
2018,Noviembre,República de Irlanda,0,1,,1,POINT (7819 -72453013)
2018,Noviembre,República de Irlanda,7,14,,21,POINT (863337 -7735002)
2018,Noviembre,Islandia,0,1,,1,POINT (0.81488 -77356)
2018,Noviembre,Islandia,0,4,,4,POINT (10446304 -75516486)
2018,Noviembre,Islandia,4,15,,19,POINT (4697157 -74140516)
2018,Noviembre,Islandia,0,2,,2,POINT (6170465 -7542726)
2018,Noviembre,Israel,0,1,,1,POINT (-4191162 -69941498)
2018,Noviembre,Israel,0,1,,1,POINT (-4214082 -69941431)
2018,Noviembre,Israel,0,1,,1,POINT (0.33002 -76876446)
2018,Noviembre,Israel,6,16,,22,POINT (0.81488 -77356)
2018,Noviembre,Israel,1,0,,1,POINT (1800143 -78802679)
2018,Noviembre,Israel,0,4,,4,POINT (10406342 -75527794)
2018,Noviembre,Israel,15,51,,66,POINT (10446304 -75516486)
2018,Noviembre,Israel,1,4,,5,POINT (10886686 -74776479)
2018,Noviembre,Israel,0,4,,4,POINT (125744111 -81703935)
2018,Noviembre,Israel,3,15,,18,POINT (3451668 -76532004)
2018,Noviembre,Israel,87,335,,422,POINT (4697157 -74140516)
2018,Noviembre,Israel,12,52,,64,POINT (6170465 -7542726)
2018,Noviembre,Israel,0,1,,1,POINT (863337 -7735002)
2018,Noviembre,Italia,3,6,,9,POINT (-4191162 -69941498)
2018,Noviembre,Italia,1,2,,3,POINT (0.33002 -76876446)
2018,Noviembre,Italia,20,18,,38,POINT (0.81488 -77356)
2018,Noviembre,Italia,5,15,,20,POINT (10406342 -75527794)
2018,Noviembre,Italia,74,246,,320,POINT (10446304 -75516486)
2018,Noviembre,Italia,18,42,,60,POINT (10886686 -74776479)
2018,Noviembre,Italia,0,1,,1,POINT (11247723 -74213989)
2018,Noviembre,Italia,5,9,,14,POINT (11360029 -72129595)
2018,Noviembre,Italia,3,7,,10,POINT (125862 -81702165)
2018,Noviembre,Italia,37,96,,133,POINT (3451668 -76532004)
2018,Noviembre,Italia,0,1,,1,POINT (416909 -73612469)
2018,Noviembre,Italia,0,1,,1,POINT (445285 -75766353)
2018,Noviembre,Italia,762,2017,,2779,POINT (4697157 -74140516)
2018,Noviembre,Italia,1,4,,5,POINT (4815189 -75736374)
2018,Noviembre,Italia,79,265,,344,POINT (6170465 -7542726)
2018,Noviembre,Italia,1,2,,3,POINT (7088729 -70740253)
2018,Noviembre,Italia,0,3,,3,POINT (7128047 -73181317)
2018,Noviembre,Italia,13,12,,25,POINT (7819 -72453013)
2018,Noviembre,Italia,4,3,,7,POINT (836068 -72409396)
2018,Noviembre,Italia,2,4,,6,POINT (863337 -7735002)
2018,Noviembre,Jamaica,9,9,,18,POINT (10446304 -75516486)
2018,Noviembre,Jamaica,0,1,,1,POINT (10886686 -74776479)
2018,Noviembre,Jamaica,1,4,,5,POINT (125862 -81702165)
2018,Noviembre,Jamaica,3,5,,8,POINT (3451668 -76532004)
2018,Noviembre,Jamaica,30,37,,67,POINT (4697157 -74140516)
2018,Noviembre,Jamaica,0,2,,2,POINT (4815189 -75736374)
2018,Noviembre,Jamaica,4,7,,11,POINT (6170465 -7542726)
2018,Noviembre,Japón,0,1,,1,POINT (-4191162 -69941498)
2018,Noviembre,Japón,2,1,,3,POINT (-4214082 -69941431)
2018,Noviembre,Japón,2,5,,7,POINT (0.81488 -77356)
2018,Noviembre,Japón,0,8,,8,POINT (10406342 -75527794)
2018,Noviembre,Japón,11,25,,36,POINT (10446304 -75516486)
2018,Noviembre,Japón,3,3,,6,POINT (10886686 -74776479)
2018,Noviembre,Japón,0,1,,1,POINT (125862 -81702165)
2018,Noviembre,Japón,3,9,,12,POINT (3451668 -76532004)
2018,Noviembre,Japón,136,504,,640,POINT (4697157 -74140516)
2018,Noviembre,Japón,0,2,,2,POINT (4815189 -75736374)
2018,Noviembre,Japón,15,59,,74,POINT (6170465 -7542726)
2018,Noviembre,Japón,0,2,,2,POINT (7819 -72453013)
2018,Noviembre,Jordania,0,1,,1,POINT (10446304 -75516486)
2018,Noviembre,Jordania,0,5,,5,POINT (4697157 -74140516)
2018,Noviembre,Jordania,1,0,,1,POINT (6170465 -7542726)
2018,Noviembre,Kazajistán,1,2,,3,POINT (10446304 -75516486)
2018,Noviembre,Kazajistán,0,1,,1,POINT (10886686 -74776479)
2018,Noviembre,Kazajistán,5,2,,7,POINT (4697157 -74140516)
2018,Noviembre,Kazajistán,1,2,,3,POINT (6170465 -7542726)
2018,Noviembre,Kenia,0,1,,1,POINT (0.33002 -76876446)
2018,Noviembre,Kenia,0,1,,1,POINT (10446304 -75516486)
2018,Noviembre,Kenia,2,2,,4,POINT (3451668 -76532004)
2018,Noviembre,Kenia,9,7,,16,POINT (4697157 -74140516)
2018,Noviembre,Kenia,0,1,,1,POINT (6170465 -7542726)
2018,Noviembre,Kuwait,2,6,,8,POINT (4697157 -74140516)
2018,Noviembre,Kuwait,1,0,,1,POINT (6170465 -7542726)
2018,Noviembre,República de Kosovo,1,0,,1,POINT (4697157 -74140516)
2018,Noviembre,República Democrática Popular  Lao,0,1,,1,POINT (4697157 -74140516)
2018,Noviembre,Letonia,2,5,,7,POINT (10446304 -75516486)
2018,Noviembre,Letonia,1,1,,2,POINT (3451668 -76532004)
2018,Noviembre,Letonia,2,0,,2,POINT (445285 -75766353)
2018,Noviembre,Letonia,13,19,,32,POINT (4697157 -74140516)
2018,Noviembre,Letonia,0,2,,2,POINT (6170465 -7542726)
2018,Noviembre,Letonia,0,1,,1,POINT (836068 -72409396)
2018,Noviembre,Letonia,0,3,,3,POINT (9402597 -75681642)
2018,Noviembre,Lituania,1,0,,1,POINT (0.81488 -77356)
2018,Noviembre,Lituania,4,10,,14,POINT (10446304 -75516486)
2018,Noviembre,Lituania,1,0,,1,POINT (10886686 -74776479)
2018,Noviembre,Lituania,0,1,,1,POINT (11247723 -74213989)
2018,Noviembre,Lituania,2,3,,5,POINT (3451668 -76532004)
2018,Noviembre,Lituania,0,1,,1,POINT (3884426 -77061029)
2018,Noviembre,Lituania,39,32,,71,POINT (4697157 -74140516)
2018,Noviembre,Lituania,4,4,,8,POINT (6170465 -7542726)
2018,Noviembre,Lituania,0,1,,1,POINT (9402597 -75681642)
2018,Noviembre,Líbano,0,3,,3,POINT (10406342 -75527794)
2018,Noviembre,Líbano,0,1,,1,POINT (10446304 -75516486)
2018,Noviembre,Líbano,4,4,,8,POINT (10886686 -74776479)
2018,Noviembre,Líbano,2,2,,4,POINT (11360029 -72129595)
2018,Noviembre,Líbano,1,0,,1,POINT (125862 -81702165)
2018,Noviembre,Líbano,1,1,,2,POINT (3451668 -76532004)
2018,Noviembre,Líbano,12,24,,36,POINT (4697157 -74140516)
2018,Noviembre,Líbano,2,4,,6,POINT (6170465 -7542726)
2018,Noviembre,Liberia,0,1,,1,POINT (10446304 -75516486)
2018,Noviembre,Liberia,0,1,,1,POINT (6170465 -7542726)
2018,Noviembre,Libia,2,2,,4,POINT (4697157 -74140516)
2018,Noviembre,Libia,0,1,,1,POINT (6170465 -7542726)
2018,Noviembre,Liechtenstein,2,4,,6,POINT (4697157 -74140516)
2018,Noviembre,Luxemburgo,0,2,,2,POINT (10446304 -75516486)
2018,Noviembre,Luxemburgo,0,1,,1,POINT (3451668 -76532004)
2018,Noviembre,Luxemburgo,9,14,,23,POINT (4697157 -74140516)
2018,Noviembre,Luxemburgo,0,1,,1,POINT (6170465 -7542726)
2018,Noviembre,Macedonia,1,0,,1,POINT (10886686 -74776479)
2018,Noviembre,Macedonia,0,1,,1,POINT (3451668 -76532004)
2018,Noviembre,Macedonia,3,5,,8,POINT (4697157 -74140516)
2018,Noviembre,Madagascar,5,1,,6,POINT (4697157 -74140516)
2018,Noviembre,Madagascar,2,0,,2,POINT (6170465 -7542726)
2018,Noviembre,Malasia,1,1,,2,POINT (0.81488 -77356)
2018,Noviembre,Malasia,2,0,,2,POINT (10446304 -75516486)
2018,Noviembre,Malasia,0,1,,1,POINT (11247723 -74213989)
2018,Noviembre,Malasia,20,36,,56,POINT (4697157 -74140516)
2018,Noviembre,Malasia,0,2,,2,POINT (6170465 -7542726)
2018,Noviembre,Malawi,1,1,,2,POINT (4697157 -74140516)
2018,Noviembre,Malta,1,0,,1,POINT (10446304 -75516486)
2018,Noviembre,Malta,7,7,,14,POINT (4697157 -74140516)
2018,Noviembre,Malta,0,1,,1,POINT (6170465 -7542726)
2018,Noviembre,Malta,1,0,,1,POINT (7819 -72453013)
2018,Noviembre,Marruecos,1,0,,1,POINT (0.81488 -77356)
2018,Noviembre,Marruecos,1,0,,1,POINT (10446304 -75516486)
2018,Noviembre,Marruecos,1,0,,1,POINT (10886686 -74776479)
2018,Noviembre,Marruecos,1,0,,1,POINT (3451668 -76532004)
2018,Noviembre,Marruecos,17,23,,40,POINT (4697157 -74140516)
2018,Noviembre,Marruecos,0,1,,1,POINT (6170465 -7542726)
2018,Noviembre,Mauricio,0,5,,5,POINT (10406342 -75527794)
2018,Noviembre,Mauricio,0,4,,4,POINT (4697157 -74140516)
2018,Noviembre,Mauricio,0,2,,2,POINT (6170465 -7542726)
2018,Noviembre,México,2,1,,3,POINT (-4191162 -69941498)
2018,Noviembre,México,1,0,,1,POINT (0.33002 -76876446)
2018,Noviembre,México,22,33,,55,POINT (0.81488 -77356)
2018,Noviembre,México,17,21,,38,POINT (10406342 -75527794)
2018,Noviembre,México,273,404,,677,POINT (10446304 -75516486)
2018,Noviembre,México,42,71,,113,POINT (10886686 -74776479)
2018,Noviembre,México,0,1,,1,POINT (11117206 -74232675)
2018,Noviembre,México,2,3,,5,POINT (11360029 -72129595)
2018,Noviembre,México,0,3,,3,POINT (125744111 -81703935)
2018,Noviembre,México,2,1,,3,POINT (125862 -81702165)
2018,Noviembre,México,108,199,,307,POINT (3451668 -76532004)
2018,Noviembre,México,3,7,,10,POINT (416909 -73612469)
2018,Noviembre,México,0,1,,1,POINT (445285 -75766353)
2018,Noviembre,México,5049,8277,,13326,POINT (4697157 -74140516)
2018,Noviembre,México,14,26,,40,POINT (4815189 -75736374)
2018,Noviembre,México,585,1285,,1870,POINT (6170465 -7542726)
2018,Noviembre,México,1,2,,3,POINT (7088729 -70740253)
2018,Noviembre,México,6,16,,22,POINT (7128047 -73181317)
2018,Noviembre,México,6,16,,22,POINT (7819 -72453013)
2018,Noviembre,México,3,9,,12,POINT (836068 -72409396)
2018,Noviembre,México,0,1,,1,POINT (863337 -7735002)
2018,Noviembre,República de Moldavia,2,1,,3,POINT (4697157 -74140516)
2018,Noviembre,Mongolia,1,0,,1,POINT (4697157 -74140516)
2018,Noviembre,Montenegro,1,0,,1,POINT (10406342 -75527794)
2018,Noviembre,Montenegro,0,4,,4,POINT (10446304 -75516486)
2018,Noviembre,Montenegro,0,1,,1,POINT (3451668 -76532004)
2018,Noviembre,Montenegro,3,6,,9,POINT (4697157 -74140516)
2018,Noviembre,Montenegro,0,1,,1,POINT (6170465 -7542726)
2018,Noviembre,Mozambique,3,5,,8,POINT (4697157 -74140516)
2018,Noviembre,Myanmar,0,4,,4,POINT (10406342 -75527794)
2018,Noviembre,Myanmar,0,4,,4,POINT (10446304 -75516486)
2018,Noviembre,Myanmar,0,3,,3,POINT (10886686 -74776479)
2018,Noviembre,Myanmar,0,2,,2,POINT (3884426 -77061029)
2018,Noviembre,Myanmar,1,1,,2,POINT (4697157 -74140516)
2018,Noviembre,Myanmar,1,0,,1,POINT (4815189 -75736374)
2018,Noviembre,Namibia,0,1,,1,POINT (10406342 -75527794)
2018,Noviembre,Nepal,1,5,,6,POINT (4697157 -74140516)
2018,Noviembre,Nepal,1,0,,1,POINT (6170465 -7542726)
2018,Noviembre,Nicaragua,0,1,,1,POINT (10406342 -75527794)
2018,Noviembre,Nicaragua,29,53,,82,POINT (10446304 -75516486)
2018,Noviembre,Nicaragua,3,6,,9,POINT (10886686 -74776479)
2018,Noviembre,Nicaragua,0,4,,4,POINT (125744111 -81703935)
2018,Noviembre,Nicaragua,19,22,,41,POINT (3451668 -76532004)
2018,Noviembre,Nicaragua,87,122,,209,POINT (4697157 -74140516)
2018,Noviembre,Nicaragua,0,3,,3,POINT (4815189 -75736374)
2018,Noviembre,Nicaragua,26,27,,53,POINT (6170465 -7542726)
2018,Noviembre,Nicaragua,0,2,,2,POINT (7819 -72453013)
2018,Noviembre,Nigeria,0,1,,1,POINT (10406342 -75527794)
2018,Noviembre,Nigeria,0,2,,2,POINT (10446304 -75516486)
2018,Noviembre,Nigeria,1,0,,1,POINT (3451668 -76532004)
2018,Noviembre,Nigeria,7,8,,15,POINT (4697157 -74140516)
2018,Noviembre,Nigeria,0,1,,1,POINT (6170465 -7542726)
2018,Noviembre,Noruega,0,1,,1,POINT (-4191162 -69941498)
2018,Noviembre,Noruega,2,0,,2,POINT (0.81488 -77356)
2018,Noviembre,Noruega,2,4,,6,POINT (10406342 -75527794)
2018,Noviembre,Noruega,22,21,,43,POINT (10446304 -75516486)
2018,Noviembre,Noruega,5,3,,8,POINT (10886686 -74776479)
2018,Noviembre,Noruega,1,1,,2,POINT (11247723 -74213989)
2018,Noviembre,Noruega,2,7,,9,POINT (3451668 -76532004)
2018,Noviembre,Noruega,162,211,,373,POINT (4697157 -74140516)
2018,Noviembre,Noruega,1,3,,4,POINT (4815189 -75736374)
2018,Noviembre,Noruega,6,17,,23,POINT (6170465 -7542726)
2018,Noviembre,Nueva Zelanda,5,7,,12,POINT (0.81488 -77356)
2018,Noviembre,Nueva Zelanda,4,4,,8,POINT (10406342 -75527794)
2018,Noviembre,Nueva Zelanda,12,12,,24,POINT (10446304 -75516486)
2018,Noviembre,Nueva Zelanda,1,6,,7,POINT (10886686 -74776479)
2018,Noviembre,Nueva Zelanda,1,4,,5,POINT (3451668 -76532004)
2018,Noviembre,Nueva Zelanda,100,146,,246,POINT (4697157 -74140516)
2018,Noviembre,Nueva Zelanda,0,1,,1,POINT (4815189 -75736374)
2018,Noviembre,Nueva Zelanda,7,18,,25,POINT (6170465 -7542726)
2018,Noviembre,Nueva Zelanda,2,3,,5,POINT (863337 -7735002)
2018,Noviembre,Omán,0,1,,1,POINT (6170465 -7542726)
2018,Noviembre,Países Bajos,2,6,,8,POINT (-4191162 -69941498)
2018,Noviembre,Países Bajos,3,2,,5,POINT (-4214082 -69941431)
2018,Noviembre,Países Bajos,1,1,,2,POINT (0.33002 -76876446)
2018,Noviembre,Países Bajos,25,28,,53,POINT (0.81488 -77356)
2018,Noviembre,Países Bajos,24,21,,45,POINT (10406342 -75527794)
2018,Noviembre,Países Bajos,258,266,,524,POINT (10446304 -75516486)
2018,Noviembre,Países Bajos,5,24,,29,POINT (10886686 -74776479)
2018,Noviembre,Países Bajos,3,3,,6,POINT (11247723 -74213989)
2018,Noviembre,Países Bajos,0,1,,1,POINT (11360029 -72129595)
2018,Noviembre,Países Bajos,0,2,,2,POINT (125862 -81702165)
2018,Noviembre,Países Bajos,48,59,,107,POINT (3451668 -76532004)
2018,Noviembre,Países Bajos,0,3,,3,POINT (3884426 -77061029)
2018,Noviembre,Países Bajos,1739,2391,,4130,POINT (4697157 -74140516)
2018,Noviembre,Países Bajos,4,2,,6,POINT (4815189 -75736374)
2018,Noviembre,Países Bajos,116,207,,323,POINT (6170465 -7542726)
2018,Noviembre,Países Bajos,7,6,,13,POINT (7128047 -73181317)
2018,Noviembre,Países Bajos,1,7,,8,POINT (7819 -72453013)
2018,Noviembre,Países Bajos,2,0,,2,POINT (7927233 -72508188)
2018,Noviembre,Países Bajos,0,2,,2,POINT (836068 -72409396)
2018,Noviembre,Países Bajos,16,13,,29,POINT (863337 -7735002)
2018,Noviembre,Pakistán,0,1,,1,POINT (-4191162 -69941498)
2018,Noviembre,Pakistán,2,6,,8,POINT (10446304 -75516486)
2018,Noviembre,Pakistán,0,1,,1,POINT (11247723 -74213989)
2018,Noviembre,Pakistán,7,19,,26,POINT (4697157 -74140516)
2018,Noviembre,Panamá,1,4,,5,POINT (0.81488 -77356)
2018,Noviembre,Panamá,1,22,,23,POINT (10406342 -75527794)
2018,Noviembre,Panamá,782,722,,1504,POINT (10446304 -75516486)
2018,Noviembre,Panamá,74,108,,182,POINT (10886686 -74776479)
2018,Noviembre,Panamá,57,25,,82,POINT (11117206 -74232675)
2018,Noviembre,Panamá,0,2,,2,POINT (125744111 -81703935)
2018,Noviembre,Panamá,83,75,,158,POINT (125862 -81702165)
2018,Noviembre,Panamá,342,362,,704,POINT (3451668 -76532004)
2018,Noviembre,Panamá,2,2,,4,POINT (416909 -73612469)
2018,Noviembre,Panamá,42,36,,78,POINT (445285 -75766353)
2018,Noviembre,Panamá,2642,2542,,5184,POINT (4697157 -74140516)
2018,Noviembre,Panamá,68,79,,147,POINT (4815189 -75736374)
2018,Noviembre,Panamá,2464,1978,,4442,POINT (6170465 -7542726)
2018,Noviembre,Panamá,0,1,,1,POINT (6222552 -77401154)
2018,Noviembre,Panamá,1,3,,4,POINT (7102626 -77762647)
2018,Noviembre,Panamá,27,34,,61,POINT (7128047 -73181317)
2018,Noviembre,Panamá,3,2,,5,POINT (7819 -72453013)
2018,Noviembre,Panamá,0,7,,7,POINT (863337 -7735002)
2018,Noviembre,Paraguay,0,1,,1,POINT (0.81488 -77356)
2018,Noviembre,Paraguay,1,3,,4,POINT (10406342 -75527794)
2018,Noviembre,Paraguay,81,48,,129,POINT (10446304 -75516486)
2018,Noviembre,Paraguay,6,7,,13,POINT (10886686 -74776479)
2018,Noviembre,Paraguay,77,44,,121,POINT (125862 -81702165)
2018,Noviembre,Paraguay,7,10,,17,POINT (3451668 -76532004)
2018,Noviembre,Paraguay,180,217,,397,POINT (4697157 -74140516)
2018,Noviembre,Paraguay,1,0,,1,POINT (4815189 -75736374)
2018,Noviembre,Paraguay,29,51,,80,POINT (6170465 -7542726)
2018,Noviembre,Paraguay,0,1,,1,POINT (7088729 -70740253)
2018,Noviembre,Paraguay,3,1,,4,POINT (7819 -72453013)
2018,Noviembre,Perú,15,16,,31,POINT (-4191162 -69941498)
2018,Noviembre,Perú,17,37,,54,POINT (-4214082 -69941431)
2018,Noviembre,Perú,1,12,,13,POINT (0.33002 -76876446)
2018,Noviembre,Perú,107,271,,378,POINT (0.81488 -77356)
2018,Noviembre,Perú,35,25,,60,POINT (10406342 -75527794)
2018,Noviembre,Perú,1058,752,,1810,POINT (10446304 -75516486)
2018,Noviembre,Perú,4,15,,19,POINT (10886686 -74776479)
2018,Noviembre,Perú,6,14,,20,POINT (11360029 -72129595)
2018,Noviembre,Perú,254,182,,436,POINT (125862 -81702165)
2018,Noviembre,Perú,165,202,,367,POINT (3451668 -76532004)
2018,Noviembre,Perú,1,2,,3,POINT (445285 -75766353)
2018,Noviembre,Perú,3556,4460,,8016,POINT (4697157 -74140516)
2018,Noviembre,Perú,6,6,,12,POINT (4815189 -75736374)
2018,Noviembre,Perú,556,869,,1425,POINT (6170465 -7542726)
2018,Noviembre,Perú,0,1,,1,POINT (6185536 -67484028)
2018,Noviembre,Perú,0,7,,7,POINT (7088729 -70740253)
2018,Noviembre,Perú,1,1,,2,POINT (7128047 -73181317)
2018,Noviembre,Perú,64,100,,164,POINT (7819 -72453013)
2018,Noviembre,Perú,2,5,,7,POINT (836068 -72409396)
2018,Noviembre,Palestina,2,3,,5,POINT (4697157 -74140516)
2018,Noviembre,Polonia,25,4,,29,POINT (-4191162 -69941498)
2018,Noviembre,Polonia,3,2,,5,POINT (-4214082 -69941431)
2018,Noviembre,Polonia,17,16,,33,POINT (0.81488 -77356)
2018,Noviembre,Polonia,28,43,,71,POINT (10406342 -75527794)
2018,Noviembre,Polonia,51,69,,120,POINT (10446304 -75516486)
2018,Noviembre,Polonia,1,2,,3,POINT (10886686 -74776479)
2018,Noviembre,Polonia,0,4,,4,POINT (10970933 -74765343)
2018,Noviembre,Polonia,1,0,,1,POINT (11247723 -74213989)
2018,Noviembre,Polonia,3,0,,3,POINT (3451668 -76532004)
2018,Noviembre,Polonia,332,361,,693,POINT (4697157 -74140516)
2018,Noviembre,Polonia,1,0,,1,POINT (4815189 -75736374)
2018,Noviembre,Polonia,13,19,,32,POINT (6170465 -7542726)
2018,Noviembre,Polonia,0,1,,1,POINT (7819 -72453013)
2018,Noviembre,Polonia,0,2,,2,POINT (863337 -7735002)
2018,Noviembre,Portugal,0,1,,1,POINT (-4191162 -69941498)
2018,Noviembre,Portugal,1,0,,1,POINT (-4214082 -69941431)
2018,Noviembre,Portugal,3,1,,4,POINT (0.81488 -77356)
2018,Noviembre,Portugal,1,3,,4,POINT (10406342 -75527794)
2018,Noviembre,Portugal,11,21,,32,POINT (10446304 -75516486)
2018,Noviembre,Portugal,2,2,,4,POINT (10886686 -74776479)
2018,Noviembre,Portugal,0,1,,1,POINT (10970933 -74765343)
2018,Noviembre,Portugal,0,1,,1,POINT (11247723 -74213989)
2018,Noviembre,Portugal,3,2,,5,POINT (11360029 -72129595)
2018,Noviembre,Portugal,1,1,,2,POINT (125862 -81702165)
2018,Noviembre,Portugal,2,11,,13,POINT (3451668 -76532004)
2018,Noviembre,Portugal,258,492,,750,POINT (4697157 -74140516)
2018,Noviembre,Portugal,2,4,,6,POINT (4815189 -75736374)
2018,Noviembre,Portugal,11,48,,59,POINT (6170465 -7542726)
2018,Noviembre,Portugal,5,21,,26,POINT (7819 -72453013)
2018,Noviembre,Portugal,2,1,,3,POINT (836068 -72409396)
2018,Noviembre,Puerto Rico/Territorio de Estados Unidos,1,0,,1,POINT (4697157 -74140516)
2018,Noviembre,Qatar,1,0,,1,POINT (0.81488 -77356)
2018,Noviembre,Qatar,0,1,,1,POINT (6170465 -7542726)
2018,Noviembre,Reino Unido de Gran Bretaña e Irlanda del Norte,5,4,,9,POINT (-4191162 -69941498)
2018,Noviembre,Reino Unido de Gran Bretaña e Irlanda del Norte,3,6,,9,POINT (-4214082 -69941431)
2018,Noviembre,Reino Unido de Gran Bretaña e Irlanda del Norte,4,2,,6,POINT (0.33002 -76876446)
2018,Noviembre,Reino Unido de Gran Bretaña e Irlanda del Norte,44,78,,122,POINT (0.81488 -77356)
2018,Noviembre,Reino Unido de Gran Bretaña e Irlanda del Norte,14,27,,41,POINT (10406342 -75527794)
2018,Noviembre,Reino Unido de Gran Bretaña e Irlanda del Norte,111,204,,315,POINT (10446304 -75516486)
2018,Noviembre,Reino Unido de Gran Bretaña e Irlanda del Norte,5,24,,29,POINT (10886686 -74776479)
2018,Noviembre,Reino Unido de Gran Bretaña e Irlanda del Norte,8,8,,16,POINT (11247723 -74213989)
2018,Noviembre,Reino Unido de Gran Bretaña e Irlanda del Norte,2,2,,4,POINT (125744111 -81703935)
2018,Noviembre,Reino Unido de Gran Bretaña e Irlanda del Norte,1,1,,2,POINT (125862 -81702165)
2018,Noviembre,Reino Unido de Gran Bretaña e Irlanda del Norte,22,44,,66,POINT (3451668 -76532004)
2018,Noviembre,Reino Unido de Gran Bretaña e Irlanda del Norte,0,1,,1,POINT (3884426 -77061029)
2018,Noviembre,Reino Unido de Gran Bretaña e Irlanda del Norte,1,0,,1,POINT (445285 -75766353)
2018,Noviembre,Reino Unido de Gran Bretaña e Irlanda del Norte,1120,2189,,3309,POINT (4697157 -74140516)
2018,Noviembre,Reino Unido de Gran Bretaña e Irlanda del Norte,1,4,,5,POINT (4815189 -75736374)
2018,Noviembre,Reino Unido de Gran Bretaña e Irlanda del Norte,96,264,,360,POINT (6170465 -7542726)
2018,Noviembre,Reino Unido de Gran Bretaña e Irlanda del Norte,0,2,,2,POINT (7819 -72453013)
2018,Noviembre,Reino Unido de Gran Bretaña e Irlanda del Norte,0,1,,1,POINT (836068 -72409396)
2018,Noviembre,Reino Unido de Gran Bretaña e Irlanda del Norte,21,26,,47,POINT (863337 -7735002)
2018,Noviembre,República Dominicana,0,1,,1,POINT (-4191162 -69941498)
2018,Noviembre,República Dominicana,0,1,,1,POINT (0.33002 -76876446)
2018,Noviembre,República Dominicana,5,14,,19,POINT (0.81488 -77356)
2018,Noviembre,República Dominicana,14,12,,26,POINT (10406342 -75527794)
2018,Noviembre,República Dominicana,57,74,,131,POINT (10446304 -75516486)
2018,Noviembre,República Dominicana,65,33,,98,POINT (10886686 -74776479)
2018,Noviembre,República Dominicana,0,2,,2,POINT (11117206 -74232675)
2018,Noviembre,República Dominicana,2,4,,6,POINT (11360029 -72129595)
2018,Noviembre,República Dominicana,2,1,,3,POINT (125862 -81702165)
2018,Noviembre,República Dominicana,35,27,,62,POINT (3451668 -76532004)
2018,Noviembre,República Dominicana,1,1,,2,POINT (445285 -75766353)
2018,Noviembre,República Dominicana,1186,1128,,2314,POINT (4697157 -74140516)
2018,Noviembre,República Dominicana,3,2,,5,POINT (4815189 -75736374)
2018,Noviembre,República Dominicana,66,116,,182,POINT (6170465 -7542726)
2018,Noviembre,República Dominicana,0,1,,1,POINT (7088729 -70740253)
2018,Noviembre,República Dominicana,2,2,,4,POINT (7128047 -73181317)
2018,Noviembre,República Dominicana,4,3,,7,POINT (7819 -72453013)
2018,Noviembre,República Dominicana,1,1,,2,POINT (836068 -72409396)
2018,Noviembre,Rumania,2,3,,5,POINT (0.81488 -77356)
2018,Noviembre,Rumania,0,13,,13,POINT (10406342 -75527794)
2018,Noviembre,Rumania,16,20,,36,POINT (10446304 -75516486)
2018,Noviembre,Rumania,0,3,,3,POINT (10886686 -74776479)
2018,Noviembre,Rumania,1,2,,3,POINT (3451668 -76532004)
2018,Noviembre,Rumania,0,1,,1,POINT (3884426 -77061029)
2018,Noviembre,Rumania,92,85,,177,POINT (4697157 -74140516)
2018,Noviembre,Rumania,0,1,,1,POINT (4815189 -75736374)
2018,Noviembre,Rumania,8,12,,20,POINT (6170465 -7542726)
2018,Noviembre,Rumania,0,1,,1,POINT (7088729 -70740253)
2018,Noviembre,Rumania,0,2,,2,POINT (7819 -72453013)
2018,Noviembre,Rumania,0,2,,2,POINT (863337 -7735002)
2018,Noviembre,Rumania,0,1,,1,POINT (9402597 -75681642)
2018,Noviembre,Federación de Rusia,7,4,,11,POINT (0.81488 -77356)
2018,Noviembre,Federación de Rusia,2,13,,15,POINT (10406342 -75527794)
2018,Noviembre,Federación de Rusia,19,54,,73,POINT (10446304 -75516486)
2018,Noviembre,Federación de Rusia,0,6,,6,POINT (10886686 -74776479)
2018,Noviembre,Federación de Rusia,0,4,,4,POINT (10970933 -74765343)
2018,Noviembre,Federación de Rusia,0,6,,6,POINT (11247723 -74213989)
2018,Noviembre,Federación de Rusia,0,1,,1,POINT (11360029 -72129595)
2018,Noviembre,Federación de Rusia,1,1,,2,POINT (125862 -81702165)
2018,Noviembre,Federación de Rusia,1,1,,2,POINT (3451668 -76532004)
2018,Noviembre,Federación de Rusia,201,251,,452,POINT (4697157 -74140516)
2018,Noviembre,Federación de Rusia,0,2,,2,POINT (4815189 -75736374)
2018,Noviembre,Federación de Rusia,15,22,,37,POINT (6170465 -7542726)
2018,Noviembre,Federación de Rusia,1,0,,1,POINT (7819 -72453013)
2018,Noviembre,Federación de Rusia,0,4,,4,POINT (9402597 -75681642)
2018,Noviembre,San Cristóbal y Nevis,0,1,,1,POINT (0.81488 -77356)
2018,Noviembre,San Cristóbal y Nevis,1,0,,1,POINT (10446304 -75516486)
2018,Noviembre,San Cristóbal y Nevis,2,2,,4,POINT (4697157 -74140516)
2018,Noviembre,San Marino,0,1,,1,POINT (4697157 -74140516)
2018,Noviembre,San  Vicente y las Granadinas,0,1,,1,POINT (10446304 -75516486)
2018,Noviembre,San  Vicente y las Granadinas,0,1,,1,POINT (10886686 -74776479)
2018,Noviembre,San  Vicente y las Granadinas,1,0,,1,POINT (3451668 -76532004)
2018,Noviembre,San  Vicente y las Granadinas,1,0,,1,POINT (6170465 -7542726)
2018,Noviembre,Santa Lucia,0,2,,2,POINT (10406342 -75527794)
2018,Noviembre,Santa Lucia,1,0,,1,POINT (10446304 -75516486)
2018,Noviembre,Santa Lucia,0,1,,1,POINT (125862 -81702165)
2018,Noviembre,Santa Lucia,2,6,,8,POINT (4697157 -74140516)
2018,Noviembre,Santa Sede/Ciudad del Vaticano,0,1,,1,POINT (4697157 -74140516)
2018,Noviembre,Senegal,0,1,,1,POINT (10406342 -75527794)
2018,Noviembre,Senegal,1,0,,1,POINT (3451668 -76532004)
2018,Noviembre,Senegal,1,1,,2,POINT (4697157 -74140516)
2018,Noviembre,Serbia,0,1,,1,POINT (0.33002 -76876446)
2018,Noviembre,Serbia,6,3,,9,POINT (10446304 -75516486)
2018,Noviembre,Serbia,0,1,,1,POINT (11247723 -74213989)
2018,Noviembre,Serbia,1,6,,7,POINT (3451668 -76532004)
2018,Noviembre,Serbia,14,38,,52,POINT (4697157 -74140516)
2018,Noviembre,Serbia,5,3,,8,POINT (6170465 -7542726)
2018,Noviembre,Singapur,0,1,,1,POINT (-4191162 -69941498)
2018,Noviembre,Singapur,7,5,,12,POINT (10446304 -75516486)
2018,Noviembre,Singapur,1,3,,4,POINT (10886686 -74776479)
2018,Noviembre,Singapur,0,2,,2,POINT (3451668 -76532004)
2018,Noviembre,Singapur,15,34,,49,POINT (4697157 -74140516)
2018,Noviembre,Singapur,2,6,,8,POINT (6170465 -7542726)
2018,Noviembre,República Árabe Siria,0,1,,1,POINT (10886686 -74776479)
2018,Noviembre,República Árabe Siria,0,1,,1,POINT (11360029 -72129595)
2018,Noviembre,República Árabe Siria,2,6,,8,POINT (4697157 -74140516)
2018,Noviembre,República Árabe Siria,1,0,,1,POINT (7819 -72453013)
2018,Noviembre,Somalia,0,1,,1,POINT (4697157 -74140516)
2018,Noviembre,Sri Lanka,0,1,,1,POINT (3884426 -77061029)
2018,Noviembre,Sri Lanka,0,5,,5,POINT (4697157 -74140516)
2018,Noviembre,Sri Lanka,0,2,,2,POINT (6170465 -7542726)
2018,Noviembre,Sudáfrica,0,1,,1,POINT (10406342 -75527794)
2018,Noviembre,Sudáfrica,3,2,,5,POINT (10446304 -75516486)
2018,Noviembre,Sudáfrica,1,3,,4,POINT (10886686 -74776479)
2018,Noviembre,Sudáfrica,1,2,,3,POINT (3451668 -76532004)
2018,Noviembre,Sudáfrica,26,81,,107,POINT (4697157 -74140516)
2018,Noviembre,Sudáfrica,1,6,,7,POINT (6170465 -7542726)
2018,Noviembre,Sudáfrica,0,1,,1,POINT (7128047 -73181317)
2018,Noviembre,Suecia,3,4,,7,POINT (-4191162 -69941498)
2018,Noviembre,Suecia,12,13,,25,POINT (0.81488 -77356)
2018,Noviembre,Suecia,4,2,,6,POINT (10406342 -75527794)
2018,Noviembre,Suecia,22,46,,68,POINT (10446304 -75516486)
2018,Noviembre,Suecia,1,8,,9,POINT (10886686 -74776479)
2018,Noviembre,Suecia,0,3,,3,POINT (11247723 -74213989)
2018,Noviembre,Suecia,10,13,,23,POINT (3451668 -76532004)
2018,Noviembre,Suecia,0,1,,1,POINT (445285 -75766353)
2018,Noviembre,Suecia,198,324,,522,POINT (4697157 -74140516)
2018,Noviembre,Suecia,20,43,,63,POINT (6170465 -7542726)
2018,Noviembre,Suecia,0,1,,1,POINT (7819 -72453013)
2018,Noviembre,Suecia,1,2,,3,POINT (836068 -72409396)
2018,Noviembre,Suiza,3,5,,8,POINT (-4191162 -69941498)
2018,Noviembre,Suiza,1,1,,2,POINT (-4214082 -69941431)
2018,Noviembre,Suiza,33,35,,68,POINT (0.81488 -77356)
2018,Noviembre,Suiza,14,22,,36,POINT (10406342 -75527794)
2018,Noviembre,Suiza,58,78,,136,POINT (10446304 -75516486)
2018,Noviembre,Suiza,5,14,,19,POINT (10886686 -74776479)
2018,Noviembre,Suiza,1,3,,4,POINT (11247723 -74213989)
2018,Noviembre,Suiza,0,1,,1,POINT (125862 -81702165)
2018,Noviembre,Suiza,1,0,,1,POINT (133387613 -81372937)
2018,Noviembre,Suiza,21,44,,65,POINT (3451668 -76532004)
2018,Noviembre,Suiza,1,1,,2,POINT (416909 -73612469)
2018,Noviembre,Suiza,501,786,,1287,POINT (4697157 -74140516)
2018,Noviembre,Suiza,1,1,,2,POINT (4815189 -75736374)
2018,Noviembre,Suiza,67,133,,200,POINT (6170465 -7542726)
2018,Noviembre,Suiza,0,1,,1,POINT (7819 -72453013)
2018,Noviembre,Suiza,1,0,,1,POINT (836068 -72409396)
2018,Noviembre,Suiza,15,3,,18,POINT (863337 -7735002)
2018,Noviembre,Surinam,0,1,,1,POINT (125862 -81702165)
2018,Noviembre,Surinam,17,21,,38,POINT (4697157 -74140516)
2018,Noviembre,Surinam,0,1,,1,POINT (6170465 -7542726)
2018,Noviembre,Surinam,1,0,,1,POINT (7819 -72453013)
2018,Noviembre,Tailandia,1,0,,1,POINT (0.81488 -77356)
2018,Noviembre,Tailandia,7,1,,8,POINT (10446304 -75516486)
2018,Noviembre,Tailandia,17,11,,28,POINT (4697157 -74140516)
2018,Noviembre,Tailandia,3,5,,8,POINT (6170465 -7542726)
2018,Noviembre,Tanzania,2,3,,5,POINT (4697157 -74140516)
2018,Noviembre,República Democrática de Timor Oriental,0,1,,1,POINT (4697157 -74140516)
2018,Noviembre,República Democrática de Timor Oriental,0,1,,1,POINT (6170465 -7542726)
2018,Noviembre,Togo,0,1,,1,POINT (4697157 -74140516)
2018,Noviembre,Tonga,1,0,,1,POINT (4697157 -74140516)
2018,Noviembre,Trinidad y Tobago,2,20,,22,POINT (10446304 -75516486)
2018,Noviembre,Trinidad y Tobago,1,2,,3,POINT (10886686 -74776479)
2018,Noviembre,Trinidad y Tobago,6,0,,6,POINT (125862 -81702165)
2018,Noviembre,Trinidad y Tobago,5,5,,10,POINT (3451668 -76532004)
2018,Noviembre,Trinidad y Tobago,33,50,,83,POINT (4697157 -74140516)
2018,Noviembre,Trinidad y Tobago,0,6,,6,POINT (4815189 -75736374)
2018,Noviembre,Trinidad y Tobago,8,26,,34,POINT (6170465 -7542726)
2018,Noviembre,Trinidad y Tobago,1,0,,1,POINT (7128047 -73181317)
2018,Noviembre,Trinidad y Tobago,0,1,,1,POINT (7819 -72453013)
2018,Noviembre,Túnez,1,9,,10,POINT (4697157 -74140516)
2018,Noviembre,Turquía,0,2,,2,POINT (0.81488 -77356)
2018,Noviembre,Turquía,8,16,,24,POINT (10446304 -75516486)
2018,Noviembre,Turquía,0,1,,1,POINT (10886686 -74776479)
2018,Noviembre,Turquía,0,5,,5,POINT (3451668 -76532004)
2018,Noviembre,Turquía,187,394,,581,POINT (4697157 -74140516)
2018,Noviembre,Turquía,7,17,,24,POINT (6170465 -7542726)
2018,Noviembre,Ucrania,1,11,,12,POINT (10406342 -75527794)
2018,Noviembre,Ucrania,2,30,,32,POINT (10446304 -75516486)
2018,Noviembre,Ucrania,0,16,,16,POINT (10886686 -74776479)
2018,Noviembre,Ucrania,0,8,,8,POINT (10970933 -74765343)
2018,Noviembre,Ucrania,0,1,,1,POINT (11247723 -74213989)
2018,Noviembre,Ucrania,0,4,,4,POINT (3451668 -76532004)
2018,Noviembre,Ucrania,0,2,,2,POINT (3884426 -77061029)
2018,Noviembre,Ucrania,41,22,,63,POINT (4697157 -74140516)
2018,Noviembre,Ucrania,8,6,,14,POINT (6170465 -7542726)
2018,Noviembre,Ucrania,0,1,,1,POINT (863337 -7735002)
2018,Noviembre,Ucrania,0,2,,2,POINT (9402597 -75681642)
2018,Noviembre,Uganda,0,1,,1,POINT (0.81488 -77356)
2018,Noviembre,Uganda,1,1,,2,POINT (10446304 -75516486)
2018,Noviembre,Uganda,0,1,,1,POINT (4697157 -74140516)
2018,Noviembre,Uruguay,3,6,,9,POINT (0.81488 -77356)
2018,Noviembre,Uruguay,25,11,,36,POINT (10406342 -75527794)
2018,Noviembre,Uruguay,148,99,,247,POINT (10446304 -75516486)
2018,Noviembre,Uruguay,3,5,,8,POINT (10886686 -74776479)
2018,Noviembre,Uruguay,1,1,,2,POINT (11360029 -72129595)
2018,Noviembre,Uruguay,16,12,,28,POINT (125862 -81702165)
2018,Noviembre,Uruguay,4,18,,22,POINT (3451668 -76532004)
2018,Noviembre,Uruguay,1,2,,3,POINT (445285 -75766353)
2018,Noviembre,Uruguay,411,570,,981,POINT (4697157 -74140516)
2018,Noviembre,Uruguay,40,66,,106,POINT (6170465 -7542726)
2018,Noviembre,Uruguay,0,1,,1,POINT (7088729 -70740253)
2018,Noviembre,Uruguay,1,7,,8,POINT (7819 -72453013)
2018,Noviembre,Uruguay,2,0,,2,POINT (836068 -72409396)
2018,Noviembre,Uzbekistán,0,1,,1,POINT (4697157 -74140516)
2018,Noviembre,Venezuela,4,6,,10,POINT (-4191162 -69941498)
2018,Noviembre,Venezuela,1,1,,2,POINT (-4214082 -69941431)
2018,Noviembre,Venezuela,98,83,,181,POINT (0.33002 -76876446)
2018,Noviembre,Venezuela,3,0,,3,POINT (0.812436 -77847006)
2018,Noviembre,Venezuela,4814,5704,,10518,POINT (0.81488 -77356)
2018,Noviembre,Venezuela,5,2,,7,POINT (1800143 -78802679)
2018,Noviembre,Venezuela,19,37,,56,POINT (10406342 -75527794)
2018,Noviembre,Venezuela,231,249,,480,POINT (10446304 -75516486)
2018,Noviembre,Venezuela,104,171,,275,POINT (10886686 -74776479)
2018,Noviembre,Venezuela,0,3,,3,POINT (10970933 -74765343)
2018,Noviembre,Venezuela,1,7,,8,POINT (11117206 -74232675)
2018,Noviembre,Venezuela,0,1,,1,POINT (11247723 -74213989)
2018,Noviembre,Venezuela,6182,5413,,11595,POINT (11360029 -72129595)
2018,Noviembre,Venezuela,0,1,,1,POINT (1152863 -72919186)
2018,Noviembre,Venezuela,0,1,,1,POINT (125744111 -81703935)
2018,Noviembre,Venezuela,9,5,,14,POINT (125862 -81702165)
2018,Noviembre,Venezuela,100,130,,230,POINT (3451668 -76532004)
2018,Noviembre,Venezuela,31,16,,47,POINT (3866713 -67927521)
2018,Noviembre,Venezuela,1,0,,1,POINT (445285 -75766353)
2018,Noviembre,Venezuela,7314,7513,,14827,POINT (4697157 -74140516)
2018,Noviembre,Venezuela,8,14,,22,POINT (4815189 -75736374)
2018,Noviembre,Venezuela,911,927,,1838,POINT (6170465 -7542726)
2018,Noviembre,Venezuela,63,48,,111,POINT (6185536 -67484028)
2018,Noviembre,Venezuela,1078,1011,,2089,POINT (7088729 -70740253)
2018,Noviembre,Venezuela,19,26,,45,POINT (7128047 -73181317)
2018,Noviembre,Venezuela,24218,19495,,43713,POINT (7819 -72453013)
2018,Noviembre,Venezuela,1,6,,7,POINT (7927233 -72508188)
2018,Noviembre,Venezuela,3083,2265,,5348,POINT (836068 -72409396)
2018,Noviembre,Vietnam,1,0,,1,POINT (10886686 -74776479)
2018,Noviembre,Vietnam,7,6,,13,POINT (4697157 -74140516)
2018,Noviembre,República Árabe de Yemen,0,1,,1,POINT (10446304 -75516486)
2018,Noviembre,República Árabe de Yemen,0,1,,1,POINT (4697157 -74140516)
2018,Noviembre,Zambia,0,1,,1,POINT (10446304 -75516486)
2018,Noviembre,Zimbabue,2,0,,2,POINT (10446304 -75516486)
2018,Noviembre,Zimbabue,0,1,,1,POINT (3451668 -76532004)
2018,Noviembre,Zimbabue,0,2,,2,POINT (4697157 -74140516)
2018,Noviembre,Zimbabue,0,1,,1,POINT (6170465 -7542726)
2018,Noviembre,Refugiado,1,5,,6,POINT (4697157 -74140516)
2018,Noviembre,Refugiado,1,0,,1,POINT (6170465 -7542726)
2018,Noviembre,Desconocido,1,0,,1,POINT (0.81488 -77356)
2018,Noviembre,Desconocido,1,5,,6,POINT (10446304 -75516486)
2018,Noviembre,Desconocido,1,1,,2,POINT (125862 -81702165)
2018,Noviembre,Desconocido,3,3,,6,POINT (3451668 -76532004)
2018,Noviembre,Desconocido,105,178,,283,POINT (4697157 -74140516)
2018,Noviembre,Desconocido,1,4,,5,POINT (6170465 -7542726)
2018,Noviembre,Desconocido,1,0,,1,POINT (7088729 -70740253)
2018,Noviembre,Desconocido,1,0,,1,POINT (7819 -72453013)
2018,Noviembre,Desconocido,0,1,,1,POINT (4697157 -74140516)
2018,Diciembre,Albania,0,1,,1,POINT (3451668 -76532004)
2018,Diciembre,Albania,4,4,,8,POINT (4697157 -74140516)
2018,Diciembre,Alemania,7,6,,13,POINT (-4191162 -69941498)
2018,Diciembre,Alemania,8,15,,23,POINT (-4214082 -69941431)
2018,Diciembre,Alemania,4,7,,11,POINT (0.33002 -76876446)
2018,Diciembre,Alemania,70,69,,139,POINT (0.81488 -77356)
2018,Diciembre,Alemania,34,48,,82,POINT (10406342 -75527794)
2018,Diciembre,Alemania,192,320,,512,POINT (10446304 -75516486)
2018,Diciembre,Alemania,30,50,,80,POINT (10886686 -74776479)
2018,Diciembre,Alemania,2,3,,5,POINT (11117206 -74232675)
2018,Diciembre,Alemania,3,1,,4,POINT (11247723 -74213989)
2018,Diciembre,Alemania,1,2,,3,POINT (11360029 -72129595)
2018,Diciembre,Alemania,7,14,,21,POINT (125862 -81702165)
2018,Diciembre,Alemania,1,0,,1,POINT (133387613 -81372937)
2018,Diciembre,Alemania,77,136,,213,POINT (3451668 -76532004)
2018,Diciembre,Alemania,0,1,,1,POINT (445285 -75766353)
2018,Diciembre,Alemania,2935,4139,,7074,POINT (4697157 -74140516)
2018,Diciembre,Alemania,5,16,,21,POINT (4815189 -75736374)
2018,Diciembre,Alemania,172,317,,489,POINT (6170465 -7542726)
2018,Diciembre,Alemania,1,0,,1,POINT (6222552 -77401154)
2018,Diciembre,Alemania,1,2,,3,POINT (7128047 -73181317)
2018,Diciembre,Alemania,3,11,,14,POINT (7819 -72453013)
2018,Diciembre,Alemania,0,1,,1,POINT (806667 -767333)
2018,Diciembre,Alemania,3,2,,5,POINT (836068 -72409396)
2018,Diciembre,Alemania,12,18,,30,POINT (863337 -7735002)
2018,Diciembre,Andorra,0,1,,1,POINT (10446304 -75516486)
2018,Diciembre,Andorra,2,1,,3,POINT (4697157 -74140516)
2018,Diciembre,Angola,2,1,,3,POINT (10446304 -75516486)
2018,Diciembre,Angola,0,2,,2,POINT (4697157 -74140516)
2018,Diciembre,Antigua y Barbuda,0,1,,1,POINT (11360029 -72129595)
2018,Diciembre,Antigua y Barbuda,0,1,,1,POINT (4697157 -74140516)
2018,Diciembre,Antigua y Barbuda,0,2,,2,POINT (6170465 -7542726)
2018,Diciembre,Antigua y Barbuda,0,1,,1,POINT (7819 -72453013)
2018,Diciembre,Arabia Saudita,0,1,,1,POINT (10446304 -75516486)
2018,Diciembre,Arabia Saudita,1,15,,16,POINT (4697157 -74140516)
2018,Diciembre,Argelia,0,1,,1,POINT (10446304 -75516486)
2018,Diciembre,Argelia,2,9,,11,POINT (4697157 -74140516)
2018,Diciembre,Argelia,1,1,,2,POINT (6170465 -7542726)
2018,Diciembre,Argentina,3,8,,11,POINT (-4191162 -69941498)
2018,Diciembre,Argentina,4,3,,7,POINT (-4214082 -69941431)
2018,Diciembre,Argentina,4,7,,11,POINT (0.33002 -76876446)
2018,Diciembre,Argentina,114,157,,271,POINT (0.81488 -77356)
2018,Diciembre,Argentina,0,1,,1,POINT (1800143 -78802679)
2018,Diciembre,Argentina,115,70,,185,POINT (10406342 -75527794)
2018,Diciembre,Argentina,1335,1148,,2483,POINT (10446304 -75516486)
2018,Diciembre,Argentina,18,35,,53,POINT (10886686 -74776479)
2018,Diciembre,Argentina,0,1,,1,POINT (11117206 -74232675)
2018,Diciembre,Argentina,3,3,,6,POINT (11360029 -72129595)
2018,Diciembre,Argentina,247,230,,477,POINT (125862 -81702165)
2018,Diciembre,Argentina,90,106,,196,POINT (3451668 -76532004)
2018,Diciembre,Argentina,0,1,,1,POINT (445285 -75766353)
2018,Diciembre,Argentina,2956,4242,,7198,POINT (4697157 -74140516)
2018,Diciembre,Argentina,2,14,,16,POINT (4815189 -75736374)
2018,Diciembre,Argentina,278,455,,733,POINT (6170465 -7542726)
2018,Diciembre,Argentina,1,0,,1,POINT (6185536 -67484028)
2018,Diciembre,Argentina,0,2,,2,POINT (6218835 -75586989)
2018,Diciembre,Argentina,1,1,,2,POINT (7128047 -73181317)
2018,Diciembre,Argentina,4,6,,10,POINT (7819 -72453013)
2018,Diciembre,Argentina,4,4,,8,POINT (836068 -72409396)
2018,Diciembre,Argentina,1,4,,5,POINT (863337 -7735002)
2018,Diciembre,República de Armenia,1,1,,2,POINT (4697157 -74140516)
2018,Diciembre,Australia,0,1,,1,POINT (-4191162 -69941498)
2018,Diciembre,Australia,4,2,,6,POINT (-4214082 -69941431)
2018,Diciembre,Australia,10,19,,29,POINT (0.81488 -77356)
2018,Diciembre,Australia,30,26,,56,POINT (10406342 -75527794)
2018,Diciembre,Australia,97,154,,251,POINT (10446304 -75516486)
2018,Diciembre,Australia,4,11,,15,POINT (10886686 -74776479)
2018,Diciembre,Australia,1,0,,1,POINT (11117206 -74232675)
2018,Diciembre,Australia,3,3,,6,POINT (11247723 -74213989)
2018,Diciembre,Australia,1,0,,1,POINT (11360029 -72129595)
2018,Diciembre,Australia,1,0,,1,POINT (125862 -81702165)
2018,Diciembre,Australia,0,1,,1,POINT (133387613 -81372937)
2018,Diciembre,Australia,24,37,,61,POINT (3451668 -76532004)
2018,Diciembre,Australia,635,1081,,1716,POINT (4697157 -74140516)
2018,Diciembre,Australia,1,5,,6,POINT (4815189 -75736374)
2018,Diciembre,Australia,80,170,,250,POINT (6170465 -7542726)
2018,Diciembre,Australia,5,3,,8,POINT (7128047 -73181317)
2018,Diciembre,Australia,1,0,,1,POINT (7819 -72453013)
2018,Diciembre,Australia,15,28,,43,POINT (863337 -7735002)
2018,Diciembre,Austria,1,1,,2,POINT (-4191162 -69941498)
2018,Diciembre,Austria,1,2,,3,POINT (-4214082 -69941431)
2018,Diciembre,Austria,1,1,,2,POINT (0.33002 -76876446)
2018,Diciembre,Austria,7,6,,13,POINT (0.81488 -77356)
2018,Diciembre,Austria,7,4,,11,POINT (10406342 -75527794)
2018,Diciembre,Austria,21,26,,47,POINT (10446304 -75516486)
2018,Diciembre,Austria,2,3,,5,POINT (10886686 -74776479)
2018,Diciembre,Austria,2,0,,2,POINT (11117206 -74232675)
2018,Diciembre,Austria,1,1,,2,POINT (11247723 -74213989)
2018,Diciembre,Austria,1,1,,2,POINT (125862 -81702165)
2018,Diciembre,Austria,7,11,,18,POINT (3451668 -76532004)
2018,Diciembre,Austria,1,0,,1,POINT (445285 -75766353)
2018,Diciembre,Austria,302,425,,727,POINT (4697157 -74140516)
2018,Diciembre,Austria,0,1,,1,POINT (4815189 -75736374)
2018,Diciembre,Austria,21,47,,68,POINT (6170465 -7542726)
2018,Diciembre,Austria,0,1,,1,POINT (7128047 -73181317)
2018,Diciembre,Austria,1,1,,2,POINT (863337 -7735002)
2018,Diciembre,Azerbaiyán,2,2,,4,POINT (4697157 -74140516)
2018,Diciembre,Azerbaiyán,0,1,,1,POINT (6170465 -7542726)
2018,Diciembre,Bahamas,0,1,,1,POINT (10446304 -75516486)
2018,Diciembre,Bahamas,0,1,,1,POINT (10886686 -74776479)
2018,Diciembre,Bahamas,0,2,,2,POINT (3451668 -76532004)
2018,Diciembre,Bahamas,1,14,,15,POINT (4697157 -74140516)
2018,Diciembre,Bahamas,2,4,,6,POINT (6170465 -7542726)
2018,Diciembre,Bahréin,2,2,,4,POINT (4697157 -74140516)
2018,Diciembre,Bahréin,0,2,,2,POINT (6170465 -7542726)
2018,Diciembre,Bangladesh,0,1,,1,POINT (10446304 -75516486)
2018,Diciembre,Bangladesh,0,1,,1,POINT (10886686 -74776479)
2018,Diciembre,Barbados,3,2,,5,POINT (10446304 -75516486)
2018,Diciembre,Barbados,1,1,,2,POINT (3451668 -76532004)
2018,Diciembre,Barbados,9,8,,17,POINT (4697157 -74140516)
2018,Diciembre,Barbados,0,1,,1,POINT (4815189 -75736374)
2018,Diciembre,Barbados,1,2,,3,POINT (6170465 -7542726)
2018,Diciembre,República de Belarús,0,1,,1,POINT (10406342 -75527794)
2018,Diciembre,República de Belarús,3,2,,5,POINT (10446304 -75516486)
2018,Diciembre,República de Belarús,8,5,,13,POINT (4697157 -74140516)
2018,Diciembre,Bélgica,4,0,,4,POINT (-4191162 -69941498)
2018,Diciembre,Bélgica,0,1,,1,POINT (-4214082 -69941431)
2018,Diciembre,Bélgica,1,1,,2,POINT (0.33002 -76876446)
2018,Diciembre,Bélgica,9,10,,19,POINT (0.81488 -77356)
2018,Diciembre,Bélgica,2,2,,4,POINT (10406342 -75527794)
2018,Diciembre,Bélgica,41,61,,102,POINT (10446304 -75516486)
2018,Diciembre,Bélgica,4,12,,16,POINT (10886686 -74776479)
2018,Diciembre,Bélgica,0,1,,1,POINT (11360029 -72129595)
2018,Diciembre,Bélgica,1,2,,3,POINT (125862 -81702165)
2018,Diciembre,Bélgica,12,21,,33,POINT (3451668 -76532004)
2018,Diciembre,Bélgica,358,594,,952,POINT (4697157 -74140516)
2018,Diciembre,Bélgica,35,72,,107,POINT (6170465 -7542726)
2018,Diciembre,Bélgica,0,1,,1,POINT (7128047 -73181317)
2018,Diciembre,Bélgica,3,4,,7,POINT (863337 -7735002)
2018,Diciembre,Belice,2,1,,3,POINT (10446304 -75516486)
2018,Diciembre,Belice,0,1,,1,POINT (10886686 -74776479)
2018,Diciembre,Belice,1,0,,1,POINT (3451668 -76532004)
2018,Diciembre,Belice,7,7,,14,POINT (4697157 -74140516)
2018,Diciembre,Belice,0,2,,2,POINT (6170465 -7542726)
2018,Diciembre,Benín,0,1,,1,POINT (4697157 -74140516)
2018,Diciembre,Bermudas/Territorio Británico de Ultramar,1,0,,1,POINT (-4191162 -69941498)
2018,Diciembre,Bermudas/Territorio Británico de Ultramar,0,1,,1,POINT (10446304 -75516486)
2018,Diciembre,Bolivia,0,1,,1,POINT (-4214082 -69941431)
2018,Diciembre,Bolivia,27,27,,54,POINT (0.81488 -77356)
2018,Diciembre,Bolivia,21,19,,40,POINT (10406342 -75527794)
2018,Diciembre,Bolivia,118,95,,213,POINT (10446304 -75516486)
2018,Diciembre,Bolivia,23,16,,39,POINT (125862 -81702165)
2018,Diciembre,Bolivia,40,20,,60,POINT (3451668 -76532004)
2018,Diciembre,Bolivia,1084,989,,2073,POINT (4697157 -74140516)
2018,Diciembre,Bolivia,28,44,,72,POINT (6170465 -7542726)
2018,Diciembre,Bolivia,1,0,,1,POINT (6185536 -67484028)
2018,Diciembre,Bolivia,2,8,,10,POINT (7819 -72453013)
2018,Diciembre,Bolivia,0,2,,2,POINT (836068 -72409396)
2018,Diciembre,Bolivia,0,1,,1,POINT (863337 -7735002)
2018,Diciembre,Bosnia y Herzegovina,1,0,,1,POINT (0.81488 -77356)
2018,Diciembre,Bosnia y Herzegovina,0,1,,1,POINT (10446304 -75516486)
2018,Diciembre,Bosnia y Herzegovina,8,4,,12,POINT (4697157 -74140516)
2018,Diciembre,Botsuana,0,1,,1,POINT (4697157 -74140516)
2018,Diciembre,Brasil,138,117,,255,POINT (-4191162 -69941498)
2018,Diciembre,Brasil,2,6,,8,POINT (-4214082 -69941431)
2018,Diciembre,Brasil,1,1,,2,POINT (0.33002 -76876446)
2018,Diciembre,Brasil,21,33,,54,POINT (0.81488 -77356)
2018,Diciembre,Brasil,219,172,,391,POINT (10406342 -75527794)
2018,Diciembre,Brasil,871,709,,1580,POINT (10446304 -75516486)
2018,Diciembre,Brasil,20,130,,150,POINT (10886686 -74776479)
2018,Diciembre,Brasil,0,2,,2,POINT (11247723 -74213989)
2018,Diciembre,Brasil,4,6,,10,POINT (11360029 -72129595)
2018,Diciembre,Brasil,343,253,,596,POINT (125862 -81702165)
2018,Diciembre,Brasil,84,115,,199,POINT (3451668 -76532004)
2018,Diciembre,Brasil,6,3,,9,POINT (3866713 -67927521)
2018,Diciembre,Brasil,5999,6539,,12538,POINT (4697157 -74140516)
2018,Diciembre,Brasil,2,0,,2,POINT (4815189 -75736374)
2018,Diciembre,Brasil,165,224,,389,POINT (6170465 -7542726)
2018,Diciembre,Brasil,0,1,,1,POINT (6185536 -67484028)
2018,Diciembre,Brasil,3,3,,6,POINT (7088729 -70740253)
2018,Diciembre,Brasil,4,3,,7,POINT (7128047 -73181317)
2018,Diciembre,Brasil,4,5,,9,POINT (7819 -72453013)
2018,Diciembre,Brasil,2,1,,3,POINT (836068 -72409396)
2018,Diciembre,Brasil,0,1,,1,POINT (863337 -7735002)
2018,Diciembre,Brunei Darussalam,1,0,,1,POINT (4697157 -74140516)
2018,Diciembre,Bulgaria,0,2,,2,POINT (0.81488 -77356)
2018,Diciembre,Bulgaria,1,0,,1,POINT (10406342 -75527794)
2018,Diciembre,Bulgaria,5,8,,13,POINT (10446304 -75516486)
2018,Diciembre,Bulgaria,2,5,,7,POINT (3451668 -76532004)
2018,Diciembre,Bulgaria,54,54,,108,POINT (4697157 -74140516)
2018,Diciembre,Bulgaria,5,10,,15,POINT (6170465 -7542726)
2018,Diciembre,Bulgaria,0,2,,2,POINT (7819 -72453013)
2018,Diciembre,Burkina Faso,1,1,,2,POINT (4697157 -74140516)
2018,Diciembre,Bután,0,1,,1,POINT (3451668 -76532004)
2018,Diciembre,Bután,1,2,,3,POINT (4697157 -74140516)
2018,Diciembre,Cabo Verde,0,2,,2,POINT (4697157 -74140516)
2018,Diciembre,Islas Caimán/Territorio Británico de Ultramar,2,0,,2,POINT (11117206 -74232675)
2018,Diciembre,Islas Caimán/Territorio Británico de Ultramar,0,5,,5,POINT (125862 -81702165)
2018,Diciembre,Islas Caimán/Territorio Británico de Ultramar,0,1,,1,POINT (6170465 -7542726)
2018,Diciembre,Camboya,1,1,,2,POINT (4697157 -74140516)
2018,Diciembre,Camerún,0,1,,1,POINT (125862 -81702165)
2018,Diciembre,Canadá,1,4,,5,POINT (-4191162 -69941498)
2018,Diciembre,Canadá,1,5,,6,POINT (0.33002 -76876446)
2018,Diciembre,Canadá,14,21,,35,POINT (0.81488 -77356)
2018,Diciembre,Canadá,44,41,,85,POINT (10406342 -75527794)
2018,Diciembre,Canadá,638,848,,1486,POINT (10446304 -75516486)
2018,Diciembre,Canadá,35,69,,104,POINT (10886686 -74776479)
2018,Diciembre,Canadá,2,5,,7,POINT (11117206 -74232675)
2018,Diciembre,Canadá,3,3,,6,POINT (11247723 -74213989)
2018,Diciembre,Canadá,2,3,,5,POINT (11360029 -72129595)
2018,Diciembre,Canadá,1,1,,2,POINT (125744111 -81703935)
2018,Diciembre,Canadá,107,124,,231,POINT (125862 -81702165)
2018,Diciembre,Canadá,2,2,,4,POINT (133387613 -81372937)
2018,Diciembre,Canadá,106,150,,256,POINT (3451668 -76532004)
2018,Diciembre,Canadá,8,6,,14,POINT (445285 -75766353)
2018,Diciembre,Canadá,1995,3086,,5081,POINT (4697157 -74140516)
2018,Diciembre,Canadá,16,37,,53,POINT (4815189 -75736374)
2018,Diciembre,Canadá,273,572,,845,POINT (6170465 -7542726)
2018,Diciembre,Canadá,0,2,,2,POINT (6222552 -77401154)
2018,Diciembre,Canadá,14,18,,32,POINT (7128047 -73181317)
2018,Diciembre,Canadá,2,4,,6,POINT (7819 -72453013)
2018,Diciembre,Canadá,7,10,,17,POINT (863337 -7735002)
2018,Diciembre,Canadá,0,1,,1,POINT (9402597 -75681642)
2018,Diciembre,Comoras,0,1,,1,POINT (4697157 -74140516)
2018,Diciembre,República Democrática del Congo,0,3,,3,POINT (4697157 -74140516)
2018,Diciembre,República Democrática del Congo,1,1,,2,POINT (6170465 -7542726)
2018,Diciembre,República Democrática del Congo,0,1,,1,POINT (7819 -72453013)
2018,Diciembre,República de Corea,3,1,,4,POINT (-4191162 -69941498)
2018,Diciembre,República de Corea,10,8,,18,POINT (0.81488 -77356)
2018,Diciembre,República de Corea,1,0,,1,POINT (10406342 -75527794)
2018,Diciembre,República de Corea,18,22,,40,POINT (10446304 -75516486)
2018,Diciembre,República de Corea,0,1,,1,POINT (10886686 -74776479)
2018,Diciembre,República de Corea,0,1,,1,POINT (11247723 -74213989)
2018,Diciembre,República de Corea,0,1,,1,POINT (11360029 -72129595)
2018,Diciembre,República de Corea,1,0,,1,POINT (125862 -81702165)
2018,Diciembre,República de Corea,1,2,,3,POINT (3451668 -76532004)
2018,Diciembre,República de Corea,307,406,,713,POINT (4697157 -74140516)
2018,Diciembre,República de Corea,19,31,,50,POINT (6170465 -7542726)
2018,Diciembre,República de Corea,0,1,,1,POINT (7128047 -73181317)
2018,Diciembre,República de Corea,2,1,,3,POINT (7819 -72453013)
2018,Diciembre,Costa de Marfil,0,1,,1,POINT (10446304 -75516486)
2018,Diciembre,Costa Rica,1,0,,1,POINT (-4191162 -69941498)
2018,Diciembre,Costa Rica,0,1,,1,POINT (0.33002 -76876446)
2018,Diciembre,Costa Rica,1,5,,6,POINT (0.81488 -77356)
2018,Diciembre,Costa Rica,4,5,,9,POINT (10406342 -75527794)
2018,Diciembre,Costa Rica,304,217,,521,POINT (10446304 -75516486)
2018,Diciembre,Costa Rica,34,34,,68,POINT (10886686 -74776479)
2018,Diciembre,Costa Rica,0,5,,5,POINT (11117206 -74232675)
2018,Diciembre,Costa Rica,1,0,,1,POINT (11360029 -72129595)
2018,Diciembre,Costa Rica,0,1,,1,POINT (125744111 -81703935)
2018,Diciembre,Costa Rica,52,35,,87,POINT (125862 -81702165)
2018,Diciembre,Costa Rica,61,80,,141,POINT (3451668 -76532004)
2018,Diciembre,Costa Rica,0,1,,1,POINT (445285 -75766353)
2018,Diciembre,Costa Rica,1573,1779,,3352,POINT (4697157 -74140516)
2018,Diciembre,Costa Rica,19,13,,32,POINT (4815189 -75736374)
2018,Diciembre,Costa Rica,198,249,,447,POINT (6170465 -7542726)
2018,Diciembre,Costa Rica,6,4,,10,POINT (7128047 -73181317)
2018,Diciembre,Costa Rica,2,5,,7,POINT (7819 -72453013)
2018,Diciembre,Costa Rica,0,2,,2,POINT (863337 -7735002)
2018,Diciembre,Croacia,0,1,,1,POINT (-4214082 -69941431)
2018,Diciembre,Croacia,0,1,,1,POINT (0.81488 -77356)
2018,Diciembre,Croacia,0,4,,4,POINT (10406342 -75527794)
2018,Diciembre,Croacia,7,12,,19,POINT (10446304 -75516486)
2018,Diciembre,Croacia,0,2,,2,POINT (10886686 -74776479)
2018,Diciembre,Croacia,1,0,,1,POINT (11117206 -74232675)
2018,Diciembre,Croacia,0,1,,1,POINT (11247723 -74213989)
2018,Diciembre,Croacia,1,1,,2,POINT (3451668 -76532004)
2018,Diciembre,Croacia,32,64,,96,POINT (4697157 -74140516)
2018,Diciembre,Croacia,4,12,,16,POINT (6170465 -7542726)
2018,Diciembre,Cuba,2,0,,2,POINT (-4191162 -69941498)
2018,Diciembre,Cuba,2,3,,5,POINT (0.81488 -77356)
2018,Diciembre,Cuba,0,4,,4,POINT (10406342 -75527794)
2018,Diciembre,Cuba,15,39,,54,POINT (10446304 -75516486)
2018,Diciembre,Cuba,4,10,,14,POINT (10886686 -74776479)
2018,Diciembre,Cuba,1,2,,3,POINT (11117206 -74232675)
2018,Diciembre,Cuba,0,1,,1,POINT (125744111 -81703935)
2018,Diciembre,Cuba,22,42,,64,POINT (3451668 -76532004)
2018,Diciembre,Cuba,0,2,,2,POINT (445285 -75766353)
2018,Diciembre,Cuba,291,349,,640,POINT (4697157 -74140516)
2018,Diciembre,Cuba,1,3,,4,POINT (4815189 -75736374)
2018,Diciembre,Cuba,16,30,,46,POINT (6170465 -7542726)
2018,Diciembre,Cuba,1,3,,4,POINT (7128047 -73181317)
2018,Diciembre,Cuba,1,1,,2,POINT (7819 -72453013)
2018,Diciembre,República Checa,1,1,,2,POINT (-4191162 -69941498)
2018,Diciembre,República Checa,0,1,,1,POINT (-4214082 -69941431)
2018,Diciembre,República Checa,2,2,,4,POINT (0.81488 -77356)
2018,Diciembre,República Checa,1,1,,2,POINT (10406342 -75527794)
2018,Diciembre,República Checa,5,13,,18,POINT (10446304 -75516486)
2018,Diciembre,República Checa,0,1,,1,POINT (10886686 -74776479)
2018,Diciembre,República Checa,4,5,,9,POINT (3451668 -76532004)
2018,Diciembre,República Checa,91,117,,208,POINT (4697157 -74140516)
2018,Diciembre,República Checa,6,9,,15,POINT (6170465 -7542726)
2018,Diciembre,República Checa,1,0,,1,POINT (7819 -72453013)
2018,Diciembre,Chile,0,2,,2,POINT (-4214082 -69941431)
2018,Diciembre,Chile,3,3,,6,POINT (0.33002 -76876446)
2018,Diciembre,Chile,97,125,,222,POINT (0.81488 -77356)
2018,Diciembre,Chile,0,1,,1,POINT (1800143 -78802679)
2018,Diciembre,Chile,85,58,,143,POINT (10406342 -75527794)
2018,Diciembre,Chile,444,348,,792,POINT (10446304 -75516486)
2018,Diciembre,Chile,8,16,,24,POINT (10886686 -74776479)
2018,Diciembre,Chile,3,3,,6,POINT (11360029 -72129595)
2018,Diciembre,Chile,116,90,,206,POINT (125862 -81702165)
2018,Diciembre,Chile,144,141,,285,POINT (3451668 -76532004)
2018,Diciembre,Chile,2991,4367,,7358,POINT (4697157 -74140516)
2018,Diciembre,Chile,7,7,,14,POINT (4815189 -75736374)
2018,Diciembre,Chile,104,231,,335,POINT (6170465 -7542726)
2018,Diciembre,Chile,0,1,,1,POINT (7088729 -70740253)
2018,Diciembre,Chile,2,4,,6,POINT (7128047 -73181317)
2018,Diciembre,Chile,21,29,,50,POINT (7819 -72453013)
2018,Diciembre,Chile,1,12,,13,POINT (836068 -72409396)
2018,Diciembre,Chile,2,0,,2,POINT (863337 -7735002)
2018,Diciembre,China,1,1,,2,POINT (-4191162 -69941498)
2018,Diciembre,China,8,20,,28,POINT (0.81488 -77356)
2018,Diciembre,China,6,10,,16,POINT (10406342 -75527794)
2018,Diciembre,China,35,29,,64,POINT (10446304 -75516486)
2018,Diciembre,China,2,7,,9,POINT (10886686 -74776479)
2018,Diciembre,China,0,2,,2,POINT (10970933 -74765343)
2018,Diciembre,China,1,0,,1,POINT (11117206 -74232675)
2018,Diciembre,China,0,4,,4,POINT (11247723 -74213989)
2018,Diciembre,China,0,3,,3,POINT (11360029 -72129595)
2018,Diciembre,China,17,10,,27,POINT (3451668 -76532004)
2018,Diciembre,China,0,1,,1,POINT (3884426 -77061029)
2018,Diciembre,China,412,722,,1134,POINT (4697157 -74140516)
2018,Diciembre,China,0,1,,1,POINT (4815189 -75736374)
2018,Diciembre,China,37,54,,91,POINT (6170465 -7542726)
2018,Diciembre,China,3,8,,11,POINT (7819 -72453013)
2018,Diciembre,China,1,1,,2,POINT (836068 -72409396)
2018,Diciembre,China,0,1,,1,POINT (863337 -7735002)
2018,Diciembre,Taiwán,2,3,,5,POINT (10446304 -75516486)
2018,Diciembre,Taiwán,70,54,,124,POINT (4697157 -74140516)
2018,Diciembre,Taiwán,4,5,,9,POINT (6170465 -7542726)
2018,Diciembre,Taiwán,0,1,,1,POINT (7128047 -73181317)
2018,Diciembre,Taiwán,1,2,,3,POINT (7819 -72453013)
2018,Diciembre,Chipre,1,0,,1,POINT (-4191162 -69941498)
2018,Diciembre,Chipre,5,9,,14,POINT (4697157 -74140516)
2018,Diciembre,Chipre,0,1,,1,POINT (6170465 -7542726)
2018,Diciembre,Dinamarca,2,1,,3,POINT (-4214082 -69941431)
2018,Diciembre,Dinamarca,1,5,,6,POINT (0.81488 -77356)
2018,Diciembre,Dinamarca,2,5,,7,POINT (10406342 -75527794)
2018,Diciembre,Dinamarca,27,26,,53,POINT (10446304 -75516486)
2018,Diciembre,Dinamarca,3,7,,10,POINT (10886686 -74776479)
2018,Diciembre,Dinamarca,1,0,,1,POINT (11360029 -72129595)
2018,Diciembre,Dinamarca,3,11,,14,POINT (3451668 -76532004)
2018,Diciembre,Dinamarca,158,242,,400,POINT (4697157 -74140516)
2018,Diciembre,Dinamarca,2,3,,5,POINT (4815189 -75736374)
2018,Diciembre,Dinamarca,21,22,,43,POINT (6170465 -7542726)
2018,Diciembre,Dinamarca,1,1,,2,POINT (7128047 -73181317)
2018,Diciembre,Dinamarca,1,1,,2,POINT (863337 -7735002)
2018,Diciembre,Dominica,2,4,,6,POINT (4697157 -74140516)
2018,Diciembre,Dominica,0,1,,1,POINT (6170465 -7542726)
2018,Diciembre,Dominica,0,1,,1,POINT (7819 -72453013)
2018,Diciembre,Ecuador,0,1,,1,POINT (-4191162 -69941498)
2018,Diciembre,Ecuador,1,0,,1,POINT (-4214082 -69941431)
2018,Diciembre,Ecuador,129,305,,434,POINT (0.33002 -76876446)
2018,Diciembre,Ecuador,4,2,,6,POINT (0.812436 -77847006)
2018,Diciembre,Ecuador,2349,3332,,5681,POINT (0.81488 -77356)
2018,Diciembre,Ecuador,43,33,,76,POINT (1800143 -78802679)
2018,Diciembre,Ecuador,3,19,,22,POINT (10406342 -75527794)
2018,Diciembre,Ecuador,47,42,,89,POINT (10446304 -75516486)
2018,Diciembre,Ecuador,5,8,,13,POINT (10886686 -74776479)
2018,Diciembre,Ecuador,1,0,,1,POINT (11117206 -74232675)
2018,Diciembre,Ecuador,3,12,,15,POINT (11360029 -72129595)
2018,Diciembre,Ecuador,23,14,,37,POINT (125862 -81702165)
2018,Diciembre,Ecuador,481,562,,1043,POINT (3451668 -76532004)
2018,Diciembre,Ecuador,4,3,,7,POINT (3866713 -67927521)
2018,Diciembre,Ecuador,0,3,,3,POINT (445285 -75766353)
2018,Diciembre,Ecuador,3432,3973,,7405,POINT (4697157 -74140516)
2018,Diciembre,Ecuador,2,3,,5,POINT (4815189 -75736374)
2018,Diciembre,Ecuador,60,87,,147,POINT (6170465 -7542726)
2018,Diciembre,Ecuador,109,144,,253,POINT (7819 -72453013)
2018,Diciembre,Ecuador,2,5,,7,POINT (836068 -72409396)
2018,Diciembre,Egipto,0,1,,1,POINT (0.81488 -77356)
2018,Diciembre,Egipto,1,3,,4,POINT (10446304 -75516486)
2018,Diciembre,Egipto,0,1,,1,POINT (10886686 -74776479)
2018,Diciembre,Egipto,7,23,,30,POINT (4697157 -74140516)
2018,Diciembre,Egipto,0,1,,1,POINT (6170465 -7542726)
2018,Diciembre,El Salvador,1,2,,3,POINT (0.81488 -77356)
2018,Diciembre,El Salvador,1,3,,4,POINT (10406342 -75527794)
2018,Diciembre,El Salvador,328,289,,617,POINT (10446304 -75516486)
2018,Diciembre,El Salvador,6,7,,13,POINT (10886686 -74776479)
2018,Diciembre,El Salvador,8,5,,13,POINT (125862 -81702165)
2018,Diciembre,El Salvador,86,106,,192,POINT (3451668 -76532004)
2018,Diciembre,El Salvador,0,1,,1,POINT (445285 -75766353)
2018,Diciembre,El Salvador,664,759,,1423,POINT (4697157 -74140516)
2018,Diciembre,El Salvador,0,3,,3,POINT (4815189 -75736374)
2018,Diciembre,El Salvador,28,35,,63,POINT (6170465 -7542726)
2018,Diciembre,El Salvador,2,4,,6,POINT (7819 -72453013)
2018,Diciembre,El Salvador,1,0,,1,POINT (836068 -72409396)
2018,Diciembre,Emiratos Árabes,0,1,,1,POINT (10446304 -75516486)
2018,Diciembre,Emiratos Árabes,4,8,,12,POINT (4697157 -74140516)
2018,Diciembre,Emiratos Árabes,0,3,,3,POINT (6170465 -7542726)
2018,Diciembre,España,5,3,,8,POINT (-4191162 -69941498)
2018,Diciembre,España,5,7,,12,POINT (-4214082 -69941431)
2018,Diciembre,España,2,2,,4,POINT (0.33002 -76876446)
2018,Diciembre,España,41,53,,94,POINT (0.81488 -77356)
2018,Diciembre,España,9,18,,27,POINT (10406342 -75527794)
2018,Diciembre,España,123,195,,318,POINT (10446304 -75516486)
2018,Diciembre,España,44,62,,106,POINT (10886686 -74776479)
2018,Diciembre,España,0,1,,1,POINT (10970933 -74765343)
2018,Diciembre,España,1,2,,3,POINT (11117206 -74232675)
2018,Diciembre,España,1,0,,1,POINT (11247723 -74213989)
2018,Diciembre,España,0,10,,10,POINT (11360029 -72129595)
2018,Diciembre,España,9,10,,19,POINT (125862 -81702165)
2018,Diciembre,España,433,617,,1050,POINT (3451668 -76532004)
2018,Diciembre,España,0,2,,2,POINT (445285 -75766353)
2018,Diciembre,España,3744,6251,,9995,POINT (4697157 -74140516)
2018,Diciembre,España,10,23,,33,POINT (4815189 -75736374)
2018,Diciembre,España,500,895,,1395,POINT (6170465 -7542726)
2018,Diciembre,España,2,1,,3,POINT (7088729 -70740253)
2018,Diciembre,España,0,1,,1,POINT (7128047 -73181317)
2018,Diciembre,España,28,50,,78,POINT (7819 -72453013)
2018,Diciembre,España,6,9,,15,POINT (836068 -72409396)
2018,Diciembre,España,3,4,,7,POINT (863337 -7735002)
2018,Diciembre,Eslovaquia,1,1,,2,POINT (-4214082 -69941431)
2018,Diciembre,Eslovaquia,1,2,,3,POINT (0.81488 -77356)
2018,Diciembre,Eslovaquia,0,2,,2,POINT (10406342 -75527794)
2018,Diciembre,Eslovaquia,2,4,,6,POINT (10446304 -75516486)
2018,Diciembre,Eslovaquia,0,1,,1,POINT (3451668 -76532004)
2018,Diciembre,Eslovaquia,43,49,,92,POINT (4697157 -74140516)
2018,Diciembre,Eslovaquia,4,5,,9,POINT (6170465 -7542726)
2018,Diciembre,Eslovaquia,1,2,,3,POINT (863337 -7735002)
2018,Diciembre,Eslovenia,1,1,,2,POINT (0.81488 -77356)
2018,Diciembre,Eslovenia,0,1,,1,POINT (10446304 -75516486)
2018,Diciembre,Eslovenia,2,0,,2,POINT (3451668 -76532004)
2018,Diciembre,Eslovenia,29,45,,74,POINT (4697157 -74140516)
2018,Diciembre,Eslovenia,1,7,,8,POINT (6170465 -7542726)
2018,Diciembre,Eslovenia,0,1,,1,POINT (7819 -72453013)
2018,Diciembre,Estados Unidos de América,11,15,,26,POINT (-4191162 -69941498)
2018,Diciembre,Estados Unidos de América,1,5,,6,POINT (-4214082 -69941431)
2018,Diciembre,Estados Unidos de América,1,2,,3,POINT (0.33002 -76876446)
2018,Diciembre,Estados Unidos de América,34,78,,112,POINT (0.81488 -77356)
2018,Diciembre,Estados Unidos de América,71,119,,190,POINT (10406342 -75527794)
2018,Diciembre,Estados Unidos de América,6094,8070,,14164,POINT (10446304 -75516486)
2018,Diciembre,Estados Unidos de América,983,1578,,2561,POINT (10886686 -74776479)
2018,Diciembre,Estados Unidos de América,0,4,,4,POINT (10970933 -74765343)
2018,Diciembre,Estados Unidos de América,75,109,,184,POINT (11117206 -74232675)
2018,Diciembre,Estados Unidos de América,23,27,,50,POINT (11247723 -74213989)
2018,Diciembre,Estados Unidos de América,1,2,,3,POINT (11360029 -72129595)
2018,Diciembre,Estados Unidos de América,3,11,,14,POINT (125744111 -81703935)
2018,Diciembre,Estados Unidos de América,67,96,,163,POINT (125862 -81702165)
2018,Diciembre,Estados Unidos de América,2,2,,4,POINT (133387613 -81372937)
2018,Diciembre,Estados Unidos de América,2042,2976,,5018,POINT (3451668 -76532004)
2018,Diciembre,Estados Unidos de América,151,230,,381,POINT (445285 -75766353)
2018,Diciembre,Estados Unidos de América,13576,22138,,35714,POINT (4697157 -74140516)
2018,Diciembre,Estados Unidos de América,445,627,,1072,POINT (4815189 -75736374)
2018,Diciembre,Estados Unidos de América,4493,8514,,13007,POINT (6170465 -7542726)
2018,Diciembre,Estados Unidos de América,2,1,,3,POINT (6222552 -77401154)
2018,Diciembre,Estados Unidos de América,60,93,,153,POINT (7128047 -73181317)
2018,Diciembre,Estados Unidos de América,16,16,,32,POINT (7819 -72453013)
2018,Diciembre,Estados Unidos de América,8,5,,13,POINT (836068 -72409396)
2018,Diciembre,Estados Unidos de América,12,9,,21,POINT (863337 -7735002)
2018,Diciembre,Estonia,1,0,,1,POINT (0.81488 -77356)
2018,Diciembre,Estonia,0,1,,1,POINT (10406342 -75527794)
2018,Diciembre,Estonia,5,2,,7,POINT (10446304 -75516486)
2018,Diciembre,Estonia,22,25,,47,POINT (4697157 -74140516)
2018,Diciembre,Estonia,2,4,,6,POINT (6170465 -7542726)
2018,Diciembre,Estonia,1,1,,2,POINT (9402597 -75681642)
2018,Diciembre,Etiopia,4,30,,34,POINT (4697157 -74140516)
2018,Diciembre,Islas Fiji,0,1,,1,POINT (4697157 -74140516)
2018,Diciembre,Filipinas,1,1,,2,POINT (0.81488 -77356)
2018,Diciembre,Filipinas,2,37,,39,POINT (10406342 -75527794)
2018,Diciembre,Filipinas,9,65,,74,POINT (10446304 -75516486)
2018,Diciembre,Filipinas,2,1,,3,POINT (10886686 -74776479)
2018,Diciembre,Filipinas,0,10,,10,POINT (10970933 -74765343)
2018,Diciembre,Filipinas,0,5,,5,POINT (11247723 -74213989)
2018,Diciembre,Filipinas,1,0,,1,POINT (125862 -81702165)
2018,Diciembre,Filipinas,3,1,,4,POINT (3451668 -76532004)
2018,Diciembre,Filipinas,0,11,,11,POINT (3884426 -77061029)
2018,Diciembre,Filipinas,49,35,,84,POINT (4697157 -74140516)
2018,Diciembre,Filipinas,1,3,,4,POINT (6170465 -7542726)
2018,Diciembre,Filipinas,1,0,,1,POINT (7819 -72453013)
2018,Diciembre,Filipinas,1,0,,1,POINT (836068 -72409396)
2018,Diciembre,Filipinas,0,3,,3,POINT (9402597 -75681642)
2018,Diciembre,Finlandia,2,3,,5,POINT (0.81488 -77356)
2018,Diciembre,Finlandia,2,1,,3,POINT (10406342 -75527794)
2018,Diciembre,Finlandia,19,22,,41,POINT (10446304 -75516486)
2018,Diciembre,Finlandia,3,5,,8,POINT (10886686 -74776479)
2018,Diciembre,Finlandia,0,1,,1,POINT (11117206 -74232675)
2018,Diciembre,Finlandia,3,2,,5,POINT (125862 -81702165)
2018,Diciembre,Finlandia,4,9,,13,POINT (3451668 -76532004)
2018,Diciembre,Finlandia,88,118,,206,POINT (4697157 -74140516)
2018,Diciembre,Finlandia,8,18,,26,POINT (6170465 -7542726)
2018,Diciembre,Finlandia,3,4,,7,POINT (7128047 -73181317)
2018,Diciembre,Francia,10,16,,26,POINT (-4191162 -69941498)
2018,Diciembre,Francia,6,9,,15,POINT (-4214082 -69941431)
2018,Diciembre,Francia,3,9,,12,POINT (0.33002 -76876446)
2018,Diciembre,Francia,83,96,,179,POINT (0.81488 -77356)
2018,Diciembre,Francia,11,19,,30,POINT (10406342 -75527794)
2018,Diciembre,Francia,225,347,,572,POINT (10446304 -75516486)
2018,Diciembre,Francia,26,57,,83,POINT (10886686 -74776479)
2018,Diciembre,Francia,1,2,,3,POINT (10970933 -74765343)
2018,Diciembre,Francia,3,3,,6,POINT (11117206 -74232675)
2018,Diciembre,Francia,9,7,,16,POINT (11247723 -74213989)
2018,Diciembre,Francia,0,4,,4,POINT (11360029 -72129595)
2018,Diciembre,Francia,2,11,,13,POINT (125862 -81702165)
2018,Diciembre,Francia,3,5,,8,POINT (133387613 -81372937)
2018,Diciembre,Francia,79,141,,220,POINT (3451668 -76532004)
2018,Diciembre,Francia,0,1,,1,POINT (445285 -75766353)
2018,Diciembre,Francia,2747,3926,,6673,POINT (4697157 -74140516)
2018,Diciembre,Francia,11,14,,25,POINT (4815189 -75736374)
2018,Diciembre,Francia,208,398,,606,POINT (6170465 -7542726)
2018,Diciembre,Francia,0,2,,2,POINT (7128047 -73181317)
2018,Diciembre,Francia,1,4,,5,POINT (7819 -72453013)
2018,Diciembre,Francia,2,2,,4,POINT (836068 -72409396)
2018,Diciembre,Francia,4,7,,11,POINT (863337 -7735002)
2018,Diciembre,Georgia,0,2,,2,POINT (10446304 -75516486)
2018,Diciembre,Georgia,1,0,,1,POINT (3451668 -76532004)
2018,Diciembre,Georgia,2,2,,4,POINT (4697157 -74140516)
2018,Diciembre,Georgia,0,1,,1,POINT (9402597 -75681642)
2018,Diciembre,Ghana,0,4,,4,POINT (0.81488 -77356)
2018,Diciembre,Ghana,1,2,,3,POINT (10446304 -75516486)
2018,Diciembre,Ghana,1,1,,2,POINT (3451668 -76532004)
2018,Diciembre,Ghana,2,6,,8,POINT (4697157 -74140516)
2018,Diciembre,Ghana,1,0,,1,POINT (6170465 -7542726)
2018,Diciembre,Granada,0,2,,2,POINT (10446304 -75516486)
2018,Diciembre,Granada,0,1,,1,POINT (125862 -81702165)
2018,Diciembre,Granada,1,1,,2,POINT (3451668 -76532004)
2018,Diciembre,Granada,1,1,,2,POINT (4697157 -74140516)
2018,Diciembre,Grecia,1,1,,2,POINT (-4191162 -69941498)
2018,Diciembre,Grecia,0,1,,1,POINT (0.33002 -76876446)
2018,Diciembre,Grecia,0,1,,1,POINT (0.81488 -77356)
2018,Diciembre,Grecia,0,3,,3,POINT (10406342 -75527794)
2018,Diciembre,Grecia,4,9,,13,POINT (10446304 -75516486)
2018,Diciembre,Grecia,0,1,,1,POINT (10886686 -74776479)
2018,Diciembre,Grecia,1,0,,1,POINT (11117206 -74232675)
2018,Diciembre,Grecia,1,1,,2,POINT (11360029 -72129595)
2018,Diciembre,Grecia,4,1,,5,POINT (3451668 -76532004)
2018,Diciembre,Grecia,62,98,,160,POINT (4697157 -74140516)
2018,Diciembre,Grecia,9,12,,21,POINT (6170465 -7542726)
2018,Diciembre,Grecia,0,1,,1,POINT (7819 -72453013)
2018,Diciembre,Grecia,0,2,,2,POINT (806667 -767333)
2018,Diciembre,Grecia,0,2,,2,POINT (9402597 -75681642)
2018,Diciembre,Guatemala,0,1,,1,POINT (-4191162 -69941498)
2018,Diciembre,Guatemala,0,3,,3,POINT (0.81488 -77356)
2018,Diciembre,Guatemala,0,1,,1,POINT (1800143 -78802679)
2018,Diciembre,Guatemala,2,4,,6,POINT (10406342 -75527794)
2018,Diciembre,Guatemala,248,209,,457,POINT (10446304 -75516486)
2018,Diciembre,Guatemala,9,18,,27,POINT (10886686 -74776479)
2018,Diciembre,Guatemala,2,2,,4,POINT (11360029 -72129595)
2018,Diciembre,Guatemala,21,24,,45,POINT (125862 -81702165)
2018,Diciembre,Guatemala,41,63,,104,POINT (3451668 -76532004)
2018,Diciembre,Guatemala,1,0,,1,POINT (445285 -75766353)
2018,Diciembre,Guatemala,676,794,,1470,POINT (4697157 -74140516)
2018,Diciembre,Guatemala,9,15,,24,POINT (4815189 -75736374)
2018,Diciembre,Guatemala,68,116,,184,POINT (6170465 -7542726)
2018,Diciembre,Guatemala,0,4,,4,POINT (7128047 -73181317)
2018,Diciembre,Guatemala,0,1,,1,POINT (7819 -72453013)
2018,Diciembre,Guatemala,1,0,,1,POINT (836068 -72409396)
2018,Diciembre,Guatemala,1,1,,2,POINT (863337 -7735002)
2018,Diciembre,Guyana,0,2,,2,POINT (10406342 -75527794)
2018,Diciembre,Guyana,0,1,,1,POINT (11360029 -72129595)
2018,Diciembre,Guyana,0,2,,2,POINT (3451668 -76532004)
2018,Diciembre,Guyana,8,8,,16,POINT (4697157 -74140516)
2018,Diciembre,Guyana,2,2,,4,POINT (6170465 -7542726)
2018,Diciembre,Guyana,0,1,,1,POINT (7819 -72453013)
2018,Diciembre,Guyana,1,0,,1,POINT (836068 -72409396)
2018,Diciembre,Guinea,1,0,,1,POINT (4697157 -74140516)
2018,Diciembre,Haití,0,1,,1,POINT (0.81488 -77356)
2018,Diciembre,Haití,0,3,,3,POINT (10446304 -75516486)
2018,Diciembre,Haití,0,1,,1,POINT (10886686 -74776479)
2018,Diciembre,Haití,1,0,,1,POINT (125862 -81702165)
2018,Diciembre,Haití,1,0,,1,POINT (3451668 -76532004)
2018,Diciembre,Haití,5,19,,24,POINT (4697157 -74140516)
2018,Diciembre,Haití,0,1,,1,POINT (6170465 -7542726)
2018,Diciembre,Honduras,1,1,,2,POINT (0.33002 -76876446)
2018,Diciembre,Honduras,2,5,,7,POINT (0.81488 -77356)
2018,Diciembre,Honduras,0,1,,1,POINT (1800143 -78802679)
2018,Diciembre,Honduras,5,8,,13,POINT (10406342 -75527794)
2018,Diciembre,Honduras,86,77,,163,POINT (10446304 -75516486)
2018,Diciembre,Honduras,12,9,,21,POINT (10886686 -74776479)
2018,Diciembre,Honduras,1,4,,5,POINT (11360029 -72129595)
2018,Diciembre,Honduras,1,12,,13,POINT (125744111 -81703935)
2018,Diciembre,Honduras,0,2,,2,POINT (125862 -81702165)
2018,Diciembre,Honduras,42,35,,77,POINT (3451668 -76532004)
2018,Diciembre,Honduras,1,1,,2,POINT (445285 -75766353)
2018,Diciembre,Honduras,319,299,,618,POINT (4697157 -74140516)
2018,Diciembre,Honduras,4,2,,6,POINT (4815189 -75736374)
2018,Diciembre,Honduras,56,63,,119,POINT (6170465 -7542726)
2018,Diciembre,Honduras,0,1,,1,POINT (7128047 -73181317)
2018,Diciembre,Hong Kong,1,1,,2,POINT (10446304 -75516486)
2018,Diciembre,Hong Kong,13,17,,30,POINT (4697157 -74140516)
2018,Diciembre,Hong Kong,2,5,,7,POINT (6170465 -7542726)
2018,Diciembre,Hungría,0,1,,1,POINT (-4214082 -69941431)
2018,Diciembre,Hungría,0,1,,1,POINT (0.33002 -76876446)
2018,Diciembre,Hungría,2,2,,4,POINT (0.81488 -77356)
2018,Diciembre,Hungría,1,4,,5,POINT (10406342 -75527794)
2018,Diciembre,Hungría,11,14,,25,POINT (10446304 -75516486)
2018,Diciembre,Hungría,0,1,,1,POINT (10886686 -74776479)
2018,Diciembre,Hungría,39,58,,97,POINT (4697157 -74140516)
2018,Diciembre,Hungría,1,1,,2,POINT (4815189 -75736374)
2018,Diciembre,Hungría,1,5,,6,POINT (6170465 -7542726)
2018,Diciembre,India,2,8,,10,POINT (0.81488 -77356)
2018,Diciembre,India,0,9,,9,POINT (10406342 -75527794)
2018,Diciembre,India,32,58,,90,POINT (10446304 -75516486)
2018,Diciembre,India,2,6,,8,POINT (10886686 -74776479)
2018,Diciembre,India,0,3,,3,POINT (10970933 -74765343)
2018,Diciembre,India,0,1,,1,POINT (11117206 -74232675)
2018,Diciembre,India,0,2,,2,POINT (11247723 -74213989)
2018,Diciembre,India,3,7,,10,POINT (3451668 -76532004)
2018,Diciembre,India,0,2,,2,POINT (3884426 -77061029)
2018,Diciembre,India,130,419,,549,POINT (4697157 -74140516)
2018,Diciembre,India,0,1,,1,POINT (4815189 -75736374)
2018,Diciembre,India,11,78,,89,POINT (6170465 -7542726)
2018,Diciembre,India,0,4,,4,POINT (9402597 -75681642)
2018,Diciembre,Indonesia,1,1,,2,POINT (10406342 -75527794)
2018,Diciembre,Indonesia,5,3,,8,POINT (10446304 -75516486)
2018,Diciembre,Indonesia,0,4,,4,POINT (11247723 -74213989)
2018,Diciembre,Indonesia,1,0,,1,POINT (3451668 -76532004)
2018,Diciembre,Indonesia,25,20,,45,POINT (4697157 -74140516)
2018,Diciembre,Indonesia,5,3,,8,POINT (6170465 -7542726)
2018,Diciembre,Iraq,0,1,,1,POINT (10446304 -75516486)
2018,Diciembre,Iraq,0,2,,2,POINT (4697157 -74140516)
2018,Diciembre,Irán,1,0,,1,POINT (0.81488 -77356)
2018,Diciembre,Irán,0,1,,1,POINT (10406342 -75527794)
2018,Diciembre,Irán,2,0,,2,POINT (10446304 -75516486)
2018,Diciembre,Irán,0,1,,1,POINT (10886686 -74776479)
2018,Diciembre,Irán,0,1,,1,POINT (11360029 -72129595)
2018,Diciembre,Irán,7,17,,24,POINT (4697157 -74140516)
2018,Diciembre,Irán,0,1,,1,POINT (6170465 -7542726)
2018,Diciembre,República de Irlanda,0,1,,1,POINT (-4191162 -69941498)
2018,Diciembre,República de Irlanda,5,13,,18,POINT (0.81488 -77356)
2018,Diciembre,República de Irlanda,9,4,,13,POINT (10406342 -75527794)
2018,Diciembre,República de Irlanda,19,32,,51,POINT (10446304 -75516486)
2018,Diciembre,República de Irlanda,0,2,,2,POINT (10886686 -74776479)
2018,Diciembre,República de Irlanda,1,10,,11,POINT (3451668 -76532004)
2018,Diciembre,República de Irlanda,131,270,,401,POINT (4697157 -74140516)
2018,Diciembre,República de Irlanda,15,31,,46,POINT (6170465 -7542726)
2018,Diciembre,República de Irlanda,1,1,,2,POINT (7128047 -73181317)
2018,Diciembre,República de Irlanda,0,1,,1,POINT (836068 -72409396)
2018,Diciembre,República de Irlanda,10,4,,14,POINT (863337 -7735002)
2018,Diciembre,Islandia,1,0,,1,POINT (0.81488 -77356)
2018,Diciembre,Islandia,5,7,,12,POINT (10446304 -75516486)
2018,Diciembre,Islandia,10,12,,22,POINT (4697157 -74140516)
2018,Diciembre,Islandia,0,1,,1,POINT (4815189 -75736374)
2018,Diciembre,Islandia,1,4,,5,POINT (6170465 -7542726)
2018,Diciembre,Islandia,1,0,,1,POINT (863337 -7735002)
2018,Diciembre,Israel,0,1,,1,POINT (-4191162 -69941498)
2018,Diciembre,Israel,0,1,,1,POINT (-4214082 -69941431)
2018,Diciembre,Israel,5,13,,18,POINT (0.81488 -77356)
2018,Diciembre,Israel,1,0,,1,POINT (10406342 -75527794)
2018,Diciembre,Israel,19,46,,65,POINT (10446304 -75516486)
2018,Diciembre,Israel,1,9,,10,POINT (10886686 -74776479)
2018,Diciembre,Israel,0,1,,1,POINT (11117206 -74232675)
2018,Diciembre,Israel,1,0,,1,POINT (125862 -81702165)
2018,Diciembre,Israel,0,4,,4,POINT (133387613 -81372937)
2018,Diciembre,Israel,9,18,,27,POINT (3451668 -76532004)
2018,Diciembre,Israel,128,351,,479,POINT (4697157 -74140516)
2018,Diciembre,Israel,2,2,,4,POINT (4815189 -75736374)
2018,Diciembre,Israel,11,57,,68,POINT (6170465 -7542726)
2018,Diciembre,Israel,2,0,,2,POINT (863337 -7735002)
2018,Diciembre,Italia,4,3,,7,POINT (-4191162 -69941498)
2018,Diciembre,Italia,3,4,,7,POINT (-4214082 -69941431)
2018,Diciembre,Italia,10,20,,30,POINT (0.81488 -77356)
2018,Diciembre,Italia,5,16,,21,POINT (10406342 -75527794)
2018,Diciembre,Italia,130,261,,391,POINT (10446304 -75516486)
2018,Diciembre,Italia,21,46,,67,POINT (10886686 -74776479)
2018,Diciembre,Italia,0,2,,2,POINT (11117206 -74232675)
2018,Diciembre,Italia,0,2,,2,POINT (11247723 -74213989)
2018,Diciembre,Italia,3,9,,12,POINT (11360029 -72129595)
2018,Diciembre,Italia,0,4,,4,POINT (125744111 -81703935)
2018,Diciembre,Italia,8,7,,15,POINT (125862 -81702165)
2018,Diciembre,Italia,0,4,,4,POINT (133387613 -81372937)
2018,Diciembre,Italia,33,132,,165,POINT (3451668 -76532004)
2018,Diciembre,Italia,0,2,,2,POINT (445285 -75766353)
2018,Diciembre,Italia,1168,2353,,3521,POINT (4697157 -74140516)
2018,Diciembre,Italia,1,7,,8,POINT (4815189 -75736374)
2018,Diciembre,Italia,95,301,,396,POINT (6170465 -7542726)
2018,Diciembre,Italia,0,1,,1,POINT (7128047 -73181317)
2018,Diciembre,Italia,19,27,,46,POINT (7819 -72453013)
2018,Diciembre,Italia,0,1,,1,POINT (7927233 -72508188)
2018,Diciembre,Italia,6,4,,10,POINT (836068 -72409396)
2018,Diciembre,Italia,1,3,,4,POINT (863337 -7735002)
2018,Diciembre,Jamaica,1,11,,12,POINT (10446304 -75516486)
2018,Diciembre,Jamaica,2,2,,4,POINT (10886686 -74776479)
2018,Diciembre,Jamaica,2,2,,4,POINT (125862 -81702165)
2018,Diciembre,Jamaica,1,4,,5,POINT (3451668 -76532004)
2018,Diciembre,Jamaica,16,30,,46,POINT (4697157 -74140516)
2018,Diciembre,Jamaica,1,1,,2,POINT (4815189 -75736374)
2018,Diciembre,Jamaica,2,6,,8,POINT (6170465 -7542726)
2018,Diciembre,Japón,0,4,,4,POINT (-4191162 -69941498)
2018,Diciembre,Japón,1,2,,3,POINT (-4214082 -69941431)
2018,Diciembre,Japón,0,13,,13,POINT (0.81488 -77356)
2018,Diciembre,Japón,24,20,,44,POINT (10446304 -75516486)
2018,Diciembre,Japón,0,16,,16,POINT (10886686 -74776479)
2018,Diciembre,Japón,1,0,,1,POINT (11117206 -74232675)
2018,Diciembre,Japón,1,1,,2,POINT (125862 -81702165)
2018,Diciembre,Japón,2,7,,9,POINT (3451668 -76532004)
2018,Diciembre,Japón,1,0,,1,POINT (445285 -75766353)
2018,Diciembre,Japón,247,445,,692,POINT (4697157 -74140516)
2018,Diciembre,Japón,1,0,,1,POINT (4815189 -75736374)
2018,Diciembre,Japón,37,64,,101,POINT (6170465 -7542726)
2018,Diciembre,Japón,1,1,,2,POINT (863337 -7735002)
2018,Diciembre,Jordania,0,1,,1,POINT (10446304 -75516486)
2018,Diciembre,Jordania,1,15,,16,POINT (4697157 -74140516)
2018,Diciembre,Kazajistán,3,0,,3,POINT (10446304 -75516486)
2018,Diciembre,Kazajistán,8,8,,16,POINT (4697157 -74140516)
2018,Diciembre,Kazajistán,1,1,,2,POINT (6170465 -7542726)
2018,Diciembre,Kenia,0,1,,1,POINT (10446304 -75516486)
2018,Diciembre,Kenia,9,15,,24,POINT (4697157 -74140516)
2018,Diciembre,Kenia,1,0,,1,POINT (6170465 -7542726)
2018,Diciembre,Kuwait,0,3,,3,POINT (10446304 -75516486)
2018,Diciembre,Kuwait,6,6,,12,POINT (4697157 -74140516)
2018,Diciembre,República de Kosovo,0,1,,1,POINT (3451668 -76532004)
2018,Diciembre,República de Kosovo,2,1,,3,POINT (4697157 -74140516)
2018,Diciembre,República de Kosovo,0,1,,1,POINT (6170465 -7542726)
2018,Diciembre,Letonia,1,1,,2,POINT (0.81488 -77356)
2018,Diciembre,Letonia,0,1,,1,POINT (10406342 -75527794)
2018,Diciembre,Letonia,4,5,,9,POINT (10446304 -75516486)
2018,Diciembre,Letonia,0,2,,2,POINT (11247723 -74213989)
2018,Diciembre,Letonia,1,1,,2,POINT (3451668 -76532004)
2018,Diciembre,Letonia,0,1,,1,POINT (3884426 -77061029)
2018,Diciembre,Letonia,19,18,,37,POINT (4697157 -74140516)
2018,Diciembre,Letonia,2,0,,2,POINT (6170465 -7542726)
2018,Diciembre,Lituania,1,0,,1,POINT (0.81488 -77356)
2018,Diciembre,Lituania,6,8,,14,POINT (10446304 -75516486)
2018,Diciembre,Lituania,2,0,,2,POINT (3451668 -76532004)
2018,Diciembre,Lituania,35,27,,62,POINT (4697157 -74140516)
2018,Diciembre,Lituania,2,4,,6,POINT (6170465 -7542726)
2018,Diciembre,Lituania,0,1,,1,POINT (863337 -7735002)
2018,Diciembre,Lituania,0,1,,1,POINT (9402597 -75681642)
2018,Diciembre,Líbano,0,1,,1,POINT (10446304 -75516486)
2018,Diciembre,Líbano,0,4,,4,POINT (10886686 -74776479)
2018,Diciembre,Líbano,1,2,,3,POINT (11360029 -72129595)
2018,Diciembre,Líbano,1,1,,2,POINT (3451668 -76532004)
2018,Diciembre,Líbano,13,34,,47,POINT (4697157 -74140516)
2018,Diciembre,Líbano,3,3,,6,POINT (6170465 -7542726)
2018,Diciembre,Liechtenstein,7,6,,13,POINT (4697157 -74140516)
2018,Diciembre,Liechtenstein,0,2,,2,POINT (6170465 -7542726)
2018,Diciembre,Luxemburgo,2,0,,2,POINT (-4191162 -69941498)
2018,Diciembre,Luxemburgo,2,2,,4,POINT (10446304 -75516486)
2018,Diciembre,Luxemburgo,1,0,,1,POINT (10886686 -74776479)
2018,Diciembre,Luxemburgo,0,1,,1,POINT (3451668 -76532004)
2018,Diciembre,Luxemburgo,20,21,,41,POINT (4697157 -74140516)
2018,Diciembre,Luxemburgo,1,0,,1,POINT (4815189 -75736374)
2018,Diciembre,Luxemburgo,1,2,,3,POINT (6170465 -7542726)
2018,Diciembre,Macedonia,1,2,,3,POINT (10446304 -75516486)
2018,Diciembre,Macedonia,1,11,,12,POINT (4697157 -74140516)
2018,Diciembre,Malasia,5,11,,16,POINT (10446304 -75516486)
2018,Diciembre,Malasia,0,1,,1,POINT (3451668 -76532004)
2018,Diciembre,Malasia,23,33,,56,POINT (4697157 -74140516)
2018,Diciembre,Malasia,0,1,,1,POINT (6170465 -7542726)
2018,Diciembre,Malawi,0,1,,1,POINT (4697157 -74140516)
2018,Diciembre,Malta,0,2,,2,POINT (0.81488 -77356)
2018,Diciembre,Malta,5,6,,11,POINT (10446304 -75516486)
2018,Diciembre,Malta,1,0,,1,POINT (10886686 -74776479)
2018,Diciembre,Malta,7,19,,26,POINT (4697157 -74140516)
2018,Diciembre,Malta,5,6,,11,POINT (6170465 -7542726)
2018,Diciembre,Marruecos,0,1,,1,POINT (10406342 -75527794)
2018,Diciembre,Marruecos,3,1,,4,POINT (10446304 -75516486)
2018,Diciembre,Marruecos,18,23,,41,POINT (4697157 -74140516)
2018,Diciembre,Marruecos,1,0,,1,POINT (4815189 -75736374)
2018,Diciembre,Marruecos,3,4,,7,POINT (6170465 -7542726)
2018,Diciembre,Mauricio,0,1,,1,POINT (10406342 -75527794)
2018,Diciembre,Mauricio,1,0,,1,POINT (4697157 -74140516)
2018,Diciembre,Mauricio,0,1,,1,POINT (6170465 -7542726)
2018,Diciembre,México,0,2,,2,POINT (-4191162 -69941498)
2018,Diciembre,México,0,1,,1,POINT (0.33002 -76876446)
2018,Diciembre,México,26,43,,69,POINT (0.81488 -77356)
2018,Diciembre,México,11,15,,26,POINT (10406342 -75527794)
2018,Diciembre,México,353,458,,811,POINT (10446304 -75516486)
2018,Diciembre,México,59,98,,157,POINT (10886686 -74776479)
2018,Diciembre,México,0,1,,1,POINT (11117206 -74232675)
2018,Diciembre,México,2,3,,5,POINT (11360029 -72129595)
2018,Diciembre,México,0,2,,2,POINT (125744111 -81703935)
2018,Diciembre,México,6,6,,12,POINT (125862 -81702165)
2018,Diciembre,México,88,172,,260,POINT (3451668 -76532004)
2018,Diciembre,México,1,2,,3,POINT (445285 -75766353)
2018,Diciembre,México,4609,6835,,11444,POINT (4697157 -74140516)
2018,Diciembre,México,21,36,,57,POINT (4815189 -75736374)
2018,Diciembre,México,647,1168,,1815,POINT (6170465 -7542726)
2018,Diciembre,México,0,1,,1,POINT (6185536 -67484028)
2018,Diciembre,México,0,4,,4,POINT (7088729 -70740253)
2018,Diciembre,México,9,11,,20,POINT (7128047 -73181317)
2018,Diciembre,México,10,24,,34,POINT (7819 -72453013)
2018,Diciembre,México,8,12,,20,POINT (836068 -72409396)
2018,Diciembre,México,1,1,,2,POINT (863337 -7735002)
2018,Diciembre,República de Moldavia,1,0,,1,POINT (10446304 -75516486)
2018,Diciembre,República de Moldavia,4,2,,6,POINT (4697157 -74140516)
2018,Diciembre,República de Moldavia,1,0,,1,POINT (6170465 -7542726)
2018,Diciembre,Mónaco,2,1,,3,POINT (10446304 -75516486)
2018,Diciembre,Mónaco,1,1,,2,POINT (4697157 -74140516)
2018,Diciembre,Mongolia,2,1,,3,POINT (4697157 -74140516)
2018,Diciembre,Montenegro,0,4,,4,POINT (4697157 -74140516)
2018,Diciembre,Micronesia,0,1,,1,POINT (3451668 -76532004)
2018,Diciembre,Mozambique,1,1,,2,POINT (4697157 -74140516)
2018,Diciembre,Myanmar,0,1,,1,POINT (10446304 -75516486)
2018,Diciembre,Myanmar,0,1,,1,POINT (10886686 -74776479)
2018,Diciembre,Myanmar,1,1,,2,POINT (4697157 -74140516)
2018,Diciembre,Namibia,2,2,,4,POINT (10446304 -75516486)
2018,Diciembre,Namibia,1,0,,1,POINT (4697157 -74140516)
2018,Diciembre,Nepal,1,0,,1,POINT (10406342 -75527794)
2018,Diciembre,Nepal,1,5,,6,POINT (10446304 -75516486)
2018,Diciembre,Nepal,0,1,,1,POINT (10886686 -74776479)
2018,Diciembre,Nepal,6,4,,10,POINT (4697157 -74140516)
2018,Diciembre,Nicaragua,1,0,,1,POINT (0.81488 -77356)
2018,Diciembre,Nicaragua,0,1,,1,POINT (10406342 -75527794)
2018,Diciembre,Nicaragua,16,20,,36,POINT (10446304 -75516486)
2018,Diciembre,Nicaragua,2,4,,6,POINT (10886686 -74776479)
2018,Diciembre,Nicaragua,1,0,,1,POINT (11360029 -72129595)
2018,Diciembre,Nicaragua,0,1,,1,POINT (125744111 -81703935)
2018,Diciembre,Nicaragua,5,3,,8,POINT (125862 -81702165)
2018,Diciembre,Nicaragua,14,23,,37,POINT (3451668 -76532004)
2018,Diciembre,Nicaragua,1,2,,3,POINT (445285 -75766353)
2018,Diciembre,Nicaragua,101,106,,207,POINT (4697157 -74140516)
2018,Diciembre,Nicaragua,2,1,,3,POINT (4815189 -75736374)
2018,Diciembre,Nicaragua,19,12,,31,POINT (6170465 -7542726)
2018,Diciembre,Nicaragua,2,1,,3,POINT (7128047 -73181317)
2018,Diciembre,Nigeria,0,1,,1,POINT (10446304 -75516486)
2018,Diciembre,Nigeria,2,7,,9,POINT (4697157 -74140516)
2018,Diciembre,Nigeria,0,3,,3,POINT (6170465 -7542726)
2018,Diciembre,Níger,0,1,,1,POINT (4697157 -74140516)
2018,Diciembre,Noruega,1,8,,9,POINT (0.81488 -77356)
2018,Diciembre,Noruega,2,1,,3,POINT (10406342 -75527794)
2018,Diciembre,Noruega,40,59,,99,POINT (10446304 -75516486)
2018,Diciembre,Noruega,7,14,,21,POINT (10886686 -74776479)
2018,Diciembre,Noruega,1,1,,2,POINT (11247723 -74213989)
2018,Diciembre,Noruega,0,1,,1,POINT (133387613 -81372937)
2018,Diciembre,Noruega,9,11,,20,POINT (3451668 -76532004)
2018,Diciembre,Noruega,145,213,,358,POINT (4697157 -74140516)
2018,Diciembre,Noruega,4,3,,7,POINT (4815189 -75736374)
2018,Diciembre,Noruega,19,25,,44,POINT (6170465 -7542726)
2018,Diciembre,Noruega,4,3,,7,POINT (863337 -7735002)
2018,Diciembre,Nueva Zelanda,1,1,,2,POINT (-4191162 -69941498)
2018,Diciembre,Nueva Zelanda,1,0,,1,POINT (-4214082 -69941431)
2018,Diciembre,Nueva Zelanda,9,16,,25,POINT (0.81488 -77356)
2018,Diciembre,Nueva Zelanda,3,8,,11,POINT (10406342 -75527794)
2018,Diciembre,Nueva Zelanda,18,22,,40,POINT (10446304 -75516486)
2018,Diciembre,Nueva Zelanda,3,5,,8,POINT (10886686 -74776479)
2018,Diciembre,Nueva Zelanda,1,0,,1,POINT (125862 -81702165)
2018,Diciembre,Nueva Zelanda,5,8,,13,POINT (3451668 -76532004)
2018,Diciembre,Nueva Zelanda,121,174,,295,POINT (4697157 -74140516)
2018,Diciembre,Nueva Zelanda,1,0,,1,POINT (4815189 -75736374)
2018,Diciembre,Nueva Zelanda,13,28,,41,POINT (6170465 -7542726)
2018,Diciembre,Nueva Zelanda,6,3,,9,POINT (863337 -7735002)
2018,Diciembre,Omán,0,7,,7,POINT (4697157 -74140516)
2018,Diciembre,Países Bajos,3,3,,6,POINT (-4191162 -69941498)
2018,Diciembre,Países Bajos,2,5,,7,POINT (-4214082 -69941431)
2018,Diciembre,Países Bajos,3,4,,7,POINT (0.33002 -76876446)
2018,Diciembre,Países Bajos,17,26,,43,POINT (0.81488 -77356)
2018,Diciembre,Países Bajos,20,29,,49,POINT (10406342 -75527794)
2018,Diciembre,Países Bajos,297,362,,659,POINT (10446304 -75516486)
2018,Diciembre,Países Bajos,14,20,,34,POINT (10886686 -74776479)
2018,Diciembre,Países Bajos,0,1,,1,POINT (10970933 -74765343)
2018,Diciembre,Países Bajos,0,1,,1,POINT (11117206 -74232675)
2018,Diciembre,Países Bajos,2,3,,5,POINT (11247723 -74213989)
2018,Diciembre,Países Bajos,4,5,,9,POINT (11360029 -72129595)
2018,Diciembre,Países Bajos,0,1,,1,POINT (125744111 -81703935)
2018,Diciembre,Países Bajos,1,0,,1,POINT (133387613 -81372937)
2018,Diciembre,Países Bajos,57,100,,157,POINT (3451668 -76532004)
2018,Diciembre,Países Bajos,1861,2720,,4581,POINT (4697157 -74140516)
2018,Diciembre,Países Bajos,4,11,,15,POINT (4815189 -75736374)
2018,Diciembre,Países Bajos,165,275,,440,POINT (6170465 -7542726)
2018,Diciembre,Países Bajos,10,11,,21,POINT (7128047 -73181317)
2018,Diciembre,Países Bajos,0,8,,8,POINT (7819 -72453013)
2018,Diciembre,Países Bajos,0,1,,1,POINT (836068 -72409396)
2018,Diciembre,Países Bajos,8,9,,17,POINT (863337 -7735002)
2018,Diciembre,Pakistán,3,16,,19,POINT (4697157 -74140516)
2018,Diciembre,Pakistán,1,2,,3,POINT (6170465 -7542726)
2018,Diciembre,Panamá,3,1,,4,POINT (0.81488 -77356)
2018,Diciembre,Panamá,0,9,,9,POINT (10406342 -75527794)
2018,Diciembre,Panamá,519,560,,1079,POINT (10446304 -75516486)
2018,Diciembre,Panamá,85,129,,214,POINT (10886686 -74776479)
2018,Diciembre,Panamá,0,1,,1,POINT (11247723 -74213989)
2018,Diciembre,Panamá,0,3,,3,POINT (11360029 -72129595)
2018,Diciembre,Panamá,0,5,,5,POINT (125744111 -81703935)
2018,Diciembre,Panamá,64,65,,129,POINT (125862 -81702165)
2018,Diciembre,Panamá,249,337,,586,POINT (3451668 -76532004)
2018,Diciembre,Panamá,38,51,,89,POINT (445285 -75766353)
2018,Diciembre,Panamá,1756,2053,,3809,POINT (4697157 -74140516)
2018,Diciembre,Panamá,46,58,,104,POINT (4815189 -75736374)
2018,Diciembre,Panamá,1655,1728,,3383,POINT (6170465 -7542726)
2018,Diciembre,Panamá,5,9,,14,POINT (6218835 -75586989)
2018,Diciembre,Panamá,7,6,,13,POINT (7102626 -77762647)
2018,Diciembre,Panamá,5,15,,20,POINT (7128047 -73181317)
2018,Diciembre,Panamá,2,5,,7,POINT (7819 -72453013)
2018,Diciembre,Panamá,0,2,,2,POINT (7927233 -72508188)
2018,Diciembre,Panamá,4,13,,17,POINT (863337 -7735002)
2018,Diciembre,Paraguay,3,5,,8,POINT (-4191162 -69941498)
2018,Diciembre,Paraguay,0,2,,2,POINT (0.81488 -77356)
2018,Diciembre,Paraguay,3,3,,6,POINT (10406342 -75527794)
2018,Diciembre,Paraguay,58,29,,87,POINT (10446304 -75516486)
2018,Diciembre,Paraguay,5,9,,14,POINT (10886686 -74776479)
2018,Diciembre,Paraguay,48,42,,90,POINT (125862 -81702165)
2018,Diciembre,Paraguay,6,2,,8,POINT (3451668 -76532004)
2018,Diciembre,Paraguay,140,110,,250,POINT (4697157 -74140516)
2018,Diciembre,Paraguay,0,1,,1,POINT (4815189 -75736374)
2018,Diciembre,Paraguay,11,19,,30,POINT (6170465 -7542726)
2018,Diciembre,Paraguay,0,1,,1,POINT (7819 -72453013)
2018,Diciembre,Paraguay,1,0,,1,POINT (836068 -72409396)
2018,Diciembre,Perú,20,17,,37,POINT (-4191162 -69941498)
2018,Diciembre,Perú,44,38,,82,POINT (-4214082 -69941431)
2018,Diciembre,Perú,1,55,,56,POINT (0.185957 -7478366)
2018,Diciembre,Perú,3,15,,18,POINT (0.33002 -76876446)
2018,Diciembre,Perú,206,360,,566,POINT (0.81488 -77356)
2018,Diciembre,Perú,25,19,,44,POINT (10406342 -75527794)
2018,Diciembre,Perú,986,733,,1719,POINT (10446304 -75516486)
2018,Diciembre,Perú,13,16,,29,POINT (10886686 -74776479)
2018,Diciembre,Perú,1,1,,2,POINT (11117206 -74232675)
2018,Diciembre,Perú,3,20,,23,POINT (11360029 -72129595)
2018,Diciembre,Perú,0,4,,4,POINT (125744111 -81703935)
2018,Diciembre,Perú,259,191,,450,POINT (125862 -81702165)
2018,Diciembre,Perú,263,253,,516,POINT (3451668 -76532004)
2018,Diciembre,Perú,3417,4003,,7420,POINT (4697157 -74140516)
2018,Diciembre,Perú,4,2,,6,POINT (4815189 -75736374)
2018,Diciembre,Perú,697,842,,1539,POINT (6170465 -7542726)
2018,Diciembre,Perú,2,0,,2,POINT (6185536 -67484028)
2018,Diciembre,Perú,3,4,,7,POINT (7088729 -70740253)
2018,Diciembre,Perú,108,166,,274,POINT (7819 -72453013)
2018,Diciembre,Perú,8,13,,21,POINT (836068 -72409396)
2018,Diciembre,Palestina,1,2,,3,POINT (10446304 -75516486)
2018,Diciembre,Palestina,1,1,,2,POINT (4697157 -74140516)
2018,Diciembre,Palestina,0,1,,1,POINT (6170465 -7542726)
2018,Diciembre,Polonia,2,3,,5,POINT (-4191162 -69941498)
2018,Diciembre,Polonia,1,0,,1,POINT (-4214082 -69941431)
2018,Diciembre,Polonia,4,5,,9,POINT (0.81488 -77356)
2018,Diciembre,Polonia,27,41,,68,POINT (10406342 -75527794)
2018,Diciembre,Polonia,31,43,,74,POINT (10446304 -75516486)
2018,Diciembre,Polonia,0,2,,2,POINT (10886686 -74776479)
2018,Diciembre,Polonia,0,5,,5,POINT (10970933 -74765343)
2018,Diciembre,Polonia,1,6,,7,POINT (11247723 -74213989)
2018,Diciembre,Polonia,6,4,,10,POINT (3451668 -76532004)
2018,Diciembre,Polonia,0,2,,2,POINT (3884426 -77061029)
2018,Diciembre,Polonia,177,180,,357,POINT (4697157 -74140516)
2018,Diciembre,Polonia,1,0,,1,POINT (4815189 -75736374)
2018,Diciembre,Polonia,11,18,,29,POINT (6170465 -7542726)
2018,Diciembre,Polonia,1,0,,1,POINT (863337 -7735002)
2018,Diciembre,Portugal,0,1,,1,POINT (-4191162 -69941498)
2018,Diciembre,Portugal,1,1,,2,POINT (-4214082 -69941431)
2018,Diciembre,Portugal,0,4,,4,POINT (0.81488 -77356)
2018,Diciembre,Portugal,0,2,,2,POINT (10406342 -75527794)
2018,Diciembre,Portugal,18,36,,54,POINT (10446304 -75516486)
2018,Diciembre,Portugal,0,4,,4,POINT (10886686 -74776479)
2018,Diciembre,Portugal,1,4,,5,POINT (11360029 -72129595)
2018,Diciembre,Portugal,10,25,,35,POINT (3451668 -76532004)
2018,Diciembre,Portugal,239,419,,658,POINT (4697157 -74140516)
2018,Diciembre,Portugal,33,47,,80,POINT (6170465 -7542726)
2018,Diciembre,Portugal,0,1,,1,POINT (7088729 -70740253)
2018,Diciembre,Portugal,0,1,,1,POINT (7128047 -73181317)
2018,Diciembre,Portugal,11,21,,32,POINT (7819 -72453013)
2018,Diciembre,Portugal,3,3,,6,POINT (836068 -72409396)
2018,Diciembre,Qatar,0,2,,2,POINT (10446304 -75516486)
2018,Diciembre,Qatar,2,6,,8,POINT (4697157 -74140516)
2018,Diciembre,Qatar,0,2,,2,POINT (6170465 -7542726)
2018,Diciembre,Reino Unido de Gran Bretaña e Irlanda del Norte,1,2,,3,POINT (-4191162 -69941498)
2018,Diciembre,Reino Unido de Gran Bretaña e Irlanda del Norte,4,6,,10,POINT (-4214082 -69941431)
2018,Diciembre,Reino Unido de Gran Bretaña e Irlanda del Norte,0,2,,2,POINT (0.33002 -76876446)
2018,Diciembre,Reino Unido de Gran Bretaña e Irlanda del Norte,37,39,,76,POINT (0.81488 -77356)
2018,Diciembre,Reino Unido de Gran Bretaña e Irlanda del Norte,25,32,,57,POINT (10406342 -75527794)
2018,Diciembre,Reino Unido de Gran Bretaña e Irlanda del Norte,143,261,,404,POINT (10446304 -75516486)
2018,Diciembre,Reino Unido de Gran Bretaña e Irlanda del Norte,19,34,,53,POINT (10886686 -74776479)
2018,Diciembre,Reino Unido de Gran Bretaña e Irlanda del Norte,1,4,,5,POINT (11117206 -74232675)
2018,Diciembre,Reino Unido de Gran Bretaña e Irlanda del Norte,21,25,,46,POINT (11247723 -74213989)
2018,Diciembre,Reino Unido de Gran Bretaña e Irlanda del Norte,0,1,,1,POINT (125744111 -81703935)
2018,Diciembre,Reino Unido de Gran Bretaña e Irlanda del Norte,2,4,,6,POINT (125862 -81702165)
2018,Diciembre,Reino Unido de Gran Bretaña e Irlanda del Norte,1,0,,1,POINT (133387613 -81372937)
2018,Diciembre,Reino Unido de Gran Bretaña e Irlanda del Norte,53,85,,138,POINT (3451668 -76532004)
2018,Diciembre,Reino Unido de Gran Bretaña e Irlanda del Norte,0,1,,1,POINT (3884426 -77061029)
2018,Diciembre,Reino Unido de Gran Bretaña e Irlanda del Norte,3,2,,5,POINT (445285 -75766353)
2018,Diciembre,Reino Unido de Gran Bretaña e Irlanda del Norte,1470,2622,,4092,POINT (4697157 -74140516)
2018,Diciembre,Reino Unido de Gran Bretaña e Irlanda del Norte,1,9,,10,POINT (4815189 -75736374)
2018,Diciembre,Reino Unido de Gran Bretaña e Irlanda del Norte,153,308,,461,POINT (6170465 -7542726)
2018,Diciembre,Reino Unido de Gran Bretaña e Irlanda del Norte,1,0,,1,POINT (7088729 -70740253)
2018,Diciembre,Reino Unido de Gran Bretaña e Irlanda del Norte,1,4,,5,POINT (7128047 -73181317)
2018,Diciembre,Reino Unido de Gran Bretaña e Irlanda del Norte,2,2,,4,POINT (7819 -72453013)
2018,Diciembre,Reino Unido de Gran Bretaña e Irlanda del Norte,0,1,,1,POINT (836068 -72409396)
2018,Diciembre,Reino Unido de Gran Bretaña e Irlanda del Norte,29,30,,59,POINT (863337 -7735002)
2018,Diciembre,República Dominicana,2,0,,2,POINT (-4191162 -69941498)
2018,Diciembre,República Dominicana,15,16,,31,POINT (0.81488 -77356)
2018,Diciembre,República Dominicana,48,58,,106,POINT (10446304 -75516486)
2018,Diciembre,República Dominicana,19,28,,47,POINT (10886686 -74776479)
2018,Diciembre,República Dominicana,2,0,,2,POINT (10970933 -74765343)
2018,Diciembre,República Dominicana,0,3,,3,POINT (11117206 -74232675)
2018,Diciembre,República Dominicana,0,6,,6,POINT (11360029 -72129595)
2018,Diciembre,República Dominicana,1,1,,2,POINT (125744111 -81703935)
2018,Diciembre,República Dominicana,0,4,,4,POINT (125862 -81702165)
2018,Diciembre,República Dominicana,1,1,,2,POINT (133387613 -81372937)
2018,Diciembre,República Dominicana,29,24,,53,POINT (3451668 -76532004)
2018,Diciembre,República Dominicana,791,900,,1691,POINT (4697157 -74140516)
2018,Diciembre,República Dominicana,4,2,,6,POINT (4815189 -75736374)
2018,Diciembre,República Dominicana,49,89,,138,POINT (6170465 -7542726)
2018,Diciembre,República Dominicana,2,1,,3,POINT (7128047 -73181317)
2018,Diciembre,República Dominicana,2,6,,8,POINT (7819 -72453013)
2018,Diciembre,República Dominicana,0,2,,2,POINT (836068 -72409396)
2018,Diciembre,Rumania,0,1,,1,POINT (0.81488 -77356)
2018,Diciembre,Rumania,1,5,,6,POINT (10406342 -75527794)
2018,Diciembre,Rumania,12,10,,22,POINT (10446304 -75516486)
2018,Diciembre,Rumania,1,3,,4,POINT (10886686 -74776479)
2018,Diciembre,Rumania,0,1,,1,POINT (10970933 -74765343)
2018,Diciembre,Rumania,0,1,,1,POINT (11247723 -74213989)
2018,Diciembre,Rumania,0,1,,1,POINT (3451668 -76532004)
2018,Diciembre,Rumania,86,93,,179,POINT (4697157 -74140516)
2018,Diciembre,Rumania,16,15,,31,POINT (6170465 -7542726)
2018,Diciembre,Rumania,0,1,,1,POINT (9402597 -75681642)
2018,Diciembre,Federación de Rusia,1,0,,1,POINT (0.33002 -76876446)
2018,Diciembre,Federación de Rusia,5,5,,10,POINT (0.81488 -77356)
2018,Diciembre,Federación de Rusia,1,7,,8,POINT (10406342 -75527794)
2018,Diciembre,Federación de Rusia,24,21,,45,POINT (10446304 -75516486)
2018,Diciembre,Federación de Rusia,4,0,,4,POINT (10886686 -74776479)
2018,Diciembre,Federación de Rusia,0,1,,1,POINT (10970933 -74765343)
2018,Diciembre,Federación de Rusia,1,2,,3,POINT (11247723 -74213989)
2018,Diciembre,Federación de Rusia,0,1,,1,POINT (125744111 -81703935)
2018,Diciembre,Federación de Rusia,2,1,,3,POINT (125862 -81702165)
2018,Diciembre,Federación de Rusia,14,3,,17,POINT (3451668 -76532004)
2018,Diciembre,Federación de Rusia,243,235,,478,POINT (4697157 -74140516)
2018,Diciembre,Federación de Rusia,14,8,,22,POINT (6170465 -7542726)
2018,Diciembre,Federación de Rusia,0,2,,2,POINT (7102626 -77762647)
2018,Diciembre,Federación de Rusia,2,1,,3,POINT (7819 -72453013)
2018,Diciembre,Federación de Rusia,0,1,,1,POINT (9402597 -75681642)
2018,Diciembre,San Cristóbal y Nevis,0,1,,1,POINT (0.81488 -77356)
2018,Diciembre,San Cristóbal y Nevis,0,1,,1,POINT (10446304 -75516486)
2018,Diciembre,San Cristóbal y Nevis,4,3,,7,POINT (4697157 -74140516)
2018,Diciembre,San  Vicente y las Granadinas,1,0,,1,POINT (3451668 -76532004)
2018,Diciembre,San  Vicente y las Granadinas,0,2,,2,POINT (4697157 -74140516)
2018,Diciembre,Santa Lucia,1,0,,1,POINT (10446304 -75516486)
2018,Diciembre,Santa Lucia,1,2,,3,POINT (3451668 -76532004)
2018,Diciembre,Santa Lucia,4,1,,5,POINT (4697157 -74140516)
2018,Diciembre,Santa Lucia,0,2,,2,POINT (6170465 -7542726)
2018,Diciembre,Santa Lucia,0,1,,1,POINT (7819 -72453013)
2018,Diciembre,Senegal,2,2,,4,POINT (4697157 -74140516)
2018,Diciembre,Senegal,0,1,,1,POINT (6170465 -7542726)
2018,Diciembre,Serbia,2,1,,3,POINT (0.81488 -77356)
2018,Diciembre,Serbia,1,3,,4,POINT (10406342 -75527794)
2018,Diciembre,Serbia,4,8,,12,POINT (10446304 -75516486)
2018,Diciembre,Serbia,0,3,,3,POINT (3451668 -76532004)
2018,Diciembre,Serbia,19,59,,78,POINT (4697157 -74140516)
2018,Diciembre,Serbia,4,1,,5,POINT (6170465 -7542726)
2018,Diciembre,Seychelles,0,1,,1,POINT (4697157 -74140516)
2018,Diciembre,Singapur,6,7,,13,POINT (10446304 -75516486)
2018,Diciembre,Singapur,1,0,,1,POINT (10886686 -74776479)
2018,Diciembre,Singapur,2,1,,3,POINT (3451668 -76532004)
2018,Diciembre,Singapur,55,45,,100,POINT (4697157 -74140516)
2018,Diciembre,Singapur,6,4,,10,POINT (6170465 -7542726)
2018,Diciembre,República Árabe Siria,2,6,,8,POINT (4697157 -74140516)
2018,Diciembre,Sri Lanka,0,1,,1,POINT (0.81488 -77356)
2018,Diciembre,Sri Lanka,1,0,,1,POINT (10446304 -75516486)
2018,Diciembre,Sri Lanka,1,1,,2,POINT (4697157 -74140516)
2018,Diciembre,Sudáfrica,1,1,,2,POINT (0.81488 -77356)
2018,Diciembre,Sudáfrica,4,8,,12,POINT (10406342 -75527794)
2018,Diciembre,Sudáfrica,3,1,,4,POINT (10446304 -75516486)
2018,Diciembre,Sudáfrica,1,0,,1,POINT (10886686 -74776479)
2018,Diciembre,Sudáfrica,0,2,,2,POINT (3451668 -76532004)
2018,Diciembre,Sudáfrica,22,30,,52,POINT (4697157 -74140516)
2018,Diciembre,Sudáfrica,1,1,,2,POINT (6170465 -7542726)
2018,Diciembre,Sudán,2,3,,5,POINT (4697157 -74140516)
2018,Diciembre,Suecia,1,2,,3,POINT (-4191162 -69941498)
2018,Diciembre,Suecia,0,1,,1,POINT (-4214082 -69941431)
2018,Diciembre,Suecia,5,6,,11,POINT (0.81488 -77356)
2018,Diciembre,Suecia,8,6,,14,POINT (10406342 -75527794)
2018,Diciembre,Suecia,90,106,,196,POINT (10446304 -75516486)
2018,Diciembre,Suecia,14,13,,27,POINT (10886686 -74776479)
2018,Diciembre,Suecia,0,2,,2,POINT (11117206 -74232675)
2018,Diciembre,Suecia,1,1,,2,POINT (11247723 -74213989)
2018,Diciembre,Suecia,0,2,,2,POINT (125862 -81702165)
2018,Diciembre,Suecia,38,40,,78,POINT (3451668 -76532004)
2018,Diciembre,Suecia,391,565,,956,POINT (4697157 -74140516)
2018,Diciembre,Suecia,1,3,,4,POINT (4815189 -75736374)
2018,Diciembre,Suecia,45,72,,117,POINT (6170465 -7542726)
2018,Diciembre,Suecia,1,2,,3,POINT (7128047 -73181317)
2018,Diciembre,Suecia,1,0,,1,POINT (7819 -72453013)
2018,Diciembre,Suecia,2,1,,3,POINT (863337 -7735002)
2018,Diciembre,Suiza,2,4,,6,POINT (-4191162 -69941498)
2018,Diciembre,Suiza,1,1,,2,POINT (-4214082 -69941431)
2018,Diciembre,Suiza,1,0,,1,POINT (0.33002 -76876446)
2018,Diciembre,Suiza,29,36,,65,POINT (0.81488 -77356)
2018,Diciembre,Suiza,21,25,,46,POINT (10406342 -75527794)
2018,Diciembre,Suiza,66,105,,171,POINT (10446304 -75516486)
2018,Diciembre,Suiza,9,8,,17,POINT (10886686 -74776479)
2018,Diciembre,Suiza,4,5,,9,POINT (11117206 -74232675)
2018,Diciembre,Suiza,1,1,,2,POINT (11247723 -74213989)
2018,Diciembre,Suiza,3,6,,9,POINT (125862 -81702165)
2018,Diciembre,Suiza,39,59,,98,POINT (3451668 -76532004)
2018,Diciembre,Suiza,808,1326,,2134,POINT (4697157 -74140516)
2018,Diciembre,Suiza,1,3,,4,POINT (4815189 -75736374)
2018,Diciembre,Suiza,65,146,,211,POINT (6170465 -7542726)
2018,Diciembre,Suiza,1,0,,1,POINT (7128047 -73181317)
2018,Diciembre,Suiza,1,2,,3,POINT (7819 -72453013)
2018,Diciembre,Suiza,1,0,,1,POINT (836068 -72409396)
2018,Diciembre,Suiza,8,8,,16,POINT (863337 -7735002)
2018,Diciembre,Surinam,12,8,,20,POINT (4697157 -74140516)
2018,Diciembre,Surinam,1,0,,1,POINT (6170465 -7542726)
2018,Diciembre,Surinam,3,0,,3,POINT (7128047 -73181317)
2018,Diciembre,República de Tayikistán,1,1,,2,POINT (4697157 -74140516)
2018,Diciembre,Tailandia,1,0,,1,POINT (0.81488 -77356)
2018,Diciembre,Tailandia,17,10,,27,POINT (4697157 -74140516)
2018,Diciembre,Tailandia,1,0,,1,POINT (6170465 -7542726)
2018,Diciembre,Trinidad y Tobago,0,1,,1,POINT (0.81488 -77356)
2018,Diciembre,Trinidad y Tobago,1,0,,1,POINT (10406342 -75527794)
2018,Diciembre,Trinidad y Tobago,8,9,,17,POINT (10446304 -75516486)
2018,Diciembre,Trinidad y Tobago,1,1,,2,POINT (11247723 -74213989)
2018,Diciembre,Trinidad y Tobago,0,1,,1,POINT (11360029 -72129595)
2018,Diciembre,Trinidad y Tobago,0,1,,1,POINT (125862 -81702165)
2018,Diciembre,Trinidad y Tobago,4,5,,9,POINT (3451668 -76532004)
2018,Diciembre,Trinidad y Tobago,21,54,,75,POINT (4697157 -74140516)
2018,Diciembre,Trinidad y Tobago,0,1,,1,POINT (4815189 -75736374)
2018,Diciembre,Trinidad y Tobago,9,24,,33,POINT (6170465 -7542726)
2018,Diciembre,Trinidad y Tobago,0,5,,5,POINT (7128047 -73181317)
2018,Diciembre,Trinidad y Tobago,1,0,,1,POINT (7819 -72453013)
2018,Diciembre,Túnez,3,1,,4,POINT (10446304 -75516486)
2018,Diciembre,Túnez,6,7,,13,POINT (4697157 -74140516)
2018,Diciembre,Turquía,1,5,,6,POINT (0.81488 -77356)
2018,Diciembre,Turquía,1,2,,3,POINT (10406342 -75527794)
2018,Diciembre,Turquía,6,14,,20,POINT (10446304 -75516486)
2018,Diciembre,Turquía,0,3,,3,POINT (10886686 -74776479)
2018,Diciembre,Turquía,0,4,,4,POINT (3451668 -76532004)
2018,Diciembre,Turquía,155,347,,502,POINT (4697157 -74140516)
2018,Diciembre,Turquía,10,18,,28,POINT (6170465 -7542726)
2018,Diciembre,Turquía,0,1,,1,POINT (7819 -72453013)
2018,Diciembre,Turkmenistán,2,3,,5,POINT (4697157 -74140516)
2018,Diciembre,Ucrania,1,9,,10,POINT (10406342 -75527794)
2018,Diciembre,Ucrania,3,10,,13,POINT (10446304 -75516486)
2018,Diciembre,Ucrania,0,1,,1,POINT (10886686 -74776479)
2018,Diciembre,Ucrania,0,1,,1,POINT (11247723 -74213989)
2018,Diciembre,Ucrania,3,1,,4,POINT (3451668 -76532004)
2018,Diciembre,Ucrania,0,2,,2,POINT (3884426 -77061029)
2018,Diciembre,Ucrania,59,34,,93,POINT (4697157 -74140516)
2018,Diciembre,Ucrania,7,3,,10,POINT (6170465 -7542726)
2018,Diciembre,Ucrania,0,2,,2,POINT (9402597 -75681642)
2018,Diciembre,Uganda,0,1,,1,POINT (0.81488 -77356)
2018,Diciembre,Uganda,1,1,,2,POINT (4697157 -74140516)
2018,Diciembre,Uruguay,1,0,,1,POINT (-4191162 -69941498)
2018,Diciembre,Uruguay,1,0,,1,POINT (-4214082 -69941431)
2018,Diciembre,Uruguay,1,3,,4,POINT (0.81488 -77356)
2018,Diciembre,Uruguay,9,5,,14,POINT (10406342 -75527794)
2018,Diciembre,Uruguay,64,69,,133,POINT (10446304 -75516486)
2018,Diciembre,Uruguay,0,9,,9,POINT (10886686 -74776479)
2018,Diciembre,Uruguay,0,1,,1,POINT (11117206 -74232675)
2018,Diciembre,Uruguay,0,1,,1,POINT (11360029 -72129595)
2018,Diciembre,Uruguay,3,5,,8,POINT (125862 -81702165)
2018,Diciembre,Uruguay,25,35,,60,POINT (3451668 -76532004)
2018,Diciembre,Uruguay,344,567,,911,POINT (4697157 -74140516)
2018,Diciembre,Uruguay,38,73,,111,POINT (6170465 -7542726)
2018,Diciembre,Uruguay,7,9,,16,POINT (7819 -72453013)
2018,Diciembre,Uruguay,1,1,,2,POINT (836068 -72409396)
2018,Diciembre,Uzbekistán,0,1,,1,POINT (4697157 -74140516)
2018,Diciembre,Venezuela,7,8,,15,POINT (-4191162 -69941498)
2018,Diciembre,Venezuela,6,5,,11,POINT (-4214082 -69941431)
2018,Diciembre,Venezuela,0,1,,1,POINT (0.185957 -7478366)
2018,Diciembre,Venezuela,135,143,,278,POINT (0.33002 -76876446)
2018,Diciembre,Venezuela,7788,9551,,17339,POINT (0.81488 -77356)
2018,Diciembre,Venezuela,2,1,,3,POINT (1800143 -78802679)
2018,Diciembre,Venezuela,27,30,,57,POINT (10406342 -75527794)
2018,Diciembre,Venezuela,259,252,,511,POINT (10446304 -75516486)
2018,Diciembre,Venezuela,198,277,,475,POINT (10886686 -74776479)
2018,Diciembre,Venezuela,1,1,,2,POINT (10970933 -74765343)
2018,Diciembre,Venezuela,4,14,,18,POINT (11117206 -74232675)
2018,Diciembre,Venezuela,1,0,,1,POINT (11247723 -74213989)
2018,Diciembre,Venezuela,7020,5683,,12703,POINT (11360029 -72129595)
2018,Diciembre,Venezuela,5,4,,9,POINT (125862 -81702165)
2018,Diciembre,Venezuela,338,336,,674,POINT (3451668 -76532004)
2018,Diciembre,Venezuela,23,13,,36,POINT (3866713 -67927521)
2018,Diciembre,Venezuela,4,2,,6,POINT (445285 -75766353)
2018,Diciembre,Venezuela,9164,9008,,18172,POINT (4697157 -74140516)
2018,Diciembre,Venezuela,9,24,,33,POINT (4815189 -75736374)
2018,Diciembre,Venezuela,1224,1157,,2381,POINT (6170465 -7542726)
2018,Diciembre,Venezuela,73,56,,129,POINT (6185536 -67484028)
2018,Diciembre,Venezuela,1083,977,,2060,POINT (7088729 -70740253)
2018,Diciembre,Venezuela,17,39,,56,POINT (7128047 -73181317)
2018,Diciembre,Venezuela,26412,19223,,45635,POINT (7819 -72453013)
2018,Diciembre,Venezuela,2,19,,21,POINT (7927233 -72508188)
2018,Diciembre,Venezuela,3622,2408,,6030,POINT (836068 -72409396)
2018,Diciembre,Venezuela,0,1,,1,POINT (863337 -7735002)
2018,Diciembre,Vietnam,1,1,,2,POINT (0.81488 -77356)
2018,Diciembre,Vietnam,1,1,,2,POINT (10446304 -75516486)
2018,Diciembre,Vietnam,7,3,,10,POINT (4697157 -74140516)
2018,Diciembre,Vietnam,0,1,,1,POINT (6170465 -7542726)
2018,Diciembre,República Árabe de Yemen,0,1,,1,POINT (0.81488 -77356)
2018,Diciembre,República Árabe de Yemen,0,1,,1,POINT (4697157 -74140516)
2018,Diciembre,Zambia,0,1,,1,POINT (4697157 -74140516)
2018,Diciembre,Zimbabue,0,1,,1,POINT (4697157 -74140516)
2018,Diciembre,Zimbabue,1,0,,1,POINT (6170465 -7542726)
2018,Diciembre,Islas Turcas y Caicos/Territorio Británico de Ultramar,1,1,,2,POINT (10886686 -74776479)
2018,Diciembre,Refugiado,2,1,,3,POINT (10446304 -75516486)
2018,Diciembre,Refugiado,0,2,,2,POINT (3451668 -76532004)
2018,Diciembre,Refugiado,2,10,,12,POINT (4697157 -74140516)
2018,Diciembre,Refugiado,0,2,,2,POINT (6170465 -7542726)
2018,Diciembre,Desconocido,1,2,,3,POINT (10446304 -75516486)
2018,Diciembre,Desconocido,1,1,,2,POINT (10886686 -74776479)
2018,Diciembre,Desconocido,1,0,,1,POINT (3451668 -76532004)
2018,Diciembre,Desconocido,79,147,,226,POINT (4697157 -74140516)
2018,Diciembre,Desconocido,1,0,,1,POINT (4815189 -75736374)
2018,Diciembre,Desconocido,0,5,,5,POINT (6170465 -7542726)
2018,Diciembre,Desconocido,2,0,,2,POINT (7088729 -70740253)
2018,Diciembre,Desconocido,0,1,,1,POINT (836068 -72409396)
2018,Diciembre,República CentroÁfricana,1,0,,1,POINT (3451668 -76532004)
2019,Enero,Afganistán,0,1,,1,POINT (10886686 -74776479)
2019,Enero,Afganistán,0,1,,1,POINT (4697157 -74140516)
2019,Enero,Albania,0,1,,1,POINT (3451668 -76532004)
2019,Enero,Albania,2,11,,13,POINT (4697157 -74140516)
2019,Enero,Albania,0,3,,3,POINT (6170465 -7542726)
2019,Enero,Alemania,10,17,,27,POINT (-4191162 -69941498)
2019,Enero,Alemania,13,16,,29,POINT (-4214082 -69941431)
2019,Enero,Alemania,1,0,,1,POINT (0.185957 -7478366)
2019,Enero,Alemania,7,7,,14,POINT (0.33002 -76876446)
2019,Enero,Alemania,125,121,,246,POINT (0.81488 -77356)
2019,Enero,Alemania,59,59,,118,POINT (10406342 -75527794)
2019,Enero,Alemania,165,276,,441,POINT (10446304 -75516486)
2019,Enero,Alemania,24,35,,59,POINT (10886686 -74776479)
2019,Enero,Alemania,3,1,,4,POINT (11117206 -74232675)
2019,Enero,Alemania,4,8,,12,POINT (11247723 -74213989)
2019,Enero,Alemania,2,3,,5,POINT (11360029 -72129595)
2019,Enero,Alemania,6,5,,11,POINT (125862 -81702165)
2019,Enero,Alemania,1,1,,2,POINT (133387613 -81372937)
2019,Enero,Alemania,85,135,,220,POINT (3451668 -76532004)
2019,Enero,Alemania,0,1,,1,POINT (3884426 -77061029)
2019,Enero,Alemania,2,1,,3,POINT (445285 -75766353)
2019,Enero,Alemania,2311,3142,,5453,POINT (4697157 -74140516)
2019,Enero,Alemania,5,8,,13,POINT (4815189 -75736374)
2019,Enero,Alemania,167,312,,479,POINT (6170465 -7542726)
2019,Enero,Alemania,0,1,,1,POINT (7128047 -73181317)
2019,Enero,Alemania,1,13,,14,POINT (7819 -72453013)
2019,Enero,Alemania,0,1,,1,POINT (836068 -72409396)
2019,Enero,Alemania,27,39,,66,POINT (863337 -7735002)
2019,Enero,Andorra,6,9,,15,POINT (4697157 -74140516)
2019,Enero,Angola,1,1,,2,POINT (4697157 -74140516)
2019,Enero,Antigua y Barbuda,4,5,,9,POINT (4697157 -74140516)
2019,Enero,Antigua y Barbuda,0,1,,1,POINT (6170465 -7542726)
2019,Enero,Arabia Saudita,1,3,,4,POINT (4697157 -74140516)
2019,Enero,Arabia Saudita,0,1,,1,POINT (6170465 -7542726)
2019,Enero,Argelia,5,4,,9,POINT (4697157 -74140516)
2019,Enero,Argelia,1,1,,2,POINT (6170465 -7542726)
2019,Enero,Argentina,1,6,,7,POINT (-4191162 -69941498)
2019,Enero,Argentina,5,4,,9,POINT (-4214082 -69941431)
2019,Enero,Argentina,10,11,,21,POINT (0.33002 -76876446)
2019,Enero,Argentina,147,232,,379,POINT (0.81488 -77356)
2019,Enero,Argentina,0,1,,1,POINT (1800143 -78802679)
2019,Enero,Argentina,186,157,,343,POINT (10406342 -75527794)
2019,Enero,Argentina,2466,1879,,4345,POINT (10446304 -75516486)
2019,Enero,Argentina,15,30,,45,POINT (10886686 -74776479)
2019,Enero,Argentina,7,2,,9,POINT (11117206 -74232675)
2019,Enero,Argentina,10,12,,22,POINT (11360029 -72129595)
2019,Enero,Argentina,286,210,,496,POINT (125862 -81702165)
2019,Enero,Argentina,317,302,,619,POINT (3451668 -76532004)
2019,Enero,Argentina,0,1,,1,POINT (445285 -75766353)
2019,Enero,Argentina,5085,5402,,10487,POINT (4697157 -74140516)
2019,Enero,Argentina,2,5,,7,POINT (4815189 -75736374)
2019,Enero,Argentina,534,540,,1074,POINT (6170465 -7542726)
2019,Enero,Argentina,3,3,,6,POINT (7128047 -73181317)
2019,Enero,Argentina,7,22,,29,POINT (7819 -72453013)
2019,Enero,Argentina,0,7,,7,POINT (836068 -72409396)
2019,Enero,Argentina,3,1,,4,POINT (863337 -7735002)
2019,Enero,República de Armenia,1,1,,2,POINT (10446304 -75516486)
2019,Enero,República de Armenia,5,2,,7,POINT (4697157 -74140516)
2019,Enero,Australia,2,2,,4,POINT (-4191162 -69941498)
2019,Enero,Australia,1,0,,1,POINT (-4214082 -69941431)
2019,Enero,Australia,0,1,,1,POINT (0.812436 -77847006)
2019,Enero,Australia,32,30,,62,POINT (0.81488 -77356)
2019,Enero,Australia,25,20,,45,POINT (10406342 -75527794)
2019,Enero,Australia,82,102,,184,POINT (10446304 -75516486)
2019,Enero,Australia,4,12,,16,POINT (10886686 -74776479)
2019,Enero,Australia,0,3,,3,POINT (11117206 -74232675)
2019,Enero,Australia,2,6,,8,POINT (11247723 -74213989)
2019,Enero,Australia,1,1,,2,POINT (11360029 -72129595)
2019,Enero,Australia,0,3,,3,POINT (125862 -81702165)
2019,Enero,Australia,16,30,,46,POINT (3451668 -76532004)
2019,Enero,Australia,380,634,,1014,POINT (4697157 -74140516)
2019,Enero,Australia,0,2,,2,POINT (4815189 -75736374)
2019,Enero,Australia,70,136,,206,POINT (6170465 -7542726)
2019,Enero,Australia,0,1,,1,POINT (7128047 -73181317)
2019,Enero,Australia,0,1,,1,POINT (836068 -72409396)
2019,Enero,Australia,21,20,,41,POINT (863337 -7735002)
2019,Enero,Austria,7,5,,12,POINT (-4191162 -69941498)
2019,Enero,Austria,15,11,,26,POINT (0.81488 -77356)
2019,Enero,Austria,9,12,,21,POINT (10406342 -75527794)
2019,Enero,Austria,20,30,,50,POINT (10446304 -75516486)
2019,Enero,Austria,4,8,,12,POINT (10886686 -74776479)
2019,Enero,Austria,0,4,,4,POINT (11247723 -74213989)
2019,Enero,Austria,0,1,,1,POINT (11360029 -72129595)
2019,Enero,Austria,2,2,,4,POINT (125862 -81702165)
2019,Enero,Austria,0,1,,1,POINT (133387613 -81372937)
2019,Enero,Austria,8,17,,25,POINT (3451668 -76532004)
2019,Enero,Austria,1,0,,1,POINT (445285 -75766353)
2019,Enero,Austria,298,439,,737,POINT (4697157 -74140516)
2019,Enero,Austria,16,38,,54,POINT (6170465 -7542726)
2019,Enero,Austria,0,1,,1,POINT (7819 -72453013)
2019,Enero,Austria,4,3,,7,POINT (863337 -7735002)
2019,Enero,Azerbaiyán,0,1,,1,POINT (10446304 -75516486)
2019,Enero,Azerbaiyán,1,1,,2,POINT (4697157 -74140516)
2019,Enero,Bahamas,0,4,,4,POINT (10446304 -75516486)
2019,Enero,Bahamas,1,1,,2,POINT (3451668 -76532004)
2019,Enero,Bahamas,4,23,,27,POINT (4697157 -74140516)
2019,Enero,Bahamas,3,3,,6,POINT (6170465 -7542726)
2019,Enero,Bahréin,1,2,,3,POINT (4697157 -74140516)
2019,Enero,Bangladesh,0,2,,2,POINT (4697157 -74140516)
2019,Enero,Barbados,1,0,,1,POINT (10406342 -75527794)
2019,Enero,Barbados,3,0,,3,POINT (10446304 -75516486)
2019,Enero,Barbados,1,1,,2,POINT (3451668 -76532004)
2019,Enero,Barbados,3,4,,7,POINT (4697157 -74140516)
2019,Enero,Barbados,0,2,,2,POINT (6170465 -7542726)
2019,Enero,República de Belarús,0,1,,1,POINT (0.81488 -77356)
2019,Enero,República de Belarús,1,0,,1,POINT (10446304 -75516486)
2019,Enero,República de Belarús,3,2,,5,POINT (4697157 -74140516)
2019,Enero,Bélgica,0,2,,2,POINT (-4191162 -69941498)
2019,Enero,Bélgica,1,1,,2,POINT (-4214082 -69941431)
2019,Enero,Bélgica,3,2,,5,POINT (0.33002 -76876446)
2019,Enero,Bélgica,12,14,,26,POINT (0.81488 -77356)
2019,Enero,Bélgica,0,3,,3,POINT (10406342 -75527794)
2019,Enero,Bélgica,26,57,,83,POINT (10446304 -75516486)
2019,Enero,Bélgica,0,4,,4,POINT (10886686 -74776479)
2019,Enero,Bélgica,0,2,,2,POINT (10970933 -74765343)
2019,Enero,Bélgica,0,1,,1,POINT (11247723 -74213989)
2019,Enero,Bélgica,13,24,,37,POINT (3451668 -76532004)
2019,Enero,Bélgica,0,7,,7,POINT (3884426 -77061029)
2019,Enero,Bélgica,306,488,,794,POINT (4697157 -74140516)
2019,Enero,Bélgica,3,2,,5,POINT (4815189 -75736374)
2019,Enero,Bélgica,31,65,,96,POINT (6170465 -7542726)
2019,Enero,Bélgica,1,1,,2,POINT (7819 -72453013)
2019,Enero,Bélgica,0,1,,1,POINT (836068 -72409396)
2019,Enero,Bélgica,0,1,,1,POINT (863337 -7735002)
2019,Enero,Belice,0,1,,1,POINT (10446304 -75516486)
2019,Enero,Belice,1,2,,3,POINT (125862 -81702165)
2019,Enero,Belice,3,2,,5,POINT (3451668 -76532004)
2019,Enero,Belice,1,11,,12,POINT (4697157 -74140516)
2019,Enero,Belice,2,6,,8,POINT (6170465 -7542726)
2019,Enero,Benín,3,1,,4,POINT (4697157 -74140516)
2019,Enero,Bermudas/Territorio Británico de Ultramar,0,3,,3,POINT (10446304 -75516486)
2019,Enero,Bermudas/Territorio Británico de Ultramar,0,3,,3,POINT (3451668 -76532004)
2019,Enero,Bermudas/Territorio Británico de Ultramar,1,0,,1,POINT (4697157 -74140516)
2019,Enero,Bolivia,0,2,,2,POINT (-4191162 -69941498)
2019,Enero,Bolivia,28,20,,48,POINT (0.81488 -77356)
2019,Enero,Bolivia,14,7,,21,POINT (10406342 -75527794)
2019,Enero,Bolivia,235,159,,394,POINT (10446304 -75516486)
2019,Enero,Bolivia,2,3,,5,POINT (10886686 -74776479)
2019,Enero,Bolivia,0,1,,1,POINT (11360029 -72129595)
2019,Enero,Bolivia,30,25,,55,POINT (125862 -81702165)
2019,Enero,Bolivia,73,41,,114,POINT (3451668 -76532004)
2019,Enero,Bolivia,1146,1046,,2192,POINT (4697157 -74140516)
2019,Enero,Bolivia,1,1,,2,POINT (4815189 -75736374)
2019,Enero,Bolivia,50,54,,104,POINT (6170465 -7542726)
2019,Enero,Bolivia,0,1,,1,POINT (6185536 -67484028)
2019,Enero,Bolivia,2,2,,4,POINT (7128047 -73181317)
2019,Enero,Bolivia,2,7,,9,POINT (7819 -72453013)
2019,Enero,Bolivia,0,1,,1,POINT (836068 -72409396)
2019,Enero,Bosnia y Herzegovina,1,2,,3,POINT (10446304 -75516486)
2019,Enero,Bosnia y Herzegovina,0,2,,2,POINT (3451668 -76532004)
2019,Enero,Bosnia y Herzegovina,4,8,,12,POINT (4697157 -74140516)
2019,Enero,Brasil,175,163,,338,POINT (-4191162 -69941498)
2019,Enero,Brasil,3,8,,11,POINT (-4214082 -69941431)
2019,Enero,Brasil,2,3,,5,POINT (0.33002 -76876446)
2019,Enero,Brasil,36,56,,92,POINT (0.81488 -77356)
2019,Enero,Brasil,162,129,,291,POINT (10406342 -75527794)
2019,Enero,Brasil,773,595,,1368,POINT (10446304 -75516486)
2019,Enero,Brasil,11,35,,46,POINT (10886686 -74776479)
2019,Enero,Brasil,1,0,,1,POINT (11117206 -74232675)
2019,Enero,Brasil,2,4,,6,POINT (11360029 -72129595)
2019,Enero,Brasil,223,165,,388,POINT (125862 -81702165)
2019,Enero,Brasil,132,176,,308,POINT (3451668 -76532004)
2019,Enero,Brasil,4,4,,8,POINT (3866713 -67927521)
2019,Enero,Brasil,7653,7784,,15437,POINT (4697157 -74140516)
2019,Enero,Brasil,13,4,,17,POINT (4815189 -75736374)
2019,Enero,Brasil,305,340,,645,POINT (6170465 -7542726)
2019,Enero,Brasil,2,1,,3,POINT (7128047 -73181317)
2019,Enero,Brasil,6,7,,13,POINT (7819 -72453013)
2019,Enero,Brasil,3,4,,7,POINT (836068 -72409396)
2019,Enero,Brasil,1,1,,2,POINT (863337 -7735002)
2019,Enero,Bulgaria,1,3,,4,POINT (0.81488 -77356)
2019,Enero,Bulgaria,1,1,,2,POINT (10406342 -75527794)
2019,Enero,Bulgaria,5,12,,17,POINT (10446304 -75516486)
2019,Enero,Bulgaria,1,0,,1,POINT (133387613 -81372937)
2019,Enero,Bulgaria,3,2,,5,POINT (3451668 -76532004)
2019,Enero,Bulgaria,0,2,,2,POINT (3884426 -77061029)
2019,Enero,Bulgaria,1,0,,1,POINT (445285 -75766353)
2019,Enero,Bulgaria,80,77,,157,POINT (4697157 -74140516)
2019,Enero,Bulgaria,2,8,,10,POINT (6170465 -7542726)
2019,Enero,Burkina Faso,0,2,,2,POINT (4697157 -74140516)
2019,Enero,Bután,1,0,,1,POINT (4697157 -74140516)
2019,Enero,Cabo Verde,0,1,,1,POINT (4697157 -74140516)
2019,Enero,Islas Caimán/Territorio Británico de Ultramar,0,1,,1,POINT (10446304 -75516486)
2019,Enero,Islas Caimán/Territorio Británico de Ultramar,1,1,,2,POINT (125862 -81702165)
2019,Enero,Camerún,2,2,,4,POINT (4697157 -74140516)
2019,Enero,Camerún,1,2,,3,POINT (6170465 -7542726)
2019,Enero,Canadá,1,0,,1,POINT (-4191162 -69941498)
2019,Enero,Canadá,2,4,,6,POINT (-4214082 -69941431)
2019,Enero,Canadá,0,1,,1,POINT (0.33002 -76876446)
2019,Enero,Canadá,18,38,,56,POINT (0.81488 -77356)
2019,Enero,Canadá,76,66,,142,POINT (10406342 -75527794)
2019,Enero,Canadá,1245,1442,,2687,POINT (10446304 -75516486)
2019,Enero,Canadá,19,37,,56,POINT (10886686 -74776479)
2019,Enero,Canadá,0,1,,1,POINT (11117206 -74232675)
2019,Enero,Canadá,6,6,,12,POINT (11247723 -74213989)
2019,Enero,Canadá,4,2,,6,POINT (11360029 -72129595)
2019,Enero,Canadá,348,301,,649,POINT (125862 -81702165)
2019,Enero,Canadá,2,2,,4,POINT (133387613 -81372937)
2019,Enero,Canadá,94,103,,197,POINT (3451668 -76532004)
2019,Enero,Canadá,3,2,,5,POINT (445285 -75766353)
2019,Enero,Canadá,1492,2325,,3817,POINT (4697157 -74140516)
2019,Enero,Canadá,17,22,,39,POINT (4815189 -75736374)
2019,Enero,Canadá,237,559,,796,POINT (6170465 -7542726)
2019,Enero,Canadá,3,7,,10,POINT (7128047 -73181317)
2019,Enero,Canadá,4,4,,8,POINT (7819 -72453013)
2019,Enero,Canadá,8,8,,16,POINT (863337 -7735002)
2019,Enero,República Del Congo,0,1,,1,POINT (4697157 -74140516)
2019,Enero,República Democrática del Congo,0,2,,2,POINT (0.81488 -77356)
2019,Enero,República Democrática del Congo,4,5,,9,POINT (4697157 -74140516)
2019,Enero,República de Corea,10,14,,24,POINT (0.81488 -77356)
2019,Enero,República de Corea,1,2,,3,POINT (10406342 -75527794)
2019,Enero,República de Corea,7,10,,17,POINT (10446304 -75516486)
2019,Enero,República de Corea,7,3,,10,POINT (10886686 -74776479)
2019,Enero,República de Corea,0,2,,2,POINT (11360029 -72129595)
2019,Enero,República de Corea,1,1,,2,POINT (125862 -81702165)
2019,Enero,República de Corea,6,5,,11,POINT (3451668 -76532004)
2019,Enero,República de Corea,477,591,,1068,POINT (4697157 -74140516)
2019,Enero,República de Corea,5,0,,5,POINT (4815189 -75736374)
2019,Enero,República de Corea,17,28,,45,POINT (6170465 -7542726)
2019,Enero,República de Corea,2,5,,7,POINT (7819 -72453013)
2019,Enero,República de Corea,0,2,,2,POINT (836068 -72409396)
2019,Enero,República de Corea,1,0,,1,POINT (863337 -7735002)
2019,Enero,Costa de Marfil,0,1,,1,POINT (0.81488 -77356)
2019,Enero,Costa de Marfil,1,0,,1,POINT (10446304 -75516486)
2019,Enero,Costa de Marfil,2,1,,3,POINT (4697157 -74140516)
2019,Enero,Costa Rica,1,0,,1,POINT (-4214082 -69941431)
2019,Enero,Costa Rica,8,9,,17,POINT (0.81488 -77356)
2019,Enero,Costa Rica,5,4,,9,POINT (10406342 -75527794)
2019,Enero,Costa Rica,479,385,,864,POINT (10446304 -75516486)
2019,Enero,Costa Rica,14,27,,41,POINT (10886686 -74776479)
2019,Enero,Costa Rica,2,0,,2,POINT (11360029 -72129595)
2019,Enero,Costa Rica,81,82,,163,POINT (125862 -81702165)
2019,Enero,Costa Rica,57,67,,124,POINT (3451668 -76532004)
2019,Enero,Costa Rica,0,4,,4,POINT (3884426 -77061029)
2019,Enero,Costa Rica,1351,1414,,2765,POINT (4697157 -74140516)
2019,Enero,Costa Rica,9,16,,25,POINT (4815189 -75736374)
2019,Enero,Costa Rica,240,211,,451,POINT (6170465 -7542726)
2019,Enero,Costa Rica,3,4,,7,POINT (7128047 -73181317)
2019,Enero,Costa Rica,1,5,,6,POINT (7819 -72453013)
2019,Enero,Costa Rica,1,3,,4,POINT (836068 -72409396)
2019,Enero,Croacia,0,3,,3,POINT (0.81488 -77356)
2019,Enero,Croacia,1,3,,4,POINT (10406342 -75527794)
2019,Enero,Croacia,4,12,,16,POINT (10446304 -75516486)
2019,Enero,Croacia,0,2,,2,POINT (10886686 -74776479)
2019,Enero,Croacia,0,4,,4,POINT (10970933 -74765343)
2019,Enero,Croacia,1,0,,1,POINT (11360029 -72129595)
2019,Enero,Croacia,43,70,,113,POINT (4697157 -74140516)
2019,Enero,Croacia,3,11,,14,POINT (6170465 -7542726)
2019,Enero,Croacia,1,0,,1,POINT (863337 -7735002)
2019,Enero,Cuba,2,0,,2,POINT (-4191162 -69941498)
2019,Enero,Cuba,1,2,,3,POINT (0.81488 -77356)
2019,Enero,Cuba,0,15,,15,POINT (10406342 -75527794)
2019,Enero,Cuba,11,17,,28,POINT (10446304 -75516486)
2019,Enero,Cuba,10,18,,28,POINT (10886686 -74776479)
2019,Enero,Cuba,0,2,,2,POINT (11360029 -72129595)
2019,Enero,Cuba,21,32,,53,POINT (3451668 -76532004)
2019,Enero,Cuba,1,1,,2,POINT (445285 -75766353)
2019,Enero,Cuba,202,331,,533,POINT (4697157 -74140516)
2019,Enero,Cuba,4,3,,7,POINT (4815189 -75736374)
2019,Enero,Cuba,21,34,,55,POINT (6170465 -7542726)
2019,Enero,Cuba,0,1,,1,POINT (7088729 -70740253)
2019,Enero,Cuba,0,2,,2,POINT (7128047 -73181317)
2019,Enero,Cuba,0,2,,2,POINT (7819 -72453013)
2019,Enero,Cuba,1,1,,2,POINT (836068 -72409396)
2019,Enero,República Checa,3,7,,10,POINT (0.81488 -77356)
2019,Enero,República Checa,13,25,,38,POINT (10446304 -75516486)
2019,Enero,República Checa,0,2,,2,POINT (10886686 -74776479)
2019,Enero,República Checa,1,3,,4,POINT (11247723 -74213989)
2019,Enero,República Checa,0,11,,11,POINT (3451668 -76532004)
2019,Enero,República Checa,1,0,,1,POINT (445285 -75766353)
2019,Enero,República Checa,116,156,,272,POINT (4697157 -74140516)
2019,Enero,República Checa,6,11,,17,POINT (6170465 -7542726)
2019,Enero,República Checa,0,1,,1,POINT (7819 -72453013)
2019,Enero,República Checa,0,3,,3,POINT (863337 -7735002)
2019,Enero,Chile,0,2,,2,POINT (-4191162 -69941498)
2019,Enero,Chile,2,6,,8,POINT (-4214082 -69941431)
2019,Enero,Chile,3,3,,6,POINT (0.33002 -76876446)
2019,Enero,Chile,87,112,,199,POINT (0.81488 -77356)
2019,Enero,Chile,1,1,,2,POINT (1800143 -78802679)
2019,Enero,Chile,167,115,,282,POINT (10406342 -75527794)
2019,Enero,Chile,564,413,,977,POINT (10446304 -75516486)
2019,Enero,Chile,8,19,,27,POINT (10886686 -74776479)
2019,Enero,Chile,1,2,,3,POINT (11117206 -74232675)
2019,Enero,Chile,3,5,,8,POINT (11360029 -72129595)
2019,Enero,Chile,0,1,,1,POINT (125744111 -81703935)
2019,Enero,Chile,104,76,,180,POINT (125862 -81702165)
2019,Enero,Chile,218,218,,436,POINT (3451668 -76532004)
2019,Enero,Chile,2,2,,4,POINT (445285 -75766353)
2019,Enero,Chile,5234,5463,,10697,POINT (4697157 -74140516)
2019,Enero,Chile,4,4,,8,POINT (4815189 -75736374)
2019,Enero,Chile,200,243,,443,POINT (6170465 -7542726)
2019,Enero,Chile,0,1,,1,POINT (6185536 -67484028)
2019,Enero,Chile,3,2,,5,POINT (7088729 -70740253)
2019,Enero,Chile,1,1,,2,POINT (7128047 -73181317)
2019,Enero,Chile,13,21,,34,POINT (7819 -72453013)
2019,Enero,Chile,3,9,,12,POINT (836068 -72409396)
2019,Enero,Chile,0,3,,3,POINT (863337 -7735002)
2019,Enero,China,1,4,,5,POINT (-4191162 -69941498)
2019,Enero,China,2,0,,2,POINT (-4214082 -69941431)
2019,Enero,China,17,17,,34,POINT (0.81488 -77356)
2019,Enero,China,0,1,,1,POINT (10406342 -75527794)
2019,Enero,China,31,32,,63,POINT (10446304 -75516486)
2019,Enero,China,3,21,,24,POINT (10886686 -74776479)
2019,Enero,China,0,15,,15,POINT (11247723 -74213989)
2019,Enero,China,1,3,,4,POINT (11360029 -72129595)
2019,Enero,China,12,19,,31,POINT (3451668 -76532004)
2019,Enero,China,0,4,,4,POINT (3884426 -77061029)
2019,Enero,China,395,660,,1055,POINT (4697157 -74140516)
2019,Enero,China,36,67,,103,POINT (6170465 -7542726)
2019,Enero,China,0,1,,1,POINT (6185536 -67484028)
2019,Enero,China,5,3,,8,POINT (7819 -72453013)
2019,Enero,China,2,1,,3,POINT (863337 -7735002)
2019,Enero,China,0,6,,6,POINT (9402597 -75681642)
2019,Enero,Taiwán,2,0,,2,POINT (0.81488 -77356)
2019,Enero,Taiwán,4,4,,8,POINT (10446304 -75516486)
2019,Enero,Taiwán,7,3,,10,POINT (3451668 -76532004)
2019,Enero,Taiwán,75,77,,152,POINT (4697157 -74140516)
2019,Enero,Taiwán,13,27,,40,POINT (6170465 -7542726)
2019,Enero,Taiwán,2,3,,5,POINT (7819 -72453013)
2019,Enero,Chipre,1,0,,1,POINT (10446304 -75516486)
2019,Enero,Chipre,6,6,,12,POINT (4697157 -74140516)
2019,Enero,Chipre,1,2,,3,POINT (6170465 -7542726)
2019,Enero,Dinamarca,0,3,,3,POINT (-4191162 -69941498)
2019,Enero,Dinamarca,1,2,,3,POINT (-4214082 -69941431)
2019,Enero,Dinamarca,4,8,,12,POINT (0.81488 -77356)
2019,Enero,Dinamarca,0,7,,7,POINT (10406342 -75527794)
2019,Enero,Dinamarca,54,50,,104,POINT (10446304 -75516486)
2019,Enero,Dinamarca,3,10,,13,POINT (10886686 -74776479)
2019,Enero,Dinamarca,3,3,,6,POINT (11247723 -74213989)
2019,Enero,Dinamarca,1,1,,2,POINT (11360029 -72129595)
2019,Enero,Dinamarca,2,1,,3,POINT (125862 -81702165)
2019,Enero,Dinamarca,5,13,,18,POINT (3451668 -76532004)
2019,Enero,Dinamarca,149,246,,395,POINT (4697157 -74140516)
2019,Enero,Dinamarca,13,26,,39,POINT (6170465 -7542726)
2019,Enero,Dinamarca,0,2,,2,POINT (863337 -7735002)
2019,Enero,Dominica,6,4,,10,POINT (4697157 -74140516)
2019,Enero,Dominica,0,2,,2,POINT (6170465 -7542726)
2019,Enero,Ecuador,1,0,,1,POINT (-4191162 -69941498)
2019,Enero,Ecuador,0,5,,5,POINT (-4214082 -69941431)
2019,Enero,Ecuador,49,253,,302,POINT (0.33002 -76876446)
2019,Enero,Ecuador,2,2,,4,POINT (0.812436 -77847006)
2019,Enero,Ecuador,1234,2009,,3243,POINT (0.81488 -77356)
2019,Enero,Ecuador,5,9,,14,POINT (1800143 -78802679)
2019,Enero,Ecuador,2,26,,28,POINT (10406342 -75527794)
2019,Enero,Ecuador,37,42,,79,POINT (10446304 -75516486)
2019,Enero,Ecuador,4,17,,21,POINT (10886686 -74776479)
2019,Enero,Ecuador,0,2,,2,POINT (11117206 -74232675)
2019,Enero,Ecuador,6,18,,24,POINT (11360029 -72129595)
2019,Enero,Ecuador,0,1,,1,POINT (125744111 -81703935)
2019,Enero,Ecuador,8,14,,22,POINT (125862 -81702165)
2019,Enero,Ecuador,267,340,,607,POINT (3451668 -76532004)
2019,Enero,Ecuador,0,6,,6,POINT (3866713 -67927521)
2019,Enero,Ecuador,0,2,,2,POINT (445285 -75766353)
2019,Enero,Ecuador,2720,3570,,6290,POINT (4697157 -74140516)
2019,Enero,Ecuador,3,5,,8,POINT (4815189 -75736374)
2019,Enero,Ecuador,99,167,,266,POINT (6170465 -7542726)
2019,Enero,Ecuador,0,1,,1,POINT (6185536 -67484028)
2019,Enero,Ecuador,2,2,,4,POINT (7088729 -70740253)
2019,Enero,Ecuador,0,1,,1,POINT (7128047 -73181317)
2019,Enero,Ecuador,80,125,,205,POINT (7819 -72453013)
2019,Enero,Ecuador,6,8,,14,POINT (836068 -72409396)
2019,Enero,Egipto,2,3,,5,POINT (10446304 -75516486)
2019,Enero,Egipto,0,2,,2,POINT (3451668 -76532004)
2019,Enero,Egipto,9,13,,22,POINT (4697157 -74140516)
2019,Enero,Egipto,1,1,,2,POINT (6170465 -7542726)
2019,Enero,El Salvador,0,1,,1,POINT (-4214082 -69941431)
2019,Enero,El Salvador,3,7,,10,POINT (0.81488 -77356)
2019,Enero,El Salvador,0,1,,1,POINT (10406342 -75527794)
2019,Enero,El Salvador,198,229,,427,POINT (10446304 -75516486)
2019,Enero,El Salvador,5,7,,12,POINT (10886686 -74776479)
2019,Enero,El Salvador,0,1,,1,POINT (125862 -81702165)
2019,Enero,El Salvador,103,100,,203,POINT (3451668 -76532004)
2019,Enero,El Salvador,1,0,,1,POINT (445285 -75766353)
2019,Enero,El Salvador,515,683,,1198,POINT (4697157 -74140516)
2019,Enero,El Salvador,2,3,,5,POINT (4815189 -75736374)
2019,Enero,El Salvador,34,64,,98,POINT (6170465 -7542726)
2019,Enero,Emiratos Árabes,0,2,,2,POINT (10446304 -75516486)
2019,Enero,Emiratos Árabes,0,1,,1,POINT (10886686 -74776479)
2019,Enero,Emiratos Árabes,4,13,,17,POINT (4697157 -74140516)
2019,Enero,Emiratos Árabes,0,3,,3,POINT (6170465 -7542726)
2019,Enero,España,4,1,,5,POINT (-4191162 -69941498)
2019,Enero,España,7,5,,12,POINT (-4214082 -69941431)
2019,Enero,España,1,4,,5,POINT (0.33002 -76876446)
2019,Enero,España,42,74,,116,POINT (0.81488 -77356)
2019,Enero,España,0,1,,1,POINT (1800143 -78802679)
2019,Enero,España,14,28,,42,POINT (10406342 -75527794)
2019,Enero,España,124,172,,296,POINT (10446304 -75516486)
2019,Enero,España,12,42,,54,POINT (10886686 -74776479)
2019,Enero,España,0,1,,1,POINT (10970933 -74765343)
2019,Enero,España,4,2,,6,POINT (11117206 -74232675)
2019,Enero,España,2,5,,7,POINT (11247723 -74213989)
2019,Enero,España,3,12,,15,POINT (11360029 -72129595)
2019,Enero,España,6,6,,12,POINT (125862 -81702165)
2019,Enero,España,240,405,,645,POINT (3451668 -76532004)
2019,Enero,España,1,1,,2,POINT (445285 -75766353)
2019,Enero,España,3070,5617,,8687,POINT (4697157 -74140516)
2019,Enero,España,4,10,,14,POINT (4815189 -75736374)
2019,Enero,España,330,757,,1087,POINT (6170465 -7542726)
2019,Enero,España,0,1,,1,POINT (6218835 -75586989)
2019,Enero,España,1,3,,4,POINT (7088729 -70740253)
2019,Enero,España,1,4,,5,POINT (7128047 -73181317)
2019,Enero,España,22,42,,64,POINT (7819 -72453013)
2019,Enero,España,3,10,,13,POINT (836068 -72409396)
2019,Enero,España,3,3,,6,POINT (863337 -7735002)
2019,Enero,Eritrea,2,1,,3,POINT (4697157 -74140516)
2019,Enero,Eslovaquia,1,1,,2,POINT (0.81488 -77356)
2019,Enero,Eslovaquia,1,0,,1,POINT (10406342 -75527794)
2019,Enero,Eslovaquia,11,9,,20,POINT (10446304 -75516486)
2019,Enero,Eslovaquia,0,3,,3,POINT (10886686 -74776479)
2019,Enero,Eslovaquia,0,2,,2,POINT (3451668 -76532004)
2019,Enero,Eslovaquia,50,95,,145,POINT (4697157 -74140516)
2019,Enero,Eslovaquia,0,5,,5,POINT (4815189 -75736374)
2019,Enero,Eslovaquia,7,13,,20,POINT (6170465 -7542726)
2019,Enero,Eslovaquia,2,1,,3,POINT (7819 -72453013)
2019,Enero,Eslovaquia,1,7,,8,POINT (863337 -7735002)
2019,Enero,Eslovenia,3,3,,6,POINT (0.81488 -77356)
2019,Enero,Eslovenia,1,2,,3,POINT (10446304 -75516486)
2019,Enero,Eslovenia,2,5,,7,POINT (3451668 -76532004)
2019,Enero,Eslovenia,37,47,,84,POINT (4697157 -74140516)
2019,Enero,Eslovenia,0,6,,6,POINT (6170465 -7542726)
2019,Enero,Eslovenia,0,1,,1,POINT (7819 -72453013)
2019,Enero,Estados Unidos de América,9,18,,27,POINT (-4191162 -69941498)
2019,Enero,Estados Unidos de América,8,16,,24,POINT (-4214082 -69941431)
2019,Enero,Estados Unidos de América,3,8,,11,POINT (0.33002 -76876446)
2019,Enero,Estados Unidos de América,0,1,,1,POINT (0.812436 -77847006)
2019,Enero,Estados Unidos de América,80,123,,203,POINT (0.81488 -77356)
2019,Enero,Estados Unidos de América,1,0,,1,POINT (1800143 -78802679)
2019,Enero,Estados Unidos de América,42,75,,117,POINT (10406342 -75527794)
2019,Enero,Estados Unidos de América,5077,6991,,12068,POINT (10446304 -75516486)
2019,Enero,Estados Unidos de América,438,797,,1235,POINT (10886686 -74776479)
2019,Enero,Estados Unidos de América,0,1,,1,POINT (10970933 -74765343)
2019,Enero,Estados Unidos de América,31,47,,78,POINT (11117206 -74232675)
2019,Enero,Estados Unidos de América,8,11,,19,POINT (11247723 -74213989)
2019,Enero,Estados Unidos de América,1,8,,9,POINT (11360029 -72129595)
2019,Enero,Estados Unidos de América,3,6,,9,POINT (125744111 -81703935)
2019,Enero,Estados Unidos de América,27,34,,61,POINT (125862 -81702165)
2019,Enero,Estados Unidos de América,1,1,,2,POINT (133387613 -81372937)
2019,Enero,Estados Unidos de América,1034,1612,,2646,POINT (3451668 -76532004)
2019,Enero,Estados Unidos de América,84,146,,230,POINT (445285 -75766353)
2019,Enero,Estados Unidos de América,8495,14663,,23158,POINT (4697157 -74140516)
2019,Enero,Estados Unidos de América,182,332,,514,POINT (4815189 -75736374)
2019,Enero,Estados Unidos de América,2816,6991,,9807,POINT (6170465 -7542726)
2019,Enero,Estados Unidos de América,0,1,,1,POINT (6218835 -75586989)
2019,Enero,Estados Unidos de América,1,1,,2,POINT (7088729 -70740253)
2019,Enero,Estados Unidos de América,26,39,,65,POINT (7128047 -73181317)
2019,Enero,Estados Unidos de América,10,25,,35,POINT (7819 -72453013)
2019,Enero,Estados Unidos de América,2,4,,6,POINT (836068 -72409396)
2019,Enero,Estados Unidos de América,16,19,,35,POINT (863337 -7735002)
2019,Enero,Estonia,2,0,,2,POINT (0.81488 -77356)
2019,Enero,Estonia,2,9,,11,POINT (10446304 -75516486)
2019,Enero,Estonia,0,1,,1,POINT (11360029 -72129595)
2019,Enero,Estonia,28,32,,60,POINT (4697157 -74140516)
2019,Enero,Estonia,1,6,,7,POINT (6170465 -7542726)
2019,Enero,Etiopia,0,1,,1,POINT (3451668 -76532004)
2019,Enero,Etiopia,3,42,,45,POINT (4697157 -74140516)
2019,Enero,Filipinas,1,0,,1,POINT (-4214082 -69941431)
2019,Enero,Filipinas,0,1,,1,POINT (0.81488 -77356)
2019,Enero,Filipinas,5,37,,42,POINT (10406342 -75527794)
2019,Enero,Filipinas,10,45,,55,POINT (10446304 -75516486)
2019,Enero,Filipinas,1,26,,27,POINT (10886686 -74776479)
2019,Enero,Filipinas,0,33,,33,POINT (10970933 -74765343)
2019,Enero,Filipinas,0,10,,10,POINT (11247723 -74213989)
2019,Enero,Filipinas,3,7,,10,POINT (3451668 -76532004)
2019,Enero,Filipinas,0,20,,20,POINT (3884426 -77061029)
2019,Enero,Filipinas,64,75,,139,POINT (4697157 -74140516)
2019,Enero,Filipinas,9,5,,14,POINT (6170465 -7542726)
2019,Enero,Filipinas,0,11,,11,POINT (9402597 -75681642)
2019,Enero,Finlandia,0,1,,1,POINT (-4191162 -69941498)
2019,Enero,Finlandia,0,1,,1,POINT (-4214082 -69941431)
2019,Enero,Finlandia,7,2,,9,POINT (0.81488 -77356)
2019,Enero,Finlandia,3,3,,6,POINT (10406342 -75527794)
2019,Enero,Finlandia,15,21,,36,POINT (10446304 -75516486)
2019,Enero,Finlandia,1,1,,2,POINT (10886686 -74776479)
2019,Enero,Finlandia,1,0,,1,POINT (11117206 -74232675)
2019,Enero,Finlandia,2,14,,16,POINT (3451668 -76532004)
2019,Enero,Finlandia,72,84,,156,POINT (4697157 -74140516)
2019,Enero,Finlandia,7,22,,29,POINT (6170465 -7542726)
2019,Enero,Finlandia,1,0,,1,POINT (7819 -72453013)
2019,Enero,Finlandia,1,2,,3,POINT (863337 -7735002)
2019,Enero,Francia,7,6,,13,POINT (-4191162 -69941498)
2019,Enero,Francia,21,20,,41,POINT (-4214082 -69941431)
2019,Enero,Francia,3,5,,8,POINT (0.33002 -76876446)
2019,Enero,Francia,123,163,,286,POINT (0.81488 -77356)
2019,Enero,Francia,14,30,,44,POINT (10406342 -75527794)
2019,Enero,Francia,261,315,,576,POINT (10446304 -75516486)
2019,Enero,Francia,23,38,,61,POINT (10886686 -74776479)
2019,Enero,Francia,4,4,,8,POINT (11117206 -74232675)
2019,Enero,Francia,2,7,,9,POINT (11247723 -74213989)
2019,Enero,Francia,0,1,,1,POINT (11360029 -72129595)
2019,Enero,Francia,2,1,,3,POINT (125744111 -81703935)
2019,Enero,Francia,2,6,,8,POINT (125862 -81702165)
2019,Enero,Francia,3,6,,9,POINT (133387613 -81372937)
2019,Enero,Francia,119,175,,294,POINT (3451668 -76532004)
2019,Enero,Francia,0,1,,1,POINT (3884426 -77061029)
2019,Enero,Francia,3466,4222,,7688,POINT (4697157 -74140516)
2019,Enero,Francia,6,9,,15,POINT (4815189 -75736374)
2019,Enero,Francia,236,432,,668,POINT (6170465 -7542726)
2019,Enero,Francia,3,4,,7,POINT (7128047 -73181317)
2019,Enero,Francia,2,8,,10,POINT (7819 -72453013)
2019,Enero,Francia,0,1,,1,POINT (836068 -72409396)
2019,Enero,Francia,5,14,,19,POINT (863337 -7735002)
2019,Enero,Georgia,1,1,,2,POINT (-4214082 -69941431)
2019,Enero,Georgia,2,1,,3,POINT (10446304 -75516486)
2019,Enero,Georgia,6,3,,9,POINT (4697157 -74140516)
2019,Enero,Georgia,1,0,,1,POINT (7128047 -73181317)
2019,Enero,Georgia,0,1,,1,POINT (9402597 -75681642)
2019,Enero,Ghana,0,1,,1,POINT (0.81488 -77356)
2019,Enero,Ghana,0,1,,1,POINT (10446304 -75516486)
2019,Enero,Ghana,0,1,,1,POINT (3451668 -76532004)
2019,Enero,Ghana,1,6,,7,POINT (4697157 -74140516)
2019,Enero,Granada,0,9,,9,POINT (4697157 -74140516)
2019,Enero,Granada,0,2,,2,POINT (6170465 -7542726)
2019,Enero,Grecia,0,2,,2,POINT (-4214082 -69941431)
2019,Enero,Grecia,0,3,,3,POINT (10406342 -75527794)
2019,Enero,Grecia,1,5,,6,POINT (10446304 -75516486)
2019,Enero,Grecia,0,3,,3,POINT (11247723 -74213989)
2019,Enero,Grecia,0,4,,4,POINT (3451668 -76532004)
2019,Enero,Grecia,34,82,,116,POINT (4697157 -74140516)
2019,Enero,Grecia,1,0,,1,POINT (4815189 -75736374)
2019,Enero,Grecia,3,16,,19,POINT (6170465 -7542726)
2019,Enero,Grecia,0,3,,3,POINT (7819 -72453013)
2019,Enero,Grecia,0,1,,1,POINT (806667 -767333)
2019,Enero,Grecia,1,1,,2,POINT (863337 -7735002)
2019,Enero,Grecia,0,1,,1,POINT (9402597 -75681642)
2019,Enero,Guatemala,1,0,,1,POINT (0.33002 -76876446)
2019,Enero,Guatemala,2,6,,8,POINT (0.81488 -77356)
2019,Enero,Guatemala,0,5,,5,POINT (10406342 -75527794)
2019,Enero,Guatemala,130,153,,283,POINT (10446304 -75516486)
2019,Enero,Guatemala,6,15,,21,POINT (10886686 -74776479)
2019,Enero,Guatemala,1,1,,2,POINT (125862 -81702165)
2019,Enero,Guatemala,11,34,,45,POINT (3451668 -76532004)
2019,Enero,Guatemala,414,703,,1117,POINT (4697157 -74140516)
2019,Enero,Guatemala,7,6,,13,POINT (4815189 -75736374)
2019,Enero,Guatemala,48,97,,145,POINT (6170465 -7542726)
2019,Enero,Guatemala,0,1,,1,POINT (6218835 -75586989)
2019,Enero,Guatemala,1,0,,1,POINT (7088729 -70740253)
2019,Enero,Guatemala,0,1,,1,POINT (7128047 -73181317)
2019,Enero,Guatemala,2,4,,6,POINT (7819 -72453013)
2019,Enero,Guatemala,1,0,,1,POINT (836068 -72409396)
2019,Enero,Guyana,3,3,,6,POINT (10446304 -75516486)
2019,Enero,Guyana,0,1,,1,POINT (11360029 -72129595)
2019,Enero,Guyana,1,2,,3,POINT (3451668 -76532004)
2019,Enero,Guyana,13,14,,27,POINT (4697157 -74140516)
2019,Enero,Guyana,0,2,,2,POINT (6170465 -7542726)
2019,Enero,Guyana,1,0,,1,POINT (7819 -72453013)
2019,Enero,Guyana,1,0,,1,POINT (836068 -72409396)
2019,Enero,Guinea Ecuatorial,0,2,,2,POINT (3451668 -76532004)
2019,Enero,Haití,2,6,,8,POINT (10446304 -75516486)
2019,Enero,Haití,2,0,,2,POINT (10886686 -74776479)
2019,Enero,Haití,0,2,,2,POINT (3451668 -76532004)
2019,Enero,Haití,17,27,,44,POINT (4697157 -74140516)
2019,Enero,Haití,3,5,,8,POINT (6170465 -7542726)
2019,Enero,Honduras,1,0,,1,POINT (-4214082 -69941431)
2019,Enero,Honduras,3,4,,7,POINT (0.81488 -77356)
2019,Enero,Honduras,1,5,,6,POINT (10406342 -75527794)
2019,Enero,Honduras,79,67,,146,POINT (10446304 -75516486)
2019,Enero,Honduras,9,8,,17,POINT (10886686 -74776479)
2019,Enero,Honduras,2,9,,11,POINT (11360029 -72129595)
2019,Enero,Honduras,1,3,,4,POINT (125862 -81702165)
2019,Enero,Honduras,53,40,,93,POINT (3451668 -76532004)
2019,Enero,Honduras,238,230,,468,POINT (4697157 -74140516)
2019,Enero,Honduras,9,27,,36,POINT (4815189 -75736374)
2019,Enero,Honduras,52,74,,126,POINT (6170465 -7542726)
2019,Enero,Honduras,4,0,,4,POINT (7128047 -73181317)
2019,Enero,Honduras,0,2,,2,POINT (7819 -72453013)
2019,Enero,Honduras,0,1,,1,POINT (836068 -72409396)
2019,Enero,Hong Kong,2,0,,2,POINT (10446304 -75516486)
2019,Enero,Hong Kong,13,11,,24,POINT (4697157 -74140516)
2019,Enero,Hong Kong,4,3,,7,POINT (6170465 -7542726)
2019,Enero,Hungría,0,1,,1,POINT (-4214082 -69941431)
2019,Enero,Hungría,1,1,,2,POINT (0.81488 -77356)
2019,Enero,Hungría,1,2,,3,POINT (10406342 -75527794)
2019,Enero,Hungría,10,13,,23,POINT (10446304 -75516486)
2019,Enero,Hungría,1,1,,2,POINT (10886686 -74776479)
2019,Enero,Hungría,0,1,,1,POINT (11247723 -74213989)
2019,Enero,Hungría,0,1,,1,POINT (125862 -81702165)
2019,Enero,Hungría,6,5,,11,POINT (3451668 -76532004)
2019,Enero,Hungría,48,96,,144,POINT (4697157 -74140516)
2019,Enero,Hungría,9,17,,26,POINT (6170465 -7542726)
2019,Enero,Hungría,0,3,,3,POINT (7819 -72453013)
2019,Enero,Hungría,1,1,,2,POINT (863337 -7735002)
2019,Enero,India,0,1,,1,POINT (0.33002 -76876446)
2019,Enero,India,15,3,,18,POINT (0.81488 -77356)
2019,Enero,India,0,7,,7,POINT (10406342 -75527794)
2019,Enero,India,11,58,,69,POINT (10446304 -75516486)
2019,Enero,India,0,13,,13,POINT (10886686 -74776479)
2019,Enero,India,0,1,,1,POINT (10970933 -74765343)
2019,Enero,India,0,1,,1,POINT (11247723 -74213989)
2019,Enero,India,2,17,,19,POINT (3451668 -76532004)
2019,Enero,India,0,1,,1,POINT (3884426 -77061029)
2019,Enero,India,104,448,,552,POINT (4697157 -74140516)
2019,Enero,India,0,1,,1,POINT (4815189 -75736374)
2019,Enero,India,27,103,,130,POINT (6170465 -7542726)
2019,Enero,India,0,1,,1,POINT (7128047 -73181317)
2019,Enero,India,0,1,,1,POINT (9402597 -75681642)
2019,Enero,Indonesia,0,4,,4,POINT (10406342 -75527794)
2019,Enero,Indonesia,2,6,,8,POINT (10446304 -75516486)
2019,Enero,Indonesia,0,1,,1,POINT (10970933 -74765343)
2019,Enero,Indonesia,0,1,,1,POINT (3451668 -76532004)
2019,Enero,Indonesia,15,22,,37,POINT (4697157 -74140516)
2019,Enero,Indonesia,0,1,,1,POINT (6170465 -7542726)
2019,Enero,Iraq,0,1,,1,POINT (10446304 -75516486)
2019,Enero,Iraq,0,1,,1,POINT (3451668 -76532004)
2019,Enero,Iraq,1,4,,5,POINT (4697157 -74140516)
2019,Enero,Irán,0,1,,1,POINT (10446304 -75516486)
2019,Enero,Irán,0,1,,1,POINT (3451668 -76532004)
2019,Enero,Irán,8,13,,21,POINT (4697157 -74140516)
2019,Enero,Irán,0,1,,1,POINT (6170465 -7542726)
2019,Enero,República de Irlanda,1,0,,1,POINT (-4191162 -69941498)
2019,Enero,República de Irlanda,2,2,,4,POINT (-4214082 -69941431)
2019,Enero,República de Irlanda,5,6,,11,POINT (0.81488 -77356)
2019,Enero,República de Irlanda,10,6,,16,POINT (10406342 -75527794)
2019,Enero,República de Irlanda,17,44,,61,POINT (10446304 -75516486)
2019,Enero,República de Irlanda,2,10,,12,POINT (10886686 -74776479)
2019,Enero,República de Irlanda,1,0,,1,POINT (125862 -81702165)
2019,Enero,República de Irlanda,2,10,,12,POINT (3451668 -76532004)
2019,Enero,República de Irlanda,126,245,,371,POINT (4697157 -74140516)
2019,Enero,República de Irlanda,0,1,,1,POINT (4815189 -75736374)
2019,Enero,República de Irlanda,17,43,,60,POINT (6170465 -7542726)
2019,Enero,República de Irlanda,0,1,,1,POINT (7088729 -70740253)
2019,Enero,República de Irlanda,0,1,,1,POINT (7819 -72453013)
2019,Enero,República de Irlanda,11,7,,18,POINT (863337 -7735002)
2019,Enero,Islandia,1,0,,1,POINT (0.81488 -77356)
2019,Enero,Islandia,1,2,,3,POINT (10446304 -75516486)
2019,Enero,Islandia,0,1,,1,POINT (3451668 -76532004)
2019,Enero,Islandia,1,5,,6,POINT (4697157 -74140516)
2019,Enero,Islandia,1,0,,1,POINT (4815189 -75736374)
2019,Enero,Islandia,1,12,,13,POINT (6170465 -7542726)
2019,Enero,Israel,4,13,,17,POINT (0.81488 -77356)
2019,Enero,Israel,4,2,,6,POINT (10406342 -75527794)
2019,Enero,Israel,18,53,,71,POINT (10446304 -75516486)
2019,Enero,Israel,1,1,,2,POINT (10886686 -74776479)
2019,Enero,Israel,0,1,,1,POINT (11360029 -72129595)
2019,Enero,Israel,0,2,,2,POINT (125862 -81702165)
2019,Enero,Israel,6,20,,26,POINT (3451668 -76532004)
2019,Enero,Israel,108,404,,512,POINT (4697157 -74140516)
2019,Enero,Israel,12,81,,93,POINT (6170465 -7542726)
2019,Enero,Israel,0,1,,1,POINT (863337 -7735002)
2019,Enero,Italia,2,2,,4,POINT (-4191162 -69941498)
2019,Enero,Italia,3,6,,9,POINT (-4214082 -69941431)
2019,Enero,Italia,1,4,,5,POINT (0.33002 -76876446)
2019,Enero,Italia,21,32,,53,POINT (0.81488 -77356)
2019,Enero,Italia,2,12,,14,POINT (10406342 -75527794)
2019,Enero,Italia,120,312,,432,POINT (10446304 -75516486)
2019,Enero,Italia,17,42,,59,POINT (10886686 -74776479)
2019,Enero,Italia,2,8,,10,POINT (11117206 -74232675)
2019,Enero,Italia,1,1,,2,POINT (11247723 -74213989)
2019,Enero,Italia,1,8,,9,POINT (11360029 -72129595)
2019,Enero,Italia,0,1,,1,POINT (125744111 -81703935)
2019,Enero,Italia,10,15,,25,POINT (125862 -81702165)
2019,Enero,Italia,34,105,,139,POINT (3451668 -76532004)
2019,Enero,Italia,0,1,,1,POINT (3866713 -67927521)
2019,Enero,Italia,0,1,,1,POINT (3884426 -77061029)
2019,Enero,Italia,0,1,,1,POINT (445285 -75766353)
2019,Enero,Italia,1065,2239,,3304,POINT (4697157 -74140516)
2019,Enero,Italia,0,8,,8,POINT (4815189 -75736374)
2019,Enero,Italia,105,350,,455,POINT (6170465 -7542726)
2019,Enero,Italia,1,1,,2,POINT (7128047 -73181317)
2019,Enero,Italia,15,24,,39,POINT (7819 -72453013)
2019,Enero,Italia,3,4,,7,POINT (836068 -72409396)
2019,Enero,Italia,1,3,,4,POINT (863337 -7735002)
2019,Enero,Jamaica,0,1,,1,POINT (0.81488 -77356)
2019,Enero,Jamaica,7,9,,16,POINT (10446304 -75516486)
2019,Enero,Jamaica,1,4,,5,POINT (10886686 -74776479)
2019,Enero,Jamaica,0,1,,1,POINT (125862 -81702165)
2019,Enero,Jamaica,6,3,,9,POINT (3451668 -76532004)
2019,Enero,Jamaica,0,1,,1,POINT (445285 -75766353)
2019,Enero,Jamaica,23,26,,49,POINT (4697157 -74140516)
2019,Enero,Jamaica,8,9,,17,POINT (6170465 -7542726)
2019,Enero,Japón,2,1,,3,POINT (-4191162 -69941498)
2019,Enero,Japón,0,3,,3,POINT (-4214082 -69941431)
2019,Enero,Japón,4,13,,17,POINT (0.81488 -77356)
2019,Enero,Japón,11,14,,25,POINT (10446304 -75516486)
2019,Enero,Japón,0,4,,4,POINT (10886686 -74776479)
2019,Enero,Japón,0,1,,1,POINT (11360029 -72129595)
2019,Enero,Japón,2,2,,4,POINT (125862 -81702165)
2019,Enero,Japón,4,9,,13,POINT (3451668 -76532004)
2019,Enero,Japón,185,456,,641,POINT (4697157 -74140516)
2019,Enero,Japón,1,1,,2,POINT (4815189 -75736374)
2019,Enero,Japón,19,53,,72,POINT (6170465 -7542726)
2019,Enero,Japón,0,1,,1,POINT (7819 -72453013)
2019,Enero,Jordania,0,1,,1,POINT (0.81488 -77356)
2019,Enero,Jordania,0,1,,1,POINT (10406342 -75527794)
2019,Enero,Jordania,1,0,,1,POINT (10446304 -75516486)
2019,Enero,Jordania,0,1,,1,POINT (10886686 -74776479)
2019,Enero,Jordania,6,3,,9,POINT (4697157 -74140516)
2019,Enero,Kazajistán,7,7,,14,POINT (4697157 -74140516)
2019,Enero,Kazajistán,1,0,,1,POINT (6170465 -7542726)
2019,Enero,Kenia,0,1,,1,POINT (0.33002 -76876446)
2019,Enero,Kenia,1,1,,2,POINT (10446304 -75516486)
2019,Enero,Kenia,0,3,,3,POINT (3451668 -76532004)
2019,Enero,Kenia,5,4,,9,POINT (4697157 -74140516)
2019,Enero,Kirguistán,1,0,,1,POINT (4697157 -74140516)
2019,Enero,Kuwait,0,1,,1,POINT (4697157 -74140516)
2019,Enero,República de Kosovo,0,1,,1,POINT (3451668 -76532004)
2019,Enero,República Democrática Popular  Lao,1,0,,1,POINT (4697157 -74140516)
2019,Enero,Letonia,0,2,,2,POINT (0.81488 -77356)
2019,Enero,Letonia,0,1,,1,POINT (10406342 -75527794)
2019,Enero,Letonia,5,7,,12,POINT (10446304 -75516486)
2019,Enero,Letonia,0,1,,1,POINT (3451668 -76532004)
2019,Enero,Letonia,0,1,,1,POINT (3884426 -77061029)
2019,Enero,Letonia,23,31,,54,POINT (4697157 -74140516)
2019,Enero,Letonia,4,4,,8,POINT (6170465 -7542726)
2019,Enero,Lituania,2,0,,2,POINT (0.81488 -77356)
2019,Enero,Lituania,0,1,,1,POINT (10406342 -75527794)
2019,Enero,Lituania,5,4,,9,POINT (10446304 -75516486)
2019,Enero,Lituania,0,1,,1,POINT (10886686 -74776479)
2019,Enero,Lituania,1,3,,4,POINT (3451668 -76532004)
2019,Enero,Lituania,29,33,,62,POINT (4697157 -74140516)
2019,Enero,Lituania,1,0,,1,POINT (4815189 -75736374)
2019,Enero,Lituania,2,2,,4,POINT (6170465 -7542726)
2019,Enero,Líbano,0,1,,1,POINT (10446304 -75516486)
2019,Enero,Líbano,1,4,,5,POINT (10886686 -74776479)
2019,Enero,Líbano,1,1,,2,POINT (11360029 -72129595)
2019,Enero,Líbano,23,32,,55,POINT (4697157 -74140516)
2019,Enero,Líbano,0,2,,2,POINT (6170465 -7542726)
2019,Enero,Liberia,1,0,,1,POINT (4697157 -74140516)
2019,Enero,Liechtenstein,0,1,,1,POINT (10446304 -75516486)
2019,Enero,Liechtenstein,1,3,,4,POINT (4697157 -74140516)
2019,Enero,Liechtenstein,0,1,,1,POINT (6170465 -7542726)
2019,Enero,Liechtenstein,0,1,,1,POINT (806667 -767333)
2019,Enero,Luxemburgo,0,1,,1,POINT (0.81488 -77356)
2019,Enero,Luxemburgo,1,3,,4,POINT (10446304 -75516486)
2019,Enero,Luxemburgo,1,2,,3,POINT (3451668 -76532004)
2019,Enero,Luxemburgo,9,20,,29,POINT (4697157 -74140516)
2019,Enero,Luxemburgo,1,2,,3,POINT (6170465 -7542726)
2019,Enero,Luxemburgo,0,1,,1,POINT (863337 -7735002)
2019,Enero,Macedonia,1,1,,2,POINT (10446304 -75516486)
2019,Enero,Macedonia,4,6,,10,POINT (4697157 -74140516)
2019,Enero,Macedonia,0,2,,2,POINT (6170465 -7542726)
2019,Enero,Madagascar,2,1,,3,POINT (4697157 -74140516)
2019,Enero,Madagascar,1,0,,1,POINT (6170465 -7542726)
2019,Enero,Malasia,1,0,,1,POINT (0.81488 -77356)
2019,Enero,Malasia,1,12,,13,POINT (10446304 -75516486)
2019,Enero,Malasia,14,8,,22,POINT (4697157 -74140516)
2019,Enero,Malasia,1,2,,3,POINT (6170465 -7542726)
2019,Enero,Malí,0,2,,2,POINT (4697157 -74140516)
2019,Enero,Malta,1,0,,1,POINT (0.81488 -77356)
2019,Enero,Malta,2,2,,4,POINT (10446304 -75516486)
2019,Enero,Malta,4,11,,15,POINT (4697157 -74140516)
2019,Enero,Marruecos,0,1,,1,POINT (10446304 -75516486)
2019,Enero,Marruecos,13,13,,26,POINT (4697157 -74140516)
2019,Enero,Marruecos,0,1,,1,POINT (6170465 -7542726)
2019,Enero,Mauricio,0,1,,1,POINT (0.81488 -77356)
2019,Enero,Mauricio,0,2,,2,POINT (10406342 -75527794)
2019,Enero,Mauricio,3,0,,3,POINT (4697157 -74140516)
2019,Enero,Mauricio,1,0,,1,POINT (6170465 -7542726)
2019,Enero,México,3,3,,6,POINT (-4191162 -69941498)
2019,Enero,México,11,6,,17,POINT (-4214082 -69941431)
2019,Enero,México,2,8,,10,POINT (0.33002 -76876446)
2019,Enero,México,26,38,,64,POINT (0.81488 -77356)
2019,Enero,México,8,17,,25,POINT (10406342 -75527794)
2019,Enero,México,291,375,,666,POINT (10446304 -75516486)
2019,Enero,México,32,61,,93,POINT (10886686 -74776479)
2019,Enero,México,0,3,,3,POINT (11360029 -72129595)
2019,Enero,México,6,4,,10,POINT (125862 -81702165)
2019,Enero,México,80,156,,236,POINT (3451668 -76532004)
2019,Enero,México,3,4,,7,POINT (445285 -75766353)
2019,Enero,México,4291,6745,,11036,POINT (4697157 -74140516)
2019,Enero,México,10,24,,34,POINT (4815189 -75736374)
2019,Enero,México,456,1072,,1528,POINT (6170465 -7542726)
2019,Enero,México,2,0,,2,POINT (6185536 -67484028)
2019,Enero,México,1,1,,2,POINT (7088729 -70740253)
2019,Enero,México,14,13,,27,POINT (7128047 -73181317)
2019,Enero,México,19,35,,54,POINT (7819 -72453013)
2019,Enero,México,2,5,,7,POINT (836068 -72409396)
2019,Enero,México,1,0,,1,POINT (863337 -7735002)
2019,Enero,República de Moldavia,0,1,,1,POINT (10446304 -75516486)
2019,Enero,República de Moldavia,2,4,,6,POINT (4697157 -74140516)
2019,Enero,República de Moldavia,0,1,,1,POINT (4815189 -75736374)
2019,Enero,Mónaco,0,1,,1,POINT (0.81488 -77356)
2019,Enero,Mónaco,0,2,,2,POINT (4697157 -74140516)
2019,Enero,Mongolia,1,0,,1,POINT (10446304 -75516486)
2019,Enero,Mongolia,3,2,,5,POINT (4697157 -74140516)
2019,Enero,Montenegro,0,1,,1,POINT (0.81488 -77356)
2019,Enero,Montenegro,1,2,,3,POINT (10446304 -75516486)
2019,Enero,Montenegro,1,1,,2,POINT (3451668 -76532004)
2019,Enero,Montenegro,0,1,,1,POINT (3884426 -77061029)
2019,Enero,Montenegro,1,1,,2,POINT (4697157 -74140516)
2019,Enero,Montenegro,0,6,,6,POINT (6170465 -7542726)
2019,Enero,Micronesia,0,1,,1,POINT (4697157 -74140516)
2019,Enero,Mozambique,1,6,,7,POINT (4697157 -74140516)
2019,Enero,Myanmar,0,3,,3,POINT (10886686 -74776479)
2019,Enero,Myanmar,0,3,,3,POINT (10970933 -74765343)
2019,Enero,Myanmar,0,1,,1,POINT (4697157 -74140516)
2019,Enero,Namibia,0,2,,2,POINT (4697157 -74140516)
2019,Enero,Nepal,1,0,,1,POINT (10446304 -75516486)
2019,Enero,Nepal,0,1,,1,POINT (4697157 -74140516)
2019,Enero,Nepal,2,0,,2,POINT (6170465 -7542726)
2019,Enero,Nicaragua,0,1,,1,POINT (0.81488 -77356)
2019,Enero,Nicaragua,0,3,,3,POINT (10406342 -75527794)
2019,Enero,Nicaragua,19,20,,39,POINT (10446304 -75516486)
2019,Enero,Nicaragua,2,1,,3,POINT (10886686 -74776479)
2019,Enero,Nicaragua,0,1,,1,POINT (11247723 -74213989)
2019,Enero,Nicaragua,1,2,,3,POINT (125862 -81702165)
2019,Enero,Nicaragua,22,19,,41,POINT (3451668 -76532004)
2019,Enero,Nicaragua,91,123,,214,POINT (4697157 -74140516)
2019,Enero,Nicaragua,5,3,,8,POINT (4815189 -75736374)
2019,Enero,Nicaragua,12,12,,24,POINT (6170465 -7542726)
2019,Enero,Nicaragua,9,8,,17,POINT (7128047 -73181317)
2019,Enero,Nigeria,0,1,,1,POINT (0.81488 -77356)
2019,Enero,Nigeria,3,2,,5,POINT (10446304 -75516486)
2019,Enero,Nigeria,0,1,,1,POINT (11360029 -72129595)
2019,Enero,Nigeria,1,0,,1,POINT (3451668 -76532004)
2019,Enero,Nigeria,3,5,,8,POINT (4697157 -74140516)
2019,Enero,Nigeria,1,3,,4,POINT (6170465 -7542726)
2019,Enero,Noruega,2,0,,2,POINT (-4214082 -69941431)
2019,Enero,Noruega,6,2,,8,POINT (0.81488 -77356)
2019,Enero,Noruega,2,5,,7,POINT (10406342 -75527794)
2019,Enero,Noruega,33,34,,67,POINT (10446304 -75516486)
2019,Enero,Noruega,4,5,,9,POINT (10886686 -74776479)
2019,Enero,Noruega,2,2,,4,POINT (11117206 -74232675)
2019,Enero,Noruega,1,3,,4,POINT (11247723 -74213989)
2019,Enero,Noruega,0,2,,2,POINT (11360029 -72129595)
2019,Enero,Noruega,0,1,,1,POINT (125744111 -81703935)
2019,Enero,Noruega,1,2,,3,POINT (125862 -81702165)
2019,Enero,Noruega,1,1,,2,POINT (133387613 -81372937)
2019,Enero,Noruega,5,14,,19,POINT (3451668 -76532004)
2019,Enero,Noruega,141,187,,328,POINT (4697157 -74140516)
2019,Enero,Noruega,12,26,,38,POINT (6170465 -7542726)
2019,Enero,Noruega,0,1,,1,POINT (7128047 -73181317)
2019,Enero,Noruega,1,1,,2,POINT (7819 -72453013)
2019,Enero,Noruega,1,1,,2,POINT (863337 -7735002)
2019,Enero,Nueva Zelanda,0,2,,2,POINT (-4191162 -69941498)
2019,Enero,Nueva Zelanda,0,1,,1,POINT (-4214082 -69941431)
2019,Enero,Nueva Zelanda,7,8,,15,POINT (0.81488 -77356)
2019,Enero,Nueva Zelanda,3,3,,6,POINT (10406342 -75527794)
2019,Enero,Nueva Zelanda,15,19,,34,POINT (10446304 -75516486)
2019,Enero,Nueva Zelanda,1,0,,1,POINT (10886686 -74776479)
2019,Enero,Nueva Zelanda,3,4,,7,POINT (3451668 -76532004)
2019,Enero,Nueva Zelanda,84,125,,209,POINT (4697157 -74140516)
2019,Enero,Nueva Zelanda,9,19,,28,POINT (6170465 -7542726)
2019,Enero,Nueva Zelanda,0,1,,1,POINT (7819 -72453013)
2019,Enero,Nueva Zelanda,1,4,,5,POINT (863337 -7735002)
2019,Enero,Omán,0,1,,1,POINT (10446304 -75516486)
2019,Enero,Países Bajos,4,4,,8,POINT (-4191162 -69941498)
2019,Enero,Países Bajos,3,2,,5,POINT (-4214082 -69941431)
2019,Enero,Países Bajos,0,1,,1,POINT (0.33002 -76876446)
2019,Enero,Países Bajos,44,56,,100,POINT (0.81488 -77356)
2019,Enero,Países Bajos,35,32,,67,POINT (10406342 -75527794)
2019,Enero,Países Bajos,332,315,,647,POINT (10446304 -75516486)
2019,Enero,Países Bajos,5,18,,23,POINT (10886686 -74776479)
2019,Enero,Países Bajos,0,2,,2,POINT (10970933 -74765343)
2019,Enero,Países Bajos,1,1,,2,POINT (11117206 -74232675)
2019,Enero,Países Bajos,5,7,,12,POINT (11247723 -74213989)
2019,Enero,Países Bajos,1,2,,3,POINT (11360029 -72129595)
2019,Enero,Países Bajos,1,4,,5,POINT (125862 -81702165)
2019,Enero,Países Bajos,68,90,,158,POINT (3451668 -76532004)
2019,Enero,Países Bajos,0,1,,1,POINT (3884426 -77061029)
2019,Enero,Países Bajos,0,1,,1,POINT (445285 -75766353)
2019,Enero,Países Bajos,1646,2168,,3814,POINT (4697157 -74140516)
2019,Enero,Países Bajos,1,5,,6,POINT (4815189 -75736374)
2019,Enero,Países Bajos,140,244,,384,POINT (6170465 -7542726)
2019,Enero,Países Bajos,0,1,,1,POINT (6185536 -67484028)
2019,Enero,Países Bajos,7,4,,11,POINT (7128047 -73181317)
2019,Enero,Países Bajos,0,4,,4,POINT (7819 -72453013)
2019,Enero,Países Bajos,0,1,,1,POINT (836068 -72409396)
2019,Enero,Países Bajos,7,8,,15,POINT (863337 -7735002)
2019,Enero,Pakistán,0,3,,3,POINT (10446304 -75516486)
2019,Enero,Pakistán,0,1,,1,POINT (3451668 -76532004)
2019,Enero,Pakistán,4,19,,23,POINT (4697157 -74140516)
2019,Enero,Pakistán,0,3,,3,POINT (6170465 -7542726)
2019,Enero,Pakistán,0,1,,1,POINT (7128047 -73181317)
2019,Enero,Panamá,10,7,,17,POINT (0.81488 -77356)
2019,Enero,Panamá,2,31,,33,POINT (10406342 -75527794)
2019,Enero,Panamá,488,504,,992,POINT (10446304 -75516486)
2019,Enero,Panamá,141,144,,285,POINT (10886686 -74776479)
2019,Enero,Panamá,0,1,,1,POINT (11247723 -74213989)
2019,Enero,Panamá,68,68,,136,POINT (125862 -81702165)
2019,Enero,Panamá,363,276,,639,POINT (3451668 -76532004)
2019,Enero,Panamá,23,20,,43,POINT (445285 -75766353)
2019,Enero,Panamá,1851,1932,,3783,POINT (4697157 -74140516)
2019,Enero,Panamá,48,75,,123,POINT (4815189 -75736374)
2019,Enero,Panamá,1917,1405,,3322,POINT (6170465 -7542726)
2019,Enero,Panamá,0,2,,2,POINT (6222552 -77401154)
2019,Enero,Panamá,3,2,,5,POINT (7102626 -77762647)
2019,Enero,Panamá,20,19,,39,POINT (7128047 -73181317)
2019,Enero,Panamá,1,4,,5,POINT (7819 -72453013)
2019,Enero,Panamá,0,1,,1,POINT (836068 -72409396)
2019,Enero,Panamá,0,9,,9,POINT (863337 -7735002)
2019,Enero,Paraguay,3,1,,4,POINT (0.81488 -77356)
2019,Enero,Paraguay,1,2,,3,POINT (10406342 -75527794)
2019,Enero,Paraguay,141,96,,237,POINT (10446304 -75516486)
2019,Enero,Paraguay,1,2,,3,POINT (10886686 -74776479)
2019,Enero,Paraguay,42,39,,81,POINT (125862 -81702165)
2019,Enero,Paraguay,16,13,,29,POINT (3451668 -76532004)
2019,Enero,Paraguay,209,146,,355,POINT (4697157 -74140516)
2019,Enero,Paraguay,1,0,,1,POINT (4815189 -75736374)
2019,Enero,Paraguay,31,27,,58,POINT (6170465 -7542726)
2019,Enero,Paraguay,0,1,,1,POINT (7128047 -73181317)
2019,Enero,Paraguay,1,0,,1,POINT (7819 -72453013)
2019,Enero,Perú,12,21,,33,POINT (-4191162 -69941498)
2019,Enero,Perú,65,48,,113,POINT (-4214082 -69941431)
2019,Enero,Perú,1,3,,4,POINT (0.185957 -7478366)
2019,Enero,Perú,2,18,,20,POINT (0.33002 -76876446)
2019,Enero,Perú,239,489,,728,POINT (0.81488 -77356)
2019,Enero,Perú,69,43,,112,POINT (10406342 -75527794)
2019,Enero,Perú,872,648,,1520,POINT (10446304 -75516486)
2019,Enero,Perú,14,21,,35,POINT (10886686 -74776479)
2019,Enero,Perú,0,1,,1,POINT (10970933 -74765343)
2019,Enero,Perú,11,19,,30,POINT (11360029 -72129595)
2019,Enero,Perú,349,245,,594,POINT (125862 -81702165)
2019,Enero,Perú,417,394,,811,POINT (3451668 -76532004)
2019,Enero,Perú,1,1,,2,POINT (445285 -75766353)
2019,Enero,Perú,3730,4145,,7875,POINT (4697157 -74140516)
2019,Enero,Perú,5,13,,18,POINT (4815189 -75736374)
2019,Enero,Perú,938,1063,,2001,POINT (6170465 -7542726)
2019,Enero,Perú,0,1,,1,POINT (6185536 -67484028)
2019,Enero,Perú,6,8,,14,POINT (7088729 -70740253)
2019,Enero,Perú,2,2,,4,POINT (7128047 -73181317)
2019,Enero,Perú,59,125,,184,POINT (7819 -72453013)
2019,Enero,Perú,6,12,,18,POINT (836068 -72409396)
2019,Enero,Perú,0,1,,1,POINT (863337 -7735002)
2019,Enero,Palestina,0,1,,1,POINT (3451668 -76532004)
2019,Enero,Palestina,0,1,,1,POINT (4697157 -74140516)
2019,Enero,Polonia,1,1,,2,POINT (-4191162 -69941498)
2019,Enero,Polonia,2,3,,5,POINT (-4214082 -69941431)
2019,Enero,Polonia,0,1,,1,POINT (0.33002 -76876446)
2019,Enero,Polonia,5,7,,12,POINT (0.81488 -77356)
2019,Enero,Polonia,44,37,,81,POINT (10406342 -75527794)
2019,Enero,Polonia,128,122,,250,POINT (10446304 -75516486)
2019,Enero,Polonia,1,5,,6,POINT (10886686 -74776479)
2019,Enero,Polonia,0,2,,2,POINT (10970933 -74765343)
2019,Enero,Polonia,1,0,,1,POINT (11117206 -74232675)
2019,Enero,Polonia,0,1,,1,POINT (11247723 -74213989)
2019,Enero,Polonia,1,2,,3,POINT (11360029 -72129595)
2019,Enero,Polonia,1,1,,2,POINT (125862 -81702165)
2019,Enero,Polonia,2,25,,27,POINT (3451668 -76532004)
2019,Enero,Polonia,0,2,,2,POINT (3884426 -77061029)
2019,Enero,Polonia,258,382,,640,POINT (4697157 -74140516)
2019,Enero,Polonia,2,6,,8,POINT (4815189 -75736374)
2019,Enero,Polonia,29,25,,54,POINT (6170465 -7542726)
2019,Enero,Polonia,1,0,,1,POINT (7819 -72453013)
2019,Enero,Polonia,0,2,,2,POINT (806667 -767333)
2019,Enero,Polonia,5,4,,9,POINT (863337 -7735002)
2019,Enero,Portugal,1,0,,1,POINT (-4191162 -69941498)
2019,Enero,Portugal,0,1,,1,POINT (0.33002 -76876446)
2019,Enero,Portugal,12,26,,38,POINT (0.81488 -77356)
2019,Enero,Portugal,4,7,,11,POINT (10406342 -75527794)
2019,Enero,Portugal,19,24,,43,POINT (10446304 -75516486)
2019,Enero,Portugal,4,9,,13,POINT (10886686 -74776479)
2019,Enero,Portugal,0,1,,1,POINT (11117206 -74232675)
2019,Enero,Portugal,1,1,,2,POINT (11247723 -74213989)
2019,Enero,Portugal,0,2,,2,POINT (11360029 -72129595)
2019,Enero,Portugal,0,1,,1,POINT (125862 -81702165)
2019,Enero,Portugal,5,17,,22,POINT (3451668 -76532004)
2019,Enero,Portugal,320,573,,893,POINT (4697157 -74140516)
2019,Enero,Portugal,1,1,,2,POINT (4815189 -75736374)
2019,Enero,Portugal,45,63,,108,POINT (6170465 -7542726)
2019,Enero,Portugal,0,2,,2,POINT (7088729 -70740253)
2019,Enero,Portugal,7,15,,22,POINT (7819 -72453013)
2019,Enero,Portugal,2,1,,3,POINT (836068 -72409396)
2019,Enero,Portugal,2,1,,3,POINT (863337 -7735002)
2019,Enero,Qatar,0,1,,1,POINT (4697157 -74140516)
2019,Enero,Reino Unido de Gran Bretaña e Irlanda del Norte,4,4,,8,POINT (-4191162 -69941498)
2019,Enero,Reino Unido de Gran Bretaña e Irlanda del Norte,5,7,,12,POINT (-4214082 -69941431)
2019,Enero,Reino Unido de Gran Bretaña e Irlanda del Norte,1,4,,5,POINT (0.33002 -76876446)
2019,Enero,Reino Unido de Gran Bretaña e Irlanda del Norte,45,74,,119,POINT (0.81488 -77356)
2019,Enero,Reino Unido de Gran Bretaña e Irlanda del Norte,51,59,,110,POINT (10406342 -75527794)
2019,Enero,Reino Unido de Gran Bretaña e Irlanda del Norte,148,243,,391,POINT (10446304 -75516486)
2019,Enero,Reino Unido de Gran Bretaña e Irlanda del Norte,12,21,,33,POINT (10886686 -74776479)
2019,Enero,Reino Unido de Gran Bretaña e Irlanda del Norte,2,4,,6,POINT (11117206 -74232675)
2019,Enero,Reino Unido de Gran Bretaña e Irlanda del Norte,14,16,,30,POINT (11247723 -74213989)
2019,Enero,Reino Unido de Gran Bretaña e Irlanda del Norte,0,1,,1,POINT (11360029 -72129595)
2019,Enero,Reino Unido de Gran Bretaña e Irlanda del Norte,1,1,,2,POINT (125744111 -81703935)
2019,Enero,Reino Unido de Gran Bretaña e Irlanda del Norte,2,3,,5,POINT (125862 -81702165)
2019,Enero,Reino Unido de Gran Bretaña e Irlanda del Norte,21,76,,97,POINT (3451668 -76532004)
2019,Enero,Reino Unido de Gran Bretaña e Irlanda del Norte,2,1,,3,POINT (445285 -75766353)
2019,Enero,Reino Unido de Gran Bretaña e Irlanda del Norte,1382,2306,,3688,POINT (4697157 -74140516)
2019,Enero,Reino Unido de Gran Bretaña e Irlanda del Norte,4,6,,10,POINT (4815189 -75736374)
2019,Enero,Reino Unido de Gran Bretaña e Irlanda del Norte,99,274,,373,POINT (6170465 -7542726)
2019,Enero,Reino Unido de Gran Bretaña e Irlanda del Norte,0,2,,2,POINT (7128047 -73181317)
2019,Enero,Reino Unido de Gran Bretaña e Irlanda del Norte,0,4,,4,POINT (7819 -72453013)
2019,Enero,Reino Unido de Gran Bretaña e Irlanda del Norte,0,1,,1,POINT (836068 -72409396)
2019,Enero,Reino Unido de Gran Bretaña e Irlanda del Norte,21,32,,53,POINT (863337 -7735002)
2019,Enero,República Dominicana,0,1,,1,POINT (0.33002 -76876446)
2019,Enero,República Dominicana,2,9,,11,POINT (0.81488 -77356)
2019,Enero,República Dominicana,0,1,,1,POINT (1800143 -78802679)
2019,Enero,República Dominicana,0,1,,1,POINT (10406342 -75527794)
2019,Enero,República Dominicana,43,48,,91,POINT (10446304 -75516486)
2019,Enero,República Dominicana,19,46,,65,POINT (10886686 -74776479)
2019,Enero,República Dominicana,0,1,,1,POINT (11117206 -74232675)
2019,Enero,República Dominicana,0,1,,1,POINT (125862 -81702165)
2019,Enero,República Dominicana,35,33,,68,POINT (3451668 -76532004)
2019,Enero,República Dominicana,1,0,,1,POINT (445285 -75766353)
2019,Enero,República Dominicana,755,765,,1520,POINT (4697157 -74140516)
2019,Enero,República Dominicana,3,3,,6,POINT (4815189 -75736374)
2019,Enero,República Dominicana,88,118,,206,POINT (6170465 -7542726)
2019,Enero,República Dominicana,1,1,,2,POINT (7088729 -70740253)
2019,Enero,República Dominicana,2,1,,3,POINT (7128047 -73181317)
2019,Enero,República Dominicana,4,5,,9,POINT (7819 -72453013)
2019,Enero,Rumania,0,1,,1,POINT (-4214082 -69941431)
2019,Enero,Rumania,0,1,,1,POINT (0.81488 -77356)
2019,Enero,Rumania,3,10,,13,POINT (10406342 -75527794)
2019,Enero,Rumania,14,25,,39,POINT (10446304 -75516486)
2019,Enero,Rumania,0,1,,1,POINT (10970933 -74765343)
2019,Enero,Rumania,1,1,,2,POINT (11247723 -74213989)
2019,Enero,Rumania,4,5,,9,POINT (125862 -81702165)
2019,Enero,Rumania,1,2,,3,POINT (3451668 -76532004)
2019,Enero,Rumania,105,121,,226,POINT (4697157 -74140516)
2019,Enero,Rumania,1,1,,2,POINT (4815189 -75736374)
2019,Enero,Rumania,15,9,,24,POINT (6170465 -7542726)
2019,Enero,Rumania,1,0,,1,POINT (836068 -72409396)
2019,Enero,Federación de Rusia,2,2,,4,POINT (-4214082 -69941431)
2019,Enero,Federación de Rusia,39,25,,64,POINT (0.81488 -77356)
2019,Enero,Federación de Rusia,1,18,,19,POINT (10406342 -75527794)
2019,Enero,Federación de Rusia,37,29,,66,POINT (10446304 -75516486)
2019,Enero,Federación de Rusia,1,1,,2,POINT (10886686 -74776479)
2019,Enero,Federación de Rusia,2,1,,3,POINT (125862 -81702165)
2019,Enero,Federación de Rusia,7,11,,18,POINT (3451668 -76532004)
2019,Enero,Federación de Rusia,0,1,,1,POINT (3884426 -77061029)
2019,Enero,Federación de Rusia,287,368,,655,POINT (4697157 -74140516)
2019,Enero,Federación de Rusia,1,1,,2,POINT (4815189 -75736374)
2019,Enero,Federación de Rusia,15,15,,30,POINT (6170465 -7542726)
2019,Enero,Federación de Rusia,1,1,,2,POINT (7128047 -73181317)
2019,Enero,Federación de Rusia,0,1,,1,POINT (7819 -72453013)
2019,Enero,Federación de Rusia,0,1,,1,POINT (863337 -7735002)
2019,Enero,Rwanda,0,1,,1,POINT (4697157 -74140516)
2019,Enero,Rwanda,1,0,,1,POINT (6170465 -7542726)
2019,Enero,Sahara Occidental/Desierto Sahara,0,1,,1,POINT (4697157 -74140516)
2019,Enero,San Cristóbal y Nevis,3,3,,6,POINT (4697157 -74140516)
2019,Enero,San Cristóbal y Nevis,0,1,,1,POINT (6170465 -7542726)
2019,Enero,Samoa Occidental,1,0,,1,POINT (4697157 -74140516)
2019,Enero,San Marino,1,1,,2,POINT (4697157 -74140516)
2019,Enero,San  Vicente y las Granadinas,1,0,,1,POINT (10446304 -75516486)
2019,Enero,Santa Lucia,1,1,,2,POINT (10446304 -75516486)
2019,Enero,Santa Lucia,0,1,,1,POINT (11360029 -72129595)
2019,Enero,Santa Lucia,0,1,,1,POINT (3451668 -76532004)
2019,Enero,Santa Lucia,2,3,,5,POINT (4697157 -74140516)
2019,Enero,Santa Lucia,1,1,,2,POINT (6170465 -7542726)
2019,Enero,Santa Lucia,1,1,,2,POINT (7128047 -73181317)
2019,Enero,Senegal,2,0,,2,POINT (4697157 -74140516)
2019,Enero,Serbia,1,3,,4,POINT (0.81488 -77356)
2019,Enero,Serbia,0,2,,2,POINT (10406342 -75527794)
2019,Enero,Serbia,0,3,,3,POINT (10446304 -75516486)
2019,Enero,Serbia,3,2,,5,POINT (125862 -81702165)
2019,Enero,Serbia,1,1,,2,POINT (3451668 -76532004)
2019,Enero,Serbia,27,63,,90,POINT (4697157 -74140516)
2019,Enero,Serbia,1,4,,5,POINT (6170465 -7542726)
2019,Enero,Singapur,1,1,,2,POINT (10446304 -75516486)
2019,Enero,Singapur,1,0,,1,POINT (3451668 -76532004)
2019,Enero,Singapur,25,41,,66,POINT (4697157 -74140516)
2019,Enero,Singapur,2,2,,4,POINT (6170465 -7542726)
2019,Enero,República Árabe Siria,1,2,,3,POINT (4697157 -74140516)
2019,Enero,Sri Lanka,0,2,,2,POINT (10406342 -75527794)
2019,Enero,Sri Lanka,2,4,,6,POINT (4697157 -74140516)
2019,Enero,Sudáfrica,3,3,,6,POINT (10406342 -75527794)
2019,Enero,Sudáfrica,3,8,,11,POINT (10446304 -75516486)
2019,Enero,Sudáfrica,0,1,,1,POINT (10886686 -74776479)
2019,Enero,Sudáfrica,0,1,,1,POINT (10970933 -74765343)
2019,Enero,Sudáfrica,22,42,,64,POINT (4697157 -74140516)
2019,Enero,Sudáfrica,3,7,,10,POINT (6170465 -7542726)
2019,Enero,Sudáfrica,0,1,,1,POINT (7819 -72453013)
2019,Enero,Suecia,4,3,,7,POINT (-4191162 -69941498)
2019,Enero,Suecia,0,1,,1,POINT (0.33002 -76876446)
2019,Enero,Suecia,5,6,,11,POINT (0.81488 -77356)
2019,Enero,Suecia,9,5,,14,POINT (10406342 -75527794)
2019,Enero,Suecia,55,65,,120,POINT (10446304 -75516486)
2019,Enero,Suecia,5,5,,10,POINT (10886686 -74776479)
2019,Enero,Suecia,2,3,,5,POINT (11247723 -74213989)
2019,Enero,Suecia,0,8,,8,POINT (125862 -81702165)
2019,Enero,Suecia,18,23,,41,POINT (3451668 -76532004)
2019,Enero,Suecia,325,427,,752,POINT (4697157 -74140516)
2019,Enero,Suecia,1,1,,2,POINT (4815189 -75736374)
2019,Enero,Suecia,19,52,,71,POINT (6170465 -7542726)
2019,Enero,Suecia,0,2,,2,POINT (7128047 -73181317)
2019,Enero,Suecia,1,0,,1,POINT (7819 -72453013)
2019,Enero,Suecia,0,3,,3,POINT (836068 -72409396)
2019,Enero,Suiza,4,3,,7,POINT (-4191162 -69941498)
2019,Enero,Suiza,12,7,,19,POINT (-4214082 -69941431)
2019,Enero,Suiza,2,5,,7,POINT (0.33002 -76876446)
2019,Enero,Suiza,26,56,,82,POINT (0.81488 -77356)
2019,Enero,Suiza,37,36,,73,POINT (10406342 -75527794)
2019,Enero,Suiza,75,81,,156,POINT (10446304 -75516486)
2019,Enero,Suiza,8,9,,17,POINT (10886686 -74776479)
2019,Enero,Suiza,2,0,,2,POINT (11117206 -74232675)
2019,Enero,Suiza,4,5,,9,POINT (11247723 -74213989)
2019,Enero,Suiza,2,2,,4,POINT (11360029 -72129595)
2019,Enero,Suiza,3,7,,10,POINT (125862 -81702165)
2019,Enero,Suiza,1,1,,2,POINT (133387613 -81372937)
2019,Enero,Suiza,48,76,,124,POINT (3451668 -76532004)
2019,Enero,Suiza,676,939,,1615,POINT (4697157 -74140516)
2019,Enero,Suiza,4,5,,9,POINT (4815189 -75736374)
2019,Enero,Suiza,84,147,,231,POINT (6170465 -7542726)
2019,Enero,Suiza,1,0,,1,POINT (7819 -72453013)
2019,Enero,Suiza,1,1,,2,POINT (836068 -72409396)
2019,Enero,Suiza,7,8,,15,POINT (863337 -7735002)
2019,Enero,Surinam,0,1,,1,POINT (11360029 -72129595)
2019,Enero,Surinam,16,19,,35,POINT (4697157 -74140516)
2019,Enero,Surinam,1,3,,4,POINT (6170465 -7542726)
2019,Enero,Surinam,4,3,,7,POINT (7128047 -73181317)
2019,Enero,Surinam,0,1,,1,POINT (836068 -72409396)
2019,Enero,Taiwán,1,0,,1,POINT (4697157 -74140516)
2019,Enero,Tailandia,1,1,,2,POINT (10406342 -75527794)
2019,Enero,Tailandia,1,1,,2,POINT (10446304 -75516486)
2019,Enero,Tailandia,2,0,,2,POINT (3451668 -76532004)
2019,Enero,Tailandia,10,12,,22,POINT (4697157 -74140516)
2019,Enero,Tanzania,2,1,,3,POINT (4697157 -74140516)
2019,Enero,Togo,0,1,,1,POINT (0.81488 -77356)
2019,Enero,Togo,0,1,,1,POINT (4697157 -74140516)
2019,Enero,Tonga,1,0,,1,POINT (4697157 -74140516)
2019,Enero,Trinidad y Tobago,3,8,,11,POINT (10446304 -75516486)
2019,Enero,Trinidad y Tobago,1,4,,5,POINT (10886686 -74776479)
2019,Enero,Trinidad y Tobago,1,1,,2,POINT (125862 -81702165)
2019,Enero,Trinidad y Tobago,8,10,,18,POINT (3451668 -76532004)
2019,Enero,Trinidad y Tobago,21,53,,74,POINT (4697157 -74140516)
2019,Enero,Trinidad y Tobago,1,1,,2,POINT (4815189 -75736374)
2019,Enero,Trinidad y Tobago,1,10,,11,POINT (6170465 -7542726)
2019,Enero,Trinidad y Tobago,0,1,,1,POINT (7128047 -73181317)
2019,Enero,Trinidad y Tobago,1,0,,1,POINT (7819 -72453013)
2019,Enero,Túnez,9,8,,17,POINT (4697157 -74140516)
2019,Enero,Túnez,0,1,,1,POINT (6170465 -7542726)
2019,Enero,Túnez,0,1,,1,POINT (7128047 -73181317)
2019,Enero,Turquía,0,1,,1,POINT (-4214082 -69941431)
2019,Enero,Turquía,2,3,,5,POINT (0.81488 -77356)
2019,Enero,Turquía,0,1,,1,POINT (10406342 -75527794)
2019,Enero,Turquía,7,10,,17,POINT (10446304 -75516486)
2019,Enero,Turquía,0,1,,1,POINT (10886686 -74776479)
2019,Enero,Turquía,0,3,,3,POINT (11247723 -74213989)
2019,Enero,Turquía,1,6,,7,POINT (3451668 -76532004)
2019,Enero,Turquía,187,384,,571,POINT (4697157 -74140516)
2019,Enero,Turquía,6,18,,24,POINT (6170465 -7542726)
2019,Enero,Turquía,0,1,,1,POINT (7088729 -70740253)
2019,Enero,Turquía,0,2,,2,POINT (7819 -72453013)
2019,Enero,Ucrania,1,0,,1,POINT (-4191162 -69941498)
2019,Enero,Ucrania,1,1,,2,POINT (0.81488 -77356)
2019,Enero,Ucrania,1,10,,11,POINT (10406342 -75527794)
2019,Enero,Ucrania,2,10,,12,POINT (10446304 -75516486)
2019,Enero,Ucrania,0,2,,2,POINT (10886686 -74776479)
2019,Enero,Ucrania,0,1,,1,POINT (10970933 -74765343)
2019,Enero,Ucrania,0,5,,5,POINT (11247723 -74213989)
2019,Enero,Ucrania,1,4,,5,POINT (3451668 -76532004)
2019,Enero,Ucrania,0,1,,1,POINT (3884426 -77061029)
2019,Enero,Ucrania,31,55,,86,POINT (4697157 -74140516)
2019,Enero,Ucrania,0,1,,1,POINT (4815189 -75736374)
2019,Enero,Ucrania,6,4,,10,POINT (6170465 -7542726)
2019,Enero,Ucrania,2,2,,4,POINT (863337 -7735002)
2019,Enero,Ucrania,0,1,,1,POINT (9402597 -75681642)
2019,Enero,Uganda,1,1,,2,POINT (4697157 -74140516)
2019,Enero,Uruguay,0,1,,1,POINT (-4214082 -69941431)
2019,Enero,Uruguay,5,14,,19,POINT (0.81488 -77356)
2019,Enero,Uruguay,45,15,,60,POINT (10406342 -75527794)
2019,Enero,Uruguay,98,71,,169,POINT (10446304 -75516486)
2019,Enero,Uruguay,0,5,,5,POINT (10886686 -74776479)
2019,Enero,Uruguay,1,0,,1,POINT (11117206 -74232675)
2019,Enero,Uruguay,14,13,,27,POINT (125862 -81702165)
2019,Enero,Uruguay,26,30,,56,POINT (3451668 -76532004)
2019,Enero,Uruguay,574,600,,1174,POINT (4697157 -74140516)
2019,Enero,Uruguay,2,2,,4,POINT (4815189 -75736374)
2019,Enero,Uruguay,49,70,,119,POINT (6170465 -7542726)
2019,Enero,Uruguay,0,1,,1,POINT (7128047 -73181317)
2019,Enero,Uruguay,0,3,,3,POINT (7819 -72453013)
2019,Enero,Uruguay,0,2,,2,POINT (863337 -7735002)
2019,Enero,Uzbekistán,0,1,,1,POINT (4697157 -74140516)
2019,Enero,Vanuatu,1,0,,1,POINT (7819 -72453013)
2019,Enero,Venezuela,9,4,,13,POINT (-4191162 -69941498)
2019,Enero,Venezuela,1,2,,3,POINT (-4214082 -69941431)
2019,Enero,Venezuela,103,83,,186,POINT (0.33002 -76876446)
2019,Enero,Venezuela,3,4,,7,POINT (0.812436 -77847006)
2019,Enero,Venezuela,4952,4762,,9714,POINT (0.81488 -77356)
2019,Enero,Venezuela,5,2,,7,POINT (1800143 -78802679)
2019,Enero,Venezuela,32,48,,80,POINT (10406342 -75527794)
2019,Enero,Venezuela,189,205,,394,POINT (10446304 -75516486)
2019,Enero,Venezuela,171,219,,390,POINT (10886686 -74776479)
2019,Enero,Venezuela,0,1,,1,POINT (10970933 -74765343)
2019,Enero,Venezuela,9,7,,16,POINT (11117206 -74232675)
2019,Enero,Venezuela,5527,5326,,10853,POINT (11360029 -72129595)
2019,Enero,Venezuela,0,2,,2,POINT (12165168 -71983761)
2019,Enero,Venezuela,7,2,,9,POINT (125862 -81702165)
2019,Enero,Venezuela,299,348,,647,POINT (3451668 -76532004)
2019,Enero,Venezuela,25,30,,55,POINT (3866713 -67927521)
2019,Enero,Venezuela,3,2,,5,POINT (445285 -75766353)
2019,Enero,Venezuela,8371,7406,,15777,POINT (4697157 -74140516)
2019,Enero,Venezuela,24,23,,47,POINT (4815189 -75736374)
2019,Enero,Venezuela,874,870,,1744,POINT (6170465 -7542726)
2019,Enero,Venezuela,49,31,,80,POINT (6185536 -67484028)
2019,Enero,Venezuela,1,7,,8,POINT (6218835 -75586989)
2019,Enero,Venezuela,1159,1108,,2267,POINT (7088729 -70740253)
2019,Enero,Venezuela,18,21,,39,POINT (7128047 -73181317)
2019,Enero,Venezuela,23014,21954,,44968,POINT (7819 -72453013)
2019,Enero,Venezuela,2,9,,11,POINT (7927233 -72508188)
2019,Enero,Venezuela,2331,2061,,4392,POINT (836068 -72409396)
2019,Enero,Venezuela,0,1,,1,POINT (9402597 -75681642)
2019,Enero,Vietnam,0,3,,3,POINT (0.81488 -77356)
2019,Enero,Vietnam,2,1,,3,POINT (10446304 -75516486)
2019,Enero,Vietnam,3,10,,13,POINT (4697157 -74140516)
2019,Enero,República Árabe de Yemen,1,2,,3,POINT (4697157 -74140516)
2019,Enero,Zambia,0,1,,1,POINT (4697157 -74140516)
2019,Enero,Zimbabue,0,2,,2,POINT (4697157 -74140516)
2019,Enero,Islas Turcas y Caicos/Territorio Británico de Ultramar,0,3,,3,POINT (10886686 -74776479)
2019,Enero,Refugiado,2,1,,3,POINT (10446304 -75516486)
2019,Enero,Refugiado,0,8,,8,POINT (4697157 -74140516)
2019,Enero,Desconocido,1,0,,1,POINT (0.33002 -76876446)
2019,Enero,Desconocido,1,2,,3,POINT (10446304 -75516486)
2019,Enero,Desconocido,0,1,,1,POINT (3451668 -76532004)
2019,Enero,Desconocido,90,123,,213,POINT (4697157 -74140516)
2019,Enero,Desconocido,1,0,,1,POINT (4815189 -75736374)
2019,Enero,Desconocido,1,3,,4,POINT (6170465 -7542726)
2019,Enero,Desconocido,2,0,,2,POINT (7088729 -70740253)
2019,Enero,Desconocido,0,1,,1,POINT (6170465 -7542726)
2019,Febrero,Afganistán,0,1,,1,POINT (4697157 -74140516)
2019,Febrero,Albania,2,0,,2,POINT (10446304 -75516486)
2019,Febrero,Albania,0,2,,2,POINT (3451668 -76532004)
2019,Febrero,Albania,3,16,,19,POINT (4697157 -74140516)
2019,Febrero,Albania,2,3,,5,POINT (6170465 -7542726)
2019,Febrero,Alemania,7,13,,20,POINT (-4191162 -69941498)
2019,Febrero,Alemania,21,20,,41,POINT (-4214082 -69941431)
2019,Febrero,Alemania,3,4,,7,POINT (0.33002 -76876446)
2019,Febrero,Alemania,107,115,,222,POINT (0.81488 -77356)
2019,Febrero,Alemania,44,35,,79,POINT (10406342 -75527794)
2019,Febrero,Alemania,232,328,,560,POINT (10446304 -75516486)
2019,Febrero,Alemania,17,42,,59,POINT (10886686 -74776479)
2019,Febrero,Alemania,0,2,,2,POINT (10970933 -74765343)
2019,Febrero,Alemania,0,2,,2,POINT (11117206 -74232675)
2019,Febrero,Alemania,9,3,,12,POINT (11247723 -74213989)
2019,Febrero,Alemania,0,1,,1,POINT (11360029 -72129595)
2019,Febrero,Alemania,1,1,,2,POINT (125744111 -81703935)
2019,Febrero,Alemania,3,6,,9,POINT (125862 -81702165)
2019,Febrero,Alemania,82,108,,190,POINT (3451668 -76532004)
2019,Febrero,Alemania,5,6,,11,POINT (445285 -75766353)
2019,Febrero,Alemania,3213,3991,,7204,POINT (4697157 -74140516)
2019,Febrero,Alemania,3,11,,14,POINT (4815189 -75736374)
2019,Febrero,Alemania,218,363,,581,POINT (6170465 -7542726)
2019,Febrero,Alemania,1,1,,2,POINT (6222552 -77401154)
2019,Febrero,Alemania,0,1,,1,POINT (7088729 -70740253)
2019,Febrero,Alemania,3,4,,7,POINT (7128047 -73181317)
2019,Febrero,Alemania,1,9,,10,POINT (7819 -72453013)
2019,Febrero,Alemania,0,1,,1,POINT (7927233 -72508188)
2019,Febrero,Alemania,0,1,,1,POINT (836068 -72409396)
2019,Febrero,Alemania,19,21,,40,POINT (863337 -7735002)
2019,Febrero,Andorra,1,0,,1,POINT (10446304 -75516486)
2019,Febrero,Andorra,2,9,,11,POINT (4697157 -74140516)
2019,Febrero,Andorra,1,0,,1,POINT (6170465 -7542726)
2019,Febrero,Angola,0,1,,1,POINT (10446304 -75516486)
2019,Febrero,Angola,1,1,,2,POINT (4697157 -74140516)
2019,Febrero,Angola,0,1,,1,POINT (6170465 -7542726)
2019,Febrero,Antigua y Barbuda,0,1,,1,POINT (3451668 -76532004)
2019,Febrero,Antigua y Barbuda,0,2,,2,POINT (4697157 -74140516)
2019,Febrero,Arabia Saudita,1,3,,4,POINT (4697157 -74140516)
2019,Febrero,Arabia Saudita,0,1,,1,POINT (4815189 -75736374)
2019,Febrero,Argelia,0,1,,1,POINT (0.81488 -77356)
2019,Febrero,Argelia,1,1,,2,POINT (10446304 -75516486)
2019,Febrero,Argelia,1,0,,1,POINT (3451668 -76532004)
2019,Febrero,Argelia,4,6,,10,POINT (4697157 -74140516)
2019,Febrero,Argelia,0,1,,1,POINT (6170465 -7542726)
2019,Febrero,Argentina,9,14,,23,POINT (-4214082 -69941431)
2019,Febrero,Argentina,3,9,,12,POINT (0.33002 -76876446)
2019,Febrero,Argentina,67,110,,177,POINT (0.81488 -77356)
2019,Febrero,Argentina,298,228,,526,POINT (10406342 -75527794)
2019,Febrero,Argentina,1805,1489,,3294,POINT (10446304 -75516486)
2019,Febrero,Argentina,21,34,,55,POINT (10886686 -74776479)
2019,Febrero,Argentina,1,0,,1,POINT (11117206 -74232675)
2019,Febrero,Argentina,4,3,,7,POINT (11360029 -72129595)
2019,Febrero,Argentina,329,277,,606,POINT (125862 -81702165)
2019,Febrero,Argentina,1,0,,1,POINT (133387613 -81372937)
2019,Febrero,Argentina,173,236,,409,POINT (3451668 -76532004)
2019,Febrero,Argentina,1,0,,1,POINT (445285 -75766353)
2019,Febrero,Argentina,4539,5660,,10199,POINT (4697157 -74140516)
2019,Febrero,Argentina,0,12,,12,POINT (4815189 -75736374)
2019,Febrero,Argentina,372,511,,883,POINT (6170465 -7542726)
2019,Febrero,Argentina,1,0,,1,POINT (7128047 -73181317)
2019,Febrero,Argentina,4,14,,18,POINT (7819 -72453013)
2019,Febrero,Argentina,0,4,,4,POINT (7927233 -72508188)
2019,Febrero,Argentina,3,6,,9,POINT (836068 -72409396)
2019,Febrero,Argentina,1,8,,9,POINT (863337 -7735002)
2019,Febrero,República de Armenia,0,2,,2,POINT (10446304 -75516486)
2019,Febrero,República de Armenia,0,2,,2,POINT (4697157 -74140516)
2019,Febrero,Australia,2,1,,3,POINT (-4214082 -69941431)
2019,Febrero,Australia,1,9,,10,POINT (0.33002 -76876446)
2019,Febrero,Australia,18,17,,35,POINT (0.81488 -77356)
2019,Febrero,Australia,10,11,,21,POINT (10406342 -75527794)
2019,Febrero,Australia,45,63,,108,POINT (10446304 -75516486)
2019,Febrero,Australia,7,11,,18,POINT (10886686 -74776479)
2019,Febrero,Australia,0,1,,1,POINT (11247723 -74213989)
2019,Febrero,Australia,0,1,,1,POINT (11360029 -72129595)
2019,Febrero,Australia,5,13,,18,POINT (3451668 -76532004)
2019,Febrero,Australia,1,0,,1,POINT (445285 -75766353)
2019,Febrero,Australia,224,446,,670,POINT (4697157 -74140516)
2019,Febrero,Australia,1,1,,2,POINT (4815189 -75736374)
2019,Febrero,Australia,37,90,,127,POINT (6170465 -7542726)
2019,Febrero,Australia,1,1,,2,POINT (7819 -72453013)
2019,Febrero,Australia,15,13,,28,POINT (863337 -7735002)
2019,Febrero,Austria,0,2,,2,POINT (-4214082 -69941431)
2019,Febrero,Austria,1,0,,1,POINT (0.33002 -76876446)
2019,Febrero,Austria,8,14,,22,POINT (0.81488 -77356)
2019,Febrero,Austria,11,8,,19,POINT (10406342 -75527794)
2019,Febrero,Austria,15,17,,32,POINT (10446304 -75516486)
2019,Febrero,Austria,2,4,,6,POINT (10886686 -74776479)
2019,Febrero,Austria,1,1,,2,POINT (11117206 -74232675)
2019,Febrero,Austria,0,2,,2,POINT (11247723 -74213989)
2019,Febrero,Austria,9,12,,21,POINT (3451668 -76532004)
2019,Febrero,Austria,385,458,,843,POINT (4697157 -74140516)
2019,Febrero,Austria,2,0,,2,POINT (4815189 -75736374)
2019,Febrero,Austria,30,39,,69,POINT (6170465 -7542726)
2019,Febrero,Austria,1,1,,2,POINT (863337 -7735002)
2019,Febrero,Azerbaiyán,1,0,,1,POINT (10446304 -75516486)
2019,Febrero,Azerbaiyán,3,0,,3,POINT (4697157 -74140516)
2019,Febrero,Azerbaiyán,1,1,,2,POINT (6170465 -7542726)
2019,Febrero,Bahamas,0,1,,1,POINT (0.81488 -77356)
2019,Febrero,Bahamas,2,1,,3,POINT (10446304 -75516486)
2019,Febrero,Bahamas,1,4,,5,POINT (3451668 -76532004)
2019,Febrero,Bahamas,5,18,,23,POINT (4697157 -74140516)
2019,Febrero,Bahamas,0,1,,1,POINT (4815189 -75736374)
2019,Febrero,Bahamas,0,9,,9,POINT (6170465 -7542726)
2019,Febrero,Bangladesh,2,0,,2,POINT (10446304 -75516486)
2019,Febrero,Bangladesh,1,2,,3,POINT (4697157 -74140516)
2019,Febrero,Barbados,1,0,,1,POINT (10446304 -75516486)
2019,Febrero,Barbados,0,1,,1,POINT (10886686 -74776479)
2019,Febrero,Barbados,2,1,,3,POINT (3451668 -76532004)
2019,Febrero,Barbados,9,6,,15,POINT (4697157 -74140516)
2019,Febrero,Barbados,1,3,,4,POINT (6170465 -7542726)
2019,Febrero,República de Belarús,2,0,,2,POINT (10446304 -75516486)
2019,Febrero,República de Belarús,0,1,,1,POINT (3451668 -76532004)
2019,Febrero,República de Belarús,2,1,,3,POINT (4697157 -74140516)
2019,Febrero,República de Belarús,1,0,,1,POINT (6170465 -7542726)
2019,Febrero,República de Belarús,1,0,,1,POINT (863337 -7735002)
2019,Febrero,Bélgica,1,1,,2,POINT (-4191162 -69941498)
2019,Febrero,Bélgica,2,0,,2,POINT (-4214082 -69941431)
2019,Febrero,Bélgica,2,0,,2,POINT (0.33002 -76876446)
2019,Febrero,Bélgica,23,27,,50,POINT (0.81488 -77356)
2019,Febrero,Bélgica,2,2,,4,POINT (10406342 -75527794)
2019,Febrero,Bélgica,44,43,,87,POINT (10446304 -75516486)
2019,Febrero,Bélgica,1,7,,8,POINT (10886686 -74776479)
2019,Febrero,Bélgica,2,2,,4,POINT (11247723 -74213989)
2019,Febrero,Bélgica,1,1,,2,POINT (125744111 -81703935)
2019,Febrero,Bélgica,0,2,,2,POINT (125862 -81702165)
2019,Febrero,Bélgica,18,36,,54,POINT (3451668 -76532004)
2019,Febrero,Bélgica,361,538,,899,POINT (4697157 -74140516)
2019,Febrero,Bélgica,1,3,,4,POINT (4815189 -75736374)
2019,Febrero,Bélgica,46,57,,103,POINT (6170465 -7542726)
2019,Febrero,Bélgica,0,1,,1,POINT (7128047 -73181317)
2019,Febrero,Bélgica,1,2,,3,POINT (863337 -7735002)
2019,Febrero,Belice,1,2,,3,POINT (10446304 -75516486)
2019,Febrero,Belice,1,0,,1,POINT (10886686 -74776479)
2019,Febrero,Belice,2,2,,4,POINT (3451668 -76532004)
2019,Febrero,Belice,5,12,,17,POINT (4697157 -74140516)
2019,Febrero,Belice,0,1,,1,POINT (6170465 -7542726)
2019,Febrero,Benín,0,1,,1,POINT (10446304 -75516486)
2019,Febrero,Benín,0,2,,2,POINT (4697157 -74140516)
2019,Febrero,Benín,0,1,,1,POINT (6170465 -7542726)
2019,Febrero,Bermudas/Territorio Británico de Ultramar,0,2,,2,POINT (10446304 -75516486)
2019,Febrero,Bermudas/Territorio Británico de Ultramar,2,1,,3,POINT (10886686 -74776479)
2019,Febrero,Bermudas/Territorio Británico de Ultramar,0,2,,2,POINT (6170465 -7542726)
2019,Febrero,Bolivia,1,1,,2,POINT (-4191162 -69941498)
2019,Febrero,Bolivia,17,14,,31,POINT (0.81488 -77356)
2019,Febrero,Bolivia,31,14,,45,POINT (10406342 -75527794)
2019,Febrero,Bolivia,137,98,,235,POINT (10446304 -75516486)
2019,Febrero,Bolivia,2,4,,6,POINT (10886686 -74776479)
2019,Febrero,Bolivia,13,14,,27,POINT (125862 -81702165)
2019,Febrero,Bolivia,22,29,,51,POINT (3451668 -76532004)
2019,Febrero,Bolivia,692,646,,1338,POINT (4697157 -74140516)
2019,Febrero,Bolivia,4,0,,4,POINT (4815189 -75736374)
2019,Febrero,Bolivia,33,43,,76,POINT (6170465 -7542726)
2019,Febrero,Bolivia,0,1,,1,POINT (6185536 -67484028)
2019,Febrero,Bolivia,2,1,,3,POINT (7088729 -70740253)
2019,Febrero,Bolivia,0,2,,2,POINT (7819 -72453013)
2019,Febrero,Bolivia,0,1,,1,POINT (836068 -72409396)
2019,Febrero,Bosnia y Herzegovina,1,1,,2,POINT (10446304 -75516486)
2019,Febrero,Bosnia y Herzegovina,0,1,,1,POINT (3451668 -76532004)
2019,Febrero,Bosnia y Herzegovina,8,5,,13,POINT (4697157 -74140516)
2019,Febrero,Botsuana,1,0,,1,POINT (4697157 -74140516)
2019,Febrero,Brasil,106,83,,189,POINT (-4191162 -69941498)
2019,Febrero,Brasil,5,8,,13,POINT (-4214082 -69941431)
2019,Febrero,Brasil,25,39,,64,POINT (0.81488 -77356)
2019,Febrero,Brasil,337,252,,589,POINT (10406342 -75527794)
2019,Febrero,Brasil,659,520,,1179,POINT (10446304 -75516486)
2019,Febrero,Brasil,10,24,,34,POINT (10886686 -74776479)
2019,Febrero,Brasil,1,0,,1,POINT (11117206 -74232675)
2019,Febrero,Brasil,1,4,,5,POINT (11360029 -72129595)
2019,Febrero,Brasil,1,1,,2,POINT (125744111 -81703935)
2019,Febrero,Brasil,292,238,,530,POINT (125862 -81702165)
2019,Febrero,Brasil,106,161,,267,POINT (3451668 -76532004)
2019,Febrero,Brasil,1,4,,5,POINT (3866713 -67927521)
2019,Febrero,Brasil,5635,6883,,12518,POINT (4697157 -74140516)
2019,Febrero,Brasil,3,6,,9,POINT (4815189 -75736374)
2019,Febrero,Brasil,251,358,,609,POINT (6170465 -7542726)
2019,Febrero,Brasil,0,3,,3,POINT (7128047 -73181317)
2019,Febrero,Brasil,1,4,,5,POINT (7819 -72453013)
2019,Febrero,Brasil,0,9,,9,POINT (7927233 -72508188)
2019,Febrero,Brasil,4,1,,5,POINT (836068 -72409396)
2019,Febrero,Brasil,0,2,,2,POINT (863337 -7735002)
2019,Febrero,Bulgaria,5,3,,8,POINT (0.81488 -77356)
2019,Febrero,Bulgaria,4,5,,9,POINT (10406342 -75527794)
2019,Febrero,Bulgaria,4,4,,8,POINT (10446304 -75516486)
2019,Febrero,Bulgaria,1,1,,2,POINT (125862 -81702165)
2019,Febrero,Bulgaria,1,0,,1,POINT (3451668 -76532004)
2019,Febrero,Bulgaria,0,1,,1,POINT (3884426 -77061029)
2019,Febrero,Bulgaria,68,81,,149,POINT (4697157 -74140516)
2019,Febrero,Bulgaria,1,0,,1,POINT (4815189 -75736374)
2019,Febrero,Bulgaria,4,14,,18,POINT (6170465 -7542726)
2019,Febrero,Burkina Faso,0,1,,1,POINT (10446304 -75516486)
2019,Febrero,Burkina Faso,2,1,,3,POINT (4697157 -74140516)
2019,Febrero,Burundi,1,0,,1,POINT (10446304 -75516486)
2019,Febrero,Bután,0,1,,1,POINT (10446304 -75516486)
2019,Febrero,Cabo Verde,1,0,,1,POINT (10446304 -75516486)
2019,Febrero,Cabo Verde,0,2,,2,POINT (4697157 -74140516)
2019,Febrero,Islas Caimán/Territorio Británico de Ultramar,0,1,,1,POINT (10446304 -75516486)
2019,Febrero,Islas Caimán/Territorio Británico de Ultramar,0,1,,1,POINT (4697157 -74140516)
2019,Febrero,Camboya,1,1,,2,POINT (10446304 -75516486)
2019,Febrero,Camerún,0,1,,1,POINT (10446304 -75516486)
2019,Febrero,Camerún,0,1,,1,POINT (3451668 -76532004)
2019,Febrero,Camerún,0,5,,5,POINT (4697157 -74140516)
2019,Febrero,Camerún,1,0,,1,POINT (6170465 -7542726)
2019,Febrero,Canadá,0,4,,4,POINT (-4191162 -69941498)
2019,Febrero,Canadá,2,13,,15,POINT (-4214082 -69941431)
2019,Febrero,Canadá,4,2,,6,POINT (0.33002 -76876446)
2019,Febrero,Canadá,20,29,,49,POINT (0.81488 -77356)
2019,Febrero,Canadá,70,64,,134,POINT (10406342 -75527794)
2019,Febrero,Canadá,1349,1439,,2788,POINT (10446304 -75516486)
2019,Febrero,Canadá,39,64,,103,POINT (10886686 -74776479)
2019,Febrero,Canadá,1,0,,1,POINT (10970933 -74765343)
2019,Febrero,Canadá,2,2,,4,POINT (11117206 -74232675)
2019,Febrero,Canadá,0,1,,1,POINT (11360029 -72129595)
2019,Febrero,Canadá,1,1,,2,POINT (125744111 -81703935)
2019,Febrero,Canadá,259,274,,533,POINT (125862 -81702165)
2019,Febrero,Canadá,82,130,,212,POINT (3451668 -76532004)
2019,Febrero,Canadá,2,2,,4,POINT (445285 -75766353)
2019,Febrero,Canadá,1864,2767,,4631,POINT (4697157 -74140516)
2019,Febrero,Canadá,12,22,,34,POINT (4815189 -75736374)
2019,Febrero,Canadá,233,551,,784,POINT (6170465 -7542726)
2019,Febrero,Canadá,1,2,,3,POINT (7128047 -73181317)
2019,Febrero,Canadá,1,4,,5,POINT (7819 -72453013)
2019,Febrero,Canadá,1,2,,3,POINT (7927233 -72508188)
2019,Febrero,Canadá,14,17,,31,POINT (863337 -7735002)
2019,Febrero,República Democrática del Congo,1,0,,1,POINT (3451668 -76532004)
2019,Febrero,República Democrática del Congo,7,2,,9,POINT (4697157 -74140516)
2019,Febrero,República Democrática del Congo,1,0,,1,POINT (4815189 -75736374)
2019,Febrero,República de Corea,0,1,,1,POINT (-4214082 -69941431)
2019,Febrero,República de Corea,7,13,,20,POINT (0.81488 -77356)
2019,Febrero,República de Corea,0,1,,1,POINT (10406342 -75527794)
2019,Febrero,República de Corea,20,11,,31,POINT (10446304 -75516486)
2019,Febrero,República de Corea,0,2,,2,POINT (10886686 -74776479)
2019,Febrero,República de Corea,1,0,,1,POINT (125862 -81702165)
2019,Febrero,República de Corea,2,9,,11,POINT (3451668 -76532004)
2019,Febrero,República de Corea,247,426,,673,POINT (4697157 -74140516)
2019,Febrero,República de Corea,0,2,,2,POINT (4815189 -75736374)
2019,Febrero,República de Corea,15,53,,68,POINT (6170465 -7542726)
2019,Febrero,República de Corea,0,1,,1,POINT (836068 -72409396)
2019,Febrero,Costa de Marfil,2,3,,5,POINT (4697157 -74140516)
2019,Febrero,Costa de Marfil,0,2,,2,POINT (6170465 -7542726)
2019,Febrero,Costa Rica,0,6,,6,POINT (0.81488 -77356)
2019,Febrero,Costa Rica,4,3,,7,POINT (10406342 -75527794)
2019,Febrero,Costa Rica,261,212,,473,POINT (10446304 -75516486)
2019,Febrero,Costa Rica,9,15,,24,POINT (10886686 -74776479)
2019,Febrero,Costa Rica,0,1,,1,POINT (125744111 -81703935)
2019,Febrero,Costa Rica,60,50,,110,POINT (125862 -81702165)
2019,Febrero,Costa Rica,44,70,,114,POINT (3451668 -76532004)
2019,Febrero,Costa Rica,977,1291,,2268,POINT (4697157 -74140516)
2019,Febrero,Costa Rica,7,10,,17,POINT (4815189 -75736374)
2019,Febrero,Costa Rica,134,256,,390,POINT (6170465 -7542726)
2019,Febrero,Costa Rica,2,3,,5,POINT (7128047 -73181317)
2019,Febrero,Costa Rica,0,2,,2,POINT (7819 -72453013)
2019,Febrero,Costa Rica,0,1,,1,POINT (7927233 -72508188)
2019,Febrero,Croacia,1,0,,1,POINT (0.33002 -76876446)
2019,Febrero,Croacia,1,3,,4,POINT (0.81488 -77356)
2019,Febrero,Croacia,1,4,,5,POINT (10406342 -75527794)
2019,Febrero,Croacia,1,7,,8,POINT (10446304 -75516486)
2019,Febrero,Croacia,0,2,,2,POINT (3451668 -76532004)
2019,Febrero,Croacia,35,58,,93,POINT (4697157 -74140516)
2019,Febrero,Croacia,1,11,,12,POINT (6170465 -7542726)
2019,Febrero,Croacia,0,1,,1,POINT (863337 -7735002)
2019,Febrero,Cuba,2,1,,3,POINT (-4191162 -69941498)
2019,Febrero,Cuba,0,1,,1,POINT (0.33002 -76876446)
2019,Febrero,Cuba,0,3,,3,POINT (0.81488 -77356)
2019,Febrero,Cuba,0,9,,9,POINT (10406342 -75527794)
2019,Febrero,Cuba,9,10,,19,POINT (10446304 -75516486)
2019,Febrero,Cuba,12,36,,48,POINT (10886686 -74776479)
2019,Febrero,Cuba,1,1,,2,POINT (11360029 -72129595)
2019,Febrero,Cuba,16,26,,42,POINT (3451668 -76532004)
2019,Febrero,Cuba,0,1,,1,POINT (445285 -75766353)
2019,Febrero,Cuba,158,245,,403,POINT (4697157 -74140516)
2019,Febrero,Cuba,0,3,,3,POINT (4815189 -75736374)
2019,Febrero,Cuba,14,16,,30,POINT (6170465 -7542726)
2019,Febrero,Cuba,0,2,,2,POINT (7128047 -73181317)
2019,Febrero,Cuba,1,0,,1,POINT (7927233 -72508188)
2019,Febrero,República Checa,0,1,,1,POINT (-4214082 -69941431)
2019,Febrero,República Checa,5,8,,13,POINT (0.81488 -77356)
2019,Febrero,República Checa,0,1,,1,POINT (10406342 -75527794)
2019,Febrero,República Checa,7,14,,21,POINT (10446304 -75516486)
2019,Febrero,República Checa,1,0,,1,POINT (10886686 -74776479)
2019,Febrero,República Checa,2,5,,7,POINT (3451668 -76532004)
2019,Febrero,República Checa,125,217,,342,POINT (4697157 -74140516)
2019,Febrero,República Checa,7,13,,20,POINT (6170465 -7542726)
2019,Febrero,República Checa,1,4,,5,POINT (863337 -7735002)
2019,Febrero,Chile,4,7,,11,POINT (-4214082 -69941431)
2019,Febrero,Chile,2,4,,6,POINT (0.33002 -76876446)
2019,Febrero,Chile,78,134,,212,POINT (0.81488 -77356)
2019,Febrero,Chile,561,420,,981,POINT (10406342 -75527794)
2019,Febrero,Chile,831,655,,1486,POINT (10446304 -75516486)
2019,Febrero,Chile,7,14,,21,POINT (10886686 -74776479)
2019,Febrero,Chile,1,0,,1,POINT (11117206 -74232675)
2019,Febrero,Chile,2,7,,9,POINT (11360029 -72129595)
2019,Febrero,Chile,99,73,,172,POINT (125862 -81702165)
2019,Febrero,Chile,191,214,,405,POINT (3451668 -76532004)
2019,Febrero,Chile,0,1,,1,POINT (445285 -75766353)
2019,Febrero,Chile,7346,7095,,14441,POINT (4697157 -74140516)
2019,Febrero,Chile,1,8,,9,POINT (4815189 -75736374)
2019,Febrero,Chile,313,327,,640,POINT (6170465 -7542726)
2019,Febrero,Chile,0,1,,1,POINT (6222552 -77401154)
2019,Febrero,Chile,0,1,,1,POINT (7128047 -73181317)
2019,Febrero,Chile,9,31,,40,POINT (7819 -72453013)
2019,Febrero,Chile,15,55,,70,POINT (7927233 -72508188)
2019,Febrero,Chile,0,4,,4,POINT (836068 -72409396)
2019,Febrero,China,1,1,,2,POINT (-4191162 -69941498)
2019,Febrero,China,1,0,,1,POINT (-4214082 -69941431)
2019,Febrero,China,7,5,,12,POINT (0.81488 -77356)
2019,Febrero,China,0,1,,1,POINT (10406342 -75527794)
2019,Febrero,China,50,54,,104,POINT (10446304 -75516486)
2019,Febrero,China,2,10,,12,POINT (10886686 -74776479)
2019,Febrero,China,0,5,,5,POINT (11247723 -74213989)
2019,Febrero,China,1,0,,1,POINT (125862 -81702165)
2019,Febrero,China,22,42,,64,POINT (3451668 -76532004)
2019,Febrero,China,0,4,,4,POINT (3884426 -77061029)
2019,Febrero,China,469,778,,1247,POINT (4697157 -74140516)
2019,Febrero,China,1,3,,4,POINT (4815189 -75736374)
2019,Febrero,China,45,72,,117,POINT (6170465 -7542726)
2019,Febrero,China,4,2,,6,POINT (7819 -72453013)
2019,Febrero,China,1,1,,2,POINT (836068 -72409396)
2019,Febrero,China,0,3,,3,POINT (9402597 -75681642)
2019,Febrero,Taiwán,4,2,,6,POINT (0.81488 -77356)
2019,Febrero,Taiwán,4,1,,5,POINT (10446304 -75516486)
2019,Febrero,Taiwán,1,0,,1,POINT (10886686 -74776479)
2019,Febrero,Taiwán,2,7,,9,POINT (3451668 -76532004)
2019,Febrero,Taiwán,62,68,,130,POINT (4697157 -74140516)
2019,Febrero,Taiwán,0,1,,1,POINT (4815189 -75736374)
2019,Febrero,Taiwán,6,9,,15,POINT (6170465 -7542726)
2019,Febrero,Taiwán,0,1,,1,POINT (7819 -72453013)
2019,Febrero,Chipre,1,0,,1,POINT (3451668 -76532004)
2019,Febrero,Chipre,2,5,,7,POINT (4697157 -74140516)
2019,Febrero,Chipre,0,1,,1,POINT (6170465 -7542726)
2019,Febrero,Dinamarca,0,2,,2,POINT (-4214082 -69941431)
2019,Febrero,Dinamarca,1,3,,4,POINT (0.81488 -77356)
2019,Febrero,Dinamarca,4,1,,5,POINT (10406342 -75527794)
2019,Febrero,Dinamarca,41,35,,76,POINT (10446304 -75516486)
2019,Febrero,Dinamarca,1,7,,8,POINT (10886686 -74776479)
2019,Febrero,Dinamarca,2,1,,3,POINT (10970933 -74765343)
2019,Febrero,Dinamarca,3,2,,5,POINT (11247723 -74213989)
2019,Febrero,Dinamarca,0,5,,5,POINT (125862 -81702165)
2019,Febrero,Dinamarca,3,7,,10,POINT (3451668 -76532004)
2019,Febrero,Dinamarca,204,266,,470,POINT (4697157 -74140516)
2019,Febrero,Dinamarca,0,1,,1,POINT (4815189 -75736374)
2019,Febrero,Dinamarca,19,31,,50,POINT (6170465 -7542726)
2019,Febrero,Dinamarca,1,0,,1,POINT (836068 -72409396)
2019,Febrero,Dinamarca,0,3,,3,POINT (863337 -7735002)
2019,Febrero,Dominica,1,0,,1,POINT (3451668 -76532004)
2019,Febrero,Dominica,4,3,,7,POINT (4697157 -74140516)
2019,Febrero,Dominica,0,1,,1,POINT (6170465 -7542726)
2019,Febrero,Ecuador,3,0,,3,POINT (-4191162 -69941498)
2019,Febrero,Ecuador,0,2,,2,POINT (-4214082 -69941431)
2019,Febrero,Ecuador,50,237,,287,POINT (0.33002 -76876446)
2019,Febrero,Ecuador,11,8,,19,POINT (0.812436 -77847006)
2019,Febrero,Ecuador,1846,2137,,3983,POINT (0.81488 -77356)
2019,Febrero,Ecuador,19,14,,33,POINT (1800143 -78802679)
2019,Febrero,Ecuador,41,41,,82,POINT (10406342 -75527794)
2019,Febrero,Ecuador,84,77,,161,POINT (10446304 -75516486)
2019,Febrero,Ecuador,16,19,,35,POINT (10886686 -74776479)
2019,Febrero,Ecuador,0,1,,1,POINT (11117206 -74232675)
2019,Febrero,Ecuador,4,12,,16,POINT (11360029 -72129595)
2019,Febrero,Ecuador,19,19,,38,POINT (125862 -81702165)
2019,Febrero,Ecuador,596,618,,1214,POINT (3451668 -76532004)
2019,Febrero,Ecuador,1,4,,5,POINT (3866713 -67927521)
2019,Febrero,Ecuador,0,1,,1,POINT (3884426 -77061029)
2019,Febrero,Ecuador,1,2,,3,POINT (445285 -75766353)
2019,Febrero,Ecuador,2814,3571,,6385,POINT (4697157 -74140516)
2019,Febrero,Ecuador,6,10,,16,POINT (4815189 -75736374)
2019,Febrero,Ecuador,51,97,,148,POINT (6170465 -7542726)
2019,Febrero,Ecuador,2,3,,5,POINT (7128047 -73181317)
2019,Febrero,Ecuador,78,104,,182,POINT (7819 -72453013)
2019,Febrero,Ecuador,7,6,,13,POINT (836068 -72409396)
2019,Febrero,Ecuador,0,1,,1,POINT (863337 -7735002)
2019,Febrero,Egipto,1,2,,3,POINT (0.81488 -77356)
2019,Febrero,Egipto,0,3,,3,POINT (3451668 -76532004)
2019,Febrero,Egipto,7,28,,35,POINT (4697157 -74140516)
2019,Febrero,Egipto,1,0,,1,POINT (7128047 -73181317)
2019,Febrero,El Salvador,2,1,,3,POINT (0.81488 -77356)
2019,Febrero,El Salvador,0,2,,2,POINT (10406342 -75527794)
2019,Febrero,El Salvador,190,212,,402,POINT (10446304 -75516486)
2019,Febrero,El Salvador,9,8,,17,POINT (10886686 -74776479)
2019,Febrero,El Salvador,0,1,,1,POINT (10970933 -74765343)
2019,Febrero,El Salvador,0,1,,1,POINT (11360029 -72129595)
2019,Febrero,El Salvador,4,5,,9,POINT (125862 -81702165)
2019,Febrero,El Salvador,83,116,,199,POINT (3451668 -76532004)
2019,Febrero,El Salvador,480,678,,1158,POINT (4697157 -74140516)
2019,Febrero,El Salvador,1,3,,4,POINT (4815189 -75736374)
2019,Febrero,El Salvador,24,31,,55,POINT (6170465 -7542726)
2019,Febrero,El Salvador,1,0,,1,POINT (836068 -72409396)
2019,Febrero,Emiratos Árabes,0,1,,1,POINT (10446304 -75516486)
2019,Febrero,Emiratos Árabes,2,14,,16,POINT (4697157 -74140516)
2019,Febrero,Emiratos Árabes,0,1,,1,POINT (6170465 -7542726)
2019,Febrero,Emiratos Árabes,0,1,,1,POINT (7128047 -73181317)
2019,Febrero,España,2,4,,6,POINT (-4191162 -69941498)
2019,Febrero,España,9,7,,16,POINT (-4214082 -69941431)
2019,Febrero,España,4,6,,10,POINT (0.33002 -76876446)
2019,Febrero,España,46,81,,127,POINT (0.81488 -77356)
2019,Febrero,España,24,39,,63,POINT (10406342 -75527794)
2019,Febrero,España,109,193,,302,POINT (10446304 -75516486)
2019,Febrero,España,25,63,,88,POINT (10886686 -74776479)
2019,Febrero,España,2,1,,3,POINT (11117206 -74232675)
2019,Febrero,España,2,7,,9,POINT (11360029 -72129595)
2019,Febrero,España,6,5,,11,POINT (125862 -81702165)
2019,Febrero,España,0,1,,1,POINT (133387613 -81372937)
2019,Febrero,España,233,373,,606,POINT (3451668 -76532004)
2019,Febrero,España,0,1,,1,POINT (445285 -75766353)
2019,Febrero,España,2797,5681,,8478,POINT (4697157 -74140516)
2019,Febrero,España,5,15,,20,POINT (4815189 -75736374)
2019,Febrero,España,292,714,,1006,POINT (6170465 -7542726)
2019,Febrero,España,0,2,,2,POINT (6185536 -67484028)
2019,Febrero,España,0,2,,2,POINT (7088729 -70740253)
2019,Febrero,España,0,1,,1,POINT (7128047 -73181317)
2019,Febrero,España,20,49,,69,POINT (7819 -72453013)
2019,Febrero,España,4,12,,16,POINT (7927233 -72508188)
2019,Febrero,España,5,8,,13,POINT (836068 -72409396)
2019,Febrero,España,3,9,,12,POINT (863337 -7735002)
2019,Febrero,Eslovaquia,0,1,,1,POINT (-4214082 -69941431)
2019,Febrero,Eslovaquia,0,3,,3,POINT (0.81488 -77356)
2019,Febrero,Eslovaquia,5,12,,17,POINT (10446304 -75516486)
2019,Febrero,Eslovaquia,1,1,,2,POINT (10886686 -74776479)
2019,Febrero,Eslovaquia,1,0,,1,POINT (3451668 -76532004)
2019,Febrero,Eslovaquia,79,95,,174,POINT (4697157 -74140516)
2019,Febrero,Eslovaquia,4,4,,8,POINT (6170465 -7542726)
2019,Febrero,Eslovenia,2,1,,3,POINT (0.81488 -77356)
2019,Febrero,Eslovenia,1,0,,1,POINT (10406342 -75527794)
2019,Febrero,Eslovenia,1,3,,4,POINT (10446304 -75516486)
2019,Febrero,Eslovenia,1,0,,1,POINT (10886686 -74776479)
2019,Febrero,Eslovenia,3,6,,9,POINT (3451668 -76532004)
2019,Febrero,Eslovenia,43,64,,107,POINT (4697157 -74140516)
2019,Febrero,Eslovenia,0,5,,5,POINT (6170465 -7542726)
2019,Febrero,Estados Unidos de América,3,6,,9,POINT (-4191162 -69941498)
2019,Febrero,Estados Unidos de América,22,26,,48,POINT (-4214082 -69941431)
2019,Febrero,Estados Unidos de América,0,2,,2,POINT (0.33002 -76876446)
2019,Febrero,Estados Unidos de América,47,84,,131,POINT (0.81488 -77356)
2019,Febrero,Estados Unidos de América,55,91,,146,POINT (10406342 -75527794)
2019,Febrero,Estados Unidos de América,6692,8261,,14953,POINT (10446304 -75516486)
2019,Febrero,Estados Unidos de América,688,1237,,1925,POINT (10886686 -74776479)
2019,Febrero,Estados Unidos de América,31,46,,77,POINT (11117206 -74232675)
2019,Febrero,Estados Unidos de América,5,5,,10,POINT (11247723 -74213989)
2019,Febrero,Estados Unidos de América,1,5,,6,POINT (11360029 -72129595)
2019,Febrero,Estados Unidos de América,1,7,,8,POINT (125744111 -81703935)
2019,Febrero,Estados Unidos de América,42,48,,90,POINT (125862 -81702165)
2019,Febrero,Estados Unidos de América,5,10,,15,POINT (133387613 -81372937)
2019,Febrero,Estados Unidos de América,1295,1955,,3250,POINT (3451668 -76532004)
2019,Febrero,Estados Unidos de América,97,178,,275,POINT (445285 -75766353)
2019,Febrero,Estados Unidos de América,9719,16663,,26382,POINT (4697157 -74140516)
2019,Febrero,Estados Unidos de América,162,303,,465,POINT (4815189 -75736374)
2019,Febrero,Estados Unidos de América,2995,7699,,10694,POINT (6170465 -7542726)
2019,Febrero,Estados Unidos de América,0,1,,1,POINT (6222552 -77401154)
2019,Febrero,Estados Unidos de América,1,1,,2,POINT (7088729 -70740253)
2019,Febrero,Estados Unidos de América,22,48,,70,POINT (7128047 -73181317)
2019,Febrero,Estados Unidos de América,14,10,,24,POINT (7819 -72453013)
2019,Febrero,Estados Unidos de América,30,121,,151,POINT (7927233 -72508188)
2019,Febrero,Estados Unidos de América,6,6,,12,POINT (836068 -72409396)
2019,Febrero,Estados Unidos de América,10,11,,21,POINT (863337 -7735002)
2019,Febrero,Estonia,3,0,,3,POINT (-4214082 -69941431)
2019,Febrero,Estonia,3,11,,14,POINT (10446304 -75516486)
2019,Febrero,Estonia,2,5,,7,POINT (3451668 -76532004)
2019,Febrero,Estonia,37,65,,102,POINT (4697157 -74140516)
2019,Febrero,Estonia,6,5,,11,POINT (6170465 -7542726)
2019,Febrero,Etiopia,0,1,,1,POINT (10886686 -74776479)
2019,Febrero,Etiopia,1,0,,1,POINT (3451668 -76532004)
2019,Febrero,Etiopia,4,35,,39,POINT (4697157 -74140516)
2019,Febrero,Islas Fiji,0,1,,1,POINT (10886686 -74776479)
2019,Febrero,Islas Fiji,0,2,,2,POINT (4697157 -74140516)
2019,Febrero,Filipinas,1,0,,1,POINT (0.81488 -77356)
2019,Febrero,Filipinas,6,72,,78,POINT (10406342 -75527794)
2019,Febrero,Filipinas,10,64,,74,POINT (10446304 -75516486)
2019,Febrero,Filipinas,0,11,,11,POINT (10886686 -74776479)
2019,Febrero,Filipinas,0,24,,24,POINT (10970933 -74765343)
2019,Febrero,Filipinas,0,7,,7,POINT (11247723 -74213989)
2019,Febrero,Filipinas,1,24,,25,POINT (3451668 -76532004)
2019,Febrero,Filipinas,0,19,,19,POINT (3884426 -77061029)
2019,Febrero,Filipinas,48,67,,115,POINT (4697157 -74140516)
2019,Febrero,Filipinas,3,2,,5,POINT (6170465 -7542726)
2019,Febrero,Filipinas,0,1,,1,POINT (9402597 -75681642)
2019,Febrero,Finlandia,1,0,,1,POINT (-4214082 -69941431)
2019,Febrero,Finlandia,2,1,,3,POINT (0.81488 -77356)
2019,Febrero,Finlandia,0,2,,2,POINT (10406342 -75527794)
2019,Febrero,Finlandia,12,10,,22,POINT (10446304 -75516486)
2019,Febrero,Finlandia,2,0,,2,POINT (10886686 -74776479)
2019,Febrero,Finlandia,1,1,,2,POINT (11247723 -74213989)
2019,Febrero,Finlandia,0,1,,1,POINT (125862 -81702165)
2019,Febrero,Finlandia,4,9,,13,POINT (3451668 -76532004)
2019,Febrero,Finlandia,100,110,,210,POINT (4697157 -74140516)
2019,Febrero,Finlandia,10,19,,29,POINT (6170465 -7542726)
2019,Febrero,Finlandia,0,1,,1,POINT (7819 -72453013)
2019,Febrero,Finlandia,0,1,,1,POINT (863337 -7735002)
2019,Febrero,Francia,4,8,,12,POINT (-4191162 -69941498)
2019,Febrero,Francia,14,27,,41,POINT (-4214082 -69941431)
2019,Febrero,Francia,4,7,,11,POINT (0.33002 -76876446)
2019,Febrero,Francia,114,170,,284,POINT (0.81488 -77356)
2019,Febrero,Francia,11,23,,34,POINT (10406342 -75527794)
2019,Febrero,Francia,247,312,,559,POINT (10446304 -75516486)
2019,Febrero,Francia,45,60,,105,POINT (10886686 -74776479)
2019,Febrero,Francia,0,1,,1,POINT (10970933 -74765343)
2019,Febrero,Francia,2,2,,4,POINT (11117206 -74232675)
2019,Febrero,Francia,5,3,,8,POINT (11247723 -74213989)
2019,Febrero,Francia,1,0,,1,POINT (11360029 -72129595)
2019,Febrero,Francia,1,1,,2,POINT (125744111 -81703935)
2019,Febrero,Francia,2,2,,4,POINT (125862 -81702165)
2019,Febrero,Francia,2,4,,6,POINT (133387613 -81372937)
2019,Febrero,Francia,113,197,,310,POINT (3451668 -76532004)
2019,Febrero,Francia,3782,4691,,8473,POINT (4697157 -74140516)
2019,Febrero,Francia,3,20,,23,POINT (4815189 -75736374)
2019,Febrero,Francia,313,504,,817,POINT (6170465 -7542726)
2019,Febrero,Francia,0,2,,2,POINT (6222552 -77401154)
2019,Febrero,Francia,5,7,,12,POINT (7128047 -73181317)
2019,Febrero,Francia,2,3,,5,POINT (7819 -72453013)
2019,Febrero,Francia,0,1,,1,POINT (7927233 -72508188)
2019,Febrero,Francia,0,1,,1,POINT (836068 -72409396)
2019,Febrero,Francia,14,13,,27,POINT (863337 -7735002)
2019,Febrero,Francia,0,1,,1,POINT (9402597 -75681642)
2019,Febrero,Gabón,1,0,,1,POINT (4697157 -74140516)
2019,Febrero,Georgia,1,1,,2,POINT (0.81488 -77356)
2019,Febrero,Georgia,0,1,,1,POINT (10406342 -75527794)
2019,Febrero,Georgia,1,2,,3,POINT (10446304 -75516486)
2019,Febrero,Georgia,0,1,,1,POINT (3884426 -77061029)
2019,Febrero,Georgia,2,15,,17,POINT (4697157 -74140516)
2019,Febrero,Georgia,2,0,,2,POINT (6170465 -7542726)
2019,Febrero,Ghana,4,5,,9,POINT (4697157 -74140516)
2019,Febrero,Ghana,0,1,,1,POINT (6170465 -7542726)
2019,Febrero,Granada,1,1,,2,POINT (4697157 -74140516)
2019,Febrero,Grecia,2,4,,6,POINT (0.81488 -77356)
2019,Febrero,Grecia,2,2,,4,POINT (10406342 -75527794)
2019,Febrero,Grecia,4,10,,14,POINT (10446304 -75516486)
2019,Febrero,Grecia,1,0,,1,POINT (10886686 -74776479)
2019,Febrero,Grecia,0,2,,2,POINT (11247723 -74213989)
2019,Febrero,Grecia,0,1,,1,POINT (3451668 -76532004)
2019,Febrero,Grecia,39,104,,143,POINT (4697157 -74140516)
2019,Febrero,Grecia,3,6,,9,POINT (6170465 -7542726)
2019,Febrero,Grecia,1,0,,1,POINT (7819 -72453013)
2019,Febrero,Grecia,0,1,,1,POINT (836068 -72409396)
2019,Febrero,Grecia,1,1,,2,POINT (9402597 -75681642)
2019,Febrero,Guatemala,0,1,,1,POINT (-4214082 -69941431)
2019,Febrero,Guatemala,2,3,,5,POINT (0.81488 -77356)
2019,Febrero,Guatemala,1,3,,4,POINT (10406342 -75527794)
2019,Febrero,Guatemala,106,133,,239,POINT (10446304 -75516486)
2019,Febrero,Guatemala,8,16,,24,POINT (10886686 -74776479)
2019,Febrero,Guatemala,1,0,,1,POINT (133387613 -81372937)
2019,Febrero,Guatemala,24,62,,86,POINT (3451668 -76532004)
2019,Febrero,Guatemala,471,752,,1223,POINT (4697157 -74140516)
2019,Febrero,Guatemala,0,7,,7,POINT (4815189 -75736374)
2019,Febrero,Guatemala,48,127,,175,POINT (6170465 -7542726)
2019,Febrero,Guatemala,0,2,,2,POINT (7819 -72453013)
2019,Febrero,Guatemala,0,2,,2,POINT (836068 -72409396)
2019,Febrero,Guyana,0,1,,1,POINT (0.81488 -77356)
2019,Febrero,Guyana,1,0,,1,POINT (10406342 -75527794)
2019,Febrero,Guyana,1,3,,4,POINT (10446304 -75516486)
2019,Febrero,Guyana,1,0,,1,POINT (10886686 -74776479)
2019,Febrero,Guyana,0,1,,1,POINT (11360029 -72129595)
2019,Febrero,Guyana,2,3,,5,POINT (3451668 -76532004)
2019,Febrero,Guyana,3,23,,26,POINT (4697157 -74140516)
2019,Febrero,Guyana,0,1,,1,POINT (6170465 -7542726)
2019,Febrero,Guyana,0,1,,1,POINT (7128047 -73181317)
2019,Febrero,Guyana,0,2,,2,POINT (7819 -72453013)
2019,Febrero,Haití,0,1,,1,POINT (0.81488 -77356)
2019,Febrero,Haití,0,1,,1,POINT (10406342 -75527794)
2019,Febrero,Haití,3,5,,8,POINT (10446304 -75516486)
2019,Febrero,Haití,1,1,,2,POINT (3451668 -76532004)
2019,Febrero,Haití,18,22,,40,POINT (4697157 -74140516)
2019,Febrero,Haití,3,6,,9,POINT (6170465 -7542726)
2019,Febrero,Honduras,3,1,,4,POINT (0.81488 -77356)
2019,Febrero,Honduras,1,13,,14,POINT (10406342 -75527794)
2019,Febrero,Honduras,88,99,,187,POINT (10446304 -75516486)
2019,Febrero,Honduras,7,11,,18,POINT (10886686 -74776479)
2019,Febrero,Honduras,0,1,,1,POINT (125862 -81702165)
2019,Febrero,Honduras,36,28,,64,POINT (3451668 -76532004)
2019,Febrero,Honduras,0,1,,1,POINT (3884426 -77061029)
2019,Febrero,Honduras,287,309,,596,POINT (4697157 -74140516)
2019,Febrero,Honduras,3,6,,9,POINT (4815189 -75736374)
2019,Febrero,Honduras,43,52,,95,POINT (6170465 -7542726)
2019,Febrero,Honduras,1,1,,2,POINT (7128047 -73181317)
2019,Febrero,Honduras,0,3,,3,POINT (7819 -72453013)
2019,Febrero,Honduras,1,0,,1,POINT (836068 -72409396)
2019,Febrero,Hong Kong,1,2,,3,POINT (0.81488 -77356)
2019,Febrero,Hong Kong,2,0,,2,POINT (10446304 -75516486)
2019,Febrero,Hong Kong,17,25,,42,POINT (4697157 -74140516)
2019,Febrero,Hungría,2,3,,5,POINT (0.81488 -77356)
2019,Febrero,Hungría,0,1,,1,POINT (10406342 -75527794)
2019,Febrero,Hungría,4,4,,8,POINT (10446304 -75516486)
2019,Febrero,Hungría,8,14,,22,POINT (3451668 -76532004)
2019,Febrero,Hungría,72,123,,195,POINT (4697157 -74140516)
2019,Febrero,Hungría,7,12,,19,POINT (6170465 -7542726)
2019,Febrero,India,0,1,,1,POINT (-4214082 -69941431)
2019,Febrero,India,1,14,,15,POINT (10406342 -75527794)
2019,Febrero,India,9,61,,70,POINT (10446304 -75516486)
2019,Febrero,India,1,15,,16,POINT (10886686 -74776479)
2019,Febrero,India,0,7,,7,POINT (11247723 -74213989)
2019,Febrero,India,6,23,,29,POINT (3451668 -76532004)
2019,Febrero,India,0,1,,1,POINT (3884426 -77061029)
2019,Febrero,India,94,418,,512,POINT (4697157 -74140516)
2019,Febrero,India,1,1,,2,POINT (4815189 -75736374)
2019,Febrero,India,13,78,,91,POINT (6170465 -7542726)
2019,Febrero,India,0,1,,1,POINT (7128047 -73181317)
2019,Febrero,India,0,3,,3,POINT (806667 -767333)
2019,Febrero,India,0,3,,3,POINT (9402597 -75681642)
2019,Febrero,Indonesia,0,1,,1,POINT (10406342 -75527794)
2019,Febrero,Indonesia,5,1,,6,POINT (10446304 -75516486)
2019,Febrero,Indonesia,1,2,,3,POINT (3451668 -76532004)
2019,Febrero,Indonesia,13,16,,29,POINT (4697157 -74140516)
2019,Febrero,Indonesia,0,1,,1,POINT (6170465 -7542726)
2019,Febrero,Iraq,1,0,,1,POINT (4697157 -74140516)
2019,Febrero,Irán,0,2,,2,POINT (0.81488 -77356)
2019,Febrero,Irán,0,1,,1,POINT (10406342 -75527794)
2019,Febrero,Irán,2,1,,3,POINT (10446304 -75516486)
2019,Febrero,Irán,1,1,,2,POINT (3451668 -76532004)
2019,Febrero,Irán,5,18,,23,POINT (4697157 -74140516)
2019,Febrero,Irán,0,2,,2,POINT (6170465 -7542726)
2019,Febrero,República de Irlanda,0,1,,1,POINT (-4191162 -69941498)
2019,Febrero,República de Irlanda,1,2,,3,POINT (-4214082 -69941431)
2019,Febrero,República de Irlanda,6,11,,17,POINT (0.81488 -77356)
2019,Febrero,República de Irlanda,2,10,,12,POINT (10406342 -75527794)
2019,Febrero,República de Irlanda,20,32,,52,POINT (10446304 -75516486)
2019,Febrero,República de Irlanda,0,6,,6,POINT (10886686 -74776479)
2019,Febrero,República de Irlanda,1,0,,1,POINT (11117206 -74232675)
2019,Febrero,República de Irlanda,4,13,,17,POINT (3451668 -76532004)
2019,Febrero,República de Irlanda,104,177,,281,POINT (4697157 -74140516)
2019,Febrero,República de Irlanda,15,36,,51,POINT (6170465 -7542726)
2019,Febrero,República de Irlanda,0,1,,1,POINT (7927233 -72508188)
2019,Febrero,República de Irlanda,5,4,,9,POINT (863337 -7735002)
2019,Febrero,Islandia,1,1,,2,POINT (10406342 -75527794)
2019,Febrero,Islandia,3,2,,5,POINT (10446304 -75516486)
2019,Febrero,Islandia,6,17,,23,POINT (4697157 -74140516)
2019,Febrero,Islandia,1,1,,2,POINT (6170465 -7542726)
2019,Febrero,Islandia,0,1,,1,POINT (863337 -7735002)
2019,Febrero,Israel,1,2,,3,POINT (-4191162 -69941498)
2019,Febrero,Israel,1,3,,4,POINT (0.33002 -76876446)
2019,Febrero,Israel,10,20,,30,POINT (0.81488 -77356)
2019,Febrero,Israel,0,2,,2,POINT (10406342 -75527794)
2019,Febrero,Israel,21,110,,131,POINT (10446304 -75516486)
2019,Febrero,Israel,0,5,,5,POINT (10886686 -74776479)
2019,Febrero,Israel,0,1,,1,POINT (11117206 -74232675)
2019,Febrero,Israel,9,22,,31,POINT (3451668 -76532004)
2019,Febrero,Israel,155,396,,551,POINT (4697157 -74140516)
2019,Febrero,Israel,0,1,,1,POINT (4815189 -75736374)
2019,Febrero,Israel,28,91,,119,POINT (6170465 -7542726)
2019,Febrero,Israel,0,1,,1,POINT (7819 -72453013)
2019,Febrero,Israel,0,4,,4,POINT (863337 -7735002)
2019,Febrero,Italia,1,2,,3,POINT (-4191162 -69941498)
2019,Febrero,Italia,2,3,,5,POINT (-4214082 -69941431)
2019,Febrero,Italia,0,3,,3,POINT (0.33002 -76876446)
2019,Febrero,Italia,14,31,,45,POINT (0.81488 -77356)
2019,Febrero,Italia,4,20,,24,POINT (10406342 -75527794)
2019,Febrero,Italia,87,228,,315,POINT (10446304 -75516486)
2019,Febrero,Italia,12,40,,52,POINT (10886686 -74776479)
2019,Febrero,Italia,0,2,,2,POINT (11117206 -74232675)
2019,Febrero,Italia,3,6,,9,POINT (11360029 -72129595)
2019,Febrero,Italia,5,9,,14,POINT (125862 -81702165)
2019,Febrero,Italia,37,115,,152,POINT (3451668 -76532004)
2019,Febrero,Italia,940,2260,,3200,POINT (4697157 -74140516)
2019,Febrero,Italia,0,5,,5,POINT (4815189 -75736374)
2019,Febrero,Italia,81,318,,399,POINT (6170465 -7542726)
2019,Febrero,Italia,0,1,,1,POINT (7088729 -70740253)
2019,Febrero,Italia,2,1,,3,POINT (7128047 -73181317)
2019,Febrero,Italia,7,21,,28,POINT (7819 -72453013)
2019,Febrero,Italia,1,1,,2,POINT (7927233 -72508188)
2019,Febrero,Italia,4,5,,9,POINT (836068 -72409396)
2019,Febrero,Italia,3,5,,8,POINT (863337 -7735002)
2019,Febrero,Jamaica,0,2,,2,POINT (0.81488 -77356)
2019,Febrero,Jamaica,9,8,,17,POINT (10446304 -75516486)
2019,Febrero,Jamaica,3,5,,8,POINT (10886686 -74776479)
2019,Febrero,Jamaica,10,4,,14,POINT (3451668 -76532004)
2019,Febrero,Jamaica,29,57,,86,POINT (4697157 -74140516)
2019,Febrero,Jamaica,4,10,,14,POINT (6170465 -7542726)
2019,Febrero,Japón,1,0,,1,POINT (-4191162 -69941498)
2019,Febrero,Japón,8,7,,15,POINT (0.81488 -77356)
2019,Febrero,Japón,1,1,,2,POINT (10406342 -75527794)
2019,Febrero,Japón,14,18,,32,POINT (10446304 -75516486)
2019,Febrero,Japón,0,7,,7,POINT (10886686 -74776479)
2019,Febrero,Japón,0,1,,1,POINT (11360029 -72129595)
2019,Febrero,Japón,4,12,,16,POINT (3451668 -76532004)
2019,Febrero,Japón,227,512,,739,POINT (4697157 -74140516)
2019,Febrero,Japón,0,2,,2,POINT (4815189 -75736374)
2019,Febrero,Japón,35,50,,85,POINT (6170465 -7542726)
2019,Febrero,Jordania,0,3,,3,POINT (0.81488 -77356)
2019,Febrero,Jordania,5,8,,13,POINT (4697157 -74140516)
2019,Febrero,Jordania,0,3,,3,POINT (6170465 -7542726)
2019,Febrero,Kazajistán,1,1,,2,POINT (0.81488 -77356)
2019,Febrero,Kazajistán,3,1,,4,POINT (4697157 -74140516)
2019,Febrero,Kazajistán,3,2,,5,POINT (6170465 -7542726)
2019,Febrero,Kenia,2,0,,2,POINT (10446304 -75516486)
2019,Febrero,Kenia,1,0,,1,POINT (3451668 -76532004)
2019,Febrero,Kenia,3,9,,12,POINT (4697157 -74140516)
2019,Febrero,Kenia,0,2,,2,POINT (6170465 -7542726)
2019,Febrero,Kirguistán,1,0,,1,POINT (4697157 -74140516)
2019,Febrero,Kuwait,1,1,,2,POINT (10446304 -75516486)
2019,Febrero,Kuwait,7,0,,7,POINT (4697157 -74140516)
2019,Febrero,República de Kosovo,1,0,,1,POINT (4697157 -74140516)
2019,Febrero,Letonia,0,1,,1,POINT (0.33002 -76876446)
2019,Febrero,Letonia,1,0,,1,POINT (0.81488 -77356)
2019,Febrero,Letonia,2,1,,3,POINT (10446304 -75516486)
2019,Febrero,Letonia,0,4,,4,POINT (3451668 -76532004)
2019,Febrero,Letonia,11,19,,30,POINT (4697157 -74140516)
2019,Febrero,Letonia,1,2,,3,POINT (6170465 -7542726)
2019,Febrero,Letonia,0,1,,1,POINT (9402597 -75681642)
2019,Febrero,Lituania,1,0,,1,POINT (0.81488 -77356)
2019,Febrero,Lituania,5,9,,14,POINT (10446304 -75516486)
2019,Febrero,Lituania,3,9,,12,POINT (3451668 -76532004)
2019,Febrero,Lituania,25,33,,58,POINT (4697157 -74140516)
2019,Febrero,Lituania,3,8,,11,POINT (6170465 -7542726)
2019,Febrero,Líbano,0,1,,1,POINT (0.81488 -77356)
2019,Febrero,Líbano,0,2,,2,POINT (10446304 -75516486)
2019,Febrero,Líbano,1,1,,2,POINT (10886686 -74776479)
2019,Febrero,Líbano,0,1,,1,POINT (11360029 -72129595)
2019,Febrero,Líbano,0,5,,5,POINT (3451668 -76532004)
2019,Febrero,Líbano,6,20,,26,POINT (4697157 -74140516)
2019,Febrero,Líbano,0,4,,4,POINT (6170465 -7542726)
2019,Febrero,Líbano,1,2,,3,POINT (7128047 -73181317)
2019,Febrero,Libia,1,3,,4,POINT (4697157 -74140516)
2019,Febrero,Liechtenstein,0,1,,1,POINT (10886686 -74776479)
2019,Febrero,Liechtenstein,0,1,,1,POINT (4697157 -74140516)
2019,Febrero,Luxemburgo,1,0,,1,POINT (0.81488 -77356)
2019,Febrero,Luxemburgo,0,1,,1,POINT (10446304 -75516486)
2019,Febrero,Luxemburgo,2,3,,5,POINT (3451668 -76532004)
2019,Febrero,Luxemburgo,16,18,,34,POINT (4697157 -74140516)
2019,Febrero,Luxemburgo,0,1,,1,POINT (6170465 -7542726)
2019,Febrero,Luxemburgo,1,0,,1,POINT (7819 -72453013)
2019,Febrero,Macedonia,0,1,,1,POINT (0.81488 -77356)
2019,Febrero,Macedonia,2,1,,3,POINT (10446304 -75516486)
2019,Febrero,Macedonia,0,1,,1,POINT (3451668 -76532004)
2019,Febrero,Macedonia,6,11,,17,POINT (4697157 -74140516)
2019,Febrero,Madagascar,1,0,,1,POINT (10446304 -75516486)
2019,Febrero,Madagascar,0,1,,1,POINT (4697157 -74140516)
2019,Febrero,Madagascar,1,0,,1,POINT (6170465 -7542726)
2019,Febrero,Malasia,0,1,,1,POINT (10406342 -75527794)
2019,Febrero,Malasia,14,6,,20,POINT (4697157 -74140516)
2019,Febrero,Malasia,0,1,,1,POINT (4815189 -75736374)
2019,Febrero,Malasia,0,1,,1,POINT (6170465 -7542726)
2019,Febrero,Malawi,0,1,,1,POINT (4697157 -74140516)
2019,Febrero,Maldivas,0,1,,1,POINT (3451668 -76532004)
2019,Febrero,Malí,1,1,,2,POINT (4697157 -74140516)
2019,Febrero,Malta,1,1,,2,POINT (10406342 -75527794)
2019,Febrero,Malta,2,2,,4,POINT (10446304 -75516486)
2019,Febrero,Malta,5,12,,17,POINT (4697157 -74140516)
2019,Febrero,Malta,0,1,,1,POINT (6170465 -7542726)
2019,Febrero,Marruecos,0,1,,1,POINT (10446304 -75516486)
2019,Febrero,Marruecos,0,1,,1,POINT (445285 -75766353)
2019,Febrero,Marruecos,19,26,,45,POINT (4697157 -74140516)
2019,Febrero,Marruecos,4,2,,6,POINT (6170465 -7542726)
2019,Febrero,Mauricio,0,1,,1,POINT (10446304 -75516486)
2019,Febrero,Mauricio,1,1,,2,POINT (4697157 -74140516)
2019,Febrero,Mauritania,0,1,,1,POINT (4697157 -74140516)
2019,Febrero,México,0,1,,1,POINT (-4191162 -69941498)
2019,Febrero,México,1,3,,4,POINT (-4214082 -69941431)
2019,Febrero,México,0,1,,1,POINT (0.185957 -7478366)
2019,Febrero,México,3,1,,4,POINT (0.33002 -76876446)
2019,Febrero,México,19,29,,48,POINT (0.81488 -77356)
2019,Febrero,México,25,25,,50,POINT (10406342 -75527794)
2019,Febrero,México,340,449,,789,POINT (10446304 -75516486)
2019,Febrero,México,22,61,,83,POINT (10886686 -74776479)
2019,Febrero,México,0,4,,4,POINT (11360029 -72129595)
2019,Febrero,México,3,5,,8,POINT (125862 -81702165)
2019,Febrero,México,75,206,,281,POINT (3451668 -76532004)
2019,Febrero,México,2,2,,4,POINT (445285 -75766353)
2019,Febrero,México,3765,6950,,10715,POINT (4697157 -74140516)
2019,Febrero,México,6,15,,21,POINT (4815189 -75736374)
2019,Febrero,México,350,924,,1274,POINT (6170465 -7542726)
2019,Febrero,México,0,4,,4,POINT (6185536 -67484028)
2019,Febrero,México,2,0,,2,POINT (7088729 -70740253)
2019,Febrero,México,5,12,,17,POINT (7128047 -73181317)
2019,Febrero,México,8,11,,19,POINT (7819 -72453013)
2019,Febrero,México,4,11,,15,POINT (7927233 -72508188)
2019,Febrero,México,1,2,,3,POINT (836068 -72409396)
2019,Febrero,México,2,2,,4,POINT (863337 -7735002)
2019,Febrero,República de Moldavia,1,0,,1,POINT (0.81488 -77356)
2019,Febrero,República de Moldavia,1,0,,1,POINT (10446304 -75516486)
2019,Febrero,República de Moldavia,4,0,,4,POINT (4697157 -74140516)
2019,Febrero,Mónaco,1,0,,1,POINT (10446304 -75516486)
2019,Febrero,Mónaco,0,1,,1,POINT (3451668 -76532004)
2019,Febrero,Mongolia,1,1,,2,POINT (10446304 -75516486)
2019,Febrero,Montenegro,0,1,,1,POINT (10406342 -75527794)
2019,Febrero,Montenegro,0,3,,3,POINT (10446304 -75516486)
2019,Febrero,Montenegro,2,6,,8,POINT (4697157 -74140516)
2019,Febrero,Micronesia,1,0,,1,POINT (10446304 -75516486)
2019,Febrero,Myanmar,0,10,,10,POINT (10406342 -75527794)
2019,Febrero,Myanmar,1,17,,18,POINT (10446304 -75516486)
2019,Febrero,Myanmar,0,1,,1,POINT (10886686 -74776479)
2019,Febrero,Myanmar,0,1,,1,POINT (10970933 -74765343)
2019,Febrero,Myanmar,0,8,,8,POINT (9402597 -75681642)
2019,Febrero,Namibia,1,0,,1,POINT (4697157 -74140516)
2019,Febrero,Nepal,2,0,,2,POINT (10446304 -75516486)
2019,Febrero,Nepal,0,2,,2,POINT (3451668 -76532004)
2019,Febrero,Nepal,1,3,,4,POINT (4697157 -74140516)
2019,Febrero,Nepal,0,1,,1,POINT (6170465 -7542726)
2019,Febrero,Nicaragua,0,2,,2,POINT (10406342 -75527794)
2019,Febrero,Nicaragua,26,17,,43,POINT (10446304 -75516486)
2019,Febrero,Nicaragua,2,1,,3,POINT (10886686 -74776479)
2019,Febrero,Nicaragua,3,10,,13,POINT (125744111 -81703935)
2019,Febrero,Nicaragua,1,0,,1,POINT (125862 -81702165)
2019,Febrero,Nicaragua,13,14,,27,POINT (3451668 -76532004)
2019,Febrero,Nicaragua,88,107,,195,POINT (4697157 -74140516)
2019,Febrero,Nicaragua,5,5,,10,POINT (4815189 -75736374)
2019,Febrero,Nicaragua,21,19,,40,POINT (6170465 -7542726)
2019,Febrero,Nicaragua,2,6,,8,POINT (7128047 -73181317)
2019,Febrero,Nigeria,1,2,,3,POINT (0.81488 -77356)
2019,Febrero,Nigeria,3,5,,8,POINT (10446304 -75516486)
2019,Febrero,Nigeria,0,1,,1,POINT (10886686 -74776479)
2019,Febrero,Nigeria,1,1,,2,POINT (3451668 -76532004)
2019,Febrero,Nigeria,6,14,,20,POINT (4697157 -74140516)
2019,Febrero,Nigeria,0,1,,1,POINT (6170465 -7542726)
2019,Febrero,Níger,1,0,,1,POINT (10446304 -75516486)
2019,Febrero,Noruega,1,1,,2,POINT (-4214082 -69941431)
2019,Febrero,Noruega,10,4,,14,POINT (0.81488 -77356)
2019,Febrero,Noruega,3,2,,5,POINT (10406342 -75527794)
2019,Febrero,Noruega,45,39,,84,POINT (10446304 -75516486)
2019,Febrero,Noruega,4,2,,6,POINT (10886686 -74776479)
2019,Febrero,Noruega,1,3,,4,POINT (11247723 -74213989)
2019,Febrero,Noruega,0,2,,2,POINT (125862 -81702165)
2019,Febrero,Noruega,6,10,,16,POINT (3451668 -76532004)
2019,Febrero,Noruega,146,189,,335,POINT (4697157 -74140516)
2019,Febrero,Noruega,12,15,,27,POINT (6170465 -7542726)
2019,Febrero,Noruega,0,1,,1,POINT (7128047 -73181317)
2019,Febrero,Noruega,2,2,,4,POINT (863337 -7735002)
2019,Febrero,Nueva Zelanda,2,0,,2,POINT (-4191162 -69941498)
2019,Febrero,Nueva Zelanda,2,0,,2,POINT (0.33002 -76876446)
2019,Febrero,Nueva Zelanda,6,2,,8,POINT (0.81488 -77356)
2019,Febrero,Nueva Zelanda,2,5,,7,POINT (10406342 -75527794)
2019,Febrero,Nueva Zelanda,6,12,,18,POINT (10446304 -75516486)
2019,Febrero,Nueva Zelanda,0,2,,2,POINT (10886686 -74776479)
2019,Febrero,Nueva Zelanda,0,2,,2,POINT (11247723 -74213989)
2019,Febrero,Nueva Zelanda,1,2,,3,POINT (3451668 -76532004)
2019,Febrero,Nueva Zelanda,44,64,,108,POINT (4697157 -74140516)
2019,Febrero,Nueva Zelanda,0,1,,1,POINT (4815189 -75736374)
2019,Febrero,Nueva Zelanda,4,15,,19,POINT (6170465 -7542726)
2019,Febrero,Nueva Zelanda,1,0,,1,POINT (863337 -7735002)
2019,Febrero,Omán,0,1,,1,POINT (10446304 -75516486)
2019,Febrero,Omán,1,0,,1,POINT (4697157 -74140516)
2019,Febrero,Omán,0,1,,1,POINT (863337 -7735002)
2019,Febrero,Países Bajos,5,5,,10,POINT (-4191162 -69941498)
2019,Febrero,Países Bajos,3,5,,8,POINT (-4214082 -69941431)
2019,Febrero,Países Bajos,1,2,,3,POINT (0.33002 -76876446)
2019,Febrero,Países Bajos,32,27,,59,POINT (0.81488 -77356)
2019,Febrero,Países Bajos,26,32,,58,POINT (10406342 -75527794)
2019,Febrero,Países Bajos,327,281,,608,POINT (10446304 -75516486)
2019,Febrero,Países Bajos,11,17,,28,POINT (10886686 -74776479)
2019,Febrero,Países Bajos,1,0,,1,POINT (10970933 -74765343)
2019,Febrero,Países Bajos,2,3,,5,POINT (11117206 -74232675)
2019,Febrero,Países Bajos,0,1,,1,POINT (11360029 -72129595)
2019,Febrero,Países Bajos,3,8,,11,POINT (125744111 -81703935)
2019,Febrero,Países Bajos,2,2,,4,POINT (125862 -81702165)
2019,Febrero,Países Bajos,65,72,,137,POINT (3451668 -76532004)
2019,Febrero,Países Bajos,0,1,,1,POINT (3866713 -67927521)
2019,Febrero,Países Bajos,0,1,,1,POINT (445285 -75766353)
2019,Febrero,Países Bajos,1675,2245,,3920,POINT (4697157 -74140516)
2019,Febrero,Países Bajos,2,3,,5,POINT (4815189 -75736374)
2019,Febrero,Países Bajos,147,211,,358,POINT (6170465 -7542726)
2019,Febrero,Países Bajos,0,2,,2,POINT (6185536 -67484028)
2019,Febrero,Países Bajos,7,11,,18,POINT (7128047 -73181317)
2019,Febrero,Países Bajos,0,4,,4,POINT (7819 -72453013)
2019,Febrero,Países Bajos,1,2,,3,POINT (7927233 -72508188)
2019,Febrero,Países Bajos,0,4,,4,POINT (836068 -72409396)
2019,Febrero,Países Bajos,7,9,,16,POINT (863337 -7735002)
2019,Febrero,Pakistán,1,2,,3,POINT (10446304 -75516486)
2019,Febrero,Pakistán,6,10,,16,POINT (4697157 -74140516)
2019,Febrero,Pakistán,2,0,,2,POINT (6170465 -7542726)
2019,Febrero,Palau,1,1,,2,POINT (4697157 -74140516)
2019,Febrero,Panamá,0,1,,1,POINT (0.33002 -76876446)
2019,Febrero,Panamá,3,6,,9,POINT (0.81488 -77356)
2019,Febrero,Panamá,4,18,,22,POINT (10406342 -75527794)
2019,Febrero,Panamá,876,789,,1665,POINT (10446304 -75516486)
2019,Febrero,Panamá,110,143,,253,POINT (10886686 -74776479)
2019,Febrero,Panamá,1,0,,1,POINT (10970933 -74765343)
2019,Febrero,Panamá,0,1,,1,POINT (11360029 -72129595)
2019,Febrero,Panamá,69,47,,116,POINT (125862 -81702165)
2019,Febrero,Panamá,458,425,,883,POINT (3451668 -76532004)
2019,Febrero,Panamá,2234,2233,,4467,POINT (4697157 -74140516)
2019,Febrero,Panamá,84,89,,173,POINT (4815189 -75736374)
2019,Febrero,Panamá,2518,1934,,4452,POINT (6170465 -7542726)
2019,Febrero,Panamá,1,4,,5,POINT (6218835 -75586989)
2019,Febrero,Panamá,2,3,,5,POINT (6222552 -77401154)
2019,Febrero,Panamá,3,3,,6,POINT (7102626 -77762647)
2019,Febrero,Panamá,35,26,,61,POINT (7128047 -73181317)
2019,Febrero,Panamá,1,6,,7,POINT (7819 -72453013)
2019,Febrero,Panamá,0,1,,1,POINT (836068 -72409396)
2019,Febrero,Panamá,0,1,,1,POINT (863337 -7735002)
2019,Febrero,Paraguay,1,2,,3,POINT (0.81488 -77356)
2019,Febrero,Paraguay,2,0,,2,POINT (10406342 -75527794)
2019,Febrero,Paraguay,50,25,,75,POINT (10446304 -75516486)
2019,Febrero,Paraguay,2,2,,4,POINT (10886686 -74776479)
2019,Febrero,Paraguay,26,18,,44,POINT (125862 -81702165)
2019,Febrero,Paraguay,14,12,,26,POINT (3451668 -76532004)
2019,Febrero,Paraguay,197,213,,410,POINT (4697157 -74140516)
2019,Febrero,Paraguay,2,1,,3,POINT (4815189 -75736374)
2019,Febrero,Paraguay,18,45,,63,POINT (6170465 -7542726)
2019,Febrero,Paraguay,0,3,,3,POINT (7819 -72453013)
2019,Febrero,Paraguay,0,7,,7,POINT (7927233 -72508188)
2019,Febrero,Perú,13,10,,23,POINT (-4191162 -69941498)
2019,Febrero,Perú,109,101,,210,POINT (-4214082 -69941431)
2019,Febrero,Perú,0,13,,13,POINT (0.33002 -76876446)
2019,Febrero,Perú,181,336,,517,POINT (0.81488 -77356)
2019,Febrero,Perú,114,70,,184,POINT (10406342 -75527794)
2019,Febrero,Perú,1625,1148,,2773,POINT (10446304 -75516486)
2019,Febrero,Perú,25,35,,60,POINT (10886686 -74776479)
2019,Febrero,Perú,2,0,,2,POINT (11117206 -74232675)
2019,Febrero,Perú,4,7,,11,POINT (11360029 -72129595)
2019,Febrero,Perú,654,429,,1083,POINT (125862 -81702165)
2019,Febrero,Perú,609,547,,1156,POINT (3451668 -76532004)
2019,Febrero,Perú,0,1,,1,POINT (3866713 -67927521)
2019,Febrero,Perú,2,1,,3,POINT (445285 -75766353)
2019,Febrero,Perú,4886,5155,,10041,POINT (4697157 -74140516)
2019,Febrero,Perú,7,6,,13,POINT (4815189 -75736374)
2019,Febrero,Perú,1088,1240,,2328,POINT (6170465 -7542726)
2019,Febrero,Perú,2,8,,10,POINT (7088729 -70740253)
2019,Febrero,Perú,2,1,,3,POINT (7128047 -73181317)
2019,Febrero,Perú,69,92,,161,POINT (7819 -72453013)
2019,Febrero,Perú,7,9,,16,POINT (836068 -72409396)
2019,Febrero,Perú,1,1,,2,POINT (863337 -7735002)
2019,Febrero,Palestina,0,1,,1,POINT (4697157 -74140516)
2019,Febrero,Polonia,0,1,,1,POINT (-4191162 -69941498)
2019,Febrero,Polonia,2,3,,5,POINT (-4214082 -69941431)
2019,Febrero,Polonia,2,0,,2,POINT (0.33002 -76876446)
2019,Febrero,Polonia,5,7,,12,POINT (0.81488 -77356)
2019,Febrero,Polonia,1,1,,2,POINT (1800143 -78802679)
2019,Febrero,Polonia,75,76,,151,POINT (10406342 -75527794)
2019,Febrero,Polonia,67,69,,136,POINT (10446304 -75516486)
2019,Febrero,Polonia,4,3,,7,POINT (10886686 -74776479)
2019,Febrero,Polonia,1,0,,1,POINT (10970933 -74765343)
2019,Febrero,Polonia,1,1,,2,POINT (125744111 -81703935)
2019,Febrero,Polonia,2,4,,6,POINT (3451668 -76532004)
2019,Febrero,Polonia,0,1,,1,POINT (3884426 -77061029)
2019,Febrero,Polonia,265,371,,636,POINT (4697157 -74140516)
2019,Febrero,Polonia,7,7,,14,POINT (4815189 -75736374)
2019,Febrero,Polonia,26,22,,48,POINT (6170465 -7542726)
2019,Febrero,Polonia,0,1,,1,POINT (6185536 -67484028)
2019,Febrero,Polonia,4,1,,5,POINT (863337 -7735002)
2019,Febrero,Polonia,0,1,,1,POINT (9402597 -75681642)
2019,Febrero,Portugal,0,1,,1,POINT (-4214082 -69941431)
2019,Febrero,Portugal,1,0,,1,POINT (0.33002 -76876446)
2019,Febrero,Portugal,7,13,,20,POINT (0.81488 -77356)
2019,Febrero,Portugal,5,6,,11,POINT (10406342 -75527794)
2019,Febrero,Portugal,28,33,,61,POINT (10446304 -75516486)
2019,Febrero,Portugal,2,6,,8,POINT (10886686 -74776479)
2019,Febrero,Portugal,0,3,,3,POINT (11360029 -72129595)
2019,Febrero,Portugal,3,2,,5,POINT (125862 -81702165)
2019,Febrero,Portugal,3,17,,20,POINT (3451668 -76532004)
2019,Febrero,Portugal,230,484,,714,POINT (4697157 -74140516)
2019,Febrero,Portugal,0,1,,1,POINT (4815189 -75736374)
2019,Febrero,Portugal,16,51,,67,POINT (6170465 -7542726)
2019,Febrero,Portugal,4,10,,14,POINT (7819 -72453013)
2019,Febrero,Portugal,0,4,,4,POINT (836068 -72409396)
2019,Febrero,Portugal,0,1,,1,POINT (863337 -7735002)
2019,Febrero,Qatar,0,4,,4,POINT (4697157 -74140516)
2019,Febrero,Reino Unido de Gran Bretaña e Irlanda del Norte,6,3,,9,POINT (-4191162 -69941498)
2019,Febrero,Reino Unido de Gran Bretaña e Irlanda del Norte,3,9,,12,POINT (-4214082 -69941431)
2019,Febrero,Reino Unido de Gran Bretaña e Irlanda del Norte,2,2,,4,POINT (0.33002 -76876446)
2019,Febrero,Reino Unido de Gran Bretaña e Irlanda del Norte,50,74,,124,POINT (0.81488 -77356)
2019,Febrero,Reino Unido de Gran Bretaña e Irlanda del Norte,62,75,,137,POINT (10406342 -75527794)
2019,Febrero,Reino Unido de Gran Bretaña e Irlanda del Norte,151,234,,385,POINT (10446304 -75516486)
2019,Febrero,Reino Unido de Gran Bretaña e Irlanda del Norte,9,27,,36,POINT (10886686 -74776479)
2019,Febrero,Reino Unido de Gran Bretaña e Irlanda del Norte,1,6,,7,POINT (11117206 -74232675)
2019,Febrero,Reino Unido de Gran Bretaña e Irlanda del Norte,4,7,,11,POINT (11247723 -74213989)
2019,Febrero,Reino Unido de Gran Bretaña e Irlanda del Norte,1,2,,3,POINT (125744111 -81703935)
2019,Febrero,Reino Unido de Gran Bretaña e Irlanda del Norte,0,5,,5,POINT (125862 -81702165)
2019,Febrero,Reino Unido de Gran Bretaña e Irlanda del Norte,28,76,,104,POINT (3451668 -76532004)
2019,Febrero,Reino Unido de Gran Bretaña e Irlanda del Norte,1314,2342,,3656,POINT (4697157 -74140516)
2019,Febrero,Reino Unido de Gran Bretaña e Irlanda del Norte,1,4,,5,POINT (4815189 -75736374)
2019,Febrero,Reino Unido de Gran Bretaña e Irlanda del Norte,115,247,,362,POINT (6170465 -7542726)
2019,Febrero,Reino Unido de Gran Bretaña e Irlanda del Norte,1,0,,1,POINT (6185536 -67484028)
2019,Febrero,Reino Unido de Gran Bretaña e Irlanda del Norte,2,3,,5,POINT (7819 -72453013)
2019,Febrero,Reino Unido de Gran Bretaña e Irlanda del Norte,1,4,,5,POINT (7927233 -72508188)
2019,Febrero,Reino Unido de Gran Bretaña e Irlanda del Norte,19,9,,28,POINT (863337 -7735002)
2019,Febrero,República Dominicana,0,1,,1,POINT (-4214082 -69941431)
2019,Febrero,República Dominicana,4,14,,18,POINT (0.81488 -77356)
2019,Febrero,República Dominicana,0,2,,2,POINT (10406342 -75527794)
2019,Febrero,República Dominicana,48,71,,119,POINT (10446304 -75516486)
2019,Febrero,República Dominicana,21,35,,56,POINT (10886686 -74776479)
2019,Febrero,República Dominicana,0,1,,1,POINT (10970933 -74765343)
2019,Febrero,República Dominicana,1,0,,1,POINT (11117206 -74232675)
2019,Febrero,República Dominicana,0,2,,2,POINT (11247723 -74213989)
2019,Febrero,República Dominicana,0,4,,4,POINT (11360029 -72129595)
2019,Febrero,República Dominicana,0,1,,1,POINT (125862 -81702165)
2019,Febrero,República Dominicana,40,40,,80,POINT (3451668 -76532004)
2019,Febrero,República Dominicana,791,822,,1613,POINT (4697157 -74140516)
2019,Febrero,República Dominicana,1,4,,5,POINT (4815189 -75736374)
2019,Febrero,República Dominicana,81,110,,191,POINT (6170465 -7542726)
2019,Febrero,República Dominicana,3,6,,9,POINT (7819 -72453013)
2019,Febrero,República Dominicana,2,8,,10,POINT (7927233 -72508188)
2019,Febrero,Rumania,1,0,,1,POINT (-4214082 -69941431)
2019,Febrero,Rumania,3,1,,4,POINT (10406342 -75527794)
2019,Febrero,Rumania,9,13,,22,POINT (10446304 -75516486)
2019,Febrero,Rumania,1,2,,3,POINT (10886686 -74776479)
2019,Febrero,Rumania,0,2,,2,POINT (11247723 -74213989)
2019,Febrero,Rumania,7,10,,17,POINT (3451668 -76532004)
2019,Febrero,Rumania,139,147,,286,POINT (4697157 -74140516)
2019,Febrero,Rumania,1,0,,1,POINT (4815189 -75736374)
2019,Febrero,Rumania,16,15,,31,POINT (6170465 -7542726)
2019,Febrero,Rumania,2,0,,2,POINT (863337 -7735002)
2019,Febrero,Federación de Rusia,1,0,,1,POINT (-4214082 -69941431)
2019,Febrero,Federación de Rusia,12,10,,22,POINT (0.81488 -77356)
2019,Febrero,Federación de Rusia,1,10,,11,POINT (10406342 -75527794)
2019,Febrero,Federación de Rusia,15,14,,29,POINT (10446304 -75516486)
2019,Febrero,Federación de Rusia,3,3,,6,POINT (10886686 -74776479)
2019,Febrero,Federación de Rusia,0,2,,2,POINT (11247723 -74213989)
2019,Febrero,Federación de Rusia,1,0,,1,POINT (11360029 -72129595)
2019,Febrero,Federación de Rusia,9,16,,25,POINT (3451668 -76532004)
2019,Febrero,Federación de Rusia,198,221,,419,POINT (4697157 -74140516)
2019,Febrero,Federación de Rusia,15,16,,31,POINT (6170465 -7542726)
2019,Febrero,Federación de Rusia,1,2,,3,POINT (7819 -72453013)
2019,Febrero,Federación de Rusia,1,0,,1,POINT (836068 -72409396)
2019,Febrero,Federación de Rusia,0,2,,2,POINT (9402597 -75681642)
2019,Febrero,Rwanda,0,2,,2,POINT (4697157 -74140516)
2019,Febrero,Rwanda,1,0,,1,POINT (6170465 -7542726)
2019,Febrero,San Cristóbal y Nevis,0,2,,2,POINT (10446304 -75516486)
2019,Febrero,San Cristóbal y Nevis,4,1,,5,POINT (4697157 -74140516)
2019,Febrero,San Cristóbal y Nevis,0,1,,1,POINT (6170465 -7542726)
2019,Febrero,San Marino,0,1,,1,POINT (4697157 -74140516)
2019,Febrero,San  Vicente y las Granadinas,1,0,,1,POINT (10446304 -75516486)
2019,Febrero,San  Vicente y las Granadinas,1,0,,1,POINT (4697157 -74140516)
2019,Febrero,San  Vicente y las Granadinas,0,1,,1,POINT (6170465 -7542726)
2019,Febrero,Santa Lucia,0,1,,1,POINT (0.81488 -77356)
2019,Febrero,Santa Lucia,1,0,,1,POINT (10446304 -75516486)
2019,Febrero,Santa Lucia,0,2,,2,POINT (3451668 -76532004)
2019,Febrero,Santa Lucia,7,2,,9,POINT (4697157 -74140516)
2019,Febrero,Santa Lucia,0,1,,1,POINT (7819 -72453013)
2019,Febrero,Santa Sede/Ciudad del Vaticano,0,1,,1,POINT (4697157 -74140516)
2019,Febrero,Santo Tomé y Príncipe,1,0,,1,POINT (6170465 -7542726)
2019,Febrero,Senegal,1,1,,2,POINT (10446304 -75516486)
2019,Febrero,Senegal,1,0,,1,POINT (10886686 -74776479)
2019,Febrero,Senegal,2,3,,5,POINT (4697157 -74140516)
2019,Febrero,Serbia,2,4,,6,POINT (10446304 -75516486)
2019,Febrero,Serbia,0,1,,1,POINT (10886686 -74776479)
2019,Febrero,Serbia,3,0,,3,POINT (3451668 -76532004)
2019,Febrero,Serbia,19,46,,65,POINT (4697157 -74140516)
2019,Febrero,Serbia,1,5,,6,POINT (6170465 -7542726)
2019,Febrero,Sierra Leona,0,1,,1,POINT (10446304 -75516486)
2019,Febrero,Singapur,1,0,,1,POINT (-4214082 -69941431)
2019,Febrero,Singapur,4,2,,6,POINT (10446304 -75516486)
2019,Febrero,Singapur,0,1,,1,POINT (10886686 -74776479)
2019,Febrero,Singapur,9,26,,35,POINT (4697157 -74140516)
2019,Febrero,Singapur,0,1,,1,POINT (6170465 -7542726)
2019,Febrero,Singapur,0,1,,1,POINT (7128047 -73181317)
2019,Febrero,República Árabe Siria,0,2,,2,POINT (10970933 -74765343)
2019,Febrero,República Árabe Siria,0,1,,1,POINT (11247723 -74213989)
2019,Febrero,República Árabe Siria,0,3,,3,POINT (4697157 -74140516)
2019,Febrero,Somalia,0,1,,1,POINT (6170465 -7542726)
2019,Febrero,Sri Lanka,0,1,,1,POINT (10886686 -74776479)
2019,Febrero,Sri Lanka,1,5,,6,POINT (4697157 -74140516)
2019,Febrero,Sudáfrica,0,1,,1,POINT (0.81488 -77356)
2019,Febrero,Sudáfrica,1,6,,7,POINT (10406342 -75527794)
2019,Febrero,Sudáfrica,5,4,,9,POINT (10446304 -75516486)
2019,Febrero,Sudáfrica,1,2,,3,POINT (10886686 -74776479)
2019,Febrero,Sudáfrica,0,1,,1,POINT (11247723 -74213989)
2019,Febrero,Sudáfrica,0,2,,2,POINT (3451668 -76532004)
2019,Febrero,Sudáfrica,19,35,,54,POINT (4697157 -74140516)
2019,Febrero,Sudáfrica,2,2,,4,POINT (6170465 -7542726)
2019,Febrero,Sudáfrica,1,1,,2,POINT (863337 -7735002)
2019,Febrero,Sudán,1,0,,1,POINT (3451668 -76532004)
2019,Febrero,Sudán,0,1,,1,POINT (4697157 -74140516)
2019,Febrero,Suecia,0,1,,1,POINT (-4191162 -69941498)
2019,Febrero,Suecia,3,9,,12,POINT (-4214082 -69941431)
2019,Febrero,Suecia,0,1,,1,POINT (0.33002 -76876446)
2019,Febrero,Suecia,15,15,,30,POINT (0.81488 -77356)
2019,Febrero,Suecia,17,19,,36,POINT (10406342 -75527794)
2019,Febrero,Suecia,85,84,,169,POINT (10446304 -75516486)
2019,Febrero,Suecia,2,12,,14,POINT (10886686 -74776479)
2019,Febrero,Suecia,0,1,,1,POINT (11117206 -74232675)
2019,Febrero,Suecia,4,8,,12,POINT (11247723 -74213989)
2019,Febrero,Suecia,0,1,,1,POINT (11360029 -72129595)
2019,Febrero,Suecia,3,3,,6,POINT (125862 -81702165)
2019,Febrero,Suecia,5,21,,26,POINT (3451668 -76532004)
2019,Febrero,Suecia,0,1,,1,POINT (445285 -75766353)
2019,Febrero,Suecia,302,395,,697,POINT (4697157 -74140516)
2019,Febrero,Suecia,5,3,,8,POINT (4815189 -75736374)
2019,Febrero,Suecia,28,55,,83,POINT (6170465 -7542726)
2019,Febrero,Suecia,0,1,,1,POINT (7819 -72453013)
2019,Febrero,Suecia,0,1,,1,POINT (7927233 -72508188)
2019,Febrero,Suecia,6,5,,11,POINT (863337 -7735002)
2019,Febrero,Suiza,4,4,,8,POINT (-4191162 -69941498)
2019,Febrero,Suiza,3,2,,5,POINT (-4214082 -69941431)
2019,Febrero,Suiza,1,2,,3,POINT (0.33002 -76876446)
2019,Febrero,Suiza,24,32,,56,POINT (0.81488 -77356)
2019,Febrero,Suiza,30,18,,48,POINT (10406342 -75527794)
2019,Febrero,Suiza,83,81,,164,POINT (10446304 -75516486)
2019,Febrero,Suiza,20,24,,44,POINT (10886686 -74776479)
2019,Febrero,Suiza,1,2,,3,POINT (11247723 -74213989)
2019,Febrero,Suiza,2,2,,4,POINT (125862 -81702165)
2019,Febrero,Suiza,39,57,,96,POINT (3451668 -76532004)
2019,Febrero,Suiza,716,921,,1637,POINT (4697157 -74140516)
2019,Febrero,Suiza,2,2,,4,POINT (4815189 -75736374)
2019,Febrero,Suiza,93,123,,216,POINT (6170465 -7542726)
2019,Febrero,Suiza,0,1,,1,POINT (6185536 -67484028)
2019,Febrero,Suiza,2,0,,2,POINT (7819 -72453013)
2019,Febrero,Suiza,1,3,,4,POINT (836068 -72409396)
2019,Febrero,Suiza,10,8,,18,POINT (863337 -7735002)
2019,Febrero,Surinam,0,1,,1,POINT (-4191162 -69941498)
2019,Febrero,Surinam,10,18,,28,POINT (4697157 -74140516)
2019,Febrero,Tailandia,0,1,,1,POINT (10406342 -75527794)
2019,Febrero,Tailandia,4,3,,7,POINT (10446304 -75516486)
2019,Febrero,Tailandia,1,1,,2,POINT (3451668 -76532004)
2019,Febrero,Tailandia,15,16,,31,POINT (4697157 -74140516)
2019,Febrero,Tailandia,1,0,,1,POINT (6170465 -7542726)
2019,Febrero,Tanzania,0,1,,1,POINT (10446304 -75516486)
2019,Febrero,Tanzania,3,0,,3,POINT (4697157 -74140516)
2019,Febrero,Togo,0,1,,1,POINT (3451668 -76532004)
2019,Febrero,Togo,0,2,,2,POINT (4697157 -74140516)
2019,Febrero,Trinidad y Tobago,0,1,,1,POINT (0.33002 -76876446)
2019,Febrero,Trinidad y Tobago,2,13,,15,POINT (10446304 -75516486)
2019,Febrero,Trinidad y Tobago,1,4,,5,POINT (10886686 -74776479)
2019,Febrero,Trinidad y Tobago,4,11,,15,POINT (3451668 -76532004)
2019,Febrero,Trinidad y Tobago,25,46,,71,POINT (4697157 -74140516)
2019,Febrero,Trinidad y Tobago,1,7,,8,POINT (6170465 -7542726)
2019,Febrero,Trinidad y Tobago,0,2,,2,POINT (7128047 -73181317)
2019,Febrero,Túnez,1,0,,1,POINT (-4191162 -69941498)
2019,Febrero,Túnez,1,1,,2,POINT (10446304 -75516486)
2019,Febrero,Túnez,0,7,,7,POINT (4697157 -74140516)
2019,Febrero,Túnez,1,0,,1,POINT (7819 -72453013)
2019,Febrero,Turquía,0,1,,1,POINT (-4214082 -69941431)
2019,Febrero,Turquía,4,6,,10,POINT (0.81488 -77356)
2019,Febrero,Turquía,1,1,,2,POINT (10406342 -75527794)
2019,Febrero,Turquía,6,13,,19,POINT (10446304 -75516486)
2019,Febrero,Turquía,0,1,,1,POINT (10886686 -74776479)
2019,Febrero,Turquía,0,1,,1,POINT (11360029 -72129595)
2019,Febrero,Turquía,0,1,,1,POINT (125862 -81702165)
2019,Febrero,Turquía,1,8,,9,POINT (3451668 -76532004)
2019,Febrero,Turquía,158,395,,553,POINT (4697157 -74140516)
2019,Febrero,Turquía,9,14,,23,POINT (6170465 -7542726)
2019,Febrero,Turkmenistán,0,1,,1,POINT (4697157 -74140516)
2019,Febrero,Ucrania,1,1,,2,POINT (0.81488 -77356)
2019,Febrero,Ucrania,0,16,,16,POINT (10406342 -75527794)
2019,Febrero,Ucrania,4,6,,10,POINT (10446304 -75516486)
2019,Febrero,Ucrania,0,1,,1,POINT (10886686 -74776479)
2019,Febrero,Ucrania,0,2,,2,POINT (10970933 -74765343)
2019,Febrero,Ucrania,1,6,,7,POINT (3451668 -76532004)
2019,Febrero,Ucrania,0,8,,8,POINT (3884426 -77061029)
2019,Febrero,Ucrania,23,34,,57,POINT (4697157 -74140516)
2019,Febrero,Ucrania,8,2,,10,POINT (6170465 -7542726)
2019,Febrero,Ucrania,0,1,,1,POINT (9402597 -75681642)
2019,Febrero,Uganda,0,1,,1,POINT (0.81488 -77356)
2019,Febrero,Uganda,1,0,,1,POINT (10446304 -75516486)
2019,Febrero,Uganda,1,0,,1,POINT (3451668 -76532004)
2019,Febrero,Uganda,0,2,,2,POINT (4697157 -74140516)
2019,Febrero,Uruguay,0,2,,2,POINT (-4191162 -69941498)
2019,Febrero,Uruguay,0,1,,1,POINT (-4214082 -69941431)
2019,Febrero,Uruguay,7,9,,16,POINT (0.81488 -77356)
2019,Febrero,Uruguay,62,40,,102,POINT (10406342 -75527794)
2019,Febrero,Uruguay,105,92,,197,POINT (10446304 -75516486)
2019,Febrero,Uruguay,3,4,,7,POINT (10886686 -74776479)
2019,Febrero,Uruguay,1,3,,4,POINT (11360029 -72129595)
2019,Febrero,Uruguay,18,13,,31,POINT (125862 -81702165)
2019,Febrero,Uruguay,28,47,,75,POINT (3451668 -76532004)
2019,Febrero,Uruguay,480,546,,1026,POINT (4697157 -74140516)
2019,Febrero,Uruguay,58,83,,141,POINT (6170465 -7542726)
2019,Febrero,Uruguay,0,1,,1,POINT (7088729 -70740253)
2019,Febrero,Uruguay,0,1,,1,POINT (7128047 -73181317)
2019,Febrero,Uruguay,0,4,,4,POINT (7819 -72453013)
2019,Febrero,Uruguay,0,1,,1,POINT (836068 -72409396)
2019,Febrero,Uzbekistán,0,1,,1,POINT (4697157 -74140516)
2019,Febrero,Venezuela,2,6,,8,POINT (-4191162 -69941498)
2019,Febrero,Venezuela,2,1,,3,POINT (-4214082 -69941431)
2019,Febrero,Venezuela,0,1,,1,POINT (0.185957 -7478366)
2019,Febrero,Venezuela,49,67,,116,POINT (0.33002 -76876446)
2019,Febrero,Venezuela,3526,3604,,7130,POINT (0.81488 -77356)
2019,Febrero,Venezuela,1,0,,1,POINT (1800143 -78802679)
2019,Febrero,Venezuela,22,19,,41,POINT (10406342 -75527794)
2019,Febrero,Venezuela,246,289,,535,POINT (10446304 -75516486)
2019,Febrero,Venezuela,119,158,,277,POINT (10886686 -74776479)
2019,Febrero,Venezuela,0,1,,1,POINT (10970933 -74765343)
2019,Febrero,Venezuela,3,8,,11,POINT (11117206 -74232675)
2019,Febrero,Venezuela,4402,4160,,8562,POINT (11360029 -72129595)
2019,Febrero,Venezuela,0,1,,1,POINT (12165168 -71983761)
2019,Febrero,Venezuela,5,2,,7,POINT (125862 -81702165)
2019,Febrero,Venezuela,238,275,,513,POINT (3451668 -76532004)
2019,Febrero,Venezuela,23,17,,40,POINT (3866713 -67927521)
2019,Febrero,Venezuela,6000,5983,,11983,POINT (4697157 -74140516)
2019,Febrero,Venezuela,19,15,,34,POINT (4815189 -75736374)
2019,Febrero,Venezuela,781,790,,1571,POINT (6170465 -7542726)
2019,Febrero,Venezuela,39,30,,69,POINT (6185536 -67484028)
2019,Febrero,Venezuela,662,603,,1265,POINT (7088729 -70740253)
2019,Febrero,Venezuela,12,12,,24,POINT (7128047 -73181317)
2019,Febrero,Venezuela,20665,17554,,38219,POINT (7819 -72453013)
2019,Febrero,Venezuela,18,40,,58,POINT (7927233 -72508188)
2019,Febrero,Venezuela,1636,1283,,2919,POINT (836068 -72409396)
2019,Febrero,Vietnam,0,1,,1,POINT (10406342 -75527794)
2019,Febrero,Vietnam,0,1,,1,POINT (10446304 -75516486)
2019,Febrero,Vietnam,4,2,,6,POINT (4697157 -74140516)
2019,Febrero,Vietnam,0,1,,1,POINT (6170465 -7542726)
2019,Febrero,Islas Vírgenes Británicas/Territorio Británico de Ultramar,0,2,,2,POINT (6170465 -7542726)
2019,Febrero,República Árabe de Yemen,0,1,,1,POINT (4697157 -74140516)
2019,Febrero,Zambia,0,2,,2,POINT (4697157 -74140516)
2019,Febrero,Zambia,0,2,,2,POINT (6170465 -7542726)
2019,Febrero,Zimbabue,1,2,,3,POINT (4697157 -74140516)
2019,Febrero,Anguila/Territorio Británico de Ultramar,0,1,,1,POINT (4697157 -74140516)
2019,Febrero,Refugiado,2,4,,6,POINT (4697157 -74140516)
2019,Febrero,Desconocido,2,6,,8,POINT (10446304 -75516486)
2019,Febrero,Desconocido,4,1,,5,POINT (3451668 -76532004)
2019,Febrero,Desconocido,78,126,,204,POINT (4697157 -74140516)
2019,Febrero,Desconocido,1,2,,3,POINT (6170465 -7542726)
2019,Febrero,Desconocido,0,1,,1,POINT (7819 -72453013)
2019,Febrero,Desconocido,0,1,,1,POINT (4697157 -74140516)
2019,Marzo,Afganistán,1,0,,1,POINT (10446304 -75516486)
2019,Marzo,Afganistán,0,1,,1,POINT (10886686 -74776479)
2019,Marzo,Afganistán,0,3,,3,POINT (4697157 -74140516)
2019,Marzo,Albania,0,2,,2,POINT (0.81488 -77356)
2019,Marzo,Albania,0,1,,1,POINT (10446304 -75516486)
2019,Marzo,Albania,1,1,,2,POINT (10886686 -74776479)
2019,Marzo,Albania,0,1,,1,POINT (3451668 -76532004)
2019,Marzo,Albania,2,30,,32,POINT (4697157 -74140516)
2019,Marzo,Albania,2,1,,3,POINT (6170465 -7542726)
2019,Marzo,Alemania,5,13,,18,POINT (-4191162 -69941498)
2019,Marzo,Alemania,24,20,,44,POINT (-4214082 -69941431)
2019,Marzo,Alemania,5,9,,14,POINT (0.33002 -76876446)
2019,Marzo,Alemania,1,0,,1,POINT (0.812436 -77847006)
2019,Marzo,Alemania,112,152,,264,POINT (0.81488 -77356)
2019,Marzo,Alemania,68,72,,140,POINT (10406342 -75527794)
2019,Marzo,Alemania,153,229,,382,POINT (10446304 -75516486)
2019,Marzo,Alemania,23,44,,67,POINT (10886686 -74776479)
2019,Marzo,Alemania,1,1,,2,POINT (11117206 -74232675)
2019,Marzo,Alemania,2,2,,4,POINT (11247723 -74213989)
2019,Marzo,Alemania,3,1,,4,POINT (11360029 -72129595)
2019,Marzo,Alemania,1,1,,2,POINT (125744111 -81703935)
2019,Marzo,Alemania,5,7,,12,POINT (125862 -81702165)
2019,Marzo,Alemania,0,2,,2,POINT (133387613 -81372937)
2019,Marzo,Alemania,75,100,,175,POINT (3451668 -76532004)
2019,Marzo,Alemania,3,2,,5,POINT (445285 -75766353)
2019,Marzo,Alemania,2888,3754,,6642,POINT (4697157 -74140516)
2019,Marzo,Alemania,7,13,,20,POINT (4815189 -75736374)
2019,Marzo,Alemania,184,306,,490,POINT (6170465 -7542726)
2019,Marzo,Alemania,0,1,,1,POINT (6185536 -67484028)
2019,Marzo,Alemania,0,2,,2,POINT (7128047 -73181317)
2019,Marzo,Alemania,3,6,,9,POINT (7819 -72453013)
2019,Marzo,Alemania,17,18,,35,POINT (863337 -7735002)
2019,Marzo,Alemania,0,4,,4,POINT (9402597 -75681642)
2019,Marzo,Andorra,0,1,,1,POINT (0.81488 -77356)
2019,Marzo,Andorra,9,9,,18,POINT (4697157 -74140516)
2019,Marzo,Andorra,0,1,,1,POINT (6170465 -7542726)
2019,Marzo,Angola,0,2,,2,POINT (4697157 -74140516)
2019,Marzo,Antigua y Barbuda,0,1,,1,POINT (4697157 -74140516)
2019,Marzo,Arabia Saudita,2,2,,4,POINT (10446304 -75516486)
2019,Marzo,Arabia Saudita,0,2,,2,POINT (10886686 -74776479)
2019,Marzo,Arabia Saudita,7,11,,18,POINT (4697157 -74140516)
2019,Marzo,Arabia Saudita,0,2,,2,POINT (6170465 -7542726)
2019,Marzo,Argelia,1,0,,1,POINT (10446304 -75516486)
2019,Marzo,Argelia,1,1,,2,POINT (3451668 -76532004)
2019,Marzo,Argelia,2,3,,5,POINT (4697157 -74140516)
2019,Marzo,Argelia,0,1,,1,POINT (6170465 -7542726)
2019,Marzo,Argentina,6,4,,10,POINT (-4191162 -69941498)
2019,Marzo,Argentina,2,6,,8,POINT (-4214082 -69941431)
2019,Marzo,Argentina,9,8,,17,POINT (0.33002 -76876446)
2019,Marzo,Argentina,106,158,,264,POINT (0.81488 -77356)
2019,Marzo,Argentina,394,279,,673,POINT (10406342 -75527794)
2019,Marzo,Argentina,2977,2295,,5272,POINT (10446304 -75516486)
2019,Marzo,Argentina,19,33,,52,POINT (10886686 -74776479)
2019,Marzo,Argentina,0,1,,1,POINT (11117206 -74232675)
2019,Marzo,Argentina,2,6,,8,POINT (11360029 -72129595)
2019,Marzo,Argentina,290,234,,524,POINT (125862 -81702165)
2019,Marzo,Argentina,136,172,,308,POINT (3451668 -76532004)
2019,Marzo,Argentina,1,0,,1,POINT (445285 -75766353)
2019,Marzo,Argentina,6106,7095,,13201,POINT (4697157 -74140516)
2019,Marzo,Argentina,6,17,,23,POINT (4815189 -75736374)
2019,Marzo,Argentina,340,494,,834,POINT (6170465 -7542726)
2019,Marzo,Argentina,1,1,,2,POINT (7088729 -70740253)
2019,Marzo,Argentina,0,4,,4,POINT (7128047 -73181317)
2019,Marzo,Argentina,1,3,,4,POINT (7819 -72453013)
2019,Marzo,Argentina,1,3,,4,POINT (836068 -72409396)
2019,Marzo,Argentina,1,2,,3,POINT (863337 -7735002)
2019,Marzo,Argentina,0,2,,2,POINT (9402597 -75681642)
2019,Marzo,República de Armenia,1,0,,1,POINT (10446304 -75516486)
2019,Marzo,República de Armenia,1,1,,2,POINT (4697157 -74140516)
2019,Marzo,Australia,1,2,,3,POINT (-4191162 -69941498)
2019,Marzo,Australia,3,3,,6,POINT (-4214082 -69941431)
2019,Marzo,Australia,0,1,,1,POINT (0.33002 -76876446)
2019,Marzo,Australia,18,22,,40,POINT (0.81488 -77356)
2019,Marzo,Australia,5,13,,18,POINT (10406342 -75527794)
2019,Marzo,Australia,53,69,,122,POINT (10446304 -75516486)
2019,Marzo,Australia,10,11,,21,POINT (10886686 -74776479)
2019,Marzo,Australia,1,1,,2,POINT (11247723 -74213989)
2019,Marzo,Australia,0,1,,1,POINT (11360029 -72129595)
2019,Marzo,Australia,0,1,,1,POINT (125744111 -81703935)
2019,Marzo,Australia,0,2,,2,POINT (125862 -81702165)
2019,Marzo,Australia,1,2,,3,POINT (133387613 -81372937)
2019,Marzo,Australia,7,22,,29,POINT (3451668 -76532004)
2019,Marzo,Australia,309,549,,858,POINT (4697157 -74140516)
2019,Marzo,Australia,1,0,,1,POINT (4815189 -75736374)
2019,Marzo,Australia,31,83,,114,POINT (6170465 -7542726)
2019,Marzo,Australia,0,1,,1,POINT (7819 -72453013)
2019,Marzo,Australia,17,20,,37,POINT (863337 -7735002)
2019,Marzo,Australia,1,0,,1,POINT (9402597 -75681642)
2019,Marzo,Austria,1,1,,2,POINT (-4191162 -69941498)
2019,Marzo,Austria,2,3,,5,POINT (-4214082 -69941431)
2019,Marzo,Austria,2,4,,6,POINT (0.33002 -76876446)
2019,Marzo,Austria,8,5,,13,POINT (0.81488 -77356)
2019,Marzo,Austria,5,6,,11,POINT (10406342 -75527794)
2019,Marzo,Austria,14,18,,32,POINT (10446304 -75516486)
2019,Marzo,Austria,3,5,,8,POINT (10886686 -74776479)
2019,Marzo,Austria,1,1,,2,POINT (125744111 -81703935)
2019,Marzo,Austria,7,7,,14,POINT (3451668 -76532004)
2019,Marzo,Austria,238,277,,515,POINT (4697157 -74140516)
2019,Marzo,Austria,14,29,,43,POINT (6170465 -7542726)
2019,Marzo,Austria,0,1,,1,POINT (7128047 -73181317)
2019,Marzo,Austria,1,1,,2,POINT (7819 -72453013)
2019,Marzo,Austria,0,1,,1,POINT (836068 -72409396)
2019,Marzo,Austria,3,1,,4,POINT (863337 -7735002)
2019,Marzo,Azerbaiyán,0,1,,1,POINT (0.81488 -77356)
2019,Marzo,Azerbaiyán,3,9,,12,POINT (4697157 -74140516)
2019,Marzo,Bahamas,5,3,,8,POINT (10446304 -75516486)
2019,Marzo,Bahamas,0,1,,1,POINT (10886686 -74776479)
2019,Marzo,Bahamas,1,0,,1,POINT (3451668 -76532004)
2019,Marzo,Bahamas,4,6,,10,POINT (4697157 -74140516)
2019,Marzo,Bahamas,5,6,,11,POINT (6170465 -7542726)
2019,Marzo,Bahréin,0,2,,2,POINT (4697157 -74140516)
2019,Marzo,Bangladesh,0,1,,1,POINT (10446304 -75516486)
2019,Marzo,Bangladesh,3,4,,7,POINT (4697157 -74140516)
2019,Marzo,Bangladesh,0,1,,1,POINT (863337 -7735002)
2019,Marzo,Barbados,0,1,,1,POINT (10446304 -75516486)
2019,Marzo,Barbados,1,1,,2,POINT (3451668 -76532004)
2019,Marzo,Barbados,9,10,,19,POINT (4697157 -74140516)
2019,Marzo,Barbados,0,2,,2,POINT (6170465 -7542726)
2019,Marzo,República de Belarús,1,1,,2,POINT (3451668 -76532004)
2019,Marzo,República de Belarús,5,12,,17,POINT (4697157 -74140516)
2019,Marzo,República de Belarús,2,0,,2,POINT (7819 -72453013)
2019,Marzo,Bélgica,1,2,,3,POINT (-4214082 -69941431)
2019,Marzo,Bélgica,1,0,,1,POINT (0.33002 -76876446)
2019,Marzo,Bélgica,20,19,,39,POINT (0.81488 -77356)
2019,Marzo,Bélgica,5,4,,9,POINT (10406342 -75527794)
2019,Marzo,Bélgica,33,39,,72,POINT (10446304 -75516486)
2019,Marzo,Bélgica,10,16,,26,POINT (10886686 -74776479)
2019,Marzo,Bélgica,0,6,,6,POINT (11247723 -74213989)
2019,Marzo,Bélgica,1,1,,2,POINT (133387613 -81372937)
2019,Marzo,Bélgica,6,19,,25,POINT (3451668 -76532004)
2019,Marzo,Bélgica,256,444,,700,POINT (4697157 -74140516)
2019,Marzo,Bélgica,3,1,,4,POINT (4815189 -75736374)
2019,Marzo,Bélgica,22,53,,75,POINT (6170465 -7542726)
2019,Marzo,Bélgica,0,1,,1,POINT (863337 -7735002)
2019,Marzo,Belice,0,1,,1,POINT (10446304 -75516486)
2019,Marzo,Belice,1,4,,5,POINT (3451668 -76532004)
2019,Marzo,Belice,5,14,,19,POINT (4697157 -74140516)
2019,Marzo,Belice,6,1,,7,POINT (6170465 -7542726)
2019,Marzo,Benín,0,1,,1,POINT (4697157 -74140516)
2019,Marzo,Benín,2,1,,3,POINT (6170465 -7542726)
2019,Marzo,Bermudas/Territorio Británico de Ultramar,2,2,,4,POINT (10446304 -75516486)
2019,Marzo,Bermudas/Territorio Británico de Ultramar,0,1,,1,POINT (3451668 -76532004)
2019,Marzo,Bermudas/Territorio Británico de Ultramar,0,1,,1,POINT (4697157 -74140516)
2019,Marzo,Bermudas/Territorio Británico de Ultramar,0,5,,5,POINT (6170465 -7542726)
2019,Marzo,Bolivia,0,2,,2,POINT (-4191162 -69941498)
2019,Marzo,Bolivia,1,1,,2,POINT (-4214082 -69941431)
2019,Marzo,Bolivia,11,67,,78,POINT (0.81488 -77356)
2019,Marzo,Bolivia,54,50,,104,POINT (10406342 -75527794)
2019,Marzo,Bolivia,150,102,,252,POINT (10446304 -75516486)
2019,Marzo,Bolivia,1,2,,3,POINT (10886686 -74776479)
2019,Marzo,Bolivia,0,1,,1,POINT (11360029 -72129595)
2019,Marzo,Bolivia,13,14,,27,POINT (125862 -81702165)
2019,Marzo,Bolivia,33,42,,75,POINT (3451668 -76532004)
2019,Marzo,Bolivia,530,645,,1175,POINT (4697157 -74140516)
2019,Marzo,Bolivia,1,2,,3,POINT (4815189 -75736374)
2019,Marzo,Bolivia,39,93,,132,POINT (6170465 -7542726)
2019,Marzo,Bolivia,1,1,,2,POINT (7819 -72453013)
2019,Marzo,Bosnia y Herzegovina,0,1,,1,POINT (10406342 -75527794)
2019,Marzo,Bosnia y Herzegovina,1,0,,1,POINT (125862 -81702165)
2019,Marzo,Bosnia y Herzegovina,6,8,,14,POINT (4697157 -74140516)
2019,Marzo,Bosnia y Herzegovina,2,0,,2,POINT (6170465 -7542726)
2019,Marzo,Brasil,122,117,,239,POINT (-4191162 -69941498)
2019,Marzo,Brasil,3,3,,6,POINT (-4214082 -69941431)
2019,Marzo,Brasil,15,28,,43,POINT (0.81488 -77356)
2019,Marzo,Brasil,475,319,,794,POINT (10406342 -75527794)
2019,Marzo,Brasil,1118,753,,1871,POINT (10446304 -75516486)
2019,Marzo,Brasil,20,102,,122,POINT (10886686 -74776479)
2019,Marzo,Brasil,2,2,,4,POINT (11360029 -72129595)
2019,Marzo,Brasil,1,3,,4,POINT (125744111 -81703935)
2019,Marzo,Brasil,444,346,,790,POINT (125862 -81702165)
2019,Marzo,Brasil,87,119,,206,POINT (3451668 -76532004)
2019,Marzo,Brasil,0,2,,2,POINT (3866713 -67927521)
2019,Marzo,Brasil,1,1,,2,POINT (445285 -75766353)
2019,Marzo,Brasil,5369,6266,,11635,POINT (4697157 -74140516)
2019,Marzo,Brasil,3,9,,12,POINT (4815189 -75736374)
2019,Marzo,Brasil,173,316,,489,POINT (6170465 -7542726)
2019,Marzo,Brasil,0,3,,3,POINT (7128047 -73181317)
2019,Marzo,Brasil,0,1,,1,POINT (7819 -72453013)
2019,Marzo,Brasil,0,2,,2,POINT (836068 -72409396)
2019,Marzo,Brasil,0,4,,4,POINT (863337 -7735002)
2019,Marzo,Bulgaria,0,1,,1,POINT (0.81488 -77356)
2019,Marzo,Bulgaria,6,3,,9,POINT (10446304 -75516486)
2019,Marzo,Bulgaria,1,1,,2,POINT (10886686 -74776479)
2019,Marzo,Bulgaria,1,1,,2,POINT (3451668 -76532004)
2019,Marzo,Bulgaria,26,39,,65,POINT (4697157 -74140516)
2019,Marzo,Bulgaria,0,1,,1,POINT (4815189 -75736374)
2019,Marzo,Bulgaria,4,10,,14,POINT (6170465 -7542726)
2019,Marzo,Burkina Faso,0,1,,1,POINT (4697157 -74140516)
2019,Marzo,Islas Caimán/Territorio Británico de Ultramar,1,0,,1,POINT (10446304 -75516486)
2019,Marzo,Islas Caimán/Territorio Británico de Ultramar,3,0,,3,POINT (10886686 -74776479)
2019,Marzo,Islas Caimán/Territorio Británico de Ultramar,1,0,,1,POINT (125862 -81702165)
2019,Marzo,Islas Caimán/Territorio Británico de Ultramar,2,0,,2,POINT (3451668 -76532004)
2019,Marzo,Islas Caimán/Territorio Británico de Ultramar,0,1,,1,POINT (4697157 -74140516)
2019,Marzo,Islas Caimán/Territorio Británico de Ultramar,1,0,,1,POINT (6170465 -7542726)
2019,Marzo,Camboya,0,1,,1,POINT (4697157 -74140516)
2019,Marzo,Camerún,1,3,,4,POINT (10446304 -75516486)
2019,Marzo,Camerún,1,0,,1,POINT (3451668 -76532004)
2019,Marzo,Camerún,3,5,,8,POINT (4697157 -74140516)
2019,Marzo,Canadá,2,3,,5,POINT (-4191162 -69941498)
2019,Marzo,Canadá,1,4,,5,POINT (-4214082 -69941431)
2019,Marzo,Canadá,1,1,,2,POINT (0.33002 -76876446)
2019,Marzo,Canadá,14,29,,43,POINT (0.81488 -77356)
2019,Marzo,Canadá,109,87,,196,POINT (10406342 -75527794)
2019,Marzo,Canadá,1339,1427,,2766,POINT (10446304 -75516486)
2019,Marzo,Canadá,42,44,,86,POINT (10886686 -74776479)
2019,Marzo,Canadá,2,2,,4,POINT (11117206 -74232675)
2019,Marzo,Canadá,0,1,,1,POINT (11247723 -74213989)
2019,Marzo,Canadá,1,1,,2,POINT (11360029 -72129595)
2019,Marzo,Canadá,2,5,,7,POINT (125744111 -81703935)
2019,Marzo,Canadá,269,234,,503,POINT (125862 -81702165)
2019,Marzo,Canadá,3,3,,6,POINT (133387613 -81372937)
2019,Marzo,Canadá,115,134,,249,POINT (3451668 -76532004)
2019,Marzo,Canadá,2,1,,3,POINT (445285 -75766353)
2019,Marzo,Canadá,1805,2561,,4366,POINT (4697157 -74140516)
2019,Marzo,Canadá,9,17,,26,POINT (4815189 -75736374)
2019,Marzo,Canadá,242,494,,736,POINT (6170465 -7542726)
2019,Marzo,Canadá,3,9,,12,POINT (7128047 -73181317)
2019,Marzo,Canadá,0,1,,1,POINT (7819 -72453013)
2019,Marzo,Canadá,13,12,,25,POINT (863337 -7735002)
2019,Marzo,Chad,0,1,,1,POINT (4697157 -74140516)
2019,Marzo,República Del Congo,0,1,,1,POINT (4697157 -74140516)
2019,Marzo,República Democrática del Congo,5,2,,7,POINT (4697157 -74140516)
2019,Marzo,República de Corea,1,3,,4,POINT (-4191162 -69941498)
2019,Marzo,República de Corea,10,14,,24,POINT (0.81488 -77356)
2019,Marzo,República de Corea,13,17,,30,POINT (10446304 -75516486)
2019,Marzo,República de Corea,1,4,,5,POINT (10886686 -74776479)
2019,Marzo,República de Corea,0,1,,1,POINT (11247723 -74213989)
2019,Marzo,República de Corea,3,5,,8,POINT (3451668 -76532004)
2019,Marzo,República de Corea,240,474,,714,POINT (4697157 -74140516)
2019,Marzo,República de Corea,13,38,,51,POINT (6170465 -7542726)
2019,Marzo,Costa de Marfil,1,1,,2,POINT (4697157 -74140516)
2019,Marzo,Costa de Marfil,0,3,,3,POINT (6170465 -7542726)
2019,Marzo,Costa Rica,0,3,,3,POINT (-4214082 -69941431)
2019,Marzo,Costa Rica,0,6,,6,POINT (1800143 -78802679)
2019,Marzo,Costa Rica,210,151,,361,POINT (10446304 -75516486)
2019,Marzo,Costa Rica,24,19,,43,POINT (10886686 -74776479)
2019,Marzo,Costa Rica,0,4,,4,POINT (11360029 -72129595)
2019,Marzo,Costa Rica,51,45,,96,POINT (125862 -81702165)
2019,Marzo,Costa Rica,38,61,,99,POINT (3451668 -76532004)
2019,Marzo,Costa Rica,1,0,,1,POINT (445285 -75766353)
2019,Marzo,Costa Rica,1008,1246,,2254,POINT (4697157 -74140516)
2019,Marzo,Costa Rica,2,9,,11,POINT (4815189 -75736374)
2019,Marzo,Costa Rica,106,170,,276,POINT (6170465 -7542726)
2019,Marzo,Costa Rica,1,3,,4,POINT (7128047 -73181317)
2019,Marzo,Costa Rica,0,3,,3,POINT (836068 -72409396)
2019,Marzo,Croacia,0,1,,1,POINT (0.81488 -77356)
2019,Marzo,Croacia,0,2,,2,POINT (10406342 -75527794)
2019,Marzo,Croacia,4,6,,10,POINT (10446304 -75516486)
2019,Marzo,Croacia,0,3,,3,POINT (10970933 -74765343)
2019,Marzo,Croacia,32,41,,73,POINT (4697157 -74140516)
2019,Marzo,Croacia,3,5,,8,POINT (6170465 -7542726)
2019,Marzo,Croacia,1,1,,2,POINT (863337 -7735002)
2019,Marzo,Cuba,0,9,,9,POINT (0.81488 -77356)
2019,Marzo,Cuba,0,11,,11,POINT (1800143 -78802679)
2019,Marzo,Cuba,12,18,,30,POINT (10446304 -75516486)
2019,Marzo,Cuba,7,22,,29,POINT (10886686 -74776479)
2019,Marzo,Cuba,1,0,,1,POINT (11360029 -72129595)
2019,Marzo,Cuba,29,29,,58,POINT (3451668 -76532004)
2019,Marzo,Cuba,0,1,,1,POINT (445285 -75766353)
2019,Marzo,Cuba,182,348,,530,POINT (4697157 -74140516)
2019,Marzo,Cuba,1,2,,3,POINT (4815189 -75736374)
2019,Marzo,Cuba,15,29,,44,POINT (6170465 -7542726)
2019,Marzo,Cuba,1,1,,2,POINT (7819 -72453013)
2019,Marzo,República Checa,0,1,,1,POINT (-4214082 -69941431)
2019,Marzo,República Checa,0,1,,1,POINT (0.812436 -77847006)
2019,Marzo,República Checa,3,8,,11,POINT (0.81488 -77356)
2019,Marzo,República Checa,1,5,,6,POINT (10406342 -75527794)
2019,Marzo,República Checa,8,18,,26,POINT (10446304 -75516486)
2019,Marzo,República Checa,0,1,,1,POINT (3451668 -76532004)
2019,Marzo,República Checa,120,195,,315,POINT (4697157 -74140516)
2019,Marzo,República Checa,8,15,,23,POINT (6170465 -7542726)
2019,Marzo,República Checa,2,1,,3,POINT (863337 -7735002)
2019,Marzo,Chile,1,0,,1,POINT (-4191162 -69941498)
2019,Marzo,Chile,3,1,,4,POINT (-4214082 -69941431)
2019,Marzo,Chile,3,1,,4,POINT (0.33002 -76876446)
2019,Marzo,Chile,42,77,,119,POINT (0.81488 -77356)
2019,Marzo,Chile,273,182,,455,POINT (10406342 -75527794)
2019,Marzo,Chile,627,432,,1059,POINT (10446304 -75516486)
2019,Marzo,Chile,16,32,,48,POINT (10886686 -74776479)
2019,Marzo,Chile,1,4,,5,POINT (11117206 -74232675)
2019,Marzo,Chile,0,5,,5,POINT (11247723 -74213989)
2019,Marzo,Chile,2,3,,5,POINT (11360029 -72129595)
2019,Marzo,Chile,345,261,,606,POINT (125862 -81702165)
2019,Marzo,Chile,125,174,,299,POINT (3451668 -76532004)
2019,Marzo,Chile,0,2,,2,POINT (445285 -75766353)
2019,Marzo,Chile,4080,4998,,9078,POINT (4697157 -74140516)
2019,Marzo,Chile,2,6,,8,POINT (4815189 -75736374)
2019,Marzo,Chile,88,207,,295,POINT (6170465 -7542726)
2019,Marzo,Chile,0,1,,1,POINT (7088729 -70740253)
2019,Marzo,Chile,8,13,,21,POINT (7819 -72453013)
2019,Marzo,Chile,0,2,,2,POINT (836068 -72409396)
2019,Marzo,Chile,0,1,,1,POINT (863337 -7735002)
2019,Marzo,China,2,1,,3,POINT (-4191162 -69941498)
2019,Marzo,China,1,1,,2,POINT (-4214082 -69941431)
2019,Marzo,China,12,6,,18,POINT (0.81488 -77356)
2019,Marzo,China,1,2,,3,POINT (10406342 -75527794)
2019,Marzo,China,51,26,,77,POINT (10446304 -75516486)
2019,Marzo,China,7,12,,19,POINT (10886686 -74776479)
2019,Marzo,China,0,10,,10,POINT (10970933 -74765343)
2019,Marzo,China,9,16,,25,POINT (3451668 -76532004)
2019,Marzo,China,0,4,,4,POINT (3884426 -77061029)
2019,Marzo,China,525,1109,,1634,POINT (4697157 -74140516)
2019,Marzo,China,0,1,,1,POINT (4815189 -75736374)
2019,Marzo,China,65,124,,189,POINT (6170465 -7542726)
2019,Marzo,China,0,7,,7,POINT (7819 -72453013)
2019,Marzo,China,0,1,,1,POINT (863337 -7735002)
2019,Marzo,Taiwán,0,1,,1,POINT (-4214082 -69941431)
2019,Marzo,Taiwán,1,2,,3,POINT (0.81488 -77356)
2019,Marzo,Taiwán,3,1,,4,POINT (10406342 -75527794)
2019,Marzo,Taiwán,10,9,,19,POINT (10446304 -75516486)
2019,Marzo,Taiwán,1,1,,2,POINT (10886686 -74776479)
2019,Marzo,Taiwán,0,1,,1,POINT (125862 -81702165)
2019,Marzo,Taiwán,1,3,,4,POINT (3451668 -76532004)
2019,Marzo,Taiwán,99,110,,209,POINT (4697157 -74140516)
2019,Marzo,Taiwán,7,13,,20,POINT (6170465 -7542726)
2019,Marzo,Chipre,2,0,,2,POINT (10446304 -75516486)
2019,Marzo,Chipre,5,20,,25,POINT (4697157 -74140516)
2019,Marzo,Dinamarca,0,3,,3,POINT (0.33002 -76876446)
2019,Marzo,Dinamarca,10,5,,15,POINT (0.81488 -77356)
2019,Marzo,Dinamarca,5,5,,10,POINT (10406342 -75527794)
2019,Marzo,Dinamarca,32,39,,71,POINT (10446304 -75516486)
2019,Marzo,Dinamarca,0,2,,2,POINT (10886686 -74776479)
2019,Marzo,Dinamarca,5,9,,14,POINT (11247723 -74213989)
2019,Marzo,Dinamarca,2,2,,4,POINT (125744111 -81703935)
2019,Marzo,Dinamarca,1,0,,1,POINT (125862 -81702165)
2019,Marzo,Dinamarca,11,14,,25,POINT (3451668 -76532004)
2019,Marzo,Dinamarca,0,1,,1,POINT (3884426 -77061029)
2019,Marzo,Dinamarca,0,1,,1,POINT (445285 -75766353)
2019,Marzo,Dinamarca,199,262,,461,POINT (4697157 -74140516)
2019,Marzo,Dinamarca,0,1,,1,POINT (4815189 -75736374)
2019,Marzo,Dinamarca,8,26,,34,POINT (6170465 -7542726)
2019,Marzo,Dinamarca,0,1,,1,POINT (863337 -7735002)
2019,Marzo,Dominica,0,1,,1,POINT (3451668 -76532004)
2019,Marzo,Dominica,1,5,,6,POINT (4697157 -74140516)
2019,Marzo,Dominica,0,1,,1,POINT (4815189 -75736374)
2019,Marzo,Dominica,0,1,,1,POINT (6170465 -7542726)
2019,Marzo,Ecuador,0,1,,1,POINT (-4191162 -69941498)
2019,Marzo,Ecuador,0,3,,3,POINT (-4214082 -69941431)
2019,Marzo,Ecuador,0,1,,1,POINT (0.185957 -7478366)
2019,Marzo,Ecuador,77,276,,353,POINT (0.33002 -76876446)
2019,Marzo,Ecuador,0,1,,1,POINT (0.812436 -77847006)
2019,Marzo,Ecuador,1675,2130,,3805,POINT (0.81488 -77356)
2019,Marzo,Ecuador,33,20,,53,POINT (1800143 -78802679)
2019,Marzo,Ecuador,53,48,,101,POINT (10406342 -75527794)
2019,Marzo,Ecuador,651,479,,1130,POINT (10446304 -75516486)
2019,Marzo,Ecuador,30,28,,58,POINT (10886686 -74776479)
2019,Marzo,Ecuador,0,1,,1,POINT (11117206 -74232675)
2019,Marzo,Ecuador,4,5,,9,POINT (11360029 -72129595)
2019,Marzo,Ecuador,32,25,,57,POINT (125862 -81702165)
2019,Marzo,Ecuador,758,769,,1527,POINT (3451668 -76532004)
2019,Marzo,Ecuador,0,2,,2,POINT (3866713 -67927521)
2019,Marzo,Ecuador,0,2,,2,POINT (445285 -75766353)
2019,Marzo,Ecuador,2826,3545,,6371,POINT (4697157 -74140516)
2019,Marzo,Ecuador,10,17,,27,POINT (4815189 -75736374)
2019,Marzo,Ecuador,59,102,,161,POINT (6170465 -7542726)
2019,Marzo,Ecuador,0,1,,1,POINT (7088729 -70740253)
2019,Marzo,Ecuador,1,3,,4,POINT (7128047 -73181317)
2019,Marzo,Ecuador,38,66,,104,POINT (7819 -72453013)
2019,Marzo,Ecuador,0,1,,1,POINT (836068 -72409396)
2019,Marzo,Ecuador,1,0,,1,POINT (863337 -7735002)
2019,Marzo,Egipto,0,1,,1,POINT (11360029 -72129595)
2019,Marzo,Egipto,0,2,,2,POINT (3451668 -76532004)
2019,Marzo,Egipto,3,23,,26,POINT (4697157 -74140516)
2019,Marzo,El Salvador,0,1,,1,POINT (0.81488 -77356)
2019,Marzo,El Salvador,1,2,,3,POINT (10406342 -75527794)
2019,Marzo,El Salvador,220,181,,401,POINT (10446304 -75516486)
2019,Marzo,El Salvador,2,5,,7,POINT (10886686 -74776479)
2019,Marzo,El Salvador,1,2,,3,POINT (125862 -81702165)
2019,Marzo,El Salvador,80,100,,180,POINT (3451668 -76532004)
2019,Marzo,El Salvador,1,2,,3,POINT (445285 -75766353)
2019,Marzo,El Salvador,502,691,,1193,POINT (4697157 -74140516)
2019,Marzo,El Salvador,1,2,,3,POINT (4815189 -75736374)
2019,Marzo,El Salvador,33,48,,81,POINT (6170465 -7542726)
2019,Marzo,Emiratos Árabes,1,2,,3,POINT (10446304 -75516486)
2019,Marzo,Emiratos Árabes,7,55,,62,POINT (4697157 -74140516)
2019,Marzo,Emiratos Árabes,2,0,,2,POINT (6170465 -7542726)
2019,Marzo,España,0,3,,3,POINT (-4191162 -69941498)
2019,Marzo,España,10,12,,22,POINT (-4214082 -69941431)
2019,Marzo,España,4,2,,6,POINT (0.33002 -76876446)
2019,Marzo,España,37,45,,82,POINT (0.81488 -77356)
2019,Marzo,España,0,1,,1,POINT (1800143 -78802679)
2019,Marzo,España,47,237,,284,POINT (10406342 -75527794)
2019,Marzo,España,138,183,,321,POINT (10446304 -75516486)
2019,Marzo,España,18,64,,82,POINT (10886686 -74776479)
2019,Marzo,España,0,1,,1,POINT (10970933 -74765343)
2019,Marzo,España,0,2,,2,POINT (11117206 -74232675)
2019,Marzo,España,2,2,,4,POINT (11247723 -74213989)
2019,Marzo,España,7,14,,21,POINT (11360029 -72129595)
2019,Marzo,España,8,8,,16,POINT (125862 -81702165)
2019,Marzo,España,172,301,,473,POINT (3451668 -76532004)
2019,Marzo,España,1,0,,1,POINT (445285 -75766353)
2019,Marzo,España,2743,5859,,8602,POINT (4697157 -74140516)
2019,Marzo,España,2,17,,19,POINT (4815189 -75736374)
2019,Marzo,España,304,612,,916,POINT (6170465 -7542726)
2019,Marzo,España,0,1,,1,POINT (7128047 -73181317)
2019,Marzo,España,21,31,,52,POINT (7819 -72453013)
2019,Marzo,España,0,2,,2,POINT (7927233 -72508188)
2019,Marzo,España,4,8,,12,POINT (836068 -72409396)
2019,Marzo,España,3,2,,5,POINT (863337 -7735002)
2019,Marzo,Eritrea,1,2,,3,POINT (4697157 -74140516)
2019,Marzo,Eslovaquia,0,1,,1,POINT (-4191162 -69941498)
2019,Marzo,Eslovaquia,1,1,,2,POINT (0.81488 -77356)
2019,Marzo,Eslovaquia,2,2,,4,POINT (10406342 -75527794)
2019,Marzo,Eslovaquia,3,9,,12,POINT (10446304 -75516486)
2019,Marzo,Eslovaquia,0,2,,2,POINT (3451668 -76532004)
2019,Marzo,Eslovaquia,64,104,,168,POINT (4697157 -74140516)
2019,Marzo,Eslovaquia,6,6,,12,POINT (6170465 -7542726)
2019,Marzo,Eslovaquia,1,0,,1,POINT (7819 -72453013)
2019,Marzo,Eslovaquia,0,1,,1,POINT (863337 -7735002)
2019,Marzo,Eslovenia,2,3,,5,POINT (0.81488 -77356)
2019,Marzo,Eslovenia,0,2,,2,POINT (10406342 -75527794)
2019,Marzo,Eslovenia,1,1,,2,POINT (10446304 -75516486)
2019,Marzo,Eslovenia,0,1,,1,POINT (3451668 -76532004)
2019,Marzo,Eslovenia,27,44,,71,POINT (4697157 -74140516)
2019,Marzo,Eslovenia,1,2,,3,POINT (6170465 -7542726)
2019,Marzo,Estados Unidos de América,22,22,,44,POINT (-4191162 -69941498)
2019,Marzo,Estados Unidos de América,7,19,,26,POINT (-4214082 -69941431)
2019,Marzo,Estados Unidos de América,1,4,,5,POINT (0.33002 -76876446)
2019,Marzo,Estados Unidos de América,42,64,,106,POINT (0.81488 -77356)
2019,Marzo,Estados Unidos de América,57,90,,147,POINT (10406342 -75527794)
2019,Marzo,Estados Unidos de América,7668,8750,,16418,POINT (10446304 -75516486)
2019,Marzo,Estados Unidos de América,826,1328,,2154,POINT (10886686 -74776479)
2019,Marzo,Estados Unidos de América,1,1,,2,POINT (10970933 -74765343)
2019,Marzo,Estados Unidos de América,47,67,,114,POINT (11117206 -74232675)
2019,Marzo,Estados Unidos de América,5,6,,11,POINT (11247723 -74213989)
2019,Marzo,Estados Unidos de América,15,17,,32,POINT (11360029 -72129595)
2019,Marzo,Estados Unidos de América,23,24,,47,POINT (125744111 -81703935)
2019,Marzo,Estados Unidos de América,76,48,,124,POINT (125862 -81702165)
2019,Marzo,Estados Unidos de América,2,5,,7,POINT (133387613 -81372937)
2019,Marzo,Estados Unidos de América,1892,2424,,4316,POINT (3451668 -76532004)
2019,Marzo,Estados Unidos de América,161,244,,405,POINT (445285 -75766353)
2019,Marzo,Estados Unidos de América,12556,19434,,31990,POINT (4697157 -74140516)
2019,Marzo,Estados Unidos de América,291,460,,751,POINT (4815189 -75736374)
2019,Marzo,Estados Unidos de América,3791,8381,,12172,POINT (6170465 -7542726)
2019,Marzo,Estados Unidos de América,1,0,,1,POINT (6218835 -75586989)
2019,Marzo,Estados Unidos de América,34,76,,110,POINT (7128047 -73181317)
2019,Marzo,Estados Unidos de América,11,7,,18,POINT (7819 -72453013)
2019,Marzo,Estados Unidos de América,5,16,,21,POINT (7927233 -72508188)
2019,Marzo,Estados Unidos de América,3,4,,7,POINT (836068 -72409396)
2019,Marzo,Estados Unidos de América,15,11,,26,POINT (863337 -7735002)
2019,Marzo,Estonia,0,1,,1,POINT (10446304 -75516486)
2019,Marzo,Estonia,0,1,,1,POINT (11247723 -74213989)
2019,Marzo,Estonia,0,1,,1,POINT (3451668 -76532004)
2019,Marzo,Estonia,24,36,,60,POINT (4697157 -74140516)
2019,Marzo,Estonia,2,3,,5,POINT (6170465 -7542726)
2019,Marzo,Etiopia,0,1,,1,POINT (10406342 -75527794)
2019,Marzo,Etiopia,0,1,,1,POINT (10446304 -75516486)
2019,Marzo,Etiopia,2,3,,5,POINT (3451668 -76532004)
2019,Marzo,Etiopia,2,34,,36,POINT (4697157 -74140516)
2019,Marzo,Etiopia,0,1,,1,POINT (6170465 -7542726)
2019,Marzo,Filipinas,1,0,,1,POINT (0.81488 -77356)
2019,Marzo,Filipinas,2,54,,56,POINT (10406342 -75527794)
2019,Marzo,Filipinas,6,55,,61,POINT (10446304 -75516486)
2019,Marzo,Filipinas,1,5,,6,POINT (10886686 -74776479)
2019,Marzo,Filipinas,1,24,,25,POINT (10970933 -74765343)
2019,Marzo,Filipinas,0,11,,11,POINT (11247723 -74213989)
2019,Marzo,Filipinas,2,7,,9,POINT (3451668 -76532004)
2019,Marzo,Filipinas,0,11,,11,POINT (3884426 -77061029)
2019,Marzo,Filipinas,53,82,,135,POINT (4697157 -74140516)
2019,Marzo,Filipinas,4,7,,11,POINT (6170465 -7542726)
2019,Marzo,Filipinas,0,11,,11,POINT (9402597 -75681642)
2019,Marzo,Finlandia,0,1,,1,POINT (-4191162 -69941498)
2019,Marzo,Finlandia,0,1,,1,POINT (-4214082 -69941431)
2019,Marzo,Finlandia,3,2,,5,POINT (0.81488 -77356)
2019,Marzo,Finlandia,1,0,,1,POINT (10406342 -75527794)
2019,Marzo,Finlandia,8,8,,16,POINT (10446304 -75516486)
2019,Marzo,Finlandia,1,2,,3,POINT (10886686 -74776479)
2019,Marzo,Finlandia,1,3,,4,POINT (3451668 -76532004)
2019,Marzo,Finlandia,68,83,,151,POINT (4697157 -74140516)
2019,Marzo,Finlandia,0,1,,1,POINT (4815189 -75736374)
2019,Marzo,Finlandia,13,13,,26,POINT (6170465 -7542726)
2019,Marzo,Finlandia,1,0,,1,POINT (863337 -7735002)
2019,Marzo,Francia,9,6,,15,POINT (-4191162 -69941498)
2019,Marzo,Francia,15,25,,40,POINT (-4214082 -69941431)
2019,Marzo,Francia,7,7,,14,POINT (0.33002 -76876446)
2019,Marzo,Francia,106,133,,239,POINT (0.81488 -77356)
2019,Marzo,Francia,14,22,,36,POINT (10406342 -75527794)
2019,Marzo,Francia,232,367,,599,POINT (10446304 -75516486)
2019,Marzo,Francia,49,50,,99,POINT (10886686 -74776479)
2019,Marzo,Francia,1,1,,2,POINT (10970933 -74765343)
2019,Marzo,Francia,1,0,,1,POINT (11117206 -74232675)
2019,Marzo,Francia,1,4,,5,POINT (11360029 -72129595)
2019,Marzo,Francia,3,2,,5,POINT (125744111 -81703935)
2019,Marzo,Francia,3,19,,22,POINT (125862 -81702165)
2019,Marzo,Francia,79,140,,219,POINT (3451668 -76532004)
2019,Marzo,Francia,2850,3721,,6571,POINT (4697157 -74140516)
2019,Marzo,Francia,12,14,,26,POINT (4815189 -75736374)
2019,Marzo,Francia,213,389,,602,POINT (6170465 -7542726)
2019,Marzo,Francia,1,6,,7,POINT (7128047 -73181317)
2019,Marzo,Francia,0,3,,3,POINT (7819 -72453013)
2019,Marzo,Francia,2,11,,13,POINT (863337 -7735002)
2019,Marzo,Georgia,0,1,,1,POINT (10406342 -75527794)
2019,Marzo,Georgia,2,1,,3,POINT (10446304 -75516486)
2019,Marzo,Georgia,6,6,,12,POINT (4697157 -74140516)
2019,Marzo,Georgia,0,2,,2,POINT (9402597 -75681642)
2019,Marzo,Ghana,0,1,,1,POINT (0.81488 -77356)
2019,Marzo,Ghana,0,3,,3,POINT (10446304 -75516486)
2019,Marzo,Ghana,1,10,,11,POINT (4697157 -74140516)
2019,Marzo,Ghana,0,2,,2,POINT (6170465 -7542726)
2019,Marzo,Granada,1,0,,1,POINT (10446304 -75516486)
2019,Marzo,Granada,2,3,,5,POINT (4697157 -74140516)
2019,Marzo,Grecia,1,0,,1,POINT (-4214082 -69941431)
2019,Marzo,Grecia,2,2,,4,POINT (0.81488 -77356)
2019,Marzo,Grecia,0,2,,2,POINT (10406342 -75527794)
2019,Marzo,Grecia,6,26,,32,POINT (10446304 -75516486)
2019,Marzo,Grecia,0,1,,1,POINT (10886686 -74776479)
2019,Marzo,Grecia,0,3,,3,POINT (3451668 -76532004)
2019,Marzo,Grecia,34,76,,110,POINT (4697157 -74140516)
2019,Marzo,Grecia,0,16,,16,POINT (6170465 -7542726)
2019,Marzo,Grecia,0,2,,2,POINT (9402597 -75681642)
2019,Marzo,Guatemala,0,1,,1,POINT (0.33002 -76876446)
2019,Marzo,Guatemala,2,1,,3,POINT (0.81488 -77356)
2019,Marzo,Guatemala,4,2,,6,POINT (10406342 -75527794)
2019,Marzo,Guatemala,177,191,,368,POINT (10446304 -75516486)
2019,Marzo,Guatemala,38,30,,68,POINT (10886686 -74776479)
2019,Marzo,Guatemala,0,1,,1,POINT (11117206 -74232675)
2019,Marzo,Guatemala,0,2,,2,POINT (11360029 -72129595)
2019,Marzo,Guatemala,6,4,,10,POINT (125862 -81702165)
2019,Marzo,Guatemala,25,53,,78,POINT (3451668 -76532004)
2019,Marzo,Guatemala,1,0,,1,POINT (445285 -75766353)
2019,Marzo,Guatemala,411,729,,1140,POINT (4697157 -74140516)
2019,Marzo,Guatemala,6,7,,13,POINT (4815189 -75736374)
2019,Marzo,Guatemala,51,101,,152,POINT (6170465 -7542726)
2019,Marzo,Guatemala,1,2,,3,POINT (7128047 -73181317)
2019,Marzo,Guatemala,0,6,,6,POINT (7927233 -72508188)
2019,Marzo,Guyana,0,1,,1,POINT (0.81488 -77356)
2019,Marzo,Guyana,0,1,,1,POINT (10406342 -75527794)
2019,Marzo,Guyana,1,1,,2,POINT (10446304 -75516486)
2019,Marzo,Guyana,2,1,,3,POINT (10886686 -74776479)
2019,Marzo,Guyana,0,1,,1,POINT (125862 -81702165)
2019,Marzo,Guyana,3,2,,5,POINT (3451668 -76532004)
2019,Marzo,Guyana,17,15,,32,POINT (4697157 -74140516)
2019,Marzo,Guyana,4,1,,5,POINT (6170465 -7542726)
2019,Marzo,Guinea,0,1,,1,POINT (7819 -72453013)
2019,Marzo,Guinea Bissau,2,0,,2,POINT (4697157 -74140516)
2019,Marzo,Haití,1,7,,8,POINT (10446304 -75516486)
2019,Marzo,Haití,1,1,,2,POINT (3451668 -76532004)
2019,Marzo,Haití,11,21,,32,POINT (4697157 -74140516)
2019,Marzo,Haití,3,4,,7,POINT (6170465 -7542726)
2019,Marzo,Honduras,2,1,,3,POINT (0.81488 -77356)
2019,Marzo,Honduras,1,2,,3,POINT (10406342 -75527794)
2019,Marzo,Honduras,109,59,,168,POINT (10446304 -75516486)
2019,Marzo,Honduras,9,12,,21,POINT (10886686 -74776479)
2019,Marzo,Honduras,0,1,,1,POINT (10970933 -74765343)
2019,Marzo,Honduras,46,40,,86,POINT (3451668 -76532004)
2019,Marzo,Honduras,0,1,,1,POINT (445285 -75766353)
2019,Marzo,Honduras,242,328,,570,POINT (4697157 -74140516)
2019,Marzo,Honduras,5,5,,10,POINT (4815189 -75736374)
2019,Marzo,Honduras,45,79,,124,POINT (6170465 -7542726)
2019,Marzo,Honduras,2,2,,4,POINT (7128047 -73181317)
2019,Marzo,Honduras,0,2,,2,POINT (7819 -72453013)
2019,Marzo,Honduras,3,8,,11,POINT (7927233 -72508188)
2019,Marzo,Honduras,0,1,,1,POINT (863337 -7735002)
2019,Marzo,Hong Kong,1,1,,2,POINT (10446304 -75516486)
2019,Marzo,Hong Kong,1,0,,1,POINT (3451668 -76532004)
2019,Marzo,Hong Kong,23,14,,37,POINT (4697157 -74140516)
2019,Marzo,Hungría,0,1,,1,POINT (-4191162 -69941498)
2019,Marzo,Hungría,0,1,,1,POINT (-4214082 -69941431)
2019,Marzo,Hungría,0,1,,1,POINT (0.33002 -76876446)
2019,Marzo,Hungría,3,1,,4,POINT (0.81488 -77356)
2019,Marzo,Hungría,2,2,,4,POINT (10406342 -75527794)
2019,Marzo,Hungría,17,14,,31,POINT (10446304 -75516486)
2019,Marzo,Hungría,1,1,,2,POINT (10886686 -74776479)
2019,Marzo,Hungría,0,1,,1,POINT (11360029 -72129595)
2019,Marzo,Hungría,0,1,,1,POINT (3451668 -76532004)
2019,Marzo,Hungría,46,64,,110,POINT (4697157 -74140516)
2019,Marzo,Hungría,6,18,,24,POINT (6170465 -7542726)
2019,Marzo,Hungría,0,1,,1,POINT (7128047 -73181317)
2019,Marzo,India,1,0,,1,POINT (-4214082 -69941431)
2019,Marzo,India,10,4,,14,POINT (0.81488 -77356)
2019,Marzo,India,2,15,,17,POINT (10406342 -75527794)
2019,Marzo,India,22,66,,88,POINT (10446304 -75516486)
2019,Marzo,India,2,15,,17,POINT (10886686 -74776479)
2019,Marzo,India,0,3,,3,POINT (11247723 -74213989)
2019,Marzo,India,4,28,,32,POINT (3451668 -76532004)
2019,Marzo,India,0,2,,2,POINT (3884426 -77061029)
2019,Marzo,India,133,537,,670,POINT (4697157 -74140516)
2019,Marzo,India,1,0,,1,POINT (4815189 -75736374)
2019,Marzo,India,15,85,,100,POINT (6170465 -7542726)
2019,Marzo,India,0,5,,5,POINT (7128047 -73181317)
2019,Marzo,India,0,3,,3,POINT (9402597 -75681642)
2019,Marzo,Indonesia,0,1,,1,POINT (0.81488 -77356)
2019,Marzo,Indonesia,1,8,,9,POINT (10406342 -75527794)
2019,Marzo,Indonesia,5,2,,7,POINT (10446304 -75516486)
2019,Marzo,Indonesia,0,2,,2,POINT (10886686 -74776479)
2019,Marzo,Indonesia,0,2,,2,POINT (10970933 -74765343)
2019,Marzo,Indonesia,2,5,,7,POINT (3451668 -76532004)
2019,Marzo,Indonesia,18,32,,50,POINT (4697157 -74140516)
2019,Marzo,Indonesia,2,2,,4,POINT (6170465 -7542726)
2019,Marzo,Iraq,0,1,,1,POINT (10446304 -75516486)
2019,Marzo,Iraq,0,2,,2,POINT (4697157 -74140516)
2019,Marzo,Irán,10,20,,30,POINT (4697157 -74140516)
2019,Marzo,Irán,0,1,,1,POINT (6170465 -7542726)
2019,Marzo,República de Irlanda,2,0,,2,POINT (-4191162 -69941498)
2019,Marzo,República de Irlanda,9,10,,19,POINT (0.81488 -77356)
2019,Marzo,República de Irlanda,7,4,,11,POINT (10406342 -75527794)
2019,Marzo,República de Irlanda,20,39,,59,POINT (10446304 -75516486)
2019,Marzo,República de Irlanda,2,3,,5,POINT (10886686 -74776479)
2019,Marzo,República de Irlanda,1,0,,1,POINT (11360029 -72129595)
2019,Marzo,República de Irlanda,2,10,,12,POINT (3451668 -76532004)
2019,Marzo,República de Irlanda,132,214,,346,POINT (4697157 -74140516)
2019,Marzo,República de Irlanda,13,38,,51,POINT (6170465 -7542726)
2019,Marzo,República de Irlanda,0,1,,1,POINT (7128047 -73181317)
2019,Marzo,República de Irlanda,5,6,,11,POINT (863337 -7735002)
2019,Marzo,Islandia,0,1,,1,POINT (10406342 -75527794)
2019,Marzo,Islandia,1,3,,4,POINT (10446304 -75516486)
2019,Marzo,Islandia,0,2,,2,POINT (3451668 -76532004)
2019,Marzo,Islandia,15,22,,37,POINT (4697157 -74140516)
2019,Marzo,Islandia,1,4,,5,POINT (6170465 -7542726)
2019,Marzo,Islandia,1,1,,2,POINT (863337 -7735002)
2019,Marzo,Israel,1,5,,6,POINT (-4214082 -69941431)
2019,Marzo,Israel,13,33,,46,POINT (0.81488 -77356)
2019,Marzo,Israel,1,1,,2,POINT (10406342 -75527794)
2019,Marzo,Israel,21,53,,74,POINT (10446304 -75516486)
2019,Marzo,Israel,0,5,,5,POINT (10886686 -74776479)
2019,Marzo,Israel,3,0,,3,POINT (125862 -81702165)
2019,Marzo,Israel,18,48,,66,POINT (3451668 -76532004)
2019,Marzo,Israel,139,514,,653,POINT (4697157 -74140516)
2019,Marzo,Israel,2,5,,7,POINT (4815189 -75736374)
2019,Marzo,Israel,47,113,,160,POINT (6170465 -7542726)
2019,Marzo,Israel,0,1,,1,POINT (7819 -72453013)
2019,Marzo,Italia,0,2,,2,POINT (-4191162 -69941498)
2019,Marzo,Italia,2,7,,9,POINT (-4214082 -69941431)
2019,Marzo,Italia,2,2,,4,POINT (0.33002 -76876446)
2019,Marzo,Italia,15,34,,49,POINT (0.81488 -77356)
2019,Marzo,Italia,11,19,,30,POINT (10406342 -75527794)
2019,Marzo,Italia,105,216,,321,POINT (10446304 -75516486)
2019,Marzo,Italia,18,54,,72,POINT (10886686 -74776479)
2019,Marzo,Italia,0,1,,1,POINT (10970933 -74765343)
2019,Marzo,Italia,3,1,,4,POINT (11117206 -74232675)
2019,Marzo,Italia,0,1,,1,POINT (11247723 -74213989)
2019,Marzo,Italia,10,12,,22,POINT (11360029 -72129595)
2019,Marzo,Italia,1,0,,1,POINT (125744111 -81703935)
2019,Marzo,Italia,5,11,,16,POINT (125862 -81702165)
2019,Marzo,Italia,39,91,,130,POINT (3451668 -76532004)
2019,Marzo,Italia,0,3,,3,POINT (3884426 -77061029)
2019,Marzo,Italia,727,1914,,2641,POINT (4697157 -74140516)
2019,Marzo,Italia,0,8,,8,POINT (4815189 -75736374)
2019,Marzo,Italia,85,259,,344,POINT (6170465 -7542726)
2019,Marzo,Italia,4,3,,7,POINT (6185536 -67484028)
2019,Marzo,Italia,0,2,,2,POINT (7088729 -70740253)
2019,Marzo,Italia,7,16,,23,POINT (7819 -72453013)
2019,Marzo,Italia,1,5,,6,POINT (836068 -72409396)
2019,Marzo,Italia,1,4,,5,POINT (863337 -7735002)
2019,Marzo,Italia,1,2,,3,POINT (9402597 -75681642)
2019,Marzo,Jamaica,1,0,,1,POINT (10406342 -75527794)
2019,Marzo,Jamaica,9,9,,18,POINT (10446304 -75516486)
2019,Marzo,Jamaica,1,4,,5,POINT (10886686 -74776479)
2019,Marzo,Jamaica,0,2,,2,POINT (125862 -81702165)
2019,Marzo,Jamaica,9,3,,12,POINT (3451668 -76532004)
2019,Marzo,Jamaica,24,25,,49,POINT (4697157 -74140516)
2019,Marzo,Jamaica,3,12,,15,POINT (6170465 -7542726)
2019,Marzo,Japón,0,4,,4,POINT (-4191162 -69941498)
2019,Marzo,Japón,1,1,,2,POINT (-4214082 -69941431)
2019,Marzo,Japón,5,17,,22,POINT (0.81488 -77356)
2019,Marzo,Japón,0,2,,2,POINT (10406342 -75527794)
2019,Marzo,Japón,18,29,,47,POINT (10446304 -75516486)
2019,Marzo,Japón,2,9,,11,POINT (10886686 -74776479)
2019,Marzo,Japón,10,12,,22,POINT (3451668 -76532004)
2019,Marzo,Japón,189,468,,657,POINT (4697157 -74140516)
2019,Marzo,Japón,34,58,,92,POINT (6170465 -7542726)
2019,Marzo,Japón,0,2,,2,POINT (863337 -7735002)
2019,Marzo,Jordania,0,1,,1,POINT (10446304 -75516486)
2019,Marzo,Jordania,0,1,,1,POINT (3451668 -76532004)
2019,Marzo,Jordania,3,15,,18,POINT (4697157 -74140516)
2019,Marzo,Kazajistán,1,1,,2,POINT (10446304 -75516486)
2019,Marzo,Kazajistán,8,4,,12,POINT (4697157 -74140516)
2019,Marzo,Kazajistán,0,1,,1,POINT (6170465 -7542726)
2019,Marzo,Kenia,1,0,,1,POINT (10446304 -75516486)
2019,Marzo,Kenia,7,12,,19,POINT (4697157 -74140516)
2019,Marzo,Kenia,0,1,,1,POINT (6170465 -7542726)
2019,Marzo,Kirguistán,3,4,,7,POINT (4697157 -74140516)
2019,Marzo,Kuwait,0,1,,1,POINT (4697157 -74140516)
2019,Marzo,República de Kosovo,1,3,,4,POINT (4697157 -74140516)
2019,Marzo,Letonia,0,2,,2,POINT (0.81488 -77356)
2019,Marzo,Letonia,0,1,,1,POINT (10406342 -75527794)
2019,Marzo,Letonia,2,6,,8,POINT (10446304 -75516486)
2019,Marzo,Letonia,0,1,,1,POINT (10970933 -74765343)
2019,Marzo,Letonia,23,27,,50,POINT (4697157 -74140516)
2019,Marzo,Letonia,1,4,,5,POINT (6170465 -7542726)
2019,Marzo,Lituania,2,1,,3,POINT (0.81488 -77356)
2019,Marzo,Lituania,0,1,,1,POINT (10406342 -75527794)
2019,Marzo,Lituania,3,4,,7,POINT (10446304 -75516486)
2019,Marzo,Lituania,0,1,,1,POINT (10886686 -74776479)
2019,Marzo,Lituania,0,1,,1,POINT (10970933 -74765343)
2019,Marzo,Lituania,1,1,,2,POINT (3451668 -76532004)
2019,Marzo,Lituania,38,37,,75,POINT (4697157 -74140516)
2019,Marzo,Lituania,2,2,,4,POINT (6170465 -7542726)
2019,Marzo,Lituania,0,1,,1,POINT (863337 -7735002)
2019,Marzo,Lituania,0,1,,1,POINT (9402597 -75681642)
2019,Marzo,Líbano,1,0,,1,POINT (10446304 -75516486)
2019,Marzo,Líbano,0,2,,2,POINT (10886686 -74776479)
2019,Marzo,Líbano,2,1,,3,POINT (11360029 -72129595)
2019,Marzo,Líbano,0,1,,1,POINT (125862 -81702165)
2019,Marzo,Líbano,1,1,,2,POINT (3451668 -76532004)
2019,Marzo,Líbano,15,35,,50,POINT (4697157 -74140516)
2019,Marzo,Líbano,1,2,,3,POINT (6170465 -7542726)
2019,Marzo,Liberia,0,1,,1,POINT (10446304 -75516486)
2019,Marzo,Libia,0,2,,2,POINT (4697157 -74140516)
2019,Marzo,Liechtenstein,3,4,,7,POINT (4697157 -74140516)
2019,Marzo,Luxemburgo,0,1,,1,POINT (-4214082 -69941431)
2019,Marzo,Luxemburgo,2,0,,2,POINT (0.81488 -77356)
2019,Marzo,Luxemburgo,0,3,,3,POINT (10446304 -75516486)
2019,Marzo,Luxemburgo,2,0,,2,POINT (3451668 -76532004)
2019,Marzo,Luxemburgo,5,10,,15,POINT (4697157 -74140516)
2019,Marzo,Luxemburgo,0,1,,1,POINT (6170465 -7542726)
2019,Marzo,Macedonia,1,3,,4,POINT (10446304 -75516486)
2019,Marzo,Macedonia,3,7,,10,POINT (4697157 -74140516)
2019,Marzo,Malasia,3,4,,7,POINT (10446304 -75516486)
2019,Marzo,Malasia,1,0,,1,POINT (3451668 -76532004)
2019,Marzo,Malasia,11,17,,28,POINT (4697157 -74140516)
2019,Marzo,Malasia,0,1,,1,POINT (6170465 -7542726)
2019,Marzo,Malta,1,1,,2,POINT (0.81488 -77356)
2019,Marzo,Malta,4,8,,12,POINT (4697157 -74140516)
2019,Marzo,Marruecos,0,1,,1,POINT (0.81488 -77356)
2019,Marzo,Marruecos,4,1,,5,POINT (10446304 -75516486)
2019,Marzo,Marruecos,0,1,,1,POINT (10886686 -74776479)
2019,Marzo,Marruecos,19,29,,48,POINT (4697157 -74140516)
2019,Marzo,Marruecos,1,1,,2,POINT (4815189 -75736374)
2019,Marzo,Marruecos,1,2,,3,POINT (6170465 -7542726)
2019,Marzo,Islas Marshall,1,0,,1,POINT (6170465 -7542726)
2019,Marzo,Mauricio,0,1,,1,POINT (10446304 -75516486)
2019,Marzo,Mauricio,1,0,,1,POINT (4697157 -74140516)
2019,Marzo,México,0,2,,2,POINT (-4191162 -69941498)
2019,Marzo,México,1,3,,4,POINT (-4214082 -69941431)
2019,Marzo,México,0,4,,4,POINT (0.33002 -76876446)
2019,Marzo,México,15,22,,37,POINT (0.81488 -77356)
2019,Marzo,México,0,3,,3,POINT (1800143 -78802679)
2019,Marzo,México,36,26,,62,POINT (10406342 -75527794)
2019,Marzo,México,518,631,,1149,POINT (10446304 -75516486)
2019,Marzo,México,36,81,,117,POINT (10886686 -74776479)
2019,Marzo,México,4,3,,7,POINT (11360029 -72129595)
2019,Marzo,México,2,3,,5,POINT (125862 -81702165)
2019,Marzo,México,120,214,,334,POINT (3451668 -76532004)
2019,Marzo,México,2,4,,6,POINT (445285 -75766353)
2019,Marzo,México,4377,7692,,12069,POINT (4697157 -74140516)
2019,Marzo,México,21,28,,49,POINT (4815189 -75736374)
2019,Marzo,México,382,1093,,1475,POINT (6170465 -7542726)
2019,Marzo,México,0,1,,1,POINT (6222552 -77401154)
2019,Marzo,México,6,11,,17,POINT (7128047 -73181317)
2019,Marzo,México,3,11,,14,POINT (7819 -72453013)
2019,Marzo,México,1,1,,2,POINT (863337 -7735002)
2019,Marzo,República de Moldavia,4,4,,8,POINT (4697157 -74140516)
2019,Marzo,República de Moldavia,0,1,,1,POINT (6170465 -7542726)
2019,Marzo,Mónaco,0,1,,1,POINT (10446304 -75516486)
2019,Marzo,Mónaco,1,1,,2,POINT (4697157 -74140516)
2019,Marzo,Mongolia,3,1,,4,POINT (4697157 -74140516)
2019,Marzo,Montenegro,1,5,,6,POINT (4697157 -74140516)
2019,Marzo,Montenegro,1,0,,1,POINT (6170465 -7542726)
2019,Marzo,Mozambique,0,1,,1,POINT (4697157 -74140516)
2019,Marzo,Myanmar,0,5,,5,POINT (10406342 -75527794)
2019,Marzo,Myanmar,0,4,,4,POINT (10446304 -75516486)
2019,Marzo,Myanmar,0,5,,5,POINT (10886686 -74776479)
2019,Marzo,Myanmar,1,3,,4,POINT (10970933 -74765343)
2019,Marzo,Myanmar,3,5,,8,POINT (4697157 -74140516)
2019,Marzo,Namibia,1,0,,1,POINT (10970933 -74765343)
2019,Marzo,Nepal,0,6,,6,POINT (10446304 -75516486)
2019,Marzo,Nepal,0,4,,4,POINT (4697157 -74140516)
2019,Marzo,Nicaragua,0,2,,2,POINT (10406342 -75527794)
2019,Marzo,Nicaragua,51,33,,84,POINT (10446304 -75516486)
2019,Marzo,Nicaragua,7,6,,13,POINT (10886686 -74776479)
2019,Marzo,Nicaragua,3,1,,4,POINT (125862 -81702165)
2019,Marzo,Nicaragua,10,24,,34,POINT (3451668 -76532004)
2019,Marzo,Nicaragua,1,0,,1,POINT (445285 -75766353)
2019,Marzo,Nicaragua,91,121,,212,POINT (4697157 -74140516)
2019,Marzo,Nicaragua,2,6,,8,POINT (4815189 -75736374)
2019,Marzo,Nicaragua,33,36,,69,POINT (6170465 -7542726)
2019,Marzo,Nicaragua,2,3,,5,POINT (7128047 -73181317)
2019,Marzo,Nigeria,1,2,,3,POINT (10446304 -75516486)
2019,Marzo,Nigeria,0,1,,1,POINT (10886686 -74776479)
2019,Marzo,Nigeria,1,0,,1,POINT (3451668 -76532004)
2019,Marzo,Nigeria,5,9,,14,POINT (4697157 -74140516)
2019,Marzo,Nigeria,0,1,,1,POINT (6170465 -7542726)
2019,Marzo,Noruega,0,2,,2,POINT (-4191162 -69941498)
2019,Marzo,Noruega,2,7,,9,POINT (0.81488 -77356)
2019,Marzo,Noruega,1,3,,4,POINT (10406342 -75527794)
2019,Marzo,Noruega,8,28,,36,POINT (10446304 -75516486)
2019,Marzo,Noruega,3,3,,6,POINT (10886686 -74776479)
2019,Marzo,Noruega,1,0,,1,POINT (11247723 -74213989)
2019,Marzo,Noruega,0,1,,1,POINT (11360029 -72129595)
2019,Marzo,Noruega,1,1,,2,POINT (125744111 -81703935)
2019,Marzo,Noruega,8,18,,26,POINT (3451668 -76532004)
2019,Marzo,Noruega,94,151,,245,POINT (4697157 -74140516)
2019,Marzo,Noruega,0,1,,1,POINT (4815189 -75736374)
2019,Marzo,Noruega,7,20,,27,POINT (6170465 -7542726)
2019,Marzo,Nueva Zelanda,3,2,,5,POINT (-4191162 -69941498)
2019,Marzo,Nueva Zelanda,2,2,,4,POINT (-4214082 -69941431)
2019,Marzo,Nueva Zelanda,2,2,,4,POINT (0.81488 -77356)
2019,Marzo,Nueva Zelanda,2,2,,4,POINT (10406342 -75527794)
2019,Marzo,Nueva Zelanda,7,14,,21,POINT (10446304 -75516486)
2019,Marzo,Nueva Zelanda,1,1,,2,POINT (10886686 -74776479)
2019,Marzo,Nueva Zelanda,5,3,,8,POINT (11247723 -74213989)
2019,Marzo,Nueva Zelanda,0,1,,1,POINT (133387613 -81372937)
2019,Marzo,Nueva Zelanda,0,3,,3,POINT (3451668 -76532004)
2019,Marzo,Nueva Zelanda,45,98,,143,POINT (4697157 -74140516)
2019,Marzo,Nueva Zelanda,4,13,,17,POINT (6170465 -7542726)
2019,Marzo,Nueva Zelanda,0,1,,1,POINT (863337 -7735002)
2019,Marzo,Omán,0,4,,4,POINT (4697157 -74140516)
2019,Marzo,Países Bajos,3,5,,8,POINT (-4191162 -69941498)
2019,Marzo,Países Bajos,2,5,,7,POINT (-4214082 -69941431)
2019,Marzo,Países Bajos,23,25,,48,POINT (0.81488 -77356)
2019,Marzo,Países Bajos,19,26,,45,POINT (10406342 -75527794)
2019,Marzo,Países Bajos,299,306,,605,POINT (10446304 -75516486)
2019,Marzo,Países Bajos,13,27,,40,POINT (10886686 -74776479)
2019,Marzo,Países Bajos,1,13,,14,POINT (10970933 -74765343)
2019,Marzo,Países Bajos,0,1,,1,POINT (11117206 -74232675)
2019,Marzo,Países Bajos,3,4,,7,POINT (11247723 -74213989)
2019,Marzo,Países Bajos,1,0,,1,POINT (11360029 -72129595)
2019,Marzo,Países Bajos,0,2,,2,POINT (1152863 -72919186)
2019,Marzo,Países Bajos,2,3,,5,POINT (125744111 -81703935)
2019,Marzo,Países Bajos,1,0,,1,POINT (125862 -81702165)
2019,Marzo,Países Bajos,57,68,,125,POINT (3451668 -76532004)
2019,Marzo,Países Bajos,1690,2317,,4007,POINT (4697157 -74140516)
2019,Marzo,Países Bajos,1,6,,7,POINT (4815189 -75736374)
2019,Marzo,Países Bajos,116,195,,311,POINT (6170465 -7542726)
2019,Marzo,Países Bajos,0,1,,1,POINT (6218835 -75586989)
2019,Marzo,Países Bajos,11,13,,24,POINT (7128047 -73181317)
2019,Marzo,Países Bajos,0,1,,1,POINT (7819 -72453013)
2019,Marzo,Países Bajos,8,5,,13,POINT (863337 -7735002)
2019,Marzo,Pakistán,0,1,,1,POINT (0.81488 -77356)
2019,Marzo,Pakistán,2,6,,8,POINT (10446304 -75516486)
2019,Marzo,Pakistán,0,2,,2,POINT (3451668 -76532004)
2019,Marzo,Pakistán,3,23,,26,POINT (4697157 -74140516)
2019,Marzo,Pakistán,0,1,,1,POINT (6170465 -7542726)
2019,Marzo,Panamá,2,3,,5,POINT (0.81488 -77356)
2019,Marzo,Panamá,0,1,,1,POINT (1800143 -78802679)
2019,Marzo,Panamá,2,13,,15,POINT (10406342 -75527794)
2019,Marzo,Panamá,643,582,,1225,POINT (10446304 -75516486)
2019,Marzo,Panamá,107,107,,214,POINT (10886686 -74776479)
2019,Marzo,Panamá,2,1,,3,POINT (11360029 -72129595)
2019,Marzo,Panamá,0,1,,1,POINT (125744111 -81703935)
2019,Marzo,Panamá,56,55,,111,POINT (125862 -81702165)
2019,Marzo,Panamá,430,440,,870,POINT (3451668 -76532004)
2019,Marzo,Panamá,2427,2295,,4722,POINT (4697157 -74140516)
2019,Marzo,Panamá,62,63,,125,POINT (4815189 -75736374)
2019,Marzo,Panamá,2211,1875,,4086,POINT (6170465 -7542726)
2019,Marzo,Panamá,0,2,,2,POINT (6222552 -77401154)
2019,Marzo,Panamá,0,1,,1,POINT (7088729 -70740253)
2019,Marzo,Panamá,5,2,,7,POINT (7102626 -77762647)
2019,Marzo,Panamá,16,11,,27,POINT (7128047 -73181317)
2019,Marzo,Panamá,1,0,,1,POINT (7819 -72453013)
2019,Marzo,Panamá,1,2,,3,POINT (863337 -7735002)
2019,Marzo,Paraguay,1,0,,1,POINT (0.81488 -77356)
2019,Marzo,Paraguay,3,1,,4,POINT (10406342 -75527794)
2019,Marzo,Paraguay,88,65,,153,POINT (10446304 -75516486)
2019,Marzo,Paraguay,1,5,,6,POINT (10886686 -74776479)
2019,Marzo,Paraguay,45,35,,80,POINT (125862 -81702165)
2019,Marzo,Paraguay,5,6,,11,POINT (3451668 -76532004)
2019,Marzo,Paraguay,159,132,,291,POINT (4697157 -74140516)
2019,Marzo,Paraguay,19,21,,40,POINT (6170465 -7542726)
2019,Marzo,Paraguay,2,2,,4,POINT (7819 -72453013)
2019,Marzo,Perú,12,10,,22,POINT (-4191162 -69941498)
2019,Marzo,Perú,38,71,,109,POINT (-4214082 -69941431)
2019,Marzo,Perú,4,6,,10,POINT (0.185957 -7478366)
2019,Marzo,Perú,0,11,,11,POINT (0.33002 -76876446)
2019,Marzo,Perú,105,236,,341,POINT (0.81488 -77356)
2019,Marzo,Perú,67,43,,110,POINT (10406342 -75527794)
2019,Marzo,Perú,1146,741,,1887,POINT (10446304 -75516486)
2019,Marzo,Perú,8,34,,42,POINT (10886686 -74776479)
2019,Marzo,Perú,0,1,,1,POINT (11117206 -74232675)
2019,Marzo,Perú,6,13,,19,POINT (11360029 -72129595)
2019,Marzo,Perú,395,271,,666,POINT (125862 -81702165)
2019,Marzo,Perú,275,323,,598,POINT (3451668 -76532004)
2019,Marzo,Perú,0,2,,2,POINT (445285 -75766353)
2019,Marzo,Perú,3631,4268,,7899,POINT (4697157 -74140516)
2019,Marzo,Perú,5,12,,17,POINT (4815189 -75736374)
2019,Marzo,Perú,755,961,,1716,POINT (6170465 -7542726)
2019,Marzo,Perú,0,1,,1,POINT (6185536 -67484028)
2019,Marzo,Perú,1,1,,2,POINT (7128047 -73181317)
2019,Marzo,Perú,69,90,,159,POINT (7819 -72453013)
2019,Marzo,Perú,3,4,,7,POINT (836068 -72409396)
2019,Marzo,Palestina,0,1,,1,POINT (10886686 -74776479)
2019,Marzo,Palestina,3,0,,3,POINT (4697157 -74140516)
2019,Marzo,Polonia,1,2,,3,POINT (-4214082 -69941431)
2019,Marzo,Polonia,12,11,,23,POINT (0.81488 -77356)
2019,Marzo,Polonia,17,24,,41,POINT (10406342 -75527794)
2019,Marzo,Polonia,29,30,,59,POINT (10446304 -75516486)
2019,Marzo,Polonia,1,1,,2,POINT (10886686 -74776479)
2019,Marzo,Polonia,1,0,,1,POINT (11247723 -74213989)
2019,Marzo,Polonia,1,4,,5,POINT (125862 -81702165)
2019,Marzo,Polonia,4,3,,7,POINT (3451668 -76532004)
2019,Marzo,Polonia,259,338,,597,POINT (4697157 -74140516)
2019,Marzo,Polonia,2,1,,3,POINT (4815189 -75736374)
2019,Marzo,Polonia,19,24,,43,POINT (6170465 -7542726)
2019,Marzo,Polonia,1,0,,1,POINT (863337 -7735002)
2019,Marzo,Portugal,0,1,,1,POINT (-4191162 -69941498)
2019,Marzo,Portugal,1,4,,5,POINT (-4214082 -69941431)
2019,Marzo,Portugal,0,1,,1,POINT (0.812436 -77847006)
2019,Marzo,Portugal,7,9,,16,POINT (0.81488 -77356)
2019,Marzo,Portugal,2,5,,7,POINT (10406342 -75527794)
2019,Marzo,Portugal,24,23,,47,POINT (10446304 -75516486)
2019,Marzo,Portugal,4,3,,7,POINT (10886686 -74776479)
2019,Marzo,Portugal,0,2,,2,POINT (11360029 -72129595)
2019,Marzo,Portugal,0,1,,1,POINT (125862 -81702165)
2019,Marzo,Portugal,0,4,,4,POINT (133387613 -81372937)
2019,Marzo,Portugal,4,16,,20,POINT (3451668 -76532004)
2019,Marzo,Portugal,213,478,,691,POINT (4697157 -74140516)
2019,Marzo,Portugal,2,2,,4,POINT (4815189 -75736374)
2019,Marzo,Portugal,14,44,,58,POINT (6170465 -7542726)
2019,Marzo,Portugal,1,0,,1,POINT (7088729 -70740253)
2019,Marzo,Portugal,6,15,,21,POINT (7819 -72453013)
2019,Marzo,Qatar,0,2,,2,POINT (4697157 -74140516)
2019,Marzo,Qatar,0,1,,1,POINT (6170465 -7542726)
2019,Marzo,Reino Unido de Gran Bretaña e Irlanda del Norte,2,1,,3,POINT (-4191162 -69941498)
2019,Marzo,Reino Unido de Gran Bretaña e Irlanda del Norte,9,9,,18,POINT (-4214082 -69941431)
2019,Marzo,Reino Unido de Gran Bretaña e Irlanda del Norte,0,1,,1,POINT (0.33002 -76876446)
2019,Marzo,Reino Unido de Gran Bretaña e Irlanda del Norte,47,59,,106,POINT (0.81488 -77356)
2019,Marzo,Reino Unido de Gran Bretaña e Irlanda del Norte,21,37,,58,POINT (10406342 -75527794)
2019,Marzo,Reino Unido de Gran Bretaña e Irlanda del Norte,144,219,,363,POINT (10446304 -75516486)
2019,Marzo,Reino Unido de Gran Bretaña e Irlanda del Norte,12,23,,35,POINT (10886686 -74776479)
2019,Marzo,Reino Unido de Gran Bretaña e Irlanda del Norte,0,1,,1,POINT (11117206 -74232675)
2019,Marzo,Reino Unido de Gran Bretaña e Irlanda del Norte,1,5,,6,POINT (11247723 -74213989)
2019,Marzo,Reino Unido de Gran Bretaña e Irlanda del Norte,0,2,,2,POINT (11360029 -72129595)
2019,Marzo,Reino Unido de Gran Bretaña e Irlanda del Norte,20,20,,40,POINT (125744111 -81703935)
2019,Marzo,Reino Unido de Gran Bretaña e Irlanda del Norte,0,1,,1,POINT (125862 -81702165)
2019,Marzo,Reino Unido de Gran Bretaña e Irlanda del Norte,0,1,,1,POINT (133387613 -81372937)
2019,Marzo,Reino Unido de Gran Bretaña e Irlanda del Norte,30,56,,86,POINT (3451668 -76532004)
2019,Marzo,Reino Unido de Gran Bretaña e Irlanda del Norte,1,0,,1,POINT (445285 -75766353)
2019,Marzo,Reino Unido de Gran Bretaña e Irlanda del Norte,1282,2205,,3487,POINT (4697157 -74140516)
2019,Marzo,Reino Unido de Gran Bretaña e Irlanda del Norte,6,4,,10,POINT (4815189 -75736374)
2019,Marzo,Reino Unido de Gran Bretaña e Irlanda del Norte,111,278,,389,POINT (6170465 -7542726)
2019,Marzo,Reino Unido de Gran Bretaña e Irlanda del Norte,1,2,,3,POINT (7128047 -73181317)
2019,Marzo,Reino Unido de Gran Bretaña e Irlanda del Norte,17,22,,39,POINT (863337 -7735002)
2019,Marzo,Reino Unido de Gran Bretaña e Irlanda del Norte,0,1,,1,POINT (9402597 -75681642)
2019,Marzo,República Dominicana,7,14,,21,POINT (0.81488 -77356)
2019,Marzo,República Dominicana,2,0,,2,POINT (10406342 -75527794)
2019,Marzo,República Dominicana,61,74,,135,POINT (10446304 -75516486)
2019,Marzo,República Dominicana,13,38,,51,POINT (10886686 -74776479)
2019,Marzo,República Dominicana,1,0,,1,POINT (11117206 -74232675)
2019,Marzo,República Dominicana,1,6,,7,POINT (11360029 -72129595)
2019,Marzo,República Dominicana,0,1,,1,POINT (12165168 -71983761)
2019,Marzo,República Dominicana,3,2,,5,POINT (125862 -81702165)
2019,Marzo,República Dominicana,39,68,,107,POINT (3451668 -76532004)
2019,Marzo,República Dominicana,1,0,,1,POINT (445285 -75766353)
2019,Marzo,República Dominicana,797,1081,,1878,POINT (4697157 -74140516)
2019,Marzo,República Dominicana,8,6,,14,POINT (4815189 -75736374)
2019,Marzo,República Dominicana,132,215,,347,POINT (6170465 -7542726)
2019,Marzo,República Dominicana,5,2,,7,POINT (7128047 -73181317)
2019,Marzo,República Dominicana,2,2,,4,POINT (7819 -72453013)
2019,Marzo,Rumania,0,1,,1,POINT (-4191162 -69941498)
2019,Marzo,Rumania,1,0,,1,POINT (-4214082 -69941431)
2019,Marzo,Rumania,1,2,,3,POINT (0.81488 -77356)
2019,Marzo,Rumania,2,4,,6,POINT (10406342 -75527794)
2019,Marzo,Rumania,7,20,,27,POINT (10446304 -75516486)
2019,Marzo,Rumania,1,2,,3,POINT (10886686 -74776479)
2019,Marzo,Rumania,0,1,,1,POINT (11360029 -72129595)
2019,Marzo,Rumania,1,1,,2,POINT (125862 -81702165)
2019,Marzo,Rumania,4,3,,7,POINT (3451668 -76532004)
2019,Marzo,Rumania,104,86,,190,POINT (4697157 -74140516)
2019,Marzo,Rumania,11,13,,24,POINT (6170465 -7542726)
2019,Marzo,Rumania,0,1,,1,POINT (7088729 -70740253)
2019,Marzo,Rumania,2,0,,2,POINT (7819 -72453013)
2019,Marzo,Federación de Rusia,1,0,,1,POINT (-4191162 -69941498)
2019,Marzo,Federación de Rusia,8,12,,20,POINT (0.81488 -77356)
2019,Marzo,Federación de Rusia,3,7,,10,POINT (10406342 -75527794)
2019,Marzo,Federación de Rusia,29,36,,65,POINT (10446304 -75516486)
2019,Marzo,Federación de Rusia,1,3,,4,POINT (10886686 -74776479)
2019,Marzo,Federación de Rusia,0,2,,2,POINT (10970933 -74765343)
2019,Marzo,Federación de Rusia,6,3,,9,POINT (3451668 -76532004)
2019,Marzo,Federación de Rusia,178,214,,392,POINT (4697157 -74140516)
2019,Marzo,Federación de Rusia,1,0,,1,POINT (4815189 -75736374)
2019,Marzo,Federación de Rusia,20,16,,36,POINT (6170465 -7542726)
2019,Marzo,Federación de Rusia,1,12,,13,POINT (9402597 -75681642)
2019,Marzo,Rwanda,1,0,,1,POINT (3451668 -76532004)
2019,Marzo,San Cristóbal y Nevis,2,0,,2,POINT (10446304 -75516486)
2019,Marzo,San Cristóbal y Nevis,1,2,,3,POINT (4697157 -74140516)
2019,Marzo,San Marino,1,1,,2,POINT (4697157 -74140516)
2019,Marzo,San Marino,0,1,,1,POINT (6170465 -7542726)
2019,Marzo,San  Vicente y las Granadinas,1,0,,1,POINT (3451668 -76532004)
2019,Marzo,San  Vicente y las Granadinas,2,2,,4,POINT (4697157 -74140516)
2019,Marzo,Santa Lucia,0,1,,1,POINT (10446304 -75516486)
2019,Marzo,Santa Lucia,1,0,,1,POINT (10886686 -74776479)
2019,Marzo,Santa Lucia,1,1,,2,POINT (3451668 -76532004)
2019,Marzo,Santa Lucia,2,2,,4,POINT (4697157 -74140516)
2019,Marzo,Santa Lucia,0,1,,1,POINT (6170465 -7542726)
2019,Marzo,Senegal,0,1,,1,POINT (10446304 -75516486)
2019,Marzo,Senegal,2,0,,2,POINT (4697157 -74140516)
2019,Marzo,Serbia,10,7,,17,POINT (10446304 -75516486)
2019,Marzo,Serbia,0,3,,3,POINT (3451668 -76532004)
2019,Marzo,Serbia,23,39,,62,POINT (4697157 -74140516)
2019,Marzo,Serbia,2,9,,11,POINT (6170465 -7542726)
2019,Marzo,Sierra Leona,0,1,,1,POINT (4697157 -74140516)
2019,Marzo,Singapur,0,1,,1,POINT (10406342 -75527794)
2019,Marzo,Singapur,7,8,,15,POINT (10446304 -75516486)
2019,Marzo,Singapur,0,1,,1,POINT (10886686 -74776479)
2019,Marzo,Singapur,1,1,,2,POINT (3451668 -76532004)
2019,Marzo,Singapur,34,40,,74,POINT (4697157 -74140516)
2019,Marzo,Singapur,1,1,,2,POINT (4815189 -75736374)
2019,Marzo,Singapur,3,6,,9,POINT (6170465 -7542726)
2019,Marzo,República Árabe Siria,0,1,,1,POINT (3451668 -76532004)
2019,Marzo,República Árabe Siria,1,4,,5,POINT (4697157 -74140516)
2019,Marzo,Sri Lanka,0,1,,1,POINT (10406342 -75527794)
2019,Marzo,Sri Lanka,0,1,,1,POINT (10446304 -75516486)
2019,Marzo,Sri Lanka,0,1,,1,POINT (3451668 -76532004)
2019,Marzo,Sri Lanka,1,8,,9,POINT (4697157 -74140516)
2019,Marzo,Sudáfrica,0,7,,7,POINT (10406342 -75527794)
2019,Marzo,Sudáfrica,3,4,,7,POINT (10446304 -75516486)
2019,Marzo,Sudáfrica,2,3,,5,POINT (10886686 -74776479)
2019,Marzo,Sudáfrica,0,1,,1,POINT (133387613 -81372937)
2019,Marzo,Sudáfrica,1,1,,2,POINT (3451668 -76532004)
2019,Marzo,Sudáfrica,18,40,,58,POINT (4697157 -74140516)
2019,Marzo,Sudáfrica,1,5,,6,POINT (6170465 -7542726)
2019,Marzo,Sudáfrica,1,1,,2,POINT (863337 -7735002)
2019,Marzo,Sudán,0,1,,1,POINT (3451668 -76532004)
2019,Marzo,Sudán,0,1,,1,POINT (4697157 -74140516)
2019,Marzo,Suecia,1,0,,1,POINT (-4191162 -69941498)
2019,Marzo,Suecia,0,1,,1,POINT (-4214082 -69941431)
2019,Marzo,Suecia,0,1,,1,POINT (0.33002 -76876446)
2019,Marzo,Suecia,11,15,,26,POINT (0.81488 -77356)
2019,Marzo,Suecia,15,10,,25,POINT (10406342 -75527794)
2019,Marzo,Suecia,32,55,,87,POINT (10446304 -75516486)
2019,Marzo,Suecia,6,5,,11,POINT (10886686 -74776479)
2019,Marzo,Suecia,1,4,,5,POINT (11247723 -74213989)
2019,Marzo,Suecia,1,1,,2,POINT (125744111 -81703935)
2019,Marzo,Suecia,0,2,,2,POINT (133387613 -81372937)
2019,Marzo,Suecia,8,13,,21,POINT (3451668 -76532004)
2019,Marzo,Suecia,181,280,,461,POINT (4697157 -74140516)
2019,Marzo,Suecia,0,1,,1,POINT (4815189 -75736374)
2019,Marzo,Suecia,27,52,,79,POINT (6170465 -7542726)
2019,Marzo,Suecia,1,0,,1,POINT (7128047 -73181317)
2019,Marzo,Suecia,1,2,,3,POINT (836068 -72409396)
2019,Marzo,Suecia,3,3,,6,POINT (863337 -7735002)
2019,Marzo,Suiza,1,3,,4,POINT (-4191162 -69941498)
2019,Marzo,Suiza,3,4,,7,POINT (-4214082 -69941431)
2019,Marzo,Suiza,1,1,,2,POINT (0.33002 -76876446)
2019,Marzo,Suiza,22,34,,56,POINT (0.81488 -77356)
2019,Marzo,Suiza,19,17,,36,POINT (10406342 -75527794)
2019,Marzo,Suiza,39,51,,90,POINT (10446304 -75516486)
2019,Marzo,Suiza,3,11,,14,POINT (10886686 -74776479)
2019,Marzo,Suiza,0,1,,1,POINT (11247723 -74213989)
2019,Marzo,Suiza,1,3,,4,POINT (125862 -81702165)
2019,Marzo,Suiza,9,41,,50,POINT (3451668 -76532004)
2019,Marzo,Suiza,2,0,,2,POINT (445285 -75766353)
2019,Marzo,Suiza,519,679,,1198,POINT (4697157 -74140516)
2019,Marzo,Suiza,1,1,,2,POINT (4815189 -75736374)
2019,Marzo,Suiza,61,111,,172,POINT (6170465 -7542726)
2019,Marzo,Suiza,0,2,,2,POINT (7128047 -73181317)
2019,Marzo,Suiza,1,1,,2,POINT (7819 -72453013)
2019,Marzo,Suiza,3,3,,6,POINT (863337 -7735002)
2019,Marzo,Suiza,1,0,,1,POINT (9402597 -75681642)
2019,Marzo,Surinam,0,2,,2,POINT (10406342 -75527794)
2019,Marzo,Surinam,13,25,,38,POINT (4697157 -74140516)
2019,Marzo,Surinam,3,0,,3,POINT (7128047 -73181317)
2019,Marzo,Taiwán,2,1,,3,POINT (4697157 -74140516)
2019,Marzo,Tailandia,0,2,,2,POINT (10406342 -75527794)
2019,Marzo,Tailandia,1,1,,2,POINT (10446304 -75516486)
2019,Marzo,Tailandia,1,0,,1,POINT (3451668 -76532004)
2019,Marzo,Tailandia,25,24,,49,POINT (4697157 -74140516)
2019,Marzo,Tailandia,0,1,,1,POINT (4815189 -75736374)
2019,Marzo,Tailandia,1,0,,1,POINT (6170465 -7542726)
2019,Marzo,Tanzania,1,1,,2,POINT (10446304 -75516486)
2019,Marzo,Togo,0,1,,1,POINT (4697157 -74140516)
2019,Marzo,Trinidad y Tobago,1,1,,2,POINT (0.81488 -77356)
2019,Marzo,Trinidad y Tobago,8,7,,15,POINT (10446304 -75516486)
2019,Marzo,Trinidad y Tobago,2,3,,5,POINT (10886686 -74776479)
2019,Marzo,Trinidad y Tobago,0,1,,1,POINT (125862 -81702165)
2019,Marzo,Trinidad y Tobago,6,10,,16,POINT (3451668 -76532004)
2019,Marzo,Trinidad y Tobago,26,41,,67,POINT (4697157 -74140516)
2019,Marzo,Trinidad y Tobago,1,1,,2,POINT (4815189 -75736374)
2019,Marzo,Trinidad y Tobago,2,12,,14,POINT (6170465 -7542726)
2019,Marzo,Trinidad y Tobago,0,1,,1,POINT (7128047 -73181317)
2019,Marzo,Túnez,2,1,,3,POINT (10446304 -75516486)
2019,Marzo,Túnez,9,12,,21,POINT (4697157 -74140516)
2019,Marzo,Turquía,1,1,,2,POINT (0.33002 -76876446)
2019,Marzo,Turquía,1,2,,3,POINT (0.81488 -77356)
2019,Marzo,Turquía,0,2,,2,POINT (10406342 -75527794)
2019,Marzo,Turquía,24,14,,38,POINT (10446304 -75516486)
2019,Marzo,Turquía,1,5,,6,POINT (10886686 -74776479)
2019,Marzo,Turquía,1,2,,3,POINT (3451668 -76532004)
2019,Marzo,Turquía,156,398,,554,POINT (4697157 -74140516)
2019,Marzo,Turquía,8,21,,29,POINT (6170465 -7542726)
2019,Marzo,Turquía,0,1,,1,POINT (863337 -7735002)
2019,Marzo,Ucrania,1,1,,2,POINT (0.81488 -77356)
2019,Marzo,Ucrania,1,8,,9,POINT (10406342 -75527794)
2019,Marzo,Ucrania,2,10,,12,POINT (10446304 -75516486)
2019,Marzo,Ucrania,0,4,,4,POINT (10886686 -74776479)
2019,Marzo,Ucrania,0,5,,5,POINT (10970933 -74765343)
2019,Marzo,Ucrania,0,1,,1,POINT (11247723 -74213989)
2019,Marzo,Ucrania,3,0,,3,POINT (3451668 -76532004)
2019,Marzo,Ucrania,31,24,,55,POINT (4697157 -74140516)
2019,Marzo,Ucrania,5,3,,8,POINT (6170465 -7542726)
2019,Marzo,Ucrania,0,3,,3,POINT (9402597 -75681642)
2019,Marzo,Uganda,0,1,,1,POINT (0.81488 -77356)
2019,Marzo,Uganda,0,1,,1,POINT (3451668 -76532004)
2019,Marzo,Uganda,3,3,,6,POINT (4697157 -74140516)
2019,Marzo,Uruguay,1,0,,1,POINT (-4214082 -69941431)
2019,Marzo,Uruguay,2,0,,2,POINT (0.33002 -76876446)
2019,Marzo,Uruguay,9,20,,29,POINT (0.81488 -77356)
2019,Marzo,Uruguay,11,12,,23,POINT (10406342 -75527794)
2019,Marzo,Uruguay,125,92,,217,POINT (10446304 -75516486)
2019,Marzo,Uruguay,2,10,,12,POINT (10886686 -74776479)
2019,Marzo,Uruguay,0,1,,1,POINT (11117206 -74232675)
2019,Marzo,Uruguay,1,2,,3,POINT (11360029 -72129595)
2019,Marzo,Uruguay,39,23,,62,POINT (125862 -81702165)
2019,Marzo,Uruguay,15,39,,54,POINT (3451668 -76532004)
2019,Marzo,Uruguay,207,380,,587,POINT (4697157 -74140516)
2019,Marzo,Uruguay,0,1,,1,POINT (4815189 -75736374)
2019,Marzo,Uruguay,70,105,,175,POINT (6170465 -7542726)
2019,Marzo,Uruguay,3,2,,5,POINT (7819 -72453013)
2019,Marzo,Uruguay,0,1,,1,POINT (863337 -7735002)
2019,Marzo,Uzbekistán,2,0,,2,POINT (4697157 -74140516)
2019,Marzo,Venezuela,2,2,,4,POINT (-4191162 -69941498)
2019,Marzo,Venezuela,4,4,,8,POINT (-4214082 -69941431)
2019,Marzo,Venezuela,58,64,,122,POINT (0.33002 -76876446)
2019,Marzo,Venezuela,1,1,,2,POINT (0.812436 -77847006)
2019,Marzo,Venezuela,3262,3451,,6713,POINT (0.81488 -77356)
2019,Marzo,Venezuela,0,16,,16,POINT (1800143 -78802679)
2019,Marzo,Venezuela,19,35,,54,POINT (10406342 -75527794)
2019,Marzo,Venezuela,251,336,,587,POINT (10446304 -75516486)
2019,Marzo,Venezuela,250,388,,638,POINT (10886686 -74776479)
2019,Marzo,Venezuela,0,7,,7,POINT (10970933 -74765343)
2019,Marzo,Venezuela,40,95,,135,POINT (11117206 -74232675)
2019,Marzo,Venezuela,0,6,,6,POINT (11247723 -74213989)
2019,Marzo,Venezuela,6165,5155,,11320,POINT (11360029 -72129595)
2019,Marzo,Venezuela,0,2,,2,POINT (12165168 -71983761)
2019,Marzo,Venezuela,5,7,,12,POINT (125862 -81702165)
2019,Marzo,Venezuela,217,250,,467,POINT (3451668 -76532004)
2019,Marzo,Venezuela,6,7,,13,POINT (3866713 -67927521)
2019,Marzo,Venezuela,1,2,,3,POINT (445285 -75766353)
2019,Marzo,Venezuela,7513,7329,,14842,POINT (4697157 -74140516)
2019,Marzo,Venezuela,6,17,,23,POINT (4815189 -75736374)
2019,Marzo,Venezuela,934,1173,,2107,POINT (6170465 -7542726)
2019,Marzo,Venezuela,27,31,,58,POINT (6185536 -67484028)
2019,Marzo,Venezuela,2,1,,3,POINT (6218835 -75586989)
2019,Marzo,Venezuela,349,311,,660,POINT (7088729 -70740253)
2019,Marzo,Venezuela,13,15,,28,POINT (7128047 -73181317)
2019,Marzo,Venezuela,19031,16212,,35243,POINT (7819 -72453013)
2019,Marzo,Venezuela,12,42,,54,POINT (7927233 -72508188)
2019,Marzo,Venezuela,1152,955,,2107,POINT (836068 -72409396)
2019,Marzo,Vietnam,2,1,,3,POINT (10446304 -75516486)
2019,Marzo,Vietnam,1,0,,1,POINT (3451668 -76532004)
2019,Marzo,Vietnam,13,4,,17,POINT (4697157 -74140516)
2019,Marzo,República Árabe de Yemen,0,2,,2,POINT (4697157 -74140516)
2019,Marzo,Zambia,0,1,,1,POINT (3451668 -76532004)
2019,Marzo,Zambia,1,0,,1,POINT (4697157 -74140516)
2019,Marzo,Zambia,0,1,,1,POINT (6170465 -7542726)
2019,Marzo,Zimbabue,2,0,,2,POINT (10446304 -75516486)
2019,Marzo,Zimbabue,4,4,,8,POINT (4697157 -74140516)
2019,Marzo,Refugiado,0,1,,1,POINT (10446304 -75516486)
2019,Marzo,Refugiado,1,0,,1,POINT (3451668 -76532004)
2019,Marzo,Refugiado,4,6,,10,POINT (4697157 -74140516)
2019,Marzo,Refugiado,1,0,,1,POINT (6170465 -7542726)
2019,Marzo,Desconocido,1,0,,1,POINT (0.33002 -76876446)
2019,Marzo,Desconocido,1,4,,5,POINT (10446304 -75516486)
2019,Marzo,Desconocido,1,0,,1,POINT (10886686 -74776479)
2019,Marzo,Desconocido,0,2,,2,POINT (3451668 -76532004)
2019,Marzo,Desconocido,90,147,,237,POINT (4697157 -74140516)
2019,Marzo,Desconocido,0,3,,3,POINT (6170465 -7542726)
2019,Marzo,Desconocido,0,1,,1,POINT (7819 -72453013)
2019,Abril,Albania,1,2,,3,POINT (10446304 -75516486)
2019,Abril,Albania,1,0,,1,POINT (10886686 -74776479)
2019,Abril,Albania,0,1,,1,POINT (3451668 -76532004)
2019,Abril,Albania,3,4,,7,POINT (4697157 -74140516)
2019,Abril,Alemania,9,5,,14,POINT (-4191162 -69941498)
2019,Abril,Alemania,31,25,,56,POINT (-4214082 -69941431)
2019,Abril,Alemania,4,9,,13,POINT (0.33002 -76876446)
2019,Abril,Alemania,87,79,,166,POINT (0.81488 -77356)
2019,Abril,Alemania,40,35,,75,POINT (10406342 -75527794)
2019,Abril,Alemania,152,214,,366,POINT (10446304 -75516486)
2019,Abril,Alemania,13,26,,39,POINT (10886686 -74776479)
2019,Abril,Alemania,1,0,,1,POINT (11117206 -74232675)
2019,Abril,Alemania,2,3,,5,POINT (11247723 -74213989)
2019,Abril,Alemania,3,4,,7,POINT (11360029 -72129595)
2019,Abril,Alemania,6,6,,12,POINT (125862 -81702165)
2019,Abril,Alemania,1,3,,4,POINT (133387613 -81372937)
2019,Abril,Alemania,64,78,,142,POINT (3451668 -76532004)
2019,Abril,Alemania,2180,3069,,5249,POINT (4697157 -74140516)
2019,Abril,Alemania,2,5,,7,POINT (4815189 -75736374)
2019,Abril,Alemania,179,253,,432,POINT (6170465 -7542726)
2019,Abril,Alemania,1,0,,1,POINT (7128047 -73181317)
2019,Abril,Alemania,4,8,,12,POINT (7819 -72453013)
2019,Abril,Alemania,0,1,,1,POINT (806667 -767333)
2019,Abril,Alemania,2,2,,4,POINT (836068 -72409396)
2019,Abril,Alemania,18,16,,34,POINT (863337 -7735002)
2019,Abril,Andorra,10,14,,24,POINT (4697157 -74140516)
2019,Abril,Andorra,0,1,,1,POINT (6170465 -7542726)
2019,Abril,Angola,0,1,,1,POINT (4697157 -74140516)
2019,Abril,Angola,0,1,,1,POINT (6170465 -7542726)
2019,Abril,Antigua y Barbuda,1,1,,2,POINT (10446304 -75516486)
2019,Abril,Antigua y Barbuda,2,2,,4,POINT (4697157 -74140516)
2019,Abril,Antigua y Barbuda,0,1,,1,POINT (4815189 -75736374)
2019,Abril,Arabia Saudita,0,1,,1,POINT (10446304 -75516486)
2019,Abril,Arabia Saudita,0,4,,4,POINT (4697157 -74140516)
2019,Abril,Argelia,0,1,,1,POINT (3451668 -76532004)
2019,Abril,Argelia,2,3,,5,POINT (4697157 -74140516)
2019,Abril,Argelia,0,1,,1,POINT (6170465 -7542726)
2019,Abril,Argentina,4,5,,9,POINT (-4191162 -69941498)
2019,Abril,Argentina,2,7,,9,POINT (-4214082 -69941431)
2019,Abril,Argentina,9,14,,23,POINT (0.33002 -76876446)
2019,Abril,Argentina,91,134,,225,POINT (0.81488 -77356)
2019,Abril,Argentina,316,210,,526,POINT (10406342 -75527794)
2019,Abril,Argentina,2055,1585,,3640,POINT (10446304 -75516486)
2019,Abril,Argentina,7,21,,28,POINT (10886686 -74776479)
2019,Abril,Argentina,1,0,,1,POINT (11117206 -74232675)
2019,Abril,Argentina,1,2,,3,POINT (11360029 -72129595)
2019,Abril,Argentina,167,121,,288,POINT (125862 -81702165)
2019,Abril,Argentina,131,211,,342,POINT (3451668 -76532004)
2019,Abril,Argentina,0,1,,1,POINT (445285 -75766353)
2019,Abril,Argentina,4687,5798,,10485,POINT (4697157 -74140516)
2019,Abril,Argentina,2,5,,7,POINT (4815189 -75736374)
2019,Abril,Argentina,200,353,,553,POINT (6170465 -7542726)
2019,Abril,Argentina,1,0,,1,POINT (7128047 -73181317)
2019,Abril,Argentina,1,6,,7,POINT (7819 -72453013)
2019,Abril,Argentina,2,1,,3,POINT (836068 -72409396)
2019,Abril,Argentina,3,5,,8,POINT (863337 -7735002)
2019,Abril,República de Armenia,0,1,,1,POINT (10446304 -75516486)
2019,Abril,República de Armenia,2,2,,4,POINT (4697157 -74140516)
2019,Abril,Aruba,1,0,,1,POINT (4697157 -74140516)
2019,Abril,Australia,0,1,,1,POINT (-4191162 -69941498)
2019,Abril,Australia,5,2,,7,POINT (-4214082 -69941431)
2019,Abril,Australia,2,2,,4,POINT (0.33002 -76876446)
2019,Abril,Australia,16,15,,31,POINT (0.81488 -77356)
2019,Abril,Australia,12,16,,28,POINT (10406342 -75527794)
2019,Abril,Australia,48,57,,105,POINT (10446304 -75516486)
2019,Abril,Australia,7,13,,20,POINT (10886686 -74776479)
2019,Abril,Australia,1,5,,6,POINT (11247723 -74213989)
2019,Abril,Australia,24,32,,56,POINT (3451668 -76532004)
2019,Abril,Australia,344,549,,893,POINT (4697157 -74140516)
2019,Abril,Australia,1,4,,5,POINT (4815189 -75736374)
2019,Abril,Australia,56,119,,175,POINT (6170465 -7542726)
2019,Abril,Australia,0,1,,1,POINT (7128047 -73181317)
2019,Abril,Australia,0,1,,1,POINT (7819 -72453013)
2019,Abril,Australia,16,20,,36,POINT (863337 -7735002)
2019,Abril,Austria,3,5,,8,POINT (-4214082 -69941431)
2019,Abril,Austria,1,2,,3,POINT (0.33002 -76876446)
2019,Abril,Austria,14,8,,22,POINT (0.81488 -77356)
2019,Abril,Austria,3,5,,8,POINT (10406342 -75527794)
2019,Abril,Austria,17,14,,31,POINT (10446304 -75516486)
2019,Abril,Austria,4,3,,7,POINT (10886686 -74776479)
2019,Abril,Austria,0,2,,2,POINT (125862 -81702165)
2019,Abril,Austria,2,12,,14,POINT (3451668 -76532004)
2019,Abril,Austria,195,260,,455,POINT (4697157 -74140516)
2019,Abril,Austria,0,1,,1,POINT (4815189 -75736374)
2019,Abril,Austria,12,18,,30,POINT (6170465 -7542726)
2019,Abril,Austria,0,2,,2,POINT (863337 -7735002)
2019,Abril,Azerbaiyán,0,3,,3,POINT (10446304 -75516486)
2019,Abril,Azerbaiyán,1,3,,4,POINT (4697157 -74140516)
2019,Abril,Azerbaiyán,0,1,,1,POINT (6170465 -7542726)
2019,Abril,Bahamas,6,3,,9,POINT (10446304 -75516486)
2019,Abril,Bahamas,0,1,,1,POINT (10886686 -74776479)
2019,Abril,Bahamas,1,3,,4,POINT (3451668 -76532004)
2019,Abril,Bahamas,9,13,,22,POINT (4697157 -74140516)
2019,Abril,Bahamas,0,4,,4,POINT (6170465 -7542726)
2019,Abril,Bahamas,0,1,,1,POINT (7819 -72453013)
2019,Abril,Bahréin,0,1,,1,POINT (4697157 -74140516)
2019,Abril,Bangladesh,1,0,,1,POINT (10446304 -75516486)
2019,Abril,Bangladesh,0,1,,1,POINT (3884426 -77061029)
2019,Abril,Bangladesh,0,3,,3,POINT (4697157 -74140516)
2019,Abril,Bangladesh,0,2,,2,POINT (9402597 -75681642)
2019,Abril,Barbados,5,1,,6,POINT (10446304 -75516486)
2019,Abril,Barbados,0,1,,1,POINT (3451668 -76532004)
2019,Abril,Barbados,9,15,,24,POINT (4697157 -74140516)
2019,Abril,Barbados,1,4,,5,POINT (6170465 -7542726)
2019,Abril,República de Belarús,0,1,,1,POINT (10446304 -75516486)
2019,Abril,República de Belarús,1,8,,9,POINT (4697157 -74140516)
2019,Abril,República de Belarús,0,1,,1,POINT (6170465 -7542726)
2019,Abril,República de Belarús,0,2,,2,POINT (7819 -72453013)
2019,Abril,Bélgica,2,2,,4,POINT (-4191162 -69941498)
2019,Abril,Bélgica,3,2,,5,POINT (-4214082 -69941431)
2019,Abril,Bélgica,2,0,,2,POINT (0.33002 -76876446)
2019,Abril,Bélgica,7,11,,18,POINT (0.81488 -77356)
2019,Abril,Bélgica,0,3,,3,POINT (10406342 -75527794)
2019,Abril,Bélgica,41,48,,89,POINT (10446304 -75516486)
2019,Abril,Bélgica,5,9,,14,POINT (10886686 -74776479)
2019,Abril,Bélgica,1,0,,1,POINT (10970933 -74765343)
2019,Abril,Bélgica,0,1,,1,POINT (11360029 -72129595)
2019,Abril,Bélgica,0,3,,3,POINT (125862 -81702165)
2019,Abril,Bélgica,10,19,,29,POINT (3451668 -76532004)
2019,Abril,Bélgica,0,4,,4,POINT (3884426 -77061029)
2019,Abril,Bélgica,275,440,,715,POINT (4697157 -74140516)
2019,Abril,Bélgica,24,50,,74,POINT (6170465 -7542726)
2019,Abril,Bélgica,1,0,,1,POINT (7128047 -73181317)
2019,Abril,Bélgica,6,6,,12,POINT (863337 -7735002)
2019,Abril,Belice,0,1,,1,POINT (10446304 -75516486)
2019,Abril,Belice,1,1,,2,POINT (125862 -81702165)
2019,Abril,Belice,3,1,,4,POINT (3451668 -76532004)
2019,Abril,Belice,8,10,,18,POINT (4697157 -74140516)
2019,Abril,Belice,2,7,,9,POINT (6170465 -7542726)
2019,Abril,Benín,1,0,,1,POINT (10886686 -74776479)
2019,Abril,Bermudas/Territorio Británico de Ultramar,1,0,,1,POINT (10446304 -75516486)
2019,Abril,Bermudas/Territorio Británico de Ultramar,0,1,,1,POINT (10886686 -74776479)
2019,Abril,Bermudas/Territorio Británico de Ultramar,0,1,,1,POINT (4697157 -74140516)
2019,Abril,Bermudas/Territorio Británico de Ultramar,1,4,,5,POINT (6170465 -7542726)
2019,Abril,Bolivia,1,3,,4,POINT (-4191162 -69941498)
2019,Abril,Bolivia,0,2,,2,POINT (-4214082 -69941431)
2019,Abril,Bolivia,13,7,,20,POINT (0.81488 -77356)
2019,Abril,Bolivia,23,15,,38,POINT (10406342 -75527794)
2019,Abril,Bolivia,137,112,,249,POINT (10446304 -75516486)
2019,Abril,Bolivia,3,8,,11,POINT (10886686 -74776479)
2019,Abril,Bolivia,3,1,,4,POINT (11360029 -72129595)
2019,Abril,Bolivia,13,11,,24,POINT (125862 -81702165)
2019,Abril,Bolivia,18,16,,34,POINT (3451668 -76532004)
2019,Abril,Bolivia,508,616,,1124,POINT (4697157 -74140516)
2019,Abril,Bolivia,1,0,,1,POINT (4815189 -75736374)
2019,Abril,Bolivia,17,31,,48,POINT (6170465 -7542726)
2019,Abril,Bolivia,0,1,,1,POINT (7819 -72453013)
2019,Abril,Bolivia,1,0,,1,POINT (836068 -72409396)
2019,Abril,Bolivia,0,1,,1,POINT (863337 -7735002)
2019,Abril,Bosnia y Herzegovina,0,1,,1,POINT (10406342 -75527794)
2019,Abril,Bosnia y Herzegovina,7,5,,12,POINT (4697157 -74140516)
2019,Abril,Bosnia y Herzegovina,0,2,,2,POINT (6170465 -7542726)
2019,Abril,Botsuana,0,1,,1,POINT (4697157 -74140516)
2019,Abril,Brasil,97,111,,208,POINT (-4191162 -69941498)
2019,Abril,Brasil,6,6,,12,POINT (-4214082 -69941431)
2019,Abril,Brasil,0,4,,4,POINT (0.33002 -76876446)
2019,Abril,Brasil,23,36,,59,POINT (0.81488 -77356)
2019,Abril,Brasil,301,183,,484,POINT (10406342 -75527794)
2019,Abril,Brasil,824,598,,1422,POINT (10446304 -75516486)
2019,Abril,Brasil,14,25,,39,POINT (10886686 -74776479)
2019,Abril,Brasil,2,3,,5,POINT (11360029 -72129595)
2019,Abril,Brasil,330,260,,590,POINT (125862 -81702165)
2019,Abril,Brasil,105,156,,261,POINT (3451668 -76532004)
2019,Abril,Brasil,4130,5004,,9134,POINT (4697157 -74140516)
2019,Abril,Brasil,2,8,,10,POINT (4815189 -75736374)
2019,Abril,Brasil,138,235,,373,POINT (6170465 -7542726)
2019,Abril,Brasil,2,1,,3,POINT (6185536 -67484028)
2019,Abril,Brasil,1,1,,2,POINT (7088729 -70740253)
2019,Abril,Brasil,1,3,,4,POINT (7128047 -73181317)
2019,Abril,Brasil,0,5,,5,POINT (7819 -72453013)
2019,Abril,Brasil,2,3,,5,POINT (836068 -72409396)
2019,Abril,Brasil,1,1,,2,POINT (863337 -7735002)
2019,Abril,Bulgaria,1,0,,1,POINT (-4214082 -69941431)
2019,Abril,Bulgaria,0,1,,1,POINT (0.81488 -77356)
2019,Abril,Bulgaria,4,2,,6,POINT (10446304 -75516486)
2019,Abril,Bulgaria,0,1,,1,POINT (10886686 -74776479)
2019,Abril,Bulgaria,1,3,,4,POINT (3451668 -76532004)
2019,Abril,Bulgaria,40,33,,73,POINT (4697157 -74140516)
2019,Abril,Bulgaria,1,0,,1,POINT (4815189 -75736374)
2019,Abril,Bulgaria,6,13,,19,POINT (6170465 -7542726)
2019,Abril,Islas Caimán/Territorio Británico de Ultramar,0,1,,1,POINT (10886686 -74776479)
2019,Abril,Islas Caimán/Territorio Británico de Ultramar,1,0,,1,POINT (3451668 -76532004)
2019,Abril,Islas Caimán/Territorio Británico de Ultramar,0,1,,1,POINT (4697157 -74140516)
2019,Abril,Islas Caimán/Territorio Británico de Ultramar,0,1,,1,POINT (6170465 -7542726)
2019,Abril,Camboya,2,1,,3,POINT (4697157 -74140516)
2019,Abril,Camerún,1,0,,1,POINT (10446304 -75516486)
2019,Abril,Camerún,0,3,,3,POINT (4697157 -74140516)
2019,Abril,Canadá,5,3,,8,POINT (-4191162 -69941498)
2019,Abril,Canadá,1,4,,5,POINT (-4214082 -69941431)
2019,Abril,Canadá,0,2,,2,POINT (0.33002 -76876446)
2019,Abril,Canadá,20,12,,32,POINT (0.81488 -77356)
2019,Abril,Canadá,53,45,,98,POINT (10406342 -75527794)
2019,Abril,Canadá,471,579,,1050,POINT (10446304 -75516486)
2019,Abril,Canadá,30,48,,78,POINT (10886686 -74776479)
2019,Abril,Canadá,1,0,,1,POINT (11360029 -72129595)
2019,Abril,Canadá,3,5,,8,POINT (125744111 -81703935)
2019,Abril,Canadá,2,2,,4,POINT (125862 -81702165)
2019,Abril,Canadá,2,4,,6,POINT (133387613 -81372937)
2019,Abril,Canadá,73,92,,165,POINT (3451668 -76532004)
2019,Abril,Canadá,2,1,,3,POINT (445285 -75766353)
2019,Abril,Canadá,1238,1984,,3222,POINT (4697157 -74140516)
2019,Abril,Canadá,7,6,,13,POINT (4815189 -75736374)
2019,Abril,Canadá,212,599,,811,POINT (6170465 -7542726)
2019,Abril,Canadá,3,6,,9,POINT (7128047 -73181317)
2019,Abril,Canadá,1,0,,1,POINT (7819 -72453013)
2019,Abril,Canadá,13,8,,21,POINT (863337 -7735002)
2019,Abril,República Del Congo,0,1,,1,POINT (4697157 -74140516)
2019,Abril,República Democrática del Congo,1,2,,3,POINT (4697157 -74140516)
2019,Abril,República de Corea,1,0,,1,POINT (-4191162 -69941498)
2019,Abril,República de Corea,2,0,,2,POINT (-4214082 -69941431)
2019,Abril,República de Corea,11,14,,25,POINT (0.81488 -77356)
2019,Abril,República de Corea,0,1,,1,POINT (10406342 -75527794)
2019,Abril,República de Corea,5,6,,11,POINT (10446304 -75516486)
2019,Abril,República de Corea,0,3,,3,POINT (10886686 -74776479)
2019,Abril,República de Corea,6,21,,27,POINT (3451668 -76532004)
2019,Abril,República de Corea,255,464,,719,POINT (4697157 -74140516)
2019,Abril,República de Corea,14,36,,50,POINT (6170465 -7542726)
2019,Abril,República de Corea,0,1,,1,POINT (7128047 -73181317)
2019,Abril,República de Corea,1,1,,2,POINT (7819 -72453013)
2019,Abril,República de Corea,1,0,,1,POINT (863337 -7735002)
2019,Abril,Costa de Marfil,1,0,,1,POINT (10446304 -75516486)
2019,Abril,Costa de Marfil,1,2,,3,POINT (4697157 -74140516)
2019,Abril,Costa de Marfil,0,2,,2,POINT (6170465 -7542726)
2019,Abril,Costa Rica,1,0,,1,POINT (-4191162 -69941498)
2019,Abril,Costa Rica,0,1,,1,POINT (0.33002 -76876446)
2019,Abril,Costa Rica,2,4,,6,POINT (0.81488 -77356)
2019,Abril,Costa Rica,8,7,,15,POINT (10406342 -75527794)
2019,Abril,Costa Rica,356,248,,604,POINT (10446304 -75516486)
2019,Abril,Costa Rica,42,32,,74,POINT (10886686 -74776479)
2019,Abril,Costa Rica,0,4,,4,POINT (11117206 -74232675)
2019,Abril,Costa Rica,1,1,,2,POINT (11360029 -72129595)
2019,Abril,Costa Rica,1,0,,1,POINT (125744111 -81703935)
2019,Abril,Costa Rica,90,81,,171,POINT (125862 -81702165)
2019,Abril,Costa Rica,41,68,,109,POINT (3451668 -76532004)
2019,Abril,Costa Rica,1351,1518,,2869,POINT (4697157 -74140516)
2019,Abril,Costa Rica,11,22,,33,POINT (4815189 -75736374)
2019,Abril,Costa Rica,234,225,,459,POINT (6170465 -7542726)
2019,Abril,Costa Rica,0,4,,4,POINT (7128047 -73181317)
2019,Abril,Croacia,0,1,,1,POINT (10406342 -75527794)
2019,Abril,Croacia,3,6,,9,POINT (10446304 -75516486)
2019,Abril,Croacia,1,3,,4,POINT (3451668 -76532004)
2019,Abril,Croacia,14,48,,62,POINT (4697157 -74140516)
2019,Abril,Croacia,6,11,,17,POINT (6170465 -7542726)
2019,Abril,Croacia,0,1,,1,POINT (9402597 -75681642)
2019,Abril,Cuba,2,0,,2,POINT (-4191162 -69941498)
2019,Abril,Cuba,1,2,,3,POINT (0.81488 -77356)
2019,Abril,Cuba,12,22,,34,POINT (10446304 -75516486)
2019,Abril,Cuba,14,28,,42,POINT (10886686 -74776479)
2019,Abril,Cuba,0,2,,2,POINT (11360029 -72129595)
2019,Abril,Cuba,13,22,,35,POINT (3451668 -76532004)
2019,Abril,Cuba,0,1,,1,POINT (445285 -75766353)
2019,Abril,Cuba,155,283,,438,POINT (4697157 -74140516)
2019,Abril,Cuba,2,1,,3,POINT (4815189 -75736374)
2019,Abril,Cuba,22,25,,47,POINT (6170465 -7542726)
2019,Abril,Cuba,1,3,,4,POINT (7128047 -73181317)
2019,Abril,Cuba,0,1,,1,POINT (7819 -72453013)
2019,Abril,República Checa,1,1,,2,POINT (-4214082 -69941431)
2019,Abril,República Checa,1,1,,2,POINT (0.33002 -76876446)
2019,Abril,República Checa,1,4,,5,POINT (0.81488 -77356)
2019,Abril,República Checa,0,1,,1,POINT (10406342 -75527794)
2019,Abril,República Checa,7,11,,18,POINT (10446304 -75516486)
2019,Abril,República Checa,1,1,,2,POINT (10886686 -74776479)
2019,Abril,República Checa,2,1,,3,POINT (3451668 -76532004)
2019,Abril,República Checa,96,153,,249,POINT (4697157 -74140516)
2019,Abril,República Checa,5,3,,8,POINT (6170465 -7542726)
2019,Abril,República Checa,4,7,,11,POINT (863337 -7735002)
2019,Abril,Chile,0,5,,5,POINT (-4214082 -69941431)
2019,Abril,Chile,2,2,,4,POINT (0.33002 -76876446)
2019,Abril,Chile,36,51,,87,POINT (0.81488 -77356)
2019,Abril,Chile,141,97,,238,POINT (10406342 -75527794)
2019,Abril,Chile,415,299,,714,POINT (10446304 -75516486)
2019,Abril,Chile,11,22,,33,POINT (10886686 -74776479)
2019,Abril,Chile,4,8,,12,POINT (11360029 -72129595)
2019,Abril,Chile,198,150,,348,POINT (125862 -81702165)
2019,Abril,Chile,84,148,,232,POINT (3451668 -76532004)
2019,Abril,Chile,1,0,,1,POINT (445285 -75766353)
2019,Abril,Chile,3519,4631,,8150,POINT (4697157 -74140516)
2019,Abril,Chile,7,7,,14,POINT (4815189 -75736374)
2019,Abril,Chile,66,177,,243,POINT (6170465 -7542726)
2019,Abril,Chile,0,2,,2,POINT (7128047 -73181317)
2019,Abril,Chile,9,25,,34,POINT (7819 -72453013)
2019,Abril,Chile,0,7,,7,POINT (836068 -72409396)
2019,Abril,China,2,1,,3,POINT (-4191162 -69941498)
2019,Abril,China,8,5,,13,POINT (0.81488 -77356)
2019,Abril,China,0,5,,5,POINT (10406342 -75527794)
2019,Abril,China,16,27,,43,POINT (10446304 -75516486)
2019,Abril,China,5,15,,20,POINT (10886686 -74776479)
2019,Abril,China,0,1,,1,POINT (10970933 -74765343)
2019,Abril,China,0,3,,3,POINT (11247723 -74213989)
2019,Abril,China,1,0,,1,POINT (11360029 -72129595)
2019,Abril,China,23,25,,48,POINT (3451668 -76532004)
2019,Abril,China,0,1,,1,POINT (3884426 -77061029)
2019,Abril,China,347,959,,1306,POINT (4697157 -74140516)
2019,Abril,China,4,1,,5,POINT (4815189 -75736374)
2019,Abril,China,55,105,,160,POINT (6170465 -7542726)
2019,Abril,China,1,1,,2,POINT (6185536 -67484028)
2019,Abril,China,1,1,,2,POINT (7128047 -73181317)
2019,Abril,China,2,3,,5,POINT (7819 -72453013)
2019,Abril,China,0,2,,2,POINT (9402597 -75681642)
2019,Abril,Taiwán,0,1,,1,POINT (-4191162 -69941498)
2019,Abril,Taiwán,3,1,,4,POINT (0.81488 -77356)
2019,Abril,Taiwán,4,2,,6,POINT (10446304 -75516486)
2019,Abril,Taiwán,2,5,,7,POINT (10886686 -74776479)
2019,Abril,Taiwán,0,1,,1,POINT (10970933 -74765343)
2019,Abril,Taiwán,0,2,,2,POINT (3451668 -76532004)
2019,Abril,Taiwán,51,59,,110,POINT (4697157 -74140516)
2019,Abril,Taiwán,6,15,,21,POINT (6170465 -7542726)
2019,Abril,Chipre,1,0,,1,POINT (0.81488 -77356)
2019,Abril,Chipre,1,1,,2,POINT (10446304 -75516486)
2019,Abril,Chipre,0,1,,1,POINT (3451668 -76532004)
2019,Abril,Chipre,7,6,,13,POINT (4697157 -74140516)
2019,Abril,Dinamarca,0,2,,2,POINT (-4191162 -69941498)
2019,Abril,Dinamarca,0,2,,2,POINT (0.33002 -76876446)
2019,Abril,Dinamarca,6,8,,14,POINT (0.81488 -77356)
2019,Abril,Dinamarca,4,5,,9,POINT (10406342 -75527794)
2019,Abril,Dinamarca,14,25,,39,POINT (10446304 -75516486)
2019,Abril,Dinamarca,0,2,,2,POINT (10886686 -74776479)
2019,Abril,Dinamarca,5,8,,13,POINT (3451668 -76532004)
2019,Abril,Dinamarca,100,165,,265,POINT (4697157 -74140516)
2019,Abril,Dinamarca,2,2,,4,POINT (4815189 -75736374)
2019,Abril,Dinamarca,15,30,,45,POINT (6170465 -7542726)
2019,Abril,Dinamarca,1,0,,1,POINT (863337 -7735002)
2019,Abril,Dominica,0,1,,1,POINT (10446304 -75516486)
2019,Abril,Dominica,0,1,,1,POINT (3451668 -76532004)
2019,Abril,Dominica,2,3,,5,POINT (4697157 -74140516)
2019,Abril,Dominica,1,1,,2,POINT (6170465 -7542726)
2019,Abril,Ecuador,0,3,,3,POINT (-4214082 -69941431)
2019,Abril,Ecuador,0,1,,1,POINT (0.185957 -7478366)
2019,Abril,Ecuador,81,293,,374,POINT (0.33002 -76876446)
2019,Abril,Ecuador,10,11,,21,POINT (0.812436 -77847006)
2019,Abril,Ecuador,1336,2142,,3478,POINT (0.81488 -77356)
2019,Abril,Ecuador,18,26,,44,POINT (1800143 -78802679)
2019,Abril,Ecuador,7,24,,31,POINT (10406342 -75527794)
2019,Abril,Ecuador,49,50,,99,POINT (10446304 -75516486)
2019,Abril,Ecuador,8,9,,17,POINT (10886686 -74776479)
2019,Abril,Ecuador,11,7,,18,POINT (11360029 -72129595)
2019,Abril,Ecuador,34,23,,57,POINT (125862 -81702165)
2019,Abril,Ecuador,449,487,,936,POINT (3451668 -76532004)
2019,Abril,Ecuador,1,2,,3,POINT (3866713 -67927521)
2019,Abril,Ecuador,0,2,,2,POINT (445285 -75766353)
2019,Abril,Ecuador,2755,3421,,6176,POINT (4697157 -74140516)
2019,Abril,Ecuador,3,4,,7,POINT (4815189 -75736374)
2019,Abril,Ecuador,51,86,,137,POINT (6170465 -7542726)
2019,Abril,Ecuador,1,0,,1,POINT (7088729 -70740253)
2019,Abril,Ecuador,2,3,,5,POINT (7128047 -73181317)
2019,Abril,Ecuador,48,59,,107,POINT (7819 -72453013)
2019,Abril,Ecuador,0,1,,1,POINT (836068 -72409396)
2019,Abril,Ecuador,0,1,,1,POINT (863337 -7735002)
2019,Abril,Egipto,2,2,,4,POINT (10446304 -75516486)
2019,Abril,Egipto,0,1,,1,POINT (11360029 -72129595)
2019,Abril,Egipto,7,23,,30,POINT (4697157 -74140516)
2019,Abril,Egipto,0,1,,1,POINT (6170465 -7542726)
2019,Abril,Egipto,0,1,,1,POINT (7819 -72453013)
2019,Abril,El Salvador,2,0,,2,POINT (-4214082 -69941431)
2019,Abril,El Salvador,1,2,,3,POINT (0.81488 -77356)
2019,Abril,El Salvador,0,1,,1,POINT (10406342 -75527794)
2019,Abril,El Salvador,152,125,,277,POINT (10446304 -75516486)
2019,Abril,El Salvador,6,3,,9,POINT (10886686 -74776479)
2019,Abril,El Salvador,4,3,,7,POINT (125862 -81702165)
2019,Abril,El Salvador,97,123,,220,POINT (3451668 -76532004)
2019,Abril,El Salvador,679,694,,1373,POINT (4697157 -74140516)
2019,Abril,El Salvador,126,193,,319,POINT (6170465 -7542726)
2019,Abril,Emiratos Árabes,0,2,,2,POINT (10446304 -75516486)
2019,Abril,Emiratos Árabes,8,20,,28,POINT (4697157 -74140516)
2019,Abril,Emiratos Árabes,0,1,,1,POINT (6170465 -7542726)
2019,Abril,España,3,9,,12,POINT (-4191162 -69941498)
2019,Abril,España,11,15,,26,POINT (-4214082 -69941431)
2019,Abril,España,4,4,,8,POINT (0.33002 -76876446)
2019,Abril,España,0,1,,1,POINT (0.812436 -77847006)
2019,Abril,España,42,50,,92,POINT (0.81488 -77356)
2019,Abril,España,14,31,,45,POINT (10406342 -75527794)
2019,Abril,España,114,194,,308,POINT (10446304 -75516486)
2019,Abril,España,24,52,,76,POINT (10886686 -74776479)
2019,Abril,España,2,0,,2,POINT (11117206 -74232675)
2019,Abril,España,0,1,,1,POINT (11247723 -74213989)
2019,Abril,España,9,13,,22,POINT (11360029 -72129595)
2019,Abril,España,0,1,,1,POINT (125744111 -81703935)
2019,Abril,España,7,4,,11,POINT (125862 -81702165)
2019,Abril,España,182,317,,499,POINT (3451668 -76532004)
2019,Abril,España,3637,5879,,9516,POINT (4697157 -74140516)
2019,Abril,España,5,11,,16,POINT (4815189 -75736374)
2019,Abril,España,352,688,,1040,POINT (6170465 -7542726)
2019,Abril,España,1,4,,5,POINT (7088729 -70740253)
2019,Abril,España,7,4,,11,POINT (7128047 -73181317)
2019,Abril,España,16,39,,55,POINT (7819 -72453013)
2019,Abril,España,0,1,,1,POINT (7927233 -72508188)
2019,Abril,España,5,6,,11,POINT (836068 -72409396)
2019,Abril,España,2,2,,4,POINT (863337 -7735002)
2019,Abril,Eslovaquia,1,1,,2,POINT (0.33002 -76876446)
2019,Abril,Eslovaquia,2,1,,3,POINT (0.81488 -77356)
2019,Abril,Eslovaquia,2,2,,4,POINT (10446304 -75516486)
2019,Abril,Eslovaquia,1,2,,3,POINT (10886686 -74776479)
2019,Abril,Eslovaquia,1,0,,1,POINT (3451668 -76532004)
2019,Abril,Eslovaquia,59,72,,131,POINT (4697157 -74140516)
2019,Abril,Eslovaquia,5,8,,13,POINT (6170465 -7542726)
2019,Abril,Eslovaquia,0,1,,1,POINT (863337 -7735002)
2019,Abril,Eslovenia,1,2,,3,POINT (0.81488 -77356)
2019,Abril,Eslovenia,0,2,,2,POINT (10406342 -75527794)
2019,Abril,Eslovenia,0,1,,1,POINT (10446304 -75516486)
2019,Abril,Eslovenia,1,1,,2,POINT (3451668 -76532004)
2019,Abril,Eslovenia,15,48,,63,POINT (4697157 -74140516)
2019,Abril,Eslovenia,1,3,,4,POINT (6170465 -7542726)
2019,Abril,Eslovenia,1,0,,1,POINT (836068 -72409396)
2019,Abril,Estados Unidos de América,4,9,,13,POINT (-4191162 -69941498)
2019,Abril,Estados Unidos de América,18,21,,39,POINT (-4214082 -69941431)
2019,Abril,Estados Unidos de América,2,3,,5,POINT (0.33002 -76876446)
2019,Abril,Estados Unidos de América,39,72,,111,POINT (0.81488 -77356)
2019,Abril,Estados Unidos de América,77,101,,178,POINT (10406342 -75527794)
2019,Abril,Estados Unidos de América,3,10,,13,POINT (10433609 -73247863)
2019,Abril,Estados Unidos de América,4848,6619,,11467,POINT (10446304 -75516486)
2019,Abril,Estados Unidos de América,593,989,,1582,POINT (10886686 -74776479)
2019,Abril,Estados Unidos de América,7,14,,21,POINT (11117206 -74232675)
2019,Abril,Estados Unidos de América,1,6,,7,POINT (11247723 -74213989)
2019,Abril,Estados Unidos de América,8,18,,26,POINT (11360029 -72129595)
2019,Abril,Estados Unidos de América,5,10,,15,POINT (125744111 -81703935)
2019,Abril,Estados Unidos de América,21,31,,52,POINT (125862 -81702165)
2019,Abril,Estados Unidos de América,4,14,,18,POINT (133387613 -81372937)
2019,Abril,Estados Unidos de América,1414,1832,,3246,POINT (3451668 -76532004)
2019,Abril,Estados Unidos de América,89,157,,246,POINT (445285 -75766353)
2019,Abril,Estados Unidos de América,8662,14789,,23451,POINT (4697157 -74140516)
2019,Abril,Estados Unidos de América,154,308,,462,POINT (4815189 -75736374)
2019,Abril,Estados Unidos de América,2838,6927,,9765,POINT (6170465 -7542726)
2019,Abril,Estados Unidos de América,1,0,,1,POINT (7102626 -77762647)
2019,Abril,Estados Unidos de América,32,38,,70,POINT (7128047 -73181317)
2019,Abril,Estados Unidos de América,13,24,,37,POINT (7819 -72453013)
2019,Abril,Estados Unidos de América,20,55,,75,POINT (7927233 -72508188)
2019,Abril,Estados Unidos de América,1,2,,3,POINT (836068 -72409396)
2019,Abril,Estados Unidos de América,4,4,,8,POINT (863337 -7735002)
2019,Abril,Estados Unidos de América,0,1,,1,POINT (9402597 -75681642)
2019,Abril,Estonia,0,1,,1,POINT (-4214082 -69941431)
2019,Abril,Estonia,3,0,,3,POINT (0.81488 -77356)
2019,Abril,Estonia,2,0,,2,POINT (10446304 -75516486)
2019,Abril,Estonia,3,2,,5,POINT (3451668 -76532004)
2019,Abril,Estonia,7,12,,19,POINT (4697157 -74140516)
2019,Abril,Estonia,2,9,,11,POINT (6170465 -7542726)
2019,Abril,Etiopia,0,1,,1,POINT (10446304 -75516486)
2019,Abril,Etiopia,2,50,,52,POINT (4697157 -74140516)
2019,Abril,Etiopia,0,2,,2,POINT (6170465 -7542726)
2019,Abril,Filipinas,1,0,,1,POINT (0.33002 -76876446)
2019,Abril,Filipinas,1,0,,1,POINT (0.81488 -77356)
2019,Abril,Filipinas,1,60,,61,POINT (10406342 -75527794)
2019,Abril,Filipinas,5,85,,90,POINT (10446304 -75516486)
2019,Abril,Filipinas,0,32,,32,POINT (10886686 -74776479)
2019,Abril,Filipinas,0,31,,31,POINT (10970933 -74765343)
2019,Abril,Filipinas,0,3,,3,POINT (11247723 -74213989)
2019,Abril,Filipinas,2,8,,10,POINT (3451668 -76532004)
2019,Abril,Filipinas,0,4,,4,POINT (3884426 -77061029)
2019,Abril,Filipinas,41,45,,86,POINT (4697157 -74140516)
2019,Abril,Filipinas,1,0,,1,POINT (4815189 -75736374)
2019,Abril,Filipinas,3,7,,10,POINT (6170465 -7542726)
2019,Abril,Filipinas,0,3,,3,POINT (9402597 -75681642)
2019,Abril,Finlandia,2,1,,3,POINT (0.81488 -77356)
2019,Abril,Finlandia,8,9,,17,POINT (10446304 -75516486)
2019,Abril,Finlandia,1,8,,9,POINT (3451668 -76532004)
2019,Abril,Finlandia,37,54,,91,POINT (4697157 -74140516)
2019,Abril,Finlandia,0,1,,1,POINT (4815189 -75736374)
2019,Abril,Finlandia,4,12,,16,POINT (6170465 -7542726)
2019,Abril,Finlandia,0,1,,1,POINT (863337 -7735002)
2019,Abril,Francia,17,5,,22,POINT (-4191162 -69941498)
2019,Abril,Francia,25,25,,50,POINT (-4214082 -69941431)
2019,Abril,Francia,9,14,,23,POINT (0.33002 -76876446)
2019,Abril,Francia,91,105,,196,POINT (0.81488 -77356)
2019,Abril,Francia,18,24,,42,POINT (10406342 -75527794)
2019,Abril,Francia,175,261,,436,POINT (10446304 -75516486)
2019,Abril,Francia,18,25,,43,POINT (10886686 -74776479)
2019,Abril,Francia,0,3,,3,POINT (10970933 -74765343)
2019,Abril,Francia,0,4,,4,POINT (11117206 -74232675)
2019,Abril,Francia,3,6,,9,POINT (11247723 -74213989)
2019,Abril,Francia,2,4,,6,POINT (11360029 -72129595)
2019,Abril,Francia,1,2,,3,POINT (125744111 -81703935)
2019,Abril,Francia,1,3,,4,POINT (125862 -81702165)
2019,Abril,Francia,101,145,,246,POINT (3451668 -76532004)
2019,Abril,Francia,0,1,,1,POINT (3884426 -77061029)
2019,Abril,Francia,1,0,,1,POINT (445285 -75766353)
2019,Abril,Francia,2175,3057,,5232,POINT (4697157 -74140516)
2019,Abril,Francia,12,11,,23,POINT (4815189 -75736374)
2019,Abril,Francia,237,336,,573,POINT (6170465 -7542726)
2019,Abril,Francia,3,4,,7,POINT (7128047 -73181317)
2019,Abril,Francia,2,1,,3,POINT (7819 -72453013)
2019,Abril,Francia,0,1,,1,POINT (836068 -72409396)
2019,Abril,Francia,6,11,,17,POINT (863337 -7735002)
2019,Abril,Gambia,1,0,,1,POINT (4697157 -74140516)
2019,Abril,Georgia,0,15,,15,POINT (10406342 -75527794)
2019,Abril,Georgia,0,4,,4,POINT (10446304 -75516486)
2019,Abril,Georgia,7,9,,16,POINT (4697157 -74140516)
2019,Abril,Georgia,0,2,,2,POINT (9402597 -75681642)
2019,Abril,Ghana,1,2,,3,POINT (10446304 -75516486)
2019,Abril,Ghana,0,4,,4,POINT (4697157 -74140516)
2019,Abril,Ghana,1,1,,2,POINT (6170465 -7542726)
2019,Abril,Gibraltar/Territorio Británico de Ultramar,0,1,,1,POINT (4697157 -74140516)
2019,Abril,Granada,0,1,,1,POINT (11117206 -74232675)
2019,Abril,Granada,2,1,,3,POINT (3451668 -76532004)
2019,Abril,Granada,1,3,,4,POINT (4697157 -74140516)
2019,Abril,Granada,0,1,,1,POINT (6170465 -7542726)
2019,Abril,Granada,0,1,,1,POINT (7819 -72453013)
2019,Abril,Grecia,1,0,,1,POINT (0.81488 -77356)
2019,Abril,Grecia,0,1,,1,POINT (10406342 -75527794)
2019,Abril,Grecia,4,14,,18,POINT (10446304 -75516486)
2019,Abril,Grecia,4,5,,9,POINT (3451668 -76532004)
2019,Abril,Grecia,44,76,,120,POINT (4697157 -74140516)
2019,Abril,Grecia,2,3,,5,POINT (6170465 -7542726)
2019,Abril,Grecia,1,0,,1,POINT (863337 -7735002)
2019,Abril,Grecia,0,2,,2,POINT (9402597 -75681642)
2019,Abril,Guatemala,1,0,,1,POINT (0.33002 -76876446)
2019,Abril,Guatemala,1,1,,2,POINT (0.81488 -77356)
2019,Abril,Guatemala,12,8,,20,POINT (10406342 -75527794)
2019,Abril,Guatemala,206,189,,395,POINT (10446304 -75516486)
2019,Abril,Guatemala,7,15,,22,POINT (10886686 -74776479)
2019,Abril,Guatemala,0,1,,1,POINT (10970933 -74765343)
2019,Abril,Guatemala,0,1,,1,POINT (11360029 -72129595)
2019,Abril,Guatemala,17,9,,26,POINT (125862 -81702165)
2019,Abril,Guatemala,33,59,,92,POINT (3451668 -76532004)
2019,Abril,Guatemala,585,789,,1374,POINT (4697157 -74140516)
2019,Abril,Guatemala,6,10,,16,POINT (4815189 -75736374)
2019,Abril,Guatemala,72,136,,208,POINT (6170465 -7542726)
2019,Abril,Guatemala,0,6,,6,POINT (7128047 -73181317)
2019,Abril,Guatemala,0,1,,1,POINT (863337 -7735002)
2019,Abril,Guyana,0,1,,1,POINT (-4191162 -69941498)
2019,Abril,Guyana,0,1,,1,POINT (0.33002 -76876446)
2019,Abril,Guyana,0,5,,5,POINT (10446304 -75516486)
2019,Abril,Guyana,15,15,,30,POINT (4697157 -74140516)
2019,Abril,Guyana,0,7,,7,POINT (6170465 -7542726)
2019,Abril,Guyana,0,1,,1,POINT (7819 -72453013)
2019,Abril,Guinea,0,1,,1,POINT (4697157 -74140516)
2019,Abril,Guayana Francesa/Departamento de Ultramar Francés,0,1,,1,POINT (3451668 -76532004)
2019,Abril,Guayana Francesa/Departamento de Ultramar Francés,0,1,,1,POINT (4697157 -74140516)
2019,Abril,Haití,2,2,,4,POINT (10446304 -75516486)
2019,Abril,Haití,1,2,,3,POINT (10886686 -74776479)
2019,Abril,Haití,1,0,,1,POINT (3451668 -76532004)
2019,Abril,Haití,7,22,,29,POINT (4697157 -74140516)
2019,Abril,Haití,4,6,,10,POINT (6170465 -7542726)
2019,Abril,Honduras,1,0,,1,POINT (-4191162 -69941498)
2019,Abril,Honduras,0,1,,1,POINT (-4214082 -69941431)
2019,Abril,Honduras,3,3,,6,POINT (0.81488 -77356)
2019,Abril,Honduras,0,1,,1,POINT (10406342 -75527794)
2019,Abril,Honduras,156,126,,282,POINT (10446304 -75516486)
2019,Abril,Honduras,8,12,,20,POINT (10886686 -74776479)
2019,Abril,Honduras,0,1,,1,POINT (10970933 -74765343)
2019,Abril,Honduras,0,2,,2,POINT (125744111 -81703935)
2019,Abril,Honduras,0,2,,2,POINT (133387613 -81372937)
2019,Abril,Honduras,64,43,,107,POINT (3451668 -76532004)
2019,Abril,Honduras,347,341,,688,POINT (4697157 -74140516)
2019,Abril,Honduras,8,5,,13,POINT (4815189 -75736374)
2019,Abril,Honduras,80,80,,160,POINT (6170465 -7542726)
2019,Abril,Honduras,0,4,,4,POINT (7128047 -73181317)
2019,Abril,Honduras,2,1,,3,POINT (7819 -72453013)
2019,Abril,Hong Kong,0,1,,1,POINT (0.81488 -77356)
2019,Abril,Hong Kong,4,1,,5,POINT (10446304 -75516486)
2019,Abril,Hong Kong,21,16,,37,POINT (4697157 -74140516)
2019,Abril,Hong Kong,5,3,,8,POINT (6170465 -7542726)
2019,Abril,Hungría,4,1,,5,POINT (0.81488 -77356)
2019,Abril,Hungría,2,1,,3,POINT (10406342 -75527794)
2019,Abril,Hungría,1,3,,4,POINT (10446304 -75516486)
2019,Abril,Hungría,1,0,,1,POINT (10886686 -74776479)
2019,Abril,Hungría,1,1,,2,POINT (3451668 -76532004)
2019,Abril,Hungría,42,61,,103,POINT (4697157 -74140516)
2019,Abril,Hungría,4,6,,10,POINT (6170465 -7542726)
2019,Abril,India,0,3,,3,POINT (0.81488 -77356)
2019,Abril,India,0,16,,16,POINT (10406342 -75527794)
2019,Abril,India,22,56,,78,POINT (10446304 -75516486)
2019,Abril,India,6,19,,25,POINT (10886686 -74776479)
2019,Abril,India,0,5,,5,POINT (11247723 -74213989)
2019,Abril,India,1,8,,9,POINT (3451668 -76532004)
2019,Abril,India,92,444,,536,POINT (4697157 -74140516)
2019,Abril,India,1,4,,5,POINT (4815189 -75736374)
2019,Abril,India,7,61,,68,POINT (6170465 -7542726)
2019,Abril,Indonesia,0,6,,6,POINT (10406342 -75527794)
2019,Abril,Indonesia,3,18,,21,POINT (10446304 -75516486)
2019,Abril,Indonesia,0,1,,1,POINT (3451668 -76532004)
2019,Abril,Indonesia,10,26,,36,POINT (4697157 -74140516)
2019,Abril,Indonesia,2,2,,4,POINT (6170465 -7542726)
2019,Abril,Iraq,0,3,,3,POINT (4697157 -74140516)
2019,Abril,Irán,0,2,,2,POINT (10446304 -75516486)
2019,Abril,Irán,0,1,,1,POINT (10886686 -74776479)
2019,Abril,Irán,0,1,,1,POINT (3451668 -76532004)
2019,Abril,Irán,4,15,,19,POINT (4697157 -74140516)
2019,Abril,Irán,0,3,,3,POINT (6170465 -7542726)
2019,Abril,República de Irlanda,1,1,,2,POINT (-4191162 -69941498)
2019,Abril,República de Irlanda,1,2,,3,POINT (-4214082 -69941431)
2019,Abril,República de Irlanda,10,17,,27,POINT (0.81488 -77356)
2019,Abril,República de Irlanda,2,1,,3,POINT (10406342 -75527794)
2019,Abril,República de Irlanda,20,17,,37,POINT (10446304 -75516486)
2019,Abril,República de Irlanda,1,2,,3,POINT (10886686 -74776479)
2019,Abril,República de Irlanda,0,1,,1,POINT (11117206 -74232675)
2019,Abril,República de Irlanda,1,2,,3,POINT (11247723 -74213989)
2019,Abril,República de Irlanda,0,1,,1,POINT (125744111 -81703935)
2019,Abril,República de Irlanda,1,5,,6,POINT (3451668 -76532004)
2019,Abril,República de Irlanda,118,184,,302,POINT (4697157 -74140516)
2019,Abril,República de Irlanda,8,31,,39,POINT (6170465 -7542726)
2019,Abril,República de Irlanda,8,7,,15,POINT (863337 -7735002)
2019,Abril,Islandia,2,2,,4,POINT (10406342 -75527794)
2019,Abril,Islandia,3,1,,4,POINT (10446304 -75516486)
2019,Abril,Islandia,1,2,,3,POINT (3451668 -76532004)
2019,Abril,Islandia,8,6,,14,POINT (4697157 -74140516)
2019,Abril,Islandia,2,3,,5,POINT (6170465 -7542726)
2019,Abril,Israel,4,4,,8,POINT (-4191162 -69941498)
2019,Abril,Israel,2,9,,11,POINT (-4214082 -69941431)
2019,Abril,Israel,0,2,,2,POINT (0.33002 -76876446)
2019,Abril,Israel,7,44,,51,POINT (0.81488 -77356)
2019,Abril,Israel,38,36,,74,POINT (10406342 -75527794)
2019,Abril,Israel,31,68,,99,POINT (10446304 -75516486)
2019,Abril,Israel,3,5,,8,POINT (10886686 -74776479)
2019,Abril,Israel,1,2,,3,POINT (125862 -81702165)
2019,Abril,Israel,35,51,,86,POINT (3451668 -76532004)
2019,Abril,Israel,284,646,,930,POINT (4697157 -74140516)
2019,Abril,Israel,0,1,,1,POINT (4815189 -75736374)
2019,Abril,Israel,220,339,,559,POINT (6170465 -7542726)
2019,Abril,Italia,0,2,,2,POINT (-4191162 -69941498)
2019,Abril,Italia,2,7,,9,POINT (-4214082 -69941431)
2019,Abril,Italia,1,2,,3,POINT (0.33002 -76876446)
2019,Abril,Italia,10,13,,23,POINT (0.81488 -77356)
2019,Abril,Italia,0,1,,1,POINT (1800143 -78802679)
2019,Abril,Italia,5,14,,19,POINT (10406342 -75527794)
2019,Abril,Italia,86,167,,253,POINT (10446304 -75516486)
2019,Abril,Italia,15,35,,50,POINT (10886686 -74776479)
2019,Abril,Italia,1,0,,1,POINT (10970933 -74765343)
2019,Abril,Italia,0,1,,1,POINT (11117206 -74232675)
2019,Abril,Italia,1,2,,3,POINT (11247723 -74213989)
2019,Abril,Italia,11,21,,32,POINT (11360029 -72129595)
2019,Abril,Italia,1,1,,2,POINT (125744111 -81703935)
2019,Abril,Italia,6,10,,16,POINT (125862 -81702165)
2019,Abril,Italia,0,2,,2,POINT (133387613 -81372937)
2019,Abril,Italia,22,91,,113,POINT (3451668 -76532004)
2019,Abril,Italia,893,1768,,2661,POINT (4697157 -74140516)
2019,Abril,Italia,1,5,,6,POINT (4815189 -75736374)
2019,Abril,Italia,67,200,,267,POINT (6170465 -7542726)
2019,Abril,Italia,0,4,,4,POINT (7088729 -70740253)
2019,Abril,Italia,0,1,,1,POINT (7128047 -73181317)
2019,Abril,Italia,16,27,,43,POINT (7819 -72453013)
2019,Abril,Italia,4,4,,8,POINT (836068 -72409396)
2019,Abril,Italia,2,6,,8,POINT (863337 -7735002)
2019,Abril,Jamaica,10,8,,18,POINT (10446304 -75516486)
2019,Abril,Jamaica,2,5,,7,POINT (10886686 -74776479)
2019,Abril,Jamaica,2,9,,11,POINT (3451668 -76532004)
2019,Abril,Jamaica,28,37,,65,POINT (4697157 -74140516)
2019,Abril,Jamaica,0,5,,5,POINT (4815189 -75736374)
2019,Abril,Jamaica,3,10,,13,POINT (6170465 -7542726)
2019,Abril,Japón,0,1,,1,POINT (-4191162 -69941498)
2019,Abril,Japón,1,3,,4,POINT (-4214082 -69941431)
2019,Abril,Japón,0,1,,1,POINT (0.33002 -76876446)
2019,Abril,Japón,6,12,,18,POINT (0.81488 -77356)
2019,Abril,Japón,8,14,,22,POINT (10446304 -75516486)
2019,Abril,Japón,2,5,,7,POINT (10886686 -74776479)
2019,Abril,Japón,0,1,,1,POINT (125862 -81702165)
2019,Abril,Japón,13,26,,39,POINT (3451668 -76532004)
2019,Abril,Japón,173,376,,549,POINT (4697157 -74140516)
2019,Abril,Japón,0,3,,3,POINT (4815189 -75736374)
2019,Abril,Japón,22,35,,57,POINT (6170465 -7542726)
2019,Abril,Japón,2,0,,2,POINT (7819 -72453013)
2019,Abril,Jordania,0,5,,5,POINT (4697157 -74140516)
2019,Abril,Jordania,0,1,,1,POINT (6170465 -7542726)
2019,Abril,Kazajistán,1,1,,2,POINT (0.81488 -77356)
2019,Abril,Kazajistán,1,0,,1,POINT (10446304 -75516486)
2019,Abril,Kazajistán,8,5,,13,POINT (4697157 -74140516)
2019,Abril,Kenia,0,1,,1,POINT (0.33002 -76876446)
2019,Abril,Kenia,1,2,,3,POINT (10446304 -75516486)
2019,Abril,Kenia,1,6,,7,POINT (4697157 -74140516)
2019,Abril,Kiribati,0,1,,1,POINT (11247723 -74213989)
2019,Abril,Kuwait,0,5,,5,POINT (10446304 -75516486)
2019,Abril,Kuwait,0,5,,5,POINT (4697157 -74140516)
2019,Abril,República de Kosovo,0,1,,1,POINT (4697157 -74140516)
2019,Abril,República Democrática Popular  Lao,0,3,,3,POINT (4697157 -74140516)
2019,Abril,Letonia,0,1,,1,POINT (-4214082 -69941431)
2019,Abril,Letonia,0,1,,1,POINT (0.81488 -77356)
2019,Abril,Letonia,0,2,,2,POINT (10406342 -75527794)
2019,Abril,Letonia,10,13,,23,POINT (4697157 -74140516)
2019,Abril,Letonia,1,0,,1,POINT (6170465 -7542726)
2019,Abril,Lituania,2,0,,2,POINT (0.81488 -77356)
2019,Abril,Lituania,0,2,,2,POINT (10406342 -75527794)
2019,Abril,Lituania,0,2,,2,POINT (10446304 -75516486)
2019,Abril,Lituania,0,2,,2,POINT (3451668 -76532004)
2019,Abril,Lituania,28,21,,49,POINT (4697157 -74140516)
2019,Abril,Lituania,3,6,,9,POINT (6170465 -7542726)
2019,Abril,Líbano,0,1,,1,POINT (0.81488 -77356)
2019,Abril,Líbano,0,1,,1,POINT (10446304 -75516486)
2019,Abril,Líbano,1,3,,4,POINT (10886686 -74776479)
2019,Abril,Líbano,1,3,,4,POINT (11360029 -72129595)
2019,Abril,Líbano,0,1,,1,POINT (3451668 -76532004)
2019,Abril,Líbano,18,30,,48,POINT (4697157 -74140516)
2019,Abril,Liechtenstein,0,1,,1,POINT (10446304 -75516486)
2019,Abril,Liechtenstein,3,1,,4,POINT (4697157 -74140516)
2019,Abril,Luxemburgo,1,0,,1,POINT (-4214082 -69941431)
2019,Abril,Luxemburgo,2,4,,6,POINT (10446304 -75516486)
2019,Abril,Luxemburgo,0,3,,3,POINT (3451668 -76532004)
2019,Abril,Luxemburgo,7,14,,21,POINT (4697157 -74140516)
2019,Abril,Luxemburgo,1,0,,1,POINT (6170465 -7542726)
2019,Abril,Macedonia,0,1,,1,POINT (10446304 -75516486)
2019,Abril,Macedonia,4,10,,14,POINT (4697157 -74140516)
2019,Abril,Macedonia,0,1,,1,POINT (6170465 -7542726)
2019,Abril,Madagascar,2,0,,2,POINT (4697157 -74140516)
2019,Abril,Malasia,0,1,,1,POINT (-4191162 -69941498)
2019,Abril,Malasia,1,1,,2,POINT (0.81488 -77356)
2019,Abril,Malasia,3,2,,5,POINT (10446304 -75516486)
2019,Abril,Malasia,0,1,,1,POINT (10886686 -74776479)
2019,Abril,Malasia,10,13,,23,POINT (4697157 -74140516)
2019,Abril,Malasia,1,2,,3,POINT (6170465 -7542726)
2019,Abril,Malawi,0,1,,1,POINT (4697157 -74140516)
2019,Abril,Malta,0,1,,1,POINT (0.81488 -77356)
2019,Abril,Malta,0,1,,1,POINT (3451668 -76532004)
2019,Abril,Malta,3,4,,7,POINT (4697157 -74140516)
2019,Abril,Malta,1,3,,4,POINT (6170465 -7542726)
2019,Abril,Marruecos,3,2,,5,POINT (10446304 -75516486)
2019,Abril,Marruecos,1,0,,1,POINT (10886686 -74776479)
2019,Abril,Marruecos,11,17,,28,POINT (4697157 -74140516)
2019,Abril,Marruecos,1,0,,1,POINT (4815189 -75736374)
2019,Abril,Marruecos,1,0,,1,POINT (6170465 -7542726)
2019,Abril,Mauricio,2,2,,4,POINT (10446304 -75516486)
2019,Abril,Mauricio,1,1,,2,POINT (4697157 -74140516)
2019,Abril,Mauricio,0,1,,1,POINT (6170465 -7542726)
2019,Abril,México,2,0,,2,POINT (-4191162 -69941498)
2019,Abril,México,2,1,,3,POINT (-4214082 -69941431)
2019,Abril,México,0,1,,1,POINT (0.33002 -76876446)
2019,Abril,México,25,54,,79,POINT (0.81488 -77356)
2019,Abril,México,38,31,,69,POINT (10406342 -75527794)
2019,Abril,México,341,494,,835,POINT (10446304 -75516486)
2019,Abril,México,54,83,,137,POINT (10886686 -74776479)
2019,Abril,México,3,4,,7,POINT (11360029 -72129595)
2019,Abril,México,0,2,,2,POINT (125744111 -81703935)
2019,Abril,México,5,4,,9,POINT (125862 -81702165)
2019,Abril,México,99,198,,297,POINT (3451668 -76532004)
2019,Abril,México,1,1,,2,POINT (445285 -75766353)
2019,Abril,México,5703,8333,,14036,POINT (4697157 -74140516)
2019,Abril,México,14,15,,29,POINT (4815189 -75736374)
2019,Abril,México,559,1144,,1703,POINT (6170465 -7542726)
2019,Abril,México,6,20,,26,POINT (7128047 -73181317)
2019,Abril,México,6,7,,13,POINT (7819 -72453013)
2019,Abril,México,0,1,,1,POINT (836068 -72409396)
2019,Abril,México,0,2,,2,POINT (863337 -7735002)
2019,Abril,República de Moldavia,4,2,,6,POINT (4697157 -74140516)
2019,Abril,Mongolia,2,0,,2,POINT (4697157 -74140516)
2019,Abril,Montenegro,0,2,,2,POINT (10406342 -75527794)
2019,Abril,Montenegro,0,3,,3,POINT (10446304 -75516486)
2019,Abril,Montenegro,0,1,,1,POINT (10886686 -74776479)
2019,Abril,Montenegro,1,2,,3,POINT (4697157 -74140516)
2019,Abril,Montenegro,0,1,,1,POINT (6170465 -7542726)
2019,Abril,Mozambique,1,1,,2,POINT (4697157 -74140516)
2019,Abril,Myanmar,0,9,,9,POINT (10406342 -75527794)
2019,Abril,Myanmar,0,9,,9,POINT (10446304 -75516486)
2019,Abril,Myanmar,0,1,,1,POINT (4697157 -74140516)
2019,Abril,Nepal,0,1,,1,POINT (0.81488 -77356)
2019,Abril,Nepal,1,0,,1,POINT (10446304 -75516486)
2019,Abril,Nepal,2,2,,4,POINT (4697157 -74140516)
2019,Abril,Nicaragua,38,50,,88,POINT (10446304 -75516486)
2019,Abril,Nicaragua,0,2,,2,POINT (10886686 -74776479)
2019,Abril,Nicaragua,0,1,,1,POINT (11117206 -74232675)
2019,Abril,Nicaragua,0,1,,1,POINT (11360029 -72129595)
2019,Abril,Nicaragua,5,9,,14,POINT (125744111 -81703935)
2019,Abril,Nicaragua,1,1,,2,POINT (125862 -81702165)
2019,Abril,Nicaragua,11,11,,22,POINT (3451668 -76532004)
2019,Abril,Nicaragua,86,130,,216,POINT (4697157 -74140516)
2019,Abril,Nicaragua,1,2,,3,POINT (4815189 -75736374)
2019,Abril,Nicaragua,15,22,,37,POINT (6170465 -7542726)
2019,Abril,Nicaragua,1,3,,4,POINT (7128047 -73181317)
2019,Abril,Nigeria,0,3,,3,POINT (10446304 -75516486)
2019,Abril,Nigeria,1,0,,1,POINT (10886686 -74776479)
2019,Abril,Nigeria,8,18,,26,POINT (4697157 -74140516)
2019,Abril,Nigeria,1,3,,4,POINT (6170465 -7542726)
2019,Abril,Noruega,2,0,,2,POINT (-4191162 -69941498)
2019,Abril,Noruega,2,4,,6,POINT (-4214082 -69941431)
2019,Abril,Noruega,1,0,,1,POINT (0.33002 -76876446)
2019,Abril,Noruega,10,3,,13,POINT (0.81488 -77356)
2019,Abril,Noruega,5,2,,7,POINT (10406342 -75527794)
2019,Abril,Noruega,22,36,,58,POINT (10446304 -75516486)
2019,Abril,Noruega,2,3,,5,POINT (10886686 -74776479)
2019,Abril,Noruega,0,1,,1,POINT (11360029 -72129595)
2019,Abril,Noruega,2,6,,8,POINT (3451668 -76532004)
2019,Abril,Noruega,120,185,,305,POINT (4697157 -74140516)
2019,Abril,Noruega,9,15,,24,POINT (6170465 -7542726)
2019,Abril,Noruega,2,0,,2,POINT (863337 -7735002)
2019,Abril,Nueva Zelanda,1,0,,1,POINT (-4191162 -69941498)
2019,Abril,Nueva Zelanda,0,2,,2,POINT (-4214082 -69941431)
2019,Abril,Nueva Zelanda,9,7,,16,POINT (0.81488 -77356)
2019,Abril,Nueva Zelanda,2,9,,11,POINT (10406342 -75527794)
2019,Abril,Nueva Zelanda,8,9,,17,POINT (10446304 -75516486)
2019,Abril,Nueva Zelanda,3,3,,6,POINT (10886686 -74776479)
2019,Abril,Nueva Zelanda,1,1,,2,POINT (125744111 -81703935)
2019,Abril,Nueva Zelanda,0,1,,1,POINT (125862 -81702165)
2019,Abril,Nueva Zelanda,2,2,,4,POINT (133387613 -81372937)
2019,Abril,Nueva Zelanda,2,1,,3,POINT (3451668 -76532004)
2019,Abril,Nueva Zelanda,57,102,,159,POINT (4697157 -74140516)
2019,Abril,Nueva Zelanda,11,19,,30,POINT (6170465 -7542726)
2019,Abril,Nueva Zelanda,2,3,,5,POINT (863337 -7735002)
2019,Abril,Omán,0,2,,2,POINT (4697157 -74140516)
2019,Abril,Países Bajos,0,2,,2,POINT (-4191162 -69941498)
2019,Abril,Países Bajos,3,6,,9,POINT (-4214082 -69941431)
2019,Abril,Países Bajos,1,2,,3,POINT (0.33002 -76876446)
2019,Abril,Países Bajos,24,23,,47,POINT (0.81488 -77356)
2019,Abril,Países Bajos,23,17,,40,POINT (10406342 -75527794)
2019,Abril,Países Bajos,285,275,,560,POINT (10446304 -75516486)
2019,Abril,Países Bajos,10,36,,46,POINT (10886686 -74776479)
2019,Abril,Países Bajos,4,20,,24,POINT (11117206 -74232675)
2019,Abril,Países Bajos,1,4,,5,POINT (11247723 -74213989)
2019,Abril,Países Bajos,3,4,,7,POINT (11360029 -72129595)
2019,Abril,Países Bajos,2,1,,3,POINT (125862 -81702165)
2019,Abril,Países Bajos,1,1,,2,POINT (133387613 -81372937)
2019,Abril,Países Bajos,49,64,,113,POINT (3451668 -76532004)
2019,Abril,Países Bajos,1826,2346,,4172,POINT (4697157 -74140516)
2019,Abril,Países Bajos,3,9,,12,POINT (4815189 -75736374)
2019,Abril,Países Bajos,182,263,,445,POINT (6170465 -7542726)
2019,Abril,Países Bajos,10,9,,19,POINT (7128047 -73181317)
2019,Abril,Países Bajos,0,4,,4,POINT (7819 -72453013)
2019,Abril,Países Bajos,1,0,,1,POINT (836068 -72409396)
2019,Abril,Países Bajos,7,8,,15,POINT (863337 -7735002)
2019,Abril,Pakistán,0,2,,2,POINT (10446304 -75516486)
2019,Abril,Pakistán,1,0,,1,POINT (3451668 -76532004)
2019,Abril,Pakistán,5,19,,24,POINT (4697157 -74140516)
2019,Abril,Pakistán,0,4,,4,POINT (6170465 -7542726)
2019,Abril,Pakistán,0,1,,1,POINT (7819 -72453013)
2019,Abril,Panamá,1,3,,4,POINT (0.81488 -77356)
2019,Abril,Panamá,2,37,,39,POINT (10406342 -75527794)
2019,Abril,Panamá,1,0,,1,POINT (10433609 -73247863)
2019,Abril,Panamá,471,522,,993,POINT (10446304 -75516486)
2019,Abril,Panamá,72,102,,174,POINT (10886686 -74776479)
2019,Abril,Panamá,0,1,,1,POINT (10970933 -74765343)
2019,Abril,Panamá,1,0,,1,POINT (11360029 -72129595)
2019,Abril,Panamá,21,30,,51,POINT (125862 -81702165)
2019,Abril,Panamá,380,407,,787,POINT (3451668 -76532004)
2019,Abril,Panamá,1714,1799,,3513,POINT (4697157 -74140516)
2019,Abril,Panamá,25,46,,71,POINT (4815189 -75736374)
2019,Abril,Panamá,1417,1344,,2761,POINT (6170465 -7542726)
2019,Abril,Panamá,1,2,,3,POINT (7102626 -77762647)
2019,Abril,Panamá,11,10,,21,POINT (7128047 -73181317)
2019,Abril,Panamá,1,3,,4,POINT (7819 -72453013)
2019,Abril,Panamá,2,1,,3,POINT (863337 -7735002)
2019,Abril,Papúa Nueva Guinea,1,0,,1,POINT (-4214082 -69941431)
2019,Abril,Papúa Nueva Guinea,1,0,,1,POINT (4697157 -74140516)
2019,Abril,Paraguay,0,1,,1,POINT (-4214082 -69941431)
2019,Abril,Paraguay,1,1,,2,POINT (10406342 -75527794)
2019,Abril,Paraguay,90,68,,158,POINT (10446304 -75516486)
2019,Abril,Paraguay,2,2,,4,POINT (10886686 -74776479)
2019,Abril,Paraguay,59,36,,95,POINT (125862 -81702165)
2019,Abril,Paraguay,18,72,,90,POINT (3451668 -76532004)
2019,Abril,Paraguay,168,201,,369,POINT (4697157 -74140516)
2019,Abril,Paraguay,3,2,,5,POINT (4815189 -75736374)
2019,Abril,Paraguay,23,14,,37,POINT (6170465 -7542726)
2019,Abril,Perú,7,5,,12,POINT (-4191162 -69941498)
2019,Abril,Perú,53,66,,119,POINT (-4214082 -69941431)
2019,Abril,Perú,49,89,,138,POINT (0.185957 -7478366)
2019,Abril,Perú,1,15,,16,POINT (0.33002 -76876446)
2019,Abril,Perú,101,231,,332,POINT (0.81488 -77356)
2019,Abril,Perú,46,35,,81,POINT (10406342 -75527794)
2019,Abril,Perú,1031,624,,1655,POINT (10446304 -75516486)
2019,Abril,Perú,8,14,,22,POINT (10886686 -74776479)
2019,Abril,Perú,0,1,,1,POINT (10970933 -74765343)
2019,Abril,Perú,8,14,,22,POINT (11360029 -72129595)
2019,Abril,Perú,0,3,,3,POINT (125744111 -81703935)
2019,Abril,Perú,287,194,,481,POINT (125862 -81702165)
2019,Abril,Perú,308,346,,654,POINT (3451668 -76532004)
2019,Abril,Perú,0,2,,2,POINT (445285 -75766353)
2019,Abril,Perú,4062,4578,,8640,POINT (4697157 -74140516)
2019,Abril,Perú,3,10,,13,POINT (4815189 -75736374)
2019,Abril,Perú,762,1022,,1784,POINT (6170465 -7542726)
2019,Abril,Perú,1,2,,3,POINT (6185536 -67484028)
2019,Abril,Perú,2,4,,6,POINT (7088729 -70740253)
2019,Abril,Perú,0,5,,5,POINT (7128047 -73181317)
2019,Abril,Perú,48,81,,129,POINT (7819 -72453013)
2019,Abril,Palestina,0,3,,3,POINT (4697157 -74140516)
2019,Abril,Polonia,0,1,,1,POINT (-4191162 -69941498)
2019,Abril,Polonia,0,2,,2,POINT (-4214082 -69941431)
2019,Abril,Polonia,12,13,,25,POINT (0.81488 -77356)
2019,Abril,Polonia,1,11,,12,POINT (10406342 -75527794)
2019,Abril,Polonia,28,35,,63,POINT (10446304 -75516486)
2019,Abril,Polonia,2,2,,4,POINT (10886686 -74776479)
2019,Abril,Polonia,0,1,,1,POINT (11247723 -74213989)
2019,Abril,Polonia,3,13,,16,POINT (3451668 -76532004)
2019,Abril,Polonia,0,4,,4,POINT (3884426 -77061029)
2019,Abril,Polonia,190,214,,404,POINT (4697157 -74140516)
2019,Abril,Polonia,14,15,,29,POINT (6170465 -7542726)
2019,Abril,Polonia,0,4,,4,POINT (806667 -767333)
2019,Abril,Polonia,0,1,,1,POINT (863337 -7735002)
2019,Abril,Portugal,2,1,,3,POINT (-4214082 -69941431)
2019,Abril,Portugal,5,7,,12,POINT (0.81488 -77356)
2019,Abril,Portugal,2,3,,5,POINT (10406342 -75527794)
2019,Abril,Portugal,36,38,,74,POINT (10446304 -75516486)
2019,Abril,Portugal,1,8,,9,POINT (10886686 -74776479)
2019,Abril,Portugal,0,1,,1,POINT (11117206 -74232675)
2019,Abril,Portugal,0,1,,1,POINT (11247723 -74213989)
2019,Abril,Portugal,3,2,,5,POINT (11360029 -72129595)
2019,Abril,Portugal,3,3,,6,POINT (125862 -81702165)
2019,Abril,Portugal,8,21,,29,POINT (3451668 -76532004)
2019,Abril,Portugal,298,500,,798,POINT (4697157 -74140516)
2019,Abril,Portugal,6,6,,12,POINT (4815189 -75736374)
2019,Abril,Portugal,18,46,,64,POINT (6170465 -7542726)
2019,Abril,Portugal,0,1,,1,POINT (7088729 -70740253)
2019,Abril,Portugal,11,18,,29,POINT (7819 -72453013)
2019,Abril,Portugal,0,1,,1,POINT (836068 -72409396)
2019,Abril,Qatar,0,2,,2,POINT (4697157 -74140516)
2019,Abril,Qatar,0,1,,1,POINT (6170465 -7542726)
2019,Abril,Reino Unido de Gran Bretaña e Irlanda del Norte,5,4,,9,POINT (-4191162 -69941498)
2019,Abril,Reino Unido de Gran Bretaña e Irlanda del Norte,9,6,,15,POINT (-4214082 -69941431)
2019,Abril,Reino Unido de Gran Bretaña e Irlanda del Norte,61,80,,141,POINT (0.81488 -77356)
2019,Abril,Reino Unido de Gran Bretaña e Irlanda del Norte,20,17,,37,POINT (10406342 -75527794)
2019,Abril,Reino Unido de Gran Bretaña e Irlanda del Norte,136,204,,340,POINT (10446304 -75516486)
2019,Abril,Reino Unido de Gran Bretaña e Irlanda del Norte,7,31,,38,POINT (10886686 -74776479)
2019,Abril,Reino Unido de Gran Bretaña e Irlanda del Norte,0,3,,3,POINT (11117206 -74232675)
2019,Abril,Reino Unido de Gran Bretaña e Irlanda del Norte,2,1,,3,POINT (11247723 -74213989)
2019,Abril,Reino Unido de Gran Bretaña e Irlanda del Norte,0,3,,3,POINT (11360029 -72129595)
2019,Abril,Reino Unido de Gran Bretaña e Irlanda del Norte,2,3,,5,POINT (125744111 -81703935)
2019,Abril,Reino Unido de Gran Bretaña e Irlanda del Norte,2,0,,2,POINT (125862 -81702165)
2019,Abril,Reino Unido de Gran Bretaña e Irlanda del Norte,1,6,,7,POINT (133387613 -81372937)
2019,Abril,Reino Unido de Gran Bretaña e Irlanda del Norte,37,73,,110,POINT (3451668 -76532004)
2019,Abril,Reino Unido de Gran Bretaña e Irlanda del Norte,0,1,,1,POINT (445285 -75766353)
2019,Abril,Reino Unido de Gran Bretaña e Irlanda del Norte,1445,2390,,3835,POINT (4697157 -74140516)
2019,Abril,Reino Unido de Gran Bretaña e Irlanda del Norte,1,6,,7,POINT (4815189 -75736374)
2019,Abril,Reino Unido de Gran Bretaña e Irlanda del Norte,158,334,,492,POINT (6170465 -7542726)
2019,Abril,Reino Unido de Gran Bretaña e Irlanda del Norte,3,1,,4,POINT (7128047 -73181317)
2019,Abril,Reino Unido de Gran Bretaña e Irlanda del Norte,0,2,,2,POINT (7819 -72453013)
2019,Abril,Reino Unido de Gran Bretaña e Irlanda del Norte,0,1,,1,POINT (836068 -72409396)
2019,Abril,Reino Unido de Gran Bretaña e Irlanda del Norte,39,30,,69,POINT (863337 -7735002)
2019,Abril,República Dominicana,1,3,,4,POINT (-4191162 -69941498)
2019,Abril,República Dominicana,2,0,,2,POINT (-4214082 -69941431)
2019,Abril,República Dominicana,5,15,,20,POINT (0.81488 -77356)
2019,Abril,República Dominicana,0,1,,1,POINT (1800143 -78802679)
2019,Abril,República Dominicana,0,4,,4,POINT (10406342 -75527794)
2019,Abril,República Dominicana,70,78,,148,POINT (10446304 -75516486)
2019,Abril,República Dominicana,16,24,,40,POINT (10886686 -74776479)
2019,Abril,República Dominicana,0,1,,1,POINT (11117206 -74232675)
2019,Abril,República Dominicana,0,2,,2,POINT (11360029 -72129595)
2019,Abril,República Dominicana,39,27,,66,POINT (3451668 -76532004)
2019,Abril,República Dominicana,1709,1479,,3188,POINT (4697157 -74140516)
2019,Abril,República Dominicana,3,1,,4,POINT (4815189 -75736374)
2019,Abril,República Dominicana,109,114,,223,POINT (6170465 -7542726)
2019,Abril,República Dominicana,3,2,,5,POINT (7128047 -73181317)
2019,Abril,República Dominicana,3,7,,10,POINT (7819 -72453013)
2019,Abril,República Dominicana,0,1,,1,POINT (836068 -72409396)
2019,Abril,República Dominicana,0,1,,1,POINT (863337 -7735002)
2019,Abril,Rumania,0,2,,2,POINT (-4214082 -69941431)
2019,Abril,Rumania,0,2,,2,POINT (0.81488 -77356)
2019,Abril,Rumania,1,5,,6,POINT (10406342 -75527794)
2019,Abril,Rumania,7,9,,16,POINT (10446304 -75516486)
2019,Abril,Rumania,0,3,,3,POINT (10886686 -74776479)
2019,Abril,Rumania,0,8,,8,POINT (10970933 -74765343)
2019,Abril,Rumania,1,1,,2,POINT (11117206 -74232675)
2019,Abril,Rumania,0,1,,1,POINT (11247723 -74213989)
2019,Abril,Rumania,0,1,,1,POINT (11360029 -72129595)
2019,Abril,Rumania,0,2,,2,POINT (3451668 -76532004)
2019,Abril,Rumania,94,81,,175,POINT (4697157 -74140516)
2019,Abril,Rumania,9,11,,20,POINT (6170465 -7542726)
2019,Abril,Federación de Rusia,17,8,,25,POINT (0.81488 -77356)
2019,Abril,Federación de Rusia,2,17,,19,POINT (10406342 -75527794)
2019,Abril,Federación de Rusia,16,26,,42,POINT (10446304 -75516486)
2019,Abril,Federación de Rusia,0,3,,3,POINT (10886686 -74776479)
2019,Abril,Federación de Rusia,0,1,,1,POINT (10970933 -74765343)
2019,Abril,Federación de Rusia,1,0,,1,POINT (11117206 -74232675)
2019,Abril,Federación de Rusia,0,2,,2,POINT (11247723 -74213989)
2019,Abril,Federación de Rusia,0,3,,3,POINT (11360029 -72129595)
2019,Abril,Federación de Rusia,0,1,,1,POINT (125744111 -81703935)
2019,Abril,Federación de Rusia,0,1,,1,POINT (125862 -81702165)
2019,Abril,Federación de Rusia,5,7,,12,POINT (3451668 -76532004)
2019,Abril,Federación de Rusia,0,5,,5,POINT (3884426 -77061029)
2019,Abril,Federación de Rusia,203,207,,410,POINT (4697157 -74140516)
2019,Abril,Federación de Rusia,1,0,,1,POINT (4815189 -75736374)
2019,Abril,Federación de Rusia,16,21,,37,POINT (6170465 -7542726)
2019,Abril,Federación de Rusia,0,2,,2,POINT (7128047 -73181317)
2019,Abril,Federación de Rusia,1,2,,3,POINT (863337 -7735002)
2019,Abril,Federación de Rusia,0,4,,4,POINT (9402597 -75681642)
2019,Abril,Rwanda,0,1,,1,POINT (4697157 -74140516)
2019,Abril,San Cristóbal y Nevis,0,1,,1,POINT (4697157 -74140516)
2019,Abril,San Cristóbal y Nevis,0,1,,1,POINT (6170465 -7542726)
2019,Abril,San Marino,0,3,,3,POINT (4697157 -74140516)
2019,Abril,San  Vicente y las Granadinas,0,1,,1,POINT (10446304 -75516486)
2019,Abril,San  Vicente y las Granadinas,0,2,,2,POINT (125862 -81702165)
2019,Abril,San  Vicente y las Granadinas,3,1,,4,POINT (4697157 -74140516)
2019,Abril,San  Vicente y las Granadinas,0,1,,1,POINT (6170465 -7542726)
2019,Abril,Santa Lucia,1,0,,1,POINT (10446304 -75516486)
2019,Abril,Santa Lucia,7,5,,12,POINT (4697157 -74140516)
2019,Abril,Santa Lucia,0,1,,1,POINT (6170465 -7542726)
2019,Abril,Santa Sede/Ciudad del Vaticano,0,1,,1,POINT (4697157 -74140516)
2019,Abril,Senegal,0,1,,1,POINT (4697157 -74140516)
2019,Abril,Serbia,1,1,,2,POINT (0.81488 -77356)
2019,Abril,Serbia,1,2,,3,POINT (10406342 -75527794)
2019,Abril,Serbia,3,3,,6,POINT (10446304 -75516486)
2019,Abril,Serbia,1,3,,4,POINT (3451668 -76532004)
2019,Abril,Serbia,16,48,,64,POINT (4697157 -74140516)
2019,Abril,Serbia,1,3,,4,POINT (6170465 -7542726)
2019,Abril,Serbia,0,1,,1,POINT (9402597 -75681642)
2019,Abril,Singapur,1,0,,1,POINT (0.81488 -77356)
2019,Abril,Singapur,4,1,,5,POINT (10446304 -75516486)
2019,Abril,Singapur,0,4,,4,POINT (3451668 -76532004)
2019,Abril,Singapur,24,38,,62,POINT (4697157 -74140516)
2019,Abril,Singapur,1,3,,4,POINT (6170465 -7542726)
2019,Abril,Singapur,1,0,,1,POINT (863337 -7735002)
2019,Abril,República Árabe Siria,0,1,,1,POINT (10886686 -74776479)
2019,Abril,República Árabe Siria,0,4,,4,POINT (4697157 -74140516)
2019,Abril,República Árabe Siria,1,0,,1,POINT (6170465 -7542726)
2019,Abril,Sri Lanka,0,3,,3,POINT (10446304 -75516486)
2019,Abril,Sri Lanka,2,4,,6,POINT (4697157 -74140516)
2019,Abril,Sri Lanka,0,1,,1,POINT (6170465 -7542726)
2019,Abril,Sudáfrica,0,1,,1,POINT (-4214082 -69941431)
2019,Abril,Sudáfrica,1,6,,7,POINT (10406342 -75527794)
2019,Abril,Sudáfrica,4,6,,10,POINT (10446304 -75516486)
2019,Abril,Sudáfrica,4,5,,9,POINT (10886686 -74776479)
2019,Abril,Sudáfrica,0,3,,3,POINT (125744111 -81703935)
2019,Abril,Sudáfrica,1,1,,2,POINT (3451668 -76532004)
2019,Abril,Sudáfrica,16,29,,45,POINT (4697157 -74140516)
2019,Abril,Sudáfrica,0,2,,2,POINT (6170465 -7542726)
2019,Abril,Sudán,1,0,,1,POINT (3451668 -76532004)
2019,Abril,Sudán,1,0,,1,POINT (6170465 -7542726)
2019,Abril,Suecia,1,4,,5,POINT (-4214082 -69941431)
2019,Abril,Suecia,0,3,,3,POINT (0.33002 -76876446)
2019,Abril,Suecia,16,7,,23,POINT (0.81488 -77356)
2019,Abril,Suecia,12,6,,18,POINT (10406342 -75527794)
2019,Abril,Suecia,11,23,,34,POINT (10446304 -75516486)
2019,Abril,Suecia,5,6,,11,POINT (10886686 -74776479)
2019,Abril,Suecia,3,5,,8,POINT (11247723 -74213989)
2019,Abril,Suecia,0,1,,1,POINT (11360029 -72129595)
2019,Abril,Suecia,2,11,,13,POINT (3451668 -76532004)
2019,Abril,Suecia,153,255,,408,POINT (4697157 -74140516)
2019,Abril,Suecia,1,1,,2,POINT (4815189 -75736374)
2019,Abril,Suecia,19,30,,49,POINT (6170465 -7542726)
2019,Abril,Suecia,1,5,,6,POINT (863337 -7735002)
2019,Abril,Suiza,4,3,,7,POINT (-4191162 -69941498)
2019,Abril,Suiza,8,4,,12,POINT (-4214082 -69941431)
2019,Abril,Suiza,5,3,,8,POINT (0.33002 -76876446)
2019,Abril,Suiza,23,17,,40,POINT (0.81488 -77356)
2019,Abril,Suiza,19,20,,39,POINT (10406342 -75527794)
2019,Abril,Suiza,76,63,,139,POINT (10446304 -75516486)
2019,Abril,Suiza,6,5,,11,POINT (10886686 -74776479)
2019,Abril,Suiza,0,1,,1,POINT (11247723 -74213989)
2019,Abril,Suiza,2,1,,3,POINT (125862 -81702165)
2019,Abril,Suiza,49,71,,120,POINT (3451668 -76532004)
2019,Abril,Suiza,2,3,,5,POINT (445285 -75766353)
2019,Abril,Suiza,562,727,,1289,POINT (4697157 -74140516)
2019,Abril,Suiza,1,8,,9,POINT (4815189 -75736374)
2019,Abril,Suiza,49,84,,133,POINT (6170465 -7542726)
2019,Abril,Suiza,1,0,,1,POINT (7128047 -73181317)
2019,Abril,Suiza,2,2,,4,POINT (7819 -72453013)
2019,Abril,Suiza,5,4,,9,POINT (863337 -7735002)
2019,Abril,Surinam,0,2,,2,POINT (10446304 -75516486)
2019,Abril,Surinam,17,8,,25,POINT (4697157 -74140516)
2019,Abril,Surinam,0,9,,9,POINT (6170465 -7542726)
2019,Abril,Surinam,0,2,,2,POINT (7128047 -73181317)
2019,Abril,Taiwán,3,1,,4,POINT (4697157 -74140516)
2019,Abril,Tailandia,6,2,,8,POINT (10446304 -75516486)
2019,Abril,Tailandia,2,0,,2,POINT (3451668 -76532004)
2019,Abril,Tailandia,21,16,,37,POINT (4697157 -74140516)
2019,Abril,Tailandia,1,3,,4,POINT (6170465 -7542726)
2019,Abril,Tanzania,2,0,,2,POINT (4697157 -74140516)
2019,Abril,Togo,0,1,,1,POINT (10886686 -74776479)
2019,Abril,Trinidad y Tobago,1,0,,1,POINT (10406342 -75527794)
2019,Abril,Trinidad y Tobago,3,5,,8,POINT (10446304 -75516486)
2019,Abril,Trinidad y Tobago,1,4,,5,POINT (10886686 -74776479)
2019,Abril,Trinidad y Tobago,0,3,,3,POINT (3451668 -76532004)
2019,Abril,Trinidad y Tobago,30,48,,78,POINT (4697157 -74140516)
2019,Abril,Trinidad y Tobago,0,1,,1,POINT (4815189 -75736374)
2019,Abril,Trinidad y Tobago,9,10,,19,POINT (6170465 -7542726)
2019,Abril,Trinidad y Tobago,0,3,,3,POINT (7128047 -73181317)
2019,Abril,Trinidad y Tobago,0,1,,1,POINT (7819 -72453013)
2019,Abril,Trinidad y Tobago,1,1,,2,POINT (7927233 -72508188)
2019,Abril,Túnez,0,1,,1,POINT (0.81488 -77356)
2019,Abril,Túnez,0,3,,3,POINT (10446304 -75516486)
2019,Abril,Túnez,1,0,,1,POINT (3451668 -76532004)
2019,Abril,Túnez,5,4,,9,POINT (4697157 -74140516)
2019,Abril,Turquía,1,1,,2,POINT (-4214082 -69941431)
2019,Abril,Turquía,1,3,,4,POINT (0.81488 -77356)
2019,Abril,Turquía,0,1,,1,POINT (10406342 -75527794)
2019,Abril,Turquía,7,5,,12,POINT (10446304 -75516486)
2019,Abril,Turquía,3,6,,9,POINT (3451668 -76532004)
2019,Abril,Turquía,149,297,,446,POINT (4697157 -74140516)
2019,Abril,Turquía,7,12,,19,POINT (6170465 -7542726)
2019,Abril,Ucrania,1,2,,3,POINT (0.81488 -77356)
2019,Abril,Ucrania,2,9,,11,POINT (10406342 -75527794)
2019,Abril,Ucrania,3,11,,14,POINT (10446304 -75516486)
2019,Abril,Ucrania,0,7,,7,POINT (10886686 -74776479)
2019,Abril,Ucrania,0,1,,1,POINT (10970933 -74765343)
2019,Abril,Ucrania,0,2,,2,POINT (11247723 -74213989)
2019,Abril,Ucrania,1,1,,2,POINT (125744111 -81703935)
2019,Abril,Ucrania,0,4,,4,POINT (3451668 -76532004)
2019,Abril,Ucrania,0,1,,1,POINT (3884426 -77061029)
2019,Abril,Ucrania,23,15,,38,POINT (4697157 -74140516)
2019,Abril,Ucrania,4,3,,7,POINT (6170465 -7542726)
2019,Abril,Ucrania,1,0,,1,POINT (863337 -7735002)
2019,Abril,Ucrania,0,3,,3,POINT (9402597 -75681642)
2019,Abril,Uganda,2,3,,5,POINT (4697157 -74140516)
2019,Abril,Uruguay,0,1,,1,POINT (-4191162 -69941498)
2019,Abril,Uruguay,0,4,,4,POINT (-4214082 -69941431)
2019,Abril,Uruguay,1,4,,5,POINT (0.33002 -76876446)
2019,Abril,Uruguay,3,8,,11,POINT (0.81488 -77356)
2019,Abril,Uruguay,24,24,,48,POINT (10406342 -75527794)
2019,Abril,Uruguay,164,146,,310,POINT (10446304 -75516486)
2019,Abril,Uruguay,3,11,,14,POINT (10886686 -74776479)
2019,Abril,Uruguay,5,2,,7,POINT (11360029 -72129595)
2019,Abril,Uruguay,28,24,,52,POINT (125862 -81702165)
2019,Abril,Uruguay,43,65,,108,POINT (3451668 -76532004)
2019,Abril,Uruguay,319,411,,730,POINT (4697157 -74140516)
2019,Abril,Uruguay,0,1,,1,POINT (4815189 -75736374)
2019,Abril,Uruguay,39,66,,105,POINT (6170465 -7542726)
2019,Abril,Uruguay,0,2,,2,POINT (7088729 -70740253)
2019,Abril,Uruguay,0,1,,1,POINT (7128047 -73181317)
2019,Abril,Uruguay,3,9,,12,POINT (7819 -72453013)
2019,Abril,Uzbekistán,1,1,,2,POINT (3451668 -76532004)
2019,Abril,Uzbekistán,0,1,,1,POINT (6170465 -7542726)
2019,Abril,Venezuela,3,4,,7,POINT (-4191162 -69941498)
2019,Abril,Venezuela,5,8,,13,POINT (-4214082 -69941431)
2019,Abril,Venezuela,0,2,,2,POINT (0.185957 -7478366)
2019,Abril,Venezuela,131,118,,249,POINT (0.33002 -76876446)
2019,Abril,Venezuela,3330,3554,,6884,POINT (0.81488 -77356)
2019,Abril,Venezuela,4,9,,13,POINT (1800143 -78802679)
2019,Abril,Venezuela,22,17,,39,POINT (10406342 -75527794)
2019,Abril,Venezuela,10,36,,46,POINT (10433609 -73247863)
2019,Abril,Venezuela,205,271,,476,POINT (10446304 -75516486)
2019,Abril,Venezuela,270,329,,599,POINT (10886686 -74776479)
2019,Abril,Venezuela,0,5,,5,POINT (10970933 -74765343)
2019,Abril,Venezuela,23,63,,86,POINT (11117206 -74232675)
2019,Abril,Venezuela,9801,8584,,18385,POINT (11360029 -72129595)
2019,Abril,Venezuela,0,1,,1,POINT (12165168 -71983761)
2019,Abril,Venezuela,0,1,,1,POINT (125744111 -81703935)
2019,Abril,Venezuela,4,3,,7,POINT (125862 -81702165)
2019,Abril,Venezuela,243,225,,468,POINT (3451668 -76532004)
2019,Abril,Venezuela,21,10,,31,POINT (3866713 -67927521)
2019,Abril,Venezuela,1,0,,1,POINT (445285 -75766353)
2019,Abril,Venezuela,7563,7510,,15073,POINT (4697157 -74140516)
2019,Abril,Venezuela,7,14,,21,POINT (4815189 -75736374)
2019,Abril,Venezuela,1009,951,,1960,POINT (6170465 -7542726)
2019,Abril,Venezuela,43,37,,80,POINT (6185536 -67484028)
2019,Abril,Venezuela,517,465,,982,POINT (7088729 -70740253)
2019,Abril,Venezuela,13,4,,17,POINT (7128047 -73181317)
2019,Abril,Venezuela,27906,24989,,52895,POINT (7819 -72453013)
2019,Abril,Venezuela,15,30,,45,POINT (7927233 -72508188)
2019,Abril,Venezuela,1239,1001,,2240,POINT (836068 -72409396)
2019,Abril,Vietnam,0,1,,1,POINT (11360029 -72129595)
2019,Abril,Vietnam,7,2,,9,POINT (4697157 -74140516)
2019,Abril,Vietnam,1,1,,2,POINT (6170465 -7542726)
2019,Abril,República Árabe de Yemen,0,2,,2,POINT (10446304 -75516486)
2019,Abril,República Árabe de Yemen,0,1,,1,POINT (4697157 -74140516)
2019,Abril,Zambia,0,1,,1,POINT (6170465 -7542726)
2019,Abril,Zimbabue,1,2,,3,POINT (4697157 -74140516)
2019,Abril,Islas Turcas y Caicos/Territorio Británico de Ultramar,2,0,,2,POINT (10446304 -75516486)
2019,Abril,Refugiado,0,1,,1,POINT (4697157 -74140516)
2019,Abril,Desconocido,0,4,,4,POINT (10446304 -75516486)
2019,Abril,Desconocido,2,1,,3,POINT (3451668 -76532004)
2019,Abril,Desconocido,89,158,,247,POINT (4697157 -74140516)
2019,Abril,Desconocido,2,3,,5,POINT (6170465 -7542726)
2019,Mayo,Afganistán,0,2,,2,POINT (4697157 -74140516)
2019,Mayo,Afganistán,0,1,,1,POINT (6170465 -7542726)
2019,Mayo,Albania,0,2,,2,POINT (3451668 -76532004)
2019,Mayo,Albania,7,7,,14,POINT (4697157 -74140516)
2019,Mayo,Albania,1,2,,3,POINT (6170465 -7542726)
2019,Mayo,Alemania,7,12,,19,POINT (-4191162 -69941498)
2019,Mayo,Alemania,15,21,,36,POINT (-4214082 -69941431)
2019,Mayo,Alemania,5,9,,14,POINT (0.33002 -76876446)
2019,Mayo,Alemania,95,106,,201,POINT (0.81488 -77356)
2019,Mayo,Alemania,32,22,,54,POINT (10406342 -75527794)
2019,Mayo,Alemania,85,119,,204,POINT (10446304 -75516486)
2019,Mayo,Alemania,10,23,,33,POINT (10886686 -74776479)
2019,Mayo,Alemania,0,2,,2,POINT (11247723 -74213989)
2019,Mayo,Alemania,2,2,,4,POINT (11360029 -72129595)
2019,Mayo,Alemania,4,5,,9,POINT (125862 -81702165)
2019,Mayo,Alemania,4,4,,8,POINT (133387613 -81372937)
2019,Mayo,Alemania,51,89,,140,POINT (3451668 -76532004)
2019,Mayo,Alemania,0,2,,2,POINT (3884426 -77061029)
2019,Mayo,Alemania,1349,2149,,3498,POINT (4697157 -74140516)
2019,Mayo,Alemania,9,7,,16,POINT (4815189 -75736374)
2019,Mayo,Alemania,147,260,,407,POINT (6170465 -7542726)
2019,Mayo,Alemania,0,1,,1,POINT (7128047 -73181317)
2019,Mayo,Alemania,3,4,,7,POINT (7819 -72453013)
2019,Mayo,Alemania,11,10,,21,POINT (863337 -7735002)
2019,Mayo,Andorra,2,7,,9,POINT (4697157 -74140516)
2019,Mayo,Angola,1,1,,2,POINT (10446304 -75516486)
2019,Mayo,Angola,0,7,,7,POINT (4697157 -74140516)
2019,Mayo,Antigua y Barbuda,0,1,,1,POINT (10446304 -75516486)
2019,Mayo,Antigua y Barbuda,1,1,,2,POINT (10886686 -74776479)
2019,Mayo,Antigua y Barbuda,2,2,,4,POINT (4697157 -74140516)
2019,Mayo,Países Bajos,0,1,,1,POINT (4697157 -74140516)
2019,Mayo,Arabia Saudita,1,4,,5,POINT (4697157 -74140516)
2019,Mayo,Arabia Saudita,0,3,,3,POINT (6170465 -7542726)
2019,Mayo,Argelia,3,2,,5,POINT (4697157 -74140516)
2019,Mayo,Argentina,6,4,,10,POINT (-4191162 -69941498)
2019,Mayo,Argentina,18,19,,37,POINT (-4214082 -69941431)
2019,Mayo,Argentina,12,15,,27,POINT (0.33002 -76876446)
2019,Mayo,Argentina,91,151,,242,POINT (0.81488 -77356)
2019,Mayo,Argentina,525,291,,816,POINT (10406342 -75527794)
2019,Mayo,Argentina,1756,1280,,3036,POINT (10446304 -75516486)
2019,Mayo,Argentina,16,48,,64,POINT (10886686 -74776479)
2019,Mayo,Argentina,2,13,,15,POINT (11360029 -72129595)
2019,Mayo,Argentina,0,5,,5,POINT (125744111 -81703935)
2019,Mayo,Argentina,159,124,,283,POINT (125862 -81702165)
2019,Mayo,Argentina,91,156,,247,POINT (3451668 -76532004)
2019,Mayo,Argentina,4330,5631,,9961,POINT (4697157 -74140516)
2019,Mayo,Argentina,2,14,,16,POINT (4815189 -75736374)
2019,Mayo,Argentina,173,485,,658,POINT (6170465 -7542726)
2019,Mayo,Argentina,1,0,,1,POINT (7088729 -70740253)
2019,Mayo,Argentina,2,4,,6,POINT (7128047 -73181317)
2019,Mayo,Argentina,3,6,,9,POINT (7819 -72453013)
2019,Mayo,Argentina,2,0,,2,POINT (836068 -72409396)
2019,Mayo,Argentina,0,1,,1,POINT (863337 -7735002)
2019,Mayo,República de Armenia,2,1,,3,POINT (4697157 -74140516)
2019,Mayo,República de Armenia,0,1,,1,POINT (6170465 -7542726)
2019,Mayo,Australia,1,0,,1,POINT (-4191162 -69941498)
2019,Mayo,Australia,0,6,,6,POINT (-4214082 -69941431)
2019,Mayo,Australia,0,1,,1,POINT (0.33002 -76876446)
2019,Mayo,Australia,18,15,,33,POINT (0.81488 -77356)
2019,Mayo,Australia,11,14,,25,POINT (10406342 -75527794)
2019,Mayo,Australia,35,45,,80,POINT (10446304 -75516486)
2019,Mayo,Australia,1,15,,16,POINT (10886686 -74776479)
2019,Mayo,Australia,2,0,,2,POINT (125862 -81702165)
2019,Mayo,Australia,5,17,,22,POINT (3451668 -76532004)
2019,Mayo,Australia,296,521,,817,POINT (4697157 -74140516)
2019,Mayo,Australia,0,2,,2,POINT (4815189 -75736374)
2019,Mayo,Australia,43,78,,121,POINT (6170465 -7542726)
2019,Mayo,Australia,0,1,,1,POINT (7128047 -73181317)
2019,Mayo,Australia,13,13,,26,POINT (863337 -7735002)
2019,Mayo,Austria,1,1,,2,POINT (-4191162 -69941498)
2019,Mayo,Austria,1,0,,1,POINT (0.33002 -76876446)
2019,Mayo,Austria,4,8,,12,POINT (0.81488 -77356)
2019,Mayo,Austria,2,6,,8,POINT (10406342 -75527794)
2019,Mayo,Austria,9,12,,21,POINT (10446304 -75516486)
2019,Mayo,Austria,1,3,,4,POINT (10886686 -74776479)
2019,Mayo,Austria,0,1,,1,POINT (11360029 -72129595)
2019,Mayo,Austria,5,13,,18,POINT (3451668 -76532004)
2019,Mayo,Austria,116,218,,334,POINT (4697157 -74140516)
2019,Mayo,Austria,0,1,,1,POINT (4815189 -75736374)
2019,Mayo,Austria,9,32,,41,POINT (6170465 -7542726)
2019,Mayo,Austria,0,1,,1,POINT (863337 -7735002)
2019,Mayo,Azerbaiyán,0,1,,1,POINT (0.81488 -77356)
2019,Mayo,Azerbaiyán,0,1,,1,POINT (10446304 -75516486)
2019,Mayo,Azerbaiyán,1,0,,1,POINT (3451668 -76532004)
2019,Mayo,Azerbaiyán,1,10,,11,POINT (4697157 -74140516)
2019,Mayo,Azerbaiyán,1,1,,2,POINT (6170465 -7542726)
2019,Mayo,Bahamas,1,0,,1,POINT (0.81488 -77356)
2019,Mayo,Bahamas,1,3,,4,POINT (10446304 -75516486)
2019,Mayo,Bahamas,1,1,,2,POINT (3451668 -76532004)
2019,Mayo,Bahamas,16,14,,30,POINT (4697157 -74140516)
2019,Mayo,Bahamas,0,6,,6,POINT (6170465 -7542726)
2019,Mayo,Bahréin,0,1,,1,POINT (10446304 -75516486)
2019,Mayo,Bahréin,0,2,,2,POINT (4697157 -74140516)
2019,Mayo,Bangladesh,0,1,,1,POINT (4697157 -74140516)
2019,Mayo,Barbados,4,3,,7,POINT (10446304 -75516486)
2019,Mayo,Barbados,1,3,,4,POINT (10886686 -74776479)
2019,Mayo,Barbados,0,1,,1,POINT (3451668 -76532004)
2019,Mayo,Barbados,6,10,,16,POINT (4697157 -74140516)
2019,Mayo,Barbados,1,0,,1,POINT (6170465 -7542726)
2019,Mayo,República de Belarús,3,8,,11,POINT (4697157 -74140516)
2019,Mayo,República de Belarús,0,2,,2,POINT (7819 -72453013)
2019,Mayo,Bélgica,2,1,,3,POINT (-4214082 -69941431)
2019,Mayo,Bélgica,0,1,,1,POINT (0.33002 -76876446)
2019,Mayo,Bélgica,12,19,,31,POINT (0.81488 -77356)
2019,Mayo,Bélgica,4,3,,7,POINT (10406342 -75527794)
2019,Mayo,Bélgica,16,23,,39,POINT (10446304 -75516486)
2019,Mayo,Bélgica,2,4,,6,POINT (10886686 -74776479)
2019,Mayo,Bélgica,9,17,,26,POINT (3451668 -76532004)
2019,Mayo,Bélgica,166,333,,499,POINT (4697157 -74140516)
2019,Mayo,Bélgica,0,1,,1,POINT (4815189 -75736374)
2019,Mayo,Bélgica,25,43,,68,POINT (6170465 -7542726)
2019,Mayo,Bélgica,0,1,,1,POINT (7128047 -73181317)
2019,Mayo,Bélgica,1,1,,2,POINT (863337 -7735002)
2019,Mayo,Belice,1,0,,1,POINT (-4214082 -69941431)
2019,Mayo,Belice,1,1,,2,POINT (10446304 -75516486)
2019,Mayo,Belice,0,2,,2,POINT (125744111 -81703935)
2019,Mayo,Belice,1,0,,1,POINT (125862 -81702165)
2019,Mayo,Belice,2,3,,5,POINT (3451668 -76532004)
2019,Mayo,Belice,15,14,,29,POINT (4697157 -74140516)
2019,Mayo,Belice,8,11,,19,POINT (6170465 -7542726)
2019,Mayo,Bermudas/Territorio Británico de Ultramar,0,1,,1,POINT (10446304 -75516486)
2019,Mayo,Bermudas/Territorio Británico de Ultramar,1,3,,4,POINT (4697157 -74140516)
2019,Mayo,Bermudas/Territorio Británico de Ultramar,0,3,,3,POINT (6170465 -7542726)
2019,Mayo,Bolivia,0,3,,3,POINT (-4191162 -69941498)
2019,Mayo,Bolivia,1,0,,1,POINT (-4214082 -69941431)
2019,Mayo,Bolivia,11,22,,33,POINT (0.81488 -77356)
2019,Mayo,Bolivia,21,10,,31,POINT (10406342 -75527794)
2019,Mayo,Bolivia,92,75,,167,POINT (10446304 -75516486)
2019,Mayo,Bolivia,1,3,,4,POINT (10886686 -74776479)
2019,Mayo,Bolivia,22,5,,27,POINT (125862 -81702165)
2019,Mayo,Bolivia,15,27,,42,POINT (3451668 -76532004)
2019,Mayo,Bolivia,641,736,,1377,POINT (4697157 -74140516)
2019,Mayo,Bolivia,39,42,,81,POINT (6170465 -7542726)
2019,Mayo,Bolivia,1,0,,1,POINT (7128047 -73181317)
2019,Mayo,Bolivia,1,0,,1,POINT (7819 -72453013)
2019,Mayo,Bolivia,1,0,,1,POINT (836068 -72409396)
2019,Mayo,Bolivia,1,0,,1,POINT (863337 -7735002)
2019,Mayo,Bosnia y Herzegovina,2,1,,3,POINT (10446304 -75516486)
2019,Mayo,Bosnia y Herzegovina,7,6,,13,POINT (4697157 -74140516)
2019,Mayo,Botsuana,3,1,,4,POINT (4697157 -74140516)
2019,Mayo,Brasil,137,117,,254,POINT (-4191162 -69941498)
2019,Mayo,Brasil,6,6,,12,POINT (-4214082 -69941431)
2019,Mayo,Brasil,0,1,,1,POINT (0.33002 -76876446)
2019,Mayo,Brasil,23,28,,51,POINT (0.81488 -77356)
2019,Mayo,Brasil,405,276,,681,POINT (10406342 -75527794)
2019,Mayo,Brasil,648,494,,1142,POINT (10446304 -75516486)
2019,Mayo,Brasil,20,43,,63,POINT (10886686 -74776479)
2019,Mayo,Brasil,2,1,,3,POINT (11247723 -74213989)
2019,Mayo,Brasil,2,5,,7,POINT (11360029 -72129595)
2019,Mayo,Brasil,199,157,,356,POINT (125862 -81702165)
2019,Mayo,Brasil,2,2,,4,POINT (133387613 -81372937)
2019,Mayo,Brasil,100,170,,270,POINT (3451668 -76532004)
2019,Mayo,Brasil,1,2,,3,POINT (3866713 -67927521)
2019,Mayo,Brasil,4329,5556,,9885,POINT (4697157 -74140516)
2019,Mayo,Brasil,1,17,,18,POINT (4815189 -75736374)
2019,Mayo,Brasil,138,336,,474,POINT (6170465 -7542726)
2019,Mayo,Brasil,2,3,,5,POINT (6185536 -67484028)
2019,Mayo,Brasil,1,1,,2,POINT (7128047 -73181317)
2019,Mayo,Brasil,2,1,,3,POINT (7819 -72453013)
2019,Mayo,Brasil,2,0,,2,POINT (836068 -72409396)
2019,Mayo,Brunei Darussalam,1,0,,1,POINT (10446304 -75516486)
2019,Mayo,Bulgaria,1,0,,1,POINT (0.81488 -77356)
2019,Mayo,Bulgaria,0,2,,2,POINT (10406342 -75527794)
2019,Mayo,Bulgaria,4,4,,8,POINT (10446304 -75516486)
2019,Mayo,Bulgaria,0,1,,1,POINT (3451668 -76532004)
2019,Mayo,Bulgaria,0,1,,1,POINT (3884426 -77061029)
2019,Mayo,Bulgaria,25,31,,56,POINT (4697157 -74140516)
2019,Mayo,Bulgaria,4,6,,10,POINT (6170465 -7542726)
2019,Mayo,Bulgaria,0,1,,1,POINT (836068 -72409396)
2019,Mayo,Burkina Faso,0,1,,1,POINT (4697157 -74140516)
2019,Mayo,Islas Caimán/Territorio Británico de Ultramar,1,0,,1,POINT (4697157 -74140516)
2019,Mayo,Camerún,1,0,,1,POINT (10446304 -75516486)
2019,Mayo,Camerún,2,3,,5,POINT (4697157 -74140516)
2019,Mayo,Guernsey,0,1,,1,POINT (10886686 -74776479)
2019,Mayo,Canadá,1,0,,1,POINT (-4191162 -69941498)
2019,Mayo,Canadá,1,0,,1,POINT (-4214082 -69941431)
2019,Mayo,Canadá,8,16,,24,POINT (0.81488 -77356)
2019,Mayo,Canadá,8,7,,15,POINT (10406342 -75527794)
2019,Mayo,Canadá,178,320,,498,POINT (10446304 -75516486)
2019,Mayo,Canadá,15,29,,44,POINT (10886686 -74776479)
2019,Mayo,Canadá,0,2,,2,POINT (11360029 -72129595)
2019,Mayo,Canadá,0,2,,2,POINT (125744111 -81703935)
2019,Mayo,Canadá,5,5,,10,POINT (125862 -81702165)
2019,Mayo,Canadá,0,3,,3,POINT (133387613 -81372937)
2019,Mayo,Canadá,73,81,,154,POINT (3451668 -76532004)
2019,Mayo,Canadá,0,1,,1,POINT (3884426 -77061029)
2019,Mayo,Canadá,1384,2177,,3561,POINT (4697157 -74140516)
2019,Mayo,Canadá,8,13,,21,POINT (4815189 -75736374)
2019,Mayo,Canadá,171,460,,631,POINT (6170465 -7542726)
2019,Mayo,Canadá,1,4,,5,POINT (7128047 -73181317)
2019,Mayo,Canadá,0,1,,1,POINT (7819 -72453013)
2019,Mayo,Canadá,3,4,,7,POINT (863337 -7735002)
2019,Mayo,Chad,1,0,,1,POINT (4697157 -74140516)
2019,Mayo,República Del Congo,0,3,,3,POINT (4697157 -74140516)
2019,Mayo,República Democrática del Congo,0,7,,7,POINT (4697157 -74140516)
2019,Mayo,República de Corea,3,3,,6,POINT (-4214082 -69941431)
2019,Mayo,República de Corea,16,9,,25,POINT (0.81488 -77356)
2019,Mayo,República de Corea,1,0,,1,POINT (10406342 -75527794)
2019,Mayo,República de Corea,6,19,,25,POINT (10446304 -75516486)
2019,Mayo,República de Corea,2,4,,6,POINT (10886686 -74776479)
2019,Mayo,República de Corea,0,5,,5,POINT (11247723 -74213989)
2019,Mayo,República de Corea,0,1,,1,POINT (125862 -81702165)
2019,Mayo,República de Corea,11,6,,17,POINT (3451668 -76532004)
2019,Mayo,República de Corea,182,489,,671,POINT (4697157 -74140516)
2019,Mayo,República de Corea,24,52,,76,POINT (6170465 -7542726)
2019,Mayo,Costa de Marfil,1,0,,1,POINT (10446304 -75516486)
2019,Mayo,Costa de Marfil,2,1,,3,POINT (4697157 -74140516)
2019,Mayo,Costa Rica,1,0,,1,POINT (-4191162 -69941498)
2019,Mayo,Costa Rica,4,2,,6,POINT (0.81488 -77356)
2019,Mayo,Costa Rica,0,5,,5,POINT (1800143 -78802679)
2019,Mayo,Costa Rica,4,4,,8,POINT (10406342 -75527794)
2019,Mayo,Costa Rica,154,162,,316,POINT (10446304 -75516486)
2019,Mayo,Costa Rica,13,32,,45,POINT (10886686 -74776479)
2019,Mayo,Costa Rica,0,2,,2,POINT (11247723 -74213989)
2019,Mayo,Costa Rica,1,0,,1,POINT (11360029 -72129595)
2019,Mayo,Costa Rica,190,142,,332,POINT (125862 -81702165)
2019,Mayo,Costa Rica,53,83,,136,POINT (3451668 -76532004)
2019,Mayo,Costa Rica,0,2,,2,POINT (3884426 -77061029)
2019,Mayo,Costa Rica,0,1,,1,POINT (445285 -75766353)
2019,Mayo,Costa Rica,1089,1502,,2591,POINT (4697157 -74140516)
2019,Mayo,Costa Rica,3,17,,20,POINT (4815189 -75736374)
2019,Mayo,Costa Rica,135,285,,420,POINT (6170465 -7542726)
2019,Mayo,Costa Rica,0,1,,1,POINT (7128047 -73181317)
2019,Mayo,Costa Rica,2,2,,4,POINT (7819 -72453013)
2019,Mayo,Costa Rica,0,1,,1,POINT (836068 -72409396)
2019,Mayo,Croacia,0,1,,1,POINT (-4191162 -69941498)
2019,Mayo,Croacia,0,1,,1,POINT (-4214082 -69941431)
2019,Mayo,Croacia,0,1,,1,POINT (0.81488 -77356)
2019,Mayo,Croacia,0,2,,2,POINT (10406342 -75527794)
2019,Mayo,Croacia,2,10,,12,POINT (10446304 -75516486)
2019,Mayo,Croacia,0,1,,1,POINT (11360029 -72129595)
2019,Mayo,Croacia,1,1,,2,POINT (3451668 -76532004)
2019,Mayo,Croacia,17,31,,48,POINT (4697157 -74140516)
2019,Mayo,Croacia,4,4,,8,POINT (6170465 -7542726)
2019,Mayo,Cuba,0,1,,1,POINT (-4191162 -69941498)
2019,Mayo,Cuba,0,1,,1,POINT (0.81488 -77356)
2019,Mayo,Cuba,15,13,,28,POINT (10446304 -75516486)
2019,Mayo,Cuba,22,45,,67,POINT (10886686 -74776479)
2019,Mayo,Cuba,1,1,,2,POINT (11360029 -72129595)
2019,Mayo,Cuba,0,1,,1,POINT (125862 -81702165)
2019,Mayo,Cuba,27,35,,62,POINT (3451668 -76532004)
2019,Mayo,Cuba,187,339,,526,POINT (4697157 -74140516)
2019,Mayo,Cuba,0,5,,5,POINT (4815189 -75736374)
2019,Mayo,Cuba,11,26,,37,POINT (6170465 -7542726)
2019,Mayo,Cuba,0,1,,1,POINT (6185536 -67484028)
2019,Mayo,Cuba,1,5,,6,POINT (7128047 -73181317)
2019,Mayo,República Checa,1,1,,2,POINT (-4214082 -69941431)
2019,Mayo,República Checa,7,13,,20,POINT (0.81488 -77356)
2019,Mayo,República Checa,3,10,,13,POINT (10446304 -75516486)
2019,Mayo,República Checa,0,1,,1,POINT (10886686 -74776479)
2019,Mayo,República Checa,2,1,,3,POINT (3451668 -76532004)
2019,Mayo,República Checa,33,72,,105,POINT (4697157 -74140516)
2019,Mayo,República Checa,0,7,,7,POINT (6170465 -7542726)
2019,Mayo,Chile,0,1,,1,POINT (-4191162 -69941498)
2019,Mayo,Chile,1,3,,4,POINT (-4214082 -69941431)
2019,Mayo,Chile,0,3,,3,POINT (0.33002 -76876446)
2019,Mayo,Chile,34,52,,86,POINT (0.81488 -77356)
2019,Mayo,Chile,176,119,,295,POINT (10406342 -75527794)
2019,Mayo,Chile,367,292,,659,POINT (10446304 -75516486)
2019,Mayo,Chile,9,13,,22,POINT (10886686 -74776479)
2019,Mayo,Chile,0,2,,2,POINT (11117206 -74232675)
2019,Mayo,Chile,2,4,,6,POINT (11360029 -72129595)
2019,Mayo,Chile,179,113,,292,POINT (125862 -81702165)
2019,Mayo,Chile,100,161,,261,POINT (3451668 -76532004)
2019,Mayo,Chile,1,0,,1,POINT (445285 -75766353)
2019,Mayo,Chile,3951,5036,,8987,POINT (4697157 -74140516)
2019,Mayo,Chile,3,14,,17,POINT (4815189 -75736374)
2019,Mayo,Chile,72,190,,262,POINT (6170465 -7542726)
2019,Mayo,Chile,0,1,,1,POINT (6185536 -67484028)
2019,Mayo,Chile,3,1,,4,POINT (7128047 -73181317)
2019,Mayo,Chile,5,20,,25,POINT (7819 -72453013)
2019,Mayo,Chile,1,3,,4,POINT (836068 -72409396)
2019,Mayo,China,3,8,,11,POINT (0.81488 -77356)
2019,Mayo,China,1,2,,3,POINT (10406342 -75527794)
2019,Mayo,China,35,19,,54,POINT (10446304 -75516486)
2019,Mayo,China,3,23,,26,POINT (10886686 -74776479)
2019,Mayo,China,0,5,,5,POINT (10970933 -74765343)
2019,Mayo,China,0,3,,3,POINT (11247723 -74213989)
2019,Mayo,China,13,30,,43,POINT (3451668 -76532004)
2019,Mayo,China,0,3,,3,POINT (3884426 -77061029)
2019,Mayo,China,466,1042,,1508,POINT (4697157 -74140516)
2019,Mayo,China,1,1,,2,POINT (4815189 -75736374)
2019,Mayo,China,46,95,,141,POINT (6170465 -7542726)
2019,Mayo,China,1,4,,5,POINT (7819 -72453013)
2019,Mayo,China,1,0,,1,POINT (863337 -7735002)
2019,Mayo,Taiwán,1,0,,1,POINT (-4214082 -69941431)
2019,Mayo,Taiwán,2,0,,2,POINT (0.81488 -77356)
2019,Mayo,Taiwán,5,4,,9,POINT (10446304 -75516486)
2019,Mayo,Taiwán,0,1,,1,POINT (10886686 -74776479)
2019,Mayo,Taiwán,2,5,,7,POINT (3451668 -76532004)
2019,Mayo,Taiwán,66,96,,162,POINT (4697157 -74140516)
2019,Mayo,Taiwán,0,1,,1,POINT (4815189 -75736374)
2019,Mayo,Taiwán,10,9,,19,POINT (6170465 -7542726)
2019,Mayo,Chipre,1,0,,1,POINT (0.81488 -77356)
2019,Mayo,Chipre,1,1,,2,POINT (10446304 -75516486)
2019,Mayo,Chipre,1,0,,1,POINT (3451668 -76532004)
2019,Mayo,Chipre,3,5,,8,POINT (4697157 -74140516)
2019,Mayo,Chipre,0,1,,1,POINT (6170465 -7542726)
2019,Mayo,Dinamarca,0,1,,1,POINT (-4191162 -69941498)
2019,Mayo,Dinamarca,1,1,,2,POINT (-4214082 -69941431)
2019,Mayo,Dinamarca,3,0,,3,POINT (0.33002 -76876446)
2019,Mayo,Dinamarca,5,5,,10,POINT (0.81488 -77356)
2019,Mayo,Dinamarca,3,7,,10,POINT (10406342 -75527794)
2019,Mayo,Dinamarca,7,14,,21,POINT (10446304 -75516486)
2019,Mayo,Dinamarca,0,2,,2,POINT (10886686 -74776479)
2019,Mayo,Dinamarca,1,2,,3,POINT (11247723 -74213989)
2019,Mayo,Dinamarca,0,1,,1,POINT (125862 -81702165)
2019,Mayo,Dinamarca,1,17,,18,POINT (3451668 -76532004)
2019,Mayo,Dinamarca,62,119,,181,POINT (4697157 -74140516)
2019,Mayo,Dinamarca,8,32,,40,POINT (6170465 -7542726)
2019,Mayo,Dinamarca,0,1,,1,POINT (7128047 -73181317)
2019,Mayo,Dominica,0,1,,1,POINT (10446304 -75516486)
2019,Mayo,Dominica,1,2,,3,POINT (3451668 -76532004)
2019,Mayo,Dominica,4,2,,6,POINT (4697157 -74140516)
2019,Mayo,Dominica,0,3,,3,POINT (6170465 -7542726)
2019,Mayo,Ecuador,0,10,,10,POINT (-4214082 -69941431)
2019,Mayo,Ecuador,76,229,,305,POINT (0.33002 -76876446)
2019,Mayo,Ecuador,4,0,,4,POINT (0.812436 -77847006)
2019,Mayo,Ecuador,1398,2112,,3510,POINT (0.81488 -77356)
2019,Mayo,Ecuador,9,15,,24,POINT (1800143 -78802679)
2019,Mayo,Ecuador,6,10,,16,POINT (10406342 -75527794)
2019,Mayo,Ecuador,66,78,,144,POINT (10446304 -75516486)
2019,Mayo,Ecuador,9,19,,28,POINT (10886686 -74776479)
2019,Mayo,Ecuador,4,10,,14,POINT (11360029 -72129595)
2019,Mayo,Ecuador,9,14,,23,POINT (125862 -81702165)
2019,Mayo,Ecuador,461,461,,922,POINT (3451668 -76532004)
2019,Mayo,Ecuador,1,3,,4,POINT (3866713 -67927521)
2019,Mayo,Ecuador,0,1,,1,POINT (445285 -75766353)
2019,Mayo,Ecuador,2814,3664,,6478,POINT (4697157 -74140516)
2019,Mayo,Ecuador,3,1,,4,POINT (4815189 -75736374)
2019,Mayo,Ecuador,58,94,,152,POINT (6170465 -7542726)
2019,Mayo,Ecuador,0,1,,1,POINT (7128047 -73181317)
2019,Mayo,Ecuador,46,52,,98,POINT (7819 -72453013)
2019,Mayo,Ecuador,1,3,,4,POINT (836068 -72409396)
2019,Mayo,Egipto,0,3,,3,POINT (10446304 -75516486)
2019,Mayo,Egipto,5,17,,22,POINT (4697157 -74140516)
2019,Mayo,El Salvador,1,1,,2,POINT (0.81488 -77356)
2019,Mayo,El Salvador,0,1,,1,POINT (10406342 -75527794)
2019,Mayo,El Salvador,314,273,,587,POINT (10446304 -75516486)
2019,Mayo,El Salvador,5,5,,10,POINT (10886686 -74776479)
2019,Mayo,El Salvador,1,2,,3,POINT (125862 -81702165)
2019,Mayo,El Salvador,57,60,,117,POINT (3451668 -76532004)
2019,Mayo,El Salvador,2,0,,2,POINT (445285 -75766353)
2019,Mayo,El Salvador,589,785,,1374,POINT (4697157 -74140516)
2019,Mayo,El Salvador,1,5,,6,POINT (4815189 -75736374)
2019,Mayo,El Salvador,82,136,,218,POINT (6170465 -7542726)
2019,Mayo,El Salvador,0,1,,1,POINT (7819 -72453013)
2019,Mayo,Emiratos Árabes,1,5,,6,POINT (4697157 -74140516)
2019,Mayo,Emiratos Árabes,0,2,,2,POINT (6170465 -7542726)
2019,Mayo,España,3,6,,9,POINT (-4191162 -69941498)
2019,Mayo,España,4,16,,20,POINT (-4214082 -69941431)
2019,Mayo,España,5,5,,10,POINT (0.33002 -76876446)
2019,Mayo,España,24,56,,80,POINT (0.81488 -77356)
2019,Mayo,España,2,0,,2,POINT (1800143 -78802679)
2019,Mayo,España,8,18,,26,POINT (10406342 -75527794)
2019,Mayo,España,86,128,,214,POINT (10446304 -75516486)
2019,Mayo,España,6,32,,38,POINT (10886686 -74776479)
2019,Mayo,España,0,1,,1,POINT (10970933 -74765343)
2019,Mayo,España,1,0,,1,POINT (11247723 -74213989)
2019,Mayo,España,11,16,,27,POINT (11360029 -72129595)
2019,Mayo,España,2,2,,4,POINT (125744111 -81703935)
2019,Mayo,España,11,7,,18,POINT (125862 -81702165)
2019,Mayo,España,1,0,,1,POINT (133387613 -81372937)
2019,Mayo,España,155,310,,465,POINT (3451668 -76532004)
2019,Mayo,España,0,1,,1,POINT (445285 -75766353)
2019,Mayo,España,2454,5635,,8089,POINT (4697157 -74140516)
2019,Mayo,España,6,19,,25,POINT (4815189 -75736374)
2019,Mayo,España,281,592,,873,POINT (6170465 -7542726)
2019,Mayo,España,1,1,,2,POINT (7088729 -70740253)
2019,Mayo,España,1,2,,3,POINT (7128047 -73181317)
2019,Mayo,España,26,51,,77,POINT (7819 -72453013)
2019,Mayo,España,5,8,,13,POINT (836068 -72409396)
2019,Mayo,España,1,2,,3,POINT (863337 -7735002)
2019,Mayo,Eslovaquia,0,2,,2,POINT (0.81488 -77356)
2019,Mayo,Eslovaquia,5,4,,9,POINT (10446304 -75516486)
2019,Mayo,Eslovaquia,0,1,,1,POINT (11360029 -72129595)
2019,Mayo,Eslovaquia,33,46,,79,POINT (4697157 -74140516)
2019,Mayo,Eslovaquia,0,1,,1,POINT (4815189 -75736374)
2019,Mayo,Eslovaquia,2,1,,3,POINT (6170465 -7542726)
2019,Mayo,Eslovenia,0,1,,1,POINT (10446304 -75516486)
2019,Mayo,Eslovenia,0,1,,1,POINT (10886686 -74776479)
2019,Mayo,Eslovenia,14,19,,33,POINT (4697157 -74140516)
2019,Mayo,Eslovenia,2,5,,7,POINT (6170465 -7542726)
2019,Mayo,Estados Unidos de América,15,22,,37,POINT (-4191162 -69941498)
2019,Mayo,Estados Unidos de América,29,24,,53,POINT (-4214082 -69941431)
2019,Mayo,Estados Unidos de América,0,2,,2,POINT (0.33002 -76876446)
2019,Mayo,Estados Unidos de América,34,60,,94,POINT (0.81488 -77356)
2019,Mayo,Estados Unidos de América,27,55,,82,POINT (10406342 -75527794)
2019,Mayo,Estados Unidos de América,4995,7001,,11996,POINT (10446304 -75516486)
2019,Mayo,Estados Unidos de América,619,1081,,1700,POINT (10886686 -74776479)
2019,Mayo,Estados Unidos de América,0,1,,1,POINT (10970933 -74765343)
2019,Mayo,Estados Unidos de América,8,8,,16,POINT (11360029 -72129595)
2019,Mayo,Estados Unidos de América,0,8,,8,POINT (125744111 -81703935)
2019,Mayo,Estados Unidos de América,37,46,,83,POINT (125862 -81702165)
2019,Mayo,Estados Unidos de América,2,10,,12,POINT (133387613 -81372937)
2019,Mayo,Estados Unidos de América,1767,2446,,4213,POINT (3451668 -76532004)
2019,Mayo,Estados Unidos de América,180,226,,406,POINT (445285 -75766353)
2019,Mayo,Estados Unidos de América,10295,17583,,27878,POINT (4697157 -74140516)
2019,Mayo,Estados Unidos de América,255,386,,641,POINT (4815189 -75736374)
2019,Mayo,Estados Unidos de América,3608,8797,,12405,POINT (6170465 -7542726)
2019,Mayo,Estados Unidos de América,1,0,,1,POINT (6185536 -67484028)
2019,Mayo,Estados Unidos de América,0,2,,2,POINT (6218835 -75586989)
2019,Mayo,Estados Unidos de América,1,0,,1,POINT (7088729 -70740253)
2019,Mayo,Estados Unidos de América,27,64,,91,POINT (7128047 -73181317)
2019,Mayo,Estados Unidos de América,10,13,,23,POINT (7819 -72453013)
2019,Mayo,Estados Unidos de América,0,1,,1,POINT (7927233 -72508188)
2019,Mayo,Estados Unidos de América,3,4,,7,POINT (836068 -72409396)
2019,Mayo,Estados Unidos de América,6,4,,10,POINT (863337 -7735002)
2019,Mayo,Estonia,1,3,,4,POINT (0.81488 -77356)
2019,Mayo,Estonia,0,1,,1,POINT (10406342 -75527794)
2019,Mayo,Estonia,3,3,,6,POINT (10446304 -75516486)
2019,Mayo,Estonia,7,5,,12,POINT (3451668 -76532004)
2019,Mayo,Estonia,14,15,,29,POINT (4697157 -74140516)
2019,Mayo,Estonia,3,5,,8,POINT (6170465 -7542726)
2019,Mayo,Etiopia,0,1,,1,POINT (10406342 -75527794)
2019,Mayo,Etiopia,0,1,,1,POINT (10446304 -75516486)
2019,Mayo,Etiopia,2,61,,63,POINT (4697157 -74140516)
2019,Mayo,Etiopia,1,1,,2,POINT (6170465 -7542726)
2019,Mayo,Islas Fiji,2,0,,2,POINT (4697157 -74140516)
2019,Mayo,Islas Fiji,0,5,,5,POINT (6170465 -7542726)
2019,Mayo,Filipinas,1,38,,39,POINT (10406342 -75527794)
2019,Mayo,Filipinas,7,47,,54,POINT (10446304 -75516486)
2019,Mayo,Filipinas,0,23,,23,POINT (10886686 -74776479)
2019,Mayo,Filipinas,0,20,,20,POINT (10970933 -74765343)
2019,Mayo,Filipinas,0,7,,7,POINT (11247723 -74213989)
2019,Mayo,Filipinas,1,20,,21,POINT (3451668 -76532004)
2019,Mayo,Filipinas,0,14,,14,POINT (3884426 -77061029)
2019,Mayo,Filipinas,49,54,,103,POINT (4697157 -74140516)
2019,Mayo,Filipinas,2,6,,8,POINT (6170465 -7542726)
2019,Mayo,Filipinas,0,1,,1,POINT (806667 -767333)
2019,Mayo,Finlandia,1,0,,1,POINT (-4214082 -69941431)
2019,Mayo,Finlandia,3,6,,9,POINT (0.81488 -77356)
2019,Mayo,Finlandia,3,6,,9,POINT (10446304 -75516486)
2019,Mayo,Finlandia,3,6,,9,POINT (3451668 -76532004)
2019,Mayo,Finlandia,34,44,,78,POINT (4697157 -74140516)
2019,Mayo,Finlandia,4,8,,12,POINT (6170465 -7542726)
2019,Mayo,Francia,3,3,,6,POINT (-4191162 -69941498)
2019,Mayo,Francia,31,37,,68,POINT (-4214082 -69941431)
2019,Mayo,Francia,6,11,,17,POINT (0.33002 -76876446)
2019,Mayo,Francia,124,138,,262,POINT (0.81488 -77356)
2019,Mayo,Francia,10,24,,34,POINT (10406342 -75527794)
2019,Mayo,Francia,265,321,,586,POINT (10446304 -75516486)
2019,Mayo,Francia,2,11,,13,POINT (10886686 -74776479)
2019,Mayo,Francia,5,7,,12,POINT (11247723 -74213989)
2019,Mayo,Francia,2,0,,2,POINT (11360029 -72129595)
2019,Mayo,Francia,3,1,,4,POINT (125744111 -81703935)
2019,Mayo,Francia,2,3,,5,POINT (125862 -81702165)
2019,Mayo,Francia,1,0,,1,POINT (133387613 -81372937)
2019,Mayo,Francia,60,88,,148,POINT (3451668 -76532004)
2019,Mayo,Francia,0,1,,1,POINT (3884426 -77061029)
2019,Mayo,Francia,1410,2415,,3825,POINT (4697157 -74140516)
2019,Mayo,Francia,12,21,,33,POINT (4815189 -75736374)
2019,Mayo,Francia,161,296,,457,POINT (6170465 -7542726)
2019,Mayo,Francia,0,1,,1,POINT (6185536 -67484028)
2019,Mayo,Francia,1,3,,4,POINT (6222552 -77401154)
2019,Mayo,Francia,0,4,,4,POINT (7128047 -73181317)
2019,Mayo,Francia,0,2,,2,POINT (7819 -72453013)
2019,Mayo,Francia,0,1,,1,POINT (836068 -72409396)
2019,Mayo,Francia,6,10,,16,POINT (863337 -7735002)
2019,Mayo,Gambia,0,1,,1,POINT (10446304 -75516486)
2019,Mayo,Georgia,1,2,,3,POINT (10446304 -75516486)
2019,Mayo,Georgia,6,7,,13,POINT (4697157 -74140516)
2019,Mayo,Georgia,0,2,,2,POINT (9402597 -75681642)
2019,Mayo,Ghana,3,2,,5,POINT (3451668 -76532004)
2019,Mayo,Ghana,1,7,,8,POINT (4697157 -74140516)
2019,Mayo,Ghana,1,0,,1,POINT (6170465 -7542726)
2019,Mayo,Gibraltar/Territorio Británico de Ultramar,0,1,,1,POINT (4697157 -74140516)
2019,Mayo,Granada,0,1,,1,POINT (10446304 -75516486)
2019,Mayo,Granada,0,1,,1,POINT (4697157 -74140516)
2019,Mayo,Granada,0,1,,1,POINT (6170465 -7542726)
2019,Mayo,Grecia,0,2,,2,POINT (0.33002 -76876446)
2019,Mayo,Grecia,5,14,,19,POINT (10446304 -75516486)
2019,Mayo,Grecia,1,1,,2,POINT (10886686 -74776479)
2019,Mayo,Grecia,0,1,,1,POINT (11247723 -74213989)
2019,Mayo,Grecia,4,4,,8,POINT (3451668 -76532004)
2019,Mayo,Grecia,27,60,,87,POINT (4697157 -74140516)
2019,Mayo,Grecia,0,3,,3,POINT (6170465 -7542726)
2019,Mayo,Grecia,1,1,,2,POINT (7819 -72453013)
2019,Mayo,Guatemala,1,6,,7,POINT (0.81488 -77356)
2019,Mayo,Guatemala,0,2,,2,POINT (10406342 -75527794)
2019,Mayo,Guatemala,106,123,,229,POINT (10446304 -75516486)
2019,Mayo,Guatemala,10,19,,29,POINT (10886686 -74776479)
2019,Mayo,Guatemala,0,1,,1,POINT (10970933 -74765343)
2019,Mayo,Guatemala,1,1,,2,POINT (125862 -81702165)
2019,Mayo,Guatemala,44,69,,113,POINT (3451668 -76532004)
2019,Mayo,Guatemala,405,751,,1156,POINT (4697157 -74140516)
2019,Mayo,Guatemala,4,22,,26,POINT (4815189 -75736374)
2019,Mayo,Guatemala,38,143,,181,POINT (6170465 -7542726)
2019,Mayo,Guatemala,2,1,,3,POINT (7128047 -73181317)
2019,Mayo,Guatemala,1,0,,1,POINT (7819 -72453013)
2019,Mayo,Guyana,0,1,,1,POINT (10446304 -75516486)
2019,Mayo,Guyana,3,2,,5,POINT (10886686 -74776479)
2019,Mayo,Guyana,0,1,,1,POINT (11360029 -72129595)
2019,Mayo,Guyana,1,0,,1,POINT (125862 -81702165)
2019,Mayo,Guyana,1,0,,1,POINT (3451668 -76532004)
2019,Mayo,Guyana,18,21,,39,POINT (4697157 -74140516)
2019,Mayo,Guyana,0,2,,2,POINT (6170465 -7542726)
2019,Mayo,Guyana,1,0,,1,POINT (7128047 -73181317)
2019,Mayo,Guinea,0,2,,2,POINT (4697157 -74140516)
2019,Mayo,Guinea Ecuatorial,1,1,,2,POINT (4697157 -74140516)
2019,Mayo,Haití,6,6,,12,POINT (10446304 -75516486)
2019,Mayo,Haití,3,2,,5,POINT (3451668 -76532004)
2019,Mayo,Haití,12,34,,46,POINT (4697157 -74140516)
2019,Mayo,Haití,2,1,,3,POINT (4815189 -75736374)
2019,Mayo,Haití,0,5,,5,POINT (6170465 -7542726)
2019,Mayo,Honduras,1,5,,6,POINT (0.81488 -77356)
2019,Mayo,Honduras,0,14,,14,POINT (10406342 -75527794)
2019,Mayo,Honduras,65,61,,126,POINT (10446304 -75516486)
2019,Mayo,Honduras,5,7,,12,POINT (10886686 -74776479)
2019,Mayo,Honduras,0,2,,2,POINT (10970933 -74765343)
2019,Mayo,Honduras,2,2,,4,POINT (125862 -81702165)
2019,Mayo,Honduras,42,34,,76,POINT (3451668 -76532004)
2019,Mayo,Honduras,1,2,,3,POINT (445285 -75766353)
2019,Mayo,Honduras,304,395,,699,POINT (4697157 -74140516)
2019,Mayo,Honduras,0,2,,2,POINT (4815189 -75736374)
2019,Mayo,Honduras,56,83,,139,POINT (6170465 -7542726)
2019,Mayo,Honduras,3,5,,8,POINT (7128047 -73181317)
2019,Mayo,Honduras,0,1,,1,POINT (7819 -72453013)
2019,Mayo,Hong Kong,3,1,,4,POINT (0.81488 -77356)
2019,Mayo,Hong Kong,8,10,,18,POINT (4697157 -74140516)
2019,Mayo,Hong Kong,0,2,,2,POINT (6170465 -7542726)
2019,Mayo,Hungría,1,3,,4,POINT (-4214082 -69941431)
2019,Mayo,Hungría,2,6,,8,POINT (0.81488 -77356)
2019,Mayo,Hungría,1,3,,4,POINT (10446304 -75516486)
2019,Mayo,Hungría,1,4,,5,POINT (3451668 -76532004)
2019,Mayo,Hungría,30,58,,88,POINT (4697157 -74140516)
2019,Mayo,Hungría,2,2,,4,POINT (6170465 -7542726)
2019,Mayo,Hungría,2,0,,2,POINT (863337 -7735002)
2019,Mayo,India,0,4,,4,POINT (0.81488 -77356)
2019,Mayo,India,2,14,,16,POINT (10406342 -75527794)
2019,Mayo,India,24,69,,93,POINT (10446304 -75516486)
2019,Mayo,India,1,23,,24,POINT (10886686 -74776479)
2019,Mayo,India,0,12,,12,POINT (10970933 -74765343)
2019,Mayo,India,0,4,,4,POINT (11247723 -74213989)
2019,Mayo,India,5,17,,22,POINT (3451668 -76532004)
2019,Mayo,India,0,1,,1,POINT (3884426 -77061029)
2019,Mayo,India,104,485,,589,POINT (4697157 -74140516)
2019,Mayo,India,0,1,,1,POINT (4815189 -75736374)
2019,Mayo,India,15,109,,124,POINT (6170465 -7542726)
2019,Mayo,India,0,1,,1,POINT (7128047 -73181317)
2019,Mayo,India,1,0,,1,POINT (863337 -7735002)
2019,Mayo,India,0,4,,4,POINT (9402597 -75681642)
2019,Mayo,Indonesia,0,1,,1,POINT (10406342 -75527794)
2019,Mayo,Indonesia,2,1,,3,POINT (10446304 -75516486)
2019,Mayo,Indonesia,33,42,,75,POINT (4697157 -74140516)
2019,Mayo,Indonesia,0,7,,7,POINT (6170465 -7542726)
2019,Mayo,Irán,1,1,,2,POINT (-4214082 -69941431)
2019,Mayo,Irán,1,1,,2,POINT (0.81488 -77356)
2019,Mayo,Irán,6,17,,23,POINT (4697157 -74140516)
2019,Mayo,República de Irlanda,2,1,,3,POINT (-4214082 -69941431)
2019,Mayo,República de Irlanda,22,20,,42,POINT (0.81488 -77356)
2019,Mayo,República de Irlanda,8,6,,14,POINT (10406342 -75527794)
2019,Mayo,República de Irlanda,18,22,,40,POINT (10446304 -75516486)
2019,Mayo,República de Irlanda,3,1,,4,POINT (10886686 -74776479)
2019,Mayo,República de Irlanda,1,0,,1,POINT (125744111 -81703935)
2019,Mayo,República de Irlanda,1,0,,1,POINT (133387613 -81372937)
2019,Mayo,República de Irlanda,4,8,,12,POINT (3451668 -76532004)
2019,Mayo,República de Irlanda,111,202,,313,POINT (4697157 -74140516)
2019,Mayo,República de Irlanda,15,49,,64,POINT (6170465 -7542726)
2019,Mayo,República de Irlanda,23,8,,31,POINT (863337 -7735002)
2019,Mayo,Islandia,1,3,,4,POINT (10446304 -75516486)
2019,Mayo,Islandia,0,2,,2,POINT (3451668 -76532004)
2019,Mayo,Islandia,4,5,,9,POINT (4697157 -74140516)
2019,Mayo,Islandia,0,1,,1,POINT (4815189 -75736374)
2019,Mayo,Islandia,0,3,,3,POINT (6170465 -7542726)
2019,Mayo,Israel,3,12,,15,POINT (-4214082 -69941431)
2019,Mayo,Israel,0,1,,1,POINT (0.33002 -76876446)
2019,Mayo,Israel,85,176,,261,POINT (0.81488 -77356)
2019,Mayo,Israel,40,52,,92,POINT (10406342 -75527794)
2019,Mayo,Israel,25,57,,82,POINT (10446304 -75516486)
2019,Mayo,Israel,0,3,,3,POINT (10886686 -74776479)
2019,Mayo,Israel,0,1,,1,POINT (11360029 -72129595)
2019,Mayo,Israel,4,4,,8,POINT (125862 -81702165)
2019,Mayo,Israel,55,73,,128,POINT (3451668 -76532004)
2019,Mayo,Israel,245,662,,907,POINT (4697157 -74140516)
2019,Mayo,Israel,0,2,,2,POINT (4815189 -75736374)
2019,Mayo,Israel,288,445,,733,POINT (6170465 -7542726)
2019,Mayo,Israel,0,1,,1,POINT (7819 -72453013)
2019,Mayo,Israel,1,1,,2,POINT (863337 -7735002)
2019,Mayo,Italia,0,1,,1,POINT (-4191162 -69941498)
2019,Mayo,Italia,3,6,,9,POINT (-4214082 -69941431)
2019,Mayo,Italia,1,4,,5,POINT (0.33002 -76876446)
2019,Mayo,Italia,17,19,,36,POINT (0.81488 -77356)
2019,Mayo,Italia,7,11,,18,POINT (10406342 -75527794)
2019,Mayo,Italia,71,147,,218,POINT (10446304 -75516486)
2019,Mayo,Italia,13,40,,53,POINT (10886686 -74776479)
2019,Mayo,Italia,0,1,,1,POINT (11117206 -74232675)
2019,Mayo,Italia,8,15,,23,POINT (11360029 -72129595)
2019,Mayo,Italia,2,3,,5,POINT (125862 -81702165)
2019,Mayo,Italia,46,104,,150,POINT (3451668 -76532004)
2019,Mayo,Italia,638,1736,,2374,POINT (4697157 -74140516)
2019,Mayo,Italia,1,6,,7,POINT (4815189 -75736374)
2019,Mayo,Italia,87,231,,318,POINT (6170465 -7542726)
2019,Mayo,Italia,1,0,,1,POINT (7088729 -70740253)
2019,Mayo,Italia,0,2,,2,POINT (7128047 -73181317)
2019,Mayo,Italia,19,31,,50,POINT (7819 -72453013)
2019,Mayo,Italia,4,6,,10,POINT (836068 -72409396)
2019,Mayo,Italia,0,6,,6,POINT (863337 -7735002)
2019,Mayo,Jamaica,22,17,,39,POINT (10446304 -75516486)
2019,Mayo,Jamaica,1,4,,5,POINT (10886686 -74776479)
2019,Mayo,Jamaica,1,1,,2,POINT (125862 -81702165)
2019,Mayo,Jamaica,3,7,,10,POINT (3451668 -76532004)
2019,Mayo,Jamaica,24,42,,66,POINT (4697157 -74140516)
2019,Mayo,Jamaica,2,3,,5,POINT (4815189 -75736374)
2019,Mayo,Jamaica,6,8,,14,POINT (6170465 -7542726)
2019,Mayo,Islas Salomón,0,1,,1,POINT (7819 -72453013)
2019,Mayo,Japón,1,0,,1,POINT (-4191162 -69941498)
2019,Mayo,Japón,1,1,,2,POINT (-4214082 -69941431)
2019,Mayo,Japón,13,12,,25,POINT (0.81488 -77356)
2019,Mayo,Japón,2,0,,2,POINT (10406342 -75527794)
2019,Mayo,Japón,12,30,,42,POINT (10446304 -75516486)
2019,Mayo,Japón,2,8,,10,POINT (10886686 -74776479)
2019,Mayo,Japón,0,1,,1,POINT (125862 -81702165)
2019,Mayo,Japón,8,25,,33,POINT (3451668 -76532004)
2019,Mayo,Japón,147,389,,536,POINT (4697157 -74140516)
2019,Mayo,Japón,1,2,,3,POINT (4815189 -75736374)
2019,Mayo,Japón,15,49,,64,POINT (6170465 -7542726)
2019,Mayo,Japón,0,1,,1,POINT (836068 -72409396)
2019,Mayo,Japón,0,4,,4,POINT (863337 -7735002)
2019,Mayo,Jordania,0,1,,1,POINT (10446304 -75516486)
2019,Mayo,Jordania,0,4,,4,POINT (4697157 -74140516)
2019,Mayo,Jordania,0,2,,2,POINT (6170465 -7542726)
2019,Mayo,Kazajistán,0,2,,2,POINT (3451668 -76532004)
2019,Mayo,Kazajistán,5,8,,13,POINT (4697157 -74140516)
2019,Mayo,Kenia,3,4,,7,POINT (10446304 -75516486)
2019,Mayo,Kenia,0,2,,2,POINT (3451668 -76532004)
2019,Mayo,Kenia,5,11,,16,POINT (4697157 -74140516)
2019,Mayo,Kenia,0,3,,3,POINT (6170465 -7542726)
2019,Mayo,Kuwait,2,1,,3,POINT (10886686 -74776479)
2019,Mayo,Kuwait,0,2,,2,POINT (4697157 -74140516)
2019,Mayo,República de Kosovo,2,0,,2,POINT (4697157 -74140516)
2019,Mayo,República Democrática Popular  Lao,0,2,,2,POINT (4697157 -74140516)
2019,Mayo,Lesoto,1,0,,1,POINT (6170465 -7542726)
2019,Mayo,Letonia,0,2,,2,POINT (10446304 -75516486)
2019,Mayo,Letonia,0,1,,1,POINT (10970933 -74765343)
2019,Mayo,Letonia,1,1,,2,POINT (3451668 -76532004)
2019,Mayo,Letonia,4,9,,13,POINT (4697157 -74140516)
2019,Mayo,Letonia,2,0,,2,POINT (6170465 -7542726)
2019,Mayo,Letonia,1,1,,2,POINT (9402597 -75681642)
2019,Mayo,Lituania,1,0,,1,POINT (-4214082 -69941431)
2019,Mayo,Lituania,3,2,,5,POINT (0.81488 -77356)
2019,Mayo,Lituania,1,2,,3,POINT (10446304 -75516486)
2019,Mayo,Lituania,0,1,,1,POINT (11247723 -74213989)
2019,Mayo,Lituania,1,0,,1,POINT (3451668 -76532004)
2019,Mayo,Lituania,13,27,,40,POINT (4697157 -74140516)
2019,Mayo,Lituania,2,10,,12,POINT (6170465 -7542726)
2019,Mayo,Lituania,0,1,,1,POINT (863337 -7735002)
2019,Mayo,Líbano,2,4,,6,POINT (10446304 -75516486)
2019,Mayo,Líbano,2,4,,6,POINT (10886686 -74776479)
2019,Mayo,Líbano,0,1,,1,POINT (11360029 -72129595)
2019,Mayo,Líbano,0,1,,1,POINT (3451668 -76532004)
2019,Mayo,Líbano,8,18,,26,POINT (4697157 -74140516)
2019,Mayo,Líbano,0,6,,6,POINT (6170465 -7542726)
2019,Mayo,Liberia,1,0,,1,POINT (10446304 -75516486)
2019,Mayo,Libia,0,1,,1,POINT (4697157 -74140516)
2019,Mayo,Liechtenstein,1,2,,3,POINT (4697157 -74140516)
2019,Mayo,Luxemburgo,0,1,,1,POINT (10446304 -75516486)
2019,Mayo,Luxemburgo,1,1,,2,POINT (3451668 -76532004)
2019,Mayo,Luxemburgo,6,14,,20,POINT (4697157 -74140516)
2019,Mayo,Luxemburgo,1,0,,1,POINT (863337 -7735002)
2019,Mayo,Macedonia,2,17,,19,POINT (4697157 -74140516)
2019,Mayo,Madagascar,0,1,,1,POINT (4697157 -74140516)
2019,Mayo,Malasia,0,1,,1,POINT (0.81488 -77356)
2019,Mayo,Malasia,4,1,,5,POINT (10446304 -75516486)
2019,Mayo,Malasia,19,21,,40,POINT (4697157 -74140516)
2019,Mayo,Malasia,1,7,,8,POINT (6170465 -7542726)
2019,Mayo,Malta,1,2,,3,POINT (10446304 -75516486)
2019,Mayo,Malta,0,1,,1,POINT (3451668 -76532004)
2019,Mayo,Malta,1,9,,10,POINT (4697157 -74140516)
2019,Mayo,Malta,0,1,,1,POINT (6170465 -7542726)
2019,Mayo,Malta,1,1,,2,POINT (863337 -7735002)
2019,Mayo,Marruecos,0,2,,2,POINT (10446304 -75516486)
2019,Mayo,Marruecos,1,0,,1,POINT (10886686 -74776479)
2019,Mayo,Marruecos,0,1,,1,POINT (3451668 -76532004)
2019,Mayo,Marruecos,16,12,,28,POINT (4697157 -74140516)
2019,Mayo,Marruecos,1,0,,1,POINT (6170465 -7542726)
2019,Mayo,Mauricio,1,5,,6,POINT (4697157 -74140516)
2019,Mayo,México,0,4,,4,POINT (-4191162 -69941498)
2019,Mayo,México,3,3,,6,POINT (-4214082 -69941431)
2019,Mayo,México,0,2,,2,POINT (0.33002 -76876446)
2019,Mayo,México,23,28,,51,POINT (0.81488 -77356)
2019,Mayo,México,0,5,,5,POINT (1800143 -78802679)
2019,Mayo,México,16,15,,31,POINT (10406342 -75527794)
2019,Mayo,México,358,505,,863,POINT (10446304 -75516486)
2019,Mayo,México,40,69,,109,POINT (10886686 -74776479)
2019,Mayo,México,1,3,,4,POINT (11360029 -72129595)
2019,Mayo,México,2,2,,4,POINT (125862 -81702165)
2019,Mayo,México,109,246,,355,POINT (3451668 -76532004)
2019,Mayo,México,2,4,,6,POINT (445285 -75766353)
2019,Mayo,México,4918,8004,,12922,POINT (4697157 -74140516)
2019,Mayo,México,6,21,,27,POINT (4815189 -75736374)
2019,Mayo,México,459,1210,,1669,POINT (6170465 -7542726)
2019,Mayo,México,1,6,,7,POINT (7128047 -73181317)
2019,Mayo,México,3,4,,7,POINT (7819 -72453013)
2019,Mayo,México,0,2,,2,POINT (836068 -72409396)
2019,Mayo,República de Moldavia,4,0,,4,POINT (4697157 -74140516)
2019,Mayo,Mongolia,1,4,,5,POINT (4697157 -74140516)
2019,Mayo,Montenegro,0,1,,1,POINT (10406342 -75527794)
2019,Mayo,Montenegro,1,1,,2,POINT (10446304 -75516486)
2019,Mayo,Montenegro,0,1,,1,POINT (10886686 -74776479)
2019,Mayo,Montenegro,0,1,,1,POINT (3451668 -76532004)
2019,Mayo,Montenegro,0,2,,2,POINT (4697157 -74140516)
2019,Mayo,Montenegro,0,1,,1,POINT (6170465 -7542726)
2019,Mayo,Mozambique,1,4,,5,POINT (4697157 -74140516)
2019,Mayo,Myanmar,0,1,,1,POINT (10406342 -75527794)
2019,Mayo,Nepal,0,1,,1,POINT (0.81488 -77356)
2019,Mayo,Nepal,0,1,,1,POINT (10446304 -75516486)
2019,Mayo,Nepal,1,2,,3,POINT (4697157 -74140516)
2019,Mayo,Nicaragua,0,1,,1,POINT (0.81488 -77356)
2019,Mayo,Nicaragua,23,24,,47,POINT (10446304 -75516486)
2019,Mayo,Nicaragua,5,4,,9,POINT (10886686 -74776479)
2019,Mayo,Nicaragua,2,2,,4,POINT (125862 -81702165)
2019,Mayo,Nicaragua,13,22,,35,POINT (3451668 -76532004)
2019,Mayo,Nicaragua,1,1,,2,POINT (445285 -75766353)
2019,Mayo,Nicaragua,78,116,,194,POINT (4697157 -74140516)
2019,Mayo,Nicaragua,2,1,,3,POINT (4815189 -75736374)
2019,Mayo,Nicaragua,13,26,,39,POINT (6170465 -7542726)
2019,Mayo,Nicaragua,1,1,,2,POINT (7128047 -73181317)
2019,Mayo,Nigeria,0,4,,4,POINT (10446304 -75516486)
2019,Mayo,Nigeria,3,15,,18,POINT (4697157 -74140516)
2019,Mayo,Nigeria,1,5,,6,POINT (6170465 -7542726)
2019,Mayo,Noruega,1,1,,2,POINT (-4191162 -69941498)
2019,Mayo,Noruega,0,3,,3,POINT (-4214082 -69941431)
2019,Mayo,Noruega,5,2,,7,POINT (0.81488 -77356)
2019,Mayo,Noruega,2,0,,2,POINT (10406342 -75527794)
2019,Mayo,Noruega,8,14,,22,POINT (10446304 -75516486)
2019,Mayo,Noruega,0,1,,1,POINT (10886686 -74776479)
2019,Mayo,Noruega,0,3,,3,POINT (11360029 -72129595)
2019,Mayo,Noruega,2,2,,4,POINT (125862 -81702165)
2019,Mayo,Noruega,3,8,,11,POINT (3451668 -76532004)
2019,Mayo,Noruega,65,91,,156,POINT (4697157 -74140516)
2019,Mayo,Noruega,0,1,,1,POINT (4815189 -75736374)
2019,Mayo,Noruega,7,11,,18,POINT (6170465 -7542726)
2019,Mayo,Noruega,2,2,,4,POINT (863337 -7735002)
2019,Mayo,Nueva Zelanda,3,2,,5,POINT (-4214082 -69941431)
2019,Mayo,Nueva Zelanda,10,10,,20,POINT (0.81488 -77356)
2019,Mayo,Nueva Zelanda,4,6,,10,POINT (10406342 -75527794)
2019,Mayo,Nueva Zelanda,6,18,,24,POINT (10446304 -75516486)
2019,Mayo,Nueva Zelanda,0,2,,2,POINT (10886686 -74776479)
2019,Mayo,Nueva Zelanda,1,1,,2,POINT (11247723 -74213989)
2019,Mayo,Nueva Zelanda,1,8,,9,POINT (3451668 -76532004)
2019,Mayo,Nueva Zelanda,60,80,,140,POINT (4697157 -74140516)
2019,Mayo,Nueva Zelanda,10,14,,24,POINT (6170465 -7542726)
2019,Mayo,Nueva Zelanda,4,2,,6,POINT (863337 -7735002)
2019,Mayo,Omán,1,0,,1,POINT (6170465 -7542726)
2019,Mayo,Países Bajos,2,2,,4,POINT (-4191162 -69941498)
2019,Mayo,Países Bajos,6,7,,13,POINT (-4214082 -69941431)
2019,Mayo,Países Bajos,1,1,,2,POINT (0.33002 -76876446)
2019,Mayo,Países Bajos,39,32,,71,POINT (0.81488 -77356)
2019,Mayo,Países Bajos,17,17,,34,POINT (10406342 -75527794)
2019,Mayo,Países Bajos,275,182,,457,POINT (10446304 -75516486)
2019,Mayo,Países Bajos,12,14,,26,POINT (10886686 -74776479)
2019,Mayo,Países Bajos,1,9,,10,POINT (11360029 -72129595)
2019,Mayo,Países Bajos,0,2,,2,POINT (1152863 -72919186)
2019,Mayo,Países Bajos,0,2,,2,POINT (125862 -81702165)
2019,Mayo,Países Bajos,0,5,,5,POINT (133387613 -81372937)
2019,Mayo,Países Bajos,55,84,,139,POINT (3451668 -76532004)
2019,Mayo,Países Bajos,1508,2066,,3574,POINT (4697157 -74140516)
2019,Mayo,Países Bajos,1,6,,7,POINT (4815189 -75736374)
2019,Mayo,Países Bajos,121,215,,336,POINT (6170465 -7542726)
2019,Mayo,Países Bajos,4,8,,12,POINT (7128047 -73181317)
2019,Mayo,Países Bajos,1,5,,6,POINT (7819 -72453013)
2019,Mayo,Países Bajos,6,11,,17,POINT (863337 -7735002)
2019,Mayo,Pakistán,6,16,,22,POINT (4697157 -74140516)
2019,Mayo,Pakistán,1,2,,3,POINT (6170465 -7542726)
2019,Mayo,Panamá,1,0,,1,POINT (0.81488 -77356)
2019,Mayo,Panamá,0,1,,1,POINT (1800143 -78802679)
2019,Mayo,Panamá,1,16,,17,POINT (10406342 -75527794)
2019,Mayo,Panamá,465,472,,937,POINT (10446304 -75516486)
2019,Mayo,Panamá,134,163,,297,POINT (10886686 -74776479)
2019,Mayo,Panamá,0,1,,1,POINT (10970933 -74765343)
2019,Mayo,Panamá,0,3,,3,POINT (11247723 -74213989)
2019,Mayo,Panamá,0,2,,2,POINT (11360029 -72129595)
2019,Mayo,Panamá,32,34,,66,POINT (125862 -81702165)
2019,Mayo,Panamá,342,409,,751,POINT (3451668 -76532004)
2019,Mayo,Panamá,2,1,,3,POINT (445285 -75766353)
2019,Mayo,Panamá,1520,1835,,3355,POINT (4697157 -74140516)
2019,Mayo,Panamá,18,34,,52,POINT (4815189 -75736374)
2019,Mayo,Panamá,1482,1450,,2932,POINT (6170465 -7542726)
2019,Mayo,Panamá,1,1,,2,POINT (7102626 -77762647)
2019,Mayo,Panamá,17,10,,27,POINT (7128047 -73181317)
2019,Mayo,Panamá,2,3,,5,POINT (7819 -72453013)
2019,Mayo,Panamá,4,4,,8,POINT (863337 -7735002)
2019,Mayo,Papúa Nueva Guinea,1,0,,1,POINT (-4214082 -69941431)
2019,Mayo,Papúa Nueva Guinea,0,1,,1,POINT (4697157 -74140516)
2019,Mayo,Paraguay,3,9,,12,POINT (-4191162 -69941498)
2019,Mayo,Paraguay,2,4,,6,POINT (0.81488 -77356)
2019,Mayo,Paraguay,3,4,,7,POINT (10406342 -75527794)
2019,Mayo,Paraguay,100,33,,133,POINT (10446304 -75516486)
2019,Mayo,Paraguay,4,0,,4,POINT (10886686 -74776479)
2019,Mayo,Paraguay,0,1,,1,POINT (11360029 -72129595)
2019,Mayo,Paraguay,41,32,,73,POINT (125862 -81702165)
2019,Mayo,Paraguay,18,13,,31,POINT (3451668 -76532004)
2019,Mayo,Paraguay,197,234,,431,POINT (4697157 -74140516)
2019,Mayo,Paraguay,2,1,,3,POINT (4815189 -75736374)
2019,Mayo,Paraguay,29,47,,76,POINT (6170465 -7542726)
2019,Mayo,Paraguay,0,1,,1,POINT (7819 -72453013)
2019,Mayo,Perú,5,7,,12,POINT (-4191162 -69941498)
2019,Mayo,Perú,61,58,,119,POINT (-4214082 -69941431)
2019,Mayo,Perú,19,47,,66,POINT (0.185957 -7478366)
2019,Mayo,Perú,2,19,,21,POINT (0.33002 -76876446)
2019,Mayo,Perú,96,250,,346,POINT (0.81488 -77356)
2019,Mayo,Perú,26,30,,56,POINT (10406342 -75527794)
2019,Mayo,Perú,1184,740,,1924,POINT (10446304 -75516486)
2019,Mayo,Perú,11,32,,43,POINT (10886686 -74776479)
2019,Mayo,Perú,3,12,,15,POINT (11360029 -72129595)
2019,Mayo,Perú,407,277,,684,POINT (125862 -81702165)
2019,Mayo,Perú,331,393,,724,POINT (3451668 -76532004)
2019,Mayo,Perú,0,2,,2,POINT (445285 -75766353)
2019,Mayo,Perú,4170,4729,,8899,POINT (4697157 -74140516)
2019,Mayo,Perú,4,7,,11,POINT (4815189 -75736374)
2019,Mayo,Perú,804,1113,,1917,POINT (6170465 -7542726)
2019,Mayo,Perú,1,0,,1,POINT (7088729 -70740253)
2019,Mayo,Perú,0,2,,2,POINT (7128047 -73181317)
2019,Mayo,Perú,48,83,,131,POINT (7819 -72453013)
2019,Mayo,Perú,0,1,,1,POINT (836068 -72409396)
2019,Mayo,Palestina,0,2,,2,POINT (4697157 -74140516)
2019,Mayo,Polonia,1,0,,1,POINT (-4214082 -69941431)
2019,Mayo,Polonia,8,13,,21,POINT (0.81488 -77356)
2019,Mayo,Polonia,2,7,,9,POINT (10406342 -75527794)
2019,Mayo,Polonia,11,23,,34,POINT (10446304 -75516486)
2019,Mayo,Polonia,1,1,,2,POINT (10886686 -74776479)
2019,Mayo,Polonia,3,1,,4,POINT (11247723 -74213989)
2019,Mayo,Polonia,4,5,,9,POINT (3451668 -76532004)
2019,Mayo,Polonia,146,170,,316,POINT (4697157 -74140516)
2019,Mayo,Polonia,16,24,,40,POINT (6170465 -7542726)
2019,Mayo,Polonia,1,1,,2,POINT (863337 -7735002)
2019,Mayo,Portugal,1,1,,2,POINT (-4214082 -69941431)
2019,Mayo,Portugal,1,7,,8,POINT (0.81488 -77356)
2019,Mayo,Portugal,1,1,,2,POINT (10406342 -75527794)
2019,Mayo,Portugal,16,23,,39,POINT (10446304 -75516486)
2019,Mayo,Portugal,1,5,,6,POINT (10886686 -74776479)
2019,Mayo,Portugal,5,5,,10,POINT (11360029 -72129595)
2019,Mayo,Portugal,1,2,,3,POINT (125862 -81702165)
2019,Mayo,Portugal,9,12,,21,POINT (3451668 -76532004)
2019,Mayo,Portugal,208,465,,673,POINT (4697157 -74140516)
2019,Mayo,Portugal,0,3,,3,POINT (4815189 -75736374)
2019,Mayo,Portugal,12,49,,61,POINT (6170465 -7542726)
2019,Mayo,Portugal,6,11,,17,POINT (7819 -72453013)
2019,Mayo,Portugal,1,1,,2,POINT (836068 -72409396)
2019,Mayo,Qatar,0,1,,1,POINT (4697157 -74140516)
2019,Mayo,Qatar,0,1,,1,POINT (4815189 -75736374)
2019,Mayo,Qatar,0,1,,1,POINT (6170465 -7542726)
2019,Mayo,Reino Unido de Gran Bretaña e Irlanda del Norte,3,4,,7,POINT (-4191162 -69941498)
2019,Mayo,Reino Unido de Gran Bretaña e Irlanda del Norte,9,13,,22,POINT (-4214082 -69941431)
2019,Mayo,Reino Unido de Gran Bretaña e Irlanda del Norte,3,4,,7,POINT (0.33002 -76876446)
2019,Mayo,Reino Unido de Gran Bretaña e Irlanda del Norte,77,93,,170,POINT (0.81488 -77356)
2019,Mayo,Reino Unido de Gran Bretaña e Irlanda del Norte,17,18,,35,POINT (10406342 -75527794)
2019,Mayo,Reino Unido de Gran Bretaña e Irlanda del Norte,117,157,,274,POINT (10446304 -75516486)
2019,Mayo,Reino Unido de Gran Bretaña e Irlanda del Norte,8,19,,27,POINT (10886686 -74776479)
2019,Mayo,Reino Unido de Gran Bretaña e Irlanda del Norte,0,3,,3,POINT (10970933 -74765343)
2019,Mayo,Reino Unido de Gran Bretaña e Irlanda del Norte,1,1,,2,POINT (11360029 -72129595)
2019,Mayo,Reino Unido de Gran Bretaña e Irlanda del Norte,1,1,,2,POINT (125744111 -81703935)
2019,Mayo,Reino Unido de Gran Bretaña e Irlanda del Norte,0,3,,3,POINT (125862 -81702165)
2019,Mayo,Reino Unido de Gran Bretaña e Irlanda del Norte,1,1,,2,POINT (133387613 -81372937)
2019,Mayo,Reino Unido de Gran Bretaña e Irlanda del Norte,34,62,,96,POINT (3451668 -76532004)
2019,Mayo,Reino Unido de Gran Bretaña e Irlanda del Norte,1019,2001,,3020,POINT (4697157 -74140516)
2019,Mayo,Reino Unido de Gran Bretaña e Irlanda del Norte,0,4,,4,POINT (4815189 -75736374)
2019,Mayo,Reino Unido de Gran Bretaña e Irlanda del Norte,139,310,,449,POINT (6170465 -7542726)
2019,Mayo,Reino Unido de Gran Bretaña e Irlanda del Norte,33,32,,65,POINT (863337 -7735002)
2019,Mayo,República Dominicana,0,1,,1,POINT (-4214082 -69941431)
2019,Mayo,República Dominicana,0,2,,2,POINT (0.33002 -76876446)
2019,Mayo,República Dominicana,4,12,,16,POINT (0.81488 -77356)
2019,Mayo,República Dominicana,94,123,,217,POINT (10446304 -75516486)
2019,Mayo,República Dominicana,14,51,,65,POINT (10886686 -74776479)
2019,Mayo,República Dominicana,0,2,,2,POINT (11247723 -74213989)
2019,Mayo,República Dominicana,0,3,,3,POINT (11360029 -72129595)
2019,Mayo,República Dominicana,40,38,,78,POINT (3451668 -76532004)
2019,Mayo,República Dominicana,2,1,,3,POINT (445285 -75766353)
2019,Mayo,República Dominicana,1125,1240,,2365,POINT (4697157 -74140516)
2019,Mayo,República Dominicana,5,3,,8,POINT (4815189 -75736374)
2019,Mayo,República Dominicana,83,185,,268,POINT (6170465 -7542726)
2019,Mayo,República Dominicana,0,2,,2,POINT (7819 -72453013)
2019,Mayo,Desconocido,0,1,,1,POINT (4697157 -74140516)
2019,Mayo,Rumania,4,2,,6,POINT (0.81488 -77356)
2019,Mayo,Rumania,2,3,,5,POINT (10406342 -75527794)
2019,Mayo,Rumania,8,16,,24,POINT (10446304 -75516486)
2019,Mayo,Rumania,0,1,,1,POINT (10886686 -74776479)
2019,Mayo,Rumania,2,3,,5,POINT (3451668 -76532004)
2019,Mayo,Rumania,69,69,,138,POINT (4697157 -74140516)
2019,Mayo,Rumania,1,0,,1,POINT (4815189 -75736374)
2019,Mayo,Rumania,9,10,,19,POINT (6170465 -7542726)
2019,Mayo,Federación de Rusia,1,0,,1,POINT (0.33002 -76876446)
2019,Mayo,Federación de Rusia,3,5,,8,POINT (0.81488 -77356)
2019,Mayo,Federación de Rusia,1,9,,10,POINT (10406342 -75527794)
2019,Mayo,Federación de Rusia,22,18,,40,POINT (10446304 -75516486)
2019,Mayo,Federación de Rusia,1,3,,4,POINT (10886686 -74776479)
2019,Mayo,Federación de Rusia,0,7,,7,POINT (11247723 -74213989)
2019,Mayo,Federación de Rusia,2,0,,2,POINT (11360029 -72129595)
2019,Mayo,Federación de Rusia,6,11,,17,POINT (3451668 -76532004)
2019,Mayo,Federación de Rusia,168,200,,368,POINT (4697157 -74140516)
2019,Mayo,Federación de Rusia,11,10,,21,POINT (6170465 -7542726)
2019,Mayo,Federación de Rusia,0,1,,1,POINT (7128047 -73181317)
2019,Mayo,Federación de Rusia,0,2,,2,POINT (9402597 -75681642)
2019,Mayo,San Cristóbal y Nevis,1,0,,1,POINT (10446304 -75516486)
2019,Mayo,San Cristóbal y Nevis,1,0,,1,POINT (4697157 -74140516)
2019,Mayo,San Cristóbal y Nevis,0,1,,1,POINT (6170465 -7542726)
2019,Mayo,San Marino,0,1,,1,POINT (4697157 -74140516)
2019,Mayo,San  Vicente y las Granadinas,0,2,,2,POINT (10446304 -75516486)
2019,Mayo,San  Vicente y las Granadinas,1,1,,2,POINT (4697157 -74140516)
2019,Mayo,Santa Lucia,0,3,,3,POINT (10446304 -75516486)
2019,Mayo,Santa Lucia,0,1,,1,POINT (10886686 -74776479)
2019,Mayo,Santa Lucia,4,2,,6,POINT (4697157 -74140516)
2019,Mayo,Santa Lucia,1,1,,2,POINT (7128047 -73181317)
2019,Mayo,Santa Sede/Ciudad del Vaticano,0,1,,1,POINT (4697157 -74140516)
2019,Mayo,Senegal,1,1,,2,POINT (4697157 -74140516)
2019,Mayo,Serbia,1,0,,1,POINT (0.81488 -77356)
2019,Mayo,Serbia,2,2,,4,POINT (10446304 -75516486)
2019,Mayo,Serbia,1,2,,3,POINT (3451668 -76532004)
2019,Mayo,Serbia,8,22,,30,POINT (4697157 -74140516)
2019,Mayo,Serbia,1,1,,2,POINT (6170465 -7542726)
2019,Mayo,Singapur,1,0,,1,POINT (-4214082 -69941431)
2019,Mayo,Singapur,1,0,,1,POINT (0.81488 -77356)
2019,Mayo,Singapur,4,7,,11,POINT (10446304 -75516486)
2019,Mayo,Singapur,19,38,,57,POINT (4697157 -74140516)
2019,Mayo,Singapur,2,5,,7,POINT (6170465 -7542726)
2019,Mayo,República Árabe Siria,1,0,,1,POINT (11360029 -72129595)
2019,Mayo,República Árabe Siria,0,2,,2,POINT (4697157 -74140516)
2019,Mayo,República Árabe Siria,0,1,,1,POINT (6170465 -7542726)
2019,Mayo,Sri Lanka,0,1,,1,POINT (10446304 -75516486)
2019,Mayo,Sri Lanka,0,1,,1,POINT (3451668 -76532004)
2019,Mayo,Sri Lanka,1,1,,2,POINT (4697157 -74140516)
2019,Mayo,Sri Lanka,0,1,,1,POINT (6170465 -7542726)
2019,Mayo,Sudáfrica,0,5,,5,POINT (10406342 -75527794)
2019,Mayo,Sudáfrica,2,5,,7,POINT (10446304 -75516486)
2019,Mayo,Sudáfrica,0,2,,2,POINT (10886686 -74776479)
2019,Mayo,Sudáfrica,0,3,,3,POINT (3451668 -76532004)
2019,Mayo,Sudáfrica,15,33,,48,POINT (4697157 -74140516)
2019,Mayo,Sudáfrica,2,3,,5,POINT (6170465 -7542726)
2019,Mayo,Sudán,1,1,,2,POINT (4697157 -74140516)
2019,Mayo,Suecia,0,1,,1,POINT (-4191162 -69941498)
2019,Mayo,Suecia,1,0,,1,POINT (-4214082 -69941431)
2019,Mayo,Suecia,1,1,,2,POINT (0.33002 -76876446)
2019,Mayo,Suecia,8,9,,17,POINT (0.81488 -77356)
2019,Mayo,Suecia,7,9,,16,POINT (10406342 -75527794)
2019,Mayo,Suecia,8,21,,29,POINT (10446304 -75516486)
2019,Mayo,Suecia,2,1,,3,POINT (10886686 -74776479)
2019,Mayo,Suecia,0,1,,1,POINT (11247723 -74213989)
2019,Mayo,Suecia,3,9,,12,POINT (3451668 -76532004)
2019,Mayo,Suecia,100,178,,278,POINT (4697157 -74140516)
2019,Mayo,Suecia,12,19,,31,POINT (6170465 -7542726)
2019,Mayo,Suecia,2,0,,2,POINT (7128047 -73181317)
2019,Mayo,Suecia,0,1,,1,POINT (863337 -7735002)
2019,Mayo,Suiza,2,2,,4,POINT (-4214082 -69941431)
2019,Mayo,Suiza,1,1,,2,POINT (0.33002 -76876446)
2019,Mayo,Suiza,41,32,,73,POINT (0.81488 -77356)
2019,Mayo,Suiza,18,17,,35,POINT (10406342 -75527794)
2019,Mayo,Suiza,41,45,,86,POINT (10446304 -75516486)
2019,Mayo,Suiza,2,5,,7,POINT (10886686 -74776479)
2019,Mayo,Suiza,0,1,,1,POINT (11247723 -74213989)
2019,Mayo,Suiza,2,5,,7,POINT (125862 -81702165)
2019,Mayo,Suiza,0,2,,2,POINT (133387613 -81372937)
2019,Mayo,Suiza,33,48,,81,POINT (3451668 -76532004)
2019,Mayo,Suiza,1,0,,1,POINT (445285 -75766353)
2019,Mayo,Suiza,290,511,,801,POINT (4697157 -74140516)
2019,Mayo,Suiza,0,2,,2,POINT (4815189 -75736374)
2019,Mayo,Suiza,41,84,,125,POINT (6170465 -7542726)
2019,Mayo,Suiza,3,3,,6,POINT (863337 -7735002)
2019,Mayo,Surinam,0,2,,2,POINT (10446304 -75516486)
2019,Mayo,Surinam,19,33,,52,POINT (4697157 -74140516)
2019,Mayo,Surinam,2,5,,7,POINT (6170465 -7542726)
2019,Mayo,Surinam,0,3,,3,POINT (7128047 -73181317)
2019,Mayo,Taiwán,1,0,,1,POINT (4697157 -74140516)
2019,Mayo,Tailandia,1,1,,2,POINT (0.81488 -77356)
2019,Mayo,Tailandia,1,3,,4,POINT (10446304 -75516486)
2019,Mayo,Tailandia,1,0,,1,POINT (10886686 -74776479)
2019,Mayo,Tailandia,16,8,,24,POINT (4697157 -74140516)
2019,Mayo,Tailandia,2,3,,5,POINT (6170465 -7542726)
2019,Mayo,Tanzania,1,0,,1,POINT (3451668 -76532004)
2019,Mayo,Tanzania,3,4,,7,POINT (4697157 -74140516)
2019,Mayo,Trinidad y Tobago,0,1,,1,POINT (-4214082 -69941431)
2019,Mayo,Trinidad y Tobago,0,1,,1,POINT (0.33002 -76876446)
2019,Mayo,Trinidad y Tobago,6,12,,18,POINT (10446304 -75516486)
2019,Mayo,Trinidad y Tobago,6,7,,13,POINT (10886686 -74776479)
2019,Mayo,Trinidad y Tobago,1,1,,2,POINT (125862 -81702165)
2019,Mayo,Trinidad y Tobago,6,13,,19,POINT (3451668 -76532004)
2019,Mayo,Trinidad y Tobago,29,64,,93,POINT (4697157 -74140516)
2019,Mayo,Trinidad y Tobago,4,18,,22,POINT (6170465 -7542726)
2019,Mayo,Túnez,2,3,,5,POINT (4697157 -74140516)
2019,Mayo,Túnez,0,1,,1,POINT (6170465 -7542726)
2019,Mayo,Turquía,2,3,,5,POINT (0.81488 -77356)
2019,Mayo,Turquía,0,2,,2,POINT (10406342 -75527794)
2019,Mayo,Turquía,6,12,,18,POINT (10446304 -75516486)
2019,Mayo,Turquía,2,6,,8,POINT (3451668 -76532004)
2019,Mayo,Turquía,141,350,,491,POINT (4697157 -74140516)
2019,Mayo,Turquía,1,15,,16,POINT (6170465 -7542726)
2019,Mayo,Ucrania,0,1,,1,POINT (0.81488 -77356)
2019,Mayo,Ucrania,1,10,,11,POINT (10406342 -75527794)
2019,Mayo,Ucrania,0,14,,14,POINT (10446304 -75516486)
2019,Mayo,Ucrania,0,4,,4,POINT (10886686 -74776479)
2019,Mayo,Ucrania,0,4,,4,POINT (10970933 -74765343)
2019,Mayo,Ucrania,0,4,,4,POINT (11247723 -74213989)
2019,Mayo,Ucrania,0,12,,12,POINT (3451668 -76532004)
2019,Mayo,Ucrania,0,7,,7,POINT (3884426 -77061029)
2019,Mayo,Ucrania,35,28,,63,POINT (4697157 -74140516)
2019,Mayo,Ucrania,0,1,,1,POINT (4815189 -75736374)
2019,Mayo,Ucrania,3,4,,7,POINT (6170465 -7542726)
2019,Mayo,Ucrania,0,3,,3,POINT (9402597 -75681642)
2019,Mayo,Uganda,0,1,,1,POINT (10446304 -75516486)
2019,Mayo,Uganda,1,1,,2,POINT (4697157 -74140516)
2019,Mayo,Uruguay,1,0,,1,POINT (-4191162 -69941498)
2019,Mayo,Uruguay,0,1,,1,POINT (-4214082 -69941431)
2019,Mayo,Uruguay,2,2,,4,POINT (0.33002 -76876446)
2019,Mayo,Uruguay,5,16,,21,POINT (0.81488 -77356)
2019,Mayo,Uruguay,106,35,,141,POINT (10406342 -75527794)
2019,Mayo,Uruguay,124,91,,215,POINT (10446304 -75516486)
2019,Mayo,Uruguay,4,11,,15,POINT (10886686 -74776479)
2019,Mayo,Uruguay,21,18,,39,POINT (125862 -81702165)
2019,Mayo,Uruguay,21,97,,118,POINT (3451668 -76532004)
2019,Mayo,Uruguay,0,1,,1,POINT (445285 -75766353)
2019,Mayo,Uruguay,403,467,,870,POINT (4697157 -74140516)
2019,Mayo,Uruguay,0,4,,4,POINT (4815189 -75736374)
2019,Mayo,Uruguay,79,125,,204,POINT (6170465 -7542726)
2019,Mayo,Uruguay,2,4,,6,POINT (7819 -72453013)
2019,Mayo,Uruguay,0,1,,1,POINT (836068 -72409396)
2019,Mayo,Uzbekistán,0,2,,2,POINT (6170465 -7542726)
2019,Mayo,Vanuatu,0,1,,1,POINT (4697157 -74140516)
2019,Mayo,Venezuela,4,7,,11,POINT (-4191162 -69941498)
2019,Mayo,Venezuela,5,4,,9,POINT (-4214082 -69941431)
2019,Mayo,Venezuela,66,78,,144,POINT (0.33002 -76876446)
2019,Mayo,Venezuela,3618,3863,,7481,POINT (0.81488 -77356)
2019,Mayo,Venezuela,3,18,,21,POINT (1800143 -78802679)
2019,Mayo,Venezuela,11,20,,31,POINT (10406342 -75527794)
2019,Mayo,Venezuela,229,222,,451,POINT (10446304 -75516486)
2019,Mayo,Venezuela,249,328,,577,POINT (10886686 -74776479)
2019,Mayo,Venezuela,12,44,,56,POINT (11117206 -74232675)
2019,Mayo,Venezuela,0,2,,2,POINT (11247723 -74213989)
2019,Mayo,Venezuela,8727,7879,,16606,POINT (11360029 -72129595)
2019,Mayo,Venezuela,0,1,,1,POINT (1152863 -72919186)
2019,Mayo,Venezuela,2,3,,5,POINT (125862 -81702165)
2019,Mayo,Venezuela,0,1,,1,POINT (133387613 -81372937)
2019,Mayo,Venezuela,213,234,,447,POINT (3451668 -76532004)
2019,Mayo,Venezuela,43,21,,64,POINT (3866713 -67927521)
2019,Mayo,Venezuela,3,1,,4,POINT (445285 -75766353)
2019,Mayo,Venezuela,8546,8266,,16812,POINT (4697157 -74140516)
2019,Mayo,Venezuela,9,20,,29,POINT (4815189 -75736374)
2019,Mayo,Venezuela,1529,1685,,3214,POINT (6170465 -7542726)
2019,Mayo,Venezuela,39,55,,94,POINT (6185536 -67484028)
2019,Mayo,Venezuela,471,434,,905,POINT (7088729 -70740253)
2019,Mayo,Venezuela,9,7,,16,POINT (7128047 -73181317)
2019,Mayo,Venezuela,29767,28185,,57952,POINT (7819 -72453013)
2019,Mayo,Venezuela,8,18,,26,POINT (7927233 -72508188)
2019,Mayo,Venezuela,1251,1066,,2317,POINT (836068 -72409396)
2019,Mayo,Vietnam,0,3,,3,POINT (10406342 -75527794)
2019,Mayo,Vietnam,0,3,,3,POINT (10446304 -75516486)
2019,Mayo,Vietnam,0,6,,6,POINT (10886686 -74776479)
2019,Mayo,Vietnam,0,6,,6,POINT (10970933 -74765343)
2019,Mayo,Vietnam,19,18,,37,POINT (4697157 -74140516)
2019,Mayo,Vietnam,1,2,,3,POINT (6170465 -7542726)
2019,Mayo,República Árabe de Yemen,0,2,,2,POINT (4697157 -74140516)
2019,Mayo,Zambia,2,1,,3,POINT (10446304 -75516486)
2019,Mayo,Zimbabue,0,1,,1,POINT (10446304 -75516486)
2019,Mayo,Zimbabue,1,0,,1,POINT (3451668 -76532004)
2019,Mayo,Zimbabue,3,2,,5,POINT (4697157 -74140516)
2019,Mayo,Zimbabue,1,0,,1,POINT (6170465 -7542726)
2019,Mayo,Desconocido,3,2,,5,POINT (10446304 -75516486)
2019,Mayo,Desconocido,2,0,,2,POINT (10886686 -74776479)
2019,Mayo,Desconocido,0,1,,1,POINT (125862 -81702165)
2019,Mayo,Desconocido,2,4,,6,POINT (3451668 -76532004)
2019,Mayo,Desconocido,103,157,,260,POINT (4697157 -74140516)
2019,Mayo,Desconocido,3,8,,11,POINT (6170465 -7542726)
2019,Junio,Afganistán,1,1,,2,POINT (4697157 -74140516)
2019,Junio,Albania,0,1,,1,POINT (1800143 -78802679)
2019,Junio,Albania,0,2,,2,POINT (3451668 -76532004)
2019,Junio,Albania,2,13,,15,POINT (4697157 -74140516)
2019,Junio,Albania,2,1,,3,POINT (6170465 -7542726)
2019,Junio,Alemania,3,3,,6,POINT (-4191162 -69941498)
2019,Junio,Alemania,24,24,,48,POINT (-4214082 -69941431)
2019,Junio,Alemania,11,12,,23,POINT (0.33002 -76876446)
2019,Junio,Alemania,97,122,,219,POINT (0.81488 -77356)
2019,Junio,Alemania,26,37,,63,POINT (10406342 -75527794)
2019,Junio,Alemania,94,139,,233,POINT (10446304 -75516486)
2019,Junio,Alemania,20,29,,49,POINT (10886686 -74776479)
2019,Junio,Alemania,0,2,,2,POINT (11360029 -72129595)
2019,Junio,Alemania,5,2,,7,POINT (125862 -81702165)
2019,Junio,Alemania,0,5,,5,POINT (133387613 -81372937)
2019,Junio,Alemania,61,67,,128,POINT (3451668 -76532004)
2019,Junio,Alemania,1590,2274,,3864,POINT (4697157 -74140516)
2019,Junio,Alemania,0,1,,1,POINT (4815189 -75736374)
2019,Junio,Alemania,144,273,,417,POINT (6170465 -7542726)
2019,Junio,Alemania,4,2,,6,POINT (7819 -72453013)
2019,Junio,Alemania,11,14,,25,POINT (863337 -7735002)
2019,Junio,Andorra,0,1,,1,POINT (10446304 -75516486)
2019,Junio,Andorra,3,13,,16,POINT (4697157 -74140516)
2019,Junio,Andorra,0,2,,2,POINT (6170465 -7542726)
2019,Junio,Angola,0,1,,1,POINT (4697157 -74140516)
2019,Junio,Antigua y Barbuda,0,2,,2,POINT (10886686 -74776479)
2019,Junio,Antigua y Barbuda,2,2,,4,POINT (4697157 -74140516)
2019,Junio,Antigua y Barbuda,1,5,,6,POINT (6170465 -7542726)
2019,Junio,Arabia Saudita,0,2,,2,POINT (10446304 -75516486)
2019,Junio,Arabia Saudita,0,1,,1,POINT (3451668 -76532004)
2019,Junio,Arabia Saudita,0,16,,16,POINT (4697157 -74140516)
2019,Junio,Arabia Saudita,0,1,,1,POINT (6170465 -7542726)
2019,Junio,Argelia,1,0,,1,POINT (3451668 -76532004)
2019,Junio,Argelia,1,4,,5,POINT (4697157 -74140516)
2019,Junio,Argentina,2,5,,7,POINT (-4191162 -69941498)
2019,Junio,Argentina,8,6,,14,POINT (-4214082 -69941431)
2019,Junio,Argentina,7,18,,25,POINT (0.33002 -76876446)
2019,Junio,Argentina,78,148,,226,POINT (0.81488 -77356)
2019,Junio,Argentina,345,202,,547,POINT (10406342 -75527794)
2019,Junio,Argentina,1523,1190,,2713,POINT (10446304 -75516486)
2019,Junio,Argentina,9,32,,41,POINT (10886686 -74776479)
2019,Junio,Argentina,0,1,,1,POINT (11247723 -74213989)
2019,Junio,Argentina,8,10,,18,POINT (11360029 -72129595)
2019,Junio,Argentina,209,150,,359,POINT (125862 -81702165)
2019,Junio,Argentina,102,156,,258,POINT (3451668 -76532004)
2019,Junio,Argentina,1,2,,3,POINT (445285 -75766353)
2019,Junio,Argentina,3684,5092,,8776,POINT (4697157 -74140516)
2019,Junio,Argentina,6,7,,13,POINT (4815189 -75736374)
2019,Junio,Argentina,211,437,,648,POINT (6170465 -7542726)
2019,Junio,Argentina,0,1,,1,POINT (7088729 -70740253)
2019,Junio,Argentina,0,1,,1,POINT (7128047 -73181317)
2019,Junio,Argentina,3,5,,8,POINT (7819 -72453013)
2019,Junio,Argentina,0,1,,1,POINT (836068 -72409396)
2019,Junio,Argentina,0,1,,1,POINT (863337 -7735002)
2019,Junio,República de Armenia,2,1,,3,POINT (10446304 -75516486)
2019,Junio,República de Armenia,1,2,,3,POINT (4697157 -74140516)
2019,Junio,República de Armenia,0,2,,2,POINT (6170465 -7542726)
2019,Junio,Australia,2,0,,2,POINT (-4191162 -69941498)
2019,Junio,Australia,2,3,,5,POINT (-4214082 -69941431)
2019,Junio,Australia,19,29,,48,POINT (0.81488 -77356)
2019,Junio,Australia,14,16,,30,POINT (10406342 -75527794)
2019,Junio,Australia,53,64,,117,POINT (10446304 -75516486)
2019,Junio,Australia,4,13,,17,POINT (10886686 -74776479)
2019,Junio,Australia,0,1,,1,POINT (11360029 -72129595)
2019,Junio,Australia,1,2,,3,POINT (125862 -81702165)
2019,Junio,Australia,9,24,,33,POINT (3451668 -76532004)
2019,Junio,Australia,0,1,,1,POINT (445285 -75766353)
2019,Junio,Australia,334,581,,915,POINT (4697157 -74140516)
2019,Junio,Australia,2,0,,2,POINT (4815189 -75736374)
2019,Junio,Australia,56,77,,133,POINT (6170465 -7542726)
2019,Junio,Australia,0,1,,1,POINT (7819 -72453013)
2019,Junio,Australia,0,1,,1,POINT (836068 -72409396)
2019,Junio,Australia,11,12,,23,POINT (863337 -7735002)
2019,Junio,Austria,3,1,,4,POINT (-4214082 -69941431)
2019,Junio,Austria,13,12,,25,POINT (0.81488 -77356)
2019,Junio,Austria,1,4,,5,POINT (10406342 -75527794)
2019,Junio,Austria,6,12,,18,POINT (10446304 -75516486)
2019,Junio,Austria,0,2,,2,POINT (10886686 -74776479)
2019,Junio,Austria,2,4,,6,POINT (3451668 -76532004)
2019,Junio,Austria,125,229,,354,POINT (4697157 -74140516)
2019,Junio,Austria,0,2,,2,POINT (4815189 -75736374)
2019,Junio,Austria,11,24,,35,POINT (6170465 -7542726)
2019,Junio,Azerbaiyán,0,1,,1,POINT (4697157 -74140516)
2019,Junio,Bahamas,12,5,,17,POINT (10446304 -75516486)
2019,Junio,Bahamas,1,4,,5,POINT (10886686 -74776479)
2019,Junio,Bahamas,0,5,,5,POINT (3451668 -76532004)
2019,Junio,Bahamas,6,18,,24,POINT (4697157 -74140516)
2019,Junio,Bahamas,5,9,,14,POINT (6170465 -7542726)
2019,Junio,Bahréin,1,1,,2,POINT (10886686 -74776479)
2019,Junio,Bahréin,0,3,,3,POINT (4697157 -74140516)
2019,Junio,Bangladesh,0,1,,1,POINT (10446304 -75516486)
2019,Junio,Bangladesh,1,4,,5,POINT (4697157 -74140516)
2019,Junio,Bangladesh,1,0,,1,POINT (6170465 -7542726)
2019,Junio,Barbados,1,1,,2,POINT (10406342 -75527794)
2019,Junio,Barbados,2,2,,4,POINT (10446304 -75516486)
2019,Junio,Barbados,2,0,,2,POINT (10886686 -74776479)
2019,Junio,Barbados,16,10,,26,POINT (4697157 -74140516)
2019,Junio,Barbados,1,6,,7,POINT (6170465 -7542726)
2019,Junio,República de Belarús,0,1,,1,POINT (3451668 -76532004)
2019,Junio,República de Belarús,0,1,,1,POINT (3884426 -77061029)
2019,Junio,República de Belarús,1,5,,6,POINT (4697157 -74140516)
2019,Junio,República de Belarús,1,0,,1,POINT (6170465 -7542726)
2019,Junio,Bélgica,0,9,,9,POINT (-4214082 -69941431)
2019,Junio,Bélgica,18,22,,40,POINT (0.81488 -77356)
2019,Junio,Bélgica,2,1,,3,POINT (10406342 -75527794)
2019,Junio,Bélgica,33,46,,79,POINT (10446304 -75516486)
2019,Junio,Bélgica,3,5,,8,POINT (10886686 -74776479)
2019,Junio,Bélgica,0,1,,1,POINT (11360029 -72129595)
2019,Junio,Bélgica,0,1,,1,POINT (125862 -81702165)
2019,Junio,Bélgica,16,24,,40,POINT (3451668 -76532004)
2019,Junio,Bélgica,356,484,,840,POINT (4697157 -74140516)
2019,Junio,Bélgica,40,73,,113,POINT (6170465 -7542726)
2019,Junio,Bélgica,1,0,,1,POINT (7128047 -73181317)
2019,Junio,Belice,3,2,,5,POINT (10446304 -75516486)
2019,Junio,Belice,0,1,,1,POINT (10886686 -74776479)
2019,Junio,Belice,0,2,,2,POINT (3451668 -76532004)
2019,Junio,Belice,12,16,,28,POINT (4697157 -74140516)
2019,Junio,Belice,4,7,,11,POINT (6170465 -7542726)
2019,Junio,Benín,0,1,,1,POINT (10406342 -75527794)
2019,Junio,Bermudas/Territorio Británico de Ultramar,0,2,,2,POINT (4697157 -74140516)
2019,Junio,Bermudas/Territorio Británico de Ultramar,0,2,,2,POINT (6170465 -7542726)
2019,Junio,Bolivia,0,2,,2,POINT (-4191162 -69941498)
2019,Junio,Bolivia,11,10,,21,POINT (0.81488 -77356)
2019,Junio,Bolivia,12,14,,26,POINT (10406342 -75527794)
2019,Junio,Bolivia,81,67,,148,POINT (10446304 -75516486)
2019,Junio,Bolivia,2,1,,3,POINT (10886686 -74776479)
2019,Junio,Bolivia,1,4,,5,POINT (11360029 -72129595)
2019,Junio,Bolivia,31,16,,47,POINT (125862 -81702165)
2019,Junio,Bolivia,13,20,,33,POINT (3451668 -76532004)
2019,Junio,Bolivia,832,817,,1649,POINT (4697157 -74140516)
2019,Junio,Bolivia,43,39,,82,POINT (6170465 -7542726)
2019,Junio,Bolivia,1,0,,1,POINT (863337 -7735002)
2019,Junio,Bosnia y Herzegovina,8,1,,9,POINT (4697157 -74140516)
2019,Junio,Botsuana,1,0,,1,POINT (4697157 -74140516)
2019,Junio,Brasil,156,160,,316,POINT (-4191162 -69941498)
2019,Junio,Brasil,1,8,,9,POINT (-4214082 -69941431)
2019,Junio,Brasil,0,1,,1,POINT (0.33002 -76876446)
2019,Junio,Brasil,21,37,,58,POINT (0.81488 -77356)
2019,Junio,Brasil,230,157,,387,POINT (10406342 -75527794)
2019,Junio,Brasil,509,372,,881,POINT (10446304 -75516486)
2019,Junio,Brasil,13,25,,38,POINT (10886686 -74776479)
2019,Junio,Brasil,1,3,,4,POINT (11360029 -72129595)
2019,Junio,Brasil,221,169,,390,POINT (125862 -81702165)
2019,Junio,Brasil,56,114,,170,POINT (3451668 -76532004)
2019,Junio,Brasil,1,6,,7,POINT (3866713 -67927521)
2019,Junio,Brasil,1,1,,2,POINT (445285 -75766353)
2019,Junio,Brasil,3501,4581,,8082,POINT (4697157 -74140516)
2019,Junio,Brasil,6,9,,15,POINT (4815189 -75736374)
2019,Junio,Brasil,148,266,,414,POINT (6170465 -7542726)
2019,Junio,Brasil,1,0,,1,POINT (6185536 -67484028)
2019,Junio,Brasil,0,1,,1,POINT (7088729 -70740253)
2019,Junio,Brasil,0,1,,1,POINT (7128047 -73181317)
2019,Junio,Brasil,0,3,,3,POINT (7819 -72453013)
2019,Junio,Brasil,0,12,,12,POINT (7927233 -72508188)
2019,Junio,Brasil,0,2,,2,POINT (836068 -72409396)
2019,Junio,Brasil,1,1,,2,POINT (863337 -7735002)
2019,Junio,Brunei Darussalam,1,1,,2,POINT (4697157 -74140516)
2019,Junio,Bulgaria,1,2,,3,POINT (0.81488 -77356)
2019,Junio,Bulgaria,1,2,,3,POINT (10446304 -75516486)
2019,Junio,Bulgaria,1,3,,4,POINT (3451668 -76532004)
2019,Junio,Bulgaria,27,15,,42,POINT (4697157 -74140516)
2019,Junio,Bulgaria,0,1,,1,POINT (4815189 -75736374)
2019,Junio,Bulgaria,4,12,,16,POINT (6170465 -7542726)
2019,Junio,Bulgaria,0,1,,1,POINT (863337 -7735002)
2019,Junio,Burkina Faso,0,1,,1,POINT (4697157 -74140516)
2019,Junio,Cabo Verde,0,1,,1,POINT (6170465 -7542726)
2019,Junio,Islas Caimán/Territorio Británico de Ultramar,1,1,,2,POINT (10446304 -75516486)
2019,Junio,Islas Caimán/Territorio Británico de Ultramar,1,0,,1,POINT (125862 -81702165)
2019,Junio,Islas Caimán/Territorio Británico de Ultramar,0,3,,3,POINT (4697157 -74140516)
2019,Junio,Islas Caimán/Territorio Británico de Ultramar,0,1,,1,POINT (6170465 -7542726)
2019,Junio,Camboya,1,1,,2,POINT (4697157 -74140516)
2019,Junio,Camerún,0,1,,1,POINT (10406342 -75527794)
2019,Junio,Camerún,0,1,,1,POINT (4697157 -74140516)
2019,Junio,Canadá,1,1,,2,POINT (-4191162 -69941498)
2019,Junio,Canadá,1,2,,3,POINT (-4214082 -69941431)
2019,Junio,Canadá,13,13,,26,POINT (0.81488 -77356)
2019,Junio,Canadá,1,2,,3,POINT (10406342 -75527794)
2019,Junio,Canadá,142,191,,333,POINT (10446304 -75516486)
2019,Junio,Canadá,37,54,,91,POINT (10886686 -74776479)
2019,Junio,Canadá,1,1,,2,POINT (11247723 -74213989)
2019,Junio,Canadá,0,1,,1,POINT (11360029 -72129595)
2019,Junio,Canadá,1,1,,2,POINT (125862 -81702165)
2019,Junio,Canadá,50,88,,138,POINT (3451668 -76532004)
2019,Junio,Canadá,4,2,,6,POINT (445285 -75766353)
2019,Junio,Canadá,1192,1967,,3159,POINT (4697157 -74140516)
2019,Junio,Canadá,9,8,,17,POINT (4815189 -75736374)
2019,Junio,Canadá,236,491,,727,POINT (6170465 -7542726)
2019,Junio,Canadá,1,4,,5,POINT (7128047 -73181317)
2019,Junio,Canadá,3,3,,6,POINT (7819 -72453013)
2019,Junio,Canadá,3,3,,6,POINT (863337 -7735002)
2019,Junio,Comoras,0,1,,1,POINT (6170465 -7542726)
2019,Junio,República Democrática del Congo,0,1,,1,POINT (10406342 -75527794)
2019,Junio,República Democrática del Congo,2,2,,4,POINT (4697157 -74140516)
2019,Junio,República Democrática del Congo,1,0,,1,POINT (6170465 -7542726)
2019,Junio,República de Corea,19,13,,32,POINT (0.81488 -77356)
2019,Junio,República de Corea,1,0,,1,POINT (10406342 -75527794)
2019,Junio,República de Corea,19,11,,30,POINT (10446304 -75516486)
2019,Junio,República de Corea,0,5,,5,POINT (10886686 -74776479)
2019,Junio,República de Corea,1,4,,5,POINT (3451668 -76532004)
2019,Junio,República de Corea,171,374,,545,POINT (4697157 -74140516)
2019,Junio,República de Corea,16,45,,61,POINT (6170465 -7542726)
2019,Junio,Costa de Marfil,1,0,,1,POINT (10406342 -75527794)
2019,Junio,Costa de Marfil,0,1,,1,POINT (4697157 -74140516)
2019,Junio,Costa Rica,2,0,,2,POINT (0.33002 -76876446)
2019,Junio,Costa Rica,1,2,,3,POINT (0.81488 -77356)
2019,Junio,Costa Rica,0,3,,3,POINT (1800143 -78802679)
2019,Junio,Costa Rica,1,2,,3,POINT (10406342 -75527794)
2019,Junio,Costa Rica,161,122,,283,POINT (10446304 -75516486)
2019,Junio,Costa Rica,15,32,,47,POINT (10886686 -74776479)
2019,Junio,Costa Rica,0,2,,2,POINT (11117206 -74232675)
2019,Junio,Costa Rica,2,0,,2,POINT (11360029 -72129595)
2019,Junio,Costa Rica,0,1,,1,POINT (125744111 -81703935)
2019,Junio,Costa Rica,107,85,,192,POINT (125862 -81702165)
2019,Junio,Costa Rica,27,42,,69,POINT (3451668 -76532004)
2019,Junio,Costa Rica,1,1,,2,POINT (445285 -75766353)
2019,Junio,Costa Rica,1272,1451,,2723,POINT (4697157 -74140516)
2019,Junio,Costa Rica,5,9,,14,POINT (4815189 -75736374)
2019,Junio,Costa Rica,98,147,,245,POINT (6170465 -7542726)
2019,Junio,Costa Rica,0,3,,3,POINT (7819 -72453013)
2019,Junio,Costa Rica,0,1,,1,POINT (863337 -7735002)
2019,Junio,Croacia,1,0,,1,POINT (0.81488 -77356)
2019,Junio,Croacia,0,1,,1,POINT (10406342 -75527794)
2019,Junio,Croacia,0,2,,2,POINT (10446304 -75516486)
2019,Junio,Croacia,0,1,,1,POINT (3451668 -76532004)
2019,Junio,Croacia,0,1,,1,POINT (3884426 -77061029)
2019,Junio,Croacia,11,34,,45,POINT (4697157 -74140516)
2019,Junio,Croacia,1,0,,1,POINT (4815189 -75736374)
2019,Junio,Croacia,6,8,,14,POINT (6170465 -7542726)
2019,Junio,Cuba,1,2,,3,POINT (-4191162 -69941498)
2019,Junio,Cuba,0,1,,1,POINT (10406342 -75527794)
2019,Junio,Cuba,14,15,,29,POINT (10446304 -75516486)
2019,Junio,Cuba,8,18,,26,POINT (10886686 -74776479)
2019,Junio,Cuba,17,17,,34,POINT (3451668 -76532004)
2019,Junio,Cuba,0,2,,2,POINT (445285 -75766353)
2019,Junio,Cuba,198,319,,517,POINT (4697157 -74140516)
2019,Junio,Cuba,1,1,,2,POINT (4815189 -75736374)
2019,Junio,Cuba,20,24,,44,POINT (6170465 -7542726)
2019,Junio,Cuba,0,1,,1,POINT (7088729 -70740253)
2019,Junio,Cuba,2,2,,4,POINT (7128047 -73181317)
2019,Junio,Cuba,0,1,,1,POINT (7819 -72453013)
2019,Junio,República Checa,1,2,,3,POINT (-4214082 -69941431)
2019,Junio,República Checa,3,5,,8,POINT (0.81488 -77356)
2019,Junio,República Checa,7,6,,13,POINT (10446304 -75516486)
2019,Junio,República Checa,0,1,,1,POINT (10886686 -74776479)
2019,Junio,República Checa,0,1,,1,POINT (11360029 -72129595)
2019,Junio,República Checa,0,14,,14,POINT (3451668 -76532004)
2019,Junio,República Checa,44,90,,134,POINT (4697157 -74140516)
2019,Junio,República Checa,4,7,,11,POINT (6170465 -7542726)
2019,Junio,Chile,0,1,,1,POINT (-4191162 -69941498)
2019,Junio,Chile,3,3,,6,POINT (-4214082 -69941431)
2019,Junio,Chile,0,5,,5,POINT (0.33002 -76876446)
2019,Junio,Chile,23,56,,79,POINT (0.81488 -77356)
2019,Junio,Chile,100,72,,172,POINT (10406342 -75527794)
2019,Junio,Chile,315,254,,569,POINT (10446304 -75516486)
2019,Junio,Chile,7,22,,29,POINT (10886686 -74776479)
2019,Junio,Chile,1,6,,7,POINT (11360029 -72129595)
2019,Junio,Chile,84,60,,144,POINT (125862 -81702165)
2019,Junio,Chile,0,2,,2,POINT (133387613 -81372937)
2019,Junio,Chile,89,134,,223,POINT (3451668 -76532004)
2019,Junio,Chile,3339,4685,,8024,POINT (4697157 -74140516)
2019,Junio,Chile,2,4,,6,POINT (4815189 -75736374)
2019,Junio,Chile,76,175,,251,POINT (6170465 -7542726)
2019,Junio,Chile,0,1,,1,POINT (7128047 -73181317)
2019,Junio,Chile,6,17,,23,POINT (7819 -72453013)
2019,Junio,Chile,0,1,,1,POINT (836068 -72409396)
2019,Junio,China,2,0,,2,POINT (-4191162 -69941498)
2019,Junio,China,1,0,,1,POINT (-4214082 -69941431)
2019,Junio,China,3,12,,15,POINT (0.81488 -77356)
2019,Junio,China,10,26,,36,POINT (10446304 -75516486)
2019,Junio,China,9,22,,31,POINT (10886686 -74776479)
2019,Junio,China,0,2,,2,POINT (10970933 -74765343)
2019,Junio,China,1,0,,1,POINT (125744111 -81703935)
2019,Junio,China,1,0,,1,POINT (125862 -81702165)
2019,Junio,China,8,25,,33,POINT (3451668 -76532004)
2019,Junio,China,0,1,,1,POINT (3884426 -77061029)
2019,Junio,China,0,2,,2,POINT (445285 -75766353)
2019,Junio,China,494,992,,1486,POINT (4697157 -74140516)
2019,Junio,China,1,1,,2,POINT (4815189 -75736374)
2019,Junio,China,43,67,,110,POINT (6170465 -7542726)
2019,Junio,China,4,3,,7,POINT (7128047 -73181317)
2019,Junio,China,3,4,,7,POINT (7819 -72453013)
2019,Junio,China,0,1,,1,POINT (7927233 -72508188)
2019,Junio,China,1,1,,2,POINT (836068 -72409396)
2019,Junio,Taiwán,2,1,,3,POINT (0.81488 -77356)
2019,Junio,Taiwán,4,3,,7,POINT (10446304 -75516486)
2019,Junio,Taiwán,0,2,,2,POINT (10886686 -74776479)
2019,Junio,Taiwán,1,3,,4,POINT (3451668 -76532004)
2019,Junio,Taiwán,70,83,,153,POINT (4697157 -74140516)
2019,Junio,Taiwán,2,8,,10,POINT (6170465 -7542726)
2019,Junio,Taiwán,2,1,,3,POINT (7819 -72453013)
2019,Junio,Taiwán,1,0,,1,POINT (863337 -7735002)
2019,Junio,Chipre,0,1,,1,POINT (10886686 -74776479)
2019,Junio,Chipre,0,1,,1,POINT (3451668 -76532004)
2019,Junio,Chipre,6,9,,15,POINT (4697157 -74140516)
2019,Junio,Chipre,0,3,,3,POINT (6170465 -7542726)
2019,Junio,Dinamarca,0,1,,1,POINT (0.33002 -76876446)
2019,Junio,Dinamarca,5,8,,13,POINT (0.81488 -77356)
2019,Junio,Dinamarca,1,2,,3,POINT (10406342 -75527794)
2019,Junio,Dinamarca,10,20,,30,POINT (10446304 -75516486)
2019,Junio,Dinamarca,0,2,,2,POINT (10886686 -74776479)
2019,Junio,Dinamarca,4,6,,10,POINT (3451668 -76532004)
2019,Junio,Dinamarca,106,142,,248,POINT (4697157 -74140516)
2019,Junio,Dinamarca,3,5,,8,POINT (4815189 -75736374)
2019,Junio,Dinamarca,8,20,,28,POINT (6170465 -7542726)
2019,Junio,Dinamarca,2,0,,2,POINT (863337 -7735002)
2019,Junio,Dominica,1,0,,1,POINT (10446304 -75516486)
2019,Junio,Dominica,1,0,,1,POINT (10886686 -74776479)
2019,Junio,Dominica,2,2,,4,POINT (3451668 -76532004)
2019,Junio,Dominica,4,2,,6,POINT (4697157 -74140516)
2019,Junio,Dominica,2,0,,2,POINT (6170465 -7542726)
2019,Junio,Ecuador,0,4,,4,POINT (-4191162 -69941498)
2019,Junio,Ecuador,0,3,,3,POINT (-4214082 -69941431)
2019,Junio,Ecuador,1,2,,3,POINT (0.185957 -7478366)
2019,Junio,Ecuador,61,218,,279,POINT (0.33002 -76876446)
2019,Junio,Ecuador,6,7,,13,POINT (0.812436 -77847006)
2019,Junio,Ecuador,1266,2029,,3295,POINT (0.81488 -77356)
2019,Junio,Ecuador,16,54,,70,POINT (1800143 -78802679)
2019,Junio,Ecuador,15,43,,58,POINT (10406342 -75527794)
2019,Junio,Ecuador,64,56,,120,POINT (10446304 -75516486)
2019,Junio,Ecuador,3,4,,7,POINT (10886686 -74776479)
2019,Junio,Ecuador,0,1,,1,POINT (11117206 -74232675)
2019,Junio,Ecuador,6,8,,14,POINT (11360029 -72129595)
2019,Junio,Ecuador,11,8,,19,POINT (125862 -81702165)
2019,Junio,Ecuador,245,355,,600,POINT (3451668 -76532004)
2019,Junio,Ecuador,0,4,,4,POINT (445285 -75766353)
2019,Junio,Ecuador,2344,3191,,5535,POINT (4697157 -74140516)
2019,Junio,Ecuador,1,3,,4,POINT (4815189 -75736374)
2019,Junio,Ecuador,53,76,,129,POINT (6170465 -7542726)
2019,Junio,Ecuador,2,0,,2,POINT (7088729 -70740253)
2019,Junio,Ecuador,1,0,,1,POINT (7128047 -73181317)
2019,Junio,Ecuador,40,60,,100,POINT (7819 -72453013)
2019,Junio,Ecuador,1,4,,5,POINT (836068 -72409396)
2019,Junio,Egipto,0,1,,1,POINT (10406342 -75527794)
2019,Junio,Egipto,0,1,,1,POINT (10446304 -75516486)
2019,Junio,Egipto,0,1,,1,POINT (445285 -75766353)
2019,Junio,Egipto,10,26,,36,POINT (4697157 -74140516)
2019,Junio,Egipto,5,7,,12,POINT (6170465 -7542726)
2019,Junio,El Salvador,3,2,,5,POINT (0.81488 -77356)
2019,Junio,El Salvador,0,4,,4,POINT (10406342 -75527794)
2019,Junio,El Salvador,26,37,,63,POINT (10446304 -75516486)
2019,Junio,El Salvador,2,7,,9,POINT (10886686 -74776479)
2019,Junio,El Salvador,0,1,,1,POINT (11360029 -72129595)
2019,Junio,El Salvador,7,3,,10,POINT (125862 -81702165)
2019,Junio,El Salvador,2,9,,11,POINT (3451668 -76532004)
2019,Junio,El Salvador,476,614,,1090,POINT (4697157 -74140516)
2019,Junio,El Salvador,1,1,,2,POINT (4815189 -75736374)
2019,Junio,El Salvador,102,95,,197,POINT (6170465 -7542726)
2019,Junio,El Salvador,0,1,,1,POINT (7128047 -73181317)
2019,Junio,El Salvador,1,1,,2,POINT (7819 -72453013)
2019,Junio,Emiratos Árabes,1,1,,2,POINT (10446304 -75516486)
2019,Junio,Emiratos Árabes,0,2,,2,POINT (3451668 -76532004)
2019,Junio,Emiratos Árabes,4,11,,15,POINT (4697157 -74140516)
2019,Junio,Emiratos Árabes,0,1,,1,POINT (6170465 -7542726)
2019,Junio,España,4,1,,5,POINT (-4191162 -69941498)
2019,Junio,España,8,9,,17,POINT (-4214082 -69941431)
2019,Junio,España,2,0,,2,POINT (0.33002 -76876446)
2019,Junio,España,39,49,,88,POINT (0.81488 -77356)
2019,Junio,España,0,1,,1,POINT (1800143 -78802679)
2019,Junio,España,12,13,,25,POINT (10406342 -75527794)
2019,Junio,España,107,164,,271,POINT (10446304 -75516486)
2019,Junio,España,7,45,,52,POINT (10886686 -74776479)
2019,Junio,España,2,2,,4,POINT (10970933 -74765343)
2019,Junio,España,0,2,,2,POINT (11117206 -74232675)
2019,Junio,España,1,6,,7,POINT (11247723 -74213989)
2019,Junio,España,6,17,,23,POINT (11360029 -72129595)
2019,Junio,España,2,2,,4,POINT (125744111 -81703935)
2019,Junio,España,6,8,,14,POINT (125862 -81702165)
2019,Junio,España,308,439,,747,POINT (3451668 -76532004)
2019,Junio,España,1,0,,1,POINT (445285 -75766353)
2019,Junio,España,2677,5168,,7845,POINT (4697157 -74140516)
2019,Junio,España,5,9,,14,POINT (4815189 -75736374)
2019,Junio,España,553,947,,1500,POINT (6170465 -7542726)
2019,Junio,España,0,1,,1,POINT (6185536 -67484028)
2019,Junio,España,1,2,,3,POINT (7088729 -70740253)
2019,Junio,España,2,1,,3,POINT (7128047 -73181317)
2019,Junio,España,24,49,,73,POINT (7819 -72453013)
2019,Junio,España,5,5,,10,POINT (836068 -72409396)
2019,Junio,España,0,2,,2,POINT (863337 -7735002)
2019,Junio,Eslovaquia,0,2,,2,POINT (0.81488 -77356)
2019,Junio,Eslovaquia,5,5,,10,POINT (10446304 -75516486)
2019,Junio,Eslovaquia,1,0,,1,POINT (3451668 -76532004)
2019,Junio,Eslovaquia,30,19,,49,POINT (4697157 -74140516)
2019,Junio,Eslovaquia,3,2,,5,POINT (6170465 -7542726)
2019,Junio,Eslovenia,0,1,,1,POINT (-4214082 -69941431)
2019,Junio,Eslovenia,0,1,,1,POINT (0.81488 -77356)
2019,Junio,Eslovenia,1,0,,1,POINT (10446304 -75516486)
2019,Junio,Eslovenia,1,0,,1,POINT (10886686 -74776479)
2019,Junio,Eslovenia,10,13,,23,POINT (4697157 -74140516)
2019,Junio,Eslovenia,4,6,,10,POINT (6170465 -7542726)
2019,Junio,Estados Unidos de América,18,31,,49,POINT (-4191162 -69941498)
2019,Junio,Estados Unidos de América,14,20,,34,POINT (-4214082 -69941431)
2019,Junio,Estados Unidos de América,1,5,,6,POINT (0.33002 -76876446)
2019,Junio,Estados Unidos de América,39,66,,105,POINT (0.81488 -77356)
2019,Junio,Estados Unidos de América,31,78,,109,POINT (10406342 -75527794)
2019,Junio,Estados Unidos de América,5622,7095,,12717,POINT (10446304 -75516486)
2019,Junio,Estados Unidos de América,1041,1459,,2500,POINT (10886686 -74776479)
2019,Junio,Estados Unidos de América,7,9,,16,POINT (11117206 -74232675)
2019,Junio,Estados Unidos de América,1,6,,7,POINT (11247723 -74213989)
2019,Junio,Estados Unidos de América,9,16,,25,POINT (11360029 -72129595)
2019,Junio,Estados Unidos de América,4,6,,10,POINT (1152863 -72919186)
2019,Junio,Estados Unidos de América,1,4,,5,POINT (125744111 -81703935)
2019,Junio,Estados Unidos de América,75,72,,147,POINT (125862 -81702165)
2019,Junio,Estados Unidos de América,2,3,,5,POINT (133387613 -81372937)
2019,Junio,Estados Unidos de América,2445,2933,,5378,POINT (3451668 -76532004)
2019,Junio,Estados Unidos de América,287,358,,645,POINT (445285 -75766353)
2019,Junio,Estados Unidos de América,13761,19588,,33349,POINT (4697157 -74140516)
2019,Junio,Estados Unidos de América,440,511,,951,POINT (4815189 -75736374)
2019,Junio,Estados Unidos de América,5069,9166,,14235,POINT (6170465 -7542726)
2019,Junio,Estados Unidos de América,1,1,,2,POINT (6185536 -67484028)
2019,Junio,Estados Unidos de América,0,2,,2,POINT (6218835 -75586989)
2019,Junio,Estados Unidos de América,1,0,,1,POINT (7088729 -70740253)
2019,Junio,Estados Unidos de América,77,83,,160,POINT (7128047 -73181317)
2019,Junio,Estados Unidos de América,11,13,,24,POINT (7819 -72453013)
2019,Junio,Estados Unidos de América,0,1,,1,POINT (836068 -72409396)
2019,Junio,Estados Unidos de América,5,12,,17,POINT (863337 -7735002)
2019,Junio,Estados Unidos de América,1,0,,1,POINT (9402597 -75681642)
2019,Junio,Estonia,1,0,,1,POINT (-4214082 -69941431)
2019,Junio,Estonia,1,1,,2,POINT (0.81488 -77356)
2019,Junio,Estonia,4,9,,13,POINT (4697157 -74140516)
2019,Junio,Estonia,6,6,,12,POINT (6170465 -7542726)
2019,Junio,Etiopia,2,53,,55,POINT (4697157 -74140516)
2019,Junio,Islas Fiji,1,0,,1,POINT (10446304 -75516486)
2019,Junio,Islas Fiji,0,1,,1,POINT (4697157 -74140516)
2019,Junio,Filipinas,3,2,,5,POINT (0.81488 -77356)
2019,Junio,Filipinas,2,40,,42,POINT (10406342 -75527794)
2019,Junio,Filipinas,7,50,,57,POINT (10446304 -75516486)
2019,Junio,Filipinas,1,19,,20,POINT (10886686 -74776479)
2019,Junio,Filipinas,0,27,,27,POINT (10970933 -74765343)
2019,Junio,Filipinas,0,3,,3,POINT (11247723 -74213989)
2019,Junio,Filipinas,1,13,,14,POINT (3451668 -76532004)
2019,Junio,Filipinas,0,12,,12,POINT (3884426 -77061029)
2019,Junio,Filipinas,65,63,,128,POINT (4697157 -74140516)
2019,Junio,Filipinas,1,0,,1,POINT (4815189 -75736374)
2019,Junio,Filipinas,4,4,,8,POINT (6170465 -7542726)
2019,Junio,Filipinas,0,11,,11,POINT (9402597 -75681642)
2019,Junio,Finlandia,4,2,,6,POINT (0.81488 -77356)
2019,Junio,Finlandia,1,0,,1,POINT (10406342 -75527794)
2019,Junio,Finlandia,4,2,,6,POINT (10446304 -75516486)
2019,Junio,Finlandia,0,1,,1,POINT (11360029 -72129595)
2019,Junio,Finlandia,0,1,,1,POINT (125862 -81702165)
2019,Junio,Finlandia,3,8,,11,POINT (3451668 -76532004)
2019,Junio,Finlandia,51,61,,112,POINT (4697157 -74140516)
2019,Junio,Finlandia,6,7,,13,POINT (6170465 -7542726)
2019,Junio,Francia,4,4,,8,POINT (-4191162 -69941498)
2019,Junio,Francia,22,31,,53,POINT (-4214082 -69941431)
2019,Junio,Francia,7,4,,11,POINT (0.33002 -76876446)
2019,Junio,Francia,165,180,,345,POINT (0.81488 -77356)
2019,Junio,Francia,90,479,,569,POINT (10406342 -75527794)
2019,Junio,Francia,120,144,,264,POINT (10446304 -75516486)
2019,Junio,Francia,12,16,,28,POINT (10886686 -74776479)
2019,Junio,Francia,0,3,,3,POINT (11117206 -74232675)
2019,Junio,Francia,0,1,,1,POINT (11247723 -74213989)
2019,Junio,Francia,1,1,,2,POINT (11360029 -72129595)
2019,Junio,Francia,1,1,,2,POINT (125862 -81702165)
2019,Junio,Francia,1,1,,2,POINT (133387613 -81372937)
2019,Junio,Francia,47,88,,135,POINT (3451668 -76532004)
2019,Junio,Francia,1485,2308,,3793,POINT (4697157 -74140516)
2019,Junio,Francia,5,12,,17,POINT (4815189 -75736374)
2019,Junio,Francia,198,368,,566,POINT (6170465 -7542726)
2019,Junio,Francia,4,9,,13,POINT (7819 -72453013)
2019,Junio,Francia,5,6,,11,POINT (863337 -7735002)
2019,Junio,Gambia,0,1,,1,POINT (4697157 -74140516)
2019,Junio,Georgia,0,1,,1,POINT (10406342 -75527794)
2019,Junio,Georgia,0,2,,2,POINT (10446304 -75516486)
2019,Junio,Georgia,3,2,,5,POINT (4697157 -74140516)
2019,Junio,Georgia,0,2,,2,POINT (6170465 -7542726)
2019,Junio,Georgia,0,2,,2,POINT (9402597 -75681642)
2019,Junio,Ghana,0,6,,6,POINT (10446304 -75516486)
2019,Junio,Ghana,2,1,,3,POINT (3451668 -76532004)
2019,Junio,Ghana,2,7,,9,POINT (4697157 -74140516)
2019,Junio,Granada,0,1,,1,POINT (10446304 -75516486)
2019,Junio,Granada,0,1,,1,POINT (3451668 -76532004)
2019,Junio,Granada,3,5,,8,POINT (4697157 -74140516)
2019,Junio,Granada,3,1,,4,POINT (6170465 -7542726)
2019,Junio,Grecia,1,0,,1,POINT (-4214082 -69941431)
2019,Junio,Grecia,0,9,,9,POINT (10406342 -75527794)
2019,Junio,Grecia,2,10,,12,POINT (10446304 -75516486)
2019,Junio,Grecia,0,2,,2,POINT (10886686 -74776479)
2019,Junio,Grecia,0,1,,1,POINT (3451668 -76532004)
2019,Junio,Grecia,21,71,,92,POINT (4697157 -74140516)
2019,Junio,Grecia,3,7,,10,POINT (6170465 -7542726)
2019,Junio,Grecia,0,2,,2,POINT (9402597 -75681642)
2019,Junio,Guatemala,1,3,,4,POINT (0.81488 -77356)
2019,Junio,Guatemala,1,1,,2,POINT (10406342 -75527794)
2019,Junio,Guatemala,125,141,,266,POINT (10446304 -75516486)
2019,Junio,Guatemala,7,8,,15,POINT (10886686 -74776479)
2019,Junio,Guatemala,0,1,,1,POINT (10970933 -74765343)
2019,Junio,Guatemala,0,1,,1,POINT (11360029 -72129595)
2019,Junio,Guatemala,7,7,,14,POINT (125862 -81702165)
2019,Junio,Guatemala,13,26,,39,POINT (3451668 -76532004)
2019,Junio,Guatemala,0,1,,1,POINT (445285 -75766353)
2019,Junio,Guatemala,593,862,,1455,POINT (4697157 -74140516)
2019,Junio,Guatemala,1,4,,5,POINT (4815189 -75736374)
2019,Junio,Guatemala,86,123,,209,POINT (6170465 -7542726)
2019,Junio,Guatemala,0,1,,1,POINT (7102626 -77762647)
2019,Junio,Guatemala,1,1,,2,POINT (7128047 -73181317)
2019,Junio,Guatemala,1,1,,2,POINT (7819 -72453013)
2019,Junio,Guatemala,1,0,,1,POINT (863337 -7735002)
2019,Junio,Guyana,2,2,,4,POINT (10446304 -75516486)
2019,Junio,Guyana,1,0,,1,POINT (10886686 -74776479)
2019,Junio,Guyana,1,0,,1,POINT (125862 -81702165)
2019,Junio,Guyana,0,1,,1,POINT (3451668 -76532004)
2019,Junio,Guyana,10,8,,18,POINT (4697157 -74140516)
2019,Junio,Guyana,4,2,,6,POINT (6170465 -7542726)
2019,Junio,Guyana,1,1,,2,POINT (7128047 -73181317)
2019,Junio,Guyana,1,0,,1,POINT (7819 -72453013)
2019,Junio,Guinea,0,1,,1,POINT (6170465 -7542726)
2019,Junio,Guinea Ecuatorial,0,1,,1,POINT (4697157 -74140516)
2019,Junio,Guinea Ecuatorial,1,0,,1,POINT (6170465 -7542726)
2019,Junio,Guinea Bissau,1,0,,1,POINT (4697157 -74140516)
2019,Junio,Haití,3,4,,7,POINT (10446304 -75516486)
2019,Junio,Haití,0,1,,1,POINT (10886686 -74776479)
2019,Junio,Haití,1,2,,3,POINT (3451668 -76532004)
2019,Junio,Haití,0,1,,1,POINT (445285 -75766353)
2019,Junio,Haití,12,15,,27,POINT (4697157 -74140516)
2019,Junio,Haití,1,9,,10,POINT (6170465 -7542726)
2019,Junio,Honduras,3,2,,5,POINT (0.81488 -77356)
2019,Junio,Honduras,1,0,,1,POINT (10406342 -75527794)
2019,Junio,Honduras,41,40,,81,POINT (10446304 -75516486)
2019,Junio,Honduras,4,6,,10,POINT (10886686 -74776479)
2019,Junio,Honduras,0,50,,50,POINT (125744111 -81703935)
2019,Junio,Honduras,17,25,,42,POINT (3451668 -76532004)
2019,Junio,Honduras,0,1,,1,POINT (3884426 -77061029)
2019,Junio,Honduras,230,277,,507,POINT (4697157 -74140516)
2019,Junio,Honduras,84,89,,173,POINT (6170465 -7542726)
2019,Junio,Honduras,0,2,,2,POINT (7102626 -77762647)
2019,Junio,Honduras,1,0,,1,POINT (7819 -72453013)
2019,Junio,Hong Kong,1,0,,1,POINT (-4214082 -69941431)
2019,Junio,Hong Kong,3,1,,4,POINT (10446304 -75516486)
2019,Junio,Hong Kong,10,12,,22,POINT (4697157 -74140516)
2019,Junio,Hong Kong,2,2,,4,POINT (6170465 -7542726)
2019,Junio,Hungría,2,2,,4,POINT (0.81488 -77356)
2019,Junio,Hungría,1,1,,2,POINT (10446304 -75516486)
2019,Junio,Hungría,1,1,,2,POINT (10886686 -74776479)
2019,Junio,Hungría,0,1,,1,POINT (3451668 -76532004)
2019,Junio,Hungría,31,38,,69,POINT (4697157 -74140516)
2019,Junio,Hungría,13,13,,26,POINT (6170465 -7542726)
2019,Junio,Hungría,0,1,,1,POINT (7819 -72453013)
2019,Junio,India,1,5,,6,POINT (0.81488 -77356)
2019,Junio,India,0,11,,11,POINT (10406342 -75527794)
2019,Junio,India,10,65,,75,POINT (10446304 -75516486)
2019,Junio,India,4,17,,21,POINT (10886686 -74776479)
2019,Junio,India,0,1,,1,POINT (10970933 -74765343)
2019,Junio,India,0,6,,6,POINT (11247723 -74213989)
2019,Junio,India,0,1,,1,POINT (11360029 -72129595)
2019,Junio,India,1,15,,16,POINT (3451668 -76532004)
2019,Junio,India,0,2,,2,POINT (3884426 -77061029)
2019,Junio,India,84,402,,486,POINT (4697157 -74140516)
2019,Junio,India,12,76,,88,POINT (6170465 -7542726)
2019,Junio,India,0,1,,1,POINT (7128047 -73181317)
2019,Junio,India,0,5,,5,POINT (9402597 -75681642)
2019,Junio,Indonesia,2,0,,2,POINT (0.81488 -77356)
2019,Junio,Indonesia,1,2,,3,POINT (10446304 -75516486)
2019,Junio,Indonesia,0,1,,1,POINT (10886686 -74776479)
2019,Junio,Indonesia,0,2,,2,POINT (3451668 -76532004)
2019,Junio,Indonesia,21,29,,50,POINT (4697157 -74140516)
2019,Junio,Indonesia,4,3,,7,POINT (6170465 -7542726)
2019,Junio,Iraq,1,1,,2,POINT (4697157 -74140516)
2019,Junio,Irán,0,2,,2,POINT (10446304 -75516486)
2019,Junio,Irán,6,12,,18,POINT (4697157 -74140516)
2019,Junio,Irán,1,1,,2,POINT (6170465 -7542726)
2019,Junio,República de Irlanda,0,4,,4,POINT (-4214082 -69941431)
2019,Junio,República de Irlanda,9,10,,19,POINT (0.81488 -77356)
2019,Junio,República de Irlanda,3,2,,5,POINT (10406342 -75527794)
2019,Junio,República de Irlanda,17,31,,48,POINT (10446304 -75516486)
2019,Junio,República de Irlanda,4,3,,7,POINT (10886686 -74776479)
2019,Junio,República de Irlanda,2,0,,2,POINT (125862 -81702165)
2019,Junio,República de Irlanda,2,7,,9,POINT (3451668 -76532004)
2019,Junio,República de Irlanda,130,241,,371,POINT (4697157 -74140516)
2019,Junio,República de Irlanda,28,58,,86,POINT (6170465 -7542726)
2019,Junio,República de Irlanda,1,0,,1,POINT (7128047 -73181317)
2019,Junio,República de Irlanda,0,1,,1,POINT (7819 -72453013)
2019,Junio,República de Irlanda,8,10,,18,POINT (863337 -7735002)
2019,Junio,Islandia,0,1,,1,POINT (10446304 -75516486)
2019,Junio,Islandia,5,7,,12,POINT (4697157 -74140516)
2019,Junio,Islandia,0,3,,3,POINT (6170465 -7542726)
2019,Junio,Islandia,2,1,,3,POINT (7128047 -73181317)
2019,Junio,Israel,2,4,,6,POINT (-4191162 -69941498)
2019,Junio,Israel,0,1,,1,POINT (-4214082 -69941431)
2019,Junio,Israel,0,1,,1,POINT (0.33002 -76876446)
2019,Junio,Israel,50,105,,155,POINT (0.81488 -77356)
2019,Junio,Israel,52,49,,101,POINT (10406342 -75527794)
2019,Junio,Israel,18,52,,70,POINT (10446304 -75516486)
2019,Junio,Israel,0,6,,6,POINT (10886686 -74776479)
2019,Junio,Israel,2,8,,10,POINT (125862 -81702165)
2019,Junio,Israel,13,20,,33,POINT (3451668 -76532004)
2019,Junio,Israel,192,465,,657,POINT (4697157 -74140516)
2019,Junio,Israel,102,185,,287,POINT (6170465 -7542726)
2019,Junio,Italia,1,2,,3,POINT (-4191162 -69941498)
2019,Junio,Italia,4,5,,9,POINT (-4214082 -69941431)
2019,Junio,Italia,1,5,,6,POINT (0.33002 -76876446)
2019,Junio,Italia,14,25,,39,POINT (0.81488 -77356)
2019,Junio,Italia,1,10,,11,POINT (10406342 -75527794)
2019,Junio,Italia,103,164,,267,POINT (10446304 -75516486)
2019,Junio,Italia,18,43,,61,POINT (10886686 -74776479)
2019,Junio,Italia,0,1,,1,POINT (11117206 -74232675)
2019,Junio,Italia,18,15,,33,POINT (11360029 -72129595)
2019,Junio,Italia,8,3,,11,POINT (125862 -81702165)
2019,Junio,Italia,45,100,,145,POINT (3451668 -76532004)
2019,Junio,Italia,0,1,,1,POINT (445285 -75766353)
2019,Junio,Italia,705,1586,,2291,POINT (4697157 -74140516)
2019,Junio,Italia,1,12,,13,POINT (4815189 -75736374)
2019,Junio,Italia,130,264,,394,POINT (6170465 -7542726)
2019,Junio,Italia,1,1,,2,POINT (7128047 -73181317)
2019,Junio,Italia,16,29,,45,POINT (7819 -72453013)
2019,Junio,Italia,6,2,,8,POINT (836068 -72409396)
2019,Junio,Italia,0,1,,1,POINT (863337 -7735002)
2019,Junio,Jamaica,13,14,,27,POINT (10446304 -75516486)
2019,Junio,Jamaica,3,5,,8,POINT (10886686 -74776479)
2019,Junio,Jamaica,0,5,,5,POINT (125862 -81702165)
2019,Junio,Jamaica,6,6,,12,POINT (3451668 -76532004)
2019,Junio,Jamaica,27,29,,56,POINT (4697157 -74140516)
2019,Junio,Jamaica,0,3,,3,POINT (4815189 -75736374)
2019,Junio,Jamaica,8,17,,25,POINT (6170465 -7542726)
2019,Junio,Jamaica,0,1,,1,POINT (7819 -72453013)
2019,Junio,Japón,2,1,,3,POINT (-4214082 -69941431)
2019,Junio,Japón,3,8,,11,POINT (0.81488 -77356)
2019,Junio,Japón,0,1,,1,POINT (10406342 -75527794)
2019,Junio,Japón,7,16,,23,POINT (10446304 -75516486)
2019,Junio,Japón,1,2,,3,POINT (10886686 -74776479)
2019,Junio,Japón,1,0,,1,POINT (11117206 -74232675)
2019,Junio,Japón,11,12,,23,POINT (3451668 -76532004)
2019,Junio,Japón,0,1,,1,POINT (3884426 -77061029)
2019,Junio,Japón,1,0,,1,POINT (445285 -75766353)
2019,Junio,Japón,111,420,,531,POINT (4697157 -74140516)
2019,Junio,Japón,29,39,,68,POINT (6170465 -7542726)
2019,Junio,Japón,0,1,,1,POINT (7819 -72453013)
2019,Junio,Japón,0,1,,1,POINT (863337 -7735002)
2019,Junio,Jordania,0,1,,1,POINT (10446304 -75516486)
2019,Junio,Jordania,3,6,,9,POINT (4697157 -74140516)
2019,Junio,Jordania,1,0,,1,POINT (6170465 -7542726)
2019,Junio,Kazajistán,4,4,,8,POINT (4697157 -74140516)
2019,Junio,Kazajistán,1,1,,2,POINT (6170465 -7542726)
2019,Junio,Kenia,1,3,,4,POINT (10446304 -75516486)
2019,Junio,Kenia,1,0,,1,POINT (3451668 -76532004)
2019,Junio,Kenia,6,12,,18,POINT (4697157 -74140516)
2019,Junio,Kenia,2,1,,3,POINT (6170465 -7542726)
2019,Junio,Kiribati,0,1,,1,POINT (3884426 -77061029)
2019,Junio,Kirguistán,1,0,,1,POINT (10446304 -75516486)
2019,Junio,Kuwait,0,6,,6,POINT (10446304 -75516486)
2019,Junio,Kuwait,0,1,,1,POINT (10886686 -74776479)
2019,Junio,Kuwait,0,6,,6,POINT (4697157 -74140516)
2019,Junio,Kuwait,0,1,,1,POINT (6170465 -7542726)
2019,Junio,República de Kosovo,0,2,,2,POINT (4697157 -74140516)
2019,Junio,República de Kosovo,0,1,,1,POINT (6170465 -7542726)
2019,Junio,República Democrática Popular  Lao,0,1,,1,POINT (10446304 -75516486)
2019,Junio,Letonia,0,5,,5,POINT (10406342 -75527794)
2019,Junio,Letonia,1,2,,3,POINT (10446304 -75516486)
2019,Junio,Letonia,0,1,,1,POINT (10886686 -74776479)
2019,Junio,Letonia,0,2,,2,POINT (10970933 -74765343)
2019,Junio,Letonia,1,0,,1,POINT (3451668 -76532004)
2019,Junio,Letonia,0,1,,1,POINT (3884426 -77061029)
2019,Junio,Letonia,7,11,,18,POINT (4697157 -74140516)
2019,Junio,Letonia,1,1,,2,POINT (6170465 -7542726)
2019,Junio,Letonia,0,1,,1,POINT (836068 -72409396)
2019,Junio,Lituania,4,0,,4,POINT (0.81488 -77356)
2019,Junio,Lituania,5,4,,9,POINT (10446304 -75516486)
2019,Junio,Lituania,1,2,,3,POINT (3451668 -76532004)
2019,Junio,Lituania,27,18,,45,POINT (4697157 -74140516)
2019,Junio,Lituania,5,9,,14,POINT (6170465 -7542726)
2019,Junio,Lituania,1,0,,1,POINT (863337 -7735002)
2019,Junio,Líbano,0,2,,2,POINT (10406342 -75527794)
2019,Junio,Líbano,0,1,,1,POINT (10446304 -75516486)
2019,Junio,Líbano,5,1,,6,POINT (10886686 -74776479)
2019,Junio,Líbano,0,1,,1,POINT (11360029 -72129595)
2019,Junio,Líbano,1,2,,3,POINT (3451668 -76532004)
2019,Junio,Líbano,13,31,,44,POINT (4697157 -74140516)
2019,Junio,Líbano,0,1,,1,POINT (4815189 -75736374)
2019,Junio,Líbano,0,4,,4,POINT (6170465 -7542726)
2019,Junio,Líbano,1,1,,2,POINT (7128047 -73181317)
2019,Junio,Liberia,0,1,,1,POINT (4697157 -74140516)
2019,Junio,Liberia,0,1,,1,POINT (6170465 -7542726)
2019,Junio,Liechtenstein,1,0,,1,POINT (10446304 -75516486)
2019,Junio,Liechtenstein,2,1,,3,POINT (4697157 -74140516)
2019,Junio,Liechtenstein,0,1,,1,POINT (6170465 -7542726)
2019,Junio,Luxemburgo,2,1,,3,POINT (10446304 -75516486)
2019,Junio,Luxemburgo,0,1,,1,POINT (10886686 -74776479)
2019,Junio,Luxemburgo,8,11,,19,POINT (4697157 -74140516)
2019,Junio,Luxemburgo,2,1,,3,POINT (6170465 -7542726)
2019,Junio,Macedonia,0,3,,3,POINT (4697157 -74140516)
2019,Junio,Madagascar,1,1,,2,POINT (4697157 -74140516)
2019,Junio,Madagascar,3,0,,3,POINT (6170465 -7542726)
2019,Junio,Malasia,1,0,,1,POINT (0.81488 -77356)
2019,Junio,Malasia,2,5,,7,POINT (10446304 -75516486)
2019,Junio,Malasia,0,1,,1,POINT (3451668 -76532004)
2019,Junio,Malasia,8,13,,21,POINT (4697157 -74140516)
2019,Junio,Malasia,1,2,,3,POINT (6170465 -7542726)
2019,Junio,Malasia,0,1,,1,POINT (9402597 -75681642)
2019,Junio,Malawi,0,1,,1,POINT (4697157 -74140516)
2019,Junio,Malta,3,8,,11,POINT (4697157 -74140516)
2019,Junio,Malta,0,3,,3,POINT (6170465 -7542726)
2019,Junio,Marruecos,0,2,,2,POINT (10406342 -75527794)
2019,Junio,Marruecos,0,2,,2,POINT (10446304 -75516486)
2019,Junio,Marruecos,2,1,,3,POINT (3451668 -76532004)
2019,Junio,Marruecos,6,22,,28,POINT (4697157 -74140516)
2019,Junio,Marruecos,2,1,,3,POINT (6170465 -7542726)
2019,Junio,Mauricio,0,5,,5,POINT (4697157 -74140516)
2019,Junio,Mauricio,2,1,,3,POINT (6170465 -7542726)
2019,Junio,Mauritania,0,1,,1,POINT (4697157 -74140516)
2019,Junio,México,1,1,,2,POINT (-4191162 -69941498)
2019,Junio,México,2,3,,5,POINT (-4214082 -69941431)
2019,Junio,México,1,2,,3,POINT (0.33002 -76876446)
2019,Junio,México,35,43,,78,POINT (0.81488 -77356)
2019,Junio,México,0,1,,1,POINT (1800143 -78802679)
2019,Junio,México,17,27,,44,POINT (10406342 -75527794)
2019,Junio,México,220,402,,622,POINT (10446304 -75516486)
2019,Junio,México,31,81,,112,POINT (10886686 -74776479)
2019,Junio,México,1,5,,6,POINT (11360029 -72129595)
2019,Junio,México,4,3,,7,POINT (125862 -81702165)
2019,Junio,México,63,161,,224,POINT (3451668 -76532004)
2019,Junio,México,4,0,,4,POINT (445285 -75766353)
2019,Junio,México,4840,7349,,12189,POINT (4697157 -74140516)
2019,Junio,México,13,17,,30,POINT (4815189 -75736374)
2019,Junio,México,1139,1971,,3110,POINT (6170465 -7542726)
2019,Junio,México,6,14,,20,POINT (7128047 -73181317)
2019,Junio,México,0,16,,16,POINT (7819 -72453013)
2019,Junio,México,0,3,,3,POINT (836068 -72409396)
2019,Junio,México,0,1,,1,POINT (863337 -7735002)
2019,Junio,República de Moldavia,6,1,,7,POINT (4697157 -74140516)
2019,Junio,Mónaco,0,2,,2,POINT (10446304 -75516486)
2019,Junio,Mongolia,0,2,,2,POINT (10446304 -75516486)
2019,Junio,Mongolia,1,4,,5,POINT (4697157 -74140516)
2019,Junio,Montenegro,1,3,,4,POINT (4697157 -74140516)
2019,Junio,Mozambique,1,0,,1,POINT (10886686 -74776479)
2019,Junio,Myanmar,2,1,,3,POINT (4697157 -74140516)
2019,Junio,Namibia,0,1,,1,POINT (3451668 -76532004)
2019,Junio,Nepal,1,2,,3,POINT (4697157 -74140516)
2019,Junio,Nicaragua,1,0,,1,POINT (-4191162 -69941498)
2019,Junio,Nicaragua,0,1,,1,POINT (1800143 -78802679)
2019,Junio,Nicaragua,22,33,,55,POINT (10446304 -75516486)
2019,Junio,Nicaragua,0,8,,8,POINT (10886686 -74776479)
2019,Junio,Nicaragua,0,1,,1,POINT (11360029 -72129595)
2019,Junio,Nicaragua,7,4,,11,POINT (125744111 -81703935)
2019,Junio,Nicaragua,8,4,,12,POINT (125862 -81702165)
2019,Junio,Nicaragua,13,16,,29,POINT (3451668 -76532004)
2019,Junio,Nicaragua,94,103,,197,POINT (4697157 -74140516)
2019,Junio,Nicaragua,1,3,,4,POINT (4815189 -75736374)
2019,Junio,Nicaragua,39,36,,75,POINT (6170465 -7542726)
2019,Junio,Nicaragua,2,1,,3,POINT (7128047 -73181317)
2019,Junio,Nigeria,0,6,,6,POINT (10446304 -75516486)
2019,Junio,Nigeria,0,1,,1,POINT (10886686 -74776479)
2019,Junio,Nigeria,1,0,,1,POINT (3451668 -76532004)
2019,Junio,Nigeria,1,9,,10,POINT (4697157 -74140516)
2019,Junio,Nigeria,0,2,,2,POINT (6170465 -7542726)
2019,Junio,Noruega,1,0,,1,POINT (-4214082 -69941431)
2019,Junio,Noruega,4,2,,6,POINT (0.81488 -77356)
2019,Junio,Noruega,1,0,,1,POINT (10406342 -75527794)
2019,Junio,Noruega,16,28,,44,POINT (10446304 -75516486)
2019,Junio,Noruega,1,9,,10,POINT (10886686 -74776479)
2019,Junio,Noruega,1,1,,2,POINT (10970933 -74765343)
2019,Junio,Noruega,0,1,,1,POINT (11360029 -72129595)
2019,Junio,Noruega,11,20,,31,POINT (3451668 -76532004)
2019,Junio,Noruega,191,219,,410,POINT (4697157 -74140516)
2019,Junio,Noruega,4,2,,6,POINT (4815189 -75736374)
2019,Junio,Noruega,21,29,,50,POINT (6170465 -7542726)
2019,Junio,Noruega,0,1,,1,POINT (7128047 -73181317)
2019,Junio,Nueva Zelanda,1,2,,3,POINT (-4214082 -69941431)
2019,Junio,Nueva Zelanda,10,15,,25,POINT (0.81488 -77356)
2019,Junio,Nueva Zelanda,5,8,,13,POINT (10406342 -75527794)
2019,Junio,Nueva Zelanda,13,13,,26,POINT (10446304 -75516486)
2019,Junio,Nueva Zelanda,2,5,,7,POINT (10886686 -74776479)
2019,Junio,Nueva Zelanda,0,1,,1,POINT (11360029 -72129595)
2019,Junio,Nueva Zelanda,0,4,,4,POINT (3451668 -76532004)
2019,Junio,Nueva Zelanda,63,115,,178,POINT (4697157 -74140516)
2019,Junio,Nueva Zelanda,12,20,,32,POINT (6170465 -7542726)
2019,Junio,Nueva Zelanda,0,1,,1,POINT (7128047 -73181317)
2019,Junio,Nueva Zelanda,1,0,,1,POINT (863337 -7735002)
2019,Junio,Países Bajos,2,0,,2,POINT (-4191162 -69941498)
2019,Junio,Países Bajos,6,14,,20,POINT (-4214082 -69941431)
2019,Junio,Países Bajos,1,1,,2,POINT (0.33002 -76876446)
2019,Junio,Países Bajos,36,38,,74,POINT (0.81488 -77356)
2019,Junio,Países Bajos,26,12,,38,POINT (10406342 -75527794)
2019,Junio,Países Bajos,234,228,,462,POINT (10446304 -75516486)
2019,Junio,Países Bajos,12,35,,47,POINT (10886686 -74776479)
2019,Junio,Países Bajos,0,2,,2,POINT (11117206 -74232675)
2019,Junio,Países Bajos,2,6,,8,POINT (11360029 -72129595)
2019,Junio,Países Bajos,0,1,,1,POINT (1152863 -72919186)
2019,Junio,Países Bajos,0,3,,3,POINT (125862 -81702165)
2019,Junio,Países Bajos,68,70,,138,POINT (3451668 -76532004)
2019,Junio,Países Bajos,1537,2084,,3621,POINT (4697157 -74140516)
2019,Junio,Países Bajos,0,4,,4,POINT (4815189 -75736374)
2019,Junio,Países Bajos,131,218,,349,POINT (6170465 -7542726)
2019,Junio,Países Bajos,2,0,,2,POINT (6185536 -67484028)
2019,Junio,Países Bajos,13,12,,25,POINT (7128047 -73181317)
2019,Junio,Países Bajos,1,5,,6,POINT (7819 -72453013)
2019,Junio,Países Bajos,1,1,,2,POINT (7927233 -72508188)
2019,Junio,Países Bajos,0,2,,2,POINT (836068 -72409396)
2019,Junio,Países Bajos,5,4,,9,POINT (863337 -7735002)
2019,Junio,Pakistán,0,1,,1,POINT (10446304 -75516486)
2019,Junio,Pakistán,3,13,,16,POINT (4697157 -74140516)
2019,Junio,Pakistán,0,4,,4,POINT (6170465 -7542726)
2019,Junio,Panamá,6,2,,8,POINT (0.81488 -77356)
2019,Junio,Panamá,0,10,,10,POINT (10406342 -75527794)
2019,Junio,Panamá,526,438,,964,POINT (10446304 -75516486)
2019,Junio,Panamá,110,130,,240,POINT (10886686 -74776479)
2019,Junio,Panamá,0,2,,2,POINT (11360029 -72129595)
2019,Junio,Panamá,57,56,,113,POINT (125862 -81702165)
2019,Junio,Panamá,352,450,,802,POINT (3451668 -76532004)
2019,Junio,Panamá,1696,1902,,3598,POINT (4697157 -74140516)
2019,Junio,Panamá,31,37,,68,POINT (4815189 -75736374)
2019,Junio,Panamá,1889,1524,,3413,POINT (6170465 -7542726)
2019,Junio,Panamá,1,2,,3,POINT (7102626 -77762647)
2019,Junio,Panamá,22,19,,41,POINT (7128047 -73181317)
2019,Junio,Panamá,2,2,,4,POINT (7819 -72453013)
2019,Junio,Panamá,2,2,,4,POINT (863337 -7735002)
2019,Junio,Paraguay,2,5,,7,POINT (0.81488 -77356)
2019,Junio,Paraguay,1,1,,2,POINT (10406342 -75527794)
2019,Junio,Paraguay,45,30,,75,POINT (10446304 -75516486)
2019,Junio,Paraguay,0,2,,2,POINT (10886686 -74776479)
2019,Junio,Paraguay,9,9,,18,POINT (125862 -81702165)
2019,Junio,Paraguay,8,11,,19,POINT (3451668 -76532004)
2019,Junio,Paraguay,177,186,,363,POINT (4697157 -74140516)
2019,Junio,Paraguay,33,49,,82,POINT (6170465 -7542726)
2019,Junio,Perú,9,6,,15,POINT (-4191162 -69941498)
2019,Junio,Perú,47,47,,94,POINT (-4214082 -69941431)
2019,Junio,Perú,19,65,,84,POINT (0.185957 -7478366)
2019,Junio,Perú,5,9,,14,POINT (0.33002 -76876446)
2019,Junio,Perú,146,279,,425,POINT (0.81488 -77356)
2019,Junio,Perú,15,26,,41,POINT (10406342 -75527794)
2019,Junio,Perú,1270,766,,2036,POINT (10446304 -75516486)
2019,Junio,Perú,4,19,,23,POINT (10886686 -74776479)
2019,Junio,Perú,3,18,,21,POINT (11360029 -72129595)
2019,Junio,Perú,198,140,,338,POINT (125862 -81702165)
2019,Junio,Perú,200,290,,490,POINT (3451668 -76532004)
2019,Junio,Perú,2,2,,4,POINT (445285 -75766353)
2019,Junio,Perú,2957,3819,,6776,POINT (4697157 -74140516)
2019,Junio,Perú,2,4,,6,POINT (4815189 -75736374)
2019,Junio,Perú,562,840,,1402,POINT (6170465 -7542726)
2019,Junio,Perú,0,1,,1,POINT (7088729 -70740253)
2019,Junio,Perú,0,1,,1,POINT (7102626 -77762647)
2019,Junio,Perú,0,2,,2,POINT (7128047 -73181317)
2019,Junio,Perú,54,70,,124,POINT (7819 -72453013)
2019,Junio,Perú,4,4,,8,POINT (836068 -72409396)
2019,Junio,Perú,0,1,,1,POINT (863337 -7735002)
2019,Junio,Palestina,2,0,,2,POINT (4697157 -74140516)
2019,Junio,Palestina,0,1,,1,POINT (6170465 -7542726)
2019,Junio,Polonia,1,1,,2,POINT (-4191162 -69941498)
2019,Junio,Polonia,1,0,,1,POINT (-4214082 -69941431)
2019,Junio,Polonia,0,2,,2,POINT (0.33002 -76876446)
2019,Junio,Polonia,3,8,,11,POINT (0.81488 -77356)
2019,Junio,Polonia,0,7,,7,POINT (10406342 -75527794)
2019,Junio,Polonia,11,11,,22,POINT (10446304 -75516486)
2019,Junio,Polonia,2,1,,3,POINT (10886686 -74776479)
2019,Junio,Polonia,0,1,,1,POINT (11247723 -74213989)
2019,Junio,Polonia,1,7,,8,POINT (3451668 -76532004)
2019,Junio,Polonia,120,162,,282,POINT (4697157 -74140516)
2019,Junio,Polonia,30,30,,60,POINT (6170465 -7542726)
2019,Junio,Polonia,0,1,,1,POINT (836068 -72409396)
2019,Junio,Polonia,1,3,,4,POINT (863337 -7735002)
2019,Junio,Portugal,2,3,,5,POINT (-4214082 -69941431)
2019,Junio,Portugal,10,7,,17,POINT (0.81488 -77356)
2019,Junio,Portugal,4,5,,9,POINT (10406342 -75527794)
2019,Junio,Portugal,10,27,,37,POINT (10446304 -75516486)
2019,Junio,Portugal,3,13,,16,POINT (10886686 -74776479)
2019,Junio,Portugal,3,4,,7,POINT (11360029 -72129595)
2019,Junio,Portugal,1,0,,1,POINT (125862 -81702165)
2019,Junio,Portugal,9,15,,24,POINT (3451668 -76532004)
2019,Junio,Portugal,234,428,,662,POINT (4697157 -74140516)
2019,Junio,Portugal,2,3,,5,POINT (4815189 -75736374)
2019,Junio,Portugal,31,57,,88,POINT (6170465 -7542726)
2019,Junio,Portugal,0,1,,1,POINT (6185536 -67484028)
2019,Junio,Portugal,8,10,,18,POINT (7819 -72453013)
2019,Junio,Portugal,0,1,,1,POINT (836068 -72409396)
2019,Junio,Portugal,0,2,,2,POINT (863337 -7735002)
2019,Junio,Qatar,0,2,,2,POINT (10446304 -75516486)
2019,Junio,Qatar,1,2,,3,POINT (4697157 -74140516)
2019,Junio,Reino Unido de Gran Bretaña e Irlanda del Norte,3,6,,9,POINT (-4191162 -69941498)
2019,Junio,Reino Unido de Gran Bretaña e Irlanda del Norte,6,9,,15,POINT (-4214082 -69941431)
2019,Junio,Reino Unido de Gran Bretaña e Irlanda del Norte,5,5,,10,POINT (0.33002 -76876446)
2019,Junio,Reino Unido de Gran Bretaña e Irlanda del Norte,108,120,,228,POINT (0.81488 -77356)
2019,Junio,Reino Unido de Gran Bretaña e Irlanda del Norte,10,9,,19,POINT (10406342 -75527794)
2019,Junio,Reino Unido de Gran Bretaña e Irlanda del Norte,115,167,,282,POINT (10446304 -75516486)
2019,Junio,Reino Unido de Gran Bretaña e Irlanda del Norte,12,13,,25,POINT (10886686 -74776479)
2019,Junio,Reino Unido de Gran Bretaña e Irlanda del Norte,0,6,,6,POINT (125862 -81702165)
2019,Junio,Reino Unido de Gran Bretaña e Irlanda del Norte,35,55,,90,POINT (3451668 -76532004)
2019,Junio,Reino Unido de Gran Bretaña e Irlanda del Norte,1,1,,2,POINT (445285 -75766353)
2019,Junio,Reino Unido de Gran Bretaña e Irlanda del Norte,997,1894,,2891,POINT (4697157 -74140516)
2019,Junio,Reino Unido de Gran Bretaña e Irlanda del Norte,0,10,,10,POINT (4815189 -75736374)
2019,Junio,Reino Unido de Gran Bretaña e Irlanda del Norte,176,310,,486,POINT (6170465 -7542726)
2019,Junio,Reino Unido de Gran Bretaña e Irlanda del Norte,1,0,,1,POINT (6185536 -67484028)
2019,Junio,Reino Unido de Gran Bretaña e Irlanda del Norte,0,1,,1,POINT (7128047 -73181317)
2019,Junio,Reino Unido de Gran Bretaña e Irlanda del Norte,1,3,,4,POINT (7819 -72453013)
2019,Junio,Reino Unido de Gran Bretaña e Irlanda del Norte,29,22,,51,POINT (863337 -7735002)
2019,Junio,República Dominicana,0,1,,1,POINT (-4191162 -69941498)
2019,Junio,República Dominicana,5,15,,20,POINT (0.81488 -77356)
2019,Junio,República Dominicana,18,20,,38,POINT (10406342 -75527794)
2019,Junio,República Dominicana,58,71,,129,POINT (10446304 -75516486)
2019,Junio,República Dominicana,19,42,,61,POINT (10886686 -74776479)
2019,Junio,República Dominicana,0,1,,1,POINT (11117206 -74232675)
2019,Junio,República Dominicana,3,1,,4,POINT (11360029 -72129595)
2019,Junio,República Dominicana,0,2,,2,POINT (125862 -81702165)
2019,Junio,República Dominicana,27,33,,60,POINT (3451668 -76532004)
2019,Junio,República Dominicana,0,2,,2,POINT (445285 -75766353)
2019,Junio,República Dominicana,925,1010,,1935,POINT (4697157 -74140516)
2019,Junio,República Dominicana,0,1,,1,POINT (4815189 -75736374)
2019,Junio,República Dominicana,92,132,,224,POINT (6170465 -7542726)
2019,Junio,República Dominicana,5,1,,6,POINT (7128047 -73181317)
2019,Junio,República Dominicana,2,1,,3,POINT (7819 -72453013)
2019,Junio,República Dominicana,0,1,,1,POINT (836068 -72409396)
2019,Junio,Rumania,2,3,,5,POINT (0.81488 -77356)
2019,Junio,Rumania,1,5,,6,POINT (10406342 -75527794)
2019,Junio,Rumania,3,13,,16,POINT (10446304 -75516486)
2019,Junio,Rumania,1,2,,3,POINT (10886686 -74776479)
2019,Junio,Rumania,0,2,,2,POINT (11247723 -74213989)
2019,Junio,Rumania,1,2,,3,POINT (3451668 -76532004)
2019,Junio,Rumania,0,1,,1,POINT (3884426 -77061029)
2019,Junio,Rumania,62,61,,123,POINT (4697157 -74140516)
2019,Junio,Rumania,14,11,,25,POINT (6170465 -7542726)
2019,Junio,Federación de Rusia,0,2,,2,POINT (-4191162 -69941498)
2019,Junio,Federación de Rusia,1,0,,1,POINT (-4214082 -69941431)
2019,Junio,Federación de Rusia,1,0,,1,POINT (0.33002 -76876446)
2019,Junio,Federación de Rusia,2,2,,4,POINT (0.81488 -77356)
2019,Junio,Federación de Rusia,0,3,,3,POINT (10406342 -75527794)
2019,Junio,Federación de Rusia,14,14,,28,POINT (10446304 -75516486)
2019,Junio,Federación de Rusia,1,0,,1,POINT (10886686 -74776479)
2019,Junio,Federación de Rusia,0,1,,1,POINT (11247723 -74213989)
2019,Junio,Federación de Rusia,0,1,,1,POINT (11360029 -72129595)
2019,Junio,Federación de Rusia,7,9,,16,POINT (3451668 -76532004)
2019,Junio,Federación de Rusia,0,5,,5,POINT (3884426 -77061029)
2019,Junio,Federación de Rusia,133,164,,297,POINT (4697157 -74140516)
2019,Junio,Federación de Rusia,1,0,,1,POINT (4815189 -75736374)
2019,Junio,Federación de Rusia,20,18,,38,POINT (6170465 -7542726)
2019,Junio,Federación de Rusia,1,0,,1,POINT (7819 -72453013)
2019,Junio,Federación de Rusia,0,1,,1,POINT (863337 -7735002)
2019,Junio,Rwanda,0,1,,1,POINT (4697157 -74140516)
2019,Junio,San Cristóbal y Nevis,1,1,,2,POINT (10446304 -75516486)
2019,Junio,San Cristóbal y Nevis,0,2,,2,POINT (125862 -81702165)
2019,Junio,San Cristóbal y Nevis,3,3,,6,POINT (4697157 -74140516)
2019,Junio,San Cristóbal y Nevis,1,0,,1,POINT (6170465 -7542726)
2019,Junio,San  Vicente y las Granadinas,1,1,,2,POINT (125862 -81702165)
2019,Junio,San  Vicente y las Granadinas,1,0,,1,POINT (3451668 -76532004)
2019,Junio,San  Vicente y las Granadinas,0,4,,4,POINT (4697157 -74140516)
2019,Junio,San  Vicente y las Granadinas,2,3,,5,POINT (6170465 -7542726)
2019,Junio,Santa Lucia,0,1,,1,POINT (10446304 -75516486)
2019,Junio,Santa Lucia,1,1,,2,POINT (3451668 -76532004)
2019,Junio,Santa Lucia,3,1,,4,POINT (4697157 -74140516)
2019,Junio,Santa Lucia,6,1,,7,POINT (6170465 -7542726)
2019,Junio,Santa Lucia,2,1,,3,POINT (7128047 -73181317)
2019,Junio,Santa Sede/Ciudad del Vaticano,0,3,,3,POINT (4697157 -74140516)
2019,Junio,Santa Sede/Ciudad del Vaticano,0,1,,1,POINT (6170465 -7542726)
2019,Junio,Senegal,0,1,,1,POINT (3451668 -76532004)
2019,Junio,Senegal,1,8,,9,POINT (4697157 -74140516)
2019,Junio,Serbia,0,1,,1,POINT (0.33002 -76876446)
2019,Junio,Serbia,3,3,,6,POINT (10446304 -75516486)
2019,Junio,Serbia,0,1,,1,POINT (125862 -81702165)
2019,Junio,Serbia,1,1,,2,POINT (3451668 -76532004)
2019,Junio,Serbia,11,33,,44,POINT (4697157 -74140516)
2019,Junio,Serbia,5,10,,15,POINT (6170465 -7542726)
2019,Junio,Singapur,3,2,,5,POINT (10446304 -75516486)
2019,Junio,Singapur,1,1,,2,POINT (3451668 -76532004)
2019,Junio,Singapur,21,37,,58,POINT (4697157 -74140516)
2019,Junio,Singapur,2,0,,2,POINT (6170465 -7542726)
2019,Junio,República Árabe Siria,0,4,,4,POINT (4697157 -74140516)
2019,Junio,República Árabe Siria,0,1,,1,POINT (6170465 -7542726)
2019,Junio,Sri Lanka,0,1,,1,POINT (0.81488 -77356)
2019,Junio,Sri Lanka,0,1,,1,POINT (10406342 -75527794)
2019,Junio,Sri Lanka,0,1,,1,POINT (3451668 -76532004)
2019,Junio,Sri Lanka,1,0,,1,POINT (4697157 -74140516)
2019,Junio,Sudáfrica,0,1,,1,POINT (-4214082 -69941431)
2019,Junio,Sudáfrica,1,1,,2,POINT (0.81488 -77356)
2019,Junio,Sudáfrica,0,1,,1,POINT (10406342 -75527794)
2019,Junio,Sudáfrica,4,4,,8,POINT (10446304 -75516486)
2019,Junio,Sudáfrica,35,50,,85,POINT (4697157 -74140516)
2019,Junio,Sudáfrica,3,1,,4,POINT (6170465 -7542726)
2019,Junio,Sudáfrica,0,2,,2,POINT (7819 -72453013)
2019,Junio,Sudán,1,1,,2,POINT (4697157 -74140516)
2019,Junio,Suecia,0,1,,1,POINT (-4191162 -69941498)
2019,Junio,Suecia,6,8,,14,POINT (0.81488 -77356)
2019,Junio,Suecia,4,4,,8,POINT (10406342 -75527794)
2019,Junio,Suecia,19,27,,46,POINT (10446304 -75516486)
2019,Junio,Suecia,5,6,,11,POINT (10886686 -74776479)
2019,Junio,Suecia,0,2,,2,POINT (11247723 -74213989)
2019,Junio,Suecia,4,12,,16,POINT (3451668 -76532004)
2019,Junio,Suecia,216,260,,476,POINT (4697157 -74140516)
2019,Junio,Suecia,1,5,,6,POINT (4815189 -75736374)
2019,Junio,Suecia,32,55,,87,POINT (6170465 -7542726)
2019,Junio,Suecia,1,0,,1,POINT (863337 -7735002)
2019,Junio,Suiza,9,2,,11,POINT (-4214082 -69941431)
2019,Junio,Suiza,3,1,,4,POINT (0.33002 -76876446)
2019,Junio,Suiza,34,33,,67,POINT (0.81488 -77356)
2019,Junio,Suiza,13,14,,27,POINT (10406342 -75527794)
2019,Junio,Suiza,50,66,,116,POINT (10446304 -75516486)
2019,Junio,Suiza,3,10,,13,POINT (10886686 -74776479)
2019,Junio,Suiza,1,0,,1,POINT (11247723 -74213989)
2019,Junio,Suiza,0,1,,1,POINT (11360029 -72129595)
2019,Junio,Suiza,0,1,,1,POINT (125744111 -81703935)
2019,Junio,Suiza,0,1,,1,POINT (125862 -81702165)
2019,Junio,Suiza,28,33,,61,POINT (3451668 -76532004)
2019,Junio,Suiza,1,1,,2,POINT (445285 -75766353)
2019,Junio,Suiza,354,545,,899,POINT (4697157 -74140516)
2019,Junio,Suiza,1,2,,3,POINT (4815189 -75736374)
2019,Junio,Suiza,50,77,,127,POINT (6170465 -7542726)
2019,Junio,Suiza,0,1,,1,POINT (7819 -72453013)
2019,Junio,Suiza,1,0,,1,POINT (836068 -72409396)
2019,Junio,Suiza,1,2,,3,POINT (863337 -7735002)
2019,Junio,Surinam,2,1,,3,POINT (10446304 -75516486)
2019,Junio,Surinam,15,24,,39,POINT (4697157 -74140516)
2019,Junio,Surinam,4,1,,5,POINT (6170465 -7542726)
2019,Junio,Taiwán,0,1,,1,POINT (4697157 -74140516)
2019,Junio,República de Tayikistán,0,1,,1,POINT (0.81488 -77356)
2019,Junio,República de Tayikistán,0,1,,1,POINT (4697157 -74140516)
2019,Junio,Tailandia,3,0,,3,POINT (0.81488 -77356)
2019,Junio,Tailandia,3,3,,6,POINT (10446304 -75516486)
2019,Junio,Tailandia,14,10,,24,POINT (4697157 -74140516)
2019,Junio,Tailandia,0,1,,1,POINT (6170465 -7542726)
2019,Junio,Tanzania,0,1,,1,POINT (10446304 -75516486)
2019,Junio,Tanzania,1,0,,1,POINT (3451668 -76532004)
2019,Junio,Tanzania,0,1,,1,POINT (4697157 -74140516)
2019,Junio,Tanzania,0,1,,1,POINT (6170465 -7542726)
2019,Junio,Togo,0,2,,2,POINT (10406342 -75527794)
2019,Junio,Togo,0,1,,1,POINT (4697157 -74140516)
2019,Junio,Trinidad y Tobago,6,7,,13,POINT (10446304 -75516486)
2019,Junio,Trinidad y Tobago,5,1,,6,POINT (10886686 -74776479)
2019,Junio,Trinidad y Tobago,5,8,,13,POINT (3451668 -76532004)
2019,Junio,Trinidad y Tobago,49,48,,97,POINT (4697157 -74140516)
2019,Junio,Trinidad y Tobago,0,1,,1,POINT (4815189 -75736374)
2019,Junio,Trinidad y Tobago,7,14,,21,POINT (6170465 -7542726)
2019,Junio,Trinidad y Tobago,2,3,,5,POINT (7128047 -73181317)
2019,Junio,Trinidad y Tobago,0,1,,1,POINT (7819 -72453013)
2019,Junio,Túnez,0,1,,1,POINT (10406342 -75527794)
2019,Junio,Túnez,0,1,,1,POINT (11360029 -72129595)
2019,Junio,Túnez,5,3,,8,POINT (4697157 -74140516)
2019,Junio,Turquía,0,1,,1,POINT (0.81488 -77356)
2019,Junio,Turquía,0,4,,4,POINT (10406342 -75527794)
2019,Junio,Turquía,9,13,,22,POINT (10446304 -75516486)
2019,Junio,Turquía,0,3,,3,POINT (10886686 -74776479)
2019,Junio,Turquía,0,1,,1,POINT (11247723 -74213989)
2019,Junio,Turquía,0,3,,3,POINT (3451668 -76532004)
2019,Junio,Turquía,179,368,,547,POINT (4697157 -74140516)
2019,Junio,Turquía,7,14,,21,POINT (6170465 -7542726)
2019,Junio,Turquía,0,1,,1,POINT (7128047 -73181317)
2019,Junio,Turquía,0,1,,1,POINT (863337 -7735002)
2019,Junio,Ucrania,1,0,,1,POINT (-4214082 -69941431)
2019,Junio,Ucrania,2,2,,4,POINT (0.81488 -77356)
2019,Junio,Ucrania,0,5,,5,POINT (10406342 -75527794)
2019,Junio,Ucrania,1,4,,5,POINT (10446304 -75516486)
2019,Junio,Ucrania,0,2,,2,POINT (10886686 -74776479)
2019,Junio,Ucrania,0,1,,1,POINT (10970933 -74765343)
2019,Junio,Ucrania,0,3,,3,POINT (11247723 -74213989)
2019,Junio,Ucrania,0,4,,4,POINT (3884426 -77061029)
2019,Junio,Ucrania,31,34,,65,POINT (4697157 -74140516)
2019,Junio,Ucrania,4,6,,10,POINT (6170465 -7542726)
2019,Junio,Ucrania,0,1,,1,POINT (9402597 -75681642)
2019,Junio,Uganda,0,1,,1,POINT (0.81488 -77356)
2019,Junio,Uganda,0,1,,1,POINT (10446304 -75516486)
2019,Junio,Uganda,0,3,,3,POINT (4697157 -74140516)
2019,Junio,Uganda,2,0,,2,POINT (6170465 -7542726)
2019,Junio,Uruguay,1,2,,3,POINT (-4214082 -69941431)
2019,Junio,Uruguay,4,1,,5,POINT (0.33002 -76876446)
2019,Junio,Uruguay,1,11,,12,POINT (0.81488 -77356)
2019,Junio,Uruguay,23,8,,31,POINT (10406342 -75527794)
2019,Junio,Uruguay,137,91,,228,POINT (10446304 -75516486)
2019,Junio,Uruguay,1,10,,11,POINT (10886686 -74776479)
2019,Junio,Uruguay,53,45,,98,POINT (125862 -81702165)
2019,Junio,Uruguay,10,31,,41,POINT (3451668 -76532004)
2019,Junio,Uruguay,0,2,,2,POINT (445285 -75766353)
2019,Junio,Uruguay,404,531,,935,POINT (4697157 -74140516)
2019,Junio,Uruguay,1,0,,1,POINT (4815189 -75736374)
2019,Junio,Uruguay,97,135,,232,POINT (6170465 -7542726)
2019,Junio,Uruguay,2,5,,7,POINT (7819 -72453013)
2019,Junio,Venezuela,4,3,,7,POINT (-4191162 -69941498)
2019,Junio,Venezuela,6,3,,9,POINT (-4214082 -69941431)
2019,Junio,Venezuela,81,73,,154,POINT (0.33002 -76876446)
2019,Junio,Venezuela,3555,3698,,7253,POINT (0.81488 -77356)
2019,Junio,Venezuela,2,20,,22,POINT (1800143 -78802679)
2019,Junio,Venezuela,17,42,,59,POINT (10406342 -75527794)
2019,Junio,Venezuela,199,219,,418,POINT (10446304 -75516486)
2019,Junio,Venezuela,291,405,,696,POINT (10886686 -74776479)
2019,Junio,Venezuela,16,27,,43,POINT (11117206 -74232675)
2019,Junio,Venezuela,7884,7359,,15243,POINT (11360029 -72129595)
2019,Junio,Venezuela,0,2,,2,POINT (1152863 -72919186)
2019,Junio,Venezuela,3,2,,5,POINT (125862 -81702165)
2019,Junio,Venezuela,206,224,,430,POINT (3451668 -76532004)
2019,Junio,Venezuela,21,19,,40,POINT (3866713 -67927521)
2019,Junio,Venezuela,2,2,,4,POINT (445285 -75766353)
2019,Junio,Venezuela,7900,7827,,15727,POINT (4697157 -74140516)
2019,Junio,Venezuela,7,20,,27,POINT (4815189 -75736374)
2019,Junio,Venezuela,1515,1474,,2989,POINT (6170465 -7542726)
2019,Junio,Venezuela,38,28,,66,POINT (6185536 -67484028)
2019,Junio,Venezuela,700,690,,1390,POINT (7088729 -70740253)
2019,Junio,Venezuela,9,13,,22,POINT (7128047 -73181317)
2019,Junio,Venezuela,29976,26826,,56802,POINT (7819 -72453013)
2019,Junio,Venezuela,12,28,,40,POINT (7927233 -72508188)
2019,Junio,Venezuela,1904,1597,,3501,POINT (836068 -72409396)
2019,Junio,Venezuela,1,0,,1,POINT (863337 -7735002)
2019,Junio,Vietnam,5,2,,7,POINT (4697157 -74140516)
2019,Junio,Vietnam,5,4,,9,POINT (6170465 -7542726)
2019,Junio,República Árabe de Yemen,2,3,,5,POINT (4697157 -74140516)
2019,Junio,Zambia,0,1,,1,POINT (4697157 -74140516)
2019,Junio,Zimbabue,1,2,,3,POINT (4697157 -74140516)
2019,Junio,Zimbabue,0,1,,1,POINT (6170465 -7542726)
2019,Junio,Desconocido,5,4,,9,POINT (10446304 -75516486)
2019,Junio,Desconocido,0,1,,1,POINT (10886686 -74776479)
2019,Julio,Desconocido,101,163,,264,POINT (4697157 -74140516)
2019,Julio,Desconocido,7,15,,22,POINT (6170465 -7542726)
2019,Julio,Desconocido,1,0,,1,POINT (7819 -72453013)
